,TIME,SRC,PACKET_SIZE,CUMULATIVE_PACKET_SIZE,PAGE_NUMBER,TOTAL_PACKET_SIZE
0,0.0,172.217.194.0-255,153,153,96,349074
1,2.5e-05,172.31.47.0-255,66,219,96,349074
2,3.2e-05,172.217.194.0-255,1484,1703,96,349074
3,3.6e-05,172.31.47.0-255,66,1769,96,349074
4,4.1e-05,172.217.194.0-255,2902,4671,96,349074
5,4.3e-05,172.31.47.0-255,66,4737,96,349074
6,5e-05,172.217.194.0-255,7156,11893,96,349074
7,5.2e-05,172.31.47.0-255,66,11959,96,349074
8,5.5e-05,172.217.194.0-255,1484,13443,96,349074
9,5.7e-05,172.31.47.0-255,66,13509,96,349074
10,6e-05,172.217.194.0-255,530,14039,96,349074
11,6.2e-05,172.31.47.0-255,66,14105,96,349074
12,0.000163,172.217.194.0-255,1484,15589,96,349074
13,0.000167,172.31.47.0-255,66,15655,96,349074
14,0.000173,172.217.194.0-255,2902,18557,96,349074
15,0.000175,172.31.47.0-255,66,18623,96,349074
16,0.000182,172.217.194.0-255,5738,24361,96,349074
17,0.000184,172.31.47.0-255,66,24427,96,349074
18,0.000213,172.217.194.0-255,5738,30165,96,349074
19,0.000216,172.31.47.0-255,66,30231,96,349074
20,0.000227,172.217.194.0-255,1125,31356,96,349074
21,0.00023,172.31.47.0-255,66,31422,96,349074
22,0.000305,172.217.194.0-255,1484,32906,96,349074
23,0.000308,172.31.47.0-255,66,32972,96,349074
24,0.000313,172.217.194.0-255,2902,35874,96,349074
25,0.000315,172.31.47.0-255,66,35940,96,349074
26,0.000321,172.217.194.0-255,4320,40260,96,349074
27,0.000323,172.31.47.0-255,66,40326,96,349074
28,0.000339,172.217.194.0-255,1484,41810,96,349074
29,0.000342,172.31.47.0-255,66,41876,96,349074
30,0.000346,172.217.194.0-255,2902,44778,96,349074
31,0.000349,172.31.47.0-255,66,44844,96,349074
32,0.000377,172.217.194.0-255,3961,48805,96,349074
33,0.000381,172.31.47.0-255,66,48871,96,349074
34,0.000388,172.217.194.0-255,7156,56027,96,349074
35,0.00039,172.31.47.0-255,66,56093,96,349074
36,0.000393,172.217.194.0-255,1484,57577,96,349074
37,0.000417,172.31.47.0-255,66,57643,96,349074
38,0.000443,172.217.194.0-255,646,58289,96,349074
39,0.000715,172.31.47.0-255,66,58355,96,349074
40,0.001289,172.217.194.0-255,1484,59839,96,349074
41,0.001299,172.217.194.0-255,2902,62741,96,349074
42,0.001303,172.31.47.0-255,66,62807,96,349074
43,0.00131,172.217.194.0-255,4320,67127,96,349074
44,0.001312,172.31.47.0-255,66,67193,96,349074
45,0.001333,172.217.194.0-255,1484,68677,96,349074
46,0.00134,172.217.194.0-255,7156,75833,96,349074
47,0.001342,172.31.47.0-255,66,75899,96,349074
48,0.001367,172.217.194.0-255,5738,81637,96,349074
49,0.001369,172.31.47.0-255,66,81703,96,349074
50,0.001378,172.31.47.0-255,66,81769,96,349074
51,0.001399,172.217.194.0-255,1484,83253,96,349074
52,0.001411,172.217.194.0-255,766,84019,96,349074
53,0.001413,172.31.47.0-255,66,84085,96,349074
54,0.001567,172.217.194.0-255,1484,85569,96,349074
55,0.001571,172.217.194.0-255,2902,88471,96,349074
56,0.001573,172.31.47.0-255,66,88537,96,349074
57,0.001595,172.217.194.0-255,4320,92857,96,349074
58,0.001597,172.31.47.0-255,66,92923,96,349074
59,0.001608,172.217.194.0-255,1484,94407,96,349074
60,0.001625,172.217.194.0-255,5738,100145,96,349074
61,0.001627,172.31.47.0-255,66,100211,96,349074
62,0.001645,172.217.194.0-255,4320,104531,96,349074
63,0.001646,172.31.47.0-255,66,104597,96,349074
64,0.001674,172.31.47.0-255,66,104663,96,349074
65,0.001679,172.217.194.0-255,5020,109683,96,349074
66,0.00168,172.31.47.0-255,66,109749,96,349074
67,0.00169,172.217.194.0-255,2902,112651,96,349074
68,0.001692,172.31.47.0-255,66,112717,96,349074
69,0.001705,172.217.194.0-255,2902,115619,96,349074
70,0.001706,172.31.47.0-255,66,115685,96,349074
71,0.001709,172.217.194.0-255,1484,117169,96,349074
72,0.001723,172.217.194.0-255,7156,124325,96,349074
73,0.001725,172.31.47.0-255,66,124391,96,349074
74,0.001739,172.217.194.0-255,4320,128711,96,349074
75,0.001741,172.31.47.0-255,66,128777,96,349074
76,0.001746,172.217.194.0-255,5738,134515,96,349074
77,0.001748,172.31.47.0-255,66,134581,96,349074
78,0.001785,172.31.47.0-255,66,134647,96,349074
79,0.001832,172.217.194.0-255,1484,136131,96,349074
80,0.001847,172.217.194.0-255,2902,139033,96,349074
81,0.001849,172.31.47.0-255,66,139099,96,349074
82,0.001868,172.217.194.0-255,5738,144837,96,349074
83,0.00187,172.31.47.0-255,66,144903,96,349074
84,0.001873,172.217.194.0-255,2902,147805,96,349074
85,0.001875,172.31.47.0-255,66,147871,96,349074
86,0.001889,172.217.194.0-255,1484,149355,96,349074
87,0.001899,172.217.194.0-255,4320,153675,96,349074
88,0.001901,172.31.47.0-255,66,153741,96,349074
89,0.001922,172.217.194.0-255,7156,160897,96,349074
90,0.001924,172.31.47.0-255,66,160963,96,349074
91,0.001932,172.31.47.0-255,66,161029,96,349074
92,0.00395,172.217.194.0-255,5738,166767,96,349074
93,0.003956,172.31.47.0-255,66,166833,96,349074
94,0.005952,172.217.194.0-255,5738,172571,96,349074
95,0.005959,172.31.47.0-255,66,172637,96,349074
96,0.007977,172.217.194.0-255,5738,178375,96,349074
97,0.007984,172.31.47.0-255,66,178441,96,349074
98,0.010003,172.217.194.0-255,5738,184179,96,349074
99,0.010011,172.31.47.0-255,66,184245,96,349074
100,0.01204,172.217.194.0-255,5738,189983,96,349074
101,0.01205,172.31.47.0-255,66,190049,96,349074
102,0.014075,172.217.194.0-255,5738,195787,96,349074
103,0.014083,172.31.47.0-255,66,195853,96,349074
104,0.016082,172.217.194.0-255,5738,201591,96,349074
105,0.016089,172.31.47.0-255,66,201657,96,349074
106,0.018087,172.217.194.0-255,5738,207395,96,349074
107,0.018096,172.31.47.0-255,66,207461,96,349074
108,0.020128,172.217.194.0-255,5738,213199,96,349074
109,0.020136,172.31.47.0-255,66,213265,96,349074
110,0.022164,172.217.194.0-255,5738,219003,96,349074
111,0.022172,172.31.47.0-255,66,219069,96,349074
112,0.024197,172.217.194.0-255,5738,224807,96,349074
113,0.024204,172.31.47.0-255,66,224873,96,349074
114,0.025343,172.31.47.0-255,172,225045,96,349074
115,0.025384,172.31.47.0-255,1109,226154,96,349074
116,0.02546,172.31.47.0-255,1514,227668,96,349074
117,0.025462,172.31.47.0-255,1302,228970,96,349074
118,0.026196,172.217.194.0-255,5738,234708,96,349074
119,0.026203,172.31.47.0-255,66,234774,96,349074
120,0.026919,104.244.42.0-255,66,234840,96,349074
121,0.026962,104.244.42.0-255,66,234906,96,349074
122,0.027014,104.244.42.0-255,66,234972,96,349074
123,0.028185,172.217.194.0-255,1484,236456,96,349074
124,0.028213,172.217.194.0-255,4320,240776,96,349074
125,0.028218,172.31.47.0-255,66,240842,96,349074
126,0.030232,172.217.194.0-255,5738,246580,96,349074
127,0.030238,172.31.47.0-255,66,246646,96,349074
128,0.032233,172.217.194.0-255,2902,249548,96,349074
129,0.032237,172.31.47.0-255,66,249614,96,349074
130,0.032269,172.217.194.0-255,2902,252516,96,349074
131,0.032272,172.31.47.0-255,66,252582,96,349074
132,0.034251,172.217.194.0-255,4320,256902,96,349074
133,0.034255,172.31.47.0-255,66,256968,96,349074
134,0.03428,172.217.194.0-255,1484,258452,96,349074
135,0.036248,172.217.194.0-255,4320,262772,96,349074
136,0.036253,172.31.47.0-255,66,262838,96,349074
137,0.038246,172.217.194.0-255,5738,268576,96,349074
138,0.03825,172.31.47.0-255,66,268642,96,349074
139,0.040253,172.217.194.0-255,5738,274380,96,349074
140,0.040258,172.31.47.0-255,66,274446,96,349074
141,0.042265,172.217.194.0-255,5738,280184,96,349074
142,0.04227,172.31.47.0-255,66,280250,96,349074
143,0.044277,172.217.194.0-255,5738,285988,96,349074
144,0.044282,172.31.47.0-255,66,286054,96,349074
145,0.046283,172.217.194.0-255,5738,291792,96,349074
146,0.046289,172.31.47.0-255,66,291858,96,349074
147,0.048282,172.217.194.0-255,4320,296178,96,349074
148,0.048287,172.31.47.0-255,66,296244,96,349074
149,0.048319,172.217.194.0-255,1484,297728,96,349074
150,0.050278,172.217.194.0-255,4320,302048,96,349074
151,0.050283,172.31.47.0-255,66,302114,96,349074
152,0.052293,172.217.194.0-255,4320,306434,96,349074
153,0.052298,172.31.47.0-255,66,306500,96,349074
154,0.052323,172.217.194.0-255,1484,307984,96,349074
155,0.054291,172.217.194.0-255,4320,312304,96,349074
156,0.054296,172.31.47.0-255,66,312370,96,349074
157,0.05629,172.217.194.0-255,5738,318108,96,349074
158,0.056294,172.31.47.0-255,66,318174,96,349074
159,0.058282,172.217.194.0-255,4320,322494,96,349074
160,0.058287,172.31.47.0-255,66,322560,96,349074
161,0.058309,172.217.194.0-255,1484,324044,96,349074
162,0.060292,172.217.194.0-255,4320,328364,96,349074
163,0.060297,172.31.47.0-255,66,328430,96,349074
164,0.062297,172.217.194.0-255,4320,332750,96,349074
165,0.062301,172.31.47.0-255,66,332816,96,349074
166,0.062332,172.217.194.0-255,1484,334300,96,349074
167,0.064308,172.217.194.0-255,4320,338620,96,349074
168,0.064313,172.31.47.0-255,66,338686,96,349074
169,0.066317,172.217.194.0-255,4320,343006,96,349074
170,0.066322,172.31.47.0-255,66,343072,96,349074
171,0.066346,172.217.194.0-255,1484,344556,96,349074
172,0.068335,172.217.194.0-255,1484,346040,96,349074
173,0.068339,172.31.47.0-255,66,346106,96,349074
174,0.068364,172.217.194.0-255,2902,349008,96,349074
175,0.068367,172.31.47.0-255,66,349074,96,349074
176,0.0,172.217.194.0-255,152,152,96,216687
177,2.6e-05,172.31.47.0-255,66,218,96,216687
178,3.2e-05,172.217.194.0-255,1484,1702,96,216687
179,3.6e-05,172.31.47.0-255,66,1768,96,216687
180,5e-05,172.217.194.0-255,2902,4670,96,216687
181,5.2e-05,172.31.47.0-255,66,4736,96,216687
182,9.4e-05,172.217.194.0-255,5738,10474,96,216687
183,9.6e-05,172.31.47.0-255,66,10540,96,216687
184,0.000105,172.31.47.0-255,66,10606,96,216687
185,0.00011,172.217.194.0-255,2902,13508,96,216687
186,0.000112,172.31.47.0-255,66,13574,96,216687
187,0.00013,172.217.194.0-255,5738,19312,96,216687
188,0.000133,172.31.47.0-255,66,19378,96,216687
189,0.000147,172.217.194.0-255,3961,23339,96,216687
190,0.00015,172.31.47.0-255,66,23405,96,216687
191,0.000993,172.217.194.0-255,1484,24889,96,216687
192,0.000999,172.31.47.0-255,66,24955,96,216687
193,0.001006,172.217.194.0-255,1484,26439,96,216687
194,0.001007,172.31.47.0-255,66,26505,96,216687
195,0.00102,172.217.194.0-255,1484,27989,96,216687
196,0.001022,172.31.47.0-255,66,28055,96,216687
197,0.001025,172.217.194.0-255,1484,29539,96,216687
198,0.001026,172.31.47.0-255,66,29605,96,216687
199,0.001032,172.217.194.0-255,5738,35343,96,216687
200,0.001034,172.31.47.0-255,66,35409,96,216687
201,0.001056,172.217.194.0-255,1484,36893,96,216687
202,0.001058,172.31.47.0-255,66,36959,96,216687
203,0.001078,172.31.47.0-255,66,37025,96,216687
204,0.001113,172.217.194.0-255,1484,38509,96,216687
205,0.001115,172.31.47.0-255,66,38575,96,216687
206,0.001141,172.31.47.0-255,66,38641,96,216687
207,0.001649,172.217.194.0-255,645,39286,96,216687
208,0.001669,172.31.47.0-255,66,39352,96,216687
209,0.001688,172.217.194.0-255,1484,40836,96,216687
210,0.001702,172.217.194.0-255,1484,42320,96,216687
211,0.001705,172.31.47.0-255,66,42386,96,216687
212,0.001718,172.217.194.0-255,2902,45288,96,216687
213,0.00172,172.31.47.0-255,66,45354,96,216687
214,0.00173,172.31.47.0-255,66,45420,96,216687
215,0.001762,172.217.194.0-255,5738,51158,96,216687
216,0.001765,172.31.47.0-255,66,51224,96,216687
217,0.001794,172.217.194.0-255,2184,53408,96,216687
218,0.001797,172.31.47.0-255,66,53474,96,216687
219,0.001799,172.31.47.0-255,66,53540,96,216687
220,0.004067,172.217.194.0-255,4320,57860,96,216687
221,0.004071,172.31.47.0-255,66,57926,96,216687
222,0.004087,172.217.194.0-255,1484,59410,96,216687
223,0.006365,172.217.194.0-255,4320,63730,96,216687
224,0.006372,172.31.47.0-255,66,63796,96,216687
225,0.008643,172.217.194.0-255,5738,69534,96,216687
226,0.008652,172.31.47.0-255,66,69600,96,216687
227,0.010925,172.217.194.0-255,5738,75338,96,216687
228,0.010933,172.31.47.0-255,66,75404,96,216687
229,0.013241,172.217.194.0-255,5738,81142,96,216687
230,0.013249,172.31.47.0-255,66,81208,96,216687
231,0.015582,172.217.194.0-255,5738,86946,96,216687
232,0.015593,172.31.47.0-255,66,87012,96,216687
233,0.017912,172.217.194.0-255,5738,92750,96,216687
234,0.017919,172.31.47.0-255,66,92816,96,216687
235,0.020232,172.217.194.0-255,5738,98554,96,216687
236,0.020239,172.31.47.0-255,66,98620,96,216687
237,0.022541,172.217.194.0-255,5738,104358,96,216687
238,0.022547,172.31.47.0-255,66,104424,96,216687
239,0.023456,172.31.47.0-255,172,104596,96,216687
240,0.02349,172.31.47.0-255,1110,105706,96,216687
241,0.023546,172.31.47.0-255,1514,107220,96,216687
242,0.023548,172.31.47.0-255,1301,108521,96,216687
243,0.024812,172.217.194.0-255,5738,114259,96,216687
244,0.024817,172.31.47.0-255,66,114325,96,216687
245,0.025001,104.244.42.0-255,66,114391,96,216687
246,0.025026,104.244.42.0-255,66,114457,96,216687
247,0.025081,104.244.42.0-255,66,114523,96,216687
248,0.02715,172.217.194.0-255,5738,120261,96,216687
249,0.027156,172.31.47.0-255,66,120327,96,216687
250,0.029479,172.217.194.0-255,5738,126065,96,216687
251,0.029483,172.31.47.0-255,66,126131,96,216687
252,0.03178,172.217.194.0-255,5738,131869,96,216687
253,0.031785,172.31.47.0-255,66,131935,96,216687
254,0.034101,172.217.194.0-255,5738,137673,96,216687
255,0.034106,172.31.47.0-255,66,137739,96,216687
256,0.036369,172.217.194.0-255,4320,142059,96,216687
257,0.036374,172.31.47.0-255,66,142125,96,216687
258,0.036401,172.217.194.0-255,1484,143609,96,216687
259,0.038715,172.217.194.0-255,4320,147929,96,216687
260,0.03872,172.31.47.0-255,66,147995,96,216687
261,0.041062,172.217.194.0-255,5738,153733,96,216687
262,0.041067,172.31.47.0-255,66,153799,96,216687
263,0.043347,172.217.194.0-255,5738,159537,96,216687
264,0.043352,172.31.47.0-255,66,159603,96,216687
265,0.045609,172.217.194.0-255,5738,165341,96,216687
266,0.045615,172.31.47.0-255,66,165407,96,216687
267,0.047879,172.217.194.0-255,4320,169727,96,216687
268,0.047884,172.31.47.0-255,66,169793,96,216687
269,0.0479,172.217.194.0-255,1484,171277,96,216687
270,0.050196,172.217.194.0-255,4320,175597,96,216687
271,0.050201,172.31.47.0-255,66,175663,96,216687
272,0.052528,172.217.194.0-255,5738,181401,96,216687
273,0.052533,172.31.47.0-255,66,181467,96,216687
274,0.054827,172.217.194.0-255,4320,185787,96,216687
275,0.054832,172.31.47.0-255,66,185853,96,216687
276,0.054858,172.217.194.0-255,1484,187337,96,216687
277,0.057127,172.217.194.0-255,4320,191657,96,216687
278,0.057133,172.31.47.0-255,66,191723,96,216687
279,0.059404,172.217.194.0-255,4320,196043,96,216687
280,0.059409,172.31.47.0-255,66,196109,96,216687
281,0.059432,172.217.194.0-255,1484,197593,96,216687
282,0.061675,172.217.194.0-255,2902,200495,96,216687
283,0.06168,172.31.47.0-255,66,200561,96,216687
284,0.061708,172.217.194.0-255,1484,202045,96,216687
285,0.064011,172.217.194.0-255,4320,206365,96,216687
286,0.064016,172.31.47.0-255,66,206431,96,216687
287,0.066361,172.217.194.0-255,4320,210751,96,216687
288,0.066367,172.31.47.0-255,66,210817,96,216687
289,0.066384,172.217.194.0-255,1484,212301,96,216687
290,0.068719,172.217.194.0-255,4320,216621,96,216687
291,0.068724,172.31.47.0-255,66,216687,96,216687
292,0.0,172.217.194.0-255,153,153,96,221307
293,3e-05,172.31.47.0-255,66,219,96,221307
294,3.6e-05,172.217.194.0-255,1484,1703,96,221307
295,4e-05,172.31.47.0-255,66,1769,96,221307
296,4.4e-05,172.217.194.0-255,2902,4671,96,221307
297,4.6e-05,172.31.47.0-255,66,4737,96,221307
298,5.9e-05,172.217.194.0-255,7156,11893,96,221307
299,6.1e-05,172.31.47.0-255,66,11959,96,221307
300,6.6e-05,172.217.194.0-255,2127,14086,96,221307
301,6.8e-05,172.31.47.0-255,66,14152,96,221307
302,9.1e-05,172.217.194.0-255,7156,21308,96,221307
303,9.3e-05,172.31.47.0-255,66,21374,96,221307
304,0.000124,172.217.194.0-255,4320,25694,96,221307
305,0.000127,172.31.47.0-255,66,25760,96,221307
306,0.000133,172.217.194.0-255,5379,31139,96,221307
307,0.000135,172.31.47.0-255,66,31205,96,221307
308,0.00025,172.217.194.0-255,1484,32689,96,221307
309,0.000255,172.31.47.0-255,66,32755,96,221307
310,0.000266,172.217.194.0-255,2902,35657,96,221307
311,0.000272,172.31.47.0-255,66,35723,96,221307
312,0.000292,172.217.194.0-255,5738,41461,96,221307
313,0.000295,172.31.47.0-255,66,41527,96,221307
314,0.00033,172.31.47.0-255,66,41593,96,221307
315,0.000333,172.217.194.0-255,2902,44495,96,221307
316,0.000336,172.31.47.0-255,66,44561,96,221307
317,0.000357,172.217.194.0-255,5738,50299,96,221307
318,0.000364,172.31.47.0-255,66,50365,96,221307
319,0.000371,172.217.194.0-255,7089,57454,96,221307
320,0.000373,172.31.47.0-255,66,57520,96,221307
321,0.000453,172.217.194.0-255,364,57884,96,221307
322,0.000457,172.31.47.0-255,66,57950,96,221307
323,0.000696,172.217.194.0-255,1484,59434,96,221307
324,0.000722,172.217.194.0-255,2902,62336,96,221307
325,0.000725,172.31.47.0-255,66,62402,96,221307
326,0.000731,172.217.194.0-255,5738,68140,96,221307
327,0.000733,172.31.47.0-255,66,68206,96,221307
328,0.000737,172.217.194.0-255,2902,71108,96,221307
329,0.000743,172.31.47.0-255,66,71174,96,221307
330,0.000777,172.31.47.0-255,66,71240,96,221307
331,0.000788,172.31.47.0-255,66,71306,96,221307
332,0.000891,172.217.194.0-255,1484,72790,96,221307
333,0.000895,172.217.194.0-255,1484,74274,96,221307
334,0.000899,172.31.47.0-255,66,74340,96,221307
335,0.00091,172.217.194.0-255,1484,75824,96,221307
336,0.00092,172.217.194.0-255,5738,81562,96,221307
337,0.000922,172.31.47.0-255,66,81628,96,221307
338,0.000928,172.217.194.0-255,5738,87366,96,221307
339,0.00093,172.31.47.0-255,66,87432,96,221307
340,0.000949,172.217.194.0-255,7156,94588,96,221307
341,0.000951,172.31.47.0-255,66,94654,96,221307
342,0.000963,172.217.194.0-255,5738,100392,96,221307
343,0.000965,172.31.47.0-255,66,100458,96,221307
344,0.00097,172.217.194.0-255,4320,104778,96,221307
345,0.000972,172.31.47.0-255,66,104844,96,221307
346,0.000998,172.217.194.0-255,766,105610,96,221307
347,0.001175,172.31.47.0-255,66,105676,96,221307
348,0.00132,172.217.194.0-255,1484,107160,96,221307
349,0.001328,172.217.194.0-255,2902,110062,96,221307
350,0.001331,172.31.47.0-255,66,110128,96,221307
351,0.001334,172.217.194.0-255,1484,111612,96,221307
352,0.001361,172.217.194.0-255,4320,115932,96,221307
353,0.001363,172.31.47.0-255,66,115998,96,221307
354,0.001406,172.217.194.0-255,7156,123154,96,221307
355,0.001409,172.31.47.0-255,66,123220,96,221307
356,0.001433,172.217.194.0-255,5738,128958,96,221307
357,0.001435,172.31.47.0-255,66,129024,96,221307
358,0.001442,172.217.194.0-255,7156,136180,96,221307
359,0.001444,172.31.47.0-255,66,136246,96,221307
360,0.001453,172.217.194.0-255,3602,139848,96,221307
361,0.001454,172.31.47.0-255,66,139914,96,221307
362,0.001458,172.217.194.0-255,4320,144234,96,221307
363,0.00146,172.31.47.0-255,66,144300,96,221307
364,0.001488,172.31.47.0-255,66,144366,96,221307
365,0.001493,172.217.194.0-255,5738,150104,96,221307
366,0.001495,172.31.47.0-255,66,150170,96,221307
367,0.001557,172.31.47.0-255,66,150236,96,221307
368,0.001572,172.31.47.0-255,66,150302,96,221307
369,0.001608,172.31.47.0-255,66,150368,96,221307
370,0.001634,172.217.194.0-255,6438,156806,96,221307
371,0.001637,172.31.47.0-255,66,156872,96,221307
372,0.001658,172.217.194.0-255,1484,158356,96,221307
373,0.001669,172.217.194.0-255,2902,161258,96,221307
374,0.00167,172.31.47.0-255,66,161324,96,221307
375,0.0017,172.217.194.0-255,5738,167062,96,221307
376,0.001703,172.31.47.0-255,66,167128,96,221307
377,0.001707,172.217.194.0-255,4320,171448,96,221307
378,0.001709,172.31.47.0-255,66,171514,96,221307
379,0.001725,172.217.194.0-255,7156,178670,96,221307
380,0.001727,172.31.47.0-255,66,178736,96,221307
381,0.001746,172.217.194.0-255,4320,183056,96,221307
382,0.001748,172.31.47.0-255,66,183122,96,221307
383,0.001756,172.31.47.0-255,66,183188,96,221307
384,0.00183,172.217.194.0-255,1484,184672,96,221307
385,0.001847,172.217.194.0-255,2902,187574,96,221307
386,0.001848,172.31.47.0-255,66,187640,96,221307
387,0.001854,172.217.194.0-255,5738,193378,96,221307
388,0.001856,172.31.47.0-255,66,193444,96,221307
389,0.001887,172.31.47.0-255,66,193510,96,221307
390,0.00194,172.31.47.0-255,66,193576,96,221307
391,0.001952,172.217.194.0-255,4320,197896,96,221307
392,0.001953,172.31.47.0-255,66,197962,96,221307
393,0.001971,172.217.194.0-255,2902,200864,96,221307
394,0.001976,172.31.47.0-255,66,200930,96,221307
395,0.001985,172.31.47.0-255,66,200996,96,221307
396,0.001987,172.217.194.0-255,1484,202480,96,221307
397,0.002012,172.31.47.0-255,66,202546,96,221307
398,0.002015,172.217.194.0-255,2184,204730,96,221307
399,0.002018,172.31.47.0-255,66,204796,96,221307
400,0.002047,172.217.194.0-255,4320,209116,96,221307
401,0.002049,172.31.47.0-255,66,209182,96,221307
402,0.002093,172.31.47.0-255,66,209248,96,221307
403,0.002102,172.31.47.0-255,66,209314,96,221307
404,0.002124,172.217.194.0-255,7156,216470,96,221307
405,0.002127,172.31.47.0-255,66,216536,96,221307
406,0.002154,172.31.47.0-255,66,216602,96,221307
407,0.002189,172.31.47.0-255,66,216668,96,221307
408,0.002212,172.217.194.0-255,105,216773,96,221307
409,0.008409,172.31.47.0-255,66,216839,96,221307
410,0.008435,172.31.47.0-255,105,216944,96,221307
411,0.010916,172.217.194.0-255,66,217010,96,221307
412,0.026537,172.31.47.0-255,172,217182,96,221307
413,0.026566,172.31.47.0-255,1109,218291,96,221307
414,0.0266,172.31.47.0-255,1514,219805,96,221307
415,0.026602,172.31.47.0-255,1304,221109,96,221307
416,0.028057,104.244.42.0-255,66,221175,96,221307
417,0.028103,104.244.42.0-255,66,221241,96,221307
418,0.028148,104.244.42.0-255,66,221307,96,221307
419,0.0,172.217.194.0-255,153,153,96,291872
420,1.4e-05,172.31.47.0-255,66,219,96,291872
421,2.1e-05,172.217.194.0-255,1484,1703,96,291872
422,2.5e-05,172.31.47.0-255,66,1769,96,291872
423,3e-05,172.217.194.0-255,2902,4671,96,291872
424,3.3e-05,172.31.47.0-255,66,4737,96,291872
425,4.7e-05,172.217.194.0-255,7156,11893,96,291872
426,5e-05,172.31.47.0-255,66,11959,96,291872
427,7.8e-05,172.217.194.0-255,1981,13940,96,291872
428,8e-05,172.31.47.0-255,66,14006,96,291872
429,0.000104,172.217.194.0-255,2902,16908,96,291872
430,0.000107,172.31.47.0-255,66,16974,96,291872
431,0.000113,172.217.194.0-255,7156,24130,96,291872
432,0.000115,172.31.47.0-255,66,24196,96,291872
433,0.000167,172.217.194.0-255,6797,30993,96,291872
434,0.000169,172.31.47.0-255,66,31059,96,291872
435,0.000214,172.217.194.0-255,4320,35379,96,291872
436,0.000216,172.31.47.0-255,66,35445,96,291872
437,0.000226,172.217.194.0-255,1484,36929,96,291872
438,0.000228,172.31.47.0-255,66,36995,96,291872
439,0.000239,172.217.194.0-255,7156,44151,96,291872
440,0.000242,172.31.47.0-255,66,44217,96,291872
441,0.000272,172.217.194.0-255,5738,49955,96,291872
442,0.000274,172.31.47.0-255,66,50021,96,291872
443,0.000305,172.31.47.0-255,66,50087,96,291872
444,0.000315,172.217.194.0-255,1484,51571,96,291872
445,0.000317,172.31.47.0-255,66,51637,96,291872
446,0.000334,172.217.194.0-255,3961,55598,96,291872
447,0.000337,172.31.47.0-255,66,55664,96,291872
448,0.000339,172.217.194.0-255,367,56031,96,291872
449,0.000341,172.31.47.0-255,66,56097,96,291872
450,0.000385,172.217.194.0-255,376,56473,96,291872
451,0.000631,172.217.194.0-255,1484,57957,96,291872
452,0.000635,172.217.194.0-255,2902,60859,96,291872
453,0.00064,172.31.47.0-255,66,60925,96,291872
454,0.000648,172.31.47.0-255,66,60991,96,291872
455,0.000654,172.217.194.0-255,5738,66729,96,291872
456,0.000656,172.31.47.0-255,66,66795,96,291872
457,0.000703,172.31.47.0-255,66,66861,96,291872
458,0.000736,172.31.47.0-255,66,66927,96,291872
459,0.000855,172.217.194.0-255,1484,68411,96,291872
460,0.000869,172.217.194.0-255,2902,71313,96,291872
461,0.000872,172.31.47.0-255,66,71379,96,291872
462,0.000876,172.217.194.0-255,2902,74281,96,291872
463,0.000877,172.31.47.0-255,66,74347,96,291872
464,0.000901,172.217.194.0-255,2902,77249,96,291872
465,0.000903,172.31.47.0-255,66,77315,96,291872
466,0.000918,172.31.47.0-255,66,77381,96,291872
467,0.000923,172.217.194.0-255,4320,81701,96,291872
468,0.000925,172.31.47.0-255,66,81767,96,291872
469,0.000948,172.217.194.0-255,6438,88205,96,291872
470,0.000951,172.31.47.0-255,66,88271,96,291872
471,0.001677,172.217.194.0-255,1484,89755,96,291872
472,0.001685,172.217.194.0-255,2902,92657,96,291872
473,0.001689,172.31.47.0-255,66,92723,96,291872
474,0.001718,172.217.194.0-255,5738,98461,96,291872
475,0.001721,172.31.47.0-255,66,98527,96,291872
476,0.001731,172.31.47.0-255,66,98593,96,291872
477,0.001758,172.217.194.0-255,2902,101495,96,291872
478,0.001765,172.31.47.0-255,66,101561,96,291872
479,0.001778,172.31.47.0-255,66,101627,96,291872
480,0.001807,172.217.194.0-255,1484,103111,96,291872
481,0.001812,172.217.194.0-255,2902,106013,96,291872
482,0.001815,172.31.47.0-255,66,106079,96,291872
483,0.00184,172.217.194.0-255,5738,111817,96,291872
484,0.001842,172.31.47.0-255,66,111883,96,291872
485,0.001849,172.217.194.0-255,5738,117621,96,291872
486,0.001851,172.31.47.0-255,66,117687,96,291872
487,0.001858,172.217.194.0-255,5738,123425,96,291872
488,0.00186,172.31.47.0-255,66,123491,96,291872
489,0.001897,172.217.194.0-255,7156,130647,96,291872
490,0.0019,172.31.47.0-255,66,130713,96,291872
491,0.001906,172.217.194.0-255,5020,135733,96,291872
492,0.001909,172.31.47.0-255,66,135799,96,291872
493,0.001971,172.217.194.0-255,1484,137283,96,291872
494,0.001976,172.217.194.0-255,2902,140185,96,291872
495,0.001979,172.31.47.0-255,66,140251,96,291872
496,0.002007,172.217.194.0-255,5738,145989,96,291872
497,0.002009,172.31.47.0-255,66,146055,96,291872
498,0.002017,172.217.194.0-255,7156,153211,96,291872
499,0.00202,172.31.47.0-255,66,153277,96,291872
500,0.002046,172.217.194.0-255,5738,159015,96,291872
501,0.002048,172.31.47.0-255,66,159081,96,291872
502,0.00206,172.31.47.0-255,66,159147,96,291872
503,0.002162,172.217.194.0-255,1484,160631,96,291872
504,0.002168,172.217.194.0-255,2902,163533,96,291872
505,0.002171,172.31.47.0-255,66,163599,96,291872
506,0.002202,172.217.194.0-255,5738,169337,96,291872
507,0.002205,172.31.47.0-255,66,169403,96,291872
508,0.002211,172.217.194.0-255,5738,175141,96,291872
509,0.002214,172.31.47.0-255,66,175207,96,291872
510,0.002263,172.31.47.0-255,66,175273,96,291872
511,0.002303,172.217.194.0-255,4320,179593,96,291872
512,0.002306,172.31.47.0-255,66,179659,96,291872
513,0.002334,172.31.47.0-255,66,179725,96,291872
514,0.002349,172.31.47.0-255,66,179791,96,291872
515,0.002365,172.31.47.0-255,66,179857,96,291872
516,0.002369,172.217.194.0-255,2902,182759,96,291872
517,0.002372,172.31.47.0-255,66,182825,96,291872
518,0.004645,172.217.194.0-255,5738,188563,96,291872
519,0.004653,172.31.47.0-255,66,188629,96,291872
520,0.00695,172.217.194.0-255,2902,191531,96,291872
521,0.006954,172.31.47.0-255,66,191597,96,291872
522,0.006975,172.217.194.0-255,2902,194499,96,291872
523,0.006978,172.31.47.0-255,66,194565,96,291872
524,0.009238,172.217.194.0-255,2902,197467,96,291872
525,0.009243,172.31.47.0-255,66,197533,96,291872
526,0.009273,172.217.194.0-255,2902,200435,96,291872
527,0.009276,172.31.47.0-255,66,200501,96,291872
528,0.01152,172.217.194.0-255,2902,203403,96,291872
529,0.011527,172.31.47.0-255,66,203469,96,291872
530,0.011566,172.217.194.0-255,2902,206371,96,291872
531,0.011568,172.31.47.0-255,66,206437,96,291872
532,0.013818,172.217.194.0-255,2902,209339,96,291872
533,0.013826,172.31.47.0-255,66,209405,96,291872
534,0.013857,172.217.194.0-255,2902,212307,96,291872
535,0.01386,172.31.47.0-255,66,212373,96,291872
536,0.016133,172.217.194.0-255,5738,218111,96,291872
537,0.016143,172.31.47.0-255,66,218177,96,291872
538,0.01849,172.217.194.0-255,5738,223915,96,291872
539,0.0185,172.31.47.0-255,66,223981,96,291872
540,0.020801,172.217.194.0-255,5738,229719,96,291872
541,0.020807,172.31.47.0-255,66,229785,96,291872
542,0.023106,172.217.194.0-255,5738,235523,96,291872
543,0.023112,172.31.47.0-255,66,235589,96,291872
544,0.025436,172.217.194.0-255,5738,241327,96,291872
545,0.025442,172.31.47.0-255,66,241393,96,291872
546,0.027742,172.217.194.0-255,5738,247131,96,291872
547,0.027749,172.31.47.0-255,66,247197,96,291872
548,0.028724,172.31.47.0-255,172,247369,96,291872
549,0.028755,172.31.47.0-255,1109,248478,96,291872
550,0.028812,172.31.47.0-255,1514,249992,96,291872
551,0.028814,172.31.47.0-255,1303,251295,96,291872
552,0.030069,172.217.194.0-255,5738,257033,96,291872
553,0.030075,172.31.47.0-255,66,257099,96,291872
554,0.030209,104.244.42.0-255,66,257165,96,291872
555,0.030239,104.244.42.0-255,66,257231,96,291872
556,0.030312,104.244.42.0-255,66,257297,96,291872
557,0.032382,172.217.194.0-255,5738,263035,96,291872
558,0.032387,172.31.47.0-255,66,263101,96,291872
559,0.034672,172.217.194.0-255,5738,268839,96,291872
560,0.03468,172.31.47.0-255,66,268905,96,291872
561,0.036985,172.217.194.0-255,5738,274643,96,291872
562,0.036992,172.31.47.0-255,66,274709,96,291872
563,0.039294,172.217.194.0-255,5738,280447,96,291872
564,0.039302,172.31.47.0-255,66,280513,96,291872
565,0.0416,172.217.194.0-255,5738,286251,96,291872
566,0.041606,172.31.47.0-255,66,286317,96,291872
567,0.043895,172.217.194.0-255,5318,291635,96,291872
568,0.043902,172.31.47.0-255,66,291701,96,291872
569,0.044086,172.31.47.0-255,105,291806,96,291872
570,0.046346,172.217.194.0-255,66,291872,96,291872
571,0.0,74.125.200.0-255,153,153,96,322979
572,2e-05,172.31.47.0-255,66,219,96,322979
573,2.8e-05,74.125.200.0-255,1484,1703,96,322979
574,3.3e-05,172.31.47.0-255,66,1769,96,322979
575,3.8e-05,74.125.200.0-255,2902,4671,96,322979
576,4.2e-05,172.31.47.0-255,66,4737,96,322979
577,4.6e-05,74.125.200.0-255,2902,7639,96,322979
578,4.9e-05,172.31.47.0-255,66,7705,96,322979
579,7.4e-05,74.125.200.0-255,2902,10607,96,322979
580,7.8e-05,172.31.47.0-255,66,10673,96,322979
581,0.000108,74.125.200.0-255,2902,13575,96,322979
582,0.000111,172.31.47.0-255,66,13641,96,322979
583,0.000129,74.125.200.0-255,2082,15723,96,322979
584,0.000131,172.31.47.0-255,66,15789,96,322979
585,0.000136,74.125.200.0-255,5738,21527,96,322979
586,0.000138,172.31.47.0-255,66,21593,96,322979
587,0.000169,172.31.47.0-255,66,21659,96,322979
588,0.00031,74.125.200.0-255,1484,23143,96,322979
589,0.000314,172.31.47.0-255,66,23209,96,322979
590,0.000318,74.125.200.0-255,2902,26111,96,322979
591,0.00032,172.31.47.0-255,66,26177,96,322979
592,0.000335,74.125.200.0-255,1484,27661,96,322979
593,0.000337,172.31.47.0-255,66,27727,96,322979
594,0.000361,74.125.200.0-255,4320,32047,96,322979
595,0.000364,172.31.47.0-255,66,32113,96,322979
596,0.00037,74.125.200.0-255,4320,36433,96,322979
597,0.000371,172.31.47.0-255,66,36499,96,322979
598,0.000383,74.125.200.0-255,2543,39042,96,322979
599,0.000385,172.31.47.0-255,66,39108,96,322979
600,0.000391,74.125.200.0-255,7156,46264,96,322979
601,0.000393,172.31.47.0-255,66,46330,96,322979
602,0.000417,74.125.200.0-255,2902,49232,96,322979
603,0.000419,172.31.47.0-255,66,49298,96,322979
604,0.000437,74.125.200.0-255,4320,53618,96,322979
605,0.00044,172.31.47.0-255,66,53684,96,322979
606,0.000456,74.125.200.0-255,2817,56501,96,322979
607,0.000459,172.31.47.0-255,66,56567,96,322979
608,0.000494,74.125.200.0-255,129,56696,96,322979
609,0.00061,74.125.200.0-255,1484,58180,96,322979
610,0.000614,172.31.47.0-255,66,58246,96,322979
611,0.00062,74.125.200.0-255,2902,61148,96,322979
612,0.000622,172.31.47.0-255,66,61214,96,322979
613,0.000625,74.125.200.0-255,1484,62698,96,322979
614,0.000628,74.125.200.0-255,2902,65600,96,322979
615,0.00063,172.31.47.0-255,66,65666,96,322979
616,0.000643,74.125.200.0-255,2902,68568,96,322979
617,0.000646,172.31.47.0-255,66,68634,96,322979
618,0.000661,74.125.200.0-255,2902,71536,96,322979
619,0.000663,172.31.47.0-255,66,71602,96,322979
620,0.000668,74.125.200.0-255,5738,77340,96,322979
621,0.00067,172.31.47.0-255,66,77406,96,322979
622,0.000672,74.125.200.0-255,1484,78890,96,322979
623,0.000697,74.125.200.0-255,5738,84628,96,322979
624,0.000701,172.31.47.0-255,66,84694,96,322979
625,0.00071,74.125.200.0-255,2902,87596,96,322979
626,0.000712,172.31.47.0-255,66,87662,96,322979
627,0.000728,74.125.200.0-255,3884,91546,96,322979
628,0.00073,172.31.47.0-255,66,91612,96,322979
629,0.000958,74.125.200.0-255,1484,93096,96,322979
630,0.000996,74.125.200.0-255,2902,95998,96,322979
631,0.001001,172.31.47.0-255,66,96064,96,322979
632,0.001025,74.125.200.0-255,4320,100384,96,322979
633,0.00103,74.125.200.0-255,4320,104704,96,322979
634,0.001034,172.31.47.0-255,66,104770,96,322979
635,0.001037,172.31.47.0-255,66,104836,96,322979
636,0.001051,74.125.200.0-255,1484,106320,96,322979
637,0.001067,74.125.200.0-255,1484,107804,96,322979
638,0.00107,172.31.47.0-255,66,107870,96,322979
639,0.001101,172.31.47.0-255,66,107936,96,322979
640,0.001107,74.125.200.0-255,7156,115092,96,322979
641,0.00111,172.31.47.0-255,66,115158,96,322979
642,0.001112,74.125.200.0-255,218,115376,96,322979
643,0.001203,74.125.200.0-255,1484,116860,96,322979
644,0.001207,172.31.47.0-255,66,116926,96,322979
645,0.001226,74.125.200.0-255,2902,119828,96,322979
646,0.001229,172.31.47.0-255,66,119894,96,322979
647,0.001246,74.125.200.0-255,1484,121378,96,322979
648,0.001259,74.125.200.0-255,2902,124280,96,322979
649,0.001262,172.31.47.0-255,66,124346,96,322979
650,0.001265,74.125.200.0-255,1484,125830,96,322979
651,0.001287,74.125.200.0-255,2902,128732,96,322979
652,0.00129,172.31.47.0-255,66,128798,96,322979
653,0.001361,74.125.200.0-255,4320,133118,96,322979
654,0.001365,74.125.200.0-255,2902,136020,96,322979
655,0.00137,172.31.47.0-255,66,136086,96,322979
656,0.001373,172.31.47.0-255,66,136152,96,322979
657,0.001391,74.125.200.0-255,2902,139054,96,322979
658,0.001393,172.31.47.0-255,66,139120,96,322979
659,0.001402,172.31.47.0-255,66,139186,96,322979
660,0.001405,74.125.200.0-255,766,139952,96,322979
661,0.001505,74.125.200.0-255,1484,141436,96,322979
662,0.001508,172.31.47.0-255,66,141502,96,322979
663,0.00153,74.125.200.0-255,2902,144404,96,322979
664,0.001533,172.31.47.0-255,66,144470,96,322979
665,0.001537,74.125.200.0-255,4320,148790,96,322979
666,0.001539,172.31.47.0-255,66,148856,96,322979
667,0.001575,74.125.200.0-255,4320,153176,96,322979
668,0.001577,172.31.47.0-255,66,153242,96,322979
669,0.001595,74.125.200.0-255,1484,154726,96,322979
670,0.001604,172.31.47.0-255,66,154792,96,322979
671,0.001625,74.125.200.0-255,2902,157694,96,322979
672,0.001627,172.31.47.0-255,66,157760,96,322979
673,0.001632,74.125.200.0-255,5738,163498,96,322979
674,0.001634,172.31.47.0-255,66,163564,96,322979
675,0.001671,172.31.47.0-255,66,163630,96,322979
676,0.001731,172.31.47.0-255,66,163696,96,322979
677,0.001777,74.125.200.0-255,1484,165180,96,322979
678,0.001801,172.31.47.0-255,66,165246,96,322979
679,0.001821,74.125.200.0-255,1484,166730,96,322979
680,0.001835,172.31.47.0-255,66,166796,96,322979
681,0.001844,172.31.47.0-255,66,166862,96,322979
682,0.001847,74.125.200.0-255,2184,169046,96,322979
683,0.001849,172.31.47.0-255,66,169112,96,322979
684,0.001994,74.125.200.0-255,1484,170596,96,322979
685,0.001999,74.125.200.0-255,2902,173498,96,322979
686,0.002001,172.31.47.0-255,66,173564,96,322979
687,0.002006,74.125.200.0-255,4320,177884,96,322979
688,0.002007,172.31.47.0-255,66,177950,96,322979
689,0.002023,74.125.200.0-255,7156,185106,96,322979
690,0.002025,172.31.47.0-255,66,185172,96,322979
691,0.004024,74.125.200.0-255,2902,188074,96,322979
692,0.00403,172.31.47.0-255,66,188140,96,322979
693,0.004047,74.125.200.0-255,2902,191042,96,322979
694,0.004049,172.31.47.0-255,66,191108,96,322979
695,0.006027,74.125.200.0-255,2902,194010,96,322979
696,0.006033,172.31.47.0-255,66,194076,96,322979
697,0.006052,74.125.200.0-255,2902,196978,96,322979
698,0.006054,172.31.47.0-255,66,197044,96,322979
699,0.008039,74.125.200.0-255,5738,202782,96,322979
700,0.00805,172.31.47.0-255,66,202848,96,322979
701,0.010053,74.125.200.0-255,5738,208586,96,322979
702,0.010061,172.31.47.0-255,66,208652,96,322979
703,0.012076,74.125.200.0-255,5738,214390,96,322979
704,0.012085,172.31.47.0-255,66,214456,96,322979
705,0.014093,74.125.200.0-255,5738,220194,96,322979
706,0.014099,172.31.47.0-255,66,220260,96,322979
707,0.016107,74.125.200.0-255,5738,225998,96,322979
708,0.016115,172.31.47.0-255,66,226064,96,322979
709,0.018123,74.125.200.0-255,5738,231802,96,322979
710,0.018129,172.31.47.0-255,66,231868,96,322979
711,0.020132,74.125.200.0-255,5738,237606,96,322979
712,0.020137,172.31.47.0-255,66,237672,96,322979
713,0.022136,74.125.200.0-255,5738,243410,96,322979
714,0.022147,172.31.47.0-255,66,243476,96,322979
715,0.024067,172.31.47.0-255,175,243651,96,322979
716,0.024119,172.31.47.0-255,1134,244785,96,322979
717,0.024148,74.125.200.0-255,5738,250523,96,322979
718,0.024154,172.31.47.0-255,66,250589,96,322979
719,0.024232,172.31.47.0-255,1514,252103,96,322979
720,0.024234,172.31.47.0-255,1277,253380,96,322979
721,0.025648,104.244.42.0-255,66,253446,96,322979
722,0.025688,104.244.42.0-255,66,253512,96,322979
723,0.025789,104.244.42.0-255,66,253578,96,322979
724,0.026173,74.125.200.0-255,5738,259316,96,322979
725,0.026179,172.31.47.0-255,66,259382,96,322979
726,0.028189,74.125.200.0-255,5738,265120,96,322979
727,0.028195,172.31.47.0-255,66,265186,96,322979
728,0.030189,74.125.200.0-255,5738,270924,96,322979
729,0.030194,172.31.47.0-255,66,270990,96,322979
730,0.032201,74.125.200.0-255,5738,276728,96,322979
731,0.032205,172.31.47.0-255,66,276794,96,322979
732,0.034205,74.125.200.0-255,5738,282532,96,322979
733,0.03421,172.31.47.0-255,66,282598,96,322979
734,0.036203,74.125.200.0-255,1484,284082,96,322979
735,0.036225,74.125.200.0-255,4320,288402,96,322979
736,0.03623,172.31.47.0-255,66,288468,96,322979
737,0.038232,74.125.200.0-255,5738,294206,96,322979
738,0.038246,172.31.47.0-255,66,294272,96,322979
739,0.04025,74.125.200.0-255,5738,300010,96,322979
740,0.040257,172.31.47.0-255,66,300076,96,322979
741,0.042298,74.125.200.0-255,5738,305814,96,322979
742,0.042303,172.31.47.0-255,66,305880,96,322979
743,0.04429,74.125.200.0-255,2902,308782,96,322979
744,0.044295,172.31.47.0-255,66,308848,96,322979
745,0.044323,74.125.200.0-255,2902,311750,96,322979
746,0.044326,172.31.47.0-255,66,311816,96,322979
747,0.046279,74.125.200.0-255,2902,314718,96,322979
748,0.046285,172.31.47.0-255,66,314784,96,322979
749,0.046313,74.125.200.0-255,2902,317686,96,322979
750,0.046316,172.31.47.0-255,66,317752,96,322979
751,0.048287,74.125.200.0-255,2902,320654,96,322979
752,0.048294,172.31.47.0-255,66,320720,96,322979
753,0.048315,74.125.200.0-255,2022,322742,96,322979
754,0.048317,172.31.47.0-255,66,322808,96,322979
755,0.049081,172.31.47.0-255,105,322913,96,322979
756,0.051052,74.125.200.0-255,66,322979,96,322979
757,0.0,74.125.24.0-255,153,153,96,336537
758,1.3e-05,172.31.47.0-255,66,219,96,336537
759,1.9e-05,74.125.24.0-255,1484,1703,96,336537
760,2.3e-05,172.31.47.0-255,66,1769,96,336537
761,2.8e-05,74.125.24.0-255,2902,4671,96,336537
762,3.1e-05,172.31.47.0-255,66,4737,96,336537
763,6.2e-05,74.125.24.0-255,7156,11893,96,336537
764,6.5e-05,172.31.47.0-255,66,11959,96,336537
765,6.8e-05,74.125.24.0-255,2084,14043,96,336537
766,7e-05,172.31.47.0-255,66,14109,96,336537
767,7.4e-05,74.125.24.0-255,2902,17011,96,336537
768,7.6e-05,172.31.47.0-255,66,17077,96,336537
769,9.9e-05,74.125.24.0-255,7156,24233,96,336537
770,0.000101,172.31.47.0-255,66,24299,96,336537
771,0.000104,74.125.24.0-255,1484,25783,96,336537
772,0.000105,172.31.47.0-255,66,25849,96,336537
773,0.000124,74.125.24.0-255,5379,31228,96,336537
774,0.000126,172.31.47.0-255,66,31294,96,336537
775,0.000274,74.125.24.0-255,1484,32778,96,336537
776,0.000278,172.31.47.0-255,66,32844,96,336537
777,0.000283,74.125.24.0-255,2902,35746,96,336537
778,0.000285,172.31.47.0-255,66,35812,96,336537
779,0.00031,74.125.24.0-255,5738,41550,96,336537
780,0.000313,172.31.47.0-255,66,41616,96,336537
781,0.000317,74.125.24.0-255,2902,44518,96,336537
782,0.000319,172.31.47.0-255,66,44584,96,336537
783,0.00036,74.125.24.0-255,2902,47486,96,336537
784,0.000363,172.31.47.0-255,66,47552,96,336537
785,0.00039,172.31.47.0-255,66,47618,96,336537
786,0.000395,74.125.24.0-255,5738,53356,96,336537
787,0.000397,172.31.47.0-255,66,53422,96,336537
788,0.000427,74.125.24.0-255,4235,57657,96,336537
789,0.00043,172.31.47.0-255,66,57723,96,336537
790,0.000498,74.125.24.0-255,381,58104,96,336537
791,0.000655,74.125.24.0-255,1484,59588,96,336537
792,0.000658,172.31.47.0-255,66,59654,96,336537
793,0.000663,74.125.24.0-255,2902,62556,96,336537
794,0.000665,172.31.47.0-255,66,62622,96,336537
795,0.000695,74.125.24.0-255,5738,68360,96,336537
796,0.000697,172.31.47.0-255,66,68426,96,336537
797,0.000733,74.125.24.0-255,5738,74164,96,336537
798,0.000735,172.31.47.0-255,66,74230,96,336537
799,0.000761,172.31.47.0-255,66,74296,96,336537
800,0.000779,74.125.24.0-255,1484,75780,96,336537
801,0.000802,172.31.47.0-255,66,75846,96,336537
802,0.000915,74.125.24.0-255,1484,77330,96,336537
803,0.00094,74.125.24.0-255,2902,80232,96,336537
804,0.000943,172.31.47.0-255,66,80298,96,336537
805,0.000947,74.125.24.0-255,2902,83200,96,336537
806,0.000949,172.31.47.0-255,66,83266,96,336537
807,0.000961,74.125.24.0-255,2902,86168,96,336537
808,0.000963,172.31.47.0-255,66,86234,96,336537
809,0.000975,74.125.24.0-255,1484,87718,96,336537
810,0.001,172.31.47.0-255,66,87784,96,336537
811,0.001005,74.125.24.0-255,4320,92104,96,336537
812,0.001007,172.31.47.0-255,66,92170,96,336537
813,0.001017,74.125.24.0-255,1484,93654,96,336537
814,0.001042,74.125.24.0-255,1484,95138,96,336537
815,0.001044,172.31.47.0-255,66,95204,96,336537
816,0.001063,74.125.24.0-255,3602,98806,96,336537
817,0.001065,172.31.47.0-255,66,98872,96,336537
818,0.001081,74.125.24.0-255,1484,100356,96,336537
819,0.001104,74.125.24.0-255,4320,104676,96,336537
820,0.001107,172.31.47.0-255,66,104742,96,336537
821,0.001114,74.125.24.0-255,7156,111898,96,336537
822,0.001116,172.31.47.0-255,66,111964,96,336537
823,0.001119,74.125.24.0-255,1484,113448,96,336537
824,0.001134,74.125.24.0-255,7156,120604,96,336537
825,0.001137,172.31.47.0-255,66,120670,96,336537
826,0.001157,74.125.24.0-255,5738,126408,96,336537
827,0.00116,172.31.47.0-255,66,126474,96,336537
828,0.001166,74.125.24.0-255,6438,132912,96,336537
829,0.001168,172.31.47.0-255,66,132978,96,336537
830,0.001266,74.125.24.0-255,1484,134462,96,336537
831,0.00127,74.125.24.0-255,1484,135946,96,336537
832,0.001273,172.31.47.0-255,66,136012,96,336537
833,0.001289,74.125.24.0-255,1484,137496,96,336537
834,0.001296,74.125.24.0-255,5738,143234,96,336537
835,0.001298,172.31.47.0-255,66,143300,96,336537
836,0.001303,74.125.24.0-255,2902,146202,96,336537
837,0.001304,172.31.47.0-255,66,146268,96,336537
838,0.001361,172.31.47.0-255,66,146334,96,336537
839,0.001373,172.31.47.0-255,66,146400,96,336537
840,0.001908,74.125.24.0-255,1484,147884,96,336537
841,0.001914,74.125.24.0-255,2902,150786,96,336537
842,0.001918,172.31.47.0-255,66,150852,96,336537
843,0.00194,74.125.24.0-255,5738,156590,96,336537
844,0.001942,172.31.47.0-255,66,156656,96,336537
845,0.001966,74.125.24.0-255,7156,163812,96,336537
846,0.001969,172.31.47.0-255,66,163878,96,336537
847,0.001992,74.125.24.0-255,5738,169616,96,336537
848,0.001994,172.31.47.0-255,66,169682,96,336537
849,0.002006,172.31.47.0-255,66,169748,96,336537
850,0.002009,74.125.24.0-255,766,170514,96,336537
851,0.002102,74.125.24.0-255,1484,171998,96,336537
852,0.002106,172.31.47.0-255,66,172064,96,336537
853,0.00211,74.125.24.0-255,1484,173548,96,336537
854,0.002124,74.125.24.0-255,1484,175032,96,336537
855,0.002131,74.125.24.0-255,5738,180770,96,336537
856,0.002134,172.31.47.0-255,66,180836,96,336537
857,0.002136,172.31.47.0-255,66,180902,96,336537
858,0.002168,172.31.47.0-255,66,180968,96,336537
859,0.002189,74.125.24.0-255,2902,183870,96,336537
860,0.002192,172.31.47.0-255,66,183936,96,336537
861,0.002222,172.31.47.0-255,66,184002,96,336537
862,0.004697,74.125.24.0-255,5738,189740,96,336537
863,0.004704,172.31.47.0-255,66,189806,96,336537
864,0.007185,74.125.24.0-255,5738,195544,96,336537
865,0.007193,172.31.47.0-255,66,195610,96,336537
866,0.009667,74.125.24.0-255,5738,201348,96,336537
867,0.009674,172.31.47.0-255,66,201414,96,336537
868,0.012139,74.125.24.0-255,5738,207152,96,336537
869,0.012148,172.31.47.0-255,66,207218,96,336537
870,0.014628,74.125.24.0-255,5738,212956,96,336537
871,0.014637,172.31.47.0-255,66,213022,96,336537
872,0.017137,74.125.24.0-255,5738,218760,96,336537
873,0.017148,172.31.47.0-255,66,218826,96,336537
874,0.01962,74.125.24.0-255,5738,224564,96,336537
875,0.019628,172.31.47.0-255,66,224630,96,336537
876,0.022078,74.125.24.0-255,5738,230368,96,336537
877,0.022085,172.31.47.0-255,66,230434,96,336537
878,0.024551,74.125.24.0-255,5738,236172,96,336537
879,0.024559,172.31.47.0-255,66,236238,96,336537
880,0.027041,74.125.24.0-255,5738,241976,96,336537
881,0.027055,172.31.47.0-255,66,242042,96,336537
882,0.029552,74.125.24.0-255,5738,247780,96,336537
883,0.029559,172.31.47.0-255,66,247846,96,336537
884,0.030815,172.31.47.0-255,172,248018,96,336537
885,0.030843,172.31.47.0-255,1110,249128,96,336537
886,0.03089,172.31.47.0-255,1514,250642,96,336537
887,0.030892,172.31.47.0-255,1302,251944,96,336537
888,0.032016,74.125.24.0-255,5738,257682,96,336537
889,0.032022,172.31.47.0-255,66,257748,96,336537
890,0.032369,104.244.42.0-255,66,257814,96,336537
891,0.032429,104.244.42.0-255,66,257880,96,336537
892,0.032491,104.244.42.0-255,66,257946,96,336537
893,0.03452,74.125.24.0-255,5738,263684,96,336537
894,0.034525,172.31.47.0-255,66,263750,96,336537
895,0.037011,74.125.24.0-255,5738,269488,96,336537
896,0.037018,172.31.47.0-255,66,269554,96,336537
897,0.039492,74.125.24.0-255,5738,275292,96,336537
898,0.039499,172.31.47.0-255,66,275358,96,336537
899,0.041995,74.125.24.0-255,5738,281096,96,336537
900,0.042001,172.31.47.0-255,66,281162,96,336537
901,0.044471,74.125.24.0-255,5738,286900,96,336537
902,0.044476,172.31.47.0-255,66,286966,96,336537
903,0.046976,74.125.24.0-255,5738,292704,96,336537
904,0.046983,172.31.47.0-255,66,292770,96,336537
905,0.049469,74.125.24.0-255,5738,298508,96,336537
906,0.049474,172.31.47.0-255,66,298574,96,336537
907,0.051942,74.125.24.0-255,5738,304312,96,336537
908,0.051948,172.31.47.0-255,66,304378,96,336537
909,0.054419,74.125.24.0-255,5738,310116,96,336537
910,0.054425,172.31.47.0-255,66,310182,96,336537
911,0.056943,74.125.24.0-255,5738,315920,96,336537
912,0.056949,172.31.47.0-255,66,315986,96,336537
913,0.059415,74.125.24.0-255,5738,321724,96,336537
914,0.05942,172.31.47.0-255,66,321790,96,336537
915,0.061901,74.125.24.0-255,5738,327528,96,336537
916,0.061909,172.31.47.0-255,66,327594,96,336537
917,0.064386,74.125.24.0-255,5738,333332,96,336537
918,0.064391,172.31.47.0-255,66,333398,96,336537
919,0.066877,74.125.24.0-255,2902,336300,96,336537
920,0.066884,172.31.47.0-255,66,336366,96,336537
921,0.067052,172.31.47.0-255,105,336471,96,336537
922,0.069495,74.125.24.0-255,66,336537,96,336537
923,0.0,172.31.47.0-255,105,105,96,105
924,0.0,172.217.194.0-255,153,153,96,268546
925,2.6e-05,172.31.47.0-255,66,219,96,268546
926,3.2e-05,172.217.194.0-255,1484,1703,96,268546
927,3.6e-05,172.31.47.0-255,66,1769,96,268546
928,4e-05,172.217.194.0-255,2902,4671,96,268546
929,4.2e-05,172.31.47.0-255,66,4737,96,268546
930,4.8e-05,172.217.194.0-255,7156,11893,96,268546
931,5.1e-05,172.31.47.0-255,66,11959,96,268546
932,7.3e-05,172.217.194.0-255,4320,16279,96,268546
933,7.5e-05,172.31.47.0-255,66,16345,96,268546
934,9.7e-05,172.217.194.0-255,2201,18546,96,268546
935,0.0001,172.31.47.0-255,66,18612,96,268546
936,0.000105,172.217.194.0-255,7156,25768,96,268546
937,0.000107,172.31.47.0-255,66,25834,96,268546
938,0.000112,172.217.194.0-255,5379,31213,96,268546
939,0.000115,172.31.47.0-255,66,31279,96,268546
940,0.000201,172.217.194.0-255,1484,32763,96,268546
941,0.000204,172.31.47.0-255,66,32829,96,268546
942,0.000209,172.217.194.0-255,2902,35731,96,268546
943,0.000211,172.31.47.0-255,66,35797,96,268546
944,0.000216,172.217.194.0-255,4320,40117,96,268546
945,0.000219,172.31.47.0-255,66,40183,96,268546
946,0.000239,172.217.194.0-255,1484,41667,96,268546
947,0.000241,172.31.47.0-255,66,41733,96,268546
948,0.000273,172.31.47.0-255,66,41799,96,268546
949,0.000303,172.31.47.0-255,66,41865,96,268546
950,0.000322,172.217.194.0-255,766,42631,96,268546
951,0.000324,172.31.47.0-255,66,42697,96,268546
952,0.000327,172.217.194.0-255,394,43091,96,268546
953,0.000328,172.31.47.0-255,66,43157,96,268546
954,0.000365,172.217.194.0-255,1484,44641,96,268546
955,0.000388,172.217.194.0-255,2902,47543,96,268546
956,0.000391,172.31.47.0-255,66,47609,96,268546
957,0.000396,172.217.194.0-255,4320,51929,96,268546
958,0.000399,172.31.47.0-255,66,51995,96,268546
959,0.00041,172.217.194.0-255,1484,53479,96,268546
960,0.000424,172.217.194.0-255,7090,60569,96,268546
961,0.000427,172.31.47.0-255,66,60635,96,268546
962,0.00047,172.217.194.0-255,7156,67791,96,268546
963,0.000474,172.31.47.0-255,66,67857,96,268546
964,0.000486,172.31.47.0-255,66,67923,96,268546
965,0.001099,172.217.194.0-255,1484,69407,96,268546
966,0.001121,172.217.194.0-255,2902,72309,96,268546
967,0.001125,172.31.47.0-255,66,72375,96,268546
968,0.001132,172.217.194.0-255,5738,78113,96,268546
969,0.001134,172.31.47.0-255,66,78179,96,268546
970,0.00114,172.217.194.0-255,5738,83917,96,268546
971,0.001142,172.31.47.0-255,66,83983,96,268546
972,0.001146,172.217.194.0-255,2902,86885,96,268546
973,0.001148,172.31.47.0-255,66,86951,96,268546
974,0.001176,172.31.47.0-255,66,87017,96,268546
975,0.00118,172.217.194.0-255,1484,88501,96,268546
976,0.001202,172.217.194.0-255,3602,92103,96,268546
977,0.001205,172.31.47.0-255,66,92169,96,268546
978,0.001252,172.217.194.0-255,1484,93653,96,268546
979,0.001273,172.217.194.0-255,2902,96555,96,268546
980,0.001276,172.31.47.0-255,66,96621,96,268546
981,0.00128,172.217.194.0-255,4320,100941,96,268546
982,0.001282,172.31.47.0-255,66,101007,96,268546
983,0.001308,172.31.47.0-255,66,101073,96,268546
984,0.001329,172.217.194.0-255,2902,103975,96,268546
985,0.001331,172.31.47.0-255,66,104041,96,268546
986,0.001348,172.217.194.0-255,7156,111197,96,268546
987,0.00135,172.31.47.0-255,66,111263,96,268546
988,0.001361,172.217.194.0-255,2902,114165,96,268546
989,0.001363,172.31.47.0-255,66,114231,96,268546
990,0.001409,172.31.47.0-255,66,114297,96,268546
991,0.001417,172.31.47.0-255,66,114363,96,268546
992,0.001421,172.217.194.0-255,1484,115847,96,268546
993,0.001464,172.31.47.0-255,66,115913,96,268546
994,0.001468,172.217.194.0-255,2184,118097,96,268546
995,0.001469,172.31.47.0-255,66,118163,96,268546
996,0.001518,172.217.194.0-255,1484,119647,96,268546
997,0.001523,172.217.194.0-255,2902,122549,96,268546
998,0.001525,172.31.47.0-255,66,122615,96,268546
999,0.001546,172.217.194.0-255,5738,128353,96,268546
1000,0.001549,172.31.47.0-255,66,128419,96,268546
1001,0.001569,172.217.194.0-255,5738,134157,96,268546
1002,0.001571,172.31.47.0-255,66,134223,96,268546
1003,0.001591,172.217.194.0-255,7156,141379,96,268546
1004,0.001593,172.31.47.0-255,66,141445,96,268546
1005,0.001599,172.217.194.0-255,5738,147183,96,268546
1006,0.0016,172.31.47.0-255,66,147249,96,268546
1007,0.001616,172.217.194.0-255,5020,152269,96,268546
1008,0.001618,172.31.47.0-255,66,152335,96,268546
1009,0.001681,172.217.194.0-255,1484,153819,96,268546
1010,0.001696,172.217.194.0-255,2902,156721,96,268546
1011,0.001699,172.31.47.0-255,66,156787,96,268546
1012,0.001701,172.217.194.0-255,1484,158271,96,268546
1013,0.001717,172.217.194.0-255,4320,162591,96,268546
1014,0.001719,172.31.47.0-255,66,162657,96,268546
1015,0.001784,172.31.47.0-255,66,162723,96,268546
1016,0.001794,172.31.47.0-255,66,162789,96,268546
1017,0.001956,172.217.194.0-255,1484,164273,96,268546
1018,0.001961,172.217.194.0-255,2902,167175,96,268546
1019,0.001964,172.31.47.0-255,66,167241,96,268546
1020,0.001984,172.217.194.0-255,5738,172979,96,268546
1021,0.001987,172.31.47.0-255,66,173045,96,268546
1022,0.002004,172.217.194.0-255,2902,175947,96,268546
1023,0.002006,172.31.47.0-255,66,176013,96,268546
1024,0.002027,172.217.194.0-255,7156,183169,96,268546
1025,0.00203,172.31.47.0-255,66,183235,96,268546
1026,0.002046,172.217.194.0-255,1484,184719,96,268546
1027,0.002081,172.31.47.0-255,66,184785,96,268546
1028,0.002105,172.217.194.0-255,1484,186269,96,268546
1029,0.002109,172.217.194.0-255,2902,189171,96,268546
1030,0.002111,172.31.47.0-255,66,189237,96,268546
1031,0.002132,172.217.194.0-255,5738,194975,96,268546
1032,0.002135,172.31.47.0-255,66,195041,96,268546
1033,0.002148,172.217.194.0-255,1484,196525,96,268546
1034,0.002177,172.31.47.0-255,66,196591,96,268546
1035,0.002203,172.217.194.0-255,7156,203747,96,268546
1036,0.002206,172.31.47.0-255,66,203813,96,268546
1037,0.002224,172.217.194.0-255,3602,207415,96,268546
1038,0.002226,172.31.47.0-255,66,207481,96,268546
1039,0.00224,172.217.194.0-255,1484,208965,96,268546
1040,0.002263,172.31.47.0-255,66,209031,96,268546
1041,0.002267,172.217.194.0-255,4320,213351,96,268546
1042,0.00227,172.31.47.0-255,66,213417,96,268546
1043,0.002296,172.217.194.0-255,4320,217737,96,268546
1044,0.002298,172.31.47.0-255,66,217803,96,268546
1045,0.00232,172.31.47.0-255,66,217869,96,268546
1046,0.002337,172.217.194.0-255,1484,219353,96,268546
1047,0.002339,172.217.194.0-255,766,220119,96,268546
1048,0.00234,172.31.47.0-255,66,220185,96,268546
1049,0.004589,172.217.194.0-255,2902,223087,96,268546
1050,0.004592,172.31.47.0-255,66,223153,96,268546
1051,0.004612,172.217.194.0-255,2902,226055,96,268546
1052,0.004614,172.31.47.0-255,66,226121,96,268546
1053,0.006879,172.217.194.0-255,5738,231859,96,268546
1054,0.006884,172.31.47.0-255,66,231925,96,268546
1055,0.009145,172.217.194.0-255,5738,237663,96,268546
1056,0.00915,172.31.47.0-255,66,237729,96,268546
1057,0.011441,172.217.194.0-255,5738,243467,96,268546
1058,0.011448,172.31.47.0-255,66,243533,96,268546
1059,0.013748,172.217.194.0-255,5738,249271,96,268546
1060,0.013758,172.31.47.0-255,66,249337,96,268546
1061,0.016028,172.217.194.0-255,5738,255075,96,268546
1062,0.016036,172.31.47.0-255,66,255141,96,268546
1063,0.018336,172.217.194.0-255,5738,260879,96,268546
1064,0.018343,172.31.47.0-255,66,260945,96,268546
1065,0.020632,172.217.194.0-255,3069,264014,96,268546
1066,0.020637,172.31.47.0-255,66,264080,96,268546
1067,0.020787,172.31.47.0-255,105,264185,96,268546
1068,0.023016,172.217.194.0-255,66,264251,96,268546
1069,0.028338,172.31.47.0-255,172,264423,96,268546
1070,0.028369,172.31.47.0-255,1109,265532,96,268546
1071,0.0284,172.31.47.0-255,1514,267046,96,268546
1072,0.028401,172.31.47.0-255,1302,268348,96,268546
1073,0.029875,104.244.42.0-255,66,268414,96,268546
1074,0.030006,104.244.42.0-255,66,268480,96,268546
1075,0.030009,104.244.42.0-255,66,268546,96,268546
1076,0.0,172.253.118.0-255,153,153,96,93159
1077,3.1e-05,172.31.47.0-255,66,219,96,93159
1078,3.8e-05,172.253.118.0-255,1484,1703,96,93159
1079,4.1e-05,172.31.47.0-255,66,1769,96,93159
1080,4.5e-05,172.253.118.0-255,2902,4671,96,93159
1081,5.4e-05,172.31.47.0-255,66,4737,96,93159
1082,0.000108,172.253.118.0-255,5738,10475,96,93159
1083,0.000111,172.31.47.0-255,66,10541,96,93159
1084,0.000133,172.253.118.0-255,1484,12025,96,93159
1085,0.000135,172.31.47.0-255,66,12091,96,93159
1086,0.000286,172.253.118.0-255,2090,14181,96,93159
1087,0.00029,172.31.47.0-255,66,14247,96,93159
1088,0.000349,172.253.118.0-255,7156,21403,96,93159
1089,0.000354,172.31.47.0-255,66,21469,96,93159
1090,0.00038,172.253.118.0-255,4320,25789,96,93159
1091,0.000383,172.31.47.0-255,66,25855,96,93159
1092,0.000644,172.253.118.0-255,5379,31234,96,93159
1093,0.000649,172.31.47.0-255,66,31300,96,93159
1094,0.000783,172.253.118.0-255,4320,35620,96,93159
1095,0.000787,172.31.47.0-255,66,35686,96,93159
1096,0.000839,172.31.47.0-255,66,35752,96,93159
1097,0.001376,172.31.47.0-255,66,35818,96,93159
1098,0.001394,172.253.118.0-255,4297,40115,96,93159
1099,0.001397,172.31.47.0-255,66,40181,96,93159
1100,0.001734,172.253.118.0-255,7156,47337,96,93159
1101,0.001738,172.31.47.0-255,66,47403,96,93159
1102,0.001774,172.31.47.0-255,66,47469,96,93159
1103,0.001796,172.253.118.0-255,1050,48519,96,93159
1104,0.001798,172.31.47.0-255,66,48585,96,93159
1105,0.002538,172.253.118.0-255,7156,55741,96,93159
1106,0.002597,172.253.118.0-255,5020,60761,96,93159
1107,0.002666,172.31.47.0-255,66,60827,96,93159
1108,0.003414,172.253.118.0-255,7156,67983,96,93159
1109,0.003419,172.31.47.0-255,66,68049,96,93159
1110,0.00437,172.253.118.0-255,5738,73787,96,93159
1111,0.005142,172.253.118.0-255,1484,75271,96,93159
1112,0.005186,172.253.118.0-255,1484,76755,96,93159
1113,0.006213,172.253.118.0-255,5738,82493,96,93159
1114,0.006527,172.31.47.0-255,66,82559,96,93159
1115,0.006907,172.31.47.0-255,66,82625,96,93159
1116,0.006965,172.31.47.0-255,66,82691,96,93159
1117,0.007866,172.31.47.0-255,66,82757,96,93159
1118,0.007953,172.31.47.0-255,66,82823,96,93159
1119,0.009054,172.31.47.0-255,66,82889,96,93159
1120,0.010469,172.253.118.0-255,5738,88627,96,93159
1121,0.012422,172.31.47.0-255,66,88693,96,93159
1122,0.013053,172.31.47.0-255,105,88798,96,93159
1123,0.015517,172.253.118.0-255,66,88864,96,93159
1124,0.029773,172.31.47.0-255,172,89036,96,93159
1125,0.029803,172.31.47.0-255,1110,90146,96,93159
1126,0.029842,172.31.47.0-255,1514,91660,96,93159
1127,0.029844,172.31.47.0-255,1301,92961,96,93159
1128,0.031279,104.244.42.0-255,66,93027,96,93159
1129,0.031344,104.244.42.0-255,66,93093,96,93159
1130,0.031394,104.244.42.0-255,66,93159,96,93159
1131,0.0,172.217.194.0-255,153,153,96,248333
1132,3.2e-05,172.31.47.0-255,66,219,96,248333
1133,3.9e-05,172.217.194.0-255,1484,1703,96,248333
1134,4.3e-05,172.31.47.0-255,66,1769,96,248333
1135,4.8e-05,172.217.194.0-255,2902,4671,96,248333
1136,5e-05,172.31.47.0-255,66,4737,96,248333
1137,6.5e-05,172.217.194.0-255,7156,11893,96,248333
1138,6.8e-05,172.31.47.0-255,66,11959,96,248333
1139,7.2e-05,172.217.194.0-255,1976,13935,96,248333
1140,7.4e-05,172.31.47.0-255,66,14001,96,248333
1141,0.000122,172.217.194.0-255,1484,15485,96,248333
1142,0.000125,172.31.47.0-255,66,15551,96,248333
1143,0.00013,172.217.194.0-255,2902,18453,96,248333
1144,0.000133,172.31.47.0-255,66,18519,96,248333
1145,0.000144,172.217.194.0-255,5738,24257,96,248333
1146,0.000147,172.31.47.0-255,66,24323,96,248333
1147,0.000154,172.217.194.0-255,7156,31479,96,248333
1148,0.000156,172.31.47.0-255,66,31545,96,248333
1149,0.000191,172.217.194.0-255,2543,34088,96,248333
1150,0.000194,172.31.47.0-255,66,34154,96,248333
1151,0.000206,172.31.47.0-255,66,34220,96,248333
1152,0.000217,172.217.194.0-255,3961,38181,96,248333
1153,0.000219,172.31.47.0-255,66,38247,96,248333
1154,0.000271,172.217.194.0-255,1484,39731,96,248333
1155,0.000275,172.31.47.0-255,66,39797,96,248333
1156,0.000293,172.217.194.0-255,2902,42699,96,248333
1157,0.000296,172.31.47.0-255,66,42765,96,248333
1158,0.000299,172.217.194.0-255,1484,44249,96,248333
1159,0.000302,172.31.47.0-255,66,44315,96,248333
1160,0.000333,172.217.194.0-255,4320,48635,96,248333
1161,0.000341,172.31.47.0-255,66,48701,96,248333
1162,0.000348,172.217.194.0-255,6797,55498,96,248333
1163,0.000351,172.31.47.0-255,66,55564,96,248333
1164,0.000354,172.217.194.0-255,378,55942,96,248333
1165,0.000493,172.217.194.0-255,366,56308,96,248333
1166,0.00072,172.217.194.0-255,1484,57792,96,248333
1167,0.000724,172.31.47.0-255,66,57858,96,248333
1168,0.000729,172.217.194.0-255,2902,60760,96,248333
1169,0.000731,172.31.47.0-255,66,60826,96,248333
1170,0.000735,172.217.194.0-255,2902,63728,96,248333
1171,0.000736,172.31.47.0-255,66,63794,96,248333
1172,0.000753,172.217.194.0-255,2902,66696,96,248333
1173,0.000755,172.31.47.0-255,66,66762,96,248333
1174,0.000766,172.217.194.0-255,6797,73559,96,248333
1175,0.000768,172.217.194.0-255,1484,75043,96,248333
1176,0.00077,172.31.47.0-255,66,75109,96,248333
1177,0.000813,172.31.47.0-255,66,75175,96,248333
1178,0.000817,172.217.194.0-255,1993,77168,96,248333
1179,0.000818,172.31.47.0-255,66,77234,96,248333
1180,0.001054,172.217.194.0-255,1484,78718,96,248333
1181,0.001061,172.217.194.0-255,2902,81620,96,248333
1182,0.001065,172.31.47.0-255,66,81686,96,248333
1183,0.001078,172.217.194.0-255,2902,84588,96,248333
1184,0.001084,172.31.47.0-255,66,84654,96,248333
1185,0.001107,172.217.194.0-255,2902,87556,96,248333
1186,0.00111,172.31.47.0-255,66,87622,96,248333
1187,0.001121,172.31.47.0-255,66,87688,96,248333
1188,0.001144,172.217.194.0-255,1484,89172,96,248333
1189,0.001156,172.31.47.0-255,66,89238,96,248333
1190,0.001465,172.217.194.0-255,1484,90722,96,248333
1191,0.001471,172.217.194.0-255,2902,93624,96,248333
1192,0.001475,172.31.47.0-255,66,93690,96,248333
1193,0.001501,172.217.194.0-255,5738,99428,96,248333
1194,0.001503,172.31.47.0-255,66,99494,96,248333
1195,0.001538,172.31.47.0-255,66,99560,96,248333
1196,0.001558,172.31.47.0-255,66,99626,96,248333
1197,0.002013,172.217.194.0-255,1484,101110,96,248333
1198,0.002029,172.217.194.0-255,2902,104012,96,248333
1199,0.002033,172.31.47.0-255,66,104078,96,248333
1200,0.002059,172.217.194.0-255,5738,109816,96,248333
1201,0.002061,172.31.47.0-255,66,109882,96,248333
1202,0.002092,172.31.47.0-255,66,109948,96,248333
1203,0.002111,172.217.194.0-255,4320,114268,96,248333
1204,0.002113,172.31.47.0-255,66,114334,96,248333
1205,0.002117,172.217.194.0-255,2902,117236,96,248333
1206,0.002119,172.31.47.0-255,66,117302,96,248333
1207,0.002151,172.31.47.0-255,66,117368,96,248333
1208,0.002222,172.217.194.0-255,1484,118852,96,248333
1209,0.002226,172.217.194.0-255,2902,121754,96,248333
1210,0.002228,172.31.47.0-255,66,121820,96,248333
1211,0.002234,172.217.194.0-255,5738,127558,96,248333
1212,0.002236,172.31.47.0-255,66,127624,96,248333
1213,0.002245,172.217.194.0-255,4320,131944,96,248333
1214,0.00229,172.217.194.0-255,1484,133428,96,248333
1215,0.002348,172.217.194.0-255,1484,134912,96,248333
1216,0.002352,172.217.194.0-255,2902,137814,96,248333
1217,0.002362,172.217.194.0-255,1484,139298,96,248333
1218,0.002381,172.217.194.0-255,4320,143618,96,248333
1219,0.002394,172.217.194.0-255,2902,146520,96,248333
1220,0.00241,172.217.194.0-255,7156,153676,96,248333
1221,0.002423,172.217.194.0-255,2902,156578,96,248333
1222,0.00243,172.217.194.0-255,7156,163734,96,248333
1223,0.002447,172.217.194.0-255,2902,166636,96,248333
1224,0.002478,172.217.194.0-255,5020,171656,96,248333
1225,0.002484,172.217.194.0-255,5738,177394,96,248333
1226,0.002513,172.217.194.0-255,2902,180296,96,248333
1227,0.002535,172.217.194.0-255,1484,181780,96,248333
1228,0.002579,172.217.194.0-255,4320,186100,96,248333
1229,0.002597,172.217.194.0-255,7156,193256,96,248333
1230,0.002644,172.217.194.0-255,4320,197576,96,248333
1231,0.002665,172.217.194.0-255,5738,203314,96,248333
1232,0.004244,172.31.47.0-255,66,203380,96,248333
1233,0.006864,172.217.194.0-255,5738,209118,96,248333
1234,0.00687,172.31.47.0-255,66,209184,96,248333
1235,0.009412,172.217.194.0-255,5738,214922,96,248333
1236,0.009418,172.31.47.0-255,66,214988,96,248333
1237,0.011941,172.217.194.0-255,5738,220726,96,248333
1238,0.011948,172.31.47.0-255,66,220792,96,248333
1239,0.014486,172.217.194.0-255,5738,226530,96,248333
1240,0.014495,172.31.47.0-255,66,226596,96,248333
1241,0.017044,172.217.194.0-255,5738,232334,96,248333
1242,0.017052,172.31.47.0-255,66,232400,96,248333
1243,0.0196,172.217.194.0-255,5738,238138,96,248333
1244,0.019609,172.31.47.0-255,66,238204,96,248333
1245,0.022161,172.217.194.0-255,2722,240926,96,248333
1246,0.022168,172.31.47.0-255,66,240992,96,248333
1247,0.022359,172.31.47.0-255,105,241097,96,248333
1248,0.02484,172.217.194.0-255,66,241163,96,248333
1249,0.02785,172.31.47.0-255,172,241335,96,248333
1250,0.027877,172.31.47.0-255,1110,242445,96,248333
1251,0.027916,172.31.47.0-255,1514,243959,96,248333
1252,0.027917,172.31.47.0-255,1514,245473,96,248333
1253,0.027922,172.31.47.0-255,1514,246987,96,248333
1254,0.027923,172.31.47.0-255,1082,248069,96,248333
1255,0.029388,104.244.42.0-255,66,248135,96,248333
1256,0.029436,104.244.42.0-255,66,248201,96,248333
1257,0.029489,104.244.42.0-255,66,248267,96,248333
1258,0.029491,104.244.42.0-255,66,248333,96,248333
1259,0.0,172.217.194.0-255,159,159,96,292242
1260,1.9e-05,172.31.47.0-255,66,225,96,292242
1261,2.5e-05,172.217.194.0-255,1484,1709,96,292242
1262,2.9e-05,172.31.47.0-255,66,1775,96,292242
1263,3.3e-05,172.217.194.0-255,2902,4677,96,292242
1264,4.2e-05,172.31.47.0-255,66,4743,96,292242
1265,4.6e-05,172.217.194.0-255,4320,9063,96,292242
1266,4.8e-05,172.31.47.0-255,66,9129,96,292242
1267,6.6e-05,172.217.194.0-255,2902,12031,96,292242
1268,6.8e-05,172.31.47.0-255,66,12097,96,292242
1269,9e-05,172.217.194.0-255,2102,14199,96,292242
1270,9.2e-05,172.31.47.0-255,66,14265,96,292242
1271,9.7e-05,172.217.194.0-255,5738,20003,96,292242
1272,9.8e-05,172.31.47.0-255,66,20069,96,292242
1273,0.000148,172.31.47.0-255,66,20135,96,292242
1274,0.000151,172.217.194.0-255,2902,23037,96,292242
1275,0.000153,172.31.47.0-255,66,23103,96,292242
1276,0.000187,172.31.47.0-255,66,23169,96,292242
1277,0.000191,172.217.194.0-255,5379,28548,96,292242
1278,0.000192,172.31.47.0-255,66,28614,96,292242
1279,0.000229,172.217.194.0-255,7156,35770,96,292242
1280,0.000231,172.31.47.0-255,66,35836,96,292242
1281,0.000256,172.31.47.0-255,66,35902,96,292242
1282,0.000258,172.217.194.0-255,342,36244,96,292242
1283,0.000259,172.31.47.0-255,66,36310,96,292242
1284,0.000298,172.217.194.0-255,119,36429,96,292242
1285,0.000299,172.31.47.0-255,66,36495,96,292242
1286,0.000318,172.217.194.0-255,380,36875,96,292242
1287,0.00032,172.31.47.0-255,66,36941,96,292242
1288,0.000573,172.217.194.0-255,1484,38425,96,292242
1289,0.000576,172.217.194.0-255,1484,39909,96,292242
1290,0.000579,172.31.47.0-255,66,39975,96,292242
1291,0.000593,172.217.194.0-255,1484,41459,96,292242
1292,0.000602,172.217.194.0-255,5738,47197,96,292242
1293,0.000604,172.31.47.0-255,66,47263,96,292242
1294,0.000629,172.31.47.0-255,66,47329,96,292242
1295,0.000655,172.217.194.0-255,2902,50231,96,292242
1296,0.000657,172.31.47.0-255,66,50297,96,292242
1297,0.000662,172.217.194.0-255,4320,54617,96,292242
1298,0.000664,172.31.47.0-255,66,54683,96,292242
1299,0.000695,172.217.194.0-255,6438,61121,96,292242
1300,0.000699,172.31.47.0-255,66,61187,96,292242
1301,0.000764,172.217.194.0-255,1484,62671,96,292242
1302,0.00078,172.217.194.0-255,2902,65573,96,292242
1303,0.000782,172.31.47.0-255,66,65639,96,292242
1304,0.000786,172.217.194.0-255,2902,68541,96,292242
1305,0.000788,172.31.47.0-255,66,68607,96,292242
1306,0.00082,172.217.194.0-255,2902,71509,96,292242
1307,0.000822,172.31.47.0-255,66,71575,96,292242
1308,0.000841,172.31.47.0-255,66,71641,96,292242
1309,0.000845,172.217.194.0-255,5738,77379,96,292242
1310,0.000847,172.31.47.0-255,66,77445,96,292242
1311,0.000876,172.217.194.0-255,5020,82465,96,292242
1312,0.000878,172.31.47.0-255,66,82531,96,292242
1313,0.000976,172.217.194.0-255,1484,84015,96,292242
1314,0.00098,172.217.194.0-255,2902,86917,96,292242
1315,0.000984,172.31.47.0-255,66,86983,96,292242
1316,0.001013,172.217.194.0-255,5738,92721,96,292242
1317,0.001041,172.217.194.0-255,4320,97041,96,292242
1318,0.001046,172.31.47.0-255,66,97107,96,292242
1319,0.001048,172.31.47.0-255,66,97173,96,292242
1320,0.001067,172.31.47.0-255,66,97239,96,292242
1321,0.001078,172.31.47.0-255,66,97305,96,292242
1322,0.001109,172.31.47.0-255,66,97371,96,292242
1323,0.001114,172.217.194.0-255,2902,100273,96,292242
1324,0.001115,172.31.47.0-255,66,100339,96,292242
1325,0.00114,172.31.47.0-255,66,100405,96,292242
1326,0.00119,172.31.47.0-255,66,100471,96,292242
1327,0.002092,172.217.194.0-255,1484,101955,96,292242
1328,0.002098,172.217.194.0-255,2902,104857,96,292242
1329,0.002101,172.31.47.0-255,66,104923,96,292242
1330,0.002134,172.217.194.0-255,5738,110661,96,292242
1331,0.002137,172.31.47.0-255,66,110727,96,292242
1332,0.002147,172.31.47.0-255,66,110793,96,292242
1333,0.002186,172.217.194.0-255,2902,113695,96,292242
1334,0.002199,172.31.47.0-255,66,113761,96,292242
1335,0.002202,172.31.47.0-255,66,113827,96,292242
1336,0.004422,172.217.194.0-255,5738,119565,96,292242
1337,0.004431,172.31.47.0-255,66,119631,96,292242
1338,0.006654,172.217.194.0-255,5738,125369,96,292242
1339,0.006659,172.31.47.0-255,66,125435,96,292242
1340,0.00888,172.217.194.0-255,5738,131173,96,292242
1341,0.008886,172.31.47.0-255,66,131239,96,292242
1342,0.011102,172.217.194.0-255,5738,136977,96,292242
1343,0.011107,172.31.47.0-255,66,137043,96,292242
1344,0.013333,172.217.194.0-255,5738,142781,96,292242
1345,0.013338,172.31.47.0-255,66,142847,96,292242
1346,0.015573,172.217.194.0-255,5738,148585,96,292242
1347,0.015583,172.31.47.0-255,66,148651,96,292242
1348,0.017794,172.217.194.0-255,5738,154389,96,292242
1349,0.017803,172.31.47.0-255,66,154455,96,292242
1350,0.020033,172.217.194.0-255,5738,160193,96,292242
1351,0.020043,172.31.47.0-255,66,160259,96,292242
1352,0.022287,172.217.194.0-255,5738,165997,96,292242
1353,0.022303,172.31.47.0-255,66,166063,96,292242
1354,0.023515,172.31.47.0-255,172,166235,96,292242
1355,0.023545,172.31.47.0-255,1105,167340,96,292242
1356,0.023595,172.31.47.0-255,1514,168854,96,292242
1357,0.023597,172.31.47.0-255,1306,170160,96,292242
1358,0.024539,172.217.194.0-255,5738,175898,96,292242
1359,0.024545,172.31.47.0-255,66,175964,96,292242
1360,0.025034,104.244.42.0-255,66,176030,96,292242
1361,0.025248,104.244.42.0-255,66,176096,96,292242
1362,0.02527,104.244.42.0-255,66,176162,96,292242
1363,0.026746,172.217.194.0-255,5738,181900,96,292242
1364,0.026752,172.31.47.0-255,66,181966,96,292242
1365,0.028974,172.217.194.0-255,5738,187704,96,292242
1366,0.02898,172.31.47.0-255,66,187770,96,292242
1367,0.03121,172.217.194.0-255,5738,193508,96,292242
1368,0.031218,172.31.47.0-255,66,193574,96,292242
1369,0.03343,172.217.194.0-255,5738,199312,96,292242
1370,0.033436,172.31.47.0-255,66,199378,96,292242
1371,0.035634,172.217.194.0-255,5738,205116,96,292242
1372,0.03564,172.31.47.0-255,66,205182,96,292242
1373,0.037896,172.217.194.0-255,5738,210920,96,292242
1374,0.037903,172.31.47.0-255,66,210986,96,292242
1375,0.040177,172.217.194.0-255,5738,216724,96,292242
1376,0.040187,172.31.47.0-255,66,216790,96,292242
1377,0.042417,172.217.194.0-255,5738,222528,96,292242
1378,0.042423,172.31.47.0-255,66,222594,96,292242
1379,0.044638,172.217.194.0-255,5738,228332,96,292242
1380,0.044644,172.31.47.0-255,66,228398,96,292242
1381,0.046852,172.217.194.0-255,5738,234136,96,292242
1382,0.046859,172.31.47.0-255,66,234202,96,292242
1383,0.049093,172.217.194.0-255,5738,239940,96,292242
1384,0.049103,172.31.47.0-255,66,240006,96,292242
1385,0.051329,172.217.194.0-255,5738,245744,96,292242
1386,0.051335,172.31.47.0-255,66,245810,96,292242
1387,0.053566,172.217.194.0-255,5738,251548,96,292242
1388,0.053572,172.31.47.0-255,66,251614,96,292242
1389,0.055804,172.217.194.0-255,5738,257352,96,292242
1390,0.055812,172.31.47.0-255,66,257418,96,292242
1391,0.058015,172.217.194.0-255,5738,263156,96,292242
1392,0.058019,172.31.47.0-255,66,263222,96,292242
1393,0.060245,172.217.194.0-255,5738,268960,96,292242
1394,0.06025,172.31.47.0-255,66,269026,96,292242
1395,0.062501,172.217.194.0-255,5738,274764,96,292242
1396,0.062506,172.31.47.0-255,66,274830,96,292242
1397,0.06474,172.217.194.0-255,5738,280568,96,292242
1398,0.064746,172.31.47.0-255,66,280634,96,292242
1399,0.066986,172.217.194.0-255,5738,286372,96,292242
1400,0.066991,172.31.47.0-255,66,286438,96,292242
1401,0.069189,172.217.194.0-255,5738,292176,96,292242
1402,0.069195,172.31.47.0-255,66,292242,96,292242
1403,0.0,74.125.24.0-255,153,153,96,193522
1404,2.8e-05,172.31.47.0-255,66,219,96,193522
1405,3.5e-05,74.125.24.0-255,1484,1703,96,193522
1406,3.8e-05,172.31.47.0-255,66,1769,96,193522
1407,4.3e-05,74.125.24.0-255,2902,4671,96,193522
1408,4.5e-05,172.31.47.0-255,66,4737,96,193522
1409,5.8e-05,74.125.24.0-255,7156,11893,96,193522
1410,6.1e-05,172.31.47.0-255,66,11959,96,193522
1411,6.4e-05,74.125.24.0-255,2172,14131,96,193522
1412,6.6e-05,172.31.47.0-255,66,14197,96,193522
1413,9.6e-05,172.31.47.0-255,66,14263,96,193522
1414,0.000128,74.125.24.0-255,5379,19642,96,193522
1415,0.000131,172.31.47.0-255,66,19708,96,193522
1416,0.000169,74.125.24.0-255,1484,21192,96,193522
1417,0.000171,172.31.47.0-255,66,21258,96,193522
1418,0.000194,74.125.24.0-255,2902,24160,96,193522
1419,0.000196,172.31.47.0-255,66,24226,96,193522
1420,0.000202,74.125.24.0-255,5738,29964,96,193522
1421,0.000205,172.31.47.0-255,66,30030,96,193522
1422,0.00021,74.125.24.0-255,4320,34350,96,193522
1423,0.000216,172.31.47.0-255,66,34416,96,193522
1424,0.000241,74.125.24.0-255,1484,35900,96,193522
1425,0.000243,172.31.47.0-255,66,35966,96,193522
1426,0.000251,74.125.24.0-255,7156,43122,96,193522
1427,0.000253,172.31.47.0-255,66,43188,96,193522
1428,0.000282,74.125.24.0-255,6797,49985,96,193522
1429,0.000285,172.31.47.0-255,66,50051,96,193522
1430,0.00029,74.125.24.0-255,4272,54323,96,193522
1431,0.000293,172.31.47.0-255,66,54389,96,193522
1432,0.000295,74.125.24.0-255,110,54499,96,193522
1433,0.000298,172.31.47.0-255,66,54565,96,193522
1434,0.0003,74.125.24.0-255,331,54896,96,193522
1435,0.000554,74.125.24.0-255,1484,56380,96,193522
1436,0.000558,172.31.47.0-255,66,56446,96,193522
1437,0.000563,74.125.24.0-255,2902,59348,96,193522
1438,0.000574,172.31.47.0-255,66,59414,96,193522
1439,0.000586,74.125.24.0-255,5738,65152,96,193522
1440,0.000601,172.31.47.0-255,66,65218,96,193522
1441,0.000635,172.31.47.0-255,66,65284,96,193522
1442,0.000664,74.125.24.0-255,4320,69604,96,193522
1443,0.000675,172.31.47.0-255,66,69670,96,193522
1444,0.000693,74.125.24.0-255,6438,76108,96,193522
1445,0.0007,172.31.47.0-255,66,76174,96,193522
1446,0.000741,74.125.24.0-255,1484,77658,96,193522
1447,0.000746,74.125.24.0-255,2902,80560,96,193522
1448,0.000749,172.31.47.0-255,66,80626,96,193522
1449,0.000791,74.125.24.0-255,5738,86364,96,193522
1450,0.000798,74.125.24.0-255,5738,92102,96,193522
1451,0.000802,172.31.47.0-255,66,92168,96,193522
1452,0.0009,74.125.24.0-255,5020,97188,96,193522
1453,0.000902,172.31.47.0-255,66,97254,96,193522
1454,0.000905,74.125.24.0-255,5738,102992,96,193522
1455,0.000907,172.31.47.0-255,66,103058,96,193522
1456,0.000925,172.31.47.0-255,66,103124,96,193522
1457,0.000929,172.31.47.0-255,66,103190,96,193522
1458,0.00098,172.31.47.0-255,66,103256,96,193522
1459,0.000988,74.125.24.0-255,7156,110412,96,193522
1460,0.000993,172.31.47.0-255,66,110478,96,193522
1461,0.001006,74.125.24.0-255,6438,116916,96,193522
1462,0.001013,74.125.24.0-255,1484,118400,96,193522
1463,0.001014,172.31.47.0-255,66,118466,96,193522
1464,0.001059,172.31.47.0-255,66,118532,96,193522
1465,0.001086,74.125.24.0-255,1484,120016,96,193522
1466,0.001091,74.125.24.0-255,2902,122918,96,193522
1467,0.001094,172.31.47.0-255,66,122984,96,193522
1468,0.001097,74.125.24.0-255,5738,128722,96,193522
1469,0.001108,172.31.47.0-255,66,128788,96,193522
1470,0.001142,74.125.24.0-255,5738,134526,96,193522
1471,0.001147,172.31.47.0-255,66,134592,96,193522
1472,0.001164,74.125.24.0-255,1484,136076,96,193522
1473,0.001182,74.125.24.0-255,2184,138260,96,193522
1474,0.001189,172.31.47.0-255,66,138326,96,193522
1475,0.001244,172.31.47.0-255,66,138392,96,193522
1476,0.001294,74.125.24.0-255,7156,145548,96,193522
1477,0.001299,172.31.47.0-255,66,145614,96,193522
1478,0.001339,172.31.47.0-255,66,145680,96,193522
1479,0.001367,74.125.24.0-255,1125,146805,96,193522
1480,0.001368,172.31.47.0-255,66,146871,96,193522
1481,0.001588,74.125.24.0-255,1484,148355,96,193522
1482,0.001592,172.31.47.0-255,66,148421,96,193522
1483,0.001597,74.125.24.0-255,2902,151323,96,193522
1484,0.001604,74.125.24.0-255,5738,157061,96,193522
1485,0.001618,172.31.47.0-255,66,157127,96,193522
1486,0.001621,74.125.24.0-255,7156,164283,96,193522
1487,0.001624,74.125.24.0-255,1484,165767,96,193522
1488,0.001636,172.31.47.0-255,66,165833,96,193522
1489,0.001667,74.125.24.0-255,2184,168017,96,193522
1490,0.001673,172.31.47.0-255,66,168083,96,193522
1491,0.001691,74.125.24.0-255,2902,170985,96,193522
1492,0.001696,172.31.47.0-255,66,171051,96,193522
1493,0.001727,74.125.24.0-255,7156,178207,96,193522
1494,0.00173,172.31.47.0-255,66,178273,96,193522
1495,0.001737,74.125.24.0-255,6797,185070,96,193522
1496,0.001742,74.125.24.0-255,2902,187972,96,193522
1497,0.001746,172.31.47.0-255,66,188038,96,193522
1498,0.001792,172.31.47.0-255,66,188104,96,193522
1499,0.001806,172.31.47.0-255,66,188170,96,193522
1500,0.001863,172.31.47.0-255,66,188236,96,193522
1501,0.001866,74.125.24.0-255,1484,189720,96,193522
1502,0.001869,172.31.47.0-255,66,189786,96,193522
1503,0.001918,172.31.47.0-255,66,189852,96,193522
1504,0.001965,74.125.24.0-255,105,189957,96,193522
1505,0.001972,172.31.47.0-255,66,190023,96,193522
1506,0.00336,172.31.47.0-255,105,190128,96,193522
1507,0.005541,74.125.24.0-255,66,190194,96,193522
1508,0.028388,172.31.47.0-255,172,190366,96,193522
1509,0.028417,172.31.47.0-255,1109,191475,96,193522
1510,0.028452,172.31.47.0-255,1514,192989,96,193522
1511,0.028454,172.31.47.0-255,335,193324,96,193522
1512,0.029911,104.244.42.0-255,66,193390,96,193522
1513,0.029955,104.244.42.0-255,66,193456,96,193522
1514,0.030007,104.244.42.0-255,66,193522,96,193522
1515,0.0,74.125.24.0-255,153,153,96,311526
1516,3e-05,172.31.47.0-255,66,219,96,311526
1517,3.7e-05,74.125.24.0-255,1484,1703,96,311526
1518,4.2e-05,172.31.47.0-255,66,1769,96,311526
1519,5.3e-05,74.125.24.0-255,2902,4671,96,311526
1520,5.6e-05,172.31.47.0-255,66,4737,96,311526
1521,6.1e-05,74.125.24.0-255,2902,7639,96,311526
1522,6.4e-05,172.31.47.0-255,66,7705,96,311526
1523,0.000106,74.125.24.0-255,6246,13951,96,311526
1524,0.000109,172.31.47.0-255,66,14017,96,311526
1525,0.000161,74.125.24.0-255,1484,15501,96,311526
1526,0.000165,172.31.47.0-255,66,15567,96,311526
1527,0.000198,74.125.24.0-255,2902,18469,96,311526
1528,0.000201,172.31.47.0-255,66,18535,96,311526
1529,0.000208,74.125.24.0-255,5738,24273,96,311526
1530,0.00021,172.31.47.0-255,66,24339,96,311526
1531,0.000255,74.125.24.0-255,5738,30077,96,311526
1532,0.000259,172.31.47.0-255,66,30143,96,311526
1533,0.000282,74.125.24.0-255,1125,31268,96,311526
1534,0.000286,172.31.47.0-255,66,31334,96,311526
1535,0.00045,74.125.24.0-255,1484,32818,96,311526
1536,0.000455,172.31.47.0-255,66,32884,96,311526
1537,0.000459,74.125.24.0-255,2902,35786,96,311526
1538,0.000471,172.31.47.0-255,66,35852,96,311526
1539,0.000481,74.125.24.0-255,5738,41590,96,311526
1540,0.000488,172.31.47.0-255,66,41656,96,311526
1541,0.000496,74.125.24.0-255,6797,48453,96,311526
1542,0.000498,172.31.47.0-255,66,48519,96,311526
1543,0.000514,74.125.24.0-255,7156,55675,96,311526
1544,0.000519,172.31.47.0-255,66,55741,96,311526
1545,0.000549,74.125.24.0-255,7156,62897,96,311526
1546,0.000553,172.31.47.0-255,66,62963,96,311526
1547,0.000557,74.125.24.0-255,2817,65780,96,311526
1548,0.00056,172.31.47.0-255,66,65846,96,311526
1549,0.000563,74.125.24.0-255,127,65973,96,311526
1550,0.000617,74.125.24.0-255,351,66324,96,311526
1551,0.000851,172.31.47.0-255,66,66390,96,311526
1552,0.00097,74.125.24.0-255,1484,67874,96,311526
1553,0.00098,74.125.24.0-255,2902,70776,96,311526
1554,0.000984,172.31.47.0-255,66,70842,96,311526
1555,0.001013,74.125.24.0-255,5738,76580,96,311526
1556,0.001016,172.31.47.0-255,66,76646,96,311526
1557,0.00102,74.125.24.0-255,1484,78130,96,311526
1558,0.001056,172.31.47.0-255,66,78196,96,311526
1559,0.001082,74.125.24.0-255,1484,79680,96,311526
1560,0.001113,172.31.47.0-255,66,79746,96,311526
1561,0.001213,74.125.24.0-255,1484,81230,96,311526
1562,0.001219,74.125.24.0-255,2902,84132,96,311526
1563,0.001223,172.31.47.0-255,66,84198,96,311526
1564,0.001227,74.125.24.0-255,1484,85682,96,311526
1565,0.001256,74.125.24.0-255,4320,90002,96,311526
1566,0.00126,172.31.47.0-255,66,90068,96,311526
1567,0.001265,74.125.24.0-255,7156,97224,96,311526
1568,0.001268,172.31.47.0-255,66,97290,96,311526
1569,0.001281,74.125.24.0-255,2902,100192,96,311526
1570,0.001283,172.31.47.0-255,66,100258,96,311526
1571,0.001322,172.31.47.0-255,66,100324,96,311526
1572,0.001325,74.125.24.0-255,2184,102508,96,311526
1573,0.001327,172.31.47.0-255,66,102574,96,311526
1574,0.001958,74.125.24.0-255,1484,104058,96,311526
1575,0.001965,74.125.24.0-255,2902,106960,96,311526
1576,0.00197,172.31.47.0-255,66,107026,96,311526
1577,0.001994,74.125.24.0-255,4320,111346,96,311526
1578,0.001997,172.31.47.0-255,66,111412,96,311526
1579,0.003893,74.125.24.0-255,1484,112896,96,311526
1580,0.003937,74.125.24.0-255,1484,114380,96,311526
1581,0.00394,172.31.47.0-255,66,114446,96,311526
1582,0.003966,74.125.24.0-255,2902,117348,96,311526
1583,0.003969,172.31.47.0-255,66,117414,96,311526
1584,0.005868,74.125.24.0-255,2902,120316,96,311526
1585,0.005872,172.31.47.0-255,66,120382,96,311526
1586,0.005911,74.125.24.0-255,2902,123284,96,311526
1587,0.005914,172.31.47.0-255,66,123350,96,311526
1588,0.007834,74.125.24.0-255,5738,129088,96,311526
1589,0.00784,172.31.47.0-255,66,129154,96,311526
1590,0.009802,74.125.24.0-255,5738,134892,96,311526
1591,0.00981,172.31.47.0-255,66,134958,96,311526
1592,0.011731,74.125.24.0-255,5738,140696,96,311526
1593,0.011736,172.31.47.0-255,66,140762,96,311526
1594,0.01368,74.125.24.0-255,5738,146500,96,311526
1595,0.013685,172.31.47.0-255,66,146566,96,311526
1596,0.01567,74.125.24.0-255,5738,152304,96,311526
1597,0.015677,172.31.47.0-255,66,152370,96,311526
1598,0.017637,74.125.24.0-255,5738,158108,96,311526
1599,0.017644,172.31.47.0-255,66,158174,96,311526
1600,0.019583,74.125.24.0-255,5738,163912,96,311526
1601,0.01959,172.31.47.0-255,66,163978,96,311526
1602,0.02156,74.125.24.0-255,5738,169716,96,311526
1603,0.021566,172.31.47.0-255,66,169782,96,311526
1604,0.023497,74.125.24.0-255,5738,175520,96,311526
1605,0.023503,172.31.47.0-255,66,175586,96,311526
1606,0.025464,74.125.24.0-255,5738,181324,96,311526
1607,0.02547,172.31.47.0-255,66,181390,96,311526
1608,0.027426,74.125.24.0-255,5738,187128,96,311526
1609,0.027432,172.31.47.0-255,66,187194,96,311526
1610,0.028222,172.31.47.0-255,171,187365,96,311526
1611,0.028251,172.31.47.0-255,1133,188498,96,311526
1612,0.028289,172.31.47.0-255,1514,190012,96,311526
1613,0.028291,172.31.47.0-255,1278,191290,96,311526
1614,0.029364,74.125.24.0-255,5738,197028,96,311526
1615,0.029373,172.31.47.0-255,66,197094,96,311526
1616,0.029958,104.244.42.0-255,66,197160,96,311526
1617,0.029967,104.244.42.0-255,66,197226,96,311526
1618,0.029971,104.244.42.0-255,66,197292,96,311526
1619,0.03131,74.125.24.0-255,5738,203030,96,311526
1620,0.031316,172.31.47.0-255,66,203096,96,311526
1621,0.033251,74.125.24.0-255,4320,207416,96,311526
1622,0.033255,172.31.47.0-255,66,207482,96,311526
1623,0.033281,74.125.24.0-255,1484,208966,96,311526
1624,0.035186,74.125.24.0-255,4320,213286,96,311526
1625,0.035191,172.31.47.0-255,66,213352,96,311526
1626,0.037136,74.125.24.0-255,5738,219090,96,311526
1627,0.037141,172.31.47.0-255,66,219156,96,311526
1628,0.039085,74.125.24.0-255,5738,224894,96,311526
1629,0.03909,172.31.47.0-255,66,224960,96,311526
1630,0.041033,74.125.24.0-255,5738,230698,96,311526
1631,0.041038,172.31.47.0-255,66,230764,96,311526
1632,0.042978,74.125.24.0-255,5738,236502,96,311526
1633,0.042983,172.31.47.0-255,66,236568,96,311526
1634,0.044922,74.125.24.0-255,2902,239470,96,311526
1635,0.044927,172.31.47.0-255,66,239536,96,311526
1636,0.044967,74.125.24.0-255,2902,242438,96,311526
1637,0.044971,172.31.47.0-255,66,242504,96,311526
1638,0.046855,74.125.24.0-255,2902,245406,96,311526
1639,0.04686,172.31.47.0-255,66,245472,96,311526
1640,0.046911,74.125.24.0-255,2902,248374,96,311526
1641,0.046916,172.31.47.0-255,66,248440,96,311526
1642,0.048801,74.125.24.0-255,1484,249924,96,311526
1643,0.048838,74.125.24.0-255,4320,254244,96,311526
1644,0.048844,172.31.47.0-255,66,254310,96,311526
1645,0.050784,74.125.24.0-255,5738,260048,96,311526
1646,0.05079,172.31.47.0-255,66,260114,96,311526
1647,0.052712,74.125.24.0-255,4320,264434,96,311526
1648,0.052717,172.31.47.0-255,66,264500,96,311526
1649,0.052745,74.125.24.0-255,1484,265984,96,311526
1650,0.054628,74.125.24.0-255,4320,270304,96,311526
1651,0.054634,172.31.47.0-255,66,270370,96,311526
1652,0.056585,74.125.24.0-255,5738,276108,96,311526
1653,0.056591,172.31.47.0-255,66,276174,96,311526
1654,0.058575,74.125.24.0-255,5738,281912,96,311526
1655,0.05858,172.31.47.0-255,66,281978,96,311526
1656,0.060513,74.125.24.0-255,5738,287716,96,311526
1657,0.060518,172.31.47.0-255,66,287782,96,311526
1658,0.062449,74.125.24.0-255,2902,290684,96,311526
1659,0.062454,172.31.47.0-255,66,290750,96,311526
1660,0.062486,74.125.24.0-255,2902,293652,96,311526
1661,0.062489,172.31.47.0-255,66,293718,96,311526
1662,0.064396,74.125.24.0-255,2902,296620,96,311526
1663,0.064402,172.31.47.0-255,66,296686,96,311526
1664,0.064428,74.125.24.0-255,2902,299588,96,311526
1665,0.064431,172.31.47.0-255,66,299654,96,311526
1666,0.066342,74.125.24.0-255,2902,302556,96,311526
1667,0.066347,172.31.47.0-255,66,302622,96,311526
1668,0.066379,74.125.24.0-255,2902,305524,96,311526
1669,0.066381,172.31.47.0-255,66,305590,96,311526
1670,0.068286,74.125.24.0-255,2902,308492,96,311526
1671,0.068291,172.31.47.0-255,66,308558,96,311526
1672,0.068324,74.125.24.0-255,2902,311460,96,311526
1673,0.068327,172.31.47.0-255,66,311526,96,311526
1674,0.0,74.125.24.0-255,157,157,96,196193
1675,2.3e-05,172.31.47.0-255,66,223,96,196193
1676,3e-05,74.125.24.0-255,1484,1707,96,196193
1677,3.3e-05,172.31.47.0-255,66,1773,96,196193
1678,3.8e-05,74.125.24.0-255,2902,4675,96,196193
1679,3.9e-05,172.31.47.0-255,66,4741,96,196193
1680,5.1e-05,74.125.24.0-255,5738,10479,96,196193
1681,5.3e-05,172.31.47.0-255,66,10545,96,196193
1682,8.5e-05,172.31.47.0-255,66,10611,96,196193
1683,0.000113,74.125.24.0-255,2251,12862,96,196193
1684,0.000115,172.31.47.0-255,66,12928,96,196193
1685,0.000121,74.125.24.0-255,6797,19725,96,196193
1686,0.000123,172.31.47.0-255,66,19791,96,196193
1687,0.000232,74.125.24.0-255,1484,21275,96,196193
1688,0.000236,172.31.47.0-255,66,21341,96,196193
1689,0.000239,74.125.24.0-255,1484,22825,96,196193
1690,0.000241,172.31.47.0-255,66,22891,96,196193
1691,0.00026,74.125.24.0-255,1484,24375,96,196193
1692,0.000264,172.31.47.0-255,66,24441,96,196193
1693,0.000265,74.125.24.0-255,5738,30179,96,196193
1694,0.000269,172.31.47.0-255,66,30245,96,196193
1695,0.00029,74.125.24.0-255,2902,33147,96,196193
1696,0.000294,172.31.47.0-255,66,33213,96,196193
1697,0.000332,172.31.47.0-255,66,33279,96,196193
1698,0.000336,74.125.24.0-255,2902,36181,96,196193
1699,0.000338,172.31.47.0-255,66,36247,96,196193
1700,0.000361,74.125.24.0-255,7139,43386,96,196193
1701,0.000368,172.31.47.0-255,66,43452,96,196193
1702,0.000387,74.125.24.0-255,345,43797,96,196193
1703,0.00039,172.31.47.0-255,66,43863,96,196193
1704,0.00056,74.125.24.0-255,1484,45347,96,196193
1705,0.000572,74.125.24.0-255,2902,48249,96,196193
1706,0.000575,172.31.47.0-255,66,48315,96,196193
1707,0.000578,74.125.24.0-255,1484,49799,96,196193
1708,0.000603,74.125.24.0-255,4320,54119,96,196193
1709,0.000605,172.31.47.0-255,66,54185,96,196193
1710,0.000611,74.125.24.0-255,5738,59923,96,196193
1711,0.000613,172.31.47.0-255,66,59989,96,196193
1712,0.00064,74.125.24.0-255,7156,67145,96,196193
1713,0.000643,172.31.47.0-255,66,67211,96,196193
1714,0.000649,74.125.24.0-255,7156,74367,96,196193
1715,0.00065,172.31.47.0-255,66,74433,96,196193
1716,0.000679,74.125.24.0-255,1484,75917,96,196193
1717,0.000695,74.125.24.0-255,2184,78101,96,196193
1718,0.000698,172.31.47.0-255,66,78167,96,196193
1719,0.000855,74.125.24.0-255,1484,79651,96,196193
1720,0.000868,74.125.24.0-255,2902,82553,96,196193
1721,0.000871,172.31.47.0-255,66,82619,96,196193
1722,0.000874,74.125.24.0-255,1484,84103,96,196193
1723,0.0009,74.125.24.0-255,4320,88423,96,196193
1724,0.000903,172.31.47.0-255,66,88489,96,196193
1725,0.000931,172.31.47.0-255,66,88555,96,196193
1726,0.000944,74.125.24.0-255,2902,91457,96,196193
1727,0.00095,172.31.47.0-255,66,91523,96,196193
1728,0.000957,74.125.24.0-255,7156,98679,96,196193
1729,0.000959,172.31.47.0-255,66,98745,96,196193
1730,0.000986,74.125.24.0-255,1484,100229,96,196193
1731,0.001001,74.125.24.0-255,3602,103831,96,196193
1732,0.001004,172.31.47.0-255,66,103897,96,196193
1733,0.001009,74.125.24.0-255,5738,109635,96,196193
1734,0.001011,172.31.47.0-255,66,109701,96,196193
1735,0.001029,74.125.24.0-255,5738,115439,96,196193
1736,0.001032,172.31.47.0-255,66,115505,96,196193
1737,0.001055,74.125.24.0-255,7156,122661,96,196193
1738,0.001058,172.31.47.0-255,66,122727,96,196193
1739,0.001063,74.125.24.0-255,7156,129883,96,196193
1740,0.001065,172.31.47.0-255,66,129949,96,196193
1741,0.001091,74.125.24.0-255,1484,131433,96,196193
1742,0.001105,74.125.24.0-255,5020,136453,96,196193
1743,0.001108,172.31.47.0-255,66,136519,96,196193
1744,0.001114,74.125.24.0-255,7156,143675,96,196193
1745,0.001115,172.31.47.0-255,66,143741,96,196193
1746,0.00115,172.31.47.0-255,66,143807,96,196193
1747,0.001181,74.125.24.0-255,1484,145291,96,196193
1748,0.001206,172.31.47.0-255,66,145357,96,196193
1749,0.001232,74.125.24.0-255,1484,146841,96,196193
1750,0.001235,74.125.24.0-255,1484,148325,96,196193
1751,0.001237,172.31.47.0-255,66,148391,96,196193
1752,0.001247,74.125.24.0-255,1484,149875,96,196193
1753,0.001258,74.125.24.0-255,5738,155613,96,196193
1754,0.001261,172.31.47.0-255,66,155679,96,196193
1755,0.001304,74.125.24.0-255,5738,161417,96,196193
1756,0.001306,172.31.47.0-255,66,161483,96,196193
1757,0.001333,74.125.24.0-255,5738,167221,96,196193
1758,0.001336,172.31.47.0-255,66,167287,96,196193
1759,0.001347,172.31.47.0-255,66,167353,96,196193
1760,0.001382,74.125.24.0-255,2902,170255,96,196193
1761,0.001385,172.31.47.0-255,66,170321,96,196193
1762,0.001419,172.31.47.0-255,66,170387,96,196193
1763,0.001451,172.31.47.0-255,66,170453,96,196193
1764,0.00146,172.31.47.0-255,66,170519,96,196193
1765,0.001701,74.125.24.0-255,1484,172003,96,196193
1766,0.001706,74.125.24.0-255,2902,174905,96,196193
1767,0.001709,172.31.47.0-255,66,174971,96,196193
1768,0.001738,74.125.24.0-255,5738,180709,96,196193
1769,0.001741,172.31.47.0-255,66,180775,96,196193
1770,0.001753,172.31.47.0-255,66,180841,96,196193
1771,0.001836,172.31.47.0-255,66,180907,96,196193
1772,0.00186,172.31.47.0-255,66,180973,96,196193
1773,0.001888,74.125.24.0-255,2902,183875,96,196193
1774,0.001891,172.31.47.0-255,66,183941,96,196193
1775,0.001905,172.31.47.0-255,66,184007,96,196193
1776,0.00192,172.31.47.0-255,66,184073,96,196193
1777,0.001931,172.31.47.0-255,66,184139,96,196193
1778,0.00197,172.31.47.0-255,66,184205,96,196193
1779,0.001984,172.31.47.0-255,66,184271,96,196193
1780,0.001997,172.31.47.0-255,66,184337,96,196193
1781,0.002002,74.125.24.0-255,4320,188657,96,196193
1782,0.002004,172.31.47.0-255,66,188723,96,196193
1783,0.002055,172.31.47.0-255,66,188789,96,196193
1784,0.00206,74.125.24.0-255,2699,191488,96,196193
1785,0.002062,172.31.47.0-255,66,191554,96,196193
1786,0.002065,74.125.24.0-255,105,191659,96,196193
1787,0.003329,172.31.47.0-255,66,191725,96,196193
1788,0.003353,172.31.47.0-255,105,191830,96,196193
1789,0.005939,74.125.24.0-255,66,191896,96,196193
1790,0.027091,172.31.47.0-255,172,192068,96,196193
1791,0.027118,172.31.47.0-255,1105,193173,96,196193
1792,0.02715,172.31.47.0-255,1514,194687,96,196193
1793,0.027152,172.31.47.0-255,1308,195995,96,196193
1794,0.02862,104.244.42.0-255,66,196061,96,196193
1795,0.028637,104.244.42.0-255,66,196127,96,196193
1796,0.02864,104.244.42.0-255,66,196193,96,196193
1797,0.0,172.31.47.0-255,105,105,96,105
1798,0.0,74.125.68.0-255,153,153,96,331719
1799,1.5e-05,172.31.47.0-255,66,219,96,331719
1800,4.6e-05,74.125.68.0-255,1484,1703,96,331719
1801,5.1e-05,172.31.47.0-255,66,1769,96,331719
1802,5.7e-05,74.125.68.0-255,2902,4671,96,331719
1803,6.1e-05,172.31.47.0-255,66,4737,96,331719
1804,6.6e-05,74.125.68.0-255,2902,7639,96,331719
1805,7.4e-05,172.31.47.0-255,66,7705,96,331719
1806,0.000101,74.125.68.0-255,4320,12025,96,331719
1807,0.000103,172.31.47.0-255,66,12091,96,331719
1808,0.000114,172.31.47.0-255,66,12157,96,331719
1809,0.000126,74.125.68.0-255,7156,19313,96,331719
1810,0.000128,172.31.47.0-255,66,19379,96,331719
1811,0.00017,74.125.68.0-255,3961,23340,96,331719
1812,0.000173,172.31.47.0-255,66,23406,96,331719
1813,0.000232,74.125.68.0-255,1484,24890,96,331719
1814,0.000236,172.31.47.0-255,66,24956,96,331719
1815,0.000239,74.125.68.0-255,1484,26440,96,331719
1816,0.000241,172.31.47.0-255,66,26506,96,331719
1817,0.000264,74.125.68.0-255,1484,27990,96,331719
1818,0.000271,172.31.47.0-255,66,28056,96,331719
1819,0.000278,74.125.68.0-255,5738,33794,96,331719
1820,0.00028,172.31.47.0-255,66,33860,96,331719
1821,0.000283,74.125.68.0-255,1484,35344,96,331719
1822,0.000286,172.31.47.0-255,66,35410,96,331719
1823,0.000311,74.125.68.0-255,5379,40789,96,331719
1824,0.000318,172.31.47.0-255,66,40855,96,331719
1825,0.000322,74.125.68.0-255,2902,43757,96,331719
1826,0.000325,172.31.47.0-255,66,43823,96,331719
1827,0.000361,74.125.68.0-255,5738,49561,96,331719
1828,0.000364,172.31.47.0-255,66,49627,96,331719
1829,0.000382,74.125.68.0-255,1484,51111,96,331719
1830,0.000402,74.125.68.0-255,7109,58220,96,331719
1831,0.000405,172.31.47.0-255,66,58286,96,331719
1832,0.000408,74.125.68.0-255,374,58660,96,331719
1833,0.000704,74.125.68.0-255,1484,60144,96,331719
1834,0.000709,74.125.68.0-255,2902,63046,96,331719
1835,0.000715,172.31.47.0-255,66,63112,96,331719
1836,0.000723,172.31.47.0-255,66,63178,96,331719
1837,0.000733,74.125.68.0-255,4320,67498,96,331719
1838,0.000737,172.31.47.0-255,66,67564,96,331719
1839,0.000772,172.31.47.0-255,66,67630,96,331719
1840,0.000777,74.125.68.0-255,2902,70532,96,331719
1841,0.000779,172.31.47.0-255,66,70598,96,331719
1842,0.000828,172.31.47.0-255,66,70664,96,331719
1843,0.000831,74.125.68.0-255,766,71430,96,331719
1844,0.000979,74.125.68.0-255,1484,72914,96,331719
1845,0.000985,172.31.47.0-255,66,72980,96,331719
1846,0.001011,74.125.68.0-255,2902,75882,96,331719
1847,0.001015,172.31.47.0-255,66,75948,96,331719
1848,0.001021,74.125.68.0-255,5738,81686,96,331719
1849,0.001024,172.31.47.0-255,66,81752,96,331719
1850,0.001028,74.125.68.0-255,2902,84654,96,331719
1851,0.001035,172.31.47.0-255,66,84720,96,331719
1852,0.00104,74.125.68.0-255,4320,89040,96,331719
1853,0.001042,172.31.47.0-255,66,89106,96,331719
1854,0.001082,172.31.47.0-255,66,89172,96,331719
1855,0.001087,74.125.68.0-255,4320,93492,96,331719
1856,0.00109,172.31.47.0-255,66,93558,96,331719
1857,0.001129,74.125.68.0-255,3602,97160,96,331719
1858,0.001131,172.31.47.0-255,66,97226,96,331719
1859,0.001174,74.125.68.0-255,2902,100128,96,331719
1860,0.001178,172.31.47.0-255,66,100194,96,331719
1861,0.001189,74.125.68.0-255,2902,103096,96,331719
1862,0.001196,172.31.47.0-255,66,103162,96,331719
1863,0.001227,74.125.68.0-255,1484,104646,96,331719
1864,0.001241,172.31.47.0-255,66,104712,96,331719
1865,0.001246,74.125.68.0-255,4320,109032,96,331719
1866,0.001249,172.31.47.0-255,66,109098,96,331719
1867,0.001259,74.125.68.0-255,5738,114836,96,331719
1868,0.001261,172.31.47.0-255,66,114902,96,331719
1869,0.001303,172.31.47.0-255,66,114968,96,331719
1870,0.00149,74.125.68.0-255,1484,116452,96,331719
1871,0.001526,74.125.68.0-255,2902,119354,96,331719
1872,0.001531,172.31.47.0-255,66,119420,96,331719
1873,0.001538,74.125.68.0-255,5738,125158,96,331719
1874,0.00154,172.31.47.0-255,66,125224,96,331719
1875,0.001545,74.125.68.0-255,2902,128126,96,331719
1876,0.001551,172.31.47.0-255,66,128192,96,331719
1877,0.001556,74.125.68.0-255,4320,132512,96,331719
1878,0.001558,172.31.47.0-255,66,132578,96,331719
1879,0.001605,172.31.47.0-255,66,132644,96,331719
1880,0.001612,74.125.68.0-255,5738,138382,96,331719
1881,0.001615,172.31.47.0-255,66,138448,96,331719
1882,0.001649,74.125.68.0-255,2184,140632,96,331719
1883,0.001651,172.31.47.0-255,66,140698,96,331719
1884,0.00201,74.125.68.0-255,1484,142182,96,331719
1885,0.002018,74.125.68.0-255,2902,145084,96,331719
1886,0.002024,172.31.47.0-255,66,145150,96,331719
1887,0.002053,74.125.68.0-255,2902,148052,96,331719
1888,0.002056,172.31.47.0-255,66,148118,96,331719
1889,0.002061,74.125.68.0-255,4320,152438,96,331719
1890,0.002063,172.31.47.0-255,66,152504,96,331719
1891,0.002066,74.125.68.0-255,1484,153988,96,331719
1892,0.002103,74.125.68.0-255,7156,161144,96,331719
1893,0.002106,172.31.47.0-255,66,161210,96,331719
1894,0.00211,74.125.68.0-255,2902,164112,96,331719
1895,0.002112,172.31.47.0-255,66,164178,96,331719
1896,0.00214,74.125.68.0-255,2902,167080,96,331719
1897,0.002147,172.31.47.0-255,66,167146,96,331719
1898,0.002184,172.31.47.0-255,66,167212,96,331719
1899,0.002196,172.31.47.0-255,66,167278,96,331719
1900,0.002235,74.125.68.0-255,4320,171598,96,331719
1901,0.002238,172.31.47.0-255,66,171664,96,331719
1902,0.002244,74.125.68.0-255,5738,177402,96,331719
1903,0.002247,172.31.47.0-255,66,177468,96,331719
1904,0.002264,172.31.47.0-255,66,177534,96,331719
1905,0.002303,74.125.68.0-255,1484,179018,96,331719
1906,0.002314,74.125.68.0-255,1484,180502,96,331719
1907,0.002316,172.31.47.0-255,66,180568,96,331719
1908,0.002321,74.125.68.0-255,1484,182052,96,331719
1909,0.002344,74.125.68.0-255,2902,184954,96,331719
1910,0.002347,172.31.47.0-255,66,185020,96,331719
1911,0.004608,74.125.68.0-255,1484,186504,96,331719
1912,0.004679,74.125.68.0-255,4320,190824,96,331719
1913,0.004685,172.31.47.0-255,66,190890,96,331719
1914,0.006991,74.125.68.0-255,5738,196628,96,331719
1915,0.006999,172.31.47.0-255,66,196694,96,331719
1916,0.009302,74.125.68.0-255,5738,202432,96,331719
1917,0.009308,172.31.47.0-255,66,202498,96,331719
1918,0.01161,74.125.68.0-255,5738,208236,96,331719
1919,0.011616,172.31.47.0-255,66,208302,96,331719
1920,0.01393,74.125.68.0-255,5738,214040,96,331719
1921,0.013938,172.31.47.0-255,66,214106,96,331719
1922,0.016242,74.125.68.0-255,5738,219844,96,331719
1923,0.01625,172.31.47.0-255,66,219910,96,331719
1924,0.01857,74.125.68.0-255,5738,225648,96,331719
1925,0.018584,172.31.47.0-255,66,225714,96,331719
1926,0.020888,74.125.68.0-255,5738,231452,96,331719
1927,0.020895,172.31.47.0-255,66,231518,96,331719
1928,0.0232,74.125.68.0-255,5738,237256,96,331719
1929,0.023206,172.31.47.0-255,66,237322,96,331719
1930,0.025534,74.125.68.0-255,5738,243060,96,331719
1931,0.025539,172.31.47.0-255,66,243126,96,331719
1932,0.026229,172.31.47.0-255,172,243298,96,331719
1933,0.026256,172.31.47.0-255,1105,244403,96,331719
1934,0.026308,172.31.47.0-255,1514,245917,96,331719
1935,0.02631,172.31.47.0-255,341,246258,96,331719
1936,0.02772,104.244.42.0-255,66,246324,96,331719
1937,0.027841,74.125.68.0-255,5738,252062,96,331719
1938,0.027845,172.31.47.0-255,66,252128,96,331719
1939,0.027871,104.244.42.0-255,66,252194,96,331719
1940,0.027886,104.244.42.0-255,66,252260,96,331719
1941,0.030164,74.125.68.0-255,5738,257998,96,331719
1942,0.030171,172.31.47.0-255,66,258064,96,331719
1943,0.03249,74.125.68.0-255,5738,263802,96,331719
1944,0.032495,172.31.47.0-255,66,263868,96,331719
1945,0.034805,74.125.68.0-255,5738,269606,96,331719
1946,0.034812,172.31.47.0-255,66,269672,96,331719
1947,0.037124,74.125.68.0-255,5738,275410,96,331719
1948,0.037131,172.31.47.0-255,66,275476,96,331719
1949,0.039435,74.125.68.0-255,5738,281214,96,331719
1950,0.03944,172.31.47.0-255,66,281280,96,331719
1951,0.041759,74.125.68.0-255,5738,287018,96,331719
1952,0.041768,172.31.47.0-255,66,287084,96,331719
1953,0.044078,74.125.68.0-255,5738,292822,96,331719
1954,0.044085,172.31.47.0-255,66,292888,96,331719
1955,0.046395,74.125.68.0-255,5738,298626,96,331719
1956,0.046401,172.31.47.0-255,66,298692,96,331719
1957,0.048715,74.125.68.0-255,5738,304430,96,331719
1958,0.04872,172.31.47.0-255,66,304496,96,331719
1959,0.051022,74.125.68.0-255,5738,310234,96,331719
1960,0.051027,172.31.47.0-255,66,310300,96,331719
1961,0.053348,74.125.68.0-255,5738,316038,96,331719
1962,0.053355,172.31.47.0-255,66,316104,96,331719
1963,0.055661,74.125.68.0-255,5738,321842,96,331719
1964,0.055667,172.31.47.0-255,66,321908,96,331719
1965,0.057974,74.125.68.0-255,5738,327646,96,331719
1966,0.057979,172.31.47.0-255,66,327712,96,331719
1967,0.060288,74.125.68.0-255,3770,331482,96,331719
1968,0.060294,172.31.47.0-255,66,331548,96,331719
1969,0.060471,172.31.47.0-255,105,331653,96,331719
1970,0.062728,74.125.68.0-255,66,331719,96,331719
1971,0.0,172.31.47.0-255,105,105,96,276
1972,0.002396,157.240.13.0-255,105,210,96,276
1973,0.002408,172.31.47.0-255,66,276,96,276
1974,0.0,172.31.47.0-255,105,105,96,105
1975,0.0,172.31.47.0-255,105,105,96,276
1976,0.002043,157.240.13.0-255,105,210,96,276
1977,0.002056,172.31.47.0-255,66,276,96,276
1978,0.0,74.125.24.0-255,153,153,96,182483
1979,2.2e-05,172.31.47.0-255,66,219,96,182483
1980,2.9e-05,74.125.24.0-255,1484,1703,96,182483
1981,3.2e-05,172.31.47.0-255,66,1769,96,182483
1982,3.6e-05,74.125.24.0-255,2902,4671,96,182483
1983,3.8e-05,172.31.47.0-255,66,4737,96,182483
1984,4.3e-05,74.125.24.0-255,5738,10475,96,182483
1985,4.6e-05,172.31.47.0-255,66,10541,96,182483
1986,4.8e-05,74.125.24.0-255,1484,12025,96,182483
1987,5e-05,172.31.47.0-255,66,12091,96,182483
1988,8.2e-05,172.31.47.0-255,66,12157,96,182483
1989,9.1e-05,172.31.47.0-255,66,12223,96,182483
1990,0.000135,74.125.24.0-255,1484,13707,96,182483
1991,0.000138,172.31.47.0-255,66,13773,96,182483
1992,0.000143,74.125.24.0-255,2902,16675,96,182483
1993,0.000144,172.31.47.0-255,66,16741,96,182483
1994,0.000162,74.125.24.0-255,5738,22479,96,182483
1995,0.000164,172.31.47.0-255,66,22545,96,182483
1996,0.000197,74.125.24.0-255,6797,29342,96,182483
1997,0.000199,172.31.47.0-255,66,29408,96,182483
1998,0.000205,74.125.24.0-255,7156,36564,96,182483
1999,0.000206,172.31.47.0-255,66,36630,96,182483
2000,0.000243,74.125.24.0-255,5738,42368,96,182483
2001,0.000246,172.31.47.0-255,66,42434,96,182483
2002,0.000258,74.125.24.0-255,4228,46662,96,182483
2003,0.000261,172.31.47.0-255,66,46728,96,182483
2004,0.000264,74.125.24.0-255,136,46864,96,182483
2005,0.000266,172.31.47.0-255,66,46930,96,182483
2006,0.000665,74.125.24.0-255,349,47279,96,182483
2007,0.00067,172.31.47.0-255,66,47345,96,182483
2008,0.000701,74.125.24.0-255,1484,48829,96,182483
2009,0.000707,74.125.24.0-255,4320,53149,96,182483
2010,0.000709,172.31.47.0-255,66,53215,96,182483
2011,0.000728,74.125.24.0-255,4320,57535,96,182483
2012,0.000731,172.31.47.0-255,66,57601,96,182483
2013,0.000758,74.125.24.0-255,5738,63339,96,182483
2014,0.00076,172.31.47.0-255,66,63405,96,182483
2015,0.000763,74.125.24.0-255,1125,64530,96,182483
2016,0.000817,172.31.47.0-255,66,64596,96,182483
2017,0.000905,74.125.24.0-255,1484,66080,96,182483
2018,0.000913,74.125.24.0-255,2902,68982,96,182483
2019,0.000916,172.31.47.0-255,66,69048,96,182483
2020,0.000935,74.125.24.0-255,5738,74786,96,182483
2021,0.000939,172.31.47.0-255,66,74852,96,182483
2022,0.000943,74.125.24.0-255,2902,77754,96,182483
2023,0.000945,172.31.47.0-255,66,77820,96,182483
2024,0.000981,172.31.47.0-255,66,77886,96,182483
2025,0.000989,172.31.47.0-255,66,77952,96,182483
2026,0.001013,74.125.24.0-255,4320,82272,96,182483
2027,0.001016,172.31.47.0-255,66,82338,96,182483
2028,0.001044,172.31.47.0-255,66,82404,96,182483
2029,0.001054,172.31.47.0-255,66,82470,96,182483
2030,0.001102,172.31.47.0-255,66,82536,96,182483
2031,0.001111,172.31.47.0-255,66,82602,96,182483
2032,0.001143,172.31.47.0-255,66,82668,96,182483
2033,0.001152,172.31.47.0-255,66,82734,96,182483
2034,0.001188,172.31.47.0-255,66,82800,96,182483
2035,0.001572,74.125.24.0-255,1484,84284,96,182483
2036,0.001576,74.125.24.0-255,2902,87186,96,182483
2037,0.001582,172.31.47.0-255,66,87252,96,182483
2038,0.001591,74.125.24.0-255,4320,91572,96,182483
2039,0.001592,172.31.47.0-255,66,91638,96,182483
2040,0.001605,74.125.24.0-255,1484,93122,96,182483
2041,0.001616,74.125.24.0-255,4320,97442,96,182483
2042,0.001618,172.31.47.0-255,66,97508,96,182483
2043,0.001638,74.125.24.0-255,7156,104664,96,182483
2044,0.001641,172.31.47.0-255,66,104730,96,182483
2045,0.001681,172.31.47.0-255,66,104796,96,182483
2046,0.001698,74.125.24.0-255,3602,108398,96,182483
2047,0.0017,172.31.47.0-255,66,108464,96,182483
2048,0.001789,74.125.24.0-255,1484,109948,96,182483
2049,0.001794,74.125.24.0-255,2902,112850,96,182483
2050,0.001796,172.31.47.0-255,66,112916,96,182483
2051,0.001818,74.125.24.0-255,5738,118654,96,182483
2052,0.00182,172.31.47.0-255,66,118720,96,182483
2053,0.001824,74.125.24.0-255,4320,123040,96,182483
2054,0.001826,172.31.47.0-255,66,123106,96,182483
2055,0.001828,74.125.24.0-255,1484,124590,96,182483
2056,0.001845,74.125.24.0-255,4320,128910,96,182483
2057,0.001849,172.31.47.0-255,66,128976,96,182483
2058,0.001858,74.125.24.0-255,5738,134714,96,182483
2059,0.001859,172.31.47.0-255,66,134780,96,182483
2060,0.001875,74.125.24.0-255,1484,136264,96,182483
2061,0.001914,172.31.47.0-255,66,136330,96,182483
2062,0.001917,74.125.24.0-255,1484,137814,96,182483
2063,0.001942,172.31.47.0-255,66,137880,96,182483
2064,0.00195,74.125.24.0-255,5738,143618,96,182483
2065,0.001952,172.31.47.0-255,66,143684,96,182483
2066,0.001967,74.125.24.0-255,2184,145868,96,182483
2067,0.001969,172.31.47.0-255,66,145934,96,182483
2068,0.002015,172.31.47.0-255,66,146000,96,182483
2069,0.00202,74.125.24.0-255,4320,150320,96,182483
2070,0.002021,172.31.47.0-255,66,150386,96,182483
2071,0.002045,172.31.47.0-255,66,150452,96,182483
2072,0.002051,74.125.24.0-255,7156,157608,96,182483
2073,0.002053,172.31.47.0-255,66,157674,96,182483
2074,0.002075,74.125.24.0-255,7156,164830,96,182483
2075,0.002078,172.31.47.0-255,66,164896,96,182483
2076,0.002086,172.31.47.0-255,66,164962,96,182483
2077,0.002117,172.31.47.0-255,66,165028,96,182483
2078,0.002131,172.31.47.0-255,66,165094,96,182483
2079,0.002155,74.125.24.0-255,2902,167996,96,182483
2080,0.002158,172.31.47.0-255,66,168062,96,182483
2081,0.002171,172.31.47.0-255,66,168128,96,182483
2082,0.002188,74.125.24.0-255,7156,175284,96,182483
2083,0.00219,172.31.47.0-255,66,175350,96,182483
2084,0.002215,74.125.24.0-255,2430,177780,96,182483
2085,0.002217,74.125.24.0-255,105,177885,96,182483
2086,0.002222,172.31.47.0-255,66,177951,96,182483
2087,0.003607,172.31.47.0-255,66,178017,96,182483
2088,0.003637,172.31.47.0-255,105,178122,96,182483
2089,0.005886,74.125.24.0-255,66,178188,96,182483
2090,0.031187,172.31.47.0-255,172,178360,96,182483
2091,0.031231,172.31.47.0-255,1109,179469,96,182483
2092,0.031301,172.31.47.0-255,1514,180983,96,182483
2093,0.031303,172.31.47.0-255,1302,182285,96,182483
2094,0.03271,104.244.42.0-255,66,182351,96,182483
2095,0.03281,104.244.42.0-255,66,182417,96,182483
2096,0.032859,104.244.42.0-255,66,182483,96,182483
2097,0.0,74.125.200.0-255,162,162,96,295015
2098,3e-05,172.31.47.0-255,66,228,96,295015
2099,3.6e-05,74.125.200.0-255,1484,1712,96,295015
2100,4e-05,172.31.47.0-255,66,1778,96,295015
2101,4.4e-05,74.125.200.0-255,2902,4680,96,295015
2102,4.7e-05,172.31.47.0-255,66,4746,96,295015
2103,7.2e-05,74.125.200.0-255,5738,10484,96,295015
2104,7.4e-05,172.31.47.0-255,66,10550,96,295015
2105,7.9e-05,74.125.200.0-255,3669,14219,96,295015
2106,8.1e-05,172.31.47.0-255,66,14285,96,295015
2107,0.000139,74.125.200.0-255,1484,15769,96,295015
2108,0.000143,172.31.47.0-255,66,15835,96,295015
2109,0.000155,74.125.200.0-255,2902,18737,96,295015
2110,0.000159,172.31.47.0-255,66,18803,96,295015
2111,0.00018,74.125.200.0-255,5738,24541,96,295015
2112,0.000183,172.31.47.0-255,66,24607,96,295015
2113,0.000188,74.125.200.0-255,2902,27509,96,295015
2114,0.00019,172.31.47.0-255,66,27575,96,295015
2115,0.00021,74.125.200.0-255,3961,31536,96,295015
2116,0.000213,172.31.47.0-255,66,31602,96,295015
2117,0.000217,74.125.200.0-255,2902,34504,96,295015
2118,0.000219,172.31.47.0-255,66,34570,96,295015
2119,0.00025,74.125.200.0-255,2902,37472,96,295015
2120,0.000253,172.31.47.0-255,66,37538,96,295015
2121,0.00026,74.125.200.0-255,7156,44694,96,295015
2122,0.000262,172.31.47.0-255,66,44760,96,295015
2123,0.000276,74.125.200.0-255,2902,47662,96,295015
2124,0.000278,172.31.47.0-255,66,47728,96,295015
2125,0.000298,74.125.200.0-255,1125,48853,96,295015
2126,0.000301,172.31.47.0-255,66,48919,96,295015
2127,0.000576,74.125.200.0-255,1484,50403,96,295015
2128,0.000581,172.31.47.0-255,66,50469,96,295015
2129,0.000586,74.125.200.0-255,2902,53371,96,295015
2130,0.000588,172.31.47.0-255,66,53437,96,295015
2131,0.000612,74.125.200.0-255,5738,59175,96,295015
2132,0.000614,172.31.47.0-255,66,59241,96,295015
2133,0.000618,74.125.200.0-255,1484,60725,96,295015
2134,0.000635,74.125.200.0-255,5379,66104,96,295015
2135,0.000637,172.31.47.0-255,66,66170,96,295015
2136,0.000703,74.125.200.0-255,1484,67654,96,295015
2137,0.000716,74.125.200.0-255,1484,69138,96,295015
2138,0.000719,172.31.47.0-255,66,69204,96,295015
2139,0.000737,74.125.200.0-255,1484,70688,96,295015
2140,0.000742,74.125.200.0-255,2902,73590,96,295015
2141,0.000744,172.31.47.0-255,66,73656,96,295015
2142,0.000749,74.125.200.0-255,4320,77976,96,295015
2143,0.000751,172.31.47.0-255,66,78042,96,295015
2144,0.000773,74.125.200.0-255,1484,79526,96,295015
2145,0.000803,172.31.47.0-255,66,79592,96,295015
2146,0.000815,172.31.47.0-255,66,79658,96,295015
2147,0.000867,74.125.200.0-255,2543,82201,96,295015
2148,0.00087,172.31.47.0-255,66,82267,96,295015
2149,0.000873,74.125.200.0-255,647,82914,96,295015
2150,0.001059,172.31.47.0-255,66,82980,96,295015
2151,0.001515,74.125.200.0-255,1484,84464,96,295015
2152,0.001526,74.125.200.0-255,2902,87366,96,295015
2153,0.00153,172.31.47.0-255,66,87432,96,295015
2154,0.001538,74.125.200.0-255,5738,93170,96,295015
2155,0.00154,172.31.47.0-255,66,93236,96,295015
2156,0.001545,74.125.200.0-255,2902,96138,96,295015
2157,0.001546,172.31.47.0-255,66,96204,96,295015
2158,0.001564,74.125.200.0-255,4320,100524,96,295015
2159,0.001566,172.31.47.0-255,66,100590,96,295015
2160,0.001596,74.125.200.0-255,7156,107746,96,295015
2161,0.001599,172.31.47.0-255,66,107812,96,295015
2162,0.001623,74.125.200.0-255,7156,114968,96,295015
2163,0.001626,172.31.47.0-255,66,115034,96,295015
2164,0.00163,74.125.200.0-255,2184,117218,96,295015
2165,0.001632,172.31.47.0-255,66,117284,96,295015
2166,0.00184,74.125.200.0-255,1484,118768,96,295015
2167,0.001847,74.125.200.0-255,2902,121670,96,295015
2168,0.001851,172.31.47.0-255,66,121736,96,295015
2169,0.001857,74.125.200.0-255,2902,124638,96,295015
2170,0.00186,172.31.47.0-255,66,124704,96,295015
2171,0.001877,74.125.200.0-255,2902,127606,96,295015
2172,0.001879,172.31.47.0-255,66,127672,96,295015
2173,0.00191,172.31.47.0-255,66,127738,96,295015
2174,0.00194,74.125.200.0-255,2902,130640,96,295015
2175,0.001942,172.31.47.0-255,66,130706,96,295015
2176,0.001957,74.125.200.0-255,2902,133608,96,295015
2177,0.001959,172.31.47.0-255,66,133674,96,295015
2178,0.001984,74.125.200.0-255,2902,136576,96,295015
2179,0.001987,172.31.47.0-255,66,136642,96,295015
2180,0.002003,74.125.200.0-255,1484,138126,96,295015
2181,0.002031,74.125.200.0-255,2184,140310,96,295015
2182,0.002034,172.31.47.0-255,66,140376,96,295015
2183,0.004508,74.125.200.0-255,1484,141860,96,295015
2184,0.00456,74.125.200.0-255,2902,144762,96,295015
2185,0.004563,172.31.47.0-255,66,144828,96,295015
2186,0.004574,74.125.200.0-255,1484,146312,96,295015
2187,0.007096,74.125.200.0-255,4320,150632,96,295015
2188,0.007101,172.31.47.0-255,66,150698,96,295015
2189,0.00966,74.125.200.0-255,5738,156436,96,295015
2190,0.009667,172.31.47.0-255,66,156502,96,295015
2191,0.012204,74.125.200.0-255,5738,162240,96,295015
2192,0.012209,172.31.47.0-255,66,162306,96,295015
2193,0.014756,74.125.200.0-255,5738,168044,96,295015
2194,0.014764,172.31.47.0-255,66,168110,96,295015
2195,0.01731,74.125.200.0-255,5738,173848,96,295015
2196,0.017318,172.31.47.0-255,66,173914,96,295015
2197,0.019854,74.125.200.0-255,5738,179652,96,295015
2198,0.019862,172.31.47.0-255,66,179718,96,295015
2199,0.022303,172.31.47.0-255,172,179890,96,295015
2200,0.022357,172.31.47.0-255,1105,180995,96,295015
2201,0.022391,74.125.200.0-255,5738,186733,96,295015
2202,0.022396,172.31.47.0-255,66,186799,96,295015
2203,0.022501,172.31.47.0-255,1514,188313,96,295015
2204,0.022503,172.31.47.0-255,1306,189619,96,295015
2205,0.023859,104.244.42.0-255,66,189685,96,295015
2206,0.023895,104.244.42.0-255,66,189751,96,295015
2207,0.024055,104.244.42.0-255,66,189817,96,295015
2208,0.024935,74.125.200.0-255,5738,195555,96,295015
2209,0.02494,172.31.47.0-255,66,195621,96,295015
2210,0.027492,74.125.200.0-255,5738,201359,96,295015
2211,0.027498,172.31.47.0-255,66,201425,96,295015
2212,0.030062,74.125.200.0-255,5738,207163,96,295015
2213,0.030069,172.31.47.0-255,66,207229,96,295015
2214,0.03262,74.125.200.0-255,5738,212967,96,295015
2215,0.032625,172.31.47.0-255,66,213033,96,295015
2216,0.035179,74.125.200.0-255,5738,218771,96,295015
2217,0.035186,172.31.47.0-255,66,218837,96,295015
2218,0.037733,74.125.200.0-255,5738,224575,96,295015
2219,0.037739,172.31.47.0-255,66,224641,96,295015
2220,0.040284,74.125.200.0-255,5738,230379,96,295015
2221,0.04029,172.31.47.0-255,66,230445,96,295015
2222,0.042829,74.125.200.0-255,5738,236183,96,295015
2223,0.042845,172.31.47.0-255,66,236249,96,295015
2224,0.045406,74.125.200.0-255,1484,237733,96,295015
2225,0.045436,74.125.200.0-255,4320,242053,96,295015
2226,0.04544,172.31.47.0-255,66,242119,96,295015
2227,0.047964,74.125.200.0-255,1484,243603,96,295015
2228,0.047992,74.125.200.0-255,4320,247923,96,295015
2229,0.047996,172.31.47.0-255,66,247989,96,295015
2230,0.050551,74.125.200.0-255,5738,253727,96,295015
2231,0.050555,172.31.47.0-255,66,253793,96,295015
2232,0.05309,74.125.200.0-255,5738,259531,96,295015
2233,0.053094,172.31.47.0-255,66,259597,96,295015
2234,0.055628,74.125.200.0-255,5738,265335,96,295015
2235,0.055632,172.31.47.0-255,66,265401,96,295015
2236,0.058162,74.125.200.0-255,2902,268303,96,295015
2237,0.058166,172.31.47.0-255,66,268369,96,295015
2238,0.058195,74.125.200.0-255,2902,271271,96,295015
2239,0.058197,172.31.47.0-255,66,271337,96,295015
2240,0.060697,74.125.200.0-255,1484,272821,96,295015
2241,0.060728,74.125.200.0-255,4320,277141,96,295015
2242,0.060732,172.31.47.0-255,66,277207,96,295015
2243,0.063288,74.125.200.0-255,2902,280109,96,295015
2244,0.063292,172.31.47.0-255,66,280175,96,295015
2245,0.063314,74.125.200.0-255,2902,283077,96,295015
2246,0.063317,172.31.47.0-255,66,283143,96,295015
2247,0.065833,74.125.200.0-255,2902,286045,96,295015
2248,0.065837,172.31.47.0-255,66,286111,96,295015
2249,0.065861,74.125.200.0-255,2902,289013,96,295015
2250,0.065863,172.31.47.0-255,66,289079,96,295015
2251,0.068376,74.125.200.0-255,2902,291981,96,295015
2252,0.068381,172.31.47.0-255,66,292047,96,295015
2253,0.068405,74.125.200.0-255,2902,294949,96,295015
2254,0.068408,172.31.47.0-255,66,295015,96,295015
2255,0.0,172.217.194.0-255,152,152,96,295366
2256,1.8e-05,172.31.47.0-255,66,218,96,295366
2257,2.5e-05,172.217.194.0-255,1484,1702,96,295366
2258,3.1e-05,172.31.47.0-255,66,1768,96,295366
2259,3.5e-05,172.217.194.0-255,2902,4670,96,295366
2260,4.9e-05,172.31.47.0-255,66,4736,96,295366
2261,5.7e-05,172.217.194.0-255,7156,11892,96,295366
2262,6.2e-05,172.31.47.0-255,66,11958,96,295366
2263,6.6e-05,172.217.194.0-255,2097,14055,96,295366
2264,6.9e-05,172.31.47.0-255,66,14121,96,295366
2265,9.1e-05,172.217.194.0-255,1484,15605,96,295366
2266,9.4e-05,172.31.47.0-255,66,15671,96,295366
2267,0.000116,172.217.194.0-255,1484,17155,96,295366
2268,0.00012,172.31.47.0-255,66,17221,96,295366
2269,0.000125,172.217.194.0-255,4320,21541,96,295366
2270,0.000127,172.31.47.0-255,66,21607,96,295366
2271,0.000138,172.31.47.0-255,66,21673,96,295366
2272,0.00017,172.217.194.0-255,1125,22798,96,295366
2273,0.000173,172.31.47.0-255,66,22864,96,295366
2274,0.000197,172.217.194.0-255,1484,24348,96,295366
2275,0.000199,172.31.47.0-255,66,24414,96,295366
2276,0.000213,172.217.194.0-255,2902,27316,96,295366
2277,0.000215,172.31.47.0-255,66,27382,96,295366
2278,0.000226,172.217.194.0-255,4320,31702,96,295366
2279,0.000229,172.31.47.0-255,66,31768,96,295366
2280,0.00027,172.217.194.0-255,5738,37506,96,295366
2281,0.000274,172.31.47.0-255,66,37572,96,295366
2282,0.0003,172.217.194.0-255,2543,40115,96,295366
2283,0.000303,172.31.47.0-255,66,40181,96,295366
2284,0.000388,172.217.194.0-255,1484,41665,96,295366
2285,0.000393,172.31.47.0-255,66,41731,96,295366
2286,0.000398,172.217.194.0-255,2902,44633,96,295366
2287,0.000401,172.31.47.0-255,66,44699,96,295366
2288,0.000406,172.217.194.0-255,4320,49019,96,295366
2289,0.000413,172.31.47.0-255,66,49085,96,295366
2290,0.000439,172.217.194.0-255,1484,50569,96,295366
2291,0.000447,172.217.194.0-255,6797,57366,96,295366
2292,0.000451,172.31.47.0-255,66,57432,96,295366
2293,0.000453,172.217.194.0-255,379,57811,96,295366
2294,0.000518,172.217.194.0-255,366,58177,96,295366
2295,0.000592,172.217.194.0-255,1484,59661,96,295366
2296,0.000597,172.31.47.0-255,66,59727,96,295366
2297,0.000603,172.217.194.0-255,2902,62629,96,295366
2298,0.000605,172.31.47.0-255,66,62695,96,295366
2299,0.000639,172.217.194.0-255,5738,68433,96,295366
2300,0.000646,172.217.194.0-255,4320,72753,96,295366
2301,0.000685,172.217.194.0-255,4320,77073,96,295366
2302,0.000703,172.217.194.0-255,3602,80675,96,295366
2303,0.00071,172.31.47.0-255,66,80741,96,295366
2304,0.001473,172.217.194.0-255,1484,82225,96,295366
2305,0.001484,172.217.194.0-255,2902,85127,96,295366
2306,0.001489,172.31.47.0-255,66,85193,96,295366
2307,0.001496,172.217.194.0-255,2902,88095,96,295366
2308,0.001498,172.31.47.0-255,66,88161,96,295366
2309,0.001516,172.217.194.0-255,2902,91063,96,295366
2310,0.001518,172.31.47.0-255,66,91129,96,295366
2311,0.00153,172.217.194.0-255,5738,96867,96,295366
2312,0.001532,172.31.47.0-255,66,96933,96,295366
2313,0.001565,172.217.194.0-255,7156,104089,96,295366
2314,0.001567,172.31.47.0-255,66,104155,96,295366
2315,0.001579,172.31.47.0-255,66,104221,96,295366
2316,0.002068,172.217.194.0-255,1484,105705,96,295366
2317,0.002078,172.217.194.0-255,2902,108607,96,295366
2318,0.002083,172.31.47.0-255,66,108673,96,295366
2319,0.002089,172.217.194.0-255,2902,111575,96,295366
2320,0.002091,172.31.47.0-255,66,111641,96,295366
2321,0.002132,172.217.194.0-255,2902,114543,96,295366
2322,0.002134,172.31.47.0-255,66,114609,96,295366
2323,0.002151,172.31.47.0-255,66,114675,96,295366
2324,0.004223,172.217.194.0-255,4320,118995,96,295366
2325,0.00423,172.31.47.0-255,66,119061,96,295366
2326,0.004255,172.217.194.0-255,1484,120545,96,295366
2327,0.006292,172.217.194.0-255,4320,124865,96,295366
2328,0.006296,172.31.47.0-255,66,124931,96,295366
2329,0.008373,172.217.194.0-255,5738,130669,96,295366
2330,0.008379,172.31.47.0-255,66,130735,96,295366
2331,0.010494,172.217.194.0-255,5738,136473,96,295366
2332,0.010501,172.31.47.0-255,66,136539,96,295366
2333,0.012592,172.217.194.0-255,5738,142277,96,295366
2334,0.012601,172.31.47.0-255,66,142343,96,295366
2335,0.014689,172.217.194.0-255,5738,148081,96,295366
2336,0.014695,172.31.47.0-255,66,148147,96,295366
2337,0.016758,172.217.194.0-255,5738,153885,96,295366
2338,0.016766,172.31.47.0-255,66,153951,96,295366
2339,0.018843,172.217.194.0-255,5738,159689,96,295366
2340,0.018848,172.31.47.0-255,66,159755,96,295366
2341,0.020919,172.217.194.0-255,4320,164075,96,295366
2342,0.020923,172.31.47.0-255,66,164141,96,295366
2343,0.020952,172.217.194.0-255,1484,165625,96,295366
2344,0.023013,172.217.194.0-255,4320,169945,96,295366
2345,0.023022,172.31.47.0-255,66,170011,96,295366
2346,0.024533,172.31.47.0-255,172,170183,96,295366
2347,0.024561,172.31.47.0-255,1110,171293,96,295366
2348,0.024591,172.31.47.0-255,1514,172807,96,295366
2349,0.024593,172.31.47.0-255,1301,174108,96,295366
2350,0.025097,172.217.194.0-255,5738,179846,96,295366
2351,0.025102,172.31.47.0-255,66,179912,96,295366
2352,0.026057,104.244.42.0-255,66,179978,96,295366
2353,0.02609,104.244.42.0-255,66,180044,96,295366
2354,0.026148,104.244.42.0-255,66,180110,96,295366
2355,0.02719,172.217.194.0-255,4320,184430,96,295366
2356,0.027193,172.31.47.0-255,66,184496,96,295366
2357,0.027222,172.217.194.0-255,1484,185980,96,295366
2358,0.029239,172.217.194.0-255,4320,190300,96,295366
2359,0.029244,172.31.47.0-255,66,190366,96,295366
2360,0.031321,172.217.194.0-255,4320,194686,96,295366
2361,0.031326,172.31.47.0-255,66,194752,96,295366
2362,0.03136,172.217.194.0-255,1484,196236,96,295366
2363,0.033423,172.217.194.0-255,4320,200556,96,295366
2364,0.033428,172.31.47.0-255,66,200622,96,295366
2365,0.035492,172.217.194.0-255,5738,206360,96,295366
2366,0.035496,172.31.47.0-255,66,206426,96,295366
2367,0.037583,172.217.194.0-255,1484,207910,96,295366
2368,0.037613,172.217.194.0-255,4320,212230,96,295366
2369,0.037617,172.31.47.0-255,66,212296,96,295366
2370,0.039693,172.217.194.0-255,4320,216616,96,295366
2371,0.039698,172.31.47.0-255,66,216682,96,295366
2372,0.039725,172.217.194.0-255,1484,218166,96,295366
2373,0.041798,172.217.194.0-255,4320,222486,96,295366
2374,0.041802,172.31.47.0-255,66,222552,96,295366
2375,0.043878,172.217.194.0-255,5738,228290,96,295366
2376,0.043883,172.31.47.0-255,66,228356,96,295366
2377,0.045967,172.217.194.0-255,5738,234094,96,295366
2378,0.045972,172.31.47.0-255,66,234160,96,295366
2379,0.048045,172.217.194.0-255,5738,239898,96,295366
2380,0.04805,172.31.47.0-255,66,239964,96,295366
2381,0.05012,172.217.194.0-255,5738,245702,96,295366
2382,0.050125,172.31.47.0-255,66,245768,96,295366
2383,0.052185,172.217.194.0-255,5738,251506,96,295366
2384,0.05219,172.31.47.0-255,66,251572,96,295366
2385,0.054236,172.217.194.0-255,1484,253056,96,295366
2386,0.054265,172.217.194.0-255,4320,257376,96,295366
2387,0.054269,172.31.47.0-255,66,257442,96,295366
2388,0.05635,172.217.194.0-255,5738,263180,96,295366
2389,0.056355,172.31.47.0-255,66,263246,96,295366
2390,0.058447,172.217.194.0-255,4320,267566,96,295366
2391,0.058452,172.31.47.0-255,66,267632,96,295366
2392,0.058481,172.217.194.0-255,1484,269116,96,295366
2393,0.060527,172.217.194.0-255,4320,273436,96,295366
2394,0.060532,172.31.47.0-255,66,273502,96,295366
2395,0.062609,172.217.194.0-255,4320,277822,96,295366
2396,0.062614,172.31.47.0-255,66,277888,96,295366
2397,0.062638,172.217.194.0-255,1484,279372,96,295366
2398,0.064675,172.217.194.0-255,4320,283692,96,295366
2399,0.064679,172.31.47.0-255,66,283758,96,295366
2400,0.066784,172.217.194.0-255,5738,289496,96,295366
2401,0.066789,172.31.47.0-255,66,289562,96,295366
2402,0.068865,172.217.194.0-255,5738,295300,96,295366
2403,0.06887,172.31.47.0-255,66,295366,96,295366
2404,0.0,172.217.194.0-255,154,154,96,273499
2405,2.6e-05,172.31.47.0-255,66,220,96,273499
2406,3.4e-05,172.217.194.0-255,1484,1704,96,273499
2407,3.8e-05,172.31.47.0-255,66,1770,96,273499
2408,4.3e-05,172.217.194.0-255,2902,4672,96,273499
2409,4.6e-05,172.31.47.0-255,66,4738,96,273499
2410,6.3e-05,172.217.194.0-255,7156,11894,96,273499
2411,6.6e-05,172.31.47.0-255,66,11960,96,273499
2412,6.9e-05,172.217.194.0-255,1484,13444,96,273499
2413,7.3e-05,172.31.47.0-255,66,13510,96,273499
2414,7.6e-05,172.217.194.0-255,730,14240,96,273499
2415,7.9e-05,172.31.47.0-255,66,14306,96,273499
2416,0.000309,172.217.194.0-255,1484,15790,96,273499
2417,0.000315,172.31.47.0-255,66,15856,96,273499
2418,0.000321,172.217.194.0-255,2902,18758,96,273499
2419,0.000324,172.31.47.0-255,66,18824,96,273499
2420,0.000331,172.217.194.0-255,5738,24562,96,273499
2421,0.000339,172.31.47.0-255,66,24628,96,273499
2422,0.000346,172.217.194.0-255,5738,30366,96,273499
2423,0.000348,172.31.47.0-255,66,30432,96,273499
2424,0.000385,172.217.194.0-255,1125,31557,96,273499
2425,0.000387,172.31.47.0-255,66,31623,96,273499
2426,0.000426,172.217.194.0-255,1484,33107,96,273499
2427,0.000429,172.31.47.0-255,66,33173,96,273499
2428,0.000433,172.217.194.0-255,2902,36075,96,273499
2429,0.000436,172.31.47.0-255,66,36141,96,273499
2430,0.000439,172.217.194.0-255,1484,37625,96,273499
2431,0.000441,172.31.47.0-255,66,37691,96,273499
2432,0.000468,172.217.194.0-255,2902,40593,96,273499
2433,0.00047,172.31.47.0-255,66,40659,96,273499
2434,0.000481,172.31.47.0-255,66,40725,96,273499
2435,0.000522,172.217.194.0-255,342,41067,96,273499
2436,0.000591,172.217.194.0-255,119,41186,96,273499
2437,0.000605,172.217.194.0-255,382,41568,96,273499
2438,0.000614,172.31.47.0-255,66,41634,96,273499
2439,0.00087,172.217.194.0-255,1484,43118,96,273499
2440,0.000877,172.217.194.0-255,2902,46020,96,273499
2441,0.000886,172.31.47.0-255,66,46086,96,273499
2442,0.000898,172.217.194.0-255,5738,51824,96,273499
2443,0.000936,172.217.194.0-255,4320,56144,96,273499
2444,0.00096,172.217.194.0-255,1484,57628,96,273499
2445,0.000978,172.217.194.0-255,5020,62648,96,273499
2446,0.000983,172.31.47.0-255,66,62714,96,273499
2447,0.001506,172.217.194.0-255,1484,64198,96,273499
2448,0.001512,172.217.194.0-255,2902,67100,96,273499
2449,0.001515,172.31.47.0-255,66,67166,96,273499
2450,0.001523,172.217.194.0-255,5738,72904,96,273499
2451,0.001545,172.31.47.0-255,66,72970,96,273499
2452,0.001563,172.31.47.0-255,66,73036,96,273499
2453,0.001598,172.217.194.0-255,4320,77356,96,273499
2454,0.001624,172.217.194.0-255,4320,81676,96,273499
2455,0.001626,172.31.47.0-255,66,81742,96,273499
2456,0.00163,172.31.47.0-255,66,81808,96,273499
2457,0.001658,172.217.194.0-255,1484,83292,96,273499
2458,0.001665,172.217.194.0-255,7156,90448,96,273499
2459,0.001709,172.31.47.0-255,66,90514,96,273499
2460,0.001723,172.217.194.0-255,5738,96252,96,273499
2461,0.001745,172.31.47.0-255,66,96318,96,273499
2462,0.001776,172.217.194.0-255,2902,99220,96,273499
2463,0.00178,172.217.194.0-255,2184,101404,96,273499
2464,0.001803,172.217.194.0-255,2902,104306,96,273499
2465,0.001806,172.217.194.0-255,1484,105790,96,273499
2466,0.001819,172.217.194.0-255,5738,111528,96,273499
2467,0.001834,172.31.47.0-255,66,111594,96,273499
2468,0.001839,172.217.194.0-255,2902,114496,96,273499
2469,0.001843,172.31.47.0-255,66,114562,96,273499
2470,0.001878,172.217.194.0-255,1484,116046,96,273499
2471,0.001883,172.217.194.0-255,4320,120366,96,273499
2472,0.001906,172.217.194.0-255,2184,122550,96,273499
2473,0.001911,172.217.194.0-255,4320,126870,96,273499
2474,0.001916,172.31.47.0-255,66,126936,96,273499
2475,0.00193,172.217.194.0-255,2902,129838,96,273499
2476,0.001937,172.217.194.0-255,7156,136994,96,273499
2477,0.002017,172.31.47.0-255,66,137060,96,273499
2478,0.002034,172.31.47.0-255,66,137126,96,273499
2479,0.002112,172.217.194.0-255,1484,138610,96,273499
2480,0.002116,172.217.194.0-255,1484,140094,96,273499
2481,0.002127,172.217.194.0-255,1484,141578,96,273499
2482,0.002133,172.217.194.0-255,5738,147316,96,273499
2483,0.002136,172.31.47.0-255,66,147382,96,273499
2484,0.002148,172.31.47.0-255,66,147448,96,273499
2485,0.002206,172.217.194.0-255,5738,153186,96,273499
2486,0.002237,172.31.47.0-255,66,153252,96,273499
2487,0.002244,172.31.47.0-255,66,153318,96,273499
2488,0.004492,172.217.194.0-255,5738,159056,96,273499
2489,0.01184,172.217.194.0-255,1484,160540,96,273499
2490,0.011896,172.31.47.0-255,66,160606,96,273499
2491,0.014156,172.217.194.0-255,5738,166344,96,273499
2492,0.014174,172.31.47.0-255,66,166410,96,273499
2493,0.016439,172.217.194.0-255,5738,172148,96,273499
2494,0.020027,172.31.47.0-255,66,172214,96,273499
2495,0.02227,172.217.194.0-255,5738,177952,96,273499
2496,0.022282,172.31.47.0-255,66,178018,96,273499
2497,0.024531,172.217.194.0-255,5738,183756,96,273499
2498,0.027669,172.31.47.0-255,66,183822,96,273499
2499,0.02994,172.217.194.0-255,5738,189560,96,273499
2500,0.029951,172.31.47.0-255,66,189626,96,273499
2501,0.032202,172.217.194.0-255,5738,195364,96,273499
2502,0.03222,172.31.47.0-255,66,195430,96,273499
2503,0.034489,172.217.194.0-255,5738,201168,96,273499
2504,0.034508,172.31.47.0-255,66,201234,96,273499
2505,0.036757,172.217.194.0-255,5738,206972,96,273499
2506,0.036771,172.31.47.0-255,66,207038,96,273499
2507,0.039021,172.217.194.0-255,5738,212776,96,273499
2508,0.03904,172.31.47.0-255,66,212842,96,273499
2509,0.041312,172.217.194.0-255,5738,218580,96,273499
2510,0.041329,172.31.47.0-255,66,218646,96,273499
2511,0.043616,172.217.194.0-255,5738,224384,96,273499
2512,0.043636,172.31.47.0-255,66,224450,96,273499
2513,0.04591,172.217.194.0-255,5738,230188,96,273499
2514,0.045928,172.31.47.0-255,66,230254,96,273499
2515,0.048192,172.217.194.0-255,5738,235992,96,273499
2516,0.048209,172.31.47.0-255,66,236058,96,273499
2517,0.050473,172.217.194.0-255,5738,241796,96,273499
2518,0.050492,172.31.47.0-255,66,241862,96,273499
2519,0.052752,172.217.194.0-255,5738,247600,96,273499
2520,0.052769,172.31.47.0-255,66,247666,96,273499
2521,0.054105,172.31.47.0-255,171,247837,96,273499
2522,0.054145,172.31.47.0-255,1125,248962,96,273499
2523,0.054206,172.31.47.0-255,1514,250476,96,273499
2524,0.054208,172.31.47.0-255,1288,251764,96,273499
2525,0.055018,172.217.194.0-255,5738,257502,96,273499
2526,0.055034,172.31.47.0-255,66,257568,96,273499
2527,0.055662,104.244.42.0-255,66,257634,96,273499
2528,0.055702,104.244.42.0-255,66,257700,96,273499
2529,0.055746,104.244.42.0-255,66,257766,96,273499
2530,0.057316,172.217.194.0-255,5738,263504,96,273499
2531,0.057334,172.31.47.0-255,66,263570,96,273499
2532,0.059604,172.217.194.0-255,5738,269308,96,273499
2533,0.059624,172.31.47.0-255,66,269374,96,273499
2534,0.06189,172.217.194.0-255,3888,273262,96,273499
2535,0.06191,172.31.47.0-255,66,273328,96,273499
2536,0.062238,172.31.47.0-255,105,273433,96,273499
2537,0.064453,172.217.194.0-255,66,273499,96,273499
2538,0.0,172.217.194.0-255,153,153,96,251635
2539,2.5e-05,172.31.47.0-255,66,219,96,251635
2540,3.1e-05,172.217.194.0-255,1484,1703,96,251635
2541,3.4e-05,172.31.47.0-255,66,1769,96,251635
2542,3.7e-05,172.217.194.0-255,1484,3253,96,251635
2543,3.8e-05,172.31.47.0-255,66,3319,96,251635
2544,5.1e-05,172.217.194.0-255,1484,4803,96,251635
2545,5.3e-05,172.31.47.0-255,66,4869,96,251635
2546,6.1e-05,172.217.194.0-255,7156,12025,96,251635
2547,6.3e-05,172.31.47.0-255,66,12091,96,251635
2548,8.6e-05,172.217.194.0-255,2083,14174,96,251635
2549,8.7e-05,172.31.47.0-255,66,14240,96,251635
2550,0.000894,172.217.194.0-255,1484,15724,96,251635
2551,0.0009,172.31.47.0-255,66,15790,96,251635
2552,0.000909,172.217.194.0-255,2902,18692,96,251635
2553,0.000911,172.31.47.0-255,66,18758,96,251635
2554,0.000915,172.217.194.0-255,2902,21660,96,251635
2555,0.000916,172.31.47.0-255,66,21726,96,251635
2556,0.000934,172.217.194.0-255,2902,24628,96,251635
2557,0.000936,172.31.47.0-255,66,24694,96,251635
2558,0.00095,172.217.194.0-255,2902,27596,96,251635
2559,0.000951,172.31.47.0-255,66,27662,96,251635
2560,0.000972,172.217.194.0-255,3961,31623,96,251635
2561,0.000974,172.31.47.0-255,66,31689,96,251635
2562,0.001016,172.217.194.0-255,1484,33173,96,251635
2563,0.001018,172.31.47.0-255,66,33239,96,251635
2564,0.001033,172.217.194.0-255,5738,38977,96,251635
2565,0.001035,172.31.47.0-255,66,39043,96,251635
2566,0.001046,172.217.194.0-255,4320,43363,96,251635
2567,0.001048,172.31.47.0-255,66,43429,96,251635
2568,0.001062,172.217.194.0-255,2902,46331,96,251635
2569,0.001063,172.31.47.0-255,66,46397,96,251635
2570,0.001077,172.217.194.0-255,4320,50717,96,251635
2571,0.001078,172.31.47.0-255,66,50783,96,251635
2572,0.001121,172.31.47.0-255,66,50849,96,251635
2573,0.001138,172.217.194.0-255,1484,52333,96,251635
2574,0.00114,172.31.47.0-255,66,52399,96,251635
2575,0.001143,172.217.194.0-255,1484,53883,96,251635
2576,0.001144,172.31.47.0-255,66,53949,96,251635
2577,0.001157,172.217.194.0-255,2184,56133,96,251635
2578,0.001159,172.31.47.0-255,66,56199,96,251635
2579,0.001278,172.217.194.0-255,340,56539,96,251635
2580,0.00128,172.31.47.0-255,66,56605,96,251635
2581,0.001323,172.217.194.0-255,117,56722,96,251635
2582,0.001325,172.31.47.0-255,66,56788,96,251635
2583,0.001427,172.217.194.0-255,1484,58272,96,251635
2584,0.001429,172.31.47.0-255,66,58338,96,251635
2585,0.001449,172.217.194.0-255,1484,59822,96,251635
2586,0.00145,172.31.47.0-255,66,59888,96,251635
2587,0.001466,172.217.194.0-255,1484,61372,96,251635
2588,0.001467,172.31.47.0-255,66,61438,96,251635
2589,0.001478,172.217.194.0-255,2902,64340,96,251635
2590,0.00148,172.31.47.0-255,66,64406,96,251635
2591,0.001494,172.217.194.0-255,2902,67308,96,251635
2592,0.001496,172.31.47.0-255,66,67374,96,251635
2593,0.001513,172.217.194.0-255,1484,68858,96,251635
2594,0.001515,172.31.47.0-255,66,68924,96,251635
2595,0.001543,172.31.47.0-255,66,68990,96,251635
2596,0.001578,172.217.194.0-255,4320,73310,96,251635
2597,0.00158,172.31.47.0-255,66,73376,96,251635
2598,0.001596,172.217.194.0-255,1484,74860,96,251635
2599,0.001597,172.31.47.0-255,66,74926,96,251635
2600,0.001606,172.217.194.0-255,1484,76410,96,251635
2601,0.001608,172.31.47.0-255,66,76476,96,251635
2602,0.001626,172.217.194.0-255,3602,80078,96,251635
2603,0.001628,172.31.47.0-255,66,80144,96,251635
2604,0.003882,172.217.194.0-255,1484,81628,96,251635
2605,0.003887,172.31.47.0-255,66,81694,96,251635
2606,0.003913,172.217.194.0-255,4320,86014,96,251635
2607,0.00393,172.31.47.0-255,66,86080,96,251635
2608,0.006162,172.217.194.0-255,1484,87564,96,251635
2609,0.006169,172.31.47.0-255,66,87630,96,251635
2610,0.006206,172.217.194.0-255,4320,91950,96,251635
2611,0.006208,172.31.47.0-255,66,92016,96,251635
2612,0.008502,172.217.194.0-255,5738,97754,96,251635
2613,0.008509,172.31.47.0-255,66,97820,96,251635
2614,0.010786,172.217.194.0-255,5738,103558,96,251635
2615,0.010793,172.31.47.0-255,66,103624,96,251635
2616,0.013106,172.217.194.0-255,5738,109362,96,251635
2617,0.013115,172.31.47.0-255,66,109428,96,251635
2618,0.015397,172.217.194.0-255,5738,115166,96,251635
2619,0.015404,172.31.47.0-255,66,115232,96,251635
2620,0.017707,172.217.194.0-255,5738,120970,96,251635
2621,0.017712,172.31.47.0-255,66,121036,96,251635
2622,0.0193,172.31.47.0-255,172,121208,96,251635
2623,0.01933,172.31.47.0-255,1110,122318,96,251635
2624,0.019367,172.31.47.0-255,1514,123832,96,251635
2625,0.019369,172.31.47.0-255,1301,125133,96,251635
2626,0.019992,172.217.194.0-255,5738,130871,96,251635
2627,0.019999,172.31.47.0-255,66,130937,96,251635
2628,0.020837,104.244.42.0-255,66,131003,96,251635
2629,0.020858,104.244.42.0-255,66,131069,96,251635
2630,0.020977,104.244.42.0-255,66,131135,96,251635
2631,0.022279,172.217.194.0-255,4320,135455,96,251635
2632,0.022283,172.31.47.0-255,66,135521,96,251635
2633,0.022311,172.217.194.0-255,1484,137005,96,251635
2634,0.024571,172.217.194.0-255,4320,141325,96,251635
2635,0.024577,172.31.47.0-255,66,141391,96,251635
2636,0.026838,172.217.194.0-255,5738,147129,96,251635
2637,0.026843,172.31.47.0-255,66,147195,96,251635
2638,0.029191,172.217.194.0-255,2902,150097,96,251635
2639,0.029196,172.31.47.0-255,66,150163,96,251635
2640,0.029226,172.217.194.0-255,2902,153065,96,251635
2641,0.029229,172.31.47.0-255,66,153131,96,251635
2642,0.031474,172.217.194.0-255,2902,156033,96,251635
2643,0.031479,172.31.47.0-255,66,156099,96,251635
2644,0.031521,172.217.194.0-255,2902,159001,96,251635
2645,0.031523,172.31.47.0-255,66,159067,96,251635
2646,0.03373,172.217.194.0-255,2902,161969,96,251635
2647,0.033734,172.31.47.0-255,66,162035,96,251635
2648,0.033809,172.217.194.0-255,2902,164937,96,251635
2649,0.033813,172.31.47.0-255,66,165003,96,251635
2650,0.036001,172.217.194.0-255,2902,167905,96,251635
2651,0.036005,172.31.47.0-255,66,167971,96,251635
2652,0.036105,172.217.194.0-255,2902,170873,96,251635
2653,0.03611,172.31.47.0-255,66,170939,96,251635
2654,0.038298,172.217.194.0-255,2902,173841,96,251635
2655,0.038304,172.31.47.0-255,66,173907,96,251635
2656,0.038363,172.217.194.0-255,1484,175391,96,251635
2657,0.038378,172.217.194.0-255,1484,176875,96,251635
2658,0.038382,172.31.47.0-255,66,176941,96,251635
2659,0.040606,172.217.194.0-255,2902,179843,96,251635
2660,0.040611,172.31.47.0-255,66,179909,96,251635
2661,0.040656,172.217.194.0-255,1484,181393,96,251635
2662,0.040667,172.217.194.0-255,1484,182877,96,251635
2663,0.04067,172.31.47.0-255,66,182943,96,251635
2664,0.042899,172.217.194.0-255,2902,185845,96,251635
2665,0.042906,172.31.47.0-255,66,185911,96,251635
2666,0.042938,172.217.194.0-255,2902,188813,96,251635
2667,0.04294,172.31.47.0-255,66,188879,96,251635
2668,0.045188,172.217.194.0-255,2902,191781,96,251635
2669,0.045195,172.31.47.0-255,66,191847,96,251635
2670,0.045217,172.217.194.0-255,2902,194749,96,251635
2671,0.045221,172.31.47.0-255,66,194815,96,251635
2672,0.047506,172.217.194.0-255,5738,200553,96,251635
2673,0.047513,172.31.47.0-255,66,200619,96,251635
2674,0.049813,172.217.194.0-255,5738,206357,96,251635
2675,0.049818,172.31.47.0-255,66,206423,96,251635
2676,0.05212,172.217.194.0-255,5738,212161,96,251635
2677,0.052125,172.31.47.0-255,66,212227,96,251635
2678,0.054419,172.217.194.0-255,5738,217965,96,251635
2679,0.054424,172.31.47.0-255,66,218031,96,251635
2680,0.056695,172.217.194.0-255,1484,219515,96,251635
2681,0.056718,172.217.194.0-255,4320,223835,96,251635
2682,0.056722,172.31.47.0-255,66,223901,96,251635
2683,0.059045,172.217.194.0-255,5738,229639,96,251635
2684,0.059052,172.31.47.0-255,66,229705,96,251635
2685,0.061362,172.217.194.0-255,5738,235443,96,251635
2686,0.061366,172.31.47.0-255,66,235509,96,251635
2687,0.063652,172.217.194.0-255,4320,239829,96,251635
2688,0.063658,172.31.47.0-255,66,239895,96,251635
2689,0.063686,172.217.194.0-255,1484,241379,96,251635
2690,0.065936,172.217.194.0-255,4320,245699,96,251635
2691,0.06594,172.31.47.0-255,66,245765,96,251635
2692,0.068195,172.217.194.0-255,4320,250085,96,251635
2693,0.0682,172.31.47.0-255,66,250151,96,251635
2694,0.068229,172.217.194.0-255,1484,251635,96,251635
2695,0.0,74.125.24.0-255,153,153,96,331531
2696,2.5e-05,172.31.47.0-255,66,219,96,331531
2697,3.1e-05,74.125.24.0-255,1484,1703,96,331531
2698,3.5e-05,172.31.47.0-255,66,1769,96,331531
2699,4e-05,74.125.24.0-255,2902,4671,96,331531
2700,4.2e-05,172.31.47.0-255,66,4737,96,331531
2701,7e-05,74.125.24.0-255,5738,10475,96,331531
2702,7.4e-05,172.31.47.0-255,66,10541,96,331531
2703,9.5e-05,74.125.24.0-255,3557,14098,96,331531
2704,9.8e-05,172.31.47.0-255,66,14164,96,331531
2705,0.000134,74.125.24.0-255,4320,18484,96,331531
2706,0.000137,172.31.47.0-255,66,18550,96,331531
2707,0.000156,74.125.24.0-255,4320,22870,96,331531
2708,0.00016,172.31.47.0-255,66,22936,96,331531
2709,0.000214,74.125.24.0-255,5738,28674,96,331531
2710,0.000217,172.31.47.0-255,66,28740,96,331531
2711,0.000235,74.125.24.0-255,2543,31283,96,331531
2712,0.000237,172.31.47.0-255,66,31349,96,331531
2713,0.000314,74.125.24.0-255,1484,32833,96,331531
2714,0.000319,172.31.47.0-255,66,32899,96,331531
2715,0.000324,74.125.24.0-255,2902,35801,96,331531
2716,0.000326,172.31.47.0-255,66,35867,96,331531
2717,0.00035,74.125.24.0-255,5738,41605,96,331531
2718,0.000354,172.31.47.0-255,66,41671,96,331531
2719,0.000359,74.125.24.0-255,4320,45991,96,331531
2720,0.000362,172.31.47.0-255,66,46057,96,331531
2721,0.000375,74.125.24.0-255,2543,48600,96,331531
2722,0.000377,172.31.47.0-255,66,48666,96,331531
2723,0.000416,74.125.24.0-255,1484,50150,96,331531
2724,0.000419,172.31.47.0-255,66,50216,96,331531
2725,0.000424,74.125.24.0-255,2902,53118,96,331531
2726,0.000426,172.31.47.0-255,66,53184,96,331531
2727,0.000444,74.125.24.0-255,5738,58922,96,331531
2728,0.000447,172.31.47.0-255,66,58988,96,331531
2729,0.000454,74.125.24.0-255,7127,66115,96,331531
2730,0.000456,172.31.47.0-255,66,66181,96,331531
2731,0.000483,74.125.24.0-255,379,66560,96,331531
2732,0.000487,172.31.47.0-255,66,66626,96,331531
2733,0.000673,74.125.24.0-255,1484,68110,96,331531
2734,0.000677,172.31.47.0-255,66,68176,96,331531
2735,0.000682,74.125.24.0-255,2902,71078,96,331531
2736,0.000685,172.31.47.0-255,66,71144,96,331531
2737,0.000691,74.125.24.0-255,5738,76882,96,331531
2738,0.000693,172.31.47.0-255,66,76948,96,331531
2739,0.000718,74.125.24.0-255,5738,82686,96,331531
2740,0.000721,172.31.47.0-255,66,82752,96,331531
2741,0.000758,74.125.24.0-255,4320,87072,96,331531
2742,0.000761,172.31.47.0-255,66,87138,96,331531
2743,0.00078,74.125.24.0-255,5379,92517,96,331531
2744,0.000783,172.31.47.0-255,66,92583,96,331531
2745,0.000809,74.125.24.0-255,2902,95485,96,331531
2746,0.000812,172.31.47.0-255,66,95551,96,331531
2747,0.000827,74.125.24.0-255,5379,100930,96,331531
2748,0.00083,172.31.47.0-255,66,100996,96,331531
2749,0.001202,74.125.24.0-255,1484,102480,96,331531
2750,0.001206,74.125.24.0-255,1484,103964,96,331531
2751,0.001208,172.31.47.0-255,66,104030,96,331531
2752,0.001211,172.31.47.0-255,66,104096,96,331531
2753,0.001228,74.125.24.0-255,1484,105580,96,331531
2754,0.00123,172.31.47.0-255,66,105646,96,331531
2755,0.001236,74.125.24.0-255,5738,111384,96,331531
2756,0.001238,172.31.47.0-255,66,111450,96,331531
2757,0.001243,74.125.24.0-255,4320,115770,96,331531
2758,0.001245,172.31.47.0-255,66,115836,96,331531
2759,0.001272,172.31.47.0-255,66,115902,96,331531
2760,0.001305,172.31.47.0-255,66,115968,96,331531
2761,0.001466,74.125.24.0-255,1484,117452,96,331531
2762,0.001471,172.31.47.0-255,66,117518,96,331531
2763,0.001475,74.125.24.0-255,1484,119002,96,331531
2764,0.001478,172.31.47.0-255,66,119068,96,331531
2765,0.001493,74.125.24.0-255,1484,120552,96,331531
2766,0.001495,172.31.47.0-255,66,120618,96,331531
2767,0.001502,74.125.24.0-255,5738,126356,96,331531
2768,0.001504,172.31.47.0-255,66,126422,96,331531
2769,0.00152,74.125.24.0-255,7156,133578,96,331531
2770,0.001523,172.31.47.0-255,66,133644,96,331531
2771,0.001548,172.31.47.0-255,66,133710,96,331531
2772,0.001582,172.31.47.0-255,66,133776,96,331531
2773,0.001623,74.125.24.0-255,1484,135260,96,331531
2774,0.001626,172.31.47.0-255,66,135326,96,331531
2775,0.00163,74.125.24.0-255,2902,138228,96,331531
2776,0.001631,172.31.47.0-255,66,138294,96,331531
2777,0.001643,74.125.24.0-255,2902,141196,96,331531
2778,0.001646,172.31.47.0-255,66,141262,96,331531
2779,0.001661,74.125.24.0-255,2902,144164,96,331531
2780,0.001663,172.31.47.0-255,66,144230,96,331531
2781,0.001668,74.125.24.0-255,4320,148550,96,331531
2782,0.00167,172.31.47.0-255,66,148616,96,331531
2783,0.001707,172.31.47.0-255,66,148682,96,331531
2784,0.00172,172.31.47.0-255,66,148748,96,331531
2785,0.001724,74.125.24.0-255,2902,151650,96,331531
2786,0.001733,172.31.47.0-255,66,151716,96,331531
2787,0.001744,74.125.24.0-255,3602,155318,96,331531
2788,0.00175,74.125.24.0-255,7156,162474,96,331531
2789,0.001762,172.31.47.0-255,66,162540,96,331531
2790,0.00182,172.31.47.0-255,66,162606,96,331531
2791,0.001839,172.31.47.0-255,66,162672,96,331531
2792,0.001852,74.125.24.0-255,2184,164856,96,331531
2793,0.001869,74.125.24.0-255,5738,170594,96,331531
2794,0.001869,172.31.47.0-255,66,170660,96,331531
2795,0.001873,172.31.47.0-255,66,170726,96,331531
2796,0.001895,74.125.24.0-255,5738,176464,96,331531
2797,0.001905,172.31.47.0-255,66,176530,96,331531
2798,0.001909,172.31.47.0-255,66,176596,96,331531
2799,0.002251,74.125.24.0-255,1484,178080,96,331531
2800,0.002265,74.125.24.0-255,2902,180982,96,331531
2801,0.002268,172.31.47.0-255,66,181048,96,331531
2802,0.002272,74.125.24.0-255,1484,182532,96,331531
2803,0.002292,74.125.24.0-255,4320,186852,96,331531
2804,0.002304,172.31.47.0-255,66,186918,96,331531
2805,0.002307,74.125.24.0-255,2902,189820,96,331531
2806,0.002316,172.31.47.0-255,66,189886,96,331531
2807,0.002327,74.125.24.0-255,5738,195624,96,331531
2808,0.00233,172.31.47.0-255,66,195690,96,331531
2809,0.002355,74.125.24.0-255,2902,198592,96,331531
2810,0.002359,172.31.47.0-255,66,198658,96,331531
2811,0.004628,74.125.24.0-255,2902,201560,96,331531
2812,0.004647,172.31.47.0-255,66,201626,96,331531
2813,0.004669,74.125.24.0-255,2902,204528,96,331531
2814,0.004673,172.31.47.0-255,66,204594,96,331531
2815,0.006958,74.125.24.0-255,5738,210332,96,331531
2816,0.012388,172.31.47.0-255,66,210398,96,331531
2817,0.013989,74.125.24.0-255,1484,211882,96,331531
2818,0.013998,172.31.47.0-255,66,211948,96,331531
2819,0.014669,74.125.24.0-255,4320,216268,96,331531
2820,0.014674,172.31.47.0-255,66,216334,96,331531
2821,0.016289,74.125.24.0-255,1484,217818,96,331531
2822,0.016295,172.31.47.0-255,66,217884,96,331531
2823,0.016993,74.125.24.0-255,4320,222204,96,331531
2824,0.018561,74.125.24.0-255,1484,223688,96,331531
2825,0.019265,172.31.47.0-255,66,223754,96,331531
2826,0.021555,74.125.24.0-255,5738,229492,96,331531
2827,0.021568,172.31.47.0-255,66,229558,96,331531
2828,0.023831,74.125.24.0-255,1484,231042,96,331531
2829,0.023839,172.31.47.0-255,66,231108,96,331531
2830,0.023859,74.125.24.0-255,4320,235428,96,331531
2831,0.02542,172.31.47.0-255,66,235494,96,331531
2832,0.026124,74.125.24.0-255,1484,236978,96,331531
2833,0.02613,172.31.47.0-255,66,237044,96,331531
2834,0.027692,74.125.24.0-255,4320,241364,96,331531
2835,0.027737,172.31.47.0-255,66,241430,96,331531
2836,0.028409,74.125.24.0-255,1484,242914,96,331531
2837,0.030033,74.125.24.0-255,4320,247234,96,331531
2838,0.030048,172.31.47.0-255,66,247300,96,331531
2839,0.032326,74.125.24.0-255,1484,248784,96,331531
2840,0.032359,74.125.24.0-255,4320,253104,96,331531
2841,0.032376,172.31.47.0-255,66,253170,96,331531
2842,0.03467,74.125.24.0-255,5738,258908,96,331531
2843,0.034677,172.31.47.0-255,66,258974,96,331531
2844,0.037007,74.125.24.0-255,5738,264712,96,331531
2845,0.037025,172.31.47.0-255,66,264778,96,331531
2846,0.039316,74.125.24.0-255,2902,267680,96,331531
2847,0.039322,172.31.47.0-255,66,267746,96,331531
2848,0.039354,74.125.24.0-255,2902,270648,96,331531
2849,0.039373,172.31.47.0-255,66,270714,96,331531
2850,0.041595,74.125.24.0-255,2902,273616,96,331531
2851,0.041602,172.31.47.0-255,66,273682,96,331531
2852,0.04164,74.125.24.0-255,1484,275166,96,331531
2853,0.041653,74.125.24.0-255,1484,276650,96,331531
2854,0.041668,172.31.47.0-255,66,276716,96,331531
2855,0.043938,74.125.24.0-255,4320,281036,96,331531
2856,0.043957,172.31.47.0-255,66,281102,96,331531
2857,0.044014,74.125.24.0-255,1484,282586,96,331531
2858,0.046222,74.125.24.0-255,4320,286906,96,331531
2859,0.046228,172.31.47.0-255,66,286972,96,331531
2860,0.048541,74.125.24.0-255,5738,292710,96,331531
2861,0.048669,172.31.47.0-255,172,292882,96,331531
2862,0.048699,172.31.47.0-255,1101,293983,96,331531
2863,0.048731,172.31.47.0-255,1514,295497,96,331531
2864,0.048732,172.31.47.0-255,1514,297011,96,331531
2865,0.048734,172.31.47.0-255,1514,298525,96,331531
2866,0.048735,172.31.47.0-255,1091,299616,96,331531
2867,0.048756,172.31.47.0-255,66,299682,96,331531
2868,0.050207,104.244.42.0-255,66,299748,96,331531
2869,0.050249,104.244.42.0-255,66,299814,96,331531
2870,0.050291,104.244.42.0-255,66,299880,96,331531
2871,0.050293,104.244.42.0-255,66,299946,96,331531
2872,0.05104,74.125.24.0-255,5738,305684,96,331531
2873,0.051046,172.31.47.0-255,66,305750,96,331531
2874,0.053535,74.125.24.0-255,5738,311488,96,331531
2875,0.053549,172.31.47.0-255,66,311554,96,331531
2876,0.055852,74.125.24.0-255,5738,317292,96,331531
2877,0.055868,172.31.47.0-255,66,317358,96,331531
2878,0.05818,74.125.24.0-255,5738,323096,96,331531
2879,0.058195,172.31.47.0-255,66,323162,96,331531
2880,0.060522,74.125.24.0-255,5738,328900,96,331531
2881,0.06054,172.31.47.0-255,66,328966,96,331531
2882,0.062872,74.125.24.0-255,2328,331294,96,331531
2883,0.062885,172.31.47.0-255,66,331360,96,331531
2884,0.063134,172.31.47.0-255,105,331465,96,331531
2885,0.065345,74.125.24.0-255,66,331531,96,331531
2886,0.0,74.125.24.0-255,153,153,96,275574
2887,3.1e-05,172.31.47.0-255,66,219,96,275574
2888,3.8e-05,74.125.24.0-255,1484,1703,96,275574
2889,4.2e-05,172.31.47.0-255,66,1769,96,275574
2890,4.7e-05,74.125.24.0-255,2902,4671,96,275574
2891,5.7e-05,172.31.47.0-255,66,4737,96,275574
2892,8.7e-05,74.125.24.0-255,4320,9057,96,275574
2893,9e-05,172.31.47.0-255,66,9123,96,275574
2894,9.3e-05,74.125.24.0-255,1484,10607,96,275574
2895,9.5e-05,172.31.47.0-255,66,10673,96,275574
2896,0.00013,172.31.47.0-255,66,10739,96,275574
2897,0.000137,74.125.24.0-255,7156,17895,96,275574
2898,0.000139,172.31.47.0-255,66,17961,96,275574
2899,0.000194,74.125.24.0-255,5379,23340,96,275574
2900,0.000197,172.31.47.0-255,66,23406,96,275574
2901,0.000221,74.125.24.0-255,1484,24890,96,275574
2902,0.000224,172.31.47.0-255,66,24956,96,275574
2903,0.000229,74.125.24.0-255,2902,27858,96,275574
2904,0.000231,172.31.47.0-255,66,27924,96,275574
2905,0.000259,74.125.24.0-255,5738,33662,96,275574
2906,0.000263,172.31.47.0-255,66,33728,96,275574
2907,0.000266,74.125.24.0-255,1484,35212,96,275574
2908,0.00027,172.31.47.0-255,66,35278,96,275574
2909,0.000302,74.125.24.0-255,5379,40657,96,275574
2910,0.000305,172.31.47.0-255,66,40723,96,275574
2911,0.000666,74.125.24.0-255,1484,42207,96,275574
2912,0.000671,172.31.47.0-255,66,42273,96,275574
2913,0.000679,74.125.24.0-255,2902,45175,96,275574
2914,0.000681,172.31.47.0-255,66,45241,96,275574
2915,0.000694,74.125.24.0-255,5738,50979,96,275574
2916,0.000696,172.31.47.0-255,66,51045,96,275574
2917,0.000745,74.125.24.0-255,6797,57842,96,275574
2918,0.000749,172.31.47.0-255,66,57908,96,275574
2919,0.001291,74.125.24.0-255,1484,59392,96,275574
2920,0.001318,74.125.24.0-255,2902,62294,96,275574
2921,0.001323,172.31.47.0-255,66,62360,96,275574
2922,0.001329,74.125.24.0-255,4320,66680,96,275574
2923,0.001331,172.31.47.0-255,66,66746,96,275574
2924,0.001363,172.31.47.0-255,66,66812,96,275574
2925,0.00139,74.125.24.0-255,2902,69714,96,275574
2926,0.001392,172.31.47.0-255,66,69780,96,275574
2927,0.001423,172.31.47.0-255,66,69846,96,275574
2928,0.001448,74.125.24.0-255,766,70612,96,275574
2929,0.001678,172.31.47.0-255,66,70678,96,275574
2930,0.00187,74.125.24.0-255,1484,72162,96,275574
2931,0.001877,74.125.24.0-255,2902,75064,96,275574
2932,0.00188,172.31.47.0-255,66,75130,96,275574
2933,0.001891,74.125.24.0-255,1484,76614,96,275574
2934,0.00191,74.125.24.0-255,4320,80934,96,275574
2935,0.001913,172.31.47.0-255,66,81000,96,275574
2936,0.001949,74.125.24.0-255,4320,85320,96,275574
2937,0.001951,172.31.47.0-255,66,85386,96,275574
2938,0.001968,74.125.24.0-255,2902,88288,96,275574
2939,0.00197,172.31.47.0-255,66,88354,96,275574
2940,0.001979,172.31.47.0-255,66,88420,96,275574
2941,0.002012,172.31.47.0-255,66,88486,96,275574
2942,0.004082,74.125.24.0-255,4320,92806,96,275574
2943,0.004086,172.31.47.0-255,66,92872,96,275574
2944,0.004113,74.125.24.0-255,1484,94356,96,275574
2945,0.006166,74.125.24.0-255,4320,98676,96,275574
2946,0.006172,172.31.47.0-255,66,98742,96,275574
2947,0.008277,74.125.24.0-255,5738,104480,96,275574
2948,0.008284,172.31.47.0-255,66,104546,96,275574
2949,0.010381,74.125.24.0-255,5738,110284,96,275574
2950,0.010387,172.31.47.0-255,66,110350,96,275574
2951,0.01247,74.125.24.0-255,5738,116088,96,275574
2952,0.012482,172.31.47.0-255,66,116154,96,275574
2953,0.014611,74.125.24.0-255,5738,121892,96,275574
2954,0.01462,172.31.47.0-255,66,121958,96,275574
2955,0.01669,74.125.24.0-255,5738,127696,96,275574
2956,0.016698,172.31.47.0-255,66,127762,96,275574
2957,0.018778,74.125.24.0-255,5738,133500,96,275574
2958,0.018785,172.31.47.0-255,66,133566,96,275574
2959,0.020864,74.125.24.0-255,5738,139304,96,275574
2960,0.020871,172.31.47.0-255,66,139370,96,275574
2961,0.022959,74.125.24.0-255,5738,145108,96,275574
2962,0.022969,172.31.47.0-255,66,145174,96,275574
2963,0.025031,74.125.24.0-255,5738,150912,96,275574
2964,0.025038,172.31.47.0-255,66,150978,96,275574
2965,0.025378,172.31.47.0-255,171,151149,96,275574
2966,0.025416,172.31.47.0-255,1134,152283,96,275574
2967,0.025485,172.31.47.0-255,1514,153797,96,275574
2968,0.025487,172.31.47.0-255,1277,155074,96,275574
2969,0.026947,104.244.42.0-255,66,155140,96,275574
2970,0.027001,104.244.42.0-255,66,155206,96,275574
2971,0.027053,104.244.42.0-255,66,155272,96,275574
2972,0.027116,74.125.24.0-255,5738,161010,96,275574
2973,0.027119,172.31.47.0-255,66,161076,96,275574
2974,0.029213,74.125.24.0-255,5738,166814,96,275574
2975,0.029218,172.31.47.0-255,66,166880,96,275574
2976,0.031336,74.125.24.0-255,4320,171200,96,275574
2977,0.031342,172.31.47.0-255,66,171266,96,275574
2978,0.031376,74.125.24.0-255,1484,172750,96,275574
2979,0.033421,74.125.24.0-255,4320,177070,96,275574
2980,0.033427,172.31.47.0-255,66,177136,96,275574
2981,0.035517,74.125.24.0-255,5738,182874,96,275574
2982,0.035522,172.31.47.0-255,66,182940,96,275574
2983,0.03759,74.125.24.0-255,2902,185842,96,275574
2984,0.037596,172.31.47.0-255,66,185908,96,275574
2985,0.037627,74.125.24.0-255,2902,188810,96,275574
2986,0.03763,172.31.47.0-255,66,188876,96,275574
2987,0.039664,74.125.24.0-255,2902,191778,96,275574
2988,0.03967,172.31.47.0-255,66,191844,96,275574
2989,0.039731,74.125.24.0-255,2902,194746,96,275574
2990,0.039735,172.31.47.0-255,66,194812,96,275574
2991,0.041762,74.125.24.0-255,2902,197714,96,275574
2992,0.041767,172.31.47.0-255,66,197780,96,275574
2993,0.041808,74.125.24.0-255,2902,200682,96,275574
2994,0.041812,172.31.47.0-255,66,200748,96,275574
2995,0.043847,74.125.24.0-255,2902,203650,96,275574
2996,0.043852,172.31.47.0-255,66,203716,96,275574
2997,0.043908,74.125.24.0-255,2902,206618,96,275574
2998,0.043911,172.31.47.0-255,66,206684,96,275574
2999,0.045954,74.125.24.0-255,2902,209586,96,275574
3000,0.045959,172.31.47.0-255,66,209652,96,275574
3001,0.046015,74.125.24.0-255,2902,212554,96,275574
3002,0.046019,172.31.47.0-255,66,212620,96,275574
3003,0.048037,74.125.24.0-255,2902,215522,96,275574
3004,0.048043,172.31.47.0-255,66,215588,96,275574
3005,0.048091,74.125.24.0-255,2902,218490,96,275574
3006,0.048096,172.31.47.0-255,66,218556,96,275574
3007,0.050119,74.125.24.0-255,2902,221458,96,275574
3008,0.050124,172.31.47.0-255,66,221524,96,275574
3009,0.050154,74.125.24.0-255,1484,223008,96,275574
3010,0.05017,74.125.24.0-255,1484,224492,96,275574
3011,0.050173,172.31.47.0-255,66,224558,96,275574
3012,0.052249,74.125.24.0-255,2902,227460,96,275574
3013,0.052254,172.31.47.0-255,66,227526,96,275574
3014,0.052276,74.125.24.0-255,2902,230428,96,275574
3015,0.052279,172.31.47.0-255,66,230494,96,275574
3016,0.054366,74.125.24.0-255,5738,236232,96,275574
3017,0.054374,172.31.47.0-255,66,236298,96,275574
3018,0.056477,74.125.24.0-255,5738,242036,96,275574
3019,0.056485,172.31.47.0-255,66,242102,96,275574
3020,0.058566,74.125.24.0-255,5738,247840,96,275574
3021,0.058571,172.31.47.0-255,66,247906,96,275574
3022,0.060657,74.125.24.0-255,5738,253644,96,275574
3023,0.060663,172.31.47.0-255,66,253710,96,275574
3024,0.062753,74.125.24.0-255,5738,259448,96,275574
3025,0.062758,172.31.47.0-255,66,259514,96,275574
3026,0.064882,74.125.24.0-255,5738,265252,96,275574
3027,0.064887,172.31.47.0-255,66,265318,96,275574
3028,0.066971,74.125.24.0-255,4320,269638,96,275574
3029,0.066976,172.31.47.0-255,66,269704,96,275574
3030,0.067007,74.125.24.0-255,1484,271188,96,275574
3031,0.069048,74.125.24.0-255,4320,275508,96,275574
3032,0.069053,172.31.47.0-255,66,275574,96,275574
3033,0.0,74.125.24.0-255,152,152,96,270038
3034,3.2e-05,172.31.47.0-255,66,218,96,270038
3035,3.9e-05,74.125.24.0-255,1484,1702,96,270038
3036,4.3e-05,172.31.47.0-255,66,1768,96,270038
3037,4.8e-05,74.125.24.0-255,2902,4670,96,270038
3038,5.1e-05,172.31.47.0-255,66,4736,96,270038
3039,5.8e-05,74.125.24.0-255,7156,11892,96,270038
3040,6.1e-05,172.31.47.0-255,66,11958,96,270038
3041,9.4e-05,172.31.47.0-255,66,12024,96,270038
3042,0.000105,172.31.47.0-255,66,12090,96,270038
3043,0.000247,74.125.24.0-255,1484,13574,96,270038
3044,0.000251,172.31.47.0-255,66,13640,96,270038
3045,0.000255,74.125.24.0-255,1484,15124,96,270038
3046,0.000256,172.31.47.0-255,66,15190,96,270038
3047,0.000272,74.125.24.0-255,1484,16674,96,270038
3048,0.000276,172.31.47.0-255,66,16740,96,270038
3049,0.000282,74.125.24.0-255,5738,22478,96,270038
3050,0.000285,172.31.47.0-255,66,22544,96,270038
3051,0.000339,172.31.47.0-255,66,22610,96,270038
3052,0.000351,172.31.47.0-255,66,22676,96,270038
3053,0.000372,74.125.24.0-255,361,23037,96,270038
3054,0.000374,172.31.47.0-255,66,23103,96,270038
3055,0.000414,74.125.24.0-255,131,23234,96,270038
3056,0.000416,172.31.47.0-255,66,23300,96,270038
3057,0.000894,74.125.24.0-255,347,23647,96,270038
3058,0.000898,172.31.47.0-255,66,23713,96,270038
3059,0.00118,74.125.24.0-255,1484,25197,96,270038
3060,0.001185,172.31.47.0-255,66,25263,96,270038
3061,0.00119,74.125.24.0-255,2902,28165,96,270038
3062,0.001192,172.31.47.0-255,66,28231,96,270038
3063,0.001212,74.125.24.0-255,5738,33969,96,270038
3064,0.001214,172.31.47.0-255,66,34035,96,270038
3065,0.001229,74.125.24.0-255,5738,39773,96,270038
3066,0.001232,172.31.47.0-255,66,39839,96,270038
3067,0.001258,74.125.24.0-255,7156,46995,96,270038
3068,0.00126,172.31.47.0-255,66,47061,96,270038
3069,0.001263,74.125.24.0-255,1484,48545,96,270038
3070,0.001265,172.31.47.0-255,66,48611,96,270038
3071,0.001296,172.31.47.0-255,66,48677,96,270038
3072,0.001305,74.125.24.0-255,766,49443,96,270038
3073,0.001307,172.31.47.0-255,66,49509,96,270038
3074,0.001803,74.125.24.0-255,1484,50993,96,270038
3075,0.001805,172.31.47.0-255,66,51059,96,270038
3076,0.001823,74.125.24.0-255,2902,53961,96,270038
3077,0.001824,172.31.47.0-255,66,54027,96,270038
3078,0.001844,74.125.24.0-255,5738,59765,96,270038
3079,0.001845,172.31.47.0-255,66,59831,96,270038
3080,0.001848,74.125.24.0-255,1484,61315,96,270038
3081,0.001883,74.125.24.0-255,1484,62799,96,270038
3082,0.001941,74.125.24.0-255,1484,64283,96,270038
3083,0.001952,74.125.24.0-255,2902,67185,96,270038
3084,0.001964,74.125.24.0-255,1484,68669,96,270038
3085,0.001978,74.125.24.0-255,4320,72989,96,270038
3086,0.001986,74.125.24.0-255,1484,74473,96,270038
3087,0.001995,74.125.24.0-255,4320,78793,96,270038
3088,0.002006,74.125.24.0-255,2902,81695,96,270038
3089,0.002036,74.125.24.0-255,1484,83179,96,270038
3090,0.002857,172.31.47.0-255,66,83245,96,270038
3091,0.004872,74.125.24.0-255,5738,88983,96,270038
3092,0.004876,172.31.47.0-255,66,89049,96,270038
3093,0.006907,74.125.24.0-255,5738,94787,96,270038
3094,0.006913,172.31.47.0-255,66,94853,96,270038
3095,0.008932,74.125.24.0-255,5738,100591,96,270038
3096,0.00894,172.31.47.0-255,66,100657,96,270038
3097,0.010993,74.125.24.0-255,4320,104977,96,270038
3098,0.011,172.31.47.0-255,66,105043,96,270038
3099,0.011014,74.125.24.0-255,1484,106527,96,270038
3100,0.013016,74.125.24.0-255,4320,110847,96,270038
3101,0.013024,172.31.47.0-255,66,110913,96,270038
3102,0.015083,74.125.24.0-255,5738,116651,96,270038
3103,0.015092,172.31.47.0-255,66,116717,96,270038
3104,0.01714,74.125.24.0-255,5738,122455,96,270038
3105,0.017147,172.31.47.0-255,66,122521,96,270038
3106,0.019214,74.125.24.0-255,5738,128259,96,270038
3107,0.019222,172.31.47.0-255,66,128325,96,270038
3108,0.021252,74.125.24.0-255,5738,134063,96,270038
3109,0.021258,172.31.47.0-255,66,134129,96,270038
3110,0.023328,74.125.24.0-255,5738,139867,96,270038
3111,0.023335,172.31.47.0-255,66,139933,96,270038
3112,0.025263,172.31.47.0-255,172,140105,96,270038
3113,0.025293,172.31.47.0-255,1105,141210,96,270038
3114,0.025319,172.31.47.0-255,1514,142724,96,270038
3115,0.025321,172.31.47.0-255,1306,144030,96,270038
3116,0.025337,74.125.24.0-255,2902,146932,96,270038
3117,0.025341,172.31.47.0-255,66,146998,96,270038
3118,0.025354,74.125.24.0-255,2902,149900,96,270038
3119,0.025357,172.31.47.0-255,66,149966,96,270038
3120,0.026808,104.244.42.0-255,66,150032,96,270038
3121,0.026853,104.244.42.0-255,66,150098,96,270038
3122,0.026904,104.244.42.0-255,66,150164,96,270038
3123,0.027362,74.125.24.0-255,4320,154484,96,270038
3124,0.027367,172.31.47.0-255,66,154550,96,270038
3125,0.027384,74.125.24.0-255,1484,156034,96,270038
3126,0.029396,74.125.24.0-255,2902,158936,96,270038
3127,0.029402,172.31.47.0-255,66,159002,96,270038
3128,0.029438,74.125.24.0-255,1484,160486,96,270038
3129,0.03143,74.125.24.0-255,2902,163388,96,270038
3130,0.031436,172.31.47.0-255,66,163454,96,270038
3131,0.03146,74.125.24.0-255,1484,164938,96,270038
3132,0.033499,74.125.24.0-255,4320,169258,96,270038
3133,0.033508,172.31.47.0-255,66,169324,96,270038
3134,0.035528,74.125.24.0-255,5738,175062,96,270038
3135,0.03554,172.31.47.0-255,66,175128,96,270038
3136,0.037559,74.125.24.0-255,5738,180866,96,270038
3137,0.037568,172.31.47.0-255,66,180932,96,270038
3138,0.039597,74.125.24.0-255,2902,183834,96,270038
3139,0.039604,172.31.47.0-255,66,183900,96,270038
3140,0.039623,74.125.24.0-255,2902,186802,96,270038
3141,0.039626,172.31.47.0-255,66,186868,96,270038
3142,0.04164,74.125.24.0-255,2902,189770,96,270038
3143,0.041645,172.31.47.0-255,66,189836,96,270038
3144,0.041658,74.125.24.0-255,2902,192738,96,270038
3145,0.041661,172.31.47.0-255,66,192804,96,270038
3146,0.043677,74.125.24.0-255,5738,198542,96,270038
3147,0.043688,172.31.47.0-255,66,198608,96,270038
3148,0.045714,74.125.24.0-255,2902,201510,96,270038
3149,0.045719,172.31.47.0-255,66,201576,96,270038
3150,0.045748,74.125.24.0-255,2902,204478,96,270038
3151,0.045751,172.31.47.0-255,66,204544,96,270038
3152,0.047718,74.125.24.0-255,2902,207446,96,270038
3153,0.047723,172.31.47.0-255,66,207512,96,270038
3154,0.047754,74.125.24.0-255,2902,210414,96,270038
3155,0.047757,172.31.47.0-255,66,210480,96,270038
3156,0.049747,74.125.24.0-255,2902,213382,96,270038
3157,0.049753,172.31.47.0-255,66,213448,96,270038
3158,0.049782,74.125.24.0-255,2902,216350,96,270038
3159,0.049785,172.31.47.0-255,66,216416,96,270038
3160,0.051768,74.125.24.0-255,2902,219318,96,270038
3161,0.051773,172.31.47.0-255,66,219384,96,270038
3162,0.051813,74.125.24.0-255,2902,222286,96,270038
3163,0.051816,172.31.47.0-255,66,222352,96,270038
3164,0.053807,74.125.24.0-255,2902,225254,96,270038
3165,0.053816,172.31.47.0-255,66,225320,96,270038
3166,0.053837,74.125.24.0-255,2902,228222,96,270038
3167,0.05384,172.31.47.0-255,66,228288,96,270038
3168,0.055829,74.125.24.0-255,2902,231190,96,270038
3169,0.055836,172.31.47.0-255,66,231256,96,270038
3170,0.055863,74.125.24.0-255,2902,234158,96,270038
3171,0.055866,172.31.47.0-255,66,234224,96,270038
3172,0.057852,74.125.24.0-255,2902,237126,96,270038
3173,0.057863,172.31.47.0-255,66,237192,96,270038
3174,0.057882,74.125.24.0-255,2902,240094,96,270038
3175,0.057885,172.31.47.0-255,66,240160,96,270038
3176,0.059871,74.125.24.0-255,2902,243062,96,270038
3177,0.059877,172.31.47.0-255,66,243128,96,270038
3178,0.059911,74.125.24.0-255,2902,246030,96,270038
3179,0.059914,172.31.47.0-255,66,246096,96,270038
3180,0.061899,74.125.24.0-255,2902,248998,96,270038
3181,0.061903,172.31.47.0-255,66,249064,96,270038
3182,0.061934,74.125.24.0-255,2902,251966,96,270038
3183,0.061936,172.31.47.0-255,66,252032,96,270038
3184,0.063933,74.125.24.0-255,1484,253516,96,270038
3185,0.063959,74.125.24.0-255,1484,255000,96,270038
3186,0.063963,172.31.47.0-255,66,255066,96,270038
3187,0.06399,74.125.24.0-255,1484,256550,96,270038
3188,0.064003,74.125.24.0-255,1484,258034,96,270038
3189,0.064005,172.31.47.0-255,66,258100,96,270038
3190,0.065999,74.125.24.0-255,2902,261002,96,270038
3191,0.066005,172.31.47.0-255,66,261068,96,270038
3192,0.066042,74.125.24.0-255,2902,263970,96,270038
3193,0.066045,172.31.47.0-255,66,264036,96,270038
3194,0.068022,74.125.24.0-255,2902,266938,96,270038
3195,0.068027,172.31.47.0-255,66,267004,96,270038
3196,0.068061,74.125.24.0-255,1484,268488,96,270038
3197,0.068073,74.125.24.0-255,1484,269972,96,270038
3198,0.068075,172.31.47.0-255,66,270038,96,270038
3199,0.0,74.125.68.0-255,153,153,96,330347
3200,3.3e-05,172.31.47.0-255,66,219,96,330347
3201,8.3e-05,74.125.68.0-255,1484,1703,96,330347
3202,8.9e-05,172.31.47.0-255,66,1769,96,330347
3203,9.3e-05,74.125.68.0-255,1484,3253,96,330347
3204,9.5e-05,172.31.47.0-255,66,3319,96,330347
3205,0.000108,74.125.68.0-255,2902,6221,96,330347
3206,0.000114,172.31.47.0-255,66,6287,96,330347
3207,0.000122,74.125.68.0-255,4320,10607,96,330347
3208,0.000125,172.31.47.0-255,66,10673,96,330347
3209,0.00016,74.125.68.0-255,1484,12157,96,330347
3210,0.000162,172.31.47.0-255,66,12223,96,330347
3211,0.000168,74.125.68.0-255,2099,14322,96,330347
3212,0.000171,172.31.47.0-255,66,14388,96,330347
3213,0.000184,74.125.68.0-255,2902,17290,96,330347
3214,0.000186,172.31.47.0-255,66,17356,96,330347
3215,0.000195,74.125.68.0-255,7156,24512,96,330347
3216,0.000198,172.31.47.0-255,66,24578,96,330347
3217,0.000204,74.125.68.0-255,4320,28898,96,330347
3218,0.000209,172.31.47.0-255,66,28964,96,330347
3219,0.000224,74.125.68.0-255,2543,31507,96,330347
3220,0.000233,172.31.47.0-255,66,31573,96,330347
3221,0.000288,74.125.68.0-255,1484,33057,96,330347
3222,0.000292,172.31.47.0-255,66,33123,96,330347
3223,0.000297,74.125.68.0-255,2902,36025,96,330347
3224,0.0003,172.31.47.0-255,66,36091,96,330347
3225,0.000349,74.125.68.0-255,1484,37575,96,330347
3226,0.000352,172.31.47.0-255,66,37641,96,330347
3227,0.000357,74.125.68.0-255,2902,40543,96,330347
3228,0.00036,172.31.47.0-255,66,40609,96,330347
3229,0.000373,74.125.68.0-255,5738,46347,96,330347
3230,0.000377,172.31.47.0-255,66,46413,96,330347
3231,0.000381,74.125.68.0-255,2543,48956,96,330347
3232,0.000384,172.31.47.0-255,66,49022,96,330347
3233,0.000389,74.125.68.0-255,2902,51924,96,330347
3234,0.000392,172.31.47.0-255,66,51990,96,330347
3235,0.000432,74.125.68.0-255,7156,59146,96,330347
3236,0.000459,74.125.68.0-255,2902,62048,96,330347
3237,0.000471,74.125.68.0-255,4273,66321,96,330347
3238,0.000475,74.125.68.0-255,111,66432,96,330347
3239,0.000484,172.31.47.0-255,66,66498,96,330347
3240,0.000576,74.125.68.0-255,1484,67982,96,330347
3241,0.000582,74.125.68.0-255,1484,69466,96,330347
3242,0.000605,74.125.68.0-255,1484,70950,96,330347
3243,0.000635,74.125.68.0-255,5738,76688,96,330347
3244,0.000656,74.125.68.0-255,6797,83485,96,330347
3245,0.000678,74.125.68.0-255,5738,89223,96,330347
3246,0.000705,74.125.68.0-255,7156,96379,96,330347
3247,0.000719,74.125.68.0-255,3961,100340,96,330347
3248,0.000863,172.31.47.0-255,66,100406,96,330347
3249,0.001024,74.125.68.0-255,1484,101890,96,330347
3250,0.00103,74.125.68.0-255,1484,103374,96,330347
3251,0.001053,74.125.68.0-255,1484,104858,96,330347
3252,0.001059,74.125.68.0-255,4320,109178,96,330347
3253,0.001063,74.125.68.0-255,2902,112080,96,330347
3254,0.001068,172.31.47.0-255,66,112146,96,330347
3255,0.001095,74.125.68.0-255,5738,117884,96,330347
3256,0.001121,172.31.47.0-255,66,117950,96,330347
3257,0.001189,172.31.47.0-255,66,118016,96,330347
3258,0.001213,74.125.68.0-255,1484,119500,96,330347
3259,0.001218,74.125.68.0-255,2902,122402,96,330347
3260,0.001248,74.125.68.0-255,2902,125304,96,330347
3261,0.001253,74.125.68.0-255,1484,126788,96,330347
3262,0.001276,74.125.68.0-255,2902,129690,96,330347
3263,0.001283,172.31.47.0-255,66,129756,96,330347
3264,0.001305,74.125.68.0-255,7156,136912,96,330347
3265,0.001322,172.31.47.0-255,66,136978,96,330347
3266,0.001368,74.125.68.0-255,1484,138462,96,330347
3267,0.001373,74.125.68.0-255,2902,141364,96,330347
3268,0.001399,172.31.47.0-255,66,141430,96,330347
3269,0.001404,74.125.68.0-255,2184,143614,96,330347
3270,0.001418,172.31.47.0-255,66,143680,96,330347
3271,0.00147,74.125.68.0-255,1484,145164,96,330347
3272,0.001486,74.125.68.0-255,2902,148066,96,330347
3273,0.001568,74.125.68.0-255,2902,150968,96,330347
3274,0.001583,74.125.68.0-255,1484,152452,96,330347
3275,0.001621,74.125.68.0-255,1484,153936,96,330347
3276,0.001625,172.31.47.0-255,66,154002,96,330347
3277,0.001663,74.125.68.0-255,5020,159022,96,330347
3278,0.001688,172.31.47.0-255,66,159088,96,330347
3279,0.001839,74.125.68.0-255,1484,160572,96,330347
3280,0.001846,74.125.68.0-255,2902,163474,96,330347
3281,0.001865,74.125.68.0-255,2902,166376,96,330347
3282,0.001881,74.125.68.0-255,1484,167860,96,330347
3283,0.001903,74.125.68.0-255,4320,172180,96,330347
3284,0.001907,172.31.47.0-255,66,172246,96,330347
3285,0.001914,172.31.47.0-255,66,172312,96,330347
3286,0.001946,74.125.68.0-255,5738,178050,96,330347
3287,0.001956,74.125.68.0-255,7156,185206,96,330347
3288,0.002018,172.31.47.0-255,66,185272,96,330347
3289,0.004038,74.125.68.0-255,5738,191010,96,330347
3290,0.004059,172.31.47.0-255,66,191076,96,330347
3291,0.006105,74.125.68.0-255,5738,196814,96,330347
3292,0.006116,172.31.47.0-255,66,196880,96,330347
3293,0.008169,74.125.68.0-255,5738,202618,96,330347
3294,0.0156,74.125.68.0-255,1484,204102,96,330347
3295,0.022597,172.31.47.0-255,66,204168,96,330347
3296,0.024617,74.125.68.0-255,5738,209906,96,330347
3297,0.024634,172.31.47.0-255,66,209972,96,330347
3298,0.026648,74.125.68.0-255,5738,215710,96,330347
3299,0.026655,172.31.47.0-255,66,215776,96,330347
3300,0.028667,74.125.68.0-255,5738,221514,96,330347
3301,0.028674,172.31.47.0-255,66,221580,96,330347
3302,0.030673,74.125.68.0-255,5738,227318,96,330347
3303,0.030682,172.31.47.0-255,66,227384,96,330347
3304,0.032691,74.125.68.0-255,5738,233122,96,330347
3305,0.032699,172.31.47.0-255,66,233188,96,330347
3306,0.0347,74.125.68.0-255,5738,238926,96,330347
3307,0.038823,172.31.47.0-255,66,238992,96,330347
3308,0.040848,74.125.68.0-255,5738,244730,96,330347
3309,0.040864,172.31.47.0-255,66,244796,96,330347
3310,0.042864,74.125.68.0-255,5738,250534,96,330347
3311,0.042872,172.31.47.0-255,66,250600,96,330347
3312,0.043611,172.31.47.0-255,172,250772,96,330347
3313,0.043643,172.31.47.0-255,1101,251873,96,330347
3314,0.043704,172.31.47.0-255,1514,253387,96,330347
3315,0.043706,172.31.47.0-255,1310,254697,96,330347
3316,0.044892,74.125.68.0-255,5738,260435,96,330347
3317,0.044899,172.31.47.0-255,66,260501,96,330347
3318,0.04518,104.244.42.0-255,66,260567,96,330347
3319,0.045204,104.244.42.0-255,66,260633,96,330347
3320,0.045255,104.244.42.0-255,66,260699,96,330347
3321,0.046912,74.125.68.0-255,5738,266437,96,330347
3322,0.046918,172.31.47.0-255,66,266503,96,330347
3323,0.048927,74.125.68.0-255,5738,272241,96,330347
3324,0.048934,172.31.47.0-255,66,272307,96,330347
3325,0.050943,74.125.68.0-255,5738,278045,96,330347
3326,0.050949,172.31.47.0-255,66,278111,96,330347
3327,0.052967,74.125.68.0-255,5738,283849,96,330347
3328,0.052974,172.31.47.0-255,66,283915,96,330347
3329,0.054988,74.125.68.0-255,5738,289653,96,330347
3330,0.054994,172.31.47.0-255,66,289719,96,330347
3331,0.057015,74.125.68.0-255,5738,295457,96,330347
3332,0.057021,172.31.47.0-255,66,295523,96,330347
3333,0.059045,74.125.68.0-255,5738,301261,96,330347
3334,0.059051,172.31.47.0-255,66,301327,96,330347
3335,0.061108,74.125.68.0-255,5738,307065,96,330347
3336,0.061115,172.31.47.0-255,66,307131,96,330347
3337,0.063126,74.125.68.0-255,5738,312869,96,330347
3338,0.063132,172.31.47.0-255,66,312935,96,330347
3339,0.065143,74.125.68.0-255,5738,318673,96,330347
3340,0.06515,172.31.47.0-255,66,318739,96,330347
3341,0.067164,74.125.68.0-255,5738,324477,96,330347
3342,0.06717,172.31.47.0-255,66,324543,96,330347
3343,0.069194,74.125.68.0-255,5738,330281,96,330347
3344,0.069209,172.31.47.0-255,66,330347,96,330347
3345,0.0,74.125.200.0-255,159,159,96,373500
3346,2.2e-05,172.31.47.0-255,66,225,96,373500
3347,2.8e-05,74.125.200.0-255,1484,1709,96,373500
3348,3.2e-05,172.31.47.0-255,66,1775,96,373500
3349,3.6e-05,74.125.200.0-255,2902,4677,96,373500
3350,3.8e-05,172.31.47.0-255,66,4743,96,373500
3351,6.2e-05,74.125.200.0-255,7156,11899,96,373500
3352,6.5e-05,172.31.47.0-255,66,11965,96,373500
3353,8.6e-05,74.125.200.0-255,3579,15544,96,373500
3354,8.8e-05,172.31.47.0-255,66,15610,96,373500
3355,9.3e-05,74.125.200.0-255,4320,19930,96,373500
3356,9.5e-05,172.31.47.0-255,66,19996,96,373500
3357,0.000132,172.31.47.0-255,66,20062,96,373500
3358,0.000135,74.125.200.0-255,1125,21187,96,373500
3359,0.000136,172.31.47.0-255,66,21253,96,373500
3360,0.000222,74.125.200.0-255,1484,22737,96,373500
3361,0.000225,172.31.47.0-255,66,22803,96,373500
3362,0.00024,74.125.200.0-255,2902,25705,96,373500
3363,0.000242,172.31.47.0-255,66,25771,96,373500
3364,0.000263,74.125.200.0-255,5738,31509,96,373500
3365,0.000266,172.31.47.0-255,66,31575,96,373500
3366,0.000272,74.125.200.0-255,5738,37313,96,373500
3367,0.000274,172.31.47.0-255,66,37379,96,373500
3368,0.000288,74.125.200.0-255,1125,38504,96,373500
3369,0.00029,172.31.47.0-255,66,38570,96,373500
3370,0.000295,74.125.200.0-255,2902,41472,96,373500
3371,0.000296,172.31.47.0-255,66,41538,96,373500
3372,0.00032,74.125.200.0-255,4320,45858,96,373500
3373,0.000323,172.31.47.0-255,66,45924,96,373500
3374,0.000327,74.125.200.0-255,2902,48826,96,373500
3375,0.000329,172.31.47.0-255,66,48892,96,373500
3376,0.000348,74.125.200.0-255,7075,55967,96,373500
3377,0.000351,172.31.47.0-255,66,56033,96,373500
3378,0.000353,74.125.200.0-255,130,56163,96,373500
3379,0.000356,74.125.200.0-255,344,56507,96,373500
3380,0.000641,74.125.200.0-255,1484,57991,96,373500
3381,0.000647,172.31.47.0-255,66,58057,96,373500
3382,0.000655,74.125.200.0-255,2902,60959,96,373500
3383,0.000658,172.31.47.0-255,66,61025,96,373500
3384,0.00066,74.125.200.0-255,1484,62509,96,373500
3385,0.000685,74.125.200.0-255,4320,66829,96,373500
3386,0.000688,172.31.47.0-255,66,66895,96,373500
3387,0.00069,74.125.200.0-255,1484,68379,96,373500
3388,0.000709,74.125.200.0-255,5738,74117,96,373500
3389,0.000712,172.31.47.0-255,66,74183,96,373500
3390,0.000731,74.125.200.0-255,2902,77085,96,373500
3391,0.000734,172.31.47.0-255,66,77151,96,373500
3392,0.00076,172.31.47.0-255,66,77217,96,373500
3393,0.000775,74.125.200.0-255,1484,78701,96,373500
3394,0.000803,74.125.200.0-255,2184,80885,96,373500
3395,0.000806,172.31.47.0-255,66,80951,96,373500
3396,0.001088,74.125.200.0-255,1484,82435,96,373500
3397,0.001095,74.125.200.0-255,1484,83919,96,373500
3398,0.001099,172.31.47.0-255,66,83985,96,373500
3399,0.001116,74.125.200.0-255,1484,85469,96,373500
3400,0.00112,74.125.200.0-255,1484,86953,96,373500
3401,0.001122,172.31.47.0-255,66,87019,96,373500
3402,0.001144,74.125.200.0-255,4320,91339,96,373500
3403,0.001146,172.31.47.0-255,66,91405,96,373500
3404,0.001149,74.125.200.0-255,1484,92889,96,373500
3405,0.001152,74.125.200.0-255,2902,95791,96,373500
3406,0.001154,172.31.47.0-255,66,95857,96,373500
3407,0.001158,74.125.200.0-255,1484,97341,96,373500
3408,0.001172,74.125.200.0-255,4320,101661,96,373500
3409,0.001173,172.31.47.0-255,66,101727,96,373500
3410,0.001192,74.125.200.0-255,2902,104629,96,373500
3411,0.001194,172.31.47.0-255,66,104695,96,373500
3412,0.001213,74.125.200.0-255,4320,109015,96,373500
3413,0.001215,172.31.47.0-255,66,109081,96,373500
3414,0.001239,74.125.200.0-255,2902,111983,96,373500
3415,0.001241,172.31.47.0-255,66,112049,96,373500
3416,0.001259,74.125.200.0-255,3602,115651,96,373500
3417,0.001261,172.31.47.0-255,66,115717,96,373500
3418,0.001374,74.125.200.0-255,1484,117201,96,373500
3419,0.001378,74.125.200.0-255,1484,118685,96,373500
3420,0.001381,172.31.47.0-255,66,118751,96,373500
3421,0.001393,74.125.200.0-255,1484,120235,96,373500
3422,0.001399,74.125.200.0-255,5738,125973,96,373500
3423,0.001401,172.31.47.0-255,66,126039,96,373500
3424,0.001427,74.125.200.0-255,1484,127523,96,373500
3425,0.00144,74.125.200.0-255,5738,133261,96,373500
3426,0.001442,172.31.47.0-255,66,133327,96,373500
3427,0.001458,74.125.200.0-255,5738,139065,96,373500
3428,0.00146,172.31.47.0-255,66,139131,96,373500
3429,0.001465,74.125.200.0-255,5738,144869,96,373500
3430,0.001466,172.31.47.0-255,66,144935,96,373500
3431,0.001494,74.125.200.0-255,5020,149955,96,373500
3432,0.001496,172.31.47.0-255,66,150021,96,373500
3433,0.001684,74.125.200.0-255,1484,151505,96,373500
3434,0.001698,74.125.200.0-255,1484,152989,96,373500
3435,0.001701,172.31.47.0-255,66,153055,96,373500
3436,0.001717,74.125.200.0-255,1484,154539,96,373500
3437,0.00172,74.125.200.0-255,2902,157441,96,373500
3438,0.001722,172.31.47.0-255,66,157507,96,373500
3439,0.001734,74.125.200.0-255,2902,160409,96,373500
3440,0.001736,172.31.47.0-255,66,160475,96,373500
3441,0.00179,74.125.200.0-255,2902,163377,96,373500
3442,0.001791,172.31.47.0-255,66,163443,96,373500
3443,0.001815,172.31.47.0-255,66,163509,96,373500
3444,0.00182,74.125.200.0-255,5738,169247,96,373500
3445,0.001821,172.31.47.0-255,66,169313,96,373500
3446,0.001826,74.125.200.0-255,5020,174333,96,373500
3447,0.001828,172.31.47.0-255,66,174399,96,373500
3448,0.002193,74.125.200.0-255,1484,175883,96,373500
3449,0.002212,74.125.200.0-255,2902,178785,96,373500
3450,0.002214,172.31.47.0-255,66,178851,96,373500
3451,0.002219,74.125.200.0-255,4320,183171,96,373500
3452,0.00222,172.31.47.0-255,66,183237,96,373500
3453,0.002224,74.125.200.0-255,2902,186139,96,373500
3454,0.002238,172.31.47.0-255,66,186205,96,373500
3455,0.002254,74.125.200.0-255,2902,189107,96,373500
3456,0.002257,172.31.47.0-255,66,189173,96,373500
3457,0.002262,74.125.200.0-255,5738,194911,96,373500
3458,0.002264,172.31.47.0-255,66,194977,96,373500
3459,0.002289,74.125.200.0-255,5738,200715,96,373500
3460,0.002293,172.31.47.0-255,66,200781,96,373500
3461,0.002297,74.125.200.0-255,4320,205101,96,373500
3462,0.002299,172.31.47.0-255,66,205167,96,373500
3463,0.002332,74.125.200.0-255,3602,208769,96,373500
3464,0.002335,172.31.47.0-255,66,208835,96,373500
3465,0.002504,74.125.200.0-255,1484,210319,96,373500
3466,0.002508,74.125.200.0-255,1484,211803,96,373500
3467,0.002511,172.31.47.0-255,66,211869,96,373500
3468,0.002521,74.125.200.0-255,1484,213353,96,373500
3469,0.002538,74.125.200.0-255,2902,216255,96,373500
3470,0.002541,172.31.47.0-255,66,216321,96,373500
3471,0.002552,74.125.200.0-255,1484,217805,96,373500
3472,0.002579,74.125.200.0-255,4320,222125,96,373500
3473,0.002582,172.31.47.0-255,66,222191,96,373500
3474,0.002597,74.125.200.0-255,4320,226511,96,373500
3475,0.002599,172.31.47.0-255,66,226577,96,373500
3476,0.002622,74.125.200.0-255,1484,228061,96,373500
3477,0.002645,172.31.47.0-255,66,228127,96,373500
3478,0.002648,74.125.200.0-255,1484,229611,96,373500
3479,0.005253,74.125.200.0-255,4320,233931,96,373500
3480,0.005258,172.31.47.0-255,66,233997,96,373500
3481,0.007891,74.125.200.0-255,5738,239735,96,373500
3482,0.007898,172.31.47.0-255,66,239801,96,373500
3483,0.010513,74.125.200.0-255,5738,245539,96,373500
3484,0.01052,172.31.47.0-255,66,245605,96,373500
3485,0.013141,74.125.200.0-255,5738,251343,96,373500
3486,0.013148,172.31.47.0-255,66,251409,96,373500
3487,0.015764,74.125.200.0-255,5738,257147,96,373500
3488,0.015776,172.31.47.0-255,66,257213,96,373500
3489,0.018397,74.125.200.0-255,5738,262951,96,373500
3490,0.018405,172.31.47.0-255,66,263017,96,373500
3491,0.021024,74.125.200.0-255,5738,268755,96,373500
3492,0.021032,172.31.47.0-255,66,268821,96,373500
3493,0.023646,74.125.200.0-255,4320,273141,96,373500
3494,0.023652,172.31.47.0-255,66,273207,96,373500
3495,0.023672,74.125.200.0-255,1484,274691,96,373500
3496,0.026266,74.125.200.0-255,2902,277593,96,373500
3497,0.026271,172.31.47.0-255,66,277659,96,373500
3498,0.026289,74.125.200.0-255,1484,279143,96,373500
3499,0.026305,172.31.47.0-255,172,279315,96,373500
3500,0.02633,172.31.47.0-255,1109,280424,96,373500
3501,0.026358,172.31.47.0-255,1514,281938,96,373500
3502,0.02636,172.31.47.0-255,1302,283240,96,373500
3503,0.027834,104.244.42.0-255,66,283306,96,373500
3504,0.028008,104.244.42.0-255,66,283372,96,373500
3505,0.02801,104.244.42.0-255,66,283438,96,373500
3506,0.028878,74.125.200.0-255,2902,286340,96,373500
3507,0.028882,172.31.47.0-255,66,286406,96,373500
3508,0.028912,74.125.200.0-255,1484,287890,96,373500
3509,0.031483,74.125.200.0-255,2902,290792,96,373500
3510,0.031487,172.31.47.0-255,66,290858,96,373500
3511,0.031513,74.125.200.0-255,1484,292342,96,373500
3512,0.0341,74.125.200.0-255,4320,296662,96,373500
3513,0.034106,172.31.47.0-255,66,296728,96,373500
3514,0.036699,74.125.200.0-255,1484,298212,96,373500
3515,0.03673,74.125.200.0-255,4320,302532,96,373500
3516,0.036734,172.31.47.0-255,66,302598,96,373500
3517,0.039357,74.125.200.0-255,5738,308336,96,373500
3518,0.039362,172.31.47.0-255,66,308402,96,373500
3519,0.04197,74.125.200.0-255,5738,314140,96,373500
3520,0.041975,172.31.47.0-255,66,314206,96,373500
3521,0.044589,74.125.200.0-255,5738,319944,96,373500
3522,0.044594,172.31.47.0-255,66,320010,96,373500
3523,0.047196,74.125.200.0-255,2902,322912,96,373500
3524,0.0472,172.31.47.0-255,66,322978,96,373500
3525,0.047227,74.125.200.0-255,2902,325880,96,373500
3526,0.04723,172.31.47.0-255,66,325946,96,373500
3527,0.049816,74.125.200.0-255,2902,328848,96,373500
3528,0.049821,172.31.47.0-255,66,328914,96,373500
3529,0.049852,74.125.200.0-255,2902,331816,96,373500
3530,0.049855,172.31.47.0-255,66,331882,96,373500
3531,0.052438,74.125.200.0-255,2902,334784,96,373500
3532,0.052442,172.31.47.0-255,66,334850,96,373500
3533,0.052499,74.125.200.0-255,2902,337752,96,373500
3534,0.052503,172.31.47.0-255,66,337818,96,373500
3535,0.055046,74.125.200.0-255,2902,340720,96,373500
3536,0.055051,172.31.47.0-255,66,340786,96,373500
3537,0.055127,74.125.200.0-255,2902,343688,96,373500
3538,0.055133,172.31.47.0-255,66,343754,96,373500
3539,0.057659,74.125.200.0-255,2902,346656,96,373500
3540,0.057664,172.31.47.0-255,66,346722,96,373500
3541,0.057748,74.125.200.0-255,2902,349624,96,373500
3542,0.057752,172.31.47.0-255,66,349690,96,373500
3543,0.060266,74.125.200.0-255,2902,352592,96,373500
3544,0.06027,172.31.47.0-255,66,352658,96,373500
3545,0.060359,74.125.200.0-255,2902,355560,96,373500
3546,0.060363,172.31.47.0-255,66,355626,96,373500
3547,0.062879,74.125.200.0-255,2902,358528,96,373500
3548,0.062885,172.31.47.0-255,66,358594,96,373500
3549,0.062959,74.125.200.0-255,2902,361496,96,373500
3550,0.062963,172.31.47.0-255,66,361562,96,373500
3551,0.065488,74.125.200.0-255,1484,363046,96,373500
3552,0.065558,74.125.200.0-255,1484,364530,96,373500
3553,0.065563,172.31.47.0-255,66,364596,96,373500
3554,0.065579,74.125.200.0-255,2902,367498,96,373500
3555,0.065585,172.31.47.0-255,66,367564,96,373500
3556,0.068174,74.125.200.0-255,2902,370466,96,373500
3557,0.068179,172.31.47.0-255,66,370532,96,373500
3558,0.068208,74.125.200.0-255,2902,373434,96,373500
3559,0.06821,172.31.47.0-255,66,373500,96,373500
3560,0.0,172.31.47.0-255,66,66,96,66
3561,0.0,172.217.194.0-255,153,153,96,270704
3562,2.8e-05,172.31.47.0-255,66,219,96,270704
3563,6.7e-05,172.217.194.0-255,1484,1703,96,270704
3564,7.2e-05,172.31.47.0-255,66,1769,96,270704
3565,7.5e-05,172.217.194.0-255,1484,3253,96,270704
3566,7.8e-05,172.31.47.0-255,66,3319,96,270704
3567,0.000101,172.217.194.0-255,1484,4803,96,270704
3568,0.000104,172.31.47.0-255,66,4869,96,270704
3569,0.00011,172.217.194.0-255,5738,10607,96,270704
3570,0.000116,172.31.47.0-255,66,10673,96,270704
3571,0.00014,172.217.194.0-255,3556,14229,96,270704
3572,0.000143,172.31.47.0-255,66,14295,96,270704
3573,0.00021,172.217.194.0-255,1484,15779,96,270704
3574,0.000213,172.31.47.0-255,66,15845,96,270704
3575,0.000218,172.217.194.0-255,2902,18747,96,270704
3576,0.00022,172.31.47.0-255,66,18813,96,270704
3577,0.000248,172.217.194.0-255,4320,23133,96,270704
3578,0.00025,172.31.47.0-255,66,23199,96,270704
3579,0.000256,172.217.194.0-255,5738,28937,96,270704
3580,0.000258,172.31.47.0-255,66,29003,96,270704
3581,0.000306,172.31.47.0-255,66,29069,96,270704
3582,0.000316,172.31.47.0-255,66,29135,96,270704
3583,0.000336,172.217.194.0-255,4320,33455,96,270704
3584,0.000339,172.31.47.0-255,66,33521,96,270704
3585,0.000344,172.217.194.0-255,4320,37841,96,270704
3586,0.000346,172.31.47.0-255,66,37907,96,270704
3587,0.000373,172.217.194.0-255,6438,44345,96,270704
3588,0.000377,172.31.47.0-255,66,44411,96,270704
3589,0.000379,172.217.194.0-255,340,44751,96,270704
3590,0.000382,172.31.47.0-255,66,44817,96,270704
3591,0.000408,172.217.194.0-255,119,44936,96,270704
3592,0.000411,172.31.47.0-255,66,45002,96,270704
3593,0.000536,172.217.194.0-255,1484,46486,96,270704
3594,0.00054,172.31.47.0-255,66,46552,96,270704
3595,0.000545,172.217.194.0-255,2902,49454,96,270704
3596,0.000547,172.31.47.0-255,66,49520,96,270704
3597,0.000573,172.217.194.0-255,5738,55258,96,270704
3598,0.000575,172.31.47.0-255,66,55324,96,270704
3599,0.000582,172.217.194.0-255,7156,62480,96,270704
3600,0.000584,172.31.47.0-255,66,62546,96,270704
3601,0.000614,172.217.194.0-255,5738,68284,96,270704
3602,0.000617,172.31.47.0-255,66,68350,96,270704
3603,0.000634,172.31.47.0-255,66,68416,96,270704
3604,0.000636,172.217.194.0-255,766,69182,96,270704
3605,0.000638,172.31.47.0-255,66,69248,96,270704
3606,0.001127,172.217.194.0-255,1484,70732,96,270704
3607,0.001133,172.31.47.0-255,66,70798,96,270704
3608,0.001138,172.217.194.0-255,2902,73700,96,270704
3609,0.001141,172.31.47.0-255,66,73766,96,270704
3610,0.001145,172.217.194.0-255,4320,78086,96,270704
3611,0.001146,172.31.47.0-255,66,78152,96,270704
3612,0.001169,172.217.194.0-255,1484,79636,96,270704
3613,0.001171,172.31.47.0-255,66,79702,96,270704
3614,0.001182,172.31.47.0-255,66,79768,96,270704
3615,0.001204,172.217.194.0-255,5738,85506,96,270704
3616,0.001206,172.31.47.0-255,66,85572,96,270704
3617,0.001233,172.217.194.0-255,5020,90592,96,270704
3618,0.001235,172.31.47.0-255,66,90658,96,270704
3619,0.001457,172.217.194.0-255,1484,92142,96,270704
3620,0.001459,172.31.47.0-255,66,92208,96,270704
3621,0.001463,172.217.194.0-255,2902,95110,96,270704
3622,0.001464,172.31.47.0-255,66,95176,96,270704
3623,0.001481,172.217.194.0-255,4320,99496,96,270704
3624,0.001483,172.31.47.0-255,66,99562,96,270704
3625,0.001498,172.217.194.0-255,1484,101046,96,270704
3626,0.0015,172.31.47.0-255,66,101112,96,270704
3627,0.00153,172.217.194.0-255,2902,104014,96,270704
3628,0.001551,172.217.194.0-255,2184,106198,96,270704
3629,0.001977,172.217.194.0-255,1484,107682,96,270704
3630,0.001989,172.217.194.0-255,2902,110584,96,270704
3631,0.001991,172.217.194.0-255,1484,112068,96,270704
3632,0.002006,172.217.194.0-255,4320,116388,96,270704
3633,0.002022,172.217.194.0-255,2902,119290,96,270704
3634,0.002027,172.217.194.0-255,4320,123610,96,270704
3635,0.002045,172.217.194.0-255,5738,129348,96,270704
3636,0.002057,172.217.194.0-255,2902,132250,96,270704
3637,0.002074,172.217.194.0-255,4320,136570,96,270704
3638,0.002085,172.217.194.0-255,2902,139472,96,270704
3639,0.002099,172.217.194.0-255,766,140238,96,270704
3640,0.002275,172.217.194.0-255,1484,141722,96,270704
3641,0.002279,172.217.194.0-255,2902,144624,96,270704
3642,0.002281,172.217.194.0-255,1484,146108,96,270704
3643,0.002292,172.217.194.0-255,4320,150428,96,270704
3644,0.002311,172.217.194.0-255,2902,153330,96,270704
3645,0.002323,172.217.194.0-255,5738,159068,96,270704
3646,0.002333,172.217.194.0-255,2902,161970,96,270704
3647,0.002338,172.217.194.0-255,4320,166290,96,270704
3648,0.002386,172.217.194.0-255,4320,170610,96,270704
3649,0.002406,172.217.194.0-255,5738,176348,96,270704
3650,0.002411,172.217.194.0-255,4320,180668,96,270704
3651,0.002435,172.217.194.0-255,7156,187824,96,270704
3652,0.00245,172.217.194.0-255,4320,192144,96,270704
3653,0.002489,172.217.194.0-255,2902,195046,96,270704
3654,0.002568,172.217.194.0-255,1484,196530,96,270704
3655,0.002586,172.217.194.0-255,6438,202968,96,270704
3656,0.002607,172.217.194.0-255,2902,205870,96,270704
3657,0.002723,172.217.194.0-255,7156,213026,96,270704
3658,0.002769,172.217.194.0-255,5020,218046,96,270704
3659,0.004569,172.31.47.0-255,66,218112,96,270704
3660,0.007196,172.217.194.0-255,5738,223850,96,270704
3661,0.007209,172.31.47.0-255,66,223916,96,270704
3662,0.009798,172.217.194.0-255,5738,229654,96,270704
3663,0.009815,172.31.47.0-255,66,229720,96,270704
3664,0.012413,172.217.194.0-255,5738,235458,96,270704
3665,0.012431,172.31.47.0-255,66,235524,96,270704
3666,0.015016,172.217.194.0-255,5738,241262,96,270704
3667,0.015022,172.31.47.0-255,66,241328,96,270704
3668,0.017603,172.217.194.0-255,5738,247066,96,270704
3669,0.017609,172.31.47.0-255,66,247132,96,270704
3670,0.020181,172.217.194.0-255,5738,252870,96,270704
3671,0.020193,172.31.47.0-255,66,252936,96,270704
3672,0.022793,172.217.194.0-255,5738,258674,96,270704
3673,0.0228,172.31.47.0-255,66,258740,96,270704
3674,0.025401,172.217.194.0-255,5738,264478,96,270704
3675,0.025411,172.31.47.0-255,66,264544,96,270704
3676,0.028001,172.217.194.0-255,1626,266170,96,270704
3677,0.028015,172.31.47.0-255,66,266236,96,270704
3678,0.028234,172.31.47.0-255,105,266341,96,270704
3679,0.030779,172.217.194.0-255,66,266407,96,270704
3680,0.038888,172.31.47.0-255,172,266579,96,270704
3681,0.038929,172.31.47.0-255,1101,267680,96,270704
3682,0.038959,172.31.47.0-255,1514,269194,96,270704
3683,0.038961,172.31.47.0-255,1312,270506,96,270704
3684,0.040393,104.244.42.0-255,66,270572,96,270704
3685,0.04042,104.244.42.0-255,66,270638,96,270704
3686,0.040462,104.244.42.0-255,66,270704,96,270704
3687,0.0,172.253.118.0-255,153,153,96,283227
3688,3.5e-05,172.31.47.0-255,66,219,96,283227
3689,4.3e-05,172.253.118.0-255,1484,1703,96,283227
3690,4.7e-05,172.31.47.0-255,66,1769,96,283227
3691,5.2e-05,172.253.118.0-255,2902,4671,96,283227
3692,5.4e-05,172.31.47.0-255,66,4737,96,283227
3693,6e-05,172.253.118.0-255,7156,11893,96,283227
3694,6.2e-05,172.31.47.0-255,66,11959,96,283227
3695,6.7e-05,172.253.118.0-255,1974,13933,96,283227
3696,6.9e-05,172.31.47.0-255,66,13999,96,283227
3697,8.4e-05,172.253.118.0-255,1484,15483,96,283227
3698,8.7e-05,172.31.47.0-255,66,15549,96,283227
3699,0.000122,172.31.47.0-255,66,15615,96,283227
3700,0.000125,172.253.118.0-255,1484,17099,96,283227
3701,0.000127,172.31.47.0-255,66,17165,96,283227
3702,0.000157,172.253.118.0-255,3961,21126,96,283227
3703,0.000161,172.31.47.0-255,66,21192,96,283227
3704,0.000215,172.253.118.0-255,1484,22676,96,283227
3705,0.000217,172.31.47.0-255,66,22742,96,283227
3706,0.000221,172.253.118.0-255,1484,24226,96,283227
3707,0.000223,172.31.47.0-255,66,24292,96,283227
3708,0.000237,172.253.118.0-255,1484,25776,96,283227
3709,0.000239,172.31.47.0-255,66,25842,96,283227
3710,0.000246,172.253.118.0-255,5738,31580,96,283227
3711,0.000249,172.31.47.0-255,66,31646,96,283227
3712,0.000256,172.253.118.0-255,6797,38443,96,283227
3713,0.000258,172.31.47.0-255,66,38509,96,283227
3714,0.000282,172.253.118.0-255,5738,44247,96,283227
3715,0.000287,172.31.47.0-255,66,44313,96,283227
3716,0.000316,172.31.47.0-255,66,44379,96,283227
3717,0.00032,172.253.118.0-255,2819,47198,96,283227
3718,0.000324,172.31.47.0-255,66,47264,96,283227
3719,0.000327,172.253.118.0-255,126,47390,96,283227
3720,0.000452,172.253.118.0-255,1484,48874,96,283227
3721,0.000456,172.31.47.0-255,66,48940,96,283227
3722,0.000461,172.253.118.0-255,2902,51842,96,283227
3723,0.000463,172.31.47.0-255,66,51908,96,283227
3724,0.000466,172.253.118.0-255,1484,53392,96,283227
3725,0.00049,172.253.118.0-255,4320,57712,96,283227
3726,0.000493,172.31.47.0-255,66,57778,96,283227
3727,0.000546,172.31.47.0-255,66,57844,96,283227
3728,0.000559,172.253.118.0-255,2902,60746,96,283227
3729,0.000562,172.31.47.0-255,66,60812,96,283227
3730,0.000581,172.31.47.0-255,66,60878,96,283227
3731,0.000774,172.253.118.0-255,1484,62362,96,283227
3732,0.000789,172.253.118.0-255,2902,65264,96,283227
3733,0.000792,172.31.47.0-255,66,65330,96,283227
3734,0.000796,172.253.118.0-255,1484,66814,96,283227
3735,0.000813,172.253.118.0-255,4320,71134,96,283227
3736,0.000816,172.31.47.0-255,66,71200,96,283227
3737,0.00085,172.31.47.0-255,66,71266,96,283227
3738,0.000869,172.253.118.0-255,1484,72750,96,283227
3739,0.000882,172.31.47.0-255,66,72816,96,283227
3740,0.000948,172.253.118.0-255,1484,74300,96,283227
3741,0.000969,172.253.118.0-255,2902,77202,96,283227
3742,0.000972,172.31.47.0-255,66,77268,96,283227
3743,0.000978,172.253.118.0-255,5738,83006,96,283227
3744,0.000981,172.31.47.0-255,66,83072,96,283227
3745,0.000985,172.253.118.0-255,2902,85974,96,283227
3746,0.000987,172.31.47.0-255,66,86040,96,283227
3747,0.001026,172.31.47.0-255,66,86106,96,283227
3748,0.001057,172.31.47.0-255,66,86172,96,283227
3749,0.001901,172.253.118.0-255,1484,87656,96,283227
3750,0.001911,172.253.118.0-255,2902,90558,96,283227
3751,0.001914,172.31.47.0-255,66,90624,96,283227
3752,0.001921,172.253.118.0-255,5738,96362,96,283227
3753,0.001922,172.31.47.0-255,66,96428,96,283227
3754,0.00196,172.31.47.0-255,66,96494,96,283227
3755,0.002003,172.253.118.0-255,5738,102232,96,283227
3756,0.002005,172.31.47.0-255,66,102298,96,283227
3757,0.002025,172.253.118.0-255,5020,107318,96,283227
3758,0.002027,172.31.47.0-255,66,107384,96,283227
3759,0.004223,172.253.118.0-255,2902,110286,96,283227
3760,0.004226,172.31.47.0-255,66,110352,96,283227
3761,0.004238,172.253.118.0-255,2902,113254,96,283227
3762,0.004239,172.31.47.0-255,66,113320,96,283227
3763,0.006455,172.253.118.0-255,5738,119058,96,283227
3764,0.00646,172.31.47.0-255,66,119124,96,283227
3765,0.008696,172.253.118.0-255,5738,124862,96,283227
3766,0.008703,172.31.47.0-255,66,124928,96,283227
3767,0.010935,172.253.118.0-255,5738,130666,96,283227
3768,0.010943,172.31.47.0-255,66,130732,96,283227
3769,0.013169,172.253.118.0-255,5738,136470,96,283227
3770,0.013175,172.31.47.0-255,66,136536,96,283227
3771,0.015405,172.253.118.0-255,5738,142274,96,283227
3772,0.015411,172.31.47.0-255,66,142340,96,283227
3773,0.017656,172.253.118.0-255,5738,148078,96,283227
3774,0.017663,172.31.47.0-255,66,148144,96,283227
3775,0.01989,172.253.118.0-255,5738,153882,96,283227
3776,0.019898,172.31.47.0-255,66,153948,96,283227
3777,0.022144,172.253.118.0-255,5738,159686,96,283227
3778,0.022154,172.31.47.0-255,66,159752,96,283227
3779,0.02442,172.253.118.0-255,5738,165490,96,283227
3780,0.024425,172.31.47.0-255,66,165556,96,283227
3781,0.026665,172.253.118.0-255,5738,171294,96,283227
3782,0.026673,172.31.47.0-255,66,171360,96,283227
3783,0.028896,172.253.118.0-255,5738,177098,96,283227
3784,0.028903,172.31.47.0-255,66,177164,96,283227
3785,0.031145,172.253.118.0-255,5738,182902,96,283227
3786,0.031156,172.31.47.0-255,66,182968,96,283227
3787,0.032341,172.31.47.0-255,172,183140,96,283227
3788,0.032368,172.31.47.0-255,1109,184249,96,283227
3789,0.032399,172.31.47.0-255,1514,185763,96,283227
3790,0.0324,172.31.47.0-255,1302,187065,96,283227
3791,0.033393,172.253.118.0-255,5738,192803,96,283227
3792,0.033399,172.31.47.0-255,66,192869,96,283227
3793,0.033856,104.244.42.0-255,66,192935,96,283227
3794,0.034068,104.244.42.0-255,66,193001,96,283227
3795,0.034075,104.244.42.0-255,66,193067,96,283227
3796,0.035635,172.253.118.0-255,5738,198805,96,283227
3797,0.035644,172.31.47.0-255,66,198871,96,283227
3798,0.037896,172.253.118.0-255,5738,204609,96,283227
3799,0.037902,172.31.47.0-255,66,204675,96,283227
3800,0.040133,172.253.118.0-255,5738,210413,96,283227
3801,0.040139,172.31.47.0-255,66,210479,96,283227
3802,0.042375,172.253.118.0-255,5738,216217,96,283227
3803,0.042403,172.31.47.0-255,66,216283,96,283227
3804,0.044629,172.253.118.0-255,4320,220603,96,283227
3805,0.044633,172.31.47.0-255,66,220669,96,283227
3806,0.044664,172.253.118.0-255,1484,222153,96,283227
3807,0.046868,172.253.118.0-255,4320,226473,96,283227
3808,0.046873,172.31.47.0-255,66,226539,96,283227
3809,0.049097,172.253.118.0-255,5738,232277,96,283227
3810,0.049101,172.31.47.0-255,66,232343,96,283227
3811,0.051321,172.253.118.0-255,5738,238081,96,283227
3812,0.051326,172.31.47.0-255,66,238147,96,283227
3813,0.053572,172.253.118.0-255,5738,243885,96,283227
3814,0.053578,172.31.47.0-255,66,243951,96,283227
3815,0.055793,172.253.118.0-255,5738,249689,96,283227
3816,0.055798,172.31.47.0-255,66,249755,96,283227
3817,0.058022,172.253.118.0-255,5738,255493,96,283227
3818,0.058027,172.31.47.0-255,66,255559,96,283227
3819,0.060268,172.253.118.0-255,5738,261297,96,283227
3820,0.060275,172.31.47.0-255,66,261363,96,283227
3821,0.062506,172.253.118.0-255,5738,267101,96,283227
3822,0.062513,172.31.47.0-255,66,267167,96,283227
3823,0.064758,172.253.118.0-255,5738,272905,96,283227
3824,0.064763,172.31.47.0-255,66,272971,96,283227
3825,0.066994,172.253.118.0-255,4320,277291,96,283227
3826,0.066999,172.31.47.0-255,66,277357,96,283227
3827,0.067022,172.253.118.0-255,1484,278841,96,283227
3828,0.069213,172.253.118.0-255,4320,283161,96,283227
3829,0.069218,172.31.47.0-255,66,283227,96,283227
3830,0.0,74.125.200.0-255,156,156,96,356320
3831,2.2e-05,172.31.47.0-255,66,222,96,356320
3832,2.9e-05,74.125.200.0-255,1484,1706,96,356320
3833,3.3e-05,172.31.47.0-255,66,1772,96,356320
3834,3.9e-05,74.125.200.0-255,2902,4674,96,356320
3835,5e-05,172.31.47.0-255,66,4740,96,356320
3836,5.8e-05,74.125.200.0-255,7156,11896,96,356320
3837,6e-05,172.31.47.0-255,66,11962,96,356320
3838,6.4e-05,74.125.200.0-255,2012,13974,96,356320
3839,6.6e-05,172.31.47.0-255,66,14040,96,356320
3840,0.000181,74.125.200.0-255,1484,15524,96,356320
3841,0.000185,172.31.47.0-255,66,15590,96,356320
3842,0.000189,74.125.200.0-255,1484,17074,96,356320
3843,0.000191,172.31.47.0-255,66,17140,96,356320
3844,0.000194,74.125.200.0-255,1484,18624,96,356320
3845,0.000196,172.31.47.0-255,66,18690,96,356320
3846,0.000219,74.125.200.0-255,1484,20174,96,356320
3847,0.000221,172.31.47.0-255,66,20240,96,356320
3848,0.000227,74.125.200.0-255,4320,24560,96,356320
3849,0.000229,172.31.47.0-255,66,24626,96,356320
3850,0.000257,74.125.200.0-255,1484,26110,96,356320
3851,0.00026,172.31.47.0-255,66,26176,96,356320
3852,0.000266,74.125.200.0-255,5379,31555,96,356320
3853,0.000268,172.31.47.0-255,66,31621,96,356320
3854,0.000368,74.125.200.0-255,1484,33105,96,356320
3855,0.000372,172.31.47.0-255,66,33171,96,356320
3856,0.000382,74.125.200.0-255,1484,34655,96,356320
3857,0.000388,172.31.47.0-255,66,34721,96,356320
3858,0.000406,74.125.200.0-255,1484,36205,96,356320
3859,0.000409,172.31.47.0-255,66,36271,96,356320
3860,0.000413,74.125.200.0-255,2902,39173,96,356320
3861,0.000415,172.31.47.0-255,66,39239,96,356320
3862,0.000421,74.125.200.0-255,4320,43559,96,356320
3863,0.000423,172.31.47.0-255,66,43625,96,356320
3864,0.000461,172.31.47.0-255,66,43691,96,356320
3865,0.000465,74.125.200.0-255,4320,48011,96,356320
3866,0.000468,172.31.47.0-255,66,48077,96,356320
3867,0.000501,74.125.200.0-255,1484,49561,96,356320
3868,0.000526,74.125.200.0-255,7068,56629,96,356320
3869,0.000529,172.31.47.0-255,66,56695,96,356320
3870,0.000666,74.125.200.0-255,132,56827,96,356320
3871,0.00071,74.125.200.0-255,1484,58311,96,356320
3872,0.000713,172.31.47.0-255,66,58377,96,356320
3873,0.000718,74.125.200.0-255,2902,61279,96,356320
3874,0.00072,172.31.47.0-255,66,61345,96,356320
3875,0.000742,74.125.200.0-255,5738,67083,96,356320
3876,0.000744,172.31.47.0-255,66,67149,96,356320
3877,0.000767,74.125.200.0-255,4320,71469,96,356320
3878,0.000769,172.31.47.0-255,66,71535,96,356320
3879,0.000784,74.125.200.0-255,2543,74078,96,356320
3880,0.000786,172.31.47.0-255,66,74144,96,356320
3881,0.000962,74.125.200.0-255,1484,75628,96,356320
3882,0.000981,74.125.200.0-255,1484,77112,96,356320
3883,0.000984,172.31.47.0-255,66,77178,96,356320
3884,0.000989,74.125.200.0-255,2902,80080,96,356320
3885,0.00099,172.31.47.0-255,66,80146,96,356320
3886,0.001,74.125.200.0-255,5738,85884,96,356320
3887,0.001001,172.31.47.0-255,66,85950,96,356320
3888,0.001046,172.31.47.0-255,66,86016,96,356320
3889,0.001094,74.125.200.0-255,7156,93172,96,356320
3890,0.001097,172.31.47.0-255,66,93238,96,356320
3891,0.001124,74.125.200.0-255,3602,96840,96,356320
3892,0.001138,74.125.200.0-255,7156,103996,96,356320
3893,0.001148,172.31.47.0-255,66,104062,96,356320
3894,0.001152,172.31.47.0-255,66,104128,96,356320
3895,0.001154,172.31.47.0-255,66,104194,96,356320
3896,0.001156,172.31.47.0-255,66,104260,96,356320
3897,0.001183,74.125.200.0-255,6438,110698,96,356320
3898,0.001186,172.31.47.0-255,66,110764,96,356320
3899,0.001189,74.125.200.0-255,2902,113666,96,356320
3900,0.001191,172.31.47.0-255,66,113732,96,356320
3901,0.001224,74.125.200.0-255,4320,118052,96,356320
3902,0.001227,172.31.47.0-255,66,118118,96,356320
3903,0.001238,172.31.47.0-255,66,118184,96,356320
3904,0.00169,74.125.200.0-255,1484,119668,96,356320
3905,0.001708,74.125.200.0-255,2902,122570,96,356320
3906,0.001712,172.31.47.0-255,66,122636,96,356320
3907,0.001715,74.125.200.0-255,1484,124120,96,356320
3908,0.001736,74.125.200.0-255,2902,127022,96,356320
3909,0.001738,172.31.47.0-255,66,127088,96,356320
3910,0.001754,74.125.200.0-255,4320,131408,96,356320
3911,0.001756,172.31.47.0-255,66,131474,96,356320
3912,0.001778,74.125.200.0-255,1484,132958,96,356320
3913,0.001781,74.125.200.0-255,2902,135860,96,356320
3914,0.001783,172.31.47.0-255,66,135926,96,356320
3915,0.001788,74.125.200.0-255,2902,138828,96,356320
3916,0.001789,172.31.47.0-255,66,138894,96,356320
3917,0.001812,74.125.200.0-255,1484,140378,96,356320
3918,0.001816,74.125.200.0-255,2902,143280,96,356320
3919,0.001818,172.31.47.0-255,66,143346,96,356320
3920,0.001848,74.125.200.0-255,5738,149084,96,356320
3921,0.00185,172.31.47.0-255,66,149150,96,356320
3922,0.001873,74.125.200.0-255,3602,152752,96,356320
3923,0.001875,172.31.47.0-255,66,152818,96,356320
3924,0.002025,74.125.200.0-255,1484,154302,96,356320
3925,0.002039,74.125.200.0-255,2902,157204,96,356320
3926,0.002042,172.31.47.0-255,66,157270,96,356320
3927,0.002071,74.125.200.0-255,5738,163008,96,356320
3928,0.002073,172.31.47.0-255,66,163074,96,356320
3929,0.0021,74.125.200.0-255,7156,170230,96,356320
3930,0.002103,172.31.47.0-255,66,170296,96,356320
3931,0.002127,74.125.200.0-255,5738,176034,96,356320
3932,0.002129,172.31.47.0-255,66,176100,96,356320
3933,0.00215,74.125.200.0-255,1484,177584,96,356320
3934,0.002169,74.125.200.0-255,5738,183322,96,356320
3935,0.002172,172.31.47.0-255,66,183388,96,356320
3936,0.002177,74.125.200.0-255,3602,186990,96,356320
3937,0.002178,172.31.47.0-255,66,187056,96,356320
3938,0.002195,74.125.200.0-255,2902,189958,96,356320
3939,0.002197,172.31.47.0-255,66,190024,96,356320
3940,0.002217,74.125.200.0-255,1484,191508,96,356320
3941,0.002224,74.125.200.0-255,5738,197246,96,356320
3942,0.002226,172.31.47.0-255,66,197312,96,356320
3943,0.002255,74.125.200.0-255,4320,201632,96,356320
3944,0.002257,172.31.47.0-255,66,201698,96,356320
3945,0.002267,172.31.47.0-255,66,201764,96,356320
3946,0.002287,74.125.200.0-255,2902,204666,96,356320
3947,0.002289,172.31.47.0-255,66,204732,96,356320
3948,0.002303,172.31.47.0-255,66,204798,96,356320
3949,0.004563,74.125.200.0-255,1484,206282,96,356320
3950,0.004582,74.125.200.0-255,4320,210602,96,356320
3951,0.004586,172.31.47.0-255,66,210668,96,356320
3952,0.006843,74.125.200.0-255,5738,216406,96,356320
3953,0.006848,172.31.47.0-255,66,216472,96,356320
3954,0.009122,74.125.200.0-255,5738,222210,96,356320
3955,0.009128,172.31.47.0-255,66,222276,96,356320
3956,0.011396,74.125.200.0-255,5738,228014,96,356320
3957,0.011403,172.31.47.0-255,66,228080,96,356320
3958,0.013699,74.125.200.0-255,5738,233818,96,356320
3959,0.013705,172.31.47.0-255,66,233884,96,356320
3960,0.01598,74.125.200.0-255,5738,239622,96,356320
3961,0.015989,172.31.47.0-255,66,239688,96,356320
3962,0.018269,74.125.200.0-255,5738,245426,96,356320
3963,0.018278,172.31.47.0-255,66,245492,96,356320
3964,0.020537,74.125.200.0-255,5738,251230,96,356320
3965,0.020544,172.31.47.0-255,66,251296,96,356320
3966,0.022824,74.125.200.0-255,5738,257034,96,356320
3967,0.022832,172.31.47.0-255,66,257100,96,356320
3968,0.025109,74.125.200.0-255,5738,262838,96,356320
3969,0.025117,172.31.47.0-255,66,262904,96,356320
3970,0.027145,172.31.47.0-255,172,263076,96,356320
3971,0.027196,172.31.47.0-255,1111,264187,96,356320
3972,0.027276,172.31.47.0-255,1514,265701,96,356320
3973,0.027277,172.31.47.0-255,1300,267001,96,356320
3974,0.027389,74.125.200.0-255,5738,272739,96,356320
3975,0.027395,172.31.47.0-255,66,272805,96,356320
3976,0.028757,104.244.42.0-255,66,272871,96,356320
3977,0.028786,104.244.42.0-255,66,272937,96,356320
3978,0.02888,104.244.42.0-255,66,273003,96,356320
3979,0.029657,74.125.200.0-255,5738,278741,96,356320
3980,0.029662,172.31.47.0-255,66,278807,96,356320
3981,0.031944,74.125.200.0-255,5738,284545,96,356320
3982,0.03195,172.31.47.0-255,66,284611,96,356320
3983,0.034231,74.125.200.0-255,5738,290349,96,356320
3984,0.034237,172.31.47.0-255,66,290415,96,356320
3985,0.036503,74.125.200.0-255,5738,296153,96,356320
3986,0.036508,172.31.47.0-255,66,296219,96,356320
3987,0.038794,74.125.200.0-255,5738,301957,96,356320
3988,0.038801,172.31.47.0-255,66,302023,96,356320
3989,0.04107,74.125.200.0-255,5738,307761,96,356320
3990,0.041076,172.31.47.0-255,66,307827,96,356320
3991,0.043347,74.125.200.0-255,5738,313565,96,356320
3992,0.043356,172.31.47.0-255,66,313631,96,356320
3993,0.045617,74.125.200.0-255,5738,319369,96,356320
3994,0.045622,172.31.47.0-255,66,319435,96,356320
3995,0.047887,74.125.200.0-255,5738,325173,96,356320
3996,0.047893,172.31.47.0-255,66,325239,96,356320
3997,0.050147,74.125.200.0-255,5738,330977,96,356320
3998,0.050153,172.31.47.0-255,66,331043,96,356320
3999,0.052428,74.125.200.0-255,5738,336781,96,356320
4000,0.052433,172.31.47.0-255,66,336847,96,356320
4001,0.054703,74.125.200.0-255,5738,342585,96,356320
4002,0.054709,172.31.47.0-255,66,342651,96,356320
4003,0.056982,74.125.200.0-255,5738,348389,96,356320
4004,0.056987,172.31.47.0-255,66,348455,96,356320
4005,0.059264,74.125.200.0-255,4320,352775,96,356320
4006,0.05927,172.31.47.0-255,66,352841,96,356320
4007,0.059294,74.125.200.0-255,1484,354325,96,356320
4008,0.061556,74.125.200.0-255,1758,356083,96,356320
4009,0.061562,172.31.47.0-255,66,356149,96,356320
4010,0.061713,172.31.47.0-255,105,356254,96,356320
4011,0.06394,74.125.200.0-255,66,356320,96,356320
4012,0.0,74.125.24.0-255,153,153,96,308249
4013,2.2e-05,172.31.47.0-255,66,219,96,308249
4014,2.9e-05,74.125.24.0-255,1484,1703,96,308249
4015,3.3e-05,172.31.47.0-255,66,1769,96,308249
4016,3.8e-05,74.125.24.0-255,2902,4671,96,308249
4017,4.1e-05,172.31.47.0-255,66,4737,96,308249
4018,6.9e-05,74.125.24.0-255,7156,11893,96,308249
4019,7.2e-05,172.31.47.0-255,66,11959,96,308249
4020,7.6e-05,74.125.24.0-255,2102,14061,96,308249
4021,7.8e-05,172.31.47.0-255,66,14127,96,308249
4022,0.00011,74.125.24.0-255,2902,17029,96,308249
4023,0.000114,172.31.47.0-255,66,17095,96,308249
4024,0.000137,172.31.47.0-255,66,17161,96,308249
4025,0.000142,74.125.24.0-255,4320,21481,96,308249
4026,0.000144,172.31.47.0-255,66,21547,96,308249
4027,0.000173,74.125.24.0-255,1125,22672,96,308249
4028,0.000177,172.31.47.0-255,66,22738,96,308249
4029,0.00018,74.125.24.0-255,1484,24222,96,308249
4030,0.000182,172.31.47.0-255,66,24288,96,308249
4031,0.000192,74.125.24.0-255,1484,25772,96,308249
4032,0.000195,172.31.47.0-255,66,25838,96,308249
4033,0.000211,74.125.24.0-255,2902,28740,96,308249
4034,0.000215,172.31.47.0-255,66,28806,96,308249
4035,0.00023,74.125.24.0-255,5738,34544,96,308249
4036,0.000232,172.31.47.0-255,66,34610,96,308249
4037,0.00025,74.125.24.0-255,4320,38930,96,308249
4038,0.000252,172.31.47.0-255,66,38996,96,308249
4039,0.000255,74.125.24.0-255,1125,40121,96,308249
4040,0.000257,172.31.47.0-255,66,40187,96,308249
4041,0.000722,74.125.24.0-255,1484,41671,96,308249
4042,0.000727,172.31.47.0-255,66,41737,96,308249
4043,0.000733,74.125.24.0-255,2902,44639,96,308249
4044,0.000738,74.125.24.0-255,2902,47541,96,308249
4045,0.000743,74.125.24.0-255,4320,51861,96,308249
4046,0.000744,172.31.47.0-255,66,51927,96,308249
4047,0.000749,172.31.47.0-255,66,51993,96,308249
4048,0.000774,74.125.24.0-255,1484,53477,96,308249
4049,0.0008,74.125.24.0-255,3961,57438,96,308249
4050,0.000809,172.31.47.0-255,66,57504,96,308249
4051,0.000824,74.125.24.0-255,1484,58988,96,308249
4052,0.000837,74.125.24.0-255,2902,61890,96,308249
4053,0.00084,74.125.24.0-255,1484,63374,96,308249
4054,0.000843,172.31.47.0-255,66,63440,96,308249
4055,0.000852,74.125.24.0-255,4320,67760,96,308249
4056,0.000869,172.31.47.0-255,66,67826,96,308249
4057,0.000883,74.125.24.0-255,2902,70728,96,308249
4058,0.000886,172.31.47.0-255,66,70794,96,308249
4059,0.000911,74.125.24.0-255,4541,75335,96,308249
4060,0.000915,172.31.47.0-255,66,75401,96,308249
4061,0.000927,74.125.24.0-255,1484,76885,96,308249
4062,0.000944,74.125.24.0-255,2902,79787,96,308249
4063,0.000951,74.125.24.0-255,5738,85525,96,308249
4064,0.000956,172.31.47.0-255,66,85591,96,308249
4065,0.000988,74.125.24.0-255,6797,92388,96,308249
4066,0.000994,172.31.47.0-255,66,92454,96,308249
4067,0.001162,74.125.24.0-255,1484,93938,96,308249
4068,0.001168,74.125.24.0-255,2902,96840,96,308249
4069,0.001171,172.31.47.0-255,66,96906,96,308249
4070,0.001178,74.125.24.0-255,5738,102644,96,308249
4071,0.001187,172.31.47.0-255,66,102710,96,308249
4072,0.001249,74.125.24.0-255,1484,104194,96,308249
4073,0.00127,74.125.24.0-255,4816,109010,96,308249
4074,0.001273,172.31.47.0-255,66,109076,96,308249
4075,0.001506,74.125.24.0-255,1484,110560,96,308249
4076,0.001524,74.125.24.0-255,2902,113462,96,308249
4077,0.001527,172.31.47.0-255,66,113528,96,308249
4078,0.001531,74.125.24.0-255,2902,116430,96,308249
4079,0.001548,74.125.24.0-255,2902,119332,96,308249
4080,0.001558,172.31.47.0-255,66,119398,96,308249
4081,0.001616,74.125.24.0-255,766,120164,96,308249
4082,0.001628,172.31.47.0-255,66,120230,96,308249
4083,0.002247,74.125.24.0-255,1484,121714,96,308249
4084,0.002257,74.125.24.0-255,2902,124616,96,308249
4085,0.002262,172.31.47.0-255,66,124682,96,308249
4086,0.002269,74.125.24.0-255,5738,130420,96,308249
4087,0.00231,74.125.24.0-255,2902,133322,96,308249
4088,0.002317,172.31.47.0-255,66,133388,96,308249
4089,0.002344,74.125.24.0-255,2902,136290,96,308249
4090,0.002353,172.31.47.0-255,66,136356,96,308249
4091,0.002378,74.125.24.0-255,5738,142094,96,308249
4092,0.002384,172.31.47.0-255,66,142160,96,308249
4093,0.002415,74.125.24.0-255,7156,149316,96,308249
4094,0.00243,74.125.24.0-255,3602,152918,96,308249
4095,0.002433,172.31.47.0-255,66,152984,96,308249
4096,0.005006,74.125.24.0-255,5738,158722,96,308249
4097,0.005011,172.31.47.0-255,66,158788,96,308249
4098,0.007588,74.125.24.0-255,5738,164526,96,308249
4099,0.007594,172.31.47.0-255,66,164592,96,308249
4100,0.010136,74.125.24.0-255,5738,170330,96,308249
4101,0.010143,172.31.47.0-255,66,170396,96,308249
4102,0.01267,74.125.24.0-255,5738,176134,96,308249
4103,0.012679,172.31.47.0-255,66,176200,96,308249
4104,0.015241,74.125.24.0-255,5738,181938,96,308249
4105,0.01525,172.31.47.0-255,66,182004,96,308249
4106,0.017778,74.125.24.0-255,5738,187742,96,308249
4107,0.017787,172.31.47.0-255,66,187808,96,308249
4108,0.020388,74.125.24.0-255,5738,193546,96,308249
4109,0.020406,172.31.47.0-255,66,193612,96,308249
4110,0.023009,74.125.24.0-255,5738,199350,96,308249
4111,0.02302,172.31.47.0-255,66,199416,96,308249
4112,0.025586,74.125.24.0-255,5738,205154,96,308249
4113,0.025605,172.31.47.0-255,66,205220,96,308249
4114,0.028191,74.125.24.0-255,5738,210958,96,308249
4115,0.02821,172.31.47.0-255,66,211024,96,308249
4116,0.030786,74.125.24.0-255,5738,216762,96,308249
4117,0.030801,172.31.47.0-255,66,216828,96,308249
4118,0.03334,74.125.24.0-255,5738,222566,96,308249
4119,0.033352,172.31.47.0-255,66,222632,96,308249
4120,0.035963,74.125.24.0-255,5738,228370,96,308249
4121,0.035978,172.31.47.0-255,66,228436,96,308249
4122,0.038555,74.125.24.0-255,5738,234174,96,308249
4123,0.038572,172.31.47.0-255,66,234240,96,308249
4124,0.041124,74.125.24.0-255,5738,239978,96,308249
4125,0.041149,172.31.47.0-255,66,240044,96,308249
4126,0.043055,172.31.47.0-255,172,240216,96,308249
4127,0.043083,172.31.47.0-255,1101,241317,96,308249
4128,0.043127,172.31.47.0-255,1514,242831,96,308249
4129,0.043128,172.31.47.0-255,1310,244141,96,308249
4130,0.043677,74.125.24.0-255,5738,249879,96,308249
4131,0.043685,172.31.47.0-255,66,249945,96,308249
4132,0.044598,104.244.42.0-255,66,250011,96,308249
4133,0.044637,104.244.42.0-255,66,250077,96,308249
4134,0.04469,104.244.42.0-255,66,250143,96,308249
4135,0.046228,74.125.24.0-255,5738,255881,96,308249
4136,0.046245,172.31.47.0-255,66,255947,96,308249
4137,0.048807,74.125.24.0-255,5738,261685,96,308249
4138,0.048823,172.31.47.0-255,66,261751,96,308249
4139,0.051364,74.125.24.0-255,5738,267489,96,308249
4140,0.051375,172.31.47.0-255,66,267555,96,308249
4141,0.053903,74.125.24.0-255,5738,273293,96,308249
4142,0.053912,172.31.47.0-255,66,273359,96,308249
4143,0.056469,74.125.24.0-255,5738,279097,96,308249
4144,0.056477,172.31.47.0-255,66,279163,96,308249
4145,0.059033,74.125.24.0-255,5738,284901,96,308249
4146,0.059041,172.31.47.0-255,66,284967,96,308249
4147,0.061621,74.125.24.0-255,5738,290705,96,308249
4148,0.06163,172.31.47.0-255,66,290771,96,308249
4149,0.064185,74.125.24.0-255,5738,296509,96,308249
4150,0.064194,172.31.47.0-255,66,296575,96,308249
4151,0.066792,74.125.24.0-255,5738,302313,96,308249
4152,0.066803,172.31.47.0-255,66,302379,96,308249
4153,0.069352,74.125.24.0-255,4320,306699,96,308249
4154,0.069363,172.31.47.0-255,66,306765,96,308249
4155,0.069381,74.125.24.0-255,1484,308249,96,308249
4156,0.0,74.125.200.0-255,146,146,96,340374
4157,1.4e-05,172.31.47.0-255,66,212,96,340374
4158,4.6e-05,74.125.200.0-255,1484,1696,96,340374
4159,5.1e-05,172.31.47.0-255,66,1762,96,340374
4160,5.6e-05,74.125.200.0-255,2902,4664,96,340374
4161,5.9e-05,172.31.47.0-255,66,4730,96,340374
4162,6.2e-05,74.125.200.0-255,1484,6214,96,340374
4163,6.5e-05,172.31.47.0-255,66,6280,96,340374
4164,8.9e-05,74.125.200.0-255,4320,10600,96,340374
4165,9.1e-05,172.31.47.0-255,66,10666,96,340374
4166,0.000128,74.125.200.0-255,6311,16977,96,340374
4167,0.00013,172.31.47.0-255,66,17043,96,340374
4168,0.000134,74.125.200.0-255,2902,19945,96,340374
4169,0.000135,172.31.47.0-255,66,20011,96,340374
4170,0.000138,74.125.200.0-255,1484,21495,96,340374
4171,0.00014,172.31.47.0-255,66,21561,96,340374
4172,0.000169,74.125.200.0-255,2902,24463,96,340374
4173,0.000171,172.31.47.0-255,66,24529,96,340374
4174,0.000178,74.125.200.0-255,6797,31326,96,340374
4175,0.00018,172.31.47.0-255,66,31392,96,340374
4176,0.000261,74.125.200.0-255,1484,32876,96,340374
4177,0.000264,172.31.47.0-255,66,32942,96,340374
4178,0.000291,74.125.200.0-255,2902,35844,96,340374
4179,0.000293,172.31.47.0-255,66,35910,96,340374
4180,0.000323,74.125.200.0-255,5738,41648,96,340374
4181,0.000326,172.31.47.0-255,66,41714,96,340374
4182,0.000357,74.125.200.0-255,4320,46034,96,340374
4183,0.000359,172.31.47.0-255,66,46100,96,340374
4184,0.000387,74.125.200.0-255,2543,48643,96,340374
4185,0.000389,172.31.47.0-255,66,48709,96,340374
4186,0.000526,74.125.200.0-255,1484,50193,96,340374
4187,0.00053,172.31.47.0-255,66,50259,96,340374
4188,0.000549,74.125.200.0-255,2902,53161,96,340374
4189,0.000552,172.31.47.0-255,66,53227,96,340374
4190,0.00058,74.125.200.0-255,5738,58965,96,340374
4191,0.000582,172.31.47.0-255,66,59031,96,340374
4192,0.000609,74.125.200.0-255,6797,65828,96,340374
4193,0.000612,172.31.47.0-255,66,65894,96,340374
4194,0.000635,74.125.200.0-255,4320,70214,96,340374
4195,0.000638,172.31.47.0-255,66,70280,96,340374
4196,0.000687,74.125.200.0-255,5738,76018,96,340374
4197,0.00069,172.31.47.0-255,66,76084,96,340374
4198,0.000696,74.125.200.0-255,5738,81822,96,340374
4199,0.000698,172.31.47.0-255,66,81888,96,340374
4200,0.000724,74.125.200.0-255,1125,83013,96,340374
4201,0.000726,172.31.47.0-255,66,83079,96,340374
4202,0.000752,74.125.200.0-255,1484,84563,96,340374
4203,0.000755,172.31.47.0-255,66,84629,96,340374
4204,0.000782,74.125.200.0-255,4320,88949,96,340374
4205,0.000784,172.31.47.0-255,66,89015,96,340374
4206,0.000787,74.125.200.0-255,1484,90499,96,340374
4207,0.000789,172.31.47.0-255,66,90565,96,340374
4208,0.000826,74.125.200.0-255,7156,97721,96,340374
4209,0.000829,172.31.47.0-255,66,97787,96,340374
4210,0.000833,74.125.200.0-255,3122,100909,96,340374
4211,0.000836,172.31.47.0-255,66,100975,96,340374
4212,0.001207,74.125.200.0-255,1484,102459,96,340374
4213,0.001211,172.31.47.0-255,66,102525,96,340374
4214,0.001236,74.125.200.0-255,2902,105427,96,340374
4215,0.001238,172.31.47.0-255,66,105493,96,340374
4216,0.001241,74.125.200.0-255,1484,106977,96,340374
4217,0.001243,172.31.47.0-255,66,107043,96,340374
4218,0.001278,74.125.200.0-255,5738,112781,96,340374
4219,0.001281,172.31.47.0-255,66,112847,96,340374
4220,0.001284,74.125.200.0-255,1484,114331,96,340374
4221,0.001286,172.31.47.0-255,66,114397,96,340374
4222,0.001311,74.125.200.0-255,7156,121553,96,340374
4223,0.001317,172.31.47.0-255,66,121619,96,340374
4224,0.001321,74.125.200.0-255,2902,124521,96,340374
4225,0.001323,172.31.47.0-255,66,124587,96,340374
4226,0.001358,74.125.200.0-255,7156,131743,96,340374
4227,0.00136,172.31.47.0-255,66,131809,96,340374
4228,0.001363,74.125.200.0-255,1484,133293,96,340374
4229,0.001365,172.31.47.0-255,66,133359,96,340374
4230,0.00137,74.125.200.0-255,2184,135543,96,340374
4231,0.001371,172.31.47.0-255,66,135609,96,340374
4232,0.002208,74.125.200.0-255,1484,137093,96,340374
4233,0.002213,172.31.47.0-255,66,137159,96,340374
4234,0.00222,74.125.200.0-255,1484,138643,96,340374
4235,0.002222,172.31.47.0-255,66,138709,96,340374
4236,0.002253,74.125.200.0-255,1484,140193,96,340374
4237,0.002255,172.31.47.0-255,66,140259,96,340374
4238,0.002261,74.125.200.0-255,5738,145997,96,340374
4239,0.002264,172.31.47.0-255,66,146063,96,340374
4240,0.002294,74.125.200.0-255,7156,153219,96,340374
4241,0.002296,172.31.47.0-255,66,153285,96,340374
4242,0.002301,74.125.200.0-255,4320,157605,96,340374
4243,0.002303,172.31.47.0-255,66,157671,96,340374
4244,0.002337,74.125.200.0-255,4320,161991,96,340374
4245,0.002339,172.31.47.0-255,66,162057,96,340374
4246,0.002346,74.125.200.0-255,7156,169213,96,340374
4247,0.002348,172.31.47.0-255,66,169279,96,340374
4248,0.004647,74.125.200.0-255,2902,172181,96,340374
4249,0.004652,172.31.47.0-255,66,172247,96,340374
4250,0.004678,74.125.200.0-255,2902,175149,96,340374
4251,0.004681,172.31.47.0-255,66,175215,96,340374
4252,0.006946,74.125.200.0-255,2902,178117,96,340374
4253,0.006951,172.31.47.0-255,66,178183,96,340374
4254,0.006981,74.125.200.0-255,2902,181085,96,340374
4255,0.006983,172.31.47.0-255,66,181151,96,340374
4256,0.00925,74.125.200.0-255,2902,184053,96,340374
4257,0.009257,172.31.47.0-255,66,184119,96,340374
4258,0.009285,74.125.200.0-255,2902,187021,96,340374
4259,0.009288,172.31.47.0-255,66,187087,96,340374
4260,0.011559,74.125.200.0-255,2902,189989,96,340374
4261,0.011566,172.31.47.0-255,66,190055,96,340374
4262,0.011609,74.125.200.0-255,2902,192957,96,340374
4263,0.011611,172.31.47.0-255,66,193023,96,340374
4264,0.013872,74.125.200.0-255,2902,195925,96,340374
4265,0.013881,172.31.47.0-255,66,195991,96,340374
4266,0.013915,74.125.200.0-255,2902,198893,96,340374
4267,0.013918,172.31.47.0-255,66,198959,96,340374
4268,0.016177,74.125.200.0-255,2902,201861,96,340374
4269,0.016183,172.31.47.0-255,66,201927,96,340374
4270,0.016211,74.125.200.0-255,2902,204829,96,340374
4271,0.016215,172.31.47.0-255,66,204895,96,340374
4272,0.018482,74.125.200.0-255,2902,207797,96,340374
4273,0.018489,172.31.47.0-255,66,207863,96,340374
4274,0.018516,74.125.200.0-255,2902,210765,96,340374
4275,0.018519,172.31.47.0-255,66,210831,96,340374
4276,0.02078,74.125.200.0-255,2902,213733,96,340374
4277,0.020788,172.31.47.0-255,66,213799,96,340374
4278,0.020823,74.125.200.0-255,2902,216701,96,340374
4279,0.020826,172.31.47.0-255,66,216767,96,340374
4280,0.023079,74.125.200.0-255,2902,219669,96,340374
4281,0.023086,172.31.47.0-255,66,219735,96,340374
4282,0.023115,74.125.200.0-255,2902,222637,96,340374
4283,0.023119,172.31.47.0-255,66,222703,96,340374
4284,0.023842,172.31.47.0-255,172,222875,96,340374
4285,0.023874,172.31.47.0-255,1105,223980,96,340374
4286,0.023927,172.31.47.0-255,1514,225494,96,340374
4287,0.023929,172.31.47.0-255,1306,226800,96,340374
4288,0.025393,74.125.200.0-255,4320,231120,96,340374
4289,0.025399,172.31.47.0-255,66,231186,96,340374
4290,0.025431,104.244.42.0-255,66,231252,96,340374
4291,0.025437,104.244.42.0-255,66,231318,96,340374
4292,0.02544,74.125.200.0-255,1484,232802,96,340374
4293,0.025519,104.244.42.0-255,66,232868,96,340374
4294,0.027704,74.125.200.0-255,4320,237188,96,340374
4295,0.027711,172.31.47.0-255,66,237254,96,340374
4296,0.030007,74.125.200.0-255,5738,242992,96,340374
4297,0.030014,172.31.47.0-255,66,243058,96,340374
4298,0.032324,74.125.200.0-255,5738,248796,96,340374
4299,0.032332,172.31.47.0-255,66,248862,96,340374
4300,0.034657,74.125.200.0-255,5738,254600,96,340374
4301,0.034665,172.31.47.0-255,66,254666,96,340374
4302,0.037001,74.125.200.0-255,5738,260404,96,340374
4303,0.037008,172.31.47.0-255,66,260470,96,340374
4304,0.03931,74.125.200.0-255,5738,266208,96,340374
4305,0.039316,172.31.47.0-255,66,266274,96,340374
4306,0.041634,74.125.200.0-255,5738,272012,96,340374
4307,0.04164,172.31.47.0-255,66,272078,96,340374
4308,0.043962,74.125.200.0-255,5738,277816,96,340374
4309,0.043969,172.31.47.0-255,66,277882,96,340374
4310,0.046264,74.125.200.0-255,5738,283620,96,340374
4311,0.04627,172.31.47.0-255,66,283686,96,340374
4312,0.048572,74.125.200.0-255,4320,288006,96,340374
4313,0.048577,172.31.47.0-255,66,288072,96,340374
4314,0.048604,74.125.200.0-255,1484,289556,96,340374
4315,0.05087,74.125.200.0-255,4320,293876,96,340374
4316,0.050875,172.31.47.0-255,66,293942,96,340374
4317,0.053186,74.125.200.0-255,5738,299680,96,340374
4318,0.053193,172.31.47.0-255,66,299746,96,340374
4319,0.055495,74.125.200.0-255,5738,305484,96,340374
4320,0.0555,172.31.47.0-255,66,305550,96,340374
4321,0.057806,74.125.200.0-255,5738,311288,96,340374
4322,0.057811,172.31.47.0-255,66,311354,96,340374
4323,0.060122,74.125.200.0-255,5738,317092,96,340374
4324,0.060128,172.31.47.0-255,66,317158,96,340374
4325,0.062426,74.125.200.0-255,5738,322896,96,340374
4326,0.062433,172.31.47.0-255,66,322962,96,340374
4327,0.064741,74.125.200.0-255,5738,328700,96,340374
4328,0.064747,172.31.47.0-255,66,328766,96,340374
4329,0.067046,74.125.200.0-255,5738,334504,96,340374
4330,0.067051,172.31.47.0-255,66,334570,96,340374
4331,0.069352,74.125.200.0-255,5738,340308,96,340374
4332,0.069357,172.31.47.0-255,66,340374,96,340374
4333,0.0,172.217.194.0-255,152,152,96,180190
4334,2.7e-05,172.31.47.0-255,66,218,96,180190
4335,3.4e-05,172.217.194.0-255,1484,1702,96,180190
4336,3.7e-05,172.31.47.0-255,66,1768,96,180190
4337,4.2e-05,172.217.194.0-255,2902,4670,96,180190
4338,5.2e-05,172.31.47.0-255,66,4736,96,180190
4339,6e-05,172.217.194.0-255,7156,11892,96,180190
4340,6.2e-05,172.31.47.0-255,66,11958,96,180190
4341,8.8e-05,172.217.194.0-255,2055,14013,96,180190
4342,9.1e-05,172.31.47.0-255,66,14079,96,180190
4343,0.000125,172.217.194.0-255,2902,16981,96,180190
4344,0.000129,172.31.47.0-255,66,17047,96,180190
4345,0.000136,172.217.194.0-255,7156,24203,96,180190
4346,0.000139,172.31.47.0-255,66,24269,96,180190
4347,0.000146,172.217.194.0-255,1484,25753,96,180190
4348,0.000148,172.31.47.0-255,66,25819,96,180190
4349,0.000172,172.217.194.0-255,5379,31198,96,180190
4350,0.000179,172.31.47.0-255,66,31264,96,180190
4351,0.000219,172.217.194.0-255,4320,35584,96,180190
4352,0.000221,172.31.47.0-255,66,35650,96,180190
4353,0.000248,172.217.194.0-255,5738,41388,96,180190
4354,0.000252,172.31.47.0-255,66,41454,96,180190
4355,0.000287,172.217.194.0-255,4320,45774,96,180190
4356,0.000291,172.31.47.0-255,66,45840,96,180190
4357,0.000332,172.31.47.0-255,66,45906,96,180190
4358,0.00035,172.31.47.0-255,66,45972,96,180190
4359,0.000353,172.217.194.0-255,367,46339,96,180190
4360,0.000355,172.31.47.0-255,66,46405,96,180190
4361,0.000435,172.217.194.0-255,1484,47889,96,180190
4362,0.000439,172.31.47.0-255,66,47955,96,180190
4363,0.000444,172.217.194.0-255,2902,50857,96,180190
4364,0.000446,172.31.47.0-255,66,50923,96,180190
4365,0.000449,172.217.194.0-255,1484,52407,96,180190
4366,0.000481,172.217.194.0-255,4320,56727,96,180190
4367,0.000485,172.31.47.0-255,66,56793,96,180190
4368,0.000503,172.31.47.0-255,66,56859,96,180190
4369,0.000535,172.217.194.0-255,7156,64015,96,180190
4370,0.000538,172.31.47.0-255,66,64081,96,180190
4371,0.000571,172.217.194.0-255,6797,70878,96,180190
4372,0.000575,172.31.47.0-255,66,70944,96,180190
4373,0.000631,172.217.194.0-255,1484,72428,96,180190
4374,0.000634,172.217.194.0-255,1484,73912,96,180190
4375,0.000636,172.31.47.0-255,66,73978,96,180190
4376,0.000661,172.217.194.0-255,1484,75462,96,180190
4377,0.000667,172.217.194.0-255,5738,81200,96,180190
4378,0.00067,172.31.47.0-255,66,81266,96,180190
4379,0.000681,172.31.47.0-255,66,81332,96,180190
4380,0.000717,172.217.194.0-255,4320,85652,96,180190
4381,0.000721,172.31.47.0-255,66,85718,96,180190
4382,0.00074,172.31.47.0-255,66,85784,96,180190
4383,0.000918,172.217.194.0-255,1484,87268,96,180190
4384,0.00094,172.217.194.0-255,2902,90170,96,180190
4385,0.000944,172.31.47.0-255,66,90236,96,180190
4386,0.000951,172.217.194.0-255,5738,95974,96,180190
4387,0.000953,172.31.47.0-255,66,96040,96,180190
4388,0.000968,172.31.47.0-255,66,96106,96,180190
4389,0.000996,172.217.194.0-255,4320,100426,96,180190
4390,0.000999,172.31.47.0-255,66,100492,96,180190
4391,0.001017,172.31.47.0-255,66,100558,96,180190
4392,0.001079,172.217.194.0-255,1484,102042,96,180190
4393,0.001083,172.217.194.0-255,1484,103526,96,180190
4394,0.001086,172.31.47.0-255,66,103592,96,180190
4395,0.001105,172.217.194.0-255,1484,105076,96,180190
4396,0.001113,172.217.194.0-255,5738,110814,96,180190
4397,0.001116,172.31.47.0-255,66,110880,96,180190
4398,0.001123,172.217.194.0-255,7156,118036,96,180190
4399,0.001126,172.31.47.0-255,66,118102,96,180190
4400,0.001151,172.217.194.0-255,5738,123840,96,180190
4401,0.001153,172.31.47.0-255,66,123906,96,180190
4402,0.001168,172.31.47.0-255,66,123972,96,180190
4403,0.00143,172.217.194.0-255,1484,125456,96,180190
4404,0.001446,172.217.194.0-255,2902,128358,96,180190
4405,0.001449,172.31.47.0-255,66,128424,96,180190
4406,0.001454,172.217.194.0-255,4320,132744,96,180190
4407,0.001456,172.31.47.0-255,66,132810,96,180190
4408,0.001471,172.217.194.0-255,1484,134294,96,180190
4409,0.001506,172.31.47.0-255,66,134360,96,180190
4410,0.001512,172.217.194.0-255,7156,141516,96,180190
4411,0.001514,172.31.47.0-255,66,141582,96,180190
4412,0.001576,172.217.194.0-255,3602,145184,96,180190
4413,0.001579,172.31.47.0-255,66,145250,96,180190
4414,0.00163,172.217.194.0-255,1484,146734,96,180190
4415,0.001645,172.217.194.0-255,2902,149636,96,180190
4416,0.001648,172.217.194.0-255,2902,152538,96,180190
4417,0.001648,172.31.47.0-255,66,152604,96,180190
4418,0.001652,172.31.47.0-255,66,152670,96,180190
4419,0.001661,172.217.194.0-255,2902,155572,96,180190
4420,0.001667,172.31.47.0-255,66,155638,96,180190
4421,0.001671,172.217.194.0-255,2902,158540,96,180190
4422,0.001672,172.31.47.0-255,66,158606,96,180190
4423,0.001719,172.31.47.0-255,66,158672,96,180190
4424,0.001725,172.31.47.0-255,66,158738,96,180190
4425,0.001735,172.31.47.0-255,66,158804,96,180190
4426,0.001775,172.31.47.0-255,66,158870,96,180190
4427,0.001812,172.31.47.0-255,66,158936,96,180190
4428,0.001834,172.31.47.0-255,66,159002,96,180190
4429,0.001845,172.31.47.0-255,66,159068,96,180190
4430,0.001878,172.217.194.0-255,5738,164806,96,180190
4431,0.001882,172.31.47.0-255,66,164872,96,180190
4432,0.001917,172.31.47.0-255,66,164938,96,180190
4433,0.001949,172.217.194.0-255,1484,166422,96,180190
4434,0.001972,172.31.47.0-255,66,166488,96,180190
4435,0.001983,172.31.47.0-255,66,166554,96,180190
4436,0.00201,172.217.194.0-255,2184,168738,96,180190
4437,0.002014,172.31.47.0-255,66,168804,96,180190
4438,0.00202,172.217.194.0-255,6683,175487,96,180190
4439,0.002023,172.31.47.0-255,66,175553,96,180190
4440,0.00203,172.217.194.0-255,105,175658,96,180190
4441,0.008706,172.31.47.0-255,66,175724,96,180190
4442,0.008733,172.31.47.0-255,105,175829,96,180190
4443,0.010924,172.217.194.0-255,66,175895,96,180190
4444,0.032216,172.31.47.0-255,172,176067,96,180190
4445,0.032243,172.31.47.0-255,1110,177177,96,180190
4446,0.032276,172.31.47.0-255,1514,178691,96,180190
4447,0.032278,172.31.47.0-255,1301,179992,96,180190
4448,0.033746,104.244.42.0-255,66,180058,96,180190
4449,0.033786,104.244.42.0-255,66,180124,96,180190
4450,0.033838,104.244.42.0-255,66,180190,96,180190
4451,0.0,216.58.221.0-255,153,153,96,361832
4452,3.2e-05,172.31.47.0-255,66,219,96,361832
4453,4.9e-05,216.58.221.0-255,1484,1703,96,361832
4454,6.1e-05,172.31.47.0-255,66,1769,96,361832
4455,6.6e-05,216.58.221.0-255,2902,4671,96,361832
4456,6.9e-05,172.31.47.0-255,66,4737,96,361832
4457,0.00011,216.58.221.0-255,4320,9057,96,361832
4458,0.000113,172.31.47.0-255,66,9123,96,361832
4459,0.000116,216.58.221.0-255,1484,10607,96,361832
4460,0.000118,172.31.47.0-255,66,10673,96,361832
4461,0.000149,216.58.221.0-255,3510,14183,96,361832
4462,0.000153,172.31.47.0-255,66,14249,96,361832
4463,0.000156,216.58.221.0-255,1484,15733,96,361832
4464,0.000158,172.31.47.0-255,66,15799,96,361832
4465,0.000163,216.58.221.0-255,2902,18701,96,361832
4466,0.000166,172.31.47.0-255,66,18767,96,361832
4467,0.000185,216.58.221.0-255,4320,23087,96,361832
4468,0.000188,172.31.47.0-255,66,23153,96,361832
4469,0.000213,216.58.221.0-255,1484,24637,96,361832
4470,0.000215,172.31.47.0-255,66,24703,96,361832
4471,0.000222,216.58.221.0-255,6797,31500,96,361832
4472,0.000225,172.31.47.0-255,66,31566,96,361832
4473,0.000302,216.58.221.0-255,1484,33050,96,361832
4474,0.000306,172.31.47.0-255,66,33116,96,361832
4475,0.000312,216.58.221.0-255,2902,36018,96,361832
4476,0.000314,172.31.47.0-255,66,36084,96,361832
4477,0.000317,216.58.221.0-255,1484,37568,96,361832
4478,0.000325,172.31.47.0-255,66,37634,96,361832
4479,0.000349,216.58.221.0-255,4320,41954,96,361832
4480,0.000353,172.31.47.0-255,66,42020,96,361832
4481,0.00036,216.58.221.0-255,6797,48817,96,361832
4482,0.000363,172.31.47.0-255,66,48883,96,361832
4483,0.000368,216.58.221.0-255,5738,54621,96,361832
4484,0.000371,172.31.47.0-255,66,54687,96,361832
4485,0.000395,216.58.221.0-255,1484,56171,96,361832
4486,0.000401,216.58.221.0-255,2902,59073,96,361832
4487,0.000404,172.31.47.0-255,66,59139,96,361832
4488,0.000436,216.58.221.0-255,7100,66239,96,361832
4489,0.00044,172.31.47.0-255,66,66305,96,361832
4490,0.001019,216.58.221.0-255,120,66425,96,361832
4491,0.001195,216.58.221.0-255,1484,67909,96,361832
4492,0.001201,172.31.47.0-255,66,67975,96,361832
4493,0.001207,216.58.221.0-255,2902,70877,96,361832
4494,0.001209,172.31.47.0-255,66,70943,96,361832
4495,0.001238,216.58.221.0-255,1484,72427,96,361832
4496,0.001257,216.58.221.0-255,2902,75329,96,361832
4497,0.001259,172.31.47.0-255,66,75395,96,361832
4498,0.001263,216.58.221.0-255,1484,76879,96,361832
4499,0.001287,216.58.221.0-255,1484,78363,96,361832
4500,0.00129,172.31.47.0-255,66,78429,96,361832
4501,0.001295,216.58.221.0-255,4320,82749,96,361832
4502,0.001296,172.31.47.0-255,66,82815,96,361832
4503,0.00132,172.31.47.0-255,66,82881,96,361832
4504,0.001359,216.58.221.0-255,4320,87201,96,361832
4505,0.001361,172.31.47.0-255,66,87267,96,361832
4506,0.001383,216.58.221.0-255,3961,91228,96,361832
4507,0.001385,172.31.47.0-255,66,91294,96,361832
4508,0.001432,216.58.221.0-255,1484,92778,96,361832
4509,0.001452,216.58.221.0-255,2902,95680,96,361832
4510,0.001454,172.31.47.0-255,66,95746,96,361832
4511,0.001459,216.58.221.0-255,5738,101484,96,361832
4512,0.00146,172.31.47.0-255,66,101550,96,361832
4513,0.001463,216.58.221.0-255,1484,103034,96,361832
4514,0.001479,216.58.221.0-255,2902,105936,96,361832
4515,0.001481,172.31.47.0-255,66,106002,96,361832
4516,0.001485,216.58.221.0-255,2902,108904,96,361832
4517,0.001486,172.31.47.0-255,66,108970,96,361832
4518,0.001513,216.58.221.0-255,2902,111872,96,361832
4519,0.001514,172.31.47.0-255,66,111938,96,361832
4520,0.001523,172.31.47.0-255,66,112004,96,361832
4521,0.001543,216.58.221.0-255,1484,113488,96,361832
4522,0.001546,216.58.221.0-255,2184,115672,96,361832
4523,0.001548,172.31.47.0-255,66,115738,96,361832
4524,0.00157,216.58.221.0-255,1484,117222,96,361832
4525,0.001573,216.58.221.0-255,2902,120124,96,361832
4526,0.001575,172.31.47.0-255,66,120190,96,361832
4527,0.001598,216.58.221.0-255,5738,125928,96,361832
4528,0.001601,172.31.47.0-255,66,125994,96,361832
4529,0.001635,172.31.47.0-255,66,126060,96,361832
4530,0.00164,216.58.221.0-255,7156,133216,96,361832
4531,0.001642,172.31.47.0-255,66,133282,96,361832
4532,0.001661,216.58.221.0-255,1484,134766,96,361832
4533,0.001671,216.58.221.0-255,2184,136950,96,361832
4534,0.001673,172.31.47.0-255,66,137016,96,361832
4535,0.001871,216.58.221.0-255,1484,138500,96,361832
4536,0.001883,216.58.221.0-255,2902,141402,96,361832
4537,0.001885,172.31.47.0-255,66,141468,96,361832
4538,0.001888,216.58.221.0-255,1484,142952,96,361832
4539,0.001916,216.58.221.0-255,4320,147272,96,361832
4540,0.001918,172.31.47.0-255,66,147338,96,361832
4541,0.001923,216.58.221.0-255,5738,153076,96,361832
4542,0.001925,172.31.47.0-255,66,153142,96,361832
4543,0.001957,216.58.221.0-255,7156,160298,96,361832
4544,0.001959,172.31.47.0-255,66,160364,96,361832
4545,0.003831,216.58.221.0-255,4320,164684,96,361832
4546,0.003834,172.31.47.0-255,66,164750,96,361832
4547,0.003848,216.58.221.0-255,1484,166234,96,361832
4548,0.005722,216.58.221.0-255,4320,170554,96,361832
4549,0.005727,172.31.47.0-255,66,170620,96,361832
4550,0.007648,216.58.221.0-255,5738,176358,96,361832
4551,0.007653,172.31.47.0-255,66,176424,96,361832
4552,0.009547,216.58.221.0-255,5738,182162,96,361832
4553,0.009554,172.31.47.0-255,66,182228,96,361832
4554,0.011451,216.58.221.0-255,5738,187966,96,361832
4555,0.011458,172.31.47.0-255,66,188032,96,361832
4556,0.013356,216.58.221.0-255,5738,193770,96,361832
4557,0.013366,172.31.47.0-255,66,193836,96,361832
4558,0.015255,216.58.221.0-255,5738,199574,96,361832
4559,0.015261,172.31.47.0-255,66,199640,96,361832
4560,0.017155,216.58.221.0-255,5738,205378,96,361832
4561,0.017161,172.31.47.0-255,66,205444,96,361832
4562,0.019049,216.58.221.0-255,4320,209764,96,361832
4563,0.019054,172.31.47.0-255,66,209830,96,361832
4564,0.019085,216.58.221.0-255,1484,211314,96,361832
4565,0.02095,216.58.221.0-255,4320,215634,96,361832
4566,0.020959,172.31.47.0-255,66,215700,96,361832
4567,0.022864,216.58.221.0-255,5738,221438,96,361832
4568,0.022873,172.31.47.0-255,66,221504,96,361832
4569,0.024568,172.31.47.0-255,172,221676,96,361832
4570,0.024595,172.31.47.0-255,1110,222786,96,361832
4571,0.024629,172.31.47.0-255,1514,224300,96,361832
4572,0.024631,172.31.47.0-255,1302,225602,96,361832
4573,0.024755,216.58.221.0-255,4320,229922,96,361832
4574,0.024761,172.31.47.0-255,66,229988,96,361832
4575,0.024792,216.58.221.0-255,1484,231472,96,361832
4576,0.026104,104.244.42.0-255,66,231538,96,361832
4577,0.026301,104.244.42.0-255,66,231604,96,361832
4578,0.026303,104.244.42.0-255,66,231670,96,361832
4579,0.026642,216.58.221.0-255,2902,234572,96,361832
4580,0.026645,172.31.47.0-255,66,234638,96,361832
4581,0.026678,216.58.221.0-255,1484,236122,96,361832
4582,0.028526,216.58.221.0-255,4320,240442,96,361832
4583,0.028531,172.31.47.0-255,66,240508,96,361832
4584,0.030424,216.58.221.0-255,5738,246246,96,361832
4585,0.03043,172.31.47.0-255,66,246312,96,361832
4586,0.032327,216.58.221.0-255,5738,252050,96,361832
4587,0.032331,172.31.47.0-255,66,252116,96,361832
4588,0.034218,216.58.221.0-255,5738,257854,96,361832
4589,0.034223,172.31.47.0-255,66,257920,96,361832
4590,0.036115,216.58.221.0-255,5738,263658,96,361832
4591,0.036119,172.31.47.0-255,66,263724,96,361832
4592,0.038009,216.58.221.0-255,4320,268044,96,361832
4593,0.038013,172.31.47.0-255,66,268110,96,361832
4594,0.038039,216.58.221.0-255,1484,269594,96,361832
4595,0.0399,216.58.221.0-255,4320,273914,96,361832
4596,0.039906,172.31.47.0-255,66,273980,96,361832
4597,0.041792,216.58.221.0-255,5738,279718,96,361832
4598,0.041796,172.31.47.0-255,66,279784,96,361832
4599,0.043689,216.58.221.0-255,5738,285522,96,361832
4600,0.043693,172.31.47.0-255,66,285588,96,361832
4601,0.04558,216.58.221.0-255,5738,291326,96,361832
4602,0.045584,172.31.47.0-255,66,291392,96,361832
4603,0.047464,216.58.221.0-255,2902,294294,96,361832
4604,0.047469,172.31.47.0-255,66,294360,96,361832
4605,0.0475,216.58.221.0-255,2902,297262,96,361832
4606,0.047503,172.31.47.0-255,66,297328,96,361832
4607,0.049348,216.58.221.0-255,2902,300230,96,361832
4608,0.049354,172.31.47.0-255,66,300296,96,361832
4609,0.049387,216.58.221.0-255,2902,303198,96,361832
4610,0.04939,172.31.47.0-255,66,303264,96,361832
4611,0.051235,216.58.221.0-255,2902,306166,96,361832
4612,0.051239,172.31.47.0-255,66,306232,96,361832
4613,0.051271,216.58.221.0-255,2902,309134,96,361832
4614,0.051274,172.31.47.0-255,66,309200,96,361832
4615,0.05312,216.58.221.0-255,2902,312102,96,361832
4616,0.053124,172.31.47.0-255,66,312168,96,361832
4617,0.053158,216.58.221.0-255,2902,315070,96,361832
4618,0.053161,172.31.47.0-255,66,315136,96,361832
4619,0.055008,216.58.221.0-255,2902,318038,96,361832
4620,0.055012,172.31.47.0-255,66,318104,96,361832
4621,0.055041,216.58.221.0-255,2902,321006,96,361832
4622,0.055043,172.31.47.0-255,66,321072,96,361832
4623,0.056926,216.58.221.0-255,5738,326810,96,361832
4624,0.056931,172.31.47.0-255,66,326876,96,361832
4625,0.058817,216.58.221.0-255,5738,332614,96,361832
4626,0.058822,172.31.47.0-255,66,332680,96,361832
4627,0.060709,216.58.221.0-255,5738,338418,96,361832
4628,0.060715,172.31.47.0-255,66,338484,96,361832
4629,0.062598,216.58.221.0-255,5738,344222,96,361832
4630,0.062603,172.31.47.0-255,66,344288,96,361832
4631,0.064495,216.58.221.0-255,5738,350026,96,361832
4632,0.0645,172.31.47.0-255,66,350092,96,361832
4633,0.066389,216.58.221.0-255,5738,355830,96,361832
4634,0.066395,172.31.47.0-255,66,355896,96,361832
4635,0.068284,216.58.221.0-255,2902,358798,96,361832
4636,0.068288,172.31.47.0-255,66,358864,96,361832
4637,0.06832,216.58.221.0-255,2902,361766,96,361832
4638,0.068323,172.31.47.0-255,66,361832,96,361832
4639,0.0,172.31.47.0-255,105,105,96,276
4640,0.001758,157.240.7.0-255,105,210,96,276
4641,0.001767,172.31.47.0-255,66,276,96,276
4642,0.0,74.125.200.0-255,153,153,96,339785
4643,2.3e-05,172.31.47.0-255,66,219,96,339785
4644,3e-05,74.125.200.0-255,1484,1703,96,339785
4645,3.3e-05,172.31.47.0-255,66,1769,96,339785
4646,3.6e-05,74.125.200.0-255,1484,3253,96,339785
4647,3.8e-05,172.31.47.0-255,66,3319,96,339785
4648,6.7e-05,74.125.200.0-255,1484,4803,96,339785
4649,7e-05,172.31.47.0-255,66,4869,96,339785
4650,7.7e-05,74.125.200.0-255,5738,10607,96,339785
4651,7.9e-05,172.31.47.0-255,66,10673,96,339785
4652,0.000102,74.125.200.0-255,1484,12157,96,339785
4653,0.000105,172.31.47.0-255,66,12223,96,339785
4654,0.000123,74.125.200.0-255,2109,14332,96,339785
4655,0.000125,172.31.47.0-255,66,14398,96,339785
4656,0.000127,74.125.200.0-255,1484,15882,96,339785
4657,0.000129,172.31.47.0-255,66,15948,96,339785
4658,0.000154,74.125.200.0-255,2902,18850,96,339785
4659,0.000156,172.31.47.0-255,66,18916,96,339785
4660,0.000163,74.125.200.0-255,1484,20400,96,339785
4661,0.000165,172.31.47.0-255,66,20466,96,339785
4662,0.000197,172.31.47.0-255,66,20532,96,339785
4663,0.000201,74.125.200.0-255,2543,23075,96,339785
4664,0.000203,172.31.47.0-255,66,23141,96,339785
4665,0.000301,74.125.200.0-255,1484,24625,96,339785
4666,0.000305,172.31.47.0-255,66,24691,96,339785
4667,0.000323,74.125.200.0-255,2902,27593,96,339785
4668,0.000326,172.31.47.0-255,66,27659,96,339785
4669,0.000351,74.125.200.0-255,4320,31979,96,339785
4670,0.000353,172.31.47.0-255,66,32045,96,339785
4671,0.000378,74.125.200.0-255,2902,34947,96,339785
4672,0.000381,172.31.47.0-255,66,35013,96,339785
4673,0.000408,74.125.200.0-255,5379,40392,96,339785
4674,0.00041,172.31.47.0-255,66,40458,96,339785
4675,0.000415,74.125.200.0-255,4320,44778,96,339785
4676,0.000417,172.31.47.0-255,66,44844,96,339785
4677,0.000447,74.125.200.0-255,4320,49164,96,339785
4678,0.00045,172.31.47.0-255,66,49230,96,339785
4679,0.000454,74.125.200.0-255,2902,52132,96,339785
4680,0.000456,172.31.47.0-255,66,52198,96,339785
4681,0.00046,74.125.200.0-255,4320,56518,96,339785
4682,0.000462,172.31.47.0-255,66,56584,96,339785
4683,0.00047,74.125.200.0-255,1125,57709,96,339785
4684,0.000495,74.125.200.0-255,398,58107,96,339785
4685,0.00055,74.125.200.0-255,376,58483,96,339785
4686,0.000554,172.31.47.0-255,66,58549,96,339785
4687,0.000766,74.125.200.0-255,1484,60033,96,339785
4688,0.000796,74.125.200.0-255,2902,62935,96,339785
4689,0.0008,172.31.47.0-255,66,63001,96,339785
4690,0.000803,74.125.200.0-255,1484,64485,96,339785
4691,0.000834,74.125.200.0-255,4320,68805,96,339785
4692,0.000837,172.31.47.0-255,66,68871,96,339785
4693,0.000841,74.125.200.0-255,2902,71773,96,339785
4694,0.000844,172.31.47.0-255,66,71839,96,339785
4695,0.000849,74.125.200.0-255,4320,76159,96,339785
4696,0.000851,172.31.47.0-255,66,76225,96,339785
4697,0.000921,172.31.47.0-255,66,76291,96,339785
4698,0.000926,74.125.200.0-255,4320,80611,96,339785
4699,0.000929,172.31.47.0-255,66,80677,96,339785
4700,0.000934,74.125.200.0-255,3602,84279,96,339785
4701,0.000942,172.31.47.0-255,66,84345,96,339785
4702,0.001274,74.125.200.0-255,1484,85829,96,339785
4703,0.001279,74.125.200.0-255,1484,87313,96,339785
4704,0.001283,172.31.47.0-255,66,87379,96,339785
4705,0.001288,74.125.200.0-255,2902,90281,96,339785
4706,0.001291,172.31.47.0-255,66,90347,96,339785
4707,0.001311,74.125.200.0-255,2902,93249,96,339785
4708,0.001314,172.31.47.0-255,66,93315,96,339785
4709,0.001342,74.125.200.0-255,2902,96217,96,339785
4710,0.001344,172.31.47.0-255,66,96283,96,339785
4711,0.001354,172.31.47.0-255,66,96349,96,339785
4712,0.001357,74.125.200.0-255,1484,97833,96,339785
4713,0.001387,172.31.47.0-255,66,97899,96,339785
4714,0.00139,74.125.200.0-255,766,98665,96,339785
4715,0.001428,74.125.200.0-255,1484,100149,96,339785
4716,0.00143,172.31.47.0-255,66,100215,96,339785
4717,0.001458,74.125.200.0-255,2902,103117,96,339785
4718,0.001461,172.31.47.0-255,66,103183,96,339785
4719,0.001478,74.125.200.0-255,2902,106085,96,339785
4720,0.00148,172.31.47.0-255,66,106151,96,339785
4721,0.001509,74.125.200.0-255,2902,109053,96,339785
4722,0.001511,172.31.47.0-255,66,109119,96,339785
4723,0.001522,172.31.47.0-255,66,109185,96,339785
4724,0.001549,74.125.200.0-255,1484,110669,96,339785
4725,0.00156,74.125.200.0-255,2902,113571,96,339785
4726,0.001562,172.31.47.0-255,66,113637,96,339785
4727,0.001602,172.31.47.0-255,66,113703,96,339785
4728,0.001933,74.125.200.0-255,1484,115187,96,339785
4729,0.001938,74.125.200.0-255,2902,118089,96,339785
4730,0.001941,172.31.47.0-255,66,118155,96,339785
4731,0.001967,74.125.200.0-255,1484,119639,96,339785
4732,0.001978,74.125.200.0-255,2902,122541,96,339785
4733,0.00198,172.31.47.0-255,66,122607,96,339785
4734,0.001986,74.125.200.0-255,5738,128345,96,339785
4735,0.001988,172.31.47.0-255,66,128411,96,339785
4736,0.002008,74.125.200.0-255,2902,131313,96,339785
4737,0.00201,172.31.47.0-255,66,131379,96,339785
4738,0.002016,74.125.200.0-255,5738,137117,96,339785
4739,0.002017,172.31.47.0-255,66,137183,96,339785
4740,0.002056,74.125.200.0-255,7156,144339,96,339785
4741,0.002059,172.31.47.0-255,66,144405,96,339785
4742,0.002064,74.125.200.0-255,3602,148007,96,339785
4743,0.002066,172.31.47.0-255,66,148073,96,339785
4744,0.00213,74.125.200.0-255,1484,149557,96,339785
4745,0.002145,74.125.200.0-255,1484,151041,96,339785
4746,0.002149,172.31.47.0-255,66,151107,96,339785
4747,0.002157,74.125.200.0-255,1484,152591,96,339785
4748,0.002161,74.125.200.0-255,2902,155493,96,339785
4749,0.002163,172.31.47.0-255,66,155559,96,339785
4750,0.002191,74.125.200.0-255,2902,158461,96,339785
4751,0.002193,172.31.47.0-255,66,158527,96,339785
4752,0.002203,172.31.47.0-255,66,158593,96,339785
4753,0.002208,74.125.200.0-255,7156,165749,96,339785
4754,0.00221,172.31.47.0-255,66,165815,96,339785
4755,0.002235,74.125.200.0-255,2902,168717,96,339785
4756,0.00224,74.125.200.0-255,5020,173737,96,339785
4757,0.002243,172.31.47.0-255,66,173803,96,339785
4758,0.002246,172.31.47.0-255,66,173869,96,339785
4759,0.004524,74.125.200.0-255,4320,178189,96,339785
4760,0.004528,172.31.47.0-255,66,178255,96,339785
4761,0.004551,74.125.200.0-255,1484,179739,96,339785
4762,0.006828,74.125.200.0-255,4320,184059,96,339785
4763,0.006833,172.31.47.0-255,66,184125,96,339785
4764,0.009144,74.125.200.0-255,5738,189863,96,339785
4765,0.009152,172.31.47.0-255,66,189929,96,339785
4766,0.01149,74.125.200.0-255,5738,195667,96,339785
4767,0.01151,172.31.47.0-255,66,195733,96,339785
4768,0.013831,74.125.200.0-255,5738,201471,96,339785
4769,0.013849,172.31.47.0-255,66,201537,96,339785
4770,0.016203,74.125.200.0-255,5738,207275,96,339785
4771,0.016221,172.31.47.0-255,66,207341,96,339785
4772,0.018528,74.125.200.0-255,5738,213079,96,339785
4773,0.018545,172.31.47.0-255,66,213145,96,339785
4774,0.020848,74.125.200.0-255,5738,218883,96,339785
4775,0.020861,172.31.47.0-255,66,218949,96,339785
4776,0.023162,74.125.200.0-255,5738,224687,96,339785
4777,0.023169,172.31.47.0-255,66,224753,96,339785
4778,0.025457,74.125.200.0-255,4320,229073,96,339785
4779,0.025462,172.31.47.0-255,66,229139,96,339785
4780,0.025489,74.125.200.0-255,1484,230623,96,339785
4781,0.027762,74.125.200.0-255,4320,234943,96,339785
4782,0.02777,172.31.47.0-255,66,235009,96,339785
4783,0.030121,74.125.200.0-255,5738,240747,96,339785
4784,0.030128,172.31.47.0-255,66,240813,96,339785
4785,0.032422,74.125.200.0-255,5738,246551,96,339785
4786,0.032429,172.31.47.0-255,66,246617,96,339785
4787,0.034741,74.125.200.0-255,5738,252355,96,339785
4788,0.034749,172.31.47.0-255,66,252421,96,339785
4789,0.037064,74.125.200.0-255,5738,258159,96,339785
4790,0.037083,172.31.47.0-255,66,258225,96,339785
4791,0.039399,74.125.200.0-255,5738,263963,96,339785
4792,0.039417,172.31.47.0-255,66,264029,96,339785
4793,0.041717,74.125.200.0-255,4320,268349,96,339785
4794,0.041723,172.31.47.0-255,66,268415,96,339785
4795,0.041751,74.125.200.0-255,1484,269899,96,339785
4796,0.042191,172.31.47.0-255,171,270070,96,339785
4797,0.042227,172.31.47.0-255,1125,271195,96,339785
4798,0.042296,172.31.47.0-255,1514,272709,96,339785
4799,0.042298,172.31.47.0-255,1286,273995,96,339785
4800,0.043775,104.244.42.0-255,66,274061,96,339785
4801,0.043784,104.244.42.0-255,66,274127,96,339785
4802,0.043868,104.244.42.0-255,66,274193,96,339785
4803,0.044032,74.125.200.0-255,4320,278513,96,339785
4804,0.044039,172.31.47.0-255,66,278579,96,339785
4805,0.046361,74.125.200.0-255,5738,284317,96,339785
4806,0.046379,172.31.47.0-255,66,284383,96,339785
4807,0.048704,74.125.200.0-255,5738,290121,96,339785
4808,0.048713,172.31.47.0-255,66,290187,96,339785
4809,0.051,74.125.200.0-255,5738,295925,96,339785
4810,0.051004,172.31.47.0-255,66,295991,96,339785
4811,0.053287,74.125.200.0-255,4320,300311,96,339785
4812,0.053293,172.31.47.0-255,66,300377,96,339785
4813,0.053328,74.125.200.0-255,1484,301861,96,339785
4814,0.055573,74.125.200.0-255,4320,306181,96,339785
4815,0.055578,172.31.47.0-255,66,306247,96,339785
4816,0.057856,74.125.200.0-255,1484,307731,96,339785
4817,0.057889,74.125.200.0-255,4320,312051,96,339785
4818,0.057893,172.31.47.0-255,66,312117,96,339785
4819,0.060171,74.125.200.0-255,4320,316437,96,339785
4820,0.060177,172.31.47.0-255,66,316503,96,339785
4821,0.060211,74.125.200.0-255,1484,317987,96,339785
4822,0.062462,74.125.200.0-255,4320,322307,96,339785
4823,0.062467,172.31.47.0-255,66,322373,96,339785
4824,0.064758,74.125.200.0-255,5738,328111,96,339785
4825,0.064764,172.31.47.0-255,66,328177,96,339785
4826,0.067082,74.125.200.0-255,5738,333915,96,339785
4827,0.067087,172.31.47.0-255,66,333981,96,339785
4828,0.069377,74.125.200.0-255,5738,339719,96,339785
4829,0.069383,172.31.47.0-255,66,339785,96,339785
4830,0.0,172.217.194.0-255,146,146,96,190410
4831,2.2e-05,172.31.47.0-255,66,212,96,190410
4832,2.8e-05,172.217.194.0-255,1484,1696,96,190410
4833,3.2e-05,172.31.47.0-255,66,1762,96,190410
4834,4.2e-05,172.217.194.0-255,2902,4664,96,190410
4835,4.6e-05,172.31.47.0-255,66,4730,96,190410
4836,5.3e-05,172.217.194.0-255,7156,11886,96,190410
4837,5.5e-05,172.31.47.0-255,66,11952,96,190410
4838,8.2e-05,172.217.194.0-255,2103,14055,96,190410
4839,8.8e-05,172.31.47.0-255,66,14121,96,190410
4840,0.000145,172.217.194.0-255,1484,15605,96,190410
4841,0.000147,172.31.47.0-255,66,15671,96,190410
4842,0.000166,172.217.194.0-255,2902,18573,96,190410
4843,0.000168,172.31.47.0-255,66,18639,96,190410
4844,0.000174,172.217.194.0-255,5738,24377,96,190410
4845,0.000175,172.31.47.0-255,66,24443,96,190410
4846,0.000228,172.31.47.0-255,66,24509,96,190410
4847,0.000242,172.31.47.0-255,66,24575,96,190410
4848,0.000274,172.217.194.0-255,5738,30313,96,190410
4849,0.000276,172.31.47.0-255,66,30379,96,190410
4850,0.000304,172.31.47.0-255,66,30445,96,190410
4851,0.000329,172.217.194.0-255,1484,31929,96,190410
4852,0.000331,172.31.47.0-255,66,31995,96,190410
4853,0.000336,172.217.194.0-255,2902,34897,96,190410
4854,0.000338,172.31.47.0-255,66,34963,96,190410
4855,0.000348,172.217.194.0-255,5738,40701,96,190410
4856,0.00035,172.31.47.0-255,66,40767,96,190410
4857,0.000393,172.31.47.0-255,66,40833,96,190410
4858,0.000403,172.31.47.0-255,66,40899,96,190410
4859,0.000436,172.217.194.0-255,2497,43396,96,190410
4860,0.000438,172.31.47.0-255,66,43462,96,190410
4861,0.000468,172.217.194.0-255,1484,44946,96,190410
4862,0.000469,172.31.47.0-255,66,45012,96,190410
4863,0.000472,172.217.194.0-255,1484,46496,96,190410
4864,0.000474,172.31.47.0-255,66,46562,96,190410
4865,0.000508,172.217.194.0-255,1484,48046,96,190410
4866,0.00051,172.31.47.0-255,66,48112,96,190410
4867,0.000516,172.217.194.0-255,5738,53850,96,190410
4868,0.000518,172.31.47.0-255,66,53916,96,190410
4869,0.000534,172.31.47.0-255,66,53982,96,190410
4870,0.000544,172.31.47.0-255,66,54048,96,190410
4871,0.000587,172.217.194.0-255,7156,61204,96,190410
4872,0.000589,172.31.47.0-255,66,61270,96,190410
4873,0.00062,172.31.47.0-255,66,61336,96,190410
4874,0.000624,172.217.194.0-255,2543,63879,96,190410
4875,0.000625,172.31.47.0-255,66,63945,96,190410
4876,0.000643,172.217.194.0-255,2902,66847,96,190410
4877,0.000645,172.31.47.0-255,66,66913,96,190410
4878,0.000651,172.217.194.0-255,1484,68397,96,190410
4879,0.000675,172.217.194.0-255,5738,74135,96,190410
4880,0.000677,172.31.47.0-255,66,74201,96,190410
4881,0.000683,172.217.194.0-255,5738,79939,96,190410
4882,0.000685,172.31.47.0-255,66,80005,96,190410
4883,0.000719,172.31.47.0-255,66,80071,96,190410
4884,0.000745,172.31.47.0-255,66,80137,96,190410
4885,0.000771,172.217.194.0-255,3602,83739,96,190410
4886,0.000773,172.31.47.0-255,66,83805,96,190410
4887,0.000782,172.31.47.0-255,66,83871,96,190410
4888,0.000862,172.31.47.0-255,66,83937,96,190410
4889,0.000895,172.31.47.0-255,66,84003,96,190410
4890,0.000925,172.217.194.0-255,4320,88323,96,190410
4891,0.000928,172.31.47.0-255,66,88389,96,190410
4892,0.000946,172.31.47.0-255,66,88455,96,190410
4893,0.00095,172.217.194.0-255,3602,92057,96,190410
4894,0.000952,172.31.47.0-255,66,92123,96,190410
4895,0.00097,172.217.194.0-255,4320,96443,96,190410
4896,0.000972,172.31.47.0-255,66,96509,96,190410
4897,0.000983,172.217.194.0-255,2543,99052,96,190410
4898,0.000992,172.31.47.0-255,66,99118,96,190410
4899,0.001005,172.217.194.0-255,1484,100602,96,190410
4900,0.001009,172.217.194.0-255,2902,103504,96,190410
4901,0.001017,172.217.194.0-255,5738,109242,96,190410
4902,0.001028,172.31.47.0-255,66,109308,96,190410
4903,0.001046,172.217.194.0-255,7156,116464,96,190410
4904,0.001075,172.217.194.0-255,5738,122202,96,190410
4905,0.001081,172.217.194.0-255,7156,129358,96,190410
4906,0.001087,172.31.47.0-255,66,129424,96,190410
4907,0.001111,172.217.194.0-255,3602,133026,96,190410
4908,0.001117,172.217.194.0-255,4320,137346,96,190410
4909,0.00112,172.217.194.0-255,2902,140248,96,190410
4910,0.001134,172.217.194.0-255,7156,147404,96,190410
4911,0.001149,172.217.194.0-255,1484,148888,96,190410
4912,0.001154,172.31.47.0-255,66,148954,96,190410
4913,0.001203,172.31.47.0-255,66,149020,96,190410
4914,0.00123,172.217.194.0-255,3602,152622,96,190410
4915,0.001257,172.31.47.0-255,66,152688,96,190410
4916,0.001276,172.31.47.0-255,66,152754,96,190410
4917,0.001306,172.217.194.0-255,4320,157074,96,190410
4918,0.001309,172.217.194.0-255,1484,158558,96,190410
4919,0.001318,172.31.47.0-255,66,158624,96,190410
4920,0.001328,172.217.194.0-255,4320,162944,96,190410
4921,0.001371,172.217.194.0-255,7156,170100,96,190410
4922,0.001378,172.31.47.0-255,66,170166,96,190410
4923,0.001388,172.217.194.0-255,4320,174486,96,190410
4924,0.001408,172.217.194.0-255,5738,180224,96,190410
4925,0.001425,172.217.194.0-255,5384,185608,96,190410
4926,0.001428,172.217.194.0-255,97,185705,96,190410
4927,0.001441,172.31.47.0-255,66,185771,96,190410
4928,0.001465,172.217.194.0-255,105,185876,96,190410
4929,0.00438,172.31.47.0-255,66,185942,96,190410
4930,0.004417,172.31.47.0-255,105,186047,96,190410
4931,0.006712,172.217.194.0-255,66,186113,96,190410
4932,0.026401,172.31.47.0-255,172,186285,96,190410
4933,0.026434,172.31.47.0-255,1105,187390,96,190410
4934,0.026494,172.31.47.0-255,1514,188904,96,190410
4935,0.026496,172.31.47.0-255,1308,190212,96,190410
4936,0.027925,104.244.42.0-255,66,190278,96,190410
4937,0.027977,104.244.42.0-255,66,190344,96,190410
4938,0.028014,104.244.42.0-255,66,190410,96,190410
4939,0.0,74.125.200.0-255,153,153,96,245840
4940,3.3e-05,172.31.47.0-255,66,219,96,245840
4941,4e-05,74.125.200.0-255,1484,1703,96,245840
4942,4.5e-05,172.31.47.0-255,66,1769,96,245840
4943,5e-05,74.125.200.0-255,2902,4671,96,245840
4944,6.1e-05,172.31.47.0-255,66,4737,96,245840
4945,6.5e-05,74.125.200.0-255,2902,7639,96,245840
4946,6.8e-05,172.31.47.0-255,66,7705,96,245840
4947,9.5e-05,74.125.200.0-255,1484,9189,96,245840
4948,9.9e-05,172.31.47.0-255,66,9255,96,245840
4949,0.000105,74.125.200.0-255,5011,14266,96,245840
4950,0.000108,172.31.47.0-255,66,14332,96,245840
4951,0.00027,74.125.200.0-255,1484,15816,96,245840
4952,0.000274,172.31.47.0-255,66,15882,96,245840
4953,0.000279,74.125.200.0-255,1484,17366,96,245840
4954,0.000281,172.31.47.0-255,66,17432,96,245840
4955,0.00031,74.125.200.0-255,1484,18916,96,245840
4956,0.000314,172.31.47.0-255,66,18982,96,245840
4957,0.000318,74.125.200.0-255,2902,21884,96,245840
4958,0.000321,172.31.47.0-255,66,21950,96,245840
4959,0.000326,74.125.200.0-255,4320,26270,96,245840
4960,0.000329,172.31.47.0-255,66,26336,96,245840
4961,0.000365,172.31.47.0-255,66,26402,96,245840
4962,0.000398,172.31.47.0-255,66,26468,96,245840
4963,0.000403,74.125.200.0-255,4320,30788,96,245840
4964,0.000406,172.31.47.0-255,66,30854,96,245840
4965,0.000449,172.31.47.0-255,66,30920,96,245840
4966,0.000454,74.125.200.0-255,1484,32404,96,245840
4967,0.000457,172.31.47.0-255,66,32470,96,245840
4968,0.000495,74.125.200.0-255,421,32891,96,245840
4969,0.0005,172.31.47.0-255,66,32957,96,245840
4970,0.00053,74.125.200.0-255,1484,34441,96,245840
4971,0.000544,74.125.200.0-255,2902,37343,96,245840
4972,0.000554,172.31.47.0-255,66,37409,96,245840
4973,0.000559,74.125.200.0-255,4320,41729,96,245840
4974,0.000573,172.31.47.0-255,66,41795,96,245840
4975,0.0006,74.125.200.0-255,7156,48951,96,245840
4976,0.00061,172.31.47.0-255,66,49017,96,245840
4977,0.00062,74.125.200.0-255,1484,50501,96,245840
4978,0.000624,74.125.200.0-255,2902,53403,96,245840
4979,0.000638,172.31.47.0-255,66,53469,96,245840
4980,0.00065,74.125.200.0-255,5738,59207,96,245840
4981,0.00067,172.31.47.0-255,66,59273,96,245840
4982,0.000676,74.125.200.0-255,7156,66429,96,245840
4983,0.000679,74.125.200.0-255,766,67195,96,245840
4984,0.000687,172.31.47.0-255,66,67261,96,245840
4985,0.000892,74.125.200.0-255,354,67615,96,245840
4986,0.001049,74.125.200.0-255,1484,69099,96,245840
4987,0.001053,172.31.47.0-255,66,69165,96,245840
4988,0.001057,74.125.200.0-255,1484,70649,96,245840
4989,0.001076,74.125.200.0-255,1484,72133,96,245840
4990,0.001082,74.125.200.0-255,5738,77871,96,245840
4991,0.001091,172.31.47.0-255,66,77937,96,245840
4992,0.001137,172.31.47.0-255,66,78003,96,245840
4993,0.001193,172.31.47.0-255,66,78069,96,245840
4994,0.001547,74.125.200.0-255,1484,79553,96,245840
4995,0.001557,74.125.200.0-255,2902,82455,96,245840
4996,0.001561,172.31.47.0-255,66,82521,96,245840
4997,0.001592,74.125.200.0-255,5738,88259,96,245840
4998,0.001596,74.125.200.0-255,1484,89743,96,245840
4999,0.001607,74.125.200.0-255,1484,91227,96,245840
5000,0.001659,74.125.200.0-255,4320,95547,96,245840
5001,0.001676,74.125.200.0-255,6438,101985,96,245840
5002,0.010872,172.31.47.0-255,66,102051,96,245840
5003,0.011009,74.125.200.0-255,1484,103535,96,245840
5004,0.013154,74.125.200.0-255,4320,107855,96,245840
5005,0.013163,172.31.47.0-255,66,107921,96,245840
5006,0.01542,74.125.200.0-255,5738,113659,96,245840
5007,0.018237,172.31.47.0-255,66,113725,96,245840
5008,0.020507,74.125.200.0-255,5738,119463,96,245840
5009,0.020518,172.31.47.0-255,66,119529,96,245840
5010,0.022795,74.125.200.0-255,5738,125267,96,245840
5011,0.022815,172.31.47.0-255,66,125333,96,245840
5012,0.025077,74.125.200.0-255,5738,131071,96,245840
5013,0.025084,172.31.47.0-255,66,131137,96,245840
5014,0.027346,74.125.200.0-255,5738,136875,96,245840
5015,0.027352,172.31.47.0-255,66,136941,96,245840
5016,0.029611,74.125.200.0-255,5738,142679,96,245840
5017,0.029623,172.31.47.0-255,66,142745,96,245840
5018,0.031885,74.125.200.0-255,5738,148483,96,245840
5019,0.031897,172.31.47.0-255,66,148549,96,245840
5020,0.034231,74.125.200.0-255,5738,154287,96,245840
5021,0.034244,172.31.47.0-255,66,154353,96,245840
5022,0.036505,74.125.200.0-255,5738,160091,96,245840
5023,0.036513,172.31.47.0-255,66,160157,96,245840
5024,0.038785,74.125.200.0-255,5738,165895,96,245840
5025,0.038802,172.31.47.0-255,66,165961,96,245840
5026,0.039727,172.31.47.0-255,172,166133,96,245840
5027,0.039754,172.31.47.0-255,1101,167234,96,245840
5028,0.039789,172.31.47.0-255,1514,168748,96,245840
5029,0.03979,172.31.47.0-255,1310,170058,96,245840
5030,0.041061,74.125.200.0-255,5738,175796,96,245840
5031,0.041072,172.31.47.0-255,66,175862,96,245840
5032,0.041283,104.244.42.0-255,66,175928,96,245840
5033,0.041423,104.244.42.0-255,66,175994,96,245840
5034,0.04143,104.244.42.0-255,66,176060,96,245840
5035,0.043338,74.125.200.0-255,5738,181798,96,245840
5036,0.043354,172.31.47.0-255,66,181864,96,245840
5037,0.045653,74.125.200.0-255,5738,187602,96,245840
5038,0.045669,172.31.47.0-255,66,187668,96,245840
5039,0.047924,74.125.200.0-255,2902,190570,96,245840
5040,0.047934,172.31.47.0-255,66,190636,96,245840
5041,0.047963,74.125.200.0-255,2902,193538,96,245840
5042,0.047982,172.31.47.0-255,66,193604,96,245840
5043,0.050223,74.125.200.0-255,5738,199342,96,245840
5044,0.050341,172.31.47.0-255,66,199408,96,245840
5045,0.052612,74.125.200.0-255,5738,205146,96,245840
5046,0.052629,172.31.47.0-255,66,205212,96,245840
5047,0.054893,74.125.200.0-255,5738,210950,96,245840
5048,0.054902,172.31.47.0-255,66,211016,96,245840
5049,0.057179,74.125.200.0-255,5738,216754,96,245840
5050,0.057191,172.31.47.0-255,66,216820,96,245840
5051,0.05947,74.125.200.0-255,5738,222558,96,245840
5052,0.059485,172.31.47.0-255,66,222624,96,245840
5053,0.061766,74.125.200.0-255,5738,228362,96,245840
5054,0.061785,172.31.47.0-255,66,228428,96,245840
5055,0.064054,74.125.200.0-255,5738,234166,96,245840
5056,0.064071,172.31.47.0-255,66,234232,96,245840
5057,0.066353,74.125.200.0-255,5738,239970,96,245840
5058,0.066372,172.31.47.0-255,66,240036,96,245840
5059,0.068734,74.125.200.0-255,5738,245774,96,245840
5060,0.068746,172.31.47.0-255,66,245840,96,245840
5061,0.0,74.125.24.0-255,297,297,96,317403
5062,2.3e-05,172.31.47.0-255,66,363,96,317403
5063,2.8e-05,74.125.24.0-255,1484,1847,96,317403
5064,3.1e-05,172.31.47.0-255,66,1913,96,317403
5065,4.4e-05,74.125.24.0-255,4320,6233,96,317403
5066,4.7e-05,172.31.47.0-255,66,6299,96,317403
5067,7.4e-05,74.125.24.0-255,2902,9201,96,317403
5068,7.6e-05,172.31.47.0-255,66,9267,96,317403
5069,9.4e-05,74.125.24.0-255,4848,14115,96,317403
5070,9.6e-05,172.31.47.0-255,66,14181,96,317403
5071,0.000153,74.125.24.0-255,1484,15665,96,317403
5072,0.000156,172.31.47.0-255,66,15731,96,317403
5073,0.000161,74.125.24.0-255,2902,18633,96,317403
5074,0.000163,172.31.47.0-255,66,18699,96,317403
5075,0.000165,74.125.24.0-255,1484,20183,96,317403
5076,0.000167,172.31.47.0-255,66,20249,96,317403
5077,0.000193,74.125.24.0-255,4320,24569,96,317403
5078,0.000199,172.31.47.0-255,66,24635,96,317403
5079,0.000224,172.31.47.0-255,66,24701,96,317403
5080,0.00025,74.125.24.0-255,3961,28662,96,317403
5081,0.000253,172.31.47.0-255,66,28728,96,317403
5082,0.00026,74.125.24.0-255,7156,35884,96,317403
5083,0.000262,172.31.47.0-255,66,35950,96,317403
5084,0.000305,74.125.24.0-255,2543,38493,96,317403
5085,0.000308,172.31.47.0-255,66,38559,96,317403
5086,0.00042,74.125.24.0-255,1484,40043,96,317403
5087,0.000424,172.31.47.0-255,66,40109,96,317403
5088,0.000428,74.125.24.0-255,2902,43011,96,317403
5089,0.00043,172.31.47.0-255,66,43077,96,317403
5090,0.00045,74.125.24.0-255,5738,48815,96,317403
5091,0.000456,172.31.47.0-255,66,48881,96,317403
5092,0.000482,74.125.24.0-255,7090,55971,96,317403
5093,0.000485,172.31.47.0-255,66,56037,96,317403
5094,0.000514,74.125.24.0-255,385,56422,96,317403
5095,0.000568,74.125.24.0-255,1484,57906,96,317403
5096,0.000571,172.31.47.0-255,66,57972,96,317403
5097,0.000574,74.125.24.0-255,1484,59456,96,317403
5098,0.000596,74.125.24.0-255,4320,63776,96,317403
5099,0.000598,172.31.47.0-255,66,63842,96,317403
5100,0.000638,74.125.24.0-255,2902,66744,96,317403
5101,0.000641,172.31.47.0-255,66,66810,96,317403
5102,0.000667,74.125.24.0-255,6797,73607,96,317403
5103,0.00067,172.31.47.0-255,66,73673,96,317403
5104,0.000813,74.125.24.0-255,1484,75157,96,317403
5105,0.000816,74.125.24.0-255,1484,76641,96,317403
5106,0.000819,172.31.47.0-255,66,76707,96,317403
5107,0.000842,74.125.24.0-255,1484,78191,96,317403
5108,0.000847,74.125.24.0-255,5738,83929,96,317403
5109,0.00085,172.31.47.0-255,66,83995,96,317403
5110,0.00089,74.125.24.0-255,4320,88315,96,317403
5111,0.000893,172.31.47.0-255,66,88381,96,317403
5112,0.000912,74.125.24.0-255,2543,90924,96,317403
5113,0.000915,172.31.47.0-255,66,90990,96,317403
5114,0.001705,74.125.24.0-255,1484,92474,96,317403
5115,0.001726,74.125.24.0-255,2902,95376,96,317403
5116,0.00173,172.31.47.0-255,66,95442,96,317403
5117,0.001749,74.125.24.0-255,5738,101180,96,317403
5118,0.001751,172.31.47.0-255,66,101246,96,317403
5119,0.001776,74.125.24.0-255,7156,108402,96,317403
5120,0.001778,172.31.47.0-255,66,108468,96,317403
5121,0.001798,74.125.24.0-255,2902,111370,96,317403
5122,0.001799,172.31.47.0-255,66,111436,96,317403
5123,0.001822,172.31.47.0-255,66,111502,96,317403
5124,0.001843,74.125.24.0-255,1484,112986,96,317403
5125,0.001855,74.125.24.0-255,766,113752,96,317403
5126,0.001856,172.31.47.0-255,66,113818,96,317403
5127,0.001947,74.125.24.0-255,1484,115302,96,317403
5128,0.001963,74.125.24.0-255,2902,118204,96,317403
5129,0.001965,172.31.47.0-255,66,118270,96,317403
5130,0.001987,74.125.24.0-255,5738,124008,96,317403
5131,0.001989,172.31.47.0-255,66,124074,96,317403
5132,0.002009,74.125.24.0-255,2902,126976,96,317403
5133,0.00201,172.31.47.0-255,66,127042,96,317403
5134,0.002042,172.31.47.0-255,66,127108,96,317403
5135,0.002051,172.31.47.0-255,66,127174,96,317403
5136,0.002063,74.125.24.0-255,2184,129358,96,317403
5137,0.002065,172.31.47.0-255,66,129424,96,317403
5138,0.002089,74.125.24.0-255,7156,136580,96,317403
5139,0.002092,172.31.47.0-255,66,136646,96,317403
5140,0.00211,74.125.24.0-255,5738,142384,96,317403
5141,0.002111,172.31.47.0-255,66,142450,96,317403
5142,0.002132,74.125.24.0-255,1484,143934,96,317403
5143,0.002161,74.125.24.0-255,2902,146836,96,317403
5144,0.002187,74.125.24.0-255,2902,149738,96,317403
5145,0.002229,74.125.24.0-255,1484,151222,96,317403
5146,0.002295,74.125.24.0-255,4320,155542,96,317403
5147,0.002331,74.125.24.0-255,5738,161280,96,317403
5148,0.006712,172.31.47.0-255,66,161346,96,317403
5149,0.008997,74.125.24.0-255,5738,167084,96,317403
5150,0.009004,172.31.47.0-255,66,167150,96,317403
5151,0.011289,74.125.24.0-255,5738,172888,96,317403
5152,0.011295,172.31.47.0-255,66,172954,96,317403
5153,0.013579,74.125.24.0-255,5738,178692,96,317403
5154,0.013585,172.31.47.0-255,66,178758,96,317403
5155,0.015893,74.125.24.0-255,5738,184496,96,317403
5156,0.015898,172.31.47.0-255,66,184562,96,317403
5157,0.018194,74.125.24.0-255,5738,190300,96,317403
5158,0.018205,172.31.47.0-255,66,190366,96,317403
5159,0.02048,74.125.24.0-255,5738,196104,96,317403
5160,0.020488,172.31.47.0-255,66,196170,96,317403
5161,0.022778,74.125.24.0-255,5738,201908,96,317403
5162,0.022783,172.31.47.0-255,66,201974,96,317403
5163,0.025082,74.125.24.0-255,5738,207712,96,317403
5164,0.025088,172.31.47.0-255,66,207778,96,317403
5165,0.027386,74.125.24.0-255,5738,213516,96,317403
5166,0.027393,172.31.47.0-255,66,213582,96,317403
5167,0.029672,74.125.24.0-255,5738,219320,96,317403
5168,0.029678,172.31.47.0-255,66,219386,96,317403
5169,0.031978,74.125.24.0-255,5738,225124,96,317403
5170,0.031985,172.31.47.0-255,66,225190,96,317403
5171,0.03394,172.31.47.0-255,172,225362,96,317403
5172,0.033966,172.31.47.0-255,1109,226471,96,317403
5173,0.033997,172.31.47.0-255,1514,227985,96,317403
5174,0.033999,172.31.47.0-255,1302,229287,96,317403
5175,0.034268,74.125.24.0-255,5738,235025,96,317403
5176,0.034274,172.31.47.0-255,66,235091,96,317403
5177,0.035446,104.244.42.0-255,66,235157,96,317403
5178,0.03561,104.244.42.0-255,66,235223,96,317403
5179,0.03566,104.244.42.0-255,66,235289,96,317403
5180,0.036549,74.125.24.0-255,1484,236773,96,317403
5181,0.036572,74.125.24.0-255,4320,241093,96,317403
5182,0.036576,172.31.47.0-255,66,241159,96,317403
5183,0.038847,74.125.24.0-255,5738,246897,96,317403
5184,0.038853,172.31.47.0-255,66,246963,96,317403
5185,0.041111,74.125.24.0-255,5738,252701,96,317403
5186,0.041116,172.31.47.0-255,66,252767,96,317403
5187,0.043385,74.125.24.0-255,5738,258505,96,317403
5188,0.043389,172.31.47.0-255,66,258571,96,317403
5189,0.045656,74.125.24.0-255,5738,264309,96,317403
5190,0.045662,172.31.47.0-255,66,264375,96,317403
5191,0.047936,74.125.24.0-255,2902,267277,96,317403
5192,0.047941,172.31.47.0-255,66,267343,96,317403
5193,0.047966,74.125.24.0-255,2902,270245,96,317403
5194,0.047969,172.31.47.0-255,66,270311,96,317403
5195,0.050208,74.125.24.0-255,2902,273213,96,317403
5196,0.050213,172.31.47.0-255,66,273279,96,317403
5197,0.05024,74.125.24.0-255,2902,276181,96,317403
5198,0.050242,172.31.47.0-255,66,276247,96,317403
5199,0.052484,74.125.24.0-255,2902,279149,96,317403
5200,0.052489,172.31.47.0-255,66,279215,96,317403
5201,0.052518,74.125.24.0-255,2902,282117,96,317403
5202,0.052521,172.31.47.0-255,66,282183,96,317403
5203,0.05479,74.125.24.0-255,4320,286503,96,317403
5204,0.054796,172.31.47.0-255,66,286569,96,317403
5205,0.054823,74.125.24.0-255,1484,288053,96,317403
5206,0.057071,74.125.24.0-255,2902,290955,96,317403
5207,0.057076,172.31.47.0-255,66,291021,96,317403
5208,0.0571,74.125.24.0-255,1484,292505,96,317403
5209,0.059327,74.125.24.0-255,4320,296825,96,317403
5210,0.059332,172.31.47.0-255,66,296891,96,317403
5211,0.061593,74.125.24.0-255,4320,301211,96,317403
5212,0.061598,172.31.47.0-255,66,301277,96,317403
5213,0.061623,74.125.24.0-255,1484,302761,96,317403
5214,0.063846,74.125.24.0-255,4320,307081,96,317403
5215,0.063851,172.31.47.0-255,66,307147,96,317403
5216,0.066108,74.125.24.0-255,4320,311467,96,317403
5217,0.066113,172.31.47.0-255,66,311533,96,317403
5218,0.066143,74.125.24.0-255,1484,313017,96,317403
5219,0.068405,74.125.24.0-255,4320,317337,96,317403
5220,0.068409,172.31.47.0-255,66,317403,96,317403
5221,0.0,172.217.194.0-255,153,153,96,269071
5222,2.7e-05,172.31.47.0-255,66,219,96,269071
5223,3.3e-05,172.217.194.0-255,1484,1703,96,269071
5224,3.7e-05,172.31.47.0-255,66,1769,96,269071
5225,4.2e-05,172.217.194.0-255,2902,4671,96,269071
5226,4.4e-05,172.31.47.0-255,66,4737,96,269071
5227,4.8e-05,172.217.194.0-255,4320,9057,96,269071
5228,5.7e-05,172.31.47.0-255,66,9123,96,269071
5229,8.4e-05,172.217.194.0-255,2902,12025,96,269071
5230,8.7e-05,172.31.47.0-255,66,12091,96,269071
5231,9.7e-05,172.31.47.0-255,66,12157,96,269071
5232,0.00016,172.31.47.0-255,66,12223,96,269071
5233,0.000186,172.217.194.0-255,1484,13707,96,269071
5234,0.000188,172.31.47.0-255,66,13773,96,269071
5235,0.000193,172.217.194.0-255,2902,16675,96,269071
5236,0.000194,172.31.47.0-255,66,16741,96,269071
5237,0.000197,172.217.194.0-255,1484,18225,96,269071
5238,0.000199,172.31.47.0-255,66,18291,96,269071
5239,0.000227,172.217.194.0-255,4320,22611,96,269071
5240,0.000229,172.31.47.0-255,66,22677,96,269071
5241,0.000232,172.217.194.0-255,1484,24161,96,269071
5242,0.000233,172.31.47.0-255,66,24227,96,269071
5243,0.000265,172.217.194.0-255,5379,29606,96,269071
5244,0.000268,172.31.47.0-255,66,29672,96,269071
5245,0.000574,172.217.194.0-255,1484,31156,96,269071
5246,0.000578,172.31.47.0-255,66,31222,96,269071
5247,0.000584,172.217.194.0-255,2902,34124,96,269071
5248,0.000585,172.31.47.0-255,66,34190,96,269071
5249,0.000591,172.217.194.0-255,5738,39928,96,269071
5250,0.000597,172.31.47.0-255,66,39994,96,269071
5251,0.000623,172.217.194.0-255,2902,42896,96,269071
5252,0.000626,172.31.47.0-255,66,42962,96,269071
5253,0.000655,172.31.47.0-255,66,43028,96,269071
5254,0.000681,172.217.194.0-255,5738,48766,96,269071
5255,0.000684,172.31.47.0-255,66,48832,96,269071
5256,0.000714,172.31.47.0-255,66,48898,96,269071
5257,0.000727,172.31.47.0-255,66,48964,96,269071
5258,0.000729,172.217.194.0-255,1125,50089,96,269071
5259,0.000924,172.31.47.0-255,66,50155,96,269071
5260,0.001279,172.217.194.0-255,1484,51639,96,269071
5261,0.001296,172.217.194.0-255,2902,54541,96,269071
5262,0.0013,172.31.47.0-255,66,54607,96,269071
5263,0.001307,172.217.194.0-255,5738,60345,96,269071
5264,0.001308,172.31.47.0-255,66,60411,96,269071
5265,0.001343,172.31.47.0-255,66,60477,96,269071
5266,0.001366,172.217.194.0-255,2902,63379,96,269071
5267,0.001368,172.31.47.0-255,66,63445,96,269071
5268,0.001401,172.217.194.0-255,4320,67765,96,269071
5269,0.001404,172.31.47.0-255,66,67831,96,269071
5270,0.001417,172.217.194.0-255,6438,74269,96,269071
5271,0.001423,172.31.47.0-255,66,74335,96,269071
5272,0.00149,172.217.194.0-255,1484,75819,96,269071
5273,0.001504,172.217.194.0-255,2902,78721,96,269071
5274,0.001506,172.31.47.0-255,66,78787,96,269071
5275,0.001511,172.217.194.0-255,4320,83107,96,269071
5276,0.001513,172.31.47.0-255,66,83173,96,269071
5277,0.001537,172.217.194.0-255,1484,84657,96,269071
5278,0.001546,172.31.47.0-255,66,84723,96,269071
5279,0.001568,172.217.194.0-255,4320,89043,96,269071
5280,0.00157,172.31.47.0-255,66,89109,96,269071
5281,0.001593,172.217.194.0-255,4320,93429,96,269071
5282,0.001595,172.31.47.0-255,66,93495,96,269071
5283,0.00162,172.217.194.0-255,6438,99933,96,269071
5284,0.001622,172.31.47.0-255,66,99999,96,269071
5285,0.003927,172.217.194.0-255,5738,105737,96,269071
5286,0.003931,172.31.47.0-255,66,105803,96,269071
5287,0.006243,172.217.194.0-255,5738,111541,96,269071
5288,0.006248,172.31.47.0-255,66,111607,96,269071
5289,0.008546,172.217.194.0-255,5738,117345,96,269071
5290,0.008552,172.31.47.0-255,66,117411,96,269071
5291,0.010898,172.217.194.0-255,5738,123149,96,269071
5292,0.010904,172.31.47.0-255,66,123215,96,269071
5293,0.01323,172.217.194.0-255,5738,128953,96,269071
5294,0.013239,172.31.47.0-255,66,129019,96,269071
5295,0.015598,172.217.194.0-255,5738,134757,96,269071
5296,0.015603,172.31.47.0-255,66,134823,96,269071
5297,0.017934,172.217.194.0-255,5738,140561,96,269071
5298,0.01794,172.31.47.0-255,66,140627,96,269071
5299,0.019687,172.31.47.0-255,172,140799,96,269071
5300,0.019735,172.31.47.0-255,1109,141908,96,269071
5301,0.019799,172.31.47.0-255,1514,143422,96,269071
5302,0.0198,172.31.47.0-255,335,143757,96,269071
5303,0.02028,172.217.194.0-255,5738,149495,96,269071
5304,0.020285,172.31.47.0-255,66,149561,96,269071
5305,0.021212,104.244.42.0-255,66,149627,96,269071
5306,0.021267,104.244.42.0-255,66,149693,96,269071
5307,0.021373,104.244.42.0-255,66,149759,96,269071
5308,0.022601,172.217.194.0-255,1484,151243,96,269071
5309,0.022629,172.217.194.0-255,4320,155563,96,269071
5310,0.022633,172.31.47.0-255,66,155629,96,269071
5311,0.024957,172.217.194.0-255,5738,161367,96,269071
5312,0.024962,172.31.47.0-255,66,161433,96,269071
5313,0.027295,172.217.194.0-255,5738,167171,96,269071
5314,0.027301,172.31.47.0-255,66,167237,96,269071
5315,0.029607,172.217.194.0-255,5738,172975,96,269071
5316,0.029613,172.31.47.0-255,66,173041,96,269071
5317,0.031935,172.217.194.0-255,5738,178779,96,269071
5318,0.03194,172.31.47.0-255,66,178845,96,269071
5319,0.034268,172.217.194.0-255,5738,184583,96,269071
5320,0.034274,172.31.47.0-255,66,184649,96,269071
5321,0.036572,172.217.194.0-255,5738,190387,96,269071
5322,0.036577,172.31.47.0-255,66,190453,96,269071
5323,0.038893,172.217.194.0-255,5738,196191,96,269071
5324,0.038897,172.31.47.0-255,66,196257,96,269071
5325,0.041219,172.217.194.0-255,4320,200577,96,269071
5326,0.041224,172.31.47.0-255,66,200643,96,269071
5327,0.041249,172.217.194.0-255,1484,202127,96,269071
5328,0.043529,172.217.194.0-255,4320,206447,96,269071
5329,0.043534,172.31.47.0-255,66,206513,96,269071
5330,0.045859,172.217.194.0-255,5738,212251,96,269071
5331,0.045863,172.31.47.0-255,66,212317,96,269071
5332,0.048202,172.217.194.0-255,5738,218055,96,269071
5333,0.048206,172.31.47.0-255,66,218121,96,269071
5334,0.050521,172.217.194.0-255,5738,223859,96,269071
5335,0.050525,172.31.47.0-255,66,223925,96,269071
5336,0.052833,172.217.194.0-255,5738,229663,96,269071
5337,0.052837,172.31.47.0-255,66,229729,96,269071
5338,0.055147,172.217.194.0-255,5738,235467,96,269071
5339,0.055151,172.31.47.0-255,66,235533,96,269071
5340,0.05746,172.217.194.0-255,4320,239853,96,269071
5341,0.057464,172.31.47.0-255,66,239919,96,269071
5342,0.057494,172.217.194.0-255,1484,241403,96,269071
5343,0.059767,172.217.194.0-255,4320,245723,96,269071
5344,0.059772,172.31.47.0-255,66,245789,96,269071
5345,0.062086,172.217.194.0-255,5738,251527,96,269071
5346,0.06209,172.31.47.0-255,66,251593,96,269071
5347,0.064402,172.217.194.0-255,5738,257331,96,269071
5348,0.064409,172.31.47.0-255,66,257397,96,269071
5349,0.066742,172.217.194.0-255,5738,263135,96,269071
5350,0.066746,172.31.47.0-255,66,263201,96,269071
5351,0.06907,172.217.194.0-255,4320,267521,96,269071
5352,0.069075,172.31.47.0-255,66,267587,96,269071
5353,0.069105,172.217.194.0-255,1484,269071,96,269071
5354,0.0,74.125.68.0-255,153,153,96,300581
5355,3e-05,172.31.47.0-255,66,219,96,300581
5356,3.6e-05,74.125.68.0-255,1484,1703,96,300581
5357,3.9e-05,172.31.47.0-255,66,1769,96,300581
5358,5.9e-05,74.125.68.0-255,2902,4671,96,300581
5359,6.6e-05,172.31.47.0-255,66,4737,96,300581
5360,7.2e-05,74.125.68.0-255,5738,10475,96,300581
5361,7.4e-05,172.31.47.0-255,66,10541,96,300581
5362,0.000109,74.125.68.0-255,3590,14131,96,300581
5363,0.000113,172.31.47.0-255,66,14197,96,300581
5364,0.000178,74.125.68.0-255,1484,15681,96,300581
5365,0.000182,172.31.47.0-255,66,15747,96,300581
5366,0.00021,74.125.68.0-255,2902,18649,96,300581
5367,0.000212,172.31.47.0-255,66,18715,96,300581
5368,0.000218,74.125.68.0-255,4320,23035,96,300581
5369,0.00022,172.31.47.0-255,66,23101,96,300581
5370,0.000263,172.31.47.0-255,66,23167,96,300581
5371,0.000317,172.31.47.0-255,66,23233,96,300581
5372,0.000344,74.125.68.0-255,2902,26135,96,300581
5373,0.000346,172.31.47.0-255,66,26201,96,300581
5374,0.000374,74.125.68.0-255,5379,31580,96,300581
5375,0.000377,172.31.47.0-255,66,31646,96,300581
5376,0.000696,74.125.68.0-255,1484,33130,96,300581
5377,0.000701,172.31.47.0-255,66,33196,96,300581
5378,0.000709,74.125.68.0-255,2902,36098,96,300581
5379,0.000712,172.31.47.0-255,66,36164,96,300581
5380,0.00074,74.125.68.0-255,5738,41902,96,300581
5381,0.000744,172.31.47.0-255,66,41968,96,300581
5382,0.000747,74.125.68.0-255,1484,43452,96,300581
5383,0.000749,172.31.47.0-255,66,43518,96,300581
5384,0.000771,74.125.68.0-255,1484,45002,96,300581
5385,0.000774,172.31.47.0-255,66,45068,96,300581
5386,0.000777,74.125.68.0-255,1484,46552,96,300581
5387,0.000805,74.125.68.0-255,2543,49095,96,300581
5388,0.000808,74.125.68.0-255,646,49741,96,300581
5389,0.00091,74.125.68.0-255,1484,51225,96,300581
5390,0.000916,74.125.68.0-255,2902,54127,96,300581
5391,0.000945,74.125.68.0-255,5738,59865,96,300581
5392,0.000959,74.125.68.0-255,1484,61349,96,300581
5393,0.000975,74.125.68.0-255,2902,64251,96,300581
5394,0.000994,74.125.68.0-255,2902,67153,96,300581
5395,0.001006,74.125.68.0-255,2543,69696,96,300581
5396,0.001009,74.125.68.0-255,1484,71180,96,300581
5397,0.001026,74.125.68.0-255,4320,75500,96,300581
5398,0.001344,172.31.47.0-255,66,75566,96,300581
5399,0.001372,74.125.68.0-255,1484,77050,96,300581
5400,0.001377,74.125.68.0-255,2902,79952,96,300581
5401,0.001382,74.125.68.0-255,2902,82854,96,300581
5402,0.001393,74.125.68.0-255,2902,85756,96,300581
5403,0.001395,74.125.68.0-255,1484,87240,96,300581
5404,0.001412,74.125.68.0-255,2902,90142,96,300581
5405,0.001419,172.31.47.0-255,66,90208,96,300581
5406,0.001445,74.125.68.0-255,5738,95946,96,300581
5407,0.001449,74.125.68.0-255,1484,97430,96,300581
5408,0.001461,74.125.68.0-255,1484,98914,96,300581
5409,0.001464,74.125.68.0-255,1484,100398,96,300581
5410,0.001472,172.31.47.0-255,66,100464,96,300581
5411,0.001483,74.125.68.0-255,2902,103366,96,300581
5412,0.001497,172.31.47.0-255,66,103432,96,300581
5413,0.001522,74.125.68.0-255,5738,109170,96,300581
5414,0.001531,74.125.68.0-255,766,109936,96,300581
5415,0.00154,172.31.47.0-255,66,110002,96,300581
5416,0.003611,74.125.68.0-255,4320,114322,96,300581
5417,0.003621,172.31.47.0-255,66,114388,96,300581
5418,0.003646,74.125.68.0-255,1484,115872,96,300581
5419,0.005681,74.125.68.0-255,4320,120192,96,300581
5420,0.00642,172.31.47.0-255,66,120258,96,300581
5421,0.008503,74.125.68.0-255,5738,125996,96,300581
5422,0.008513,172.31.47.0-255,66,126062,96,300581
5423,0.010582,74.125.68.0-255,5738,131800,96,300581
5424,0.010592,172.31.47.0-255,66,131866,96,300581
5425,0.012667,74.125.68.0-255,5738,137604,96,300581
5426,0.012693,172.31.47.0-255,66,137670,96,300581
5427,0.014778,74.125.68.0-255,5738,143408,96,300581
5428,0.014786,172.31.47.0-255,66,143474,96,300581
5429,0.016882,74.125.68.0-255,5738,149212,96,300581
5430,0.016888,172.31.47.0-255,66,149278,96,300581
5431,0.018963,74.125.68.0-255,5738,155016,96,300581
5432,0.018971,172.31.47.0-255,66,155082,96,300581
5433,0.021039,74.125.68.0-255,5738,160820,96,300581
5434,0.021047,172.31.47.0-255,66,160886,96,300581
5435,0.022099,172.31.47.0-255,172,161058,96,300581
5436,0.02213,172.31.47.0-255,1109,162167,96,300581
5437,0.022181,172.31.47.0-255,1514,163681,96,300581
5438,0.022182,172.31.47.0-255,1514,165195,96,300581
5439,0.022183,172.31.47.0-255,1514,166709,96,300581
5440,0.022184,172.31.47.0-255,116,166825,96,300581
5441,0.023117,74.125.68.0-255,5738,172563,96,300581
5442,0.023123,172.31.47.0-255,66,172629,96,300581
5443,0.023682,104.244.42.0-255,66,172695,96,300581
5444,0.023707,104.244.42.0-255,66,172761,96,300581
5445,0.023775,104.244.42.0-255,66,172827,96,300581
5446,0.023779,104.244.42.0-255,66,172893,96,300581
5447,0.025193,74.125.68.0-255,5738,178631,96,300581
5448,0.025199,172.31.47.0-255,66,178697,96,300581
5449,0.027258,74.125.68.0-255,5738,184435,96,300581
5450,0.027264,172.31.47.0-255,66,184501,96,300581
5451,0.029339,74.125.68.0-255,5738,190239,96,300581
5452,0.029347,172.31.47.0-255,66,190305,96,300581
5453,0.031415,74.125.68.0-255,5738,196043,96,300581
5454,0.031422,172.31.47.0-255,66,196109,96,300581
5455,0.033497,74.125.68.0-255,5738,201847,96,300581
5456,0.033504,172.31.47.0-255,66,201913,96,300581
5457,0.035574,74.125.68.0-255,5738,207651,96,300581
5458,0.03558,172.31.47.0-255,66,207717,96,300581
5459,0.037647,74.125.68.0-255,5738,213455,96,300581
5460,0.037653,172.31.47.0-255,66,213521,96,300581
5461,0.039726,74.125.68.0-255,5738,219259,96,300581
5462,0.039733,172.31.47.0-255,66,219325,96,300581
5463,0.04179,74.125.68.0-255,5738,225063,96,300581
5464,0.041797,172.31.47.0-255,66,225129,96,300581
5465,0.043875,74.125.68.0-255,5738,230867,96,300581
5466,0.04388,172.31.47.0-255,66,230933,96,300581
5467,0.045958,74.125.68.0-255,5738,236671,96,300581
5468,0.045964,172.31.47.0-255,66,236737,96,300581
5469,0.048076,74.125.68.0-255,5738,242475,96,300581
5470,0.048082,172.31.47.0-255,66,242541,96,300581
5471,0.050147,74.125.68.0-255,5738,248279,96,300581
5472,0.050153,172.31.47.0-255,66,248345,96,300581
5473,0.052224,74.125.68.0-255,5738,254083,96,300581
5474,0.052229,172.31.47.0-255,66,254149,96,300581
5475,0.054299,74.125.68.0-255,5738,259887,96,300581
5476,0.054305,172.31.47.0-255,66,259953,96,300581
5477,0.056377,74.125.68.0-255,5738,265691,96,300581
5478,0.056383,172.31.47.0-255,66,265757,96,300581
5479,0.058449,74.125.68.0-255,5738,271495,96,300581
5480,0.058454,172.31.47.0-255,66,271561,96,300581
5481,0.060525,74.125.68.0-255,5738,277299,96,300581
5482,0.06053,172.31.47.0-255,66,277365,96,300581
5483,0.062617,74.125.68.0-255,5738,283103,96,300581
5484,0.062624,172.31.47.0-255,66,283169,96,300581
5485,0.064698,74.125.68.0-255,5738,288907,96,300581
5486,0.064706,172.31.47.0-255,66,288973,96,300581
5487,0.06678,74.125.68.0-255,5738,294711,96,300581
5488,0.066786,172.31.47.0-255,66,294777,96,300581
5489,0.068849,74.125.68.0-255,5738,300515,96,300581
5490,0.068855,172.31.47.0-255,66,300581,96,300581
5491,0.0,172.31.47.0-255,66,66,96,66
5492,0.0,172.31.47.0-255,105,105,96,276
5493,0.001771,157.240.7.0-255,105,210,96,276
5494,0.001783,172.31.47.0-255,66,276,96,276
5495,0.0,172.31.47.0-255,66,66,96,66
5496,0.0,172.31.47.0-255,105,105,96,276
5497,0.001765,157.240.13.0-255,105,210,96,276
5498,0.001779,172.31.47.0-255,66,276,96,276
5499,0.0,172.217.194.0-255,153,153,96,276472
5500,2.7e-05,172.31.47.0-255,66,219,96,276472
5501,3.3e-05,172.217.194.0-255,1484,1703,96,276472
5502,3.8e-05,172.31.47.0-255,66,1769,96,276472
5503,4.3e-05,172.217.194.0-255,2902,4671,96,276472
5504,4.6e-05,172.31.47.0-255,66,4737,96,276472
5505,5.2e-05,172.217.194.0-255,7156,11893,96,276472
5506,5.4e-05,172.31.47.0-255,66,11959,96,276472
5507,6.3e-05,172.217.194.0-255,2219,14178,96,276472
5508,6.6e-05,172.31.47.0-255,66,14244,96,276472
5509,0.000107,172.31.47.0-255,66,14310,96,276472
5510,0.000111,172.217.194.0-255,4320,18630,96,276472
5511,0.000113,172.31.47.0-255,66,18696,96,276472
5512,0.00013,172.217.194.0-255,1125,19821,96,276472
5513,0.000133,172.31.47.0-255,66,19887,96,276472
5514,0.000164,172.217.194.0-255,1484,21371,96,276472
5515,0.000166,172.31.47.0-255,66,21437,96,276472
5516,0.000169,172.217.194.0-255,1484,22921,96,276472
5517,0.000171,172.31.47.0-255,66,22987,96,276472
5518,0.0002,172.217.194.0-255,1484,24471,96,276472
5519,0.000203,172.31.47.0-255,66,24537,96,276472
5520,0.000209,172.217.194.0-255,5738,30275,96,276472
5521,0.000211,172.31.47.0-255,66,30341,96,276472
5522,0.000227,172.31.47.0-255,66,30407,96,276472
5523,0.00026,172.217.194.0-255,4320,34727,96,276472
5524,0.000263,172.31.47.0-255,66,34793,96,276472
5525,0.000285,172.217.194.0-255,4320,39113,96,276472
5526,0.000288,172.31.47.0-255,66,39179,96,276472
5527,0.000296,172.217.194.0-255,2184,41363,96,276472
5528,0.000298,172.31.47.0-255,66,41429,96,276472
5529,0.0003,172.217.194.0-255,377,41806,96,276472
5530,0.000343,172.217.194.0-255,100,41906,96,276472
5531,0.000513,172.217.194.0-255,1484,43390,96,276472
5532,0.000518,172.31.47.0-255,66,43456,96,276472
5533,0.000521,172.217.194.0-255,1484,44940,96,276472
5534,0.000539,172.217.194.0-255,1484,46424,96,276472
5535,0.000542,172.31.47.0-255,66,46490,96,276472
5536,0.000548,172.217.194.0-255,5738,52228,96,276472
5537,0.00055,172.31.47.0-255,66,52294,96,276472
5538,0.000555,172.217.194.0-255,5738,58032,96,276472
5539,0.000557,172.31.47.0-255,66,58098,96,276472
5540,0.000594,172.217.194.0-255,7156,65254,96,276472
5541,0.000596,172.31.47.0-255,66,65320,96,276472
5542,0.000606,172.31.47.0-255,66,65386,96,276472
5543,0.000609,172.217.194.0-255,2184,67570,96,276472
5544,0.000612,172.31.47.0-255,66,67636,96,276472
5545,0.000663,172.217.194.0-255,1484,69120,96,276472
5546,0.000668,172.217.194.0-255,2902,72022,96,276472
5547,0.00067,172.31.47.0-255,66,72088,96,276472
5548,0.000701,172.217.194.0-255,2902,74990,96,276472
5549,0.000703,172.31.47.0-255,66,75056,96,276472
5550,0.00072,172.217.194.0-255,2902,77958,96,276472
5551,0.000723,172.31.47.0-255,66,78024,96,276472
5552,0.000726,172.217.194.0-255,1484,79508,96,276472
5553,0.000743,172.217.194.0-255,5738,85246,96,276472
5554,0.000745,172.31.47.0-255,66,85312,96,276472
5555,0.00075,172.217.194.0-255,4320,89632,96,276472
5556,0.000752,172.31.47.0-255,66,89698,96,276472
5557,0.000782,172.217.194.0-255,4320,94018,96,276472
5558,0.000785,172.31.47.0-255,66,94084,96,276472
5559,0.000794,172.31.47.0-255,66,94150,96,276472
5560,0.000823,172.217.194.0-255,1484,95634,96,276472
5561,0.000841,172.217.194.0-255,2902,98536,96,276472
5562,0.000844,172.31.47.0-255,66,98602,96,276472
5563,0.000847,172.217.194.0-255,1484,100086,96,276472
5564,0.000873,172.217.194.0-255,4320,104406,96,276472
5565,0.000876,172.31.47.0-255,66,104472,96,276472
5566,0.000907,172.217.194.0-255,1484,105956,96,276472
5567,0.000909,172.31.47.0-255,66,106022,96,276472
5568,0.000918,172.217.194.0-255,2902,108924,96,276472
5569,0.00092,172.31.47.0-255,66,108990,96,276472
5570,0.00095,172.217.194.0-255,5738,114728,96,276472
5571,0.000953,172.31.47.0-255,66,114794,96,276472
5572,0.000958,172.217.194.0-255,5020,119814,96,276472
5573,0.00096,172.31.47.0-255,66,119880,96,276472
5574,0.000963,172.217.194.0-255,1484,121364,96,276472
5575,0.000965,172.217.194.0-255,1484,122848,96,276472
5576,0.000968,172.31.47.0-255,66,122914,96,276472
5577,0.000997,172.217.194.0-255,1484,124398,96,276472
5578,0.001003,172.217.194.0-255,5738,130136,96,276472
5579,0.001006,172.31.47.0-255,66,130202,96,276472
5580,0.001016,172.31.47.0-255,66,130268,96,276472
5581,0.001046,172.217.194.0-255,4320,134588,96,276472
5582,0.001049,172.31.47.0-255,66,134654,96,276472
5583,0.001059,172.31.47.0-255,66,134720,96,276472
5584,0.001066,172.217.194.0-255,1063,135783,96,276472
5585,0.00124,172.217.194.0-255,1484,137267,96,276472
5586,0.001244,172.31.47.0-255,66,137333,96,276472
5587,0.001265,172.217.194.0-255,2902,140235,96,276472
5588,0.001268,172.31.47.0-255,66,140301,96,276472
5589,0.001291,172.217.194.0-255,5738,146039,96,276472
5590,0.001294,172.31.47.0-255,66,146105,96,276472
5591,0.001298,172.217.194.0-255,4320,150425,96,276472
5592,0.0013,172.31.47.0-255,66,150491,96,276472
5593,0.001302,172.217.194.0-255,1484,151975,96,276472
5594,0.001337,172.31.47.0-255,66,152041,96,276472
5595,0.001342,172.217.194.0-255,5738,157779,96,276472
5596,0.001344,172.31.47.0-255,66,157845,96,276472
5597,0.001364,172.217.194.0-255,2184,160029,96,276472
5598,0.001367,172.31.47.0-255,66,160095,96,276472
5599,0.001478,172.217.194.0-255,1484,161579,96,276472
5600,0.001482,172.217.194.0-255,2902,164481,96,276472
5601,0.001486,172.31.47.0-255,66,164547,96,276472
5602,0.001537,172.217.194.0-255,5738,170285,96,276472
5603,0.00154,172.31.47.0-255,66,170351,96,276472
5604,0.001564,172.31.47.0-255,66,170417,96,276472
5605,0.001569,172.217.194.0-255,4320,174737,96,276472
5606,0.001571,172.31.47.0-255,66,174803,96,276472
5607,0.001611,172.217.194.0-255,5738,180541,96,276472
5608,0.001615,172.31.47.0-255,66,180607,96,276472
5609,0.001625,172.217.194.0-255,766,181373,96,276472
5610,0.001641,172.217.194.0-255,2902,184275,96,276472
5611,0.001643,172.31.47.0-255,66,184341,96,276472
5612,0.001671,172.217.194.0-255,4320,188661,96,276472
5613,0.001674,172.31.47.0-255,66,188727,96,276472
5614,0.001677,172.217.194.0-255,1484,190211,96,276472
5615,0.001691,172.31.47.0-255,66,190277,96,276472
5616,0.001693,172.217.194.0-255,1484,191761,96,276472
5617,0.001707,172.217.194.0-255,5738,197499,96,276472
5618,0.001709,172.31.47.0-255,66,197565,96,276472
5619,0.001736,172.217.194.0-255,5738,203303,96,276472
5620,0.001739,172.31.47.0-255,66,203369,96,276472
5621,0.001743,172.217.194.0-255,2184,205553,96,276472
5622,0.001745,172.31.47.0-255,66,205619,96,276472
5623,0.001809,172.217.194.0-255,1484,207103,96,276472
5624,0.001823,172.217.194.0-255,2902,210005,96,276472
5625,0.001826,172.31.47.0-255,66,210071,96,276472
5626,0.001841,172.217.194.0-255,5738,215809,96,276472
5627,0.001847,172.31.47.0-255,66,215875,96,276472
5628,0.00185,172.217.194.0-255,1484,217359,96,276472
5629,0.001855,172.217.194.0-255,4320,221679,96,276472
5630,0.001857,172.31.47.0-255,66,221745,96,276472
5631,0.001874,172.217.194.0-255,4320,226065,96,276472
5632,0.001878,172.31.47.0-255,66,226131,96,276472
5633,0.001888,172.217.194.0-255,2902,229033,96,276472
5634,0.00189,172.31.47.0-255,66,229099,96,276472
5635,0.001926,172.31.47.0-255,66,229165,96,276472
5636,0.001947,172.217.194.0-255,1484,230649,96,276472
5637,0.001964,172.217.194.0-255,2902,233551,96,276472
5638,0.001967,172.31.47.0-255,66,233617,96,276472
5639,0.001971,172.217.194.0-255,2902,236519,96,276472
5640,0.001973,172.31.47.0-255,66,236585,96,276472
5641,0.001989,172.217.194.0-255,2902,239487,96,276472
5642,0.001992,172.31.47.0-255,66,239553,96,276472
5643,0.001998,172.217.194.0-255,5738,245291,96,276472
5644,0.002,172.31.47.0-255,66,245357,96,276472
5645,0.00202,172.217.194.0-255,5738,251095,96,276472
5646,0.002022,172.31.47.0-255,66,251161,96,276472
5647,0.002038,172.31.47.0-255,66,251227,96,276472
5648,0.002186,172.217.194.0-255,1484,252711,96,276472
5649,0.002201,172.217.194.0-255,2902,255613,96,276472
5650,0.002205,172.31.47.0-255,66,255679,96,276472
5651,0.002225,172.217.194.0-255,5738,261417,96,276472
5652,0.002227,172.31.47.0-255,66,261483,96,276472
5653,0.002263,172.31.47.0-255,66,261549,96,276472
5654,0.002269,172.217.194.0-255,7156,268705,96,276472
5655,0.002271,172.31.47.0-255,66,268771,96,276472
5656,0.002304,172.217.194.0-255,2902,271673,96,276472
5657,0.002307,172.31.47.0-255,66,271739,96,276472
5658,0.002348,172.31.47.0-255,66,271805,96,276472
5659,0.004592,172.217.194.0-255,136,271941,96,276472
5660,0.004674,172.31.47.0-255,66,272007,96,276472
5661,0.004705,172.31.47.0-255,105,272112,96,276472
5662,0.006974,172.217.194.0-255,66,272178,96,276472
5663,0.027616,172.31.47.0-255,171,272349,96,276472
5664,0.027665,172.31.47.0-255,1129,273478,96,276472
5665,0.027727,172.31.47.0-255,1514,274992,96,276472
5666,0.02775,172.31.47.0-255,1282,276274,96,276472
5667,0.029168,104.244.42.0-255,66,276340,96,276472
5668,0.029245,104.244.42.0-255,66,276406,96,276472
5669,0.029335,104.244.42.0-255,66,276472,96,276472
5670,0.0,172.31.47.0-255,105,105,96,459
5671,0.00029,172.31.47.0-255,90,195,96,459
5672,0.000299,172.31.47.0-255,66,261,96,459
5673,0.00295,74.125.24.0-255,66,327,96,459
5674,0.002982,74.125.24.0-255,66,393,96,459
5675,0.003005,172.31.47.0-255,66,459,96,459
5676,0.0,172.217.194.0-255,153,153,96,332230
5677,3e-05,172.31.47.0-255,66,219,96,332230
5678,3.7e-05,172.217.194.0-255,1484,1703,96,332230
5679,4.1e-05,172.31.47.0-255,66,1769,96,332230
5680,4.6e-05,172.217.194.0-255,2902,4671,96,332230
5681,4.8e-05,172.31.47.0-255,66,4737,96,332230
5682,5.2e-05,172.217.194.0-255,2902,7639,96,332230
5683,5.4e-05,172.31.47.0-255,66,7705,96,332230
5684,7.3e-05,172.217.194.0-255,1484,9189,96,332230
5685,7.5e-05,172.31.47.0-255,66,9255,96,332230
5686,8.9e-05,172.31.47.0-255,66,9321,96,332230
5687,0.000106,172.217.194.0-255,4320,13641,96,332230
5688,0.000109,172.31.47.0-255,66,13707,96,332230
5689,0.000144,172.31.47.0-255,66,13773,96,332230
5690,0.000168,172.217.194.0-255,1484,15257,96,332230
5691,0.00017,172.31.47.0-255,66,15323,96,332230
5692,0.000188,172.217.194.0-255,1484,16807,96,332230
5693,0.00019,172.31.47.0-255,66,16873,96,332230
5694,0.000209,172.217.194.0-255,1484,18357,96,332230
5695,0.000211,172.31.47.0-255,66,18423,96,332230
5696,0.000216,172.217.194.0-255,4320,22743,96,332230
5697,0.000219,172.31.47.0-255,66,22809,96,332230
5698,0.000224,172.217.194.0-255,4320,27129,96,332230
5699,0.000227,172.31.47.0-255,66,27195,96,332230
5700,0.000249,172.217.194.0-255,4320,31515,96,332230
5701,0.000252,172.31.47.0-255,66,31581,96,332230
5702,0.000255,172.217.194.0-255,1484,33065,96,332230
5703,0.000257,172.31.47.0-255,66,33131,96,332230
5704,0.000273,172.217.194.0-255,5738,38869,96,332230
5705,0.000278,172.31.47.0-255,66,38935,96,332230
5706,0.000287,172.217.194.0-255,7156,46091,96,332230
5707,0.000289,172.31.47.0-255,66,46157,96,332230
5708,0.000313,172.217.194.0-255,2495,48652,96,332230
5709,0.000315,172.31.47.0-255,66,48718,96,332230
5710,0.000766,172.217.194.0-255,1484,50202,96,332230
5711,0.000782,172.217.194.0-255,2902,53104,96,332230
5712,0.000786,172.31.47.0-255,66,53170,96,332230
5713,0.00079,172.217.194.0-255,2902,56072,96,332230
5714,0.000793,172.31.47.0-255,66,56138,96,332230
5715,0.000806,172.217.194.0-255,2902,59040,96,332230
5716,0.000808,172.31.47.0-255,66,59106,96,332230
5717,0.000848,172.217.194.0-255,7156,66262,96,332230
5718,0.000852,172.31.47.0-255,66,66328,96,332230
5719,0.00087,172.217.194.0-255,1484,67812,96,332230
5720,0.000881,172.31.47.0-255,66,67878,96,332230
5721,0.000886,172.217.194.0-255,4740,72618,96,332230
5722,0.000889,172.31.47.0-255,66,72684,96,332230
5723,0.000929,172.217.194.0-255,2902,75586,96,332230
5724,0.000933,172.31.47.0-255,66,75652,96,332230
5725,0.000958,172.31.47.0-255,66,75718,96,332230
5726,0.000961,172.217.194.0-255,1484,77202,96,332230
5727,0.000979,172.217.194.0-255,1484,78686,96,332230
5728,0.000982,172.31.47.0-255,66,78752,96,332230
5729,0.001007,172.31.47.0-255,66,78818,96,332230
5730,0.00103,172.217.194.0-255,3602,82420,96,332230
5731,0.001034,172.31.47.0-255,66,82486,96,332230
5732,0.001207,172.217.194.0-255,1484,83970,96,332230
5733,0.001211,172.217.194.0-255,2902,86872,96,332230
5734,0.001214,172.31.47.0-255,66,86938,96,332230
5735,0.001229,172.217.194.0-255,2902,89840,96,332230
5736,0.001231,172.31.47.0-255,66,89906,96,332230
5737,0.001244,172.217.194.0-255,2902,92808,96,332230
5738,0.001246,172.31.47.0-255,66,92874,96,332230
5739,0.00125,172.217.194.0-255,4320,97194,96,332230
5740,0.001252,172.31.47.0-255,66,97260,96,332230
5741,0.001255,172.217.194.0-255,2902,100162,96,332230
5742,0.001258,172.31.47.0-255,66,100228,96,332230
5743,0.001287,172.31.47.0-255,66,100294,96,332230
5744,0.001291,172.217.194.0-255,2902,103196,96,332230
5745,0.001293,172.31.47.0-255,66,103262,96,332230
5746,0.001309,172.217.194.0-255,5020,108282,96,332230
5747,0.001311,172.31.47.0-255,66,108348,96,332230
5748,0.001404,172.217.194.0-255,1484,109832,96,332230
5749,0.001407,172.217.194.0-255,1484,111316,96,332230
5750,0.00141,172.31.47.0-255,66,111382,96,332230
5751,0.001423,172.217.194.0-255,1484,112866,96,332230
5752,0.001428,172.217.194.0-255,4320,117186,96,332230
5753,0.00143,172.31.47.0-255,66,117252,96,332230
5754,0.001441,172.217.194.0-255,1484,118736,96,332230
5755,0.001445,172.217.194.0-255,2902,121638,96,332230
5756,0.001447,172.31.47.0-255,66,121704,96,332230
5757,0.00147,172.217.194.0-255,2902,124606,96,332230
5758,0.001472,172.31.47.0-255,66,124672,96,332230
5759,0.001493,172.217.194.0-255,7156,131828,96,332230
5760,0.001495,172.31.47.0-255,66,131894,96,332230
5761,0.0015,172.217.194.0-255,5738,137632,96,332230
5762,0.001501,172.31.47.0-255,66,137698,96,332230
5763,0.001515,172.217.194.0-255,5020,142718,96,332230
5764,0.001518,172.31.47.0-255,66,142784,96,332230
5765,0.00155,172.31.47.0-255,66,142850,96,332230
5766,0.001558,172.217.194.0-255,2902,145752,96,332230
5767,0.001561,172.31.47.0-255,66,145818,96,332230
5768,0.001586,172.217.194.0-255,5738,151556,96,332230
5769,0.001588,172.31.47.0-255,66,151622,96,332230
5770,0.001597,172.31.47.0-255,66,151688,96,332230
5771,0.001601,172.217.194.0-255,3602,155290,96,332230
5772,0.001603,172.31.47.0-255,66,155356,96,332230
5773,0.001722,172.217.194.0-255,1484,156840,96,332230
5774,0.001738,172.217.194.0-255,2902,159742,96,332230
5775,0.001741,172.31.47.0-255,66,159808,96,332230
5776,0.001758,172.217.194.0-255,2902,162710,96,332230
5777,0.00176,172.31.47.0-255,66,162776,96,332230
5778,0.001778,172.217.194.0-255,2902,165678,96,332230
5779,0.00178,172.31.47.0-255,66,165744,96,332230
5780,0.001792,172.217.194.0-255,5738,171482,96,332230
5781,0.001794,172.31.47.0-255,66,171548,96,332230
5782,0.001815,172.217.194.0-255,7156,178704,96,332230
5783,0.001818,172.31.47.0-255,66,178770,96,332230
5784,0.001824,172.217.194.0-255,7156,185926,96,332230
5785,0.001826,172.31.47.0-255,66,185992,96,332230
5786,0.001867,172.217.194.0-255,3602,189594,96,332230
5787,0.001869,172.31.47.0-255,66,189660,96,332230
5788,0.00228,172.217.194.0-255,1484,191144,96,332230
5789,0.002289,172.217.194.0-255,2902,194046,96,332230
5790,0.002292,172.31.47.0-255,66,194112,96,332230
5791,0.002303,172.217.194.0-255,5738,199850,96,332230
5792,0.002308,172.31.47.0-255,66,199916,96,332230
5793,0.002317,172.217.194.0-255,4320,204236,96,332230
5794,0.002321,172.31.47.0-255,66,204302,96,332230
5795,0.002359,172.31.47.0-255,66,204368,96,332230
5796,0.00468,172.217.194.0-255,5738,210106,96,332230
5797,0.004695,172.31.47.0-255,66,210172,96,332230
5798,0.007025,172.217.194.0-255,5738,215910,96,332230
5799,0.007041,172.31.47.0-255,66,215976,96,332230
5800,0.009307,172.217.194.0-255,5738,221714,96,332230
5801,0.009313,172.31.47.0-255,66,221780,96,332230
5802,0.011598,172.217.194.0-255,4320,226100,96,332230
5803,0.011603,172.31.47.0-255,66,226166,96,332230
5804,0.01162,172.217.194.0-255,1484,227650,96,332230
5805,0.013931,172.217.194.0-255,4320,231970,96,332230
5806,0.013944,172.31.47.0-255,66,232036,96,332230
5807,0.016223,172.217.194.0-255,5738,237774,96,332230
5808,0.01623,172.31.47.0-255,66,237840,96,332230
5809,0.018532,172.217.194.0-255,5738,243578,96,332230
5810,0.018538,172.31.47.0-255,66,243644,96,332230
5811,0.020861,172.217.194.0-255,5738,249382,96,332230
5812,0.020869,172.31.47.0-255,66,249448,96,332230
5813,0.023176,172.217.194.0-255,2902,252350,96,332230
5814,0.023185,172.31.47.0-255,66,252416,96,332230
5815,0.023211,172.217.194.0-255,2902,255318,96,332230
5816,0.023213,172.31.47.0-255,66,255384,96,332230
5817,0.025453,172.217.194.0-255,2902,258286,96,332230
5818,0.025458,172.31.47.0-255,66,258352,96,332230
5819,0.025506,172.217.194.0-255,1484,259836,96,332230
5820,0.02552,172.217.194.0-255,1484,261320,96,332230
5821,0.025523,172.31.47.0-255,66,261386,96,332230
5822,0.027739,172.217.194.0-255,2902,264288,96,332230
5823,0.027745,172.31.47.0-255,66,264354,96,332230
5824,0.027823,172.217.194.0-255,1484,265838,96,332230
5825,0.027839,172.217.194.0-255,1484,267322,96,332230
5826,0.027842,172.31.47.0-255,66,267388,96,332230
5827,0.030015,172.217.194.0-255,2902,270290,96,332230
5828,0.030022,172.31.47.0-255,66,270356,96,332230
5829,0.030085,172.217.194.0-255,1484,271840,96,332230
5830,0.0301,172.217.194.0-255,1484,273324,96,332230
5831,0.030103,172.31.47.0-255,66,273390,96,332230
5832,0.032305,172.217.194.0-255,2902,276292,96,332230
5833,0.03231,172.31.47.0-255,66,276358,96,332230
5834,0.032386,172.217.194.0-255,2902,279260,96,332230
5835,0.03239,172.31.47.0-255,66,279326,96,332230
5836,0.032646,172.31.47.0-255,172,279498,96,332230
5837,0.032678,172.31.47.0-255,1104,280602,96,332230
5838,0.0327,172.31.47.0-255,1514,282116,96,332230
5839,0.032701,172.31.47.0-255,1307,283423,96,332230
5840,0.034207,104.244.42.0-255,66,283489,96,332230
5841,0.034213,104.244.42.0-255,66,283555,96,332230
5842,0.03425,104.244.42.0-255,66,283621,96,332230
5843,0.03462,172.217.194.0-255,1484,285105,96,332230
5844,0.034644,172.217.194.0-255,1484,286589,96,332230
5845,0.034648,172.31.47.0-255,66,286655,96,332230
5846,0.034694,172.217.194.0-255,2902,289557,96,332230
5847,0.034697,172.31.47.0-255,66,289623,96,332230
5848,0.036903,172.217.194.0-255,2902,292525,96,332230
5849,0.036909,172.31.47.0-255,66,292591,96,332230
5850,0.037013,172.217.194.0-255,2902,295493,96,332230
5851,0.037018,172.31.47.0-255,66,295559,96,332230
5852,0.039172,172.217.194.0-255,2902,298461,96,332230
5853,0.039177,172.31.47.0-255,66,298527,96,332230
5854,0.03926,172.217.194.0-255,2902,301429,96,332230
5855,0.039264,172.31.47.0-255,66,301495,96,332230
5856,0.041472,172.217.194.0-255,2902,304397,96,332230
5857,0.041476,172.31.47.0-255,66,304463,96,332230
5858,0.04155,172.217.194.0-255,2902,307365,96,332230
5859,0.041554,172.31.47.0-255,66,307431,96,332230
5860,0.043732,172.217.194.0-255,2902,310333,96,332230
5861,0.043736,172.31.47.0-255,66,310399,96,332230
5862,0.043803,172.217.194.0-255,2902,313301,96,332230
5863,0.043807,172.31.47.0-255,66,313367,96,332230
5864,0.045982,172.217.194.0-255,2902,316269,96,332230
5865,0.045987,172.31.47.0-255,66,316335,96,332230
5866,0.046046,172.217.194.0-255,2902,319237,96,332230
5867,0.046049,172.31.47.0-255,66,319303,96,332230
5868,0.048266,172.217.194.0-255,2902,322205,96,332230
5869,0.048272,172.31.47.0-255,66,322271,96,332230
5870,0.048339,172.217.194.0-255,2902,325173,96,332230
5871,0.048344,172.31.47.0-255,66,325239,96,332230
5872,0.050522,172.217.194.0-255,2902,328141,96,332230
5873,0.050527,172.31.47.0-255,66,328207,96,332230
5874,0.050671,172.217.194.0-255,2902,331109,96,332230
5875,0.050676,172.31.47.0-255,66,331175,96,332230
5876,0.052813,172.217.194.0-255,818,331993,96,332230
5877,0.052948,172.31.47.0-255,66,332059,96,332230
5878,0.052971,172.31.47.0-255,105,332164,96,332230
5879,0.055202,172.217.194.0-255,66,332230,96,332230
5880,0.0,74.125.24.0-255,153,153,96,334587
5881,1.4e-05,172.31.47.0-255,66,219,96,334587
5882,2.1e-05,74.125.24.0-255,1484,1703,96,334587
5883,2.5e-05,172.31.47.0-255,66,1769,96,334587
5884,3e-05,74.125.24.0-255,2902,4671,96,334587
5885,3.4e-05,172.31.47.0-255,66,4737,96,334587
5886,3.8e-05,74.125.24.0-255,2902,7639,96,334587
5887,4.1e-05,172.31.47.0-255,66,7705,96,334587
5888,6.1e-05,74.125.24.0-255,4320,12025,96,334587
5889,6.4e-05,172.31.47.0-255,66,12091,96,334587
5890,8.6e-05,74.125.24.0-255,2902,14993,96,334587
5891,8.8e-05,172.31.47.0-255,66,15059,96,334587
5892,0.000118,172.31.47.0-255,66,15125,96,334587
5893,0.000148,74.125.24.0-255,3961,19086,96,334587
5894,0.00015,172.31.47.0-255,66,19152,96,334587
5895,0.00055,74.125.24.0-255,1484,20636,96,334587
5896,0.000555,172.31.47.0-255,66,20702,96,334587
5897,0.000559,74.125.24.0-255,1484,22186,96,334587
5898,0.000561,172.31.47.0-255,66,22252,96,334587
5899,0.000574,74.125.24.0-255,1484,23736,96,334587
5900,0.000576,172.31.47.0-255,66,23802,96,334587
5901,0.000583,74.125.24.0-255,5738,29540,96,334587
5902,0.000585,172.31.47.0-255,66,29606,96,334587
5903,0.000591,74.125.24.0-255,5738,35344,96,334587
5904,0.000593,172.31.47.0-255,66,35410,96,334587
5905,0.000631,74.125.24.0-255,5738,41148,96,334587
5906,0.000634,172.31.47.0-255,66,41214,96,334587
5907,0.00066,172.31.47.0-255,66,41280,96,334587
5908,0.000665,74.125.24.0-255,4234,45514,96,334587
5909,0.000667,172.31.47.0-255,66,45580,96,334587
5910,0.001013,74.125.24.0-255,132,45712,96,334587
5911,0.001141,74.125.24.0-255,1484,47196,96,334587
5912,0.001147,172.31.47.0-255,66,47262,96,334587
5913,0.001166,74.125.24.0-255,2902,50164,96,334587
5914,0.001169,172.31.47.0-255,66,50230,96,334587
5915,0.001174,74.125.24.0-255,2902,53132,96,334587
5916,0.001176,172.31.47.0-255,66,53198,96,334587
5917,0.001193,74.125.24.0-255,2902,56100,96,334587
5918,0.001195,172.31.47.0-255,66,56166,96,334587
5919,0.001201,74.125.24.0-255,5738,61904,96,334587
5920,0.001202,172.31.47.0-255,66,61970,96,334587
5921,0.001231,74.125.24.0-255,7156,69126,96,334587
5922,0.001234,172.31.47.0-255,66,69192,96,334587
5923,0.00124,74.125.24.0-255,5738,74930,96,334587
5924,0.001242,172.31.47.0-255,66,74996,96,334587
5925,0.001267,74.125.24.0-255,5020,80016,96,334587
5926,0.001269,172.31.47.0-255,66,80082,96,334587
5927,0.001332,74.125.24.0-255,346,80428,96,334587
5928,0.001374,74.125.24.0-255,1484,81912,96,334587
5929,0.001377,172.31.47.0-255,66,81978,96,334587
5930,0.001391,74.125.24.0-255,4320,86298,96,334587
5931,0.001394,172.31.47.0-255,66,86364,96,334587
5932,0.001418,74.125.24.0-255,2902,89266,96,334587
5933,0.001421,172.31.47.0-255,66,89332,96,334587
5934,0.001424,74.125.24.0-255,1484,90816,96,334587
5935,0.001444,74.125.24.0-255,7156,97972,96,334587
5936,0.001446,172.31.47.0-255,66,98038,96,334587
5937,0.001462,74.125.24.0-255,7156,105194,96,334587
5938,0.001464,172.31.47.0-255,66,105260,96,334587
5939,0.001481,74.125.24.0-255,5738,110998,96,334587
5940,0.001483,172.31.47.0-255,66,111064,96,334587
5941,0.001523,74.125.24.0-255,5020,116084,96,334587
5942,0.001526,172.31.47.0-255,66,116150,96,334587
5943,0.001532,74.125.24.0-255,5738,121888,96,334587
5944,0.001535,172.31.47.0-255,66,121954,96,334587
5945,0.001556,74.125.24.0-255,1484,123438,96,334587
5946,0.001569,74.125.24.0-255,4320,127758,96,334587
5947,0.001571,172.31.47.0-255,66,127824,96,334587
5948,0.001594,74.125.24.0-255,7156,134980,96,334587
5949,0.001596,172.31.47.0-255,66,135046,96,334587
5950,0.001602,74.125.24.0-255,5738,140784,96,334587
5951,0.001604,172.31.47.0-255,66,140850,96,334587
5952,0.001625,172.31.47.0-255,66,140916,96,334587
5953,0.001702,74.125.24.0-255,1484,142400,96,334587
5954,0.001716,74.125.24.0-255,2902,145302,96,334587
5955,0.001718,172.31.47.0-255,66,145368,96,334587
5956,0.001738,74.125.24.0-255,4320,149688,96,334587
5957,0.001741,172.31.47.0-255,66,149754,96,334587
5958,0.001761,74.125.24.0-255,1484,151238,96,334587
5959,0.001775,172.31.47.0-255,66,151304,96,334587
5960,0.001779,74.125.24.0-255,2902,154206,96,334587
5961,0.001781,172.31.47.0-255,66,154272,96,334587
5962,0.001797,74.125.24.0-255,5738,160010,96,334587
5963,0.001799,172.31.47.0-255,66,160076,96,334587
5964,0.001832,74.125.24.0-255,2184,162260,96,334587
5965,0.001834,172.31.47.0-255,66,162326,96,334587
5966,0.001926,74.125.24.0-255,1484,163810,96,334587
5967,0.001939,74.125.24.0-255,1484,165294,96,334587
5968,0.001941,172.31.47.0-255,66,165360,96,334587
5969,0.001961,74.125.24.0-255,1484,166844,96,334587
5970,0.001967,74.125.24.0-255,5738,172582,96,334587
5971,0.00197,172.31.47.0-255,66,172648,96,334587
5972,0.002004,74.125.24.0-255,1484,174132,96,334587
5973,0.002028,172.31.47.0-255,66,174198,96,334587
5974,0.002033,74.125.24.0-255,4320,178518,96,334587
5975,0.002035,172.31.47.0-255,66,178584,96,334587
5976,0.002054,172.31.47.0-255,66,178650,96,334587
5977,0.002091,172.31.47.0-255,66,178716,96,334587
5978,0.00213,172.31.47.0-255,66,178782,96,334587
5979,0.002144,74.125.24.0-255,1484,180266,96,334587
5980,0.002149,74.125.24.0-255,3602,183868,96,334587
5981,0.002151,172.31.47.0-255,66,183934,96,334587
5982,0.004481,74.125.24.0-255,5738,189672,96,334587
5983,0.004488,172.31.47.0-255,66,189738,96,334587
5984,0.0068,74.125.24.0-255,5738,195476,96,334587
5985,0.006807,172.31.47.0-255,66,195542,96,334587
5986,0.009113,74.125.24.0-255,2902,198444,96,334587
5987,0.009118,172.31.47.0-255,66,198510,96,334587
5988,0.009136,74.125.24.0-255,2902,201412,96,334587
5989,0.009139,172.31.47.0-255,66,201478,96,334587
5990,0.011424,74.125.24.0-255,2902,204380,96,334587
5991,0.01143,172.31.47.0-255,66,204446,96,334587
5992,0.011506,74.125.24.0-255,2902,207348,96,334587
5993,0.011511,172.31.47.0-255,66,207414,96,334587
5994,0.013752,74.125.24.0-255,2902,210316,96,334587
5995,0.01376,172.31.47.0-255,66,210382,96,334587
5996,0.013812,74.125.24.0-255,2902,213284,96,334587
5997,0.013816,172.31.47.0-255,66,213350,96,334587
5998,0.016085,74.125.24.0-255,2902,216252,96,334587
5999,0.016092,172.31.47.0-255,66,216318,96,334587
6000,0.016155,74.125.24.0-255,2902,219220,96,334587
6001,0.016158,172.31.47.0-255,66,219286,96,334587
6002,0.018452,74.125.24.0-255,2902,222188,96,334587
6003,0.018461,172.31.47.0-255,66,222254,96,334587
6004,0.01851,74.125.24.0-255,2902,225156,96,334587
6005,0.018515,172.31.47.0-255,66,225222,96,334587
6006,0.020813,74.125.24.0-255,4320,229542,96,334587
6007,0.020819,172.31.47.0-255,66,229608,96,334587
6008,0.020836,74.125.24.0-255,1484,231092,96,334587
6009,0.023185,74.125.24.0-255,4320,235412,96,334587
6010,0.023191,172.31.47.0-255,66,235478,96,334587
6011,0.024919,172.31.47.0-255,172,235650,96,334587
6012,0.024953,172.31.47.0-255,1109,236759,96,334587
6013,0.025011,172.31.47.0-255,1514,238273,96,334587
6014,0.025013,172.31.47.0-255,335,238608,96,334587
6015,0.025539,74.125.24.0-255,5738,244346,96,334587
6016,0.025545,172.31.47.0-255,66,244412,96,334587
6017,0.026473,104.244.42.0-255,66,244478,96,334587
6018,0.026509,104.244.42.0-255,66,244544,96,334587
6019,0.02655,104.244.42.0-255,66,244610,96,334587
6020,0.027916,74.125.24.0-255,5738,250348,96,334587
6021,0.027921,172.31.47.0-255,66,250414,96,334587
6022,0.030259,74.125.24.0-255,5738,256152,96,334587
6023,0.030264,172.31.47.0-255,66,256218,96,334587
6024,0.032632,74.125.24.0-255,5738,261956,96,334587
6025,0.032638,172.31.47.0-255,66,262022,96,334587
6026,0.034998,74.125.24.0-255,5738,267760,96,334587
6027,0.035005,172.31.47.0-255,66,267826,96,334587
6028,0.037439,74.125.24.0-255,5738,273564,96,334587
6029,0.037446,172.31.47.0-255,66,273630,96,334587
6030,0.039793,74.125.24.0-255,5738,279368,96,334587
6031,0.039799,172.31.47.0-255,66,279434,96,334587
6032,0.042125,74.125.24.0-255,4320,283754,96,334587
6033,0.04213,172.31.47.0-255,66,283820,96,334587
6034,0.042148,74.125.24.0-255,1484,285304,96,334587
6035,0.04451,74.125.24.0-255,4320,289624,96,334587
6036,0.044517,172.31.47.0-255,66,289690,96,334587
6037,0.046898,74.125.24.0-255,5738,295428,96,334587
6038,0.046903,172.31.47.0-255,66,295494,96,334587
6039,0.049228,74.125.24.0-255,5738,301232,96,334587
6040,0.049236,172.31.47.0-255,66,301298,96,334587
6041,0.051611,74.125.24.0-255,5738,307036,96,334587
6042,0.051619,172.31.47.0-255,66,307102,96,334587
6043,0.053982,74.125.24.0-255,5738,312840,96,334587
6044,0.053986,172.31.47.0-255,66,312906,96,334587
6045,0.056288,74.125.24.0-255,5738,318644,96,334587
6046,0.056295,172.31.47.0-255,66,318710,96,334587
6047,0.058611,74.125.24.0-255,5738,324448,96,334587
6048,0.058617,172.31.47.0-255,66,324514,96,334587
6049,0.060912,74.125.24.0-255,5738,330252,96,334587
6050,0.060918,172.31.47.0-255,66,330318,96,334587
6051,0.06324,74.125.24.0-255,4032,334350,96,334587
6052,0.063248,172.31.47.0-255,66,334416,96,334587
6053,0.06344,172.31.47.0-255,105,334521,96,334587
6054,0.065746,74.125.24.0-255,66,334587,96,334587
6055,0.0,172.217.194.0-255,153,153,96,176945
6056,3.2e-05,172.31.47.0-255,66,219,96,176945
6057,3.9e-05,172.217.194.0-255,1484,1703,96,176945
6058,4.3e-05,172.31.47.0-255,66,1769,96,176945
6059,5.7e-05,172.217.194.0-255,2902,4671,96,176945
6060,6e-05,172.31.47.0-255,66,4737,96,176945
6061,6.6e-05,172.217.194.0-255,5738,10475,96,176945
6062,6.9e-05,172.31.47.0-255,66,10541,96,176945
6063,0.000103,172.217.194.0-255,1484,12025,96,176945
6064,0.000105,172.31.47.0-255,66,12091,96,176945
6065,0.000116,172.31.47.0-255,66,12157,96,176945
6066,0.000126,172.31.47.0-255,66,12223,96,176945
6067,0.000157,172.217.194.0-255,2543,14766,96,176945
6068,0.00016,172.31.47.0-255,66,14832,96,176945
6069,0.00019,172.217.194.0-255,1484,16316,96,176945
6070,0.000193,172.31.47.0-255,66,16382,96,176945
6071,0.000197,172.217.194.0-255,2902,19284,96,176945
6072,0.0002,172.31.47.0-255,66,19350,96,176945
6073,0.000211,172.217.194.0-255,5738,25088,96,176945
6074,0.000214,172.31.47.0-255,66,25154,96,176945
6075,0.000219,172.217.194.0-255,5738,30892,96,176945
6076,0.000221,172.31.47.0-255,66,30958,96,176945
6077,0.000277,172.31.47.0-255,66,31024,96,176945
6078,0.000283,172.217.194.0-255,4254,35278,96,176945
6079,0.000284,172.31.47.0-255,66,35344,96,176945
6080,0.000287,172.217.194.0-255,364,35708,96,176945
6081,0.000288,172.31.47.0-255,66,35774,96,176945
6082,0.000344,172.217.194.0-255,1484,37258,96,176945
6083,0.000349,172.31.47.0-255,66,37324,96,176945
6084,0.000375,172.217.194.0-255,2902,40226,96,176945
6085,0.000379,172.31.47.0-255,66,40292,96,176945
6086,0.000385,172.217.194.0-255,5738,46030,96,176945
6087,0.000388,172.31.47.0-255,66,46096,96,176945
6088,0.000453,172.217.194.0-255,6797,52893,96,176945
6089,0.000456,172.31.47.0-255,66,52959,96,176945
6090,0.000464,172.217.194.0-255,7156,60115,96,176945
6091,0.000467,172.31.47.0-255,66,60181,96,176945
6092,0.000481,172.217.194.0-255,7156,67337,96,176945
6093,0.000484,172.31.47.0-255,66,67403,96,176945
6094,0.000514,172.217.194.0-255,2543,69946,96,176945
6095,0.000518,172.31.47.0-255,66,70012,96,176945
6096,0.00068,172.217.194.0-255,1484,71496,96,176945
6097,0.000687,172.217.194.0-255,2902,74398,96,176945
6098,0.00069,172.31.47.0-255,66,74464,96,176945
6099,0.000697,172.217.194.0-255,5738,80202,96,176945
6100,0.000702,172.31.47.0-255,66,80268,96,176945
6101,0.000732,172.31.47.0-255,66,80334,96,176945
6102,0.000759,172.217.194.0-255,2902,83236,96,176945
6103,0.000765,172.31.47.0-255,66,83302,96,176945
6104,0.00077,172.31.47.0-255,66,83368,96,176945
6105,0.000774,172.217.194.0-255,1484,84852,96,176945
6106,0.000823,172.31.47.0-255,66,84918,96,176945
6107,0.000839,172.31.47.0-255,66,84984,96,176945
6108,0.000846,172.217.194.0-255,5738,90722,96,176945
6109,0.000848,172.31.47.0-255,66,90788,96,176945
6110,0.000882,172.217.194.0-255,4320,95108,96,176945
6111,0.000886,172.31.47.0-255,66,95174,96,176945
6112,0.000904,172.31.47.0-255,66,95240,96,176945
6113,0.000918,172.31.47.0-255,66,95306,96,176945
6114,0.000943,172.217.194.0-255,4320,99626,96,176945
6115,0.000951,172.31.47.0-255,66,99692,96,176945
6116,0.000983,172.31.47.0-255,66,99758,96,176945
6117,0.001002,172.31.47.0-255,66,99824,96,176945
6118,0.001008,172.217.194.0-255,5738,105562,96,176945
6119,0.001012,172.31.47.0-255,66,105628,96,176945
6120,0.001026,172.217.194.0-255,766,106394,96,176945
6121,0.001049,172.217.194.0-255,1484,107878,96,176945
6122,0.001053,172.31.47.0-255,66,107944,96,176945
6123,0.001058,172.217.194.0-255,2902,110846,96,176945
6124,0.001061,172.31.47.0-255,66,110912,96,176945
6125,0.001089,172.217.194.0-255,5738,116650,96,176945
6126,0.001092,172.31.47.0-255,66,116716,96,176945
6127,0.001095,172.217.194.0-255,1484,118200,96,176945
6128,0.00114,172.31.47.0-255,66,118266,96,176945
6129,0.00116,172.31.47.0-255,66,118332,96,176945
6130,0.001164,172.217.194.0-255,2184,120516,96,176945
6131,0.001166,172.31.47.0-255,66,120582,96,176945
6132,0.001223,172.217.194.0-255,1484,122066,96,176945
6133,0.001235,172.217.194.0-255,2902,124968,96,176945
6134,0.001239,172.31.47.0-255,66,125034,96,176945
6135,0.001242,172.217.194.0-255,1484,126518,96,176945
6136,0.001275,172.217.194.0-255,4320,130838,96,176945
6137,0.001278,172.31.47.0-255,66,130904,96,176945
6138,0.001296,172.31.47.0-255,66,130970,96,176945
6139,0.001302,172.217.194.0-255,5738,136708,96,176945
6140,0.001304,172.31.47.0-255,66,136774,96,176945
6141,0.001334,172.217.194.0-255,5020,141794,96,176945
6142,0.001338,172.31.47.0-255,66,141860,96,176945
6143,0.001389,172.217.194.0-255,1484,143344,96,176945
6144,0.001395,172.217.194.0-255,2902,146246,96,176945
6145,0.001398,172.31.47.0-255,66,146312,96,176945
6146,0.00143,172.217.194.0-255,5738,152050,96,176945
6147,0.001434,172.31.47.0-255,66,152116,96,176945
6148,0.001474,172.31.47.0-255,66,152182,96,176945
6149,0.001511,172.217.194.0-255,7156,159338,96,176945
6150,0.001515,172.31.47.0-255,66,159404,96,176945
6151,0.001546,172.217.194.0-255,3602,163006,96,176945
6152,0.00155,172.31.47.0-255,66,163072,96,176945
6153,0.001561,172.31.47.0-255,66,163138,96,176945
6154,0.001581,172.217.194.0-255,1484,164622,96,176945
6155,0.001599,172.31.47.0-255,66,164688,96,176945
6156,0.001604,172.217.194.0-255,4320,169008,96,176945
6157,0.001607,172.31.47.0-255,66,169074,96,176945
6158,0.001649,172.31.47.0-255,66,169140,96,176945
6159,0.001654,172.217.194.0-255,2902,172042,96,176945
6160,0.001656,172.31.47.0-255,66,172108,96,176945
6161,0.001714,172.31.47.0-255,66,172174,96,176945
6162,0.001724,172.31.47.0-255,66,172240,96,176945
6163,0.001743,172.217.194.0-255,105,172345,96,176945
6164,0.001744,172.31.47.0-255,66,172411,96,176945
6165,0.003644,172.31.47.0-255,66,172477,96,176945
6166,0.003671,172.31.47.0-255,105,172582,96,176945
6167,0.005604,172.217.194.0-255,66,172648,96,176945
6168,0.033166,172.31.47.0-255,172,172820,96,176945
6169,0.033197,172.31.47.0-255,1110,173930,96,176945
6170,0.033266,172.31.47.0-255,1514,175444,96,176945
6171,0.033268,172.31.47.0-255,1303,176747,96,176945
6172,0.034655,104.244.42.0-255,66,176813,96,176945
6173,0.034683,104.244.42.0-255,66,176879,96,176945
6174,0.034767,104.244.42.0-255,66,176945,96,176945
6175,0.0,172.217.194.0-255,153,153,96,305174
6176,2.8e-05,172.31.47.0-255,66,219,96,305174
6177,3.4e-05,172.217.194.0-255,1484,1703,96,305174
6178,3.8e-05,172.31.47.0-255,66,1769,96,305174
6179,4.3e-05,172.217.194.0-255,2902,4671,96,305174
6180,4.5e-05,172.31.47.0-255,66,4737,96,305174
6181,5.3e-05,172.217.194.0-255,7156,11893,96,305174
6182,5.6e-05,172.31.47.0-255,66,11959,96,305174
6183,0.0001,172.217.194.0-255,2035,13994,96,305174
6184,0.000103,172.31.47.0-255,66,14060,96,305174
6185,0.000175,172.217.194.0-255,1484,15544,96,305174
6186,0.000178,172.31.47.0-255,66,15610,96,305174
6187,0.000183,172.217.194.0-255,1484,17094,96,305174
6188,0.000185,172.31.47.0-255,66,17160,96,305174
6189,0.000201,172.217.194.0-255,1484,18644,96,305174
6190,0.000203,172.31.47.0-255,66,18710,96,305174
6191,0.00021,172.217.194.0-255,5738,24448,96,305174
6192,0.000212,172.31.47.0-255,66,24514,96,305174
6193,0.000254,172.217.194.0-255,6797,31311,96,305174
6194,0.000257,172.31.47.0-255,66,31377,96,305174
6195,0.000293,172.217.194.0-255,1484,32861,96,305174
6196,0.000296,172.31.47.0-255,66,32927,96,305174
6197,0.0003,172.217.194.0-255,1484,34411,96,305174
6198,0.000302,172.31.47.0-255,66,34477,96,305174
6199,0.000315,172.217.194.0-255,1484,35961,96,305174
6200,0.000318,172.31.47.0-255,66,36027,96,305174
6201,0.000336,172.217.194.0-255,5738,41765,96,305174
6202,0.000339,172.31.47.0-255,66,41831,96,305174
6203,0.000386,172.217.194.0-255,4320,46151,96,305174
6204,0.00039,172.31.47.0-255,66,46217,96,305174
6205,0.000409,172.217.194.0-255,2543,48760,96,305174
6206,0.000412,172.31.47.0-255,66,48826,96,305174
6207,0.000858,172.217.194.0-255,1484,50310,96,305174
6208,0.000868,172.217.194.0-255,2902,53212,96,305174
6209,0.000873,172.31.47.0-255,66,53278,96,305174
6210,0.000881,172.217.194.0-255,4320,57598,96,305174
6211,0.000883,172.31.47.0-255,66,57664,96,305174
6212,0.000899,172.217.194.0-255,1484,59148,96,305174
6213,0.000961,172.31.47.0-255,66,59214,96,305174
6214,0.001067,172.217.194.0-255,1484,60698,96,305174
6215,0.001087,172.217.194.0-255,2902,63600,96,305174
6216,0.001091,172.31.47.0-255,66,63666,96,305174
6217,0.001098,172.217.194.0-255,5738,69404,96,305174
6218,0.001099,172.31.47.0-255,66,69470,96,305174
6219,0.001155,172.217.194.0-255,2902,72372,96,305174
6220,0.001158,172.31.47.0-255,66,72438,96,305174
6221,0.001186,172.31.47.0-255,66,72504,96,305174
6222,0.001237,172.217.194.0-255,2902,75406,96,305174
6223,0.001241,172.31.47.0-255,66,75472,96,305174
6224,0.001269,172.31.47.0-255,66,75538,96,305174
6225,0.001583,172.217.194.0-255,1484,77022,96,305174
6226,0.001597,172.217.194.0-255,2902,79924,96,305174
6227,0.0016,172.31.47.0-255,66,79990,96,305174
6228,0.00162,172.217.194.0-255,5738,85728,96,305174
6229,0.001622,172.31.47.0-255,66,85794,96,305174
6230,0.001665,172.31.47.0-255,66,85860,96,305174
6231,0.001727,172.217.194.0-255,1484,87344,96,305174
6232,0.001758,172.31.47.0-255,66,87410,96,305174
6233,0.001822,172.217.194.0-255,2184,89594,96,305174
6234,0.001823,172.31.47.0-255,66,89660,96,305174
6235,0.001867,172.217.194.0-255,2902,92562,96,305174
6236,0.001869,172.31.47.0-255,66,92628,96,305174
6237,0.001887,172.217.194.0-255,4320,96948,96,305174
6238,0.00189,172.31.47.0-255,66,97014,96,305174
6239,0.001904,172.217.194.0-255,2902,99916,96,305174
6240,0.001906,172.31.47.0-255,66,99982,96,305174
6241,0.001924,172.217.194.0-255,2902,102884,96,305174
6242,0.001926,172.31.47.0-255,66,102950,96,305174
6243,0.001949,172.31.47.0-255,66,103016,96,305174
6244,0.002018,172.217.194.0-255,2902,105918,96,305174
6245,0.00202,172.31.47.0-255,66,105984,96,305174
6246,0.002046,172.31.47.0-255,66,106050,96,305174
6247,0.002119,172.217.194.0-255,2902,108952,96,305174
6248,0.002121,172.31.47.0-255,66,109018,96,305174
6249,0.002148,172.31.47.0-255,66,109084,96,305174
6250,0.004168,172.217.194.0-255,5738,114822,96,305174
6251,0.004173,172.31.47.0-255,66,114888,96,305174
6252,0.006189,172.217.194.0-255,5738,120626,96,305174
6253,0.006195,172.31.47.0-255,66,120692,96,305174
6254,0.008264,172.217.194.0-255,5738,126430,96,305174
6255,0.00827,172.31.47.0-255,66,126496,96,305174
6256,0.010296,172.217.194.0-255,5738,132234,96,305174
6257,0.010303,172.31.47.0-255,66,132300,96,305174
6258,0.01235,172.217.194.0-255,5738,138038,96,305174
6259,0.01236,172.31.47.0-255,66,138104,96,305174
6260,0.014376,172.217.194.0-255,5738,143842,96,305174
6261,0.014383,172.31.47.0-255,66,143908,96,305174
6262,0.016433,172.217.194.0-255,5738,149646,96,305174
6263,0.016439,172.31.47.0-255,66,149712,96,305174
6264,0.01847,172.217.194.0-255,5738,155450,96,305174
6265,0.018477,172.31.47.0-255,66,155516,96,305174
6266,0.020493,172.217.194.0-255,5738,161254,96,305174
6267,0.0205,172.31.47.0-255,66,161320,96,305174
6268,0.022542,172.217.194.0-255,5738,167058,96,305174
6269,0.022549,172.31.47.0-255,66,167124,96,305174
6270,0.02461,172.217.194.0-255,5738,172862,96,305174
6271,0.024617,172.31.47.0-255,66,172928,96,305174
6272,0.026644,172.217.194.0-255,5738,178666,96,305174
6273,0.026649,172.31.47.0-255,66,178732,96,305174
6274,0.028696,172.217.194.0-255,5738,184470,96,305174
6275,0.028702,172.31.47.0-255,66,184536,96,305174
6276,0.029941,172.31.47.0-255,171,184707,96,305174
6277,0.029966,172.31.47.0-255,1134,185841,96,305174
6278,0.030003,172.31.47.0-255,1514,187355,96,305174
6279,0.030004,172.31.47.0-255,1277,188632,96,305174
6280,0.03073,172.217.194.0-255,5738,194370,96,305174
6281,0.030736,172.31.47.0-255,66,194436,96,305174
6282,0.031465,104.244.42.0-255,66,194502,96,305174
6283,0.031529,104.244.42.0-255,66,194568,96,305174
6284,0.031571,104.244.42.0-255,66,194634,96,305174
6285,0.032777,172.217.194.0-255,5738,200372,96,305174
6286,0.032781,172.31.47.0-255,66,200438,96,305174
6287,0.034821,172.217.194.0-255,5738,206176,96,305174
6288,0.034826,172.31.47.0-255,66,206242,96,305174
6289,0.036881,172.217.194.0-255,5738,211980,96,305174
6290,0.036886,172.31.47.0-255,66,212046,96,305174
6291,0.03893,172.217.194.0-255,5738,217784,96,305174
6292,0.038934,172.31.47.0-255,66,217850,96,305174
6293,0.040957,172.217.194.0-255,5738,223588,96,305174
6294,0.040977,172.31.47.0-255,66,223654,96,305174
6295,0.043021,172.217.194.0-255,5738,229392,96,305174
6296,0.043027,172.31.47.0-255,66,229458,96,305174
6297,0.045035,172.217.194.0-255,2902,232360,96,305174
6298,0.04504,172.31.47.0-255,66,232426,96,305174
6299,0.045068,172.217.194.0-255,2902,235328,96,305174
6300,0.04507,172.31.47.0-255,66,235394,96,305174
6301,0.047087,172.217.194.0-255,5738,241132,96,305174
6302,0.047092,172.31.47.0-255,66,241198,96,305174
6303,0.049123,172.217.194.0-255,5738,246936,96,305174
6304,0.049128,172.31.47.0-255,66,247002,96,305174
6305,0.051148,172.217.194.0-255,5738,252740,96,305174
6306,0.051153,172.31.47.0-255,66,252806,96,305174
6307,0.053182,172.217.194.0-255,5738,258544,96,305174
6308,0.053188,172.31.47.0-255,66,258610,96,305174
6309,0.055226,172.217.194.0-255,5738,264348,96,305174
6310,0.055231,172.31.47.0-255,66,264414,96,305174
6311,0.057259,172.217.194.0-255,5738,270152,96,305174
6312,0.057264,172.31.47.0-255,66,270218,96,305174
6313,0.059262,172.217.194.0-255,5738,275956,96,305174
6314,0.059267,172.31.47.0-255,66,276022,96,305174
6315,0.061292,172.217.194.0-255,2902,278924,96,305174
6316,0.061298,172.31.47.0-255,66,278990,96,305174
6317,0.061328,172.217.194.0-255,2902,281892,96,305174
6318,0.061331,172.31.47.0-255,66,281958,96,305174
6319,0.063335,172.217.194.0-255,5738,287696,96,305174
6320,0.06334,172.31.47.0-255,66,287762,96,305174
6321,0.065382,172.217.194.0-255,5738,293500,96,305174
6322,0.065388,172.31.47.0-255,66,293566,96,305174
6323,0.067426,172.217.194.0-255,5738,299304,96,305174
6324,0.067431,172.31.47.0-255,66,299370,96,305174
6325,0.069453,172.217.194.0-255,5738,305108,96,305174
6326,0.069459,172.31.47.0-255,66,305174,96,305174
6327,0.0,74.125.24.0-255,153,153,96,291475
6328,2.2e-05,172.31.47.0-255,66,219,96,291475
6329,2.9e-05,74.125.24.0-255,1484,1703,96,291475
6330,3.3e-05,172.31.47.0-255,66,1769,96,291475
6331,4.7e-05,74.125.24.0-255,2902,4671,96,291475
6332,5e-05,172.31.47.0-255,66,4737,96,291475
6333,5.8e-05,74.125.24.0-255,7156,11893,96,291475
6334,6.2e-05,172.31.47.0-255,66,11959,96,291475
6335,0.000103,172.31.47.0-255,66,12025,96,291475
6336,0.000108,74.125.24.0-255,2902,14927,96,291475
6337,0.00011,172.31.47.0-255,66,14993,96,291475
6338,0.000149,74.125.24.0-255,6797,21790,96,291475
6339,0.000153,172.31.47.0-255,66,21856,96,291475
6340,0.000197,74.125.24.0-255,1484,23340,96,291475
6341,0.0002,172.31.47.0-255,66,23406,96,291475
6342,0.000205,74.125.24.0-255,2902,26308,96,291475
6343,0.000207,172.31.47.0-255,66,26374,96,291475
6344,0.000213,74.125.24.0-255,5738,32112,96,291475
6345,0.000216,172.31.47.0-255,66,32178,96,291475
6346,0.000256,74.125.24.0-255,6797,38975,96,291475
6347,0.00026,172.31.47.0-255,66,39041,96,291475
6348,0.001137,74.125.24.0-255,1484,40525,96,291475
6349,0.001145,172.31.47.0-255,66,40591,96,291475
6350,0.001155,74.125.24.0-255,2902,43493,96,291475
6351,0.001157,172.31.47.0-255,66,43559,96,291475
6352,0.001171,74.125.24.0-255,5738,49297,96,291475
6353,0.001173,172.31.47.0-255,66,49363,96,291475
6354,0.001203,74.125.24.0-255,6797,56160,96,291475
6355,0.00121,172.31.47.0-255,66,56226,96,291475
6356,0.001284,74.125.24.0-255,1484,57710,96,291475
6357,0.00129,172.31.47.0-255,66,57776,96,291475
6358,0.001295,74.125.24.0-255,2902,60678,96,291475
6359,0.001296,172.31.47.0-255,66,60744,96,291475
6360,0.001335,74.125.24.0-255,5738,66482,96,291475
6361,0.001338,172.31.47.0-255,66,66548,96,291475
6362,0.001344,74.125.24.0-255,5738,72286,96,291475
6363,0.001347,172.31.47.0-255,66,72352,96,291475
6364,0.001369,74.125.24.0-255,4320,76672,96,291475
6365,0.001371,172.31.47.0-255,66,76738,96,291475
6366,0.001385,74.125.24.0-255,7156,83894,96,291475
6367,0.001388,172.31.47.0-255,66,83960,96,291475
6368,0.001419,74.125.24.0-255,2543,86503,96,291475
6369,0.001422,172.31.47.0-255,66,86569,96,291475
6370,0.001427,74.125.24.0-255,3961,90530,96,291475
6371,0.001429,172.31.47.0-255,66,90596,96,291475
6372,0.001468,74.125.24.0-255,1484,92080,96,291475
6373,0.001487,74.125.24.0-255,2902,94982,96,291475
6374,0.00149,172.31.47.0-255,66,95048,96,291475
6375,0.001493,74.125.24.0-255,1484,96532,96,291475
6376,0.001516,74.125.24.0-255,4320,100852,96,291475
6377,0.001519,172.31.47.0-255,66,100918,96,291475
6378,0.001545,74.125.24.0-255,6783,107701,96,291475
6379,0.001548,172.31.47.0-255,66,107767,96,291475
6380,0.001944,74.125.24.0-255,1484,109251,96,291475
6381,0.001949,74.125.24.0-255,2902,112153,96,291475
6382,0.001954,172.31.47.0-255,66,112219,96,291475
6383,0.001983,74.125.24.0-255,5738,117957,96,291475
6384,0.001985,172.31.47.0-255,66,118023,96,291475
6385,0.001992,74.125.24.0-255,5787,123810,96,291475
6386,0.001994,172.31.47.0-255,66,123876,96,291475
6387,0.004247,74.125.24.0-255,4320,128196,96,291475
6388,0.004251,172.31.47.0-255,66,128262,96,291475
6389,0.004274,74.125.24.0-255,1484,129746,96,291475
6390,0.006534,74.125.24.0-255,4320,134066,96,291475
6391,0.006539,172.31.47.0-255,66,134132,96,291475
6392,0.008804,74.125.24.0-255,5738,139870,96,291475
6393,0.00881,172.31.47.0-255,66,139936,96,291475
6394,0.01112,74.125.24.0-255,5738,145674,96,291475
6395,0.011129,172.31.47.0-255,66,145740,96,291475
6396,0.013452,74.125.24.0-255,5738,151478,96,291475
6397,0.013459,172.31.47.0-255,66,151544,96,291475
6398,0.01574,74.125.24.0-255,5738,157282,96,291475
6399,0.015747,172.31.47.0-255,66,157348,96,291475
6400,0.018028,74.125.24.0-255,5738,163086,96,291475
6401,0.018036,172.31.47.0-255,66,163152,96,291475
6402,0.020321,74.125.24.0-255,5738,168890,96,291475
6403,0.020328,172.31.47.0-255,66,168956,96,291475
6404,0.022616,74.125.24.0-255,5738,174694,96,291475
6405,0.022624,172.31.47.0-255,66,174760,96,291475
6406,0.024339,172.31.47.0-255,172,174932,96,291475
6407,0.024378,172.31.47.0-255,1101,176033,96,291475
6408,0.024452,172.31.47.0-255,1514,177547,96,291475
6409,0.024454,172.31.47.0-255,1310,178857,96,291475
6410,0.024902,74.125.24.0-255,5738,184595,96,291475
6411,0.024908,172.31.47.0-255,66,184661,96,291475
6412,0.0259,104.244.42.0-255,66,184727,96,291475
6413,0.02594,104.244.42.0-255,66,184793,96,291475
6414,0.025984,104.244.42.0-255,66,184859,96,291475
6415,0.02719,74.125.24.0-255,4320,189179,96,291475
6416,0.027194,172.31.47.0-255,66,189245,96,291475
6417,0.027226,74.125.24.0-255,1484,190729,96,291475
6418,0.029426,74.125.24.0-255,2902,193631,96,291475
6419,0.029432,172.31.47.0-255,66,193697,96,291475
6420,0.029462,74.125.24.0-255,1484,195181,96,291475
6421,0.03168,74.125.24.0-255,4320,199501,96,291475
6422,0.031685,172.31.47.0-255,66,199567,96,291475
6423,0.033969,74.125.24.0-255,5738,205305,96,291475
6424,0.033976,172.31.47.0-255,66,205371,96,291475
6425,0.036298,74.125.24.0-255,5738,211109,96,291475
6426,0.036302,172.31.47.0-255,66,211175,96,291475
6427,0.038582,74.125.24.0-255,5738,216913,96,291475
6428,0.038586,172.31.47.0-255,66,216979,96,291475
6429,0.040837,74.125.24.0-255,4320,221299,96,291475
6430,0.040842,172.31.47.0-255,66,221365,96,291475
6431,0.040874,74.125.24.0-255,1484,222849,96,291475
6432,0.043093,74.125.24.0-255,4320,227169,96,291475
6433,0.043098,172.31.47.0-255,66,227235,96,291475
6434,0.045469,74.125.24.0-255,5738,232973,96,291475
6435,0.045474,172.31.47.0-255,66,233039,96,291475
6436,0.04774,74.125.24.0-255,5738,238777,96,291475
6437,0.047745,172.31.47.0-255,66,238843,96,291475
6438,0.049993,74.125.24.0-255,2902,241745,96,291475
6439,0.049999,172.31.47.0-255,66,241811,96,291475
6440,0.050044,74.125.24.0-255,2902,244713,96,291475
6441,0.050047,172.31.47.0-255,66,244779,96,291475
6442,0.052287,74.125.24.0-255,2902,247681,96,291475
6443,0.052307,172.31.47.0-255,66,247747,96,291475
6444,0.052362,74.125.24.0-255,2902,250649,96,291475
6445,0.052365,172.31.47.0-255,66,250715,96,291475
6446,0.054613,74.125.24.0-255,2902,253617,96,291475
6447,0.054628,172.31.47.0-255,66,253683,96,291475
6448,0.054658,74.125.24.0-255,2902,256585,96,291475
6449,0.054661,172.31.47.0-255,66,256651,96,291475
6450,0.056925,74.125.24.0-255,5738,262389,96,291475
6451,0.05694,172.31.47.0-255,66,262455,96,291475
6452,0.059232,74.125.24.0-255,5738,268193,96,291475
6453,0.05925,172.31.47.0-255,66,268259,96,291475
6454,0.061518,74.125.24.0-255,5738,273997,96,291475
6455,0.061534,172.31.47.0-255,66,274063,96,291475
6456,0.063861,74.125.24.0-255,5738,279801,96,291475
6457,0.06388,172.31.47.0-255,66,279867,96,291475
6458,0.066474,74.125.24.0-255,5738,285605,96,291475
6459,0.066492,172.31.47.0-255,66,285671,96,291475
6460,0.069175,74.125.24.0-255,5738,291409,96,291475
6461,0.069191,172.31.47.0-255,66,291475,96,291475
6462,0.0,172.217.194.0-255,153,153,96,348611
6463,1.5e-05,172.31.47.0-255,66,219,96,348611
6464,2.3e-05,172.217.194.0-255,1484,1703,96,348611
6465,2.7e-05,172.31.47.0-255,66,1769,96,348611
6466,3.3e-05,172.217.194.0-255,2902,4671,96,348611
6467,3.5e-05,172.31.47.0-255,66,4737,96,348611
6468,4.3e-05,172.217.194.0-255,7156,11893,96,348611
6469,4.5e-05,172.31.47.0-255,66,11959,96,348611
6470,4.9e-05,172.217.194.0-255,1948,13907,96,348611
6471,5.3e-05,172.31.47.0-255,66,13973,96,348611
6472,5.8e-05,172.217.194.0-255,4320,18293,96,348611
6473,6e-05,172.31.47.0-255,66,18359,96,348611
6474,8.5e-05,172.217.194.0-255,7156,25515,96,348611
6475,8.8e-05,172.31.47.0-255,66,25581,96,348611
6476,0.0001,172.217.194.0-255,2902,28483,96,348611
6477,0.000103,172.31.47.0-255,66,28549,96,348611
6478,0.000123,172.217.194.0-255,2543,31092,96,348611
6479,0.000126,172.31.47.0-255,66,31158,96,348611
6480,0.000157,172.217.194.0-255,1484,32642,96,348611
6481,0.000159,172.31.47.0-255,66,32708,96,348611
6482,0.000164,172.217.194.0-255,2902,35610,96,348611
6483,0.000166,172.31.47.0-255,66,35676,96,348611
6484,0.00017,172.217.194.0-255,2902,38578,96,348611
6485,0.000172,172.31.47.0-255,66,38644,96,348611
6486,0.000186,172.217.194.0-255,2902,41546,96,348611
6487,0.000189,172.31.47.0-255,66,41612,96,348611
6488,0.000196,172.217.194.0-255,6797,48409,96,348611
6489,0.000198,172.31.47.0-255,66,48475,96,348611
6490,0.000255,172.217.194.0-255,4320,52795,96,348611
6491,0.000258,172.31.47.0-255,66,52861,96,348611
6492,0.00029,172.31.47.0-255,66,52927,96,348611
6493,0.000294,172.217.194.0-255,2833,55760,96,348611
6494,0.000296,172.31.47.0-255,66,55826,96,348611
6495,0.000537,172.217.194.0-255,366,56192,96,348611
6496,0.000645,172.217.194.0-255,1484,57676,96,348611
6497,0.00065,172.31.47.0-255,66,57742,96,348611
6498,0.000671,172.217.194.0-255,2902,60644,96,348611
6499,0.000673,172.217.194.0-255,1484,62128,96,348611
6500,0.000676,172.31.47.0-255,66,62194,96,348611
6501,0.000689,172.217.194.0-255,4320,66514,96,348611
6502,0.000692,172.31.47.0-255,66,66580,96,348611
6503,0.000695,172.217.194.0-255,1484,68064,96,348611
6504,0.000733,172.31.47.0-255,66,68130,96,348611
6505,0.000738,172.217.194.0-255,2902,71032,96,348611
6506,0.00074,172.31.47.0-255,66,71098,96,348611
6507,0.000765,172.217.194.0-255,6797,77895,96,348611
6508,0.000769,172.31.47.0-255,66,77961,96,348611
6509,0.001179,172.217.194.0-255,1484,79445,96,348611
6510,0.001184,172.217.194.0-255,1484,80929,96,348611
6511,0.001186,172.31.47.0-255,66,80995,96,348611
6512,0.0012,172.217.194.0-255,1484,82479,96,348611
6513,0.001205,172.217.194.0-255,5738,88217,96,348611
6514,0.001207,172.31.47.0-255,66,88283,96,348611
6515,0.001236,172.217.194.0-255,5738,94021,96,348611
6516,0.001238,172.31.47.0-255,66,94087,96,348611
6517,0.001261,172.217.194.0-255,1484,95571,96,348611
6518,0.001274,172.31.47.0-255,66,95637,96,348611
6519,0.001278,172.217.194.0-255,2184,97821,96,348611
6520,0.001279,172.31.47.0-255,66,97887,96,348611
6521,0.001474,172.217.194.0-255,1484,99371,96,348611
6522,0.001485,172.217.194.0-255,2902,102273,96,348611
6523,0.001488,172.31.47.0-255,66,102339,96,348611
6524,0.001494,172.217.194.0-255,5738,108077,96,348611
6525,0.001496,172.31.47.0-255,66,108143,96,348611
6526,0.001521,172.217.194.0-255,2902,111045,96,348611
6527,0.001525,172.31.47.0-255,66,111111,96,348611
6528,0.001545,172.31.47.0-255,66,111177,96,348611
6529,0.001571,172.217.194.0-255,2902,114079,96,348611
6530,0.001573,172.31.47.0-255,66,114145,96,348611
6531,0.001591,172.31.47.0-255,66,114211,96,348611
6532,0.001744,172.217.194.0-255,1484,115695,96,348611
6533,0.001757,172.217.194.0-255,2902,118597,96,348611
6534,0.00176,172.31.47.0-255,66,118663,96,348611
6535,0.001782,172.217.194.0-255,5738,124401,96,348611
6536,0.001785,172.31.47.0-255,66,124467,96,348611
6537,0.001813,172.31.47.0-255,66,124533,96,348611
6538,0.001833,172.217.194.0-255,4320,128853,96,348611
6539,0.001836,172.31.47.0-255,66,128919,96,348611
6540,0.001853,172.217.194.0-255,6438,135357,96,348611
6541,0.001855,172.31.47.0-255,66,135423,96,348611
6542,0.001915,172.217.194.0-255,1484,136907,96,348611
6543,0.001919,172.217.194.0-255,2902,139809,96,348611
6544,0.001922,172.31.47.0-255,66,139875,96,348611
6545,0.001945,172.217.194.0-255,5738,145613,96,348611
6546,0.001947,172.31.47.0-255,66,145679,96,348611
6547,0.001953,172.217.194.0-255,5738,151417,96,348611
6548,0.001955,172.31.47.0-255,66,151483,96,348611
6549,0.001973,172.217.194.0-255,7156,158639,96,348611
6550,0.001975,172.31.47.0-255,66,158705,96,348611
6551,0.001985,172.31.47.0-255,66,158771,96,348611
6552,0.002004,172.217.194.0-255,2184,160955,96,348611
6553,0.002007,172.31.47.0-255,66,161021,96,348611
6554,0.002012,172.217.194.0-255,4320,165341,96,348611
6555,0.002013,172.31.47.0-255,66,165407,96,348611
6556,0.004002,172.217.194.0-255,5738,171145,96,348611
6557,0.004009,172.31.47.0-255,66,171211,96,348611
6558,0.005997,172.217.194.0-255,4320,175531,96,348611
6559,0.006,172.31.47.0-255,66,175597,96,348611
6560,0.006035,172.217.194.0-255,1484,177081,96,348611
6561,0.007975,172.217.194.0-255,4320,181401,96,348611
6562,0.007982,172.31.47.0-255,66,181467,96,348611
6563,0.009972,172.217.194.0-255,5738,187205,96,348611
6564,0.009979,172.31.47.0-255,66,187271,96,348611
6565,0.011958,172.217.194.0-255,5738,193009,96,348611
6566,0.011966,172.31.47.0-255,66,193075,96,348611
6567,0.013948,172.217.194.0-255,5738,198813,96,348611
6568,0.013953,172.31.47.0-255,66,198879,96,348611
6569,0.015918,172.217.194.0-255,5738,204617,96,348611
6570,0.015924,172.31.47.0-255,66,204683,96,348611
6571,0.017916,172.217.194.0-255,5738,210421,96,348611
6572,0.017926,172.31.47.0-255,66,210487,96,348611
6573,0.019893,172.217.194.0-255,5738,216225,96,348611
6574,0.019905,172.31.47.0-255,66,216291,96,348611
6575,0.021877,172.217.194.0-255,5738,222029,96,348611
6576,0.021884,172.31.47.0-255,66,222095,96,348611
6577,0.02391,172.217.194.0-255,5738,227833,96,348611
6578,0.023917,172.31.47.0-255,66,227899,96,348611
6579,0.025879,172.217.194.0-255,5738,233637,96,348611
6580,0.025886,172.31.47.0-255,66,233703,96,348611
6581,0.027856,172.217.194.0-255,5738,239441,96,348611
6582,0.027862,172.31.47.0-255,66,239507,96,348611
6583,0.029861,172.217.194.0-255,5738,245245,96,348611
6584,0.029866,172.31.47.0-255,66,245311,96,348611
6585,0.030869,172.31.47.0-255,172,245483,96,348611
6586,0.030897,172.31.47.0-255,1109,246592,96,348611
6587,0.030954,172.31.47.0-255,1514,248106,96,348611
6588,0.030956,172.31.47.0-255,1302,249408,96,348611
6589,0.031842,172.217.194.0-255,5738,255146,96,348611
6590,0.031848,172.31.47.0-255,66,255212,96,348611
6591,0.032419,104.244.42.0-255,66,255278,96,348611
6592,0.032447,104.244.42.0-255,66,255344,96,348611
6593,0.032499,104.244.42.0-255,66,255410,96,348611
6594,0.033826,172.217.194.0-255,5738,261148,96,348611
6595,0.033831,172.31.47.0-255,66,261214,96,348611
6596,0.035809,172.217.194.0-255,5738,266952,96,348611
6597,0.035814,172.31.47.0-255,66,267018,96,348611
6598,0.0378,172.217.194.0-255,5738,272756,96,348611
6599,0.037807,172.31.47.0-255,66,272822,96,348611
6600,0.039777,172.217.194.0-255,5738,278560,96,348611
6601,0.039783,172.31.47.0-255,66,278626,96,348611
6602,0.041769,172.217.194.0-255,5738,284364,96,348611
6603,0.041775,172.31.47.0-255,66,284430,96,348611
6604,0.043761,172.217.194.0-255,5738,290168,96,348611
6605,0.043767,172.31.47.0-255,66,290234,96,348611
6606,0.045759,172.217.194.0-255,5738,295972,96,348611
6607,0.045768,172.31.47.0-255,66,296038,96,348611
6608,0.047782,172.217.194.0-255,5738,301776,96,348611
6609,0.047789,172.31.47.0-255,66,301842,96,348611
6610,0.049792,172.217.194.0-255,5738,307580,96,348611
6611,0.049799,172.31.47.0-255,66,307646,96,348611
6612,0.051796,172.217.194.0-255,5738,313384,96,348611
6613,0.051802,172.31.47.0-255,66,313450,96,348611
6614,0.053798,172.217.194.0-255,5738,319188,96,348611
6615,0.053803,172.31.47.0-255,66,319254,96,348611
6616,0.055855,172.217.194.0-255,5738,324992,96,348611
6617,0.055861,172.31.47.0-255,66,325058,96,348611
6618,0.057825,172.217.194.0-255,5738,330796,96,348611
6619,0.057833,172.31.47.0-255,66,330862,96,348611
6620,0.059797,172.217.194.0-255,5738,336600,96,348611
6621,0.059804,172.31.47.0-255,66,336666,96,348611
6622,0.061786,172.217.194.0-255,5738,342404,96,348611
6623,0.061791,172.31.47.0-255,66,342470,96,348611
6624,0.063781,172.217.194.0-255,5738,348208,96,348611
6625,0.063787,172.31.47.0-255,66,348274,96,348611
6626,0.065741,172.217.194.0-255,100,348374,96,348611
6627,0.065776,172.31.47.0-255,66,348440,96,348611
6628,0.065812,172.31.47.0-255,105,348545,96,348611
6629,0.067739,172.217.194.0-255,66,348611,96,348611
6630,0.0,74.125.24.0-255,297,297,96,315009
6631,2.9e-05,172.31.47.0-255,66,363,96,315009
6632,3.6e-05,74.125.24.0-255,1484,1847,96,315009
6633,4e-05,172.31.47.0-255,66,1913,96,315009
6634,4.5e-05,74.125.24.0-255,2902,4815,96,315009
6635,4.8e-05,172.31.47.0-255,66,4881,96,315009
6636,6.5e-05,74.125.24.0-255,1484,6365,96,315009
6637,6.7e-05,172.31.47.0-255,66,6431,96,315009
6638,8.1e-05,74.125.24.0-255,1484,7915,96,315009
6639,8.3e-05,172.31.47.0-255,66,7981,96,315009
6640,0.000105,172.31.47.0-255,66,8047,96,315009
6641,0.000122,74.125.24.0-255,4320,12367,96,315009
6642,0.000125,172.31.47.0-255,66,12433,96,315009
6643,0.000154,74.125.24.0-255,5738,18171,96,315009
6644,0.000156,172.31.47.0-255,66,18237,96,315009
6645,0.000177,172.31.47.0-255,66,18303,96,315009
6646,0.000179,74.125.24.0-255,766,19069,96,315009
6647,0.000182,172.31.47.0-255,66,19135,96,315009
6648,0.000185,74.125.24.0-255,1484,20619,96,315009
6649,0.000187,172.31.47.0-255,66,20685,96,315009
6650,0.000191,74.125.24.0-255,2902,23587,96,315009
6651,0.000193,172.31.47.0-255,66,23653,96,315009
6652,0.000195,74.125.24.0-255,1484,25137,96,315009
6653,0.000198,172.31.47.0-255,66,25203,96,315009
6654,0.000204,74.125.24.0-255,5738,30941,96,315009
6655,0.000208,172.31.47.0-255,66,31007,96,315009
6656,0.000232,74.125.24.0-255,4320,35327,96,315009
6657,0.000236,172.31.47.0-255,66,35393,96,315009
6658,0.000252,74.125.24.0-255,1400,36793,96,315009
6659,0.000255,172.31.47.0-255,66,36859,96,315009
6660,0.000271,74.125.24.0-255,130,36989,96,315009
6661,0.000355,74.125.24.0-255,1484,38473,96,315009
6662,0.000359,172.31.47.0-255,66,38539,96,315009
6663,0.000364,74.125.24.0-255,2902,41441,96,315009
6664,0.000366,172.31.47.0-255,66,41507,96,315009
6665,0.000372,74.125.24.0-255,4320,45827,96,315009
6666,0.000374,172.31.47.0-255,66,45893,96,315009
6667,0.000395,74.125.24.0-255,1484,47377,96,315009
6668,0.000402,74.125.24.0-255,5738,53115,96,315009
6669,0.000405,172.31.47.0-255,66,53181,96,315009
6670,0.00041,74.125.24.0-255,2902,56083,96,315009
6671,0.000411,172.31.47.0-255,66,56149,96,315009
6672,0.000443,172.31.47.0-255,66,56215,96,315009
6673,0.000448,74.125.24.0-255,4220,60435,96,315009
6674,0.00045,172.31.47.0-255,66,60501,96,315009
6675,0.001592,74.125.24.0-255,1484,61985,96,315009
6676,0.001602,74.125.24.0-255,2902,64887,96,315009
6677,0.001606,172.31.47.0-255,66,64953,96,315009
6678,0.001615,74.125.24.0-255,5738,70691,96,315009
6679,0.001617,172.31.47.0-255,66,70757,96,315009
6680,0.001647,74.125.24.0-255,7156,77913,96,315009
6681,0.00165,172.31.47.0-255,66,77979,96,315009
6682,0.001653,74.125.24.0-255,1484,79463,96,315009
6683,0.001667,74.125.24.0-255,4320,83783,96,315009
6684,0.00167,172.31.47.0-255,66,83849,96,315009
6685,0.001692,74.125.24.0-255,2902,86751,96,315009
6686,0.001695,172.31.47.0-255,66,86817,96,315009
6687,0.001705,172.31.47.0-255,66,86883,96,315009
6688,0.001739,74.125.24.0-255,4320,91203,96,315009
6689,0.001742,172.31.47.0-255,66,91269,96,315009
6690,0.001746,74.125.24.0-255,2902,94171,96,315009
6691,0.001749,172.31.47.0-255,66,94237,96,315009
6692,0.001763,74.125.24.0-255,2902,97139,96,315009
6693,0.001765,172.31.47.0-255,66,97205,96,315009
6694,0.001771,74.125.24.0-255,5738,102943,96,315009
6695,0.001773,172.31.47.0-255,66,103009,96,315009
6696,0.001789,74.125.24.0-255,5738,108747,96,315009
6697,0.001792,172.31.47.0-255,66,108813,96,315009
6698,0.001803,172.31.47.0-255,66,108879,96,315009
6699,0.001842,74.125.24.0-255,2184,111063,96,315009
6700,0.001845,172.31.47.0-255,66,111129,96,315009
6701,0.003715,74.125.24.0-255,2902,114031,96,315009
6702,0.003719,172.31.47.0-255,66,114097,96,315009
6703,0.003758,74.125.24.0-255,2902,116999,96,315009
6704,0.00376,172.31.47.0-255,66,117065,96,315009
6705,0.005636,74.125.24.0-255,2902,119967,96,315009
6706,0.005638,172.31.47.0-255,66,120033,96,315009
6707,0.005665,74.125.24.0-255,2902,122935,96,315009
6708,0.005668,172.31.47.0-255,66,123001,96,315009
6709,0.007572,74.125.24.0-255,5738,128739,96,315009
6710,0.007579,172.31.47.0-255,66,128805,96,315009
6711,0.00952,74.125.24.0-255,5738,134543,96,315009
6712,0.009528,172.31.47.0-255,66,134609,96,315009
6713,0.011427,74.125.24.0-255,5738,140347,96,315009
6714,0.011433,172.31.47.0-255,66,140413,96,315009
6715,0.013397,74.125.24.0-255,5738,146151,96,315009
6716,0.013403,172.31.47.0-255,66,146217,96,315009
6717,0.015315,74.125.24.0-255,5738,151955,96,315009
6718,0.015323,172.31.47.0-255,66,152021,96,315009
6719,0.017275,74.125.24.0-255,5738,157759,96,315009
6720,0.017289,172.31.47.0-255,66,157825,96,315009
6721,0.019227,74.125.24.0-255,5738,163563,96,315009
6722,0.019234,172.31.47.0-255,66,163629,96,315009
6723,0.021175,74.125.24.0-255,5738,169367,96,315009
6724,0.021181,172.31.47.0-255,66,169433,96,315009
6725,0.023116,74.125.24.0-255,5738,175171,96,315009
6726,0.023121,172.31.47.0-255,66,175237,96,315009
6727,0.025024,74.125.24.0-255,4320,179557,96,315009
6728,0.02503,172.31.47.0-255,66,179623,96,315009
6729,0.025063,74.125.24.0-255,1484,181107,96,315009
6730,0.025554,172.31.47.0-255,172,181279,96,315009
6731,0.025588,172.31.47.0-255,1109,182388,96,315009
6732,0.025622,172.31.47.0-255,1514,183902,96,315009
6733,0.025624,172.31.47.0-255,1514,185416,96,315009
6734,0.025625,172.31.47.0-255,1514,186930,96,315009
6735,0.025626,172.31.47.0-255,1083,188013,96,315009
6736,0.026949,74.125.24.0-255,4320,192333,96,315009
6737,0.026954,172.31.47.0-255,66,192399,96,315009
6738,0.027085,104.244.42.0-255,66,192465,96,315009
6739,0.027129,104.244.42.0-255,66,192531,96,315009
6740,0.027177,104.244.42.0-255,66,192597,96,315009
6741,0.027181,104.244.42.0-255,66,192663,96,315009
6742,0.028927,74.125.24.0-255,5738,198401,96,315009
6743,0.028934,172.31.47.0-255,66,198467,96,315009
6744,0.03087,74.125.24.0-255,4320,202787,96,315009
6745,0.030874,172.31.47.0-255,66,202853,96,315009
6746,0.030902,74.125.24.0-255,1484,204337,96,315009
6747,0.032808,74.125.24.0-255,4320,208657,96,315009
6748,0.032812,172.31.47.0-255,66,208723,96,315009
6749,0.034736,74.125.24.0-255,4320,213043,96,315009
6750,0.034741,172.31.47.0-255,66,213109,96,315009
6751,0.034767,74.125.24.0-255,1484,214593,96,315009
6752,0.03665,74.125.24.0-255,4320,218913,96,315009
6753,0.036654,172.31.47.0-255,66,218979,96,315009
6754,0.038603,74.125.24.0-255,5738,224717,96,315009
6755,0.038608,172.31.47.0-255,66,224783,96,315009
6756,0.040523,74.125.24.0-255,4320,229103,96,315009
6757,0.040528,172.31.47.0-255,66,229169,96,315009
6758,0.040556,74.125.24.0-255,1484,230653,96,315009
6759,0.042453,74.125.24.0-255,4320,234973,96,315009
6760,0.042457,172.31.47.0-255,66,235039,96,315009
6761,0.044397,74.125.24.0-255,4320,239359,96,315009
6762,0.044401,172.31.47.0-255,66,239425,96,315009
6763,0.044429,74.125.24.0-255,1484,240909,96,315009
6764,0.046337,74.125.24.0-255,4320,245229,96,315009
6765,0.046341,172.31.47.0-255,66,245295,96,315009
6766,0.048275,74.125.24.0-255,5738,251033,96,315009
6767,0.04828,172.31.47.0-255,66,251099,96,315009
6768,0.050204,74.125.24.0-255,5738,256837,96,315009
6769,0.050211,172.31.47.0-255,66,256903,96,315009
6770,0.052154,74.125.24.0-255,5738,262641,96,315009
6771,0.05216,172.31.47.0-255,66,262707,96,315009
6772,0.054108,74.125.24.0-255,5738,268445,96,315009
6773,0.054112,172.31.47.0-255,66,268511,96,315009
6774,0.056019,74.125.24.0-255,1484,269995,96,315009
6775,0.056046,74.125.24.0-255,4320,274315,96,315009
6776,0.05605,172.31.47.0-255,66,274381,96,315009
6777,0.057953,74.125.24.0-255,5738,280119,96,315009
6778,0.057958,172.31.47.0-255,66,280185,96,315009
6779,0.059889,74.125.24.0-255,5738,285923,96,315009
6780,0.059894,172.31.47.0-255,66,285989,96,315009
6781,0.061818,74.125.24.0-255,5738,291727,96,315009
6782,0.061824,172.31.47.0-255,66,291793,96,315009
6783,0.06377,74.125.24.0-255,5738,297531,96,315009
6784,0.063776,172.31.47.0-255,66,297597,96,315009
6785,0.065706,74.125.24.0-255,5738,303335,96,315009
6786,0.065711,172.31.47.0-255,66,303401,96,315009
6787,0.067647,74.125.24.0-255,5738,309139,96,315009
6788,0.067654,172.31.47.0-255,66,309205,96,315009
6789,0.069566,74.125.24.0-255,5738,314943,96,315009
6790,0.069572,172.31.47.0-255,66,315009,96,315009
6791,0.0,172.31.47.0-255,105,105,96,276
6792,0.001507,157.240.13.0-255,105,210,96,276
6793,0.001521,172.31.47.0-255,66,276,96,276
6794,0.0,74.125.68.0-255,153,153,96,376187
6795,3.1e-05,172.31.47.0-255,66,219,96,376187
6796,3.7e-05,74.125.68.0-255,1484,1703,96,376187
6797,4.1e-05,172.31.47.0-255,66,1769,96,376187
6798,4.5e-05,74.125.68.0-255,2902,4671,96,376187
6799,4.8e-05,172.31.47.0-255,66,4737,96,376187
6800,5e-05,74.125.68.0-255,1484,6221,96,376187
6801,5.2e-05,172.31.47.0-255,66,6287,96,376187
6802,6.9e-05,74.125.68.0-255,1484,7771,96,376187
6803,7.1e-05,172.31.47.0-255,66,7837,96,376187
6804,9e-05,74.125.68.0-255,1484,9321,96,376187
6805,9.2e-05,172.31.47.0-255,66,9387,96,376187
6806,0.000109,74.125.68.0-255,4899,14286,96,376187
6807,0.000111,172.31.47.0-255,66,14352,96,376187
6808,0.000152,74.125.68.0-255,2902,17254,96,376187
6809,0.000155,172.31.47.0-255,66,17320,96,376187
6810,0.000172,74.125.68.0-255,2902,20222,96,376187
6811,0.000174,172.31.47.0-255,66,20288,96,376187
6812,0.000177,74.125.68.0-255,1484,21772,96,376187
6813,0.000178,172.31.47.0-255,66,21838,96,376187
6814,0.000196,74.125.68.0-255,5738,27576,96,376187
6815,0.000198,172.31.47.0-255,66,27642,96,376187
6816,0.000203,74.125.68.0-255,3961,31603,96,376187
6817,0.000204,172.31.47.0-255,66,31669,96,376187
6818,0.000297,74.125.68.0-255,1484,33153,96,376187
6819,0.000301,172.31.47.0-255,66,33219,96,376187
6820,0.000326,74.125.68.0-255,2902,36121,96,376187
6821,0.000329,172.31.47.0-255,66,36187,96,376187
6822,0.000347,74.125.68.0-255,1484,37671,96,376187
6823,0.000349,172.31.47.0-255,66,37737,96,376187
6824,0.000363,74.125.68.0-255,2902,40639,96,376187
6825,0.000366,172.31.47.0-255,66,40705,96,376187
6826,0.000369,74.125.68.0-255,1484,42189,96,376187
6827,0.000389,74.125.68.0-255,4320,46509,96,376187
6828,0.000393,172.31.47.0-255,66,46575,96,376187
6829,0.000407,74.125.68.0-255,2543,49118,96,376187
6830,0.000409,172.31.47.0-255,66,49184,96,376187
6831,0.000591,74.125.68.0-255,1484,50668,96,376187
6832,0.000614,74.125.68.0-255,1484,52152,96,376187
6833,0.000617,172.31.47.0-255,66,52218,96,376187
6834,0.000657,74.125.68.0-255,2902,55120,96,376187
6835,0.00066,172.31.47.0-255,66,55186,96,376187
6836,0.000665,74.125.68.0-255,1484,56670,96,376187
6837,0.000668,74.125.68.0-255,1484,58154,96,376187
6838,0.000669,172.31.47.0-255,66,58220,96,376187
6839,0.000685,74.125.68.0-255,1484,59704,96,376187
6840,0.000689,74.125.68.0-255,2902,62606,96,376187
6841,0.000691,172.31.47.0-255,66,62672,96,376187
6842,0.000712,74.125.68.0-255,2902,65574,96,376187
6843,0.000714,172.31.47.0-255,66,65640,96,376187
6844,0.000716,74.125.68.0-255,1125,66765,96,376187
6845,0.000764,74.125.68.0-255,1484,68249,96,376187
6846,0.000768,172.31.47.0-255,66,68315,96,376187
6847,0.000771,74.125.68.0-255,1484,69799,96,376187
6848,0.000786,74.125.68.0-255,1484,71283,96,376187
6849,0.000788,172.31.47.0-255,66,71349,96,376187
6850,0.00081,74.125.68.0-255,5738,77087,96,376187
6851,0.000813,172.31.47.0-255,66,77153,96,376187
6852,0.000817,74.125.68.0-255,2902,80055,96,376187
6853,0.000818,172.31.47.0-255,66,80121,96,376187
6854,0.000823,74.125.68.0-255,2902,83023,96,376187
6855,0.000824,172.31.47.0-255,66,83089,96,376187
6856,0.00084,74.125.68.0-255,1125,84214,96,376187
6857,0.000864,74.125.68.0-255,1484,85698,96,376187
6858,0.000867,172.31.47.0-255,66,85764,96,376187
6859,0.000885,74.125.68.0-255,7156,92920,96,376187
6860,0.000888,172.31.47.0-255,66,92986,96,376187
6861,0.000948,74.125.68.0-255,2902,95888,96,376187
6862,0.000951,172.31.47.0-255,66,95954,96,376187
6863,0.00097,74.125.68.0-255,5379,101333,96,376187
6864,0.000972,172.31.47.0-255,66,101399,96,376187
6865,0.001146,74.125.68.0-255,1484,102883,96,376187
6866,0.001161,74.125.68.0-255,2902,105785,96,376187
6867,0.001165,172.31.47.0-255,66,105851,96,376187
6868,0.001198,74.125.68.0-255,1484,107335,96,376187
6869,0.001214,74.125.68.0-255,1484,108819,96,376187
6870,0.001215,172.31.47.0-255,66,108885,96,376187
6871,0.00122,74.125.68.0-255,4320,113205,96,376187
6872,0.001222,172.31.47.0-255,66,113271,96,376187
6873,0.00125,74.125.68.0-255,1484,114755,96,376187
6874,0.001264,74.125.68.0-255,5738,120493,96,376187
6875,0.001266,172.31.47.0-255,66,120559,96,376187
6876,0.001282,74.125.68.0-255,1484,122043,96,376187
6877,0.001286,74.125.68.0-255,4320,126363,96,376187
6878,0.001288,172.31.47.0-255,66,126429,96,376187
6879,0.00129,74.125.68.0-255,1484,127913,96,376187
6880,0.00132,74.125.68.0-255,1484,129397,96,376187
6881,0.001323,172.31.47.0-255,66,129463,96,376187
6882,0.001325,74.125.68.0-255,1484,130947,96,376187
6883,0.001338,74.125.68.0-255,1484,132431,96,376187
6884,0.00134,172.31.47.0-255,66,132497,96,376187
6885,0.001403,74.125.68.0-255,1484,133981,96,376187
6886,0.001422,74.125.68.0-255,1484,135465,96,376187
6887,0.001423,172.31.47.0-255,66,135531,96,376187
6888,0.001496,74.125.68.0-255,766,136297,96,376187
6889,0.001814,74.125.68.0-255,1484,137781,96,376187
6890,0.001817,172.31.47.0-255,66,137847,96,376187
6891,0.001833,74.125.68.0-255,2902,140749,96,376187
6892,0.001835,172.31.47.0-255,66,140815,96,376187
6893,0.001861,74.125.68.0-255,4320,145135,96,376187
6894,0.001863,172.31.47.0-255,66,145201,96,376187
6895,0.001874,74.125.68.0-255,1484,146685,96,376187
6896,0.001888,74.125.68.0-255,4320,151005,96,376187
6897,0.001891,172.31.47.0-255,66,151071,96,376187
6898,0.001911,74.125.68.0-255,1484,152555,96,376187
6899,0.001917,74.125.68.0-255,7156,159711,96,376187
6900,0.00192,172.31.47.0-255,66,159777,96,376187
6901,0.001932,74.125.68.0-255,1484,161261,96,376187
6902,0.001949,74.125.68.0-255,7156,168417,96,376187
6903,0.001952,172.31.47.0-255,66,168483,96,376187
6904,0.001974,74.125.68.0-255,2184,170667,96,376187
6905,0.001976,172.31.47.0-255,66,170733,96,376187
6906,0.00199,74.125.68.0-255,4320,175053,96,376187
6907,0.001992,172.31.47.0-255,66,175119,96,376187
6908,0.002015,74.125.68.0-255,1484,176603,96,376187
6909,0.002022,74.125.68.0-255,7156,183759,96,376187
6910,0.002024,172.31.47.0-255,66,183825,96,376187
6911,0.002055,172.31.47.0-255,66,183891,96,376187
6912,0.002109,74.125.68.0-255,6438,190329,96,376187
6913,0.002112,172.31.47.0-255,66,190395,96,376187
6914,0.004156,74.125.68.0-255,2902,193297,96,376187
6915,0.004159,172.31.47.0-255,66,193363,96,376187
6916,0.004176,74.125.68.0-255,2902,196265,96,376187
6917,0.004178,172.31.47.0-255,66,196331,96,376187
6918,0.006205,74.125.68.0-255,4320,200651,96,376187
6919,0.006212,172.31.47.0-255,66,200717,96,376187
6920,0.00623,74.125.68.0-255,1484,202201,96,376187
6921,0.008271,74.125.68.0-255,4320,206521,96,376187
6922,0.008277,172.31.47.0-255,66,206587,96,376187
6923,0.010355,74.125.68.0-255,5738,212325,96,376187
6924,0.010364,172.31.47.0-255,66,212391,96,376187
6925,0.012395,74.125.68.0-255,4320,216711,96,376187
6926,0.012401,172.31.47.0-255,66,216777,96,376187
6927,0.012415,74.125.68.0-255,1484,218261,96,376187
6928,0.014444,74.125.68.0-255,4320,222581,96,376187
6929,0.014452,172.31.47.0-255,66,222647,96,376187
6930,0.016501,74.125.68.0-255,4320,226967,96,376187
6931,0.016508,172.31.47.0-255,66,227033,96,376187
6932,0.016536,74.125.68.0-255,1484,228517,96,376187
6933,0.018566,74.125.68.0-255,4320,232837,96,376187
6934,0.018572,172.31.47.0-255,66,232903,96,376187
6935,0.020623,74.125.68.0-255,5738,238641,96,376187
6936,0.02063,172.31.47.0-255,66,238707,96,376187
6937,0.022116,172.31.47.0-255,172,238879,96,376187
6938,0.022145,172.31.47.0-255,1105,239984,96,376187
6939,0.022182,172.31.47.0-255,1514,241498,96,376187
6940,0.022184,172.31.47.0-255,339,241837,96,376187
6941,0.022673,74.125.68.0-255,5738,247575,96,376187
6942,0.022679,172.31.47.0-255,66,247641,96,376187
6943,0.023651,104.244.42.0-255,66,247707,96,376187
6944,0.023704,104.244.42.0-255,66,247773,96,376187
6945,0.023748,104.244.42.0-255,66,247839,96,376187
6946,0.024736,74.125.68.0-255,5738,253577,96,376187
6947,0.02474,172.31.47.0-255,66,253643,96,376187
6948,0.026784,74.125.68.0-255,2902,256545,96,376187
6949,0.026789,172.31.47.0-255,66,256611,96,376187
6950,0.026804,74.125.68.0-255,2902,259513,96,376187
6951,0.026807,172.31.47.0-255,66,259579,96,376187
6952,0.02883,74.125.68.0-255,2902,262481,96,376187
6953,0.028832,172.31.47.0-255,66,262547,96,376187
6954,0.028847,74.125.68.0-255,2902,265449,96,376187
6955,0.028849,172.31.47.0-255,66,265515,96,376187
6956,0.030883,74.125.68.0-255,5738,271253,96,376187
6957,0.030889,172.31.47.0-255,66,271319,96,376187
6958,0.032955,74.125.68.0-255,5738,277057,96,376187
6959,0.032961,172.31.47.0-255,66,277123,96,376187
6960,0.035001,74.125.68.0-255,2902,280025,96,376187
6961,0.035005,172.31.47.0-255,66,280091,96,376187
6962,0.035032,74.125.68.0-255,2902,282993,96,376187
6963,0.035035,172.31.47.0-255,66,283059,96,376187
6964,0.037045,74.125.68.0-255,2902,285961,96,376187
6965,0.037051,172.31.47.0-255,66,286027,96,376187
6966,0.037082,74.125.68.0-255,2902,288929,96,376187
6967,0.037085,172.31.47.0-255,66,288995,96,376187
6968,0.039117,74.125.68.0-255,2902,291897,96,376187
6969,0.039132,172.31.47.0-255,66,291963,96,376187
6970,0.039155,74.125.68.0-255,2902,294865,96,376187
6971,0.039158,172.31.47.0-255,66,294931,96,376187
6972,0.041187,74.125.68.0-255,5738,300669,96,376187
6973,0.041199,172.31.47.0-255,66,300735,96,376187
6974,0.043277,74.125.68.0-255,5738,306473,96,376187
6975,0.043292,172.31.47.0-255,66,306539,96,376187
6976,0.045351,74.125.68.0-255,5738,312277,96,376187
6977,0.045369,172.31.47.0-255,66,312343,96,376187
6978,0.047448,74.125.68.0-255,5738,318081,96,376187
6979,0.047461,172.31.47.0-255,66,318147,96,376187
6980,0.049531,74.125.68.0-255,5738,323885,96,376187
6981,0.049551,172.31.47.0-255,66,323951,96,376187
6982,0.051613,74.125.68.0-255,5738,329689,96,376187
6983,0.051627,172.31.47.0-255,66,329755,96,376187
6984,0.053695,74.125.68.0-255,5738,335493,96,376187
6985,0.053712,172.31.47.0-255,66,335559,96,376187
6986,0.055779,74.125.68.0-255,5738,341297,96,376187
6987,0.055794,172.31.47.0-255,66,341363,96,376187
6988,0.057857,74.125.68.0-255,5738,347101,96,376187
6989,0.057871,172.31.47.0-255,66,347167,96,376187
6990,0.059943,74.125.68.0-255,5738,352905,96,376187
6991,0.05996,172.31.47.0-255,66,352971,96,376187
6992,0.062021,74.125.68.0-255,5738,358709,96,376187
6993,0.06204,172.31.47.0-255,66,358775,96,376187
6994,0.064106,74.125.68.0-255,5738,364513,96,376187
6995,0.064125,172.31.47.0-255,66,364579,96,376187
6996,0.066259,74.125.68.0-255,5738,370317,96,376187
6997,0.066274,172.31.47.0-255,66,370383,96,376187
6998,0.068344,74.125.68.0-255,5738,376121,96,376187
6999,0.068361,172.31.47.0-255,66,376187,96,376187
7000,0.0,74.125.68.0-255,153,153,96,281377
7001,1.7e-05,172.31.47.0-255,66,219,96,281377
7002,2.3e-05,74.125.68.0-255,1484,1703,96,281377
7003,2.7e-05,172.31.47.0-255,66,1769,96,281377
7004,4.9e-05,74.125.68.0-255,2902,4671,96,281377
7005,5.2e-05,172.31.47.0-255,66,4737,96,281377
7006,5.9e-05,74.125.68.0-255,4320,9057,96,281377
7007,6.1e-05,172.31.47.0-255,66,9123,96,281377
7008,8.9e-05,74.125.68.0-255,1484,10607,96,281377
7009,9.1e-05,172.31.47.0-255,66,10673,96,281377
7010,9.6e-05,74.125.68.0-255,3403,14076,96,281377
7011,9.8e-05,172.31.47.0-255,66,14142,96,281377
7012,0.000178,74.125.68.0-255,1484,15626,96,281377
7013,0.000181,172.31.47.0-255,66,15692,96,281377
7014,0.000184,74.125.68.0-255,1484,17176,96,281377
7015,0.000186,172.31.47.0-255,66,17242,96,281377
7016,0.000199,74.125.68.0-255,1484,18726,96,281377
7017,0.0002,172.31.47.0-255,66,18792,96,281377
7018,0.000229,74.125.68.0-255,2902,21694,96,281377
7019,0.000231,172.31.47.0-255,66,21760,96,281377
7020,0.000267,74.125.68.0-255,1484,23244,96,281377
7021,0.000269,172.31.47.0-255,66,23310,96,281377
7022,0.000287,74.125.68.0-255,2902,26212,96,281377
7023,0.000289,172.31.47.0-255,66,26278,96,281377
7024,0.000293,74.125.68.0-255,2902,29180,96,281377
7025,0.000295,172.31.47.0-255,66,29246,96,281377
7026,0.000325,74.125.68.0-255,2543,31789,96,281377
7027,0.000327,172.31.47.0-255,66,31855,96,281377
7028,0.000399,74.125.68.0-255,1484,33339,96,281377
7029,0.000402,172.31.47.0-255,66,33405,96,281377
7030,0.000423,74.125.68.0-255,2902,36307,96,281377
7031,0.000425,172.31.47.0-255,66,36373,96,281377
7032,0.000429,74.125.68.0-255,2902,39275,96,281377
7033,0.000432,172.31.47.0-255,66,39341,96,281377
7034,0.000479,74.125.68.0-255,4320,43661,96,281377
7035,0.000483,172.31.47.0-255,66,43727,96,281377
7036,0.000486,74.125.68.0-255,1484,45211,96,281377
7037,0.000488,74.125.68.0-255,1484,46695,96,281377
7038,0.00049,172.31.47.0-255,66,46761,96,281377
7039,0.000501,74.125.68.0-255,1484,48245,96,281377
7040,0.000515,74.125.68.0-255,2902,51147,96,281377
7041,0.000517,172.31.47.0-255,66,51213,96,281377
7042,0.000537,74.125.68.0-255,3961,55174,96,281377
7043,0.00054,172.31.47.0-255,66,55240,96,281377
7044,0.000543,74.125.68.0-255,2902,58142,96,281377
7045,0.000545,172.31.47.0-255,66,58208,96,281377
7046,0.000587,74.125.68.0-255,1484,59692,96,281377
7047,0.000607,74.125.68.0-255,7106,66798,96,281377
7048,0.00061,172.31.47.0-255,66,66864,96,281377
7049,0.000914,74.125.68.0-255,111,66975,96,281377
7050,0.000944,74.125.68.0-255,332,67307,96,281377
7051,0.001023,172.31.47.0-255,66,67373,96,281377
7052,0.001534,74.125.68.0-255,1484,68857,96,281377
7053,0.001544,74.125.68.0-255,2902,71759,96,281377
7054,0.001547,172.31.47.0-255,66,71825,96,281377
7055,0.001567,74.125.68.0-255,4320,76145,96,281377
7056,0.00157,172.31.47.0-255,66,76211,96,281377
7057,0.001595,172.31.47.0-255,66,76277,96,281377
7058,0.0016,74.125.68.0-255,4320,80597,96,281377
7059,0.001602,172.31.47.0-255,66,80663,96,281377
7060,0.001652,74.125.68.0-255,4320,84983,96,281377
7061,0.001655,172.31.47.0-255,66,85049,96,281377
7062,0.001683,172.31.47.0-255,66,85115,96,281377
7063,0.003626,74.125.68.0-255,5738,90853,96,281377
7064,0.003632,172.31.47.0-255,66,90919,96,281377
7065,0.00558,74.125.68.0-255,4320,95239,96,281377
7066,0.005583,172.31.47.0-255,66,95305,96,281377
7067,0.005599,74.125.68.0-255,1484,96789,96,281377
7068,0.00754,74.125.68.0-255,4320,101109,96,281377
7069,0.007547,172.31.47.0-255,66,101175,96,281377
7070,0.00952,74.125.68.0-255,5738,106913,96,281377
7071,0.009531,172.31.47.0-255,66,106979,96,281377
7072,0.011535,74.125.68.0-255,5738,112717,96,281377
7073,0.011545,172.31.47.0-255,66,112783,96,281377
7074,0.013524,74.125.68.0-255,5738,118521,96,281377
7075,0.013536,172.31.47.0-255,66,118587,96,281377
7076,0.015487,74.125.68.0-255,5738,124325,96,281377
7077,0.015495,172.31.47.0-255,66,124391,96,281377
7078,0.01746,74.125.68.0-255,5738,130129,96,281377
7079,0.017467,172.31.47.0-255,66,130195,96,281377
7080,0.019478,74.125.68.0-255,5738,135933,96,281377
7081,0.019486,172.31.47.0-255,66,135999,96,281377
7082,0.021438,74.125.68.0-255,5738,141737,96,281377
7083,0.021444,172.31.47.0-255,66,141803,96,281377
7084,0.022155,172.31.47.0-255,172,141975,96,281377
7085,0.022181,172.31.47.0-255,1110,143085,96,281377
7086,0.022238,172.31.47.0-255,1514,144599,96,281377
7087,0.02224,172.31.47.0-255,1301,145900,96,281377
7088,0.023392,74.125.68.0-255,5738,151638,96,281377
7089,0.023399,172.31.47.0-255,66,151704,96,281377
7090,0.023694,104.244.42.0-255,66,151770,96,281377
7091,0.023732,104.244.42.0-255,66,151836,96,281377
7092,0.023781,104.244.42.0-255,66,151902,96,281377
7093,0.025348,74.125.68.0-255,5738,157640,96,281377
7094,0.025354,172.31.47.0-255,66,157706,96,281377
7095,0.027303,74.125.68.0-255,5738,163444,96,281377
7096,0.027309,172.31.47.0-255,66,163510,96,281377
7097,0.029274,74.125.68.0-255,5738,169248,96,281377
7098,0.02928,172.31.47.0-255,66,169314,96,281377
7099,0.031232,74.125.68.0-255,4320,173634,96,281377
7100,0.031237,172.31.47.0-255,66,173700,96,281377
7101,0.031253,74.125.68.0-255,1484,175184,96,281377
7102,0.033184,74.125.68.0-255,4320,179504,96,281377
7103,0.03319,172.31.47.0-255,66,179570,96,281377
7104,0.035153,74.125.68.0-255,5738,185308,96,281377
7105,0.03516,172.31.47.0-255,66,185374,96,281377
7106,0.037119,74.125.68.0-255,5738,191112,96,281377
7107,0.037126,172.31.47.0-255,66,191178,96,281377
7108,0.03919,74.125.68.0-255,5738,196916,96,281377
7109,0.039197,172.31.47.0-255,66,196982,96,281377
7110,0.041183,74.125.68.0-255,5738,202720,96,281377
7111,0.04119,172.31.47.0-255,66,202786,96,281377
7112,0.043155,74.125.68.0-255,5738,208524,96,281377
7113,0.043161,172.31.47.0-255,66,208590,96,281377
7114,0.045117,74.125.68.0-255,5738,214328,96,281377
7115,0.045123,172.31.47.0-255,66,214394,96,281377
7116,0.047114,74.125.68.0-255,5738,220132,96,281377
7117,0.047118,172.31.47.0-255,66,220198,96,281377
7118,0.04907,74.125.68.0-255,5738,225936,96,281377
7119,0.049077,172.31.47.0-255,66,226002,96,281377
7120,0.051038,74.125.68.0-255,5738,231740,96,281377
7121,0.051056,172.31.47.0-255,66,231806,96,281377
7122,0.053017,74.125.68.0-255,5738,237544,96,281377
7123,0.053023,172.31.47.0-255,66,237610,96,281377
7124,0.054986,74.125.68.0-255,5738,243348,96,281377
7125,0.054993,172.31.47.0-255,66,243414,96,281377
7126,0.056954,74.125.68.0-255,5738,249152,96,281377
7127,0.05696,172.31.47.0-255,66,249218,96,281377
7128,0.058307,172.31.47.0-255,105,249323,96,281377
7129,0.05891,74.125.68.0-255,5738,255061,96,281377
7130,0.058915,172.31.47.0-255,66,255127,96,281377
7131,0.060897,74.125.68.0-255,5738,260865,96,281377
7132,0.060903,172.31.47.0-255,66,260931,96,281377
7133,0.062875,74.125.68.0-255,5738,266669,96,281377
7134,0.062882,172.31.47.0-255,66,266735,96,281377
7135,0.06485,74.125.68.0-255,5738,272473,96,281377
7136,0.064856,172.31.47.0-255,66,272539,96,281377
7137,0.066807,74.125.68.0-255,4320,276859,96,281377
7138,0.066813,172.31.47.0-255,66,276925,96,281377
7139,0.066831,74.125.68.0-255,1484,278409,96,281377
7140,0.068766,74.125.68.0-255,2902,281311,96,281377
7141,0.068772,172.31.47.0-255,66,281377,96,281377
7142,0.0,74.125.24.0-255,152,152,96,300997
7143,2.1e-05,172.31.47.0-255,66,218,96,300997
7144,2.7e-05,74.125.24.0-255,1484,1702,96,300997
7145,3.1e-05,172.31.47.0-255,66,1768,96,300997
7146,3.7e-05,74.125.24.0-255,2902,4670,96,300997
7147,4e-05,172.31.47.0-255,66,4736,96,300997
7148,4.5e-05,74.125.24.0-255,4320,9056,96,300997
7149,4.8e-05,172.31.47.0-255,66,9122,96,300997
7150,7.3e-05,74.125.24.0-255,7156,16278,96,300997
7151,7.6e-05,172.31.47.0-255,66,16344,96,300997
7152,0.0001,74.125.24.0-255,4918,21262,96,300997
7153,0.000103,172.31.47.0-255,66,21328,96,300997
7154,0.000114,172.31.47.0-255,66,21394,96,300997
7155,0.000129,74.125.24.0-255,1484,22878,96,300997
7156,0.000131,172.31.47.0-255,66,22944,96,300997
7157,0.000135,74.125.24.0-255,2902,25846,96,300997
7158,0.000137,172.31.47.0-255,66,25912,96,300997
7159,0.000164,74.125.24.0-255,5738,31650,96,300997
7160,0.000166,172.31.47.0-255,66,31716,96,300997
7161,0.000182,74.125.24.0-255,4320,36036,96,300997
7162,0.000184,172.31.47.0-255,66,36102,96,300997
7163,0.000204,74.125.24.0-255,2543,38645,96,300997
7164,0.000206,172.31.47.0-255,66,38711,96,300997
7165,0.000222,74.125.24.0-255,4320,43031,96,300997
7166,0.000224,172.31.47.0-255,66,43097,96,300997
7167,0.000239,74.125.24.0-255,2902,45999,96,300997
7168,0.000241,172.31.47.0-255,66,46065,96,300997
7169,0.000247,74.125.24.0-255,5738,51803,96,300997
7170,0.000249,172.31.47.0-255,66,51869,96,300997
7171,0.000282,74.125.24.0-255,3961,55830,96,300997
7172,0.000285,172.31.47.0-255,66,55896,96,300997
7173,0.000715,74.125.24.0-255,646,56542,96,300997
7174,0.000862,172.31.47.0-255,66,56608,96,300997
7175,0.00097,74.125.24.0-255,1484,58092,96,300997
7176,0.000979,74.125.24.0-255,2902,60994,96,300997
7177,0.000982,172.31.47.0-255,66,61060,96,300997
7178,0.00099,74.125.24.0-255,5738,66798,96,300997
7179,0.000993,172.31.47.0-255,66,66864,96,300997
7180,0.000998,74.125.24.0-255,4320,71184,96,300997
7181,0.001,172.31.47.0-255,66,71250,96,300997
7182,0.001054,172.31.47.0-255,66,71316,96,300997
7183,0.001064,172.31.47.0-255,66,71382,96,300997
7184,0.001371,74.125.24.0-255,1484,72866,96,300997
7185,0.001379,74.125.24.0-255,2902,75768,96,300997
7186,0.001384,172.31.47.0-255,66,75834,96,300997
7187,0.001392,74.125.24.0-255,5738,81572,96,300997
7188,0.001394,172.31.47.0-255,66,81638,96,300997
7189,0.001399,74.125.24.0-255,2902,84540,96,300997
7190,0.001402,172.31.47.0-255,66,84606,96,300997
7191,0.001438,172.31.47.0-255,66,84672,96,300997
7192,0.001454,74.125.24.0-255,4320,88992,96,300997
7193,0.001456,172.31.47.0-255,66,89058,96,300997
7194,0.001476,74.125.24.0-255,6438,95496,96,300997
7195,0.001479,172.31.47.0-255,66,95562,96,300997
7196,0.00153,74.125.24.0-255,1484,97046,96,300997
7197,0.001536,74.125.24.0-255,2902,99948,96,300997
7198,0.00154,172.31.47.0-255,66,100014,96,300997
7199,0.001565,74.125.24.0-255,2902,102916,96,300997
7200,0.001568,172.31.47.0-255,66,102982,96,300997
7201,0.001588,74.125.24.0-255,2902,105884,96,300997
7202,0.00159,172.31.47.0-255,66,105950,96,300997
7203,0.001605,172.31.47.0-255,66,106016,96,300997
7204,0.001608,74.125.24.0-255,1484,107500,96,300997
7205,0.001631,172.31.47.0-255,66,107566,96,300997
7206,0.001832,74.125.24.0-255,1484,109050,96,300997
7207,0.001839,74.125.24.0-255,2902,111952,96,300997
7208,0.001844,172.31.47.0-255,66,112018,96,300997
7209,0.001852,74.125.24.0-255,5738,117756,96,300997
7210,0.001854,172.31.47.0-255,66,117822,96,300997
7211,0.001859,74.125.24.0-255,2902,120724,96,300997
7212,0.001861,172.31.47.0-255,66,120790,96,300997
7213,0.001883,74.125.24.0-255,2902,123692,96,300997
7214,0.001885,172.31.47.0-255,66,123758,96,300997
7215,0.001899,172.31.47.0-255,66,123824,96,300997
7216,0.001904,74.125.24.0-255,2902,126726,96,300997
7217,0.001906,172.31.47.0-255,66,126792,96,300997
7218,0.001927,74.125.24.0-255,2184,128976,96,300997
7219,0.001929,172.31.47.0-255,66,129042,96,300997
7220,0.002085,74.125.24.0-255,1484,130526,96,300997
7221,0.002089,74.125.24.0-255,2902,133428,96,300997
7222,0.002091,172.31.47.0-255,66,133494,96,300997
7223,0.002112,74.125.24.0-255,5738,139232,96,300997
7224,0.002114,172.31.47.0-255,66,139298,96,300997
7225,0.002119,74.125.24.0-255,5738,145036,96,300997
7226,0.002121,172.31.47.0-255,66,145102,96,300997
7227,0.002123,74.125.24.0-255,1484,146586,96,300997
7228,0.002146,74.125.24.0-255,5738,152324,96,300997
7229,0.002148,172.31.47.0-255,66,152390,96,300997
7230,0.002162,74.125.24.0-255,4320,156710,96,300997
7231,0.002164,172.31.47.0-255,66,156776,96,300997
7232,0.002191,172.31.47.0-255,66,156842,96,300997
7233,0.0022,172.31.47.0-255,66,156908,96,300997
7234,0.002243,74.125.24.0-255,4320,161228,96,300997
7235,0.002245,172.31.47.0-255,66,161294,96,300997
7236,0.002276,172.31.47.0-255,66,161360,96,300997
7237,0.002279,74.125.24.0-255,1484,162844,96,300997
7238,0.002283,74.125.24.0-255,2902,165746,96,300997
7239,0.002285,172.31.47.0-255,66,165812,96,300997
7240,0.002339,74.125.24.0-255,5738,171550,96,300997
7241,0.002341,172.31.47.0-255,66,171616,96,300997
7242,0.002353,172.31.47.0-255,66,171682,96,300997
7243,0.004679,74.125.24.0-255,5738,177420,96,300997
7244,0.004684,172.31.47.0-255,66,177486,96,300997
7245,0.007011,74.125.24.0-255,5738,183224,96,300997
7246,0.007016,172.31.47.0-255,66,183290,96,300997
7247,0.009318,74.125.24.0-255,5738,189028,96,300997
7248,0.009324,172.31.47.0-255,66,189094,96,300997
7249,0.011651,74.125.24.0-255,5738,194832,96,300997
7250,0.011661,172.31.47.0-255,66,194898,96,300997
7251,0.013995,74.125.24.0-255,5738,200636,96,300997
7252,0.014008,172.31.47.0-255,66,200702,96,300997
7253,0.016388,74.125.24.0-255,5738,206440,96,300997
7254,0.016397,172.31.47.0-255,66,206506,96,300997
7255,0.018728,74.125.24.0-255,5738,212244,96,300997
7256,0.018735,172.31.47.0-255,66,212310,96,300997
7257,0.021061,74.125.24.0-255,5738,218048,96,300997
7258,0.021068,172.31.47.0-255,66,218114,96,300997
7259,0.023363,74.125.24.0-255,5738,223852,96,300997
7260,0.023371,172.31.47.0-255,66,223918,96,300997
7261,0.02569,74.125.24.0-255,5738,229656,96,300997
7262,0.025696,172.31.47.0-255,66,229722,96,300997
7263,0.025851,172.31.47.0-255,172,229894,96,300997
7264,0.025876,172.31.47.0-255,1110,231004,96,300997
7265,0.025969,172.31.47.0-255,1514,232518,96,300997
7266,0.02597,172.31.47.0-255,1302,233820,96,300997
7267,0.027399,104.244.42.0-255,66,233886,96,300997
7268,0.027446,104.244.42.0-255,66,233952,96,300997
7269,0.027537,104.244.42.0-255,66,234018,96,300997
7270,0.028012,74.125.24.0-255,5738,239756,96,300997
7271,0.028017,172.31.47.0-255,66,239822,96,300997
7272,0.030334,74.125.24.0-255,5738,245560,96,300997
7273,0.03034,172.31.47.0-255,66,245626,96,300997
7274,0.032662,74.125.24.0-255,5738,251364,96,300997
7275,0.032668,172.31.47.0-255,66,251430,96,300997
7276,0.035018,74.125.24.0-255,5738,257168,96,300997
7277,0.035025,172.31.47.0-255,66,257234,96,300997
7278,0.037348,74.125.24.0-255,5738,262972,96,300997
7279,0.037353,172.31.47.0-255,66,263038,96,300997
7280,0.039661,74.125.24.0-255,5738,268776,96,300997
7281,0.039666,172.31.47.0-255,66,268842,96,300997
7282,0.042008,74.125.24.0-255,5738,274580,96,300997
7283,0.042017,172.31.47.0-255,66,274646,96,300997
7284,0.04433,74.125.24.0-255,5738,280384,96,300997
7285,0.044336,172.31.47.0-255,66,280450,96,300997
7286,0.046662,74.125.24.0-255,5738,286188,96,300997
7287,0.046668,172.31.47.0-255,66,286254,96,300997
7288,0.04898,74.125.24.0-255,5738,291992,96,300997
7289,0.048987,172.31.47.0-255,66,292058,96,300997
7290,0.051323,74.125.24.0-255,5738,297796,96,300997
7291,0.051329,172.31.47.0-255,66,297862,96,300997
7292,0.053633,74.125.24.0-255,2898,300760,96,300997
7293,0.053639,172.31.47.0-255,66,300826,96,300997
7294,0.053765,172.31.47.0-255,105,300931,96,300997
7295,0.056058,74.125.24.0-255,66,300997,96,300997
7296,0.0,172.217.194.0-255,153,153,96,309854
7297,1.5e-05,172.31.47.0-255,66,219,96,309854
7298,2.1e-05,172.217.194.0-255,1484,1703,96,309854
7299,2.5e-05,172.31.47.0-255,66,1769,96,309854
7300,3.1e-05,172.217.194.0-255,2902,4671,96,309854
7301,3.3e-05,172.31.47.0-255,66,4737,96,309854
7302,6.1e-05,172.217.194.0-255,4320,9057,96,309854
7303,6.4e-05,172.31.47.0-255,66,9123,96,309854
7304,8.9e-05,172.217.194.0-255,4855,13978,96,309854
7305,9.1e-05,172.31.47.0-255,66,14044,96,309854
7306,0.00013,172.217.194.0-255,1484,15528,96,309854
7307,0.000133,172.31.47.0-255,66,15594,96,309854
7308,0.000143,172.217.194.0-255,2902,18496,96,309854
7309,0.000145,172.31.47.0-255,66,18562,96,309854
7310,0.000149,172.217.194.0-255,1484,20046,96,309854
7311,0.00015,172.31.47.0-255,66,20112,96,309854
7312,0.00018,172.217.194.0-255,4320,24432,96,309854
7313,0.000183,172.31.47.0-255,66,24498,96,309854
7314,0.00019,172.217.194.0-255,6797,31295,96,309854
7315,0.000192,172.31.47.0-255,66,31361,96,309854
7316,0.000197,172.217.194.0-255,4320,35681,96,309854
7317,0.0002,172.31.47.0-255,66,35747,96,309854
7318,0.000237,172.217.194.0-255,2902,38649,96,309854
7319,0.000239,172.31.47.0-255,66,38715,96,309854
7320,0.000252,172.31.47.0-255,66,38781,96,309854
7321,0.000787,172.217.194.0-255,1484,40265,96,309854
7322,0.000792,172.31.47.0-255,66,40331,96,309854
7323,0.000798,172.217.194.0-255,2902,43233,96,309854
7324,0.0008,172.31.47.0-255,66,43299,96,309854
7325,0.000806,172.217.194.0-255,5738,49037,96,309854
7326,0.000808,172.31.47.0-255,66,49103,96,309854
7327,0.000843,172.217.194.0-255,6797,55900,96,309854
7328,0.000866,172.31.47.0-255,66,55966,96,309854
7329,0.000881,172.217.194.0-255,1484,57450,96,309854
7330,0.000886,172.217.194.0-255,2902,60352,96,309854
7331,0.000903,172.217.194.0-255,5738,66090,96,309854
7332,0.000906,172.31.47.0-255,66,66156,96,309854
7333,0.000929,172.31.47.0-255,66,66222,96,309854
7334,0.00094,172.217.194.0-255,5738,71960,96,309854
7335,0.000954,172.217.194.0-255,5738,77698,96,309854
7336,0.000969,172.217.194.0-255,2543,80241,96,309854
7337,0.000989,172.217.194.0-255,5738,85979,96,309854
7338,0.000992,172.31.47.0-255,66,86045,96,309854
7339,0.000996,172.31.47.0-255,66,86111,96,309854
7340,0.001014,172.217.194.0-255,4541,90652,96,309854
7341,0.001032,172.31.47.0-255,66,90718,96,309854
7342,0.001913,172.217.194.0-255,1484,92202,96,309854
7343,0.001919,172.31.47.0-255,66,92268,96,309854
7344,0.001928,172.217.194.0-255,2902,95170,96,309854
7345,0.001934,172.217.194.0-255,5738,100908,96,309854
7346,0.001945,172.217.194.0-255,1484,102392,96,309854
7347,0.001975,172.31.47.0-255,66,102458,96,309854
7348,0.001985,172.217.194.0-255,7156,109614,96,309854
7349,0.001989,172.31.47.0-255,66,109680,96,309854
7350,0.001998,172.217.194.0-255,4320,114000,96,309854
7351,0.002,172.217.194.0-255,1484,115484,96,309854
7352,0.002012,172.217.194.0-255,766,116250,96,309854
7353,0.002033,172.31.47.0-255,66,116316,96,309854
7354,0.002341,172.217.194.0-255,1484,117800,96,309854
7355,0.002349,172.217.194.0-255,2902,120702,96,309854
7356,0.002353,172.31.47.0-255,66,120768,96,309854
7357,0.00236,172.217.194.0-255,5738,126506,96,309854
7358,0.002366,172.217.194.0-255,7156,133662,96,309854
7359,0.00238,172.217.194.0-255,2184,135846,96,309854
7360,0.00241,172.217.194.0-255,1484,137330,96,309854
7361,0.002415,172.217.194.0-255,2902,140232,96,309854
7362,0.002417,172.217.194.0-255,1484,141716,96,309854
7363,0.002434,172.217.194.0-255,4320,146036,96,309854
7364,0.00245,172.217.194.0-255,4320,150356,96,309854
7365,0.002453,172.217.194.0-255,1484,151840,96,309854
7366,0.002455,172.31.47.0-255,78,151918,96,309854
7367,0.002459,172.217.194.0-255,2902,154820,96,309854
7368,0.002462,172.31.47.0-255,78,154898,96,309854
7369,0.002479,172.217.194.0-255,5738,160636,96,309854
7370,0.002488,172.217.194.0-255,1484,162120,96,309854
7371,0.002521,172.217.194.0-255,1484,163604,96,309854
7372,0.002542,172.217.194.0-255,1484,165088,96,309854
7373,0.002554,172.217.194.0-255,4320,169408,96,309854
7374,0.002557,172.217.194.0-255,1484,170892,96,309854
7375,0.00258,172.217.194.0-255,7156,178048,96,309854
7376,0.002604,172.217.194.0-255,1484,179532,96,309854
7377,0.002621,172.217.194.0-255,6438,185970,96,309854
7378,0.002676,172.217.194.0-255,1484,187454,96,309854
7379,0.002678,172.217.194.0-255,1484,188938,96,309854
7380,0.002688,172.217.194.0-255,2902,191840,96,309854
7381,0.002697,172.217.194.0-255,1484,193324,96,309854
7382,0.002719,172.217.194.0-255,5738,199062,96,309854
7383,0.002721,172.217.194.0-255,1484,200546,96,309854
7384,0.002761,172.217.194.0-255,766,201312,96,309854
7385,0.002766,172.217.194.0-255,4320,205632,96,309854
7386,0.002792,172.217.194.0-255,4320,209952,96,309854
7387,0.002811,172.217.194.0-255,4320,214272,96,309854
7388,0.00285,172.217.194.0-255,2184,216456,96,309854
7389,0.00302,172.217.194.0-255,1484,217940,96,309854
7390,0.003025,172.217.194.0-255,2902,220842,96,309854
7391,0.003037,172.217.194.0-255,4320,225162,96,309854
7392,0.003048,172.217.194.0-255,1484,226646,96,309854
7393,0.003068,172.217.194.0-255,2902,229548,96,309854
7394,0.003085,172.217.194.0-255,4320,233868,96,309854
7395,0.003101,172.217.194.0-255,5738,239606,96,309854
7396,0.003103,172.217.194.0-255,1484,241090,96,309854
7397,0.003106,172.217.194.0-255,1484,242574,96,309854
7398,0.003163,172.217.194.0-255,7156,249730,96,309854
7399,0.003183,172.217.194.0-255,2902,252632,96,309854
7400,0.003188,172.217.194.0-255,4320,256952,96,309854
7401,0.003207,172.217.194.0-255,4320,261272,96,309854
7402,0.003233,172.217.194.0-255,3602,264874,96,309854
7403,0.003259,172.31.47.0-255,66,264940,96,309854
7404,0.003268,172.217.194.0-255,2902,267842,96,309854
7405,0.003277,172.31.47.0-255,66,267908,96,309854
7406,0.00328,172.217.194.0-255,1484,269392,96,309854
7407,0.003297,172.217.194.0-255,2902,272294,96,309854
7408,0.0033,172.217.194.0-255,1484,273778,96,309854
7409,0.003317,172.31.47.0-255,66,273844,96,309854
7410,0.003329,172.217.194.0-255,7156,281000,96,309854
7411,0.003334,172.31.47.0-255,66,281066,96,309854
7412,0.003343,172.217.194.0-255,4320,285386,96,309854
7413,0.003347,172.217.194.0-255,4320,289706,96,309854
7414,0.003375,172.217.194.0-255,2902,292608,96,309854
7415,0.003394,172.217.194.0-255,6438,299046,96,309854
7416,0.0034,172.31.47.0-255,66,299112,96,309854
7417,0.003418,172.217.194.0-255,1484,300596,96,309854
7418,0.003441,172.217.194.0-255,4458,305054,96,309854
7419,0.003475,172.31.47.0-255,66,305120,96,309854
7420,0.003481,172.217.194.0-255,97,305217,96,309854
7421,0.003491,172.217.194.0-255,105,305322,96,309854
7422,0.005244,172.31.47.0-255,66,305388,96,309854
7423,0.005276,172.31.47.0-255,105,305493,96,309854
7424,0.007561,172.217.194.0-255,66,305559,96,309854
7425,0.028,172.31.47.0-255,172,305731,96,309854
7426,0.028029,172.31.47.0-255,1110,306841,96,309854
7427,0.028082,172.31.47.0-255,1514,308355,96,309854
7428,0.028084,172.31.47.0-255,1301,309656,96,309854
7429,0.029573,104.244.42.0-255,66,309722,96,309854
7430,0.029598,104.244.42.0-255,66,309788,96,309854
7431,0.029687,104.244.42.0-255,66,309854,96,309854
7432,0.0,172.217.194.0-255,153,153,96,323913
7433,1.6e-05,172.31.47.0-255,66,219,96,323913
7434,4e-05,172.217.194.0-255,1484,1703,96,323913
7435,4.4e-05,172.31.47.0-255,66,1769,96,323913
7436,4.9e-05,172.217.194.0-255,2902,4671,96,323913
7437,5.2e-05,172.31.47.0-255,66,4737,96,323913
7438,5.7e-05,172.217.194.0-255,4320,9057,96,323913
7439,6e-05,172.31.47.0-255,66,9123,96,323913
7440,8.2e-05,172.217.194.0-255,1484,10607,96,323913
7441,8.4e-05,172.31.47.0-255,66,10673,96,323913
7442,9.5e-05,172.217.194.0-255,1484,12157,96,323913
7443,9.7e-05,172.31.47.0-255,66,12223,96,323913
7444,0.000113,172.217.194.0-255,2015,14238,96,323913
7445,0.000115,172.31.47.0-255,66,14304,96,323913
7446,0.000134,172.217.194.0-255,4320,18624,96,323913
7447,0.000136,172.31.47.0-255,66,18690,96,323913
7448,0.000141,172.217.194.0-255,4320,23010,96,323913
7449,0.000143,172.31.47.0-255,66,23076,96,323913
7450,0.000164,172.217.194.0-255,2902,25978,96,323913
7451,0.000167,172.31.47.0-255,66,26044,96,323913
7452,0.000183,172.217.194.0-255,1484,27528,96,323913
7453,0.000185,172.31.47.0-255,66,27594,96,323913
7454,0.000214,172.31.47.0-255,66,27660,96,323913
7455,0.000219,172.217.194.0-255,2902,30562,96,323913
7456,0.000221,172.31.47.0-255,66,30628,96,323913
7457,0.000236,172.217.194.0-255,5379,36007,96,323913
7458,0.000238,172.31.47.0-255,66,36073,96,323913
7459,0.000274,172.217.194.0-255,1484,37557,96,323913
7460,0.000276,172.31.47.0-255,66,37623,96,323913
7461,0.00028,172.217.194.0-255,1484,39107,96,323913
7462,0.000281,172.31.47.0-255,66,39173,96,323913
7463,0.000294,172.217.194.0-255,1484,40657,96,323913
7464,0.000297,172.217.194.0-255,1484,42141,96,323913
7465,0.000299,172.31.47.0-255,66,42207,96,323913
7466,0.000317,172.217.194.0-255,4320,46527,96,323913
7467,0.000319,172.31.47.0-255,66,46593,96,323913
7468,0.000325,172.217.194.0-255,5738,52331,96,323913
7469,0.000328,172.31.47.0-255,66,52397,96,323913
7470,0.000355,172.217.194.0-255,1475,53872,96,323913
7471,0.000386,172.217.194.0-255,362,54234,96,323913
7472,0.000388,172.31.47.0-255,66,54300,96,323913
7473,0.00081,172.217.194.0-255,1484,55784,96,323913
7474,0.000816,172.217.194.0-255,2902,58686,96,323913
7475,0.00082,172.31.47.0-255,66,58752,96,323913
7476,0.000827,172.217.194.0-255,5738,64490,96,323913
7477,0.000829,172.31.47.0-255,66,64556,96,323913
7478,0.000861,172.31.47.0-255,66,64622,96,323913
7479,0.000867,172.217.194.0-255,5738,70360,96,323913
7480,0.000869,172.31.47.0-255,66,70426,96,323913
7481,0.000917,172.217.194.0-255,5020,75446,96,323913
7482,0.000922,172.31.47.0-255,66,75512,96,323913
7483,0.001112,172.217.194.0-255,1484,76996,96,323913
7484,0.001117,172.217.194.0-255,2902,79898,96,323913
7485,0.00112,172.31.47.0-255,66,79964,96,323913
7486,0.001125,172.217.194.0-255,2902,82866,96,323913
7487,0.001127,172.31.47.0-255,66,82932,96,323913
7488,0.001141,172.217.194.0-255,2902,85834,96,323913
7489,0.001143,172.31.47.0-255,66,85900,96,323913
7490,0.001145,172.217.194.0-255,1484,87384,96,323913
7491,0.001201,172.31.47.0-255,66,87450,96,323913
7492,0.001204,172.31.47.0-255,66,87516,96,323913
7493,0.001678,172.217.194.0-255,1484,89000,96,323913
7494,0.001693,172.217.194.0-255,2902,91902,96,323913
7495,0.001697,172.31.47.0-255,66,91968,96,323913
7496,0.0017,172.217.194.0-255,1484,93452,96,323913
7497,0.001721,172.217.194.0-255,4320,97772,96,323913
7498,0.001723,172.31.47.0-255,66,97838,96,323913
7499,0.001731,172.217.194.0-255,5738,103576,96,323913
7500,0.001732,172.31.47.0-255,66,103642,96,323913
7501,0.00175,172.217.194.0-255,7156,110798,96,323913
7502,0.001752,172.31.47.0-255,66,110864,96,323913
7503,0.001761,172.31.47.0-255,66,110930,96,323913
7504,0.001779,172.217.194.0-255,1484,112414,96,323913
7505,0.001781,172.217.194.0-255,766,113180,96,323913
7506,0.001783,172.31.47.0-255,66,113246,96,323913
7507,0.001961,172.217.194.0-255,1484,114730,96,323913
7508,0.002,172.217.194.0-255,2902,117632,96,323913
7509,0.002003,172.31.47.0-255,66,117698,96,323913
7510,0.002009,172.217.194.0-255,5738,123436,96,323913
7511,0.002011,172.31.47.0-255,66,123502,96,323913
7512,0.003965,172.217.194.0-255,5738,129240,96,323913
7513,0.003973,172.31.47.0-255,66,129306,96,323913
7514,0.005936,172.217.194.0-255,2902,132208,96,323913
7515,0.005939,172.31.47.0-255,66,132274,96,323913
7516,0.005952,172.217.194.0-255,2902,135176,96,323913
7517,0.005955,172.31.47.0-255,66,135242,96,323913
7518,0.007922,172.217.194.0-255,5738,140980,96,323913
7519,0.007929,172.31.47.0-255,66,141046,96,323913
7520,0.009899,172.217.194.0-255,5738,146784,96,323913
7521,0.009907,172.31.47.0-255,66,146850,96,323913
7522,0.011864,172.217.194.0-255,5738,152588,96,323913
7523,0.011872,172.31.47.0-255,66,152654,96,323913
7524,0.013861,172.217.194.0-255,5738,158392,96,323913
7525,0.013871,172.31.47.0-255,66,158458,96,323913
7526,0.015836,172.217.194.0-255,5738,164196,96,323913
7527,0.015845,172.31.47.0-255,66,164262,96,323913
7528,0.017801,172.217.194.0-255,5738,170000,96,323913
7529,0.017808,172.31.47.0-255,66,170066,96,323913
7530,0.019788,172.217.194.0-255,5738,175804,96,323913
7531,0.019794,172.31.47.0-255,66,175870,96,323913
7532,0.021786,172.217.194.0-255,5738,181608,96,323913
7533,0.021794,172.31.47.0-255,66,181674,96,323913
7534,0.023781,172.217.194.0-255,5738,187412,96,323913
7535,0.02379,172.31.47.0-255,66,187478,96,323913
7536,0.025774,172.217.194.0-255,5738,193216,96,323913
7537,0.025781,172.31.47.0-255,66,193282,96,323913
7538,0.027739,172.217.194.0-255,5738,199020,96,323913
7539,0.027745,172.31.47.0-255,66,199086,96,323913
7540,0.029294,172.31.47.0-255,172,199258,96,323913
7541,0.029324,172.31.47.0-255,1110,200368,96,323913
7542,0.029379,172.31.47.0-255,1514,201882,96,323913
7543,0.029381,172.31.47.0-255,1301,203183,96,323913
7544,0.029716,172.217.194.0-255,5738,208921,96,323913
7545,0.029724,172.31.47.0-255,66,208987,96,323913
7546,0.030837,104.244.42.0-255,66,209053,96,323913
7547,0.031048,104.244.42.0-255,66,209119,96,323913
7548,0.031053,104.244.42.0-255,66,209185,96,323913
7549,0.031695,172.217.194.0-255,4320,213505,96,323913
7550,0.031701,172.31.47.0-255,66,213571,96,323913
7551,0.031721,172.217.194.0-255,1484,215055,96,323913
7552,0.03367,172.217.194.0-255,4320,219375,96,323913
7553,0.033677,172.31.47.0-255,66,219441,96,323913
7554,0.035677,172.217.194.0-255,5738,225179,96,323913
7555,0.035684,172.31.47.0-255,66,225245,96,323913
7556,0.037651,172.217.194.0-255,5738,230983,96,323913
7557,0.037657,172.31.47.0-255,66,231049,96,323913
7558,0.039638,172.217.194.0-255,5738,236787,96,323913
7559,0.039646,172.31.47.0-255,66,236853,96,323913
7560,0.041643,172.217.194.0-255,5738,242591,96,323913
7561,0.04165,172.31.47.0-255,66,242657,96,323913
7562,0.043604,172.217.194.0-255,5738,248395,96,323913
7563,0.043612,172.31.47.0-255,66,248461,96,323913
7564,0.045597,172.217.194.0-255,5738,254199,96,323913
7565,0.045604,172.31.47.0-255,66,254265,96,323913
7566,0.047583,172.217.194.0-255,5738,260003,96,323913
7567,0.047589,172.31.47.0-255,66,260069,96,323913
7568,0.049558,172.217.194.0-255,5738,265807,96,323913
7569,0.049564,172.31.47.0-255,66,265873,96,323913
7570,0.051506,172.217.194.0-255,5738,271611,96,323913
7571,0.051512,172.31.47.0-255,66,271677,96,323913
7572,0.053497,172.217.194.0-255,5738,277415,96,323913
7573,0.053503,172.31.47.0-255,66,277481,96,323913
7574,0.055473,172.217.194.0-255,5738,283219,96,323913
7575,0.055479,172.31.47.0-255,66,283285,96,323913
7576,0.057448,172.217.194.0-255,5738,289023,96,323913
7577,0.057454,172.31.47.0-255,66,289089,96,323913
7578,0.059428,172.217.194.0-255,5738,294827,96,323913
7579,0.059433,172.31.47.0-255,66,294893,96,323913
7580,0.061415,172.217.194.0-255,5738,300631,96,323913
7581,0.061422,172.31.47.0-255,66,300697,96,323913
7582,0.063449,172.217.194.0-255,5738,306435,96,323913
7583,0.063456,172.31.47.0-255,66,306501,96,323913
7584,0.065431,172.217.194.0-255,5738,312239,96,323913
7585,0.065436,172.31.47.0-255,66,312305,96,323913
7586,0.067397,172.217.194.0-255,5738,318043,96,323913
7587,0.067402,172.31.47.0-255,66,318109,96,323913
7588,0.069371,172.217.194.0-255,5738,323847,96,323913
7589,0.069379,172.31.47.0-255,66,323913,96,323913
7590,0.0,172.217.194.0-255,153,153,96,201007
7591,1.7e-05,172.31.47.0-255,66,219,96,201007
7592,2.3e-05,172.217.194.0-255,1484,1703,96,201007
7593,2.7e-05,172.31.47.0-255,66,1769,96,201007
7594,3.2e-05,172.217.194.0-255,2902,4671,96,201007
7595,3.4e-05,172.31.47.0-255,66,4737,96,201007
7596,4.1e-05,172.217.194.0-255,7156,11893,96,201007
7597,4.3e-05,172.31.47.0-255,66,11959,96,201007
7598,4.6e-05,172.217.194.0-255,2084,14043,96,201007
7599,4.8e-05,172.31.47.0-255,66,14109,96,201007
7600,9.7e-05,172.217.194.0-255,1484,15593,96,201007
7601,9.9e-05,172.31.47.0-255,66,15659,96,201007
7602,0.000103,172.217.194.0-255,1484,17143,96,201007
7603,0.000105,172.31.47.0-255,66,17209,96,201007
7604,0.000123,172.217.194.0-255,1484,18693,96,201007
7605,0.000125,172.31.47.0-255,66,18759,96,201007
7606,0.000131,172.217.194.0-255,5738,24497,96,201007
7607,0.000133,172.31.47.0-255,66,24563,96,201007
7608,0.000137,172.217.194.0-255,2902,27465,96,201007
7609,0.000139,172.31.47.0-255,66,27531,96,201007
7610,0.000162,172.217.194.0-255,3961,31492,96,201007
7611,0.000165,172.31.47.0-255,66,31558,96,201007
7612,0.000468,172.217.194.0-255,1484,33042,96,201007
7613,0.000473,172.31.47.0-255,66,33108,96,201007
7614,0.000478,172.217.194.0-255,2902,36010,96,201007
7615,0.00048,172.31.47.0-255,66,36076,96,201007
7616,0.000495,172.217.194.0-255,5738,41814,96,201007
7617,0.000498,172.31.47.0-255,66,41880,96,201007
7618,0.000518,172.217.194.0-255,4320,46200,96,201007
7619,0.00052,172.31.47.0-255,66,46266,96,201007
7620,0.000532,172.217.194.0-255,1484,47750,96,201007
7621,0.000534,172.31.47.0-255,66,47816,96,201007
7622,0.000565,172.31.47.0-255,66,47882,96,201007
7623,0.000572,172.217.194.0-255,7050,54932,96,201007
7624,0.000574,172.31.47.0-255,66,54998,96,201007
7625,0.000577,172.217.194.0-255,119,55117,96,201007
7626,0.000633,172.217.194.0-255,1484,56601,96,201007
7627,0.000636,172.31.47.0-255,66,56667,96,201007
7628,0.000639,172.217.194.0-255,1484,58151,96,201007
7629,0.000654,172.217.194.0-255,1484,59635,96,201007
7630,0.000656,172.31.47.0-255,66,59701,96,201007
7631,0.000662,172.217.194.0-255,5738,65439,96,201007
7632,0.000664,172.31.47.0-255,66,65505,96,201007
7633,0.000684,172.217.194.0-255,2902,68407,96,201007
7634,0.000686,172.31.47.0-255,66,68473,96,201007
7635,0.000716,172.31.47.0-255,66,68539,96,201007
7636,0.000725,172.31.47.0-255,66,68605,96,201007
7637,0.000939,172.217.194.0-255,1484,70089,96,201007
7638,0.000957,172.217.194.0-255,2902,72991,96,201007
7639,0.000961,172.31.47.0-255,66,73057,96,201007
7640,0.000979,172.217.194.0-255,2902,75959,96,201007
7641,0.000983,172.31.47.0-255,66,76025,96,201007
7642,0.001003,172.217.194.0-255,2902,78927,96,201007
7643,0.001005,172.31.47.0-255,66,78993,96,201007
7644,0.00101,172.217.194.0-255,5738,84731,96,201007
7645,0.001012,172.31.47.0-255,66,84797,96,201007
7646,0.001023,172.31.47.0-255,66,84863,96,201007
7647,0.001036,172.217.194.0-255,1484,86347,96,201007
7648,0.001054,172.217.194.0-255,4320,90667,96,201007
7649,0.001057,172.31.47.0-255,66,90733,96,201007
7650,0.001074,172.217.194.0-255,766,91499,96,201007
7651,0.0011,172.217.194.0-255,1484,92983,96,201007
7652,0.001103,172.31.47.0-255,66,93049,96,201007
7653,0.001107,172.217.194.0-255,2902,95951,96,201007
7654,0.001108,172.31.47.0-255,66,96017,96,201007
7655,0.001124,172.217.194.0-255,5738,101755,96,201007
7656,0.001126,172.31.47.0-255,66,101821,96,201007
7657,0.00118,172.31.47.0-255,66,101887,96,201007
7658,0.001196,172.217.194.0-255,5738,107625,96,201007
7659,0.001199,172.31.47.0-255,66,107691,96,201007
7660,0.001212,172.217.194.0-255,5020,112711,96,201007
7661,0.001214,172.31.47.0-255,66,112777,96,201007
7662,0.001472,172.217.194.0-255,1484,114261,96,201007
7663,0.001475,172.217.194.0-255,1484,115745,96,201007
7664,0.001481,172.31.47.0-255,66,115811,96,201007
7665,0.001499,172.217.194.0-255,1484,117295,96,201007
7666,0.001506,172.217.194.0-255,5738,123033,96,201007
7667,0.001508,172.31.47.0-255,66,123099,96,201007
7668,0.001513,172.217.194.0-255,4320,127419,96,201007
7669,0.001514,172.31.47.0-255,66,127485,96,201007
7670,0.001542,172.31.47.0-255,66,127551,96,201007
7671,0.001568,172.31.47.0-255,66,127617,96,201007
7672,0.001606,172.217.194.0-255,1484,129101,96,201007
7673,0.00161,172.217.194.0-255,2902,132003,96,201007
7674,0.001613,172.31.47.0-255,66,132069,96,201007
7675,0.001631,172.217.194.0-255,5738,137807,96,201007
7676,0.001633,172.31.47.0-255,66,137873,96,201007
7677,0.001674,172.31.47.0-255,66,137939,96,201007
7678,0.001727,172.31.47.0-255,66,138005,96,201007
7679,0.001772,172.217.194.0-255,1484,139489,96,201007
7680,0.001776,172.217.194.0-255,1484,140973,96,201007
7681,0.001778,172.31.47.0-255,66,141039,96,201007
7682,0.001793,172.217.194.0-255,1484,142523,96,201007
7683,0.001804,172.217.194.0-255,4320,146843,96,201007
7684,0.001807,172.31.47.0-255,66,146909,96,201007
7685,0.001826,172.217.194.0-255,1484,148393,96,201007
7686,0.001836,172.217.194.0-255,7156,155549,96,201007
7687,0.001838,172.217.194.0-255,1484,157033,96,201007
7688,0.001846,172.31.47.0-255,66,157099,96,201007
7689,0.001875,172.217.194.0-255,2184,159283,96,201007
7690,0.001878,172.31.47.0-255,66,159349,96,201007
7691,0.001881,172.31.47.0-255,66,159415,96,201007
7692,0.001995,172.217.194.0-255,1484,160899,96,201007
7693,0.002008,172.217.194.0-255,2902,163801,96,201007
7694,0.002012,172.31.47.0-255,66,163867,96,201007
7695,0.002015,172.217.194.0-255,1484,165351,96,201007
7696,0.002032,172.217.194.0-255,4320,169671,96,201007
7697,0.002035,172.31.47.0-255,66,169737,96,201007
7698,0.002037,172.217.194.0-255,1484,171221,96,201007
7699,0.002066,172.31.47.0-255,66,171287,96,201007
7700,0.002085,172.31.47.0-255,66,171353,96,201007
7701,0.002116,172.217.194.0-255,1484,172837,96,201007
7702,0.00213,172.217.194.0-255,2902,175739,96,201007
7703,0.002132,172.31.47.0-255,66,175805,96,201007
7704,0.002159,172.217.194.0-255,5738,181543,96,201007
7705,0.002161,172.31.47.0-255,66,181609,96,201007
7706,0.002181,172.217.194.0-255,1484,183093,96,201007
7707,0.002216,172.31.47.0-255,66,183159,96,201007
7708,0.002282,172.31.47.0-255,66,183225,96,201007
7709,0.002292,172.217.194.0-255,4320,187545,96,201007
7710,0.002296,172.31.47.0-255,66,187611,96,201007
7711,0.002364,172.217.194.0-255,1484,189095,96,201007
7712,0.002367,172.31.47.0-255,78,189173,96,201007
7713,0.002374,172.217.194.0-255,6438,195611,96,201007
7714,0.002387,172.31.47.0-255,66,195677,96,201007
7715,0.004683,172.217.194.0-255,798,196475,96,201007
7716,0.010794,172.31.47.0-255,66,196541,96,201007
7717,0.010833,172.31.47.0-255,105,196646,96,201007
7718,0.013113,172.217.194.0-255,66,196712,96,201007
7719,0.030249,172.31.47.0-255,172,196884,96,201007
7720,0.030287,172.31.47.0-255,1110,197994,96,201007
7721,0.03034,172.31.47.0-255,1514,199508,96,201007
7722,0.030359,172.31.47.0-255,1301,200809,96,201007
7723,0.031818,104.244.42.0-255,66,200875,96,201007
7724,0.031846,104.244.42.0-255,66,200941,96,201007
7725,0.031898,104.244.42.0-255,66,201007,96,201007
7726,0.0,74.125.200.0-255,153,153,96,275665
7727,3.4e-05,172.31.47.0-255,66,219,96,275665
7728,5.7e-05,74.125.200.0-255,1484,1703,96,275665
7729,6.2e-05,172.31.47.0-255,66,1769,96,275665
7730,6.5e-05,74.125.200.0-255,1484,3253,96,275665
7731,6.8e-05,172.31.47.0-255,66,3319,96,275665
7732,9.6e-05,74.125.200.0-255,1484,4803,96,275665
7733,0.0001,172.31.47.0-255,66,4869,96,275665
7734,0.000106,74.125.200.0-255,4320,9189,96,275665
7735,0.000108,172.31.47.0-255,66,9255,96,275665
7736,0.000111,74.125.200.0-255,1484,10739,96,275665
7737,0.000112,172.31.47.0-255,66,10805,96,275665
7738,0.000153,172.31.47.0-255,66,10871,96,275665
7739,0.000158,74.125.200.0-255,4320,15191,96,275665
7740,0.000162,172.31.47.0-255,66,15257,96,275665
7741,0.000184,74.125.200.0-255,4320,19577,96,275665
7742,0.000191,172.31.47.0-255,66,19643,96,275665
7743,0.00021,74.125.200.0-255,3961,23604,96,275665
7744,0.000213,172.31.47.0-255,66,23670,96,275665
7745,0.000237,74.125.200.0-255,1484,25154,96,275665
7746,0.000239,172.31.47.0-255,66,25220,96,275665
7747,0.000268,74.125.200.0-255,2902,28122,96,275665
7748,0.000272,172.31.47.0-255,66,28188,96,275665
7749,0.000276,74.125.200.0-255,2902,31090,96,275665
7750,0.000279,172.31.47.0-255,66,31156,96,275665
7751,0.000283,74.125.200.0-255,2902,34058,96,275665
7752,0.000286,172.31.47.0-255,66,34124,96,275665
7753,0.000308,74.125.200.0-255,1484,35608,96,275665
7754,0.000313,172.31.47.0-255,66,35674,96,275665
7755,0.000317,74.125.200.0-255,2902,38576,96,275665
7756,0.00032,172.31.47.0-255,66,38642,96,275665
7757,0.000354,74.125.200.0-255,6797,45439,96,275665
7758,0.000358,172.31.47.0-255,66,45505,96,275665
7759,0.000363,74.125.200.0-255,4320,49825,96,275665
7760,0.000367,172.31.47.0-255,66,49891,96,275665
7761,0.000398,172.31.47.0-255,66,49957,96,275665
7762,0.00056,74.125.200.0-255,381,50338,96,275665
7763,0.000703,74.125.200.0-255,1484,51822,96,275665
7764,0.000708,172.31.47.0-255,66,51888,96,275665
7765,0.000713,74.125.200.0-255,2902,54790,96,275665
7766,0.000718,172.31.47.0-255,66,54856,96,275665
7767,0.000747,74.125.200.0-255,5738,60594,96,275665
7768,0.00075,172.31.47.0-255,66,60660,96,275665
7769,0.000758,74.125.200.0-255,6797,67457,96,275665
7770,0.00076,172.31.47.0-255,66,67523,96,275665
7771,0.000809,172.31.47.0-255,66,67589,96,275665
7772,0.000837,74.125.200.0-255,1484,69073,96,275665
7773,0.000842,74.125.200.0-255,2543,71616,96,275665
7774,0.000845,172.31.47.0-255,66,71682,96,275665
7775,0.001468,74.125.200.0-255,1484,73166,96,275665
7776,0.00148,74.125.200.0-255,2902,76068,96,275665
7777,0.001484,172.31.47.0-255,66,76134,96,275665
7778,0.001489,74.125.200.0-255,2902,79036,96,275665
7779,0.001491,172.31.47.0-255,66,79102,96,275665
7780,0.001555,74.125.200.0-255,4320,83422,96,275665
7781,0.00156,172.31.47.0-255,66,83488,96,275665
7782,0.001571,172.31.47.0-255,66,83554,96,275665
7783,0.001577,74.125.200.0-255,5738,89292,96,275665
7784,0.001579,172.31.47.0-255,66,89358,96,275665
7785,0.001586,74.125.200.0-255,7156,96514,96,275665
7786,0.001588,172.31.47.0-255,66,96580,96,275665
7787,0.001592,74.125.200.0-255,766,97346,96,275665
7788,0.002336,74.125.200.0-255,1484,98830,96,275665
7789,0.00234,172.31.47.0-255,66,98896,96,275665
7790,0.003865,74.125.200.0-255,2902,101798,96,275665
7791,0.003869,172.31.47.0-255,66,101864,96,275665
7792,0.00462,74.125.200.0-255,2902,104766,96,275665
7793,0.004622,172.31.47.0-255,66,104832,96,275665
7794,0.006146,74.125.200.0-255,2902,107734,96,275665
7795,0.006151,172.31.47.0-255,66,107800,96,275665
7796,0.006912,74.125.200.0-255,2902,110702,96,275665
7797,0.006917,172.31.47.0-255,66,110768,96,275665
7798,0.008437,74.125.200.0-255,2902,113670,96,275665
7799,0.008443,172.31.47.0-255,66,113736,96,275665
7800,0.009206,74.125.200.0-255,2902,116638,96,275665
7801,0.009212,172.31.47.0-255,66,116704,96,275665
7802,0.010724,74.125.200.0-255,2902,119606,96,275665
7803,0.01073,172.31.47.0-255,66,119672,96,275665
7804,0.011502,74.125.200.0-255,2902,122574,96,275665
7805,0.011509,172.31.47.0-255,66,122640,96,275665
7806,0.013024,74.125.200.0-255,2902,125542,96,275665
7807,0.013038,172.31.47.0-255,66,125608,96,275665
7808,0.013791,74.125.200.0-255,2902,128510,96,275665
7809,0.013798,172.31.47.0-255,66,128576,96,275665
7810,0.015333,74.125.200.0-255,2902,131478,96,275665
7811,0.015342,172.31.47.0-255,66,131544,96,275665
7812,0.016091,74.125.200.0-255,2902,134446,96,275665
7813,0.016097,172.31.47.0-255,66,134512,96,275665
7814,0.017635,74.125.200.0-255,2902,137414,96,275665
7815,0.017642,172.31.47.0-255,66,137480,96,275665
7816,0.018382,74.125.200.0-255,2902,140382,96,275665
7817,0.018388,172.31.47.0-255,66,140448,96,275665
7818,0.019933,74.125.200.0-255,2902,143350,96,275665
7819,0.019941,172.31.47.0-255,66,143416,96,275665
7820,0.020691,74.125.200.0-255,2902,146318,96,275665
7821,0.020697,172.31.47.0-255,66,146384,96,275665
7822,0.022231,74.125.200.0-255,2902,149286,96,275665
7823,0.022237,172.31.47.0-255,66,149352,96,275665
7824,0.022989,74.125.200.0-255,2902,152254,96,275665
7825,0.022996,172.31.47.0-255,66,152320,96,275665
7826,0.024545,74.125.200.0-255,2902,155222,96,275665
7827,0.024551,172.31.47.0-255,66,155288,96,275665
7828,0.024907,172.31.47.0-255,172,155460,96,275665
7829,0.024949,172.31.47.0-255,1105,156565,96,275665
7830,0.025028,172.31.47.0-255,1514,158079,96,275665
7831,0.025052,172.31.47.0-255,1306,159385,96,275665
7832,0.025285,74.125.200.0-255,2902,162287,96,275665
7833,0.025291,172.31.47.0-255,66,162353,96,275665
7834,0.026417,104.244.42.0-255,66,162419,96,275665
7835,0.026521,104.244.42.0-255,66,162485,96,275665
7836,0.02657,104.244.42.0-255,66,162551,96,275665
7837,0.026618,104.244.42.0-255,66,162617,96,275665
7838,0.026845,74.125.200.0-255,2902,165519,96,275665
7839,0.02685,172.31.47.0-255,66,165585,96,275665
7840,0.027581,74.125.200.0-255,2902,168487,96,275665
7841,0.027588,172.31.47.0-255,66,168553,96,275665
7842,0.02914,74.125.200.0-255,2902,171455,96,275665
7843,0.029145,172.31.47.0-255,66,171521,96,275665
7844,0.029883,74.125.200.0-255,2902,174423,96,275665
7845,0.029888,172.31.47.0-255,66,174489,96,275665
7846,0.031439,74.125.200.0-255,2902,177391,96,275665
7847,0.031445,172.31.47.0-255,66,177457,96,275665
7848,0.03217,74.125.200.0-255,2902,180359,96,275665
7849,0.032176,172.31.47.0-255,66,180425,96,275665
7850,0.033731,74.125.200.0-255,2902,183327,96,275665
7851,0.033737,172.31.47.0-255,66,183393,96,275665
7852,0.034473,74.125.200.0-255,2902,186295,96,275665
7853,0.034479,172.31.47.0-255,66,186361,96,275665
7854,0.03603,74.125.200.0-255,2902,189263,96,275665
7855,0.036036,172.31.47.0-255,66,189329,96,275665
7856,0.03677,74.125.200.0-255,2902,192231,96,275665
7857,0.036775,172.31.47.0-255,66,192297,96,275665
7858,0.038329,74.125.200.0-255,2902,195199,96,275665
7859,0.038335,172.31.47.0-255,66,195265,96,275665
7860,0.03906,74.125.200.0-255,2902,198167,96,275665
7861,0.03908,172.31.47.0-255,66,198233,96,275665
7862,0.040619,74.125.200.0-255,1484,199717,96,275665
7863,0.040651,74.125.200.0-255,1484,201201,96,275665
7864,0.040656,172.31.47.0-255,66,201267,96,275665
7865,0.041363,74.125.200.0-255,2902,204169,96,275665
7866,0.041369,172.31.47.0-255,66,204235,96,275665
7867,0.042942,74.125.200.0-255,2902,207137,96,275665
7868,0.042964,172.31.47.0-255,66,207203,96,275665
7869,0.043658,74.125.200.0-255,2902,210105,96,275665
7870,0.043664,172.31.47.0-255,66,210171,96,275665
7871,0.045266,74.125.200.0-255,2902,213073,96,275665
7872,0.045272,172.31.47.0-255,66,213139,96,275665
7873,0.045952,74.125.200.0-255,2902,216041,96,275665
7874,0.045958,172.31.47.0-255,66,216107,96,275665
7875,0.047557,74.125.200.0-255,2902,219009,96,275665
7876,0.047562,172.31.47.0-255,66,219075,96,275665
7877,0.048246,74.125.200.0-255,1484,220559,96,275665
7878,0.048274,74.125.200.0-255,1484,222043,96,275665
7879,0.048279,172.31.47.0-255,66,222109,96,275665
7880,0.049851,74.125.200.0-255,2902,225011,96,275665
7881,0.049858,172.31.47.0-255,66,225077,96,275665
7882,0.050555,74.125.200.0-255,2902,227979,96,275665
7883,0.05056,172.31.47.0-255,66,228045,96,275665
7884,0.052141,74.125.200.0-255,2902,230947,96,275665
7885,0.052147,172.31.47.0-255,66,231013,96,275665
7886,0.052846,74.125.200.0-255,2902,233915,96,275665
7887,0.052853,172.31.47.0-255,66,233981,96,275665
7888,0.054437,74.125.200.0-255,2902,236883,96,275665
7889,0.054443,172.31.47.0-255,66,236949,96,275665
7890,0.055139,74.125.200.0-255,2902,239851,96,275665
7891,0.055144,172.31.47.0-255,66,239917,96,275665
7892,0.056731,74.125.200.0-255,2902,242819,96,275665
7893,0.056736,172.31.47.0-255,66,242885,96,275665
7894,0.057415,74.125.200.0-255,1484,244369,96,275665
7895,0.057439,74.125.200.0-255,1484,245853,96,275665
7896,0.057443,172.31.47.0-255,66,245919,96,275665
7897,0.059014,74.125.200.0-255,1484,247403,96,275665
7898,0.059045,74.125.200.0-255,1484,248887,96,275665
7899,0.05905,172.31.47.0-255,66,248953,96,275665
7900,0.059716,74.125.200.0-255,2902,251855,96,275665
7901,0.059721,172.31.47.0-255,66,251921,96,275665
7902,0.061328,74.125.200.0-255,2902,254823,96,275665
7903,0.061332,172.31.47.0-255,66,254889,96,275665
7904,0.062002,74.125.200.0-255,2902,257791,96,275665
7905,0.062007,172.31.47.0-255,66,257857,96,275665
7906,0.063614,74.125.200.0-255,2902,260759,96,275665
7907,0.063619,172.31.47.0-255,66,260825,96,275665
7908,0.064292,74.125.200.0-255,2902,263727,96,275665
7909,0.064298,172.31.47.0-255,66,263793,96,275665
7910,0.065948,74.125.200.0-255,2902,266695,96,275665
7911,0.065954,172.31.47.0-255,66,266761,96,275665
7912,0.066584,74.125.200.0-255,2902,269663,96,275665
7913,0.066591,172.31.47.0-255,66,269729,96,275665
7914,0.068246,74.125.200.0-255,2902,272631,96,275665
7915,0.068254,172.31.47.0-255,66,272697,96,275665
7916,0.06888,74.125.200.0-255,2902,275599,96,275665
7917,0.068885,172.31.47.0-255,66,275665,96,275665
7918,0.0,74.125.24.0-255,153,153,96,285138
7919,1.4e-05,172.31.47.0-255,66,219,96,285138
7920,2.1e-05,74.125.24.0-255,1484,1703,96,285138
7921,2.5e-05,172.31.47.0-255,66,1769,96,285138
7922,3.8e-05,74.125.24.0-255,2902,4671,96,285138
7923,4.1e-05,172.31.47.0-255,66,4737,96,285138
7924,7e-05,74.125.24.0-255,2902,7639,96,285138
7925,7.2e-05,172.31.47.0-255,66,7705,96,285138
7926,9.4e-05,74.125.24.0-255,4320,12025,96,285138
7927,9.6e-05,172.31.47.0-255,66,12091,96,285138
7928,0.000187,74.125.24.0-255,1957,14048,96,285138
7929,0.000192,172.31.47.0-255,66,14114,96,285138
7930,0.00021,74.125.24.0-255,2902,17016,96,285138
7931,0.000213,172.31.47.0-255,66,17082,96,285138
7932,0.000252,74.125.24.0-255,4320,21402,96,285138
7933,0.000255,172.31.47.0-255,66,21468,96,285138
7934,0.000281,74.125.24.0-255,2902,24370,96,285138
7935,0.000284,172.31.47.0-255,66,24436,96,285138
7936,0.000376,74.125.24.0-255,6797,31233,96,285138
7937,0.00038,172.31.47.0-255,66,31299,96,285138
7938,0.000482,74.125.24.0-255,7156,38455,96,285138
7939,0.000485,172.31.47.0-255,66,38521,96,285138
7940,0.000597,74.125.24.0-255,5738,44259,96,285138
7941,0.0006,172.31.47.0-255,66,44325,96,285138
7942,0.000635,172.31.47.0-255,66,44391,96,285138
7943,0.000842,74.125.24.0-255,4320,48711,96,285138
7944,0.000846,172.31.47.0-255,66,48777,96,285138
7945,0.000871,74.125.24.0-255,6797,55574,96,285138
7946,0.000874,172.31.47.0-255,66,55640,96,285138
7947,0.001,74.125.24.0-255,411,56051,96,285138
7948,0.001004,172.31.47.0-255,66,56117,96,285138
7949,0.001029,74.125.24.0-255,2902,59019,96,285138
7950,0.001031,172.31.47.0-255,78,59097,96,285138
7951,0.001034,74.125.24.0-255,332,59429,96,285138
7952,0.001058,172.31.47.0-255,66,59495,96,285138
7953,0.001083,74.125.24.0-255,7156,66651,96,285138
7954,0.001089,172.31.47.0-255,66,66717,96,285138
7955,0.00121,172.31.47.0-255,66,66783,96,285138
7956,0.001229,74.125.24.0-255,4320,71103,96,285138
7957,0.001273,172.31.47.0-255,66,71169,96,285138
7958,0.001476,172.31.47.0-255,66,71235,96,285138
7959,0.001572,74.125.24.0-255,4320,75555,96,285138
7960,0.001588,74.125.24.0-255,4320,79875,96,285138
7961,0.00172,74.125.24.0-255,5738,85613,96,285138
7962,0.001754,74.125.24.0-255,4320,89933,96,285138
7963,0.002022,74.125.24.0-255,4320,94253,96,285138
7964,0.00237,74.125.24.0-255,7156,101409,96,285138
7965,0.002425,74.125.24.0-255,6438,107847,96,285138
7966,0.002973,74.125.24.0-255,4320,112167,96,285138
7967,0.003693,172.31.47.0-255,66,112233,96,285138
7968,0.005729,74.125.24.0-255,5738,117971,96,285138
7969,0.005734,172.31.47.0-255,66,118037,96,285138
7970,0.007752,74.125.24.0-255,5738,123775,96,285138
7971,0.007759,172.31.47.0-255,66,123841,96,285138
7972,0.009756,74.125.24.0-255,5738,129579,96,285138
7973,0.009763,172.31.47.0-255,66,129645,96,285138
7974,0.01183,74.125.24.0-255,5738,135383,96,285138
7975,0.011836,172.31.47.0-255,66,135449,96,285138
7976,0.013849,74.125.24.0-255,5738,141187,96,285138
7977,0.013856,172.31.47.0-255,66,141253,96,285138
7978,0.015944,74.125.24.0-255,5738,146991,96,285138
7979,0.015955,172.31.47.0-255,66,147057,96,285138
7980,0.018047,74.125.24.0-255,5738,152795,96,285138
7981,0.018056,172.31.47.0-255,66,152861,96,285138
7982,0.020104,74.125.24.0-255,5738,158599,96,285138
7983,0.020114,172.31.47.0-255,66,158665,96,285138
7984,0.022141,74.125.24.0-255,5738,164403,96,285138
7985,0.02215,172.31.47.0-255,66,164469,96,285138
7986,0.024161,74.125.24.0-255,5738,170207,96,285138
7987,0.024168,172.31.47.0-255,66,170273,96,285138
7988,0.026202,74.125.24.0-255,5738,176011,96,285138
7989,0.026208,172.31.47.0-255,66,176077,96,285138
7990,0.027406,172.31.47.0-255,172,176249,96,285138
7991,0.027436,172.31.47.0-255,1109,177358,96,285138
7992,0.027496,172.31.47.0-255,1514,178872,96,285138
7993,0.027498,172.31.47.0-255,1302,180174,96,285138
7994,0.028254,74.125.24.0-255,5738,185912,96,285138
7995,0.028261,172.31.47.0-255,66,185978,96,285138
7996,0.02895,104.244.42.0-255,66,186044,96,285138
7997,0.028994,104.244.42.0-255,66,186110,96,285138
7998,0.029035,104.244.42.0-255,66,186176,96,285138
7999,0.030257,74.125.24.0-255,5738,191914,96,285138
8000,0.030263,172.31.47.0-255,66,191980,96,285138
8001,0.032304,74.125.24.0-255,5738,197718,96,285138
8002,0.032309,172.31.47.0-255,66,197784,96,285138
8003,0.034306,74.125.24.0-255,5738,203522,96,285138
8004,0.034311,172.31.47.0-255,66,203588,96,285138
8005,0.03634,74.125.24.0-255,5738,209326,96,285138
8006,0.036346,172.31.47.0-255,66,209392,96,285138
8007,0.038385,74.125.24.0-255,5738,215130,96,285138
8008,0.038392,172.31.47.0-255,66,215196,96,285138
8009,0.040381,74.125.24.0-255,5738,220934,96,285138
8010,0.040389,172.31.47.0-255,66,221000,96,285138
8011,0.042429,74.125.24.0-255,5738,226738,96,285138
8012,0.042436,172.31.47.0-255,66,226804,96,285138
8013,0.044495,74.125.24.0-255,5738,232542,96,285138
8014,0.044501,172.31.47.0-255,66,232608,96,285138
8015,0.046536,74.125.24.0-255,5738,238346,96,285138
8016,0.046542,172.31.47.0-255,66,238412,96,285138
8017,0.048583,74.125.24.0-255,5738,244150,96,285138
8018,0.048589,172.31.47.0-255,66,244216,96,285138
8019,0.050631,74.125.24.0-255,5738,249954,96,285138
8020,0.050636,172.31.47.0-255,66,250020,96,285138
8021,0.052636,74.125.24.0-255,5738,255758,96,285138
8022,0.052641,172.31.47.0-255,66,255824,96,285138
8023,0.054684,74.125.24.0-255,4320,260144,96,285138
8024,0.05469,172.31.47.0-255,66,260210,96,285138
8025,0.054715,74.125.24.0-255,1484,261694,96,285138
8026,0.056777,74.125.24.0-255,4320,266014,96,285138
8027,0.056782,172.31.47.0-255,66,266080,96,285138
8028,0.058821,74.125.24.0-255,5738,271818,96,285138
8029,0.058827,172.31.47.0-255,66,271884,96,285138
8030,0.060833,74.125.24.0-255,5738,277622,96,285138
8031,0.060838,172.31.47.0-255,66,277688,96,285138
8032,0.062853,74.125.24.0-255,5738,283426,96,285138
8033,0.062858,172.31.47.0-255,66,283492,96,285138
8034,0.064854,74.125.24.0-255,1409,284901,96,285138
8035,0.06486,172.31.47.0-255,66,284967,96,285138
8036,0.065015,172.31.47.0-255,105,285072,96,285138
8037,0.067023,74.125.24.0-255,66,285138,96,285138
8038,0.0,74.125.130.0-255,153,153,96,381475
8039,3e-05,172.31.47.0-255,66,219,96,381475
8040,3.6e-05,74.125.130.0-255,1484,1703,96,381475
8041,4.1e-05,172.31.47.0-255,66,1769,96,381475
8042,4.3e-05,74.125.130.0-255,1484,3253,96,381475
8043,4.6e-05,172.31.47.0-255,66,3319,96,381475
8044,5.1e-05,74.125.130.0-255,2902,6221,96,381475
8045,5.4e-05,172.31.47.0-255,66,6287,96,381475
8046,8.6e-05,74.125.130.0-255,5738,12025,96,381475
8047,8.9e-05,172.31.47.0-255,66,12091,96,381475
8048,9.2e-05,74.125.130.0-255,2172,14263,96,381475
8049,9.4e-05,172.31.47.0-255,66,14329,96,381475
8050,0.000109,74.125.130.0-255,1484,15813,96,381475
8051,0.000112,172.31.47.0-255,66,15879,96,381475
8052,0.000137,74.125.130.0-255,1484,17363,96,381475
8053,0.000139,172.31.47.0-255,66,17429,96,381475
8054,0.000145,74.125.130.0-255,5738,23167,96,381475
8055,0.000147,172.31.47.0-255,66,23233,96,381475
8056,0.000164,74.125.130.0-255,1484,24717,96,381475
8057,0.000167,172.31.47.0-255,66,24783,96,381475
8058,0.000184,74.125.130.0-255,5738,30521,96,381475
8059,0.000186,172.31.47.0-255,66,30587,96,381475
8060,0.000189,74.125.130.0-255,1125,31712,96,381475
8061,0.00019,172.31.47.0-255,66,31778,96,381475
8062,0.000464,74.125.130.0-255,1484,33262,96,381475
8063,0.00047,172.31.47.0-255,66,33328,96,381475
8064,0.000495,74.125.130.0-255,2902,36230,96,381475
8065,0.000499,172.31.47.0-255,66,36296,96,381475
8066,0.000516,74.125.130.0-255,1484,37780,96,381475
8067,0.000518,172.31.47.0-255,66,37846,96,381475
8068,0.000536,74.125.130.0-255,2902,40748,96,381475
8069,0.000538,172.31.47.0-255,66,40814,96,381475
8070,0.000545,74.125.130.0-255,4320,45134,96,381475
8071,0.000562,172.31.47.0-255,66,45200,96,381475
8072,0.000563,74.125.130.0-255,1484,46684,96,381475
8073,0.000585,74.125.130.0-255,6797,53481,96,381475
8074,0.00059,74.125.130.0-255,2902,56383,96,381475
8075,0.000597,172.31.47.0-255,66,56449,96,381475
8076,0.000603,74.125.130.0-255,2902,59351,96,381475
8077,0.000606,74.125.130.0-255,1484,60835,96,381475
8078,0.000609,172.31.47.0-255,66,60901,96,381475
8079,0.000624,74.125.130.0-255,5668,66569,96,381475
8080,0.000632,172.31.47.0-255,66,66635,96,381475
8081,0.00072,74.125.130.0-255,366,67001,96,381475
8082,0.000802,172.31.47.0-255,66,67067,96,381475
8083,0.000978,74.125.130.0-255,1484,68551,96,381475
8084,0.000986,74.125.130.0-255,1484,70035,96,381475
8085,0.001008,74.125.130.0-255,2902,72937,96,381475
8086,0.00104,74.125.130.0-255,5738,78675,96,381475
8087,0.001043,74.125.130.0-255,1484,80159,96,381475
8088,0.001069,74.125.130.0-255,2902,83061,96,381475
8089,0.001091,74.125.130.0-255,2902,85963,96,381475
8090,0.00111,74.125.130.0-255,2902,88865,96,381475
8091,0.001131,74.125.130.0-255,4320,93185,96,381475
8092,0.001146,74.125.130.0-255,2902,96087,96,381475
8093,0.00115,74.125.130.0-255,2902,98989,96,381475
8094,0.001198,74.125.130.0-255,2184,101173,96,381475
8095,0.001312,74.125.130.0-255,1484,102657,96,381475
8096,0.001331,74.125.130.0-255,2902,105559,96,381475
8097,0.001355,74.125.130.0-255,5738,111297,96,381475
8098,0.00136,74.125.130.0-255,2902,114199,96,381475
8099,0.001365,74.125.130.0-255,4320,118519,96,381475
8100,0.001386,74.125.130.0-255,4320,122839,96,381475
8101,0.001403,74.125.130.0-255,4320,127159,96,381475
8102,0.001408,74.125.130.0-255,4320,131479,96,381475
8103,0.001458,74.125.130.0-255,3602,135081,96,381475
8104,0.001472,74.125.130.0-255,2902,137983,96,381475
8105,0.001484,74.125.130.0-255,1484,139467,96,381475
8106,0.001523,74.125.130.0-255,5738,145205,96,381475
8107,0.001534,74.125.130.0-255,1484,146689,96,381475
8108,0.001549,74.125.130.0-255,7156,153845,96,381475
8109,0.001558,74.125.130.0-255,1484,155329,96,381475
8110,0.001561,74.125.130.0-255,1484,156813,96,381475
8111,0.001603,74.125.130.0-255,2902,159715,96,381475
8112,0.001637,74.125.130.0-255,766,160481,96,381475
8113,0.001746,74.125.130.0-255,1484,161965,96,381475
8114,0.001755,74.125.130.0-255,1484,163449,96,381475
8115,0.001765,74.125.130.0-255,1484,164933,96,381475
8116,0.001804,74.125.130.0-255,5738,170671,96,381475
8117,0.001824,74.125.130.0-255,6248,176919,96,381475
8118,0.001824,172.31.47.0-255,66,176985,96,381475
8119,0.001829,172.31.47.0-255,66,177051,96,381475
8120,0.001857,74.125.130.0-255,4320,181371,96,381475
8121,0.001873,74.125.130.0-255,2902,184273,96,381475
8122,0.001875,172.31.47.0-255,66,184339,96,381475
8123,0.001876,74.125.130.0-255,2902,187241,96,381475
8124,0.001881,172.31.47.0-255,66,187307,96,381475
8125,0.001904,74.125.130.0-255,5738,193045,96,381475
8126,0.001913,172.31.47.0-255,66,193111,96,381475
8127,0.001921,74.125.130.0-255,5738,198849,96,381475
8128,0.001924,172.31.47.0-255,66,198915,96,381475
8129,0.001926,74.125.130.0-255,4320,203235,96,381475
8130,0.001935,172.31.47.0-255,66,203301,96,381475
8131,0.001969,74.125.130.0-255,2902,206203,96,381475
8132,0.001975,172.31.47.0-255,66,206269,96,381475
8133,0.001984,74.125.130.0-255,5020,211289,96,381475
8134,0.001993,172.31.47.0-255,66,211355,96,381475
8135,0.002566,74.125.130.0-255,1484,212839,96,381475
8136,0.002584,74.125.130.0-255,1484,214323,96,381475
8137,0.002588,172.31.47.0-255,66,214389,96,381475
8138,0.002598,74.125.130.0-255,1484,215873,96,381475
8139,0.002601,74.125.130.0-255,1484,217357,96,381475
8140,0.002609,172.31.47.0-255,66,217423,96,381475
8141,0.002614,74.125.130.0-255,4320,221743,96,381475
8142,0.002617,74.125.130.0-255,1484,223227,96,381475
8143,0.002622,172.31.47.0-255,66,223293,96,381475
8144,0.002626,74.125.130.0-255,1484,224777,96,381475
8145,0.002629,74.125.130.0-255,1484,226261,96,381475
8146,0.002631,74.125.130.0-255,1484,227745,96,381475
8147,0.002636,172.31.47.0-255,66,227811,96,381475
8148,0.00268,74.125.130.0-255,2902,230713,96,381475
8149,0.002681,172.31.47.0-255,66,230779,96,381475
8150,0.002685,172.31.47.0-255,66,230845,96,381475
8151,0.002691,74.125.130.0-255,1484,232329,96,381475
8152,0.00274,74.125.130.0-255,5020,237349,96,381475
8153,0.002744,172.31.47.0-255,66,237415,96,381475
8154,0.00293,74.125.130.0-255,1484,238899,96,381475
8155,0.00295,74.125.130.0-255,2902,241801,96,381475
8156,0.002953,172.31.47.0-255,66,241867,96,381475
8157,0.002958,74.125.130.0-255,4320,246187,96,381475
8158,0.002965,172.31.47.0-255,66,246253,96,381475
8159,0.00297,74.125.130.0-255,1484,247737,96,381475
8160,0.002972,74.125.130.0-255,1484,249221,96,381475
8161,0.002985,74.125.130.0-255,4320,253541,96,381475
8162,0.002984,172.31.47.0-255,66,253607,96,381475
8163,0.002988,172.31.47.0-255,66,253673,96,381475
8164,0.00301,74.125.130.0-255,4320,257993,96,381475
8165,0.003016,172.31.47.0-255,66,258059,96,381475
8166,0.003027,74.125.130.0-255,2543,260602,96,381475
8167,0.003029,74.125.130.0-255,1484,262086,96,381475
8168,0.003031,172.31.47.0-255,66,262152,96,381475
8169,0.003031,74.125.130.0-255,1484,263636,96,381475
8170,0.003044,74.125.130.0-255,1484,265120,96,381475
8171,0.003045,172.31.47.0-255,66,265186,96,381475
8172,0.003058,74.125.130.0-255,1484,266670,96,381475
8173,0.003066,172.31.47.0-255,66,266736,96,381475
8174,0.003079,74.125.130.0-255,4320,271056,96,381475
8175,0.003082,74.125.130.0-255,1484,272540,96,381475
8176,0.003084,74.125.130.0-255,1484,274024,96,381475
8177,0.003087,74.125.130.0-255,2902,276926,96,381475
8178,0.003088,172.31.47.0-255,66,276992,96,381475
8179,0.003091,172.31.47.0-255,66,277058,96,381475
8180,0.003101,74.125.130.0-255,1484,278542,96,381475
8181,0.00312,74.125.130.0-255,4320,282862,96,381475
8182,0.003123,74.125.130.0-255,1484,284346,96,381475
8183,0.00313,172.31.47.0-255,66,284412,96,381475
8184,0.003139,74.125.130.0-255,2902,287314,96,381475
8185,0.003141,74.125.130.0-255,1484,288798,96,381475
8186,0.003152,172.31.47.0-255,66,288864,96,381475
8187,0.003166,74.125.130.0-255,766,289630,96,381475
8188,0.003316,74.125.130.0-255,1484,291114,96,381475
8189,0.003319,172.31.47.0-255,66,291180,96,381475
8190,0.003322,74.125.130.0-255,1484,292664,96,381475
8191,0.003337,74.125.130.0-255,2902,295566,96,381475
8192,0.003342,172.31.47.0-255,66,295632,96,381475
8193,0.003362,74.125.130.0-255,5738,301370,96,381475
8194,0.003365,172.31.47.0-255,66,301436,96,381475
8195,0.00339,74.125.130.0-255,4320,305756,96,381475
8196,0.003394,172.31.47.0-255,66,305822,96,381475
8197,0.003405,74.125.130.0-255,4320,310142,96,381475
8198,0.003407,74.125.130.0-255,1484,311626,96,381475
8199,0.003413,172.31.47.0-255,66,311692,96,381475
8200,0.003427,74.125.130.0-255,1484,313176,96,381475
8201,0.003428,172.31.47.0-255,66,313242,96,381475
8202,0.003441,74.125.130.0-255,2184,315426,96,381475
8203,0.003443,74.125.130.0-255,1484,316910,96,381475
8204,0.00345,172.31.47.0-255,66,316976,96,381475
8205,0.003465,74.125.130.0-255,2902,319878,96,381475
8206,0.003475,172.31.47.0-255,66,319944,96,381475
8207,0.003477,74.125.130.0-255,1484,321428,96,381475
8208,0.003506,172.31.47.0-255,66,321494,96,381475
8209,0.003511,74.125.130.0-255,5738,327232,96,381475
8210,0.003517,172.31.47.0-255,66,327298,96,381475
8211,0.003529,74.125.130.0-255,5738,333036,96,381475
8212,0.003531,172.31.47.0-255,66,333102,96,381475
8213,0.003536,74.125.130.0-255,5738,338840,96,381475
8214,0.003546,172.31.47.0-255,66,338906,96,381475
8215,0.003549,74.125.130.0-255,2184,341090,96,381475
8216,0.003557,172.31.47.0-255,66,341156,96,381475
8217,0.003569,74.125.130.0-255,1484,342640,96,381475
8218,0.003582,74.125.130.0-255,7156,349796,96,381475
8219,0.003586,74.125.130.0-255,4320,354116,96,381475
8220,0.003594,172.31.47.0-255,66,354182,96,381475
8221,0.003621,74.125.130.0-255,4320,358502,96,381475
8222,0.003631,172.31.47.0-255,66,358568,96,381475
8223,0.00365,172.31.47.0-255,66,358634,96,381475
8224,0.003651,74.125.130.0-255,1484,360118,96,381475
8225,0.003655,74.125.130.0-255,5738,365856,96,381475
8226,0.003664,172.31.47.0-255,66,365922,96,381475
8227,0.003667,74.125.130.0-255,766,366688,96,381475
8228,0.003997,74.125.130.0-255,1484,368172,96,381475
8229,0.004001,172.31.47.0-255,66,368238,96,381475
8230,0.004005,74.125.130.0-255,2902,371140,96,381475
8231,0.004012,172.31.47.0-255,66,371206,96,381475
8232,0.004037,74.125.130.0-255,5566,376772,96,381475
8233,0.004041,172.31.47.0-255,66,376838,96,381475
8234,0.004087,74.125.130.0-255,105,376943,96,381475
8235,0.004241,172.31.47.0-255,66,377009,96,381475
8236,0.004263,172.31.47.0-255,105,377114,96,381475
8237,0.006766,74.125.130.0-255,66,377180,96,381475
8238,0.031106,172.31.47.0-255,172,377352,96,381475
8239,0.031135,172.31.47.0-255,1109,378461,96,381475
8240,0.031164,172.31.47.0-255,1514,379975,96,381475
8241,0.031166,172.31.47.0-255,1302,381277,96,381475
8242,0.032639,104.244.42.0-255,66,381343,96,381475
8243,0.032822,104.244.42.0-255,66,381409,96,381475
8244,0.032826,104.244.42.0-255,66,381475,96,381475
8245,0.0,74.125.24.0-255,152,152,96,285706
8246,2.2e-05,172.31.47.0-255,66,218,96,285706
8247,2.8e-05,74.125.24.0-255,1484,1702,96,285706
8248,3.1e-05,172.31.47.0-255,66,1768,96,285706
8249,5.6e-05,74.125.24.0-255,2902,4670,96,285706
8250,5.9e-05,172.31.47.0-255,66,4736,96,285706
8251,6.5e-05,74.125.24.0-255,5738,10474,96,285706
8252,6.7e-05,172.31.47.0-255,66,10540,96,285706
8253,0.000106,74.125.24.0-255,3463,14003,96,285706
8254,0.000109,172.31.47.0-255,66,14069,96,285706
8255,0.000146,74.125.24.0-255,4320,18389,96,285706
8256,0.000149,172.31.47.0-255,66,18455,96,285706
8257,0.000153,74.125.24.0-255,2902,21357,96,285706
8258,0.000155,172.31.47.0-255,66,21423,96,285706
8259,0.00017,74.125.24.0-255,1484,22907,96,285706
8260,0.000172,172.31.47.0-255,66,22973,96,285706
8261,0.0002,74.125.24.0-255,7156,30129,96,285706
8262,0.000207,172.31.47.0-255,66,30195,96,285706
8263,0.000209,74.125.24.0-255,1125,31320,96,285706
8264,0.000211,172.31.47.0-255,66,31386,96,285706
8265,0.000358,74.125.24.0-255,1484,32870,96,285706
8266,0.000362,172.31.47.0-255,66,32936,96,285706
8267,0.000385,74.125.24.0-255,2902,35838,96,285706
8268,0.000388,172.31.47.0-255,66,35904,96,285706
8269,0.000393,74.125.24.0-255,5738,41642,96,285706
8270,0.000395,172.31.47.0-255,66,41708,96,285706
8271,0.000432,172.31.47.0-255,66,41774,96,285706
8272,0.000458,74.125.24.0-255,2543,44317,96,285706
8273,0.00046,172.31.47.0-255,66,44383,96,285706
8274,0.000472,172.31.47.0-255,66,44449,96,285706
8275,0.000479,74.125.24.0-255,1436,45885,96,285706
8276,0.000502,74.125.24.0-255,374,46259,96,285706
8277,0.000507,172.31.47.0-255,66,46325,96,285706
8278,0.001145,74.125.24.0-255,1484,47809,96,285706
8279,0.001153,74.125.24.0-255,1484,49293,96,285706
8280,0.001156,172.31.47.0-255,66,49359,96,285706
8281,0.001178,74.125.24.0-255,1484,50843,96,285706
8282,0.001183,74.125.24.0-255,4320,55163,96,285706
8283,0.001195,74.125.24.0-255,1484,56647,96,285706
8284,0.001204,74.125.24.0-255,1484,58131,96,285706
8285,0.001218,74.125.24.0-255,5738,63869,96,285706
8286,0.001241,74.125.24.0-255,5738,69607,96,285706
8287,0.001247,74.125.24.0-255,4320,73927,96,285706
8288,0.001265,74.125.24.0-255,6438,80365,96,285706
8289,0.001324,74.125.24.0-255,1484,81849,96,285706
8290,0.001336,74.125.24.0-255,2902,84751,96,285706
8291,0.001354,74.125.24.0-255,5738,90489,96,285706
8292,0.001376,74.125.24.0-255,2902,93391,96,285706
8293,0.001434,74.125.24.0-255,2184,95575,96,285706
8294,0.001794,74.125.24.0-255,1484,97059,96,285706
8295,0.00184,74.125.24.0-255,2902,99961,96,285706
8296,0.001845,74.125.24.0-255,5738,105699,96,285706
8297,0.001873,74.125.24.0-255,2902,108601,96,285706
8298,0.001907,74.125.24.0-255,1484,110085,96,285706
8299,0.002345,74.125.24.0-255,1484,111569,96,285706
8300,0.002362,74.125.24.0-255,2902,114471,96,285706
8301,0.002367,74.125.24.0-255,4320,118791,96,285706
8302,0.002375,74.125.24.0-255,1484,120275,96,285706
8303,0.002398,74.125.24.0-255,2902,123177,96,285706
8304,0.00243,74.125.24.0-255,1484,124661,96,285706
8305,0.002435,74.125.24.0-255,4320,128981,96,285706
8306,0.002453,74.125.24.0-255,4320,133301,96,285706
8307,0.002485,74.125.24.0-255,2184,135485,96,285706
8308,0.00337,172.31.47.0-255,66,135551,96,285706
8309,0.005941,74.125.24.0-255,4320,139871,96,285706
8310,0.005946,172.31.47.0-255,66,139937,96,285706
8311,0.005976,74.125.24.0-255,1484,141421,96,285706
8312,0.0085,74.125.24.0-255,4320,145741,96,285706
8313,0.008507,172.31.47.0-255,66,145807,96,285706
8314,0.011055,74.125.24.0-255,5738,151545,96,285706
8315,0.011095,172.31.47.0-255,66,151611,96,285706
8316,0.013648,74.125.24.0-255,5738,157349,96,285706
8317,0.013654,172.31.47.0-255,66,157415,96,285706
8318,0.016216,74.125.24.0-255,5738,163153,96,285706
8319,0.016222,172.31.47.0-255,66,163219,96,285706
8320,0.018759,74.125.24.0-255,5738,168957,96,285706
8321,0.018768,172.31.47.0-255,66,169023,96,285706
8322,0.021328,74.125.24.0-255,5738,174761,96,285706
8323,0.021337,172.31.47.0-255,66,174827,96,285706
8324,0.023893,74.125.24.0-255,5738,180565,96,285706
8325,0.023901,172.31.47.0-255,66,180631,96,285706
8326,0.026484,74.125.24.0-255,2902,183533,96,285706
8327,0.02649,172.31.47.0-255,66,183599,96,285706
8328,0.026519,74.125.24.0-255,2902,186501,96,285706
8329,0.026545,172.31.47.0-255,66,186567,96,285706
8330,0.028646,172.31.47.0-255,172,186739,96,285706
8331,0.028705,172.31.47.0-255,1110,187849,96,285706
8332,0.028773,172.31.47.0-255,1514,189363,96,285706
8333,0.028775,172.31.47.0-255,1301,190664,96,285706
8334,0.029018,74.125.24.0-255,2902,193566,96,285706
8335,0.029024,172.31.47.0-255,66,193632,96,285706
8336,0.029099,74.125.24.0-255,2902,196534,96,285706
8337,0.029124,172.31.47.0-255,66,196600,96,285706
8338,0.030169,104.244.42.0-255,66,196666,96,285706
8339,0.030239,104.244.42.0-255,66,196732,96,285706
8340,0.030327,104.244.42.0-255,66,196798,96,285706
8341,0.031569,74.125.24.0-255,2902,199700,96,285706
8342,0.031574,172.31.47.0-255,66,199766,96,285706
8343,0.031668,74.125.24.0-255,2902,202668,96,285706
8344,0.031674,172.31.47.0-255,66,202734,96,285706
8345,0.034105,74.125.24.0-255,2902,205636,96,285706
8346,0.034111,172.31.47.0-255,66,205702,96,285706
8347,0.034196,74.125.24.0-255,2902,208604,96,285706
8348,0.034203,172.31.47.0-255,66,208670,96,285706
8349,0.036653,74.125.24.0-255,2902,211572,96,285706
8350,0.036659,172.31.47.0-255,66,211638,96,285706
8351,0.036752,74.125.24.0-255,2902,214540,96,285706
8352,0.037037,172.31.47.0-255,66,214606,96,285706
8353,0.039199,74.125.24.0-255,2902,217508,96,285706
8354,0.039204,172.31.47.0-255,66,217574,96,285706
8355,0.039607,74.125.24.0-255,2902,220476,96,285706
8356,0.039612,172.31.47.0-255,66,220542,96,285706
8357,0.04178,74.125.24.0-255,2902,223444,96,285706
8358,0.041785,172.31.47.0-255,66,223510,96,285706
8359,0.042186,74.125.24.0-255,2902,226412,96,285706
8360,0.042191,172.31.47.0-255,66,226478,96,285706
8361,0.044338,74.125.24.0-255,2902,229380,96,285706
8362,0.044343,172.31.47.0-255,66,229446,96,285706
8363,0.044747,74.125.24.0-255,2902,232348,96,285706
8364,0.044752,172.31.47.0-255,66,232414,96,285706
8365,0.046916,74.125.24.0-255,2902,235316,96,285706
8366,0.04692,172.31.47.0-255,66,235382,96,285706
8367,0.047294,74.125.24.0-255,2902,238284,96,285706
8368,0.047298,172.31.47.0-255,66,238350,96,285706
8369,0.049466,74.125.24.0-255,2902,241252,96,285706
8370,0.04947,172.31.47.0-255,66,241318,96,285706
8371,0.049899,74.125.24.0-255,2902,244220,96,285706
8372,0.049903,172.31.47.0-255,66,244286,96,285706
8373,0.052,74.125.24.0-255,2902,247188,96,285706
8374,0.052004,172.31.47.0-255,66,247254,96,285706
8375,0.052462,74.125.24.0-255,2902,250156,96,285706
8376,0.052467,172.31.47.0-255,66,250222,96,285706
8377,0.054577,74.125.24.0-255,2902,253124,96,285706
8378,0.054583,172.31.47.0-255,66,253190,96,285706
8379,0.055022,74.125.24.0-255,2902,256092,96,285706
8380,0.055026,172.31.47.0-255,66,256158,96,285706
8381,0.057172,74.125.24.0-255,2902,259060,96,285706
8382,0.057177,172.31.47.0-255,66,259126,96,285706
8383,0.057567,74.125.24.0-255,2902,262028,96,285706
8384,0.057573,172.31.47.0-255,66,262094,96,285706
8385,0.059723,74.125.24.0-255,2902,264996,96,285706
8386,0.059728,172.31.47.0-255,66,265062,96,285706
8387,0.060132,74.125.24.0-255,2902,267964,96,285706
8388,0.060137,172.31.47.0-255,66,268030,96,285706
8389,0.062284,74.125.24.0-255,2902,270932,96,285706
8390,0.062288,172.31.47.0-255,66,270998,96,285706
8391,0.062703,74.125.24.0-255,2902,273900,96,285706
8392,0.062707,172.31.47.0-255,66,273966,96,285706
8393,0.064833,74.125.24.0-255,1484,275450,96,285706
8394,0.065259,74.125.24.0-255,4320,279770,96,285706
8395,0.065307,172.31.47.0-255,66,279836,96,285706
8396,0.067876,74.125.24.0-255,4320,284156,96,285706
8397,0.067881,172.31.47.0-255,66,284222,96,285706
8398,0.067909,74.125.24.0-255,1484,285706,96,285706
8399,0.0,74.125.24.0-255,146,146,96,270951
8400,1.5e-05,172.31.47.0-255,66,212,96,270951
8401,2.1e-05,74.125.24.0-255,1484,1696,96,270951
8402,2.6e-05,172.31.47.0-255,66,1762,96,270951
8403,3.1e-05,74.125.24.0-255,2902,4664,96,270951
8404,3.4e-05,172.31.47.0-255,66,4730,96,270951
8405,3.8e-05,74.125.24.0-255,2902,7632,96,270951
8406,4e-05,172.31.47.0-255,66,7698,96,270951
8407,6.2e-05,74.125.24.0-255,4320,12018,96,270951
8408,6.5e-05,172.31.47.0-255,66,12084,96,270951
8409,6.8e-05,74.125.24.0-255,2148,14232,96,270951
8410,7e-05,172.31.47.0-255,66,14298,96,270951
8411,0.000718,74.125.24.0-255,1484,15782,96,270951
8412,0.000724,172.31.47.0-255,66,15848,96,270951
8413,0.000733,74.125.24.0-255,2902,18750,96,270951
8414,0.000735,172.31.47.0-255,66,18816,96,270951
8415,0.000742,74.125.24.0-255,5738,24554,96,270951
8416,0.000743,172.31.47.0-255,66,24620,96,270951
8417,0.000772,74.125.24.0-255,6797,31417,96,270951
8418,0.000775,172.31.47.0-255,66,31483,96,270951
8419,0.000789,74.125.24.0-255,4320,35803,96,270951
8420,0.000792,172.31.47.0-255,66,35869,96,270951
8421,0.000825,172.31.47.0-255,66,35935,96,270951
8422,0.00083,74.125.24.0-255,2543,38478,96,270951
8423,0.000832,172.31.47.0-255,66,38544,96,270951
8424,0.001495,74.125.24.0-255,1484,40028,96,270951
8425,0.001501,172.31.47.0-255,66,40094,96,270951
8426,0.001507,74.125.24.0-255,2902,42996,96,270951
8427,0.001509,172.31.47.0-255,66,43062,96,270951
8428,0.00156,74.125.24.0-255,5738,48800,96,270951
8429,0.001562,172.31.47.0-255,66,48866,96,270951
8430,0.001574,172.31.47.0-255,66,48932,96,270951
8431,0.001589,74.125.24.0-255,5379,54311,96,270951
8432,0.001592,172.31.47.0-255,66,54377,96,270951
8433,0.001624,74.125.24.0-255,1484,55861,96,270951
8434,0.001627,172.31.47.0-255,66,55927,96,270951
8435,0.001652,172.31.47.0-255,66,55993,96,270951
8436,0.001658,74.125.24.0-255,4320,60313,96,270951
8437,0.00166,172.31.47.0-255,66,60379,96,270951
8438,0.001677,74.125.24.0-255,7156,67535,96,270951
8439,0.00168,172.31.47.0-255,66,67601,96,270951
8440,0.001686,74.125.24.0-255,5379,72980,96,270951
8441,0.001689,172.31.47.0-255,66,73046,96,270951
8442,0.002304,74.125.24.0-255,1484,74530,96,270951
8443,0.002309,172.31.47.0-255,66,74596,96,270951
8444,0.002316,74.125.24.0-255,2902,77498,96,270951
8445,0.002318,172.31.47.0-255,66,77564,96,270951
8446,0.002325,74.125.24.0-255,5738,83302,96,270951
8447,0.002327,172.31.47.0-255,66,83368,96,270951
8448,0.002354,74.125.24.0-255,7156,90524,96,270951
8449,0.002357,172.31.47.0-255,66,90590,96,270951
8450,0.00238,74.125.24.0-255,5738,96328,96,270951
8451,0.002383,172.31.47.0-255,66,96394,96,270951
8452,0.00239,74.125.24.0-255,4320,100714,96,270951
8453,0.002392,172.31.47.0-255,66,100780,96,270951
8454,0.002408,74.125.24.0-255,2902,103682,96,270951
8455,0.002411,172.31.47.0-255,66,103748,96,270951
8456,0.004752,74.125.24.0-255,5738,109486,96,270951
8457,0.004758,172.31.47.0-255,66,109552,96,270951
8458,0.007102,74.125.24.0-255,5738,115290,96,270951
8459,0.00711,172.31.47.0-255,66,115356,96,270951
8460,0.009467,74.125.24.0-255,5738,121094,96,270951
8461,0.009475,172.31.47.0-255,66,121160,96,270951
8462,0.011834,74.125.24.0-255,4320,125480,96,270951
8463,0.011841,172.31.47.0-255,66,125546,96,270951
8464,0.011862,74.125.24.0-255,1484,127030,96,270951
8465,0.011864,172.31.47.0-255,66,127096,96,270951
8466,0.014177,74.125.24.0-255,4320,131416,96,270951
8467,0.014186,172.31.47.0-255,66,131482,96,270951
8468,0.014212,74.125.24.0-255,1484,132966,96,270951
8469,0.014215,172.31.47.0-255,66,133032,96,270951
8470,0.016524,74.125.24.0-255,4320,137352,96,270951
8471,0.01653,172.31.47.0-255,66,137418,96,270951
8472,0.016548,74.125.24.0-255,1484,138902,96,270951
8473,0.01655,172.31.47.0-255,66,138968,96,270951
8474,0.018892,74.125.24.0-255,5738,144706,96,270951
8475,0.018901,172.31.47.0-255,66,144772,96,270951
8476,0.020982,172.31.47.0-255,172,144944,96,270951
8477,0.021009,172.31.47.0-255,1101,146045,96,270951
8478,0.021068,172.31.47.0-255,1514,147559,96,270951
8479,0.02107,172.31.47.0-255,1310,148869,96,270951
8480,0.021268,74.125.24.0-255,5738,154607,96,270951
8481,0.021274,172.31.47.0-255,66,154673,96,270951
8482,0.022513,104.244.42.0-255,66,154739,96,270951
8483,0.022565,104.244.42.0-255,66,154805,96,270951
8484,0.022605,104.244.42.0-255,66,154871,96,270951
8485,0.023639,74.125.24.0-255,5738,160609,96,270951
8486,0.023647,172.31.47.0-255,66,160675,96,270951
8487,0.026021,74.125.24.0-255,5738,166413,96,270951
8488,0.02603,172.31.47.0-255,66,166479,96,270951
8489,0.028401,74.125.24.0-255,5738,172217,96,270951
8490,0.028408,172.31.47.0-255,66,172283,96,270951
8491,0.030797,74.125.24.0-255,5738,178021,96,270951
8492,0.030804,172.31.47.0-255,66,178087,96,270951
8493,0.033199,74.125.24.0-255,5738,183825,96,270951
8494,0.033206,172.31.47.0-255,66,183891,96,270951
8495,0.035552,74.125.24.0-255,5738,189629,96,270951
8496,0.035559,172.31.47.0-255,66,189695,96,270951
8497,0.037922,74.125.24.0-255,5738,195433,96,270951
8498,0.037928,172.31.47.0-255,66,195499,96,270951
8499,0.040274,74.125.24.0-255,5738,201237,96,270951
8500,0.040281,172.31.47.0-255,66,201303,96,270951
8501,0.04264,74.125.24.0-255,5738,207041,96,270951
8502,0.042647,172.31.47.0-255,66,207107,96,270951
8503,0.044994,74.125.24.0-255,5738,212845,96,270951
8504,0.044999,172.31.47.0-255,66,212911,96,270951
8505,0.047426,74.125.24.0-255,5738,218649,96,270951
8506,0.047431,172.31.47.0-255,66,218715,96,270951
8507,0.049818,74.125.24.0-255,5738,224453,96,270951
8508,0.049824,172.31.47.0-255,66,224519,96,270951
8509,0.052193,74.125.24.0-255,5738,230257,96,270951
8510,0.0522,172.31.47.0-255,66,230323,96,270951
8511,0.054582,74.125.24.0-255,5738,236061,96,270951
8512,0.054599,172.31.47.0-255,66,236127,96,270951
8513,0.056958,74.125.24.0-255,5738,241865,96,270951
8514,0.056972,172.31.47.0-255,66,241931,96,270951
8515,0.059353,74.125.24.0-255,5738,247669,96,270951
8516,0.059368,172.31.47.0-255,66,247735,96,270951
8517,0.06173,74.125.24.0-255,5738,253473,96,270951
8518,0.061741,172.31.47.0-255,66,253539,96,270951
8519,0.064137,74.125.24.0-255,5738,259277,96,270951
8520,0.064154,172.31.47.0-255,66,259343,96,270951
8521,0.066549,74.125.24.0-255,5738,265081,96,270951
8522,0.066565,172.31.47.0-255,66,265147,96,270951
8523,0.068936,74.125.24.0-255,5738,270885,96,270951
8524,0.068953,172.31.47.0-255,66,270951,96,270951
8525,0.0,172.217.194.0-255,298,298,96,310855
8526,4e-05,172.31.47.0-255,66,364,96,310855
8527,4.8e-05,172.217.194.0-255,1484,1848,96,310855
8528,5.3e-05,172.31.47.0-255,66,1914,96,310855
8529,5.9e-05,172.217.194.0-255,4320,6234,96,310855
8530,6.2e-05,172.31.47.0-255,66,6300,96,310855
8531,8e-05,172.31.47.0-255,66,6366,96,310855
8532,0.000207,172.217.194.0-255,1484,7850,96,310855
8533,0.000211,172.31.47.0-255,66,7916,96,310855
8534,0.00024,172.217.194.0-255,2902,10818,96,310855
8535,0.000242,172.31.47.0-255,66,10884,96,310855
8536,0.00025,172.217.194.0-255,5738,16622,96,310855
8537,0.000253,172.31.47.0-255,66,16688,96,310855
8538,0.00029,172.217.194.0-255,6797,23485,96,310855
8539,0.000295,172.31.47.0-255,66,23551,96,310855
8540,0.000313,172.31.47.0-255,66,23617,96,310855
8541,0.000317,172.217.194.0-255,2543,26160,96,310855
8542,0.000319,172.31.47.0-255,66,26226,96,310855
8543,0.000324,172.217.194.0-255,2902,29128,96,310855
8544,0.000327,172.31.47.0-255,66,29194,96,310855
8545,0.000331,172.217.194.0-255,2902,32096,96,310855
8546,0.000334,172.31.47.0-255,66,32162,96,310855
8547,0.000367,172.217.194.0-255,4320,36482,96,310855
8548,0.00037,172.31.47.0-255,66,36548,96,310855
8549,0.000378,172.217.194.0-255,7049,43597,96,310855
8550,0.000381,172.31.47.0-255,66,43663,96,310855
8551,0.000384,172.217.194.0-255,433,44096,96,310855
8552,0.000385,172.31.47.0-255,66,44162,96,310855
8553,0.000509,172.217.194.0-255,1484,45646,96,310855
8554,0.000513,172.31.47.0-255,66,45712,96,310855
8555,0.000518,172.217.194.0-255,2902,48614,96,310855
8556,0.00052,172.31.47.0-255,66,48680,96,310855
8557,0.000556,172.217.194.0-255,5738,54418,96,310855
8558,0.000559,172.31.47.0-255,66,54484,96,310855
8559,0.000567,172.217.194.0-255,6797,61281,96,310855
8560,0.000569,172.31.47.0-255,66,61347,96,310855
8561,0.000601,172.217.194.0-255,7156,68503,96,310855
8562,0.000604,172.31.47.0-255,66,68569,96,310855
8563,0.000631,172.31.47.0-255,66,68635,96,310855
8564,0.000657,172.217.194.0-255,1125,69760,96,310855
8565,0.001076,172.217.194.0-255,1484,71244,96,310855
8566,0.001081,172.31.47.0-255,66,71310,96,310855
8567,0.001086,172.217.194.0-255,2902,74212,96,310855
8568,0.001089,172.31.47.0-255,66,74278,96,310855
8569,0.001093,172.217.194.0-255,2902,77180,96,310855
8570,0.001102,172.31.47.0-255,66,77246,96,310855
8571,0.001139,172.217.194.0-255,2902,80148,96,310855
8572,0.001145,172.31.47.0-255,66,80214,96,310855
8573,0.001151,172.31.47.0-255,66,80280,96,310855
8574,0.001162,172.31.47.0-255,66,80346,96,310855
8575,0.001165,172.217.194.0-255,766,81112,96,310855
8576,0.001474,172.31.47.0-255,66,81178,96,310855
8577,0.001585,172.217.194.0-255,1484,82662,96,310855
8578,0.001594,172.217.194.0-255,2902,85564,96,310855
8579,0.001597,172.31.47.0-255,66,85630,96,310855
8580,0.001604,172.217.194.0-255,5738,91368,96,310855
8581,0.001607,172.31.47.0-255,66,91434,96,310855
8582,0.001644,172.31.47.0-255,66,91500,96,310855
8583,0.001655,172.31.47.0-255,66,91566,96,310855
8584,0.001686,172.217.194.0-255,2184,93750,96,310855
8585,0.001689,172.31.47.0-255,66,93816,96,310855
8586,0.001884,172.217.194.0-255,1484,95300,96,310855
8587,0.001892,172.217.194.0-255,2902,98202,96,310855
8588,0.001895,172.31.47.0-255,66,98268,96,310855
8589,0.001902,172.217.194.0-255,5738,104006,96,310855
8590,0.001904,172.31.47.0-255,66,104072,96,310855
8591,0.001989,172.31.47.0-255,66,104138,96,310855
8592,0.001995,172.217.194.0-255,5738,109876,96,310855
8593,0.001997,172.31.47.0-255,66,109942,96,310855
8594,0.002003,172.217.194.0-255,5020,114962,96,310855
8595,0.002005,172.31.47.0-255,66,115028,96,310855
8596,0.004023,172.217.194.0-255,5738,120766,96,310855
8597,0.004031,172.31.47.0-255,66,120832,96,310855
8598,0.006052,172.217.194.0-255,5738,126570,96,310855
8599,0.00606,172.31.47.0-255,66,126636,96,310855
8600,0.008078,172.217.194.0-255,5738,132374,96,310855
8601,0.008086,172.31.47.0-255,66,132440,96,310855
8602,0.010103,172.217.194.0-255,5738,138178,96,310855
8603,0.010114,172.31.47.0-255,66,138244,96,310855
8604,0.012143,172.217.194.0-255,5738,143982,96,310855
8605,0.012156,172.31.47.0-255,66,144048,96,310855
8606,0.014171,172.217.194.0-255,5738,149786,96,310855
8607,0.014187,172.31.47.0-255,66,149852,96,310855
8608,0.016206,172.217.194.0-255,5738,155590,96,310855
8609,0.016224,172.31.47.0-255,66,155656,96,310855
8610,0.018238,172.217.194.0-255,5738,161394,96,310855
8611,0.018252,172.31.47.0-255,66,161460,96,310855
8612,0.020281,172.217.194.0-255,5738,167198,96,310855
8613,0.020302,172.31.47.0-255,66,167264,96,310855
8614,0.022337,172.217.194.0-255,5738,173002,96,310855
8615,0.022354,172.31.47.0-255,66,173068,96,310855
8616,0.024388,172.217.194.0-255,5738,178806,96,310855
8617,0.024405,172.31.47.0-255,66,178872,96,310855
8618,0.026409,172.217.194.0-255,5738,184610,96,310855
8619,0.026425,172.31.47.0-255,66,184676,96,310855
8620,0.028447,172.217.194.0-255,5738,190414,96,310855
8621,0.028461,172.31.47.0-255,66,190480,96,310855
8622,0.029746,172.31.47.0-255,172,190652,96,310855
8623,0.029791,172.31.47.0-255,1105,191757,96,310855
8624,0.029863,172.31.47.0-255,1514,193271,96,310855
8625,0.029865,172.31.47.0-255,1306,194577,96,310855
8626,0.030471,172.217.194.0-255,5738,200315,96,310855
8627,0.030481,172.31.47.0-255,66,200381,96,310855
8628,0.031291,104.244.42.0-255,66,200447,96,310855
8629,0.031339,104.244.42.0-255,66,200513,96,310855
8630,0.031437,104.244.42.0-255,66,200579,96,310855
8631,0.032492,172.217.194.0-255,5738,206317,96,310855
8632,0.032501,172.31.47.0-255,66,206383,96,310855
8633,0.034528,172.217.194.0-255,5738,212121,96,310855
8634,0.034547,172.31.47.0-255,66,212187,96,310855
8635,0.036575,172.217.194.0-255,5738,217925,96,310855
8636,0.036591,172.31.47.0-255,66,217991,96,310855
8637,0.038604,172.217.194.0-255,5738,223729,96,310855
8638,0.038615,172.31.47.0-255,66,223795,96,310855
8639,0.040712,172.217.194.0-255,5738,229533,96,310855
8640,0.040721,172.31.47.0-255,66,229599,96,310855
8641,0.042743,172.217.194.0-255,5738,235337,96,310855
8642,0.042752,172.31.47.0-255,66,235403,96,310855
8643,0.044757,172.217.194.0-255,5738,241141,96,310855
8644,0.044763,172.31.47.0-255,66,241207,96,310855
8645,0.046772,172.217.194.0-255,5738,246945,96,310855
8646,0.046779,172.31.47.0-255,66,247011,96,310855
8647,0.048795,172.217.194.0-255,5738,252749,96,310855
8648,0.048802,172.31.47.0-255,66,252815,96,310855
8649,0.050815,172.217.194.0-255,5738,258553,96,310855
8650,0.050822,172.31.47.0-255,66,258619,96,310855
8651,0.052845,172.217.194.0-255,5738,264357,96,310855
8652,0.052852,172.31.47.0-255,66,264423,96,310855
8653,0.05486,172.217.194.0-255,5738,270161,96,310855
8654,0.054867,172.31.47.0-255,66,270227,96,310855
8655,0.056909,172.217.194.0-255,5738,275965,96,310855
8656,0.056918,172.31.47.0-255,66,276031,96,310855
8657,0.058968,172.217.194.0-255,5738,281769,96,310855
8658,0.058976,172.31.47.0-255,66,281835,96,310855
8659,0.061024,172.217.194.0-255,5738,287573,96,310855
8660,0.061032,172.31.47.0-255,66,287639,96,310855
8661,0.063045,172.217.194.0-255,5738,293377,96,310855
8662,0.063052,172.31.47.0-255,66,293443,96,310855
8663,0.065071,172.217.194.0-255,5738,299181,96,310855
8664,0.065078,172.31.47.0-255,66,299247,96,310855
8665,0.067087,172.217.194.0-255,5738,304985,96,310855
8666,0.067094,172.31.47.0-255,66,305051,96,310855
8667,0.069115,172.217.194.0-255,5738,310789,96,310855
8668,0.069121,172.31.47.0-255,66,310855,96,310855
8669,0.0,172.217.194.0-255,153,153,96,304790
8670,2.2e-05,172.31.47.0-255,66,219,96,304790
8671,2.9e-05,172.217.194.0-255,1484,1703,96,304790
8672,3.4e-05,172.31.47.0-255,66,1769,96,304790
8673,4.1e-05,172.217.194.0-255,2902,4671,96,304790
8674,4.4e-05,172.31.47.0-255,66,4737,96,304790
8675,5.3e-05,172.217.194.0-255,7156,11893,96,304790
8676,5.7e-05,172.31.47.0-255,66,11959,96,304790
8677,8e-05,172.217.194.0-255,2008,13967,96,304790
8678,8.3e-05,172.31.47.0-255,66,14033,96,304790
8679,0.000101,172.217.194.0-255,4320,18353,96,304790
8680,0.000104,172.31.47.0-255,66,18419,96,304790
8681,0.000117,172.217.194.0-255,4320,22739,96,304790
8682,0.00012,172.31.47.0-255,66,22805,96,304790
8683,0.000139,172.217.194.0-255,2902,25707,96,304790
8684,0.000141,172.31.47.0-255,66,25773,96,304790
8685,0.000148,172.217.194.0-255,5379,31152,96,304790
8686,0.00015,172.31.47.0-255,66,31218,96,304790
8687,0.000296,172.217.194.0-255,1484,32702,96,304790
8688,0.0003,172.31.47.0-255,66,32768,96,304790
8689,0.000305,172.217.194.0-255,1484,34252,96,304790
8690,0.000307,172.31.47.0-255,66,34318,96,304790
8691,0.00032,172.217.194.0-255,1484,35802,96,304790
8692,0.000323,172.31.47.0-255,66,35868,96,304790
8693,0.00033,172.217.194.0-255,5738,41606,96,304790
8694,0.000333,172.31.47.0-255,66,41672,96,304790
8695,0.000373,172.217.194.0-255,2902,44574,96,304790
8696,0.000376,172.31.47.0-255,66,44640,96,304790
8697,0.000404,172.31.47.0-255,66,44706,96,304790
8698,0.00041,172.217.194.0-255,5738,50444,96,304790
8699,0.000413,172.31.47.0-255,66,50510,96,304790
8700,0.000434,172.217.194.0-255,5738,56248,96,304790
8701,0.000436,172.31.47.0-255,66,56314,96,304790
8702,0.000439,172.217.194.0-255,1382,57696,96,304790
8703,0.000441,172.31.47.0-255,66,57762,96,304790
8704,0.000444,172.217.194.0-255,117,57879,96,304790
8705,0.000446,172.31.47.0-255,66,57945,96,304790
8706,0.000498,172.217.194.0-255,378,58323,96,304790
8707,0.000501,172.31.47.0-255,66,58389,96,304790
8708,0.000623,172.217.194.0-255,1484,59873,96,304790
8709,0.000627,172.31.47.0-255,66,59939,96,304790
8710,0.000633,172.217.194.0-255,2902,62841,96,304790
8711,0.000635,172.31.47.0-255,66,62907,96,304790
8712,0.00065,172.217.194.0-255,2902,65809,96,304790
8713,0.000654,172.31.47.0-255,66,65875,96,304790
8714,0.000665,172.217.194.0-255,2902,68777,96,304790
8715,0.000668,172.31.47.0-255,66,68843,96,304790
8716,0.000672,172.217.194.0-255,2902,71745,96,304790
8717,0.000674,172.31.47.0-255,66,71811,96,304790
8718,0.000699,172.217.194.0-255,2902,74713,96,304790
8719,0.000701,172.31.47.0-255,66,74779,96,304790
8720,0.000716,172.31.47.0-255,66,74845,96,304790
8721,0.000722,172.217.194.0-255,5020,79865,96,304790
8722,0.000724,172.31.47.0-255,66,79931,96,304790
8723,0.001176,172.217.194.0-255,1484,81415,96,304790
8724,0.001197,172.217.194.0-255,2902,84317,96,304790
8725,0.0012,172.31.47.0-255,66,84383,96,304790
8726,0.001207,172.217.194.0-255,5738,90121,96,304790
8727,0.001209,172.31.47.0-255,66,90187,96,304790
8728,0.001249,172.217.194.0-255,4320,94507,96,304790
8729,0.001254,172.31.47.0-255,66,94573,96,304790
8730,0.00126,172.31.47.0-255,66,94639,96,304790
8731,0.001263,172.217.194.0-255,1484,96123,96,304790
8732,0.001304,172.217.194.0-255,5020,101143,96,304790
8733,0.001307,172.31.47.0-255,66,101209,96,304790
8734,0.001546,172.217.194.0-255,1484,102693,96,304790
8735,0.001562,172.217.194.0-255,2902,105595,96,304790
8736,0.001566,172.31.47.0-255,66,105661,96,304790
8737,0.001572,172.217.194.0-255,5738,111399,96,304790
8738,0.001573,172.31.47.0-255,66,111465,96,304790
8739,0.001602,172.217.194.0-255,4320,115785,96,304790
8740,0.001604,172.31.47.0-255,66,115851,96,304790
8741,0.00163,172.31.47.0-255,66,115917,96,304790
8742,0.001655,172.217.194.0-255,1484,117401,96,304790
8743,0.001683,172.31.47.0-255,66,117467,96,304790
8744,0.003724,172.217.194.0-255,5738,123205,96,304790
8745,0.00373,172.31.47.0-255,66,123271,96,304790
8746,0.005814,172.217.194.0-255,4320,127591,96,304790
8747,0.005818,172.31.47.0-255,66,127657,96,304790
8748,0.005832,172.217.194.0-255,1484,129141,96,304790
8749,0.007876,172.217.194.0-255,4320,133461,96,304790
8750,0.007883,172.31.47.0-255,66,133527,96,304790
8751,0.009924,172.217.194.0-255,5738,139265,96,304790
8752,0.009932,172.31.47.0-255,66,139331,96,304790
8753,0.011948,172.217.194.0-255,5738,145069,96,304790
8754,0.011955,172.31.47.0-255,66,145135,96,304790
8755,0.01401,172.217.194.0-255,5738,150873,96,304790
8756,0.014018,172.31.47.0-255,66,150939,96,304790
8757,0.016088,172.217.194.0-255,5738,156677,96,304790
8758,0.016096,172.31.47.0-255,66,156743,96,304790
8759,0.018211,172.217.194.0-255,5738,162481,96,304790
8760,0.018216,172.31.47.0-255,66,162547,96,304790
8761,0.020244,172.217.194.0-255,5738,168285,96,304790
8762,0.020252,172.31.47.0-255,66,168351,96,304790
8763,0.022303,172.217.194.0-255,5738,174089,96,304790
8764,0.02231,172.31.47.0-255,66,174155,96,304790
8765,0.02436,172.217.194.0-255,5738,179893,96,304790
8766,0.024366,172.31.47.0-255,66,179959,96,304790
8767,0.025612,172.31.47.0-255,176,180135,96,304790
8768,0.025643,172.31.47.0-255,1111,181246,96,304790
8769,0.025696,172.31.47.0-255,1514,182760,96,304790
8770,0.025698,172.31.47.0-255,1300,184060,96,304790
8771,0.026382,172.217.194.0-255,5738,189798,96,304790
8772,0.026389,172.31.47.0-255,66,189864,96,304790
8773,0.027172,104.244.42.0-255,66,189930,96,304790
8774,0.027214,104.244.42.0-255,66,189996,96,304790
8775,0.027254,104.244.42.0-255,66,190062,96,304790
8776,0.028459,172.217.194.0-255,5738,195800,96,304790
8777,0.028464,172.31.47.0-255,66,195866,96,304790
8778,0.030473,172.217.194.0-255,5738,201604,96,304790
8779,0.03048,172.31.47.0-255,66,201670,96,304790
8780,0.032569,172.217.194.0-255,5738,207408,96,304790
8781,0.032575,172.31.47.0-255,66,207474,96,304790
8782,0.034591,172.217.194.0-255,4320,211794,96,304790
8783,0.034596,172.31.47.0-255,66,211860,96,304790
8784,0.034613,172.217.194.0-255,1484,213344,96,304790
8785,0.036658,172.217.194.0-255,4320,217664,96,304790
8786,0.036664,172.31.47.0-255,66,217730,96,304790
8787,0.038719,172.217.194.0-255,5738,223468,96,304790
8788,0.038725,172.31.47.0-255,66,223534,96,304790
8789,0.040778,172.217.194.0-255,5738,229272,96,304790
8790,0.040784,172.31.47.0-255,66,229338,96,304790
8791,0.042824,172.217.194.0-255,5738,235076,96,304790
8792,0.042829,172.31.47.0-255,66,235142,96,304790
8793,0.044873,172.217.194.0-255,5738,240880,96,304790
8794,0.044878,172.31.47.0-255,66,240946,96,304790
8795,0.046931,172.217.194.0-255,5738,246684,96,304790
8796,0.046937,172.31.47.0-255,66,246750,96,304790
8797,0.048976,172.217.194.0-255,5738,252488,96,304790
8798,0.048983,172.31.47.0-255,66,252554,96,304790
8799,0.051066,172.217.194.0-255,5738,258292,96,304790
8800,0.051072,172.31.47.0-255,66,258358,96,304790
8801,0.053089,172.217.194.0-255,5738,264096,96,304790
8802,0.053094,172.31.47.0-255,66,264162,96,304790
8803,0.055111,172.217.194.0-255,5738,269900,96,304790
8804,0.055117,172.31.47.0-255,66,269966,96,304790
8805,0.057147,172.217.194.0-255,5738,275704,96,304790
8806,0.057153,172.31.47.0-255,66,275770,96,304790
8807,0.059181,172.217.194.0-255,5738,281508,96,304790
8808,0.059188,172.31.47.0-255,66,281574,96,304790
8809,0.061222,172.217.194.0-255,5738,287312,96,304790
8810,0.061228,172.31.47.0-255,66,287378,96,304790
8811,0.063257,172.217.194.0-255,5738,293116,96,304790
8812,0.063264,172.31.47.0-255,66,293182,96,304790
8813,0.065319,172.217.194.0-255,5738,298920,96,304790
8814,0.065326,172.31.47.0-255,66,298986,96,304790
8815,0.068135,172.217.194.0-255,5738,304724,96,304790
8816,0.068141,172.31.47.0-255,66,304790,96,304790
8817,0.0,74.125.24.0-255,153,153,96,271506
8818,2.2e-05,172.31.47.0-255,66,219,96,271506
8819,2.8e-05,74.125.24.0-255,1484,1703,96,271506
8820,3.2e-05,172.31.47.0-255,66,1769,96,271506
8821,5.2e-05,74.125.24.0-255,1484,3253,96,271506
8822,5.4e-05,172.31.47.0-255,66,3319,96,271506
8823,6.2e-05,74.125.24.0-255,2902,6221,96,271506
8824,6.6e-05,172.31.47.0-255,66,6287,96,271506
8825,7e-05,74.125.24.0-255,4320,10607,96,271506
8826,7.2e-05,172.31.47.0-255,66,10673,96,271506
8827,9.9e-05,74.125.24.0-255,1484,12157,96,271506
8828,0.000101,172.31.47.0-255,66,12223,96,271506
8829,0.000105,74.125.24.0-255,1938,14161,96,271506
8830,0.000107,172.31.47.0-255,66,14227,96,271506
8831,0.000132,74.125.24.0-255,1484,15711,96,271506
8832,0.000134,172.31.47.0-255,66,15777,96,271506
8833,0.000157,74.125.24.0-255,2902,18679,96,271506
8834,0.00016,172.31.47.0-255,66,18745,96,271506
8835,0.000163,74.125.24.0-255,2902,21647,96,271506
8836,0.000165,172.31.47.0-255,66,21713,96,271506
8837,0.000186,74.125.24.0-255,2902,24615,96,271506
8838,0.000188,172.31.47.0-255,66,24681,96,271506
8839,0.000196,74.125.24.0-255,2902,27583,96,271506
8840,0.000198,172.31.47.0-255,66,27649,96,271506
8841,0.000224,74.125.24.0-255,2902,30551,96,271506
8842,0.000226,172.31.47.0-255,66,30617,96,271506
8843,0.000237,74.125.24.0-255,1125,31742,96,271506
8844,0.00024,172.31.47.0-255,66,31808,96,271506
8845,0.00025,172.31.47.0-255,66,31874,96,271506
8846,0.000253,74.125.24.0-255,1484,33358,96,271506
8847,0.00026,172.31.47.0-255,66,33424,96,271506
8848,0.000302,74.125.24.0-255,6797,40221,96,271506
8849,0.000309,172.31.47.0-255,66,40287,96,271506
8850,0.000349,74.125.24.0-255,5738,46025,96,271506
8851,0.000354,172.31.47.0-255,66,46091,96,271506
8852,0.000359,74.125.24.0-255,1484,47575,96,271506
8853,0.000365,74.125.24.0-255,5738,53313,96,271506
8854,0.00038,172.31.47.0-255,66,53379,96,271506
8855,0.000383,74.125.24.0-255,2902,56281,96,271506
8856,0.000386,74.125.24.0-255,1125,57406,96,271506
8857,0.000393,172.31.47.0-255,66,57472,96,271506
8858,0.000448,74.125.24.0-255,394,57866,96,271506
8859,0.000472,74.125.24.0-255,115,57981,96,271506
8860,0.000556,74.125.24.0-255,1484,59465,96,271506
8861,0.000561,74.125.24.0-255,2902,62367,96,271506
8862,0.000561,172.31.47.0-255,66,62433,96,271506
8863,0.000563,74.125.24.0-255,1484,63917,96,271506
8864,0.000566,172.31.47.0-255,66,63983,96,271506
8865,0.000589,74.125.24.0-255,4320,68303,96,271506
8866,0.000595,172.31.47.0-255,66,68369,96,271506
8867,0.000599,74.125.24.0-255,2902,71271,96,271506
8868,0.00061,172.31.47.0-255,66,71337,96,271506
8869,0.000616,74.125.24.0-255,4227,75564,96,271506
8870,0.000621,172.31.47.0-255,66,75630,96,271506
8871,0.00099,74.125.24.0-255,1484,77114,96,271506
8872,0.000994,172.31.47.0-255,66,77180,96,271506
8873,0.001002,74.125.24.0-255,2902,80082,96,271506
8874,0.001006,74.125.24.0-255,2902,82984,96,271506
8875,0.001033,74.125.24.0-255,2902,85886,96,271506
8876,0.001062,74.125.24.0-255,2902,88788,96,271506
8877,0.001684,74.125.24.0-255,1484,90272,96,271506
8878,0.001699,74.125.24.0-255,2902,93174,96,271506
8879,0.001714,74.125.24.0-255,4320,97494,96,271506
8880,0.001723,74.125.24.0-255,1484,98978,96,271506
8881,0.001727,74.125.24.0-255,4320,103298,96,271506
8882,0.001736,74.125.24.0-255,1484,104782,96,271506
8883,0.001766,74.125.24.0-255,1484,106266,96,271506
8884,0.001779,74.125.24.0-255,7156,113422,96,271506
8885,0.001792,74.125.24.0-255,4320,117742,96,271506
8886,0.001797,74.125.24.0-255,5020,122762,96,271506
8887,0.001832,74.125.24.0-255,1484,124246,96,271506
8888,0.001867,74.125.24.0-255,1484,125730,96,271506
8889,0.001908,74.125.24.0-255,766,126496,96,271506
8890,0.002037,74.125.24.0-255,1484,127980,96,271506
8891,0.00205,74.125.24.0-255,1484,129464,96,271506
8892,0.002072,74.125.24.0-255,1484,130948,96,271506
8893,0.002077,74.125.24.0-255,5738,136686,96,271506
8894,0.002095,74.125.24.0-255,1484,138170,96,271506
8895,0.002107,74.125.24.0-255,2902,141072,96,271506
8896,0.002112,74.125.24.0-255,5738,146810,96,271506
8897,0.002165,74.125.24.0-255,5738,152548,96,271506
8898,0.002178,74.125.24.0-255,2902,155450,96,271506
8899,0.002192,74.125.24.0-255,4320,159770,96,271506
8900,0.002203,74.125.24.0-255,766,160536,96,271506
8901,0.00232,74.125.24.0-255,1484,162020,96,271506
8902,0.002335,74.125.24.0-255,2902,164922,96,271506
8903,0.002339,74.125.24.0-255,2902,167824,96,271506
8904,0.002348,74.125.24.0-255,2902,170726,96,271506
8905,0.002357,74.125.24.0-255,2902,173628,96,271506
8906,0.002374,74.125.24.0-255,5738,179366,96,271506
8907,0.002386,74.125.24.0-255,4320,183686,96,271506
8908,0.002388,74.125.24.0-255,1484,185170,96,271506
8909,0.002407,74.125.24.0-255,7156,192326,96,271506
8910,0.002426,74.125.24.0-255,2184,194510,96,271506
8911,0.002441,74.125.24.0-255,1484,195994,96,271506
8912,0.002482,74.125.24.0-255,1484,197478,96,271506
8913,0.002495,74.125.24.0-255,7156,204634,96,271506
8914,0.00251,74.125.24.0-255,5738,210372,96,271506
8915,0.002541,74.125.24.0-255,2902,213274,96,271506
8916,0.002558,74.125.24.0-255,3602,216876,96,271506
8917,0.002562,74.125.24.0-255,4320,221196,96,271506
8918,0.002574,74.125.24.0-255,2902,224098,96,271506
8919,0.002583,74.125.24.0-255,1484,225582,96,271506
8920,0.002595,74.125.24.0-255,2902,228484,96,271506
8921,0.002647,74.125.24.0-255,1484,229968,96,271506
8922,0.002844,74.125.24.0-255,1484,231452,96,271506
8923,0.002848,74.125.24.0-255,2902,234354,96,271506
8924,0.002867,74.125.24.0-255,2902,237256,96,271506
8925,0.002884,74.125.24.0-255,2902,240158,96,271506
8926,0.002888,74.125.24.0-255,2902,243060,96,271506
8927,0.002892,74.125.24.0-255,2902,245962,96,271506
8928,0.002923,74.125.24.0-255,2902,248864,96,271506
8929,0.002974,74.125.24.0-255,2902,251766,96,271506
8930,0.003043,74.125.24.0-255,1484,253250,96,271506
8931,0.003059,74.125.24.0-255,5738,258988,96,271506
8932,0.003088,74.125.24.0-255,3602,262590,96,271506
8933,0.003174,74.125.24.0-255,1405,263995,96,271506
8934,0.003177,74.125.24.0-255,105,264100,96,271506
8935,0.004401,172.31.47.0-255,66,264166,96,271506
8936,0.006519,172.31.47.0-255,105,264271,96,271506
8937,0.008772,74.125.24.0-255,66,264337,96,271506
8938,0.029114,172.31.47.0-255,171,264508,96,271506
8939,0.029147,172.31.47.0-255,1133,265641,96,271506
8940,0.029192,172.31.47.0-255,1514,267155,96,271506
8941,0.029193,172.31.47.0-255,1514,268669,96,271506
8942,0.029195,172.31.47.0-255,1514,270183,96,271506
8943,0.029196,172.31.47.0-255,1059,271242,96,271506
8944,0.030648,104.244.42.0-255,66,271308,96,271506
8945,0.03075,104.244.42.0-255,66,271374,96,271506
8946,0.030827,104.244.42.0-255,66,271440,96,271506
8947,0.030829,104.244.42.0-255,66,271506,96,271506
8948,0.0,172.31.47.0-255,105,105,96,105
8949,0.0,74.125.130.0-255,153,153,96,342529
8950,2.1e-05,172.31.47.0-255,66,219,96,342529
8951,2.7e-05,74.125.130.0-255,1484,1703,96,342529
8952,3.2e-05,172.31.47.0-255,66,1769,96,342529
8953,3.5e-05,74.125.130.0-255,1484,3253,96,342529
8954,3.7e-05,172.31.47.0-255,66,3319,96,342529
8955,5.6e-05,74.125.130.0-255,1484,4803,96,342529
8956,5.8e-05,172.31.47.0-255,66,4869,96,342529
8957,6.5e-05,74.125.130.0-255,5738,10607,96,342529
8958,6.8e-05,172.31.47.0-255,66,10673,96,342529
8959,0.000113,74.125.130.0-255,3627,14300,96,342529
8960,0.000116,172.31.47.0-255,66,14366,96,342529
8961,0.00016,74.125.130.0-255,1484,15850,96,342529
8962,0.000162,172.31.47.0-255,66,15916,96,342529
8963,0.000179,74.125.130.0-255,2902,18818,96,342529
8964,0.000181,172.31.47.0-255,66,18884,96,342529
8965,0.00021,74.125.130.0-255,5738,24622,96,342529
8966,0.000213,172.31.47.0-255,66,24688,96,342529
8967,0.000217,74.125.130.0-255,2902,27590,96,342529
8968,0.000218,172.31.47.0-255,66,27656,96,342529
8969,0.00024,74.125.130.0-255,3961,31617,96,342529
8970,0.000242,172.31.47.0-255,66,31683,96,342529
8971,0.000392,74.125.130.0-255,1484,33167,96,342529
8972,0.000395,172.31.47.0-255,66,33233,96,342529
8973,0.000415,74.125.130.0-255,2902,36135,96,342529
8974,0.000419,172.31.47.0-255,66,36201,96,342529
8975,0.000437,74.125.130.0-255,4320,40521,96,342529
8976,0.00044,172.31.47.0-255,66,40587,96,342529
8977,0.000462,74.125.130.0-255,2902,43489,96,342529
8978,0.000465,172.31.47.0-255,66,43555,96,342529
8979,0.000482,74.125.130.0-255,6797,50352,96,342529
8980,0.000484,172.31.47.0-255,66,50418,96,342529
8981,0.00049,74.125.130.0-255,4320,54738,96,342529
8982,0.000492,172.31.47.0-255,66,54804,96,342529
8983,0.000534,74.125.130.0-255,1484,56288,96,342529
8984,0.000564,172.31.47.0-255,66,56354,96,342529
8985,0.000638,74.125.130.0-255,113,56467,96,342529
8986,0.000656,74.125.130.0-255,385,56852,96,342529
8987,0.000937,74.125.130.0-255,1484,58336,96,342529
8988,0.000941,172.31.47.0-255,66,58402,96,342529
8989,0.000944,74.125.130.0-255,1484,59886,96,342529
8990,0.000961,74.125.130.0-255,1484,61370,96,342529
8991,0.000964,172.31.47.0-255,66,61436,96,342529
8992,0.000968,74.125.130.0-255,2902,64338,96,342529
8993,0.000969,172.31.47.0-255,66,64404,96,342529
8994,0.000986,74.125.130.0-255,2902,67306,96,342529
8995,0.000988,172.31.47.0-255,66,67372,96,342529
8996,0.000993,74.125.130.0-255,5738,73110,96,342529
8997,0.000995,172.31.47.0-255,66,73176,96,342529
8998,0.001001,74.125.130.0-255,7156,80332,96,342529
8999,0.001002,172.31.47.0-255,66,80398,96,342529
9000,0.001039,74.125.130.0-255,7156,87554,96,342529
9001,0.001042,172.31.47.0-255,66,87620,96,342529
9002,0.00106,74.125.130.0-255,3602,91222,96,342529
9003,0.001062,172.31.47.0-255,66,91288,96,342529
9004,0.001364,74.125.130.0-255,1484,92772,96,342529
9005,0.001389,74.125.130.0-255,1484,94256,96,342529
9006,0.001393,172.31.47.0-255,66,94322,96,342529
9007,0.001398,74.125.130.0-255,2902,97224,96,342529
9008,0.0014,172.31.47.0-255,66,97290,96,342529
9009,0.001404,74.125.130.0-255,2902,100192,96,342529
9010,0.001405,172.31.47.0-255,66,100258,96,342529
9011,0.001429,74.125.130.0-255,2902,103160,96,342529
9012,0.001432,172.31.47.0-255,66,103226,96,342529
9013,0.001438,74.125.130.0-255,7156,110382,96,342529
9014,0.00144,172.31.47.0-255,66,110448,96,342529
9015,0.001455,74.125.130.0-255,4320,114768,96,342529
9016,0.001458,172.31.47.0-255,66,114834,96,342529
9017,0.001473,74.125.130.0-255,4320,119154,96,342529
9018,0.001476,172.31.47.0-255,66,119220,96,342529
9019,0.001494,74.125.130.0-255,4320,123540,96,342529
9020,0.001497,172.31.47.0-255,66,123606,96,342529
9021,0.00152,74.125.130.0-255,2184,125790,96,342529
9022,0.001523,172.31.47.0-255,66,125856,96,342529
9023,0.001976,74.125.130.0-255,1484,127340,96,342529
9024,0.001998,74.125.130.0-255,2902,130242,96,342529
9025,0.002001,172.31.47.0-255,66,130308,96,342529
9026,0.002007,74.125.130.0-255,5738,136046,96,342529
9027,0.002009,172.31.47.0-255,66,136112,96,342529
9028,0.002042,74.125.130.0-255,5738,141850,96,342529
9029,0.002045,172.31.47.0-255,66,141916,96,342529
9030,0.002063,74.125.130.0-255,7156,149072,96,342529
9031,0.002065,172.31.47.0-255,66,149138,96,342529
9032,0.00208,74.125.130.0-255,1484,150622,96,342529
9033,0.002105,172.31.47.0-255,66,150688,96,342529
9034,0.004146,74.125.130.0-255,1484,152172,96,342529
9035,0.004162,74.125.130.0-255,4320,156492,96,342529
9036,0.004165,172.31.47.0-255,66,156558,96,342529
9037,0.006234,74.125.130.0-255,5738,162296,96,342529
9038,0.006239,172.31.47.0-255,66,162362,96,342529
9039,0.008307,74.125.130.0-255,5738,168100,96,342529
9040,0.008314,172.31.47.0-255,66,168166,96,342529
9041,0.010377,74.125.130.0-255,5738,173904,96,342529
9042,0.010384,172.31.47.0-255,66,173970,96,342529
9043,0.012444,74.125.130.0-255,5738,179708,96,342529
9044,0.012452,172.31.47.0-255,66,179774,96,342529
9045,0.01453,74.125.130.0-255,5738,185512,96,342529
9046,0.014539,172.31.47.0-255,66,185578,96,342529
9047,0.01659,74.125.130.0-255,2902,188480,96,342529
9048,0.016596,172.31.47.0-255,66,188546,96,342529
9049,0.016616,74.125.130.0-255,2902,191448,96,342529
9050,0.016618,172.31.47.0-255,66,191514,96,342529
9051,0.018648,74.125.130.0-255,2902,194416,96,342529
9052,0.018654,172.31.47.0-255,66,194482,96,342529
9053,0.018677,74.125.130.0-255,2902,197384,96,342529
9054,0.01868,172.31.47.0-255,66,197450,96,342529
9055,0.020701,74.125.130.0-255,2902,200352,96,342529
9056,0.020707,172.31.47.0-255,66,200418,96,342529
9057,0.02073,74.125.130.0-255,2902,203320,96,342529
9058,0.020733,172.31.47.0-255,66,203386,96,342529
9059,0.020974,172.31.47.0-255,172,203558,96,342529
9060,0.021009,172.31.47.0-255,1109,204667,96,342529
9061,0.021087,172.31.47.0-255,1514,206181,96,342529
9062,0.021089,172.31.47.0-255,1304,207485,96,342529
9063,0.022445,104.244.42.0-255,66,207551,96,342529
9064,0.022485,104.244.42.0-255,66,207617,96,342529
9065,0.022582,104.244.42.0-255,66,207683,96,342529
9066,0.02276,74.125.130.0-255,2902,210585,96,342529
9067,0.022763,172.31.47.0-255,66,210651,96,342529
9068,0.022792,74.125.130.0-255,2902,213553,96,342529
9069,0.022795,172.31.47.0-255,66,213619,96,342529
9070,0.024811,74.125.130.0-255,2902,216521,96,342529
9071,0.024816,172.31.47.0-255,66,216587,96,342529
9072,0.024848,74.125.130.0-255,2902,219489,96,342529
9073,0.02485,172.31.47.0-255,66,219555,96,342529
9074,0.026869,74.125.130.0-255,2902,222457,96,342529
9075,0.026874,172.31.47.0-255,66,222523,96,342529
9076,0.026901,74.125.130.0-255,2902,225425,96,342529
9077,0.026903,172.31.47.0-255,66,225491,96,342529
9078,0.028923,74.125.130.0-255,2902,228393,96,342529
9079,0.028928,172.31.47.0-255,66,228459,96,342529
9080,0.028952,74.125.130.0-255,2902,231361,96,342529
9081,0.028954,172.31.47.0-255,66,231427,96,342529
9082,0.030983,74.125.130.0-255,2902,234329,96,342529
9083,0.030991,172.31.47.0-255,66,234395,96,342529
9084,0.03101,74.125.130.0-255,2902,237297,96,342529
9085,0.031012,172.31.47.0-255,66,237363,96,342529
9086,0.033041,74.125.130.0-255,2902,240265,96,342529
9087,0.033048,172.31.47.0-255,66,240331,96,342529
9088,0.033077,74.125.130.0-255,2902,243233,96,342529
9089,0.033079,172.31.47.0-255,66,243299,96,342529
9090,0.035095,74.125.130.0-255,2902,246201,96,342529
9091,0.035099,172.31.47.0-255,66,246267,96,342529
9092,0.035128,74.125.130.0-255,2902,249169,96,342529
9093,0.035131,172.31.47.0-255,66,249235,96,342529
9094,0.03715,74.125.130.0-255,2902,252137,96,342529
9095,0.037154,172.31.47.0-255,66,252203,96,342529
9096,0.03718,74.125.130.0-255,2902,255105,96,342529
9097,0.037182,172.31.47.0-255,66,255171,96,342529
9098,0.039207,74.125.130.0-255,2902,258073,96,342529
9099,0.039213,172.31.47.0-255,66,258139,96,342529
9100,0.039245,74.125.130.0-255,2902,261041,96,342529
9101,0.039248,172.31.47.0-255,66,261107,96,342529
9102,0.041264,74.125.130.0-255,1484,262591,96,342529
9103,0.041292,74.125.130.0-255,1484,264075,96,342529
9104,0.041296,172.31.47.0-255,66,264141,96,342529
9105,0.041315,74.125.130.0-255,2902,267043,96,342529
9106,0.041317,172.31.47.0-255,66,267109,96,342529
9107,0.043354,74.125.130.0-255,2902,270011,96,342529
9108,0.043359,172.31.47.0-255,66,270077,96,342529
9109,0.043386,74.125.130.0-255,2902,272979,96,342529
9110,0.043389,172.31.47.0-255,66,273045,96,342529
9111,0.045404,74.125.130.0-255,2902,275947,96,342529
9112,0.045409,172.31.47.0-255,66,276013,96,342529
9113,0.045426,74.125.130.0-255,2902,278915,96,342529
9114,0.045428,172.31.47.0-255,66,278981,96,342529
9115,0.047468,74.125.130.0-255,5738,284719,96,342529
9116,0.047476,172.31.47.0-255,66,284785,96,342529
9117,0.049533,74.125.130.0-255,5738,290523,96,342529
9118,0.049539,172.31.47.0-255,66,290589,96,342529
9119,0.051592,74.125.130.0-255,2902,293491,96,342529
9120,0.051596,172.31.47.0-255,66,293557,96,342529
9121,0.051621,74.125.130.0-255,2902,296459,96,342529
9122,0.051623,172.31.47.0-255,66,296525,96,342529
9123,0.053652,74.125.130.0-255,2902,299427,96,342529
9124,0.053657,172.31.47.0-255,66,299493,96,342529
9125,0.053688,74.125.130.0-255,2902,302395,96,342529
9126,0.05369,172.31.47.0-255,66,302461,96,342529
9127,0.055716,74.125.130.0-255,2902,305363,96,342529
9128,0.055721,172.31.47.0-255,66,305429,96,342529
9129,0.055755,74.125.130.0-255,2902,308331,96,342529
9130,0.055758,172.31.47.0-255,66,308397,96,342529
9131,0.057773,74.125.130.0-255,2902,311299,96,342529
9132,0.057779,172.31.47.0-255,66,311365,96,342529
9133,0.057816,74.125.130.0-255,2902,314267,96,342529
9134,0.057819,172.31.47.0-255,66,314333,96,342529
9135,0.059828,74.125.130.0-255,2902,317235,96,342529
9136,0.059833,172.31.47.0-255,66,317301,96,342529
9137,0.059859,74.125.130.0-255,1484,318785,96,342529
9138,0.05987,74.125.130.0-255,1484,320269,96,342529
9139,0.059873,172.31.47.0-255,66,320335,96,342529
9140,0.061884,74.125.130.0-255,2902,323237,96,342529
9141,0.06189,172.31.47.0-255,66,323303,96,342529
9142,0.061919,74.125.130.0-255,2902,326205,96,342529
9143,0.061921,172.31.47.0-255,66,326271,96,342529
9144,0.063948,74.125.130.0-255,2902,329173,96,342529
9145,0.063954,172.31.47.0-255,66,329239,96,342529
9146,0.063982,74.125.130.0-255,2902,332141,96,342529
9147,0.063985,172.31.47.0-255,66,332207,96,342529
9148,0.066021,74.125.130.0-255,4320,336527,96,342529
9149,0.066025,172.31.47.0-255,66,336593,96,342529
9150,0.06605,74.125.130.0-255,1484,338077,96,342529
9151,0.068082,74.125.130.0-255,2902,340979,96,342529
9152,0.068086,172.31.47.0-255,66,341045,96,342529
9153,0.068114,74.125.130.0-255,1484,342529,96,342529
9154,0.0,172.31.47.0-255,105,105,96,276
9155,0.001772,157.240.7.0-255,105,210,96,276
9156,0.001782,172.31.47.0-255,66,276,96,276
9157,0.0,172.31.47.0-255,105,105,96,276
9158,0.00178,157.240.13.0-255,105,210,96,276
9159,0.001793,172.31.47.0-255,66,276,96,276
9160,0.0,74.125.24.0-255,152,152,96,326746
9161,2e-05,172.31.47.0-255,66,218,96,326746
9162,2.7e-05,74.125.24.0-255,1484,1702,96,326746
9163,3.1e-05,172.31.47.0-255,66,1768,96,326746
9164,3.6e-05,74.125.24.0-255,2902,4670,96,326746
9165,4e-05,172.31.47.0-255,66,4736,96,326746
9166,6.4e-05,74.125.24.0-255,5738,10474,96,326746
9167,6.7e-05,172.31.47.0-255,66,10540,96,326746
9168,8.4e-05,74.125.24.0-255,3517,14057,96,326746
9169,8.7e-05,172.31.47.0-255,66,14123,96,326746
9170,0.000115,74.125.24.0-255,4320,18443,96,326746
9171,0.000117,172.31.47.0-255,66,18509,96,326746
9172,0.00012,74.125.24.0-255,1484,19993,96,326746
9173,0.000122,172.31.47.0-255,66,20059,96,326746
9174,0.000148,172.31.47.0-255,66,20125,96,326746
9175,0.000151,74.125.24.0-255,1484,21609,96,326746
9176,0.000153,172.31.47.0-255,66,21675,96,326746
9177,0.000187,172.31.47.0-255,66,21741,96,326746
9178,0.000192,74.125.24.0-255,3602,25343,96,326746
9179,0.000194,172.31.47.0-255,66,25409,96,326746
9180,0.000231,74.125.24.0-255,1484,26893,96,326746
9181,0.000234,172.31.47.0-255,66,26959,96,326746
9182,0.000238,74.125.24.0-255,2902,29861,96,326746
9183,0.00024,172.31.47.0-255,66,29927,96,326746
9184,0.000266,74.125.24.0-255,5738,35665,96,326746
9185,0.000269,172.31.47.0-255,66,35731,96,326746
9186,0.000275,74.125.24.0-255,5738,41469,96,326746
9187,0.000277,172.31.47.0-255,66,41535,96,326746
9188,0.000325,74.125.24.0-255,1437,42972,96,326746
9189,0.000327,172.31.47.0-255,66,43038,96,326746
9190,0.000436,74.125.24.0-255,343,43381,96,326746
9191,0.001023,74.125.24.0-255,1484,44865,96,326746
9192,0.001029,172.31.47.0-255,66,44931,96,326746
9193,0.001053,74.125.24.0-255,2902,47833,96,326746
9194,0.001056,172.31.47.0-255,66,47899,96,326746
9195,0.001062,74.125.24.0-255,4320,52219,96,326746
9196,0.001064,172.31.47.0-255,66,52285,96,326746
9197,0.001079,74.125.24.0-255,1484,53769,96,326746
9198,0.001093,74.125.24.0-255,2902,56671,96,326746
9199,0.001096,172.31.47.0-255,66,56737,96,326746
9200,0.001123,172.31.47.0-255,66,56803,96,326746
9201,0.001154,172.31.47.0-255,66,56869,96,326746
9202,0.001629,74.125.24.0-255,1484,58353,96,326746
9203,0.001639,74.125.24.0-255,2902,61255,96,326746
9204,0.001643,172.31.47.0-255,66,61321,96,326746
9205,0.001649,74.125.24.0-255,2902,64223,96,326746
9206,0.001651,172.31.47.0-255,66,64289,96,326746
9207,0.001665,74.125.24.0-255,2902,67191,96,326746
9208,0.001667,172.31.47.0-255,66,67257,96,326746
9209,0.001706,172.31.47.0-255,66,67323,96,326746
9210,0.001728,74.125.24.0-255,4320,71643,96,326746
9211,0.001731,172.31.47.0-255,66,71709,96,326746
9212,0.00175,74.125.24.0-255,2902,74611,96,326746
9213,0.001752,172.31.47.0-255,66,74677,96,326746
9214,0.001776,172.31.47.0-255,66,74743,96,326746
9215,0.001845,74.125.24.0-255,1484,76227,96,326746
9216,0.001851,74.125.24.0-255,2902,79129,96,326746
9217,0.001854,172.31.47.0-255,66,79195,96,326746
9218,0.001859,74.125.24.0-255,2902,82097,96,326746
9219,0.001861,172.31.47.0-255,66,82163,96,326746
9220,0.001874,74.125.24.0-255,2902,85065,96,326746
9221,0.001877,172.31.47.0-255,66,85131,96,326746
9222,0.001894,74.125.24.0-255,4320,89451,96,326746
9223,0.001896,172.31.47.0-255,66,89517,96,326746
9224,0.001919,74.125.24.0-255,7156,96673,96,326746
9225,0.001921,172.31.47.0-255,66,96739,96,326746
9226,0.001939,74.125.24.0-255,1484,98223,96,326746
9227,0.00195,172.31.47.0-255,66,98289,96,326746
9228,0.001971,74.125.24.0-255,2184,100473,96,326746
9229,0.001974,172.31.47.0-255,66,100539,96,326746
9230,0.002057,74.125.24.0-255,1484,102023,96,326746
9231,0.002063,74.125.24.0-255,2902,104925,96,326746
9232,0.002067,172.31.47.0-255,66,104991,96,326746
9233,0.002084,74.125.24.0-255,2902,107893,96,326746
9234,0.002087,172.31.47.0-255,66,107959,96,326746
9235,0.002112,74.125.24.0-255,2902,110861,96,326746
9236,0.002115,172.31.47.0-255,66,110927,96,326746
9237,0.002122,74.125.24.0-255,7156,118083,96,326746
9238,0.002125,172.31.47.0-255,66,118149,96,326746
9239,0.002131,74.125.24.0-255,4320,122469,96,326746
9240,0.002134,172.31.47.0-255,66,122535,96,326746
9241,0.002155,74.125.24.0-255,4320,126855,96,326746
9242,0.002158,172.31.47.0-255,66,126921,96,326746
9243,0.002169,172.31.47.0-255,66,126987,96,326746
9244,0.002269,74.125.24.0-255,1484,128471,96,326746
9245,0.002293,74.125.24.0-255,2902,131373,96,326746
9246,0.002298,172.31.47.0-255,66,131439,96,326746
9247,0.002305,74.125.24.0-255,5738,137177,96,326746
9248,0.002307,172.31.47.0-255,66,137243,96,326746
9249,0.002311,74.125.24.0-255,2902,140145,96,326746
9250,0.002313,172.31.47.0-255,66,140211,96,326746
9251,0.002332,74.125.24.0-255,1484,141695,96,326746
9252,0.002338,74.125.24.0-255,4320,146015,96,326746
9253,0.00234,172.31.47.0-255,66,146081,96,326746
9254,0.00236,74.125.24.0-255,7156,153237,96,326746
9255,0.002363,172.31.47.0-255,66,153303,96,326746
9256,0.002366,74.125.24.0-255,1484,154787,96,326746
9257,0.002389,74.125.24.0-255,6438,161225,96,326746
9258,0.002392,172.31.47.0-255,66,161291,96,326746
9259,0.004727,74.125.24.0-255,4320,165611,96,326746
9260,0.004743,172.31.47.0-255,66,165677,96,326746
9261,0.004756,74.125.24.0-255,1484,167161,96,326746
9262,0.007084,74.125.24.0-255,4320,171481,96,326746
9263,0.007093,172.31.47.0-255,66,171547,96,326746
9264,0.009445,74.125.24.0-255,5738,177285,96,326746
9265,0.009451,172.31.47.0-255,66,177351,96,326746
9266,0.011801,74.125.24.0-255,5738,183089,96,326746
9267,0.011812,172.31.47.0-255,66,183155,96,326746
9268,0.014159,74.125.24.0-255,5738,188893,96,326746
9269,0.014173,172.31.47.0-255,66,188959,96,326746
9270,0.01651,74.125.24.0-255,5738,194697,96,326746
9271,0.016519,172.31.47.0-255,66,194763,96,326746
9272,0.018855,74.125.24.0-255,5738,200501,96,326746
9273,0.018862,172.31.47.0-255,66,200567,96,326746
9274,0.021187,74.125.24.0-255,5738,206305,96,326746
9275,0.021198,172.31.47.0-255,66,206371,96,326746
9276,0.023579,74.125.24.0-255,5738,212109,96,326746
9277,0.023593,172.31.47.0-255,66,212175,96,326746
9278,0.025937,74.125.24.0-255,5738,217913,96,326746
9279,0.025949,172.31.47.0-255,66,217979,96,326746
9280,0.028306,74.125.24.0-255,5738,223717,96,326746
9281,0.028314,172.31.47.0-255,66,223783,96,326746
9282,0.030725,74.125.24.0-255,5738,229521,96,326746
9283,0.030737,172.31.47.0-255,66,229587,96,326746
9284,0.033067,74.125.24.0-255,5738,235325,96,326746
9285,0.03308,172.31.47.0-255,66,235391,96,326746
9286,0.03544,74.125.24.0-255,5738,241129,96,326746
9287,0.035454,172.31.47.0-255,66,241195,96,326746
9288,0.037778,74.125.24.0-255,5738,246933,96,326746
9289,0.03779,172.31.47.0-255,66,246999,96,326746
9290,0.040144,74.125.24.0-255,5738,252737,96,326746
9291,0.040154,172.31.47.0-255,66,252803,96,326746
9292,0.040189,172.31.47.0-255,172,252975,96,326746
9293,0.040216,172.31.47.0-255,1105,254080,96,326746
9294,0.040336,172.31.47.0-255,1514,255594,96,326746
9295,0.040338,172.31.47.0-255,1306,256900,96,326746
9296,0.041714,104.244.42.0-255,66,256966,96,326746
9297,0.0418,104.244.42.0-255,66,257032,96,326746
9298,0.041875,104.244.42.0-255,66,257098,96,326746
9299,0.042499,74.125.24.0-255,5738,262836,96,326746
9300,0.042508,172.31.47.0-255,66,262902,96,326746
9301,0.044841,74.125.24.0-255,5738,268640,96,326746
9302,0.044847,172.31.47.0-255,66,268706,96,326746
9303,0.047177,74.125.24.0-255,5738,274444,96,326746
9304,0.047185,172.31.47.0-255,66,274510,96,326746
9305,0.049525,74.125.24.0-255,5738,280248,96,326746
9306,0.049532,172.31.47.0-255,66,280314,96,326746
9307,0.051867,74.125.24.0-255,5738,286052,96,326746
9308,0.051877,172.31.47.0-255,66,286118,96,326746
9309,0.054212,74.125.24.0-255,5738,291856,96,326746
9310,0.05422,172.31.47.0-255,66,291922,96,326746
9311,0.056585,74.125.24.0-255,5738,297660,96,326746
9312,0.056596,172.31.47.0-255,66,297726,96,326746
9313,0.058947,74.125.24.0-255,5738,303464,96,326746
9314,0.058954,172.31.47.0-255,66,303530,96,326746
9315,0.061285,74.125.24.0-255,5738,309268,96,326746
9316,0.061298,172.31.47.0-255,66,309334,96,326746
9317,0.063656,74.125.24.0-255,5738,315072,96,326746
9318,0.063668,172.31.47.0-255,66,315138,96,326746
9319,0.066021,74.125.24.0-255,5738,320876,96,326746
9320,0.066033,172.31.47.0-255,66,320942,96,326746
9321,0.068401,74.125.24.0-255,5738,326680,96,326746
9322,0.068408,172.31.47.0-255,66,326746,96,326746
9323,0.0,172.31.47.0-255,105,105,96,276
9324,0.001766,157.240.13.0-255,105,210,96,276
9325,0.039062,172.31.47.0-255,66,276,96,276
9326,0.0,172.217.194.0-255,150,150,96,306338
9327,2.5e-05,172.31.47.0-255,66,216,96,306338
9328,3.1e-05,172.217.194.0-255,1484,1700,96,306338
9329,3.5e-05,172.31.47.0-255,66,1766,96,306338
9330,3.9e-05,172.217.194.0-255,2902,4668,96,306338
9331,4.1e-05,172.31.47.0-255,66,4734,96,306338
9332,5.4e-05,172.217.194.0-255,7156,11890,96,306338
9333,5.6e-05,172.31.47.0-255,66,11956,96,306338
9334,9.5e-05,172.31.47.0-255,66,12022,96,306338
9335,0.000118,172.217.194.0-255,1484,13506,96,306338
9336,0.00012,172.31.47.0-255,66,13572,96,306338
9337,0.000147,172.217.194.0-255,2543,16115,96,306338
9338,0.000149,172.31.47.0-255,66,16181,96,306338
9339,0.00018,172.217.194.0-255,4320,20501,96,306338
9340,0.000184,172.31.47.0-255,66,20567,96,306338
9341,0.000189,172.217.194.0-255,7156,27723,96,306338
9342,0.000191,172.31.47.0-255,66,27789,96,306338
9343,0.000242,172.31.47.0-255,66,27855,96,306338
9344,0.000248,172.217.194.0-255,7156,35011,96,306338
9345,0.00025,172.31.47.0-255,66,35077,96,306338
9346,0.000266,172.217.194.0-255,2902,37979,96,306338
9347,0.000269,172.31.47.0-255,66,38045,96,306338
9348,0.000277,172.217.194.0-255,2543,40588,96,306338
9349,0.000279,172.31.47.0-255,66,40654,96,306338
9350,0.000562,172.217.194.0-255,647,41301,96,306338
9351,0.000566,172.31.47.0-255,66,41367,96,306338
9352,0.000659,172.217.194.0-255,1484,42851,96,306338
9353,0.000662,172.31.47.0-255,66,42917,96,306338
9354,0.000667,172.217.194.0-255,2902,45819,96,306338
9355,0.000669,172.31.47.0-255,66,45885,96,306338
9356,0.00073,172.217.194.0-255,5738,51623,96,306338
9357,0.000733,172.31.47.0-255,66,51689,96,306338
9358,0.000744,172.31.47.0-255,66,51755,96,306338
9359,0.000766,172.31.47.0-255,66,51821,96,306338
9360,0.001409,172.217.194.0-255,1484,53305,96,306338
9361,0.001419,172.217.194.0-255,2902,56207,96,306338
9362,0.001423,172.31.47.0-255,66,56273,96,306338
9363,0.001449,172.217.194.0-255,5738,62011,96,306338
9364,0.001451,172.31.47.0-255,66,62077,96,306338
9365,0.00146,172.31.47.0-255,66,62143,96,306338
9366,0.001477,172.217.194.0-255,4320,66463,96,306338
9367,0.00148,172.31.47.0-255,66,66529,96,306338
9368,0.001487,172.217.194.0-255,7156,73685,96,306338
9369,0.001489,172.31.47.0-255,66,73751,96,306338
9370,0.001515,172.217.194.0-255,3602,77353,96,306338
9371,0.001522,172.31.47.0-255,66,77419,96,306338
9372,0.001584,172.217.194.0-255,1484,78903,96,306338
9373,0.001589,172.217.194.0-255,2902,81805,96,306338
9374,0.001592,172.31.47.0-255,66,81871,96,306338
9375,0.001595,172.217.194.0-255,1484,83355,96,306338
9376,0.001632,172.217.194.0-255,4320,87675,96,306338
9377,0.001637,172.31.47.0-255,66,87741,96,306338
9378,0.001653,172.31.47.0-255,66,87807,96,306338
9379,0.001676,172.217.194.0-255,5738,93545,96,306338
9380,0.001679,172.31.47.0-255,66,93611,96,306338
9381,0.001708,172.217.194.0-255,6438,100049,96,306338
9382,0.001713,172.31.47.0-255,66,100115,96,306338
9383,0.001995,172.217.194.0-255,1484,101599,96,306338
9384,0.002,172.217.194.0-255,2902,104501,96,306338
9385,0.002004,172.31.47.0-255,66,104567,96,306338
9386,0.002018,172.217.194.0-255,5738,110305,96,306338
9387,0.002026,172.31.47.0-255,66,110371,96,306338
9388,0.002033,172.217.194.0-255,7156,117527,96,306338
9389,0.002036,172.31.47.0-255,66,117593,96,306338
9390,0.002056,172.217.194.0-255,1484,119077,96,306338
9391,0.002088,172.217.194.0-255,5738,124815,96,306338
9392,0.002091,172.31.47.0-255,66,124881,96,306338
9393,0.002131,172.31.47.0-255,66,124947,96,306338
9394,0.002218,172.217.194.0-255,1484,126431,96,306338
9395,0.002223,172.217.194.0-255,2902,129333,96,306338
9396,0.002225,172.31.47.0-255,66,129399,96,306338
9397,0.002251,172.217.194.0-255,5738,135137,96,306338
9398,0.002253,172.31.47.0-255,66,135203,96,306338
9399,0.002262,172.31.47.0-255,66,135269,96,306338
9400,0.002294,172.31.47.0-255,66,135335,96,306338
9401,0.002321,172.217.194.0-255,5020,140355,96,306338
9402,0.002323,172.31.47.0-255,66,140421,96,306338
9403,0.004575,172.217.194.0-255,5738,146159,96,306338
9404,0.004579,172.31.47.0-255,66,146225,96,306338
9405,0.006869,172.217.194.0-255,5738,151963,96,306338
9406,0.006874,172.31.47.0-255,66,152029,96,306338
9407,0.009191,172.217.194.0-255,5738,157767,96,306338
9408,0.0092,172.31.47.0-255,66,157833,96,306338
9409,0.011524,172.217.194.0-255,5738,163571,96,306338
9410,0.011531,172.31.47.0-255,66,163637,96,306338
9411,0.013781,172.217.194.0-255,5738,169375,96,306338
9412,0.013789,172.31.47.0-255,66,169441,96,306338
9413,0.016055,172.217.194.0-255,5738,175179,96,306338
9414,0.016063,172.31.47.0-255,66,175245,96,306338
9415,0.018342,172.217.194.0-255,5738,180983,96,306338
9416,0.01835,172.31.47.0-255,66,181049,96,306338
9417,0.020628,172.217.194.0-255,5738,186787,96,306338
9418,0.020634,172.31.47.0-255,66,186853,96,306338
9419,0.022919,172.217.194.0-255,5738,192591,96,306338
9420,0.022924,172.31.47.0-255,66,192657,96,306338
9421,0.025238,172.217.194.0-255,5738,198395,96,306338
9422,0.025244,172.31.47.0-255,66,198461,96,306338
9423,0.026561,172.31.47.0-255,172,198633,96,306338
9424,0.02673,172.31.47.0-255,1109,199742,96,306338
9425,0.026798,172.31.47.0-255,1514,201256,96,306338
9426,0.0268,172.31.47.0-255,1302,202558,96,306338
9427,0.027509,172.217.194.0-255,4320,206878,96,306338
9428,0.027514,172.31.47.0-255,66,206944,96,306338
9429,0.027541,172.217.194.0-255,1484,208428,96,306338
9430,0.028067,104.244.42.0-255,66,208494,96,306338
9431,0.028249,104.244.42.0-255,66,208560,96,306338
9432,0.02834,104.244.42.0-255,66,208626,96,306338
9433,0.029803,172.217.194.0-255,2902,211528,96,306338
9434,0.029808,172.31.47.0-255,66,211594,96,306338
9435,0.032106,172.217.194.0-255,4320,215914,96,306338
9436,0.03211,172.31.47.0-255,66,215980,96,306338
9437,0.03214,172.217.194.0-255,1484,217464,96,306338
9438,0.034392,172.217.194.0-255,4320,221784,96,306338
9439,0.034397,172.31.47.0-255,66,221850,96,306338
9440,0.036674,172.217.194.0-255,5738,227588,96,306338
9441,0.036679,172.31.47.0-255,66,227654,96,306338
9442,0.038913,172.217.194.0-255,2902,230556,96,306338
9443,0.038918,172.31.47.0-255,66,230622,96,306338
9444,0.038944,172.217.194.0-255,2902,233524,96,306338
9445,0.038946,172.31.47.0-255,66,233590,96,306338
9446,0.041225,172.217.194.0-255,5738,239328,96,306338
9447,0.041229,172.31.47.0-255,66,239394,96,306338
9448,0.043492,172.217.194.0-255,5738,245132,96,306338
9449,0.043496,172.31.47.0-255,66,245198,96,306338
9450,0.04576,172.217.194.0-255,4320,249518,96,306338
9451,0.045765,172.31.47.0-255,66,249584,96,306338
9452,0.045796,172.217.194.0-255,1484,251068,96,306338
9453,0.048023,172.217.194.0-255,4320,255388,96,306338
9454,0.048028,172.31.47.0-255,66,255454,96,306338
9455,0.050313,172.217.194.0-255,5738,261192,96,306338
9456,0.050318,172.31.47.0-255,66,261258,96,306338
9457,0.052604,172.217.194.0-255,5738,266996,96,306338
9458,0.052609,172.31.47.0-255,66,267062,96,306338
9459,0.054914,172.217.194.0-255,5738,272800,96,306338
9460,0.054919,172.31.47.0-255,66,272866,96,306338
9461,0.057173,172.217.194.0-255,5738,278604,96,306338
9462,0.057179,172.31.47.0-255,66,278670,96,306338
9463,0.059464,172.217.194.0-255,5738,284408,96,306338
9464,0.059468,172.31.47.0-255,66,284474,96,306338
9465,0.061766,172.217.194.0-255,5738,290212,96,306338
9466,0.061772,172.31.47.0-255,66,290278,96,306338
9467,0.064057,172.217.194.0-255,4320,294598,96,306338
9468,0.064061,172.31.47.0-255,66,294664,96,306338
9469,0.064091,172.217.194.0-255,1484,296148,96,306338
9470,0.066337,172.217.194.0-255,4320,300468,96,306338
9471,0.066341,172.31.47.0-255,66,300534,96,306338
9472,0.068616,172.217.194.0-255,5738,306272,96,306338
9473,0.068622,172.31.47.0-255,66,306338,96,306338
9474,0.0,74.125.200.0-255,157,157,96,326560
9475,2.6e-05,172.31.47.0-255,66,223,96,326560
9476,3.1e-05,74.125.200.0-255,1484,1707,96,326560
9477,3.5e-05,172.31.47.0-255,66,1773,96,326560
9478,3.7e-05,74.125.200.0-255,1484,3257,96,326560
9479,3.9e-05,172.31.47.0-255,66,3323,96,326560
9480,5.6e-05,74.125.200.0-255,1484,4807,96,326560
9481,5.8e-05,172.31.47.0-255,66,4873,96,326560
9482,6.4e-05,74.125.200.0-255,4320,9193,96,326560
9483,6.6e-05,172.31.47.0-255,66,9259,96,326560
9484,8.9e-05,74.125.200.0-255,1484,10743,96,326560
9485,9.2e-05,172.31.47.0-255,66,10809,96,326560
9486,0.00011,74.125.200.0-255,3394,14203,96,326560
9487,0.000113,172.31.47.0-255,66,14269,96,326560
9488,0.000191,74.125.200.0-255,1484,15753,96,326560
9489,0.000194,172.31.47.0-255,66,15819,96,326560
9490,0.000213,74.125.200.0-255,2902,18721,96,326560
9491,0.000215,172.31.47.0-255,66,18787,96,326560
9492,0.000237,74.125.200.0-255,5738,24525,96,326560
9493,0.00024,172.31.47.0-255,66,24591,96,326560
9494,0.000253,74.125.200.0-255,4320,28911,96,326560
9495,0.000255,172.31.47.0-255,66,28977,96,326560
9496,0.000274,74.125.200.0-255,2543,31520,96,326560
9497,0.000276,172.31.47.0-255,66,31586,96,326560
9498,0.000397,74.125.200.0-255,1484,33070,96,326560
9499,0.000401,172.31.47.0-255,66,33136,96,326560
9500,0.000412,74.125.200.0-255,2902,36038,96,326560
9501,0.000415,172.31.47.0-255,66,36104,96,326560
9502,0.000439,74.125.200.0-255,4320,40424,96,326560
9503,0.000441,172.31.47.0-255,66,40490,96,326560
9504,0.000456,74.125.200.0-255,1484,41974,96,326560
9505,0.000458,172.31.47.0-255,66,42040,96,326560
9506,0.000463,74.125.200.0-255,4320,46360,96,326560
9507,0.000466,172.31.47.0-255,66,46426,96,326560
9508,0.00049,74.125.200.0-255,5379,51805,96,326560
9509,0.000494,172.31.47.0-255,66,51871,96,326560
9510,0.00054,74.125.200.0-255,2902,54773,96,326560
9511,0.000543,172.31.47.0-255,66,54839,96,326560
9512,0.000548,74.125.200.0-255,4320,59159,96,326560
9513,0.00055,172.31.47.0-255,66,59225,96,326560
9514,0.000557,74.125.200.0-255,6797,66022,96,326560
9515,0.000561,172.31.47.0-255,66,66088,96,326560
9516,0.000575,74.125.200.0-255,412,66500,96,326560
9517,0.000694,172.31.47.0-255,66,66566,96,326560
9518,0.000936,74.125.200.0-255,331,66897,96,326560
9519,0.000966,172.31.47.0-255,66,66963,96,326560
9520,0.001127,74.125.200.0-255,1484,68447,96,326560
9521,0.001149,74.125.200.0-255,2902,71349,96,326560
9522,0.001155,172.31.47.0-255,66,71415,96,326560
9523,0.001162,74.125.200.0-255,5738,77153,96,326560
9524,0.001164,172.31.47.0-255,66,77219,96,326560
9525,0.001167,74.125.200.0-255,1484,78703,96,326560
9526,0.001193,74.125.200.0-255,5738,84441,96,326560
9527,0.001198,172.31.47.0-255,66,84507,96,326560
9528,0.001236,172.31.47.0-255,66,84573,96,326560
9529,0.001255,74.125.200.0-255,2184,86757,96,326560
9530,0.001258,172.31.47.0-255,66,86823,96,326560
9531,0.001872,74.125.200.0-255,1484,88307,96,326560
9532,0.001878,74.125.200.0-255,1484,89791,96,326560
9533,0.001881,172.31.47.0-255,66,89857,96,326560
9534,0.001894,74.125.200.0-255,1484,91341,96,326560
9535,0.001899,74.125.200.0-255,4320,95661,96,326560
9536,0.001901,172.31.47.0-255,66,95727,96,326560
9537,0.001912,74.125.200.0-255,1484,97211,96,326560
9538,0.001917,74.125.200.0-255,4320,101531,96,326560
9539,0.001918,172.31.47.0-255,66,101597,96,326560
9540,0.001923,74.125.200.0-255,4320,105917,96,326560
9541,0.001924,172.31.47.0-255,66,105983,96,326560
9542,0.001935,74.125.200.0-255,1484,107467,96,326560
9543,0.001968,172.31.47.0-255,66,107533,96,326560
9544,0.001972,74.125.200.0-255,2184,109717,96,326560
9545,0.001973,172.31.47.0-255,66,109783,96,326560
9546,0.002139,74.125.200.0-255,1484,111267,96,326560
9547,0.002143,74.125.200.0-255,1484,112751,96,326560
9548,0.002145,172.31.47.0-255,66,112817,96,326560
9549,0.002163,74.125.200.0-255,1484,114301,96,326560
9550,0.002165,74.125.200.0-255,1484,115785,96,326560
9551,0.002167,172.31.47.0-255,66,115851,96,326560
9552,0.002171,74.125.200.0-255,2902,118753,96,326560
9553,0.002172,172.31.47.0-255,66,118819,96,326560
9554,0.002212,74.125.200.0-255,5738,124557,96,326560
9555,0.002215,172.31.47.0-255,66,124623,96,326560
9556,0.002222,74.125.200.0-255,7156,131779,96,326560
9557,0.002224,172.31.47.0-255,66,131845,96,326560
9558,0.002238,74.125.200.0-255,4320,136165,96,326560
9559,0.00224,172.31.47.0-255,66,136231,96,326560
9560,0.002263,74.125.200.0-255,1484,137715,96,326560
9561,0.00228,74.125.200.0-255,6438,144153,96,326560
9562,0.002282,172.31.47.0-255,66,144219,96,326560
9563,0.002298,74.125.200.0-255,1484,145703,96,326560
9564,0.002312,74.125.200.0-255,2902,148605,96,326560
9565,0.002314,172.31.47.0-255,66,148671,96,326560
9566,0.002329,74.125.200.0-255,4320,152991,96,326560
9567,0.002331,172.31.47.0-255,66,153057,96,326560
9568,0.002334,74.125.200.0-255,1484,154541,96,326560
9569,0.00236,74.125.200.0-255,2902,157443,96,326560
9570,0.002363,172.31.47.0-255,66,157509,96,326560
9571,0.002386,74.125.200.0-255,1484,158993,96,326560
9572,0.002388,172.31.47.0-255,66,159059,96,326560
9573,0.002428,74.125.200.0-255,2902,161961,96,326560
9574,0.002432,172.31.47.0-255,66,162027,96,326560
9575,0.00245,172.31.47.0-255,66,162093,96,326560
9576,0.002524,74.125.200.0-255,1484,163577,96,326560
9577,0.002544,74.125.200.0-255,2902,166479,96,326560
9578,0.002546,172.31.47.0-255,66,166545,96,326560
9579,0.002567,74.125.200.0-255,5738,172283,96,326560
9580,0.00257,172.31.47.0-255,66,172349,96,326560
9581,0.002596,74.125.200.0-255,1484,173833,96,326560
9582,0.002599,172.31.47.0-255,66,173899,96,326560
9583,0.00517,74.125.200.0-255,4320,178219,96,326560
9584,0.005175,172.31.47.0-255,66,178285,96,326560
9585,0.007774,74.125.200.0-255,5738,184023,96,326560
9586,0.007781,172.31.47.0-255,66,184089,96,326560
9587,0.010365,74.125.200.0-255,5738,189827,96,326560
9588,0.010376,172.31.47.0-255,66,189893,96,326560
9589,0.01299,74.125.200.0-255,5738,195631,96,326560
9590,0.013001,172.31.47.0-255,66,195697,96,326560
9591,0.015584,74.125.200.0-255,5738,201435,96,326560
9592,0.015595,172.31.47.0-255,66,201501,96,326560
9593,0.018178,74.125.200.0-255,4320,205821,96,326560
9594,0.018186,172.31.47.0-255,66,205887,96,326560
9595,0.018226,74.125.200.0-255,1484,207371,96,326560
9596,0.02076,74.125.200.0-255,4320,211691,96,326560
9597,0.020765,172.31.47.0-255,66,211757,96,326560
9598,0.023344,74.125.200.0-255,4320,216077,96,326560
9599,0.02335,172.31.47.0-255,66,216143,96,326560
9600,0.023369,74.125.200.0-255,1484,217627,96,326560
9601,0.024163,172.31.47.0-255,172,217799,96,326560
9602,0.024197,172.31.47.0-255,1111,218910,96,326560
9603,0.024258,172.31.47.0-255,1514,220424,96,326560
9604,0.02426,172.31.47.0-255,1300,221724,96,326560
9605,0.025689,104.244.42.0-255,66,221790,96,326560
9606,0.025739,104.244.42.0-255,66,221856,96,326560
9607,0.025839,104.244.42.0-255,66,221922,96,326560
9608,0.025932,74.125.200.0-255,4320,226242,96,326560
9609,0.025936,172.31.47.0-255,66,226308,96,326560
9610,0.028522,74.125.200.0-255,5738,232046,96,326560
9611,0.028532,172.31.47.0-255,66,232112,96,326560
9612,0.03115,74.125.200.0-255,5738,237850,96,326560
9613,0.031156,172.31.47.0-255,66,237916,96,326560
9614,0.033721,74.125.200.0-255,2902,240818,96,326560
9615,0.033726,172.31.47.0-255,66,240884,96,326560
9616,0.033752,74.125.200.0-255,2902,243786,96,326560
9617,0.033755,172.31.47.0-255,66,243852,96,326560
9618,0.036303,74.125.200.0-255,2902,246754,96,326560
9619,0.036308,172.31.47.0-255,66,246820,96,326560
9620,0.036341,74.125.200.0-255,2902,249722,96,326560
9621,0.036344,172.31.47.0-255,66,249788,96,326560
9622,0.038889,74.125.200.0-255,2902,252690,96,326560
9623,0.038894,172.31.47.0-255,66,252756,96,326560
9624,0.038914,74.125.200.0-255,2902,255658,96,326560
9625,0.038916,172.31.47.0-255,66,255724,96,326560
9626,0.041467,74.125.200.0-255,2902,258626,96,326560
9627,0.041473,172.31.47.0-255,66,258692,96,326560
9628,0.041506,74.125.200.0-255,2902,261594,96,326560
9629,0.041509,172.31.47.0-255,66,261660,96,326560
9630,0.044045,74.125.200.0-255,2902,264562,96,326560
9631,0.04405,172.31.47.0-255,66,264628,96,326560
9632,0.04408,74.125.200.0-255,2902,267530,96,326560
9633,0.044082,172.31.47.0-255,66,267596,96,326560
9634,0.046612,74.125.200.0-255,2902,270498,96,326560
9635,0.046616,172.31.47.0-255,66,270564,96,326560
9636,0.046647,74.125.200.0-255,2902,273466,96,326560
9637,0.046649,172.31.47.0-255,66,273532,96,326560
9638,0.049181,74.125.200.0-255,2902,276434,96,326560
9639,0.049185,172.31.47.0-255,66,276500,96,326560
9640,0.04921,74.125.200.0-255,2902,279402,96,326560
9641,0.049213,172.31.47.0-255,66,279468,96,326560
9642,0.051765,74.125.200.0-255,5738,285206,96,326560
9643,0.05177,172.31.47.0-255,66,285272,96,326560
9644,0.054359,74.125.200.0-255,5738,291010,96,326560
9645,0.054364,172.31.47.0-255,66,291076,96,326560
9646,0.056943,74.125.200.0-255,5738,296814,96,326560
9647,0.056955,172.31.47.0-255,66,296880,96,326560
9648,0.059512,74.125.200.0-255,2902,299782,96,326560
9649,0.059517,172.31.47.0-255,66,299848,96,326560
9650,0.059546,74.125.200.0-255,2902,302750,96,326560
9651,0.059549,172.31.47.0-255,66,302816,96,326560
9652,0.062093,74.125.200.0-255,2902,305718,96,326560
9653,0.062098,172.31.47.0-255,66,305784,96,326560
9654,0.062124,74.125.200.0-255,2902,308686,96,326560
9655,0.062127,172.31.47.0-255,66,308752,96,326560
9656,0.064662,74.125.200.0-255,2902,311654,96,326560
9657,0.064668,172.31.47.0-255,66,311720,96,326560
9658,0.064702,74.125.200.0-255,2902,314622,96,326560
9659,0.064704,172.31.47.0-255,66,314688,96,326560
9660,0.067237,74.125.200.0-255,2902,317590,96,326560
9661,0.067244,172.31.47.0-255,66,317656,96,326560
9662,0.067281,74.125.200.0-255,2902,320558,96,326560
9663,0.067284,172.31.47.0-255,66,320624,96,326560
9664,0.069815,74.125.200.0-255,2902,323526,96,326560
9665,0.06982,172.31.47.0-255,66,323592,96,326560
9666,0.069837,74.125.200.0-255,2902,326494,96,326560
9667,0.06984,172.31.47.0-255,66,326560,96,326560
9668,0.0,172.31.47.0-255,105,105,96,105
9669,0.0,172.217.194.0-255,153,153,96,348887
9670,2.2e-05,172.31.47.0-255,66,219,96,348887
9671,4.2e-05,172.217.194.0-255,1484,1703,96,348887
9672,5.2e-05,172.31.47.0-255,66,1769,96,348887
9673,5.7e-05,172.217.194.0-255,2902,4671,96,348887
9674,6e-05,172.31.47.0-255,66,4737,96,348887
9675,6.7e-05,172.217.194.0-255,7156,11893,96,348887
9676,7e-05,172.31.47.0-255,66,11959,96,348887
9677,7.4e-05,172.217.194.0-255,2181,14140,96,348887
9678,7.6e-05,172.31.47.0-255,66,14206,96,348887
9679,0.000162,172.217.194.0-255,1484,15690,96,348887
9680,0.000165,172.31.47.0-255,66,15756,96,348887
9681,0.00017,172.217.194.0-255,2902,18658,96,348887
9682,0.000172,172.31.47.0-255,66,18724,96,348887
9683,0.000177,172.217.194.0-255,4320,23044,96,348887
9684,0.000179,172.31.47.0-255,66,23110,96,348887
9685,0.000188,172.217.194.0-255,4320,27430,96,348887
9686,0.00019,172.31.47.0-255,66,27496,96,348887
9687,0.000216,172.217.194.0-255,1484,28980,96,348887
9688,0.000218,172.31.47.0-255,66,29046,96,348887
9689,0.000223,172.217.194.0-255,2543,31589,96,348887
9690,0.000224,172.31.47.0-255,66,31655,96,348887
9691,0.000271,172.217.194.0-255,1484,33139,96,348887
9692,0.000275,172.31.47.0-255,66,33205,96,348887
9693,0.000278,172.217.194.0-255,1484,34689,96,348887
9694,0.00028,172.31.47.0-255,66,34755,96,348887
9695,0.000298,172.217.194.0-255,1484,36239,96,348887
9696,0.0003,172.31.47.0-255,66,36305,96,348887
9697,0.000309,172.217.194.0-255,5738,42043,96,348887
9698,0.000311,172.31.47.0-255,66,42109,96,348887
9699,0.00033,172.217.194.0-255,1484,43593,96,348887
9700,0.000331,172.31.47.0-255,66,43659,96,348887
9701,0.000352,172.217.194.0-255,5379,49038,96,348887
9702,0.000355,172.31.47.0-255,66,49104,96,348887
9703,0.000601,172.217.194.0-255,1484,50588,96,348887
9704,0.000607,172.217.194.0-255,1484,52072,96,348887
9705,0.00061,172.31.47.0-255,66,52138,96,348887
9706,0.000634,172.217.194.0-255,1484,53622,96,348887
9707,0.000641,172.217.194.0-255,5738,59360,96,348887
9708,0.000643,172.31.47.0-255,66,59426,96,348887
9709,0.000648,172.217.194.0-255,4320,63746,96,348887
9710,0.00065,172.31.47.0-255,66,63812,96,348887
9711,0.000669,172.217.194.0-255,2543,66355,96,348887
9712,0.000677,172.31.47.0-255,66,66421,96,348887
9713,0.00068,172.217.194.0-255,381,66802,96,348887
9714,0.000718,172.217.194.0-255,362,67164,96,348887
9715,0.000811,172.217.194.0-255,1484,68648,96,348887
9716,0.000814,172.31.47.0-255,66,68714,96,348887
9717,0.000819,172.217.194.0-255,2902,71616,96,348887
9718,0.000821,172.31.47.0-255,66,71682,96,348887
9719,0.000848,172.217.194.0-255,5738,77420,96,348887
9720,0.000851,172.31.47.0-255,66,77486,96,348887
9721,0.000885,172.217.194.0-255,4320,81806,96,348887
9722,0.000888,172.31.47.0-255,66,81872,96,348887
9723,0.000922,172.217.194.0-255,5379,87251,96,348887
9724,0.000931,172.217.194.0-255,1484,88735,96,348887
9725,0.000935,172.31.47.0-255,66,88801,96,348887
9726,0.000959,172.31.47.0-255,66,88867,96,348887
9727,0.000965,172.217.194.0-255,2543,91410,96,348887
9728,0.000967,172.31.47.0-255,66,91476,96,348887
9729,0.001275,172.217.194.0-255,1484,92960,96,348887
9730,0.00128,172.217.194.0-255,2902,95862,96,348887
9731,0.001283,172.31.47.0-255,66,95928,96,348887
9732,0.001301,172.217.194.0-255,5738,101666,96,348887
9733,0.001306,172.31.47.0-255,66,101732,96,348887
9734,0.001337,172.31.47.0-255,66,101798,96,348887
9735,0.001347,172.217.194.0-255,1484,103282,96,348887
9736,0.001377,172.31.47.0-255,66,103348,96,348887
9737,0.001983,172.217.194.0-255,1484,104832,96,348887
9738,0.001992,172.217.194.0-255,2902,107734,96,348887
9739,0.001996,172.31.47.0-255,66,107800,96,348887
9740,0.002001,172.217.194.0-255,2902,110702,96,348887
9741,0.002003,172.31.47.0-255,66,110768,96,348887
9742,0.002036,172.217.194.0-255,2902,113670,96,348887
9743,0.002038,172.31.47.0-255,66,113736,96,348887
9744,0.00205,172.31.47.0-255,66,113802,96,348887
9745,0.002057,172.217.194.0-255,7156,120958,96,348887
9746,0.002059,172.31.47.0-255,66,121024,96,348887
9747,0.002092,172.217.194.0-255,3602,124626,96,348887
9748,0.002094,172.31.47.0-255,66,124692,96,348887
9749,0.002121,172.217.194.0-255,4320,129012,96,348887
9750,0.002123,172.31.47.0-255,66,129078,96,348887
9751,0.002126,172.217.194.0-255,1484,130562,96,348887
9752,0.002153,172.217.194.0-255,5738,136300,96,348887
9753,0.002155,172.31.47.0-255,66,136366,96,348887
9754,0.002163,172.217.194.0-255,7156,143522,96,348887
9755,0.002165,172.31.47.0-255,66,143588,96,348887
9756,0.002192,172.217.194.0-255,5738,149326,96,348887
9757,0.002194,172.31.47.0-255,66,149392,96,348887
9758,0.0022,172.217.194.0-255,4320,153712,96,348887
9759,0.002202,172.31.47.0-255,66,153778,96,348887
9760,0.002235,172.217.194.0-255,5020,158798,96,348887
9761,0.002242,172.31.47.0-255,66,158864,96,348887
9762,0.004369,172.217.194.0-255,5738,164602,96,348887
9763,0.004375,172.31.47.0-255,66,164668,96,348887
9764,0.006466,172.217.194.0-255,5738,170406,96,348887
9765,0.006472,172.31.47.0-255,66,170472,96,348887
9766,0.008564,172.217.194.0-255,5738,176210,96,348887
9767,0.00857,172.31.47.0-255,66,176276,96,348887
9768,0.010695,172.217.194.0-255,5738,182014,96,348887
9769,0.010701,172.31.47.0-255,66,182080,96,348887
9770,0.012788,172.217.194.0-255,5738,187818,96,348887
9771,0.012795,172.31.47.0-255,66,187884,96,348887
9772,0.014885,172.217.194.0-255,5738,193622,96,348887
9773,0.014896,172.31.47.0-255,66,193688,96,348887
9774,0.017026,172.217.194.0-255,5738,199426,96,348887
9775,0.017034,172.31.47.0-255,66,199492,96,348887
9776,0.019138,172.217.194.0-255,5738,205230,96,348887
9777,0.019144,172.31.47.0-255,66,205296,96,348887
9778,0.021225,172.217.194.0-255,5738,211034,96,348887
9779,0.021231,172.31.47.0-255,66,211100,96,348887
9780,0.023323,172.217.194.0-255,5738,216838,96,348887
9781,0.02333,172.31.47.0-255,66,216904,96,348887
9782,0.024441,172.31.47.0-255,172,217076,96,348887
9783,0.024475,172.31.47.0-255,1109,218185,96,348887
9784,0.024535,172.31.47.0-255,1514,219699,96,348887
9785,0.024536,172.31.47.0-255,1302,221001,96,348887
9786,0.02545,172.217.194.0-255,5738,226739,96,348887
9787,0.025456,172.31.47.0-255,66,226805,96,348887
9788,0.025999,104.244.42.0-255,66,226871,96,348887
9789,0.026038,104.244.42.0-255,66,226937,96,348887
9790,0.026091,104.244.42.0-255,66,227003,96,348887
9791,0.02759,172.217.194.0-255,5738,232741,96,348887
9792,0.027595,172.31.47.0-255,66,232807,96,348887
9793,0.029669,172.217.194.0-255,5738,238545,96,348887
9794,0.029675,172.31.47.0-255,66,238611,96,348887
9795,0.031812,172.217.194.0-255,5738,244349,96,348887
9796,0.031819,172.31.47.0-255,66,244415,96,348887
9797,0.033912,172.217.194.0-255,5738,250153,96,348887
9798,0.033918,172.31.47.0-255,66,250219,96,348887
9799,0.03601,172.217.194.0-255,5738,255957,96,348887
9800,0.036016,172.31.47.0-255,66,256023,96,348887
9801,0.038127,172.217.194.0-255,5738,261761,96,348887
9802,0.038134,172.31.47.0-255,66,261827,96,348887
9803,0.040223,172.217.194.0-255,5738,267565,96,348887
9804,0.040228,172.31.47.0-255,66,267631,96,348887
9805,0.042361,172.217.194.0-255,5738,273369,96,348887
9806,0.042371,172.31.47.0-255,66,273435,96,348887
9807,0.044469,172.217.194.0-255,5738,279173,96,348887
9808,0.044476,172.31.47.0-255,66,279239,96,348887
9809,0.046632,172.217.194.0-255,5738,284977,96,348887
9810,0.046638,172.31.47.0-255,66,285043,96,348887
9811,0.048722,172.217.194.0-255,5738,290781,96,348887
9812,0.048727,172.31.47.0-255,66,290847,96,348887
9813,0.050837,172.217.194.0-255,5738,296585,96,348887
9814,0.050842,172.31.47.0-255,66,296651,96,348887
9815,0.052964,172.217.194.0-255,5738,302389,96,348887
9816,0.052969,172.31.47.0-255,66,302455,96,348887
9817,0.055104,172.217.194.0-255,5738,308193,96,348887
9818,0.055111,172.31.47.0-255,66,308259,96,348887
9819,0.057233,172.217.194.0-255,5738,313997,96,348887
9820,0.057239,172.31.47.0-255,66,314063,96,348887
9821,0.05936,172.217.194.0-255,5738,319801,96,348887
9822,0.059366,172.31.47.0-255,66,319867,96,348887
9823,0.061447,172.217.194.0-255,5738,325605,96,348887
9824,0.061452,172.31.47.0-255,66,325671,96,348887
9825,0.063544,172.217.194.0-255,5738,331409,96,348887
9826,0.063549,172.31.47.0-255,66,331475,96,348887
9827,0.065633,172.217.194.0-255,5738,337213,96,348887
9828,0.065638,172.31.47.0-255,66,337279,96,348887
9829,0.067763,172.217.194.0-255,5738,343017,96,348887
9830,0.067769,172.31.47.0-255,66,343083,96,348887
9831,0.069865,172.217.194.0-255,5738,348821,96,348887
9832,0.06987,172.31.47.0-255,66,348887,96,348887
9833,0.0,172.217.24.0-255,153,153,96,323695
9834,2.9e-05,172.31.47.0-255,66,219,96,323695
9835,3.6e-05,172.217.24.0-255,1484,1703,96,323695
9836,3.9e-05,172.31.47.0-255,66,1769,96,323695
9837,5.2e-05,172.217.24.0-255,2902,4671,96,323695
9838,5.5e-05,172.31.47.0-255,66,4737,96,323695
9839,6.2e-05,172.217.24.0-255,5738,10475,96,323695
9840,6.4e-05,172.31.47.0-255,66,10541,96,323695
9841,0.0001,172.217.24.0-255,3518,14059,96,323695
9842,0.000102,172.31.47.0-255,66,14125,96,323695
9843,0.0004,172.217.24.0-255,1484,15609,96,323695
9844,0.000405,172.31.47.0-255,66,15675,96,323695
9845,0.000414,172.217.24.0-255,2902,18577,96,323695
9846,0.000416,172.31.47.0-255,66,18643,96,323695
9847,0.000422,172.217.24.0-255,5738,24381,96,323695
9848,0.000424,172.31.47.0-255,66,24447,96,323695
9849,0.000438,172.217.24.0-255,6797,31244,96,323695
9850,0.000441,172.31.47.0-255,66,31310,96,323695
9851,0.000559,172.217.24.0-255,1484,32794,96,323695
9852,0.000563,172.31.47.0-255,66,32860,96,323695
9853,0.000569,172.217.24.0-255,2902,35762,96,323695
9854,0.000571,172.31.47.0-255,66,35828,96,323695
9855,0.000576,172.217.24.0-255,4320,40148,96,323695
9856,0.000579,172.31.47.0-255,66,40214,96,323695
9857,0.000614,172.217.24.0-255,1484,41698,96,323695
9858,0.000617,172.31.47.0-255,66,41764,96,323695
9859,0.000622,172.217.24.0-255,4320,46084,96,323695
9860,0.000625,172.31.47.0-255,66,46150,96,323695
9861,0.000658,172.217.24.0-255,2543,48693,96,323695
9862,0.000661,172.31.47.0-255,66,48759,96,323695
9863,0.001475,172.217.24.0-255,1484,50243,96,323695
9864,0.001482,172.31.47.0-255,66,50309,96,323695
9865,0.001488,172.217.24.0-255,2902,53211,96,323695
9866,0.00149,172.31.47.0-255,66,53277,96,323695
9867,0.001496,172.217.24.0-255,5738,59015,96,323695
9868,0.001498,172.31.47.0-255,66,59081,96,323695
9869,0.001507,172.217.24.0-255,4320,63401,96,323695
9870,0.00151,172.31.47.0-255,66,63467,96,323695
9871,0.00155,172.217.24.0-255,2543,66010,96,323695
9872,0.001553,172.31.47.0-255,66,66076,96,323695
9873,0.001578,172.217.24.0-255,2902,68978,96,323695
9874,0.00158,172.31.47.0-255,66,69044,96,323695
9875,0.001583,172.217.24.0-255,1484,70528,96,323695
9876,0.00161,172.217.24.0-255,5738,76266,96,323695
9877,0.001613,172.31.47.0-255,66,76332,96,323695
9878,0.001617,172.217.24.0-255,4320,80652,96,323695
9879,0.00162,172.31.47.0-255,66,80718,96,323695
9880,0.001677,172.217.24.0-255,4541,85259,96,323695
9881,0.00168,172.31.47.0-255,66,85325,96,323695
9882,0.001685,172.217.24.0-255,5738,91063,96,323695
9883,0.001688,172.31.47.0-255,66,91129,96,323695
9884,0.001704,172.217.24.0-255,2902,94031,96,323695
9885,0.001706,172.31.47.0-255,66,94097,96,323695
9886,0.001735,172.217.24.0-255,6797,100894,96,323695
9887,0.001738,172.31.47.0-255,66,100960,96,323695
9888,0.001767,172.217.24.0-255,1484,102444,96,323695
9889,0.001801,172.217.24.0-255,2902,105346,96,323695
9890,0.001804,172.31.47.0-255,66,105412,96,323695
9891,0.001828,172.217.24.0-255,4320,109732,96,323695
9892,0.00183,172.31.47.0-255,66,109798,96,323695
9893,0.001836,172.217.24.0-255,4320,114118,96,323695
9894,0.001838,172.31.47.0-255,66,114184,96,323695
9895,0.001865,172.217.24.0-255,3297,117481,96,323695
9896,0.001868,172.31.47.0-255,66,117547,96,323695
9897,0.00376,172.217.24.0-255,1484,119031,96,323695
9898,0.003784,172.217.24.0-255,4320,123351,96,323695
9899,0.003789,172.31.47.0-255,66,123417,96,323695
9900,0.005695,172.217.24.0-255,5738,129155,96,323695
9901,0.005702,172.31.47.0-255,66,129221,96,323695
9902,0.007599,172.217.24.0-255,5738,134959,96,323695
9903,0.007605,172.31.47.0-255,66,135025,96,323695
9904,0.009512,172.217.24.0-255,5738,140763,96,323695
9905,0.009521,172.31.47.0-255,66,140829,96,323695
9906,0.011423,172.217.24.0-255,5738,146567,96,323695
9907,0.01143,172.31.47.0-255,66,146633,96,323695
9908,0.01334,172.217.24.0-255,5738,152371,96,323695
9909,0.013347,172.31.47.0-255,66,152437,96,323695
9910,0.015253,172.217.24.0-255,5738,158175,96,323695
9911,0.01526,172.31.47.0-255,66,158241,96,323695
9912,0.017174,172.217.24.0-255,5738,163979,96,323695
9913,0.017181,172.31.47.0-255,66,164045,96,323695
9914,0.019098,172.217.24.0-255,5738,169783,96,323695
9915,0.019105,172.31.47.0-255,66,169849,96,323695
9916,0.021011,172.217.24.0-255,5738,175587,96,323695
9917,0.021018,172.31.47.0-255,66,175653,96,323695
9918,0.021481,172.31.47.0-255,171,175824,96,323695
9919,0.021512,172.31.47.0-255,1125,176949,96,323695
9920,0.021548,172.31.47.0-255,1514,178463,96,323695
9921,0.02155,172.31.47.0-255,1286,179749,96,323695
9922,0.022928,172.217.24.0-255,5738,185487,96,323695
9923,0.022935,172.31.47.0-255,66,185553,96,323695
9924,0.023042,104.244.42.0-255,66,185619,96,323695
9925,0.023068,104.244.42.0-255,66,185685,96,323695
9926,0.0231,104.244.42.0-255,66,185751,96,323695
9927,0.024839,172.217.24.0-255,4320,190071,96,323695
9928,0.024845,172.31.47.0-255,66,190137,96,323695
9929,0.024877,172.217.24.0-255,1484,191621,96,323695
9930,0.026742,172.217.24.0-255,4320,195941,96,323695
9931,0.026747,172.31.47.0-255,66,196007,96,323695
9932,0.028658,172.217.24.0-255,5738,201745,96,323695
9933,0.028664,172.31.47.0-255,66,201811,96,323695
9934,0.030572,172.217.24.0-255,5738,207549,96,323695
9935,0.030578,172.31.47.0-255,66,207615,96,323695
9936,0.032484,172.217.24.0-255,5738,213353,96,323695
9937,0.032489,172.31.47.0-255,66,213419,96,323695
9938,0.034389,172.217.24.0-255,5738,219157,96,323695
9939,0.034394,172.31.47.0-255,66,219223,96,323695
9940,0.036291,172.217.24.0-255,5738,224961,96,323695
9941,0.036297,172.31.47.0-255,66,225027,96,323695
9942,0.038193,172.217.24.0-255,5738,230765,96,323695
9943,0.038199,172.31.47.0-255,66,230831,96,323695
9944,0.040099,172.217.24.0-255,5738,236569,96,323695
9945,0.040104,172.31.47.0-255,66,236635,96,323695
9946,0.042,172.217.24.0-255,5738,242373,96,323695
9947,0.042005,172.31.47.0-255,66,242439,96,323695
9948,0.0439,172.217.24.0-255,5738,248177,96,323695
9949,0.043906,172.31.47.0-255,66,248243,96,323695
9950,0.045817,172.217.24.0-255,5738,253981,96,323695
9951,0.045824,172.31.47.0-255,66,254047,96,323695
9952,0.047748,172.217.24.0-255,5738,259785,96,323695
9953,0.047759,172.31.47.0-255,66,259851,96,323695
9954,0.049675,172.217.24.0-255,5738,265589,96,323695
9955,0.049688,172.31.47.0-255,66,265655,96,323695
9956,0.051629,172.217.24.0-255,5738,271393,96,323695
9957,0.051638,172.31.47.0-255,66,271459,96,323695
9958,0.053541,172.217.24.0-255,5738,277197,96,323695
9959,0.053548,172.31.47.0-255,66,277263,96,323695
9960,0.055451,172.217.24.0-255,5738,283001,96,323695
9961,0.055457,172.31.47.0-255,66,283067,96,323695
9962,0.057359,172.217.24.0-255,5738,288805,96,323695
9963,0.057366,172.31.47.0-255,66,288871,96,323695
9964,0.059274,172.217.24.0-255,5738,294609,96,323695
9965,0.059284,172.31.47.0-255,66,294675,96,323695
9966,0.061189,172.217.24.0-255,5738,300413,96,323695
9967,0.061195,172.31.47.0-255,66,300479,96,323695
9968,0.063109,172.217.24.0-255,5738,306217,96,323695
9969,0.063149,172.31.47.0-255,66,306283,96,323695
9970,0.065066,172.217.24.0-255,5738,312021,96,323695
9971,0.065077,172.31.47.0-255,66,312087,96,323695
9972,0.066988,172.217.24.0-255,5738,317825,96,323695
9973,0.067003,172.31.47.0-255,66,317891,96,323695
9974,0.068926,172.217.24.0-255,5738,323629,96,323695
9975,0.068946,172.31.47.0-255,66,323695,96,323695
9976,0.0,74.125.24.0-255,66,66,96,66
9977,0.0,74.125.24.0-255,153,153,96,276128
9978,2.5e-05,172.31.47.0-255,66,219,96,276128
9979,3.2e-05,74.125.24.0-255,1484,1703,96,276128
9980,3.6e-05,172.31.47.0-255,66,1769,96,276128
9981,5.1e-05,74.125.24.0-255,2902,4671,96,276128
9982,5.4e-05,172.31.47.0-255,66,4737,96,276128
9983,6.2e-05,74.125.24.0-255,7156,11893,96,276128
9984,6.4e-05,172.31.47.0-255,66,11959,96,276128
9985,6.8e-05,74.125.24.0-255,2066,14025,96,276128
9986,7.1e-05,172.31.47.0-255,66,14091,96,276128
9987,0.000322,74.125.24.0-255,1484,15575,96,276128
9988,0.000327,172.31.47.0-255,66,15641,96,276128
9989,0.000334,74.125.24.0-255,2902,18543,96,276128
9990,0.000337,172.31.47.0-255,66,18609,96,276128
9991,0.000372,74.125.24.0-255,5738,24347,96,276128
9992,0.000376,172.31.47.0-255,66,24413,96,276128
9993,0.000383,74.125.24.0-255,6797,31210,96,276128
9994,0.000386,172.31.47.0-255,66,31276,96,276128
9995,0.000442,74.125.24.0-255,5738,37014,96,276128
9996,0.000446,172.31.47.0-255,66,37080,96,276128
9997,0.000454,74.125.24.0-255,7156,44236,96,276128
9998,0.000457,172.31.47.0-255,66,44302,96,276128
9999,0.00049,74.125.24.0-255,3961,48263,96,276128
10000,0.000495,172.31.47.0-255,66,48329,96,276128
10001,0.001156,74.125.24.0-255,1484,49813,96,276128
10002,0.001162,172.31.47.0-255,66,49879,96,276128
10003,0.001171,74.125.24.0-255,2902,52781,96,276128
10004,0.001174,172.31.47.0-255,66,52847,96,276128
10005,0.001188,74.125.24.0-255,5738,58585,96,276128
10006,0.001191,172.31.47.0-255,66,58651,96,276128
10007,0.001196,74.125.24.0-255,2902,61553,96,276128
10008,0.001198,172.31.47.0-255,66,61619,96,276128
10009,0.001225,74.125.24.0-255,1484,63103,96,276128
10010,0.001232,74.125.24.0-255,4320,67423,96,276128
10011,0.001236,172.31.47.0-255,66,67489,96,276128
10012,0.001275,172.31.47.0-255,66,67555,96,276128
10013,0.001291,172.31.47.0-255,66,67621,96,276128
10014,0.001295,74.125.24.0-255,1484,69105,96,276128
10015,0.0013,74.125.24.0-255,2902,72007,96,276128
10016,0.001302,172.31.47.0-255,66,72073,96,276128
10017,0.001315,74.125.24.0-255,2902,74975,96,276128
10018,0.001318,172.31.47.0-255,66,75041,96,276128
10019,0.001346,74.125.24.0-255,2902,77943,96,276128
10020,0.001353,172.31.47.0-255,66,78009,96,276128
10021,0.001373,74.125.24.0-255,6797,84806,96,276128
10022,0.001376,172.31.47.0-255,66,84872,96,276128
10023,0.002021,74.125.24.0-255,1484,86356,96,276128
10024,0.002036,74.125.24.0-255,2902,89258,96,276128
10025,0.002038,172.31.47.0-255,66,89324,96,276128
10026,0.002065,74.125.24.0-255,4320,93644,96,276128
10027,0.002068,172.31.47.0-255,66,93710,96,276128
10028,0.002075,74.125.24.0-255,7156,100866,96,276128
10029,0.002077,172.31.47.0-255,66,100932,96,276128
10030,0.002099,74.125.24.0-255,1484,102416,96,276128
10031,0.002129,172.31.47.0-255,66,102482,96,276128
10032,0.002156,74.125.24.0-255,3602,106084,96,276128
10033,0.002158,172.31.47.0-255,66,106150,96,276128
10034,0.004589,74.125.24.0-255,1484,107634,96,276128
10035,0.004598,74.125.24.0-255,2902,110536,96,276128
10036,0.004603,172.31.47.0-255,66,110602,96,276128
10037,0.004608,74.125.24.0-255,1484,112086,96,276128
10038,0.006892,74.125.24.0-255,4320,116406,96,276128
10039,0.006898,172.31.47.0-255,66,116472,96,276128
10040,0.009181,74.125.24.0-255,5738,122210,96,276128
10041,0.009192,172.31.47.0-255,66,122276,96,276128
10042,0.011456,74.125.24.0-255,5738,128014,96,276128
10043,0.011468,172.31.47.0-255,66,128080,96,276128
10044,0.013738,74.125.24.0-255,5738,133818,96,276128
10045,0.013755,172.31.47.0-255,66,133884,96,276128
10046,0.016036,74.125.24.0-255,5738,139622,96,276128
10047,0.016046,172.31.47.0-255,66,139688,96,276128
10048,0.018319,74.125.24.0-255,5738,145426,96,276128
10049,0.018327,172.31.47.0-255,66,145492,96,276128
10050,0.020615,74.125.24.0-255,5738,151230,96,276128
10051,0.020625,172.31.47.0-255,66,151296,96,276128
10052,0.022917,74.125.24.0-255,5738,157034,96,276128
10053,0.022931,172.31.47.0-255,66,157100,96,276128
10054,0.025207,74.125.24.0-255,4320,161420,96,276128
10055,0.025213,172.31.47.0-255,66,161486,96,276128
10056,0.025263,74.125.24.0-255,1484,162970,96,276128
10057,0.02748,74.125.24.0-255,4320,167290,96,276128
10058,0.027492,172.31.47.0-255,66,167356,96,276128
10059,0.029263,172.31.47.0-255,176,167532,96,276128
10060,0.029295,172.31.47.0-255,1105,168637,96,276128
10061,0.02934,172.31.47.0-255,1514,170151,96,276128
10062,0.029342,172.31.47.0-255,1307,171458,96,276128
10063,0.029738,74.125.24.0-255,5738,177196,96,276128
10064,0.029745,172.31.47.0-255,66,177262,96,276128
10065,0.030826,104.244.42.0-255,66,177328,96,276128
10066,0.031011,104.244.42.0-255,66,177394,96,276128
10067,0.031018,104.244.42.0-255,66,177460,96,276128
10068,0.032005,74.125.24.0-255,5738,183198,96,276128
10069,0.032013,172.31.47.0-255,66,183264,96,276128
10070,0.034318,74.125.24.0-255,5738,189002,96,276128
10071,0.034326,172.31.47.0-255,66,189068,96,276128
10072,0.036598,74.125.24.0-255,5738,194806,96,276128
10073,0.036605,172.31.47.0-255,66,194872,96,276128
10074,0.038903,74.125.24.0-255,5738,200610,96,276128
10075,0.038915,172.31.47.0-255,66,200676,96,276128
10076,0.041176,74.125.24.0-255,5738,206414,96,276128
10077,0.041184,172.31.47.0-255,66,206480,96,276128
10078,0.04347,74.125.24.0-255,5738,212218,96,276128
10079,0.043483,172.31.47.0-255,66,212284,96,276128
10080,0.045749,74.125.24.0-255,5738,218022,96,276128
10081,0.045765,172.31.47.0-255,66,218088,96,276128
10082,0.048067,74.125.24.0-255,5738,223826,96,276128
10083,0.048082,172.31.47.0-255,66,223892,96,276128
10084,0.050384,74.125.24.0-255,5738,229630,96,276128
10085,0.050402,172.31.47.0-255,66,229696,96,276128
10086,0.052684,74.125.24.0-255,5738,235434,96,276128
10087,0.052693,172.31.47.0-255,66,235500,96,276128
10088,0.05497,74.125.24.0-255,5738,241238,96,276128
10089,0.054981,172.31.47.0-255,66,241304,96,276128
10090,0.057271,74.125.24.0-255,5738,247042,96,276128
10091,0.057291,172.31.47.0-255,66,247108,96,276128
10092,0.059599,74.125.24.0-255,5738,252846,96,276128
10093,0.059617,172.31.47.0-255,66,252912,96,276128
10094,0.061907,74.125.24.0-255,5738,258650,96,276128
10095,0.061922,172.31.47.0-255,66,258716,96,276128
10096,0.064193,74.125.24.0-255,5738,264454,96,276128
10097,0.064208,172.31.47.0-255,66,264520,96,276128
10098,0.066493,74.125.24.0-255,5738,270258,96,276128
10099,0.066509,172.31.47.0-255,66,270324,96,276128
10100,0.068772,74.125.24.0-255,5738,276062,96,276128
10101,0.068778,172.31.47.0-255,66,276128,96,276128
10102,0.0,74.125.24.0-255,146,146,96,278175
10103,2.4e-05,172.31.47.0-255,66,212,96,278175
10104,3.1e-05,74.125.24.0-255,1484,1696,96,278175
10105,3.5e-05,172.31.47.0-255,66,1762,96,278175
10106,3.9e-05,74.125.24.0-255,2902,4664,96,278175
10107,4.8e-05,172.31.47.0-255,66,4730,96,278175
10108,5.3e-05,74.125.24.0-255,7156,11886,96,278175
10109,5.6e-05,172.31.47.0-255,66,11952,96,278175
10110,8.3e-05,74.125.24.0-255,2092,14044,96,278175
10111,8.5e-05,172.31.47.0-255,66,14110,96,278175
10112,0.000144,74.125.24.0-255,1484,15594,96,278175
10113,0.000147,172.31.47.0-255,66,15660,96,278175
10114,0.000152,74.125.24.0-255,2902,18562,96,278175
10115,0.000155,172.31.47.0-255,66,18628,96,278175
10116,0.00019,74.125.24.0-255,5738,24366,96,278175
10117,0.000193,172.31.47.0-255,66,24432,96,278175
10118,0.000196,74.125.24.0-255,1484,25916,96,278175
10119,0.000197,172.31.47.0-255,66,25982,96,278175
10120,0.000239,172.31.47.0-255,66,26048,96,278175
10121,0.000264,74.125.24.0-255,5379,31427,96,278175
10122,0.000268,172.31.47.0-255,66,31493,96,278175
10123,0.000273,74.125.24.0-255,4320,35813,96,278175
10124,0.000276,172.31.47.0-255,66,35879,96,278175
10125,0.000298,74.125.24.0-255,3961,39840,96,278175
10126,0.000301,172.31.47.0-255,66,39906,96,278175
10127,0.000316,172.31.47.0-255,66,39972,96,278175
10128,0.000323,74.125.24.0-255,5738,45710,96,278175
10129,0.000325,172.31.47.0-255,66,45776,96,278175
10130,0.000376,74.125.24.0-255,2543,48319,96,278175
10131,0.00038,172.31.47.0-255,66,48385,96,278175
10132,0.000382,74.125.24.0-255,360,48745,96,278175
10133,0.000383,172.31.47.0-255,66,48811,96,278175
10134,0.000468,74.125.24.0-255,127,48938,96,278175
10135,0.000489,74.125.24.0-255,352,49290,96,278175
10136,0.000578,74.125.24.0-255,1484,50774,96,278175
10137,0.000583,74.125.24.0-255,2902,53676,96,278175
10138,0.00059,172.31.47.0-255,66,53742,96,278175
10139,0.000601,74.125.24.0-255,5738,59480,96,278175
10140,0.000606,172.31.47.0-255,66,59546,96,278175
10141,0.000631,74.125.24.0-255,6249,65795,96,278175
10142,0.000637,172.31.47.0-255,66,65861,96,278175
10143,0.000764,74.125.24.0-255,1484,67345,96,278175
10144,0.000769,74.125.24.0-255,2902,70247,96,278175
10145,0.000773,172.31.47.0-255,66,70313,96,278175
10146,0.000789,74.125.24.0-255,2902,73215,96,278175
10147,0.000798,172.31.47.0-255,66,73281,96,278175
10148,0.0008,74.125.24.0-255,2902,76183,96,278175
10149,0.000815,172.31.47.0-255,66,76249,96,278175
10150,0.000839,74.125.24.0-255,2902,79151,96,278175
10151,0.00085,172.31.47.0-255,66,79217,96,278175
10152,0.00087,172.31.47.0-255,66,79283,96,278175
10153,0.001009,74.125.24.0-255,1484,80767,96,278175
10154,0.001015,74.125.24.0-255,2902,83669,96,278175
10155,0.001018,172.31.47.0-255,66,83735,96,278175
10156,0.001024,74.125.24.0-255,4320,88055,96,278175
10157,0.001033,172.31.47.0-255,66,88121,96,278175
10158,0.001042,74.125.24.0-255,1484,89605,96,278175
10159,0.001051,74.125.24.0-255,4320,93925,96,278175
10160,0.001057,172.31.47.0-255,66,93991,96,278175
10161,0.001092,172.31.47.0-255,66,94057,96,278175
10162,0.001107,74.125.24.0-255,766,94823,96,278175
10163,0.001107,172.31.47.0-255,66,94889,96,278175
10164,0.001124,74.125.24.0-255,1484,96373,96,278175
10165,0.001127,172.31.47.0-255,66,96439,96,278175
10166,0.001155,74.125.24.0-255,4320,100759,96,278175
10167,0.001158,74.125.24.0-255,1484,102243,96,278175
10168,0.001172,172.31.47.0-255,66,102309,96,278175
10169,0.001178,74.125.24.0-255,5738,108047,96,278175
10170,0.001181,74.125.24.0-255,1484,109531,96,278175
10171,0.001185,172.31.47.0-255,66,109597,96,278175
10172,0.001213,74.125.24.0-255,7156,116753,96,278175
10173,0.001218,172.31.47.0-255,66,116819,96,278175
10174,0.001219,74.125.24.0-255,2902,119721,96,278175
10175,0.001222,172.31.47.0-255,66,119787,96,278175
10176,0.0013,74.125.24.0-255,1484,121271,96,278175
10177,0.001304,74.125.24.0-255,2902,124173,96,278175
10178,0.001307,74.125.24.0-255,2902,127075,96,278175
10179,0.001312,172.31.47.0-255,66,127141,96,278175
10180,0.001339,74.125.24.0-255,4320,131461,96,278175
10181,0.001342,74.125.24.0-255,1484,132945,96,278175
10182,0.001344,172.31.47.0-255,66,133011,96,278175
10183,0.001378,74.125.24.0-255,7156,140167,96,278175
10184,0.001383,74.125.24.0-255,5738,145905,96,278175
10185,0.001404,74.125.24.0-255,5738,151643,96,278175
10186,0.001421,74.125.24.0-255,2184,153827,96,278175
10187,0.001435,172.31.47.0-255,66,153893,96,278175
10188,0.001442,74.125.24.0-255,2902,156795,96,278175
10189,0.001451,172.31.47.0-255,66,156861,96,278175
10190,0.00146,74.125.24.0-255,4320,161181,96,278175
10191,0.001465,172.31.47.0-255,66,161247,96,278175
10192,0.001478,74.125.24.0-255,2902,164149,96,278175
10193,0.001488,74.125.24.0-255,5738,169887,96,278175
10194,0.001489,172.31.47.0-255,66,169953,96,278175
10195,0.001493,172.31.47.0-255,66,170019,96,278175
10196,0.001537,172.31.47.0-255,66,170085,96,278175
10197,0.001542,74.125.24.0-255,3602,173687,96,278175
10198,0.001548,172.31.47.0-255,66,173753,96,278175
10199,0.001584,74.125.24.0-255,1484,175237,96,278175
10200,0.001601,74.125.24.0-255,2902,178139,96,278175
10201,0.001607,74.125.24.0-255,5738,183877,96,278175
10202,0.001617,172.31.47.0-255,66,183943,96,278175
10203,0.001652,172.31.47.0-255,66,184009,96,278175
10204,0.001673,74.125.24.0-255,2902,186911,96,278175
10205,0.001683,172.31.47.0-255,66,186977,96,278175
10206,0.001688,172.31.47.0-255,66,187043,96,278175
10207,0.00187,74.125.24.0-255,1484,188527,96,278175
10208,0.001876,74.125.24.0-255,1484,190011,96,278175
10209,0.00188,172.31.47.0-255,66,190077,96,278175
10210,0.001899,74.125.24.0-255,1484,191561,96,278175
10211,0.001905,74.125.24.0-255,5738,197299,96,278175
10212,0.001908,172.31.47.0-255,66,197365,96,278175
10213,0.00195,172.31.47.0-255,66,197431,96,278175
10214,0.001961,74.125.24.0-255,2902,200333,96,278175
10215,0.001975,172.31.47.0-255,66,200399,96,278175
10216,0.001981,74.125.24.0-255,2902,203301,96,278175
10217,0.001992,172.31.47.0-255,66,203367,96,278175
10218,0.00203,172.31.47.0-255,66,203433,96,278175
10219,0.002068,74.125.24.0-255,1484,204917,96,278175
10220,0.002087,74.125.24.0-255,2902,207819,96,278175
10221,0.002098,172.31.47.0-255,66,207885,96,278175
10222,0.002108,74.125.24.0-255,2902,210787,96,278175
10223,0.002115,172.31.47.0-255,66,210853,96,278175
10224,0.002144,74.125.24.0-255,1484,212337,96,278175
10225,0.002159,74.125.24.0-255,4320,216657,96,278175
10226,0.002161,74.125.24.0-255,1484,218141,96,278175
10227,0.002169,172.31.47.0-255,66,218207,96,278175
10228,0.002201,74.125.24.0-255,7156,225363,96,278175
10229,0.002206,172.31.47.0-255,66,225429,96,278175
10230,0.002207,74.125.24.0-255,3602,229031,96,278175
10231,0.002211,172.31.47.0-255,66,229097,96,278175
10232,0.002237,74.125.24.0-255,2902,231999,96,278175
10233,0.002247,172.31.47.0-255,66,232065,96,278175
10234,0.002276,74.125.24.0-255,5738,237803,96,278175
10235,0.002281,74.125.24.0-255,2902,240705,96,278175
10236,0.002285,172.31.47.0-255,66,240771,96,278175
10237,0.00229,172.31.47.0-255,66,240837,96,278175
10238,0.002336,172.31.47.0-255,66,240903,96,278175
10239,0.002356,74.125.24.0-255,1484,242387,96,278175
10240,0.002365,74.125.24.0-255,1484,243871,96,278175
10241,0.002368,172.31.47.0-255,66,243937,96,278175
10242,0.002371,74.125.24.0-255,7156,251093,96,278175
10243,0.002376,74.125.24.0-255,3602,254695,96,278175
10244,0.002379,74.125.24.0-255,2902,257597,96,278175
10245,0.002383,172.31.47.0-255,66,257663,96,278175
10246,0.002391,74.125.24.0-255,4320,261983,96,278175
10247,0.002396,172.31.47.0-255,66,262049,96,278175
10248,0.002432,74.125.24.0-255,7156,269205,96,278175
10249,0.002436,74.125.24.0-255,1484,270689,96,278175
10250,0.002448,172.31.47.0-255,66,270755,96,278175
10251,0.002449,74.125.24.0-255,2717,273472,96,278175
10252,0.002452,172.31.47.0-255,66,273538,96,278175
10253,0.002492,74.125.24.0-255,105,273643,96,278175
10254,0.003743,172.31.47.0-255,66,273709,96,278175
10255,0.003764,172.31.47.0-255,105,273814,96,278175
10256,0.005771,74.125.24.0-255,66,273880,96,278175
10257,0.025719,172.31.47.0-255,172,274052,96,278175
10258,0.025772,172.31.47.0-255,1110,275162,96,278175
10259,0.0258,172.31.47.0-255,1514,276676,96,278175
10260,0.025802,172.31.47.0-255,1301,277977,96,278175
10261,0.027302,104.244.42.0-255,66,278043,96,278175
10262,0.027428,104.244.42.0-255,66,278109,96,278175
10263,0.027446,104.244.42.0-255,66,278175,96,278175
10264,0.0,74.125.24.0-255,153,153,96,240846
10265,1.4e-05,172.31.47.0-255,66,219,96,240846
10266,2e-05,74.125.24.0-255,1484,1703,96,240846
10267,2.5e-05,172.31.47.0-255,66,1769,96,240846
10268,2.9e-05,74.125.24.0-255,2902,4671,96,240846
10269,3.2e-05,172.31.47.0-255,66,4737,96,240846
10270,3.9e-05,74.125.24.0-255,7156,11893,96,240846
10271,4.2e-05,172.31.47.0-255,66,11959,96,240846
10272,7.4e-05,74.125.24.0-255,7156,19115,96,240846
10273,7.7e-05,172.31.47.0-255,66,19181,96,240846
10274,9.6e-05,172.31.47.0-255,66,19247,96,240846
10275,9.9e-05,74.125.24.0-255,1484,20731,96,240846
10276,0.000101,172.31.47.0-255,66,20797,96,240846
10277,0.000103,74.125.24.0-255,1125,21922,96,240846
10278,0.000105,172.31.47.0-255,66,21988,96,240846
10279,0.000148,74.125.24.0-255,1484,23472,96,240846
10280,0.00015,172.31.47.0-255,66,23538,96,240846
10281,0.000156,74.125.24.0-255,4320,27858,96,240846
10282,0.000158,172.31.47.0-255,66,27924,96,240846
10283,0.000175,74.125.24.0-255,4320,32244,96,240846
10284,0.000177,172.31.47.0-255,66,32310,96,240846
10285,0.000196,74.125.24.0-255,1484,33794,96,240846
10286,0.000199,172.31.47.0-255,66,33860,96,240846
10287,0.000234,172.31.47.0-255,66,33926,96,240846
10288,0.000244,172.31.47.0-255,66,33992,96,240846
10289,0.000403,74.125.24.0-255,135,34127,96,240846
10290,0.000407,172.31.47.0-255,66,34193,96,240846
10291,0.000522,74.125.24.0-255,1484,35677,96,240846
10292,0.000525,172.31.47.0-255,66,35743,96,240846
10293,0.00053,74.125.24.0-255,2902,38645,96,240846
10294,0.000533,172.31.47.0-255,66,38711,96,240846
10295,0.000553,74.125.24.0-255,5738,44449,96,240846
10296,0.000556,172.31.47.0-255,66,44515,96,240846
10297,0.000558,74.125.24.0-255,1484,45999,96,240846
10298,0.000569,74.125.24.0-255,2902,48901,96,240846
10299,0.000574,172.31.47.0-255,66,48967,96,240846
10300,0.000592,74.125.24.0-255,6797,55764,96,240846
10301,0.000594,172.31.47.0-255,66,55830,96,240846
10302,0.000622,172.31.47.0-255,66,55896,96,240846
10303,0.000636,74.125.24.0-255,343,56239,96,240846
10304,0.000855,74.125.24.0-255,1484,57723,96,240846
10305,0.000859,172.31.47.0-255,66,57789,96,240846
10306,0.000864,74.125.24.0-255,2902,60691,96,240846
10307,0.000866,172.31.47.0-255,66,60757,96,240846
10308,0.000871,74.125.24.0-255,5738,66495,96,240846
10309,0.000873,172.31.47.0-255,66,66561,96,240846
10310,0.000918,172.31.47.0-255,66,66627,96,240846
10311,0.000924,74.125.24.0-255,7156,73783,96,240846
10312,0.000926,172.31.47.0-255,66,73849,96,240846
10313,0.000958,74.125.24.0-255,3602,77451,96,240846
10314,0.00096,172.31.47.0-255,66,77517,96,240846
10315,0.001007,74.125.24.0-255,1484,79001,96,240846
10316,0.00101,74.125.24.0-255,1484,80485,96,240846
10317,0.001013,172.31.47.0-255,66,80551,96,240846
10318,0.001035,74.125.24.0-255,1484,82035,96,240846
10319,0.001041,74.125.24.0-255,5738,87773,96,240846
10320,0.001043,172.31.47.0-255,66,87839,96,240846
10321,0.001055,172.31.47.0-255,66,87905,96,240846
10322,0.001061,74.125.24.0-255,5738,93643,96,240846
10323,0.001063,172.31.47.0-255,66,93709,96,240846
10324,0.001076,74.125.24.0-255,1484,95193,96,240846
10325,0.001101,74.125.24.0-255,4320,99513,96,240846
10326,0.001104,172.31.47.0-255,66,99579,96,240846
10327,0.001124,74.125.24.0-255,2184,101763,96,240846
10328,0.001126,172.31.47.0-255,66,101829,96,240846
10329,0.001132,74.125.24.0-255,7156,108985,96,240846
10330,0.001134,172.31.47.0-255,66,109051,96,240846
10331,0.001144,172.31.47.0-255,66,109117,96,240846
10332,0.001172,74.125.24.0-255,7156,116273,96,240846
10333,0.001183,172.31.47.0-255,66,116339,96,240846
10334,0.001185,172.31.47.0-255,66,116405,96,240846
10335,0.001239,74.125.24.0-255,1484,117889,96,240846
10336,0.001251,74.125.24.0-255,2902,120791,96,240846
10337,0.001253,172.31.47.0-255,66,120857,96,240846
10338,0.00126,74.125.24.0-255,5738,126595,96,240846
10339,0.001261,172.31.47.0-255,66,126661,96,240846
10340,0.001309,172.31.47.0-255,66,126727,96,240846
10341,0.001315,74.125.24.0-255,5738,132465,96,240846
10342,0.001316,172.31.47.0-255,66,132531,96,240846
10343,0.00133,74.125.24.0-255,5020,137551,96,240846
10344,0.001333,172.31.47.0-255,66,137617,96,240846
10345,0.001381,74.125.24.0-255,1484,139101,96,240846
10346,0.001386,74.125.24.0-255,2902,142003,96,240846
10347,0.001388,172.31.47.0-255,66,142069,96,240846
10348,0.001408,74.125.24.0-255,5738,147807,96,240846
10349,0.00141,172.31.47.0-255,66,147873,96,240846
10350,0.001416,74.125.24.0-255,5738,153611,96,240846
10351,0.001417,172.31.47.0-255,66,153677,96,240846
10352,0.001437,74.125.24.0-255,5738,159415,96,240846
10353,0.00144,172.31.47.0-255,66,159481,96,240846
10354,0.001457,74.125.24.0-255,7156,166637,96,240846
10355,0.001459,172.31.47.0-255,66,166703,96,240846
10356,0.001464,74.125.24.0-255,2902,169605,96,240846
10357,0.001466,172.31.47.0-255,66,169671,96,240846
10358,0.001496,172.31.47.0-255,66,169737,96,240846
10359,0.00156,74.125.24.0-255,1484,171221,96,240846
10360,0.001563,74.125.24.0-255,2902,174123,96,240846
10361,0.001567,172.31.47.0-255,66,174189,96,240846
10362,0.00157,172.31.47.0-255,66,174255,96,240846
10363,0.00159,74.125.24.0-255,5738,179993,96,240846
10364,0.001593,172.31.47.0-255,66,180059,96,240846
10365,0.001598,74.125.24.0-255,5738,185797,96,240846
10366,0.001601,172.31.47.0-255,66,185863,96,240846
10367,0.00163,74.125.24.0-255,7156,193019,96,240846
10368,0.001634,172.31.47.0-255,66,193085,96,240846
10369,0.001643,172.31.47.0-255,66,193151,96,240846
10370,0.001662,74.125.24.0-255,5020,198171,96,240846
10371,0.001664,172.31.47.0-255,66,198237,96,240846
10372,0.00167,74.125.24.0-255,5738,203975,96,240846
10373,0.001672,172.31.47.0-255,66,204041,96,240846
10374,0.001706,172.31.47.0-255,66,204107,96,240846
10375,0.001714,74.125.24.0-255,2902,207009,96,240846
10376,0.001716,172.31.47.0-255,66,207075,96,240846
10377,0.001722,74.125.24.0-255,7156,214231,96,240846
10378,0.001724,172.31.47.0-255,66,214297,96,240846
10379,0.001739,74.125.24.0-255,5020,219317,96,240846
10380,0.001741,172.31.47.0-255,66,219383,96,240846
10381,0.001758,74.125.24.0-255,2902,222285,96,240846
10382,0.001761,172.31.47.0-255,66,222351,96,240846
10383,0.001799,172.31.47.0-255,66,222417,96,240846
10384,0.001805,74.125.24.0-255,6438,228855,96,240846
10385,0.001808,172.31.47.0-255,66,228921,96,240846
10386,0.001826,74.125.24.0-255,7156,236077,96,240846
10387,0.001828,172.31.47.0-255,66,236143,96,240846
10388,0.001852,172.31.47.0-255,66,236209,96,240846
10389,0.001866,74.125.24.0-255,105,236314,96,240846
10390,0.003901,172.31.47.0-255,66,236380,96,240846
10391,0.003936,172.31.47.0-255,105,236485,96,240846
10392,0.006165,74.125.24.0-255,66,236551,96,240846
10393,0.026817,172.31.47.0-255,172,236723,96,240846
10394,0.026847,172.31.47.0-255,1110,237833,96,240846
10395,0.026902,172.31.47.0-255,1514,239347,96,240846
10396,0.026904,172.31.47.0-255,1301,240648,96,240846
10397,0.028374,104.244.42.0-255,66,240714,96,240846
10398,0.028401,104.244.42.0-255,66,240780,96,240846
10399,0.028449,104.244.42.0-255,66,240846,96,240846
10400,0.0,172.217.194.0-255,304,304,96,291109
10401,1.3e-05,172.31.47.0-255,66,370,96,291109
10402,1.9e-05,172.217.194.0-255,1484,1854,96,291109
10403,2.2e-05,172.31.47.0-255,66,1920,96,291109
10404,2.8e-05,172.217.194.0-255,4320,6240,96,291109
10405,3.7e-05,172.31.47.0-255,66,6306,96,291109
10406,4.3e-05,172.217.194.0-255,7156,13462,96,291109
10407,4.6e-05,172.31.47.0-255,66,13528,96,291109
10408,8.5e-05,172.31.47.0-255,66,13594,96,291109
10409,9.8e-05,172.217.194.0-255,1930,15524,96,291109
10410,0.000103,172.31.47.0-255,66,15590,96,291109
10411,0.000108,172.217.194.0-255,3961,19551,96,291109
10412,0.00011,172.31.47.0-255,66,19617,96,291109
10413,0.000158,172.217.194.0-255,1484,21101,96,291109
10414,0.000161,172.31.47.0-255,66,21167,96,291109
10415,0.000164,172.217.194.0-255,1484,22651,96,291109
10416,0.000166,172.31.47.0-255,66,22717,96,291109
10417,0.000196,172.217.194.0-255,1484,24201,96,291109
10418,0.000198,172.31.47.0-255,66,24267,96,291109
10419,0.000204,172.217.194.0-255,5738,30005,96,291109
10420,0.000206,172.31.47.0-255,66,30071,96,291109
10421,0.000212,172.217.194.0-255,6797,36868,96,291109
10422,0.000214,172.31.47.0-255,66,36934,96,291109
10423,0.000218,172.217.194.0-255,2902,39836,96,291109
10424,0.00022,172.31.47.0-255,66,39902,96,291109
10425,0.000254,172.31.47.0-255,66,39968,96,291109
10426,0.000258,172.217.194.0-255,2833,42801,96,291109
10427,0.00026,172.31.47.0-255,66,42867,96,291109
10428,0.000262,172.217.194.0-255,99,42966,96,291109
10429,0.000264,172.31.47.0-255,66,43032,96,291109
10430,0.000412,172.217.194.0-255,1484,44516,96,291109
10431,0.000429,172.217.194.0-255,2902,47418,96,291109
10432,0.000433,172.31.47.0-255,66,47484,96,291109
10433,0.000438,172.217.194.0-255,5738,53222,96,291109
10434,0.00044,172.31.47.0-255,66,53288,96,291109
10435,0.000468,172.217.194.0-255,7156,60444,96,291109
10436,0.000471,172.31.47.0-255,66,60510,96,291109
10437,0.000496,172.217.194.0-255,6797,67307,96,291109
10438,0.000499,172.31.47.0-255,66,67373,96,291109
10439,0.000508,172.31.47.0-255,66,67439,96,291109
10440,0.001035,172.217.194.0-255,1484,68923,96,291109
10441,0.001041,172.217.194.0-255,2902,71825,96,291109
10442,0.001044,172.31.47.0-255,66,71891,96,291109
10443,0.001048,172.217.194.0-255,2902,74793,96,291109
10444,0.00105,172.31.47.0-255,66,74859,96,291109
10445,0.001079,172.217.194.0-255,2902,77761,96,291109
10446,0.001081,172.31.47.0-255,66,77827,96,291109
10447,0.001093,172.31.47.0-255,66,77893,96,291109
10448,0.001137,172.31.47.0-255,66,77959,96,291109
10449,0.001177,172.31.47.0-255,66,78025,96,291109
10450,0.001206,172.31.47.0-255,66,78091,96,291109
10451,0.001214,172.31.47.0-255,66,78157,96,291109
10452,0.001744,172.217.194.0-255,1484,79641,96,291109
10453,0.00175,172.217.194.0-255,2902,82543,96,291109
10454,0.001753,172.31.47.0-255,66,82609,96,291109
10455,0.001758,172.217.194.0-255,2902,85511,96,291109
10456,0.00176,172.31.47.0-255,66,85577,96,291109
10457,0.001785,172.217.194.0-255,2902,88479,96,291109
10458,0.001791,172.31.47.0-255,66,88545,96,291109
10459,0.001803,172.31.47.0-255,66,88611,96,291109
10460,0.00184,172.31.47.0-255,66,88677,96,291109
10461,0.001866,172.217.194.0-255,1484,90161,96,291109
10462,0.001882,172.217.194.0-255,2902,93063,96,291109
10463,0.001884,172.31.47.0-255,66,93129,96,291109
10464,0.00189,172.217.194.0-255,5738,98867,96,291109
10465,0.001892,172.31.47.0-255,66,98933,96,291109
10466,0.001921,172.31.47.0-255,66,98999,96,291109
10467,0.00195,172.217.194.0-255,2902,101901,96,291109
10468,0.001953,172.31.47.0-255,66,101967,96,291109
10469,0.001964,172.31.47.0-255,66,102033,96,291109
10470,0.001989,172.217.194.0-255,1484,103517,96,291109
10471,0.001993,172.217.194.0-255,2902,106419,96,291109
10472,0.001995,172.31.47.0-255,66,106485,96,291109
10473,0.002027,172.217.194.0-255,5738,112223,96,291109
10474,0.002029,172.31.47.0-255,66,112289,96,291109
10475,0.002034,172.217.194.0-255,4320,116609,96,291109
10476,0.002036,172.31.47.0-255,66,116675,96,291109
10477,0.00405,172.217.194.0-255,5738,122413,96,291109
10478,0.004058,172.31.47.0-255,66,122479,96,291109
10479,0.006067,172.217.194.0-255,5738,128217,96,291109
10480,0.006073,172.31.47.0-255,66,128283,96,291109
10481,0.008075,172.217.194.0-255,5738,134021,96,291109
10482,0.008081,172.31.47.0-255,66,134087,96,291109
10483,0.010082,172.217.194.0-255,5738,139825,96,291109
10484,0.010088,172.31.47.0-255,66,139891,96,291109
10485,0.012091,172.217.194.0-255,5738,145629,96,291109
10486,0.012098,172.31.47.0-255,66,145695,96,291109
10487,0.014107,172.217.194.0-255,5738,151433,96,291109
10488,0.014114,172.31.47.0-255,66,151499,96,291109
10489,0.016126,172.217.194.0-255,5738,157237,96,291109
10490,0.016134,172.31.47.0-255,66,157303,96,291109
10491,0.018129,172.217.194.0-255,5738,163041,96,291109
10492,0.018137,172.31.47.0-255,66,163107,96,291109
10493,0.020138,172.217.194.0-255,5738,168845,96,291109
10494,0.020144,172.31.47.0-255,66,168911,96,291109
10495,0.022141,172.217.194.0-255,5738,174649,96,291109
10496,0.022148,172.31.47.0-255,66,174715,96,291109
10497,0.024154,172.217.194.0-255,5738,180453,96,291109
10498,0.024159,172.31.47.0-255,66,180519,96,291109
10499,0.026134,172.217.194.0-255,5738,186257,96,291109
10500,0.026141,172.31.47.0-255,66,186323,96,291109
10501,0.02803,172.31.47.0-255,172,186495,96,291109
10502,0.028062,172.31.47.0-255,1109,187604,96,291109
10503,0.028123,172.31.47.0-255,1514,189118,96,291109
10504,0.028124,172.31.47.0-255,1514,190632,96,291109
10505,0.028129,172.31.47.0-255,1514,192146,96,291109
10506,0.02813,172.31.47.0-255,1083,193229,96,291109
10507,0.028161,172.217.194.0-255,5738,198967,96,291109
10508,0.028166,172.31.47.0-255,66,199033,96,291109
10509,0.029567,104.244.42.0-255,66,199099,96,291109
10510,0.029607,104.244.42.0-255,66,199165,96,291109
10511,0.029662,104.244.42.0-255,66,199231,96,291109
10512,0.029672,104.244.42.0-255,66,199297,96,291109
10513,0.030189,172.217.194.0-255,5738,205035,96,291109
10514,0.030194,172.31.47.0-255,66,205101,96,291109
10515,0.032215,172.217.194.0-255,5738,210839,96,291109
10516,0.03222,172.31.47.0-255,66,210905,96,291109
10517,0.034203,172.217.194.0-255,5738,216643,96,291109
10518,0.034209,172.31.47.0-255,66,216709,96,291109
10519,0.036211,172.217.194.0-255,5738,222447,96,291109
10520,0.036216,172.31.47.0-255,66,222513,96,291109
10521,0.038246,172.217.194.0-255,5738,228251,96,291109
10522,0.038256,172.31.47.0-255,66,228317,96,291109
10523,0.040243,172.217.194.0-255,5738,234055,96,291109
10524,0.040251,172.31.47.0-255,66,234121,96,291109
10525,0.042265,172.217.194.0-255,5738,239859,96,291109
10526,0.042271,172.31.47.0-255,66,239925,96,291109
10527,0.044266,172.217.194.0-255,5738,245663,96,291109
10528,0.044272,172.31.47.0-255,66,245729,96,291109
10529,0.046281,172.217.194.0-255,5738,251467,96,291109
10530,0.046286,172.31.47.0-255,66,251533,96,291109
10531,0.048303,172.217.194.0-255,5738,257271,96,291109
10532,0.048309,172.31.47.0-255,66,257337,96,291109
10533,0.050314,172.217.194.0-255,5738,263075,96,291109
10534,0.05032,172.31.47.0-255,66,263141,96,291109
10535,0.052322,172.217.194.0-255,5738,268879,96,291109
10536,0.052328,172.31.47.0-255,66,268945,96,291109
10537,0.054339,172.217.194.0-255,5738,274683,96,291109
10538,0.054345,172.31.47.0-255,66,274749,96,291109
10539,0.05637,172.217.194.0-255,5738,280487,96,291109
10540,0.056375,172.31.47.0-255,66,280553,96,291109
10541,0.058395,172.217.194.0-255,5738,286291,96,291109
10542,0.058402,172.31.47.0-255,66,286357,96,291109
10543,0.060418,172.217.194.0-255,4515,290872,96,291109
10544,0.060424,172.31.47.0-255,66,290938,96,291109
10545,0.060586,172.31.47.0-255,105,291043,96,291109
10546,0.062546,172.217.194.0-255,66,291109,96,291109
10547,0.0,74.125.68.0-255,153,153,96,323056
10548,1.6e-05,172.31.47.0-255,66,219,96,323056
10549,2.3e-05,74.125.68.0-255,1484,1703,96,323056
10550,2.7e-05,172.31.47.0-255,66,1769,96,323056
10551,3.3e-05,74.125.68.0-255,2902,4671,96,323056
10552,3.5e-05,172.31.47.0-255,66,4737,96,323056
10553,5e-05,74.125.68.0-255,5738,10475,96,323056
10554,5.3e-05,172.31.47.0-255,66,10541,96,323056
10555,5.8e-05,74.125.68.0-255,2902,13443,96,323056
10556,6.2e-05,172.31.47.0-255,66,13509,96,323056
10557,6.8e-05,74.125.68.0-255,3516,17025,96,323056
10558,7.1e-05,172.31.47.0-255,66,17091,96,323056
10559,0.00011,172.31.47.0-255,66,17157,96,323056
10560,0.000116,74.125.68.0-255,4320,21477,96,323056
10561,0.000118,172.31.47.0-255,66,21543,96,323056
10562,0.000143,74.125.68.0-255,1125,22668,96,323056
10563,0.000146,172.31.47.0-255,66,22734,96,323056
10564,0.000514,74.125.68.0-255,1484,24218,96,323056
10565,0.00052,172.31.47.0-255,66,24284,96,323056
10566,0.000526,74.125.68.0-255,2902,27186,96,323056
10567,0.000528,172.31.47.0-255,66,27252,96,323056
10568,0.000559,74.125.68.0-255,5738,32990,96,323056
10569,0.000562,172.31.47.0-255,66,33056,96,323056
10570,0.000567,74.125.68.0-255,4320,37376,96,323056
10571,0.000569,172.31.47.0-255,66,37442,96,323056
10572,0.000606,74.125.68.0-255,5379,42821,96,323056
10573,0.00061,172.31.47.0-255,66,42887,96,323056
10574,0.000616,74.125.68.0-255,4320,47207,96,323056
10575,0.000618,172.31.47.0-255,66,47273,96,323056
10576,0.000654,74.125.68.0-255,5738,53011,96,323056
10577,0.000658,172.31.47.0-255,66,53077,96,323056
10578,0.000663,74.125.68.0-255,4272,57349,96,323056
10579,0.000665,172.31.47.0-255,66,57415,96,323056
10580,0.000692,74.125.68.0-255,113,57528,96,323056
10581,0.000816,74.125.68.0-255,1484,59012,96,323056
10582,0.00082,172.31.47.0-255,66,59078,96,323056
10583,0.000826,74.125.68.0-255,2902,61980,96,323056
10584,0.000828,172.31.47.0-255,66,62046,96,323056
10585,0.000848,74.125.68.0-255,5738,67784,96,323056
10586,0.000855,172.31.47.0-255,66,67850,96,323056
10587,0.000874,74.125.68.0-255,4320,72170,96,323056
10588,0.000877,172.31.47.0-255,66,72236,96,323056
10589,0.000889,74.125.68.0-255,2543,74779,96,323056
10590,0.0009,74.125.68.0-255,7156,81935,96,323056
10591,0.000905,172.31.47.0-255,66,82001,96,323056
10592,0.000908,172.31.47.0-255,66,82067,96,323056
10593,0.000934,172.31.47.0-255,66,82133,96,323056
10594,0.001688,74.125.68.0-255,1484,83617,96,323056
10595,0.001697,74.125.68.0-255,2902,86519,96,323056
10596,0.0017,172.31.47.0-255,66,86585,96,323056
10597,0.001728,74.125.68.0-255,5738,92323,96,323056
10598,0.00173,172.31.47.0-255,66,92389,96,323056
10599,0.001733,74.125.68.0-255,1484,93873,96,323056
10600,0.001759,74.125.68.0-255,2902,96775,96,323056
10601,0.001761,172.31.47.0-255,66,96841,96,323056
10602,0.001788,74.125.68.0-255,5738,102579,96,323056
10603,0.00179,172.31.47.0-255,66,102645,96,323056
10604,0.001793,74.125.68.0-255,1484,104129,96,323056
10605,0.001795,74.125.68.0-255,1484,105613,96,323056
10606,0.001797,172.31.47.0-255,66,105679,96,323056
10607,0.001824,74.125.68.0-255,1484,107163,96,323056
10608,0.00183,74.125.68.0-255,5738,112901,96,323056
10609,0.001832,172.31.47.0-255,66,112967,96,323056
10610,0.001837,74.125.68.0-255,3602,116569,96,323056
10611,0.001839,172.31.47.0-255,66,116635,96,323056
10612,0.001968,74.125.68.0-255,1484,118119,96,323056
10613,0.001997,74.125.68.0-255,2902,121021,96,323056
10614,0.002,172.31.47.0-255,66,121087,96,323056
10615,0.002028,74.125.68.0-255,4320,125407,96,323056
10616,0.00203,172.31.47.0-255,66,125473,96,323056
10617,0.002034,74.125.68.0-255,2902,128375,96,323056
10618,0.002036,172.31.47.0-255,66,128441,96,323056
10619,0.002065,74.125.68.0-255,5738,134179,96,323056
10620,0.002068,172.31.47.0-255,66,134245,96,323056
10621,0.002072,74.125.68.0-255,2902,137147,96,323056
10622,0.002073,172.31.47.0-255,66,137213,96,323056
10623,0.002106,172.31.47.0-255,66,137279,96,323056
10624,0.002109,74.125.68.0-255,766,138045,96,323056
10625,0.002171,74.125.68.0-255,1484,139529,96,323056
10626,0.002174,172.31.47.0-255,66,139595,96,323056
10627,0.002212,74.125.68.0-255,2902,142497,96,323056
10628,0.002215,172.31.47.0-255,66,142563,96,323056
10629,0.002239,74.125.68.0-255,4320,146883,96,323056
10630,0.002241,172.31.47.0-255,66,146949,96,323056
10631,0.002244,74.125.68.0-255,1484,148433,96,323056
10632,0.002291,74.125.68.0-255,2902,151335,96,323056
10633,0.002293,172.31.47.0-255,66,151401,96,323056
10634,0.004514,74.125.68.0-255,1484,152885,96,323056
10635,0.004547,74.125.68.0-255,4320,157205,96,323056
10636,0.004553,172.31.47.0-255,66,157271,96,323056
10637,0.006864,74.125.68.0-255,5738,163009,96,323056
10638,0.006884,172.31.47.0-255,66,163075,96,323056
10639,0.009176,74.125.68.0-255,5738,168813,96,323056
10640,0.009195,172.31.47.0-255,66,168879,96,323056
10641,0.01149,74.125.68.0-255,5738,174617,96,323056
10642,0.011511,172.31.47.0-255,66,174683,96,323056
10643,0.01377,74.125.68.0-255,5738,180421,96,323056
10644,0.013777,172.31.47.0-255,66,180487,96,323056
10645,0.01604,74.125.68.0-255,5738,186225,96,323056
10646,0.016047,172.31.47.0-255,66,186291,96,323056
10647,0.018325,74.125.68.0-255,5738,192029,96,323056
10648,0.018334,172.31.47.0-255,66,192095,96,323056
10649,0.020613,74.125.68.0-255,5738,197833,96,323056
10650,0.020634,172.31.47.0-255,66,197899,96,323056
10651,0.022954,74.125.68.0-255,5738,203637,96,323056
10652,0.022975,172.31.47.0-255,66,203703,96,323056
10653,0.025242,74.125.68.0-255,5738,209441,96,323056
10654,0.025255,172.31.47.0-255,66,209507,96,323056
10655,0.027512,74.125.68.0-255,5738,215245,96,323056
10656,0.02752,172.31.47.0-255,66,215311,96,323056
10657,0.029782,74.125.68.0-255,5738,221049,96,323056
10658,0.029789,172.31.47.0-255,66,221115,96,323056
10659,0.032071,74.125.68.0-255,5738,226853,96,323056
10660,0.032079,172.31.47.0-255,66,226919,96,323056
10661,0.034341,74.125.68.0-255,5738,232657,96,323056
10662,0.034353,172.31.47.0-255,66,232723,96,323056
10663,0.034871,172.31.47.0-255,172,232895,96,323056
10664,0.034906,172.31.47.0-255,1101,233996,96,323056
10665,0.034949,172.31.47.0-255,1514,235510,96,323056
10666,0.034969,172.31.47.0-255,1310,236820,96,323056
10667,0.036467,104.244.42.0-255,66,236886,96,323056
10668,0.036478,104.244.42.0-255,66,236952,96,323056
10669,0.036541,104.244.42.0-255,66,237018,96,323056
10670,0.036545,104.244.42.0-255,66,237084,96,323056
10671,0.036614,74.125.68.0-255,2902,239986,96,323056
10672,0.03662,172.31.47.0-255,66,240052,96,323056
10673,0.036646,74.125.68.0-255,2902,242954,96,323056
10674,0.036649,172.31.47.0-255,66,243020,96,323056
10675,0.038882,74.125.68.0-255,2902,245922,96,323056
10676,0.038895,172.31.47.0-255,66,245988,96,323056
10677,0.038923,74.125.68.0-255,2902,248890,96,323056
10678,0.038926,172.31.47.0-255,66,248956,96,323056
10679,0.041185,74.125.68.0-255,4320,253276,96,323056
10680,0.041202,172.31.47.0-255,66,253342,96,323056
10681,0.041236,74.125.68.0-255,1484,254826,96,323056
10682,0.043467,74.125.68.0-255,4320,259146,96,323056
10683,0.043479,172.31.47.0-255,66,259212,96,323056
10684,0.045795,74.125.68.0-255,5738,264950,96,323056
10685,0.045812,172.31.47.0-255,66,265016,96,323056
10686,0.048089,74.125.68.0-255,5738,270754,96,323056
10687,0.048104,172.31.47.0-255,66,270820,96,323056
10688,0.050372,74.125.68.0-255,5738,276558,96,323056
10689,0.050387,172.31.47.0-255,66,276624,96,323056
10690,0.05267,74.125.68.0-255,5738,282362,96,323056
10691,0.052688,172.31.47.0-255,66,282428,96,323056
10692,0.054964,74.125.68.0-255,5738,288166,96,323056
10693,0.054978,172.31.47.0-255,66,288232,96,323056
10694,0.057274,74.125.68.0-255,5738,293970,96,323056
10695,0.05729,172.31.47.0-255,66,294036,96,323056
10696,0.059571,74.125.68.0-255,5738,299774,96,323056
10697,0.059583,172.31.47.0-255,66,299840,96,323056
10698,0.061837,74.125.68.0-255,5738,305578,96,323056
10699,0.061844,172.31.47.0-255,66,305644,96,323056
10700,0.064104,74.125.68.0-255,5738,311382,96,323056
10701,0.06411,172.31.47.0-255,66,311448,96,323056
10702,0.066383,74.125.68.0-255,5738,317186,96,323056
10703,0.066389,172.31.47.0-255,66,317252,96,323056
10704,0.068652,74.125.68.0-255,5738,322990,96,323056
10705,0.068658,172.31.47.0-255,66,323056,96,323056
10706,0.0,172.31.47.0-255,105,105,96,276
10707,0.067607,31.13.82.0-255,105,210,96,276
10708,0.067627,172.31.47.0-255,66,276,96,276
10709,0.0,172.217.194.0-255,153,153,96,315594
10710,2.6e-05,172.31.47.0-255,66,219,96,315594
10711,3.3e-05,172.217.194.0-255,1484,1703,96,315594
10712,3.6e-05,172.31.47.0-255,66,1769,96,315594
10713,4.1e-05,172.217.194.0-255,2902,4671,96,315594
10714,4.3e-05,172.31.47.0-255,66,4737,96,315594
10715,4.8e-05,172.217.194.0-255,2902,7639,96,315594
10716,5e-05,172.31.47.0-255,66,7705,96,315594
10717,6.8e-05,172.217.194.0-255,2902,10607,96,315594
10718,7.3e-05,172.31.47.0-255,66,10673,96,315594
10719,9.5e-05,172.217.194.0-255,3635,14308,96,315594
10720,9.7e-05,172.31.47.0-255,66,14374,96,315594
10721,0.000281,172.217.194.0-255,1484,15858,96,315594
10722,0.000287,172.31.47.0-255,66,15924,96,315594
10723,0.000292,172.217.194.0-255,2902,18826,96,315594
10724,0.000295,172.31.47.0-255,66,18892,96,315594
10725,0.0003,172.217.194.0-255,4320,23212,96,315594
10726,0.000302,172.31.47.0-255,66,23278,96,315594
10727,0.000317,172.217.194.0-255,1484,24762,96,315594
10728,0.000319,172.31.47.0-255,66,24828,96,315594
10729,0.000369,172.31.47.0-255,66,24894,96,315594
10730,0.000401,172.217.194.0-255,5738,30632,96,315594
10731,0.000405,172.31.47.0-255,66,30698,96,315594
10732,0.000424,172.217.194.0-255,5379,36077,96,315594
10733,0.000427,172.31.47.0-255,66,36143,96,315594
10734,0.00043,172.217.194.0-255,1484,37627,96,315594
10735,0.000432,172.31.47.0-255,66,37693,96,315594
10736,0.000458,172.31.47.0-255,66,37759,96,315594
10737,0.000464,172.217.194.0-255,5379,43138,96,315594
10738,0.000466,172.31.47.0-255,66,43204,96,315594
10739,0.000489,172.217.194.0-255,378,43582,96,315594
10740,0.000641,172.217.194.0-255,366,43948,96,315594
10741,0.000727,172.217.194.0-255,1484,45432,96,315594
10742,0.000731,172.31.47.0-255,66,45498,96,315594
10743,0.000752,172.217.194.0-255,2902,48400,96,315594
10744,0.000755,172.31.47.0-255,66,48466,96,315594
10745,0.000761,172.217.194.0-255,5738,54204,96,315594
10746,0.000763,172.31.47.0-255,66,54270,96,315594
10747,0.000789,172.217.194.0-255,6797,61067,96,315594
10748,0.000792,172.31.47.0-255,66,61133,96,315594
10749,0.000812,172.217.194.0-255,1484,62617,96,315594
10750,0.000828,172.217.194.0-255,4320,66937,96,315594
10751,0.000833,172.31.47.0-255,66,67003,96,315594
10752,0.000851,172.217.194.0-255,1484,68487,96,315594
10753,0.000857,172.217.194.0-255,5738,74225,96,315594
10754,0.00086,172.31.47.0-255,66,74291,96,315594
10755,0.000895,172.217.194.0-255,3961,78252,96,315594
10756,0.000898,172.31.47.0-255,66,78318,96,315594
10757,0.001275,172.217.194.0-255,1484,79802,96,315594
10758,0.001283,172.217.194.0-255,2902,82704,96,315594
10759,0.001287,172.31.47.0-255,66,82770,96,315594
10760,0.001293,172.217.194.0-255,5738,88508,96,315594
10761,0.001295,172.31.47.0-255,66,88574,96,315594
10762,0.001333,172.217.194.0-255,4320,92894,96,315594
10763,0.001337,172.31.47.0-255,66,92960,96,315594
10764,0.001362,172.31.47.0-255,66,93026,96,315594
10765,0.001368,172.217.194.0-255,5738,98764,96,315594
10766,0.001369,172.31.47.0-255,66,98830,96,315594
10767,0.001404,172.217.194.0-255,4320,103150,96,315594
10768,0.001406,172.31.47.0-255,66,103216,96,315594
10769,0.001421,172.217.194.0-255,766,103982,96,315594
10770,0.001793,172.217.194.0-255,1484,105466,96,315594
10771,0.001798,172.31.47.0-255,66,105532,96,315594
10772,0.001804,172.217.194.0-255,2902,108434,96,315594
10773,0.001805,172.31.47.0-255,66,108500,96,315594
10774,0.001811,172.217.194.0-255,4320,112820,96,315594
10775,0.001812,172.31.47.0-255,66,112886,96,315594
10776,0.001827,172.217.194.0-255,1484,114370,96,315594
10777,0.001843,172.217.194.0-255,2902,117272,96,315594
10778,0.001845,172.31.47.0-255,66,117338,96,315594
10779,0.001864,172.217.194.0-255,5738,123076,96,315594
10780,0.001866,172.31.47.0-255,66,123142,96,315594
10781,0.001879,172.217.194.0-255,4320,127462,96,315594
10782,0.001881,172.31.47.0-255,66,127528,96,315594
10783,0.001885,172.217.194.0-255,4320,131848,96,315594
10784,0.001887,172.31.47.0-255,66,131914,96,315594
10785,0.001901,172.217.194.0-255,4320,136234,96,315594
10786,0.001903,172.31.47.0-255,66,136300,96,315594
10787,0.001914,172.217.194.0-255,2184,138484,96,315594
10788,0.001915,172.31.47.0-255,66,138550,96,315594
10789,0.002087,172.217.194.0-255,1484,140034,96,315594
10790,0.002098,172.217.194.0-255,1484,141518,96,315594
10791,0.002101,172.31.47.0-255,66,141584,96,315594
10792,0.002116,172.217.194.0-255,1484,143068,96,315594
10793,0.002121,172.217.194.0-255,5738,148806,96,315594
10794,0.002123,172.31.47.0-255,66,148872,96,315594
10795,0.002167,172.217.194.0-255,1484,150356,96,315594
10796,0.002195,172.31.47.0-255,66,150422,96,315594
10797,0.002205,172.31.47.0-255,66,150488,96,315594
10798,0.002232,172.217.194.0-255,1484,151972,96,315594
10799,0.002245,172.217.194.0-255,2902,154874,96,315594
10800,0.002247,172.31.47.0-255,66,154940,96,315594
10801,0.002258,172.217.194.0-255,2902,157842,96,315594
10802,0.00226,172.31.47.0-255,66,157908,96,315594
10803,0.002271,172.217.194.0-255,2902,160810,96,315594
10804,0.002273,172.31.47.0-255,66,160876,96,315594
10805,0.002279,172.217.194.0-255,7156,168032,96,315594
10806,0.002281,172.31.47.0-255,66,168098,96,315594
10807,0.002316,172.31.47.0-255,66,168164,96,315594
10808,0.002319,172.217.194.0-255,2184,170348,96,315594
10809,0.00232,172.31.47.0-255,66,170414,96,315594
10810,0.002375,172.217.194.0-255,1484,171898,96,315594
10811,0.002389,172.217.194.0-255,2902,174800,96,315594
10812,0.002391,172.31.47.0-255,66,174866,96,315594
10813,0.002411,172.217.194.0-255,5738,180604,96,315594
10814,0.002413,172.31.47.0-255,66,180670,96,315594
10815,0.00243,172.217.194.0-255,7156,187826,96,315594
10816,0.002432,172.31.47.0-255,66,187892,96,315594
10817,0.002445,172.217.194.0-255,1484,189376,96,315594
10818,0.002485,172.31.47.0-255,66,189442,96,315594
10819,0.002503,172.217.194.0-255,5020,194462,96,315594
10820,0.002505,172.31.47.0-255,66,194528,96,315594
10821,0.002517,172.217.194.0-255,5738,200266,96,315594
10822,0.002519,172.31.47.0-255,66,200332,96,315594
10823,0.002542,172.217.194.0-255,4320,204652,96,315594
10824,0.002543,172.31.47.0-255,66,204718,96,315594
10825,0.002556,172.31.47.0-255,66,204784,96,315594
10826,0.002582,172.217.194.0-255,5738,210522,96,315594
10827,0.002585,172.31.47.0-255,66,210588,96,315594
10828,0.002602,172.217.194.0-255,6438,217026,96,315594
10829,0.002604,172.31.47.0-255,66,217092,96,315594
10830,0.002616,172.31.47.0-255,66,217158,96,315594
10831,0.002626,172.31.47.0-255,66,217224,96,315594
10832,0.005195,172.217.194.0-255,5738,222962,96,315594
10833,0.005202,172.31.47.0-255,66,223028,96,315594
10834,0.007749,172.217.194.0-255,5738,228766,96,315594
10835,0.007755,172.31.47.0-255,66,228832,96,315594
10836,0.010304,172.217.194.0-255,4320,233152,96,315594
10837,0.010312,172.31.47.0-255,66,233218,96,315594
10838,0.01033,172.217.194.0-255,1484,234702,96,315594
10839,0.01292,172.217.194.0-255,4320,239022,96,315594
10840,0.012927,172.31.47.0-255,66,239088,96,315594
10841,0.015519,172.217.194.0-255,5738,244826,96,315594
10842,0.015531,172.31.47.0-255,66,244892,96,315594
10843,0.018085,172.217.194.0-255,5738,250630,96,315594
10844,0.018095,172.31.47.0-255,66,250696,96,315594
10845,0.020703,172.217.194.0-255,5738,256434,96,315594
10846,0.020711,172.31.47.0-255,66,256500,96,315594
10847,0.023291,172.217.194.0-255,2902,259402,96,315594
10848,0.023296,172.31.47.0-255,66,259468,96,315594
10849,0.023329,172.217.194.0-255,2902,262370,96,315594
10850,0.023332,172.31.47.0-255,66,262436,96,315594
10851,0.025866,172.217.194.0-255,2902,265338,96,315594
10852,0.025872,172.31.47.0-255,66,265404,96,315594
10853,0.025936,172.217.194.0-255,2902,268306,96,315594
10854,0.02594,172.31.47.0-255,66,268372,96,315594
10855,0.028434,172.217.194.0-255,2902,271274,96,315594
10856,0.028439,172.31.47.0-255,66,271340,96,315594
10857,0.028484,172.217.194.0-255,2902,274242,96,315594
10858,0.028488,172.31.47.0-255,66,274308,96,315594
10859,0.030865,172.31.47.0-255,172,274480,96,315594
10860,0.030895,172.31.47.0-255,1105,275585,96,315594
10861,0.030929,172.31.47.0-255,1514,277099,96,315594
10862,0.030931,172.31.47.0-255,1306,278405,96,315594
10863,0.031022,172.217.194.0-255,2902,281307,96,315594
10864,0.031028,172.31.47.0-255,66,281373,96,315594
10865,0.031063,172.217.194.0-255,1484,282857,96,315594
10866,0.031084,172.217.194.0-255,1484,284341,96,315594
10867,0.031088,172.31.47.0-255,66,284407,96,315594
10868,0.032398,104.244.42.0-255,66,284473,96,315594
10869,0.032588,104.244.42.0-255,66,284539,96,315594
10870,0.032592,104.244.42.0-255,66,284605,96,315594
10871,0.033605,172.217.194.0-255,2902,287507,96,315594
10872,0.033611,172.31.47.0-255,66,287573,96,315594
10873,0.033653,172.217.194.0-255,1484,289057,96,315594
10874,0.033668,172.217.194.0-255,1484,290541,96,315594
10875,0.033671,172.31.47.0-255,66,290607,96,315594
10876,0.036177,172.217.194.0-255,2902,293509,96,315594
10877,0.036183,172.31.47.0-255,66,293575,96,315594
10878,0.036252,172.217.194.0-255,2902,296477,96,315594
10879,0.036256,172.31.47.0-255,66,296543,96,315594
10880,0.038748,172.217.194.0-255,2902,299445,96,315594
10881,0.038753,172.31.47.0-255,66,299511,96,315594
10882,0.038817,172.217.194.0-255,1484,300995,96,315594
10883,0.03883,172.217.194.0-255,1484,302479,96,315594
10884,0.038833,172.31.47.0-255,66,302545,96,315594
10885,0.041354,172.217.194.0-255,2902,305447,96,315594
10886,0.041359,172.31.47.0-255,66,305513,96,315594
10887,0.041419,172.217.194.0-255,1484,306997,96,315594
10888,0.041435,172.217.194.0-255,1484,308481,96,315594
10889,0.041438,172.31.47.0-255,66,308547,96,315594
10890,0.043906,172.217.194.0-255,2902,311449,96,315594
10891,0.043912,172.31.47.0-255,66,311515,96,315594
10892,0.043989,172.217.194.0-255,2902,314417,96,315594
10893,0.043995,172.31.47.0-255,66,314483,96,315594
10894,0.046491,172.217.194.0-255,874,315357,96,315594
10895,0.046635,172.31.47.0-255,66,315423,96,315594
10896,0.04666,172.31.47.0-255,105,315528,96,315594
10897,0.049193,172.217.194.0-255,66,315594,96,315594
10898,0.0,74.125.24.0-255,153,153,96,316161
10899,3.6e-05,172.31.47.0-255,66,219,96,316161
10900,4.4e-05,74.125.24.0-255,1484,1703,96,316161
10901,4.7e-05,172.31.47.0-255,66,1769,96,316161
10902,5.2e-05,74.125.24.0-255,2902,4671,96,316161
10903,5.5e-05,172.31.47.0-255,66,4737,96,316161
10904,6e-05,74.125.24.0-255,4320,9057,96,316161
10905,6.3e-05,172.31.47.0-255,66,9123,96,316161
10906,0.000109,74.125.24.0-255,5055,14178,96,316161
10907,0.000112,172.31.47.0-255,66,14244,96,316161
10908,0.000382,74.125.24.0-255,1484,15728,96,316161
10909,0.000387,172.31.47.0-255,66,15794,96,316161
10910,0.000393,74.125.24.0-255,2902,18696,96,316161
10911,0.000396,172.31.47.0-255,66,18762,96,316161
10912,0.000418,74.125.24.0-255,4320,23082,96,316161
10913,0.000422,172.31.47.0-255,66,23148,96,316161
10914,0.000441,172.31.47.0-255,66,23214,96,316161
10915,0.000468,74.125.24.0-255,1125,24339,96,316161
10916,0.000471,172.31.47.0-255,66,24405,96,316161
10917,0.000483,172.31.47.0-255,66,24471,96,316161
10918,0.000488,74.125.24.0-255,2902,27373,96,316161
10919,0.00049,172.31.47.0-255,66,27439,96,316161
10920,0.000543,172.31.47.0-255,66,27505,96,316161
10921,0.000546,74.125.24.0-255,766,28271,96,316161
10922,0.000549,172.31.47.0-255,66,28337,96,316161
10923,0.000588,74.125.24.0-255,364,28701,96,316161
10924,0.000591,172.31.47.0-255,66,28767,96,316161
10925,0.000622,74.125.24.0-255,130,28897,96,316161
10926,0.000625,172.31.47.0-255,66,28963,96,316161
10927,0.000724,74.125.24.0-255,1484,30447,96,316161
10928,0.00073,74.125.24.0-255,2902,33349,96,316161
10929,0.000733,172.31.47.0-255,66,33415,96,316161
10930,0.00075,74.125.24.0-255,2902,36317,96,316161
10931,0.000752,172.31.47.0-255,66,36383,96,316161
10932,0.000776,74.125.24.0-255,2902,39285,96,316161
10933,0.000779,172.31.47.0-255,66,39351,96,316161
10934,0.000786,74.125.24.0-255,7156,46507,96,316161
10935,0.000788,172.31.47.0-255,66,46573,96,316161
10936,0.000809,74.125.24.0-255,5738,52311,96,316161
10937,0.000811,172.31.47.0-255,66,52377,96,316161
10938,0.000834,74.125.24.0-255,7156,59533,96,316161
10939,0.000837,172.31.47.0-255,66,59599,96,316161
10940,0.000854,74.125.24.0-255,1484,61083,96,316161
10941,0.000868,74.125.24.0-255,2184,63267,96,316161
10942,0.000871,172.31.47.0-255,66,63333,96,316161
10943,0.001033,74.125.24.0-255,1484,64817,96,316161
10944,0.001045,74.125.24.0-255,2902,67719,96,316161
10945,0.001047,172.31.47.0-255,66,67785,96,316161
10946,0.001052,74.125.24.0-255,2902,70687,96,316161
10947,0.001054,172.31.47.0-255,66,70753,96,316161
10948,0.001064,74.125.24.0-255,1484,72237,96,316161
10949,0.001091,74.125.24.0-255,5738,77975,96,316161
10950,0.001094,172.31.47.0-255,66,78041,96,316161
10951,0.001113,74.125.24.0-255,2902,80943,96,316161
10952,0.001116,172.31.47.0-255,66,81009,96,316161
10953,0.001128,172.31.47.0-255,66,81075,96,316161
10954,0.001157,74.125.24.0-255,3602,84677,96,316161
10955,0.00116,172.31.47.0-255,66,84743,96,316161
10956,0.001184,74.125.24.0-255,346,85089,96,316161
10957,0.001207,74.125.24.0-255,1484,86573,96,316161
10958,0.00121,172.31.47.0-255,66,86639,96,316161
10959,0.001226,74.125.24.0-255,4320,90959,96,316161
10960,0.001229,172.31.47.0-255,66,91025,96,316161
10961,0.001252,172.31.47.0-255,66,91091,96,316161
10962,0.001279,74.125.24.0-255,1484,92575,96,316161
10963,0.00129,172.31.47.0-255,66,92641,96,316161
10964,0.001308,74.125.24.0-255,4320,96961,96,316161
10965,0.00131,172.31.47.0-255,66,97027,96,316161
10966,0.001328,74.125.24.0-255,3602,100629,96,316161
10967,0.001331,172.31.47.0-255,66,100695,96,316161
10968,0.001553,74.125.24.0-255,1484,102179,96,316161
10969,0.00156,74.125.24.0-255,2902,105081,96,316161
10970,0.001563,172.31.47.0-255,66,105147,96,316161
10971,0.001581,74.125.24.0-255,2902,108049,96,316161
10972,0.001583,172.31.47.0-255,66,108115,96,316161
10973,0.001608,74.125.24.0-255,2902,111017,96,316161
10974,0.001611,172.31.47.0-255,66,111083,96,316161
10975,0.001623,172.31.47.0-255,66,111149,96,316161
10976,0.001628,74.125.24.0-255,5738,116887,96,316161
10977,0.001629,172.31.47.0-255,66,116953,96,316161
10978,0.001686,74.125.24.0-255,5020,121973,96,316161
10979,0.001689,172.31.47.0-255,66,122039,96,316161
10980,0.001709,74.125.24.0-255,1484,123523,96,316161
10981,0.001726,74.125.24.0-255,4320,127843,96,316161
10982,0.001729,172.31.47.0-255,66,127909,96,316161
10983,0.001762,74.125.24.0-255,7156,135065,96,316161
10984,0.001766,172.31.47.0-255,66,135131,96,316161
10985,0.001773,74.125.24.0-255,7156,142287,96,316161
10986,0.001776,172.31.47.0-255,66,142353,96,316161
10987,0.001796,74.125.24.0-255,7156,149509,96,316161
10988,0.0018,172.31.47.0-255,66,149575,96,316161
10989,0.001826,74.125.24.0-255,6438,156013,96,316161
10990,0.001829,172.31.47.0-255,66,156079,96,316161
10991,0.00188,74.125.24.0-255,1484,157563,96,316161
10992,0.001887,74.125.24.0-255,2902,160465,96,316161
10993,0.00189,172.31.47.0-255,66,160531,96,316161
10994,0.001897,74.125.24.0-255,5738,166269,96,316161
10995,0.001899,172.31.47.0-255,66,166335,96,316161
10996,0.001936,172.31.47.0-255,66,166401,96,316161
10997,0.00195,74.125.24.0-255,1484,167885,96,316161
10998,0.001982,74.125.24.0-255,5738,173623,96,316161
10999,0.001987,172.31.47.0-255,66,173689,96,316161
11000,0.002029,74.125.24.0-255,5020,178709,96,316161
11001,0.002034,172.31.47.0-255,66,178775,96,316161
11002,0.002041,74.125.24.0-255,7156,185931,96,316161
11003,0.002044,172.31.47.0-255,66,185997,96,316161
11004,0.002071,74.125.24.0-255,4320,190317,96,316161
11005,0.002075,172.31.47.0-255,66,190383,96,316161
11006,0.002081,74.125.24.0-255,5738,196121,96,316161
11007,0.002083,172.31.47.0-255,66,196187,96,316161
11008,0.002148,172.31.47.0-255,66,196253,96,316161
11009,0.004418,74.125.24.0-255,5738,201991,96,316161
11010,0.004423,172.31.47.0-255,66,202057,96,316161
11011,0.006696,74.125.24.0-255,4320,206377,96,316161
11012,0.006701,172.31.47.0-255,66,206443,96,316161
11013,0.006717,74.125.24.0-255,1484,207927,96,316161
11014,0.00899,74.125.24.0-255,4320,212247,96,316161
11015,0.008998,172.31.47.0-255,66,212313,96,316161
11016,0.011295,74.125.24.0-255,5738,218051,96,316161
11017,0.011305,172.31.47.0-255,66,218117,96,316161
11018,0.013608,74.125.24.0-255,5738,223855,96,316161
11019,0.013616,172.31.47.0-255,66,223921,96,316161
11020,0.015915,74.125.24.0-255,5738,229659,96,316161
11021,0.015924,172.31.47.0-255,66,229725,96,316161
11022,0.01822,74.125.24.0-255,5738,235463,96,316161
11023,0.018225,172.31.47.0-255,66,235529,96,316161
11024,0.020519,74.125.24.0-255,5738,241267,96,316161
11025,0.020526,172.31.47.0-255,66,241333,96,316161
11026,0.022801,74.125.24.0-255,5738,247071,96,316161
11027,0.022806,172.31.47.0-255,66,247137,96,316161
11028,0.025108,74.125.24.0-255,5738,252875,96,316161
11029,0.025115,172.31.47.0-255,66,252941,96,316161
11030,0.026565,172.31.47.0-255,172,253113,96,316161
11031,0.0266,172.31.47.0-255,1109,254222,96,316161
11032,0.026663,172.31.47.0-255,1514,255736,96,316161
11033,0.026665,172.31.47.0-255,1302,257038,96,316161
11034,0.027374,74.125.24.0-255,2902,259940,96,316161
11035,0.027379,172.31.47.0-255,66,260006,96,316161
11036,0.027395,74.125.24.0-255,2902,262908,96,316161
11037,0.027397,172.31.47.0-255,66,262974,96,316161
11038,0.028096,104.244.42.0-255,66,263040,96,316161
11039,0.028136,104.244.42.0-255,66,263106,96,316161
11040,0.028239,104.244.42.0-255,66,263172,96,316161
11041,0.029642,74.125.24.0-255,2902,266074,96,316161
11042,0.029647,172.31.47.0-255,66,266140,96,316161
11043,0.029667,74.125.24.0-255,1484,267624,96,316161
11044,0.029678,74.125.24.0-255,1484,269108,96,316161
11045,0.02968,172.31.47.0-255,66,269174,96,316161
11046,0.031963,74.125.24.0-255,2902,272076,96,316161
11047,0.031971,172.31.47.0-255,66,272142,96,316161
11048,0.031993,74.125.24.0-255,2902,275044,96,316161
11049,0.031996,172.31.47.0-255,66,275110,96,316161
11050,0.034253,74.125.24.0-255,2902,278012,96,316161
11051,0.034259,172.31.47.0-255,66,278078,96,316161
11052,0.034292,74.125.24.0-255,2902,280980,96,316161
11053,0.034295,172.31.47.0-255,66,281046,96,316161
11054,0.036532,74.125.24.0-255,2902,283948,96,316161
11055,0.036537,172.31.47.0-255,66,284014,96,316161
11056,0.036569,74.125.24.0-255,2902,286916,96,316161
11057,0.036572,172.31.47.0-255,66,286982,96,316161
11058,0.038812,74.125.24.0-255,2902,289884,96,316161
11059,0.038818,172.31.47.0-255,66,289950,96,316161
11060,0.038852,74.125.24.0-255,2902,292852,96,316161
11061,0.038855,172.31.47.0-255,66,292918,96,316161
11062,0.041088,74.125.24.0-255,2902,295820,96,316161
11063,0.041092,172.31.47.0-255,66,295886,96,316161
11064,0.041119,74.125.24.0-255,2902,298788,96,316161
11065,0.041121,172.31.47.0-255,66,298854,96,316161
11066,0.043373,74.125.24.0-255,2902,301756,96,316161
11067,0.043379,172.31.47.0-255,66,301822,96,316161
11068,0.043409,74.125.24.0-255,2902,304724,96,316161
11069,0.043411,172.31.47.0-255,66,304790,96,316161
11070,0.045672,74.125.24.0-255,5738,310528,96,316161
11071,0.045678,172.31.47.0-255,66,310594,96,316161
11072,0.047985,74.125.24.0-255,5330,315924,96,316161
11073,0.047992,172.31.47.0-255,66,315990,96,316161
11074,0.048365,172.31.47.0-255,105,316095,96,316161
11075,0.05063,74.125.24.0-255,66,316161,96,316161
11076,0.0,172.31.47.0-255,105,105,96,210
11077,0.0689,31.13.82.0-255,105,210,96,210
11078,0.0,172.217.194.0-255,153,153,96,227078
11079,1.3e-05,172.31.47.0-255,66,219,96,227078
11080,1.8e-05,172.217.194.0-255,1484,1703,96,227078
11081,2.2e-05,172.31.47.0-255,66,1769,96,227078
11082,3.8e-05,172.217.194.0-255,2902,4671,96,227078
11083,4.1e-05,172.31.47.0-255,66,4737,96,227078
11084,7.1e-05,172.217.194.0-255,7156,11893,96,227078
11085,7.3e-05,172.31.47.0-255,66,11959,96,227078
11086,7.7e-05,172.217.194.0-255,2173,14132,96,227078
11087,7.9e-05,172.31.47.0-255,66,14198,96,227078
11088,0.000115,172.217.194.0-255,1484,15682,96,227078
11089,0.000118,172.31.47.0-255,66,15748,96,227078
11090,0.000133,172.217.194.0-255,1484,17232,96,227078
11091,0.000135,172.31.47.0-255,66,17298,96,227078
11092,0.000139,172.217.194.0-255,2902,20200,96,227078
11093,0.000141,172.31.47.0-255,66,20266,96,227078
11094,0.000166,172.217.194.0-255,4320,24586,96,227078
11095,0.000168,172.31.47.0-255,66,24652,96,227078
11096,0.000173,172.217.194.0-255,6797,31449,96,227078
11097,0.000186,172.31.47.0-255,66,31515,96,227078
11098,0.000246,172.217.194.0-255,1484,32999,96,227078
11099,0.00025,172.31.47.0-255,66,33065,96,227078
11100,0.000254,172.217.194.0-255,2902,35967,96,227078
11101,0.000256,172.31.47.0-255,66,36033,96,227078
11102,0.00026,172.217.194.0-255,2902,38935,96,227078
11103,0.000262,172.31.47.0-255,66,39001,96,227078
11104,0.000281,172.217.194.0-255,2902,41903,96,227078
11105,0.000284,172.31.47.0-255,66,41969,96,227078
11106,0.000288,172.217.194.0-255,2902,44871,96,227078
11107,0.00029,172.31.47.0-255,66,44937,96,227078
11108,0.00032,172.31.47.0-255,66,45003,96,227078
11109,0.000328,172.31.47.0-255,66,45069,96,227078
11110,0.000489,172.217.194.0-255,646,45715,96,227078
11111,0.000582,172.217.194.0-255,1484,47199,96,227078
11112,0.000597,172.31.47.0-255,66,47265,96,227078
11113,0.000602,172.217.194.0-255,2902,50167,96,227078
11114,0.000605,172.31.47.0-255,66,50233,96,227078
11115,0.000611,172.217.194.0-255,5738,55971,96,227078
11116,0.000614,172.31.47.0-255,66,56037,96,227078
11117,0.000619,172.217.194.0-255,5738,61775,96,227078
11118,0.000621,172.31.47.0-255,66,61841,96,227078
11119,0.000646,172.217.194.0-255,1484,63325,96,227078
11120,0.000659,172.31.47.0-255,66,63391,96,227078
11121,0.000663,172.217.194.0-255,2184,65575,96,227078
11122,0.000666,172.31.47.0-255,66,65641,96,227078
11123,0.000749,172.217.194.0-255,1484,67125,96,227078
11124,0.000756,172.217.194.0-255,2902,70027,96,227078
11125,0.00076,172.31.47.0-255,66,70093,96,227078
11126,0.000766,172.217.194.0-255,5738,75831,96,227078
11127,0.000769,172.31.47.0-255,66,75897,96,227078
11128,0.000782,172.217.194.0-255,1484,77381,96,227078
11129,0.000816,172.31.47.0-255,66,77447,96,227078
11130,0.000828,172.31.47.0-255,66,77513,96,227078
11131,0.001017,172.217.194.0-255,1484,78997,96,227078
11132,0.001025,172.217.194.0-255,2902,81899,96,227078
11133,0.001029,172.31.47.0-255,66,81965,96,227078
11134,0.001033,172.217.194.0-255,1484,83449,96,227078
11135,0.00105,172.217.194.0-255,4320,87769,96,227078
11136,0.001053,172.31.47.0-255,66,87835,96,227078
11137,0.001064,172.31.47.0-255,66,87901,96,227078
11138,0.001089,172.217.194.0-255,2902,90803,96,227078
11139,0.001092,172.31.47.0-255,66,90869,96,227078
11140,0.001103,172.31.47.0-255,66,90935,96,227078
11141,0.001106,172.217.194.0-255,766,91701,96,227078
11142,0.001714,172.217.194.0-255,1484,93185,96,227078
11143,0.001719,172.31.47.0-255,66,93251,96,227078
11144,0.001724,172.217.194.0-255,2902,96153,96,227078
11145,0.001726,172.31.47.0-255,66,96219,96,227078
11146,0.00173,172.217.194.0-255,2902,99121,96,227078
11147,0.001732,172.31.47.0-255,66,99187,96,227078
11148,0.001758,172.217.194.0-255,2902,102089,96,227078
11149,0.00176,172.31.47.0-255,66,102155,96,227078
11150,0.001767,172.217.194.0-255,7156,109311,96,227078
11151,0.001769,172.31.47.0-255,66,109377,96,227078
11152,0.001785,172.217.194.0-255,5738,115115,96,227078
11153,0.001787,172.31.47.0-255,66,115181,96,227078
11154,0.001799,172.31.47.0-255,66,115247,96,227078
11155,0.002144,172.217.194.0-255,1484,116731,96,227078
11156,0.002169,172.217.194.0-255,2902,119633,96,227078
11157,0.002173,172.31.47.0-255,66,119699,96,227078
11158,0.002179,172.217.194.0-255,5738,125437,96,227078
11159,0.002181,172.31.47.0-255,66,125503,96,227078
11160,0.002193,172.31.47.0-255,66,125569,96,227078
11161,0.002196,172.217.194.0-255,2902,128471,96,227078
11162,0.002198,172.31.47.0-255,66,128537,96,227078
11163,0.002223,172.217.194.0-255,4320,132857,96,227078
11164,0.002226,172.31.47.0-255,66,132923,96,227078
11165,0.002244,172.217.194.0-255,3602,136525,96,227078
11166,0.002247,172.31.47.0-255,66,136591,96,227078
11167,0.002361,172.217.194.0-255,1484,138075,96,227078
11168,0.002379,172.217.194.0-255,2902,140977,96,227078
11169,0.002381,172.31.47.0-255,66,141043,96,227078
11170,0.002387,172.217.194.0-255,4320,145363,96,227078
11171,0.002388,172.31.47.0-255,66,145429,96,227078
11172,0.002401,172.217.194.0-255,1484,146913,96,227078
11173,0.002403,172.217.194.0-255,1484,148397,96,227078
11174,0.002405,172.217.194.0-255,1484,149881,96,227078
11175,0.002408,172.31.47.0-255,66,149947,96,227078
11176,0.002435,172.217.194.0-255,7156,157103,96,227078
11177,0.002438,172.31.47.0-255,66,157169,96,227078
11178,0.002452,172.217.194.0-255,5738,162907,96,227078
11179,0.002454,172.31.47.0-255,66,162973,96,227078
11180,0.002486,172.31.47.0-255,66,163039,96,227078
11181,0.002488,172.217.194.0-255,1484,164523,96,227078
11182,0.002492,172.217.194.0-255,4320,168843,96,227078
11183,0.002493,172.31.47.0-255,66,168909,96,227078
11184,0.002514,172.31.47.0-255,66,168975,96,227078
11185,0.002543,172.217.194.0-255,5738,174713,96,227078
11186,0.002548,172.217.194.0-255,6438,181151,96,227078
11187,0.00255,172.217.194.0-255,1484,182635,96,227078
11188,0.002553,172.31.47.0-255,66,182701,96,227078
11189,0.002555,172.31.47.0-255,66,182767,96,227078
11190,0.002574,172.217.194.0-255,7156,189923,96,227078
11191,0.002576,172.31.47.0-255,66,189989,96,227078
11192,0.002615,172.31.47.0-255,66,190055,96,227078
11193,0.002617,172.217.194.0-255,766,190821,96,227078
11194,0.002619,172.31.47.0-255,78,190899,96,227078
11195,0.002629,172.31.47.0-255,66,190965,96,227078
11196,0.002631,172.217.194.0-255,1484,192449,96,227078
11197,0.002641,172.31.47.0-255,66,192515,96,227078
11198,0.002643,172.217.194.0-255,1484,193999,96,227078
11199,0.002672,172.217.194.0-255,4320,198319,96,227078
11200,0.002674,172.31.47.0-255,66,198385,96,227078
11201,0.002694,172.31.47.0-255,66,198451,96,227078
11202,0.002697,172.217.194.0-255,1484,199935,96,227078
11203,0.0027,172.217.194.0-255,2902,202837,96,227078
11204,0.002702,172.31.47.0-255,66,202903,96,227078
11205,0.002716,172.217.194.0-255,4320,207223,96,227078
11206,0.002718,172.31.47.0-255,66,207289,96,227078
11207,0.002757,172.31.47.0-255,66,207355,96,227078
11208,0.002762,172.217.194.0-255,5738,213093,96,227078
11209,0.002764,172.31.47.0-255,66,213159,96,227078
11210,0.002773,172.31.47.0-255,66,213225,96,227078
11211,0.002787,172.217.194.0-255,766,213991,96,227078
11212,0.003138,172.217.194.0-255,1484,215475,96,227078
11213,0.003141,172.31.47.0-255,66,215541,96,227078
11214,0.003146,172.217.194.0-255,2902,218443,96,227078
11215,0.003147,172.31.47.0-255,66,218509,96,227078
11216,0.003212,172.217.194.0-255,4833,223342,96,227078
11217,0.003215,172.31.47.0-255,66,223408,96,227078
11218,0.003231,172.217.194.0-255,105,223513,96,227078
11219,0.004047,172.31.47.0-255,66,223579,96,227078
11220,0.004077,172.31.47.0-255,105,223684,96,227078
11221,0.006346,172.217.194.0-255,66,223750,96,227078
11222,0.022787,172.31.47.0-255,172,223922,96,227078
11223,0.022833,172.31.47.0-255,1109,225031,96,227078
11224,0.022986,172.31.47.0-255,1514,226545,96,227078
11225,0.022988,172.31.47.0-255,335,226880,96,227078
11226,0.024328,104.244.42.0-255,66,226946,96,227078
11227,0.024373,104.244.42.0-255,66,227012,96,227078
11228,0.024525,104.244.42.0-255,66,227078,96,227078
11229,0.0,172.217.160.0-255,153,153,96,258700
11230,2.5e-05,172.31.47.0-255,66,219,96,258700
11231,3.4e-05,172.217.160.0-255,1484,1703,96,258700
11232,3.9e-05,172.31.47.0-255,66,1769,96,258700
11233,5.4e-05,172.217.160.0-255,2902,4671,96,258700
11234,5.8e-05,172.31.47.0-255,66,4737,96,258700
11235,6.5e-05,172.217.160.0-255,4320,9057,96,258700
11236,7.1e-05,172.31.47.0-255,66,9123,96,258700
11237,0.000135,172.31.47.0-255,66,9189,96,258700
11238,0.000246,172.31.47.0-255,66,9255,96,258700
11239,0.000284,172.217.160.0-255,2543,11798,96,258700
11240,0.000287,172.31.47.0-255,66,11864,96,258700
11241,0.000427,172.31.47.0-255,66,11930,96,258700
11242,0.000461,172.217.160.0-255,4320,16250,96,258700
11243,0.000464,172.31.47.0-255,66,16316,96,258700
11244,0.000616,172.31.47.0-255,66,16382,96,258700
11245,0.000651,172.217.160.0-255,6438,22820,96,258700
11246,0.000655,172.31.47.0-255,66,22886,96,258700
11247,0.000842,172.217.160.0-255,338,23224,96,258700
11248,0.000847,172.31.47.0-255,66,23290,96,258700
11249,0.001163,172.217.160.0-255,119,23409,96,258700
11250,0.001168,172.31.47.0-255,66,23475,96,258700
11251,0.001331,172.217.160.0-255,1484,24959,96,258700
11252,0.001336,172.31.47.0-255,66,25025,96,258700
11253,0.001341,172.217.160.0-255,1484,26509,96,258700
11254,0.001344,172.31.47.0-255,66,26575,96,258700
11255,0.001372,172.217.160.0-255,1484,28059,96,258700
11256,0.001375,172.31.47.0-255,66,28125,96,258700
11257,0.001382,172.217.160.0-255,5738,33863,96,258700
11258,0.001385,172.31.47.0-255,66,33929,96,258700
11259,0.001488,172.217.160.0-255,5738,39667,96,258700
11260,0.001493,172.31.47.0-255,66,39733,96,258700
11261,0.001569,172.217.160.0-255,4320,44053,96,258700
11262,0.001573,172.31.47.0-255,66,44119,96,258700
11263,0.001624,172.31.47.0-255,66,44185,96,258700
11264,0.001785,172.217.160.0-255,7156,51341,96,258700
11265,0.00179,172.31.47.0-255,66,51407,96,258700
11266,0.001829,172.31.47.0-255,66,51473,96,258700
11267,0.002139,172.217.160.0-255,5738,57211,96,258700
11268,0.002146,172.31.47.0-255,66,57277,96,258700
11269,0.002185,172.217.160.0-255,2184,59461,96,258700
11270,0.002188,172.31.47.0-255,66,59527,96,258700
11271,0.002261,172.31.47.0-255,66,59593,96,258700
11272,0.002295,172.31.47.0-255,66,59659,96,258700
11273,0.002514,172.31.47.0-255,66,59725,96,258700
11274,0.002597,172.31.47.0-255,66,59791,96,258700
11275,0.002629,172.217.160.0-255,4039,63830,96,258700
11276,0.002632,172.31.47.0-255,66,63896,96,258700
11277,0.004593,172.217.160.0-255,1484,65380,96,258700
11278,0.004627,172.217.160.0-255,4320,69700,96,258700
11279,0.004634,172.31.47.0-255,66,69766,96,258700
11280,0.006628,172.217.160.0-255,5738,75504,96,258700
11281,0.006649,172.31.47.0-255,66,75570,96,258700
11282,0.008655,172.217.160.0-255,5738,81308,96,258700
11283,0.008669,172.31.47.0-255,66,81374,96,258700
11284,0.01067,172.217.160.0-255,5738,87112,96,258700
11285,0.010687,172.31.47.0-255,66,87178,96,258700
11286,0.012672,172.217.160.0-255,5738,92916,96,258700
11287,0.01268,172.31.47.0-255,66,92982,96,258700
11288,0.014656,172.217.160.0-255,2902,95884,96,258700
11289,0.01466,172.31.47.0-255,66,95950,96,258700
11290,0.014687,172.217.160.0-255,2902,98852,96,258700
11291,0.01469,172.31.47.0-255,66,98918,96,258700
11292,0.016637,172.217.160.0-255,2902,101820,96,258700
11293,0.016643,172.31.47.0-255,66,101886,96,258700
11294,0.016672,172.217.160.0-255,2902,104788,96,258700
11295,0.016675,172.31.47.0-255,66,104854,96,258700
11296,0.018641,172.217.160.0-255,5738,110592,96,258700
11297,0.018648,172.31.47.0-255,66,110658,96,258700
11298,0.020626,172.217.160.0-255,5738,116396,96,258700
11299,0.020631,172.31.47.0-255,66,116462,96,258700
11300,0.022632,172.217.160.0-255,5738,122200,96,258700
11301,0.022642,172.31.47.0-255,66,122266,96,258700
11302,0.024652,172.217.160.0-255,5738,128004,96,258700
11303,0.024667,172.31.47.0-255,66,128070,96,258700
11304,0.026654,172.217.160.0-255,5738,133808,96,258700
11305,0.026662,172.31.47.0-255,66,133874,96,258700
11306,0.028651,172.217.160.0-255,5738,139612,96,258700
11307,0.028658,172.31.47.0-255,66,139678,96,258700
11308,0.030629,172.217.160.0-255,5738,145416,96,258700
11309,0.030634,172.31.47.0-255,66,145482,96,258700
11310,0.032612,172.217.160.0-255,5738,151220,96,258700
11311,0.032619,172.31.47.0-255,66,151286,96,258700
11312,0.034598,172.217.160.0-255,5738,157024,96,258700
11313,0.034604,172.31.47.0-255,66,157090,96,258700
11314,0.036587,172.217.160.0-255,5738,162828,96,258700
11315,0.036599,172.31.47.0-255,66,162894,96,258700
11316,0.038594,172.217.160.0-255,5738,168632,96,258700
11317,0.038602,172.31.47.0-255,66,168698,96,258700
11318,0.040577,172.217.160.0-255,5738,174436,96,258700
11319,0.040583,172.31.47.0-255,66,174502,96,258700
11320,0.042554,172.217.160.0-255,4320,178822,96,258700
11321,0.042571,172.31.47.0-255,66,178888,96,258700
11322,0.042589,172.217.160.0-255,1484,180372,96,258700
11323,0.044539,172.217.160.0-255,4320,184692,96,258700
11324,0.044545,172.31.47.0-255,66,184758,96,258700
11325,0.046556,172.217.160.0-255,5738,190496,96,258700
11326,0.046572,172.31.47.0-255,66,190562,96,258700
11327,0.048554,172.217.160.0-255,5738,196300,96,258700
11328,0.048563,172.31.47.0-255,66,196366,96,258700
11329,0.050556,172.217.160.0-255,5738,202104,96,258700
11330,0.050563,172.31.47.0-255,66,202170,96,258700
11331,0.052598,172.217.160.0-255,5738,207908,96,258700
11332,0.052614,172.31.47.0-255,66,207974,96,258700
11333,0.054622,172.217.160.0-255,5738,213712,96,258700
11334,0.054641,172.31.47.0-255,66,213778,96,258700
11335,0.056649,172.217.160.0-255,5738,219516,96,258700
11336,0.056665,172.31.47.0-255,66,219582,96,258700
11337,0.058658,172.217.160.0-255,5738,225320,96,258700
11338,0.058673,172.31.47.0-255,66,225386,96,258700
11339,0.060671,172.217.160.0-255,5738,231124,96,258700
11340,0.060685,172.31.47.0-255,66,231190,96,258700
11341,0.062308,172.31.47.0-255,171,231361,96,258700
11342,0.062367,172.31.47.0-255,1125,232486,96,258700
11343,0.062456,172.31.47.0-255,1514,234000,96,258700
11344,0.062458,172.31.47.0-255,1286,235286,96,258700
11345,0.062681,172.217.160.0-255,5738,241024,96,258700
11346,0.06269,172.31.47.0-255,66,241090,96,258700
11347,0.063888,104.244.42.0-255,66,241156,96,258700
11348,0.063915,104.244.42.0-255,66,241222,96,258700
11349,0.064002,104.244.42.0-255,66,241288,96,258700
11350,0.064767,172.217.160.0-255,5738,247026,96,258700
11351,0.064781,172.31.47.0-255,66,247092,96,258700
11352,0.066775,172.217.160.0-255,5738,252830,96,258700
11353,0.066783,172.31.47.0-255,66,252896,96,258700
11354,0.068778,172.217.160.0-255,5738,258634,96,258700
11355,0.068784,172.31.47.0-255,66,258700,96,258700
11356,0.0,172.217.194.0-255,153,153,96,317303
11357,2.4e-05,172.31.47.0-255,66,219,96,317303
11358,2.9e-05,172.217.194.0-255,1484,1703,96,317303
11359,3.3e-05,172.31.47.0-255,66,1769,96,317303
11360,3.5e-05,172.217.194.0-255,1484,3253,96,317303
11361,3.7e-05,172.31.47.0-255,66,3319,96,317303
11362,6e-05,172.217.194.0-255,1484,4803,96,317303
11363,6.2e-05,172.31.47.0-255,66,4869,96,317303
11364,6.8e-05,172.217.194.0-255,5738,10607,96,317303
11365,6.9e-05,172.31.47.0-255,66,10673,96,317303
11366,0.000106,172.217.194.0-255,3579,14252,96,317303
11367,0.000109,172.31.47.0-255,66,14318,96,317303
11368,0.000133,172.217.194.0-255,1484,15802,96,317303
11369,0.000135,172.31.47.0-255,66,15868,96,317303
11370,0.000139,172.217.194.0-255,2902,18770,96,317303
11371,0.00014,172.31.47.0-255,66,18836,96,317303
11372,0.000173,172.217.194.0-255,5738,24574,96,317303
11373,0.000178,172.31.47.0-255,66,24640,96,317303
11374,0.00019,172.217.194.0-255,2902,27542,96,317303
11375,0.000192,172.31.47.0-255,66,27608,96,317303
11376,0.000213,172.217.194.0-255,3961,31569,96,317303
11377,0.000216,172.31.47.0-255,66,31635,96,317303
11378,0.000415,172.217.194.0-255,1484,33119,96,317303
11379,0.000419,172.31.47.0-255,66,33185,96,317303
11380,0.000424,172.217.194.0-255,2902,36087,96,317303
11381,0.000428,172.31.47.0-255,66,36153,96,317303
11382,0.00044,172.217.194.0-255,5738,41891,96,317303
11383,0.000443,172.31.47.0-255,66,41957,96,317303
11384,0.000449,172.217.194.0-255,5738,47695,96,317303
11385,0.000451,172.31.47.0-255,66,47761,96,317303
11386,0.000497,172.217.194.0-255,5738,53499,96,317303
11387,0.0005,172.31.47.0-255,66,53565,96,317303
11388,0.000523,172.217.194.0-255,2543,56108,96,317303
11389,0.000527,172.31.47.0-255,66,56174,96,317303
11390,0.000537,172.31.47.0-255,66,56240,96,317303
11391,0.00054,172.217.194.0-255,1457,57697,96,317303
11392,0.000604,172.217.194.0-255,376,58073,96,317303
11393,0.000607,172.31.47.0-255,66,58139,96,317303
11394,0.000773,172.217.194.0-255,1484,59623,96,317303
11395,0.000776,172.217.194.0-255,1484,61107,96,317303
11396,0.000781,172.31.47.0-255,66,61173,96,317303
11397,0.000799,172.217.194.0-255,1484,62657,96,317303
11398,0.000805,172.217.194.0-255,5738,68395,96,317303
11399,0.000808,172.31.47.0-255,66,68461,96,317303
11400,0.000812,172.217.194.0-255,2902,71363,96,317303
11401,0.000814,172.31.47.0-255,66,71429,96,317303
11402,0.000842,172.31.47.0-255,66,71495,96,317303
11403,0.000845,172.217.194.0-255,1484,72979,96,317303
11404,0.000876,172.31.47.0-255,66,73045,96,317303
11405,0.000959,172.217.194.0-255,1484,74529,96,317303
11406,0.000977,172.217.194.0-255,2902,77431,96,317303
11407,0.00098,172.31.47.0-255,66,77497,96,317303
11408,0.000986,172.217.194.0-255,5738,83235,96,317303
11409,0.000988,172.31.47.0-255,66,83301,96,317303
11410,0.001028,172.31.47.0-255,66,83367,96,317303
11411,0.001074,172.31.47.0-255,66,83433,96,317303
11412,0.001081,172.217.194.0-255,5738,89171,96,317303
11413,0.001085,172.31.47.0-255,66,89237,96,317303
11414,0.001104,172.217.194.0-255,5738,94975,96,317303
11415,0.001107,172.31.47.0-255,66,95041,96,317303
11416,0.001113,172.217.194.0-255,5738,100779,96,317303
11417,0.001115,172.31.47.0-255,66,100845,96,317303
11418,0.001149,172.31.47.0-255,66,100911,96,317303
11419,0.001204,172.217.194.0-255,1484,102395,96,317303
11420,0.001209,172.217.194.0-255,2902,105297,96,317303
11421,0.001212,172.31.47.0-255,66,105363,96,317303
11422,0.001215,172.217.194.0-255,1484,106847,96,317303
11423,0.00123,172.217.194.0-255,4320,111167,96,317303
11424,0.001242,172.31.47.0-255,66,111233,96,317303
11425,0.001248,172.217.194.0-255,2902,114135,96,317303
11426,0.001255,172.31.47.0-255,66,114201,96,317303
11427,0.001275,172.31.47.0-255,66,114267,96,317303
11428,0.001287,172.31.47.0-255,66,114333,96,317303
11429,0.001312,172.217.194.0-255,2184,116517,96,317303
11430,0.001318,172.31.47.0-255,66,116583,96,317303
11431,0.001585,172.217.194.0-255,1484,118067,96,317303
11432,0.001598,172.217.194.0-255,2902,120969,96,317303
11433,0.001602,172.31.47.0-255,66,121035,96,317303
11434,0.001622,172.217.194.0-255,5738,126773,96,317303
11435,0.001625,172.31.47.0-255,66,126839,96,317303
11436,0.001629,172.217.194.0-255,4320,131159,96,317303
11437,0.001631,172.31.47.0-255,66,131225,96,317303
11438,0.001653,172.217.194.0-255,5738,136963,96,317303
11439,0.001656,172.31.47.0-255,66,137029,96,317303
11440,0.001682,172.31.47.0-255,66,137095,96,317303
11441,0.001686,172.217.194.0-255,3602,140697,96,317303
11442,0.001687,172.31.47.0-255,66,140763,96,317303
11443,0.001749,172.217.194.0-255,1484,142247,96,317303
11444,0.001753,172.217.194.0-255,2902,145149,96,317303
11445,0.001756,172.31.47.0-255,66,145215,96,317303
11446,0.00176,172.217.194.0-255,2902,148117,96,317303
11447,0.001762,172.31.47.0-255,66,148183,96,317303
11448,0.001781,172.217.194.0-255,2902,151085,96,317303
11449,0.001784,172.31.47.0-255,66,151151,96,317303
11450,0.001789,172.217.194.0-255,5738,156889,96,317303
11451,0.001791,172.31.47.0-255,66,156955,96,317303
11452,0.001794,172.217.194.0-255,1484,158439,96,317303
11453,0.001825,172.31.47.0-255,66,158505,96,317303
11454,0.001827,172.217.194.0-255,5020,163525,96,317303
11455,0.001829,172.31.47.0-255,66,163591,96,317303
11456,0.001844,172.217.194.0-255,2902,166493,96,317303
11457,0.001846,172.31.47.0-255,66,166559,96,317303
11458,0.001865,172.217.194.0-255,2902,169461,96,317303
11459,0.001871,172.217.194.0-255,7156,176617,96,317303
11460,0.001876,172.31.47.0-255,66,176683,96,317303
11461,0.001884,172.217.194.0-255,5738,182421,96,317303
11462,0.00189,172.217.194.0-255,7156,189577,96,317303
11463,0.001892,172.31.47.0-255,66,189643,96,317303
11464,0.001896,172.31.47.0-255,66,189709,96,317303
11465,0.001905,172.217.194.0-255,4320,194029,96,317303
11466,0.001907,172.31.47.0-255,66,194095,96,317303
11467,0.001924,172.217.194.0-255,1484,195579,96,317303
11468,0.00194,172.217.194.0-255,2184,197763,96,317303
11469,0.001947,172.31.47.0-255,66,197829,96,317303
11470,0.004196,172.217.194.0-255,1484,199313,96,317303
11471,0.004226,172.217.194.0-255,4320,203633,96,317303
11472,0.004231,172.31.47.0-255,66,203699,96,317303
11473,0.006521,172.217.194.0-255,5738,209437,96,317303
11474,0.006527,172.31.47.0-255,66,209503,96,317303
11475,0.008808,172.217.194.0-255,5738,215241,96,317303
11476,0.008813,172.31.47.0-255,66,215307,96,317303
11477,0.011114,172.217.194.0-255,5738,221045,96,317303
11478,0.011122,172.31.47.0-255,66,221111,96,317303
11479,0.013423,172.217.194.0-255,5738,226849,96,317303
11480,0.013433,172.31.47.0-255,66,226915,96,317303
11481,0.015746,172.217.194.0-255,5738,232653,96,317303
11482,0.015755,172.31.47.0-255,66,232719,96,317303
11483,0.018055,172.217.194.0-255,5738,238457,96,317303
11484,0.018061,172.31.47.0-255,66,238523,96,317303
11485,0.020365,172.217.194.0-255,5738,244261,96,317303
11486,0.020372,172.31.47.0-255,66,244327,96,317303
11487,0.022687,172.217.194.0-255,5738,250065,96,317303
11488,0.022695,172.31.47.0-255,66,250131,96,317303
11489,0.023955,172.31.47.0-255,172,250303,96,317303
11490,0.02399,172.31.47.0-255,1109,251412,96,317303
11491,0.024048,172.31.47.0-255,1514,252926,96,317303
11492,0.02405,172.31.47.0-255,1304,254230,96,317303
11493,0.025002,172.217.194.0-255,5738,259968,96,317303
11494,0.025007,172.31.47.0-255,66,260034,96,317303
11495,0.025479,104.244.42.0-255,66,260100,96,317303
11496,0.025506,104.244.42.0-255,66,260166,96,317303
11497,0.025552,104.244.42.0-255,66,260232,96,317303
11498,0.027304,172.217.194.0-255,5738,265970,96,317303
11499,0.027309,172.31.47.0-255,66,266036,96,317303
11500,0.029607,172.217.194.0-255,2902,268938,96,317303
11501,0.029612,172.31.47.0-255,66,269004,96,317303
11502,0.029642,172.217.194.0-255,2902,271906,96,317303
11503,0.029645,172.31.47.0-255,66,271972,96,317303
11504,0.031913,172.217.194.0-255,5738,277710,96,317303
11505,0.031917,172.31.47.0-255,66,277776,96,317303
11506,0.034204,172.217.194.0-255,5738,283514,96,317303
11507,0.034209,172.31.47.0-255,66,283580,96,317303
11508,0.036525,172.217.194.0-255,5738,289318,96,317303
11509,0.03653,172.31.47.0-255,66,289384,96,317303
11510,0.038822,172.217.194.0-255,5738,295122,96,317303
11511,0.038826,172.31.47.0-255,66,295188,96,317303
11512,0.041118,172.217.194.0-255,5738,300926,96,317303
11513,0.041123,172.31.47.0-255,66,300992,96,317303
11514,0.043421,172.217.194.0-255,4320,305312,96,317303
11515,0.043437,172.31.47.0-255,66,305378,96,317303
11516,0.043453,172.217.194.0-255,1484,306862,96,317303
11517,0.045716,172.217.194.0-255,4320,311182,96,317303
11518,0.045722,172.31.47.0-255,66,311248,96,317303
11519,0.047998,172.217.194.0-255,4320,315568,96,317303
11520,0.048003,172.31.47.0-255,66,315634,96,317303
11521,0.048032,172.217.194.0-255,1432,317066,96,317303
11522,0.048174,172.31.47.0-255,66,317132,96,317303
11523,0.0482,172.31.47.0-255,105,317237,96,317303
11524,0.05044,172.217.194.0-255,66,317303,96,317303
11525,0.0,172.31.47.0-255,105,105,96,276
11526,0.001796,157.240.7.0-255,105,210,96,276
11527,0.001809,172.31.47.0-255,66,276,96,276
11528,0.0,74.125.130.0-255,153,153,96,368165
11529,3e-05,172.31.47.0-255,66,219,96,368165
11530,3.7e-05,74.125.130.0-255,1484,1703,96,368165
11531,4.2e-05,172.31.47.0-255,66,1769,96,368165
11532,4.7e-05,74.125.130.0-255,2902,4671,96,368165
11533,4.9e-05,172.31.47.0-255,66,4737,96,368165
11534,7.8e-05,74.125.130.0-255,1484,6221,96,368165
11535,8.1e-05,172.31.47.0-255,66,6287,96,368165
11536,0.000101,74.125.130.0-255,5738,12025,96,368165
11537,0.000103,172.31.47.0-255,66,12091,96,368165
11538,0.000114,172.31.47.0-255,66,12157,96,368165
11539,0.000117,74.125.130.0-255,1484,13641,96,368165
11540,0.000119,172.31.47.0-255,66,13707,96,368165
11541,0.000149,74.125.130.0-255,4320,18027,96,368165
11542,0.000153,172.31.47.0-255,66,18093,96,368165
11543,0.000161,74.125.130.0-255,7156,25249,96,368165
11544,0.000164,172.31.47.0-255,66,25315,96,368165
11545,0.000188,74.125.130.0-255,4320,29635,96,368165
11546,0.00019,172.31.47.0-255,66,29701,96,368165
11547,0.00021,74.125.130.0-255,4320,34021,96,368165
11548,0.000213,172.31.47.0-255,66,34087,96,368165
11549,0.000235,74.125.130.0-255,6438,40525,96,368165
11550,0.000238,172.31.47.0-255,66,40591,96,368165
11551,0.000274,74.125.130.0-255,5738,46329,96,368165
11552,0.000278,172.31.47.0-255,66,46395,96,368165
11553,0.000293,74.125.130.0-255,1484,47879,96,368165
11554,0.000295,172.31.47.0-255,66,47945,96,368165
11555,0.000304,74.125.130.0-255,5738,53683,96,368165
11556,0.000307,172.31.47.0-255,66,53749,96,368165
11557,0.000328,74.125.130.0-255,2902,56651,96,368165
11558,0.000331,172.31.47.0-255,66,56717,96,368165
11559,0.000334,74.125.130.0-255,1431,58148,96,368165
11560,0.000349,74.125.130.0-255,381,58529,96,368165
11561,0.00036,172.31.47.0-255,66,58595,96,368165
11562,0.000751,74.125.130.0-255,1484,60079,96,368165
11563,0.000756,74.125.130.0-255,2902,62981,96,368165
11564,0.00076,172.31.47.0-255,66,63047,96,368165
11565,0.00078,74.125.130.0-255,5738,68785,96,368165
11566,0.000784,172.31.47.0-255,66,68851,96,368165
11567,0.000788,74.125.130.0-255,2902,71753,96,368165
11568,0.00079,74.125.130.0-255,1484,73237,96,368165
11569,0.000792,172.31.47.0-255,66,73303,96,368165
11570,0.000827,74.125.130.0-255,2902,76205,96,368165
11571,0.000831,172.31.47.0-255,66,76271,96,368165
11572,0.000842,172.31.47.0-255,66,76337,96,368165
11573,0.000847,74.125.130.0-255,4320,80657,96,368165
11574,0.000849,172.31.47.0-255,66,80723,96,368165
11575,0.000883,74.125.130.0-255,1484,82207,96,368165
11576,0.000903,74.125.130.0-255,2184,84391,96,368165
11577,0.000905,172.31.47.0-255,66,84457,96,368165
11578,0.001064,74.125.130.0-255,1484,85941,96,368165
11579,0.001077,74.125.130.0-255,2902,88843,96,368165
11580,0.00108,74.125.130.0-255,1484,90327,96,368165
11581,0.001103,74.125.130.0-255,2902,93229,96,368165
11582,0.001122,74.125.130.0-255,5738,98967,96,368165
11583,0.001146,74.125.130.0-255,1484,100451,96,368165
11584,0.001166,74.125.130.0-255,5738,106189,96,368165
11585,0.001182,74.125.130.0-255,4320,110509,96,368165
11586,0.001204,74.125.130.0-255,4320,114829,96,368165
11587,0.001208,74.125.130.0-255,3602,118431,96,368165
11588,0.001364,74.125.130.0-255,1484,119915,96,368165
11589,0.001379,74.125.130.0-255,2902,122817,96,368165
11590,0.001396,74.125.130.0-255,2902,125719,96,368165
11591,0.001411,74.125.130.0-255,4320,130039,96,368165
11592,0.001449,74.125.130.0-255,4320,134359,96,368165
11593,0.001467,74.125.130.0-255,1484,135843,96,368165
11594,0.001491,74.125.130.0-255,7156,142999,96,368165
11595,0.001495,74.125.130.0-255,2902,145901,96,368165
11596,0.001521,74.125.130.0-255,4320,150221,96,368165
11597,0.001547,74.125.130.0-255,2184,152405,96,368165
11598,0.00178,74.125.130.0-255,1484,153889,96,368165
11599,0.001795,74.125.130.0-255,1484,155373,96,368165
11600,0.001816,74.125.130.0-255,2902,158275,96,368165
11601,0.001841,74.125.130.0-255,1484,159759,96,368165
11602,0.001856,74.125.130.0-255,4320,164079,96,368165
11603,0.001915,74.125.130.0-255,1484,165563,96,368165
11604,0.001931,74.125.130.0-255,5738,171301,96,368165
11605,0.001975,74.125.130.0-255,1484,172785,96,368165
11606,0.001988,74.125.130.0-255,1484,174269,96,368165
11607,0.001993,74.125.130.0-255,4320,178589,96,368165
11608,0.001998,74.125.130.0-255,4320,182909,96,368165
11609,0.002001,74.125.130.0-255,2902,185811,96,368165
11610,0.00201,74.125.130.0-255,766,186577,96,368165
11611,0.004955,172.31.47.0-255,66,186643,96,368165
11612,0.00701,74.125.130.0-255,5738,192381,96,368165
11613,0.007017,172.31.47.0-255,66,192447,96,368165
11614,0.009031,74.125.130.0-255,5738,198185,96,368165
11615,0.009038,172.31.47.0-255,66,198251,96,368165
11616,0.011064,74.125.130.0-255,5738,203989,96,368165
11617,0.011072,172.31.47.0-255,66,204055,96,368165
11618,0.013101,74.125.130.0-255,5738,209793,96,368165
11619,0.013118,172.31.47.0-255,66,209859,96,368165
11620,0.015154,74.125.130.0-255,4320,214179,96,368165
11621,0.015162,172.31.47.0-255,66,214245,96,368165
11622,0.015195,74.125.130.0-255,1484,215729,96,368165
11623,0.017197,74.125.130.0-255,4320,220049,96,368165
11624,0.017203,172.31.47.0-255,66,220115,96,368165
11625,0.019233,74.125.130.0-255,5738,225853,96,368165
11626,0.019242,172.31.47.0-255,66,225919,96,368165
11627,0.021262,74.125.130.0-255,5738,231657,96,368165
11628,0.021269,172.31.47.0-255,66,231723,96,368165
11629,0.023293,74.125.130.0-255,4320,236043,96,368165
11630,0.0233,172.31.47.0-255,66,236109,96,368165
11631,0.023337,74.125.130.0-255,1484,237593,96,368165
11632,0.025326,74.125.130.0-255,4320,241913,96,368165
11633,0.025333,172.31.47.0-255,66,241979,96,368165
11634,0.027367,74.125.130.0-255,5738,247717,96,368165
11635,0.027374,172.31.47.0-255,66,247783,96,368165
11636,0.027962,172.31.47.0-255,172,247955,96,368165
11637,0.028,172.31.47.0-255,1110,249065,96,368165
11638,0.028063,172.31.47.0-255,1514,250579,96,368165
11639,0.028066,172.31.47.0-255,1514,252093,96,368165
11640,0.028069,172.31.47.0-255,1514,253607,96,368165
11641,0.02807,172.31.47.0-255,1082,254689,96,368165
11642,0.029411,74.125.130.0-255,5738,260427,96,368165
11643,0.029417,172.31.47.0-255,66,260493,96,368165
11644,0.02951,104.244.42.0-255,66,260559,96,368165
11645,0.029677,104.244.42.0-255,66,260625,96,368165
11646,0.029682,104.244.42.0-255,66,260691,96,368165
11647,0.029754,104.244.42.0-255,66,260757,96,368165
11648,0.031434,74.125.130.0-255,5738,266495,96,368165
11649,0.03144,172.31.47.0-255,66,266561,96,368165
11650,0.033514,74.125.130.0-255,4320,270881,96,368165
11651,0.033519,172.31.47.0-255,66,270947,96,368165
11652,0.033539,74.125.130.0-255,1484,272431,96,368165
11653,0.035583,74.125.130.0-255,4320,276751,96,368165
11654,0.035592,172.31.47.0-255,66,276817,96,368165
11655,0.037629,74.125.130.0-255,4320,281137,96,368165
11656,0.037636,172.31.47.0-255,66,281203,96,368165
11657,0.03765,74.125.130.0-255,1484,282687,96,368165
11658,0.039667,74.125.130.0-255,4320,287007,96,368165
11659,0.039672,172.31.47.0-255,66,287073,96,368165
11660,0.041693,74.125.130.0-255,1484,288557,96,368165
11661,0.041723,74.125.130.0-255,4320,292877,96,368165
11662,0.041727,172.31.47.0-255,66,292943,96,368165
11663,0.043754,74.125.130.0-255,4320,297263,96,368165
11664,0.043759,172.31.47.0-255,66,297329,96,368165
11665,0.043788,74.125.130.0-255,1484,298813,96,368165
11666,0.045816,74.125.130.0-255,4320,303133,96,368165
11667,0.045822,172.31.47.0-255,66,303199,96,368165
11668,0.047848,74.125.130.0-255,2902,306101,96,368165
11669,0.047854,172.31.47.0-255,66,306167,96,368165
11670,0.047878,74.125.130.0-255,2902,309069,96,368165
11671,0.04788,172.31.47.0-255,66,309135,96,368165
11672,0.049874,74.125.130.0-255,2902,312037,96,368165
11673,0.049879,172.31.47.0-255,66,312103,96,368165
11674,0.049903,74.125.130.0-255,2902,315005,96,368165
11675,0.049906,172.31.47.0-255,66,315071,96,368165
11676,0.051912,74.125.130.0-255,2902,317973,96,368165
11677,0.051918,172.31.47.0-255,66,318039,96,368165
11678,0.051942,74.125.130.0-255,2902,320941,96,368165
11679,0.051944,172.31.47.0-255,66,321007,96,368165
11680,0.05395,74.125.130.0-255,1484,322491,96,368165
11681,0.053993,74.125.130.0-255,4320,326811,96,368165
11682,0.054002,172.31.47.0-255,66,326877,96,368165
11683,0.056041,74.125.130.0-255,5738,332615,96,368165
11684,0.056047,172.31.47.0-255,66,332681,96,368165
11685,0.05807,74.125.130.0-255,5738,338419,96,368165
11686,0.058075,172.31.47.0-255,66,338485,96,368165
11687,0.060096,74.125.130.0-255,2902,341387,96,368165
11688,0.060101,172.31.47.0-255,66,341453,96,368165
11689,0.060127,74.125.130.0-255,2902,344355,96,368165
11690,0.06013,172.31.47.0-255,66,344421,96,368165
11691,0.062116,74.125.130.0-255,2902,347323,96,368165
11692,0.062121,172.31.47.0-255,66,347389,96,368165
11693,0.062151,74.125.130.0-255,2902,350291,96,368165
11694,0.062155,172.31.47.0-255,66,350357,96,368165
11695,0.064156,74.125.130.0-255,2902,353259,96,368165
11696,0.064161,172.31.47.0-255,66,353325,96,368165
11697,0.064189,74.125.130.0-255,2902,356227,96,368165
11698,0.064191,172.31.47.0-255,66,356293,96,368165
11699,0.066183,74.125.130.0-255,2902,359195,96,368165
11700,0.06619,172.31.47.0-255,66,359261,96,368165
11701,0.066216,74.125.130.0-255,2902,362163,96,368165
11702,0.066219,172.31.47.0-255,66,362229,96,368165
11703,0.068213,74.125.130.0-255,2902,365131,96,368165
11704,0.068219,172.31.47.0-255,66,365197,96,368165
11705,0.068282,74.125.130.0-255,2902,368099,96,368165
11706,0.068286,172.31.47.0-255,66,368165,96,368165
11707,0.0,74.125.24.0-255,153,153,96,268822
11708,1.8e-05,172.31.47.0-255,66,219,96,268822
11709,2.5e-05,74.125.24.0-255,1484,1703,96,268822
11710,3e-05,172.31.47.0-255,66,1769,96,268822
11711,3.4e-05,74.125.24.0-255,2902,4671,96,268822
11712,3.7e-05,172.31.47.0-255,66,4737,96,268822
11713,4.4e-05,74.125.24.0-255,5738,10475,96,268822
11714,4.7e-05,172.31.47.0-255,66,10541,96,268822
11715,0.000106,172.31.47.0-255,66,10607,96,268822
11716,0.000109,74.125.24.0-255,1484,12091,96,268822
11717,0.000112,172.31.47.0-255,66,12157,96,268822
11718,0.000136,74.125.24.0-255,5379,17536,96,268822
11719,0.000139,172.31.47.0-255,66,17602,96,268822
11720,0.000187,74.125.24.0-255,1484,19086,96,268822
11721,0.000189,172.31.47.0-255,66,19152,96,268822
11722,0.000193,74.125.24.0-255,1484,20636,96,268822
11723,0.000195,172.31.47.0-255,66,20702,96,268822
11724,0.000208,74.125.24.0-255,1484,22186,96,268822
11725,0.00021,172.31.47.0-255,66,22252,96,268822
11726,0.000215,74.125.24.0-255,4320,26572,96,268822
11727,0.000217,172.31.47.0-255,66,26638,96,268822
11728,0.000242,74.125.24.0-255,1484,28122,96,268822
11729,0.000245,172.31.47.0-255,66,28188,96,268822
11730,0.000251,74.125.24.0-255,5738,33926,96,268822
11731,0.000254,172.31.47.0-255,66,33992,96,268822
11732,0.000267,74.125.24.0-255,2902,36894,96,268822
11733,0.00027,172.31.47.0-255,66,36960,96,268822
11734,0.000303,172.31.47.0-255,66,37026,96,268822
11735,0.000308,74.125.24.0-255,4235,41261,96,268822
11736,0.00031,172.31.47.0-255,66,41327,96,268822
11737,0.000424,74.125.24.0-255,381,41708,96,268822
11738,0.000428,172.31.47.0-255,66,41774,96,268822
11739,0.000547,74.125.24.0-255,1484,43258,96,268822
11740,0.000553,74.125.24.0-255,1484,44742,96,268822
11741,0.000558,172.31.47.0-255,66,44808,96,268822
11742,0.000568,74.125.24.0-255,1484,46292,96,268822
11743,0.000572,74.125.24.0-255,2902,49194,96,268822
11744,0.000587,74.125.24.0-255,2902,52096,96,268822
11745,0.000594,74.125.24.0-255,6797,58893,96,268822
11746,0.000622,74.125.24.0-255,7156,66049,96,268822
11747,0.000629,172.31.47.0-255,66,66115,96,268822
11748,0.000648,74.125.24.0-255,7156,73271,96,268822
11749,0.00067,172.31.47.0-255,66,73337,96,268822
11750,0.000674,74.125.24.0-255,2543,75880,96,268822
11751,0.000679,172.31.47.0-255,66,75946,96,268822
11752,0.001262,74.125.24.0-255,1484,77430,96,268822
11753,0.001267,74.125.24.0-255,1484,78914,96,268822
11754,0.001271,172.31.47.0-255,66,78980,96,268822
11755,0.001291,74.125.24.0-255,1484,80464,96,268822
11756,0.001297,74.125.24.0-255,5738,86202,96,268822
11757,0.0013,74.125.24.0-255,2902,89104,96,268822
11758,0.001314,74.125.24.0-255,1484,90588,96,268822
11759,0.001317,172.31.47.0-255,66,90654,96,268822
11760,0.001343,74.125.24.0-255,4320,94974,96,268822
11761,0.001353,172.31.47.0-255,66,95040,96,268822
11762,0.001368,74.125.24.0-255,6438,101478,96,268822
11763,0.001389,172.31.47.0-255,66,101544,96,268822
11764,0.001473,74.125.24.0-255,1484,103028,96,268822
11765,0.001479,74.125.24.0-255,2902,105930,96,268822
11766,0.001482,172.31.47.0-255,66,105996,96,268822
11767,0.001485,74.125.24.0-255,1484,107480,96,268822
11768,0.001506,74.125.24.0-255,4320,111800,96,268822
11769,0.001508,74.125.24.0-255,1484,113284,96,268822
11770,0.001512,172.31.47.0-255,66,113350,96,268822
11771,0.001554,172.31.47.0-255,66,113416,96,268822
11772,0.001583,172.31.47.0-255,66,113482,96,268822
11773,0.001716,74.125.24.0-255,1484,114966,96,268822
11774,0.001721,74.125.24.0-255,2902,117868,96,268822
11775,0.001733,172.31.47.0-255,66,117934,96,268822
11776,0.001744,74.125.24.0-255,5738,123672,96,268822
11777,0.001755,172.31.47.0-255,66,123738,96,268822
11778,0.001759,74.125.24.0-255,2902,126640,96,268822
11779,0.001794,172.31.47.0-255,66,126706,96,268822
11780,0.001853,172.31.47.0-255,66,126772,96,268822
11781,0.001933,74.125.24.0-255,1484,128256,96,268822
11782,0.001948,74.125.24.0-255,1484,129740,96,268822
11783,0.001958,172.31.47.0-255,66,129806,96,268822
11784,0.001966,74.125.24.0-255,1484,131290,96,268822
11785,0.001972,74.125.24.0-255,4320,135610,96,268822
11786,0.001977,172.31.47.0-255,66,135676,96,268822
11787,0.001987,74.125.24.0-255,1484,137160,96,268822
11788,0.001992,74.125.24.0-255,2902,140062,96,268822
11789,0.002017,172.31.47.0-255,66,140128,96,268822
11790,0.002022,172.31.47.0-255,66,140194,96,268822
11791,0.002059,74.125.24.0-255,1484,141678,96,268822
11792,0.002065,172.31.47.0-255,66,141744,96,268822
11793,0.002126,172.31.47.0-255,66,141810,96,268822
11794,0.002204,74.125.24.0-255,1484,143294,96,268822
11795,0.002273,74.125.24.0-255,4320,147614,96,268822
11796,0.00234,74.125.24.0-255,2902,150516,96,268822
11797,0.002361,74.125.24.0-255,2184,152700,96,268822
11798,0.011721,74.125.24.0-255,1484,154184,96,268822
11799,0.016496,172.31.47.0-255,66,154250,96,268822
11800,0.018644,74.125.24.0-255,5738,159988,96,268822
11801,0.018655,172.31.47.0-255,66,160054,96,268822
11802,0.020756,74.125.24.0-255,5738,165792,96,268822
11803,0.020764,172.31.47.0-255,66,165858,96,268822
11804,0.022931,74.125.24.0-255,5738,171596,96,268822
11805,0.025627,172.31.47.0-255,66,171662,96,268822
11806,0.027766,74.125.24.0-255,5738,177400,96,268822
11807,0.027778,172.31.47.0-255,66,177466,96,268822
11808,0.029893,74.125.24.0-255,5738,183204,96,268822
11809,0.029901,172.31.47.0-255,66,183270,96,268822
11810,0.032081,74.125.24.0-255,5738,189008,96,268822
11811,0.032089,172.31.47.0-255,66,189074,96,268822
11812,0.034183,74.125.24.0-255,5738,194812,96,268822
11813,0.034189,172.31.47.0-255,66,194878,96,268822
11814,0.036285,74.125.24.0-255,5738,200616,96,268822
11815,0.036292,172.31.47.0-255,66,200682,96,268822
11816,0.038428,74.125.24.0-255,5738,206420,96,268822
11817,0.038442,172.31.47.0-255,66,206486,96,268822
11818,0.040569,74.125.24.0-255,5738,212224,96,268822
11819,0.040583,172.31.47.0-255,66,212290,96,268822
11820,0.042688,74.125.24.0-255,5738,218028,96,268822
11821,0.042701,172.31.47.0-255,66,218094,96,268822
11822,0.04479,74.125.24.0-255,5738,223832,96,268822
11823,0.0449,172.31.47.0-255,66,223898,96,268822
11824,0.046994,74.125.24.0-255,5738,229636,96,268822
11825,0.047,172.31.47.0-255,66,229702,96,268822
11826,0.048829,172.31.47.0-255,172,229874,96,268822
11827,0.048864,172.31.47.0-255,1101,230975,96,268822
11828,0.048923,172.31.47.0-255,1514,232489,96,268822
11829,0.048925,172.31.47.0-255,1310,233799,96,268822
11830,0.049111,74.125.24.0-255,5738,239537,96,268822
11831,0.049119,172.31.47.0-255,66,239603,96,268822
11832,0.050426,104.244.42.0-255,66,239669,96,268822
11833,0.050435,104.244.42.0-255,66,239735,96,268822
11834,0.050507,104.244.42.0-255,66,239801,96,268822
11835,0.051203,74.125.24.0-255,5738,245539,96,268822
11836,0.051209,172.31.47.0-255,66,245605,96,268822
11837,0.053312,74.125.24.0-255,5738,251343,96,268822
11838,0.053319,172.31.47.0-255,66,251409,96,268822
11839,0.055403,74.125.24.0-255,5738,257147,96,268822
11840,0.05541,172.31.47.0-255,66,257213,96,268822
11841,0.057489,74.125.24.0-255,5738,262951,96,268822
11842,0.0575,172.31.47.0-255,66,263017,96,268822
11843,0.059626,74.125.24.0-255,5568,268585,96,268822
11844,0.059633,172.31.47.0-255,66,268651,96,268822
11845,0.059836,172.31.47.0-255,105,268756,96,268822
11846,0.061912,74.125.24.0-255,66,268822,96,268822
11847,0.0,74.125.68.0-255,153,153,96,341593
11848,2.3e-05,172.31.47.0-255,66,219,96,341593
11849,3e-05,74.125.68.0-255,1484,1703,96,341593
11850,3.5e-05,172.31.47.0-255,66,1769,96,341593
11851,4e-05,74.125.68.0-255,2902,4671,96,341593
11852,5.1e-05,172.31.47.0-255,66,4737,96,341593
11853,5.9e-05,74.125.68.0-255,7156,11893,96,341593
11854,6.2e-05,172.31.47.0-255,66,11959,96,341593
11855,6.6e-05,74.125.68.0-255,2135,14094,96,341593
11856,6.9e-05,172.31.47.0-255,66,14160,96,341593
11857,7.4e-05,74.125.68.0-255,2902,17062,96,341593
11858,7.6e-05,172.31.47.0-255,66,17128,96,341593
11859,0.000115,74.125.68.0-255,7156,24284,96,341593
11860,0.000118,172.31.47.0-255,66,24350,96,341593
11861,0.000123,74.125.68.0-255,2902,27252,96,341593
11862,0.000126,172.31.47.0-255,66,27318,96,341593
11863,0.000153,74.125.68.0-255,3961,31279,96,341593
11864,0.000156,172.31.47.0-255,66,31345,96,341593
11865,0.000223,74.125.68.0-255,1484,32829,96,341593
11866,0.000226,172.31.47.0-255,66,32895,96,341593
11867,0.000229,74.125.68.0-255,1484,34379,96,341593
11868,0.000231,172.31.47.0-255,66,34445,96,341593
11869,0.000255,74.125.68.0-255,1484,35929,96,341593
11870,0.000258,172.31.47.0-255,66,35995,96,341593
11871,0.000262,74.125.68.0-255,2902,38897,96,341593
11872,0.000264,172.31.47.0-255,66,38963,96,341593
11873,0.000273,74.125.68.0-255,4320,43283,96,341593
11874,0.000276,172.31.47.0-255,66,43349,96,341593
11875,0.000317,172.31.47.0-255,66,43415,96,341593
11876,0.000323,74.125.68.0-255,5738,49153,96,341593
11877,0.000326,172.31.47.0-255,66,49219,96,341593
11878,0.00033,74.125.68.0-255,2902,52121,96,341593
11879,0.000332,172.31.47.0-255,66,52187,96,341593
11880,0.000359,74.125.68.0-255,4320,56507,96,341593
11881,0.000364,74.125.68.0-255,766,57273,96,341593
11882,0.000468,74.125.68.0-255,366,57639,96,341593
11883,0.000472,74.125.68.0-255,126,57765,96,341593
11884,0.00056,74.125.68.0-255,1484,59249,96,341593
11885,0.000565,172.31.47.0-255,66,59315,96,341593
11886,0.000574,74.125.68.0-255,2902,62217,96,341593
11887,0.000596,74.125.68.0-255,5738,67955,96,341593
11888,0.000601,74.125.68.0-255,2902,70857,96,341593
11889,0.000606,172.31.47.0-255,66,70923,96,341593
11890,0.000614,74.125.68.0-255,1484,72407,96,341593
11891,0.000655,74.125.68.0-255,4320,76727,96,341593
11892,0.000674,74.125.68.0-255,1484,78211,96,341593
11893,0.000688,74.125.68.0-255,2184,80395,96,341593
11894,0.00069,74.125.68.0-255,349,80744,96,341593
11895,0.000713,172.31.47.0-255,66,80810,96,341593
11896,0.001059,74.125.68.0-255,1484,82294,96,341593
11897,0.001078,74.125.68.0-255,2902,85196,96,341593
11898,0.001082,172.31.47.0-255,66,85262,96,341593
11899,0.001087,74.125.68.0-255,2902,88164,96,341593
11900,0.001108,74.125.68.0-255,2902,91066,96,341593
11901,0.001112,74.125.68.0-255,2902,93968,96,341593
11902,0.001118,172.31.47.0-255,66,94034,96,341593
11903,0.001143,74.125.68.0-255,5738,99772,96,341593
11904,0.00117,74.125.68.0-255,5020,104792,96,341593
11905,0.001173,172.31.47.0-255,66,104858,96,341593
11906,0.001177,172.31.47.0-255,66,104924,96,341593
11907,0.001326,74.125.68.0-255,1484,106408,96,341593
11908,0.001346,74.125.68.0-255,2902,109310,96,341593
11909,0.001349,74.125.68.0-255,1484,110794,96,341593
11910,0.001359,172.31.47.0-255,66,110860,96,341593
11911,0.001376,74.125.68.0-255,4320,115180,96,341593
11912,0.001399,74.125.68.0-255,4320,119500,96,341593
11913,0.001404,172.31.47.0-255,66,119566,96,341593
11914,0.001425,74.125.68.0-255,5738,125304,96,341593
11915,0.00143,74.125.68.0-255,4320,129624,96,341593
11916,0.001447,172.31.47.0-255,66,129690,96,341593
11917,0.001476,74.125.68.0-255,5738,135428,96,341593
11918,0.001479,172.31.47.0-255,66,135494,96,341593
11919,0.001506,74.125.68.0-255,3602,139096,96,341593
11920,0.001524,172.31.47.0-255,66,139162,96,341593
11921,0.001622,74.125.68.0-255,1484,140646,96,341593
11922,0.001637,74.125.68.0-255,2902,143548,96,341593
11923,0.001646,172.31.47.0-255,66,143614,96,341593
11924,0.001661,74.125.68.0-255,5738,149352,96,341593
11925,0.001669,74.125.68.0-255,1484,150836,96,341593
11926,0.001683,74.125.68.0-255,1484,152320,96,341593
11927,0.001693,74.125.68.0-255,1484,153804,96,341593
11928,0.001697,172.31.47.0-255,66,153870,96,341593
11929,0.001737,74.125.68.0-255,1484,155354,96,341593
11930,0.001759,74.125.68.0-255,2902,158256,96,341593
11931,0.001768,172.31.47.0-255,66,158322,96,341593
11932,0.00179,74.125.68.0-255,5738,164060,96,341593
11933,0.001794,74.125.68.0-255,1484,165544,96,341593
11934,0.001798,74.125.68.0-255,2902,168446,96,341593
11935,0.001817,172.31.47.0-255,66,168512,96,341593
11936,0.001824,74.125.68.0-255,1484,169996,96,341593
11937,0.001848,74.125.68.0-255,3602,173598,96,341593
11938,0.00185,172.31.47.0-255,66,173664,96,341593
11939,0.002006,74.125.68.0-255,1484,175148,96,341593
11940,0.002019,74.125.68.0-255,1484,176632,96,341593
11941,0.002025,172.31.47.0-255,66,176698,96,341593
11942,0.003855,74.125.68.0-255,2902,179600,96,341593
11943,0.003861,172.31.47.0-255,66,179666,96,341593
11944,0.004029,74.125.68.0-255,2902,182568,96,341593
11945,0.005857,74.125.68.0-255,2902,185470,96,341593
11946,0.00767,172.31.47.0-255,66,185536,96,341593
11947,0.009688,74.125.68.0-255,5738,191274,96,341593
11948,0.009696,172.31.47.0-255,66,191340,96,341593
11949,0.011727,74.125.68.0-255,5738,197078,96,341593
11950,0.011737,172.31.47.0-255,66,197144,96,341593
11951,0.013757,74.125.68.0-255,5738,202882,96,341593
11952,0.013764,172.31.47.0-255,66,202948,96,341593
11953,0.015757,74.125.68.0-255,4320,207268,96,341593
11954,0.015774,74.125.68.0-255,1484,208752,96,341593
11955,0.019709,172.31.47.0-255,66,208818,96,341593
11956,0.021735,74.125.68.0-255,5738,214556,96,341593
11957,0.021749,172.31.47.0-255,66,214622,96,341593
11958,0.02376,74.125.68.0-255,5738,220360,96,341593
11959,0.023768,172.31.47.0-255,66,220426,96,341593
11960,0.024666,172.31.47.0-255,172,220598,96,341593
11961,0.024696,172.31.47.0-255,1101,221699,96,341593
11962,0.024771,172.31.47.0-255,1514,223213,96,341593
11963,0.024773,172.31.47.0-255,1310,224523,96,341593
11964,0.025779,74.125.68.0-255,5738,230261,96,341593
11965,0.025786,172.31.47.0-255,66,230327,96,341593
11966,0.026211,104.244.42.0-255,66,230393,96,341593
11967,0.026218,104.244.42.0-255,66,230459,96,341593
11968,0.026318,104.244.42.0-255,66,230525,96,341593
11969,0.027798,74.125.68.0-255,5738,236263,96,341593
11970,0.032215,172.31.47.0-255,66,236329,96,341593
11971,0.034245,74.125.68.0-255,5738,242067,96,341593
11972,0.034263,172.31.47.0-255,66,242133,96,341593
11973,0.036314,74.125.68.0-255,5738,247871,96,341593
11974,0.036328,172.31.47.0-255,66,247937,96,341593
11975,0.038363,74.125.68.0-255,5738,253675,96,341593
11976,0.03838,172.31.47.0-255,66,253741,96,341593
11977,0.040409,74.125.68.0-255,5738,259479,96,341593
11978,0.040424,172.31.47.0-255,66,259545,96,341593
11979,0.042437,74.125.68.0-255,5738,265283,96,341593
11980,0.042451,172.31.47.0-255,66,265349,96,341593
11981,0.044473,74.125.68.0-255,5738,271087,96,341593
11982,0.044481,172.31.47.0-255,66,271153,96,341593
11983,0.046526,74.125.68.0-255,5738,276891,96,341593
11984,0.046545,172.31.47.0-255,66,276957,96,341593
11985,0.048575,74.125.68.0-255,5738,282695,96,341593
11986,0.048583,172.31.47.0-255,66,282761,96,341593
11987,0.050608,74.125.68.0-255,5738,288499,96,341593
11988,0.050617,172.31.47.0-255,66,288565,96,341593
11989,0.052638,74.125.68.0-255,5738,294303,96,341593
11990,0.052645,172.31.47.0-255,66,294369,96,341593
11991,0.054696,74.125.68.0-255,5738,300107,96,341593
11992,0.054703,172.31.47.0-255,66,300173,96,341593
11993,0.056714,74.125.68.0-255,5738,305911,96,341593
11994,0.05672,172.31.47.0-255,66,305977,96,341593
11995,0.058723,74.125.68.0-255,2902,308879,96,341593
11996,0.058731,172.31.47.0-255,66,308945,96,341593
11997,0.058737,74.125.68.0-255,2902,311847,96,341593
11998,0.058838,172.31.47.0-255,66,311913,96,341593
11999,0.060744,74.125.68.0-255,2902,314815,96,341593
12000,0.06075,172.31.47.0-255,66,314881,96,341593
12001,0.060853,74.125.68.0-255,2902,317783,96,341593
12002,0.060857,172.31.47.0-255,66,317849,96,341593
12003,0.062764,74.125.68.0-255,2902,320751,96,341593
12004,0.06277,172.31.47.0-255,66,320817,96,341593
12005,0.062856,74.125.68.0-255,2902,323719,96,341593
12006,0.062921,172.31.47.0-255,66,323785,96,341593
12007,0.064783,74.125.68.0-255,2902,326687,96,341593
12008,0.064789,172.31.47.0-255,66,326753,96,341593
12009,0.064928,74.125.68.0-255,2902,329655,96,341593
12010,0.064933,172.31.47.0-255,66,329721,96,341593
12011,0.066814,74.125.68.0-255,2902,332623,96,341593
12012,0.06682,172.31.47.0-255,66,332689,96,341593
12013,0.066937,74.125.68.0-255,2902,335591,96,341593
12014,0.066941,172.31.47.0-255,66,335657,96,341593
12015,0.06883,74.125.68.0-255,2902,338559,96,341593
12016,0.068835,172.31.47.0-255,66,338625,96,341593
12017,0.068963,74.125.68.0-255,2902,341527,96,341593
12018,0.068968,172.31.47.0-255,66,341593,96,341593
12019,0.0,172.217.194.0-255,153,153,96,163189
12020,2.8e-05,172.31.47.0-255,66,219,96,163189
12021,3.4e-05,172.217.194.0-255,1484,1703,96,163189
12022,3.9e-05,172.31.47.0-255,66,1769,96,163189
12023,4.4e-05,172.217.194.0-255,2902,4671,96,163189
12024,4.6e-05,172.31.47.0-255,66,4737,96,163189
12025,5.3e-05,172.217.194.0-255,7156,11893,96,163189
12026,5.5e-05,172.31.47.0-255,66,11959,96,163189
12027,8.4e-05,172.31.47.0-255,66,12025,96,163189
12028,9.6e-05,172.31.47.0-255,66,12091,96,163189
12029,0.00012,172.217.194.0-255,2543,14634,96,163189
12030,0.000122,172.31.47.0-255,66,14700,96,163189
12031,0.000171,172.217.194.0-255,1484,16184,96,163189
12032,0.000173,172.31.47.0-255,66,16250,96,163189
12033,0.000178,172.217.194.0-255,2902,19152,96,163189
12034,0.00018,172.31.47.0-255,66,19218,96,163189
12035,0.000184,172.217.194.0-255,2902,22120,96,163189
12036,0.000186,172.31.47.0-255,66,22186,96,163189
12037,0.000202,172.217.194.0-255,2902,25088,96,163189
12038,0.000204,172.31.47.0-255,66,25154,96,163189
12039,0.000207,172.217.194.0-255,1484,26638,96,163189
12040,0.000208,172.31.47.0-255,66,26704,96,163189
12041,0.000253,172.31.47.0-255,66,26770,96,163189
12042,0.000263,172.31.47.0-255,66,26836,96,163189
12043,0.000265,172.217.194.0-255,99,26935,96,163189
12044,0.000269,172.31.47.0-255,66,27001,96,163189
12045,0.000361,172.217.194.0-255,1484,28485,96,163189
12046,0.000366,172.31.47.0-255,66,28551,96,163189
12047,0.000385,172.217.194.0-255,2902,31453,96,163189
12048,0.00039,172.31.47.0-255,66,31519,96,163189
12049,0.000392,172.217.194.0-255,1484,33003,96,163189
12050,0.000408,172.217.194.0-255,2902,35905,96,163189
12051,0.000411,172.31.47.0-255,66,35971,96,163189
12052,0.000442,172.217.194.0-255,4320,40291,96,163189
12053,0.000445,172.31.47.0-255,66,40357,96,163189
12054,0.000465,172.217.194.0-255,3961,44318,96,163189
12055,0.000467,172.31.47.0-255,66,44384,96,163189
12056,0.000513,172.217.194.0-255,1484,45868,96,163189
12057,0.000518,172.217.194.0-255,2902,48770,96,163189
12058,0.00052,172.31.47.0-255,66,48836,96,163189
12059,0.000523,172.217.194.0-255,1484,50320,96,163189
12060,0.000539,172.217.194.0-255,4320,54640,96,163189
12061,0.000542,172.31.47.0-255,66,54706,96,163189
12062,0.000594,172.31.47.0-255,66,54772,96,163189
12063,0.000608,172.31.47.0-255,66,54838,96,163189
12064,0.000659,172.31.47.0-255,66,54904,96,163189
12065,0.000679,172.217.194.0-255,2902,57806,96,163189
12066,0.000681,172.31.47.0-255,66,57872,96,163189
12067,0.000715,172.31.47.0-255,66,57938,96,163189
12068,0.000725,172.31.47.0-255,66,58004,96,163189
12069,0.000745,172.217.194.0-255,4320,62324,96,163189
12070,0.000748,172.31.47.0-255,66,62390,96,163189
12071,0.000765,172.217.194.0-255,6438,68828,96,163189
12072,0.000768,172.31.47.0-255,66,68894,96,163189
12073,0.000807,172.217.194.0-255,2902,71796,96,163189
12074,0.00081,172.31.47.0-255,66,71862,96,163189
12075,0.000839,172.31.47.0-255,66,71928,96,163189
12076,0.000851,172.31.47.0-255,66,71994,96,163189
12077,0.00086,172.31.47.0-255,66,72060,96,163189
12078,0.000915,172.217.194.0-255,1484,73544,96,163189
12079,0.000927,172.217.194.0-255,1484,75028,96,163189
12080,0.00093,172.31.47.0-255,66,75094,96,163189
12081,0.00095,172.217.194.0-255,1484,76578,96,163189
12082,0.000955,172.217.194.0-255,5738,82316,96,163189
12083,0.000957,172.31.47.0-255,66,82382,96,163189
12084,0.00096,172.217.194.0-255,1484,83866,96,163189
12085,0.000978,172.217.194.0-255,5738,89604,96,163189
12086,0.000981,172.31.47.0-255,66,89670,96,163189
12087,0.000985,172.217.194.0-255,4320,93990,96,163189
12088,0.000987,172.31.47.0-255,66,94056,96,163189
12089,0.001016,172.31.47.0-255,66,94122,96,163189
12090,0.001019,172.217.194.0-255,2184,96306,96,163189
12091,0.001021,172.31.47.0-255,66,96372,96,163189
12092,0.001444,172.217.194.0-255,1484,97856,96,163189
12093,0.001472,172.217.194.0-255,2902,100758,96,163189
12094,0.001475,172.31.47.0-255,66,100824,96,163189
12095,0.001482,172.217.194.0-255,5738,106562,96,163189
12096,0.001485,172.217.194.0-255,4320,110882,96,163189
12097,0.001486,172.31.47.0-255,66,110948,96,163189
12098,0.001488,172.31.47.0-255,66,111014,96,163189
12099,0.001526,172.31.47.0-255,66,111080,96,163189
12100,0.001539,172.217.194.0-255,2902,113982,96,163189
12101,0.001541,172.31.47.0-255,66,114048,96,163189
12102,0.001567,172.31.47.0-255,66,114114,96,163189
12103,0.001622,172.217.194.0-255,1484,115598,96,163189
12104,0.001633,172.217.194.0-255,2902,118500,96,163189
12105,0.001635,172.31.47.0-255,66,118566,96,163189
12106,0.001659,172.217.194.0-255,5738,124304,96,163189
12107,0.001662,172.31.47.0-255,66,124370,96,163189
12108,0.001664,172.217.194.0-255,1484,125854,96,163189
12109,0.001682,172.217.194.0-255,4320,130174,96,163189
12110,0.001685,172.31.47.0-255,66,130240,96,163189
12111,0.001707,172.217.194.0-255,7156,137396,96,163189
12112,0.001709,172.31.47.0-255,66,137462,96,163189
12113,0.001719,172.31.47.0-255,66,137528,96,163189
12114,0.001744,172.217.194.0-255,1484,139012,96,163189
12115,0.001753,172.217.194.0-255,1484,140496,96,163189
12116,0.001755,172.31.47.0-255,66,140562,96,163189
12117,0.001765,172.217.194.0-255,1484,142046,96,163189
12118,0.001769,172.217.194.0-255,2902,144948,96,163189
12119,0.001772,172.31.47.0-255,66,145014,96,163189
12120,0.001783,172.217.194.0-255,2902,147916,96,163189
12121,0.001785,172.31.47.0-255,66,147982,96,163189
12122,0.001792,172.217.194.0-255,1484,149466,96,163189
12123,0.001811,172.31.47.0-255,66,149532,96,163189
12124,0.00186,172.31.47.0-255,66,149598,96,163189
12125,0.001881,172.217.194.0-255,2184,151782,96,163189
12126,0.001884,172.31.47.0-255,66,151848,96,163189
12127,0.001896,172.31.47.0-255,66,151914,96,163189
12128,0.001964,172.31.47.0-255,66,151980,96,163189
12129,0.001987,172.217.194.0-255,6438,158418,96,163189
12130,0.00199,172.31.47.0-255,66,158484,96,163189
12131,0.002004,172.31.47.0-255,66,158550,96,163189
12132,0.002007,172.217.194.0-255,105,158655,96,163189
12133,0.003053,172.31.47.0-255,66,158721,96,163189
12134,0.003076,172.31.47.0-255,105,158826,96,163189
12135,0.005309,172.217.194.0-255,66,158892,96,163189
12136,0.031056,172.31.47.0-255,172,159064,96,163189
12137,0.031088,172.31.47.0-255,1105,160169,96,163189
12138,0.031123,172.31.47.0-255,1514,161683,96,163189
12139,0.031125,172.31.47.0-255,1308,162991,96,163189
12140,0.032579,104.244.42.0-255,66,163057,96,163189
12141,0.032621,104.244.42.0-255,66,163123,96,163189
12142,0.032666,104.244.42.0-255,66,163189,96,163189
12143,0.0,172.253.118.0-255,152,152,96,285652
12144,2.6e-05,172.31.47.0-255,66,218,96,285652
12145,4.2e-05,172.253.118.0-255,1484,1702,96,285652
12146,4.5e-05,172.31.47.0-255,66,1768,96,285652
12147,5e-05,172.253.118.0-255,2902,4670,96,285652
12148,5.3e-05,172.31.47.0-255,66,4736,96,285652
12149,7.9e-05,172.253.118.0-255,2902,7638,96,285652
12150,8.2e-05,172.31.47.0-255,66,7704,96,285652
12151,9.8e-05,172.253.118.0-255,4320,12024,96,285652
12152,0.0001,172.31.47.0-255,66,12090,96,285652
12153,0.000117,172.253.118.0-255,5738,17828,96,285652
12154,0.00012,172.31.47.0-255,66,17894,96,285652
12155,0.000138,172.253.118.0-255,2046,19940,96,285652
12156,0.00014,172.31.47.0-255,66,20006,96,285652
12157,0.000145,172.253.118.0-255,2902,22908,96,285652
12158,0.000147,172.31.47.0-255,66,22974,96,285652
12159,0.00018,172.253.118.0-255,1484,24458,96,285652
12160,0.000182,172.31.47.0-255,66,24524,96,285652
12161,0.000203,172.253.118.0-255,6797,31321,96,285652
12162,0.000205,172.31.47.0-255,66,31387,96,285652
12163,0.00033,172.253.118.0-255,1484,32871,96,285652
12164,0.000333,172.31.47.0-255,66,32937,96,285652
12165,0.00035,172.253.118.0-255,2902,35839,96,285652
12166,0.000353,172.31.47.0-255,66,35905,96,285652
12167,0.000368,172.253.118.0-255,2902,38807,96,285652
12168,0.000371,172.31.47.0-255,66,38873,96,285652
12169,0.000386,172.253.118.0-255,2902,41775,96,285652
12170,0.000388,172.31.47.0-255,66,41841,96,285652
12171,0.000392,172.253.118.0-255,2902,44743,96,285652
12172,0.000396,172.31.47.0-255,66,44809,96,285652
12173,0.000432,172.253.118.0-255,3961,48770,96,285652
12174,0.000435,172.31.47.0-255,66,48836,96,285652
12175,0.0009,172.253.118.0-255,1484,50320,96,285652
12176,0.000923,172.253.118.0-255,2902,53222,96,285652
12177,0.000927,172.31.47.0-255,66,53288,96,285652
12178,0.000952,172.253.118.0-255,5738,59026,96,285652
12179,0.000955,172.31.47.0-255,66,59092,96,285652
12180,0.000959,172.253.118.0-255,2902,61994,96,285652
12181,0.000961,172.31.47.0-255,66,62060,96,285652
12182,0.001003,172.253.118.0-255,3961,66021,96,285652
12183,0.001007,172.31.47.0-255,66,66087,96,285652
12184,0.001532,172.253.118.0-255,1484,67571,96,285652
12185,0.00154,172.253.118.0-255,2902,70473,96,285652
12186,0.001543,172.31.47.0-255,66,70539,96,285652
12187,0.001548,172.253.118.0-255,2902,73441,96,285652
12188,0.001549,172.31.47.0-255,66,73507,96,285652
12189,0.001565,172.253.118.0-255,1484,74991,96,285652
12190,0.00157,172.253.118.0-255,5738,80729,96,285652
12191,0.001572,172.31.47.0-255,66,80795,96,285652
12192,0.001584,172.253.118.0-255,1484,82279,96,285652
12193,0.001606,172.31.47.0-255,66,82345,96,285652
12194,0.001629,172.253.118.0-255,2543,84888,96,285652
12195,0.001631,172.31.47.0-255,66,84954,96,285652
12196,0.001637,172.253.118.0-255,7156,92110,96,285652
12197,0.001638,172.31.47.0-255,66,92176,96,285652
12198,0.00164,172.253.118.0-255,287,92463,96,285652
12199,0.001842,172.31.47.0-255,66,92529,96,285652
12200,0.003683,172.253.118.0-255,4320,96849,96,285652
12201,0.003689,172.31.47.0-255,66,96915,96,285652
12202,0.003881,172.253.118.0-255,1484,98399,96,285652
12203,0.005725,172.253.118.0-255,4320,102719,96,285652
12204,0.00573,172.31.47.0-255,66,102785,96,285652
12205,0.007778,172.253.118.0-255,5738,108523,96,285652
12206,0.007786,172.31.47.0-255,66,108589,96,285652
12207,0.009836,172.253.118.0-255,5738,114327,96,285652
12208,0.009844,172.31.47.0-255,66,114393,96,285652
12209,0.01189,172.253.118.0-255,5738,120131,96,285652
12210,0.011898,172.31.47.0-255,66,120197,96,285652
12211,0.013951,172.253.118.0-255,5738,125935,96,285652
12212,0.013958,172.31.47.0-255,66,126001,96,285652
12213,0.015996,172.253.118.0-255,4320,130321,96,285652
12214,0.016003,172.31.47.0-255,66,130387,96,285652
12215,0.016022,172.253.118.0-255,1484,131871,96,285652
12216,0.018052,172.253.118.0-255,4320,136191,96,285652
12217,0.018058,172.31.47.0-255,66,136257,96,285652
12218,0.020115,172.253.118.0-255,5738,141995,96,285652
12219,0.020124,172.31.47.0-255,66,142061,96,285652
12220,0.02219,172.253.118.0-255,5738,147799,96,285652
12221,0.022198,172.31.47.0-255,66,147865,96,285652
12222,0.023413,172.31.47.0-255,172,148037,96,285652
12223,0.023437,172.31.47.0-255,1110,149147,96,285652
12224,0.023484,172.31.47.0-255,1514,150661,96,285652
12225,0.023486,172.31.47.0-255,1301,151962,96,285652
12226,0.024259,172.253.118.0-255,5738,157700,96,285652
12227,0.024265,172.31.47.0-255,66,157766,96,285652
12228,0.02495,104.244.42.0-255,66,157832,96,285652
12229,0.025014,104.244.42.0-255,66,157898,96,285652
12230,0.025059,104.244.42.0-255,66,157964,96,285652
12231,0.026307,172.253.118.0-255,5738,163702,96,285652
12232,0.026312,172.31.47.0-255,66,163768,96,285652
12233,0.028404,172.253.118.0-255,5738,169506,96,285652
12234,0.028411,172.31.47.0-255,66,169572,96,285652
12235,0.03046,172.253.118.0-255,5738,175310,96,285652
12236,0.030467,172.31.47.0-255,66,175376,96,285652
12237,0.032523,172.253.118.0-255,5738,181114,96,285652
12238,0.032529,172.31.47.0-255,66,181180,96,285652
12239,0.034562,172.253.118.0-255,5738,186918,96,285652
12240,0.034568,172.31.47.0-255,66,186984,96,285652
12241,0.0367,172.253.118.0-255,5738,192722,96,285652
12242,0.036707,172.31.47.0-255,66,192788,96,285652
12243,0.038762,172.253.118.0-255,5738,198526,96,285652
12244,0.038767,172.31.47.0-255,66,198592,96,285652
12245,0.040813,172.253.118.0-255,5738,204330,96,285652
12246,0.040819,172.31.47.0-255,66,204396,96,285652
12247,0.042891,172.253.118.0-255,5738,210134,96,285652
12248,0.042898,172.31.47.0-255,66,210200,96,285652
12249,0.044942,172.253.118.0-255,5738,215938,96,285652
12250,0.044948,172.31.47.0-255,66,216004,96,285652
12251,0.046984,172.253.118.0-255,5738,221742,96,285652
12252,0.046989,172.31.47.0-255,66,221808,96,285652
12253,0.049029,172.253.118.0-255,5738,227546,96,285652
12254,0.049035,172.31.47.0-255,66,227612,96,285652
12255,0.05108,172.253.118.0-255,5738,233350,96,285652
12256,0.051085,172.31.47.0-255,66,233416,96,285652
12257,0.053149,172.253.118.0-255,5738,239154,96,285652
12258,0.053157,172.31.47.0-255,66,239220,96,285652
12259,0.05523,172.253.118.0-255,5738,244958,96,285652
12260,0.055237,172.31.47.0-255,66,245024,96,285652
12261,0.057273,172.253.118.0-255,5738,250762,96,285652
12262,0.05728,172.31.47.0-255,66,250828,96,285652
12263,0.059326,172.253.118.0-255,5738,256566,96,285652
12264,0.059333,172.31.47.0-255,66,256632,96,285652
12265,0.061385,172.253.118.0-255,5738,262370,96,285652
12266,0.061392,172.31.47.0-255,66,262436,96,285652
12267,0.063449,172.253.118.0-255,5738,268174,96,285652
12268,0.063456,172.31.47.0-255,66,268240,96,285652
12269,0.065504,172.253.118.0-255,5738,273978,96,285652
12270,0.06551,172.31.47.0-255,66,274044,96,285652
12271,0.06756,172.253.118.0-255,5738,279782,96,285652
12272,0.067567,172.31.47.0-255,66,279848,96,285652
12273,0.069606,172.253.118.0-255,5738,285586,96,285652
12274,0.069611,172.31.47.0-255,66,285652,96,285652
12275,0.0,172.217.194.0-255,153,153,96,344269
12276,2.6e-05,172.31.47.0-255,66,219,96,344269
12277,3.3e-05,172.217.194.0-255,1484,1703,96,344269
12278,3.7e-05,172.31.47.0-255,66,1769,96,344269
12279,4.1e-05,172.217.194.0-255,2902,4671,96,344269
12280,4.4e-05,172.31.47.0-255,66,4737,96,344269
12281,5.1e-05,172.217.194.0-255,7156,11893,96,344269
12282,5.4e-05,172.31.47.0-255,66,11959,96,344269
12283,7.9e-05,172.217.194.0-255,2139,14098,96,344269
12284,8.1e-05,172.31.47.0-255,66,14164,96,344269
12285,0.000133,172.217.194.0-255,1484,15648,96,344269
12286,0.000136,172.31.47.0-255,66,15714,96,344269
12287,0.00015,172.217.194.0-255,2902,18616,96,344269
12288,0.000153,172.31.47.0-255,66,18682,96,344269
12289,0.000158,172.217.194.0-255,4320,23002,96,344269
12290,0.000162,172.31.47.0-255,66,23068,96,344269
12291,0.000183,172.217.194.0-255,1484,24552,96,344269
12292,0.000186,172.31.47.0-255,66,24618,96,344269
12293,0.000191,172.217.194.0-255,2902,27520,96,344269
12294,0.000193,172.31.47.0-255,66,27586,96,344269
12295,0.000206,172.217.194.0-255,3961,31547,96,344269
12296,0.000209,172.31.47.0-255,66,31613,96,344269
12297,0.000215,172.217.194.0-255,4320,35933,96,344269
12298,0.000217,172.31.47.0-255,66,35999,96,344269
12299,0.000247,172.217.194.0-255,2902,38901,96,344269
12300,0.000251,172.31.47.0-255,66,38967,96,344269
12301,0.000262,172.31.47.0-255,66,39033,96,344269
12302,0.000287,172.217.194.0-255,4320,43353,96,344269
12303,0.00029,172.31.47.0-255,66,43419,96,344269
12304,0.000312,172.217.194.0-255,2902,46321,96,344269
12305,0.000315,172.31.47.0-255,66,46387,96,344269
12306,0.000326,172.31.47.0-255,66,46453,96,344269
12307,0.000328,172.217.194.0-255,1125,47578,96,344269
12308,0.00033,172.31.47.0-255,66,47644,96,344269
12309,0.000414,172.217.194.0-255,648,48292,96,344269
12310,0.000512,172.217.194.0-255,1484,49776,96,344269
12311,0.000516,172.31.47.0-255,66,49842,96,344269
12312,0.000521,172.217.194.0-255,2902,52744,96,344269
12313,0.000536,172.31.47.0-255,66,52810,96,344269
12314,0.000537,172.217.194.0-255,4320,57130,96,344269
12315,0.000556,172.31.47.0-255,66,57196,96,344269
12316,0.000557,172.217.194.0-255,4320,61516,96,344269
12317,0.000561,172.31.47.0-255,66,61582,96,344269
12318,0.000576,172.217.194.0-255,1484,63066,96,344269
12319,0.00058,172.217.194.0-255,2543,65609,96,344269
12320,0.000592,172.31.47.0-255,66,65675,96,344269
12321,0.00061,172.217.194.0-255,1484,67159,96,344269
12322,0.000627,172.217.194.0-255,1484,68643,96,344269
12323,0.000637,172.31.47.0-255,66,68709,96,344269
12324,0.000647,172.217.194.0-255,1484,70193,96,344269
12325,0.000659,172.217.194.0-255,2902,73095,96,344269
12326,0.000663,172.31.47.0-255,66,73161,96,344269
12327,0.000691,172.217.194.0-255,2902,76063,96,344269
12328,0.000693,172.31.47.0-255,66,76129,96,344269
12329,0.000709,172.217.194.0-255,2902,79031,96,344269
12330,0.000714,172.217.194.0-255,3961,82992,96,344269
12331,0.000719,172.31.47.0-255,66,83058,96,344269
12332,0.001076,172.217.194.0-255,1484,84542,96,344269
12333,0.001081,172.31.47.0-255,66,84608,96,344269
12334,0.001096,172.217.194.0-255,1484,86092,96,344269
12335,0.001098,172.31.47.0-255,66,86158,96,344269
12336,0.001102,172.217.194.0-255,2902,89060,96,344269
12337,0.001104,172.31.47.0-255,66,89126,96,344269
12338,0.001109,172.217.194.0-255,2902,92028,96,344269
12339,0.001112,172.31.47.0-255,66,92094,96,344269
12340,0.001138,172.217.194.0-255,2902,94996,96,344269
12341,0.00115,172.31.47.0-255,66,95062,96,344269
12342,0.001154,172.31.47.0-255,66,95128,96,344269
12343,0.001163,172.217.194.0-255,2902,98030,96,344269
12344,0.00117,172.217.194.0-255,7156,105186,96,344269
12345,0.001171,172.31.47.0-255,66,105252,96,344269
12346,0.001174,172.31.47.0-255,66,105318,96,344269
12347,0.001183,172.217.194.0-255,1484,106802,96,344269
12348,0.001205,172.217.194.0-255,3602,110404,96,344269
12349,0.00121,172.217.194.0-255,4320,114724,96,344269
12350,0.001212,172.31.47.0-255,66,114790,96,344269
12351,0.001216,172.31.47.0-255,66,114856,96,344269
12352,0.001231,172.217.194.0-255,2902,117758,96,344269
12353,0.001239,172.31.47.0-255,66,117824,96,344269
12354,0.001251,172.217.194.0-255,7156,124980,96,344269
12355,0.001254,172.31.47.0-255,66,125046,96,344269
12356,0.001258,172.217.194.0-255,7156,132202,96,344269
12357,0.001264,172.217.194.0-255,5738,137940,96,344269
12358,0.001269,172.31.47.0-255,66,138006,96,344269
12359,0.001292,172.217.194.0-255,2902,140908,96,344269
12360,0.001295,172.217.194.0-255,766,141674,96,344269
12361,0.001309,172.31.47.0-255,66,141740,96,344269
12362,0.001824,172.217.194.0-255,1484,143224,96,344269
12363,0.00183,172.31.47.0-255,66,143290,96,344269
12364,0.001839,172.217.194.0-255,2902,146192,96,344269
12365,0.001843,172.217.194.0-255,1484,147676,96,344269
12366,0.001864,172.217.194.0-255,4320,151996,96,344269
12367,0.001867,172.217.194.0-255,1484,153480,96,344269
12368,0.001889,172.217.194.0-255,7156,160636,96,344269
12369,0.001922,172.217.194.0-255,4320,164956,96,344269
12370,0.001955,172.217.194.0-255,2184,167140,96,344269
12371,0.006355,172.31.47.0-255,66,167206,96,344269
12372,0.008399,172.217.194.0-255,5738,172944,96,344269
12373,0.008409,172.31.47.0-255,66,173010,96,344269
12374,0.010424,172.217.194.0-255,5738,178748,96,344269
12375,0.010431,172.31.47.0-255,66,178814,96,344269
12376,0.012438,172.217.194.0-255,5738,184552,96,344269
12377,0.014397,172.31.47.0-255,66,184618,96,344269
12378,0.016426,172.217.194.0-255,5738,190356,96,344269
12379,0.016438,172.31.47.0-255,66,190422,96,344269
12380,0.018439,172.217.194.0-255,5738,196160,96,344269
12381,0.018445,172.31.47.0-255,66,196226,96,344269
12382,0.020445,172.217.194.0-255,5738,201964,96,344269
12383,0.020451,172.31.47.0-255,66,202030,96,344269
12384,0.02247,172.217.194.0-255,5738,207768,96,344269
12385,0.022482,172.31.47.0-255,66,207834,96,344269
12386,0.0245,172.217.194.0-255,5738,213572,96,344269
12387,0.024511,172.31.47.0-255,66,213638,96,344269
12388,0.026526,172.217.194.0-255,5738,219376,96,344269
12389,0.026541,172.31.47.0-255,66,219442,96,344269
12390,0.028564,172.217.194.0-255,5738,225180,96,344269
12391,0.028584,172.31.47.0-255,66,225246,96,344269
12392,0.030588,172.217.194.0-255,5738,230984,96,344269
12393,0.030604,172.31.47.0-255,66,231050,96,344269
12394,0.032617,172.217.194.0-255,5738,236788,96,344269
12395,0.032634,172.31.47.0-255,66,236854,96,344269
12396,0.034782,172.217.194.0-255,5738,242592,96,344269
12397,0.034806,172.31.47.0-255,66,242658,96,344269
12398,0.036826,172.217.194.0-255,5738,248396,96,344269
12399,0.036837,172.31.47.0-255,66,248462,96,344269
12400,0.038878,172.217.194.0-255,5738,254200,96,344269
12401,0.038892,172.31.47.0-255,66,254266,96,344269
12402,0.039288,172.31.47.0-255,172,254438,96,344269
12403,0.03932,172.31.47.0-255,1101,255539,96,344269
12404,0.039354,172.31.47.0-255,1514,257053,96,344269
12405,0.039356,172.31.47.0-255,1310,258363,96,344269
12406,0.040808,104.244.42.0-255,66,258429,96,344269
12407,0.040839,104.244.42.0-255,66,258495,96,344269
12408,0.040877,104.244.42.0-255,66,258561,96,344269
12409,0.040907,172.217.194.0-255,5738,264299,96,344269
12410,0.040913,172.31.47.0-255,66,264365,96,344269
12411,0.042932,172.217.194.0-255,5738,270103,96,344269
12412,0.042955,172.31.47.0-255,66,270169,96,344269
12413,0.045003,172.217.194.0-255,5738,275907,96,344269
12414,0.045022,172.31.47.0-255,66,275973,96,344269
12415,0.047079,172.217.194.0-255,5738,281711,96,344269
12416,0.047094,172.31.47.0-255,66,281777,96,344269
12417,0.049101,172.217.194.0-255,5738,287515,96,344269
12418,0.049118,172.31.47.0-255,66,287581,96,344269
12419,0.051116,172.217.194.0-255,5738,293319,96,344269
12420,0.051139,172.31.47.0-255,66,293385,96,344269
12421,0.053163,172.217.194.0-255,5738,299123,96,344269
12422,0.053173,172.31.47.0-255,66,299189,96,344269
12423,0.055191,172.217.194.0-255,4320,303509,96,344269
12424,0.055196,172.31.47.0-255,66,303575,96,344269
12425,0.055222,172.217.194.0-255,1484,305059,96,344269
12426,0.057215,172.217.194.0-255,4320,309379,96,344269
12427,0.05722,172.31.47.0-255,66,309445,96,344269
12428,0.059232,172.217.194.0-255,5738,315183,96,344269
12429,0.0593,172.31.47.0-255,66,315249,96,344269
12430,0.061301,172.217.194.0-255,5738,320987,96,344269
12431,0.061309,172.31.47.0-255,66,321053,96,344269
12432,0.0633,172.217.194.0-255,5738,326791,96,344269
12433,0.063306,172.31.47.0-255,66,326857,96,344269
12434,0.06536,172.217.194.0-255,5738,332595,96,344269
12435,0.065366,172.31.47.0-255,66,332661,96,344269
12436,0.067352,172.217.194.0-255,5738,338399,96,344269
12437,0.067358,172.31.47.0-255,66,338465,96,344269
12438,0.069367,172.217.194.0-255,5738,344203,96,344269
12439,0.069373,172.31.47.0-255,66,344269,96,344269
12440,0.0,74.125.24.0-255,154,154,96,244261
12441,2.4e-05,172.31.47.0-255,66,220,96,244261
12442,3e-05,74.125.24.0-255,1484,1704,96,244261
12443,3.3e-05,172.31.47.0-255,66,1770,96,244261
12444,5.8e-05,74.125.24.0-255,2902,4672,96,244261
12445,6e-05,172.31.47.0-255,66,4738,96,244261
12446,6.6e-05,74.125.24.0-255,7156,11894,96,244261
12447,6.8e-05,172.31.47.0-255,66,11960,96,244261
12448,8.3e-05,74.125.24.0-255,1484,13444,96,244261
12449,8.5e-05,172.31.47.0-255,66,13510,96,244261
12450,0.0001,74.125.24.0-255,3480,16990,96,244261
12451,0.000103,172.31.47.0-255,66,17056,96,244261
12452,0.000126,74.125.24.0-255,5738,22794,96,244261
12453,0.000129,172.31.47.0-255,66,22860,96,244261
12454,0.000146,74.125.24.0-255,2902,25762,96,244261
12455,0.000148,172.31.47.0-255,66,25828,96,244261
12456,0.000162,74.125.24.0-255,5379,31207,96,244261
12457,0.000164,172.31.47.0-255,66,31273,96,244261
12458,0.000274,74.125.24.0-255,1484,32757,96,244261
12459,0.000277,172.31.47.0-255,66,32823,96,244261
12460,0.000291,74.125.24.0-255,2902,35725,96,244261
12461,0.000293,172.31.47.0-255,66,35791,96,244261
12462,0.000296,74.125.24.0-255,1484,37275,96,244261
12463,0.000298,172.31.47.0-255,66,37341,96,244261
12464,0.000316,74.125.24.0-255,4320,41661,96,244261
12465,0.000319,172.31.47.0-255,66,41727,96,244261
12466,0.000369,172.31.47.0-255,66,41793,96,244261
12467,0.000393,74.125.24.0-255,1484,43277,96,244261
12468,0.000396,172.31.47.0-255,66,43343,96,244261
12469,0.00042,172.31.47.0-255,66,43409,96,244261
12470,0.000518,74.125.24.0-255,1484,44893,96,244261
12471,0.000524,74.125.24.0-255,2902,47795,96,244261
12472,0.000526,172.31.47.0-255,66,47861,96,244261
12473,0.000549,74.125.24.0-255,5738,53599,96,244261
12474,0.000552,172.31.47.0-255,66,53665,96,244261
12475,0.000555,74.125.24.0-255,1484,55149,96,244261
12476,0.000597,74.125.24.0-255,4320,59469,96,244261
12477,0.000599,172.31.47.0-255,66,59535,96,244261
12478,0.000625,172.31.47.0-255,66,59601,96,244261
12479,0.000651,74.125.24.0-255,1484,61085,96,244261
12480,0.000674,172.31.47.0-255,66,61151,96,244261
12481,0.000789,74.125.24.0-255,1484,62635,96,244261
12482,0.000806,74.125.24.0-255,1484,64119,96,244261
12483,0.000809,172.31.47.0-255,66,64185,96,244261
12484,0.000827,74.125.24.0-255,1484,65669,96,244261
12485,0.000833,74.125.24.0-255,5738,71407,96,244261
12486,0.000836,172.31.47.0-255,66,71473,96,244261
12487,0.00084,74.125.24.0-255,2902,74375,96,244261
12488,0.000842,172.31.47.0-255,66,74441,96,244261
12489,0.000864,172.31.47.0-255,66,74507,96,244261
12490,0.000873,172.31.47.0-255,66,74573,96,244261
12491,0.00094,172.31.47.0-255,66,74639,96,244261
12492,0.000959,74.125.24.0-255,3602,78241,96,244261
12493,0.000962,172.31.47.0-255,66,78307,96,244261
12494,0.000966,74.125.24.0-255,2902,81209,96,244261
12495,0.000968,172.31.47.0-255,66,81275,96,244261
12496,0.000991,172.31.47.0-255,66,81341,96,244261
12497,0.001083,74.125.24.0-255,1484,82825,96,244261
12498,0.001108,74.125.24.0-255,1484,84309,96,244261
12499,0.001111,172.31.47.0-255,66,84375,96,244261
12500,0.001115,74.125.24.0-255,1484,85859,96,244261
12501,0.001133,74.125.24.0-255,1484,87343,96,244261
12502,0.001136,172.31.47.0-255,66,87409,96,244261
12503,0.001142,74.125.24.0-255,5738,93147,96,244261
12504,0.001144,172.31.47.0-255,66,93213,96,244261
12505,0.001146,74.125.24.0-255,1484,94697,96,244261
12506,0.001186,172.31.47.0-255,66,94763,96,244261
12507,0.001191,172.31.47.0-255,66,94829,96,244261
12508,0.001499,74.125.24.0-255,1484,96313,96,244261
12509,0.001511,74.125.24.0-255,2902,99215,96,244261
12510,0.001514,172.31.47.0-255,66,99281,96,244261
12511,0.00152,74.125.24.0-255,5738,105019,96,244261
12512,0.001522,172.31.47.0-255,66,105085,96,244261
12513,0.001533,74.125.24.0-255,2902,107987,96,244261
12514,0.001536,172.31.47.0-255,66,108053,96,244261
12515,0.001561,74.125.24.0-255,7156,115209,96,244261
12516,0.001564,172.31.47.0-255,66,115275,96,244261
12517,0.001576,74.125.24.0-255,2902,118177,96,244261
12518,0.001579,172.31.47.0-255,66,118243,96,244261
12519,0.001606,172.31.47.0-255,66,118309,96,244261
12520,0.001631,74.125.24.0-255,1484,119793,96,244261
12521,0.001647,74.125.24.0-255,2902,122695,96,244261
12522,0.001651,172.31.47.0-255,66,122761,96,244261
12523,0.001654,74.125.24.0-255,1484,124245,96,244261
12524,0.001669,74.125.24.0-255,4320,128565,96,244261
12525,0.001671,172.31.47.0-255,66,128631,96,244261
12526,0.001676,74.125.24.0-255,4320,132951,96,244261
12527,0.001678,172.31.47.0-255,66,133017,96,244261
12528,0.001696,74.125.24.0-255,4320,137337,96,244261
12529,0.001699,172.31.47.0-255,66,137403,96,244261
12530,0.001746,74.125.24.0-255,2902,140305,96,244261
12531,0.001749,172.31.47.0-255,66,140371,96,244261
12532,0.001778,172.31.47.0-255,66,140437,96,244261
12533,0.001877,74.125.24.0-255,1484,141921,96,244261
12534,0.001897,74.125.24.0-255,2902,144823,96,244261
12535,0.001899,172.31.47.0-255,66,144889,96,244261
12536,0.001903,74.125.24.0-255,1484,146373,96,244261
12537,0.001921,74.125.24.0-255,4320,150693,96,244261
12538,0.001923,172.31.47.0-255,66,150759,96,244261
12539,0.001928,74.125.24.0-255,4320,155079,96,244261
12540,0.00193,172.31.47.0-255,66,155145,96,244261
12541,0.001958,74.125.24.0-255,5738,160883,96,244261
12542,0.001965,172.31.47.0-255,66,160949,96,244261
12543,0.001972,74.125.24.0-255,5738,166687,96,244261
12544,0.001974,172.31.47.0-255,66,166753,96,244261
12545,0.001987,74.125.24.0-255,4320,171073,96,244261
12546,0.00199,172.31.47.0-255,66,171139,96,244261
12547,0.002004,74.125.24.0-255,2902,174041,96,244261
12548,0.002006,172.31.47.0-255,66,174107,96,244261
12549,0.002009,74.125.24.0-255,766,174873,96,244261
12550,0.002176,172.31.47.0-255,66,174939,96,244261
12551,0.002176,74.125.24.0-255,1484,176423,96,244261
12552,0.002195,74.125.24.0-255,2902,179325,96,244261
12553,0.002197,172.31.47.0-255,66,179391,96,244261
12554,0.002203,74.125.24.0-255,5738,185129,96,244261
12555,0.002207,172.31.47.0-255,66,185195,96,244261
12556,0.002213,74.125.24.0-255,4320,189515,96,244261
12557,0.002215,172.31.47.0-255,66,189581,96,244261
12558,0.002264,74.125.24.0-255,1484,191065,96,244261
12559,0.002268,172.31.47.0-255,78,191143,96,244261
12560,0.002278,172.31.47.0-255,78,191221,96,244261
12561,0.002292,74.125.24.0-255,5738,196959,96,244261
12562,0.002295,172.31.47.0-255,66,197025,96,244261
12563,0.002321,74.125.24.0-255,6438,203463,96,244261
12564,0.002323,172.31.47.0-255,66,203529,96,244261
12565,0.002326,74.125.24.0-255,1484,205013,96,244261
12566,0.002328,74.125.24.0-255,1484,206497,96,244261
12567,0.00233,172.31.47.0-255,66,206563,96,244261
12568,0.002332,74.125.24.0-255,1484,208047,96,244261
12569,0.002335,172.31.47.0-255,78,208125,96,244261
12570,0.00234,74.125.24.0-255,5738,213863,96,244261
12571,0.002343,172.31.47.0-255,78,213941,96,244261
12572,0.002369,74.125.24.0-255,5738,219679,96,244261
12573,0.002373,172.31.47.0-255,66,219745,96,244261
12574,0.002378,74.125.24.0-255,5738,225483,96,244261
12575,0.002383,172.31.47.0-255,66,225549,96,244261
12576,0.002396,172.31.47.0-255,66,225615,96,244261
12577,0.002399,74.125.24.0-255,1484,227099,96,244261
12578,0.002422,74.125.24.0-255,4320,231419,96,244261
12579,0.002424,172.31.47.0-255,66,231485,96,244261
12580,0.002437,74.125.24.0-255,2902,234387,96,244261
12581,0.002439,172.31.47.0-255,66,234453,96,244261
12582,0.002473,172.31.47.0-255,66,234519,96,244261
12583,0.002485,172.31.47.0-255,66,234585,96,244261
12584,0.002489,74.125.24.0-255,2902,237487,96,244261
12585,0.002492,172.31.47.0-255,66,237553,96,244261
12586,0.002526,172.31.47.0-255,66,237619,96,244261
12587,0.002529,74.125.24.0-255,97,237716,96,244261
12588,0.002531,74.125.24.0-255,105,237821,96,244261
12589,0.007279,172.31.47.0-255,66,237887,96,244261
12590,0.007306,172.31.47.0-255,105,237992,96,244261
12591,0.009248,74.125.24.0-255,66,238058,96,244261
12592,0.024265,172.31.47.0-255,172,238230,96,244261
12593,0.024296,172.31.47.0-255,1105,239335,96,244261
12594,0.024358,172.31.47.0-255,1514,240849,96,244261
12595,0.024361,172.31.47.0-255,1514,242363,96,244261
12596,0.024362,172.31.47.0-255,1514,243877,96,244261
12597,0.024362,172.31.47.0-255,120,243997,96,244261
12598,0.025805,104.244.42.0-255,66,244063,96,244261
12599,0.025826,104.244.42.0-255,66,244129,96,244261
12600,0.02593,104.244.42.0-255,66,244195,96,244261
12601,0.025936,104.244.42.0-255,66,244261,96,244261
12602,0.0,74.125.24.0-255,159,159,96,228447
12603,3.4e-05,172.31.47.0-255,66,225,96,228447
12604,4e-05,74.125.24.0-255,1484,1709,96,228447
12605,4.5e-05,172.31.47.0-255,66,1775,96,228447
12606,5e-05,74.125.24.0-255,2902,4677,96,228447
12607,5.1e-05,172.31.47.0-255,66,4743,96,228447
12608,5.7e-05,74.125.24.0-255,7156,11899,96,228447
12609,6e-05,172.31.47.0-255,66,11965,96,228447
12610,6.3e-05,74.125.24.0-255,1484,13449,96,228447
12611,6.5e-05,172.31.47.0-255,66,13515,96,228447
12612,0.000102,172.31.47.0-255,66,13581,96,228447
12613,0.000121,74.125.24.0-255,2543,16124,96,228447
12614,0.000123,172.31.47.0-255,66,16190,96,228447
12615,0.000453,74.125.24.0-255,1484,17674,96,228447
12616,0.000457,172.31.47.0-255,66,17740,96,228447
12617,0.000463,74.125.24.0-255,2902,20642,96,228447
12618,0.000464,172.31.47.0-255,66,20708,96,228447
12619,0.000479,74.125.24.0-255,5738,26446,96,228447
12620,0.000481,172.31.47.0-255,66,26512,96,228447
12621,0.000502,74.125.24.0-255,1484,27996,96,228447
12622,0.000504,172.31.47.0-255,66,28062,96,228447
12623,0.000531,172.31.47.0-255,66,28128,96,228447
12624,0.000541,172.31.47.0-255,66,28194,96,228447
12625,0.00056,74.125.24.0-255,1432,29626,96,228447
12626,0.000565,172.31.47.0-255,66,29692,96,228447
12627,0.00075,74.125.24.0-255,114,29806,96,228447
12628,0.000754,172.31.47.0-255,66,29872,96,228447
12629,0.000883,74.125.24.0-255,1484,31356,96,228447
12630,0.000888,172.31.47.0-255,66,31422,96,228447
12631,0.000893,74.125.24.0-255,2902,34324,96,228447
12632,0.000895,172.31.47.0-255,66,34390,96,228447
12633,0.000909,74.125.24.0-255,4320,38710,96,228447
12634,0.000912,172.31.47.0-255,66,38776,96,228447
12635,0.000925,74.125.24.0-255,1484,40260,96,228447
12636,0.000931,74.125.24.0-255,4320,44580,96,228447
12637,0.000933,172.31.47.0-255,66,44646,96,228447
12638,0.000953,74.125.24.0-255,1484,46130,96,228447
12639,0.000992,172.31.47.0-255,66,46196,96,228447
12640,0.001,74.125.24.0-255,6797,52993,96,228447
12641,0.001003,172.31.47.0-255,66,53059,96,228447
12642,0.003276,74.125.24.0-255,4320,57379,96,228447
12643,0.003282,172.31.47.0-255,66,57445,96,228447
12644,0.003298,74.125.24.0-255,1484,58929,96,228447
12645,0.005534,74.125.24.0-255,4320,63249,96,228447
12646,0.005539,172.31.47.0-255,66,63315,96,228447
12647,0.007763,74.125.24.0-255,5738,69053,96,228447
12648,0.007769,172.31.47.0-255,66,69119,96,228447
12649,0.010032,74.125.24.0-255,5738,74857,96,228447
12650,0.010039,172.31.47.0-255,66,74923,96,228447
12651,0.012305,74.125.24.0-255,5738,80661,96,228447
12652,0.012311,172.31.47.0-255,66,80727,96,228447
12653,0.014558,74.125.24.0-255,5738,86465,96,228447
12654,0.014566,172.31.47.0-255,66,86531,96,228447
12655,0.0168,74.125.24.0-255,5738,92269,96,228447
12656,0.016808,172.31.47.0-255,66,92335,96,228447
12657,0.019046,74.125.24.0-255,5738,98073,96,228447
12658,0.019053,172.31.47.0-255,66,98139,96,228447
12659,0.02128,74.125.24.0-255,5738,103877,96,228447
12660,0.021285,172.31.47.0-255,66,103943,96,228447
12661,0.021286,172.31.47.0-255,172,104115,96,228447
12662,0.021309,172.31.47.0-255,1111,105226,96,228447
12663,0.021343,172.31.47.0-255,1514,106740,96,228447
12664,0.021344,172.31.47.0-255,1514,108254,96,228447
12665,0.021349,172.31.47.0-255,1514,109768,96,228447
12666,0.02135,172.31.47.0-255,1081,110849,96,228447
12667,0.022818,104.244.42.0-255,66,110915,96,228447
12668,0.022856,104.244.42.0-255,66,110981,96,228447
12669,0.0229,104.244.42.0-255,66,111047,96,228447
12670,0.022902,104.244.42.0-255,66,111113,96,228447
12671,0.023517,74.125.24.0-255,4320,115433,96,228447
12672,0.023522,172.31.47.0-255,66,115499,96,228447
12673,0.02355,74.125.24.0-255,1484,116983,96,228447
12674,0.025777,74.125.24.0-255,4320,121303,96,228447
12675,0.025784,172.31.47.0-255,66,121369,96,228447
12676,0.028037,74.125.24.0-255,5738,127107,96,228447
12677,0.028046,172.31.47.0-255,66,127173,96,228447
12678,0.03031,74.125.24.0-255,2902,130075,96,228447
12679,0.030316,172.31.47.0-255,66,130141,96,228447
12680,0.030347,74.125.24.0-255,2902,133043,96,228447
12681,0.03035,172.31.47.0-255,66,133109,96,228447
12682,0.032524,74.125.24.0-255,2902,136011,96,228447
12683,0.03253,172.31.47.0-255,66,136077,96,228447
12684,0.032583,74.125.24.0-255,2902,138979,96,228447
12685,0.032587,172.31.47.0-255,66,139045,96,228447
12686,0.03472,74.125.24.0-255,1484,140529,96,228447
12687,0.034745,74.125.24.0-255,1484,142013,96,228447
12688,0.034749,172.31.47.0-255,66,142079,96,228447
12689,0.034786,74.125.24.0-255,2902,144981,96,228447
12690,0.034789,172.31.47.0-255,66,145047,96,228447
12691,0.036971,74.125.24.0-255,2902,147949,96,228447
12692,0.036976,172.31.47.0-255,66,148015,96,228447
12693,0.037029,74.125.24.0-255,2902,150917,96,228447
12694,0.037033,172.31.47.0-255,66,150983,96,228447
12695,0.039224,74.125.24.0-255,2902,153885,96,228447
12696,0.039231,172.31.47.0-255,66,153951,96,228447
12697,0.039278,74.125.24.0-255,2902,156853,96,228447
12698,0.039283,172.31.47.0-255,66,156919,96,228447
12699,0.04149,74.125.24.0-255,5738,162657,96,228447
12700,0.041496,172.31.47.0-255,66,162723,96,228447
12701,0.043699,74.125.24.0-255,5738,168461,96,228447
12702,0.043707,172.31.47.0-255,66,168527,96,228447
12703,0.045973,74.125.24.0-255,4320,172847,96,228447
12704,0.045978,172.31.47.0-255,66,172913,96,228447
12705,0.046004,74.125.24.0-255,1484,174397,96,228447
12706,0.048228,74.125.24.0-255,4320,178717,96,228447
12707,0.048234,172.31.47.0-255,66,178783,96,228447
12708,0.050494,74.125.24.0-255,5738,184521,96,228447
12709,0.050499,172.31.47.0-255,66,184587,96,228447
12710,0.052753,74.125.24.0-255,2902,187489,96,228447
12711,0.052757,172.31.47.0-255,66,187555,96,228447
12712,0.052784,74.125.24.0-255,2902,190457,96,228447
12713,0.052786,172.31.47.0-255,66,190523,96,228447
12714,0.054986,74.125.24.0-255,4320,194843,96,228447
12715,0.054992,172.31.47.0-255,66,194909,96,228447
12716,0.055022,74.125.24.0-255,1484,196393,96,228447
12717,0.057205,74.125.24.0-255,4320,200713,96,228447
12718,0.057211,172.31.47.0-255,66,200779,96,228447
12719,0.059433,74.125.24.0-255,5738,206517,96,228447
12720,0.05944,172.31.47.0-255,66,206583,96,228447
12721,0.061706,74.125.24.0-255,5738,212321,96,228447
12722,0.061711,172.31.47.0-255,66,212387,96,228447
12723,0.063913,74.125.24.0-255,4320,216707,96,228447
12724,0.063918,172.31.47.0-255,66,216773,96,228447
12725,0.063944,74.125.24.0-255,1484,218257,96,228447
12726,0.066173,74.125.24.0-255,4320,222577,96,228447
12727,0.066177,172.31.47.0-255,66,222643,96,228447
12728,0.068441,74.125.24.0-255,5738,228381,96,228447
12729,0.068447,172.31.47.0-255,66,228447,96,228447
12730,0.0,74.125.68.0-255,153,153,96,314167
12731,3.3e-05,172.31.47.0-255,66,219,96,314167
12732,3.9e-05,74.125.68.0-255,1484,1703,96,314167
12733,4.2e-05,172.31.47.0-255,66,1769,96,314167
12734,4.6e-05,74.125.68.0-255,2902,4671,96,314167
12735,4.9e-05,172.31.47.0-255,66,4737,96,314167
12736,5.4e-05,74.125.68.0-255,4320,9057,96,314167
12737,5.7e-05,172.31.47.0-255,66,9123,96,314167
12738,8.1e-05,74.125.68.0-255,5052,14175,96,314167
12739,8.4e-05,172.31.47.0-255,66,14241,96,314167
12740,0.000198,74.125.68.0-255,1484,15725,96,314167
12741,0.000202,172.31.47.0-255,66,15791,96,314167
12742,0.000209,74.125.68.0-255,2902,18693,96,314167
12743,0.00021,172.31.47.0-255,66,18759,96,314167
12744,0.000214,74.125.68.0-255,1484,20243,96,314167
12745,0.000215,172.31.47.0-255,66,20309,96,314167
12746,0.000231,74.125.68.0-255,4320,24629,96,314167
12747,0.000233,172.31.47.0-255,66,24695,96,314167
12748,0.000237,74.125.68.0-255,2902,27597,96,314167
12749,0.000238,172.31.47.0-255,66,27663,96,314167
12750,0.000241,74.125.68.0-255,1484,29147,96,314167
12751,0.000243,172.31.47.0-255,66,29213,96,314167
12752,0.000261,74.125.68.0-255,2543,31756,96,314167
12753,0.000263,172.31.47.0-255,66,31822,96,314167
12754,0.000301,74.125.68.0-255,1484,33306,96,314167
12755,0.000304,172.31.47.0-255,66,33372,96,314167
12756,0.000309,74.125.68.0-255,2902,36274,96,314167
12757,0.000311,172.31.47.0-255,66,36340,96,314167
12758,0.000335,74.125.68.0-255,1484,37824,96,314167
12759,0.000337,172.31.47.0-255,66,37890,96,314167
12760,0.000358,74.125.68.0-255,4320,42210,96,314167
12761,0.000362,74.125.68.0-255,4320,46530,96,314167
12762,0.000363,172.31.47.0-255,66,46596,96,314167
12763,0.000367,172.31.47.0-255,66,46662,96,314167
12764,0.000393,74.125.68.0-255,2543,49205,96,314167
12765,0.000396,172.31.47.0-255,66,49271,96,314167
12766,0.000698,74.125.68.0-255,1484,50755,96,314167
12767,0.000703,74.125.68.0-255,1484,52239,96,314167
12768,0.000706,172.31.47.0-255,66,52305,96,314167
12769,0.000726,74.125.68.0-255,2902,55207,96,314167
12770,0.00073,172.31.47.0-255,66,55273,96,314167
12771,0.000751,74.125.68.0-255,5738,61011,96,314167
12772,0.000754,172.31.47.0-255,66,61077,96,314167
12773,0.000761,74.125.68.0-255,6797,67874,96,314167
12774,0.000763,172.31.47.0-255,66,67940,96,314167
12775,0.000766,74.125.68.0-255,1484,69424,96,314167
12776,0.000785,74.125.68.0-255,5738,75162,96,314167
12777,0.000788,172.31.47.0-255,66,75228,96,314167
12778,0.000794,74.125.68.0-255,4320,79548,96,314167
12779,0.000795,172.31.47.0-255,66,79614,96,314167
12780,0.000816,74.125.68.0-255,4541,84155,96,314167
12781,0.000819,172.31.47.0-255,66,84221,96,314167
12782,0.000838,74.125.68.0-255,1484,85705,96,314167
12783,0.000852,74.125.68.0-255,2902,88607,96,314167
12784,0.000855,172.31.47.0-255,66,88673,96,314167
12785,0.000874,74.125.68.0-255,4320,92993,96,314167
12786,0.000877,172.31.47.0-255,66,93059,96,314167
12787,0.000891,74.125.68.0-255,4320,97379,96,314167
12788,0.000894,172.31.47.0-255,66,97445,96,314167
12789,0.000911,74.125.68.0-255,3961,101406,96,314167
12790,0.000914,172.31.47.0-255,66,101472,96,314167
12791,0.001457,74.125.68.0-255,1484,102956,96,314167
12792,0.001466,74.125.68.0-255,1484,104440,96,314167
12793,0.001471,172.31.47.0-255,66,104506,96,314167
12794,0.001497,74.125.68.0-255,1484,105990,96,314167
12795,0.001504,74.125.68.0-255,4320,110310,96,314167
12796,0.001506,172.31.47.0-255,66,110376,96,314167
12797,0.001512,74.125.68.0-255,5738,116114,96,314167
12798,0.001515,172.31.47.0-255,66,116180,96,314167
12799,0.001552,172.31.47.0-255,66,116246,96,314167
12800,0.001559,74.125.68.0-255,4320,120566,96,314167
12801,0.001561,172.31.47.0-255,66,120632,96,314167
12802,0.001602,74.125.68.0-255,3602,124234,96,314167
12803,0.001606,172.31.47.0-255,66,124300,96,314167
12804,0.001648,74.125.68.0-255,1484,125784,96,314167
12805,0.001673,74.125.68.0-255,2902,128686,96,314167
12806,0.001677,172.31.47.0-255,66,128752,96,314167
12807,0.0017,74.125.68.0-255,2902,131654,96,314167
12808,0.001703,172.31.47.0-255,66,131720,96,314167
12809,0.001721,74.125.68.0-255,2902,134622,96,314167
12810,0.001725,172.31.47.0-255,66,134688,96,314167
12811,0.001729,74.125.68.0-255,2902,137590,96,314167
12812,0.001731,172.31.47.0-255,66,137656,96,314167
12813,0.001734,74.125.68.0-255,1484,139140,96,314167
12814,0.001758,74.125.68.0-255,2902,142042,96,314167
12815,0.001762,172.31.47.0-255,66,142108,96,314167
12816,0.001804,172.31.47.0-255,66,142174,96,314167
12817,0.001807,74.125.68.0-255,1484,143658,96,314167
12818,0.001826,74.125.68.0-255,2902,146560,96,314167
12819,0.001828,172.31.47.0-255,66,146626,96,314167
12820,0.001853,74.125.68.0-255,3602,150228,96,314167
12821,0.001856,172.31.47.0-255,66,150294,96,314167
12822,0.004207,74.125.68.0-255,1484,151778,96,314167
12823,0.004234,74.125.68.0-255,4320,156098,96,314167
12824,0.004239,172.31.47.0-255,66,156164,96,314167
12825,0.006598,74.125.68.0-255,2902,159066,96,314167
12826,0.006604,172.31.47.0-255,66,159132,96,314167
12827,0.006623,74.125.68.0-255,2902,162034,96,314167
12828,0.006626,172.31.47.0-255,66,162100,96,314167
12829,0.008969,74.125.68.0-255,2902,165002,96,314167
12830,0.008976,172.31.47.0-255,66,165068,96,314167
12831,0.008997,74.125.68.0-255,2902,167970,96,314167
12832,0.009,172.31.47.0-255,66,168036,96,314167
12833,0.011339,74.125.68.0-255,2902,170938,96,314167
12834,0.011346,172.31.47.0-255,66,171004,96,314167
12835,0.011369,74.125.68.0-255,2902,173906,96,314167
12836,0.011372,172.31.47.0-255,66,173972,96,314167
12837,0.01371,74.125.68.0-255,2902,176874,96,314167
12838,0.013717,172.31.47.0-255,66,176940,96,314167
12839,0.013738,74.125.68.0-255,2902,179842,96,314167
12840,0.01374,172.31.47.0-255,66,179908,96,314167
12841,0.016087,74.125.68.0-255,4320,184228,96,314167
12842,0.016093,172.31.47.0-255,66,184294,96,314167
12843,0.016113,74.125.68.0-255,1484,185778,96,314167
12844,0.018478,74.125.68.0-255,4320,190098,96,314167
12845,0.018492,172.31.47.0-255,66,190164,96,314167
12846,0.020867,74.125.68.0-255,5738,195902,96,314167
12847,0.020875,172.31.47.0-255,66,195968,96,314167
12848,0.023248,74.125.68.0-255,5738,201706,96,314167
12849,0.023257,172.31.47.0-255,66,201772,96,314167
12850,0.025664,74.125.68.0-255,5738,207510,96,314167
12851,0.025671,172.31.47.0-255,66,207576,96,314167
12852,0.028053,74.125.68.0-255,5738,213314,96,314167
12853,0.02806,172.31.47.0-255,66,213380,96,314167
12854,0.030434,74.125.68.0-255,5738,219118,96,314167
12855,0.030448,172.31.47.0-255,66,219184,96,314167
12856,0.032815,74.125.68.0-255,5738,224922,96,314167
12857,0.032821,172.31.47.0-255,66,224988,96,314167
12858,0.035206,74.125.68.0-255,5738,230726,96,314167
12859,0.035219,172.31.47.0-255,66,230792,96,314167
12860,0.037599,74.125.68.0-255,5738,236530,96,314167
12861,0.03761,172.31.47.0-255,66,236596,96,314167
12862,0.039989,74.125.68.0-255,5738,242334,96,314167
12863,0.039992,172.31.47.0-255,172,242506,96,314167
12864,0.039994,172.31.47.0-255,66,242572,96,314167
12865,0.040021,172.31.47.0-255,1105,243677,96,314167
12866,0.040113,172.31.47.0-255,1514,245191,96,314167
12867,0.040115,172.31.47.0-255,1306,246497,96,314167
12868,0.041545,104.244.42.0-255,66,246563,96,314167
12869,0.041556,104.244.42.0-255,66,246629,96,314167
12870,0.041671,104.244.42.0-255,66,246695,96,314167
12871,0.042368,74.125.68.0-255,5738,252433,96,314167
12872,0.042379,172.31.47.0-255,66,252499,96,314167
12873,0.044748,74.125.68.0-255,5738,258237,96,314167
12874,0.044754,172.31.47.0-255,66,258303,96,314167
12875,0.047114,74.125.68.0-255,4320,262623,96,314167
12876,0.047119,172.31.47.0-255,66,262689,96,314167
12877,0.047146,74.125.68.0-255,1484,264173,96,314167
12878,0.049494,74.125.68.0-255,4320,268493,96,314167
12879,0.049499,172.31.47.0-255,66,268559,96,314167
12880,0.051858,74.125.68.0-255,5738,274297,96,314167
12881,0.051863,172.31.47.0-255,66,274363,96,314167
12882,0.054224,74.125.68.0-255,5738,280101,96,314167
12883,0.054229,172.31.47.0-255,66,280167,96,314167
12884,0.056595,74.125.68.0-255,4320,284487,96,314167
12885,0.0566,172.31.47.0-255,66,284553,96,314167
12886,0.056618,74.125.68.0-255,1484,286037,96,314167
12887,0.058989,74.125.68.0-255,4320,290357,96,314167
12888,0.058999,172.31.47.0-255,66,290423,96,314167
12889,0.061364,74.125.68.0-255,2902,293325,96,314167
12890,0.061369,172.31.47.0-255,66,293391,96,314167
12891,0.0614,74.125.68.0-255,2902,296293,96,314167
12892,0.061403,172.31.47.0-255,66,296359,96,314167
12893,0.063737,74.125.68.0-255,2902,299261,96,314167
12894,0.063741,172.31.47.0-255,66,299327,96,314167
12895,0.063766,74.125.68.0-255,2902,302229,96,314167
12896,0.063769,172.31.47.0-255,66,302295,96,314167
12897,0.066105,74.125.68.0-255,2902,305197,96,314167
12898,0.066111,172.31.47.0-255,66,305263,96,314167
12899,0.066138,74.125.68.0-255,2902,308165,96,314167
12900,0.066141,172.31.47.0-255,66,308231,96,314167
12901,0.068493,74.125.68.0-255,2902,311133,96,314167
12902,0.068502,172.31.47.0-255,66,311199,96,314167
12903,0.068519,74.125.68.0-255,2902,314101,96,314167
12904,0.068522,172.31.47.0-255,66,314167,96,314167
12905,0.0,74.125.24.0-255,153,153,96,275607
12906,1.9e-05,172.31.47.0-255,66,219,96,275607
12907,4.9e-05,74.125.24.0-255,1484,1703,96,275607
12908,5.2e-05,172.31.47.0-255,66,1769,96,275607
12909,5.7e-05,74.125.24.0-255,2902,4671,96,275607
12910,5.9e-05,172.31.47.0-255,66,4737,96,275607
12911,8.7e-05,74.125.24.0-255,5738,10475,96,275607
12912,9e-05,172.31.47.0-255,66,10541,96,275607
12913,0.000115,74.125.24.0-255,1484,12025,96,275607
12914,0.000117,172.31.47.0-255,66,12091,96,275607
12915,0.000153,172.31.47.0-255,66,12157,96,275607
12916,0.000159,74.125.24.0-255,6797,18954,96,275607
12917,0.000161,172.31.47.0-255,66,19020,96,275607
12918,0.00022,74.125.24.0-255,1484,20504,96,275607
12919,0.000223,172.31.47.0-255,66,20570,96,275607
12920,0.000226,74.125.24.0-255,1484,22054,96,275607
12921,0.000228,172.31.47.0-255,66,22120,96,275607
12922,0.000248,74.125.24.0-255,1484,23604,96,275607
12923,0.000251,172.31.47.0-255,66,23670,96,275607
12924,0.000254,74.125.24.0-255,1484,25154,96,275607
12925,0.000255,172.31.47.0-255,66,25220,96,275607
12926,0.000289,74.125.24.0-255,4320,29540,96,275607
12927,0.000292,172.31.47.0-255,66,29606,96,275607
12928,0.000298,74.125.24.0-255,6797,36403,96,275607
12929,0.0003,172.31.47.0-255,66,36469,96,275607
12930,0.000307,74.125.24.0-255,1484,37953,96,275607
12931,0.00031,172.31.47.0-255,66,38019,96,275607
12932,0.000329,74.125.24.0-255,5738,43757,96,275607
12933,0.000331,172.31.47.0-255,66,43823,96,275607
12934,0.000341,74.125.24.0-255,5738,49561,96,275607
12935,0.000344,172.31.47.0-255,66,49627,96,275607
12936,0.000396,74.125.24.0-255,4320,53947,96,275607
12937,0.000399,172.31.47.0-255,66,54013,96,275607
12938,0.000422,74.125.24.0-255,327,54340,96,275607
12939,0.000563,74.125.24.0-255,1484,55824,96,275607
12940,0.000566,172.31.47.0-255,66,55890,96,275607
12941,0.000593,74.125.24.0-255,2902,58792,96,275607
12942,0.000596,172.31.47.0-255,66,58858,96,275607
12943,0.000601,74.125.24.0-255,5738,64596,96,275607
12944,0.000603,172.31.47.0-255,66,64662,96,275607
12945,0.000638,172.31.47.0-255,66,64728,96,275607
12946,0.000643,74.125.24.0-255,7156,71884,96,275607
12947,0.000645,172.31.47.0-255,66,71950,96,275607
12948,0.000697,74.125.24.0-255,3602,75552,96,275607
12949,0.000701,172.31.47.0-255,66,75618,96,275607
12950,0.001253,74.125.24.0-255,1484,77102,96,275607
12951,0.001261,74.125.24.0-255,2902,80004,96,275607
12952,0.001265,172.31.47.0-255,66,80070,96,275607
12953,0.001285,74.125.24.0-255,5738,85808,96,275607
12954,0.001288,172.31.47.0-255,66,85874,96,275607
12955,0.001318,74.125.24.0-255,4320,90194,96,275607
12956,0.001322,172.31.47.0-255,66,90260,96,275607
12957,0.001355,172.31.47.0-255,66,90326,96,275607
12958,0.001382,74.125.24.0-255,7156,97482,96,275607
12959,0.001384,172.31.47.0-255,66,97548,96,275607
12960,0.001412,74.125.24.0-255,3602,101150,96,275607
12961,0.001414,172.31.47.0-255,66,101216,96,275607
12962,0.001444,74.125.24.0-255,1484,102700,96,275607
12963,0.001457,74.125.24.0-255,1484,104184,96,275607
12964,0.001459,172.31.47.0-255,66,104250,96,275607
12965,0.00148,74.125.24.0-255,1484,105734,96,275607
12966,0.001485,74.125.24.0-255,5738,111472,96,275607
12967,0.001487,172.31.47.0-255,66,111538,96,275607
12968,0.001491,74.125.24.0-255,5738,117276,96,275607
12969,0.001493,172.31.47.0-255,66,117342,96,275607
12970,0.001497,74.125.24.0-255,4320,121662,96,275607
12971,0.0015,172.31.47.0-255,66,121728,96,275607
12972,0.001534,172.31.47.0-255,66,121794,96,275607
12973,0.001538,74.125.24.0-255,4320,126114,96,275607
12974,0.00154,172.31.47.0-255,66,126180,96,275607
12975,0.001542,74.125.24.0-255,766,126946,96,275607
12976,0.001606,74.125.24.0-255,1484,128430,96,275607
12977,0.001608,172.31.47.0-255,66,128496,96,275607
12978,0.001612,74.125.24.0-255,2902,131398,96,275607
12979,0.001613,172.31.47.0-255,66,131464,96,275607
12980,0.001643,74.125.24.0-255,5738,137202,96,275607
12981,0.001646,172.31.47.0-255,66,137268,96,275607
12982,0.001659,74.125.24.0-255,5738,143006,96,275607
12983,0.001665,172.31.47.0-255,66,143072,96,275607
12984,0.001685,74.125.24.0-255,7156,150228,96,275607
12985,0.001687,172.31.47.0-255,66,150294,96,275607
12986,0.001695,172.31.47.0-255,66,150360,96,275607
12987,0.001725,74.125.24.0-255,2184,152544,96,275607
12988,0.001727,172.31.47.0-255,66,152610,96,275607
12989,0.002329,74.125.24.0-255,1484,154094,96,275607
12990,0.002348,74.125.24.0-255,2902,156996,96,275607
12991,0.00235,172.31.47.0-255,66,157062,96,275607
12992,0.002356,74.125.24.0-255,5738,162800,96,275607
12993,0.002359,172.31.47.0-255,66,162866,96,275607
12994,0.002384,74.125.24.0-255,7156,170022,96,275607
12995,0.002387,172.31.47.0-255,66,170088,96,275607
12996,0.002414,74.125.24.0-255,5738,175826,96,275607
12997,0.002417,172.31.47.0-255,66,175892,96,275607
12998,0.002433,74.125.24.0-255,2902,178794,96,275607
12999,0.002435,172.31.47.0-255,66,178860,96,275607
13000,0.002478,172.31.47.0-255,66,178926,96,275607
13001,0.002508,172.31.47.0-255,66,178992,96,275607
13002,0.002511,74.125.24.0-255,2184,181176,96,275607
13003,0.002514,172.31.47.0-255,66,181242,96,275607
13004,0.002649,74.125.24.0-255,1484,182726,96,275607
13005,0.002654,74.125.24.0-255,1484,184210,96,275607
13006,0.002657,172.31.47.0-255,66,184276,96,275607
13007,0.002687,74.125.24.0-255,1484,185760,96,275607
13008,0.002694,74.125.24.0-255,5738,191498,96,275607
13009,0.002697,172.31.47.0-255,66,191564,96,275607
13010,0.002702,74.125.24.0-255,4320,195884,96,275607
13011,0.002704,172.31.47.0-255,66,195950,96,275607
13012,0.002754,74.125.24.0-255,5738,201688,96,275607
13013,0.002784,74.125.24.0-255,5738,207426,96,275607
13014,0.00279,74.125.24.0-255,5738,213164,96,275607
13015,0.002793,74.125.24.0-255,2184,215348,96,275607
13016,0.002797,74.125.24.0-255,2902,218250,96,275607
13017,0.002801,74.125.24.0-255,2902,221152,96,275607
13018,0.002813,74.125.24.0-255,5738,226890,96,275607
13019,0.002838,74.125.24.0-255,5738,232628,96,275607
13020,0.002843,74.125.24.0-255,4320,236948,96,275607
13021,0.002849,74.125.24.0-255,6438,243386,96,275607
13022,0.002855,74.125.24.0-255,7156,250542,96,275607
13023,0.002901,74.125.24.0-255,7156,257698,96,275607
13024,0.002924,172.31.47.0-255,66,257764,96,275607
13025,0.002936,74.125.24.0-255,6438,264202,96,275607
13026,0.002946,74.125.24.0-255,4320,268522,96,275607
13027,0.002957,172.31.47.0-255,66,268588,96,275607
13028,0.002998,172.31.47.0-255,66,268654,96,275607
13029,0.003004,172.31.47.0-255,66,268720,96,275607
13030,0.003031,74.125.24.0-255,2184,270904,96,275607
13031,0.003041,172.31.47.0-255,66,270970,96,275607
13032,0.00305,74.125.24.0-255,105,271075,96,275607
13033,0.003054,172.31.47.0-255,66,271141,96,275607
13034,0.005052,172.31.47.0-255,105,271246,96,275607
13035,0.007595,74.125.24.0-255,66,271312,96,275607
13036,0.036398,172.31.47.0-255,172,271484,96,275607
13037,0.036423,172.31.47.0-255,1109,272593,96,275607
13038,0.036458,172.31.47.0-255,1514,274107,96,275607
13039,0.03646,172.31.47.0-255,1302,275409,96,275607
13040,0.03792,104.244.42.0-255,66,275475,96,275607
13041,0.037936,104.244.42.0-255,66,275541,96,275607
13042,0.03803,104.244.42.0-255,66,275607,96,275607
13043,0.0,172.31.47.0-255,105,105,96,276
13044,0.001905,157.240.13.0-255,105,210,96,276
13045,0.001919,172.31.47.0-255,66,276,96,276
13046,0.0,172.217.24.0-255,146,146,96,308258
13047,2.3e-05,172.31.47.0-255,66,212,96,308258
13048,2.9e-05,172.217.24.0-255,1484,1696,96,308258
13049,3.3e-05,172.31.47.0-255,66,1762,96,308258
13050,3.7e-05,172.217.24.0-255,2902,4664,96,308258
13051,3.9e-05,172.31.47.0-255,66,4730,96,308258
13052,7e-05,172.217.24.0-255,4320,9050,96,308258
13053,7.2e-05,172.31.47.0-255,66,9116,96,308258
13054,7.7e-05,172.217.24.0-255,4320,13436,96,308258
13055,7.9e-05,172.31.47.0-255,66,13502,96,308258
13056,9.6e-05,172.217.24.0-255,683,14185,96,308258
13057,9.8e-05,172.31.47.0-255,66,14251,96,308258
13058,0.000127,172.217.24.0-255,1484,15735,96,308258
13059,0.000129,172.31.47.0-255,66,15801,96,308258
13060,0.000151,172.217.24.0-255,4320,20121,96,308258
13061,0.000153,172.31.47.0-255,66,20187,96,308258
13062,0.000157,172.217.24.0-255,2902,23089,96,308258
13063,0.000159,172.31.47.0-255,66,23155,96,308258
13064,0.000185,172.217.24.0-255,7156,30311,96,308258
13065,0.000188,172.31.47.0-255,66,30377,96,308258
13066,0.00019,172.217.24.0-255,1125,31502,96,308258
13067,0.000191,172.31.47.0-255,66,31568,96,308258
13068,0.000318,172.217.24.0-255,1484,33052,96,308258
13069,0.000322,172.31.47.0-255,66,33118,96,308258
13070,0.000327,172.217.24.0-255,2902,36020,96,308258
13071,0.000329,172.31.47.0-255,66,36086,96,308258
13072,0.000333,172.217.24.0-255,2902,38988,96,308258
13073,0.000336,172.31.47.0-255,66,39054,96,308258
13074,0.000357,172.217.24.0-255,2902,41956,96,308258
13075,0.000361,172.31.47.0-255,66,42022,96,308258
13076,0.000369,172.217.24.0-255,2902,44924,96,308258
13077,0.000372,172.31.47.0-255,66,44990,96,308258
13078,0.000386,172.217.24.0-255,3961,48951,96,308258
13079,0.000388,172.31.47.0-255,66,49017,96,308258
13080,0.000409,172.217.24.0-255,1484,50501,96,308258
13081,0.000412,172.217.24.0-255,1484,51985,96,308258
13082,0.000415,172.31.47.0-255,66,52051,96,308258
13083,0.000422,172.217.24.0-255,1484,53535,96,308258
13084,0.000436,172.217.24.0-255,5738,59273,96,308258
13085,0.000439,172.31.47.0-255,66,59339,96,308258
13086,0.000472,172.217.24.0-255,2902,62241,96,308258
13087,0.000475,172.31.47.0-255,66,62307,96,308258
13088,0.000495,172.217.24.0-255,3961,66268,96,308258
13089,0.000499,172.31.47.0-255,66,66334,96,308258
13090,0.000503,172.217.24.0-255,396,66730,96,308258
13091,0.00074,172.31.47.0-255,66,66796,96,308258
13092,0.001088,172.217.24.0-255,112,66908,96,308258
13093,0.001245,172.217.24.0-255,1484,68392,96,308258
13094,0.00125,172.31.47.0-255,66,68458,96,308258
13095,0.001257,172.217.24.0-255,2902,71360,96,308258
13096,0.00126,172.31.47.0-255,66,71426,96,308258
13097,0.001267,172.217.24.0-255,5738,77164,96,308258
13098,0.001269,172.31.47.0-255,66,77230,96,308258
13099,0.001274,172.217.24.0-255,2902,80132,96,308258
13100,0.001276,172.31.47.0-255,66,80198,96,308258
13101,0.001281,172.217.24.0-255,3961,84159,96,308258
13102,0.001283,172.31.47.0-255,66,84225,96,308258
13103,0.001347,172.217.24.0-255,1484,85709,96,308258
13104,0.001362,172.217.24.0-255,2902,88611,96,308258
13105,0.001366,172.31.47.0-255,66,88677,96,308258
13106,0.001369,172.217.24.0-255,1484,90161,96,308258
13107,0.001386,172.217.24.0-255,4320,94481,96,308258
13108,0.001388,172.31.47.0-255,66,94547,96,308258
13109,0.001393,172.217.24.0-255,2902,97449,96,308258
13110,0.001394,172.31.47.0-255,66,97515,96,308258
13111,0.001415,172.217.24.0-255,2902,100417,96,308258
13112,0.001417,172.31.47.0-255,66,100483,96,308258
13113,0.001433,172.217.24.0-255,1125,101608,96,308258
13114,0.002948,172.31.47.0-255,66,101674,96,308258
13115,0.003285,172.217.24.0-255,1484,103158,96,308258
13116,0.003315,172.217.24.0-255,2902,106060,96,308258
13117,0.003318,172.31.47.0-255,66,106126,96,308258
13118,0.004829,172.217.24.0-255,1484,107610,96,308258
13119,0.005208,172.217.24.0-255,4320,111930,96,308258
13120,0.005213,172.31.47.0-255,66,111996,96,308258
13121,0.007103,172.217.24.0-255,5738,117734,96,308258
13122,0.00711,172.31.47.0-255,66,117800,96,308258
13123,0.009003,172.217.24.0-255,5738,123538,96,308258
13124,0.009009,172.31.47.0-255,66,123604,96,308258
13125,0.010903,172.217.24.0-255,5738,129342,96,308258
13126,0.01091,172.31.47.0-255,66,129408,96,308258
13127,0.012813,172.217.24.0-255,5738,135146,96,308258
13128,0.012821,172.31.47.0-255,66,135212,96,308258
13129,0.014715,172.217.24.0-255,5738,140950,96,308258
13130,0.014721,172.31.47.0-255,66,141016,96,308258
13131,0.016618,172.217.24.0-255,5738,146754,96,308258
13132,0.016624,172.31.47.0-255,66,146820,96,308258
13133,0.018521,172.217.24.0-255,5738,152558,96,308258
13134,0.018527,172.31.47.0-255,66,152624,96,308258
13135,0.020425,172.217.24.0-255,5738,158362,96,308258
13136,0.020432,172.31.47.0-255,66,158428,96,308258
13137,0.022323,172.217.24.0-255,5738,164166,96,308258
13138,0.022328,172.31.47.0-255,66,164232,96,308258
13139,0.022781,172.31.47.0-255,172,164404,96,308258
13140,0.022808,172.31.47.0-255,1101,165505,96,308258
13141,0.022846,172.31.47.0-255,1514,167019,96,308258
13142,0.022848,172.31.47.0-255,1514,168533,96,308258
13143,0.022852,172.31.47.0-255,1514,170047,96,308258
13144,0.022852,172.31.47.0-255,1091,171138,96,308258
13145,0.024247,172.217.24.0-255,5738,176876,96,308258
13146,0.024252,172.31.47.0-255,66,176942,96,308258
13147,0.024325,104.244.42.0-255,66,177008,96,308258
13148,0.024371,104.244.42.0-255,66,177074,96,308258
13149,0.024427,104.244.42.0-255,66,177140,96,308258
13150,0.024432,104.244.42.0-255,66,177206,96,308258
13151,0.026141,172.217.24.0-255,5738,182944,96,308258
13152,0.026146,172.31.47.0-255,66,183010,96,308258
13153,0.028035,172.217.24.0-255,4320,187330,96,308258
13154,0.02804,172.31.47.0-255,66,187396,96,308258
13155,0.028068,172.217.24.0-255,1484,188880,96,308258
13156,0.029933,172.217.24.0-255,4320,193200,96,308258
13157,0.029938,172.31.47.0-255,66,193266,96,308258
13158,0.031828,172.217.24.0-255,5738,199004,96,308258
13159,0.031834,172.31.47.0-255,66,199070,96,308258
13160,0.033743,172.217.24.0-255,5738,204808,96,308258
13161,0.033751,172.31.47.0-255,66,204874,96,308258
13162,0.035643,172.217.24.0-255,5738,210612,96,308258
13163,0.035651,172.31.47.0-255,66,210678,96,308258
13164,0.037557,172.217.24.0-255,5738,216416,96,308258
13165,0.037571,172.31.47.0-255,66,216482,96,308258
13166,0.039481,172.217.24.0-255,5738,222220,96,308258
13167,0.039494,172.31.47.0-255,66,222286,96,308258
13168,0.041407,172.217.24.0-255,5738,228024,96,308258
13169,0.041422,172.31.47.0-255,66,228090,96,308258
13170,0.043332,172.217.24.0-255,5738,233828,96,308258
13171,0.043351,172.31.47.0-255,66,233894,96,308258
13172,0.045258,172.217.24.0-255,5738,239632,96,308258
13173,0.045267,172.31.47.0-255,66,239698,96,308258
13174,0.047192,172.217.24.0-255,5738,245436,96,308258
13175,0.047199,172.31.47.0-255,66,245502,96,308258
13176,0.049141,172.217.24.0-255,5738,251240,96,308258
13177,0.049158,172.31.47.0-255,66,251306,96,308258
13178,0.051055,172.217.24.0-255,5738,257044,96,308258
13179,0.051067,172.31.47.0-255,66,257110,96,308258
13180,0.052973,172.217.24.0-255,5738,262848,96,308258
13181,0.052985,172.31.47.0-255,66,262914,96,308258
13182,0.054888,172.217.24.0-255,5738,268652,96,308258
13183,0.054901,172.31.47.0-255,66,268718,96,308258
13184,0.05682,172.217.24.0-255,5738,274456,96,308258
13185,0.056834,172.31.47.0-255,66,274522,96,308258
13186,0.058737,172.217.24.0-255,5738,280260,96,308258
13187,0.058749,172.31.47.0-255,66,280326,96,308258
13188,0.060653,172.217.24.0-255,5738,286064,96,308258
13189,0.060659,172.31.47.0-255,66,286130,96,308258
13190,0.062551,172.217.24.0-255,5738,291868,96,308258
13191,0.062555,172.31.47.0-255,66,291934,96,308258
13192,0.064439,172.217.24.0-255,4320,296254,96,308258
13193,0.064444,172.31.47.0-255,66,296320,96,308258
13194,0.064458,172.217.24.0-255,1484,297804,96,308258
13195,0.066375,172.217.24.0-255,1484,299288,96,308258
13196,0.06638,172.31.47.0-255,66,299354,96,308258
13197,0.066406,172.217.24.0-255,2902,302256,96,308258
13198,0.066408,172.31.47.0-255,66,302322,96,308258
13199,0.068282,172.217.24.0-255,2902,305224,96,308258
13200,0.068287,172.31.47.0-255,66,305290,96,308258
13201,0.068315,172.217.24.0-255,2902,308192,96,308258
13202,0.068318,172.31.47.0-255,66,308258,96,308258
13203,0.0,74.125.24.0-255,153,153,96,309380
13204,2.3e-05,172.31.47.0-255,66,219,96,309380
13205,3e-05,74.125.24.0-255,1484,1703,96,309380
13206,3.4e-05,172.31.47.0-255,66,1769,96,309380
13207,3.9e-05,74.125.24.0-255,2902,4671,96,309380
13208,4.2e-05,172.31.47.0-255,66,4737,96,309380
13209,5e-05,74.125.24.0-255,7156,11893,96,309380
13210,5.2e-05,172.31.47.0-255,66,11959,96,309380
13211,5.6e-05,74.125.24.0-255,2255,14214,96,309380
13212,5.8e-05,172.31.47.0-255,66,14280,96,309380
13213,0.000142,74.125.24.0-255,1484,15764,96,309380
13214,0.000147,172.31.47.0-255,66,15830,96,309380
13215,0.000153,74.125.24.0-255,2902,18732,96,309380
13216,0.000156,172.31.47.0-255,66,18798,96,309380
13217,0.000161,74.125.24.0-255,4320,23118,96,309380
13218,0.000164,172.31.47.0-255,66,23184,96,309380
13219,0.000181,74.125.24.0-255,1484,24668,96,309380
13220,0.000184,172.31.47.0-255,66,24734,96,309380
13221,0.000201,74.125.24.0-255,4320,29054,96,309380
13222,0.000204,172.31.47.0-255,66,29120,96,309380
13223,0.000225,74.125.24.0-255,2543,31663,96,309380
13224,0.000227,172.31.47.0-255,66,31729,96,309380
13225,0.000233,74.125.24.0-255,2902,34631,96,309380
13226,0.000235,172.31.47.0-255,66,34697,96,309380
13227,0.000255,74.125.24.0-255,4320,39017,96,309380
13228,0.000258,172.31.47.0-255,66,39083,96,309380
13229,0.000269,172.31.47.0-255,66,39149,96,309380
13230,0.000453,74.125.24.0-255,1484,40633,96,309380
13231,0.000458,172.31.47.0-255,66,40699,96,309380
13232,0.000464,74.125.24.0-255,2902,43601,96,309380
13233,0.000466,172.31.47.0-255,66,43667,96,309380
13234,0.000471,74.125.24.0-255,2902,46569,96,309380
13235,0.000474,172.31.47.0-255,66,46635,96,309380
13236,0.000492,74.125.24.0-255,2902,49537,96,309380
13237,0.000495,172.31.47.0-255,66,49603,96,309380
13238,0.0005,74.125.24.0-255,4320,53923,96,309380
13239,0.000503,172.31.47.0-255,66,53989,96,309380
13240,0.00052,74.125.24.0-255,2543,56532,96,309380
13241,0.000523,172.31.47.0-255,66,56598,96,309380
13242,0.000526,74.125.24.0-255,645,57243,96,309380
13243,0.000658,74.125.24.0-255,1484,58727,96,309380
13244,0.000662,172.31.47.0-255,66,58793,96,309380
13245,0.000667,74.125.24.0-255,2902,61695,96,309380
13246,0.000669,172.31.47.0-255,66,61761,96,309380
13247,0.00068,74.125.24.0-255,2902,64663,96,309380
13248,0.000682,172.31.47.0-255,66,64729,96,309380
13249,0.000694,74.125.24.0-255,2902,67631,96,309380
13250,0.000696,172.31.47.0-255,66,67697,96,309380
13251,0.000701,74.125.24.0-255,5738,73435,96,309380
13252,0.000703,172.31.47.0-255,66,73501,96,309380
13253,0.000739,74.125.24.0-255,2902,76403,96,309380
13254,0.000742,172.31.47.0-255,66,76469,96,309380
13255,0.000772,172.31.47.0-255,66,76535,96,309380
13256,0.000777,74.125.24.0-255,3961,80496,96,309380
13257,0.000779,172.31.47.0-255,66,80562,96,309380
13258,0.000928,74.125.24.0-255,1484,82046,96,309380
13259,0.000946,74.125.24.0-255,2902,84948,96,309380
13260,0.000948,172.31.47.0-255,66,85014,96,309380
13261,0.000954,74.125.24.0-255,4320,89334,96,309380
13262,0.000955,172.31.47.0-255,66,89400,96,309380
13263,0.00096,74.125.24.0-255,4320,93720,96,309380
13264,0.000962,172.31.47.0-255,66,93786,96,309380
13265,0.00098,74.125.24.0-255,4320,98106,96,309380
13266,0.000982,172.31.47.0-255,66,98172,96,309380
13267,0.001025,172.31.47.0-255,66,98238,96,309380
13268,0.001046,74.125.24.0-255,6438,104676,96,309380
13269,0.001049,172.31.47.0-255,66,104742,96,309380
13270,0.001064,74.125.24.0-255,1484,106226,96,309380
13271,0.001068,74.125.24.0-255,2902,109128,96,309380
13272,0.00107,172.31.47.0-255,66,109194,96,309380
13273,0.001074,74.125.24.0-255,2902,112096,96,309380
13274,0.001076,172.31.47.0-255,66,112162,96,309380
13275,0.001091,74.125.24.0-255,2902,115064,96,309380
13276,0.001093,172.31.47.0-255,66,115130,96,309380
13277,0.001097,74.125.24.0-255,2902,118032,96,309380
13278,0.001099,172.31.47.0-255,66,118098,96,309380
13279,0.001132,172.31.47.0-255,66,118164,96,309380
13280,0.001142,172.31.47.0-255,66,118230,96,309380
13281,0.001144,74.125.24.0-255,766,118996,96,309380
13282,0.001171,74.125.24.0-255,1484,120480,96,309380
13283,0.001173,172.31.47.0-255,66,120546,96,309380
13284,0.001176,74.125.24.0-255,1484,122030,96,309380
13285,0.001193,74.125.24.0-255,2902,124932,96,309380
13286,0.001195,172.31.47.0-255,66,124998,96,309380
13287,0.0012,74.125.24.0-255,4320,129318,96,309380
13288,0.001202,172.31.47.0-255,66,129384,96,309380
13289,0.001219,74.125.24.0-255,5738,135122,96,309380
13290,0.001221,172.31.47.0-255,66,135188,96,309380
13291,0.001223,74.125.24.0-255,1484,136672,96,309380
13292,0.001282,172.31.47.0-255,66,136738,96,309380
13293,0.001287,74.125.24.0-255,3602,140340,96,309380
13294,0.001289,172.31.47.0-255,66,140406,96,309380
13295,0.001456,74.125.24.0-255,1484,141890,96,309380
13296,0.001479,74.125.24.0-255,2902,144792,96,309380
13297,0.001482,172.31.47.0-255,66,144858,96,309380
13298,0.001488,74.125.24.0-255,5738,150596,96,309380
13299,0.00149,172.31.47.0-255,66,150662,96,309380
13300,0.001527,172.31.47.0-255,66,150728,96,309380
13301,0.001532,74.125.24.0-255,4320,155048,96,309380
13302,0.001534,172.31.47.0-255,66,155114,96,309380
13303,0.001564,74.125.24.0-255,6438,161552,96,309380
13304,0.001566,172.31.47.0-255,66,161618,96,309380
13305,0.00193,74.125.24.0-255,1484,163102,96,309380
13306,0.001936,74.125.24.0-255,2902,166004,96,309380
13307,0.001938,172.31.47.0-255,66,166070,96,309380
13308,0.001955,74.125.24.0-255,5738,171808,96,309380
13309,0.001957,172.31.47.0-255,66,171874,96,309380
13310,0.001961,74.125.24.0-255,2902,174776,96,309380
13311,0.001963,172.31.47.0-255,66,174842,96,309380
13312,0.002001,74.125.24.0-255,5738,180580,96,309380
13313,0.002003,172.31.47.0-255,66,180646,96,309380
13314,0.002022,74.125.24.0-255,4320,184966,96,309380
13315,0.002024,172.31.47.0-255,66,185032,96,309380
13316,0.002049,172.31.47.0-255,66,185098,96,309380
13317,0.002165,74.125.24.0-255,1484,186582,96,309380
13318,0.002169,74.125.24.0-255,2902,189484,96,309380
13319,0.002174,172.31.47.0-255,66,189550,96,309380
13320,0.002189,74.125.24.0-255,5738,195288,96,309380
13321,0.002192,172.31.47.0-255,66,195354,96,309380
13322,0.002223,172.31.47.0-255,66,195420,96,309380
13323,0.002244,74.125.24.0-255,4320,199740,96,309380
13324,0.002246,172.31.47.0-255,66,199806,96,309380
13325,0.002255,172.31.47.0-255,66,199872,96,309380
13326,0.002258,74.125.24.0-255,766,200638,96,309380
13327,0.002297,74.125.24.0-255,1484,202122,96,309380
13328,0.0023,172.31.47.0-255,66,202188,96,309380
13329,0.002314,74.125.24.0-255,4320,206508,96,309380
13330,0.002316,172.31.47.0-255,66,206574,96,309380
13331,0.002319,74.125.24.0-255,1484,208058,96,309380
13332,0.002339,74.125.24.0-255,5738,213796,96,309380
13333,0.002342,172.31.47.0-255,66,213862,96,309380
13334,0.002381,172.31.47.0-255,66,213928,96,309380
13335,0.002417,74.125.24.0-255,4320,218248,96,309380
13336,0.002421,172.31.47.0-255,66,218314,96,309380
13337,0.002433,74.125.24.0-255,7156,225470,96,309380
13338,0.002436,172.31.47.0-255,66,225536,96,309380
13339,0.002444,74.125.24.0-255,3602,229138,96,309380
13340,0.002448,172.31.47.0-255,66,229204,96,309380
13341,0.004761,74.125.24.0-255,5738,234942,96,309380
13342,0.004777,172.31.47.0-255,66,235008,96,309380
13343,0.007057,74.125.24.0-255,5738,240746,96,309380
13344,0.007065,172.31.47.0-255,66,240812,96,309380
13345,0.009326,74.125.24.0-255,5738,246550,96,309380
13346,0.009332,172.31.47.0-255,66,246616,96,309380
13347,0.011619,74.125.24.0-255,5738,252354,96,309380
13348,0.011629,172.31.47.0-255,66,252420,96,309380
13349,0.013949,74.125.24.0-255,5738,258158,96,309380
13350,0.013958,172.31.47.0-255,66,258224,96,309380
13351,0.016196,74.125.24.0-255,5738,263962,96,309380
13352,0.016204,172.31.47.0-255,66,264028,96,309380
13353,0.018491,74.125.24.0-255,5738,269766,96,309380
13354,0.018499,172.31.47.0-255,66,269832,96,309380
13355,0.020768,74.125.24.0-255,5738,275570,96,309380
13356,0.020775,172.31.47.0-255,66,275636,96,309380
13357,0.023051,74.125.24.0-255,5738,281374,96,309380
13358,0.023056,172.31.47.0-255,66,281440,96,309380
13359,0.025325,74.125.24.0-255,5738,287178,96,309380
13360,0.025332,172.31.47.0-255,66,287244,96,309380
13361,0.027584,74.125.24.0-255,2902,290146,96,309380
13362,0.027589,172.31.47.0-255,66,290212,96,309380
13363,0.027608,74.125.24.0-255,2902,293114,96,309380
13364,0.02761,172.31.47.0-255,66,293180,96,309380
13365,0.028394,172.31.47.0-255,172,293352,96,309380
13366,0.028419,172.31.47.0-255,1105,294457,96,309380
13367,0.028467,172.31.47.0-255,1514,295971,96,309380
13368,0.028468,172.31.47.0-255,1306,297277,96,309380
13369,0.029838,74.125.24.0-255,2902,300179,96,309380
13370,0.029848,172.31.47.0-255,66,300245,96,309380
13371,0.029869,74.125.24.0-255,2902,303147,96,309380
13372,0.029873,172.31.47.0-255,66,303213,96,309380
13373,0.029931,104.244.42.0-255,66,303279,96,309380
13374,0.029977,104.244.42.0-255,66,303345,96,309380
13375,0.030036,104.244.42.0-255,66,303411,96,309380
13376,0.032112,74.125.24.0-255,2902,306313,96,309380
13377,0.032118,172.31.47.0-255,66,306379,96,309380
13378,0.03214,74.125.24.0-255,2764,309143,96,309380
13379,0.032142,172.31.47.0-255,66,309209,96,309380
13380,0.032296,172.31.47.0-255,105,309314,96,309380
13381,0.03454,74.125.24.0-255,66,309380,96,309380
13382,0.0,172.31.47.0-255,236,236,96,1560
13383,2.5e-05,172.31.47.0-255,368,604,96,1560
13384,0.001102,74.125.24.0-255,630,1234,96,1560
13385,0.002313,74.125.24.0-255,97,1331,96,1560
13386,0.002326,172.31.47.0-255,66,1397,96,1560
13387,0.011109,172.31.47.0-255,97,1494,96,1560
13388,0.019038,74.125.24.0-255,66,1560,96,1560
13389,0.0,172.253.118.0-255,153,153,96,268554
13390,7.5e-05,172.31.47.0-255,66,219,96,268554
13391,8.1e-05,172.253.118.0-255,1484,1703,96,268554
13392,8.5e-05,172.31.47.0-255,66,1769,96,268554
13393,9e-05,172.253.118.0-255,2902,4671,96,268554
13394,9.8e-05,172.31.47.0-255,66,4737,96,268554
13395,0.000104,172.253.118.0-255,4320,9057,96,268554
13396,0.000106,172.31.47.0-255,66,9123,96,268554
13397,0.000112,172.253.118.0-255,4889,14012,96,268554
13398,0.000114,172.31.47.0-255,66,14078,96,268554
13399,0.000171,172.253.118.0-255,1484,15562,96,268554
13400,0.000175,172.31.47.0-255,66,15628,96,268554
13401,0.000188,172.253.118.0-255,2902,18530,96,268554
13402,0.000194,172.31.47.0-255,66,18596,96,268554
13403,0.000201,172.253.118.0-255,5738,24334,96,268554
13404,0.000204,172.31.47.0-255,66,24400,96,268554
13405,0.000243,172.253.118.0-255,6797,31197,96,268554
13406,0.000248,172.31.47.0-255,66,31263,96,268554
13407,0.000337,172.253.118.0-255,1484,32747,96,268554
13408,0.000341,172.31.47.0-255,66,32813,96,268554
13409,0.000371,172.253.118.0-255,2902,35715,96,268554
13410,0.000376,172.253.118.0-255,5738,41453,96,268554
13411,0.000376,172.31.47.0-255,66,41519,96,268554
13412,0.000381,172.31.47.0-255,66,41585,96,268554
13413,0.000395,172.253.118.0-255,1484,43069,96,268554
13414,0.000398,172.31.47.0-255,66,43135,96,268554
13415,0.00043,172.253.118.0-255,5379,48514,96,268554
13416,0.000434,172.31.47.0-255,66,48580,96,268554
13417,0.000439,172.253.118.0-255,2902,51482,96,268554
13418,0.000442,172.31.47.0-255,66,51548,96,268554
13419,0.000462,172.253.118.0-255,4320,55868,96,268554
13420,0.000471,172.31.47.0-255,66,55934,96,268554
13421,0.000482,172.31.47.0-255,66,56000,96,268554
13422,0.000485,172.253.118.0-255,1125,57125,96,268554
13423,0.000486,172.31.47.0-255,66,57191,96,268554
13424,0.00165,172.253.118.0-255,648,57839,96,268554
13425,0.001656,172.31.47.0-255,66,57905,96,268554
13426,0.001681,172.253.118.0-255,1484,59389,96,268554
13427,0.001684,172.31.47.0-255,66,59455,96,268554
13428,0.001687,172.253.118.0-255,1484,60939,96,268554
13429,0.001688,172.31.47.0-255,66,61005,96,268554
13430,0.001709,172.253.118.0-255,2902,63907,96,268554
13431,0.001711,172.31.47.0-255,66,63973,96,268554
13432,0.001731,172.31.47.0-255,66,64039,96,268554
13433,0.001756,172.253.118.0-255,1484,65523,96,268554
13434,0.001757,172.31.47.0-255,66,65589,96,268554
13435,0.001763,172.253.118.0-255,5738,71327,96,268554
13436,0.001764,172.31.47.0-255,66,71393,96,268554
13437,0.001767,172.253.118.0-255,1484,72877,96,268554
13438,0.001768,172.31.47.0-255,66,72943,96,268554
13439,0.001802,172.31.47.0-255,66,73009,96,268554
13440,0.001806,172.253.118.0-255,4320,77329,96,268554
13441,0.001808,172.31.47.0-255,66,77395,96,268554
13442,0.00183,172.31.47.0-255,66,77461,96,268554
13443,0.001838,172.253.118.0-255,3410,80871,96,268554
13444,0.00184,172.31.47.0-255,66,80937,96,268554
13445,0.002171,172.253.118.0-255,1484,82421,96,268554
13446,0.002173,172.31.47.0-255,66,82487,96,268554
13447,0.002176,172.253.118.0-255,1484,83971,96,268554
13448,0.002178,172.31.47.0-255,66,84037,96,268554
13449,0.002196,172.253.118.0-255,1484,85521,96,268554
13450,0.002197,172.31.47.0-255,66,85587,96,268554
13451,0.002206,172.253.118.0-255,5738,91325,96,268554
13452,0.002208,172.31.47.0-255,66,91391,96,268554
13453,0.002239,172.31.47.0-255,66,91457,96,268554
13454,0.002291,172.31.47.0-255,66,91523,96,268554
13455,0.004525,172.253.118.0-255,4320,95843,96,268554
13456,0.004528,172.31.47.0-255,66,95909,96,268554
13457,0.004537,172.253.118.0-255,1484,97393,96,268554
13458,0.00676,172.253.118.0-255,4320,101713,96,268554
13459,0.006768,172.31.47.0-255,66,101779,96,268554
13460,0.009014,172.253.118.0-255,5738,107517,96,268554
13461,0.00902,172.31.47.0-255,66,107583,96,268554
13462,0.011273,172.253.118.0-255,5738,113321,96,268554
13463,0.011282,172.31.47.0-255,66,113387,96,268554
13464,0.013526,172.253.118.0-255,5738,119125,96,268554
13465,0.013535,172.31.47.0-255,66,119191,96,268554
13466,0.01578,172.253.118.0-255,5738,124929,96,268554
13467,0.015786,172.31.47.0-255,66,124995,96,268554
13468,0.018036,172.253.118.0-255,5738,130733,96,268554
13469,0.018044,172.31.47.0-255,66,130799,96,268554
13470,0.020292,172.253.118.0-255,5738,136537,96,268554
13471,0.020298,172.31.47.0-255,66,136603,96,268554
13472,0.022547,172.253.118.0-255,5738,142341,96,268554
13473,0.022553,172.31.47.0-255,66,142407,96,268554
13474,0.024789,172.253.118.0-255,5738,148145,96,268554
13475,0.024796,172.31.47.0-255,66,148211,96,268554
13476,0.025345,172.31.47.0-255,172,148383,96,268554
13477,0.02537,172.31.47.0-255,1110,149493,96,268554
13478,0.025408,172.31.47.0-255,1514,151007,96,268554
13479,0.02541,172.31.47.0-255,1301,152308,96,268554
13480,0.026869,104.244.42.0-255,66,152374,96,268554
13481,0.026897,104.244.42.0-255,66,152440,96,268554
13482,0.026953,104.244.42.0-255,66,152506,96,268554
13483,0.027019,172.253.118.0-255,1484,153990,96,268554
13484,0.027042,172.253.118.0-255,4320,158310,96,268554
13485,0.027046,172.31.47.0-255,66,158376,96,268554
13486,0.029274,172.253.118.0-255,1484,159860,96,268554
13487,0.029304,172.253.118.0-255,4320,164180,96,268554
13488,0.029309,172.31.47.0-255,66,164246,96,268554
13489,0.031547,172.253.118.0-255,5738,169984,96,268554
13490,0.031552,172.31.47.0-255,66,170050,96,268554
13491,0.033784,172.253.118.0-255,5738,175788,96,268554
13492,0.033788,172.31.47.0-255,66,175854,96,268554
13493,0.036038,172.253.118.0-255,5738,181592,96,268554
13494,0.036043,172.31.47.0-255,66,181658,96,268554
13495,0.038279,172.253.118.0-255,5738,187396,96,268554
13496,0.038283,172.31.47.0-255,66,187462,96,268554
13497,0.040538,172.253.118.0-255,5738,193200,96,268554
13498,0.040544,172.31.47.0-255,66,193266,96,268554
13499,0.042774,172.253.118.0-255,5738,199004,96,268554
13500,0.042781,172.31.47.0-255,66,199070,96,268554
13501,0.045025,172.253.118.0-255,5738,204808,96,268554
13502,0.04503,172.31.47.0-255,66,204874,96,268554
13503,0.047278,172.253.118.0-255,4320,209194,96,268554
13504,0.047283,172.31.47.0-255,66,209260,96,268554
13505,0.04732,172.253.118.0-255,1484,210744,96,268554
13506,0.049532,172.253.118.0-255,4320,215064,96,268554
13507,0.049537,172.31.47.0-255,66,215130,96,268554
13508,0.0518,172.253.118.0-255,2902,218032,96,268554
13509,0.051804,172.31.47.0-255,66,218098,96,268554
13510,0.051831,172.253.118.0-255,2902,221000,96,268554
13511,0.051834,172.31.47.0-255,66,221066,96,268554
13512,0.054038,172.253.118.0-255,2902,223968,96,268554
13513,0.054043,172.31.47.0-255,66,224034,96,268554
13514,0.054068,172.253.118.0-255,2902,226936,96,268554
13515,0.05407,172.31.47.0-255,66,227002,96,268554
13516,0.056267,172.253.118.0-255,2902,229904,96,268554
13517,0.056273,172.31.47.0-255,66,229970,96,268554
13518,0.056304,172.253.118.0-255,2902,232872,96,268554
13519,0.056307,172.31.47.0-255,66,232938,96,268554
13520,0.05851,172.253.118.0-255,2902,235840,96,268554
13521,0.058514,172.31.47.0-255,66,235906,96,268554
13522,0.058549,172.253.118.0-255,2902,238808,96,268554
13523,0.058552,172.31.47.0-255,66,238874,96,268554
13524,0.060758,172.253.118.0-255,2902,241776,96,268554
13525,0.060763,172.31.47.0-255,66,241842,96,268554
13526,0.060798,172.253.118.0-255,2902,244744,96,268554
13527,0.060802,172.31.47.0-255,66,244810,96,268554
13528,0.062992,172.253.118.0-255,2902,247712,96,268554
13529,0.062997,172.31.47.0-255,66,247778,96,268554
13530,0.063042,172.253.118.0-255,2902,250680,96,268554
13531,0.063045,172.31.47.0-255,66,250746,96,268554
13532,0.065233,172.253.118.0-255,2902,253648,96,268554
13533,0.065238,172.31.47.0-255,66,253714,96,268554
13534,0.06527,172.253.118.0-255,2902,256616,96,268554
13535,0.065273,172.31.47.0-255,66,256682,96,268554
13536,0.067481,172.253.118.0-255,2902,259584,96,268554
13537,0.067486,172.31.47.0-255,66,259650,96,268554
13538,0.067518,172.253.118.0-255,2902,262552,96,268554
13539,0.067521,172.31.47.0-255,66,262618,96,268554
13540,0.069749,172.253.118.0-255,2902,265520,96,268554
13541,0.069755,172.31.47.0-255,66,265586,96,268554
13542,0.069791,172.253.118.0-255,2902,268488,96,268554
13543,0.069794,172.31.47.0-255,66,268554,96,268554
13544,0.0,172.31.47.0-255,105,105,96,276
13545,0.001802,157.240.13.0-255,105,210,96,276
13546,0.001814,172.31.47.0-255,66,276,96,276
13547,0.0,74.125.24.0-255,153,153,96,298163
13548,3.1e-05,172.31.47.0-255,66,219,96,298163
13549,3.7e-05,74.125.24.0-255,1484,1703,96,298163
13550,4e-05,172.31.47.0-255,66,1769,96,298163
13551,4.5e-05,74.125.24.0-255,2902,4671,96,298163
13552,4.7e-05,172.31.47.0-255,66,4737,96,298163
13553,5.1e-05,74.125.24.0-255,2902,7639,96,298163
13554,5.3e-05,172.31.47.0-255,66,7705,96,298163
13555,7.3e-05,74.125.24.0-255,1484,9189,96,298163
13556,7.5e-05,172.31.47.0-255,66,9255,96,298163
13557,0.0001,74.125.24.0-255,2902,12157,96,298163
13558,0.000102,172.31.47.0-255,66,12223,96,298163
13559,0.000121,74.125.24.0-255,2101,14324,96,298163
13560,0.000123,172.31.47.0-255,66,14390,96,298163
13561,0.000234,74.125.24.0-255,1484,15874,96,298163
13562,0.000238,172.31.47.0-255,66,15940,96,298163
13563,0.000242,74.125.24.0-255,2902,18842,96,298163
13564,0.000244,172.31.47.0-255,66,18908,96,298163
13565,0.000259,74.125.24.0-255,5738,24646,96,298163
13566,0.000263,172.31.47.0-255,66,24712,96,298163
13567,0.00032,74.125.24.0-255,5738,30450,96,298163
13568,0.000324,172.31.47.0-255,66,30516,96,298163
13569,0.000347,74.125.24.0-255,1484,32000,96,298163
13570,0.000349,172.31.47.0-255,66,32066,96,298163
13571,0.000353,172.31.47.0-255,66,32132,96,298163
13572,0.000362,74.125.24.0-255,4320,36452,96,298163
13573,0.000364,172.31.47.0-255,66,36518,96,298163
13574,0.00039,74.125.24.0-255,3961,40479,96,298163
13575,0.000393,172.31.47.0-255,66,40545,96,298163
13576,0.000404,172.31.47.0-255,66,40611,96,298163
13577,0.00041,74.125.24.0-255,5738,46349,96,298163
13578,0.000412,172.31.47.0-255,66,46415,96,298163
13579,0.000438,74.125.24.0-255,1399,47814,96,298163
13580,0.000441,172.31.47.0-255,66,47880,96,298163
13581,0.000521,74.125.24.0-255,131,48011,96,298163
13582,0.000524,172.31.47.0-255,66,48077,96,298163
13583,0.000711,74.125.24.0-255,1484,49561,96,298163
13584,0.000715,172.31.47.0-255,66,49627,96,298163
13585,0.000719,74.125.24.0-255,1484,51111,96,298163
13586,0.000721,172.31.47.0-255,66,51177,96,298163
13587,0.000734,74.125.24.0-255,1484,52661,96,298163
13588,0.000737,172.31.47.0-255,66,52727,96,298163
13589,0.000744,74.125.24.0-255,5738,58465,96,298163
13590,0.000746,172.31.47.0-255,66,58531,96,298163
13591,0.000767,74.125.24.0-255,2902,61433,96,298163
13592,0.00077,172.31.47.0-255,66,61499,96,298163
13593,0.000804,74.125.24.0-255,2902,64401,96,298163
13594,0.000807,172.31.47.0-255,66,64467,96,298163
13595,0.000827,74.125.24.0-255,3961,68428,96,298163
13596,0.000829,172.31.47.0-255,66,68494,96,298163
13597,0.000837,74.125.24.0-255,7156,75650,96,298163
13598,0.000839,172.31.47.0-255,66,75716,96,298163
13599,0.000865,74.125.24.0-255,7056,82772,96,298163
13600,0.000868,172.31.47.0-255,66,82838,96,298163
13601,0.001118,74.125.24.0-255,1484,84322,96,298163
13602,0.001128,74.125.24.0-255,2902,87224,96,298163
13603,0.001132,172.31.47.0-255,66,87290,96,298163
13604,0.001139,74.125.24.0-255,2902,90192,96,298163
13605,0.001142,172.31.47.0-255,66,90258,96,298163
13606,0.001156,74.125.24.0-255,2902,93160,96,298163
13607,0.001159,172.31.47.0-255,66,93226,96,298163
13608,0.001171,172.31.47.0-255,66,93292,96,298163
13609,0.001194,74.125.24.0-255,2902,96194,96,298163
13610,0.001197,172.31.47.0-255,66,96260,96,298163
13611,0.001249,74.125.24.0-255,4320,100580,96,298163
13612,0.001252,172.31.47.0-255,66,100646,96,298163
13613,0.001274,74.125.24.0-255,6438,107084,96,298163
13614,0.001277,172.31.47.0-255,66,107150,96,298163
13615,0.003292,74.125.24.0-255,5738,112888,96,298163
13616,0.003298,172.31.47.0-255,66,112954,96,298163
13617,0.005322,74.125.24.0-255,5738,118692,96,298163
13618,0.005325,172.31.47.0-255,66,118758,96,298163
13619,0.00735,74.125.24.0-255,5738,124496,96,298163
13620,0.007357,172.31.47.0-255,66,124562,96,298163
13621,0.00937,74.125.24.0-255,5738,130300,96,298163
13622,0.009377,172.31.47.0-255,66,130366,96,298163
13623,0.011416,74.125.24.0-255,5738,136104,96,298163
13624,0.011423,172.31.47.0-255,66,136170,96,298163
13625,0.013442,74.125.24.0-255,5738,141908,96,298163
13626,0.013449,172.31.47.0-255,66,141974,96,298163
13627,0.015469,74.125.24.0-255,5738,147712,96,298163
13628,0.01548,172.31.47.0-255,66,147778,96,298163
13629,0.017534,74.125.24.0-255,5738,153516,96,298163
13630,0.017546,172.31.47.0-255,66,153582,96,298163
13631,0.019547,74.125.24.0-255,5738,159320,96,298163
13632,0.019555,172.31.47.0-255,66,159386,96,298163
13633,0.021636,74.125.24.0-255,5738,165124,96,298163
13634,0.021643,172.31.47.0-255,66,165190,96,298163
13635,0.02366,74.125.24.0-255,4320,169510,96,298163
13636,0.023667,172.31.47.0-255,66,169576,96,298163
13637,0.023698,74.125.24.0-255,1484,171060,96,298163
13638,0.025686,74.125.24.0-255,2902,173962,96,298163
13639,0.025693,172.31.47.0-255,66,174028,96,298163
13640,0.025896,172.31.47.0-255,172,174200,96,298163
13641,0.025938,172.31.47.0-255,1105,175305,96,298163
13642,0.026048,172.31.47.0-255,1514,176819,96,298163
13643,0.02605,172.31.47.0-255,1306,178125,96,298163
13644,0.027454,104.244.42.0-255,66,178191,96,298163
13645,0.027497,104.244.42.0-255,66,178257,96,298163
13646,0.027596,104.244.42.0-255,66,178323,96,298163
13647,0.027692,74.125.24.0-255,1484,179807,96,298163
13648,0.027719,74.125.24.0-255,4320,184127,96,298163
13649,0.027723,172.31.47.0-255,66,184193,96,298163
13650,0.029803,74.125.24.0-255,5738,189931,96,298163
13651,0.029808,172.31.47.0-255,66,189997,96,298163
13652,0.031788,74.125.24.0-255,2902,192899,96,298163
13653,0.031792,172.31.47.0-255,66,192965,96,298163
13654,0.031816,74.125.24.0-255,2902,195867,96,298163
13655,0.031819,172.31.47.0-255,66,195933,96,298163
13656,0.033835,74.125.24.0-255,5738,201671,96,298163
13657,0.033839,172.31.47.0-255,66,201737,96,298163
13658,0.035863,74.125.24.0-255,5738,207475,96,298163
13659,0.03587,172.31.47.0-255,66,207541,96,298163
13660,0.037902,74.125.24.0-255,5738,213279,96,298163
13661,0.037907,172.31.47.0-255,66,213345,96,298163
13662,0.039945,74.125.24.0-255,4320,217665,96,298163
13663,0.03995,172.31.47.0-255,66,217731,96,298163
13664,0.039982,74.125.24.0-255,1484,219215,96,298163
13665,0.041999,74.125.24.0-255,4320,223535,96,298163
13666,0.042005,172.31.47.0-255,66,223601,96,298163
13667,0.044012,74.125.24.0-255,5738,229339,96,298163
13668,0.044018,172.31.47.0-255,66,229405,96,298163
13669,0.046008,74.125.24.0-255,2902,232307,96,298163
13670,0.046012,172.31.47.0-255,66,232373,96,298163
13671,0.046044,74.125.24.0-255,2902,235275,96,298163
13672,0.046047,172.31.47.0-255,66,235341,96,298163
13673,0.048029,74.125.24.0-255,1484,236825,96,298163
13674,0.048055,74.125.24.0-255,4320,241145,96,298163
13675,0.048059,172.31.47.0-255,66,241211,96,298163
13676,0.050082,74.125.24.0-255,5738,246949,96,298163
13677,0.050087,172.31.47.0-255,66,247015,96,298163
13678,0.052118,74.125.24.0-255,2902,249917,96,298163
13679,0.052123,172.31.47.0-255,66,249983,96,298163
13680,0.052143,74.125.24.0-255,2902,252885,96,298163
13681,0.052145,172.31.47.0-255,66,252951,96,298163
13682,0.054188,74.125.24.0-255,5738,258689,96,298163
13683,0.054194,172.31.47.0-255,66,258755,96,298163
13684,0.056236,74.125.24.0-255,4320,263075,96,298163
13685,0.056242,172.31.47.0-255,66,263141,96,298163
13686,0.056276,74.125.24.0-255,1484,264625,96,298163
13687,0.05828,74.125.24.0-255,4320,268945,96,298163
13688,0.058285,172.31.47.0-255,66,269011,96,298163
13689,0.060352,74.125.24.0-255,5738,274749,96,298163
13690,0.060357,172.31.47.0-255,66,274815,96,298163
13691,0.062358,74.125.24.0-255,5738,280553,96,298163
13692,0.062363,172.31.47.0-255,66,280619,96,298163
13693,0.064407,74.125.24.0-255,5738,286357,96,298163
13694,0.064412,172.31.47.0-255,66,286423,96,298163
13695,0.066448,74.125.24.0-255,5738,292161,96,298163
13696,0.066451,172.31.47.0-255,66,292227,96,298163
13697,0.068458,74.125.24.0-255,2902,295129,96,298163
13698,0.068465,172.31.47.0-255,66,295195,96,298163
13699,0.068486,74.125.24.0-255,2902,298097,96,298163
13700,0.068489,172.31.47.0-255,66,298163,96,298163
13701,0.0,172.31.47.0-255,105,105,96,342
13702,0.002014,157.240.13.0-255,66,171,96,342
13703,0.002067,157.240.13.0-255,105,276,96,342
13704,0.002071,172.31.47.0-255,66,342,96,342
13705,0.0,74.125.200.0-255,153,153,96,295285
13706,1.9e-05,172.31.47.0-255,66,219,96,295285
13707,2.5e-05,74.125.200.0-255,1484,1703,96,295285
13708,2.9e-05,172.31.47.0-255,66,1769,96,295285
13709,3.4e-05,74.125.200.0-255,2902,4671,96,295285
13710,3.7e-05,172.31.47.0-255,66,4737,96,295285
13711,3.9e-05,74.125.200.0-255,1484,6221,96,295285
13712,4.1e-05,172.31.47.0-255,66,6287,96,295285
13713,4.6e-05,74.125.200.0-255,2902,9189,96,295285
13714,4.9e-05,172.31.47.0-255,66,9255,96,295285
13715,8e-05,74.125.200.0-255,1484,10739,96,295285
13716,8.2e-05,172.31.47.0-255,66,10805,96,295285
13717,0.000101,74.125.200.0-255,3591,14396,96,295285
13718,0.000103,172.31.47.0-255,66,14462,96,295285
13719,0.000194,74.125.200.0-255,1484,15946,96,295285
13720,0.000197,172.31.47.0-255,66,16012,96,295285
13721,0.000236,74.125.200.0-255,2902,18914,96,295285
13722,0.000239,172.31.47.0-255,66,18980,96,295285
13723,0.000245,74.125.200.0-255,5738,24718,96,295285
13724,0.000247,172.31.47.0-255,66,24784,96,295285
13725,0.000251,74.125.200.0-255,2902,27686,96,295285
13726,0.000253,172.31.47.0-255,66,27752,96,295285
13727,0.00028,74.125.200.0-255,1484,29236,96,295285
13728,0.000282,172.31.47.0-255,66,29302,96,295285
13729,0.000299,74.125.200.0-255,1484,30786,96,295285
13730,0.000301,172.31.47.0-255,66,30852,96,295285
13731,0.000328,172.31.47.0-255,66,30918,96,295285
13732,0.000339,172.31.47.0-255,66,30984,96,295285
13733,0.000345,74.125.200.0-255,5738,36722,96,295285
13734,0.000347,172.31.47.0-255,66,36788,96,295285
13735,0.000349,74.125.200.0-255,1484,38272,96,295285
13736,0.000369,74.125.200.0-255,5738,44010,96,295285
13737,0.000385,74.125.200.0-255,2184,46194,96,295285
13738,0.000417,74.125.200.0-255,442,46636,96,295285
13739,0.000467,74.125.200.0-255,332,46968,96,295285
13740,0.000547,172.31.47.0-255,66,47034,96,295285
13741,0.000669,74.125.200.0-255,1484,48518,96,295285
13742,0.000681,74.125.200.0-255,1484,50002,96,295285
13743,0.000696,74.125.200.0-255,1484,51486,96,295285
13744,0.000701,74.125.200.0-255,2902,54388,96,295285
13745,0.000707,172.31.47.0-255,66,54454,96,295285
13746,0.000715,74.125.200.0-255,1484,55938,96,295285
13747,0.000752,74.125.200.0-255,5738,61676,96,295285
13748,0.000763,74.125.200.0-255,2902,64578,96,295285
13749,0.000773,172.31.47.0-255,66,64644,96,295285
13750,0.000786,74.125.200.0-255,5738,70382,96,295285
13751,0.000806,74.125.200.0-255,4320,74702,96,295285
13752,0.000809,74.125.200.0-255,1484,76186,96,295285
13753,0.000811,172.31.47.0-255,66,76252,96,295285
13754,0.000816,172.31.47.0-255,66,76318,96,295285
13755,0.000855,74.125.200.0-255,1484,77802,96,295285
13756,0.000877,74.125.200.0-255,3602,81404,96,295285
13757,0.000895,172.31.47.0-255,66,81470,96,295285
13758,0.001062,74.125.200.0-255,1484,82954,96,295285
13759,0.001074,74.125.200.0-255,1484,84438,96,295285
13760,0.001076,172.31.47.0-255,66,84504,96,295285
13761,0.001093,74.125.200.0-255,1484,85988,96,295285
13762,0.001099,74.125.200.0-255,4320,90308,96,295285
13763,0.001112,74.125.200.0-255,4320,94628,96,295285
13764,0.001116,172.31.47.0-255,66,94694,96,295285
13765,0.00113,74.125.200.0-255,1484,96178,96,295285
13766,0.00116,74.125.200.0-255,2902,99080,96,295285
13767,0.001166,172.31.47.0-255,66,99146,96,295285
13768,0.001203,74.125.200.0-255,2902,102048,96,295285
13769,0.001214,172.31.47.0-255,66,102114,96,295285
13770,0.001222,74.125.200.0-255,2184,104298,96,295285
13771,0.001226,172.31.47.0-255,66,104364,96,295285
13772,0.002074,74.125.200.0-255,1484,105848,96,295285
13773,0.002081,172.31.47.0-255,66,105914,96,295285
13774,0.002089,74.125.200.0-255,2902,108816,96,295285
13775,0.002103,74.125.200.0-255,4320,113136,96,295285
13776,0.002137,74.125.200.0-255,5738,118874,96,295285
13777,0.002141,74.125.200.0-255,2902,121776,96,295285
13778,0.002166,74.125.200.0-255,2902,124678,96,295285
13779,0.002177,74.125.200.0-255,1484,126162,96,295285
13780,0.002207,74.125.200.0-255,3602,129764,96,295285
13781,0.004245,172.31.47.0-255,66,129830,96,295285
13782,0.006545,74.125.200.0-255,4320,134150,96,295285
13783,0.00655,172.31.47.0-255,66,134216,96,295285
13784,0.006564,74.125.200.0-255,1484,135700,96,295285
13785,0.008846,74.125.200.0-255,4320,140020,96,295285
13786,0.008853,172.31.47.0-255,66,140086,96,295285
13787,0.011157,74.125.200.0-255,5738,145824,96,295285
13788,0.011183,172.31.47.0-255,66,145890,96,295285
13789,0.013488,74.125.200.0-255,5738,151628,96,295285
13790,0.013496,172.31.47.0-255,66,151694,96,295285
13791,0.015803,74.125.200.0-255,5738,157432,96,295285
13792,0.015809,172.31.47.0-255,66,157498,96,295285
13793,0.018113,74.125.200.0-255,5738,163236,96,295285
13794,0.018119,172.31.47.0-255,66,163302,96,295285
13795,0.02042,74.125.200.0-255,5738,169040,96,295285
13796,0.020426,172.31.47.0-255,66,169106,96,295285
13797,0.022752,74.125.200.0-255,5738,174844,96,295285
13798,0.022759,172.31.47.0-255,66,174910,96,295285
13799,0.02506,74.125.200.0-255,5738,180648,96,295285
13800,0.025067,172.31.47.0-255,66,180714,96,295285
13801,0.027205,172.31.47.0-255,172,180886,96,295285
13802,0.027232,172.31.47.0-255,1109,181995,96,295285
13803,0.02728,172.31.47.0-255,1514,183509,96,295285
13804,0.027282,172.31.47.0-255,1302,184811,96,295285
13805,0.02736,74.125.200.0-255,5738,190549,96,295285
13806,0.027365,172.31.47.0-255,66,190615,96,295285
13807,0.02876,104.244.42.0-255,66,190681,96,295285
13808,0.028803,104.244.42.0-255,66,190747,96,295285
13809,0.028857,104.244.42.0-255,66,190813,96,295285
13810,0.029664,74.125.200.0-255,5738,196551,96,295285
13811,0.02967,172.31.47.0-255,66,196617,96,295285
13812,0.031981,74.125.200.0-255,5738,202355,96,295285
13813,0.03199,172.31.47.0-255,66,202421,96,295285
13814,0.034308,74.125.200.0-255,5738,208159,96,295285
13815,0.034313,172.31.47.0-255,66,208225,96,295285
13816,0.03661,74.125.200.0-255,5738,213963,96,295285
13817,0.036616,172.31.47.0-255,66,214029,96,295285
13818,0.038912,74.125.200.0-255,5738,219767,96,295285
13819,0.038918,172.31.47.0-255,66,219833,96,295285
13820,0.041205,74.125.200.0-255,5738,225571,96,295285
13821,0.04121,172.31.47.0-255,66,225637,96,295285
13822,0.043508,74.125.200.0-255,5738,231375,96,295285
13823,0.043516,172.31.47.0-255,66,231441,96,295285
13824,0.045838,74.125.200.0-255,5738,237179,96,295285
13825,0.045845,172.31.47.0-255,66,237245,96,295285
13826,0.048148,74.125.200.0-255,5738,242983,96,295285
13827,0.048156,172.31.47.0-255,66,243049,96,295285
13828,0.050455,74.125.200.0-255,5738,248787,96,295285
13829,0.05046,172.31.47.0-255,66,248853,96,295285
13830,0.05277,74.125.200.0-255,5738,254591,96,295285
13831,0.052776,172.31.47.0-255,66,254657,96,295285
13832,0.055084,74.125.200.0-255,5738,260395,96,295285
13833,0.055092,172.31.47.0-255,66,260461,96,295285
13834,0.057378,74.125.200.0-255,5738,266199,96,295285
13835,0.057385,172.31.47.0-255,66,266265,96,295285
13836,0.059702,74.125.200.0-255,5738,272003,96,295285
13837,0.059709,172.31.47.0-255,66,272069,96,295285
13838,0.062021,74.125.200.0-255,5738,277807,96,295285
13839,0.062027,172.31.47.0-255,66,277873,96,295285
13840,0.064337,74.125.200.0-255,5738,283611,96,295285
13841,0.064345,172.31.47.0-255,66,283677,96,295285
13842,0.066687,74.125.200.0-255,5738,289415,96,295285
13843,0.066693,172.31.47.0-255,66,289481,96,295285
13844,0.069014,74.125.200.0-255,5738,295219,96,295285
13845,0.06902,172.31.47.0-255,66,295285,96,295285
13846,0.0,172.217.160.0-255,153,153,96,342589
13847,3e-05,172.31.47.0-255,66,219,96,342589
13848,3.7e-05,172.217.160.0-255,1484,1703,96,342589
13849,4.1e-05,172.31.47.0-255,66,1769,96,342589
13850,4.6e-05,172.217.160.0-255,2902,4671,96,342589
13851,4.9e-05,172.31.47.0-255,66,4737,96,342589
13852,7.9e-05,172.217.160.0-255,4320,9057,96,342589
13853,8.2e-05,172.31.47.0-255,66,9123,96,342589
13854,0.000103,172.217.160.0-255,2902,12025,96,342589
13855,0.000105,172.31.47.0-255,66,12091,96,342589
13856,0.000109,172.217.160.0-255,2029,14120,96,342589
13857,0.000112,172.31.47.0-255,66,14186,96,342589
13858,0.000116,172.217.160.0-255,2902,17088,96,342589
13859,0.000118,172.31.47.0-255,66,17154,96,342589
13860,0.000122,172.217.160.0-255,2902,20056,96,342589
13861,0.000124,172.31.47.0-255,66,20122,96,342589
13862,0.000127,172.217.160.0-255,2902,23024,96,342589
13863,0.00013,172.31.47.0-255,66,23090,96,342589
13864,0.000142,172.217.160.0-255,1484,24574,96,342589
13865,0.000144,172.31.47.0-255,66,24640,96,342589
13866,0.000165,172.217.160.0-255,1484,26124,96,342589
13867,0.000168,172.31.47.0-255,66,26190,96,342589
13868,0.000188,172.217.160.0-255,5379,31569,96,342589
13869,0.000191,172.31.47.0-255,66,31635,96,342589
13870,0.000227,172.217.160.0-255,2902,34537,96,342589
13871,0.00023,172.31.47.0-255,66,34603,96,342589
13872,0.000245,172.217.160.0-255,1484,36087,96,342589
13873,0.000247,172.31.47.0-255,66,36153,96,342589
13874,0.000253,172.217.160.0-255,5738,41891,96,342589
13875,0.000256,172.31.47.0-255,66,41957,96,342589
13876,0.000274,172.217.160.0-255,2902,44859,96,342589
13877,0.000277,172.31.47.0-255,66,44925,96,342589
13878,0.000303,172.31.47.0-255,66,44991,96,342589
13879,0.000315,172.31.47.0-255,66,45057,96,342589
13880,0.000318,172.217.160.0-255,375,45432,96,342589
13881,0.000635,172.217.160.0-255,100,45532,96,342589
13882,0.000679,172.217.160.0-255,365,45897,96,342589
13883,0.000779,172.31.47.0-255,66,45963,96,342589
13884,0.000929,172.217.160.0-255,1484,47447,96,342589
13885,0.000939,172.217.160.0-255,2902,50349,96,342589
13886,0.000943,172.31.47.0-255,66,50415,96,342589
13887,0.00095,172.217.160.0-255,5738,56153,96,342589
13888,0.000953,172.31.47.0-255,66,56219,96,342589
13889,0.000979,172.217.160.0-255,2902,59121,96,342589
13890,0.000982,172.31.47.0-255,66,59187,96,342589
13891,0.001011,172.31.47.0-255,66,59253,96,342589
13892,0.001045,172.31.47.0-255,66,59319,96,342589
13893,0.001272,172.217.160.0-255,1484,60803,96,342589
13894,0.001302,172.217.160.0-255,1484,62287,96,342589
13895,0.001306,172.31.47.0-255,66,62353,96,342589
13896,0.001312,172.217.160.0-255,2902,65255,96,342589
13897,0.001314,172.31.47.0-255,66,65321,96,342589
13898,0.001319,172.217.160.0-255,2902,68223,96,342589
13899,0.001322,172.31.47.0-255,66,68289,96,342589
13900,0.001343,172.217.160.0-255,2902,71191,96,342589
13901,0.001345,172.31.47.0-255,66,71257,96,342589
13902,0.001353,172.217.160.0-255,7156,78413,96,342589
13903,0.001355,172.31.47.0-255,66,78479,96,342589
13904,0.00137,172.217.160.0-255,2902,81381,96,342589
13905,0.001372,172.31.47.0-255,66,81447,96,342589
13906,0.001398,172.217.160.0-255,5738,87185,96,342589
13907,0.001401,172.31.47.0-255,66,87251,96,342589
13908,0.001418,172.217.160.0-255,1484,88735,96,342589
13909,0.001458,172.217.160.0-255,2902,91637,96,342589
13910,0.001462,172.31.47.0-255,66,91703,96,342589
13911,0.001497,172.217.160.0-255,2184,93887,96,342589
13912,0.0015,172.31.47.0-255,66,93953,96,342589
13913,0.00152,172.217.160.0-255,1484,95437,96,342589
13914,0.001536,172.217.160.0-255,1484,96921,96,342589
13915,0.001539,172.31.47.0-255,66,96987,96,342589
13916,0.001543,172.217.160.0-255,2902,99889,96,342589
13917,0.001546,172.31.47.0-255,66,99955,96,342589
13918,0.001554,172.217.160.0-255,7156,107111,96,342589
13919,0.001556,172.31.47.0-255,66,107177,96,342589
13920,0.001572,172.31.47.0-255,66,107243,96,342589
13921,0.001601,172.217.160.0-255,2902,110145,96,342589
13922,0.001604,172.31.47.0-255,66,110211,96,342589
13923,0.00161,172.217.160.0-255,5020,115231,96,342589
13924,0.001613,172.31.47.0-255,66,115297,96,342589
13925,0.001671,172.31.47.0-255,66,115363,96,342589
13926,0.001682,172.217.160.0-255,1484,116847,96,342589
13927,0.001694,172.31.47.0-255,66,116913,96,342589
13928,0.003333,172.217.160.0-255,5738,122651,96,342589
13929,0.003339,172.31.47.0-255,66,122717,96,342589
13930,0.004961,172.217.160.0-255,5738,128455,96,342589
13931,0.004965,172.31.47.0-255,66,128521,96,342589
13932,0.006595,172.217.160.0-255,5738,134259,96,342589
13933,0.0066,172.31.47.0-255,66,134325,96,342589
13934,0.00823,172.217.160.0-255,4320,138645,96,342589
13935,0.008234,172.31.47.0-255,66,138711,96,342589
13936,0.008254,172.217.160.0-255,1484,140195,96,342589
13937,0.009877,172.217.160.0-255,4320,144515,96,342589
13938,0.009883,172.31.47.0-255,66,144581,96,342589
13939,0.011526,172.217.160.0-255,5738,150319,96,342589
13940,0.011532,172.31.47.0-255,66,150385,96,342589
13941,0.01316,172.217.160.0-255,5738,156123,96,342589
13942,0.013167,172.31.47.0-255,66,156189,96,342589
13943,0.014802,172.217.160.0-255,5738,161927,96,342589
13944,0.014809,172.31.47.0-255,66,161993,96,342589
13945,0.016445,172.217.160.0-255,5738,167731,96,342589
13946,0.016452,172.31.47.0-255,66,167797,96,342589
13947,0.018077,172.217.160.0-255,5738,173535,96,342589
13948,0.018084,172.31.47.0-255,66,173601,96,342589
13949,0.019711,172.217.160.0-255,5738,179339,96,342589
13950,0.019717,172.31.47.0-255,66,179405,96,342589
13951,0.021351,172.217.160.0-255,4320,183725,96,342589
13952,0.021357,172.31.47.0-255,66,183791,96,342589
13953,0.021377,172.217.160.0-255,1484,185275,96,342589
13954,0.02298,172.217.160.0-255,4320,189595,96,342589
13955,0.022986,172.31.47.0-255,66,189661,96,342589
13956,0.023318,172.31.47.0-255,172,189833,96,342589
13957,0.023348,172.31.47.0-255,1105,190938,96,342589
13958,0.023385,172.31.47.0-255,1514,192452,96,342589
13959,0.023386,172.31.47.0-255,339,192791,96,342589
13960,0.024618,172.217.160.0-255,5738,198529,96,342589
13961,0.024624,172.31.47.0-255,66,198595,96,342589
13962,0.024881,104.244.42.0-255,66,198661,96,342589
13963,0.024889,104.244.42.0-255,66,198727,96,342589
13964,0.024958,104.244.42.0-255,66,198793,96,342589
13965,0.026245,172.217.160.0-255,4320,203113,96,342589
13966,0.02625,172.31.47.0-255,66,203179,96,342589
13967,0.026275,172.217.160.0-255,1484,204663,96,342589
13968,0.027873,172.217.160.0-255,4320,208983,96,342589
13969,0.027878,172.31.47.0-255,66,209049,96,342589
13970,0.029507,172.217.160.0-255,5738,214787,96,342589
13971,0.029512,172.31.47.0-255,66,214853,96,342589
13972,0.031143,172.217.160.0-255,4320,219173,96,342589
13973,0.031148,172.31.47.0-255,66,219239,96,342589
13974,0.031177,172.217.160.0-255,1484,220723,96,342589
13975,0.032774,172.217.160.0-255,4320,225043,96,342589
13976,0.032779,172.31.47.0-255,66,225109,96,342589
13977,0.03442,172.217.160.0-255,5738,230847,96,342589
13978,0.034425,172.31.47.0-255,66,230913,96,342589
13979,0.036048,172.217.160.0-255,4320,235233,96,342589
13980,0.036053,172.31.47.0-255,66,235299,96,342589
13981,0.036081,172.217.160.0-255,1484,236783,96,342589
13982,0.037674,172.217.160.0-255,4320,241103,96,342589
13983,0.037678,172.31.47.0-255,66,241169,96,342589
13984,0.039314,172.217.160.0-255,4320,245489,96,342589
13985,0.039318,172.31.47.0-255,66,245555,96,342589
13986,0.039342,172.217.160.0-255,1484,247039,96,342589
13987,0.040968,172.217.160.0-255,4320,251359,96,342589
13988,0.040974,172.31.47.0-255,66,251425,96,342589
13989,0.042599,172.217.160.0-255,2902,254327,96,342589
13990,0.042605,172.31.47.0-255,66,254393,96,342589
13991,0.042635,172.217.160.0-255,2902,257295,96,342589
13992,0.042638,172.31.47.0-255,66,257361,96,342589
13993,0.044226,172.217.160.0-255,2902,260263,96,342589
13994,0.044232,172.31.47.0-255,66,260329,96,342589
13995,0.044264,172.217.160.0-255,2902,263231,96,342589
13996,0.044267,172.31.47.0-255,66,263297,96,342589
13997,0.045863,172.217.160.0-255,2902,266199,96,342589
13998,0.045868,172.31.47.0-255,66,266265,96,342589
13999,0.045896,172.217.160.0-255,2902,269167,96,342589
14000,0.0459,172.31.47.0-255,66,269233,96,342589
14001,0.047495,172.217.160.0-255,2902,272135,96,342589
14002,0.0475,172.31.47.0-255,66,272201,96,342589
14003,0.047536,172.217.160.0-255,2902,275103,96,342589
14004,0.04754,172.31.47.0-255,66,275169,96,342589
14005,0.049122,172.217.160.0-255,2902,278071,96,342589
14006,0.049127,172.31.47.0-255,66,278137,96,342589
14007,0.049156,172.217.160.0-255,2902,281039,96,342589
14008,0.049159,172.31.47.0-255,66,281105,96,342589
14009,0.050747,172.217.160.0-255,2902,284007,96,342589
14010,0.050751,172.31.47.0-255,66,284073,96,342589
14011,0.050802,172.217.160.0-255,2902,286975,96,342589
14012,0.050805,172.31.47.0-255,66,287041,96,342589
14013,0.052381,172.217.160.0-255,2902,289943,96,342589
14014,0.052385,172.31.47.0-255,66,290009,96,342589
14015,0.052453,172.217.160.0-255,2902,292911,96,342589
14016,0.052457,172.31.47.0-255,66,292977,96,342589
14017,0.054006,172.217.160.0-255,2902,295879,96,342589
14018,0.054011,172.31.47.0-255,66,295945,96,342589
14019,0.054066,172.217.160.0-255,1484,297429,96,342589
14020,0.054081,172.217.160.0-255,1484,298913,96,342589
14021,0.054085,172.31.47.0-255,66,298979,96,342589
14022,0.055632,172.217.160.0-255,2902,301881,96,342589
14023,0.055637,172.31.47.0-255,66,301947,96,342589
14024,0.055701,172.217.160.0-255,2902,304849,96,342589
14025,0.055705,172.31.47.0-255,66,304915,96,342589
14026,0.057267,172.217.160.0-255,2902,307817,96,342589
14027,0.057272,172.31.47.0-255,66,307883,96,342589
14028,0.057324,172.217.160.0-255,1484,309367,96,342589
14029,0.057334,172.217.160.0-255,1484,310851,96,342589
14030,0.057338,172.31.47.0-255,66,310917,96,342589
14031,0.058902,172.217.160.0-255,2902,313819,96,342589
14032,0.058907,172.31.47.0-255,66,313885,96,342589
14033,0.058957,172.217.160.0-255,2902,316787,96,342589
14034,0.058961,172.31.47.0-255,66,316853,96,342589
14035,0.060534,172.217.160.0-255,2902,319755,96,342589
14036,0.060539,172.31.47.0-255,66,319821,96,342589
14037,0.060575,172.217.160.0-255,2902,322723,96,342589
14038,0.060578,172.31.47.0-255,66,322789,96,342589
14039,0.062223,172.217.160.0-255,2902,325691,96,342589
14040,0.062229,172.31.47.0-255,66,325757,96,342589
14041,0.062247,172.217.160.0-255,2902,328659,96,342589
14042,0.06225,172.31.47.0-255,66,328725,96,342589
14043,0.063862,172.217.160.0-255,2902,331627,96,342589
14044,0.063868,172.31.47.0-255,66,331693,96,342589
14045,0.063894,172.217.160.0-255,2902,334595,96,342589
14046,0.063897,172.31.47.0-255,66,334661,96,342589
14047,0.065495,172.217.160.0-255,2902,337563,96,342589
14048,0.0655,172.31.47.0-255,66,337629,96,342589
14049,0.065534,172.217.160.0-255,2902,340531,96,342589
14050,0.065537,172.31.47.0-255,66,340597,96,342589
14051,0.067133,172.217.160.0-255,1755,342352,96,342589
14052,0.067138,172.31.47.0-255,66,342418,96,342589
14053,0.067315,172.31.47.0-255,105,342523,96,342589
14054,0.068915,172.217.160.0-255,66,342589,96,342589
14055,0.0,172.31.47.0-255,105,105,96,459
14056,0.000254,172.31.47.0-255,90,195,96,459
14057,0.000263,172.31.47.0-255,66,261,96,459
14058,0.002488,74.125.130.0-255,66,327,96,459
14059,0.002509,74.125.130.0-255,66,393,96,459
14060,0.002524,172.31.47.0-255,66,459,96,459
14061,0.0,74.125.24.0-255,146,146,96,299018
14062,2.4e-05,172.31.47.0-255,66,212,96,299018
14063,3.1e-05,74.125.24.0-255,1484,1696,96,299018
14064,3.5e-05,172.31.47.0-255,66,1762,96,299018
14065,4.7e-05,74.125.24.0-255,2902,4664,96,299018
14066,4.9e-05,172.31.47.0-255,66,4730,96,299018
14067,5.6e-05,74.125.24.0-255,5738,10468,96,299018
14068,5.8e-05,172.31.47.0-255,66,10534,96,299018
14069,7.5e-05,74.125.24.0-255,1484,12018,96,299018
14070,7.8e-05,172.31.47.0-255,66,12084,96,299018
14071,0.000116,172.31.47.0-255,66,12150,96,299018
14072,0.000143,74.125.24.0-255,5738,17888,96,299018
14073,0.000146,172.31.47.0-255,66,17954,96,299018
14074,0.000169,74.125.24.0-255,3961,21915,96,299018
14075,0.00017,172.31.47.0-255,66,21981,96,299018
14076,0.000309,74.125.24.0-255,1484,23465,96,299018
14077,0.000313,172.31.47.0-255,66,23531,96,299018
14078,0.00033,74.125.24.0-255,2902,26433,96,299018
14079,0.000333,172.31.47.0-255,66,26499,96,299018
14080,0.000337,74.125.24.0-255,2902,29401,96,299018
14081,0.000339,172.31.47.0-255,66,29467,96,299018
14082,0.00036,74.125.24.0-255,2902,32369,96,299018
14083,0.000367,172.31.47.0-255,66,32435,96,299018
14084,0.000404,172.31.47.0-255,66,32501,96,299018
14085,0.000465,172.31.47.0-255,66,32567,96,299018
14086,0.00053,74.125.24.0-255,108,32675,96,299018
14087,0.000533,172.31.47.0-255,66,32741,96,299018
14088,0.00061,74.125.24.0-255,1484,34225,96,299018
14089,0.000616,172.31.47.0-255,66,34291,96,299018
14090,0.000623,74.125.24.0-255,2902,37193,96,299018
14091,0.000625,172.31.47.0-255,66,37259,96,299018
14092,0.000633,74.125.24.0-255,1484,38743,96,299018
14093,0.000635,172.31.47.0-255,66,38809,96,299018
14094,0.000666,74.125.24.0-255,4320,43129,96,299018
14095,0.000669,172.31.47.0-255,66,43195,96,299018
14096,0.000682,172.31.47.0-255,66,43261,96,299018
14097,0.000708,74.125.24.0-255,1484,44745,96,299018
14098,0.00071,172.31.47.0-255,66,44811,96,299018
14099,0.000716,74.125.24.0-255,5738,50549,96,299018
14100,0.000718,172.31.47.0-255,66,50615,96,299018
14101,0.000778,74.125.24.0-255,5020,55635,96,299018
14102,0.000783,172.31.47.0-255,66,55701,96,299018
14103,0.000915,74.125.24.0-255,1484,57185,96,299018
14104,0.000919,172.31.47.0-255,66,57251,96,299018
14105,0.000924,74.125.24.0-255,2902,60153,96,299018
14106,0.000926,172.31.47.0-255,66,60219,96,299018
14107,0.000957,74.125.24.0-255,5738,65957,96,299018
14108,0.00096,172.31.47.0-255,66,66023,96,299018
14109,0.000962,74.125.24.0-255,1484,67507,96,299018
14110,0.000994,74.125.24.0-255,1484,68991,96,299018
14111,0.001003,172.31.47.0-255,66,69057,96,299018
14112,0.001014,74.125.24.0-255,5738,74795,96,299018
14113,0.001057,172.31.47.0-255,66,74861,96,299018
14114,0.001073,74.125.24.0-255,2184,77045,96,299018
14115,0.001091,172.31.47.0-255,66,77111,96,299018
14116,0.0011,74.125.24.0-255,1484,78595,96,299018
14117,0.00113,74.125.24.0-255,2902,81497,96,299018
14118,0.001133,74.125.24.0-255,1484,82981,96,299018
14119,0.001146,74.125.24.0-255,1484,84465,96,299018
14120,0.001149,172.31.47.0-255,66,84531,96,299018
14121,0.001183,74.125.24.0-255,7156,91687,96,299018
14122,0.001192,74.125.24.0-255,7156,98843,96,299018
14123,0.001204,172.31.47.0-255,66,98909,96,299018
14124,0.001227,172.31.47.0-255,66,98975,96,299018
14125,0.001236,74.125.24.0-255,3602,102577,96,299018
14126,0.001263,74.125.24.0-255,4320,106897,96,299018
14127,0.001268,74.125.24.0-255,4320,111217,96,299018
14128,0.001286,74.125.24.0-255,5738,116955,96,299018
14129,0.001311,172.31.47.0-255,66,117021,96,299018
14130,0.001314,74.125.24.0-255,1484,118505,96,299018
14131,0.001373,172.31.47.0-255,66,118571,96,299018
14132,0.001405,74.125.24.0-255,1484,120055,96,299018
14133,0.001423,74.125.24.0-255,2902,122957,96,299018
14134,0.001427,74.125.24.0-255,1484,124441,96,299018
14135,0.001447,74.125.24.0-255,4320,128761,96,299018
14136,0.001453,172.31.47.0-255,66,128827,96,299018
14137,0.001472,74.125.24.0-255,2902,131729,96,299018
14138,0.001486,74.125.24.0-255,3650,135379,96,299018
14139,0.001497,172.31.47.0-255,66,135445,96,299018
14140,0.002082,74.125.24.0-255,1484,136929,96,299018
14141,0.002087,74.125.24.0-255,1484,138413,96,299018
14142,0.00209,172.31.47.0-255,66,138479,96,299018
14143,0.002116,74.125.24.0-255,1484,139963,96,299018
14144,0.002123,74.125.24.0-255,5738,145701,96,299018
14145,0.00213,74.125.24.0-255,7156,152857,96,299018
14146,0.002144,74.125.24.0-255,1484,154341,96,299018
14147,0.002147,172.31.47.0-255,66,154407,96,299018
14148,0.002182,74.125.24.0-255,5738,160145,96,299018
14149,0.002203,172.31.47.0-255,66,160211,96,299018
14150,0.00225,74.125.24.0-255,4320,164531,96,299018
14151,0.002264,74.125.24.0-255,7156,171687,96,299018
14152,0.002273,172.31.47.0-255,66,171753,96,299018
14153,0.002299,74.125.24.0-255,4320,176073,96,299018
14154,0.002328,172.31.47.0-255,66,176139,96,299018
14155,0.002352,74.125.24.0-255,1484,177623,96,299018
14156,0.002357,74.125.24.0-255,2902,180525,96,299018
14157,0.00236,74.125.24.0-255,1484,182009,96,299018
14158,0.002365,172.31.47.0-255,66,182075,96,299018
14159,0.00239,74.125.24.0-255,4320,186395,96,299018
14160,0.002397,74.125.24.0-255,5738,192133,96,299018
14161,0.002415,74.125.24.0-255,7156,199289,96,299018
14162,0.002426,172.31.47.0-255,66,199355,96,299018
14163,0.002433,74.125.24.0-255,5738,205093,96,299018
14164,0.00249,172.31.47.0-255,66,205159,96,299018
14165,0.002501,74.125.24.0-255,5020,210179,96,299018
14166,0.002522,74.125.24.0-255,5738,215917,96,299018
14167,0.002538,74.125.24.0-255,2902,218819,96,299018
14168,0.002547,172.31.47.0-255,66,218885,96,299018
14169,0.002567,74.125.24.0-255,7156,226041,96,299018
14170,0.002596,74.125.24.0-255,6438,232479,96,299018
14171,0.002613,172.31.47.0-255,66,232545,96,299018
14172,0.005263,74.125.24.0-255,5738,238283,96,299018
14173,0.005279,172.31.47.0-255,66,238349,96,299018
14174,0.007881,74.125.24.0-255,5738,244087,96,299018
14175,0.007895,172.31.47.0-255,66,244153,96,299018
14176,0.010521,74.125.24.0-255,5738,249891,96,299018
14177,0.010531,172.31.47.0-255,66,249957,96,299018
14178,0.013138,74.125.24.0-255,5738,255695,96,299018
14179,0.013154,172.31.47.0-255,66,255761,96,299018
14180,0.015784,74.125.24.0-255,5738,261499,96,299018
14181,0.015803,172.31.47.0-255,66,261565,96,299018
14182,0.018434,74.125.24.0-255,5738,267303,96,299018
14183,0.018454,172.31.47.0-255,66,267369,96,299018
14184,0.021071,74.125.24.0-255,5738,273107,96,299018
14185,0.021088,172.31.47.0-255,66,273173,96,299018
14186,0.02369,74.125.24.0-255,5738,278911,96,299018
14187,0.023707,172.31.47.0-255,66,278977,96,299018
14188,0.02633,74.125.24.0-255,5738,284715,96,299018
14189,0.02635,172.31.47.0-255,66,284781,96,299018
14190,0.028959,74.125.24.0-255,5738,290519,96,299018
14191,0.028971,172.31.47.0-255,66,290585,96,299018
14192,0.031594,74.125.24.0-255,3901,294486,96,299018
14193,0.031608,172.31.47.0-255,66,294552,96,299018
14194,0.031847,172.31.47.0-255,105,294657,96,299018
14195,0.034433,74.125.24.0-255,66,294723,96,299018
14196,0.034905,172.31.47.0-255,172,294895,96,299018
14197,0.03494,172.31.47.0-255,1109,296004,96,299018
14198,0.035,172.31.47.0-255,1514,297518,96,299018
14199,0.035002,172.31.47.0-255,1302,298820,96,299018
14200,0.03648,104.244.42.0-255,66,298886,96,299018
14201,0.036512,104.244.42.0-255,66,298952,96,299018
14202,0.036562,104.244.42.0-255,66,299018,96,299018
14203,0.0,172.253.118.0-255,145,145,96,198794
14204,1.7e-05,172.31.47.0-255,66,211,96,198794
14205,2.4e-05,172.253.118.0-255,1484,1695,96,198794
14206,2.9e-05,172.31.47.0-255,66,1761,96,198794
14207,3.5e-05,172.253.118.0-255,2902,4663,96,198794
14208,3.7e-05,172.31.47.0-255,66,4729,96,198794
14209,4.5e-05,172.253.118.0-255,7156,11885,96,198794
14210,4.8e-05,172.31.47.0-255,66,11951,96,198794
14211,0.0001,172.31.47.0-255,66,12017,96,198794
14212,0.000123,172.253.118.0-255,5379,17396,96,198794
14213,0.000125,172.31.47.0-255,66,17462,96,198794
14214,0.000167,172.253.118.0-255,1484,18946,96,198794
14215,0.00017,172.31.47.0-255,66,19012,96,198794
14216,0.000175,172.253.118.0-255,2902,21914,96,198794
14217,0.000177,172.31.47.0-255,66,21980,96,198794
14218,0.00018,172.253.118.0-255,1484,23464,96,198794
14219,0.000182,172.31.47.0-255,66,23530,96,198794
14220,0.000208,172.253.118.0-255,4320,27850,96,198794
14221,0.000211,172.31.47.0-255,66,27916,96,198794
14222,0.000225,172.253.118.0-255,4320,32236,96,198794
14223,0.000227,172.31.47.0-255,66,32302,96,198794
14224,0.000265,172.253.118.0-255,7156,39458,96,198794
14225,0.000268,172.31.47.0-255,66,39524,96,198794
14226,0.000281,172.31.47.0-255,66,39590,96,198794
14227,0.000284,172.253.118.0-255,365,39955,96,198794
14228,0.000286,172.31.47.0-255,66,40021,96,198794
14229,0.00029,172.253.118.0-255,130,40151,96,198794
14230,0.000292,172.31.47.0-255,66,40217,96,198794
14231,0.000528,172.253.118.0-255,1484,41701,96,198794
14232,0.000534,172.31.47.0-255,66,41767,96,198794
14233,0.000541,172.253.118.0-255,2902,44669,96,198794
14234,0.000543,172.31.47.0-255,66,44735,96,198794
14235,0.000549,172.253.118.0-255,5738,50473,96,198794
14236,0.000552,172.31.47.0-255,66,50539,96,198794
14237,0.000589,172.31.47.0-255,66,50605,96,198794
14238,0.000594,172.253.118.0-255,4320,54925,96,198794
14239,0.000596,172.31.47.0-255,66,54991,96,198794
14240,0.000616,172.253.118.0-255,6438,61429,96,198794
14241,0.000618,172.31.47.0-255,66,61495,96,198794
14242,0.000659,172.253.118.0-255,346,61841,96,198794
14243,0.000661,172.31.47.0-255,66,61907,96,198794
14244,0.000701,172.253.118.0-255,1484,63391,96,198794
14245,0.000704,172.31.47.0-255,66,63457,96,198794
14246,0.000709,172.253.118.0-255,4320,67777,96,198794
14247,0.000712,172.31.47.0-255,66,67843,96,198794
14248,0.000752,172.31.47.0-255,66,67909,96,198794
14249,0.000763,172.31.47.0-255,66,67975,96,198794
14250,0.000793,172.253.118.0-255,1484,69459,96,198794
14251,0.000796,172.31.47.0-255,66,69525,96,198794
14252,0.000818,172.31.47.0-255,66,69591,96,198794
14253,0.000826,172.253.118.0-255,7156,76747,96,198794
14254,0.000828,172.31.47.0-255,66,76813,96,198794
14255,0.000852,172.253.118.0-255,5738,82551,96,198794
14256,0.000854,172.31.47.0-255,66,82617,96,198794
14257,0.000866,172.31.47.0-255,66,82683,96,198794
14258,0.000888,172.31.47.0-255,66,82749,96,198794
14259,0.000908,172.253.118.0-255,1484,84233,96,198794
14260,0.00091,172.31.47.0-255,66,84299,96,198794
14261,0.000915,172.253.118.0-255,2902,87201,96,198794
14262,0.000916,172.31.47.0-255,66,87267,96,198794
14263,0.00093,172.253.118.0-255,4320,91587,96,198794
14264,0.000933,172.31.47.0-255,66,91653,96,198794
14265,0.000955,172.253.118.0-255,1484,93137,96,198794
14266,0.000967,172.31.47.0-255,66,93203,96,198794
14267,0.00097,172.31.47.0-255,66,93269,96,198794
14268,0.001008,172.253.118.0-255,7156,100425,96,198794
14269,0.001012,172.31.47.0-255,66,100491,96,198794
14270,0.001037,172.31.47.0-255,66,100557,96,198794
14271,0.001051,172.253.118.0-255,4320,104877,96,198794
14272,0.001053,172.31.47.0-255,66,104943,96,198794
14273,0.00106,172.253.118.0-255,5738,110681,96,198794
14274,0.001062,172.31.47.0-255,66,110747,96,198794
14275,0.001092,172.31.47.0-255,66,110813,96,198794
14276,0.001113,172.253.118.0-255,2902,113715,96,198794
14277,0.001116,172.31.47.0-255,66,113781,96,198794
14278,0.001129,172.31.47.0-255,66,113847,96,198794
14279,0.001182,172.253.118.0-255,1484,115331,96,198794
14280,0.001187,172.31.47.0-255,66,115397,96,198794
14281,0.001198,172.253.118.0-255,2902,118299,96,198794
14282,0.0012,172.31.47.0-255,66,118365,96,198794
14283,0.001226,172.253.118.0-255,5738,124103,96,198794
14284,0.001229,172.31.47.0-255,66,124169,96,198794
14285,0.001267,172.253.118.0-255,4320,128489,96,198794
14286,0.00127,172.31.47.0-255,66,128555,96,198794
14287,0.001297,172.31.47.0-255,66,128621,96,198794
14288,0.001309,172.31.47.0-255,66,128687,96,198794
14289,0.001312,172.253.118.0-255,1484,130171,96,198794
14290,0.001314,172.31.47.0-255,66,130237,96,198794
14291,0.001319,172.253.118.0-255,2902,133139,96,198794
14292,0.001321,172.31.47.0-255,66,133205,96,198794
14293,0.001328,172.253.118.0-255,5738,138943,96,198794
14294,0.00133,172.31.47.0-255,66,139009,96,198794
14295,0.001353,172.253.118.0-255,7156,146165,96,198794
14296,0.001356,172.31.47.0-255,66,146231,96,198794
14297,0.001389,172.253.118.0-255,5738,151969,96,198794
14298,0.001403,172.31.47.0-255,66,152035,96,198794
14299,0.001406,172.31.47.0-255,66,152101,96,198794
14300,0.00147,172.253.118.0-255,1484,153585,96,198794
14301,0.001474,172.31.47.0-255,66,153651,96,198794
14302,0.001479,172.253.118.0-255,2902,156553,96,198794
14303,0.001481,172.31.47.0-255,66,156619,96,198794
14304,0.001509,172.253.118.0-255,5738,162357,96,198794
14305,0.001512,172.31.47.0-255,66,162423,96,198794
14306,0.001518,172.253.118.0-255,5738,168161,96,198794
14307,0.001521,172.31.47.0-255,66,168227,96,198794
14308,0.001537,172.253.118.0-255,5738,173965,96,198794
14309,0.001539,172.31.47.0-255,66,174031,96,198794
14310,0.00155,172.31.47.0-255,66,174097,96,198794
14311,0.001569,172.253.118.0-255,3602,177699,96,198794
14312,0.001572,172.31.47.0-255,66,177765,96,198794
14313,0.001637,172.253.118.0-255,1484,179249,96,198794
14314,0.001641,172.31.47.0-255,66,179315,96,198794
14315,0.001657,172.253.118.0-255,2902,182217,96,198794
14316,0.00166,172.31.47.0-255,66,182283,96,198794
14317,0.001666,172.253.118.0-255,5738,188021,96,198794
14318,0.001669,172.31.47.0-255,66,188087,96,198794
14319,0.001674,172.253.118.0-255,4320,192407,96,198794
14320,0.001715,172.31.47.0-255,66,192473,96,198794
14321,0.001719,172.253.118.0-255,1484,193957,96,198794
14322,0.001784,172.31.47.0-255,66,194023,96,198794
14323,0.00181,172.31.47.0-255,66,194089,96,198794
14324,0.001853,172.31.47.0-255,66,194155,96,198794
14325,0.001861,172.253.118.0-255,105,194260,96,198794
14326,0.009448,172.31.47.0-255,66,194326,96,198794
14327,0.009481,172.31.47.0-255,105,194431,96,198794
14328,0.011666,172.253.118.0-255,66,194497,96,198794
14329,0.02809,172.31.47.0-255,172,194669,96,198794
14330,0.02812,172.31.47.0-255,1110,195779,96,198794
14331,0.028172,172.31.47.0-255,1514,197293,96,198794
14332,0.028174,172.31.47.0-255,1303,198596,96,198794
14333,0.029561,104.244.42.0-255,66,198662,96,198794
14334,0.029592,104.244.42.0-255,66,198728,96,198794
14335,0.029653,104.244.42.0-255,66,198794,96,198794
14336,0.0,172.217.194.0-255,152,152,96,276802
14337,2.5e-05,172.31.47.0-255,66,218,96,276802
14338,3.1e-05,172.217.194.0-255,1484,1702,96,276802
14339,3.6e-05,172.31.47.0-255,66,1768,96,276802
14340,4.2e-05,172.217.194.0-255,2902,4670,96,276802
14341,5.3e-05,172.31.47.0-255,66,4736,96,276802
14342,6e-05,172.217.194.0-255,7156,11892,96,276802
14343,6.3e-05,172.31.47.0-255,66,11958,96,276802
14344,6.8e-05,172.217.194.0-255,4320,16278,96,276802
14345,7.1e-05,172.31.47.0-255,66,16344,96,276802
14346,0.00011,172.217.194.0-255,4962,21306,96,276802
14347,0.000118,172.31.47.0-255,66,21372,96,276802
14348,0.000129,172.31.47.0-255,66,21438,96,276802
14349,0.000209,172.31.47.0-255,66,21504,96,276802
14350,0.000229,172.31.47.0-255,66,21570,96,276802
14351,0.000231,172.217.194.0-255,377,21947,96,276802
14352,0.000233,172.31.47.0-255,66,22013,96,276802
14353,0.000236,172.217.194.0-255,98,22111,96,276802
14354,0.000238,172.31.47.0-255,66,22177,96,276802
14355,0.000242,172.217.194.0-255,1484,23661,96,276802
14356,0.000245,172.31.47.0-255,66,23727,96,276802
14357,0.00025,172.217.194.0-255,2902,26629,96,276802
14358,0.000252,172.31.47.0-255,66,26695,96,276802
14359,0.000256,172.217.194.0-255,1484,28179,96,276802
14360,0.000258,172.31.47.0-255,66,28245,96,276802
14361,0.000301,172.217.194.0-255,5738,33983,96,276802
14362,0.000304,172.31.47.0-255,66,34049,96,276802
14363,0.000314,172.31.47.0-255,66,34115,96,276802
14364,0.000347,172.217.194.0-255,7156,41271,96,276802
14365,0.00035,172.31.47.0-255,66,41337,96,276802
14366,0.00039,172.217.194.0-255,6438,47775,96,276802
14367,0.000393,172.31.47.0-255,66,47841,96,276802
14368,0.000395,172.217.194.0-255,364,48205,96,276802
14369,0.000766,172.217.194.0-255,1484,49689,96,276802
14370,0.000771,172.31.47.0-255,66,49755,96,276802
14371,0.000776,172.217.194.0-255,2902,52657,96,276802
14372,0.000778,172.31.47.0-255,66,52723,96,276802
14373,0.000782,172.217.194.0-255,1484,54207,96,276802
14374,0.000804,172.217.194.0-255,4320,58527,96,276802
14375,0.000806,172.31.47.0-255,66,58593,96,276802
14376,0.000811,172.217.194.0-255,2902,61495,96,276802
14377,0.000812,172.31.47.0-255,66,61561,96,276802
14378,0.000842,172.217.194.0-255,5738,67299,96,276802
14379,0.000844,172.31.47.0-255,66,67365,96,276802
14380,0.000883,172.31.47.0-255,66,67431,96,276802
14381,0.000909,172.217.194.0-255,2184,69615,96,276802
14382,0.000911,172.31.47.0-255,66,69681,96,276802
14383,0.000976,172.217.194.0-255,1484,71165,96,276802
14384,0.000981,172.217.194.0-255,2902,74067,96,276802
14385,0.000983,172.31.47.0-255,66,74133,96,276802
14386,0.000987,172.217.194.0-255,2902,77035,96,276802
14387,0.00099,172.31.47.0-255,66,77101,96,276802
14388,0.001011,172.217.194.0-255,2902,80003,96,276802
14389,0.001017,172.217.194.0-255,5738,85741,96,276802
14390,0.00102,172.31.47.0-255,66,85807,96,276802
14391,0.001022,172.31.47.0-255,66,85873,96,276802
14392,0.001044,172.217.194.0-255,4320,90193,96,276802
14393,0.001047,172.31.47.0-255,66,90259,96,276802
14394,0.001081,172.31.47.0-255,66,90325,96,276802
14395,0.001108,172.217.194.0-255,5020,95345,96,276802
14396,0.001111,172.31.47.0-255,66,95411,96,276802
14397,0.001972,172.217.194.0-255,1484,96895,96,276802
14398,0.001987,172.217.194.0-255,2902,99797,96,276802
14399,0.00199,172.31.47.0-255,66,99863,96,276802
14400,0.002024,172.217.194.0-255,5738,105601,96,276802
14401,0.002027,172.31.47.0-255,66,105667,96,276802
14402,0.002032,172.217.194.0-255,2902,108569,96,276802
14403,0.002034,172.31.47.0-255,66,108635,96,276802
14404,0.002077,172.31.47.0-255,66,108701,96,276802
14405,0.002087,172.31.47.0-255,66,108767,96,276802
14406,0.002121,172.217.194.0-255,2184,110951,96,276802
14407,0.002123,172.31.47.0-255,66,111017,96,276802
14408,0.004433,172.217.194.0-255,4320,115337,96,276802
14409,0.00444,172.31.47.0-255,66,115403,96,276802
14410,0.004464,172.217.194.0-255,1484,116887,96,276802
14411,0.006798,172.217.194.0-255,2902,119789,96,276802
14412,0.006802,172.31.47.0-255,66,119855,96,276802
14413,0.006818,172.217.194.0-255,1484,121339,96,276802
14414,0.009115,172.217.194.0-255,4320,125659,96,276802
14415,0.009122,172.31.47.0-255,66,125725,96,276802
14416,0.01141,172.217.194.0-255,5738,131463,96,276802
14417,0.011422,172.31.47.0-255,66,131529,96,276802
14418,0.01376,172.217.194.0-255,5738,137267,96,276802
14419,0.013771,172.31.47.0-255,66,137333,96,276802
14420,0.016109,172.217.194.0-255,5738,143071,96,276802
14421,0.016118,172.31.47.0-255,66,143137,96,276802
14422,0.018417,172.217.194.0-255,5738,148875,96,276802
14423,0.018425,172.31.47.0-255,66,148941,96,276802
14424,0.020747,172.217.194.0-255,5738,154679,96,276802
14425,0.020755,172.31.47.0-255,66,154745,96,276802
14426,0.023074,172.217.194.0-255,5738,160483,96,276802
14427,0.02308,172.31.47.0-255,66,160549,96,276802
14428,0.02541,172.217.194.0-255,5738,166287,96,276802
14429,0.025415,172.31.47.0-255,66,166353,96,276802
14430,0.026714,172.31.47.0-255,172,166525,96,276802
14431,0.026746,172.31.47.0-255,1109,167634,96,276802
14432,0.026804,172.31.47.0-255,1514,169148,96,276802
14433,0.026806,172.31.47.0-255,1302,170450,96,276802
14434,0.02774,172.217.194.0-255,5738,176188,96,276802
14435,0.027747,172.31.47.0-255,66,176254,96,276802
14436,0.028267,104.244.42.0-255,66,176320,96,276802
14437,0.028311,104.244.42.0-255,66,176386,96,276802
14438,0.028358,104.244.42.0-255,66,176452,96,276802
14439,0.030058,172.217.194.0-255,4320,180772,96,276802
14440,0.030063,172.31.47.0-255,66,180838,96,276802
14441,0.030088,172.217.194.0-255,1484,182322,96,276802
14442,0.03237,172.217.194.0-255,4320,186642,96,276802
14443,0.032375,172.31.47.0-255,66,186708,96,276802
14444,0.034695,172.217.194.0-255,5738,192446,96,276802
14445,0.034701,172.31.47.0-255,66,192512,96,276802
14446,0.037013,172.217.194.0-255,5738,198250,96,276802
14447,0.03702,172.31.47.0-255,66,198316,96,276802
14448,0.039371,172.217.194.0-255,5738,204054,96,276802
14449,0.039378,172.31.47.0-255,66,204120,96,276802
14450,0.041687,172.217.194.0-255,5738,209858,96,276802
14451,0.041693,172.31.47.0-255,66,209924,96,276802
14452,0.044009,172.217.194.0-255,5738,215662,96,276802
14453,0.044016,172.31.47.0-255,66,215728,96,276802
14454,0.046329,172.217.194.0-255,5738,221466,96,276802
14455,0.046335,172.31.47.0-255,66,221532,96,276802
14456,0.048674,172.217.194.0-255,4320,225852,96,276802
14457,0.048679,172.31.47.0-255,66,225918,96,276802
14458,0.048701,172.217.194.0-255,1484,227402,96,276802
14459,0.050993,172.217.194.0-255,4320,231722,96,276802
14460,0.051,172.31.47.0-255,66,231788,96,276802
14461,0.053325,172.217.194.0-255,5738,237526,96,276802
14462,0.053335,172.31.47.0-255,66,237592,96,276802
14463,0.055988,172.217.194.0-255,5738,243330,96,276802
14464,0.055995,172.31.47.0-255,66,243396,96,276802
14465,0.058336,172.217.194.0-255,5738,249134,96,276802
14466,0.058341,172.31.47.0-255,66,249200,96,276802
14467,0.060703,172.217.194.0-255,5738,254938,96,276802
14468,0.060709,172.31.47.0-255,66,255004,96,276802
14469,0.063031,172.217.194.0-255,5738,260742,96,276802
14470,0.063037,172.31.47.0-255,66,260808,96,276802
14471,0.065357,172.217.194.0-255,5738,266546,96,276802
14472,0.065363,172.31.47.0-255,66,266612,96,276802
14473,0.067675,172.217.194.0-255,5738,272350,96,276802
14474,0.067684,172.31.47.0-255,66,272416,96,276802
14475,0.069987,172.217.194.0-255,4320,276736,96,276802
14476,0.069993,172.31.47.0-255,66,276802,96,276802
14477,0.0,74.125.200.0-255,152,152,96,268979
14478,1.7e-05,172.31.47.0-255,66,218,96,268979
14479,2.4e-05,74.125.200.0-255,1484,1702,96,268979
14480,2.9e-05,172.31.47.0-255,66,1768,96,268979
14481,3.2e-05,74.125.200.0-255,1484,3252,96,268979
14482,3.6e-05,172.31.47.0-255,66,3318,96,268979
14483,5.9e-05,74.125.200.0-255,1484,4802,96,268979
14484,6.1e-05,172.31.47.0-255,66,4868,96,268979
14485,6.9e-05,74.125.200.0-255,7156,12024,96,268979
14486,7.2e-05,172.31.47.0-255,66,12090,96,268979
14487,7.5e-05,74.125.200.0-255,2256,14346,96,268979
14488,7.7e-05,172.31.47.0-255,66,14412,96,268979
14489,0.000104,74.125.200.0-255,2902,17314,96,268979
14490,0.000106,172.31.47.0-255,66,17380,96,268979
14491,0.00012,74.125.200.0-255,2902,20282,96,268979
14492,0.000123,172.31.47.0-255,66,20348,96,268979
14493,0.000139,74.125.200.0-255,4320,24668,96,268979
14494,0.000141,172.31.47.0-255,66,24734,96,268979
14495,0.000175,74.125.200.0-255,5738,30472,96,268979
14496,0.000178,172.31.47.0-255,66,30538,96,268979
14497,0.000193,74.125.200.0-255,1125,31663,96,268979
14498,0.000196,172.31.47.0-255,66,31729,96,268979
14499,0.000233,74.125.200.0-255,1484,33213,96,268979
14500,0.000235,172.31.47.0-255,66,33279,96,268979
14501,0.000239,74.125.200.0-255,1484,34763,96,268979
14502,0.000241,172.31.47.0-255,66,34829,96,268979
14503,0.000255,74.125.200.0-255,1484,36313,96,268979
14504,0.000257,172.31.47.0-255,66,36379,96,268979
14505,0.000271,74.125.200.0-255,4320,40699,96,268979
14506,0.000274,172.31.47.0-255,66,40765,96,268979
14507,0.000289,74.125.200.0-255,1484,42249,96,268979
14508,0.000291,172.31.47.0-255,66,42315,96,268979
14509,0.000293,74.125.200.0-255,1484,43799,96,268979
14510,0.000295,172.31.47.0-255,66,43865,96,268979
14511,0.000322,172.31.47.0-255,66,43931,96,268979
14512,0.000327,74.125.200.0-255,4320,48251,96,268979
14513,0.000329,172.31.47.0-255,66,48317,96,268979
14514,0.000351,74.125.200.0-255,7156,55473,96,268979
14515,0.000375,74.125.200.0-255,2543,58016,96,268979
14516,0.0005,74.125.200.0-255,1484,59500,96,268979
14517,0.000514,74.125.200.0-255,2902,62402,96,268979
14518,0.000531,74.125.200.0-255,4320,66722,96,268979
14519,0.000535,172.31.47.0-255,66,66788,96,268979
14520,0.00054,172.31.47.0-255,66,66854,96,268979
14521,0.000555,74.125.200.0-255,5738,72592,96,268979
14522,0.000586,74.125.200.0-255,2902,75494,96,268979
14523,0.000592,172.31.47.0-255,66,75560,96,268979
14524,0.00061,74.125.200.0-255,7156,82716,96,268979
14525,0.000631,172.31.47.0-255,66,82782,96,268979
14526,0.000646,172.31.47.0-255,66,82848,96,268979
14527,0.000772,74.125.200.0-255,1484,84332,96,268979
14528,0.000779,74.125.200.0-255,2902,87234,96,268979
14529,0.000785,74.125.200.0-255,4320,91554,96,268979
14530,0.000849,74.125.200.0-255,2902,94456,96,268979
14531,0.000854,74.125.200.0-255,4320,98776,96,268979
14532,0.00086,172.31.47.0-255,66,98842,96,268979
14533,0.000892,74.125.200.0-255,766,99608,96,268979
14534,0.000895,74.125.200.0-255,1484,101092,96,268979
14535,0.000916,74.125.200.0-255,4320,105412,96,268979
14536,0.000919,74.125.200.0-255,1484,106896,96,268979
14537,0.000922,172.31.47.0-255,66,106962,96,268979
14538,0.000932,74.125.200.0-255,1484,108446,96,268979
14539,0.000935,74.125.200.0-255,1484,109930,96,268979
14540,0.000939,172.31.47.0-255,66,109996,96,268979
14541,0.00095,74.125.200.0-255,2902,112898,96,268979
14542,0.000967,74.125.200.0-255,1484,114382,96,268979
14543,0.000974,172.31.47.0-255,66,114448,96,268979
14544,0.000999,74.125.200.0-255,7156,121604,96,268979
14545,0.001004,74.125.200.0-255,2902,124506,96,268979
14546,0.001012,172.31.47.0-255,66,124572,96,268979
14547,0.001075,172.31.47.0-255,66,124638,96,268979
14548,0.001115,74.125.200.0-255,1484,126122,96,268979
14549,0.001127,74.125.200.0-255,1484,127606,96,268979
14550,0.001145,74.125.200.0-255,1484,129090,96,268979
14551,0.001148,74.125.200.0-255,1484,130574,96,268979
14552,0.001152,74.125.200.0-255,2902,133476,96,268979
14553,0.001155,74.125.200.0-255,1484,134960,96,268979
14554,0.001159,172.31.47.0-255,66,135026,96,268979
14555,0.001178,74.125.200.0-255,4320,139346,96,268979
14556,0.001192,172.31.47.0-255,66,139412,96,268979
14557,0.001262,74.125.200.0-255,766,140178,96,268979
14558,0.001744,74.125.200.0-255,1484,141662,96,268979
14559,0.001751,74.125.200.0-255,2902,144564,96,268979
14560,0.001756,74.125.200.0-255,2902,147466,96,268979
14561,0.001773,74.125.200.0-255,2902,150368,96,268979
14562,0.0018,74.125.200.0-255,5738,156106,96,268979
14563,0.001823,74.125.200.0-255,7156,163262,96,268979
14564,0.001844,74.125.200.0-255,4320,167582,96,268979
14565,0.001879,74.125.200.0-255,2902,170484,96,268979
14566,0.001915,74.125.200.0-255,4320,174804,96,268979
14567,0.001948,74.125.200.0-255,2902,177706,96,268979
14568,0.001993,74.125.200.0-255,5738,183444,96,268979
14569,0.002016,74.125.200.0-255,4320,187764,96,268979
14570,0.002089,74.125.200.0-255,4320,192084,96,268979
14571,0.00214,74.125.200.0-255,4320,196404,96,268979
14572,0.002144,74.125.200.0-255,2902,199306,96,268979
14573,0.002175,74.125.200.0-255,1484,200790,96,268979
14574,0.002179,74.125.200.0-255,3602,204392,96,268979
14575,0.002208,74.125.200.0-255,2902,207294,96,268979
14576,0.002265,74.125.200.0-255,4320,211614,96,268979
14577,0.00227,74.125.200.0-255,5738,217352,96,268979
14578,0.002272,74.125.200.0-255,766,218118,96,268979
14579,0.007447,172.31.47.0-255,66,218184,96,268979
14580,0.009759,74.125.200.0-255,5738,223922,96,268979
14581,0.009768,172.31.47.0-255,66,223988,96,268979
14582,0.01204,74.125.200.0-255,5738,229726,96,268979
14583,0.012047,172.31.47.0-255,66,229792,96,268979
14584,0.014328,74.125.200.0-255,5738,235530,96,268979
14585,0.018025,172.31.47.0-255,66,235596,96,268979
14586,0.020307,74.125.200.0-255,5738,241334,96,268979
14587,0.020318,172.31.47.0-255,66,241400,96,268979
14588,0.022591,74.125.200.0-255,5738,247138,96,268979
14589,0.022599,172.31.47.0-255,66,247204,96,268979
14590,0.02488,74.125.200.0-255,5738,252942,96,268979
14591,0.024886,172.31.47.0-255,66,253008,96,268979
14592,0.027153,74.125.200.0-255,5738,258746,96,268979
14593,0.02716,172.31.47.0-255,66,258812,96,268979
14594,0.029443,74.125.200.0-255,5633,264445,96,268979
14595,0.029451,172.31.47.0-255,66,264511,96,268979
14596,0.029635,172.31.47.0-255,105,264616,96,268979
14597,0.031858,74.125.200.0-255,66,264682,96,268979
14598,0.032564,172.31.47.0-255,172,264854,96,268979
14599,0.032591,172.31.47.0-255,1105,265959,96,268979
14600,0.03264,172.31.47.0-255,1514,267473,96,268979
14601,0.032642,172.31.47.0-255,1308,268781,96,268979
14602,0.034042,104.244.42.0-255,66,268847,96,268979
14603,0.034235,104.244.42.0-255,66,268913,96,268979
14604,0.034239,104.244.42.0-255,66,268979,96,268979
14605,0.0,74.125.130.0-255,153,153,96,226698
14606,1.8e-05,172.31.47.0-255,66,219,96,226698
14607,2.5e-05,74.125.130.0-255,1484,1703,96,226698
14608,2.9e-05,172.31.47.0-255,66,1769,96,226698
14609,3.4e-05,74.125.130.0-255,2902,4671,96,226698
14610,3.8e-05,172.31.47.0-255,66,4737,96,226698
14611,4.1e-05,74.125.130.0-255,1484,6221,96,226698
14612,4.3e-05,172.31.47.0-255,66,6287,96,226698
14613,8.7e-05,74.125.130.0-255,5738,12025,96,226698
14614,9.1e-05,172.31.47.0-255,66,12091,96,226698
14615,9.8e-05,74.125.130.0-255,6332,18423,96,226698
14616,0.0001,172.31.47.0-255,66,18489,96,226698
14617,0.000107,74.125.130.0-255,7156,25645,96,226698
14618,0.00011,172.31.47.0-255,66,25711,96,226698
14619,0.000115,74.125.130.0-255,5379,31090,96,226698
14620,0.000117,172.31.47.0-255,66,31156,96,226698
14621,0.000204,74.125.130.0-255,1484,32640,96,226698
14622,0.000209,172.31.47.0-255,66,32706,96,226698
14623,0.000216,74.125.130.0-255,2902,35608,96,226698
14624,0.000218,172.31.47.0-255,66,35674,96,226698
14625,0.000223,74.125.130.0-255,2902,38576,96,226698
14626,0.000225,172.31.47.0-255,66,38642,96,226698
14627,0.000248,74.125.130.0-255,2902,41544,96,226698
14628,0.000252,172.31.47.0-255,66,41610,96,226698
14629,0.000257,74.125.130.0-255,4320,45930,96,226698
14630,0.000259,172.31.47.0-255,66,45996,96,226698
14631,0.000293,172.31.47.0-255,66,46062,96,226698
14632,0.000309,74.125.130.0-255,1484,47546,96,226698
14633,0.000311,172.31.47.0-255,66,47612,96,226698
14634,0.000345,172.31.47.0-255,66,47678,96,226698
14635,0.000348,74.125.130.0-255,116,47794,96,226698
14636,0.000469,74.125.130.0-255,1484,49278,96,226698
14637,0.000489,74.125.130.0-255,2902,52180,96,226698
14638,0.000495,74.125.130.0-255,5738,57918,96,226698
14639,0.000517,74.125.130.0-255,5738,63656,96,226698
14640,0.000528,74.125.130.0-255,1434,65090,96,226698
14641,0.000558,172.31.47.0-255,66,65156,96,226698
14642,0.000566,74.125.130.0-255,1484,66640,96,226698
14643,0.000584,74.125.130.0-255,5738,72378,96,226698
14644,0.00059,74.125.130.0-255,5738,78116,96,226698
14645,0.000605,74.125.130.0-255,2902,81018,96,226698
14646,0.000608,74.125.130.0-255,1125,82143,96,226698
14647,0.000627,172.31.47.0-255,66,82209,96,226698
14648,0.001727,74.125.130.0-255,1484,83693,96,226698
14649,0.001735,74.125.130.0-255,2902,86595,96,226698
14650,0.001739,172.31.47.0-255,66,86661,96,226698
14651,0.001746,74.125.130.0-255,5738,92399,96,226698
14652,0.001831,74.125.130.0-255,7156,99555,96,226698
14653,0.00185,74.125.130.0-255,3602,103157,96,226698
14654,0.007059,172.31.47.0-255,66,103223,96,226698
14655,0.009668,74.125.130.0-255,5738,108961,96,226698
14656,0.00968,172.31.47.0-255,66,109027,96,226698
14657,0.012272,74.125.130.0-255,5738,114765,96,226698
14658,0.018524,172.31.47.0-255,66,114831,96,226698
14659,0.021097,172.31.47.0-255,172,115003,96,226698
14660,0.021113,74.125.130.0-255,4320,119323,96,226698
14661,0.021124,172.31.47.0-255,66,119389,96,226698
14662,0.021141,74.125.130.0-255,1484,120873,96,226698
14663,0.021153,172.31.47.0-255,1110,121983,96,226698
14664,0.021205,172.31.47.0-255,1514,123497,96,226698
14665,0.021206,172.31.47.0-255,1301,124798,96,226698
14666,0.022664,104.244.42.0-255,66,124864,96,226698
14667,0.022717,104.244.42.0-255,66,124930,96,226698
14668,0.022767,104.244.42.0-255,66,124996,96,226698
14669,0.023702,74.125.130.0-255,4320,129316,96,226698
14670,0.023707,172.31.47.0-255,66,129382,96,226698
14671,0.026317,74.125.130.0-255,5738,135120,96,226698
14672,0.026367,172.31.47.0-255,66,135186,96,226698
14673,0.028974,74.125.130.0-255,5738,140924,96,226698
14674,0.028979,172.31.47.0-255,66,140990,96,226698
14675,0.031566,74.125.130.0-255,5738,146728,96,226698
14676,0.031573,172.31.47.0-255,66,146794,96,226698
14677,0.034156,74.125.130.0-255,5738,152532,96,226698
14678,0.034162,172.31.47.0-255,66,152598,96,226698
14679,0.036751,74.125.130.0-255,5738,158336,96,226698
14680,0.036758,172.31.47.0-255,66,158402,96,226698
14681,0.039344,74.125.130.0-255,5738,164140,96,226698
14682,0.039351,172.31.47.0-255,66,164206,96,226698
14683,0.041948,74.125.130.0-255,5738,169944,96,226698
14684,0.041956,172.31.47.0-255,66,170010,96,226698
14685,0.04456,74.125.130.0-255,5738,175748,96,226698
14686,0.044565,172.31.47.0-255,66,175814,96,226698
14687,0.04717,74.125.130.0-255,5738,181552,96,226698
14688,0.047176,172.31.47.0-255,66,181618,96,226698
14689,0.049778,74.125.130.0-255,5738,187356,96,226698
14690,0.049785,172.31.47.0-255,66,187422,96,226698
14691,0.052369,74.125.130.0-255,5738,193160,96,226698
14692,0.052376,172.31.47.0-255,66,193226,96,226698
14693,0.054957,74.125.130.0-255,4320,197546,96,226698
14694,0.054962,172.31.47.0-255,66,197612,96,226698
14695,0.054981,74.125.130.0-255,1484,199096,96,226698
14696,0.057557,74.125.130.0-255,4320,203416,96,226698
14697,0.057564,172.31.47.0-255,66,203482,96,226698
14698,0.060154,74.125.130.0-255,5738,209220,96,226698
14699,0.0602,172.31.47.0-255,66,209286,96,226698
14700,0.062822,74.125.130.0-255,5738,215024,96,226698
14701,0.062828,172.31.47.0-255,66,215090,96,226698
14702,0.065455,74.125.130.0-255,5738,220828,96,226698
14703,0.06546,172.31.47.0-255,66,220894,96,226698
14704,0.068042,74.125.130.0-255,5738,226632,96,226698
14705,0.068048,172.31.47.0-255,66,226698,96,226698
14706,0.0,172.217.194.0-255,153,153,96,207763
14707,1.8e-05,172.31.47.0-255,66,219,96,207763
14708,2.5e-05,172.217.194.0-255,1484,1703,96,207763
14709,2.9e-05,172.31.47.0-255,66,1769,96,207763
14710,3.3e-05,172.217.194.0-255,2902,4671,96,207763
14711,3.6e-05,172.31.47.0-255,66,4737,96,207763
14712,4.9e-05,172.217.194.0-255,7156,11893,96,207763
14713,5.2e-05,172.31.47.0-255,66,11959,96,207763
14714,5.5e-05,172.217.194.0-255,2170,14129,96,207763
14715,5.8e-05,172.31.47.0-255,66,14195,96,207763
14716,0.000146,172.217.194.0-255,1484,15679,96,207763
14717,0.000149,172.31.47.0-255,66,15745,96,207763
14718,0.000152,172.217.194.0-255,1484,17229,96,207763
14719,0.000155,172.31.47.0-255,66,17295,96,207763
14720,0.00017,172.217.194.0-255,1484,18779,96,207763
14721,0.000172,172.31.47.0-255,66,18845,96,207763
14722,0.000201,172.217.194.0-255,5738,24583,96,207763
14723,0.000204,172.31.47.0-255,66,24649,96,207763
14724,0.000232,172.217.194.0-255,6797,31446,96,207763
14725,0.000234,172.31.47.0-255,66,31512,96,207763
14726,0.000238,172.217.194.0-255,2902,34414,96,207763
14727,0.00024,172.31.47.0-255,66,34480,96,207763
14728,0.000259,172.217.194.0-255,4320,38800,96,207763
14729,0.000262,172.31.47.0-255,66,38866,96,207763
14730,0.000302,172.31.47.0-255,66,38932,96,207763
14731,0.000639,172.217.194.0-255,1484,40416,96,207763
14732,0.000643,172.31.47.0-255,66,40482,96,207763
14733,0.000648,172.217.194.0-255,2902,43384,96,207763
14734,0.000649,172.31.47.0-255,66,43450,96,207763
14735,0.000658,172.217.194.0-255,5738,49188,96,207763
14736,0.00066,172.31.47.0-255,66,49254,96,207763
14737,0.000703,172.31.47.0-255,66,49320,96,207763
14738,0.000712,172.31.47.0-255,66,49386,96,207763
14739,0.000739,172.31.47.0-255,66,49452,96,207763
14740,0.00078,172.217.194.0-255,4320,53772,96,207763
14741,0.000783,172.31.47.0-255,66,53838,96,207763
14742,0.000814,172.217.194.0-255,4320,58158,96,207763
14743,0.000817,172.31.47.0-255,66,58224,96,207763
14744,0.000826,172.31.47.0-255,66,58290,96,207763
14745,0.00085,172.217.194.0-255,1484,59774,96,207763
14746,0.000854,172.217.194.0-255,2902,62676,96,207763
14747,0.000855,172.31.47.0-255,66,62742,96,207763
14748,0.000883,172.217.194.0-255,5738,68480,96,207763
14749,0.000885,172.31.47.0-255,66,68546,96,207763
14750,0.000928,172.217.194.0-255,6248,74794,96,207763
14751,0.000931,172.31.47.0-255,66,74860,96,207763
14752,0.000977,172.217.194.0-255,1484,76344,96,207763
14753,0.000981,172.217.194.0-255,1484,77828,96,207763
14754,0.000983,172.31.47.0-255,66,77894,96,207763
14755,0.001005,172.217.194.0-255,1484,79378,96,207763
14756,0.001012,172.217.194.0-255,5738,85116,96,207763
14757,0.001014,172.31.47.0-255,66,85182,96,207763
14758,0.001018,172.217.194.0-255,2902,88084,96,207763
14759,0.001019,172.31.47.0-255,66,88150,96,207763
14760,0.001065,172.31.47.0-255,66,88216,96,207763
14761,0.001075,172.31.47.0-255,66,88282,96,207763
14762,0.001078,172.217.194.0-255,766,89048,96,207763
14763,0.001711,172.217.194.0-255,1484,90532,96,207763
14764,0.001715,172.31.47.0-255,66,90598,96,207763
14765,0.001721,172.217.194.0-255,2902,93500,96,207763
14766,0.001722,172.31.47.0-255,66,93566,96,207763
14767,0.001725,172.217.194.0-255,1484,95050,96,207763
14768,0.001748,172.217.194.0-255,4320,99370,96,207763
14769,0.00175,172.31.47.0-255,66,99436,96,207763
14770,0.001762,172.31.47.0-255,66,99502,96,207763
14771,0.001802,172.217.194.0-255,2902,102404,96,207763
14772,0.001805,172.31.47.0-255,66,102470,96,207763
14773,0.001836,172.31.47.0-255,66,102536,96,207763
14774,0.002624,172.217.194.0-255,1484,104020,96,207763
14775,0.002635,172.217.194.0-255,2902,106922,96,207763
14776,0.002638,172.31.47.0-255,66,106988,96,207763
14777,0.002646,172.217.194.0-255,5738,112726,96,207763
14778,0.002647,172.31.47.0-255,66,112792,96,207763
14779,0.00269,172.31.47.0-255,66,112858,96,207763
14780,0.002702,172.31.47.0-255,66,112924,96,207763
14781,0.002821,172.217.194.0-255,1484,114408,96,207763
14782,0.002826,172.217.194.0-255,2902,117310,96,207763
14783,0.002828,172.31.47.0-255,66,117376,96,207763
14784,0.002834,172.217.194.0-255,5738,123114,96,207763
14785,0.002836,172.31.47.0-255,66,123180,96,207763
14786,0.002868,172.31.47.0-255,66,123246,96,207763
14787,0.002892,172.217.194.0-255,2902,126148,96,207763
14788,0.002894,172.31.47.0-255,66,126214,96,207763
14789,0.002909,172.31.47.0-255,66,126280,96,207763
14790,0.002916,172.217.194.0-255,1484,127764,96,207763
14791,0.002919,172.217.194.0-255,1484,129248,96,207763
14792,0.00292,172.31.47.0-255,66,129314,96,207763
14793,0.002923,172.217.194.0-255,1484,130798,96,207763
14794,0.002947,172.217.194.0-255,4320,135118,96,207763
14795,0.002949,172.31.47.0-255,66,135184,96,207763
14796,0.002979,172.31.47.0-255,66,135250,96,207763
14797,0.002988,172.31.47.0-255,66,135316,96,207763
14798,0.002997,172.217.194.0-255,4320,139636,96,207763
14799,0.002998,172.31.47.0-255,66,139702,96,207763
14800,0.003035,172.217.194.0-255,3602,143304,96,207763
14801,0.003037,172.31.47.0-255,66,143370,96,207763
14802,0.003121,172.217.194.0-255,1484,144854,96,207763
14803,0.003137,172.217.194.0-255,2902,147756,96,207763
14804,0.003139,172.31.47.0-255,66,147822,96,207763
14805,0.003143,172.217.194.0-255,2902,150724,96,207763
14806,0.003145,172.31.47.0-255,66,150790,96,207763
14807,0.003164,172.217.194.0-255,2902,153692,96,207763
14808,0.003166,172.31.47.0-255,66,153758,96,207763
14809,0.003183,172.31.47.0-255,66,153824,96,207763
14810,0.003187,172.217.194.0-255,2902,156726,96,207763
14811,0.003189,172.31.47.0-255,66,156792,96,207763
14812,0.0032,172.31.47.0-255,66,156858,96,207763
14813,0.003236,172.217.194.0-255,1484,158342,96,207763
14814,0.00324,172.217.194.0-255,2902,161244,96,207763
14815,0.003243,172.31.47.0-255,66,161310,96,207763
14816,0.003249,172.217.194.0-255,5738,167048,96,207763
14817,0.003251,172.31.47.0-255,66,167114,96,207763
14818,0.003253,172.217.194.0-255,1484,168598,96,207763
14819,0.00328,172.217.194.0-255,1484,170082,96,207763
14820,0.003281,172.31.47.0-255,66,170148,96,207763
14821,0.003285,172.217.194.0-255,1484,171632,96,207763
14822,0.003291,172.217.194.0-255,5738,177370,96,207763
14823,0.003293,172.31.47.0-255,66,177436,96,207763
14824,0.003299,172.217.194.0-255,5738,183174,96,207763
14825,0.003301,172.31.47.0-255,66,183240,96,207763
14826,0.003328,172.217.194.0-255,1484,184724,96,207763
14827,0.00333,172.31.47.0-255,78,184802,96,207763
14828,0.00334,172.31.47.0-255,66,184868,96,207763
14829,0.003346,172.217.194.0-255,5738,190606,96,207763
14830,0.003351,172.217.194.0-255,4320,194926,96,207763
14831,0.00339,172.217.194.0-255,4320,199246,96,207763
14832,0.003428,172.217.194.0-255,766,200012,96,207763
14833,0.003448,172.217.194.0-255,1484,201496,96,207763
14834,0.003481,172.217.194.0-255,2597,204093,96,207763
14835,0.003484,172.217.194.0-255,105,204198,96,207763
14836,0.005248,172.31.47.0-255,66,204264,96,207763
14837,0.007019,172.31.47.0-255,105,204369,96,207763
14838,0.009237,172.217.194.0-255,66,204435,96,207763
14839,0.030127,172.31.47.0-255,172,204607,96,207763
14840,0.030156,172.31.47.0-255,1109,205716,96,207763
14841,0.030208,172.31.47.0-255,1514,207230,96,207763
14842,0.030209,172.31.47.0-255,335,207565,96,207763
14843,0.031702,104.244.42.0-255,66,207631,96,207763
14844,0.03173,104.244.42.0-255,66,207697,96,207763
14845,0.031791,104.244.42.0-255,66,207763,96,207763
14846,0.0,74.125.24.0-255,153,153,96,280617
14847,3e-05,172.31.47.0-255,66,219,96,280617
14848,3.6e-05,74.125.24.0-255,1484,1703,96,280617
14849,4e-05,172.31.47.0-255,66,1769,96,280617
14850,4.4e-05,74.125.24.0-255,2902,4671,96,280617
14851,4.6e-05,172.31.47.0-255,66,4737,96,280617
14852,5.1e-05,74.125.24.0-255,7156,11893,96,280617
14853,5.3e-05,172.31.47.0-255,66,11959,96,280617
14854,9.7e-05,172.31.47.0-255,66,12025,96,280617
14855,0.000117,74.125.24.0-255,2543,14568,96,280617
14856,0.000119,172.31.47.0-255,66,14634,96,280617
14857,0.000167,74.125.24.0-255,1484,16118,96,280617
14858,0.00017,172.31.47.0-255,66,16184,96,280617
14859,0.000174,74.125.24.0-255,2902,19086,96,280617
14860,0.000176,172.31.47.0-255,66,19152,96,280617
14861,0.000179,74.125.24.0-255,1484,20636,96,280617
14862,0.00018,172.31.47.0-255,66,20702,96,280617
14863,0.000201,74.125.24.0-255,4320,25022,96,280617
14864,0.000204,172.31.47.0-255,66,25088,96,280617
14865,0.000208,74.125.24.0-255,4320,29408,96,280617
14866,0.00021,172.31.47.0-255,66,29474,96,280617
14867,0.000244,172.31.47.0-255,66,29540,96,280617
14868,0.000253,172.31.47.0-255,66,29606,96,280617
14869,0.000267,74.125.24.0-255,1484,31090,96,280617
14870,0.000269,172.31.47.0-255,66,31156,96,280617
14871,0.000301,74.125.24.0-255,328,31484,96,280617
14872,0.000304,172.31.47.0-255,66,31550,96,280617
14873,0.000402,74.125.24.0-255,1484,33034,96,280617
14874,0.000405,172.31.47.0-255,66,33100,96,280617
14875,0.00041,74.125.24.0-255,2902,36002,96,280617
14876,0.000411,172.31.47.0-255,66,36068,96,280617
14877,0.000427,74.125.24.0-255,2902,38970,96,280617
14878,0.000429,172.31.47.0-255,66,39036,96,280617
14879,0.000432,74.125.24.0-255,1484,40520,96,280617
14880,0.000443,74.125.24.0-255,2902,43422,96,280617
14881,0.000445,172.31.47.0-255,66,43488,96,280617
14882,0.000478,172.31.47.0-255,66,43554,96,280617
14883,0.00049,172.31.47.0-255,66,43620,96,280617
14884,0.0005,74.125.24.0-255,216,43836,96,280617
14885,0.000733,74.125.24.0-255,1484,45320,96,280617
14886,0.000737,172.31.47.0-255,66,45386,96,280617
14887,0.000749,74.125.24.0-255,2902,48288,96,280617
14888,0.000751,172.31.47.0-255,66,48354,96,280617
14889,0.000772,74.125.24.0-255,5738,54092,96,280617
14890,0.000775,172.31.47.0-255,66,54158,96,280617
14891,0.000779,74.125.24.0-255,4320,58478,96,280617
14892,0.000783,172.31.47.0-255,66,58544,96,280617
14893,0.0008,74.125.24.0-255,4320,62864,96,280617
14894,0.000802,172.31.47.0-255,66,62930,96,280617
14895,0.000848,74.125.24.0-255,4320,67250,96,280617
14896,0.000851,172.31.47.0-255,66,67316,96,280617
14897,0.000878,172.31.47.0-255,66,67382,96,280617
14898,0.001643,74.125.24.0-255,1484,68866,96,280617
14899,0.001652,74.125.24.0-255,2902,71768,96,280617
14900,0.001656,172.31.47.0-255,66,71834,96,280617
14901,0.001662,74.125.24.0-255,2902,74736,96,280617
14902,0.001663,172.31.47.0-255,66,74802,96,280617
14903,0.001677,74.125.24.0-255,2902,77704,96,280617
14904,0.001679,172.31.47.0-255,66,77770,96,280617
14905,0.001684,74.125.24.0-255,5738,83508,96,280617
14906,0.001685,172.31.47.0-255,66,83574,96,280617
14907,0.001712,74.125.24.0-255,7156,90730,96,280617
14908,0.001713,172.31.47.0-255,66,90796,96,280617
14909,0.001719,74.125.24.0-255,7156,97952,96,280617
14910,0.001721,172.31.47.0-255,66,98018,96,280617
14911,0.00174,74.125.24.0-255,3602,101620,96,280617
14912,0.001742,172.31.47.0-255,66,101686,96,280617
14913,0.001768,74.125.24.0-255,2902,104588,96,280617
14914,0.001769,172.31.47.0-255,66,104654,96,280617
14915,0.001782,74.125.24.0-255,1484,106138,96,280617
14916,0.001786,74.125.24.0-255,2902,109040,96,280617
14917,0.001787,172.31.47.0-255,66,109106,96,280617
14918,0.001817,74.125.24.0-255,7156,116262,96,280617
14919,0.001819,172.31.47.0-255,66,116328,96,280617
14920,0.001824,74.125.24.0-255,7156,123484,96,280617
14921,0.001826,172.31.47.0-255,66,123550,96,280617
14922,0.00189,172.31.47.0-255,66,123616,96,280617
14923,0.001899,172.31.47.0-255,66,123682,96,280617
14924,0.001931,172.31.47.0-255,66,123748,96,280617
14925,0.001963,172.31.47.0-255,66,123814,96,280617
14926,0.001975,172.31.47.0-255,66,123880,96,280617
14927,0.001995,172.31.47.0-255,66,123946,96,280617
14928,0.004007,74.125.24.0-255,5738,129684,96,280617
14929,0.00401,172.31.47.0-255,66,129750,96,280617
14930,0.006027,74.125.24.0-255,5738,135488,96,280617
14931,0.006033,172.31.47.0-255,66,135554,96,280617
14932,0.008052,74.125.24.0-255,5738,141292,96,280617
14933,0.008058,172.31.47.0-255,66,141358,96,280617
14934,0.01006,74.125.24.0-255,5738,147096,96,280617
14935,0.010066,172.31.47.0-255,66,147162,96,280617
14936,0.012077,74.125.24.0-255,5738,152900,96,280617
14937,0.012083,172.31.47.0-255,66,152966,96,280617
14938,0.014095,74.125.24.0-255,4320,157286,96,280617
14939,0.014101,172.31.47.0-255,66,157352,96,280617
14940,0.014135,74.125.24.0-255,1484,158836,96,280617
14941,0.0161,74.125.24.0-255,4320,163156,96,280617
14942,0.016108,172.31.47.0-255,66,163222,96,280617
14943,0.018131,74.125.24.0-255,5738,168960,96,280617
14944,0.018137,172.31.47.0-255,66,169026,96,280617
14945,0.020148,74.125.24.0-255,5738,174764,96,280617
14946,0.020153,172.31.47.0-255,66,174830,96,280617
14947,0.022163,74.125.24.0-255,5738,180568,96,280617
14948,0.02217,172.31.47.0-255,66,180634,96,280617
14949,0.02419,74.125.24.0-255,5738,186372,96,280617
14950,0.024196,172.31.47.0-255,66,186438,96,280617
14951,0.025381,172.31.47.0-255,172,186610,96,280617
14952,0.02541,172.31.47.0-255,1110,187720,96,280617
14953,0.025455,172.31.47.0-255,1514,189234,96,280617
14954,0.025457,172.31.47.0-255,1514,190748,96,280617
14955,0.025462,172.31.47.0-255,1514,192262,96,280617
14956,0.025463,172.31.47.0-255,1082,193344,96,280617
14957,0.026193,74.125.24.0-255,5738,199082,96,280617
14958,0.026199,172.31.47.0-255,66,199148,96,280617
14959,0.026948,104.244.42.0-255,66,199214,96,280617
14960,0.026986,104.244.42.0-255,66,199280,96,280617
14961,0.027035,104.244.42.0-255,66,199346,96,280617
14962,0.027037,104.244.42.0-255,66,199412,96,280617
14963,0.028203,74.125.24.0-255,4320,203732,96,280617
14964,0.028207,172.31.47.0-255,66,203798,96,280617
14965,0.028232,74.125.24.0-255,1484,205282,96,280617
14966,0.030197,74.125.24.0-255,4320,209602,96,280617
14967,0.030202,172.31.47.0-255,66,209668,96,280617
14968,0.032214,74.125.24.0-255,5738,215406,96,280617
14969,0.032218,172.31.47.0-255,66,215472,96,280617
14970,0.034228,74.125.24.0-255,5738,221210,96,280617
14971,0.034233,172.31.47.0-255,66,221276,96,280617
14972,0.036262,74.125.24.0-255,5738,227014,96,280617
14973,0.036267,172.31.47.0-255,66,227080,96,280617
14974,0.038269,74.125.24.0-255,5738,232818,96,280617
14975,0.038273,172.31.47.0-255,66,232884,96,280617
14976,0.040282,74.125.24.0-255,5738,238622,96,280617
14977,0.040287,172.31.47.0-255,66,238688,96,280617
14978,0.042299,74.125.24.0-255,5738,244426,96,280617
14979,0.042304,172.31.47.0-255,66,244492,96,280617
14980,0.04434,74.125.24.0-255,5738,250230,96,280617
14981,0.044344,172.31.47.0-255,66,250296,96,280617
14982,0.046352,74.125.24.0-255,5738,256034,96,280617
14983,0.046357,172.31.47.0-255,66,256100,96,280617
14984,0.048374,74.125.24.0-255,5738,261838,96,280617
14985,0.048378,172.31.47.0-255,66,261904,96,280617
14986,0.050383,74.125.24.0-255,5738,267642,96,280617
14987,0.050388,172.31.47.0-255,66,267708,96,280617
14988,0.052411,74.125.24.0-255,5738,273446,96,280617
14989,0.052415,172.31.47.0-255,66,273512,96,280617
14990,0.054421,74.125.24.0-255,5738,279250,96,280617
14991,0.054426,172.31.47.0-255,66,279316,96,280617
14992,0.056419,74.125.24.0-255,1064,280380,96,280617
14993,0.05656,172.31.47.0-255,66,280446,96,280617
14994,0.056587,172.31.47.0-255,105,280551,96,280617
14995,0.058556,74.125.24.0-255,66,280617,96,280617
14996,0.0,74.125.24.0-255,373,373,96,204082
14997,3.3e-05,172.31.47.0-255,66,439,96,204082
14998,4e-05,74.125.24.0-255,1484,1923,96,204082
14999,4.4e-05,172.31.47.0-255,66,1989,96,204082
15000,5e-05,74.125.24.0-255,4320,6309,96,204082
15001,6e-05,172.31.47.0-255,66,6375,96,204082
15002,0.000215,172.31.47.0-255,66,6441,96,204082
15003,0.000524,74.125.24.0-255,2902,9343,96,204082
15004,0.000529,172.31.47.0-255,66,9409,96,204082
15005,0.000639,74.125.24.0-255,7156,16565,96,204082
15006,0.000644,172.31.47.0-255,66,16631,96,204082
15007,0.000678,74.125.24.0-255,5536,22167,96,204082
15008,0.000682,172.31.47.0-255,66,22233,96,204082
15009,0.00297,74.125.24.0-255,5738,27971,96,204082
15010,0.002976,172.31.47.0-255,66,28037,96,204082
15011,0.005236,74.125.24.0-255,5738,33775,96,204082
15012,0.005241,172.31.47.0-255,66,33841,96,204082
15013,0.007527,74.125.24.0-255,2902,36743,96,204082
15014,0.007533,172.31.47.0-255,66,36809,96,204082
15015,0.007565,74.125.24.0-255,2902,39711,96,204082
15016,0.007569,172.31.47.0-255,66,39777,96,204082
15017,0.009806,74.125.24.0-255,2902,42679,96,204082
15018,0.009815,172.31.47.0-255,66,42745,96,204082
15019,0.009865,74.125.24.0-255,2902,45647,96,204082
15020,0.00987,172.31.47.0-255,66,45713,96,204082
15021,0.012099,74.125.24.0-255,2902,48615,96,204082
15022,0.012114,172.31.47.0-255,66,48681,96,204082
15023,0.012163,74.125.24.0-255,2902,51583,96,204082
15024,0.012168,172.31.47.0-255,66,51649,96,204082
15025,0.014407,74.125.24.0-255,2902,54551,96,204082
15026,0.014424,172.31.47.0-255,66,54617,96,204082
15027,0.01447,74.125.24.0-255,2902,57519,96,204082
15028,0.014475,172.31.47.0-255,66,57585,96,204082
15029,0.016702,74.125.24.0-255,2902,60487,96,204082
15030,0.01671,172.31.47.0-255,66,60553,96,204082
15031,0.016736,74.125.24.0-255,2902,63455,96,204082
15032,0.016739,172.31.47.0-255,66,63521,96,204082
15033,0.019009,74.125.24.0-255,2902,66423,96,204082
15034,0.019013,172.31.47.0-255,66,66489,96,204082
15035,0.019056,74.125.24.0-255,2902,69391,96,204082
15036,0.019058,172.31.47.0-255,66,69457,96,204082
15037,0.0213,74.125.24.0-255,2902,72359,96,204082
15038,0.021307,172.31.47.0-255,66,72425,96,204082
15039,0.021342,74.125.24.0-255,2902,75327,96,204082
15040,0.021346,172.31.47.0-255,66,75393,96,204082
15041,0.023559,74.125.24.0-255,2902,78295,96,204082
15042,0.023567,172.31.47.0-255,66,78361,96,204082
15043,0.023629,74.125.24.0-255,2902,81263,96,204082
15044,0.023633,172.31.47.0-255,66,81329,96,204082
15045,0.025876,74.125.24.0-255,2902,84231,96,204082
15046,0.025891,172.31.47.0-255,66,84297,96,204082
15047,0.025941,74.125.24.0-255,2902,87199,96,204082
15048,0.025946,172.31.47.0-255,66,87265,96,204082
15049,0.028178,74.125.24.0-255,2902,90167,96,204082
15050,0.028195,172.31.47.0-255,66,90233,96,204082
15051,0.028249,74.125.24.0-255,2902,93135,96,204082
15052,0.028254,172.31.47.0-255,66,93201,96,204082
15053,0.030477,74.125.24.0-255,2902,96103,96,204082
15054,0.030494,172.31.47.0-255,66,96169,96,204082
15055,0.030542,74.125.24.0-255,2902,99071,96,204082
15056,0.030546,172.31.47.0-255,66,99137,96,204082
15057,0.032784,74.125.24.0-255,2902,102039,96,204082
15058,0.0328,172.31.47.0-255,66,102105,96,204082
15059,0.032847,74.125.24.0-255,2902,105007,96,204082
15060,0.03285,172.31.47.0-255,66,105073,96,204082
15061,0.033211,172.31.47.0-255,172,105245,96,204082
15062,0.03325,172.31.47.0-255,1101,106346,96,204082
15063,0.03333,172.31.47.0-255,1514,107860,96,204082
15064,0.033332,172.31.47.0-255,1312,109172,96,204082
15065,0.034699,104.244.42.0-255,66,109238,96,204082
15066,0.034736,104.244.42.0-255,66,109304,96,204082
15067,0.034832,104.244.42.0-255,66,109370,96,204082
15068,0.035067,74.125.24.0-255,2902,112272,96,204082
15069,0.035072,172.31.47.0-255,66,112338,96,204082
15070,0.035117,74.125.24.0-255,2902,115240,96,204082
15071,0.035121,172.31.47.0-255,66,115306,96,204082
15072,0.037361,74.125.24.0-255,2902,118208,96,204082
15073,0.037371,172.31.47.0-255,66,118274,96,204082
15074,0.037421,74.125.24.0-255,2902,121176,96,204082
15075,0.037426,172.31.47.0-255,66,121242,96,204082
15076,0.039681,74.125.24.0-255,2902,124144,96,204082
15077,0.039699,172.31.47.0-255,66,124210,96,204082
15078,0.039752,74.125.24.0-255,2902,127112,96,204082
15079,0.039757,172.31.47.0-255,66,127178,96,204082
15080,0.042004,74.125.24.0-255,2902,130080,96,204082
15081,0.04202,172.31.47.0-255,66,130146,96,204082
15082,0.042062,74.125.24.0-255,2902,133048,96,204082
15083,0.042067,172.31.47.0-255,66,133114,96,204082
15084,0.044373,74.125.24.0-255,5738,138852,96,204082
15085,0.044393,172.31.47.0-255,66,138918,96,204082
15086,0.046688,74.125.24.0-255,5738,144656,96,204082
15087,0.046702,172.31.47.0-255,66,144722,96,204082
15088,0.048985,74.125.24.0-255,5738,150460,96,204082
15089,0.048991,172.31.47.0-255,66,150526,96,204082
15090,0.05127,74.125.24.0-255,5738,156264,96,204082
15091,0.051275,172.31.47.0-255,66,156330,96,204082
15092,0.053524,74.125.24.0-255,2902,159232,96,204082
15093,0.05353,172.31.47.0-255,66,159298,96,204082
15094,0.053558,74.125.24.0-255,1484,160782,96,204082
15095,0.053561,172.31.47.0-255,66,160848,96,204082
15096,0.053589,74.125.24.0-255,1484,162332,96,204082
15097,0.053592,172.31.47.0-255,66,162398,96,204082
15098,0.055806,74.125.24.0-255,2902,165300,96,204082
15099,0.055812,172.31.47.0-255,66,165366,96,204082
15100,0.055868,74.125.24.0-255,2902,168268,96,204082
15101,0.055872,172.31.47.0-255,66,168334,96,204082
15102,0.058088,74.125.24.0-255,2902,171236,96,204082
15103,0.058093,172.31.47.0-255,66,171302,96,204082
15104,0.058133,74.125.24.0-255,2902,174204,96,204082
15105,0.058137,172.31.47.0-255,66,174270,96,204082
15106,0.060367,74.125.24.0-255,2902,177172,96,204082
15107,0.060373,172.31.47.0-255,66,177238,96,204082
15108,0.060418,74.125.24.0-255,2902,180140,96,204082
15109,0.060422,172.31.47.0-255,66,180206,96,204082
15110,0.062667,74.125.24.0-255,2902,183108,96,204082
15111,0.062672,172.31.47.0-255,66,183174,96,204082
15112,0.062706,74.125.24.0-255,2902,186076,96,204082
15113,0.06271,172.31.47.0-255,66,186142,96,204082
15114,0.064935,74.125.24.0-255,2902,189044,96,204082
15115,0.064941,172.31.47.0-255,66,189110,96,204082
15116,0.064971,74.125.24.0-255,1484,190594,96,204082
15117,0.064974,172.31.47.0-255,66,190660,96,204082
15118,0.064996,74.125.24.0-255,1484,192144,96,204082
15119,0.064999,172.31.47.0-255,66,192210,96,204082
15120,0.06723,74.125.24.0-255,2902,195112,96,204082
15121,0.067235,172.31.47.0-255,66,195178,96,204082
15122,0.067265,74.125.24.0-255,2902,198080,96,204082
15123,0.067268,172.31.47.0-255,66,198146,96,204082
15124,0.069511,74.125.24.0-255,2902,201048,96,204082
15125,0.069517,172.31.47.0-255,66,201114,96,204082
15126,0.069561,74.125.24.0-255,2902,204016,96,204082
15127,0.069564,172.31.47.0-255,66,204082,96,204082
15128,0.0,172.31.47.0-255,105,105,96,828
15129,4.7e-05,172.31.47.0-255,105,210,96,828
15130,7.4e-05,172.31.47.0-255,105,315,96,828
15131,0.001575,157.240.13.0-255,105,420,96,828
15132,0.002064,157.240.13.0-255,105,525,96,828
15133,0.040901,172.31.47.0-255,66,591,96,828
15134,0.040909,172.31.47.0-255,66,657,96,828
15135,0.067877,31.13.82.0-255,105,762,96,828
15136,0.067898,172.31.47.0-255,66,828,96,828
15137,0.0,172.31.47.0-255,105,105,96,276
15138,0.002524,157.240.13.0-255,105,210,96,276
15139,0.002539,172.31.47.0-255,66,276,96,276
15140,0.0,74.125.68.0-255,153,153,96,323003
15141,2.9e-05,172.31.47.0-255,66,219,96,323003
15142,3.6e-05,74.125.68.0-255,1484,1703,96,323003
15143,4e-05,172.31.47.0-255,66,1769,96,323003
15144,4.4e-05,74.125.68.0-255,2902,4671,96,323003
15145,4.6e-05,172.31.47.0-255,66,4737,96,323003
15146,5e-05,74.125.68.0-255,2902,7639,96,323003
15147,5.2e-05,172.31.47.0-255,66,7705,96,323003
15148,8.1e-05,74.125.68.0-255,4320,12025,96,323003
15149,8.4e-05,172.31.47.0-255,66,12091,96,323003
15150,0.000101,74.125.68.0-255,2009,14100,96,323003
15151,0.000104,172.31.47.0-255,66,14166,96,323003
15152,0.000123,74.125.68.0-255,2902,17068,96,323003
15153,0.000125,172.31.47.0-255,66,17134,96,323003
15154,0.000129,74.125.68.0-255,2902,20036,96,323003
15155,0.000131,172.31.47.0-255,66,20102,96,323003
15156,0.000147,74.125.68.0-255,4320,24422,96,323003
15157,0.000149,172.31.47.0-255,66,24488,96,323003
15158,0.000154,74.125.68.0-255,5738,30226,96,323003
15159,0.000156,172.31.47.0-255,66,30292,96,323003
15160,0.000185,74.125.68.0-255,1125,31417,96,323003
15161,0.000187,172.31.47.0-255,66,31483,96,323003
15162,0.00026,74.125.68.0-255,1484,32967,96,323003
15163,0.000264,172.31.47.0-255,66,33033,96,323003
15164,0.000268,74.125.68.0-255,2902,35935,96,323003
15165,0.000271,172.31.47.0-255,66,36001,96,323003
15166,0.000298,74.125.68.0-255,5738,41739,96,323003
15167,0.000302,172.31.47.0-255,66,41805,96,323003
15168,0.000306,74.125.68.0-255,4320,46125,96,323003
15169,0.000309,172.31.47.0-255,66,46191,96,323003
15170,0.000333,74.125.68.0-255,5379,51570,96,323003
15171,0.000337,172.31.47.0-255,66,51636,96,323003
15172,0.000365,172.31.47.0-255,66,51702,96,323003
15173,0.000398,74.125.68.0-255,1484,53186,96,323003
15174,0.00041,74.125.68.0-255,2819,56005,96,323003
15175,0.000413,172.31.47.0-255,66,56071,96,323003
15176,0.00056,74.125.68.0-255,134,56205,96,323003
15177,0.000671,74.125.68.0-255,343,56548,96,323003
15178,0.000703,172.31.47.0-255,66,56614,96,323003
15179,0.000871,74.125.68.0-255,1484,58098,96,323003
15180,0.000881,74.125.68.0-255,2902,61000,96,323003
15181,0.000884,172.31.47.0-255,66,61066,96,323003
15182,0.000919,74.125.68.0-255,1484,62550,96,323003
15183,0.000924,74.125.68.0-255,2902,65452,96,323003
15184,0.000927,172.31.47.0-255,66,65518,96,323003
15185,0.000954,74.125.68.0-255,5738,71256,96,323003
15186,0.000958,172.31.47.0-255,66,71322,96,323003
15187,0.000962,74.125.68.0-255,2543,73865,96,323003
15188,0.000964,172.31.47.0-255,66,73931,96,323003
15189,0.001005,74.125.68.0-255,2902,76833,96,323003
15190,0.001009,172.31.47.0-255,66,76899,96,323003
15191,0.001013,74.125.68.0-255,1484,78383,96,323003
15192,0.001029,74.125.68.0-255,2902,81285,96,323003
15193,0.001031,172.31.47.0-255,66,81351,96,323003
15194,0.001048,74.125.68.0-255,5738,87089,96,323003
15195,0.00105,172.31.47.0-255,66,87155,96,323003
15196,0.001074,74.125.68.0-255,2902,90057,96,323003
15197,0.001076,172.31.47.0-255,66,90123,96,323003
15198,0.001079,74.125.68.0-255,1125,91248,96,323003
15199,0.001315,172.31.47.0-255,66,91314,96,323003
15200,0.001783,74.125.68.0-255,1484,92798,96,323003
15201,0.001789,74.125.68.0-255,1484,94282,96,323003
15202,0.001792,172.31.47.0-255,66,94348,96,323003
15203,0.00181,74.125.68.0-255,1484,95832,96,323003
15204,0.001815,74.125.68.0-255,4320,100152,96,323003
15205,0.001816,172.31.47.0-255,66,100218,96,323003
15206,0.001832,74.125.68.0-255,1484,101702,96,323003
15207,0.001847,74.125.68.0-255,4320,106022,96,323003
15208,0.001849,172.31.47.0-255,66,106088,96,323003
15209,0.001867,74.125.68.0-255,4320,110408,96,323003
15210,0.00187,172.31.47.0-255,66,110474,96,323003
15211,0.001884,74.125.68.0-255,4320,114794,96,323003
15212,0.001886,172.31.47.0-255,66,114860,96,323003
15213,0.00192,74.125.68.0-255,1484,116344,96,323003
15214,0.00194,74.125.68.0-255,4320,120664,96,323003
15215,0.001943,172.31.47.0-255,66,120730,96,323003
15216,0.001972,74.125.68.0-255,5020,125750,96,323003
15217,0.001974,172.31.47.0-255,66,125816,96,323003
15218,0.002103,74.125.68.0-255,1484,127300,96,323003
15219,0.002116,74.125.68.0-255,1484,128784,96,323003
15220,0.002119,172.31.47.0-255,66,128850,96,323003
15221,0.00213,74.125.68.0-255,2902,131752,96,323003
15222,0.002132,172.31.47.0-255,66,131818,96,323003
15223,0.002148,74.125.68.0-255,5738,137556,96,323003
15224,0.00215,172.31.47.0-255,66,137622,96,323003
15225,0.00217,74.125.68.0-255,1484,139106,96,323003
15226,0.002187,74.125.68.0-255,7156,146262,96,323003
15227,0.002189,172.31.47.0-255,66,146328,96,323003
15228,0.00222,74.125.68.0-255,4320,150648,96,323003
15229,0.002223,172.31.47.0-255,66,150714,96,323003
15230,0.002242,74.125.68.0-255,5738,156452,96,323003
15231,0.002244,172.31.47.0-255,66,156518,96,323003
15232,0.002276,74.125.68.0-255,3602,160120,96,323003
15233,0.002278,172.31.47.0-255,66,160186,96,323003
15234,0.002356,74.125.68.0-255,1484,161670,96,323003
15235,0.004598,74.125.68.0-255,4320,165990,96,323003
15236,0.004602,172.31.47.0-255,66,166056,96,323003
15237,0.006927,74.125.68.0-255,5738,171794,96,323003
15238,0.006934,172.31.47.0-255,66,171860,96,323003
15239,0.00928,74.125.68.0-255,5738,177598,96,323003
15240,0.009292,172.31.47.0-255,66,177664,96,323003
15241,0.01164,74.125.68.0-255,5738,183402,96,323003
15242,0.011649,172.31.47.0-255,66,183468,96,323003
15243,0.013991,74.125.68.0-255,5738,189206,96,323003
15244,0.013998,172.31.47.0-255,66,189272,96,323003
15245,0.01633,74.125.68.0-255,5738,195010,96,323003
15246,0.016336,172.31.47.0-255,66,195076,96,323003
15247,0.018655,74.125.68.0-255,4320,199396,96,323003
15248,0.01866,172.31.47.0-255,66,199462,96,323003
15249,0.018676,74.125.68.0-255,1484,200946,96,323003
15250,0.02099,74.125.68.0-255,4320,205266,96,323003
15251,0.020997,172.31.47.0-255,66,205332,96,323003
15252,0.023347,74.125.68.0-255,5738,211070,96,323003
15253,0.023353,172.31.47.0-255,66,211136,96,323003
15254,0.024284,172.31.47.0-255,172,211308,96,323003
15255,0.02433,172.31.47.0-255,1111,212419,96,323003
15256,0.024436,172.31.47.0-255,1514,213933,96,323003
15257,0.024439,172.31.47.0-255,1300,215233,96,323003
15258,0.025686,74.125.68.0-255,5738,220971,96,323003
15259,0.025692,172.31.47.0-255,66,221037,96,323003
15260,0.025823,104.244.42.0-255,66,221103,96,323003
15261,0.025873,104.244.42.0-255,66,221169,96,323003
15262,0.025969,104.244.42.0-255,66,221235,96,323003
15263,0.028028,74.125.68.0-255,5738,226973,96,323003
15264,0.028035,172.31.47.0-255,66,227039,96,323003
15265,0.03036,74.125.68.0-255,5738,232777,96,323003
15266,0.030367,172.31.47.0-255,66,232843,96,323003
15267,0.032704,74.125.68.0-255,4320,237163,96,323003
15268,0.032708,172.31.47.0-255,66,237229,96,323003
15269,0.032737,74.125.68.0-255,1484,238713,96,323003
15270,0.035048,74.125.68.0-255,4320,243033,96,323003
15271,0.035054,172.31.47.0-255,66,243099,96,323003
15272,0.03739,74.125.68.0-255,4320,247419,96,323003
15273,0.037396,172.31.47.0-255,66,247485,96,323003
15274,0.037424,74.125.68.0-255,1484,248969,96,323003
15275,0.039726,74.125.68.0-255,4320,253289,96,323003
15276,0.039731,172.31.47.0-255,66,253355,96,323003
15277,0.042066,74.125.68.0-255,5738,259093,96,323003
15278,0.042074,172.31.47.0-255,66,259159,96,323003
15279,0.044411,74.125.68.0-255,5738,264897,96,323003
15280,0.044418,172.31.47.0-255,66,264963,96,323003
15281,0.046748,74.125.68.0-255,5738,270701,96,323003
15282,0.046755,172.31.47.0-255,66,270767,96,323003
15283,0.049073,74.125.68.0-255,5738,276505,96,323003
15284,0.049078,172.31.47.0-255,66,276571,96,323003
15285,0.051438,74.125.68.0-255,5738,282309,96,323003
15286,0.051442,172.31.47.0-255,66,282375,96,323003
15287,0.053765,74.125.68.0-255,5738,288113,96,323003
15288,0.05377,172.31.47.0-255,66,288179,96,323003
15289,0.05609,74.125.68.0-255,5738,293917,96,323003
15290,0.056096,172.31.47.0-255,66,293983,96,323003
15291,0.058432,74.125.68.0-255,5738,299721,96,323003
15292,0.058439,172.31.47.0-255,66,299787,96,323003
15293,0.060768,74.125.68.0-255,5738,305525,96,323003
15294,0.060774,172.31.47.0-255,66,305591,96,323003
15295,0.063106,74.125.68.0-255,5738,311329,96,323003
15296,0.063113,172.31.47.0-255,66,311395,96,323003
15297,0.06545,74.125.68.0-255,5738,317133,96,323003
15298,0.065455,172.31.47.0-255,66,317199,96,323003
15299,0.067777,74.125.68.0-255,5738,322937,96,323003
15300,0.067782,172.31.47.0-255,66,323003,96,323003
15301,0.0,172.217.27.0-255,153,153,96,312878
15302,2.9e-05,172.31.47.0-255,66,219,96,312878
15303,3.5e-05,172.217.27.0-255,1484,1703,96,312878
15304,4e-05,172.31.47.0-255,66,1769,96,312878
15305,4.4e-05,172.217.27.0-255,2902,4671,96,312878
15306,4.7e-05,172.31.47.0-255,66,4737,96,312878
15307,5.7e-05,172.217.27.0-255,2902,7639,96,312878
15308,6e-05,172.31.47.0-255,66,7705,96,312878
15309,6.4e-05,172.217.27.0-255,4320,12025,96,312878
15310,6.7e-05,172.31.47.0-255,66,12091,96,312878
15311,9.5e-05,172.217.27.0-255,4320,16411,96,312878
15312,0.000104,172.31.47.0-255,66,16477,96,312878
15313,0.00012,172.217.27.0-255,4783,21260,96,312878
15314,0.000122,172.31.47.0-255,66,21326,96,312878
15315,0.000132,172.31.47.0-255,66,21392,96,312878
15316,0.000274,172.217.27.0-255,1484,22876,96,312878
15317,0.000278,172.31.47.0-255,66,22942,96,312878
15318,0.000283,172.217.27.0-255,2902,25844,96,312878
15319,0.000285,172.31.47.0-255,66,25910,96,312878
15320,0.000309,172.217.27.0-255,2902,28812,96,312878
15321,0.000313,172.31.47.0-255,66,28878,96,312878
15322,0.000318,172.217.27.0-255,4320,33198,96,312878
15323,0.00032,172.31.47.0-255,66,33264,96,312878
15324,0.000354,172.31.47.0-255,66,33330,96,312878
15325,0.000355,172.217.27.0-255,7156,40486,96,312878
15326,0.000358,172.31.47.0-255,66,40552,96,312878
15327,0.000405,172.217.27.0-255,2902,43454,96,312878
15328,0.000409,172.31.47.0-255,66,43520,96,312878
15329,0.000426,172.217.27.0-255,2866,46386,96,312878
15330,0.00043,172.31.47.0-255,66,46452,96,312878
15331,0.000583,172.217.27.0-255,119,46571,96,312878
15332,0.000712,172.217.27.0-255,1484,48055,96,312878
15333,0.000716,172.31.47.0-255,66,48121,96,312878
15334,0.000721,172.217.27.0-255,2902,51023,96,312878
15335,0.000724,172.31.47.0-255,66,51089,96,312878
15336,0.000728,172.217.27.0-255,2902,53991,96,312878
15337,0.000737,172.31.47.0-255,66,54057,96,312878
15338,0.000766,172.217.27.0-255,2902,56959,96,312878
15339,0.00077,172.31.47.0-255,66,57025,96,312878
15340,0.00078,172.31.47.0-255,66,57091,96,312878
15341,0.000791,172.31.47.0-255,66,57157,96,312878
15342,0.000796,172.217.27.0-255,4228,61385,96,312878
15343,0.000798,172.31.47.0-255,66,61451,96,312878
15344,0.001027,172.217.27.0-255,1484,62935,96,312878
15345,0.001041,172.217.27.0-255,2902,65837,96,312878
15346,0.001045,172.217.27.0-255,2902,68739,96,312878
15347,0.001046,172.31.47.0-255,66,68805,96,312878
15348,0.001049,172.31.47.0-255,66,68871,96,312878
15349,0.001076,172.217.27.0-255,2902,71773,96,312878
15350,0.001079,172.31.47.0-255,66,71839,96,312878
15351,0.001084,172.217.27.0-255,4320,76159,96,312878
15352,0.001086,172.31.47.0-255,66,76225,96,312878
15353,0.001093,172.217.27.0-255,5738,81963,96,312878
15354,0.001101,172.31.47.0-255,66,82029,96,312878
15355,0.001114,172.31.47.0-255,66,82095,96,312878
15356,0.001118,172.217.27.0-255,2184,84279,96,312878
15357,0.00112,172.31.47.0-255,66,84345,96,312878
15358,0.001161,172.217.27.0-255,2902,87247,96,312878
15359,0.001165,172.31.47.0-255,66,87313,96,312878
15360,0.001169,172.217.27.0-255,1484,88797,96,312878
15361,0.001191,172.217.27.0-255,2902,91699,96,312878
15362,0.001194,172.31.47.0-255,66,91765,96,312878
15363,0.00121,172.31.47.0-255,66,91831,96,312878
15364,0.001215,172.217.27.0-255,4320,96151,96,312878
15365,0.001218,172.31.47.0-255,66,96217,96,312878
15366,0.001256,172.31.47.0-255,66,96283,96,312878
15367,0.001259,172.217.27.0-255,766,97049,96,312878
15368,0.001283,172.217.27.0-255,1484,98533,96,312878
15369,0.001287,172.31.47.0-255,66,98599,96,312878
15370,0.001292,172.217.27.0-255,4320,102919,96,312878
15371,0.001295,172.31.47.0-255,66,102985,96,312878
15372,0.001325,172.31.47.0-255,66,103051,96,312878
15373,0.001331,172.217.27.0-255,5738,108789,96,312878
15374,0.001333,172.31.47.0-255,66,108855,96,312878
15375,0.001376,172.217.27.0-255,5738,114593,96,312878
15376,0.001379,172.31.47.0-255,66,114659,96,312878
15377,0.001408,172.217.27.0-255,6438,121097,96,312878
15378,0.001412,172.31.47.0-255,66,121163,96,312878
15379,0.001424,172.31.47.0-255,66,121229,96,312878
15380,0.00146,172.217.27.0-255,4320,125549,96,312878
15381,0.001464,172.31.47.0-255,66,125615,96,312878
15382,0.00147,172.217.27.0-255,5738,131353,96,312878
15383,0.001473,172.31.47.0-255,66,131419,96,312878
15384,0.00148,172.217.27.0-255,7156,138575,96,312878
15385,0.001483,172.31.47.0-255,66,138641,96,312878
15386,0.001493,172.31.47.0-255,66,138707,96,312878
15387,0.00156,172.217.27.0-255,5738,144445,96,312878
15388,0.001564,172.31.47.0-255,66,144511,96,312878
15389,0.001571,172.217.27.0-255,7156,151667,96,312878
15390,0.001573,172.31.47.0-255,66,151733,96,312878
15391,0.001592,172.31.47.0-255,66,151799,96,312878
15392,0.001599,172.217.27.0-255,6438,158237,96,312878
15393,0.001602,172.31.47.0-255,66,158303,96,312878
15394,0.00163,172.217.27.0-255,1484,159787,96,312878
15395,0.001652,172.217.27.0-255,2902,162689,96,312878
15396,0.001656,172.31.47.0-255,66,162755,96,312878
15397,0.001662,172.217.27.0-255,5738,168493,96,312878
15398,0.001664,172.31.47.0-255,66,168559,96,312878
15399,0.001696,172.217.27.0-255,7156,175715,96,312878
15400,0.001699,172.31.47.0-255,66,175781,96,312878
15401,0.003342,172.217.27.0-255,5738,181519,96,312878
15402,0.003347,172.31.47.0-255,66,181585,96,312878
15403,0.00499,172.217.27.0-255,5738,187323,96,312878
15404,0.004996,172.31.47.0-255,66,187389,96,312878
15405,0.006638,172.217.27.0-255,5738,193127,96,312878
15406,0.006644,172.31.47.0-255,66,193193,96,312878
15407,0.008296,172.217.27.0-255,5738,198931,96,312878
15408,0.008301,172.31.47.0-255,66,198997,96,312878
15409,0.009956,172.217.27.0-255,5738,204735,96,312878
15410,0.009963,172.31.47.0-255,66,204801,96,312878
15411,0.011617,172.217.27.0-255,5738,210539,96,312878
15412,0.011623,172.31.47.0-255,66,210605,96,312878
15413,0.013266,172.217.27.0-255,5738,216343,96,312878
15414,0.013272,172.31.47.0-255,66,216409,96,312878
15415,0.01494,172.217.27.0-255,5738,222147,96,312878
15416,0.014952,172.31.47.0-255,66,222213,96,312878
15417,0.016607,172.217.27.0-255,5738,227951,96,312878
15418,0.016615,172.31.47.0-255,66,228017,96,312878
15419,0.01826,172.217.27.0-255,5738,233755,96,312878
15420,0.018266,172.31.47.0-255,66,233821,96,312878
15421,0.019914,172.217.27.0-255,5738,239559,96,312878
15422,0.019921,172.31.47.0-255,66,239625,96,312878
15423,0.021563,172.217.27.0-255,5738,245363,96,312878
15424,0.021569,172.31.47.0-255,66,245429,96,312878
15425,0.023213,172.217.27.0-255,5738,251167,96,312878
15426,0.023218,172.31.47.0-255,66,251233,96,312878
15427,0.024858,172.217.27.0-255,5738,256971,96,312878
15428,0.024864,172.31.47.0-255,66,257037,96,312878
15429,0.026511,172.217.27.0-255,5738,262775,96,312878
15430,0.026518,172.31.47.0-255,66,262841,96,312878
15431,0.028161,172.217.27.0-255,5738,268579,96,312878
15432,0.028166,172.31.47.0-255,66,268645,96,312878
15433,0.028667,172.31.47.0-255,172,268817,96,312878
15434,0.028703,172.31.47.0-255,1109,269926,96,312878
15435,0.028869,172.31.47.0-255,1514,271440,96,312878
15436,0.028871,172.31.47.0-255,1514,272954,96,312878
15437,0.028875,172.31.47.0-255,1514,274468,96,312878
15438,0.028875,172.31.47.0-255,1087,275555,96,312878
15439,0.029812,172.217.27.0-255,5738,281293,96,312878
15440,0.029816,172.31.47.0-255,66,281359,96,312878
15441,0.030173,104.244.42.0-255,66,281425,96,312878
15442,0.03021,104.244.42.0-255,66,281491,96,312878
15443,0.030411,104.244.42.0-255,66,281557,96,312878
15444,0.030414,104.244.42.0-255,66,281623,96,312878
15445,0.031453,172.217.27.0-255,2902,284525,96,312878
15446,0.031457,172.31.47.0-255,66,284591,96,312878
15447,0.031488,172.217.27.0-255,2902,287493,96,312878
15448,0.031492,172.31.47.0-255,66,287559,96,312878
15449,0.033103,172.217.27.0-255,2902,290461,96,312878
15450,0.033107,172.31.47.0-255,66,290527,96,312878
15451,0.033141,172.217.27.0-255,2902,293429,96,312878
15452,0.033144,172.31.47.0-255,66,293495,96,312878
15453,0.034751,172.217.27.0-255,2902,296397,96,312878
15454,0.034755,172.31.47.0-255,66,296463,96,312878
15455,0.034782,172.217.27.0-255,2902,299365,96,312878
15456,0.034785,172.31.47.0-255,66,299431,96,312878
15457,0.036388,172.217.27.0-255,2902,302333,96,312878
15458,0.036394,172.31.47.0-255,66,302399,96,312878
15459,0.036424,172.217.27.0-255,2902,305301,96,312878
15460,0.036427,172.31.47.0-255,66,305367,96,312878
15461,0.038033,172.217.27.0-255,2902,308269,96,312878
15462,0.038038,172.31.47.0-255,66,308335,96,312878
15463,0.038066,172.217.27.0-255,2902,311237,96,312878
15464,0.038069,172.31.47.0-255,66,311303,96,312878
15465,0.039679,172.217.27.0-255,1338,312641,96,312878
15466,0.039819,172.31.47.0-255,66,312707,96,312878
15467,0.039845,172.31.47.0-255,105,312812,96,312878
15468,0.041447,172.217.27.0-255,66,312878,96,312878
15469,0.0,74.125.200.0-255,304,304,96,359005
15470,1.7e-05,172.31.47.0-255,66,370,96,359005
15471,2.3e-05,74.125.200.0-255,1484,1854,96,359005
15472,2.8e-05,172.31.47.0-255,66,1920,96,359005
15473,4.1e-05,74.125.200.0-255,2902,4822,96,359005
15474,4.5e-05,172.31.47.0-255,66,4888,96,359005
15475,5.1e-05,74.125.200.0-255,4320,9208,96,359005
15476,5.4e-05,172.31.47.0-255,66,9274,96,359005
15477,7.4e-05,74.125.200.0-255,1484,10758,96,359005
15478,7.6e-05,172.31.47.0-255,66,10824,96,359005
15479,8.8e-05,74.125.200.0-255,4682,15506,96,359005
15480,9.1e-05,172.31.47.0-255,66,15572,96,359005
15481,9.4e-05,74.125.200.0-255,1484,17056,96,359005
15482,9.6e-05,172.31.47.0-255,66,17122,96,359005
15483,0.00013,74.125.200.0-255,4320,21442,96,359005
15484,0.000133,172.31.47.0-255,66,21508,96,359005
15485,0.000139,74.125.200.0-255,4320,25828,96,359005
15486,0.000141,172.31.47.0-255,66,25894,96,359005
15487,0.00018,74.125.200.0-255,5379,31273,96,359005
15488,0.000184,172.31.47.0-255,66,31339,96,359005
15489,0.000217,74.125.200.0-255,1484,32823,96,359005
15490,0.000219,172.31.47.0-255,66,32889,96,359005
15491,0.000246,74.125.200.0-255,2902,35791,96,359005
15492,0.000249,172.31.47.0-255,66,35857,96,359005
15493,0.000282,74.125.200.0-255,2902,38759,96,359005
15494,0.000285,172.31.47.0-255,66,38825,96,359005
15495,0.000313,74.125.200.0-255,2902,41727,96,359005
15496,0.000315,172.31.47.0-255,66,41793,96,359005
15497,0.00032,74.125.200.0-255,2902,44695,96,359005
15498,0.000322,172.31.47.0-255,66,44761,96,359005
15499,0.000332,74.125.200.0-255,3961,48722,96,359005
15500,0.000334,172.31.47.0-255,66,48788,96,359005
15501,0.000338,74.125.200.0-255,2902,51690,96,359005
15502,0.000341,172.31.47.0-255,66,51756,96,359005
15503,0.000374,74.125.200.0-255,4320,56076,96,359005
15504,0.000377,172.31.47.0-255,66,56142,96,359005
15505,0.000382,74.125.200.0-255,4320,60462,96,359005
15506,0.000384,172.31.47.0-255,66,60528,96,359005
15507,0.000388,74.125.200.0-255,1484,62012,96,359005
15508,0.000412,74.125.200.0-255,4274,66286,96,359005
15509,0.000415,172.31.47.0-255,66,66352,96,359005
15510,0.000441,74.125.200.0-255,109,66461,96,359005
15511,0.000561,74.125.200.0-255,1484,67945,96,359005
15512,0.000566,172.31.47.0-255,66,68011,96,359005
15513,0.000572,74.125.200.0-255,2902,70913,96,359005
15514,0.000574,172.31.47.0-255,66,70979,96,359005
15515,0.000585,74.125.200.0-255,4320,75299,96,359005
15516,0.000588,172.31.47.0-255,66,75365,96,359005
15517,0.00062,74.125.200.0-255,5738,81103,96,359005
15518,0.000623,172.31.47.0-255,66,81169,96,359005
15519,0.000652,74.125.200.0-255,3961,85130,96,359005
15520,0.000655,172.31.47.0-255,66,85196,96,359005
15521,0.000661,74.125.200.0-255,4320,89516,96,359005
15522,0.000663,172.31.47.0-255,66,89582,96,359005
15523,0.000689,74.125.200.0-255,2902,92484,96,359005
15524,0.000692,172.31.47.0-255,66,92550,96,359005
15525,0.000717,172.31.47.0-255,66,92616,96,359005
15526,0.001207,74.125.200.0-255,1484,94100,96,359005
15527,0.001213,74.125.200.0-255,2902,97002,96,359005
15528,0.001218,172.31.47.0-255,66,97068,96,359005
15529,0.001248,74.125.200.0-255,5738,102806,96,359005
15530,0.001251,172.31.47.0-255,66,102872,96,359005
15531,0.001257,74.125.200.0-255,5738,108610,96,359005
15532,0.001259,172.31.47.0-255,66,108676,96,359005
15533,0.001276,74.125.200.0-255,1484,110160,96,359005
15534,0.001295,74.125.200.0-255,7156,117316,96,359005
15535,0.001298,172.31.47.0-255,66,117382,96,359005
15536,0.001323,74.125.200.0-255,2902,120284,96,359005
15537,0.001326,172.31.47.0-255,66,120350,96,359005
15538,0.001329,74.125.200.0-255,1484,121834,96,359005
15539,0.001354,74.125.200.0-255,5020,126854,96,359005
15540,0.001357,172.31.47.0-255,66,126920,96,359005
15541,0.001617,74.125.200.0-255,1484,128404,96,359005
15542,0.001636,74.125.200.0-255,2902,131306,96,359005
15543,0.00164,172.31.47.0-255,66,131372,96,359005
15544,0.001645,74.125.200.0-255,2902,134274,96,359005
15545,0.001647,172.31.47.0-255,66,134340,96,359005
15546,0.001694,74.125.200.0-255,1484,135824,96,359005
15547,0.001706,172.31.47.0-255,66,135890,96,359005
15548,0.001716,172.31.47.0-255,66,135956,96,359005
15549,0.001757,172.31.47.0-255,66,136022,96,359005
15550,0.001977,74.125.200.0-255,1484,137506,96,359005
15551,0.001982,74.125.200.0-255,1484,138990,96,359005
15552,0.001985,172.31.47.0-255,66,139056,96,359005
15553,0.002015,74.125.200.0-255,1484,140540,96,359005
15554,0.002021,74.125.200.0-255,4320,144860,96,359005
15555,0.002023,172.31.47.0-255,66,144926,96,359005
15556,0.002042,74.125.200.0-255,5738,150664,96,359005
15557,0.002044,172.31.47.0-255,66,150730,96,359005
15558,0.002063,74.125.200.0-255,2902,153632,96,359005
15559,0.002066,172.31.47.0-255,66,153698,96,359005
15560,0.00207,74.125.200.0-255,2902,156600,96,359005
15561,0.002073,172.31.47.0-255,66,156666,96,359005
15562,0.002078,74.125.200.0-255,4320,160986,96,359005
15563,0.00208,172.31.47.0-255,66,161052,96,359005
15564,0.002126,172.31.47.0-255,66,161118,96,359005
15565,0.00213,74.125.200.0-255,2184,163302,96,359005
15566,0.002132,172.31.47.0-255,66,163368,96,359005
15567,0.002136,74.125.200.0-255,2902,166270,96,359005
15568,0.002138,172.31.47.0-255,66,166336,96,359005
15569,0.002145,74.125.200.0-255,7156,173492,96,359005
15570,0.002147,172.31.47.0-255,66,173558,96,359005
15571,0.002151,74.125.200.0-255,2902,176460,96,359005
15572,0.002153,172.31.47.0-255,66,176526,96,359005
15573,0.002157,74.125.200.0-255,1484,178010,96,359005
15574,0.002189,74.125.200.0-255,2902,180912,96,359005
15575,0.002192,172.31.47.0-255,66,180978,96,359005
15576,0.002202,172.31.47.0-255,66,181044,96,359005
15577,0.002211,74.125.200.0-255,2902,183946,96,359005
15578,0.002214,172.31.47.0-255,66,184012,96,359005
15579,0.002273,74.125.200.0-255,3602,187614,96,359005
15580,0.002276,172.31.47.0-255,66,187680,96,359005
15581,0.002299,74.125.200.0-255,1484,189164,96,359005
15582,0.002337,74.125.200.0-255,2902,192066,96,359005
15583,0.002341,172.31.47.0-255,66,192132,96,359005
15584,0.004613,74.125.200.0-255,1484,193616,96,359005
15585,0.004661,74.125.200.0-255,4320,197936,96,359005
15586,0.004667,172.31.47.0-255,66,198002,96,359005
15587,0.007006,74.125.200.0-255,5738,203740,96,359005
15588,0.00701,172.31.47.0-255,66,203806,96,359005
15589,0.009367,74.125.200.0-255,5738,209544,96,359005
15590,0.009375,172.31.47.0-255,66,209610,96,359005
15591,0.011711,74.125.200.0-255,5738,215348,96,359005
15592,0.011717,172.31.47.0-255,66,215414,96,359005
15593,0.014062,74.125.200.0-255,5738,221152,96,359005
15594,0.014069,172.31.47.0-255,66,221218,96,359005
15595,0.0164,74.125.200.0-255,5738,226956,96,359005
15596,0.016409,172.31.47.0-255,66,227022,96,359005
15597,0.018748,74.125.200.0-255,5738,232760,96,359005
15598,0.018757,172.31.47.0-255,66,232826,96,359005
15599,0.021085,74.125.200.0-255,5738,238564,96,359005
15600,0.021092,172.31.47.0-255,66,238630,96,359005
15601,0.023427,74.125.200.0-255,5738,244368,96,359005
15602,0.023433,172.31.47.0-255,66,244434,96,359005
15603,0.025768,74.125.200.0-255,5738,250172,96,359005
15604,0.025776,172.31.47.0-255,66,250238,96,359005
15605,0.028102,74.125.200.0-255,5738,255976,96,359005
15606,0.02811,172.31.47.0-255,66,256042,96,359005
15607,0.029547,172.31.47.0-255,172,256214,96,359005
15608,0.029573,172.31.47.0-255,1110,257324,96,359005
15609,0.029625,172.31.47.0-255,1514,258838,96,359005
15610,0.029627,172.31.47.0-255,1301,260139,96,359005
15611,0.030455,74.125.200.0-255,5738,265877,96,359005
15612,0.030463,172.31.47.0-255,66,265943,96,359005
15613,0.031085,104.244.42.0-255,66,266009,96,359005
15614,0.031177,104.244.42.0-255,66,266075,96,359005
15615,0.031198,104.244.42.0-255,66,266141,96,359005
15616,0.032791,74.125.200.0-255,5738,271879,96,359005
15617,0.032797,172.31.47.0-255,66,271945,96,359005
15618,0.035132,74.125.200.0-255,5738,277683,96,359005
15619,0.035139,172.31.47.0-255,66,277749,96,359005
15620,0.037481,74.125.200.0-255,5738,283487,96,359005
15621,0.037489,172.31.47.0-255,66,283553,96,359005
15622,0.039831,74.125.200.0-255,5738,289291,96,359005
15623,0.039837,172.31.47.0-255,66,289357,96,359005
15624,0.042165,74.125.200.0-255,5738,295095,96,359005
15625,0.042171,172.31.47.0-255,66,295161,96,359005
15626,0.044497,74.125.200.0-255,5738,300899,96,359005
15627,0.044506,172.31.47.0-255,66,300965,96,359005
15628,0.046847,74.125.200.0-255,5738,306703,96,359005
15629,0.046854,172.31.47.0-255,66,306769,96,359005
15630,0.04932,74.125.200.0-255,5738,312507,96,359005
15631,0.049327,172.31.47.0-255,66,312573,96,359005
15632,0.051678,74.125.200.0-255,5738,318311,96,359005
15633,0.051684,172.31.47.0-255,66,318377,96,359005
15634,0.054012,74.125.200.0-255,5738,324115,96,359005
15635,0.054017,172.31.47.0-255,66,324181,96,359005
15636,0.056351,74.125.200.0-255,5738,329919,96,359005
15637,0.056357,172.31.47.0-255,66,329985,96,359005
15638,0.058693,74.125.200.0-255,5738,335723,96,359005
15639,0.0587,172.31.47.0-255,66,335789,96,359005
15640,0.061051,74.125.200.0-255,5738,341527,96,359005
15641,0.061057,172.31.47.0-255,66,341593,96,359005
15642,0.063441,74.125.200.0-255,5738,347331,96,359005
15643,0.063446,172.31.47.0-255,66,347397,96,359005
15644,0.065777,74.125.200.0-255,5738,353135,96,359005
15645,0.065781,172.31.47.0-255,66,353201,96,359005
15646,0.068119,74.125.200.0-255,5738,358939,96,359005
15647,0.068126,172.31.47.0-255,66,359005,96,359005
15648,0.0,74.125.130.0-255,153,153,96,343597
15649,3.6e-05,172.31.47.0-255,66,219,96,343597
15650,4.3e-05,74.125.130.0-255,1484,1703,96,343597
15651,4.8e-05,172.31.47.0-255,66,1769,96,343597
15652,5.4e-05,74.125.130.0-255,2902,4671,96,343597
15653,5.6e-05,172.31.47.0-255,66,4737,96,343597
15654,7.2e-05,74.125.130.0-255,7156,11893,96,343597
15655,7.5e-05,172.31.47.0-255,66,11959,96,343597
15656,7.9e-05,74.125.130.0-255,1992,13951,96,343597
15657,8.2e-05,172.31.47.0-255,66,14017,96,343597
15658,0.000213,74.125.130.0-255,1484,15501,96,343597
15659,0.000218,172.31.47.0-255,66,15567,96,343597
15660,0.000225,74.125.130.0-255,2902,18469,96,343597
15661,0.000227,172.31.47.0-255,66,18535,96,343597
15662,0.000251,74.125.130.0-255,5738,24273,96,343597
15663,0.000253,172.31.47.0-255,66,24339,96,343597
15664,0.000265,74.125.130.0-255,6797,31136,96,343597
15665,0.000269,172.31.47.0-255,66,31202,96,343597
15666,0.000312,74.125.130.0-255,1484,32686,96,343597
15667,0.000315,172.31.47.0-255,66,32752,96,343597
15668,0.000321,74.125.130.0-255,2902,35654,96,343597
15669,0.000323,172.31.47.0-255,66,35720,96,343597
15670,0.000326,74.125.130.0-255,1484,37204,96,343597
15671,0.000328,172.31.47.0-255,66,37270,96,343597
15672,0.000358,74.125.130.0-255,4320,41590,96,343597
15673,0.000362,172.31.47.0-255,66,41656,96,343597
15674,0.000365,74.125.130.0-255,1484,43140,96,343597
15675,0.000366,172.31.47.0-255,66,43206,96,343597
15676,0.000392,74.125.130.0-255,5379,48585,96,343597
15677,0.000396,172.31.47.0-255,66,48651,96,343597
15678,0.000952,74.125.130.0-255,1484,50135,96,343597
15679,0.000958,172.31.47.0-255,66,50201,96,343597
15680,0.000968,74.125.130.0-255,2902,53103,96,343597
15681,0.000971,172.31.47.0-255,66,53169,96,343597
15682,0.000984,74.125.130.0-255,5738,58907,96,343597
15683,0.000987,172.31.47.0-255,66,58973,96,343597
15684,0.000995,74.125.130.0-255,6797,65770,96,343597
15685,0.000997,172.31.47.0-255,66,65836,96,343597
15686,0.001142,74.125.130.0-255,1484,67320,96,343597
15687,0.00115,74.125.130.0-255,2902,70222,96,343597
15688,0.001154,172.31.47.0-255,66,70288,96,343597
15689,0.001161,74.125.130.0-255,5738,76026,96,343597
15690,0.001163,172.31.47.0-255,66,76092,96,343597
15691,0.00117,74.125.130.0-255,5738,81830,96,343597
15692,0.001178,172.31.47.0-255,66,81896,96,343597
15693,0.001215,74.125.130.0-255,1125,83021,96,343597
15694,0.001225,74.125.130.0-255,7156,90177,96,343597
15695,0.001228,172.31.47.0-255,66,90243,96,343597
15696,0.001238,172.31.47.0-255,66,90309,96,343597
15697,0.001268,74.125.130.0-255,1706,92015,96,343597
15698,0.001272,172.31.47.0-255,66,92081,96,343597
15699,0.001433,74.125.130.0-255,1484,93565,96,343597
15700,0.00144,74.125.130.0-255,2902,96467,96,343597
15701,0.001444,172.31.47.0-255,66,96533,96,343597
15702,0.00148,74.125.130.0-255,5738,102271,96,343597
15703,0.001484,172.31.47.0-255,66,102337,96,343597
15704,0.001489,74.125.130.0-255,1484,103821,96,343597
15705,0.001495,74.125.130.0-255,2902,106723,96,343597
15706,0.001497,172.31.47.0-255,66,106789,96,343597
15707,0.001509,74.125.130.0-255,5738,112527,96,343597
15708,0.001512,172.31.47.0-255,66,112593,96,343597
15709,0.001537,74.125.130.0-255,5738,118331,96,343597
15710,0.001542,172.31.47.0-255,66,118397,96,343597
15711,0.001562,74.125.130.0-255,4320,122717,96,343597
15712,0.001564,172.31.47.0-255,66,122783,96,343597
15713,0.001567,74.125.130.0-255,1484,124267,96,343597
15714,0.001595,74.125.130.0-255,2184,126451,96,343597
15715,0.001598,172.31.47.0-255,66,126517,96,343597
15716,0.001631,74.125.130.0-255,1484,128001,96,343597
15717,0.00165,74.125.130.0-255,2902,130903,96,343597
15718,0.001654,172.31.47.0-255,66,130969,96,343597
15719,0.001681,74.125.130.0-255,5738,136707,96,343597
15720,0.001685,172.31.47.0-255,66,136773,96,343597
15721,0.001688,74.125.130.0-255,2902,139675,96,343597
15722,0.001691,172.31.47.0-255,66,139741,96,343597
15723,0.001721,172.31.47.0-255,66,139807,96,343597
15724,0.001752,74.125.130.0-255,2902,142709,96,343597
15725,0.001756,172.31.47.0-255,66,142775,96,343597
15726,0.001765,74.125.130.0-255,2902,145677,96,343597
15727,0.00177,172.31.47.0-255,66,145743,96,343597
15728,0.001773,74.125.130.0-255,1484,147227,96,343597
15729,0.001799,74.125.130.0-255,3602,150829,96,343597
15730,0.001802,172.31.47.0-255,66,150895,96,343597
15731,0.002102,74.125.130.0-255,1484,152379,96,343597
15732,0.002108,74.125.130.0-255,2902,155281,96,343597
15733,0.002111,172.31.47.0-255,66,155347,96,343597
15734,0.002139,74.125.130.0-255,5738,161085,96,343597
15735,0.002141,172.31.47.0-255,66,161151,96,343597
15736,0.002144,74.125.130.0-255,1484,162635,96,343597
15737,0.002174,74.125.130.0-255,5738,168373,96,343597
15738,0.002176,172.31.47.0-255,66,168439,96,343597
15739,0.002245,172.31.47.0-255,66,168505,96,343597
15740,0.002262,74.125.130.0-255,2184,170689,96,343597
15741,0.002264,172.31.47.0-255,66,170755,96,343597
15742,0.004489,74.125.130.0-255,5738,176493,96,343597
15743,0.004495,172.31.47.0-255,66,176559,96,343597
15744,0.006742,74.125.130.0-255,5738,182297,96,343597
15745,0.00675,172.31.47.0-255,66,182363,96,343597
15746,0.009022,74.125.130.0-255,5738,188101,96,343597
15747,0.009042,172.31.47.0-255,66,188167,96,343597
15748,0.011313,74.125.130.0-255,5738,193905,96,343597
15749,0.01133,172.31.47.0-255,66,193971,96,343597
15750,0.013593,74.125.130.0-255,5738,199709,96,343597
15751,0.013608,172.31.47.0-255,66,199775,96,343597
15752,0.015855,74.125.130.0-255,5738,205513,96,343597
15753,0.015864,172.31.47.0-255,66,205579,96,343597
15754,0.018124,74.125.130.0-255,1484,207063,96,343597
15755,0.018148,74.125.130.0-255,4320,211383,96,343597
15756,0.018153,172.31.47.0-255,66,211449,96,343597
15757,0.020402,74.125.130.0-255,4320,215769,96,343597
15758,0.020411,172.31.47.0-255,66,215835,96,343597
15759,0.020442,74.125.130.0-255,1484,217319,96,343597
15760,0.022671,74.125.130.0-255,4320,221639,96,343597
15761,0.022681,172.31.47.0-255,66,221705,96,343597
15762,0.024952,74.125.130.0-255,5738,227443,96,343597
15763,0.024963,172.31.47.0-255,66,227509,96,343597
15764,0.027208,74.125.130.0-255,5738,233247,96,343597
15765,0.027215,172.31.47.0-255,66,233313,96,343597
15766,0.028303,172.31.47.0-255,171,233484,96,343597
15767,0.02833,172.31.47.0-255,1134,234618,96,343597
15768,0.028378,172.31.47.0-255,1514,236132,96,343597
15769,0.028398,172.31.47.0-255,1277,237409,96,343597
15770,0.029462,74.125.130.0-255,5738,243147,96,343597
15771,0.029468,172.31.47.0-255,66,243213,96,343597
15772,0.029864,104.244.42.0-255,66,243279,96,343597
15773,0.030058,104.244.42.0-255,66,243345,96,343597
15774,0.030062,104.244.42.0-255,66,243411,96,343597
15775,0.031715,74.125.130.0-255,5738,249149,96,343597
15776,0.031724,172.31.47.0-255,66,249215,96,343597
15777,0.033976,74.125.130.0-255,5738,254953,96,343597
15778,0.033983,172.31.47.0-255,66,255019,96,343597
15779,0.036236,74.125.130.0-255,5738,260757,96,343597
15780,0.036243,172.31.47.0-255,66,260823,96,343597
15781,0.038504,74.125.130.0-255,5738,266561,96,343597
15782,0.038514,172.31.47.0-255,66,266627,96,343597
15783,0.040795,74.125.130.0-255,5738,272365,96,343597
15784,0.04081,172.31.47.0-255,66,272431,96,343597
15785,0.043063,74.125.130.0-255,5738,278169,96,343597
15786,0.043071,172.31.47.0-255,66,278235,96,343597
15787,0.045307,74.125.130.0-255,2902,281137,96,343597
15788,0.045312,172.31.47.0-255,66,281203,96,343597
15789,0.045343,74.125.130.0-255,2902,284105,96,343597
15790,0.045346,172.31.47.0-255,66,284171,96,343597
15791,0.047563,74.125.130.0-255,2902,287073,96,343597
15792,0.047567,172.31.47.0-255,66,287139,96,343597
15793,0.0476,74.125.130.0-255,2902,290041,96,343597
15794,0.047602,172.31.47.0-255,66,290107,96,343597
15795,0.049829,74.125.130.0-255,2902,293009,96,343597
15796,0.049834,172.31.47.0-255,66,293075,96,343597
15797,0.049864,74.125.130.0-255,2902,295977,96,343597
15798,0.049868,172.31.47.0-255,66,296043,96,343597
15799,0.052088,74.125.130.0-255,2902,298945,96,343597
15800,0.052095,172.31.47.0-255,66,299011,96,343597
15801,0.052129,74.125.130.0-255,2902,301913,96,343597
15802,0.052132,172.31.47.0-255,66,301979,96,343597
15803,0.054328,74.125.130.0-255,1484,303463,96,343597
15804,0.054359,74.125.130.0-255,1484,304947,96,343597
15805,0.054364,172.31.47.0-255,66,305013,96,343597
15806,0.054391,74.125.130.0-255,2902,307915,96,343597
15807,0.054397,172.31.47.0-255,66,307981,96,343597
15808,0.056612,74.125.130.0-255,2902,310883,96,343597
15809,0.056619,172.31.47.0-255,66,310949,96,343597
15810,0.056655,74.125.130.0-255,2902,313851,96,343597
15811,0.056659,172.31.47.0-255,66,313917,96,343597
15812,0.058857,74.125.130.0-255,2902,316819,96,343597
15813,0.058862,172.31.47.0-255,66,316885,96,343597
15814,0.058893,74.125.130.0-255,2902,319787,96,343597
15815,0.058895,172.31.47.0-255,66,319853,96,343597
15816,0.061093,74.125.130.0-255,2902,322755,96,343597
15817,0.061099,172.31.47.0-255,66,322821,96,343597
15818,0.061143,74.125.130.0-255,2902,325723,96,343597
15819,0.061147,172.31.47.0-255,66,325789,96,343597
15820,0.06334,74.125.130.0-255,2902,328691,96,343597
15821,0.063347,172.31.47.0-255,66,328757,96,343597
15822,0.063386,74.125.130.0-255,2902,331659,96,343597
15823,0.06339,172.31.47.0-255,66,331725,96,343597
15824,0.065603,74.125.130.0-255,2902,334627,96,343597
15825,0.065612,172.31.47.0-255,66,334693,96,343597
15826,0.065643,74.125.130.0-255,2902,337595,96,343597
15827,0.065646,172.31.47.0-255,66,337661,96,343597
15828,0.06786,74.125.130.0-255,2902,340563,96,343597
15829,0.067865,172.31.47.0-255,66,340629,96,343597
15830,0.067904,74.125.130.0-255,2902,343531,96,343597
15831,0.067907,172.31.47.0-255,66,343597,96,343597
15832,0.0,74.125.24.0-255,153,153,96,267545
15833,4.3e-05,172.31.47.0-255,66,219,96,267545
15834,5e-05,74.125.24.0-255,1484,1703,96,267545
15835,5.5e-05,172.31.47.0-255,66,1769,96,267545
15836,5.7e-05,74.125.24.0-255,1484,3253,96,267545
15837,6.7e-05,172.31.47.0-255,66,3319,96,267545
15838,7.4e-05,74.125.24.0-255,4320,7639,96,267545
15839,7.7e-05,172.31.47.0-255,66,7705,96,267545
15840,8.3e-05,74.125.24.0-255,6426,14131,96,267545
15841,8.6e-05,172.31.47.0-255,66,14197,96,267545
15842,0.000197,74.125.24.0-255,1484,15681,96,267545
15843,0.000202,172.31.47.0-255,66,15747,96,267545
15844,0.000208,74.125.24.0-255,2902,18649,96,267545
15845,0.00021,172.31.47.0-255,66,18715,96,267545
15846,0.000241,74.125.24.0-255,5738,24453,96,267545
15847,0.000244,172.31.47.0-255,66,24519,96,267545
15848,0.000251,74.125.24.0-255,5738,30257,96,267545
15849,0.000253,172.31.47.0-255,66,30323,96,267545
15850,0.000281,74.125.24.0-255,7156,37479,96,267545
15851,0.000285,172.31.47.0-255,66,37545,96,267545
15852,0.000317,74.125.24.0-255,6797,44342,96,267545
15853,0.000323,172.31.47.0-255,66,44408,96,267545
15854,0.000324,74.125.24.0-255,7156,51564,96,267545
15855,0.000327,172.31.47.0-255,66,51630,96,267545
15856,0.000374,172.31.47.0-255,66,51696,96,267545
15857,0.000381,74.125.24.0-255,5020,56716,96,267545
15858,0.000383,172.31.47.0-255,66,56782,96,267545
15859,0.000427,74.125.24.0-255,707,57489,96,267545
15860,0.00043,172.31.47.0-255,66,57555,96,267545
15861,0.000606,74.125.24.0-255,1484,59039,96,267545
15862,0.00061,172.31.47.0-255,66,59105,96,267545
15863,0.000615,74.125.24.0-255,2902,62007,96,267545
15864,0.000618,172.31.47.0-255,66,62073,96,267545
15865,0.000621,74.125.24.0-255,1484,63557,96,267545
15866,0.000655,74.125.24.0-255,4320,67877,96,267545
15867,0.000658,172.31.47.0-255,66,67943,96,267545
15868,0.000665,74.125.24.0-255,7156,75099,96,267545
15869,0.000667,172.31.47.0-255,66,75165,96,267545
15870,0.000685,172.31.47.0-255,66,75231,96,267545
15871,0.000717,74.125.24.0-255,4320,79551,96,267545
15872,0.000721,172.31.47.0-255,66,79617,96,267545
15873,0.000725,74.125.24.0-255,2184,81801,96,267545
15874,0.000727,172.31.47.0-255,66,81867,96,267545
15875,0.00136,74.125.24.0-255,1484,83351,96,267545
15876,0.00137,74.125.24.0-255,2902,86253,96,267545
15877,0.001374,172.31.47.0-255,66,86319,96,267545
15878,0.00138,74.125.24.0-255,5738,92057,96,267545
15879,0.001382,172.31.47.0-255,66,92123,96,267545
15880,0.001405,74.125.24.0-255,5738,97861,96,267545
15881,0.001408,172.31.47.0-255,66,97927,96,267545
15882,0.001451,74.125.24.0-255,5738,103665,96,267545
15883,0.001454,172.31.47.0-255,66,103731,96,267545
15884,0.001482,74.125.24.0-255,7156,110887,96,267545
15885,0.001485,172.31.47.0-255,66,110953,96,267545
15886,0.001507,74.125.24.0-255,4320,115273,96,267545
15887,0.001509,172.31.47.0-255,66,115339,96,267545
15888,0.00152,74.125.24.0-255,766,116105,96,267545
15889,0.001601,74.125.24.0-255,1484,117589,96,267545
15890,0.001605,172.31.47.0-255,66,117655,96,267545
15891,0.001624,74.125.24.0-255,2902,120557,96,267545
15892,0.001626,172.31.47.0-255,66,120623,96,267545
15893,0.001631,74.125.24.0-255,5738,126361,96,267545
15894,0.001633,172.31.47.0-255,66,126427,96,267545
15895,0.001668,172.31.47.0-255,66,126493,96,267545
15896,0.001691,74.125.24.0-255,1484,127977,96,267545
15897,0.0017,172.31.47.0-255,66,128043,96,267545
15898,0.001711,74.125.24.0-255,2902,130945,96,267545
15899,0.001713,172.31.47.0-255,66,131011,96,267545
15900,0.001747,172.31.47.0-255,66,131077,96,267545
15901,0.001774,74.125.24.0-255,3602,134679,96,267545
15902,0.001776,172.31.47.0-255,66,134745,96,267545
15903,0.001778,74.125.24.0-255,1484,136229,96,267545
15904,0.001791,172.31.47.0-255,66,136295,96,267545
15905,0.001814,74.125.24.0-255,4320,140615,96,267545
15906,0.001816,172.31.47.0-255,66,140681,96,267545
15907,0.001818,74.125.24.0-255,1484,142165,96,267545
15908,0.001838,74.125.24.0-255,4320,146485,96,267545
15909,0.00184,172.31.47.0-255,66,146551,96,267545
15910,0.001852,74.125.24.0-255,4320,150871,96,267545
15911,0.001853,172.31.47.0-255,66,150937,96,267545
15912,0.001873,74.125.24.0-255,7156,158093,96,267545
15913,0.001875,172.31.47.0-255,66,158159,96,267545
15914,0.001889,172.31.47.0-255,66,158225,96,267545
15915,0.001913,74.125.24.0-255,2902,161127,96,267545
15916,0.001915,172.31.47.0-255,66,161193,96,267545
15917,0.001964,172.31.47.0-255,66,161259,96,267545
15918,0.001976,74.125.24.0-255,2902,164161,96,267545
15919,0.001981,172.31.47.0-255,66,164227,96,267545
15920,0.001998,172.31.47.0-255,66,164293,96,267545
15921,0.002003,74.125.24.0-255,5020,169313,96,267545
15922,0.002005,172.31.47.0-255,66,169379,96,267545
15923,0.002007,74.125.24.0-255,1484,170863,96,267545
15924,0.002029,172.31.47.0-255,66,170929,96,267545
15925,0.002065,172.31.47.0-255,66,170995,96,267545
15926,0.002074,172.31.47.0-255,66,171061,96,267545
15927,0.002103,74.125.24.0-255,2902,173963,96,267545
15928,0.002105,172.31.47.0-255,78,174041,96,267545
15929,0.002125,172.31.47.0-255,78,174119,96,267545
15930,0.002147,74.125.24.0-255,1484,175603,96,267545
15931,0.002149,172.31.47.0-255,66,175669,96,267545
15932,0.00414,74.125.24.0-255,4320,179989,96,267545
15933,0.004145,172.31.47.0-255,66,180055,96,267545
15934,0.004181,74.125.24.0-255,1484,181539,96,267545
15935,0.00616,74.125.24.0-255,4320,185859,96,267545
15936,0.006164,172.31.47.0-255,66,185925,96,267545
15937,0.008177,74.125.24.0-255,4320,190245,96,267545
15938,0.008183,172.31.47.0-255,66,190311,96,267545
15939,0.008208,74.125.24.0-255,1484,191795,96,267545
15940,0.010213,74.125.24.0-255,4320,196115,96,267545
15941,0.010222,172.31.47.0-255,66,196181,96,267545
15942,0.01227,74.125.24.0-255,5738,201919,96,267545
15943,0.012277,172.31.47.0-255,66,201985,96,267545
15944,0.014282,74.125.24.0-255,5738,207723,96,267545
15945,0.014288,172.31.47.0-255,66,207789,96,267545
15946,0.016353,74.125.24.0-255,5738,213527,96,267545
15947,0.016361,172.31.47.0-255,66,213593,96,267545
15948,0.01837,74.125.24.0-255,5738,219331,96,267545
15949,0.018376,172.31.47.0-255,66,219397,96,267545
15950,0.019354,172.31.47.0-255,172,219569,96,267545
15951,0.019382,172.31.47.0-255,1109,220678,96,267545
15952,0.019427,172.31.47.0-255,1514,222192,96,267545
15953,0.019429,172.31.47.0-255,335,222527,96,267545
15954,0.020415,74.125.24.0-255,5738,228265,96,267545
15955,0.020422,172.31.47.0-255,66,228331,96,267545
15956,0.020871,104.244.42.0-255,66,228397,96,267545
15957,0.020965,104.244.42.0-255,66,228463,96,267545
15958,0.020969,104.244.42.0-255,66,228529,96,267545
15959,0.022411,74.125.24.0-255,2902,231431,96,267545
15960,0.022415,172.31.47.0-255,66,231497,96,267545
15961,0.022443,74.125.24.0-255,2902,234399,96,267545
15962,0.022446,172.31.47.0-255,66,234465,96,267545
15963,0.024434,74.125.24.0-255,2902,237367,96,267545
15964,0.024439,172.31.47.0-255,66,237433,96,267545
15965,0.024472,74.125.24.0-255,2902,240335,96,267545
15966,0.024476,172.31.47.0-255,66,240401,96,267545
15967,0.026488,74.125.24.0-255,4320,244721,96,267545
15968,0.026494,172.31.47.0-255,66,244787,96,267545
15969,0.026529,74.125.24.0-255,1484,246271,96,267545
15970,0.028535,74.125.24.0-255,4320,250591,96,267545
15971,0.028542,172.31.47.0-255,66,250657,96,267545
15972,0.030608,74.125.24.0-255,5738,256395,96,267545
15973,0.030614,172.31.47.0-255,66,256461,96,267545
15974,0.032655,74.125.24.0-255,5738,262199,96,267545
15975,0.032659,172.31.47.0-255,66,262265,96,267545
15976,0.034702,74.125.24.0-255,5043,267308,96,267545
15977,0.034706,172.31.47.0-255,66,267374,96,267545
15978,0.034886,172.31.47.0-255,105,267479,96,267545
15979,0.036868,74.125.24.0-255,66,267545,96,267545
15980,0.0,172.217.24.0-255,153,153,96,281458
15981,3.3e-05,172.31.47.0-255,66,219,96,281458
15982,4e-05,172.217.24.0-255,1484,1703,96,281458
15983,4.5e-05,172.31.47.0-255,66,1769,96,281458
15984,4.9e-05,172.217.24.0-255,2902,4671,96,281458
15985,5.2e-05,172.31.47.0-255,66,4737,96,281458
15986,5.7e-05,172.217.24.0-255,5738,10475,96,281458
15987,6e-05,172.31.47.0-255,66,10541,96,281458
15988,0.000109,172.217.24.0-255,3401,13942,96,281458
15989,0.000112,172.31.47.0-255,66,14008,96,281458
15990,0.000129,172.217.24.0-255,1484,15492,96,281458
15991,0.000132,172.31.47.0-255,66,15558,96,281458
15992,0.000135,172.217.24.0-255,1484,17042,96,281458
15993,0.000137,172.31.47.0-255,66,17108,96,281458
15994,0.000149,172.217.24.0-255,1484,18592,96,281458
15995,0.000151,172.31.47.0-255,66,18658,96,281458
15996,0.000158,172.217.24.0-255,5738,24396,96,281458
15997,0.00016,172.31.47.0-255,66,24462,96,281458
15998,0.000185,172.217.24.0-255,2902,27364,96,281458
15999,0.000187,172.31.47.0-255,66,27430,96,281458
16000,0.000208,172.217.24.0-255,3961,31391,96,281458
16001,0.000211,172.31.47.0-255,66,31457,96,281458
16002,0.000249,172.217.24.0-255,1484,32941,96,281458
16003,0.000252,172.31.47.0-255,66,33007,96,281458
16004,0.000256,172.217.24.0-255,1484,34491,96,281458
16005,0.000259,172.31.47.0-255,66,34557,96,281458
16006,0.000275,172.217.24.0-255,1484,36041,96,281458
16007,0.000277,172.31.47.0-255,66,36107,96,281458
16008,0.000283,172.217.24.0-255,5738,41845,96,281458
16009,0.000286,172.31.47.0-255,66,41911,96,281458
16010,0.000289,172.217.24.0-255,2902,44813,96,281458
16011,0.000291,172.31.47.0-255,66,44879,96,281458
16012,0.00031,172.217.24.0-255,3961,48840,96,281458
16013,0.000317,172.31.47.0-255,66,48906,96,281458
16014,0.000343,172.217.24.0-255,1484,50390,96,281458
16015,0.000364,172.217.24.0-255,2902,53292,96,281458
16016,0.000368,172.217.24.0-255,1484,54776,96,281458
16017,0.000377,172.31.47.0-255,66,54842,96,281458
16018,0.000386,172.217.24.0-255,4320,59162,96,281458
16019,0.000393,172.217.24.0-255,6797,65959,96,281458
16020,0.000393,172.31.47.0-255,66,66025,96,281458
16021,0.000399,172.31.47.0-255,66,66091,96,281458
16022,0.000412,172.217.24.0-255,392,66483,96,281458
16023,0.000832,172.31.47.0-255,66,66549,96,281458
16024,0.001437,172.217.24.0-255,118,66667,96,281458
16025,0.001481,172.217.24.0-255,1484,68151,96,281458
16026,0.001486,172.31.47.0-255,66,68217,96,281458
16027,0.001494,172.217.24.0-255,2902,71119,96,281458
16028,0.001503,172.217.24.0-255,7156,78275,96,281458
16029,0.001522,172.217.24.0-255,5738,84013,96,281458
16030,0.001544,172.217.24.0-255,4320,88333,96,281458
16031,0.001559,172.217.24.0-255,2902,91235,96,281458
16032,0.005213,172.31.47.0-255,66,91301,96,281458
16033,0.007213,172.217.24.0-255,5738,97039,96,281458
16034,0.007222,172.31.47.0-255,66,97105,96,281458
16035,0.009204,172.217.24.0-255,4320,101425,96,281458
16036,0.00921,172.31.47.0-255,66,101491,96,281458
16037,0.009227,172.217.24.0-255,1484,102975,96,281458
16038,0.011193,172.217.24.0-255,4320,107295,96,281458
16039,0.0112,172.31.47.0-255,66,107361,96,281458
16040,0.0132,172.217.24.0-255,5738,113099,96,281458
16041,0.013244,172.31.47.0-255,66,113165,96,281458
16042,0.015229,172.217.24.0-255,5738,118903,96,281458
16043,0.015235,172.31.47.0-255,66,118969,96,281458
16044,0.017236,172.217.24.0-255,5738,124707,96,281458
16045,0.017247,172.31.47.0-255,66,124773,96,281458
16046,0.019242,172.217.24.0-255,5738,130511,96,281458
16047,0.019251,172.31.47.0-255,66,130577,96,281458
16048,0.021241,172.217.24.0-255,5738,136315,96,281458
16049,0.021248,172.31.47.0-255,66,136381,96,281458
16050,0.023243,172.217.24.0-255,5738,142119,96,281458
16051,0.02325,172.31.47.0-255,66,142185,96,281458
16052,0.025226,172.217.24.0-255,5738,147923,96,281458
16053,0.025226,172.31.47.0-255,172,148095,96,281458
16054,0.02523,172.31.47.0-255,66,148161,96,281458
16055,0.025247,172.31.47.0-255,1110,149271,96,281458
16056,0.025287,172.31.47.0-255,1514,150785,96,281458
16057,0.025288,172.31.47.0-255,1301,152086,96,281458
16058,0.026749,104.244.42.0-255,66,152152,96,281458
16059,0.026786,104.244.42.0-255,66,152218,96,281458
16060,0.026832,104.244.42.0-255,66,152284,96,281458
16061,0.02721,172.217.24.0-255,4320,156604,96,281458
16062,0.027213,172.31.47.0-255,66,156670,96,281458
16063,0.027241,172.217.24.0-255,1484,158154,96,281458
16064,0.029185,172.217.24.0-255,1484,159638,96,281458
16065,0.02919,172.31.47.0-255,66,159704,96,281458
16066,0.029223,172.217.24.0-255,2902,162606,96,281458
16067,0.02923,172.31.47.0-255,66,162672,96,281458
16068,0.031169,172.217.24.0-255,2902,165574,96,281458
16069,0.031174,172.31.47.0-255,66,165640,96,281458
16070,0.031206,172.217.24.0-255,2902,168542,96,281458
16071,0.031228,172.31.47.0-255,66,168608,96,281458
16072,0.033159,172.217.24.0-255,2902,171510,96,281458
16073,0.033165,172.31.47.0-255,66,171576,96,281458
16074,0.033196,172.217.24.0-255,2902,174478,96,281458
16075,0.033214,172.31.47.0-255,66,174544,96,281458
16076,0.035148,172.217.24.0-255,2902,177446,96,281458
16077,0.035153,172.31.47.0-255,66,177512,96,281458
16078,0.03519,172.217.24.0-255,2902,180414,96,281458
16079,0.035207,172.31.47.0-255,66,180480,96,281458
16080,0.037136,172.217.24.0-255,2902,183382,96,281458
16081,0.037142,172.31.47.0-255,66,183448,96,281458
16082,0.037209,172.217.24.0-255,1484,184932,96,281458
16083,0.037222,172.217.24.0-255,1484,186416,96,281458
16084,0.037372,172.31.47.0-255,66,186482,96,281458
16085,0.039122,172.217.24.0-255,2902,189384,96,281458
16086,0.039126,172.31.47.0-255,66,189450,96,281458
16087,0.03934,172.217.24.0-255,2902,192352,96,281458
16088,0.039345,172.31.47.0-255,66,192418,96,281458
16089,0.041098,172.217.24.0-255,2902,195320,96,281458
16090,0.041103,172.31.47.0-255,66,195386,96,281458
16091,0.041328,172.217.24.0-255,2902,198288,96,281458
16092,0.041334,172.31.47.0-255,66,198354,96,281458
16093,0.043074,172.217.24.0-255,2902,201256,96,281458
16094,0.043079,172.31.47.0-255,66,201322,96,281458
16095,0.043308,172.217.24.0-255,2902,204224,96,281458
16096,0.043313,172.31.47.0-255,66,204290,96,281458
16097,0.045083,172.217.24.0-255,2902,207192,96,281458
16098,0.045088,172.31.47.0-255,66,207258,96,281458
16099,0.045286,172.217.24.0-255,2902,210160,96,281458
16100,0.045292,172.31.47.0-255,66,210226,96,281458
16101,0.047057,172.217.24.0-255,2902,213128,96,281458
16102,0.047062,172.31.47.0-255,66,213194,96,281458
16103,0.04727,172.217.24.0-255,2902,216096,96,281458
16104,0.047276,172.31.47.0-255,66,216162,96,281458
16105,0.049042,172.217.24.0-255,2902,219064,96,281458
16106,0.049047,172.31.47.0-255,66,219130,96,281458
16107,0.04925,172.217.24.0-255,2902,222032,96,281458
16108,0.049256,172.31.47.0-255,66,222098,96,281458
16109,0.05103,172.217.24.0-255,2902,225000,96,281458
16110,0.051036,172.31.47.0-255,66,225066,96,281458
16111,0.051231,172.217.24.0-255,2902,227968,96,281458
16112,0.051237,172.31.47.0-255,66,228034,96,281458
16113,0.053013,172.217.24.0-255,2902,230936,96,281458
16114,0.053017,172.31.47.0-255,66,231002,96,281458
16115,0.053201,172.217.24.0-255,2902,233904,96,281458
16116,0.053206,172.31.47.0-255,66,233970,96,281458
16117,0.054991,172.217.24.0-255,2902,236872,96,281458
16118,0.054996,172.31.47.0-255,66,236938,96,281458
16119,0.055178,172.217.24.0-255,2902,239840,96,281458
16120,0.055183,172.31.47.0-255,66,239906,96,281458
16121,0.05698,172.217.24.0-255,2902,242808,96,281458
16122,0.056985,172.31.47.0-255,66,242874,96,281458
16123,0.05716,172.217.24.0-255,2902,245776,96,281458
16124,0.057316,172.31.47.0-255,66,245842,96,281458
16125,0.058961,172.217.24.0-255,2902,248744,96,281458
16126,0.058966,172.31.47.0-255,66,248810,96,281458
16127,0.059299,172.217.24.0-255,2902,251712,96,281458
16128,0.059305,172.31.47.0-255,66,251778,96,281458
16129,0.060957,172.217.24.0-255,2902,254680,96,281458
16130,0.060963,172.31.47.0-255,66,254746,96,281458
16131,0.061283,172.217.24.0-255,2902,257648,96,281458
16132,0.061288,172.31.47.0-255,66,257714,96,281458
16133,0.062951,172.217.24.0-255,2902,260616,96,281458
16134,0.062956,172.31.47.0-255,66,260682,96,281458
16135,0.063266,172.217.24.0-255,2902,263584,96,281458
16136,0.063272,172.31.47.0-255,66,263650,96,281458
16137,0.064949,172.217.24.0-255,2902,266552,96,281458
16138,0.064955,172.31.47.0-255,66,266618,96,281458
16139,0.065246,172.217.24.0-255,2902,269520,96,281458
16140,0.065252,172.31.47.0-255,66,269586,96,281458
16141,0.066926,172.217.24.0-255,2902,272488,96,281458
16142,0.066931,172.31.47.0-255,66,272554,96,281458
16143,0.067226,172.217.24.0-255,2902,275456,96,281458
16144,0.067231,172.31.47.0-255,66,275522,96,281458
16145,0.068907,172.217.24.0-255,2902,278424,96,281458
16146,0.068912,172.31.47.0-255,66,278490,96,281458
16147,0.069198,172.217.24.0-255,2902,281392,96,281458
16148,0.069205,172.31.47.0-255,66,281458,96,281458
16149,0.0,172.217.27.0-255,153,153,96,341545
16150,1.5e-05,172.31.47.0-255,66,219,96,341545
16151,2e-05,172.217.27.0-255,1484,1703,96,341545
16152,2.4e-05,172.31.47.0-255,66,1769,96,341545
16153,2.9e-05,172.217.27.0-255,2902,4671,96,341545
16154,3.1e-05,172.31.47.0-255,66,4737,96,341545
16155,3.5e-05,172.217.27.0-255,2902,7639,96,341545
16156,3.7e-05,172.31.47.0-255,66,7705,96,341545
16157,4.1e-05,172.217.27.0-255,2902,10607,96,341545
16158,4.3e-05,172.31.47.0-255,66,10673,96,341545
16159,6.6e-05,172.217.27.0-255,1484,12157,96,341545
16160,6.8e-05,172.31.47.0-255,66,12223,96,341545
16161,8.3e-05,172.217.27.0-255,2011,14234,96,341545
16162,8.5e-05,172.31.47.0-255,66,14300,96,341545
16163,0.000243,172.217.27.0-255,1484,15784,96,341545
16164,0.000248,172.31.47.0-255,66,15850,96,341545
16165,0.00026,172.217.27.0-255,2902,18752,96,341545
16166,0.000262,172.31.47.0-255,66,18818,96,341545
16167,0.000265,172.217.27.0-255,1484,20302,96,341545
16168,0.000267,172.31.47.0-255,66,20368,96,341545
16169,0.000285,172.217.27.0-255,2902,23270,96,341545
16170,0.000288,172.31.47.0-255,66,23336,96,341545
16171,0.000314,172.217.27.0-255,5738,29074,96,341545
16172,0.000317,172.31.47.0-255,66,29140,96,341545
16173,0.000376,172.217.27.0-255,2543,31683,96,341545
16174,0.000379,172.31.47.0-255,66,31749,96,341545
16175,0.000498,172.217.27.0-255,1484,33233,96,341545
16176,0.000501,172.31.47.0-255,66,33299,96,341545
16177,0.000505,172.217.27.0-255,1484,34783,96,341545
16178,0.000506,172.31.47.0-255,66,34849,96,341545
16179,0.000532,172.217.27.0-255,1484,36333,96,341545
16180,0.000535,172.31.47.0-255,66,36399,96,341545
16181,0.000559,172.217.27.0-255,2902,39301,96,341545
16182,0.000562,172.31.47.0-255,66,39367,96,341545
16183,0.000592,172.217.27.0-255,4320,43687,96,341545
16184,0.000595,172.31.47.0-255,66,43753,96,341545
16185,0.000613,172.217.27.0-255,1484,45237,96,341545
16186,0.000619,172.217.27.0-255,3961,49198,96,341545
16187,0.000621,172.31.47.0-255,66,49264,96,341545
16188,0.000661,172.217.27.0-255,2902,52166,96,341545
16189,0.000664,172.31.47.0-255,66,52232,96,341545
16190,0.00068,172.217.27.0-255,1484,53716,96,341545
16191,0.000687,172.217.27.0-255,5738,59454,96,341545
16192,0.000688,172.31.47.0-255,66,59520,96,341545
16193,0.000724,172.217.27.0-255,7125,66645,96,341545
16194,0.000727,172.31.47.0-255,66,66711,96,341545
16195,0.001014,172.217.27.0-255,118,66829,96,341545
16196,0.001018,172.217.27.0-255,329,67158,96,341545
16197,0.00105,172.31.47.0-255,66,67224,96,341545
16198,0.001189,172.217.27.0-255,1484,68708,96,341545
16199,0.001197,172.217.27.0-255,2902,71610,96,341545
16200,0.001201,172.31.47.0-255,66,71676,96,341545
16201,0.001205,172.217.27.0-255,2902,74578,96,341545
16202,0.001207,172.31.47.0-255,66,74644,96,341545
16203,0.001224,172.217.27.0-255,2902,77546,96,341545
16204,0.001226,172.31.47.0-255,66,77612,96,341545
16205,0.001249,172.217.27.0-255,6797,84409,96,341545
16206,0.001252,172.31.47.0-255,66,84475,96,341545
16207,0.001311,172.217.27.0-255,1484,85959,96,341545
16208,0.001316,172.217.27.0-255,2902,88861,96,341545
16209,0.001318,172.31.47.0-255,66,88927,96,341545
16210,0.001331,172.217.27.0-255,1484,90411,96,341545
16211,0.001344,172.217.27.0-255,1484,91895,96,341545
16212,0.001345,172.31.47.0-255,66,91961,96,341545
16213,0.001351,172.217.27.0-255,4320,96281,96,341545
16214,0.001353,172.31.47.0-255,66,96347,96,341545
16215,0.001403,172.217.27.0-255,1484,97831,96,341545
16216,0.001416,172.217.27.0-255,3961,101792,96,341545
16217,0.001419,172.31.47.0-255,66,101858,96,341545
16218,0.003048,172.217.27.0-255,5738,107596,96,341545
16219,0.003054,172.31.47.0-255,66,107662,96,341545
16220,0.004686,172.217.27.0-255,4320,111982,96,341545
16221,0.004689,172.31.47.0-255,66,112048,96,341545
16222,0.004709,172.217.27.0-255,1484,113532,96,341545
16223,0.006336,172.217.27.0-255,4320,117852,96,341545
16224,0.006339,172.31.47.0-255,66,117918,96,341545
16225,0.007977,172.217.27.0-255,5738,123656,96,341545
16226,0.007983,172.31.47.0-255,66,123722,96,341545
16227,0.009608,172.217.27.0-255,5738,129460,96,341545
16228,0.009616,172.31.47.0-255,66,129526,96,341545
16229,0.011248,172.217.27.0-255,5738,135264,96,341545
16230,0.011257,172.31.47.0-255,66,135330,96,341545
16231,0.012893,172.217.27.0-255,5738,141068,96,341545
16232,0.012903,172.31.47.0-255,66,141134,96,341545
16233,0.014574,172.217.27.0-255,5738,146872,96,341545
16234,0.014581,172.31.47.0-255,66,146938,96,341545
16235,0.016225,172.217.27.0-255,5738,152676,96,341545
16236,0.016233,172.31.47.0-255,66,152742,96,341545
16237,0.017866,172.217.27.0-255,5738,158480,96,341545
16238,0.017872,172.31.47.0-255,66,158546,96,341545
16239,0.019502,172.217.27.0-255,5738,164284,96,341545
16240,0.019509,172.31.47.0-255,66,164350,96,341545
16241,0.02114,172.217.27.0-255,5738,170088,96,341545
16242,0.021147,172.31.47.0-255,66,170154,96,341545
16243,0.022775,172.217.27.0-255,5738,175892,96,341545
16244,0.022781,172.31.47.0-255,66,175958,96,341545
16245,0.024406,172.217.27.0-255,5738,181696,96,341545
16246,0.024412,172.31.47.0-255,66,181762,96,341545
16247,0.024893,172.31.47.0-255,172,181934,96,341545
16248,0.024924,172.31.47.0-255,1110,183044,96,341545
16249,0.024986,172.31.47.0-255,1514,184558,96,341545
16250,0.024989,172.31.47.0-255,1301,185859,96,341545
16251,0.026042,172.217.27.0-255,5738,191597,96,341545
16252,0.026048,172.31.47.0-255,66,191663,96,341545
16253,0.026444,104.244.42.0-255,66,191729,96,341545
16254,0.0265,104.244.42.0-255,66,191795,96,341545
16255,0.026518,104.244.42.0-255,66,191861,96,341545
16256,0.027674,172.217.27.0-255,5738,197599,96,341545
16257,0.02768,172.31.47.0-255,66,197665,96,341545
16258,0.029322,172.217.27.0-255,5738,203403,96,341545
16259,0.029329,172.31.47.0-255,66,203469,96,341545
16260,0.030964,172.217.27.0-255,5738,209207,96,341545
16261,0.030971,172.31.47.0-255,66,209273,96,341545
16262,0.032646,172.217.27.0-255,5738,215011,96,341545
16263,0.032652,172.31.47.0-255,66,215077,96,341545
16264,0.034296,172.217.27.0-255,5738,220815,96,341545
16265,0.034302,172.31.47.0-255,66,220881,96,341545
16266,0.035947,172.217.27.0-255,5738,226619,96,341545
16267,0.035953,172.31.47.0-255,66,226685,96,341545
16268,0.037582,172.217.27.0-255,5738,232423,96,341545
16269,0.037588,172.31.47.0-255,66,232489,96,341545
16270,0.039215,172.217.27.0-255,5738,238227,96,341545
16271,0.03922,172.31.47.0-255,66,238293,96,341545
16272,0.040853,172.217.27.0-255,5738,244031,96,341545
16273,0.040859,172.31.47.0-255,66,244097,96,341545
16274,0.042509,172.217.27.0-255,4320,248417,96,341545
16275,0.042514,172.31.47.0-255,66,248483,96,341545
16276,0.042543,172.217.27.0-255,1484,249967,96,341545
16277,0.044165,172.217.27.0-255,4320,254287,96,341545
16278,0.044172,172.31.47.0-255,66,254353,96,341545
16279,0.04581,172.217.27.0-255,5738,260091,96,341545
16280,0.045817,172.31.47.0-255,66,260157,96,341545
16281,0.047445,172.217.27.0-255,5738,265895,96,341545
16282,0.04745,172.31.47.0-255,66,265961,96,341545
16283,0.049085,172.217.27.0-255,5738,271699,96,341545
16284,0.04909,172.31.47.0-255,66,271765,96,341545
16285,0.050778,172.217.27.0-255,5738,277503,96,341545
16286,0.050783,172.31.47.0-255,66,277569,96,341545
16287,0.052449,172.217.27.0-255,5738,283307,96,341545
16288,0.052454,172.31.47.0-255,66,283373,96,341545
16289,0.054104,172.217.27.0-255,5738,289111,96,341545
16290,0.054111,172.31.47.0-255,66,289177,96,341545
16291,0.055751,172.217.27.0-255,5738,294915,96,341545
16292,0.055758,172.31.47.0-255,66,294981,96,341545
16293,0.057396,172.217.27.0-255,5738,300719,96,341545
16294,0.057402,172.31.47.0-255,66,300785,96,341545
16295,0.059037,172.217.27.0-255,5738,306523,96,341545
16296,0.059043,172.31.47.0-255,66,306589,96,341545
16297,0.060686,172.217.27.0-255,2902,309491,96,341545
16298,0.060691,172.31.47.0-255,66,309557,96,341545
16299,0.060707,172.217.27.0-255,2902,312459,96,341545
16300,0.06071,172.31.47.0-255,66,312525,96,341545
16301,0.062328,172.217.27.0-255,5738,318263,96,341545
16302,0.062333,172.31.47.0-255,66,318329,96,341545
16303,0.063968,172.217.27.0-255,5738,324067,96,341545
16304,0.063975,172.31.47.0-255,66,324133,96,341545
16305,0.065612,172.217.27.0-255,5738,329871,96,341545
16306,0.06562,172.31.47.0-255,66,329937,96,341545
16307,0.067263,172.217.27.0-255,5738,335675,96,341545
16308,0.06727,172.31.47.0-255,66,335741,96,341545
16309,0.068901,172.217.27.0-255,5738,341479,96,341545
16310,0.068908,172.31.47.0-255,66,341545,96,341545
16311,0.0,74.125.200.0-255,157,157,96,326878
16312,2.3e-05,172.31.47.0-255,66,223,96,326878
16313,2.9e-05,74.125.200.0-255,1484,1707,96,326878
16314,3.2e-05,172.31.47.0-255,66,1773,96,326878
16315,3.7e-05,74.125.200.0-255,2902,4675,96,326878
16316,4e-05,172.31.47.0-255,66,4741,96,326878
16317,4.9e-05,74.125.200.0-255,1484,6225,96,326878
16318,5.2e-05,172.31.47.0-255,66,6291,96,326878
16319,8e-05,74.125.200.0-255,5738,12029,96,326878
16320,8.2e-05,172.31.47.0-255,66,12095,96,326878
16321,8.6e-05,74.125.200.0-255,2183,14278,96,326878
16322,8.7e-05,172.31.47.0-255,66,14344,96,326878
16323,0.000412,74.125.200.0-255,1484,15828,96,326878
16324,0.000417,172.31.47.0-255,66,15894,96,326878
16325,0.000426,74.125.200.0-255,2902,18796,96,326878
16326,0.000428,172.31.47.0-255,66,18862,96,326878
16327,0.000437,74.125.200.0-255,1484,20346,96,326878
16328,0.00044,172.31.47.0-255,66,20412,96,326878
16329,0.000444,74.125.200.0-255,2902,23314,96,326878
16330,0.000446,172.31.47.0-255,66,23380,96,326878
16331,0.000449,74.125.200.0-255,1484,24864,96,326878
16332,0.00045,172.31.47.0-255,66,24930,96,326878
16333,0.00047,74.125.200.0-255,4320,29250,96,326878
16334,0.000477,172.31.47.0-255,66,29316,96,326878
16335,0.000503,74.125.200.0-255,2543,31859,96,326878
16336,0.000507,172.31.47.0-255,66,31925,96,326878
16337,0.000511,74.125.200.0-255,2902,34827,96,326878
16338,0.000513,172.31.47.0-255,66,34893,96,326878
16339,0.000518,74.125.200.0-255,4320,39213,96,326878
16340,0.000525,172.31.47.0-255,66,39279,96,326878
16341,0.00056,74.125.200.0-255,2902,42181,96,326878
16342,0.000563,172.31.47.0-255,66,42247,96,326878
16343,0.000569,74.125.200.0-255,6797,49044,96,326878
16344,0.000572,172.31.47.0-255,66,49110,96,326878
16345,0.000722,74.125.200.0-255,1484,50594,96,326878
16346,0.000728,74.125.200.0-255,2902,53496,96,326878
16347,0.000732,172.31.47.0-255,66,53562,96,326878
16348,0.000735,74.125.200.0-255,1484,55046,96,326878
16349,0.000755,74.125.200.0-255,2902,57948,96,326878
16350,0.000758,172.31.47.0-255,66,58014,96,326878
16351,0.000764,74.125.200.0-255,4320,62334,96,326878
16352,0.000766,172.31.47.0-255,66,62400,96,326878
16353,0.000791,74.125.200.0-255,1484,63884,96,326878
16354,0.000795,74.125.200.0-255,2865,66749,96,326878
16355,0.000802,172.31.47.0-255,66,66815,96,326878
16356,0.000873,74.125.200.0-255,1484,68299,96,326878
16357,0.000879,74.125.200.0-255,2902,71201,96,326878
16358,0.000882,172.31.47.0-255,66,71267,96,326878
16359,0.000908,74.125.200.0-255,4320,75587,96,326878
16360,0.000912,172.31.47.0-255,66,75653,96,326878
16361,0.000919,74.125.200.0-255,1484,77137,96,326878
16362,0.000943,74.125.200.0-255,7156,84293,96,326878
16363,0.000948,74.125.200.0-255,5738,90031,96,326878
16364,0.000949,74.125.200.0-255,1484,91515,96,326878
16365,0.000952,172.31.47.0-255,66,91581,96,326878
16366,0.000958,172.31.47.0-255,66,91647,96,326878
16367,0.000962,74.125.200.0-255,1484,93131,96,326878
16368,0.000963,172.31.47.0-255,66,93197,96,326878
16369,0.000987,74.125.200.0-255,4320,97517,96,326878
16370,0.000989,172.31.47.0-255,66,97583,96,326878
16371,0.000997,74.125.200.0-255,3602,101185,96,326878
16372,0.000998,172.31.47.0-255,66,101251,96,326878
16373,0.001078,74.125.200.0-255,1484,102735,96,326878
16374,0.001089,74.125.200.0-255,1484,104219,96,326878
16375,0.001092,172.31.47.0-255,66,104285,96,326878
16376,0.001096,74.125.200.0-255,2902,107187,96,326878
16377,0.001098,172.31.47.0-255,66,107253,96,326878
16378,0.001136,74.125.200.0-255,5738,112991,96,326878
16379,0.001139,172.31.47.0-255,66,113057,96,326878
16380,0.001148,172.31.47.0-255,66,113123,96,326878
16381,0.001176,172.31.47.0-255,66,113189,96,326878
16382,0.001207,74.125.200.0-255,6080,119269,96,326878
16383,0.00121,172.31.47.0-255,66,119335,96,326878
16384,0.00124,74.125.200.0-255,2902,122237,96,326878
16385,0.001243,172.31.47.0-255,66,122303,96,326878
16386,0.001246,74.125.200.0-255,1484,123787,96,326878
16387,0.001267,74.125.200.0-255,2902,126689,96,326878
16388,0.001269,172.31.47.0-255,66,126755,96,326878
16389,0.001276,74.125.200.0-255,7156,133911,96,326878
16390,0.001278,172.31.47.0-255,66,133977,96,326878
16391,0.001307,74.125.200.0-255,1484,135461,96,326878
16392,0.001314,74.125.200.0-255,7156,142617,96,326878
16393,0.001316,172.31.47.0-255,66,142683,96,326878
16394,0.001325,172.31.47.0-255,66,142749,96,326878
16395,0.001376,74.125.200.0-255,2184,144933,96,326878
16396,0.001378,172.31.47.0-255,66,144999,96,326878
16397,0.002223,74.125.200.0-255,1484,146483,96,326878
16398,0.002231,74.125.200.0-255,2902,149385,96,326878
16399,0.002235,172.31.47.0-255,66,149451,96,326878
16400,0.00227,74.125.200.0-255,4320,153771,96,326878
16401,0.002272,172.31.47.0-255,66,153837,96,326878
16402,0.002278,74.125.200.0-255,5738,159575,96,326878
16403,0.00228,172.31.47.0-255,66,159641,96,326878
16404,0.002312,172.31.47.0-255,66,159707,96,326878
16405,0.002315,74.125.200.0-255,1484,161191,96,326878
16406,0.00459,74.125.200.0-255,4320,165511,96,326878
16407,0.004597,172.31.47.0-255,66,165577,96,326878
16408,0.006869,74.125.200.0-255,4320,169897,96,326878
16409,0.006876,172.31.47.0-255,66,169963,96,326878
16410,0.006903,74.125.200.0-255,1484,171447,96,326878
16411,0.009169,74.125.200.0-255,4320,175767,96,326878
16412,0.009178,172.31.47.0-255,66,175833,96,326878
16413,0.011467,74.125.200.0-255,5738,181571,96,326878
16414,0.011476,172.31.47.0-255,66,181637,96,326878
16415,0.013762,74.125.200.0-255,5738,187375,96,326878
16416,0.013768,172.31.47.0-255,66,187441,96,326878
16417,0.016057,74.125.200.0-255,5738,193179,96,326878
16418,0.016063,172.31.47.0-255,66,193245,96,326878
16419,0.016181,172.31.47.0-255,172,193417,96,326878
16420,0.016216,172.31.47.0-255,1109,194526,96,326878
16421,0.016332,172.31.47.0-255,1514,196040,96,326878
16422,0.016356,172.31.47.0-255,1302,197342,96,326878
16423,0.017744,104.244.42.0-255,66,197408,96,326878
16424,0.017794,104.244.42.0-255,66,197474,96,326878
16425,0.017882,104.244.42.0-255,66,197540,96,326878
16426,0.017925,104.244.42.0-255,66,197606,96,326878
16427,0.018337,74.125.200.0-255,4320,201926,96,326878
16428,0.018341,172.31.47.0-255,66,201992,96,326878
16429,0.018374,74.125.200.0-255,1484,203476,96,326878
16430,0.02061,74.125.200.0-255,4320,207796,96,326878
16431,0.020614,172.31.47.0-255,66,207862,96,326878
16432,0.022887,74.125.200.0-255,5738,213600,96,326878
16433,0.022892,172.31.47.0-255,66,213666,96,326878
16434,0.025189,74.125.200.0-255,4320,217986,96,326878
16435,0.025195,172.31.47.0-255,66,218052,96,326878
16436,0.025218,74.125.200.0-255,1484,219536,96,326878
16437,0.027463,74.125.200.0-255,4320,223856,96,326878
16438,0.027468,172.31.47.0-255,66,223922,96,326878
16439,0.029734,74.125.200.0-255,4320,228242,96,326878
16440,0.029739,172.31.47.0-255,66,228308,96,326878
16441,0.029766,74.125.200.0-255,1484,229792,96,326878
16442,0.032019,74.125.200.0-255,4320,234112,96,326878
16443,0.032025,172.31.47.0-255,66,234178,96,326878
16444,0.034292,74.125.200.0-255,4320,238498,96,326878
16445,0.034296,172.31.47.0-255,66,238564,96,326878
16446,0.034323,74.125.200.0-255,1484,240048,96,326878
16447,0.036575,74.125.200.0-255,4320,244368,96,326878
16448,0.03658,172.31.47.0-255,66,244434,96,326878
16449,0.03886,74.125.200.0-255,5738,250172,96,326878
16450,0.038864,172.31.47.0-255,66,250238,96,326878
16451,0.04114,74.125.200.0-255,5738,255976,96,326878
16452,0.041145,172.31.47.0-255,66,256042,96,326878
16453,0.04342,74.125.200.0-255,5738,261780,96,326878
16454,0.043424,172.31.47.0-255,66,261846,96,326878
16455,0.045709,74.125.200.0-255,5738,267584,96,326878
16456,0.045714,172.31.47.0-255,66,267650,96,326878
16457,0.048016,74.125.200.0-255,5738,273388,96,326878
16458,0.048023,172.31.47.0-255,66,273454,96,326878
16459,0.050298,74.125.200.0-255,2902,276356,96,326878
16460,0.050304,172.31.47.0-255,66,276422,96,326878
16461,0.050331,74.125.200.0-255,2902,279324,96,326878
16462,0.050333,172.31.47.0-255,66,279390,96,326878
16463,0.052579,74.125.200.0-255,2902,282292,96,326878
16464,0.052585,172.31.47.0-255,66,282358,96,326878
16465,0.052611,74.125.200.0-255,2902,285260,96,326878
16466,0.052614,172.31.47.0-255,66,285326,96,326878
16467,0.054854,74.125.200.0-255,2902,288228,96,326878
16468,0.05486,172.31.47.0-255,66,288294,96,326878
16469,0.054888,74.125.200.0-255,2902,291196,96,326878
16470,0.05489,172.31.47.0-255,66,291262,96,326878
16471,0.057139,74.125.200.0-255,2902,294164,96,326878
16472,0.057144,172.31.47.0-255,66,294230,96,326878
16473,0.057176,74.125.200.0-255,2902,297132,96,326878
16474,0.057178,172.31.47.0-255,66,297198,96,326878
16475,0.059416,74.125.200.0-255,2902,300100,96,326878
16476,0.059421,172.31.47.0-255,66,300166,96,326878
16477,0.059448,74.125.200.0-255,2902,303068,96,326878
16478,0.059451,172.31.47.0-255,66,303134,96,326878
16479,0.061691,74.125.200.0-255,2902,306036,96,326878
16480,0.061696,172.31.47.0-255,66,306102,96,326878
16481,0.061755,74.125.200.0-255,2902,309004,96,326878
16482,0.061757,172.31.47.0-255,66,309070,96,326878
16483,0.063975,74.125.200.0-255,2902,311972,96,326878
16484,0.06398,172.31.47.0-255,66,312038,96,326878
16485,0.06405,74.125.200.0-255,2902,314940,96,326878
16486,0.064054,172.31.47.0-255,66,315006,96,326878
16487,0.066248,74.125.200.0-255,2902,317908,96,326878
16488,0.066253,172.31.47.0-255,66,317974,96,326878
16489,0.066339,74.125.200.0-255,2902,320876,96,326878
16490,0.066343,172.31.47.0-255,66,320942,96,326878
16491,0.06855,74.125.200.0-255,2902,323844,96,326878
16492,0.068554,172.31.47.0-255,66,323910,96,326878
16493,0.068611,74.125.200.0-255,2902,326812,96,326878
16494,0.068615,172.31.47.0-255,66,326878,96,326878
16495,0.0,74.125.24.0-255,153,153,96,211007
16496,2.6e-05,172.31.47.0-255,66,219,96,211007
16497,3.2e-05,74.125.24.0-255,1484,1703,96,211007
16498,3.6e-05,172.31.47.0-255,66,1769,96,211007
16499,4.1e-05,74.125.24.0-255,2902,4671,96,211007
16500,4.3e-05,172.31.47.0-255,66,4737,96,211007
16501,6.2e-05,74.125.24.0-255,2902,7639,96,211007
16502,6.4e-05,172.31.47.0-255,66,7705,96,211007
16503,7.7e-05,74.125.24.0-255,1484,9189,96,211007
16504,8.1e-05,172.31.47.0-255,66,9255,96,211007
16505,9e-05,74.125.24.0-255,6356,15611,96,211007
16506,9.2e-05,172.31.47.0-255,66,15677,96,211007
16507,0.000123,172.31.47.0-255,66,15743,96,211007
16508,0.000136,74.125.24.0-255,1125,16868,96,211007
16509,0.000139,172.31.47.0-255,66,16934,96,211007
16510,0.000256,74.125.24.0-255,1484,18418,96,211007
16511,0.00026,172.31.47.0-255,66,18484,96,211007
16512,0.000266,74.125.24.0-255,2902,21386,96,211007
16513,0.000268,172.31.47.0-255,66,21452,96,211007
16514,0.000292,74.125.24.0-255,2902,24354,96,211007
16515,0.000294,172.31.47.0-255,66,24420,96,211007
16516,0.00031,74.125.24.0-255,2902,27322,96,211007
16517,0.000312,172.31.47.0-255,66,27388,96,211007
16518,0.000352,172.31.47.0-255,66,27454,96,211007
16519,0.000367,172.31.47.0-255,66,27520,96,211007
16520,0.000391,74.125.24.0-255,131,27651,96,211007
16521,0.000394,172.31.47.0-255,66,27717,96,211007
16522,0.000475,74.125.24.0-255,1484,29201,96,211007
16523,0.00048,172.31.47.0-255,66,29267,96,211007
16524,0.000499,74.125.24.0-255,2902,32169,96,211007
16525,0.000502,172.31.47.0-255,66,32235,96,211007
16526,0.000508,74.125.24.0-255,5738,37973,96,211007
16527,0.000511,172.31.47.0-255,66,38039,96,211007
16528,0.000517,74.125.24.0-255,6797,44836,96,211007
16529,0.00052,172.31.47.0-255,66,44902,96,211007
16530,0.000543,74.125.24.0-255,2902,47804,96,211007
16531,0.000547,172.31.47.0-255,66,47870,96,211007
16532,0.000579,172.31.47.0-255,66,47936,96,211007
16533,0.000583,74.125.24.0-255,2543,50479,96,211007
16534,0.000585,172.31.47.0-255,66,50545,96,211007
16535,0.000588,74.125.24.0-255,350,50895,96,211007
16536,0.001123,172.31.47.0-255,66,50961,96,211007
16537,0.001264,74.125.24.0-255,1484,52445,96,211007
16538,0.001273,74.125.24.0-255,2902,55347,96,211007
16539,0.001277,172.31.47.0-255,66,55413,96,211007
16540,0.001301,74.125.24.0-255,5738,61151,96,211007
16541,0.001304,172.31.47.0-255,66,61217,96,211007
16542,0.001334,172.31.47.0-255,66,61283,96,211007
16543,0.001355,74.125.24.0-255,1484,62767,96,211007
16544,0.001368,172.31.47.0-255,66,62833,96,211007
16545,0.00151,74.125.24.0-255,1484,64317,96,211007
16546,0.001517,74.125.24.0-255,2902,67219,96,211007
16547,0.00152,172.31.47.0-255,66,67285,96,211007
16548,0.001542,74.125.24.0-255,5738,73023,96,211007
16549,0.001544,172.31.47.0-255,66,73089,96,211007
16550,0.001562,74.125.24.0-255,2902,75991,96,211007
16551,0.001564,172.31.47.0-255,66,76057,96,211007
16552,0.001589,172.31.47.0-255,66,76123,96,211007
16553,0.001593,74.125.24.0-255,1484,77607,96,211007
16554,0.001621,74.125.24.0-255,7156,84763,96,211007
16555,0.001624,172.31.47.0-255,66,84829,96,211007
16556,0.001639,74.125.24.0-255,2184,87013,96,211007
16557,0.001641,172.31.47.0-255,66,87079,96,211007
16558,0.001645,74.125.24.0-255,2902,89981,96,211007
16559,0.001647,172.31.47.0-255,66,90047,96,211007
16560,0.001671,74.125.24.0-255,7156,97203,96,211007
16561,0.001673,172.31.47.0-255,66,97269,96,211007
16562,0.001687,74.125.24.0-255,1484,98753,96,211007
16563,0.001719,172.31.47.0-255,66,98819,96,211007
16564,0.001722,74.125.24.0-255,1484,100303,96,211007
16565,0.001744,74.125.24.0-255,2902,103205,96,211007
16566,0.001746,172.31.47.0-255,66,103271,96,211007
16567,0.001767,74.125.24.0-255,3602,106873,96,211007
16568,0.001771,172.31.47.0-255,66,106939,96,211007
16569,0.001816,74.125.24.0-255,1484,108423,96,211007
16570,0.001822,74.125.24.0-255,2902,111325,96,211007
16571,0.001825,172.31.47.0-255,66,111391,96,211007
16572,0.001842,74.125.24.0-255,5738,117129,96,211007
16573,0.001846,172.31.47.0-255,66,117195,96,211007
16574,0.001883,172.31.47.0-255,66,117261,96,211007
16575,0.001902,74.125.24.0-255,5738,122999,96,211007
16576,0.001905,172.31.47.0-255,66,123065,96,211007
16577,0.00192,74.125.24.0-255,5020,128085,96,211007
16578,0.001922,172.31.47.0-255,66,128151,96,211007
16579,0.001932,172.31.47.0-255,66,128217,96,211007
16580,0.001955,74.125.24.0-255,2902,131119,96,211007
16581,0.001957,172.31.47.0-255,66,131185,96,211007
16582,0.001969,74.125.24.0-255,7156,138341,96,211007
16583,0.001972,172.31.47.0-255,66,138407,96,211007
16584,0.002005,172.31.47.0-255,66,138473,96,211007
16585,0.002079,74.125.24.0-255,1484,139957,96,211007
16586,0.002092,74.125.24.0-255,2902,142859,96,211007
16587,0.002094,172.31.47.0-255,66,142925,96,211007
16588,0.002117,74.125.24.0-255,5738,148663,96,211007
16589,0.00212,172.31.47.0-255,66,148729,96,211007
16590,0.002159,74.125.24.0-255,4320,153049,96,211007
16591,0.002162,172.31.47.0-255,66,153115,96,211007
16592,0.002187,172.31.47.0-255,66,153181,96,211007
16593,0.002197,172.31.47.0-255,66,153247,96,211007
16594,0.002201,74.125.24.0-255,2184,155431,96,211007
16595,0.002203,172.31.47.0-255,66,155497,96,211007
16596,0.002226,74.125.24.0-255,1484,156981,96,211007
16597,0.002236,74.125.24.0-255,1484,158465,96,211007
16598,0.002238,172.31.47.0-255,66,158531,96,211007
16599,0.002241,74.125.24.0-255,1484,160015,96,211007
16600,0.002259,74.125.24.0-255,2902,162917,96,211007
16601,0.002262,172.31.47.0-255,66,162983,96,211007
16602,0.002272,172.31.47.0-255,66,163049,96,211007
16603,0.0023,74.125.24.0-255,1484,164533,96,211007
16604,0.002313,74.125.24.0-255,4320,168853,96,211007
16605,0.002316,172.31.47.0-255,66,168919,96,211007
16606,0.002345,172.31.47.0-255,66,168985,96,211007
16607,0.002348,74.125.24.0-255,1484,170469,96,211007
16608,0.002374,172.31.47.0-255,66,170535,96,211007
16609,0.002387,74.125.24.0-255,4320,174855,96,211007
16610,0.00239,172.31.47.0-255,66,174921,96,211007
16611,0.002402,172.31.47.0-255,66,174987,96,211007
16612,0.002412,172.31.47.0-255,66,175053,96,211007
16613,0.002434,74.125.24.0-255,2184,177237,96,211007
16614,0.002435,172.31.47.0-255,66,177303,96,211007
16615,0.002445,172.31.47.0-255,66,177369,96,211007
16616,0.002451,74.125.24.0-255,7156,184525,96,211007
16617,0.002453,172.31.47.0-255,66,184591,96,211007
16618,0.002465,74.125.24.0-255,4320,188911,96,211007
16619,0.002467,172.31.47.0-255,66,188977,96,211007
16620,0.002469,74.125.24.0-255,1484,190461,96,211007
16621,0.002471,172.31.47.0-255,78,190539,96,211007
16622,0.002474,74.125.24.0-255,1484,192023,96,211007
16623,0.002476,172.31.47.0-255,66,192089,96,211007
16624,0.00248,74.125.24.0-255,2902,194991,96,211007
16625,0.002482,172.31.47.0-255,66,195057,96,211007
16626,0.002485,74.125.24.0-255,2184,197241,96,211007
16627,0.002487,172.31.47.0-255,66,197307,96,211007
16628,0.002535,74.125.24.0-255,4320,201627,96,211007
16629,0.002537,172.31.47.0-255,66,201693,96,211007
16630,0.002557,74.125.24.0-255,4611,206304,96,211007
16631,0.002559,172.31.47.0-255,66,206370,96,211007
16632,0.002589,74.125.24.0-255,105,206475,96,211007
16633,0.007063,172.31.47.0-255,66,206541,96,211007
16634,0.007091,172.31.47.0-255,105,206646,96,211007
16635,0.009411,74.125.24.0-255,66,206712,96,211007
16636,0.033622,172.31.47.0-255,172,206884,96,211007
16637,0.03365,172.31.47.0-255,1105,207989,96,211007
16638,0.033692,172.31.47.0-255,1514,209503,96,211007
16639,0.033694,172.31.47.0-255,1306,210809,96,211007
16640,0.035169,104.244.42.0-255,66,210875,96,211007
16641,0.0352,104.244.42.0-255,66,210941,96,211007
16642,0.03525,104.244.42.0-255,66,211007,96,211007
16643,0.0,172.253.118.0-255,153,153,96,226993
16644,2.4e-05,172.31.47.0-255,66,219,96,226993
16645,3.2e-05,172.253.118.0-255,1484,1703,96,226993
16646,3.7e-05,172.31.47.0-255,66,1769,96,226993
16647,6.8e-05,172.253.118.0-255,2902,4671,96,226993
16648,7.2e-05,172.31.47.0-255,66,4737,96,226993
16649,8.7e-05,172.253.118.0-255,4320,9057,96,226993
16650,9.6e-05,172.31.47.0-255,66,9123,96,226993
16651,0.000122,172.253.118.0-255,1484,10607,96,226993
16652,0.000126,172.31.47.0-255,66,10673,96,226993
16653,0.000202,172.253.118.0-255,4945,15618,96,226993
16654,0.000205,172.31.47.0-255,66,15684,96,226993
16655,0.000293,172.253.118.0-255,1484,17168,96,226993
16656,0.000296,172.31.47.0-255,66,17234,96,226993
16657,0.000334,172.31.47.0-255,66,17300,96,226993
16658,0.000572,172.253.118.0-255,2543,19843,96,226993
16659,0.000577,172.31.47.0-255,66,19909,96,226993
16660,0.000631,172.253.118.0-255,4320,24229,96,226993
16661,0.000635,172.31.47.0-255,66,24295,96,226993
16662,0.000673,172.31.47.0-255,66,24361,96,226993
16663,0.000957,172.253.118.0-255,4320,28681,96,226993
16664,0.00096,172.31.47.0-255,66,28747,96,226993
16665,0.000996,172.31.47.0-255,66,28813,96,226993
16666,0.001312,172.253.118.0-255,4320,33133,96,226993
16667,0.001316,172.31.47.0-255,66,33199,96,226993
16668,0.00137,172.31.47.0-255,66,33265,96,226993
16669,0.001975,172.253.118.0-255,1125,34390,96,226993
16670,0.001982,172.31.47.0-255,66,34456,96,226993
16671,0.002014,172.253.118.0-255,1484,35940,96,226993
16672,0.00206,172.253.118.0-255,4320,40260,96,226993
16673,0.002082,172.31.47.0-255,66,40326,96,226993
16674,0.002118,172.253.118.0-255,5738,46064,96,226993
16675,0.002132,172.253.118.0-255,4320,50384,96,226993
16676,0.002155,172.31.47.0-255,66,50450,96,226993
16677,0.002358,172.31.47.0-255,66,50516,96,226993
16678,0.002375,172.253.118.0-255,2184,52700,96,226993
16679,0.002394,172.31.47.0-255,66,52766,96,226993
16680,0.002789,172.253.118.0-255,7156,59922,96,226993
16681,0.002793,172.31.47.0-255,66,59988,96,226993
16682,0.002864,172.31.47.0-255,66,60054,96,226993
16683,0.003665,172.31.47.0-255,66,60120,96,226993
16684,0.003723,172.31.47.0-255,66,60186,96,226993
16685,0.005932,172.253.118.0-255,5738,65924,96,226993
16686,0.005938,172.31.47.0-255,66,65990,96,226993
16687,0.008173,172.253.118.0-255,5738,71728,96,226993
16688,0.008183,172.31.47.0-255,66,71794,96,226993
16689,0.010416,172.253.118.0-255,5738,77532,96,226993
16690,0.010426,172.31.47.0-255,66,77598,96,226993
16691,0.012669,172.253.118.0-255,5738,83336,96,226993
16692,0.012683,172.31.47.0-255,66,83402,96,226993
16693,0.014912,172.253.118.0-255,5738,89140,96,226993
16694,0.014923,172.31.47.0-255,66,89206,96,226993
16695,0.017171,172.253.118.0-255,5738,94944,96,226993
16696,0.017185,172.31.47.0-255,66,95010,96,226993
16697,0.019423,172.253.118.0-255,5738,100748,96,226993
16698,0.019433,172.31.47.0-255,66,100814,96,226993
16699,0.02169,172.253.118.0-255,5738,106552,96,226993
16700,0.021709,172.31.47.0-255,66,106618,96,226993
16701,0.023957,172.253.118.0-255,5738,112356,96,226993
16702,0.024992,172.31.47.0-255,66,112422,96,226993
16703,0.027262,172.253.118.0-255,5738,118160,96,226993
16704,0.027283,172.31.47.0-255,66,118226,96,226993
16705,0.02954,172.253.118.0-255,5738,123964,96,226993
16706,0.029561,172.31.47.0-255,66,124030,96,226993
16707,0.03181,172.253.118.0-255,5738,129768,96,226993
16708,0.031827,172.31.47.0-255,66,129834,96,226993
16709,0.034079,172.253.118.0-255,5738,135572,96,226993
16710,0.034099,172.31.47.0-255,66,135638,96,226993
16711,0.036341,172.253.118.0-255,5738,141376,96,226993
16712,0.036379,172.31.47.0-255,66,141442,96,226993
16713,0.038627,172.253.118.0-255,5738,147180,96,226993
16714,0.038645,172.31.47.0-255,66,147246,96,226993
16715,0.040883,172.253.118.0-255,5738,152984,96,226993
16716,0.0409,172.31.47.0-255,66,153050,96,226993
16717,0.043158,172.253.118.0-255,5738,158788,96,226993
16718,0.043179,172.31.47.0-255,66,158854,96,226993
16719,0.044955,172.31.47.0-255,172,159026,96,226993
16720,0.044988,172.31.47.0-255,1101,160127,96,226993
16721,0.045049,172.31.47.0-255,1514,161641,96,226993
16722,0.045051,172.31.47.0-255,1310,162951,96,226993
16723,0.045458,172.253.118.0-255,5738,168689,96,226993
16724,0.045467,172.31.47.0-255,66,168755,96,226993
16725,0.046546,104.244.42.0-255,66,168821,96,226993
16726,0.04657,104.244.42.0-255,66,168887,96,226993
16727,0.046631,104.244.42.0-255,66,168953,96,226993
16728,0.047695,172.253.118.0-255,5738,174691,96,226993
16729,0.047711,172.31.47.0-255,66,174757,96,226993
16730,0.049969,172.253.118.0-255,5738,180495,96,226993
16731,0.04999,172.31.47.0-255,66,180561,96,226993
16732,0.052227,172.253.118.0-255,5738,186299,96,226993
16733,0.052247,172.31.47.0-255,66,186365,96,226993
16734,0.054511,172.253.118.0-255,5738,192103,96,226993
16735,0.054528,172.31.47.0-255,66,192169,96,226993
16736,0.056768,172.253.118.0-255,5738,197907,96,226993
16737,0.056788,172.31.47.0-255,66,197973,96,226993
16738,0.059045,172.253.118.0-255,5738,203711,96,226993
16739,0.059066,172.31.47.0-255,66,203777,96,226993
16740,0.061324,172.253.118.0-255,5738,209515,96,226993
16741,0.06134,172.31.47.0-255,66,209581,96,226993
16742,0.063605,172.253.118.0-255,5738,215319,96,226993
16743,0.063624,172.31.47.0-255,66,215385,96,226993
16744,0.065872,172.253.118.0-255,5738,221123,96,226993
16745,0.065881,172.31.47.0-255,66,221189,96,226993
16746,0.068106,172.253.118.0-255,5738,226927,96,226993
16747,0.068116,172.31.47.0-255,66,226993,96,226993
16748,0.0,74.125.24.0-255,153,153,96,186450
16749,2.7e-05,172.31.47.0-255,66,219,96,186450
16750,3.4e-05,74.125.24.0-255,1484,1703,96,186450
16751,3.8e-05,172.31.47.0-255,66,1769,96,186450
16752,4.3e-05,74.125.24.0-255,2902,4671,96,186450
16753,4.5e-05,172.31.47.0-255,66,4737,96,186450
16754,5.3e-05,74.125.24.0-255,7156,11893,96,186450
16755,5.5e-05,172.31.47.0-255,66,11959,96,186450
16756,0.0001,172.31.47.0-255,66,12025,96,186450
16757,0.000109,172.31.47.0-255,66,12091,96,186450
16758,0.00017,172.31.47.0-255,66,12157,96,186450
16759,0.000199,172.31.47.0-255,66,12223,96,186450
16760,0.000222,74.125.24.0-255,2902,15125,96,186450
16761,0.000225,172.31.47.0-255,66,15191,96,186450
16762,0.000228,74.125.24.0-255,1400,16591,96,186450
16763,0.00023,172.31.47.0-255,66,16657,96,186450
16764,0.000291,74.125.24.0-255,379,17036,96,186450
16765,0.000295,172.31.47.0-255,66,17102,96,186450
16766,0.000421,74.125.24.0-255,1484,18586,96,186450
16767,0.000425,172.31.47.0-255,66,18652,96,186450
16768,0.000429,74.125.24.0-255,1484,20136,96,186450
16769,0.00043,172.31.47.0-255,66,20202,96,186450
16770,0.000447,74.125.24.0-255,1484,21686,96,186450
16771,0.00045,172.31.47.0-255,66,21752,96,186450
16772,0.000457,74.125.24.0-255,5738,27490,96,186450
16773,0.00046,172.31.47.0-255,66,27556,96,186450
16774,0.000465,74.125.24.0-255,4320,31876,96,186450
16775,0.000467,172.31.47.0-255,66,31942,96,186450
16776,0.000505,172.31.47.0-255,66,32008,96,186450
16777,0.000512,172.31.47.0-255,66,32074,96,186450
16778,0.000883,74.125.24.0-255,1484,33558,96,186450
16779,0.00089,74.125.24.0-255,2902,36460,96,186450
16780,0.000893,172.31.47.0-255,66,36526,96,186450
16781,0.000897,74.125.24.0-255,1484,38010,96,186450
16782,0.000915,74.125.24.0-255,4320,42330,96,186450
16783,0.000918,172.31.47.0-255,66,42396,96,186450
16784,0.000934,74.125.24.0-255,4320,46716,96,186450
16785,0.000937,172.31.47.0-255,66,46782,96,186450
16786,0.00096,172.31.47.0-255,66,46848,96,186450
16787,0.000968,74.125.24.0-255,7156,54004,96,186450
16788,0.00097,172.31.47.0-255,66,54070,96,186450
16789,0.000991,74.125.24.0-255,3602,57672,96,186450
16790,0.000994,172.31.47.0-255,66,57738,96,186450
16791,0.001442,74.125.24.0-255,1484,59222,96,186450
16792,0.001452,74.125.24.0-255,2902,62124,96,186450
16793,0.001456,172.31.47.0-255,66,62190,96,186450
16794,0.001461,74.125.24.0-255,1484,63674,96,186450
16795,0.001478,74.125.24.0-255,4320,67994,96,186450
16796,0.001481,172.31.47.0-255,66,68060,96,186450
16797,0.001499,74.125.24.0-255,1484,69544,96,186450
16798,0.001515,74.125.24.0-255,7156,76700,96,186450
16799,0.001519,172.31.47.0-255,66,76766,96,186450
16800,0.00154,74.125.24.0-255,4320,81086,96,186450
16801,0.001544,172.31.47.0-255,66,81152,96,186450
16802,0.001547,74.125.24.0-255,1484,82636,96,186450
16803,0.001561,74.125.24.0-255,4320,86956,96,186450
16804,0.001564,172.31.47.0-255,66,87022,96,186450
16805,0.001586,74.125.24.0-255,5020,92042,96,186450
16806,0.001588,172.31.47.0-255,66,92108,96,186450
16807,0.001616,74.125.24.0-255,1484,93592,96,186450
16808,0.001621,74.125.24.0-255,2902,96494,96,186450
16809,0.001623,172.31.47.0-255,66,96560,96,186450
16810,0.001643,74.125.24.0-255,2902,99462,96,186450
16811,0.001645,172.31.47.0-255,66,99528,96,186450
16812,0.001662,74.125.24.0-255,2902,102430,96,186450
16813,0.001664,172.31.47.0-255,66,102496,96,186450
16814,0.001675,172.31.47.0-255,66,102562,96,186450
16815,0.001721,74.125.24.0-255,5738,108300,96,186450
16816,0.001724,172.31.47.0-255,66,108366,96,186450
16817,0.001747,172.31.47.0-255,66,108432,96,186450
16818,0.001785,74.125.24.0-255,1484,109916,96,186450
16819,0.0018,74.125.24.0-255,2902,112818,96,186450
16820,0.001804,172.31.47.0-255,66,112884,96,186450
16821,0.001808,74.125.24.0-255,2902,115786,96,186450
16822,0.001811,172.31.47.0-255,66,115852,96,186450
16823,0.001823,74.125.24.0-255,2902,118754,96,186450
16824,0.001825,172.31.47.0-255,66,118820,96,186450
16825,0.001867,74.125.24.0-255,2902,121722,96,186450
16826,0.001871,172.31.47.0-255,66,121788,96,186450
16827,0.001901,172.31.47.0-255,66,121854,96,186450
16828,0.001913,172.31.47.0-255,66,121920,96,186450
16829,0.002155,74.125.24.0-255,1484,123404,96,186450
16830,0.002159,74.125.24.0-255,1484,124888,96,186450
16831,0.002162,172.31.47.0-255,66,124954,96,186450
16832,0.002178,74.125.24.0-255,1484,126438,96,186450
16833,0.002183,74.125.24.0-255,2902,129340,96,186450
16834,0.002185,172.31.47.0-255,66,129406,96,186450
16835,0.002202,74.125.24.0-255,2902,132308,96,186450
16836,0.002204,172.31.47.0-255,66,132374,96,186450
16837,0.002221,172.31.47.0-255,66,132440,96,186450
16838,0.002247,74.125.24.0-255,4320,136760,96,186450
16839,0.002249,172.31.47.0-255,66,136826,96,186450
16840,0.00226,172.31.47.0-255,66,136892,96,186450
16841,0.002293,74.125.24.0-255,5738,142630,96,186450
16842,0.002296,172.31.47.0-255,66,142696,96,186450
16843,0.002326,172.31.47.0-255,66,142762,96,186450
16844,0.00236,172.31.47.0-255,66,142828,96,186450
16845,0.002381,74.125.24.0-255,5738,148566,96,186450
16846,0.002383,172.31.47.0-255,66,148632,96,186450
16847,0.002389,74.125.24.0-255,7156,155788,96,186450
16848,0.002391,172.31.47.0-255,66,155854,96,186450
16849,0.002394,74.125.24.0-255,1484,157338,96,186450
16850,0.002436,172.31.47.0-255,66,157404,96,186450
16851,0.002442,74.125.24.0-255,5738,163142,96,186450
16852,0.002444,172.31.47.0-255,66,163208,96,186450
16853,0.002482,74.125.24.0-255,5020,168228,96,186450
16854,0.002484,172.31.47.0-255,66,168294,96,186450
16855,0.00249,74.125.24.0-255,5738,174032,96,186450
16856,0.002492,172.31.47.0-255,66,174098,96,186450
16857,0.002495,74.125.24.0-255,1484,175582,96,186450
16858,0.002529,172.31.47.0-255,66,175648,96,186450
16859,0.00254,172.31.47.0-255,66,175714,96,186450
16860,0.002565,74.125.24.0-255,1484,177198,96,186450
16861,0.002577,74.125.24.0-255,4320,181518,96,186450
16862,0.002579,172.31.47.0-255,66,181584,96,186450
16863,0.00261,172.31.47.0-255,66,181650,96,186450
16864,0.00262,172.31.47.0-255,66,181716,96,186450
16865,0.002631,172.31.47.0-255,66,181782,96,186450
16866,0.005121,74.125.24.0-255,136,181918,96,186450
16867,0.006734,172.31.47.0-255,66,181984,96,186450
16868,0.00676,172.31.47.0-255,105,182089,96,186450
16869,0.00925,74.125.24.0-255,66,182155,96,186450
16870,0.029621,172.31.47.0-255,172,182327,96,186450
16871,0.029648,172.31.47.0-255,1110,183437,96,186450
16872,0.029678,172.31.47.0-255,1514,184951,96,186450
16873,0.029679,172.31.47.0-255,1301,186252,96,186450
16874,0.031171,104.244.42.0-255,66,186318,96,186450
16875,0.031229,104.244.42.0-255,66,186384,96,186450
16876,0.031232,104.244.42.0-255,66,186450,96,186450
16877,0.0,172.31.47.0-255,105,105,96,276
16878,0.001791,157.240.13.0-255,105,210,96,276
16879,0.037977,172.31.47.0-255,66,276,96,276
16880,0.0,172.31.47.0-255,105,105,96,276
16881,0.001758,157.240.13.0-255,105,210,96,276
16882,0.001773,172.31.47.0-255,66,276,96,276
16883,0.0,74.125.24.0-255,297,297,96,283670
16884,2.6e-05,172.31.47.0-255,66,363,96,283670
16885,3.2e-05,74.125.24.0-255,1484,1847,96,283670
16886,3.6e-05,172.31.47.0-255,66,1913,96,283670
16887,4.1e-05,74.125.24.0-255,4320,6233,96,283670
16888,4.4e-05,172.31.47.0-255,66,6299,96,283670
16889,6.3e-05,74.125.24.0-255,4320,10619,96,283670
16890,6.6e-05,172.31.47.0-255,66,10685,96,283670
16891,8.8e-05,74.125.24.0-255,3431,14116,96,283670
16892,9e-05,172.31.47.0-255,66,14182,96,283670
16893,0.000334,74.125.24.0-255,1484,15666,96,283670
16894,0.00034,172.31.47.0-255,66,15732,96,283670
16895,0.000346,74.125.24.0-255,2902,18634,96,283670
16896,0.000349,172.31.47.0-255,66,18700,96,283670
16897,0.000353,74.125.24.0-255,2902,21602,96,283670
16898,0.000355,172.31.47.0-255,66,21668,96,283670
16899,0.000374,74.125.24.0-255,2902,24570,96,283670
16900,0.000378,172.31.47.0-255,66,24636,96,283670
16901,0.000383,74.125.24.0-255,4320,28956,96,283670
16902,0.000386,172.31.47.0-255,66,29022,96,283670
16903,0.000426,172.31.47.0-255,66,29088,96,283670
16904,0.000442,74.125.24.0-255,2543,31631,96,283670
16905,0.000445,74.125.24.0-255,1484,33115,96,283670
16906,0.000447,172.31.47.0-255,66,33181,96,283670
16907,0.000451,172.31.47.0-255,66,33247,96,283670
16908,0.000493,74.125.24.0-255,5379,38626,96,283670
16909,0.000496,172.31.47.0-255,66,38692,96,283670
16910,0.001163,74.125.24.0-255,1484,40176,96,283670
16911,0.001169,172.31.47.0-255,66,40242,96,283670
16912,0.001179,74.125.24.0-255,2902,43144,96,283670
16913,0.001182,172.31.47.0-255,66,43210,96,283670
16914,0.001189,74.125.24.0-255,5738,48948,96,283670
16915,0.00119,172.31.47.0-255,66,49014,96,283670
16916,0.001222,74.125.24.0-255,5738,54752,96,283670
16917,0.001226,172.31.47.0-255,66,54818,96,283670
16918,0.001258,172.31.47.0-255,66,54884,96,283670
16919,0.001267,172.31.47.0-255,66,54950,96,283670
16920,0.001328,172.31.47.0-255,66,55016,96,283670
16921,0.001333,74.125.24.0-255,4320,59336,96,283670
16922,0.001335,172.31.47.0-255,66,59402,96,283670
16923,0.001338,74.125.24.0-255,1484,60886,96,283670
16924,0.001356,74.125.24.0-255,4320,65206,96,283670
16925,0.001359,172.31.47.0-255,66,65272,96,283670
16926,0.00138,74.125.24.0-255,1484,66756,96,283670
16927,0.001395,74.125.24.0-255,5264,72020,96,283670
16928,0.001398,172.31.47.0-255,66,72086,96,283670
16929,0.001449,74.125.24.0-255,1484,73570,96,283670
16930,0.001454,74.125.24.0-255,2902,76472,96,283670
16931,0.001458,172.31.47.0-255,66,76538,96,283670
16932,0.001462,74.125.24.0-255,1484,78022,96,283670
16933,0.001476,74.125.24.0-255,4320,82342,96,283670
16934,0.001479,172.31.47.0-255,66,82408,96,283670
16935,0.001493,172.31.47.0-255,66,82474,96,283670
16936,0.001551,74.125.24.0-255,1484,83958,96,283670
16937,0.001558,74.125.24.0-255,2902,86860,96,283670
16938,0.001562,172.31.47.0-255,66,86926,96,283670
16939,0.001566,74.125.24.0-255,1484,88410,96,283670
16940,0.001593,74.125.24.0-255,4320,92730,96,283670
16941,0.001596,172.31.47.0-255,66,92796,96,283670
16942,0.001607,172.31.47.0-255,66,92862,96,283670
16943,0.001637,74.125.24.0-255,2902,95764,96,283670
16944,0.001641,172.31.47.0-255,66,95830,96,283670
16945,0.001681,172.31.47.0-255,66,95896,96,283670
16946,0.002038,74.125.24.0-255,1484,97380,96,283670
16947,0.002044,74.125.24.0-255,2902,100282,96,283670
16948,0.002047,172.31.47.0-255,66,100348,96,283670
16949,0.00205,74.125.24.0-255,1484,101832,96,283670
16950,0.002066,74.125.24.0-255,4320,106152,96,283670
16951,0.002068,172.31.47.0-255,66,106218,96,283670
16952,0.0021,172.31.47.0-255,66,106284,96,283670
16953,0.00211,172.31.47.0-255,66,106350,96,283670
16954,0.002132,74.125.24.0-255,766,107116,96,283670
16955,0.002158,74.125.24.0-255,1484,108600,96,283670
16956,0.00216,172.31.47.0-255,66,108666,96,283670
16957,0.002173,74.125.24.0-255,2902,111568,96,283670
16958,0.002175,172.31.47.0-255,66,111634,96,283670
16959,0.002186,74.125.24.0-255,1484,113118,96,283670
16960,0.002188,74.125.24.0-255,1484,114602,96,283670
16961,0.00219,172.31.47.0-255,66,114668,96,283670
16962,0.0022,74.125.24.0-255,1484,116152,96,283670
16963,0.002221,172.31.47.0-255,66,116218,96,283670
16964,0.002244,74.125.24.0-255,2902,119120,96,283670
16965,0.002245,172.31.47.0-255,66,119186,96,283670
16966,0.002277,172.31.47.0-255,66,119252,96,283670
16967,0.002345,74.125.24.0-255,1484,120736,96,283670
16968,0.002348,74.125.24.0-255,1484,122220,96,283670
16969,0.002351,172.31.47.0-255,66,122286,96,283670
16970,0.002368,74.125.24.0-255,1484,123770,96,283670
16971,0.002373,74.125.24.0-255,5738,129508,96,283670
16972,0.002375,172.31.47.0-255,66,129574,96,283670
16973,0.002389,74.125.24.0-255,1484,131058,96,283670
16974,0.002416,172.31.47.0-255,66,131124,96,283670
16975,0.002425,172.31.47.0-255,66,131190,96,283670
16976,0.002477,74.125.24.0-255,2184,133374,96,283670
16977,0.002479,172.31.47.0-255,66,133440,96,283670
16978,0.002515,74.125.24.0-255,1484,134924,96,283670
16979,0.002526,74.125.24.0-255,2902,137826,96,283670
16980,0.002529,172.31.47.0-255,66,137892,96,283670
16981,0.002531,74.125.24.0-255,1484,139376,96,283670
16982,0.002549,74.125.24.0-255,4320,143696,96,283670
16983,0.002551,172.31.47.0-255,66,143762,96,283670
16984,0.005039,74.125.24.0-255,2902,146664,96,283670
16985,0.005042,172.31.47.0-255,66,146730,96,283670
16986,0.005058,74.125.24.0-255,2902,149632,96,283670
16987,0.005059,172.31.47.0-255,66,149698,96,283670
16988,0.007554,74.125.24.0-255,5738,155436,96,283670
16989,0.007561,172.31.47.0-255,66,155502,96,283670
16990,0.010066,74.125.24.0-255,5738,161240,96,283670
16991,0.010073,172.31.47.0-255,66,161306,96,283670
16992,0.012576,74.125.24.0-255,5738,167044,96,283670
16993,0.012582,172.31.47.0-255,66,167110,96,283670
16994,0.015104,74.125.24.0-255,5738,172848,96,283670
16995,0.015117,172.31.47.0-255,66,172914,96,283670
16996,0.017638,74.125.24.0-255,5738,178652,96,283670
16997,0.017645,172.31.47.0-255,66,178718,96,283670
16998,0.020146,74.125.24.0-255,5738,184456,96,283670
16999,0.020152,172.31.47.0-255,66,184522,96,283670
17000,0.022659,74.125.24.0-255,5738,190260,96,283670
17001,0.022665,172.31.47.0-255,66,190326,96,283670
17002,0.023138,172.31.47.0-255,172,190498,96,283670
17003,0.023167,172.31.47.0-255,1109,191607,96,283670
17004,0.023193,172.31.47.0-255,1514,193121,96,283670
17005,0.023194,172.31.47.0-255,337,193458,96,283670
17006,0.024633,104.244.42.0-255,66,193524,96,283670
17007,0.024803,104.244.42.0-255,66,193590,96,283670
17008,0.024812,104.244.42.0-255,66,193656,96,283670
17009,0.02517,74.125.24.0-255,4320,197976,96,283670
17010,0.025173,172.31.47.0-255,66,198042,96,283670
17011,0.0252,74.125.24.0-255,1484,199526,96,283670
17012,0.027671,74.125.24.0-255,4320,203846,96,283670
17013,0.027675,172.31.47.0-255,66,203912,96,283670
17014,0.030168,74.125.24.0-255,5738,209650,96,283670
17015,0.030173,172.31.47.0-255,66,209716,96,283670
17016,0.032692,74.125.24.0-255,5738,215454,96,283670
17017,0.032697,172.31.47.0-255,66,215520,96,283670
17018,0.035191,74.125.24.0-255,5738,221258,96,283670
17019,0.035196,172.31.47.0-255,66,221324,96,283670
17020,0.0377,74.125.24.0-255,5738,227062,96,283670
17021,0.037704,172.31.47.0-255,66,227128,96,283670
17022,0.040211,74.125.24.0-255,5738,232866,96,283670
17023,0.040217,172.31.47.0-255,66,232932,96,283670
17024,0.042719,74.125.24.0-255,5738,238670,96,283670
17025,0.042724,172.31.47.0-255,66,238736,96,283670
17026,0.045229,74.125.24.0-255,5738,244474,96,283670
17027,0.045233,172.31.47.0-255,66,244540,96,283670
17028,0.047723,74.125.24.0-255,5738,250278,96,283670
17029,0.047728,172.31.47.0-255,66,250344,96,283670
17030,0.050221,74.125.24.0-255,5738,256082,96,283670
17031,0.050227,172.31.47.0-255,66,256148,96,283670
17032,0.052722,74.125.24.0-255,5738,261886,96,283670
17033,0.052727,172.31.47.0-255,66,261952,96,283670
17034,0.055228,74.125.24.0-255,4320,266272,96,283670
17035,0.055232,172.31.47.0-255,66,266338,96,283670
17036,0.055258,74.125.24.0-255,1484,267822,96,283670
17037,0.057722,74.125.24.0-255,4320,272142,96,283670
17038,0.057726,172.31.47.0-255,66,272208,96,283670
17039,0.060237,74.125.24.0-255,5738,277946,96,283670
17040,0.060243,172.31.47.0-255,66,278012,96,283670
17041,0.062749,74.125.24.0-255,2902,280914,96,283670
17042,0.062753,172.31.47.0-255,66,280980,96,283670
17043,0.062783,74.125.24.0-255,2453,283433,96,283670
17044,0.062786,172.31.47.0-255,66,283499,96,283670
17045,0.06292,172.31.47.0-255,105,283604,96,283670
17046,0.065384,74.125.24.0-255,66,283670,96,283670
17047,0.0,74.125.24.0-255,152,152,96,284514
17048,2.6e-05,172.31.47.0-255,66,218,96,284514
17049,3.3e-05,74.125.24.0-255,1484,1702,96,284514
17050,3.7e-05,172.31.47.0-255,66,1768,96,284514
17051,4.1e-05,74.125.24.0-255,2902,4670,96,284514
17052,4.4e-05,172.31.47.0-255,66,4736,96,284514
17053,4.9e-05,74.125.24.0-255,5738,10474,96,284514
17054,5.2e-05,172.31.47.0-255,66,10540,96,284514
17055,9.5e-05,74.125.24.0-255,3484,14024,96,284514
17056,9.8e-05,172.31.47.0-255,66,14090,96,284514
17057,0.000167,74.125.24.0-255,1484,15574,96,284514
17058,0.000171,172.31.47.0-255,66,15640,96,284514
17059,0.000174,74.125.24.0-255,1484,17124,96,284514
17060,0.000176,172.31.47.0-255,66,17190,96,284514
17061,0.000188,74.125.24.0-255,1484,18674,96,284514
17062,0.00019,172.31.47.0-255,66,18740,96,284514
17063,0.000233,74.125.24.0-255,2902,21642,96,284514
17064,0.000236,172.31.47.0-255,66,21708,96,284514
17065,0.000259,74.125.24.0-255,2902,24610,96,284514
17066,0.000261,172.31.47.0-255,66,24676,96,284514
17067,0.000273,172.31.47.0-255,66,24742,96,284514
17068,0.000304,74.125.24.0-255,1484,26226,96,284514
17069,0.000307,172.31.47.0-255,66,26292,96,284514
17070,0.000333,172.31.47.0-255,66,26358,96,284514
17071,0.000353,74.125.24.0-255,1484,27842,96,284514
17072,0.000355,172.31.47.0-255,66,27908,96,284514
17073,0.00036,74.125.24.0-255,2902,30810,96,284514
17074,0.000362,172.31.47.0-255,66,30876,96,284514
17075,0.000365,74.125.24.0-255,1484,32360,96,284514
17076,0.000366,172.31.47.0-255,66,32426,96,284514
17077,0.000388,74.125.24.0-255,4320,36746,96,284514
17078,0.000392,172.31.47.0-255,66,36812,96,284514
17079,0.000394,74.125.24.0-255,1484,38296,96,284514
17080,0.00042,74.125.24.0-255,5379,43675,96,284514
17081,0.000424,172.31.47.0-255,66,43741,96,284514
17082,0.000438,74.125.24.0-255,411,44152,96,284514
17083,0.000511,74.125.24.0-255,1484,45636,96,284514
17084,0.000515,172.31.47.0-255,66,45702,96,284514
17085,0.000524,74.125.24.0-255,2902,48604,96,284514
17086,0.000526,172.31.47.0-255,66,48670,96,284514
17087,0.000545,74.125.24.0-255,5738,54408,96,284514
17088,0.000548,172.31.47.0-255,66,54474,96,284514
17089,0.00057,74.125.24.0-255,5738,60212,96,284514
17090,0.000574,172.31.47.0-255,66,60278,96,284514
17091,0.000597,74.125.24.0-255,2543,62821,96,284514
17092,0.0006,172.31.47.0-255,66,62887,96,284514
17093,0.000609,172.31.47.0-255,66,62953,96,284514
17094,0.000626,74.125.24.0-255,6797,69750,96,284514
17095,0.000629,172.31.47.0-255,66,69816,96,284514
17096,0.000811,74.125.24.0-255,1484,71300,96,284514
17097,0.000822,74.125.24.0-255,2902,74202,96,284514
17098,0.000825,172.31.47.0-255,66,74268,96,284514
17099,0.000828,74.125.24.0-255,1484,75752,96,284514
17100,0.000846,74.125.24.0-255,4320,80072,96,284514
17101,0.000849,172.31.47.0-255,66,80138,96,284514
17102,0.000861,74.125.24.0-255,4320,84458,96,284514
17103,0.000864,172.31.47.0-255,66,84524,96,284514
17104,0.000883,172.31.47.0-255,66,84590,96,284514
17105,0.000885,74.125.24.0-255,1484,86074,96,284514
17106,0.000918,74.125.24.0-255,1484,87558,96,284514
17107,0.000921,172.31.47.0-255,66,87624,96,284514
17108,0.00095,172.31.47.0-255,66,87690,96,284514
17109,0.000992,74.125.24.0-255,1484,89174,96,284514
17110,0.001009,74.125.24.0-255,2902,92076,96,284514
17111,0.001012,172.31.47.0-255,66,92142,96,284514
17112,0.00104,74.125.24.0-255,4320,96462,96,284514
17113,0.001043,172.31.47.0-255,66,96528,96,284514
17114,0.001083,74.125.24.0-255,7156,103684,96,284514
17115,0.001086,172.31.47.0-255,66,103750,96,284514
17116,0.001103,74.125.24.0-255,1484,105234,96,284514
17117,0.001112,172.31.47.0-255,66,105300,96,284514
17118,0.001134,74.125.24.0-255,1484,106784,96,284514
17119,0.001154,74.125.24.0-255,6704,113488,96,284514
17120,0.001157,172.31.47.0-255,66,113554,96,284514
17121,0.001649,74.125.24.0-255,1484,115038,96,284514
17122,0.00166,74.125.24.0-255,2902,117940,96,284514
17123,0.001665,172.31.47.0-255,66,118006,96,284514
17124,0.001741,74.125.24.0-255,5738,123744,96,284514
17125,0.001745,172.31.47.0-255,66,123810,96,284514
17126,0.00177,74.125.24.0-255,2902,126712,96,284514
17127,0.001772,172.31.47.0-255,66,126778,96,284514
17128,0.001791,74.125.24.0-255,4320,131098,96,284514
17129,0.001794,172.31.47.0-255,66,131164,96,284514
17130,0.001829,74.125.24.0-255,4320,135484,96,284514
17131,0.001833,172.31.47.0-255,66,135550,96,284514
17132,0.001865,172.31.47.0-255,66,135616,96,284514
17133,0.001869,74.125.24.0-255,2184,137800,96,284514
17134,0.001872,172.31.47.0-255,66,137866,96,284514
17135,0.002235,74.125.24.0-255,1484,139350,96,284514
17136,0.002251,74.125.24.0-255,2902,142252,96,284514
17137,0.002254,172.31.47.0-255,66,142318,96,284514
17138,0.002259,74.125.24.0-255,2902,145220,96,284514
17139,0.002261,172.31.47.0-255,66,145286,96,284514
17140,0.002272,74.125.24.0-255,2902,148188,96,284514
17141,0.002274,172.31.47.0-255,66,148254,96,284514
17142,0.002295,74.125.24.0-255,5738,153992,96,284514
17143,0.002297,172.31.47.0-255,66,154058,96,284514
17144,0.002325,172.31.47.0-255,66,154124,96,284514
17145,0.002354,74.125.24.0-255,5020,159144,96,284514
17146,0.002357,172.31.47.0-255,66,159210,96,284514
17147,0.002373,74.125.24.0-255,1484,160694,96,284514
17148,0.002375,172.31.47.0-255,78,160772,96,284514
17149,0.002382,74.125.24.0-255,7156,167928,96,284514
17150,0.002385,172.31.47.0-255,78,168006,96,284514
17151,0.002402,74.125.24.0-255,5738,173744,96,284514
17152,0.002405,172.31.47.0-255,66,173810,96,284514
17153,0.002416,172.31.47.0-255,66,173876,96,284514
17154,0.002441,172.31.47.0-255,66,173942,96,284514
17155,0.002465,74.125.24.0-255,2184,176126,96,284514
17156,0.002467,172.31.47.0-255,66,176192,96,284514
17157,0.00247,74.125.24.0-255,1484,177676,96,284514
17158,0.002472,74.125.24.0-255,1484,179160,96,284514
17159,0.002474,172.31.47.0-255,66,179226,96,284514
17160,0.002484,74.125.24.0-255,1484,180710,96,284514
17161,0.002497,74.125.24.0-255,2902,183612,96,284514
17162,0.0025,172.31.47.0-255,66,183678,96,284514
17163,0.002515,74.125.24.0-255,7156,190834,96,284514
17164,0.002518,172.31.47.0-255,66,190900,96,284514
17165,0.002549,74.125.24.0-255,2902,193802,96,284514
17166,0.002551,172.31.47.0-255,66,193868,96,284514
17167,0.00256,172.31.47.0-255,66,193934,96,284514
17168,0.002563,74.125.24.0-255,2902,196836,96,284514
17169,0.002565,172.31.47.0-255,66,196902,96,284514
17170,0.002571,74.125.24.0-255,5020,201922,96,284514
17171,0.002573,172.31.47.0-255,66,201988,96,284514
17172,0.002615,74.125.24.0-255,1484,203472,96,284514
17173,0.00263,74.125.24.0-255,2902,206374,96,284514
17174,0.002633,172.31.47.0-255,66,206440,96,284514
17175,0.002644,74.125.24.0-255,2902,209342,96,284514
17176,0.002646,172.31.47.0-255,66,209408,96,284514
17177,0.002661,74.125.24.0-255,1484,210892,96,284514
17178,0.002671,172.31.47.0-255,66,210958,96,284514
17179,0.002692,74.125.24.0-255,1484,212442,96,284514
17180,0.002718,172.31.47.0-255,66,212508,96,284514
17181,0.002721,74.125.24.0-255,1484,213992,96,284514
17182,0.002763,74.125.24.0-255,1484,215476,96,284514
17183,0.002765,172.31.47.0-255,66,215542,96,284514
17184,0.002781,74.125.24.0-255,2902,218444,96,284514
17185,0.002783,172.31.47.0-255,66,218510,96,284514
17186,0.002789,74.125.24.0-255,5738,224248,96,284514
17187,0.00279,172.31.47.0-255,66,224314,96,284514
17188,0.002796,74.125.24.0-255,4320,228634,96,284514
17189,0.002797,172.31.47.0-255,66,228700,96,284514
17190,0.002816,74.125.24.0-255,7156,235856,96,284514
17191,0.002819,172.31.47.0-255,66,235922,96,284514
17192,0.002825,74.125.24.0-255,5738,241660,96,284514
17193,0.002827,172.31.47.0-255,66,241726,96,284514
17194,0.00285,74.125.24.0-255,6438,248164,96,284514
17195,0.002852,172.31.47.0-255,66,248230,96,284514
17196,0.002879,74.125.24.0-255,1484,249714,96,284514
17197,0.002882,172.31.47.0-255,78,249792,96,284514
17198,0.002911,74.125.24.0-255,2902,252694,96,284514
17199,0.002914,172.31.47.0-255,78,252772,96,284514
17200,0.002943,172.31.47.0-255,78,252850,96,284514
17201,0.002948,74.125.24.0-255,4320,257170,96,284514
17202,0.00295,172.31.47.0-255,78,257248,96,284514
17203,0.002967,74.125.24.0-255,2902,260150,96,284514
17204,0.002969,172.31.47.0-255,66,260216,96,284514
17205,0.002972,74.125.24.0-255,1484,261700,96,284514
17206,0.002977,74.125.24.0-255,4320,266020,96,284514
17207,0.002979,172.31.47.0-255,66,266086,96,284514
17208,0.002983,74.125.24.0-255,3602,269688,96,284514
17209,0.002985,172.31.47.0-255,66,269754,96,284514
17210,0.003003,74.125.24.0-255,1484,271238,96,284514
17211,0.003018,74.125.24.0-255,5738,276976,96,284514
17212,0.00302,172.31.47.0-255,66,277042,96,284514
17213,0.003032,74.125.24.0-255,2769,279811,96,284514
17214,0.003035,172.31.47.0-255,66,279877,96,284514
17215,0.003037,74.125.24.0-255,105,279982,96,284514
17216,0.006478,172.31.47.0-255,66,280048,96,284514
17217,0.006501,172.31.47.0-255,105,280153,96,284514
17218,0.008757,74.125.24.0-255,66,280219,96,284514
17219,0.026396,172.31.47.0-255,172,280391,96,284514
17220,0.026427,172.31.47.0-255,1105,281496,96,284514
17221,0.026472,172.31.47.0-255,1514,283010,96,284514
17222,0.026474,172.31.47.0-255,1306,284316,96,284514
17223,0.027977,104.244.42.0-255,66,284382,96,284514
17224,0.027985,104.244.42.0-255,66,284448,96,284514
17225,0.028013,104.244.42.0-255,66,284514,96,284514
17226,0.0,172.217.160.0-255,226,226,96,275421
17227,3.4e-05,172.31.47.0-255,66,292,96,275421
17228,4.1e-05,172.217.160.0-255,1484,1776,96,275421
17229,4.5e-05,172.31.47.0-255,66,1842,96,275421
17230,5.3e-05,172.217.160.0-255,4320,6162,96,275421
17231,5.8e-05,172.31.47.0-255,66,6228,96,275421
17232,0.000117,172.217.160.0-255,5738,11966,96,275421
17233,0.00012,172.31.47.0-255,66,12032,96,275421
17234,0.000137,172.217.160.0-255,3545,15577,96,275421
17235,0.00014,172.31.47.0-255,66,15643,96,275421
17236,0.000403,172.31.47.0-255,66,15709,96,275421
17237,0.000422,172.217.160.0-255,4320,20029,96,275421
17238,0.000425,172.31.47.0-255,66,20095,96,275421
17239,0.000782,172.217.160.0-255,1125,21220,96,275421
17240,0.000788,172.31.47.0-255,66,21286,96,275421
17241,0.002048,172.217.160.0-255,4320,25606,96,275421
17242,0.002055,172.31.47.0-255,66,25672,96,275421
17243,0.002417,172.217.160.0-255,1484,27156,96,275421
17244,0.002421,172.31.47.0-255,66,27222,96,275421
17245,0.003687,172.217.160.0-255,4320,31542,96,275421
17246,0.003692,172.31.47.0-255,66,31608,96,275421
17247,0.004043,172.217.160.0-255,1484,33092,96,275421
17248,0.004047,172.31.47.0-255,66,33158,96,275421
17249,0.005327,172.217.160.0-255,2902,36060,96,275421
17250,0.005333,172.31.47.0-255,66,36126,96,275421
17251,0.005351,172.217.160.0-255,1484,37610,96,275421
17252,0.005354,172.31.47.0-255,66,37676,96,275421
17253,0.005668,172.217.160.0-255,1484,39160,96,275421
17254,0.005674,172.31.47.0-255,66,39226,96,275421
17255,0.006959,172.217.160.0-255,2902,42128,96,275421
17256,0.006967,172.31.47.0-255,66,42194,96,275421
17257,0.007305,172.217.160.0-255,2902,45096,96,275421
17258,0.007312,172.31.47.0-255,66,45162,96,275421
17259,0.008602,172.217.160.0-255,2902,48064,96,275421
17260,0.008615,172.31.47.0-255,66,48130,96,275421
17261,0.008928,172.217.160.0-255,2902,51032,96,275421
17262,0.008934,172.31.47.0-255,66,51098,96,275421
17263,0.010249,172.217.160.0-255,2902,54000,96,275421
17264,0.01026,172.31.47.0-255,66,54066,96,275421
17265,0.010573,172.217.160.0-255,2902,56968,96,275421
17266,0.01058,172.31.47.0-255,66,57034,96,275421
17267,0.011904,172.217.160.0-255,2902,59936,96,275421
17268,0.011919,172.31.47.0-255,66,60002,96,275421
17269,0.012203,172.217.160.0-255,2902,62904,96,275421
17270,0.01221,172.31.47.0-255,66,62970,96,275421
17271,0.013542,172.217.160.0-255,2902,65872,96,275421
17272,0.01355,172.31.47.0-255,66,65938,96,275421
17273,0.013862,172.217.160.0-255,2902,68840,96,275421
17274,0.013868,172.31.47.0-255,66,68906,96,275421
17275,0.015187,172.217.160.0-255,2902,71808,96,275421
17276,0.015203,172.31.47.0-255,66,71874,96,275421
17277,0.015489,172.217.160.0-255,2902,74776,96,275421
17278,0.015495,172.31.47.0-255,66,74842,96,275421
17279,0.016838,172.217.160.0-255,2902,77744,96,275421
17280,0.016849,172.31.47.0-255,66,77810,96,275421
17281,0.017121,172.217.160.0-255,2902,80712,96,275421
17282,0.017128,172.31.47.0-255,66,80778,96,275421
17283,0.018487,172.217.160.0-255,2902,83680,96,275421
17284,0.018502,172.31.47.0-255,66,83746,96,275421
17285,0.018747,172.217.160.0-255,2902,86648,96,275421
17286,0.018753,172.31.47.0-255,66,86714,96,275421
17287,0.020159,172.217.160.0-255,2902,89616,96,275421
17288,0.020174,172.31.47.0-255,66,89682,96,275421
17289,0.020381,172.217.160.0-255,2902,92584,96,275421
17290,0.020386,172.31.47.0-255,66,92650,96,275421
17291,0.0218,172.217.160.0-255,2902,95552,96,275421
17292,0.021808,172.31.47.0-255,66,95618,96,275421
17293,0.022008,172.217.160.0-255,2902,98520,96,275421
17294,0.022014,172.31.47.0-255,66,98586,96,275421
17295,0.02228,172.31.47.0-255,172,98758,96,275421
17296,0.022325,172.31.47.0-255,1101,99859,96,275421
17297,0.022402,172.31.47.0-255,1514,101373,96,275421
17298,0.022404,172.31.47.0-255,1310,102683,96,275421
17299,0.023452,172.217.160.0-255,2902,105585,96,275421
17300,0.023467,172.31.47.0-255,66,105651,96,275421
17301,0.02365,172.217.160.0-255,2902,108553,96,275421
17302,0.023656,172.31.47.0-255,66,108619,96,275421
17303,0.023835,104.244.42.0-255,66,108685,96,275421
17304,0.023848,104.244.42.0-255,66,108751,96,275421
17305,0.023973,104.244.42.0-255,66,108817,96,275421
17306,0.025097,172.217.160.0-255,2902,111719,96,275421
17307,0.025107,172.31.47.0-255,66,111785,96,275421
17308,0.025268,172.217.160.0-255,2902,114687,96,275421
17309,0.025273,172.31.47.0-255,66,114753,96,275421
17310,0.026728,172.217.160.0-255,2902,117655,96,275421
17311,0.026738,172.31.47.0-255,66,117721,96,275421
17312,0.026892,172.217.160.0-255,2902,120623,96,275421
17313,0.026896,172.31.47.0-255,66,120689,96,275421
17314,0.028386,172.217.160.0-255,2902,123591,96,275421
17315,0.028399,172.31.47.0-255,66,123657,96,275421
17316,0.028511,172.217.160.0-255,2902,126559,96,275421
17317,0.028516,172.31.47.0-255,66,126625,96,275421
17318,0.030038,172.217.160.0-255,2902,129527,96,275421
17319,0.030061,172.31.47.0-255,66,129593,96,275421
17320,0.03013,172.217.160.0-255,2902,132495,96,275421
17321,0.030135,172.31.47.0-255,66,132561,96,275421
17322,0.031705,172.217.160.0-255,2902,135463,96,275421
17323,0.031724,172.31.47.0-255,66,135529,96,275421
17324,0.031759,172.217.160.0-255,2902,138431,96,275421
17325,0.031763,172.31.47.0-255,66,138497,96,275421
17326,0.03337,172.217.160.0-255,2902,141399,96,275421
17327,0.033386,172.31.47.0-255,66,141465,96,275421
17328,0.033441,172.217.160.0-255,2902,144367,96,275421
17329,0.033445,172.31.47.0-255,66,144433,96,275421
17330,0.035028,172.217.160.0-255,2902,147335,96,275421
17331,0.035046,172.31.47.0-255,66,147401,96,275421
17332,0.035079,172.217.160.0-255,2902,150303,96,275421
17333,0.035083,172.31.47.0-255,66,150369,96,275421
17334,0.036688,172.217.160.0-255,2902,153271,96,275421
17335,0.036701,172.31.47.0-255,66,153337,96,275421
17336,0.036734,172.217.160.0-255,2902,156239,96,275421
17337,0.036737,172.31.47.0-255,66,156305,96,275421
17338,0.038336,172.217.160.0-255,2902,159207,96,275421
17339,0.038351,172.31.47.0-255,66,159273,96,275421
17340,0.038417,172.217.160.0-255,2902,162175,96,275421
17341,0.038422,172.31.47.0-255,66,162241,96,275421
17342,0.039995,172.217.160.0-255,2902,165143,96,275421
17343,0.040011,172.31.47.0-255,66,165209,96,275421
17344,0.040048,172.217.160.0-255,2902,168111,96,275421
17345,0.040051,172.31.47.0-255,66,168177,96,275421
17346,0.041689,172.217.160.0-255,2902,171079,96,275421
17347,0.041702,172.31.47.0-255,66,171145,96,275421
17348,0.041742,172.217.160.0-255,2902,174047,96,275421
17349,0.041765,172.31.47.0-255,66,174113,96,275421
17350,0.043329,172.217.160.0-255,2902,177015,96,275421
17351,0.043335,172.31.47.0-255,66,177081,96,275421
17352,0.043394,172.217.160.0-255,2902,179983,96,275421
17353,0.043399,172.31.47.0-255,66,180049,96,275421
17354,0.044964,172.217.160.0-255,2902,182951,96,275421
17355,0.044974,172.31.47.0-255,66,183017,96,275421
17356,0.045011,172.217.160.0-255,1484,184501,96,275421
17357,0.045014,172.31.47.0-255,66,184567,96,275421
17358,0.045027,172.217.160.0-255,1484,186051,96,275421
17359,0.045029,172.31.47.0-255,66,186117,96,275421
17360,0.0466,172.217.160.0-255,2902,189019,96,275421
17361,0.046608,172.31.47.0-255,66,189085,96,275421
17362,0.046643,172.217.160.0-255,2902,191987,96,275421
17363,0.046645,172.31.47.0-255,66,192053,96,275421
17364,0.048226,172.217.160.0-255,2902,194955,96,275421
17365,0.048233,172.31.47.0-255,66,195021,96,275421
17366,0.048279,172.217.160.0-255,2902,197923,96,275421
17367,0.048283,172.31.47.0-255,66,197989,96,275421
17368,0.049849,172.217.160.0-255,2902,200891,96,275421
17369,0.049853,172.31.47.0-255,66,200957,96,275421
17370,0.049903,172.217.160.0-255,1484,202441,96,275421
17371,0.049907,172.31.47.0-255,66,202507,96,275421
17372,0.049924,172.217.160.0-255,1484,203991,96,275421
17373,0.049927,172.31.47.0-255,66,204057,96,275421
17374,0.051532,172.217.160.0-255,2902,206959,96,275421
17375,0.05154,172.31.47.0-255,66,207025,96,275421
17376,0.051603,172.217.160.0-255,1484,208509,96,275421
17377,0.051607,172.31.47.0-255,66,208575,96,275421
17378,0.051624,172.217.160.0-255,1484,210059,96,275421
17379,0.051627,172.31.47.0-255,66,210125,96,275421
17380,0.053171,172.217.160.0-255,2902,213027,96,275421
17381,0.053177,172.31.47.0-255,66,213093,96,275421
17382,0.053243,172.217.160.0-255,2902,215995,96,275421
17383,0.053248,172.31.47.0-255,66,216061,96,275421
17384,0.054797,172.217.160.0-255,2902,218963,96,275421
17385,0.054802,172.31.47.0-255,66,219029,96,275421
17386,0.054863,172.217.160.0-255,2902,221931,96,275421
17387,0.054868,172.31.47.0-255,66,221997,96,275421
17388,0.056422,172.217.160.0-255,2902,224899,96,275421
17389,0.05643,172.31.47.0-255,66,224965,96,275421
17390,0.05648,172.217.160.0-255,2902,227867,96,275421
17391,0.056484,172.31.47.0-255,66,227933,96,275421
17392,0.058051,172.217.160.0-255,2902,230835,96,275421
17393,0.058057,172.31.47.0-255,66,230901,96,275421
17394,0.058111,172.217.160.0-255,2902,233803,96,275421
17395,0.058119,172.31.47.0-255,66,233869,96,275421
17396,0.059688,172.217.160.0-255,2902,236771,96,275421
17397,0.059696,172.31.47.0-255,66,236837,96,275421
17398,0.059746,172.217.160.0-255,2902,239739,96,275421
17399,0.05975,172.31.47.0-255,66,239805,96,275421
17400,0.061343,172.217.160.0-255,2902,242707,96,275421
17401,0.061359,172.31.47.0-255,66,242773,96,275421
17402,0.061384,172.217.160.0-255,2902,245675,96,275421
17403,0.061387,172.31.47.0-255,66,245741,96,275421
17404,0.063021,172.217.160.0-255,2902,248643,96,275421
17405,0.063037,172.31.47.0-255,66,248709,96,275421
17406,0.06306,172.217.160.0-255,2902,251611,96,275421
17407,0.063063,172.31.47.0-255,66,251677,96,275421
17408,0.064674,172.217.160.0-255,2902,254579,96,275421
17409,0.064684,172.31.47.0-255,66,254645,96,275421
17410,0.064707,172.217.160.0-255,2902,257547,96,275421
17411,0.064711,172.31.47.0-255,66,257613,96,275421
17412,0.066312,172.217.160.0-255,2902,260515,96,275421
17413,0.066324,172.31.47.0-255,66,260581,96,275421
17414,0.066344,172.217.160.0-255,2902,263483,96,275421
17415,0.06635,172.31.47.0-255,66,263549,96,275421
17416,0.067951,172.217.160.0-255,2902,266451,96,275421
17417,0.067964,172.31.47.0-255,66,266517,96,275421
17418,0.06799,172.217.160.0-255,2902,269419,96,275421
17419,0.067993,172.31.47.0-255,66,269485,96,275421
17420,0.069602,172.217.160.0-255,2902,272387,96,275421
17421,0.069619,172.31.47.0-255,66,272453,96,275421
17422,0.069643,172.217.160.0-255,2902,275355,96,275421
17423,0.069647,172.31.47.0-255,66,275421,96,275421
17424,0.0,172.217.194.0-255,153,153,96,299657
17425,3.1e-05,172.31.47.0-255,66,219,96,299657
17426,3.8e-05,172.217.194.0-255,1484,1703,96,299657
17427,4.2e-05,172.31.47.0-255,66,1769,96,299657
17428,4.6e-05,172.217.194.0-255,2902,4671,96,299657
17429,4.8e-05,172.31.47.0-255,66,4737,96,299657
17430,7.2e-05,172.217.194.0-255,5738,10475,96,299657
17431,7.4e-05,172.31.47.0-255,66,10541,96,299657
17432,0.000153,172.217.194.0-255,3433,13974,96,299657
17433,0.000159,172.31.47.0-255,66,14040,96,299657
17434,0.000237,172.217.194.0-255,1484,15524,96,299657
17435,0.00024,172.31.47.0-255,66,15590,96,299657
17436,0.000244,172.217.194.0-255,1484,17074,96,299657
17437,0.000245,172.31.47.0-255,66,17140,96,299657
17438,0.000258,172.217.194.0-255,1484,18624,96,299657
17439,0.00026,172.31.47.0-255,66,18690,96,299657
17440,0.000285,172.217.194.0-255,5738,24428,96,299657
17441,0.000288,172.31.47.0-255,66,24494,96,299657
17442,0.000368,172.217.194.0-255,4320,28814,96,299657
17443,0.000374,172.31.47.0-255,66,28880,96,299657
17444,0.000389,172.31.47.0-255,66,28946,96,299657
17445,0.000549,172.217.194.0-255,7156,36102,96,299657
17446,0.000553,172.31.47.0-255,66,36168,96,299657
17447,0.000573,172.217.194.0-255,3961,40129,96,299657
17448,0.000588,172.31.47.0-255,66,40195,96,299657
17449,0.000707,172.217.194.0-255,4320,44515,96,299657
17450,0.000712,172.31.47.0-255,66,44581,96,299657
17451,0.000776,172.217.194.0-255,5738,50319,96,299657
17452,0.00078,172.31.47.0-255,66,50385,96,299657
17453,0.000809,172.31.47.0-255,66,50451,96,299657
17454,0.000965,172.217.194.0-255,7156,57607,96,299657
17455,0.00097,172.31.47.0-255,66,57673,96,299657
17456,0.001014,172.31.47.0-255,66,57739,96,299657
17457,0.001182,172.217.194.0-255,4320,62059,96,299657
17458,0.001187,172.31.47.0-255,66,62125,96,299657
17459,0.001226,172.31.47.0-255,66,62191,96,299657
17460,0.00144,172.217.194.0-255,2902,65093,96,299657
17461,0.001443,172.31.47.0-255,66,65159,96,299657
17462,0.001481,172.31.47.0-255,66,65225,96,299657
17463,0.001707,172.217.194.0-255,7156,72381,96,299657
17464,0.00171,172.31.47.0-255,66,72447,96,299657
17465,0.001741,172.31.47.0-255,66,72513,96,299657
17466,0.00192,172.217.194.0-255,1484,73997,96,299657
17467,0.001939,172.217.194.0-255,2902,76899,96,299657
17468,0.001942,172.31.47.0-255,66,76965,96,299657
17469,0.00198,172.217.194.0-255,2902,79867,96,299657
17470,0.001996,172.217.194.0-255,2902,82769,96,299657
17471,0.002004,172.31.47.0-255,66,82835,96,299657
17472,0.002083,172.217.194.0-255,4320,87155,96,299657
17473,0.002086,172.31.47.0-255,66,87221,96,299657
17474,0.002116,172.31.47.0-255,66,87287,96,299657
17475,0.002247,172.217.194.0-255,4320,91607,96,299657
17476,0.00225,172.31.47.0-255,66,91673,96,299657
17477,0.002272,172.217.194.0-255,6438,98111,96,299657
17478,0.002279,172.31.47.0-255,66,98177,96,299657
17479,0.002429,172.217.194.0-255,5738,103915,96,299657
17480,0.002432,172.31.47.0-255,66,103981,96,299657
17481,0.002462,172.31.47.0-255,66,104047,96,299657
17482,0.002497,172.31.47.0-255,66,104113,96,299657
17483,0.002777,172.217.194.0-255,2902,107015,96,299657
17484,0.002781,172.31.47.0-255,66,107081,96,299657
17485,0.002803,172.217.194.0-255,5020,112101,96,299657
17486,0.00281,172.31.47.0-255,66,112167,96,299657
17487,0.004833,172.217.194.0-255,5738,117905,96,299657
17488,0.004838,172.31.47.0-255,66,117971,96,299657
17489,0.006876,172.217.194.0-255,5738,123709,96,299657
17490,0.006882,172.31.47.0-255,66,123775,96,299657
17491,0.008926,172.217.194.0-255,5738,129513,96,299657
17492,0.008933,172.31.47.0-255,66,129579,96,299657
17493,0.010962,172.217.194.0-255,5738,135317,96,299657
17494,0.01097,172.31.47.0-255,66,135383,96,299657
17495,0.012989,172.217.194.0-255,5738,141121,96,299657
17496,0.012996,172.31.47.0-255,66,141187,96,299657
17497,0.015009,172.217.194.0-255,5738,146925,96,299657
17498,0.015016,172.31.47.0-255,66,146991,96,299657
17499,0.017032,172.217.194.0-255,5738,152729,96,299657
17500,0.017038,172.31.47.0-255,66,152795,96,299657
17501,0.01909,172.217.194.0-255,5738,158533,96,299657
17502,0.019095,172.31.47.0-255,66,158599,96,299657
17503,0.021111,172.217.194.0-255,5738,164337,96,299657
17504,0.021116,172.31.47.0-255,66,164403,96,299657
17505,0.022069,172.31.47.0-255,172,164575,96,299657
17506,0.022102,172.31.47.0-255,1111,165686,96,299657
17507,0.022161,172.31.47.0-255,1514,167200,96,299657
17508,0.022162,172.31.47.0-255,1514,168714,96,299657
17509,0.022166,172.31.47.0-255,1514,170228,96,299657
17510,0.022167,172.31.47.0-255,1081,171309,96,299657
17511,0.023141,172.217.194.0-255,5738,177047,96,299657
17512,0.023146,172.31.47.0-255,66,177113,96,299657
17513,0.023615,104.244.42.0-255,66,177179,96,299657
17514,0.02362,104.244.42.0-255,66,177245,96,299657
17515,0.023709,104.244.42.0-255,66,177311,96,299657
17516,0.023723,104.244.42.0-255,66,177377,96,299657
17517,0.025182,172.217.194.0-255,5738,183115,96,299657
17518,0.025186,172.31.47.0-255,66,183181,96,299657
17519,0.027293,172.217.194.0-255,5738,188919,96,299657
17520,0.027298,172.31.47.0-255,66,188985,96,299657
17521,0.02935,172.217.194.0-255,4320,193305,96,299657
17522,0.029355,172.31.47.0-255,66,193371,96,299657
17523,0.02938,172.217.194.0-255,1484,194855,96,299657
17524,0.031375,172.217.194.0-255,4320,199175,96,299657
17525,0.03138,172.31.47.0-255,66,199241,96,299657
17526,0.033405,172.217.194.0-255,5738,204979,96,299657
17527,0.03345,172.31.47.0-255,66,205045,96,299657
17528,0.035499,172.217.194.0-255,4320,209365,96,299657
17529,0.035504,172.31.47.0-255,66,209431,96,299657
17530,0.03553,172.217.194.0-255,1484,210915,96,299657
17531,0.037535,172.217.194.0-255,4320,215235,96,299657
17532,0.037539,172.31.47.0-255,66,215301,96,299657
17533,0.03955,172.217.194.0-255,5738,221039,96,299657
17534,0.039587,172.31.47.0-255,66,221105,96,299657
17535,0.041619,172.217.194.0-255,5738,226843,96,299657
17536,0.041624,172.31.47.0-255,66,226909,96,299657
17537,0.043674,172.217.194.0-255,4320,231229,96,299657
17538,0.043678,172.31.47.0-255,66,231295,96,299657
17539,0.043695,172.217.194.0-255,1484,232779,96,299657
17540,0.0457,172.217.194.0-255,4320,237099,96,299657
17541,0.045705,172.31.47.0-255,66,237165,96,299657
17542,0.047735,172.217.194.0-255,5738,242903,96,299657
17543,0.047776,172.31.47.0-255,66,242969,96,299657
17544,0.049815,172.217.194.0-255,5738,248707,96,299657
17545,0.049822,172.31.47.0-255,66,248773,96,299657
17546,0.05188,172.217.194.0-255,5738,254511,96,299657
17547,0.051885,172.31.47.0-255,66,254577,96,299657
17548,0.053903,172.217.194.0-255,5738,260315,96,299657
17549,0.053907,172.31.47.0-255,66,260381,96,299657
17550,0.055945,172.217.194.0-255,5738,266119,96,299657
17551,0.055951,172.31.47.0-255,66,266185,96,299657
17552,0.057975,172.217.194.0-255,5738,271923,96,299657
17553,0.057979,172.31.47.0-255,66,271989,96,299657
17554,0.060051,172.217.194.0-255,5738,277727,96,299657
17555,0.060057,172.31.47.0-255,66,277793,96,299657
17556,0.062081,172.217.194.0-255,4320,282113,96,299657
17557,0.062087,172.31.47.0-255,66,282179,96,299657
17558,0.062102,172.217.194.0-255,1484,283663,96,299657
17559,0.064119,172.217.194.0-255,4320,287983,96,299657
17560,0.064125,172.31.47.0-255,66,288049,96,299657
17561,0.066147,172.217.194.0-255,5738,293787,96,299657
17562,0.066193,172.31.47.0-255,66,293853,96,299657
17563,0.068229,172.217.194.0-255,5738,299591,96,299657
17564,0.068234,172.31.47.0-255,66,299657,96,299657
17565,0.0,172.217.194.0-255,152,152,96,242998
17566,3.1e-05,172.31.47.0-255,66,218,96,242998
17567,3.8e-05,172.217.194.0-255,1484,1702,96,242998
17568,4.3e-05,172.31.47.0-255,66,1768,96,242998
17569,4.8e-05,172.217.194.0-255,2902,4670,96,242998
17570,5.7e-05,172.31.47.0-255,66,4736,96,242998
17571,6.4e-05,172.217.194.0-255,5738,10474,96,242998
17572,6.6e-05,172.31.47.0-255,66,10540,96,242998
17573,0.000109,172.217.194.0-255,3559,14099,96,242998
17574,0.000112,172.31.47.0-255,66,14165,96,242998
17575,0.000286,172.217.194.0-255,1484,15649,96,242998
17576,0.000291,172.31.47.0-255,66,15715,96,242998
17577,0.000296,172.217.194.0-255,2902,18617,96,242998
17578,0.000298,172.31.47.0-255,66,18683,96,242998
17579,0.00032,172.217.194.0-255,5738,24421,96,242998
17580,0.000326,172.31.47.0-255,66,24487,96,242998
17581,0.000351,172.217.194.0-255,4320,28807,96,242998
17582,0.000354,172.31.47.0-255,66,28873,96,242998
17583,0.000394,172.31.47.0-255,66,28939,96,242998
17584,0.000404,172.31.47.0-255,66,29005,96,242998
17585,0.000446,172.31.47.0-255,66,29071,96,242998
17586,0.000448,172.217.194.0-255,394,29465,96,242998
17587,0.000452,172.31.47.0-255,66,29531,96,242998
17588,0.000482,172.217.194.0-255,380,29911,96,242998
17589,0.000486,172.31.47.0-255,66,29977,96,242998
17590,0.000554,172.217.194.0-255,1484,31461,96,242998
17591,0.000558,172.31.47.0-255,66,31527,96,242998
17592,0.000562,172.217.194.0-255,4320,35847,96,242998
17593,0.000564,172.31.47.0-255,66,35913,96,242998
17594,0.000609,172.31.47.0-255,66,35979,96,242998
17595,0.000618,172.217.194.0-255,2184,38163,96,242998
17596,0.00062,172.31.47.0-255,66,38229,96,242998
17597,0.000622,172.31.47.0-255,66,38295,96,242998
17598,0.00097,172.217.194.0-255,1484,39779,96,242998
17599,0.000978,172.217.194.0-255,2902,42681,96,242998
17600,0.000982,172.31.47.0-255,66,42747,96,242998
17601,0.000992,172.217.194.0-255,1484,44231,96,242998
17602,0.00101,172.217.194.0-255,4320,48551,96,242998
17603,0.001013,172.31.47.0-255,66,48617,96,242998
17604,0.001023,172.217.194.0-255,1484,50101,96,242998
17605,0.001055,172.31.47.0-255,66,50167,96,242998
17606,0.001077,172.217.194.0-255,2902,53069,96,242998
17607,0.00108,172.31.47.0-255,66,53135,96,242998
17608,0.001112,172.31.47.0-255,66,53201,96,242998
17609,0.001124,172.217.194.0-255,1484,54685,96,242998
17610,0.001142,172.217.194.0-255,5738,60423,96,242998
17611,0.001145,172.31.47.0-255,66,60489,96,242998
17612,0.001151,172.217.194.0-255,5738,66227,96,242998
17613,0.001152,172.31.47.0-255,66,66293,96,242998
17614,0.00117,172.217.194.0-255,2902,69195,96,242998
17615,0.001172,172.217.194.0-255,1484,70679,96,242998
17616,0.001174,172.31.47.0-255,66,70745,96,242998
17617,0.001207,172.31.47.0-255,66,70811,96,242998
17618,0.001232,172.217.194.0-255,766,71577,96,242998
17619,0.001504,172.217.194.0-255,1484,73061,96,242998
17620,0.001507,172.31.47.0-255,66,73127,96,242998
17621,0.001522,172.217.194.0-255,2902,76029,96,242998
17622,0.001529,172.31.47.0-255,66,76095,96,242998
17623,0.001535,172.217.194.0-255,4320,80415,96,242998
17624,0.001537,172.31.47.0-255,66,80481,96,242998
17625,0.001575,172.217.194.0-255,1484,81965,96,242998
17626,0.001587,172.31.47.0-255,66,82031,96,242998
17627,0.001617,172.31.47.0-255,66,82097,96,242998
17628,0.001628,172.217.194.0-255,2184,84281,96,242998
17629,0.001635,172.31.47.0-255,66,84347,96,242998
17630,0.001718,172.217.194.0-255,1484,85831,96,242998
17631,0.001735,172.217.194.0-255,2902,88733,96,242998
17632,0.001738,172.31.47.0-255,66,88799,96,242998
17633,0.001742,172.217.194.0-255,1484,90283,96,242998
17634,0.00177,172.217.194.0-255,2902,93185,96,242998
17635,0.001773,172.31.47.0-255,66,93251,96,242998
17636,0.001783,172.31.47.0-255,66,93317,96,242998
17637,0.00182,172.31.47.0-255,66,93383,96,242998
17638,0.001846,172.217.194.0-255,2902,96285,96,242998
17639,0.001849,172.31.47.0-255,66,96351,96,242998
17640,0.001853,172.217.194.0-255,2184,98535,96,242998
17641,0.001857,172.31.47.0-255,66,98601,96,242998
17642,0.00197,172.217.194.0-255,1484,100085,96,242998
17643,0.001976,172.217.194.0-255,2902,102987,96,242998
17644,0.001978,172.31.47.0-255,66,103053,96,242998
17645,0.001984,172.217.194.0-255,4320,107373,96,242998
17646,0.001986,172.31.47.0-255,66,107439,96,242998
17647,0.002008,172.217.194.0-255,1484,108923,96,242998
17648,0.002025,172.31.47.0-255,66,108989,96,242998
17649,0.002073,172.31.47.0-255,66,109055,96,242998
17650,0.002105,172.217.194.0-255,6438,115493,96,242998
17651,0.002109,172.31.47.0-255,66,115559,96,242998
17652,0.002135,172.217.194.0-255,1484,117043,96,242998
17653,0.00214,172.217.194.0-255,2902,119945,96,242998
17654,0.002143,172.31.47.0-255,66,120011,96,242998
17655,0.002149,172.217.194.0-255,5738,125749,96,242998
17656,0.002151,172.31.47.0-255,66,125815,96,242998
17657,0.002191,172.217.194.0-255,5738,131553,96,242998
17658,0.002194,172.31.47.0-255,66,131619,96,242998
17659,0.002223,172.217.194.0-255,7156,138775,96,242998
17660,0.002227,172.31.47.0-255,66,138841,96,242998
17661,0.002229,172.217.194.0-255,1484,140325,96,242998
17662,0.002239,172.31.47.0-255,66,140391,96,242998
17663,0.002269,172.217.194.0-255,5738,146129,96,242998
17664,0.002272,172.31.47.0-255,66,146195,96,242998
17665,0.002283,172.217.194.0-255,7156,153351,96,242998
17666,0.002285,172.31.47.0-255,66,153417,96,242998
17667,0.002333,172.31.47.0-255,66,153483,96,242998
17668,0.002335,172.217.194.0-255,6438,159921,96,242998
17669,0.002337,172.31.47.0-255,66,159987,96,242998
17670,0.00464,172.217.194.0-255,5738,165725,96,242998
17671,0.004656,172.31.47.0-255,66,165791,96,242998
17672,0.007011,172.217.194.0-255,5738,171529,96,242998
17673,0.007022,172.31.47.0-255,66,171595,96,242998
17674,0.009391,172.217.194.0-255,5738,177333,96,242998
17675,0.009398,172.31.47.0-255,66,177399,96,242998
17676,0.011687,172.217.194.0-255,5738,183137,96,242998
17677,0.011692,172.31.47.0-255,66,183203,96,242998
17678,0.014034,172.217.194.0-255,5738,188941,96,242998
17679,0.014042,172.31.47.0-255,66,189007,96,242998
17680,0.01639,172.217.194.0-255,5738,194745,96,242998
17681,0.016397,172.31.47.0-255,66,194811,96,242998
17682,0.018747,172.217.194.0-255,5738,200549,96,242998
17683,0.018755,172.31.47.0-255,66,200615,96,242998
17684,0.021041,172.217.194.0-255,5738,206353,96,242998
17685,0.021049,172.31.47.0-255,66,206419,96,242998
17686,0.023404,172.217.194.0-255,5738,212157,96,242998
17687,0.023411,172.31.47.0-255,66,212223,96,242998
17688,0.025722,172.217.194.0-255,5738,217961,96,242998
17689,0.02573,172.31.47.0-255,66,218027,96,242998
17690,0.02808,172.217.194.0-255,5738,223765,96,242998
17691,0.028089,172.31.47.0-255,66,223831,96,242998
17692,0.030455,172.217.194.0-255,4320,228151,96,242998
17693,0.030461,172.31.47.0-255,66,228217,96,242998
17694,0.030491,172.217.194.0-255,1484,229701,96,242998
17695,0.031565,172.31.47.0-255,172,229873,96,242998
17696,0.031594,172.31.47.0-255,1104,230977,96,242998
17697,0.031623,172.31.47.0-255,1514,232491,96,242998
17698,0.031625,172.31.47.0-255,1307,233798,96,242998
17699,0.032793,172.217.194.0-255,4320,238118,96,242998
17700,0.032799,172.31.47.0-255,66,238184,96,242998
17701,0.033131,104.244.42.0-255,66,238250,96,242998
17702,0.033169,104.244.42.0-255,66,238316,96,242998
17703,0.033232,104.244.42.0-255,66,238382,96,242998
17704,0.035106,172.217.194.0-255,2902,241284,96,242998
17705,0.035111,172.31.47.0-255,66,241350,96,242998
17706,0.035134,172.217.194.0-255,1411,242761,96,242998
17707,0.03527,172.31.47.0-255,66,242827,96,242998
17708,0.03529,172.31.47.0-255,105,242932,96,242998
17709,0.037592,172.217.194.0-255,66,242998,96,242998
17710,0.0,74.125.130.0-255,153,153,96,357494
17711,2.1e-05,172.31.47.0-255,66,219,96,357494
17712,3.6e-05,74.125.130.0-255,1484,1703,96,357494
17713,4.6e-05,172.31.47.0-255,66,1769,96,357494
17714,8.4e-05,74.125.130.0-255,2902,4671,96,357494
17715,8.6e-05,172.31.47.0-255,66,4737,96,357494
17716,8.9e-05,74.125.130.0-255,1484,6221,96,357494
17717,9.1e-05,172.31.47.0-255,66,6287,96,357494
17718,0.000125,74.125.130.0-255,2902,9189,96,357494
17719,0.000127,172.31.47.0-255,66,9255,96,357494
17720,0.000146,74.125.130.0-255,5019,14274,96,357494
17721,0.000148,172.31.47.0-255,66,14340,96,357494
17722,0.000194,74.125.130.0-255,2902,17242,96,357494
17723,0.000197,172.31.47.0-255,66,17308,96,357494
17724,0.00022,74.125.130.0-255,4320,21628,96,357494
17725,0.000222,172.31.47.0-255,66,21694,96,357494
17726,0.000272,172.31.47.0-255,66,21760,96,357494
17727,0.000275,74.125.130.0-255,1125,22885,96,357494
17728,0.000277,172.31.47.0-255,66,22951,96,357494
17729,0.000415,74.125.130.0-255,1484,24435,96,357494
17730,0.00042,172.31.47.0-255,66,24501,96,357494
17731,0.000449,74.125.130.0-255,2902,27403,96,357494
17732,0.000453,172.31.47.0-255,66,27469,96,357494
17733,0.000457,74.125.130.0-255,2902,30371,96,357494
17734,0.000459,172.31.47.0-255,66,30437,96,357494
17735,0.000514,74.125.130.0-255,7156,37593,96,357494
17736,0.000517,172.31.47.0-255,66,37659,96,357494
17737,0.000521,74.125.130.0-255,2543,40202,96,357494
17738,0.000523,172.31.47.0-255,66,40268,96,357494
17739,0.0006,74.125.130.0-255,1484,41752,96,357494
17740,0.000605,172.31.47.0-255,66,41818,96,357494
17741,0.000633,74.125.130.0-255,2902,44720,96,357494
17742,0.000637,172.31.47.0-255,66,44786,96,357494
17743,0.000659,74.125.130.0-255,5738,50524,96,357494
17744,0.000662,172.31.47.0-255,66,50590,96,357494
17745,0.000665,74.125.130.0-255,1484,52074,96,357494
17746,0.000691,74.125.130.0-255,2902,54976,96,357494
17747,0.000693,172.31.47.0-255,66,55042,96,357494
17748,0.000715,74.125.130.0-255,1484,56526,96,357494
17749,0.000736,74.125.130.0-255,1436,57962,96,357494
17750,0.000739,172.31.47.0-255,66,58028,96,357494
17751,0.000742,74.125.130.0-255,366,58394,96,357494
17752,0.000953,74.125.130.0-255,1484,59878,96,357494
17753,0.000959,172.31.47.0-255,66,59944,96,357494
17754,0.000964,74.125.130.0-255,1484,61428,96,357494
17755,0.000969,74.125.130.0-255,2902,64330,96,357494
17756,0.000979,172.31.47.0-255,66,64396,96,357494
17757,0.000984,74.125.130.0-255,2902,67298,96,357494
17758,0.000988,172.31.47.0-255,66,67364,96,357494
17759,0.001016,74.125.130.0-255,2902,70266,96,357494
17760,0.001019,172.31.47.0-255,66,70332,96,357494
17761,0.001033,74.125.130.0-255,6797,77129,96,357494
17762,0.001036,172.31.47.0-255,66,77195,96,357494
17763,0.001044,74.125.130.0-255,5738,82933,96,357494
17764,0.001046,172.31.47.0-255,66,82999,96,357494
17765,0.001085,74.125.130.0-255,1484,84483,96,357494
17766,0.001098,172.31.47.0-255,66,84549,96,357494
17767,0.00135,74.125.130.0-255,1484,86033,96,357494
17768,0.001358,74.125.130.0-255,2902,88935,96,357494
17769,0.001361,172.31.47.0-255,66,89001,96,357494
17770,0.001365,74.125.130.0-255,1484,90485,96,357494
17771,0.001393,74.125.130.0-255,2902,93387,96,357494
17772,0.001397,172.31.47.0-255,66,93453,96,357494
17773,0.001402,74.125.130.0-255,4320,97773,96,357494
17774,0.001404,172.31.47.0-255,66,97839,96,357494
17775,0.001423,74.125.130.0-255,1484,99323,96,357494
17776,0.001429,74.125.130.0-255,4320,103643,96,357494
17777,0.001435,172.31.47.0-255,66,103709,96,357494
17778,0.001461,74.125.130.0-255,5738,109447,96,357494
17779,0.001463,172.31.47.0-255,66,109513,96,357494
17780,0.001468,74.125.130.0-255,2902,112415,96,357494
17781,0.00147,172.31.47.0-255,66,112481,96,357494
17782,0.001502,74.125.130.0-255,6438,118919,96,357494
17783,0.001504,172.31.47.0-255,66,118985,96,357494
17784,0.002036,74.125.130.0-255,1484,120469,96,357494
17785,0.002041,74.125.130.0-255,2902,123371,96,357494
17786,0.002044,172.31.47.0-255,66,123437,96,357494
17787,0.002077,74.125.130.0-255,5738,129175,96,357494
17788,0.00208,172.31.47.0-255,66,129241,96,357494
17789,0.002083,74.125.130.0-255,2902,132143,96,357494
17790,0.002085,172.31.47.0-255,66,132209,96,357494
17791,0.002089,74.125.130.0-255,2902,135111,96,357494
17792,0.002091,172.31.47.0-255,66,135177,96,357494
17793,0.002111,74.125.130.0-255,1484,136661,96,357494
17794,0.002114,74.125.130.0-255,1484,138145,96,357494
17795,0.002116,172.31.47.0-255,66,138211,96,357494
17796,0.002144,74.125.130.0-255,7156,145367,96,357494
17797,0.002154,74.125.130.0-255,5738,151105,96,357494
17798,0.002158,172.31.47.0-255,66,151171,96,357494
17799,0.002161,172.31.47.0-255,66,151237,96,357494
17800,0.002185,74.125.130.0-255,2184,153421,96,357494
17801,0.002192,172.31.47.0-255,66,153487,96,357494
17802,0.002236,74.125.130.0-255,1484,154971,96,357494
17803,0.002241,74.125.130.0-255,2902,157873,96,357494
17804,0.002243,172.31.47.0-255,66,157939,96,357494
17805,0.002275,74.125.130.0-255,5738,163677,96,357494
17806,0.002279,172.31.47.0-255,66,163743,96,357494
17807,0.002283,74.125.130.0-255,4320,168063,96,357494
17808,0.002285,172.31.47.0-255,66,168129,96,357494
17809,0.002311,74.125.130.0-255,5738,173867,96,357494
17810,0.002313,172.31.47.0-255,66,173933,96,357494
17811,0.002316,74.125.130.0-255,2902,176835,96,357494
17812,0.002318,172.31.47.0-255,66,176901,96,357494
17813,0.002354,74.125.130.0-255,7156,184057,96,357494
17814,0.002357,172.31.47.0-255,66,184123,96,357494
17815,0.004658,74.125.130.0-255,5738,189861,96,357494
17816,0.004663,172.31.47.0-255,66,189927,96,357494
17817,0.006963,74.125.130.0-255,5738,195665,96,357494
17818,0.006971,172.31.47.0-255,66,195731,96,357494
17819,0.009299,74.125.130.0-255,5738,201469,96,357494
17820,0.009306,172.31.47.0-255,66,201535,96,357494
17821,0.011653,74.125.130.0-255,5738,207273,96,357494
17822,0.011659,172.31.47.0-255,66,207339,96,357494
17823,0.013977,74.125.130.0-255,5738,213077,96,357494
17824,0.013983,172.31.47.0-255,66,213143,96,357494
17825,0.016297,74.125.130.0-255,5738,218881,96,357494
17826,0.016306,172.31.47.0-255,66,218947,96,357494
17827,0.018633,74.125.130.0-255,5738,224685,96,357494
17828,0.018641,172.31.47.0-255,66,224751,96,357494
17829,0.02095,74.125.130.0-255,5738,230489,96,357494
17830,0.020957,172.31.47.0-255,66,230555,96,357494
17831,0.023271,74.125.130.0-255,2902,233457,96,357494
17832,0.023278,172.31.47.0-255,66,233523,96,357494
17833,0.023324,74.125.130.0-255,2902,236425,96,357494
17834,0.023329,172.31.47.0-255,66,236491,96,357494
17835,0.025593,74.125.130.0-255,2902,239393,96,357494
17836,0.025599,172.31.47.0-255,66,239459,96,357494
17837,0.025629,74.125.130.0-255,2902,242361,96,357494
17838,0.025633,172.31.47.0-255,66,242427,96,357494
17839,0.027919,74.125.130.0-255,2902,245329,96,357494
17840,0.027926,172.31.47.0-255,66,245395,96,357494
17841,0.027957,74.125.130.0-255,2902,248297,96,357494
17842,0.02796,172.31.47.0-255,66,248363,96,357494
17843,0.030236,74.125.130.0-255,2902,251265,96,357494
17844,0.030241,172.31.47.0-255,66,251331,96,357494
17845,0.030277,74.125.130.0-255,2902,254233,96,357494
17846,0.03028,172.31.47.0-255,66,254299,96,357494
17847,0.031053,172.31.47.0-255,172,254471,96,357494
17848,0.03109,172.31.47.0-255,1109,255580,96,357494
17849,0.03116,172.31.47.0-255,1514,257094,96,357494
17850,0.031184,172.31.47.0-255,1302,258396,96,357494
17851,0.032558,74.125.130.0-255,2902,261298,96,357494
17852,0.032564,172.31.47.0-255,66,261364,96,357494
17853,0.032596,104.244.42.0-255,66,261430,96,357494
17854,0.032601,74.125.130.0-255,2902,264332,96,357494
17855,0.032603,172.31.47.0-255,66,264398,96,357494
17856,0.032638,104.244.42.0-255,66,264464,96,357494
17857,0.032739,104.244.42.0-255,66,264530,96,357494
17858,0.034868,74.125.130.0-255,2902,267432,96,357494
17859,0.034873,172.31.47.0-255,66,267498,96,357494
17860,0.034896,74.125.130.0-255,2902,270400,96,357494
17861,0.034899,172.31.47.0-255,66,270466,96,357494
17862,0.037183,74.125.130.0-255,2902,273368,96,357494
17863,0.037188,172.31.47.0-255,66,273434,96,357494
17864,0.037217,74.125.130.0-255,2902,276336,96,357494
17865,0.037219,172.31.47.0-255,66,276402,96,357494
17866,0.039493,74.125.130.0-255,2902,279304,96,357494
17867,0.039497,172.31.47.0-255,66,279370,96,357494
17868,0.039535,74.125.130.0-255,2902,282272,96,357494
17869,0.039538,172.31.47.0-255,66,282338,96,357494
17870,0.041801,74.125.130.0-255,1484,283822,96,357494
17871,0.041837,74.125.130.0-255,4320,288142,96,357494
17872,0.041843,172.31.47.0-255,66,288208,96,357494
17873,0.044157,74.125.130.0-255,5738,293946,96,357494
17874,0.044161,172.31.47.0-255,66,294012,96,357494
17875,0.046471,74.125.130.0-255,5738,299750,96,357494
17876,0.046475,172.31.47.0-255,66,299816,96,357494
17877,0.048782,74.125.130.0-255,1484,301300,96,357494
17878,0.048801,74.125.130.0-255,4320,305620,96,357494
17879,0.048805,172.31.47.0-255,66,305686,96,357494
17880,0.051105,74.125.130.0-255,4320,310006,96,357494
17881,0.05111,172.31.47.0-255,66,310072,96,357494
17882,0.051139,74.125.130.0-255,1484,311556,96,357494
17883,0.053418,74.125.130.0-255,4320,315876,96,357494
17884,0.053424,172.31.47.0-255,66,315942,96,357494
17885,0.055732,74.125.130.0-255,2902,318844,96,357494
17886,0.055737,172.31.47.0-255,66,318910,96,357494
17887,0.055763,74.125.130.0-255,2902,321812,96,357494
17888,0.055766,172.31.47.0-255,66,321878,96,357494
17889,0.058058,74.125.130.0-255,2902,324780,96,357494
17890,0.058063,172.31.47.0-255,66,324846,96,357494
17891,0.058092,74.125.130.0-255,2902,327748,96,357494
17892,0.058095,172.31.47.0-255,66,327814,96,357494
17893,0.060368,74.125.130.0-255,2902,330716,96,357494
17894,0.060373,172.31.47.0-255,66,330782,96,357494
17895,0.060402,74.125.130.0-255,2902,333684,96,357494
17896,0.060404,172.31.47.0-255,66,333750,96,357494
17897,0.062676,74.125.130.0-255,2902,336652,96,357494
17898,0.062681,172.31.47.0-255,66,336718,96,357494
17899,0.062713,74.125.130.0-255,2902,339620,96,357494
17900,0.062716,172.31.47.0-255,66,339686,96,357494
17901,0.064987,74.125.130.0-255,2902,342588,96,357494
17902,0.064992,172.31.47.0-255,66,342654,96,357494
17903,0.065022,74.125.130.0-255,2902,345556,96,357494
17904,0.065024,172.31.47.0-255,66,345622,96,357494
17905,0.067291,74.125.130.0-255,2902,348524,96,357494
17906,0.067296,172.31.47.0-255,66,348590,96,357494
17907,0.067333,74.125.130.0-255,2902,351492,96,357494
17908,0.067336,172.31.47.0-255,66,351558,96,357494
17909,0.069592,74.125.130.0-255,2902,354460,96,357494
17910,0.069597,172.31.47.0-255,66,354526,96,357494
17911,0.069638,74.125.130.0-255,2902,357428,96,357494
17912,0.06964,172.31.47.0-255,66,357494,96,357494
17913,0.0,172.217.194.0-255,298,298,96,314168
17914,2.4e-05,172.31.47.0-255,66,364,96,314168
17915,3e-05,172.217.194.0-255,1484,1848,96,314168
17916,3.3e-05,172.31.47.0-255,66,1914,96,314168
17917,3.9e-05,172.217.194.0-255,4320,6234,96,314168
17918,4.1e-05,172.31.47.0-255,66,6300,96,314168
17919,5.1e-05,172.31.47.0-255,66,6366,96,314168
17920,0.000101,172.31.47.0-255,66,6432,96,314168
17921,0.000104,172.217.194.0-255,2543,8975,96,314168
17922,0.000105,172.31.47.0-255,66,9041,96,314168
17923,0.000173,172.217.194.0-255,1484,10525,96,314168
17924,0.000176,172.31.47.0-255,66,10591,96,314168
17925,0.000179,172.217.194.0-255,1484,12075,96,314168
17926,0.00018,172.31.47.0-255,66,12141,96,314168
17927,0.000195,172.217.194.0-255,1484,13625,96,314168
17928,0.000197,172.31.47.0-255,66,13691,96,314168
17929,0.000203,172.217.194.0-255,5738,19429,96,314168
17930,0.000204,172.31.47.0-255,66,19495,96,314168
17931,0.000224,172.217.194.0-255,6797,26292,96,314168
17932,0.000226,172.31.47.0-255,66,26358,96,314168
17933,0.00026,172.31.47.0-255,66,26424,96,314168
17934,0.000273,172.217.194.0-255,2833,29257,96,314168
17935,0.000276,172.31.47.0-255,66,29323,96,314168
17936,0.000298,172.217.194.0-255,98,29421,96,314168
17937,0.000302,172.31.47.0-255,66,29487,96,314168
17938,0.000356,172.217.194.0-255,364,29851,96,314168
17939,0.000359,172.31.47.0-255,66,29917,96,314168
17940,0.000413,172.217.194.0-255,1484,31401,96,314168
17941,0.000417,172.31.47.0-255,66,31467,96,314168
17942,0.000422,172.217.194.0-255,4320,35787,96,314168
17943,0.000424,172.31.47.0-255,66,35853,96,314168
17944,0.000435,172.31.47.0-255,66,35919,96,314168
17945,0.000437,172.217.194.0-255,576,36495,96,314168
17946,0.000789,172.217.194.0-255,1484,37979,96,314168
17947,0.00079,172.31.47.0-255,66,38045,96,314168
17948,0.000792,172.217.194.0-255,1484,39529,96,314168
17949,0.000794,172.31.47.0-255,66,39595,96,314168
17950,0.000811,172.217.194.0-255,1484,41079,96,314168
17951,0.000817,172.217.194.0-255,5738,46817,96,314168
17952,0.000819,172.31.47.0-255,66,46883,96,314168
17953,0.000822,172.217.194.0-255,1484,48367,96,314168
17954,0.000856,172.31.47.0-255,66,48433,96,314168
17955,0.000893,172.31.47.0-255,66,48499,96,314168
17956,0.000911,172.217.194.0-255,2184,50683,96,314168
17957,0.000913,172.31.47.0-255,66,50749,96,314168
17958,0.001337,172.217.194.0-255,1484,52233,96,314168
17959,0.001346,172.217.194.0-255,2902,55135,96,314168
17960,0.00135,172.31.47.0-255,66,55201,96,314168
17961,0.001356,172.217.194.0-255,5738,60939,96,314168
17962,0.001357,172.31.47.0-255,66,61005,96,314168
17963,0.001377,172.217.194.0-255,7156,68161,96,314168
17964,0.001379,172.31.47.0-255,66,68227,96,314168
17965,0.001395,172.217.194.0-255,1484,69711,96,314168
17966,0.001422,172.217.194.0-255,1484,71195,96,314168
17967,0.001425,172.31.47.0-255,66,71261,96,314168
17968,0.001456,172.31.47.0-255,66,71327,96,314168
17969,0.001481,172.217.194.0-255,2902,74229,96,314168
17970,0.001485,172.31.47.0-255,66,74295,96,314168
17971,0.001529,172.31.47.0-255,66,74361,96,314168
17972,0.001536,172.31.47.0-255,66,74427,96,314168
17973,0.001539,172.217.194.0-255,1484,75911,96,314168
17974,0.001562,172.217.194.0-255,5020,80931,96,314168
17975,0.001564,172.31.47.0-255,66,80997,96,314168
17976,0.001703,172.217.194.0-255,1484,82481,96,314168
17977,0.00171,172.217.194.0-255,2902,85383,96,314168
17978,0.001714,172.31.47.0-255,66,85449,96,314168
17979,0.001719,172.217.194.0-255,2902,88351,96,314168
17980,0.001721,172.31.47.0-255,66,88417,96,314168
17981,0.001759,172.217.194.0-255,7156,95573,96,314168
17982,0.001764,172.31.47.0-255,66,95639,96,314168
17983,0.001786,172.217.194.0-255,5738,101377,96,314168
17984,0.00179,172.31.47.0-255,66,101443,96,314168
17985,0.001811,172.217.194.0-255,5738,107181,96,314168
17986,0.001814,172.31.47.0-255,66,107247,96,314168
17987,0.001834,172.217.194.0-255,5738,112985,96,314168
17988,0.001836,172.31.47.0-255,66,113051,96,314168
17989,0.001858,172.217.194.0-255,2184,115235,96,314168
17990,0.001861,172.31.47.0-255,66,115301,96,314168
17991,0.002047,172.217.194.0-255,1484,116785,96,314168
17992,0.002066,172.217.194.0-255,2902,119687,96,314168
17993,0.002069,172.31.47.0-255,66,119753,96,314168
17994,0.002075,172.217.194.0-255,5738,125491,96,314168
17995,0.002077,172.31.47.0-255,66,125557,96,314168
17996,0.002079,172.217.194.0-255,1484,127041,96,314168
17997,0.002096,172.217.194.0-255,2902,129943,96,314168
17998,0.002098,172.31.47.0-255,66,130009,96,314168
17999,0.002114,172.217.194.0-255,7156,137165,96,314168
18000,0.002116,172.31.47.0-255,66,137231,96,314168
18001,0.002141,172.217.194.0-255,4320,141551,96,314168
18002,0.002144,172.31.47.0-255,66,141617,96,314168
18003,0.002154,172.31.47.0-255,66,141683,96,314168
18004,0.004458,172.217.194.0-255,5738,147421,96,314168
18005,0.004465,172.31.47.0-255,66,147487,96,314168
18006,0.006799,172.217.194.0-255,5738,153225,96,314168
18007,0.006804,172.31.47.0-255,66,153291,96,314168
18008,0.009095,172.217.194.0-255,5738,159029,96,314168
18009,0.0091,172.31.47.0-255,66,159095,96,314168
18010,0.01143,172.217.194.0-255,5738,164833,96,314168
18011,0.011437,172.31.47.0-255,66,164899,96,314168
18012,0.013766,172.217.194.0-255,5738,170637,96,314168
18013,0.013775,172.31.47.0-255,66,170703,96,314168
18014,0.016109,172.217.194.0-255,5738,176441,96,314168
18015,0.016118,172.31.47.0-255,66,176507,96,314168
18016,0.018437,172.217.194.0-255,5738,182245,96,314168
18017,0.018445,172.31.47.0-255,66,182311,96,314168
18018,0.020777,172.217.194.0-255,5738,188049,96,314168
18019,0.020787,172.31.47.0-255,66,188115,96,314168
18020,0.023053,172.217.194.0-255,5738,193853,96,314168
18021,0.023058,172.31.47.0-255,66,193919,96,314168
18022,0.025405,172.217.194.0-255,5738,199657,96,314168
18023,0.025411,172.31.47.0-255,66,199723,96,314168
18024,0.026091,172.31.47.0-255,171,199894,96,314168
18025,0.026131,172.31.47.0-255,1133,201027,96,314168
18026,0.026206,172.31.47.0-255,1514,202541,96,314168
18027,0.026208,172.31.47.0-255,1514,204055,96,314168
18028,0.026213,172.31.47.0-255,1514,205569,96,314168
18029,0.026214,172.31.47.0-255,1059,206628,96,314168
18030,0.027609,104.244.42.0-255,66,206694,96,314168
18031,0.027701,104.244.42.0-255,66,206760,96,314168
18032,0.027715,172.217.194.0-255,5738,212498,96,314168
18033,0.02772,172.31.47.0-255,66,212564,96,314168
18034,0.027764,104.244.42.0-255,66,212630,96,314168
18035,0.027769,104.244.42.0-255,66,212696,96,314168
18036,0.029991,172.217.194.0-255,5738,218434,96,314168
18037,0.029997,172.31.47.0-255,66,218500,96,314168
18038,0.032294,172.217.194.0-255,5738,224238,96,314168
18039,0.032299,172.31.47.0-255,66,224304,96,314168
18040,0.034597,172.217.194.0-255,2902,227206,96,314168
18041,0.034602,172.31.47.0-255,66,227272,96,314168
18042,0.034628,172.217.194.0-255,2902,230174,96,314168
18043,0.034631,172.31.47.0-255,66,230240,96,314168
18044,0.036915,172.217.194.0-255,2902,233142,96,314168
18045,0.03692,172.31.47.0-255,66,233208,96,314168
18046,0.036951,172.217.194.0-255,2902,236110,96,314168
18047,0.036954,172.31.47.0-255,66,236176,96,314168
18048,0.03922,172.217.194.0-255,4320,240496,96,314168
18049,0.03924,172.31.47.0-255,66,240562,96,314168
18050,0.039254,172.217.194.0-255,1484,242046,96,314168
18051,0.041576,172.217.194.0-255,4320,246366,96,314168
18052,0.041581,172.31.47.0-255,66,246432,96,314168
18053,0.043864,172.217.194.0-255,2902,249334,96,314168
18054,0.043868,172.31.47.0-255,66,249400,96,314168
18055,0.043898,172.217.194.0-255,2902,252302,96,314168
18056,0.043901,172.31.47.0-255,66,252368,96,314168
18057,0.0462,172.217.194.0-255,5738,258106,96,314168
18058,0.046204,172.31.47.0-255,66,258172,96,314168
18059,0.048522,172.217.194.0-255,5738,263910,96,314168
18060,0.048526,172.31.47.0-255,66,263976,96,314168
18061,0.050877,172.217.194.0-255,5738,269714,96,314168
18062,0.050885,172.31.47.0-255,66,269780,96,314168
18063,0.053169,172.217.194.0-255,4320,274100,96,314168
18064,0.053175,172.31.47.0-255,66,274166,96,314168
18065,0.053206,172.217.194.0-255,1484,275650,96,314168
18066,0.055482,172.217.194.0-255,4320,279970,96,314168
18067,0.055486,172.31.47.0-255,66,280036,96,314168
18068,0.057799,172.217.194.0-255,4320,284356,96,314168
18069,0.057804,172.31.47.0-255,66,284422,96,314168
18070,0.057836,172.217.194.0-255,1484,285906,96,314168
18071,0.060103,172.217.194.0-255,1484,287390,96,314168
18072,0.060108,172.31.47.0-255,66,287456,96,314168
18073,0.060135,172.217.194.0-255,2902,290358,96,314168
18074,0.060138,172.31.47.0-255,66,290424,96,314168
18075,0.06239,172.217.194.0-255,2902,293326,96,314168
18076,0.062395,172.31.47.0-255,66,293392,96,314168
18077,0.062489,172.217.194.0-255,2902,296294,96,314168
18078,0.062495,172.31.47.0-255,66,296360,96,314168
18079,0.064719,172.217.194.0-255,2902,299262,96,314168
18080,0.064723,172.31.47.0-255,66,299328,96,314168
18081,0.064813,172.217.194.0-255,2902,302230,96,314168
18082,0.064817,172.31.47.0-255,66,302296,96,314168
18083,0.067015,172.217.194.0-255,2902,305198,96,314168
18084,0.067019,172.31.47.0-255,66,305264,96,314168
18085,0.067123,172.217.194.0-255,2902,308166,96,314168
18086,0.067127,172.31.47.0-255,66,308232,96,314168
18087,0.069333,172.217.194.0-255,2902,311134,96,314168
18088,0.069338,172.31.47.0-255,66,311200,96,314168
18089,0.069393,172.217.194.0-255,2902,314102,96,314168
18090,0.069396,172.31.47.0-255,66,314168,96,314168
18091,0.0,172.217.194.0-255,153,153,96,243234
18092,3.6e-05,172.31.47.0-255,66,219,96,243234
18093,4.3e-05,172.217.194.0-255,1484,1703,96,243234
18094,4.8e-05,172.31.47.0-255,66,1769,96,243234
18095,5.3e-05,172.217.194.0-255,2902,4671,96,243234
18096,5.6e-05,172.31.47.0-255,66,4737,96,243234
18097,6.4e-05,172.217.194.0-255,7156,11893,96,243234
18098,6.7e-05,172.31.47.0-255,66,11959,96,243234
18099,7.1e-05,172.217.194.0-255,2019,13978,96,243234
18100,7.4e-05,172.31.47.0-255,66,14044,96,243234
18101,7.8e-05,172.217.194.0-255,1484,15528,96,243234
18102,8e-05,172.31.47.0-255,66,15594,96,243234
18103,9.6e-05,172.217.194.0-255,1484,17078,96,243234
18104,9.9e-05,172.31.47.0-255,66,17144,96,243234
18105,0.000106,172.217.194.0-255,7156,24300,96,243234
18106,0.000108,172.31.47.0-255,66,24366,96,243234
18107,0.000115,172.217.194.0-255,5738,30104,96,243234
18108,0.000117,172.31.47.0-255,66,30170,96,243234
18109,0.000154,172.217.194.0-255,2543,32713,96,243234
18110,0.000157,172.31.47.0-255,66,32779,96,243234
18111,0.000161,172.217.194.0-255,2902,35681,96,243234
18112,0.000163,172.31.47.0-255,66,35747,96,243234
18113,0.000167,172.217.194.0-255,1484,37231,96,243234
18114,0.000169,172.31.47.0-255,66,37297,96,243234
18115,0.000198,172.217.194.0-255,5738,43035,96,243234
18116,0.0002,172.31.47.0-255,66,43101,96,243234
18117,0.000204,172.217.194.0-255,1484,44585,96,243234
18118,0.000206,172.31.47.0-255,66,44651,96,243234
18119,0.000223,172.217.194.0-255,3961,48612,96,243234
18120,0.000228,172.31.47.0-255,66,48678,96,243234
18121,0.000896,172.217.194.0-255,1484,50162,96,243234
18122,0.000902,172.31.47.0-255,66,50228,96,243234
18123,0.000911,172.217.194.0-255,2902,53130,96,243234
18124,0.000914,172.31.47.0-255,66,53196,96,243234
18125,0.000921,172.217.194.0-255,5738,58934,96,243234
18126,0.000923,172.31.47.0-255,66,59000,96,243234
18127,0.000964,172.217.194.0-255,4320,63320,96,243234
18128,0.000968,172.31.47.0-255,66,63386,96,243234
18129,0.000982,172.217.194.0-255,3123,66509,96,243234
18130,0.000985,172.31.47.0-255,66,66575,96,243234
18131,0.001291,172.217.194.0-255,1484,68059,96,243234
18132,0.0013,172.217.194.0-255,2902,70961,96,243234
18133,0.001304,172.31.47.0-255,66,71027,96,243234
18134,0.001311,172.217.194.0-255,5738,76765,96,243234
18135,0.001313,172.31.47.0-255,66,76831,96,243234
18136,0.001321,172.217.194.0-255,5738,82569,96,243234
18137,0.001323,172.31.47.0-255,66,82635,96,243234
18138,0.001361,172.217.194.0-255,2902,85537,96,243234
18139,0.001381,172.217.194.0-255,2184,87721,96,243234
18140,0.002153,172.217.194.0-255,1484,89205,96,243234
18141,0.002168,172.217.194.0-255,2902,92107,96,243234
18142,0.002171,172.217.194.0-255,1484,93591,96,243234
18143,0.00219,172.217.194.0-255,4320,97911,96,243234
18144,0.002223,172.217.194.0-255,4320,102231,96,243234
18145,0.002245,172.217.194.0-255,2902,105133,96,243234
18146,0.002272,172.217.194.0-255,1484,106617,96,243234
18147,0.002276,172.217.194.0-255,2184,108801,96,243234
18148,0.003364,172.217.194.0-255,1484,110285,96,243234
18149,0.003369,172.217.194.0-255,1484,111769,96,243234
18150,0.003389,172.217.194.0-255,1484,113253,96,243234
18151,0.003395,172.217.194.0-255,5738,118991,96,243234
18152,0.003419,172.217.194.0-255,1484,120475,96,243234
18153,0.003435,172.217.194.0-255,5738,126213,96,243234
18154,0.003449,172.217.194.0-255,1484,127697,96,243234
18155,0.003461,172.217.194.0-255,2902,130599,96,243234
18156,0.003475,172.217.194.0-255,1484,132083,96,243234
18157,0.003477,172.217.194.0-255,1484,133567,96,243234
18158,0.003486,172.217.194.0-255,1484,135051,96,243234
18159,0.003501,172.217.194.0-255,1484,136535,96,243234
18160,0.003514,172.217.194.0-255,1484,138019,96,243234
18161,0.00353,172.217.194.0-255,2902,140921,96,243234
18162,0.003549,172.217.194.0-255,2184,143105,96,243234
18163,0.003638,172.217.194.0-255,1484,144589,96,243234
18164,0.003645,172.217.194.0-255,1484,146073,96,243234
18165,0.003655,172.217.194.0-255,1484,147557,96,243234
18166,0.003682,172.217.194.0-255,1484,149041,96,243234
18167,0.003692,172.217.194.0-255,1484,150525,96,243234
18168,0.003708,172.217.194.0-255,2902,153427,96,243234
18169,0.003722,172.217.194.0-255,1484,154911,96,243234
18170,0.003744,172.217.194.0-255,5738,160649,96,243234
18171,0.003756,172.217.194.0-255,1484,162133,96,243234
18172,0.003803,172.217.194.0-255,5738,167871,96,243234
18173,0.003869,172.217.194.0-255,3602,171473,96,243234
18174,0.003875,172.217.194.0-255,5738,177211,96,243234
18175,0.003885,172.31.47.0-255,66,177277,96,243234
18176,0.003926,172.217.194.0-255,7156,184433,96,243234
18177,0.003929,172.31.47.0-255,66,184499,96,243234
18178,0.003932,172.217.194.0-255,6438,190937,96,243234
18179,0.003934,172.31.47.0-255,66,191003,96,243234
18180,0.003934,172.217.194.0-255,1484,192487,96,243234
18181,0.003937,172.217.194.0-255,2902,195389,96,243234
18182,0.003955,172.31.47.0-255,66,195455,96,243234
18183,0.003961,172.217.194.0-255,5738,201193,96,243234
18184,0.003979,172.31.47.0-255,66,201259,96,243234
18185,0.003996,172.31.47.0-255,66,201325,96,243234
18186,0.004001,172.31.47.0-255,66,201391,96,243234
18187,0.004016,172.31.47.0-255,66,201457,96,243234
18188,0.004046,172.217.194.0-255,1484,202941,96,243234
18189,0.00409,172.31.47.0-255,66,203007,96,243234
18190,0.004099,172.31.47.0-255,66,203073,96,243234
18191,0.004116,172.217.194.0-255,7156,210229,96,243234
18192,0.004117,172.31.47.0-255,66,210295,96,243234
18193,0.004122,172.31.47.0-255,66,210361,96,243234
18194,0.004131,172.217.194.0-255,2902,213263,96,243234
18195,0.004141,172.31.47.0-255,66,213329,96,243234
18196,0.004151,172.217.194.0-255,2902,216231,96,243234
18197,0.004158,172.31.47.0-255,66,216297,96,243234
18198,0.00417,172.217.194.0-255,7156,223453,96,243234
18199,0.004186,172.31.47.0-255,66,223519,96,243234
18200,0.004196,172.217.194.0-255,1484,225003,96,243234
18201,0.004203,172.217.194.0-255,7156,232159,96,243234
18202,0.004207,172.31.47.0-255,66,232225,96,243234
18203,0.004232,172.217.194.0-255,6209,238434,96,243234
18204,0.004235,172.217.194.0-255,97,238531,96,243234
18205,0.004237,172.31.47.0-255,66,238597,96,243234
18206,0.004267,172.217.194.0-255,105,238702,96,243234
18207,0.006831,172.31.47.0-255,66,238768,96,243234
18208,0.006857,172.31.47.0-255,105,238873,96,243234
18209,0.009124,172.217.194.0-255,66,238939,96,243234
18210,0.030024,172.31.47.0-255,172,239111,96,243234
18211,0.030051,172.31.47.0-255,1110,240221,96,243234
18212,0.030087,172.31.47.0-255,1514,241735,96,243234
18213,0.030088,172.31.47.0-255,1301,243036,96,243234
18214,0.031571,104.244.42.0-255,66,243102,96,243234
18215,0.031579,104.244.42.0-255,66,243168,96,243234
18216,0.031637,104.244.42.0-255,66,243234,96,243234
18217,0.0,172.217.194.0-255,146,146,96,305001
18218,3.2e-05,172.31.47.0-255,66,212,96,305001
18219,3.9e-05,172.217.194.0-255,1484,1696,96,305001
18220,4.4e-05,172.31.47.0-255,66,1762,96,305001
18221,5.6e-05,172.217.194.0-255,2902,4664,96,305001
18222,5.9e-05,172.31.47.0-255,66,4730,96,305001
18223,6.7e-05,172.217.194.0-255,7156,11886,96,305001
18224,7e-05,172.31.47.0-255,66,11952,96,305001
18225,7.6e-05,172.217.194.0-255,5738,17690,96,305001
18226,7.8e-05,172.31.47.0-255,66,17756,96,305001
18227,0.00011,172.217.194.0-255,2099,19855,96,305001
18228,0.000113,172.31.47.0-255,66,19921,96,305001
18229,0.000116,172.217.194.0-255,1484,21405,96,305001
18230,0.000118,172.31.47.0-255,66,21471,96,305001
18231,0.000163,172.31.47.0-255,66,21537,96,305001
18232,0.000196,172.217.194.0-255,1484,23021,96,305001
18233,0.000198,172.31.47.0-255,66,23087,96,305001
18234,0.000203,172.217.194.0-255,2902,25989,96,305001
18235,0.000205,172.31.47.0-255,66,26055,96,305001
18236,0.000235,172.217.194.0-255,5738,31793,96,305001
18237,0.000237,172.31.47.0-255,66,31859,96,305001
18238,0.00024,172.217.194.0-255,1484,33343,96,305001
18239,0.000242,172.31.47.0-255,66,33409,96,305001
18240,0.000246,172.217.194.0-255,2902,36311,96,305001
18241,0.000248,172.31.47.0-255,66,36377,96,305001
18242,0.000297,172.31.47.0-255,66,36443,96,305001
18243,0.000308,172.31.47.0-255,66,36509,96,305001
18244,0.000316,172.217.194.0-255,676,37185,96,305001
18245,0.000318,172.31.47.0-255,66,37251,96,305001
18246,0.000563,172.217.194.0-255,1484,38735,96,305001
18247,0.000567,172.31.47.0-255,66,38801,96,305001
18248,0.000573,172.217.194.0-255,2902,41703,96,305001
18249,0.000575,172.31.47.0-255,66,41769,96,305001
18250,0.000608,172.217.194.0-255,2902,44671,96,305001
18251,0.000611,172.31.47.0-255,66,44737,96,305001
18252,0.00064,172.217.194.0-255,2902,47639,96,305001
18253,0.000643,172.31.47.0-255,66,47705,96,305001
18254,0.000646,172.217.194.0-255,1484,49189,96,305001
18255,0.000654,172.31.47.0-255,66,49255,96,305001
18256,0.000657,172.31.47.0-255,66,49321,96,305001
18257,0.000669,172.31.47.0-255,66,49387,96,305001
18258,0.00095,172.217.194.0-255,1484,50871,96,305001
18259,0.000954,172.217.194.0-255,2902,53773,96,305001
18260,0.000954,172.31.47.0-255,66,53839,96,305001
18261,0.000958,172.31.47.0-255,66,53905,96,305001
18262,0.000993,172.217.194.0-255,5738,59643,96,305001
18263,0.000996,172.31.47.0-255,66,59709,96,305001
18264,0.001006,172.31.47.0-255,66,59775,96,305001
18265,0.001055,172.217.194.0-255,5738,65513,96,305001
18266,0.001058,172.31.47.0-255,66,65579,96,305001
18267,0.001091,172.31.47.0-255,66,65645,96,305001
18268,0.001791,172.217.194.0-255,1484,67129,96,305001
18269,0.001796,172.31.47.0-255,66,67195,96,305001
18270,0.001803,172.217.194.0-255,2902,70097,96,305001
18271,0.001805,172.31.47.0-255,66,70163,96,305001
18272,0.001815,172.217.194.0-255,5738,75901,96,305001
18273,0.001817,172.31.47.0-255,66,75967,96,305001
18274,0.001842,172.217.194.0-255,5738,81705,96,305001
18275,0.001847,172.31.47.0-255,66,81771,96,305001
18276,0.001877,172.217.194.0-255,7156,88927,96,305001
18277,0.001879,172.31.47.0-255,66,88993,96,305001
18278,0.001887,172.31.47.0-255,66,89059,96,305001
18279,0.001911,172.217.194.0-255,2184,91243,96,305001
18280,0.001912,172.31.47.0-255,66,91309,96,305001
18281,0.001935,172.217.194.0-255,2902,94211,96,305001
18282,0.001937,172.31.47.0-255,66,94277,96,305001
18283,0.001941,172.217.194.0-255,2902,97179,96,305001
18284,0.001942,172.31.47.0-255,66,97245,96,305001
18285,0.001961,172.217.194.0-255,4320,101565,96,305001
18286,0.001963,172.31.47.0-255,66,101631,96,305001
18287,0.001969,172.217.194.0-255,1484,103115,96,305001
18288,0.001994,172.31.47.0-255,66,103181,96,305001
18289,0.002032,172.217.194.0-255,2902,106083,96,305001
18290,0.002034,172.31.47.0-255,66,106149,96,305001
18291,0.002107,172.217.194.0-255,1484,107633,96,305001
18292,0.002118,172.217.194.0-255,2902,110535,96,305001
18293,0.002144,172.217.194.0-255,5738,116273,96,305001
18294,0.002162,172.217.194.0-255,5738,122011,96,305001
18295,0.002179,172.217.194.0-255,7156,129167,96,305001
18296,0.002181,172.217.194.0-255,1484,130651,96,305001
18297,0.002215,172.217.194.0-255,2902,133553,96,305001
18298,0.00224,172.217.194.0-255,6438,139991,96,305001
18299,0.002293,172.217.194.0-255,1484,141475,96,305001
18300,0.002303,172.217.194.0-255,2902,144377,96,305001
18301,0.002329,172.217.194.0-255,5738,150115,96,305001
18302,0.002332,172.217.194.0-255,1484,151599,96,305001
18303,0.002398,172.217.194.0-255,1484,153083,96,305001
18304,0.003843,172.31.47.0-255,66,153149,96,305001
18305,0.006165,172.217.194.0-255,5738,158887,96,305001
18306,0.006172,172.31.47.0-255,66,158953,96,305001
18307,0.008499,172.217.194.0-255,5738,164691,96,305001
18308,0.008508,172.31.47.0-255,66,164757,96,305001
18309,0.010827,172.217.194.0-255,5738,170495,96,305001
18310,0.010841,172.31.47.0-255,66,170561,96,305001
18311,0.013166,172.217.194.0-255,5738,176299,96,305001
18312,0.013175,172.31.47.0-255,66,176365,96,305001
18313,0.015489,172.217.194.0-255,5738,182103,96,305001
18314,0.0155,172.31.47.0-255,66,182169,96,305001
18315,0.017805,172.217.194.0-255,5738,187907,96,305001
18316,0.017813,172.31.47.0-255,66,187973,96,305001
18317,0.02013,172.217.194.0-255,5738,193711,96,305001
18318,0.02014,172.31.47.0-255,66,193777,96,305001
18319,0.022468,172.217.194.0-255,5738,199515,96,305001
18320,0.022477,172.31.47.0-255,66,199581,96,305001
18321,0.024842,172.217.194.0-255,5738,205319,96,305001
18322,0.024851,172.31.47.0-255,66,205385,96,305001
18323,0.027234,172.217.194.0-255,5738,211123,96,305001
18324,0.027246,172.31.47.0-255,66,211189,96,305001
18325,0.029499,172.31.47.0-255,172,211361,96,305001
18326,0.029528,172.31.47.0-255,1105,212466,96,305001
18327,0.029573,172.31.47.0-255,1514,213980,96,305001
18328,0.029575,172.31.47.0-255,1306,215286,96,305001
18329,0.029576,172.217.194.0-255,5738,221024,96,305001
18330,0.029581,172.31.47.0-255,66,221090,96,305001
18331,0.031045,104.244.42.0-255,66,221156,96,305001
18332,0.03108,104.244.42.0-255,66,221222,96,305001
18333,0.031137,104.244.42.0-255,66,221288,96,305001
18334,0.031893,172.217.194.0-255,4320,225608,96,305001
18335,0.031899,172.31.47.0-255,66,225674,96,305001
18336,0.031933,172.217.194.0-255,1484,227158,96,305001
18337,0.034253,172.217.194.0-255,4320,231478,96,305001
18338,0.034258,172.31.47.0-255,66,231544,96,305001
18339,0.036581,172.217.194.0-255,5738,237282,96,305001
18340,0.036586,172.31.47.0-255,66,237348,96,305001
18341,0.03891,172.217.194.0-255,2902,240250,96,305001
18342,0.038915,172.31.47.0-255,66,240316,96,305001
18343,0.038951,172.217.194.0-255,2902,243218,96,305001
18344,0.038954,172.31.47.0-255,66,243284,96,305001
18345,0.04124,172.217.194.0-255,1484,244768,96,305001
18346,0.041265,172.217.194.0-255,1484,246252,96,305001
18347,0.041269,172.31.47.0-255,66,246318,96,305001
18348,0.041297,172.217.194.0-255,2902,249220,96,305001
18349,0.041301,172.31.47.0-255,66,249286,96,305001
18350,0.043643,172.217.194.0-255,5738,255024,96,305001
18351,0.043654,172.31.47.0-255,66,255090,96,305001
18352,0.046001,172.217.194.0-255,5738,260828,96,305001
18353,0.046018,172.31.47.0-255,66,260894,96,305001
18354,0.048348,172.217.194.0-255,5738,266632,96,305001
18355,0.048358,172.31.47.0-255,66,266698,96,305001
18356,0.050668,172.217.194.0-255,5738,272436,96,305001
18357,0.050681,172.31.47.0-255,66,272502,96,305001
18358,0.053042,172.217.194.0-255,5738,278240,96,305001
18359,0.053053,172.31.47.0-255,66,278306,96,305001
18360,0.055403,172.217.194.0-255,5738,284044,96,305001
18361,0.055415,172.31.47.0-255,66,284110,96,305001
18362,0.057731,172.217.194.0-255,5738,289848,96,305001
18363,0.057742,172.31.47.0-255,66,289914,96,305001
18364,0.060071,172.217.194.0-255,1484,291398,96,305001
18365,0.06011,172.217.194.0-255,4320,295718,96,305001
18366,0.060119,172.31.47.0-255,66,295784,96,305001
18367,0.062443,172.217.194.0-255,5738,301522,96,305001
18368,0.062464,172.31.47.0-255,66,301588,96,305001
18369,0.0648,172.217.194.0-255,3176,304764,96,305001
18370,0.064815,172.31.47.0-255,66,304830,96,305001
18371,0.06512,172.31.47.0-255,105,304935,96,305001
18372,0.067404,172.217.194.0-255,66,305001,96,305001
18373,0.0,74.125.200.0-255,153,153,96,388742
18374,2.5e-05,172.31.47.0-255,66,219,96,388742
18375,3.1e-05,74.125.200.0-255,1484,1703,96,388742
18376,3.5e-05,172.31.47.0-255,66,1769,96,388742
18377,4e-05,74.125.200.0-255,2902,4671,96,388742
18378,4.2e-05,172.31.47.0-255,66,4737,96,388742
18379,7.6e-05,74.125.200.0-255,7156,11893,96,388742
18380,7.9e-05,172.31.47.0-255,66,11959,96,388742
18381,8.3e-05,74.125.200.0-255,2093,14052,96,388742
18382,8.6e-05,172.31.47.0-255,66,14118,96,388742
18383,0.000105,74.125.200.0-255,2902,17020,96,388742
18384,0.000108,172.31.47.0-255,66,17086,96,388742
18385,0.000145,172.31.47.0-255,66,17152,96,388742
18386,0.000152,74.125.200.0-255,5379,22531,96,388742
18387,0.000155,172.31.47.0-255,66,22597,96,388742
18388,0.000241,74.125.200.0-255,1484,24081,96,388742
18389,0.000245,172.31.47.0-255,66,24147,96,388742
18390,0.00025,74.125.200.0-255,2902,27049,96,388742
18391,0.000252,172.31.47.0-255,66,27115,96,388742
18392,0.000266,74.125.200.0-255,1484,28599,96,388742
18393,0.000269,172.31.47.0-255,66,28665,96,388742
18394,0.000285,74.125.200.0-255,4320,32985,96,388742
18395,0.00029,74.125.200.0-255,4320,37305,96,388742
18396,0.000291,172.31.47.0-255,66,37371,96,388742
18397,0.000294,172.31.47.0-255,66,37437,96,388742
18398,0.000318,74.125.200.0-255,2543,39980,96,388742
18399,0.000322,172.31.47.0-255,66,40046,96,388742
18400,0.000329,74.125.200.0-255,7156,47202,96,388742
18401,0.000332,172.31.47.0-255,66,47268,96,388742
18402,0.00035,74.125.200.0-255,1484,48752,96,388742
18403,0.000352,172.31.47.0-255,66,48818,96,388742
18404,0.000392,172.31.47.0-255,66,48884,96,388742
18405,0.000395,74.125.200.0-255,130,49014,96,388742
18406,0.000538,74.125.200.0-255,1484,50498,96,388742
18407,0.000543,172.31.47.0-255,66,50564,96,388742
18408,0.000548,74.125.200.0-255,2902,53466,96,388742
18409,0.00055,172.31.47.0-255,66,53532,96,388742
18410,0.000557,74.125.200.0-255,5738,59270,96,388742
18411,0.000559,172.31.47.0-255,66,59336,96,388742
18412,0.000581,74.125.200.0-255,1484,60820,96,388742
18413,0.000608,74.125.200.0-255,6797,67617,96,388742
18414,0.000612,172.31.47.0-255,66,67683,96,388742
18415,0.000624,172.31.47.0-255,66,67749,96,388742
18416,0.000655,74.125.200.0-255,4320,72069,96,388742
18417,0.000658,172.31.47.0-255,66,72135,96,388742
18418,0.000681,74.125.200.0-255,2543,74678,96,388742
18419,0.000683,172.31.47.0-255,66,74744,96,388742
18420,0.000775,74.125.200.0-255,348,75092,96,388742
18421,0.000936,74.125.200.0-255,1484,76576,96,388742
18422,0.00094,172.31.47.0-255,66,76642,96,388742
18423,0.000946,74.125.200.0-255,2902,79544,96,388742
18424,0.000948,172.31.47.0-255,66,79610,96,388742
18425,0.000965,74.125.200.0-255,5738,85348,96,388742
18426,0.000968,172.31.47.0-255,66,85414,96,388742
18427,0.000971,74.125.200.0-255,1484,86898,96,388742
18428,0.000991,74.125.200.0-255,2902,89800,96,388742
18429,0.000994,172.31.47.0-255,66,89866,96,388742
18430,0.001032,74.125.200.0-255,5738,95604,96,388742
18431,0.001035,172.31.47.0-255,66,95670,96,388742
18432,0.001042,74.125.200.0-255,5738,101408,96,388742
18433,0.001044,172.31.47.0-255,66,101474,96,388742
18434,0.001058,74.125.200.0-255,1484,102958,96,388742
18435,0.001071,74.125.200.0-255,1484,104442,96,388742
18436,0.001074,172.31.47.0-255,66,104508,96,388742
18437,0.00109,74.125.200.0-255,5020,109528,96,388742
18438,0.001092,172.31.47.0-255,66,109594,96,388742
18439,0.001343,74.125.200.0-255,1484,111078,96,388742
18440,0.001362,74.125.200.0-255,2902,113980,96,388742
18441,0.001367,172.31.47.0-255,66,114046,96,388742
18442,0.001375,74.125.200.0-255,4320,118366,96,388742
18443,0.001377,172.31.47.0-255,66,118432,96,388742
18444,0.001394,74.125.200.0-255,1484,119916,96,388742
18445,0.001399,74.125.200.0-255,2902,122818,96,388742
18446,0.001401,172.31.47.0-255,66,122884,96,388742
18447,0.001422,74.125.200.0-255,4320,127204,96,388742
18448,0.001424,172.31.47.0-255,66,127270,96,388742
18449,0.001429,74.125.200.0-255,4320,131590,96,388742
18450,0.001431,172.31.47.0-255,66,131656,96,388742
18451,0.001451,74.125.200.0-255,7156,138812,96,388742
18452,0.001453,172.31.47.0-255,66,138878,96,388742
18453,0.001474,74.125.200.0-255,2902,141780,96,388742
18454,0.001476,172.31.47.0-255,66,141846,96,388742
18455,0.001488,74.125.200.0-255,2184,144030,96,388742
18456,0.00149,172.31.47.0-255,66,144096,96,388742
18457,0.001673,74.125.200.0-255,1484,145580,96,388742
18458,0.001697,74.125.200.0-255,2902,148482,96,388742
18459,0.001701,172.31.47.0-255,66,148548,96,388742
18460,0.001707,74.125.200.0-255,5738,154286,96,388742
18461,0.001709,172.31.47.0-255,66,154352,96,388742
18462,0.001739,74.125.200.0-255,4320,158672,96,388742
18463,0.001742,172.31.47.0-255,66,158738,96,388742
18464,0.001763,74.125.200.0-255,5738,164476,96,388742
18465,0.001765,172.31.47.0-255,66,164542,96,388742
18466,0.001795,172.31.47.0-255,66,164608,96,388742
18467,0.0018,74.125.200.0-255,2184,166792,96,388742
18468,0.001801,172.31.47.0-255,66,166858,96,388742
18469,0.001839,74.125.200.0-255,1484,168342,96,388742
18470,0.001853,74.125.200.0-255,2902,171244,96,388742
18471,0.001856,172.31.47.0-255,66,171310,96,388742
18472,0.001873,74.125.200.0-255,2902,174212,96,388742
18473,0.001875,172.31.47.0-255,66,174278,96,388742
18474,0.001891,74.125.200.0-255,2902,177180,96,388742
18475,0.001893,172.31.47.0-255,66,177246,96,388742
18476,0.001897,74.125.200.0-255,4320,181566,96,388742
18477,0.001899,172.31.47.0-255,66,181632,96,388742
18478,0.001905,74.125.200.0-255,5738,187370,96,388742
18479,0.001907,172.31.47.0-255,66,187436,96,388742
18480,0.001933,74.125.200.0-255,7156,194592,96,388742
18481,0.001935,172.31.47.0-255,66,194658,96,388742
18482,0.001949,74.125.200.0-255,4320,198978,96,388742
18483,0.001951,172.31.47.0-255,66,199044,96,388742
18484,0.001954,74.125.200.0-255,2184,201228,96,388742
18485,0.001956,172.31.47.0-255,66,201294,96,388742
18486,0.002059,74.125.200.0-255,1484,202778,96,388742
18487,0.002074,74.125.200.0-255,2902,205680,96,388742
18488,0.002078,172.31.47.0-255,66,205746,96,388742
18489,0.002082,74.125.200.0-255,2902,208648,96,388742
18490,0.002084,172.31.47.0-255,66,208714,96,388742
18491,0.002097,74.125.200.0-255,1484,210198,96,388742
18492,0.00211,74.125.200.0-255,2902,213100,96,388742
18493,0.002113,172.31.47.0-255,66,213166,96,388742
18494,0.002132,74.125.200.0-255,2902,216068,96,388742
18495,0.002135,172.31.47.0-255,66,216134,96,388742
18496,0.002163,74.125.200.0-255,5738,221872,96,388742
18497,0.002166,172.31.47.0-255,66,221938,96,388742
18498,0.00217,74.125.200.0-255,2902,224840,96,388742
18499,0.002173,172.31.47.0-255,66,224906,96,388742
18500,0.002174,74.125.200.0-255,4320,229226,96,388742
18501,0.002187,172.31.47.0-255,66,229292,96,388742
18502,0.002194,74.125.200.0-255,4320,233612,96,388742
18503,0.002205,172.31.47.0-255,66,233678,96,388742
18504,0.002209,74.125.200.0-255,2184,235862,96,388742
18505,0.002218,172.31.47.0-255,66,235928,96,388742
18506,0.004445,74.125.200.0-255,5738,241666,96,388742
18507,0.00445,172.31.47.0-255,66,241732,96,388742
18508,0.006704,74.125.200.0-255,4320,246052,96,388742
18509,0.006708,172.31.47.0-255,66,246118,96,388742
18510,0.006731,74.125.200.0-255,1484,247602,96,388742
18511,0.008949,74.125.200.0-255,4320,251922,96,388742
18512,0.008954,172.31.47.0-255,66,251988,96,388742
18513,0.011198,74.125.200.0-255,5738,257726,96,388742
18514,0.011204,172.31.47.0-255,66,257792,96,388742
18515,0.013444,74.125.200.0-255,5738,263530,96,388742
18516,0.01345,172.31.47.0-255,66,263596,96,388742
18517,0.015694,74.125.200.0-255,5738,269334,96,388742
18518,0.0157,172.31.47.0-255,66,269400,96,388742
18519,0.017943,74.125.200.0-255,5738,275138,96,388742
18520,0.017953,172.31.47.0-255,66,275204,96,388742
18521,0.020203,74.125.200.0-255,5738,280942,96,388742
18522,0.020217,172.31.47.0-255,66,281008,96,388742
18523,0.022463,74.125.200.0-255,5738,286746,96,388742
18524,0.022471,172.31.47.0-255,66,286812,96,388742
18525,0.024711,74.125.200.0-255,5738,292550,96,388742
18526,0.024716,172.31.47.0-255,66,292616,96,388742
18527,0.02505,172.31.47.0-255,172,292788,96,388742
18528,0.025078,172.31.47.0-255,1105,293893,96,388742
18529,0.025107,172.31.47.0-255,1514,295407,96,388742
18530,0.025108,172.31.47.0-255,1306,296713,96,388742
18531,0.026569,104.244.42.0-255,66,296779,96,388742
18532,0.0266,104.244.42.0-255,66,296845,96,388742
18533,0.026633,104.244.42.0-255,66,296911,96,388742
18534,0.026951,74.125.200.0-255,5738,302649,96,388742
18535,0.026955,172.31.47.0-255,66,302715,96,388742
18536,0.029196,74.125.200.0-255,4320,307035,96,388742
18537,0.0292,172.31.47.0-255,66,307101,96,388742
18538,0.029226,74.125.200.0-255,1484,308585,96,388742
18539,0.031456,74.125.200.0-255,4320,312905,96,388742
18540,0.031461,172.31.47.0-255,66,312971,96,388742
18541,0.033704,74.125.200.0-255,4320,317291,96,388742
18542,0.03371,172.31.47.0-255,66,317357,96,388742
18543,0.033736,74.125.200.0-255,1484,318841,96,388742
18544,0.035947,74.125.200.0-255,4320,323161,96,388742
18545,0.035957,172.31.47.0-255,66,323227,96,388742
18546,0.03819,74.125.200.0-255,5738,328965,96,388742
18547,0.038195,172.31.47.0-255,66,329031,96,388742
18548,0.040442,74.125.200.0-255,5738,334769,96,388742
18549,0.040448,172.31.47.0-255,66,334835,96,388742
18550,0.042692,74.125.200.0-255,2902,337737,96,388742
18551,0.042696,172.31.47.0-255,66,337803,96,388742
18552,0.042726,74.125.200.0-255,2902,340705,96,388742
18553,0.042728,172.31.47.0-255,66,340771,96,388742
18554,0.044926,74.125.200.0-255,2902,343673,96,388742
18555,0.044931,172.31.47.0-255,66,343739,96,388742
18556,0.044964,74.125.200.0-255,2902,346641,96,388742
18557,0.044968,172.31.47.0-255,66,346707,96,388742
18558,0.047165,74.125.200.0-255,2902,349609,96,388742
18559,0.047171,172.31.47.0-255,66,349675,96,388742
18560,0.047205,74.125.200.0-255,2902,352577,96,388742
18561,0.047208,172.31.47.0-255,66,352643,96,388742
18562,0.049398,74.125.200.0-255,2902,355545,96,388742
18563,0.049403,172.31.47.0-255,66,355611,96,388742
18564,0.04944,74.125.200.0-255,2902,358513,96,388742
18565,0.049443,172.31.47.0-255,66,358579,96,388742
18566,0.051641,74.125.200.0-255,2902,361481,96,388742
18567,0.051646,172.31.47.0-255,66,361547,96,388742
18568,0.051685,74.125.200.0-255,2902,364449,96,388742
18569,0.051689,172.31.47.0-255,66,364515,96,388742
18570,0.053875,74.125.200.0-255,2902,367417,96,388742
18571,0.05388,172.31.47.0-255,66,367483,96,388742
18572,0.053938,74.125.200.0-255,2902,370385,96,388742
18573,0.053942,172.31.47.0-255,66,370451,96,388742
18574,0.05611,74.125.200.0-255,2902,373353,96,388742
18575,0.056115,172.31.47.0-255,66,373419,96,388742
18576,0.056172,74.125.200.0-255,2902,376321,96,388742
18577,0.056175,172.31.47.0-255,66,376387,96,388742
18578,0.058343,74.125.200.0-255,2902,379289,96,388742
18579,0.058347,172.31.47.0-255,66,379355,96,388742
18580,0.0584,74.125.200.0-255,2902,382257,96,388742
18581,0.058403,172.31.47.0-255,66,382323,96,388742
18582,0.060595,74.125.200.0-255,2902,385225,96,388742
18583,0.0606,172.31.47.0-255,66,385291,96,388742
18584,0.060629,74.125.200.0-255,2902,388193,96,388742
18585,0.060633,172.31.47.0-255,66,388259,96,388742
18586,0.062835,74.125.200.0-255,246,388505,96,388742
18587,0.062949,172.31.47.0-255,66,388571,96,388742
18588,0.062975,172.31.47.0-255,105,388676,96,388742
18589,0.065167,74.125.200.0-255,66,388742,96,388742
18590,0.0,74.125.68.0-255,153,153,96,356789
18591,2.8e-05,172.31.47.0-255,66,219,96,356789
18592,3.4e-05,74.125.68.0-255,1484,1703,96,356789
18593,3.9e-05,172.31.47.0-255,66,1769,96,356789
18594,4.1e-05,74.125.68.0-255,1484,3253,96,356789
18595,4.4e-05,172.31.47.0-255,66,3319,96,356789
18596,7.9e-05,74.125.68.0-255,1484,4803,96,356789
18597,8.2e-05,172.31.47.0-255,66,4869,96,356789
18598,8.5e-05,74.125.68.0-255,1484,6353,96,356789
18599,8.7e-05,172.31.47.0-255,66,6419,96,356789
18600,9.4e-05,74.125.68.0-255,2902,9321,96,356789
18601,0.000102,172.31.47.0-255,66,9387,96,356789
18602,0.000107,74.125.68.0-255,5030,14417,96,356789
18603,0.00011,172.31.47.0-255,66,14483,96,356789
18604,0.000195,74.125.68.0-255,1484,15967,96,356789
18605,0.000199,172.31.47.0-255,66,16033,96,356789
18606,0.000204,74.125.68.0-255,2902,18935,96,356789
18607,0.000207,172.31.47.0-255,66,19001,96,356789
18608,0.000232,74.125.68.0-255,4320,23321,96,356789
18609,0.000235,172.31.47.0-255,66,23387,96,356789
18610,0.000267,172.31.47.0-255,66,23453,96,356789
18611,0.000451,74.125.68.0-255,1484,24937,96,356789
18612,0.000454,172.31.47.0-255,66,25003,96,356789
18613,0.000458,74.125.68.0-255,1484,26487,96,356789
18614,0.000459,172.31.47.0-255,66,26553,96,356789
18615,0.000477,74.125.68.0-255,1484,28037,96,356789
18616,0.000479,172.31.47.0-255,66,28103,96,356789
18617,0.000489,74.125.68.0-255,5738,33841,96,356789
18618,0.000491,172.31.47.0-255,66,33907,96,356789
18619,0.000497,74.125.68.0-255,4320,38227,96,356789
18620,0.000499,172.31.47.0-255,66,38293,96,356789
18621,0.000518,74.125.68.0-255,1484,39777,96,356789
18622,0.000523,74.125.68.0-255,2902,42679,96,356789
18623,0.000525,172.31.47.0-255,66,42745,96,356789
18624,0.000547,74.125.68.0-255,3961,46706,96,356789
18625,0.00055,74.125.68.0-255,1484,48190,96,356789
18626,0.000552,172.31.47.0-255,66,48256,96,356789
18627,0.000574,74.125.68.0-255,7156,55412,96,356789
18628,0.000582,172.31.47.0-255,66,55478,96,356789
18629,0.000603,74.125.68.0-255,2543,58021,96,356789
18630,0.000616,172.31.47.0-255,66,58087,96,356789
18631,0.000876,74.125.68.0-255,647,58734,96,356789
18632,0.001048,74.125.68.0-255,1484,60218,96,356789
18633,0.001053,172.31.47.0-255,66,60284,96,356789
18634,0.001059,74.125.68.0-255,2902,63186,96,356789
18635,0.00106,172.31.47.0-255,66,63252,96,356789
18636,0.001087,74.125.68.0-255,5738,68990,96,356789
18637,0.00109,172.31.47.0-255,66,69056,96,356789
18638,0.001117,74.125.68.0-255,7156,76212,96,356789
18639,0.00112,74.125.68.0-255,1484,77696,96,356789
18640,0.00114,74.125.68.0-255,7156,84852,96,356789
18641,0.001157,74.125.68.0-255,2902,87754,96,356789
18642,0.001174,74.125.68.0-255,5020,92774,96,356789
18643,0.001314,74.125.68.0-255,1484,94258,96,356789
18644,0.00136,74.125.68.0-255,1484,95742,96,356789
18645,0.001371,74.125.68.0-255,1484,97226,96,356789
18646,0.001384,74.125.68.0-255,4320,101546,96,356789
18647,0.001387,74.125.68.0-255,1484,103030,96,356789
18648,0.001405,74.125.68.0-255,4320,107350,96,356789
18649,0.001412,74.125.68.0-255,7156,114506,96,356789
18650,0.001423,74.125.68.0-255,1484,115990,96,356789
18651,0.001433,74.125.68.0-255,1484,117474,96,356789
18652,0.001452,74.125.68.0-255,766,118240,96,356789
18653,0.001584,172.31.47.0-255,66,118306,96,356789
18654,0.001879,74.125.68.0-255,1484,119790,96,356789
18655,0.001886,74.125.68.0-255,2902,122692,96,356789
18656,0.00189,172.31.47.0-255,66,122758,96,356789
18657,0.001917,74.125.68.0-255,5738,128496,96,356789
18658,0.00193,172.31.47.0-255,66,128562,96,356789
18659,0.001955,74.125.68.0-255,1484,130046,96,356789
18660,0.001969,74.125.68.0-255,4320,134366,96,356789
18661,0.001972,172.31.47.0-255,66,134432,96,356789
18662,0.001984,74.125.68.0-255,1484,135916,96,356789
18663,0.001992,74.125.68.0-255,2902,138818,96,356789
18664,0.002006,172.31.47.0-255,66,138884,96,356789
18665,0.002008,74.125.68.0-255,4320,143204,96,356789
18666,0.002011,172.31.47.0-255,66,143270,96,356789
18667,0.002013,74.125.68.0-255,5738,149008,96,356789
18668,0.00203,172.31.47.0-255,66,149074,96,356789
18669,0.002042,74.125.68.0-255,2902,151976,96,356789
18670,0.002054,74.125.68.0-255,766,152742,96,356789
18671,0.002056,172.31.47.0-255,66,152808,96,356789
18672,0.002141,74.125.68.0-255,1484,154292,96,356789
18673,0.002144,172.31.47.0-255,66,154358,96,356789
18674,0.002164,74.125.68.0-255,1484,155842,96,356789
18675,0.002178,74.125.68.0-255,1484,157326,96,356789
18676,0.002183,74.125.68.0-255,2902,160228,96,356789
18677,0.002192,172.31.47.0-255,66,160294,96,356789
18678,0.002195,74.125.68.0-255,2902,163196,96,356789
18679,0.002198,74.125.68.0-255,2902,166098,96,356789
18680,0.002204,172.31.47.0-255,66,166164,96,356789
18681,0.002227,74.125.68.0-255,4320,170484,96,356789
18682,0.002232,74.125.68.0-255,2902,173386,96,356789
18683,0.002235,172.31.47.0-255,66,173452,96,356789
18684,0.002244,74.125.68.0-255,2902,176354,96,356789
18685,0.002257,172.31.47.0-255,66,176420,96,356789
18686,0.00228,74.125.68.0-255,1484,177904,96,356789
18687,0.002299,74.125.68.0-255,2902,180806,96,356789
18688,0.002303,74.125.68.0-255,2902,183708,96,356789
18689,0.002304,172.31.47.0-255,66,183774,96,356789
18690,0.002308,172.31.47.0-255,66,183840,96,356789
18691,0.002329,74.125.68.0-255,2902,186742,96,356789
18692,0.002335,172.31.47.0-255,66,186808,96,356789
18693,0.002338,74.125.68.0-255,766,187574,96,356789
18694,0.002586,74.125.68.0-255,1484,189058,96,356789
18695,0.00259,172.31.47.0-255,66,189124,96,356789
18696,0.002593,74.125.68.0-255,1484,190608,96,356789
18697,0.002597,74.125.68.0-255,2902,193510,96,356789
18698,0.002599,74.125.68.0-255,1484,194994,96,356789
18699,0.002607,172.31.47.0-255,66,195060,96,356789
18700,0.002623,74.125.68.0-255,4320,199380,96,356789
18701,0.002627,74.125.68.0-255,4320,203700,96,356789
18702,0.002629,172.31.47.0-255,66,203766,96,356789
18703,0.002634,172.31.47.0-255,66,203832,96,356789
18704,0.00264,74.125.68.0-255,4320,208152,96,356789
18705,0.002655,172.31.47.0-255,66,208218,96,356789
18706,0.005229,74.125.68.0-255,1484,209702,96,356789
18707,0.005251,74.125.68.0-255,4320,214022,96,356789
18708,0.005254,172.31.47.0-255,66,214088,96,356789
18709,0.007844,74.125.68.0-255,4320,218408,96,356789
18710,0.00785,172.31.47.0-255,66,218474,96,356789
18711,0.007872,74.125.68.0-255,1484,219958,96,356789
18712,0.010455,74.125.68.0-255,4320,224278,96,356789
18713,0.010461,172.31.47.0-255,66,224344,96,356789
18714,0.013072,74.125.68.0-255,5738,230082,96,356789
18715,0.013081,172.31.47.0-255,66,230148,96,356789
18716,0.015705,74.125.68.0-255,5738,235886,96,356789
18717,0.015715,172.31.47.0-255,66,235952,96,356789
18718,0.018343,74.125.68.0-255,5738,241690,96,356789
18719,0.018363,172.31.47.0-255,66,241756,96,356789
18720,0.021009,74.125.68.0-255,5738,247494,96,356789
18721,0.021026,172.31.47.0-255,66,247560,96,356789
18722,0.023645,74.125.68.0-255,5738,253298,96,356789
18723,0.023662,172.31.47.0-255,66,253364,96,356789
18724,0.02626,74.125.68.0-255,5738,259102,96,356789
18725,0.026266,172.31.47.0-255,66,259168,96,356789
18726,0.028897,74.125.68.0-255,5738,264906,96,356789
18727,0.028918,172.31.47.0-255,66,264972,96,356789
18728,0.03153,74.125.68.0-255,5738,270710,96,356789
18729,0.031537,172.31.47.0-255,66,270776,96,356789
18730,0.03415,74.125.68.0-255,5738,276514,96,356789
18731,0.034165,172.31.47.0-255,66,276580,96,356789
18732,0.036764,74.125.68.0-255,5738,282318,96,356789
18733,0.036771,172.31.47.0-255,66,282384,96,356789
18734,0.039397,74.125.68.0-255,5738,288122,96,356789
18735,0.039419,172.31.47.0-255,66,288188,96,356789
18736,0.039981,172.31.47.0-255,172,288360,96,356789
18737,0.04001,172.31.47.0-255,1101,289461,96,356789
18738,0.040056,172.31.47.0-255,1514,290975,96,356789
18739,0.040057,172.31.47.0-255,1310,292285,96,356789
18740,0.041556,104.244.42.0-255,66,292351,96,356789
18741,0.041565,104.244.42.0-255,66,292417,96,356789
18742,0.041638,104.244.42.0-255,66,292483,96,356789
18743,0.042028,74.125.68.0-255,5738,298221,96,356789
18744,0.042037,172.31.47.0-255,66,298287,96,356789
18745,0.044675,74.125.68.0-255,5738,304025,96,356789
18746,0.044696,172.31.47.0-255,66,304091,96,356789
18747,0.047325,74.125.68.0-255,5738,309829,96,356789
18748,0.047375,172.31.47.0-255,66,309895,96,356789
18749,0.050005,74.125.68.0-255,5738,315633,96,356789
18750,0.050019,172.31.47.0-255,66,315699,96,356789
18751,0.052619,74.125.68.0-255,5738,321437,96,356789
18752,0.052624,172.31.47.0-255,66,321503,96,356789
18753,0.055219,74.125.68.0-255,2902,324405,96,356789
18754,0.055224,172.31.47.0-255,66,324471,96,356789
18755,0.055251,74.125.68.0-255,2902,327373,96,356789
18756,0.055255,172.31.47.0-255,66,327439,96,356789
18757,0.057816,74.125.68.0-255,2902,330341,96,356789
18758,0.05782,172.31.47.0-255,66,330407,96,356789
18759,0.057847,74.125.68.0-255,2902,333309,96,356789
18760,0.05785,172.31.47.0-255,66,333375,96,356789
18761,0.060415,74.125.68.0-255,2902,336277,96,356789
18762,0.060419,172.31.47.0-255,66,336343,96,356789
18763,0.060484,74.125.68.0-255,2902,339245,96,356789
18764,0.060488,172.31.47.0-255,66,339311,96,356789
18765,0.063015,74.125.68.0-255,1484,340795,96,356789
18766,0.063097,74.125.68.0-255,4320,345115,96,356789
18767,0.063101,172.31.47.0-255,66,345181,96,356789
18768,0.065708,74.125.68.0-255,5738,350919,96,356789
18769,0.065714,172.31.47.0-255,66,350985,96,356789
18770,0.068314,74.125.68.0-255,5738,356723,96,356789
18771,0.06832,172.31.47.0-255,66,356789,96,356789
18772,0.0,172.31.47.0-255,105,105,96,276
18773,0.002444,157.240.13.0-255,105,210,96,276
18774,0.002453,172.31.47.0-255,66,276,96,276
18775,0.0,74.125.24.0-255,153,153,96,172210
18776,2.5e-05,172.31.47.0-255,66,219,96,172210
18777,3.2e-05,74.125.24.0-255,1484,1703,96,172210
18778,3.6e-05,172.31.47.0-255,66,1769,96,172210
18779,4.6e-05,74.125.24.0-255,2902,4671,96,172210
18780,4.9e-05,172.31.47.0-255,66,4737,96,172210
18781,5.5e-05,74.125.24.0-255,7156,11893,96,172210
18782,5.7e-05,172.31.47.0-255,66,11959,96,172210
18783,7.8e-05,74.125.24.0-255,2210,14169,96,172210
18784,8e-05,172.31.47.0-255,66,14235,96,172210
18785,0.000492,74.125.24.0-255,1484,15719,96,172210
18786,0.000497,172.31.47.0-255,66,15785,96,172210
18787,0.000523,74.125.24.0-255,2902,18687,96,172210
18788,0.000526,172.31.47.0-255,66,18753,96,172210
18789,0.000552,74.125.24.0-255,4320,23073,96,172210
18790,0.000555,172.31.47.0-255,66,23139,96,172210
18791,0.00061,74.125.24.0-255,4320,27459,96,172210
18792,0.000613,172.31.47.0-255,66,27525,96,172210
18793,0.000639,74.125.24.0-255,3961,31486,96,172210
18794,0.000642,172.31.47.0-255,66,31552,96,172210
18795,0.000664,74.125.24.0-255,5738,37290,96,172210
18796,0.000666,172.31.47.0-255,66,37356,96,172210
18797,0.000686,74.125.24.0-255,2902,40258,96,172210
18798,0.000688,172.31.47.0-255,66,40324,96,172210
18799,0.000692,74.125.24.0-255,2902,43226,96,172210
18800,0.000694,172.31.47.0-255,66,43292,96,172210
18801,0.000734,74.125.24.0-255,6797,50089,96,172210
18802,0.000738,172.31.47.0-255,66,50155,96,172210
18803,0.000747,172.31.47.0-255,66,50221,96,172210
18804,0.000757,74.125.24.0-255,5650,55871,96,172210
18805,0.000759,172.31.47.0-255,66,55937,96,172210
18806,0.000857,74.125.24.0-255,134,56071,96,172210
18807,0.001065,74.125.24.0-255,347,56418,96,172210
18808,0.0019,74.125.24.0-255,1484,57902,96,172210
18809,0.001903,172.31.47.0-255,66,57968,96,172210
18810,0.001907,74.125.24.0-255,2902,60870,96,172210
18811,0.001909,172.31.47.0-255,66,60936,96,172210
18812,0.001936,74.125.24.0-255,5738,66674,96,172210
18813,0.001938,172.31.47.0-255,66,66740,96,172210
18814,0.001961,74.125.24.0-255,1484,68224,96,172210
18815,0.001977,172.31.47.0-255,66,68290,96,172210
18816,0.001998,74.125.24.0-255,2902,71192,96,172210
18817,0.001999,172.31.47.0-255,66,71258,96,172210
18818,0.002028,172.31.47.0-255,66,71324,96,172210
18819,0.002242,74.125.24.0-255,1484,72808,96,172210
18820,0.002256,74.125.24.0-255,2902,75710,96,172210
18821,0.002258,172.31.47.0-255,66,75776,96,172210
18822,0.002261,74.125.24.0-255,1484,77260,96,172210
18823,0.002283,74.125.24.0-255,4320,81580,96,172210
18824,0.002285,172.31.47.0-255,66,81646,96,172210
18825,0.002294,172.31.47.0-255,66,81712,96,172210
18826,0.002296,74.125.24.0-255,1484,83196,96,172210
18827,0.002331,172.31.47.0-255,66,83262,96,172210
18828,0.002366,74.125.24.0-255,1484,84746,96,172210
18829,0.002388,172.31.47.0-255,66,84812,96,172210
18830,0.002413,74.125.24.0-255,2184,86996,96,172210
18831,0.002416,172.31.47.0-255,66,87062,96,172210
18832,0.002418,74.125.24.0-255,1484,88546,96,172210
18833,0.002484,172.31.47.0-255,66,88612,96,172210
18834,0.002505,74.125.24.0-255,6438,95050,96,172210
18835,0.002509,172.31.47.0-255,66,95116,96,172210
18836,0.002525,172.31.47.0-255,66,95182,96,172210
18837,0.00254,172.31.47.0-255,66,95248,96,172210
18838,0.002545,74.125.24.0-255,7156,102404,96,172210
18839,0.002548,172.31.47.0-255,66,102470,96,172210
18840,0.002592,74.125.24.0-255,4320,106790,96,172210
18841,0.002596,172.31.47.0-255,66,106856,96,172210
18842,0.002638,172.31.47.0-255,66,106922,96,172210
18843,0.002648,172.31.47.0-255,66,106988,96,172210
18844,0.002691,172.31.47.0-255,66,107054,96,172210
18845,0.002702,172.31.47.0-255,66,107120,96,172210
18846,0.002731,74.125.24.0-255,7156,114276,96,172210
18847,0.002735,172.31.47.0-255,66,114342,96,172210
18848,0.002743,74.125.24.0-255,4320,118662,96,172210
18849,0.002745,172.31.47.0-255,66,118728,96,172210
18850,0.00275,74.125.24.0-255,4320,123048,96,172210
18851,0.002753,172.31.47.0-255,66,123114,96,172210
18852,0.002772,172.31.47.0-255,66,123180,96,172210
18853,0.002775,74.125.24.0-255,1484,124664,96,172210
18854,0.002782,74.125.24.0-255,1484,126148,96,172210
18855,0.002784,172.31.47.0-255,66,126214,96,172210
18856,0.002788,74.125.24.0-255,2902,129116,96,172210
18857,0.00279,172.31.47.0-255,66,129182,96,172210
18858,0.002794,74.125.24.0-255,3602,132784,96,172210
18859,0.002797,172.31.47.0-255,66,132850,96,172210
18860,0.002906,74.125.24.0-255,1484,134334,96,172210
18861,0.002921,74.125.24.0-255,2902,137236,96,172210
18862,0.002924,172.31.47.0-255,66,137302,96,172210
18863,0.00293,74.125.24.0-255,4320,141622,96,172210
18864,0.002932,172.31.47.0-255,66,141688,96,172210
18865,0.002969,74.125.24.0-255,1484,143172,96,172210
18866,0.002981,172.31.47.0-255,66,143238,96,172210
18867,0.002984,74.125.24.0-255,1484,144722,96,172210
18868,0.002986,74.125.24.0-255,1484,146206,96,172210
18869,0.002988,172.31.47.0-255,66,146272,96,172210
18870,0.002993,74.125.24.0-255,4320,150592,96,172210
18871,0.002997,172.31.47.0-255,66,150658,96,172210
18872,0.003021,74.125.24.0-255,5738,156396,96,172210
18873,0.003028,172.31.47.0-255,66,156462,96,172210
18874,0.003038,172.31.47.0-255,66,156528,96,172210
18875,0.003048,172.31.47.0-255,66,156594,96,172210
18876,0.003115,74.125.24.0-255,1484,158078,96,172210
18877,0.003118,172.31.47.0-255,66,158144,96,172210
18878,0.003148,172.31.47.0-255,66,158210,96,172210
18879,0.003181,74.125.24.0-255,7156,165366,96,172210
18880,0.003184,172.31.47.0-255,66,165432,96,172210
18881,0.003195,172.31.47.0-255,66,165498,96,172210
18882,0.003211,172.31.47.0-255,66,165564,96,172210
18883,0.003214,74.125.24.0-255,105,165669,96,172210
18884,0.003943,172.31.47.0-255,101,165770,96,172210
18885,0.00549,172.31.47.0-255,105,165875,96,172210
18886,0.006113,74.125.24.0-255,66,165941,96,172210
18887,0.007688,74.125.24.0-255,66,166007,96,172210
18888,0.018427,172.31.47.0-255,172,166179,96,172210
18889,0.018457,172.31.47.0-255,1109,167288,96,172210
18890,0.018491,172.31.47.0-255,1514,168802,96,172210
18891,0.018493,172.31.47.0-255,1514,170316,96,172210
18892,0.018494,172.31.47.0-255,1514,171830,96,172210
18893,0.018495,172.31.47.0-255,116,171946,96,172210
18894,0.019956,104.244.42.0-255,66,172012,96,172210
18895,0.020014,104.244.42.0-255,66,172078,96,172210
18896,0.020059,104.244.42.0-255,66,172144,96,172210
18897,0.020061,104.244.42.0-255,66,172210,96,172210
18898,0.0,74.125.24.0-255,300,300,96,286439
18899,2.4e-05,172.31.47.0-255,66,366,96,286439
18900,3.1e-05,74.125.24.0-255,1484,1850,96,286439
18901,3.5e-05,172.31.47.0-255,66,1916,96,286439
18902,4.9e-05,74.125.24.0-255,4320,6236,96,286439
18903,5.2e-05,172.31.47.0-255,66,6302,96,286439
18904,5.8e-05,74.125.24.0-255,5738,12040,96,286439
18905,6.1e-05,172.31.47.0-255,66,12106,96,286439
18906,8.2e-05,74.125.24.0-255,1868,13974,96,286439
18907,8.4e-05,172.31.47.0-255,66,14040,96,286439
18908,0.000121,74.125.24.0-255,1484,15524,96,286439
18909,0.000123,172.31.47.0-255,66,15590,96,286439
18910,0.000141,74.125.24.0-255,2902,18492,96,286439
18911,0.000143,172.31.47.0-255,66,18558,96,286439
18912,0.000169,74.125.24.0-255,5738,24296,96,286439
18913,0.000171,172.31.47.0-255,66,24362,96,286439
18914,0.000197,74.125.24.0-255,5738,30100,96,286439
18915,0.000199,172.31.47.0-255,66,30166,96,286439
18916,0.000226,74.125.24.0-255,1125,31291,96,286439
18917,0.000228,172.31.47.0-255,66,31357,96,286439
18918,0.000235,74.125.24.0-255,7156,38513,96,286439
18919,0.000237,172.31.47.0-255,66,38579,96,286439
18920,0.000252,172.31.47.0-255,66,38645,96,286439
18921,0.000315,74.125.24.0-255,1484,40129,96,286439
18922,0.000318,172.31.47.0-255,66,40195,96,286439
18923,0.000323,74.125.24.0-255,2902,43097,96,286439
18924,0.000325,172.31.47.0-255,66,43163,96,286439
18925,0.000328,74.125.24.0-255,1484,44647,96,286439
18926,0.000329,172.31.47.0-255,66,44713,96,286439
18927,0.000361,74.125.24.0-255,4320,49033,96,286439
18928,0.000363,172.31.47.0-255,66,49099,96,286439
18929,0.000386,74.125.24.0-255,2902,52001,96,286439
18930,0.000388,172.31.47.0-255,66,52067,96,286439
18931,0.000411,74.125.24.0-255,3961,56028,96,286439
18932,0.000413,172.31.47.0-255,66,56094,96,286439
18933,0.000416,74.125.24.0-255,366,56460,96,286439
18934,0.000594,74.125.24.0-255,129,56589,96,286439
18935,0.001004,74.125.24.0-255,1484,58073,96,286439
18936,0.001009,172.31.47.0-255,66,58139,96,286439
18937,0.001016,74.125.24.0-255,2902,61041,96,286439
18938,0.001018,172.31.47.0-255,66,61107,96,286439
18939,0.001024,74.125.24.0-255,5738,66845,96,286439
18940,0.00103,172.31.47.0-255,66,66911,96,286439
18941,0.001063,172.31.47.0-255,66,66977,96,286439
18942,0.001091,74.125.24.0-255,7156,74133,96,286439
18943,0.001093,172.31.47.0-255,66,74199,96,286439
18944,0.001122,74.125.24.0-255,2902,77101,96,286439
18945,0.001124,172.31.47.0-255,66,77167,96,286439
18946,0.00113,74.125.24.0-255,4219,81386,96,286439
18947,0.001132,172.31.47.0-255,66,81452,96,286439
18948,0.001213,74.125.24.0-255,1484,82936,96,286439
18949,0.001217,74.125.24.0-255,1484,84420,96,286439
18950,0.00122,172.31.47.0-255,66,84486,96,286439
18951,0.001244,74.125.24.0-255,1484,85970,96,286439
18952,0.001251,74.125.24.0-255,5738,91708,96,286439
18953,0.001253,172.31.47.0-255,66,91774,96,286439
18954,0.001257,74.125.24.0-255,2902,94676,96,286439
18955,0.001259,172.31.47.0-255,66,94742,96,286439
18956,0.001284,74.125.24.0-255,5738,100480,96,286439
18957,0.001286,172.31.47.0-255,66,100546,96,286439
18958,0.001297,172.31.47.0-255,66,100612,96,286439
18959,0.001301,74.125.24.0-255,2902,103514,96,286439
18960,0.001304,172.31.47.0-255,66,103580,96,286439
18961,0.001331,74.125.24.0-255,2184,105764,96,286439
18962,0.001334,172.31.47.0-255,66,105830,96,286439
18963,0.001758,74.125.24.0-255,1484,107314,96,286439
18964,0.001773,74.125.24.0-255,2902,110216,96,286439
18965,0.001777,172.31.47.0-255,66,110282,96,286439
18966,0.001782,74.125.24.0-255,2902,113184,96,286439
18967,0.001784,172.31.47.0-255,66,113250,96,286439
18968,0.001803,74.125.24.0-255,2902,116152,96,286439
18969,0.001806,172.31.47.0-255,66,116218,96,286439
18970,0.001817,172.31.47.0-255,66,116284,96,286439
18971,0.001838,74.125.24.0-255,1484,117768,96,286439
18972,0.001899,74.125.24.0-255,5738,123506,96,286439
18973,0.001902,172.31.47.0-255,66,123572,96,286439
18974,0.00193,74.125.24.0-255,5020,128592,96,286439
18975,0.001932,172.31.47.0-255,66,128658,96,286439
18976,0.001944,172.31.47.0-255,66,128724,96,286439
18977,0.001961,172.31.47.0-255,66,128790,96,286439
18978,0.001993,74.125.24.0-255,6438,135228,96,286439
18979,0.001995,172.31.47.0-255,66,135294,96,286439
18980,0.002037,74.125.24.0-255,1484,136778,96,286439
18981,0.002053,74.125.24.0-255,2902,139680,96,286439
18982,0.002055,172.31.47.0-255,66,139746,96,286439
18983,0.002082,74.125.24.0-255,5738,145484,96,286439
18984,0.002084,172.31.47.0-255,66,145550,96,286439
18985,0.002088,74.125.24.0-255,2902,148452,96,286439
18986,0.002089,172.31.47.0-255,66,148518,96,286439
18987,0.002092,74.125.24.0-255,1484,150002,96,286439
18988,0.002117,172.31.47.0-255,66,150068,96,286439
18989,0.002143,172.31.47.0-255,66,150134,96,286439
18990,0.002182,74.125.24.0-255,1484,151618,96,286439
18991,0.002199,74.125.24.0-255,2902,154520,96,286439
18992,0.002203,172.31.47.0-255,66,154586,96,286439
18993,0.002208,74.125.24.0-255,4320,158906,96,286439
18994,0.00221,172.31.47.0-255,66,158972,96,286439
18995,0.002225,74.125.24.0-255,1484,160456,96,286439
18996,0.002245,172.31.47.0-255,66,160522,96,286439
18997,0.002268,74.125.24.0-255,2902,163424,96,286439
18998,0.002273,172.31.47.0-255,66,163490,96,286439
18999,0.002294,74.125.24.0-255,2902,166392,96,286439
19000,0.002297,172.31.47.0-255,66,166458,96,286439
19001,0.002328,172.31.47.0-255,66,166524,96,286439
19002,0.002351,74.125.24.0-255,1484,168008,96,286439
19003,0.002364,74.125.24.0-255,2902,170910,96,286439
19004,0.002367,172.31.47.0-255,66,170976,96,286439
19005,0.00237,74.125.24.0-255,1484,172460,96,286439
19006,0.002388,74.125.24.0-255,4320,176780,96,286439
19007,0.00239,172.31.47.0-255,66,176846,96,286439
19008,0.002396,74.125.24.0-255,5738,182584,96,286439
19009,0.002398,172.31.47.0-255,66,182650,96,286439
19010,0.002446,172.31.47.0-255,66,182716,96,286439
19011,0.002452,74.125.24.0-255,5020,187736,96,286439
19012,0.002454,172.31.47.0-255,66,187802,96,286439
19013,0.002551,74.125.24.0-255,1484,189286,96,286439
19014,0.002555,74.125.24.0-255,1484,190770,96,286439
19015,0.002558,172.31.47.0-255,66,190836,96,286439
19016,0.002567,74.125.24.0-255,1484,192320,96,286439
19017,0.0026,74.125.24.0-255,5738,198058,96,286439
19018,0.002602,172.31.47.0-255,66,198124,96,286439
19019,0.002613,172.31.47.0-255,66,198190,96,286439
19020,0.002627,172.31.47.0-255,66,198256,96,286439
19021,0.005198,74.125.24.0-255,5738,203994,96,286439
19022,0.005214,172.31.47.0-255,66,204060,96,286439
19023,0.007818,74.125.24.0-255,5738,209798,96,286439
19024,0.007831,172.31.47.0-255,66,209864,96,286439
19025,0.010438,74.125.24.0-255,5738,215602,96,286439
19026,0.010446,172.31.47.0-255,66,215668,96,286439
19027,0.012993,74.125.24.0-255,5738,221406,96,286439
19028,0.013,172.31.47.0-255,66,221472,96,286439
19029,0.015552,74.125.24.0-255,5738,227210,96,286439
19030,0.015562,172.31.47.0-255,66,227276,96,286439
19031,0.018145,74.125.24.0-255,5738,233014,96,286439
19032,0.018152,172.31.47.0-255,66,233080,96,286439
19033,0.020713,74.125.24.0-255,5738,238818,96,286439
19034,0.02072,172.31.47.0-255,66,238884,96,286439
19035,0.023296,74.125.24.0-255,5738,244622,96,286439
19036,0.023308,172.31.47.0-255,66,244688,96,286439
19037,0.025888,74.125.24.0-255,5738,250426,96,286439
19038,0.025895,172.31.47.0-255,66,250492,96,286439
19039,0.025971,172.31.47.0-255,172,250664,96,286439
19040,0.025998,172.31.47.0-255,1105,251769,96,286439
19041,0.026106,172.31.47.0-255,1514,253283,96,286439
19042,0.026108,172.31.47.0-255,341,253624,96,286439
19043,0.027494,104.244.42.0-255,66,253690,96,286439
19044,0.027528,104.244.42.0-255,66,253756,96,286439
19045,0.027663,104.244.42.0-255,66,253822,96,286439
19046,0.028439,74.125.24.0-255,5738,259560,96,286439
19047,0.028445,172.31.47.0-255,66,259626,96,286439
19048,0.031002,74.125.24.0-255,5738,265364,96,286439
19049,0.031009,172.31.47.0-255,66,265430,96,286439
19050,0.033579,74.125.24.0-255,5738,271168,96,286439
19051,0.033585,172.31.47.0-255,66,271234,96,286439
19052,0.03615,74.125.24.0-255,5738,276972,96,286439
19053,0.036157,172.31.47.0-255,66,277038,96,286439
19054,0.038709,74.125.24.0-255,5738,282776,96,286439
19055,0.038719,172.31.47.0-255,66,282842,96,286439
19056,0.041282,74.125.24.0-255,3360,286202,96,286439
19057,0.041288,172.31.47.0-255,66,286268,96,286439
19058,0.041426,172.31.47.0-255,105,286373,96,286439
19059,0.043956,74.125.24.0-255,66,286439,96,286439
19060,0.0,172.31.47.0-255,66,66,96,66
19061,0.0,74.125.130.0-255,153,153,96,417463
19062,3.2e-05,172.31.47.0-255,66,219,96,417463
19063,3.8e-05,74.125.130.0-255,1484,1703,96,417463
19064,4.2e-05,172.31.47.0-255,66,1769,96,417463
19065,5.9e-05,74.125.130.0-255,2902,4671,96,417463
19066,6.1e-05,172.31.47.0-255,66,4737,96,417463
19067,8.7e-05,74.125.130.0-255,4320,9057,96,417463
19068,9e-05,172.31.47.0-255,66,9123,96,417463
19069,0.000105,74.125.130.0-255,2902,12025,96,417463
19070,0.000107,172.31.47.0-255,66,12091,96,417463
19071,0.000128,74.125.130.0-255,1484,13575,96,417463
19072,0.00013,172.31.47.0-255,66,13641,96,417463
19073,0.000179,74.125.130.0-255,4979,18620,96,417463
19074,0.000182,172.31.47.0-255,66,18686,96,417463
19075,0.000185,74.125.130.0-255,1484,20170,96,417463
19076,0.000186,172.31.47.0-255,66,20236,96,417463
19077,0.000202,74.125.130.0-255,4320,24556,96,417463
19078,0.000204,172.31.47.0-255,66,24622,96,417463
19079,0.000223,74.125.130.0-255,5738,30360,96,417463
19080,0.000225,172.31.47.0-255,66,30426,96,417463
19081,0.000254,74.125.130.0-255,1125,31551,96,417463
19082,0.000256,172.31.47.0-255,66,31617,96,417463
19083,0.000399,74.125.130.0-255,1484,33101,96,417463
19084,0.000403,172.31.47.0-255,66,33167,96,417463
19085,0.000416,74.125.130.0-255,2902,36069,96,417463
19086,0.00042,172.31.47.0-255,66,36135,96,417463
19087,0.000438,74.125.130.0-255,2902,39037,96,417463
19088,0.000441,172.31.47.0-255,66,39103,96,417463
19089,0.000457,74.125.130.0-255,2902,42005,96,417463
19090,0.000459,172.31.47.0-255,66,42071,96,417463
19091,0.000463,74.125.130.0-255,2902,44973,96,417463
19092,0.000464,172.31.47.0-255,66,45039,96,417463
19093,0.000486,74.125.130.0-255,3961,49000,96,417463
19094,0.000489,172.31.47.0-255,66,49066,96,417463
19095,0.000528,74.125.130.0-255,2902,51968,96,417463
19096,0.00053,172.31.47.0-255,66,52034,96,417463
19097,0.000545,74.125.130.0-255,1484,53518,96,417463
19098,0.000549,74.125.130.0-255,1484,55002,96,417463
19099,0.000551,172.31.47.0-255,66,55068,96,417463
19100,0.000578,74.125.130.0-255,4320,59388,96,417463
19101,0.000581,172.31.47.0-255,66,59454,96,417463
19102,0.000588,74.125.130.0-255,7052,66506,96,417463
19103,0.00059,74.125.130.0-255,400,66906,96,417463
19104,0.000591,172.31.47.0-255,66,66972,96,417463
19105,0.000708,74.125.130.0-255,1484,68456,96,417463
19106,0.000711,172.31.47.0-255,66,68522,96,417463
19107,0.000717,74.125.130.0-255,2902,71424,96,417463
19108,0.00072,172.31.47.0-255,66,71490,96,417463
19109,0.00074,74.125.130.0-255,5738,77228,96,417463
19110,0.000743,172.31.47.0-255,66,77294,96,417463
19111,0.000798,74.125.130.0-255,5738,83032,96,417463
19112,0.000803,172.31.47.0-255,66,83098,96,417463
19113,0.000823,74.125.130.0-255,4320,87418,96,417463
19114,0.000826,172.31.47.0-255,66,87484,96,417463
19115,0.000838,172.31.47.0-255,66,87550,96,417463
19116,0.000841,74.125.130.0-255,2184,89734,96,417463
19117,0.000844,172.31.47.0-255,66,89800,96,417463
19118,0.000919,74.125.130.0-255,1484,91284,96,417463
19119,0.000934,74.125.130.0-255,2902,94186,96,417463
19120,0.000937,172.31.47.0-255,66,94252,96,417463
19121,0.000956,74.125.130.0-255,2902,97154,96,417463
19122,0.000959,172.31.47.0-255,66,97220,96,417463
19123,0.00098,74.125.130.0-255,2902,100122,96,417463
19124,0.000983,172.31.47.0-255,66,100188,96,417463
19125,0.000989,74.125.130.0-255,5738,105926,96,417463
19126,0.000991,172.31.47.0-255,66,105992,96,417463
19127,0.000995,74.125.130.0-255,2902,108894,96,417463
19128,0.000996,172.31.47.0-255,66,108960,96,417463
19129,0.001024,74.125.130.0-255,4320,113280,96,417463
19130,0.001028,172.31.47.0-255,66,113346,96,417463
19131,0.00103,74.125.130.0-255,5738,119084,96,417463
19132,0.001033,172.31.47.0-255,66,119150,96,417463
19133,0.001068,74.125.130.0-255,2902,122052,96,417463
19134,0.001071,172.31.47.0-255,66,122118,96,417463
19135,0.001088,74.125.130.0-255,2184,124302,96,417463
19136,0.001091,172.31.47.0-255,66,124368,96,417463
19137,0.001126,74.125.130.0-255,1484,125852,96,417463
19138,0.00114,74.125.130.0-255,2902,128754,96,417463
19139,0.001143,172.31.47.0-255,66,128820,96,417463
19140,0.001162,74.125.130.0-255,4320,133140,96,417463
19141,0.001165,172.31.47.0-255,66,133206,96,417463
19142,0.001183,74.125.130.0-255,1484,134690,96,417463
19143,0.001187,74.125.130.0-255,1484,136174,96,417463
19144,0.001189,172.31.47.0-255,66,136240,96,417463
19145,0.001194,74.125.130.0-255,2902,139142,96,417463
19146,0.001196,172.31.47.0-255,66,139208,96,417463
19147,0.001224,74.125.130.0-255,5738,144946,96,417463
19148,0.001226,74.125.130.0-255,1484,146430,96,417463
19149,0.001228,172.31.47.0-255,66,146496,96,417463
19150,0.001252,74.125.130.0-255,2902,149398,96,417463
19151,0.001256,172.31.47.0-255,66,149464,96,417463
19152,0.001273,74.125.130.0-255,1484,150948,96,417463
19153,0.00129,74.125.130.0-255,4320,155268,96,417463
19154,0.001294,172.31.47.0-255,66,155334,96,417463
19155,0.001306,74.125.130.0-255,2902,158236,96,417463
19156,0.001309,172.31.47.0-255,66,158302,96,417463
19157,0.001312,74.125.130.0-255,766,159068,96,417463
19158,0.001515,74.125.130.0-255,1484,160552,96,417463
19159,0.001535,172.31.47.0-255,66,160618,96,417463
19160,0.001539,74.125.130.0-255,1484,162102,96,417463
19161,0.001543,74.125.130.0-255,1484,163586,96,417463
19162,0.001545,172.31.47.0-255,66,163652,96,417463
19163,0.001562,74.125.130.0-255,1484,165136,96,417463
19164,0.001565,74.125.130.0-255,1484,166620,96,417463
19165,0.001567,172.31.47.0-255,66,166686,96,417463
19166,0.001584,74.125.130.0-255,4320,171006,96,417463
19167,0.001587,172.31.47.0-255,66,171072,96,417463
19168,0.00159,74.125.130.0-255,1484,172556,96,417463
19169,0.001593,74.125.130.0-255,1484,174040,96,417463
19170,0.001594,172.31.47.0-255,66,174106,96,417463
19171,0.001608,74.125.130.0-255,1484,175590,96,417463
19172,0.001626,74.125.130.0-255,2902,178492,96,417463
19173,0.001628,172.31.47.0-255,66,178558,96,417463
19174,0.001646,74.125.130.0-255,2902,181460,96,417463
19175,0.001648,172.31.47.0-255,66,181526,96,417463
19176,0.00168,74.125.130.0-255,4320,185846,96,417463
19177,0.001683,172.31.47.0-255,66,185912,96,417463
19178,0.001687,74.125.130.0-255,2902,188814,96,417463
19179,0.00169,172.31.47.0-255,66,188880,96,417463
19180,0.001701,74.125.130.0-255,5020,193900,96,417463
19181,0.001703,172.31.47.0-255,66,193966,96,417463
19182,0.001795,74.125.130.0-255,1484,195450,96,417463
19183,0.001807,74.125.130.0-255,2902,198352,96,417463
19184,0.00181,172.31.47.0-255,66,198418,96,417463
19185,0.00185,74.125.130.0-255,5738,204156,96,417463
19186,0.001853,172.31.47.0-255,66,204222,96,417463
19187,0.001863,74.125.130.0-255,1484,205706,96,417463
19188,0.001883,74.125.130.0-255,5738,211444,96,417463
19189,0.001885,172.31.47.0-255,66,211510,96,417463
19190,0.00189,74.125.130.0-255,4320,215830,96,417463
19191,0.001892,172.31.47.0-255,66,215896,96,417463
19192,0.001911,74.125.130.0-255,2902,218798,96,417463
19193,0.001914,172.31.47.0-255,66,218864,96,417463
19194,0.00193,74.125.130.0-255,2902,221766,96,417463
19195,0.001933,172.31.47.0-255,66,221832,96,417463
19196,0.001955,74.125.130.0-255,6438,228270,96,417463
19197,0.001957,172.31.47.0-255,66,228336,96,417463
19198,0.003937,74.125.130.0-255,5738,234074,96,417463
19199,0.003944,172.31.47.0-255,66,234140,96,417463
19200,0.005911,74.125.130.0-255,1484,235624,96,417463
19201,0.005935,74.125.130.0-255,4320,239944,96,417463
19202,0.005938,172.31.47.0-255,66,240010,96,417463
19203,0.007928,74.125.130.0-255,5738,245748,96,417463
19204,0.007934,172.31.47.0-255,66,245814,96,417463
19205,0.009913,74.125.130.0-255,5738,251552,96,417463
19206,0.009919,172.31.47.0-255,66,251618,96,417463
19207,0.01193,74.125.130.0-255,5738,257356,96,417463
19208,0.011936,172.31.47.0-255,66,257422,96,417463
19209,0.013917,74.125.130.0-255,4320,261742,96,417463
19210,0.013923,172.31.47.0-255,66,261808,96,417463
19211,0.013942,74.125.130.0-255,1484,263292,96,417463
19212,0.015898,74.125.130.0-255,4320,267612,96,417463
19213,0.015903,172.31.47.0-255,66,267678,96,417463
19214,0.017898,74.125.130.0-255,5738,273416,96,417463
19215,0.017908,172.31.47.0-255,66,273482,96,417463
19216,0.019893,74.125.130.0-255,5738,279220,96,417463
19217,0.0199,172.31.47.0-255,66,279286,96,417463
19218,0.021876,74.125.130.0-255,5738,285024,96,417463
19219,0.021885,172.31.47.0-255,66,285090,96,417463
19220,0.023869,74.125.130.0-255,5738,290828,96,417463
19221,0.023875,172.31.47.0-255,66,290894,96,417463
19222,0.025866,74.125.130.0-255,5738,296632,96,417463
19223,0.02588,172.31.47.0-255,66,296698,96,417463
19224,0.027879,74.125.130.0-255,5738,302436,96,417463
19225,0.027892,172.31.47.0-255,66,302502,96,417463
19226,0.029877,74.125.130.0-255,5738,308240,96,417463
19227,0.029887,172.31.47.0-255,66,308306,96,417463
19228,0.031894,74.125.130.0-255,5738,314044,96,417463
19229,0.031906,172.31.47.0-255,66,314110,96,417463
19230,0.033892,74.125.130.0-255,5738,319848,96,417463
19231,0.033901,172.31.47.0-255,66,319914,96,417463
19232,0.035881,74.125.130.0-255,5738,325652,96,417463
19233,0.035891,172.31.47.0-255,66,325718,96,417463
19234,0.037871,74.125.130.0-255,5738,331456,96,417463
19235,0.037881,172.31.47.0-255,66,331522,96,417463
19236,0.037885,172.31.47.0-255,172,331694,96,417463
19237,0.037907,172.31.47.0-255,1101,332795,96,417463
19238,0.037965,172.31.47.0-255,1514,334309,96,417463
19239,0.037967,172.31.47.0-255,1310,335619,96,417463
19240,0.039446,104.244.42.0-255,66,335685,96,417463
19241,0.039461,104.244.42.0-255,66,335751,96,417463
19242,0.039537,104.244.42.0-255,66,335817,96,417463
19243,0.039874,74.125.130.0-255,5738,341555,96,417463
19244,0.039888,172.31.47.0-255,66,341621,96,417463
19245,0.041881,74.125.130.0-255,5738,347359,96,417463
19246,0.041896,172.31.47.0-255,66,347425,96,417463
19247,0.043909,74.125.130.0-255,5738,353163,96,417463
19248,0.043926,172.31.47.0-255,66,353229,96,417463
19249,0.045923,74.125.130.0-255,5738,358967,96,417463
19250,0.04594,172.31.47.0-255,66,359033,96,417463
19251,0.047946,74.125.130.0-255,5738,364771,96,417463
19252,0.047964,172.31.47.0-255,66,364837,96,417463
19253,0.049955,74.125.130.0-255,5738,370575,96,417463
19254,0.049972,172.31.47.0-255,66,370641,96,417463
19255,0.051982,74.125.130.0-255,5738,376379,96,417463
19256,0.052001,172.31.47.0-255,66,376445,96,417463
19257,0.053993,74.125.130.0-255,5738,382183,96,417463
19258,0.054026,172.31.47.0-255,66,382249,96,417463
19259,0.055996,74.125.130.0-255,2902,385151,96,417463
19260,0.056001,172.31.47.0-255,66,385217,96,417463
19261,0.056032,74.125.130.0-255,2902,388119,96,417463
19262,0.056034,172.31.47.0-255,66,388185,96,417463
19263,0.057974,74.125.130.0-255,2902,391087,96,417463
19264,0.057978,172.31.47.0-255,66,391153,96,417463
19265,0.057998,74.125.130.0-255,1484,392637,96,417463
19266,0.058008,74.125.130.0-255,1484,394121,96,417463
19267,0.058011,172.31.47.0-255,66,394187,96,417463
19268,0.059947,74.125.130.0-255,2902,397089,96,417463
19269,0.059952,172.31.47.0-255,66,397155,96,417463
19270,0.059981,74.125.130.0-255,2902,400057,96,417463
19271,0.059983,172.31.47.0-255,66,400123,96,417463
19272,0.061932,74.125.130.0-255,2902,403025,96,417463
19273,0.061937,172.31.47.0-255,66,403091,96,417463
19274,0.061964,74.125.130.0-255,2902,405993,96,417463
19275,0.061968,172.31.47.0-255,66,406059,96,417463
19276,0.063909,74.125.130.0-255,2902,408961,96,417463
19277,0.063914,172.31.47.0-255,66,409027,96,417463
19278,0.063943,74.125.130.0-255,2902,411929,96,417463
19279,0.063946,172.31.47.0-255,66,411995,96,417463
19280,0.065884,74.125.130.0-255,2902,414897,96,417463
19281,0.065889,172.31.47.0-255,66,414963,96,417463
19282,0.065917,74.125.130.0-255,2263,417226,96,417463
19283,0.06592,172.31.47.0-255,66,417292,96,417463
19284,0.066068,172.31.47.0-255,105,417397,96,417463
19285,0.068006,74.125.130.0-255,66,417463,96,417463
19286,0.0,172.217.194.0-255,153,153,96,286829
19287,2.4e-05,172.31.47.0-255,66,219,96,286829
19288,3.2e-05,172.217.194.0-255,1484,1703,96,286829
19289,3.7e-05,172.31.47.0-255,66,1769,96,286829
19290,4.2e-05,172.217.194.0-255,2902,4671,96,286829
19291,4.6e-05,172.31.47.0-255,66,4737,96,286829
19292,5.3e-05,172.217.194.0-255,5738,10475,96,286829
19293,5.6e-05,172.31.47.0-255,66,10541,96,286829
19294,6.2e-05,172.217.194.0-255,4320,14861,96,286829
19295,6.5e-05,172.31.47.0-255,66,14927,96,286829
19296,0.000107,172.31.47.0-255,66,14993,96,286829
19297,0.000115,172.217.194.0-255,6797,21790,96,286829
19298,0.000117,172.31.47.0-255,66,21856,96,286829
19299,0.000162,172.217.194.0-255,5738,27594,96,286829
19300,0.000165,172.31.47.0-255,66,27660,96,286829
19301,0.000173,172.217.194.0-255,7156,34816,96,286829
19302,0.000176,172.31.47.0-255,66,34882,96,286829
19303,0.000181,172.217.194.0-255,3961,38843,96,286829
19304,0.000183,172.31.47.0-255,66,38909,96,286829
19305,0.00049,172.217.194.0-255,1484,40393,96,286829
19306,0.000495,172.31.47.0-255,66,40459,96,286829
19307,0.000501,172.217.194.0-255,2902,43361,96,286829
19308,0.000504,172.31.47.0-255,66,43427,96,286829
19309,0.000509,172.217.194.0-255,2902,46329,96,286829
19310,0.000511,172.31.47.0-255,66,46395,96,286829
19311,0.000531,172.217.194.0-255,2902,49297,96,286829
19312,0.000533,172.31.47.0-255,66,49363,96,286829
19313,0.000545,172.31.47.0-255,66,49429,96,286829
19314,0.001077,172.217.194.0-255,1484,50913,96,286829
19315,0.001082,172.31.47.0-255,66,50979,96,286829
19316,0.001089,172.217.194.0-255,2902,53881,96,286829
19317,0.001091,172.31.47.0-255,66,53947,96,286829
19318,0.001097,172.217.194.0-255,5738,59685,96,286829
19319,0.001099,172.31.47.0-255,66,59751,96,286829
19320,0.001136,172.31.47.0-255,66,59817,96,286829
19321,0.001166,172.31.47.0-255,66,59883,96,286829
19322,0.001689,172.217.194.0-255,1484,61367,96,286829
19323,0.001697,172.217.194.0-255,2902,64269,96,286829
19324,0.001701,172.31.47.0-255,66,64335,96,286829
19325,0.001705,172.217.194.0-255,1484,65819,96,286829
19326,0.001723,172.217.194.0-255,4320,70139,96,286829
19327,0.001725,172.31.47.0-255,66,70205,96,286829
19328,0.00174,172.217.194.0-255,4320,74525,96,286829
19329,0.001742,172.31.47.0-255,66,74591,96,286829
19330,0.001771,172.31.47.0-255,66,74657,96,286829
19331,0.001781,172.31.47.0-255,66,74723,96,286829
19332,0.001795,172.217.194.0-255,766,75489,96,286829
19333,0.001894,172.217.194.0-255,1484,76973,96,286829
19334,0.001897,172.31.47.0-255,66,77039,96,286829
19335,0.001929,172.217.194.0-255,2902,79941,96,286829
19336,0.001931,172.31.47.0-255,66,80007,96,286829
19337,0.001953,172.217.194.0-255,5738,85745,96,286829
19338,0.001955,172.31.47.0-255,66,85811,96,286829
19339,0.00198,172.31.47.0-255,66,85877,96,286829
19340,0.002,172.217.194.0-255,1484,87361,96,286829
19341,0.002007,172.217.194.0-255,7156,94517,96,286829
19342,0.002009,172.31.47.0-255,66,94583,96,286829
19343,0.00203,172.217.194.0-255,5020,99603,96,286829
19344,0.002032,172.31.47.0-255,66,99669,96,286829
19345,0.004113,172.217.194.0-255,5738,105407,96,286829
19346,0.004116,172.31.47.0-255,66,105473,96,286829
19347,0.006187,172.217.194.0-255,1484,106957,96,286829
19348,0.006208,172.217.194.0-255,4320,111277,96,286829
19349,0.006212,172.31.47.0-255,66,111343,96,286829
19350,0.008299,172.217.194.0-255,5738,117081,96,286829
19351,0.008306,172.31.47.0-255,66,117147,96,286829
19352,0.010426,172.217.194.0-255,5738,122885,96,286829
19353,0.010433,172.31.47.0-255,66,122951,96,286829
19354,0.012526,172.217.194.0-255,5738,128689,96,286829
19355,0.012533,172.31.47.0-255,66,128755,96,286829
19356,0.014633,172.217.194.0-255,5738,134493,96,286829
19357,0.014642,172.31.47.0-255,66,134559,96,286829
19358,0.016741,172.217.194.0-255,5738,140297,96,286829
19359,0.016748,172.31.47.0-255,66,140363,96,286829
19360,0.018876,172.217.194.0-255,5738,146101,96,286829
19361,0.018885,172.31.47.0-255,66,146167,96,286829
19362,0.021016,172.217.194.0-255,5738,151905,96,286829
19363,0.021024,172.31.47.0-255,66,151971,96,286829
19364,0.023072,172.217.194.0-255,5738,157709,96,286829
19365,0.023079,172.31.47.0-255,66,157775,96,286829
19366,0.025197,172.217.194.0-255,5738,163513,96,286829
19367,0.025204,172.31.47.0-255,66,163579,96,286829
19368,0.027271,172.217.194.0-255,5738,169317,96,286829
19369,0.027278,172.31.47.0-255,66,169383,96,286829
19370,0.028409,172.31.47.0-255,172,169555,96,286829
19371,0.028447,172.31.47.0-255,1101,170656,96,286829
19372,0.028508,172.31.47.0-255,1514,172170,96,286829
19373,0.02851,172.31.47.0-255,1514,173684,96,286829
19374,0.028511,172.31.47.0-255,1514,175198,96,286829
19375,0.028512,172.31.47.0-255,1091,176289,96,286829
19376,0.029354,172.217.194.0-255,5738,182027,96,286829
19377,0.02936,172.31.47.0-255,66,182093,96,286829
19378,0.029991,104.244.42.0-255,66,182159,96,286829
19379,0.030026,104.244.42.0-255,66,182225,96,286829
19380,0.030089,104.244.42.0-255,66,182291,96,286829
19381,0.030109,104.244.42.0-255,66,182357,96,286829
19382,0.031459,172.217.194.0-255,5738,188095,96,286829
19383,0.031465,172.31.47.0-255,66,188161,96,286829
19384,0.033535,172.217.194.0-255,5738,193899,96,286829
19385,0.033551,172.31.47.0-255,66,193965,96,286829
19386,0.035689,172.217.194.0-255,5738,199703,96,286829
19387,0.035705,172.31.47.0-255,66,199769,96,286829
19388,0.037777,172.217.194.0-255,5738,205507,96,286829
19389,0.037795,172.31.47.0-255,66,205573,96,286829
19390,0.039935,172.217.194.0-255,5738,211311,96,286829
19391,0.039953,172.31.47.0-255,66,211377,96,286829
19392,0.042034,172.217.194.0-255,5738,217115,96,286829
19393,0.042051,172.31.47.0-255,66,217181,96,286829
19394,0.044182,172.217.194.0-255,5738,222919,96,286829
19395,0.044203,172.31.47.0-255,66,222985,96,286829
19396,0.046321,172.217.194.0-255,5738,228723,96,286829
19397,0.046343,172.31.47.0-255,66,228789,96,286829
19398,0.048468,172.217.194.0-255,5738,234527,96,286829
19399,0.048488,172.31.47.0-255,66,234593,96,286829
19400,0.050628,172.217.194.0-255,5738,240331,96,286829
19401,0.050644,172.31.47.0-255,66,240397,96,286829
19402,0.052723,172.217.194.0-255,5738,246135,96,286829
19403,0.052731,172.31.47.0-255,66,246201,96,286829
19404,0.054854,172.217.194.0-255,5738,251939,96,286829
19405,0.054861,172.31.47.0-255,66,252005,96,286829
19406,0.056948,172.217.194.0-255,5738,257743,96,286829
19407,0.056955,172.31.47.0-255,66,257809,96,286829
19408,0.059508,172.217.194.0-255,5738,263547,96,286829
19409,0.059515,172.31.47.0-255,66,263613,96,286829
19410,0.061631,172.217.194.0-255,5738,269351,96,286829
19411,0.061639,172.31.47.0-255,66,269417,96,286829
19412,0.063754,172.217.194.0-255,5738,275155,96,286829
19413,0.06376,172.31.47.0-255,66,275221,96,286829
19414,0.06587,172.217.194.0-255,5738,280959,96,286829
19415,0.065876,172.31.47.0-255,66,281025,96,286829
19416,0.068001,172.217.194.0-255,5738,286763,96,286829
19417,0.068008,172.31.47.0-255,66,286829,96,286829
19418,0.0,172.253.118.0-255,153,153,96,208380
19419,1.5e-05,172.31.47.0-255,66,219,96,208380
19420,2.2e-05,172.253.118.0-255,1484,1703,96,208380
19421,2.6e-05,172.31.47.0-255,66,1769,96,208380
19422,3.2e-05,172.253.118.0-255,2902,4671,96,208380
19423,3.5e-05,172.31.47.0-255,66,4737,96,208380
19424,4.1e-05,172.253.118.0-255,4320,9057,96,208380
19425,4.4e-05,172.31.47.0-255,66,9123,96,208380
19426,7.5e-05,172.253.118.0-255,2902,12025,96,208380
19427,7.9e-05,172.31.47.0-255,66,12091,96,208380
19428,8.4e-05,172.253.118.0-255,2094,14185,96,208380
19429,8.7e-05,172.31.47.0-255,66,14251,96,208380
19430,0.000175,172.253.118.0-255,1484,15735,96,208380
19431,0.000178,172.31.47.0-255,66,15801,96,208380
19432,0.000183,172.253.118.0-255,2902,18703,96,208380
19433,0.000186,172.31.47.0-255,66,18769,96,208380
19434,0.000211,172.253.118.0-255,5738,24507,96,208380
19435,0.000214,172.31.47.0-255,66,24573,96,208380
19436,0.000243,172.253.118.0-255,6797,31370,96,208380
19437,0.000246,172.31.47.0-255,66,31436,96,208380
19438,0.00025,172.253.118.0-255,2902,34338,96,208380
19439,0.000252,172.31.47.0-255,66,34404,96,208380
19440,0.000289,172.253.118.0-255,4320,38724,96,208380
19441,0.000292,172.31.47.0-255,66,38790,96,208380
19442,0.000308,172.31.47.0-255,66,38856,96,208380
19443,0.00033,172.253.118.0-255,1484,40340,96,208380
19444,0.000332,172.31.47.0-255,66,40406,96,208380
19445,0.000337,172.253.118.0-255,2902,43308,96,208380
19446,0.00034,172.31.47.0-255,66,43374,96,208380
19447,0.000344,172.253.118.0-255,2902,46276,96,208380
19448,0.00035,172.31.47.0-255,66,46342,96,208380
19449,0.000373,172.253.118.0-255,2902,49244,96,208380
19450,0.000375,172.31.47.0-255,66,49310,96,208380
19451,0.000383,172.253.118.0-255,7132,56442,96,208380
19452,0.00039,172.31.47.0-255,66,56508,96,208380
19453,0.000695,172.253.118.0-255,344,56852,96,208380
19454,0.000812,172.253.118.0-255,1484,58336,96,208380
19455,0.000818,172.31.47.0-255,66,58402,96,208380
19456,0.000824,172.253.118.0-255,2902,61304,96,208380
19457,0.000826,172.31.47.0-255,66,61370,96,208380
19458,0.000829,172.253.118.0-255,1484,62854,96,208380
19459,0.000856,172.253.118.0-255,1484,64338,96,208380
19460,0.000858,172.31.47.0-255,66,64404,96,208380
19461,0.000867,172.253.118.0-255,7156,71560,96,208380
19462,0.000869,172.31.47.0-255,66,71626,96,208380
19463,0.0009,172.253.118.0-255,2543,74169,96,208380
19464,0.000902,172.31.47.0-255,66,74235,96,208380
19465,0.000924,172.253.118.0-255,2902,77137,96,208380
19466,0.000927,172.31.47.0-255,66,77203,96,208380
19467,0.000948,172.253.118.0-255,4320,81523,96,208380
19468,0.00095,172.31.47.0-255,66,81589,96,208380
19469,0.000956,172.253.118.0-255,4320,85909,96,208380
19470,0.000959,172.31.47.0-255,66,85975,96,208380
19471,0.000972,172.253.118.0-255,4320,90295,96,208380
19472,0.000975,172.31.47.0-255,66,90361,96,208380
19473,0.000982,172.253.118.0-255,1125,91486,96,208380
19474,0.001628,172.31.47.0-255,66,91552,96,208380
19475,0.001885,172.253.118.0-255,1484,93036,96,208380
19476,0.001895,172.253.118.0-255,2902,95938,96,208380
19477,0.001899,172.31.47.0-255,66,96004,96,208380
19478,0.001907,172.253.118.0-255,5738,101742,96,208380
19479,0.001909,172.31.47.0-255,66,101808,96,208380
19480,0.001913,172.253.118.0-255,2902,104710,96,208380
19481,0.001915,172.31.47.0-255,66,104776,96,208380
19482,0.001931,172.253.118.0-255,1484,106260,96,208380
19483,0.001967,172.31.47.0-255,66,106326,96,208380
19484,0.001985,172.31.47.0-255,66,106392,96,208380
19485,0.002077,172.253.118.0-255,1484,107876,96,208380
19486,0.002083,172.253.118.0-255,2902,110778,96,208380
19487,0.002087,172.31.47.0-255,66,110844,96,208380
19488,0.002091,172.253.118.0-255,1484,112328,96,208380
19489,0.002123,172.253.118.0-255,4320,116648,96,208380
19490,0.002125,172.31.47.0-255,66,116714,96,208380
19491,0.002131,172.253.118.0-255,4320,121034,96,208380
19492,0.002133,172.31.47.0-255,66,121100,96,208380
19493,0.002151,172.31.47.0-255,66,121166,96,208380
19494,0.002195,172.31.47.0-255,66,121232,96,208380
19495,0.002208,172.31.47.0-255,66,121298,96,208380
19496,0.00226,172.31.47.0-255,66,121364,96,208380
19497,0.002312,172.253.118.0-255,1484,122848,96,208380
19498,0.002316,172.253.118.0-255,2902,125750,96,208380
19499,0.002319,172.31.47.0-255,66,125816,96,208380
19500,0.002326,172.253.118.0-255,5738,131554,96,208380
19501,0.002328,172.31.47.0-255,66,131620,96,208380
19502,0.002345,172.31.47.0-255,66,131686,96,208380
19503,0.00235,172.253.118.0-255,2902,134588,96,208380
19504,0.002352,172.31.47.0-255,66,134654,96,208380
19505,0.002355,172.253.118.0-255,1484,136138,96,208380
19506,0.002407,172.31.47.0-255,66,136204,96,208380
19507,0.002592,172.253.118.0-255,1484,137688,96,208380
19508,0.0026,172.253.118.0-255,2902,140590,96,208380
19509,0.002605,172.31.47.0-255,66,140656,96,208380
19510,0.002612,172.253.118.0-255,5738,146394,96,208380
19511,0.002615,172.31.47.0-255,66,146460,96,208380
19512,0.002624,172.253.118.0-255,2902,149362,96,208380
19513,0.002627,172.31.47.0-255,66,149428,96,208380
19514,0.00267,172.31.47.0-255,66,149494,96,208380
19515,0.002676,172.253.118.0-255,5738,155232,96,208380
19516,0.002678,172.31.47.0-255,66,155298,96,208380
19517,0.002715,172.31.47.0-255,66,155364,96,208380
19518,0.002736,172.31.47.0-255,66,155430,96,208380
19519,0.002743,172.253.118.0-255,7156,162586,96,208380
19520,0.002746,172.31.47.0-255,66,162652,96,208380
19521,0.002778,172.253.118.0-255,6438,169090,96,208380
19522,0.002781,172.31.47.0-255,66,169156,96,208380
19523,0.002803,172.253.118.0-255,1484,170640,96,208380
19524,0.002808,172.253.118.0-255,2902,173542,96,208380
19525,0.00281,172.31.47.0-255,66,173608,96,208380
19526,0.002841,172.253.118.0-255,5738,179346,96,208380
19527,0.002843,172.31.47.0-255,66,179412,96,208380
19528,0.002851,172.253.118.0-255,7156,186568,96,208380
19529,0.002853,172.31.47.0-255,66,186634,96,208380
19530,0.002863,172.253.118.0-255,4320,190954,96,208380
19531,0.002865,172.31.47.0-255,66,191020,96,208380
19532,0.002909,172.31.47.0-255,66,191086,96,208380
19533,0.002913,172.253.118.0-255,2184,193270,96,208380
19534,0.002915,172.31.47.0-255,66,193336,96,208380
19535,0.002919,172.253.118.0-255,1484,194820,96,208380
19536,0.002961,172.31.47.0-255,66,194886,96,208380
19537,0.002965,172.253.118.0-255,1484,196370,96,208380
19538,0.002982,172.31.47.0-255,66,196436,96,208380
19539,0.002985,172.253.118.0-255,1484,197920,96,208380
19540,0.002997,172.31.47.0-255,66,197986,96,208380
19541,0.003002,172.253.118.0-255,4320,202306,96,208380
19542,0.003005,172.31.47.0-255,66,202372,96,208380
19543,0.003047,172.31.47.0-255,66,202438,96,208380
19544,0.00306,172.31.47.0-255,66,202504,96,208380
19545,0.003135,172.31.47.0-255,66,202570,96,208380
19546,0.003145,172.31.47.0-255,66,202636,96,208380
19547,0.003152,172.253.118.0-255,922,203558,96,208380
19548,0.003155,172.253.118.0-255,105,203663,96,208380
19549,0.010613,172.31.47.0-255,66,203729,96,208380
19550,0.010664,172.31.47.0-255,105,203834,96,208380
19551,0.011911,172.253.118.0-255,105,203939,96,208380
19552,0.011923,172.31.47.0-255,78,204017,96,208380
19553,0.012604,172.253.118.0-255,66,204083,96,208380
19554,0.042513,172.31.47.0-255,172,204255,96,208380
19555,0.042543,172.31.47.0-255,1104,205359,96,208380
19556,0.042603,172.31.47.0-255,1514,206873,96,208380
19557,0.042605,172.31.47.0-255,1309,208182,96,208380
19558,0.04405,104.244.42.0-255,66,208248,96,208380
19559,0.044102,104.244.42.0-255,66,208314,96,208380
19560,0.044217,104.244.42.0-255,66,208380,96,208380
19561,0.0,74.125.24.0-255,146,146,96,295429
19562,1.4e-05,172.31.47.0-255,66,212,96,295429
19563,2e-05,74.125.24.0-255,1484,1696,96,295429
19564,2.4e-05,172.31.47.0-255,66,1762,96,295429
19565,3e-05,74.125.24.0-255,2902,4664,96,295429
19566,3.3e-05,172.31.47.0-255,66,4730,96,295429
19567,4e-05,74.125.24.0-255,7156,11886,96,295429
19568,4.2e-05,172.31.47.0-255,66,11952,96,295429
19569,4.6e-05,74.125.24.0-255,2138,14090,96,295429
19570,4.8e-05,172.31.47.0-255,66,14156,96,295429
19571,6.5e-05,74.125.24.0-255,1484,15640,96,295429
19572,6.7e-05,172.31.47.0-255,66,15706,96,295429
19573,0.0001,172.31.47.0-255,66,15772,96,295429
19574,0.000103,74.125.24.0-255,1484,17256,96,295429
19575,0.000104,172.31.47.0-255,66,17322,96,295429
19576,0.000109,74.125.24.0-255,2902,20224,96,295429
19577,0.000111,172.31.47.0-255,66,20290,96,295429
19578,0.000128,74.125.24.0-255,1125,21415,96,295429
19579,0.00013,172.31.47.0-255,66,21481,96,295429
19580,0.000249,74.125.24.0-255,1484,22965,96,295429
19581,0.000254,172.31.47.0-255,66,23031,96,295429
19582,0.000259,74.125.24.0-255,2902,25933,96,295429
19583,0.000261,172.31.47.0-255,66,25999,96,295429
19584,0.000296,74.125.24.0-255,5738,31737,96,295429
19585,0.000298,172.31.47.0-255,66,31803,96,295429
19586,0.00031,172.31.47.0-255,66,31869,96,295429
19587,0.000322,172.31.47.0-255,66,31935,96,295429
19588,0.000337,74.125.24.0-255,1484,33419,96,295429
19589,0.00034,172.31.47.0-255,66,33485,96,295429
19590,0.000361,74.125.24.0-255,2818,36303,96,295429
19591,0.000363,172.31.47.0-255,66,36369,96,295429
19592,0.000431,74.125.24.0-255,382,36751,96,295429
19593,0.000434,172.31.47.0-255,66,36817,96,295429
19594,0.000547,74.125.24.0-255,1484,38301,96,295429
19595,0.000552,172.31.47.0-255,66,38367,96,295429
19596,0.000557,74.125.24.0-255,2902,41269,96,295429
19597,0.000559,172.31.47.0-255,66,41335,96,295429
19598,0.000566,74.125.24.0-255,5738,47073,96,295429
19599,0.000568,172.31.47.0-255,66,47139,96,295429
19600,0.000589,74.125.24.0-255,1484,48623,96,295429
19601,0.000592,172.31.47.0-255,66,48689,96,295429
19602,0.000616,74.125.24.0-255,5379,54068,96,295429
19603,0.000619,172.31.47.0-255,66,54134,96,295429
19604,0.000634,74.125.24.0-255,5738,59872,96,295429
19605,0.000637,172.31.47.0-255,66,59938,96,295429
19606,0.000661,74.125.24.0-255,1484,61422,96,295429
19607,0.000663,172.31.47.0-255,66,61488,96,295429
19608,0.00067,74.125.24.0-255,5738,67226,96,295429
19609,0.000672,172.31.47.0-255,66,67292,96,295429
19610,0.000692,74.125.24.0-255,3961,71253,96,295429
19611,0.000694,172.31.47.0-255,66,71319,96,295429
19612,0.00083,74.125.24.0-255,1484,72803,96,295429
19613,0.000834,172.31.47.0-255,66,72869,96,295429
19614,0.000839,74.125.24.0-255,2902,75771,96,295429
19615,0.000842,172.31.47.0-255,66,75837,96,295429
19616,0.000848,74.125.24.0-255,5738,81575,96,295429
19617,0.00085,172.31.47.0-255,66,81641,96,295429
19618,0.000883,172.31.47.0-255,66,81707,96,295429
19619,0.000902,74.125.24.0-255,4320,86027,96,295429
19620,0.000905,172.31.47.0-255,66,86093,96,295429
19621,0.000925,74.125.24.0-255,6438,92531,96,295429
19622,0.000928,172.31.47.0-255,66,92597,96,295429
19623,0.00099,74.125.24.0-255,1484,94081,96,295429
19624,0.000994,74.125.24.0-255,1484,95565,96,295429
19625,0.000997,172.31.47.0-255,66,95631,96,295429
19626,0.001015,74.125.24.0-255,1484,97115,96,295429
19627,0.001022,74.125.24.0-255,5738,102853,96,295429
19628,0.001024,172.31.47.0-255,66,102919,96,295429
19629,0.001028,74.125.24.0-255,1484,104403,96,295429
19630,0.001071,172.31.47.0-255,66,104469,96,295429
19631,0.001082,172.31.47.0-255,66,104535,96,295429
19632,0.001101,74.125.24.0-255,2184,106719,96,295429
19633,0.001103,172.31.47.0-255,66,106785,96,295429
19634,0.001908,74.125.24.0-255,1484,108269,96,295429
19635,0.001914,74.125.24.0-255,2902,111171,96,295429
19636,0.001917,172.31.47.0-255,66,111237,96,295429
19637,0.00192,74.125.24.0-255,1484,112721,96,295429
19638,0.00194,74.125.24.0-255,4320,117041,96,295429
19639,0.001942,172.31.47.0-255,66,117107,96,295429
19640,0.001946,74.125.24.0-255,2902,120009,96,295429
19641,0.001948,172.31.47.0-255,66,120075,96,295429
19642,0.00197,172.31.47.0-255,66,120141,96,295429
19643,0.001975,74.125.24.0-255,5738,125879,96,295429
19644,0.001977,172.31.47.0-255,66,125945,96,295429
19645,0.002013,74.125.24.0-255,5020,130965,96,295429
19646,0.002016,172.31.47.0-255,66,131031,96,295429
19647,0.002286,74.125.24.0-255,1484,132515,96,295429
19648,0.002293,74.125.24.0-255,2902,135417,96,295429
19649,0.002296,172.31.47.0-255,66,135483,96,295429
19650,0.002301,74.125.24.0-255,2902,138385,96,295429
19651,0.002303,172.31.47.0-255,66,138451,96,295429
19652,0.002317,74.125.24.0-255,2902,141353,96,295429
19653,0.002319,172.31.47.0-255,66,141419,96,295429
19654,0.002323,74.125.24.0-255,2902,144321,96,295429
19655,0.002324,172.31.47.0-255,66,144387,96,295429
19656,0.002366,74.125.24.0-255,5738,150125,96,295429
19657,0.002368,172.31.47.0-255,66,150191,96,295429
19658,0.002387,74.125.24.0-255,4320,154511,96,295429
19659,0.002389,172.31.47.0-255,66,154577,96,295429
19660,0.002399,172.31.47.0-255,66,154643,96,295429
19661,0.002441,74.125.24.0-255,5738,160381,96,295429
19662,0.002443,172.31.47.0-255,66,160447,96,295429
19663,0.002471,172.31.47.0-255,66,160513,96,295429
19664,0.002475,74.125.24.0-255,2902,163415,96,295429
19665,0.002477,172.31.47.0-255,66,163481,96,295429
19666,0.002512,172.31.47.0-255,66,163547,96,295429
19667,0.002523,172.31.47.0-255,66,163613,96,295429
19668,0.00254,74.125.24.0-255,4320,167933,96,295429
19669,0.002543,172.31.47.0-255,66,167999,96,295429
19670,0.002548,74.125.24.0-255,5738,173737,96,295429
19671,0.00255,172.31.47.0-255,66,173803,96,295429
19672,0.002553,74.125.24.0-255,1484,175287,96,295429
19673,0.002573,172.31.47.0-255,66,175353,96,295429
19674,0.005129,74.125.24.0-255,5738,181091,96,295429
19675,0.005141,172.31.47.0-255,66,181157,96,295429
19676,0.007713,74.125.24.0-255,5738,186895,96,295429
19677,0.007729,172.31.47.0-255,66,186961,96,295429
19678,0.010294,74.125.24.0-255,5738,192699,96,295429
19679,0.010299,172.31.47.0-255,66,192765,96,295429
19680,0.012808,74.125.24.0-255,5738,198503,96,295429
19681,0.012813,172.31.47.0-255,66,198569,96,295429
19682,0.015345,74.125.24.0-255,5738,204307,96,295429
19683,0.015357,172.31.47.0-255,66,204373,96,295429
19684,0.017922,74.125.24.0-255,5738,210111,96,295429
19685,0.017929,172.31.47.0-255,66,210177,96,295429
19686,0.02046,74.125.24.0-255,5738,215915,96,295429
19687,0.020468,172.31.47.0-255,66,215981,96,295429
19688,0.023029,74.125.24.0-255,5738,221719,96,295429
19689,0.023039,172.31.47.0-255,66,221785,96,295429
19690,0.025605,74.125.24.0-255,5738,227523,96,295429
19691,0.025623,172.31.47.0-255,66,227589,96,295429
19692,0.028165,74.125.24.0-255,5738,233327,96,295429
19693,0.028171,172.31.47.0-255,66,233393,96,295429
19694,0.030739,74.125.24.0-255,5738,239131,96,295429
19695,0.030746,172.31.47.0-255,66,239197,96,295429
19696,0.03331,74.125.24.0-255,5738,244935,96,295429
19697,0.033318,172.31.47.0-255,66,245001,96,295429
19698,0.035907,74.125.24.0-255,5738,250739,96,295429
19699,0.035924,172.31.47.0-255,66,250805,96,295429
19700,0.038515,74.125.24.0-255,5738,256543,96,295429
19701,0.038525,172.31.47.0-255,66,256609,96,295429
19702,0.041075,74.125.24.0-255,5738,262347,96,295429
19703,0.041085,172.31.47.0-255,66,262413,96,295429
19704,0.043655,74.125.24.0-255,5738,268151,96,295429
19705,0.043673,172.31.47.0-255,66,268217,96,295429
19706,0.045846,172.31.47.0-255,172,268389,96,295429
19707,0.045871,172.31.47.0-255,1101,269490,96,295429
19708,0.04592,172.31.47.0-255,1514,271004,96,295429
19709,0.045922,172.31.47.0-255,1310,272314,96,295429
19710,0.046214,74.125.24.0-255,5738,278052,96,295429
19711,0.04622,172.31.47.0-255,66,278118,96,295429
19712,0.047415,104.244.42.0-255,66,278184,96,295429
19713,0.047425,104.244.42.0-255,66,278250,96,295429
19714,0.047471,104.244.42.0-255,66,278316,96,295429
19715,0.048798,74.125.24.0-255,5738,284054,96,295429
19716,0.048812,172.31.47.0-255,66,284120,96,295429
19717,0.051407,74.125.24.0-255,5738,289858,96,295429
19718,0.051425,172.31.47.0-255,66,289924,96,295429
19719,0.053953,74.125.24.0-255,5268,295192,96,295429
19720,0.053959,172.31.47.0-255,66,295258,96,295429
19721,0.054128,172.31.47.0-255,105,295363,96,295429
19722,0.056661,74.125.24.0-255,66,295429,96,295429
19723,0.0,74.125.24.0-255,153,153,96,306365
19724,2.1e-05,172.31.47.0-255,66,219,96,306365
19725,2.7e-05,74.125.24.0-255,1484,1703,96,306365
19726,3.1e-05,172.31.47.0-255,66,1769,96,306365
19727,3.5e-05,74.125.24.0-255,2902,4671,96,306365
19728,3.8e-05,172.31.47.0-255,66,4737,96,306365
19729,4e-05,74.125.24.0-255,1484,6221,96,306365
19730,4.3e-05,172.31.47.0-255,66,6287,96,306365
19731,7.1e-05,74.125.24.0-255,5738,12025,96,306365
19732,7.3e-05,172.31.47.0-255,66,12091,96,306365
19733,7.6e-05,74.125.24.0-255,2092,14183,96,306365
19734,7.9e-05,172.31.47.0-255,66,14249,96,306365
19735,0.000151,74.125.24.0-255,1484,15733,96,306365
19736,0.000155,172.31.47.0-255,66,15799,96,306365
19737,0.000161,74.125.24.0-255,2902,18701,96,306365
19738,0.000163,172.31.47.0-255,66,18767,96,306365
19739,0.000167,74.125.24.0-255,2902,21669,96,306365
19740,0.000168,172.31.47.0-255,66,21735,96,306365
19741,0.000191,74.125.24.0-255,2902,24637,96,306365
19742,0.000193,172.31.47.0-255,66,24703,96,306365
19743,0.000196,74.125.24.0-255,1484,26187,96,306365
19744,0.000198,172.31.47.0-255,66,26253,96,306365
19745,0.000213,74.125.24.0-255,5738,31991,96,306365
19746,0.000215,172.31.47.0-255,66,32057,96,306365
19747,0.000243,74.125.24.0-255,6797,38854,96,306365
19748,0.000245,172.31.47.0-255,66,38920,96,306365
19749,0.000256,172.31.47.0-255,66,38986,96,306365
19750,0.000278,74.125.24.0-255,5738,44724,96,306365
19751,0.000281,172.31.47.0-255,66,44790,96,306365
19752,0.000302,172.31.47.0-255,66,44856,96,306365
19753,0.000318,74.125.24.0-255,114,44970,96,306365
19754,0.000332,74.125.24.0-255,331,45301,96,306365
19755,0.000682,172.31.47.0-255,66,45367,96,306365
19756,0.000792,74.125.24.0-255,1484,46851,96,306365
19757,0.000798,74.125.24.0-255,2902,49753,96,306365
19758,0.000801,172.31.47.0-255,66,49819,96,306365
19759,0.000807,74.125.24.0-255,5738,55557,96,306365
19760,0.000809,172.31.47.0-255,66,55623,96,306365
19761,0.000831,74.125.24.0-255,7156,62779,96,306365
19762,0.000834,172.31.47.0-255,66,62845,96,306365
19763,0.000855,74.125.24.0-255,5738,68583,96,306365
19764,0.000857,172.31.47.0-255,66,68649,96,306365
19765,0.000868,172.31.47.0-255,66,68715,96,306365
19766,0.001619,74.125.24.0-255,1484,70199,96,306365
19767,0.001636,74.125.24.0-255,2902,73101,96,306365
19768,0.00164,172.31.47.0-255,66,73167,96,306365
19769,0.001646,74.125.24.0-255,2902,76069,96,306365
19770,0.001648,172.31.47.0-255,66,76135,96,306365
19771,0.001662,74.125.24.0-255,2902,79037,96,306365
19772,0.001664,172.31.47.0-255,66,79103,96,306365
19773,0.001676,74.125.24.0-255,2902,82005,96,306365
19774,0.001678,172.31.47.0-255,66,82071,96,306365
19775,0.001697,74.125.24.0-255,7156,89227,96,306365
19776,0.001699,172.31.47.0-255,66,89293,96,306365
19777,0.001725,74.125.24.0-255,4320,93613,96,306365
19778,0.001727,172.31.47.0-255,66,93679,96,306365
19779,0.00175,172.31.47.0-255,66,93745,96,306365
19780,0.001781,74.125.24.0-255,1484,95229,96,306365
19781,0.001798,74.125.24.0-255,2902,98131,96,306365
19782,0.0018,172.31.47.0-255,66,98197,96,306365
19783,0.001804,74.125.24.0-255,2902,101099,96,306365
19784,0.001807,172.31.47.0-255,66,101165,96,306365
19785,0.001818,74.125.24.0-255,2902,104067,96,306365
19786,0.00182,172.31.47.0-255,66,104133,96,306365
19787,0.001823,74.125.24.0-255,1484,105617,96,306365
19788,0.001837,74.125.24.0-255,1484,107101,96,306365
19789,0.001839,172.31.47.0-255,66,107167,96,306365
19790,0.001842,74.125.24.0-255,1484,108651,96,306365
19791,0.00187,172.31.47.0-255,66,108717,96,306365
19792,0.001875,74.125.24.0-255,4320,113037,96,306365
19793,0.001878,172.31.47.0-255,66,113103,96,306365
19794,0.001893,74.125.24.0-255,6438,119541,96,306365
19795,0.001896,172.31.47.0-255,66,119607,96,306365
19796,0.002012,74.125.24.0-255,1484,121091,96,306365
19797,0.002015,74.125.24.0-255,1484,122575,96,306365
19798,0.002017,172.31.47.0-255,66,122641,96,306365
19799,0.002032,74.125.24.0-255,1484,124125,96,306365
19800,0.002038,74.125.24.0-255,5738,129863,96,306365
19801,0.002041,172.31.47.0-255,66,129929,96,306365
19802,0.002075,172.31.47.0-255,66,129995,96,306365
19803,0.002077,74.125.24.0-255,1484,131479,96,306365
19804,0.002099,172.31.47.0-255,66,131545,96,306365
19805,0.002121,74.125.24.0-255,4320,135865,96,306365
19806,0.002124,172.31.47.0-255,66,135931,96,306365
19807,0.002153,172.31.47.0-255,66,135997,96,306365
19808,0.002165,74.125.24.0-255,5738,141735,96,306365
19809,0.002168,172.31.47.0-255,66,141801,96,306365
19810,0.002177,172.31.47.0-255,66,141867,96,306365
19811,0.004483,74.125.24.0-255,5738,147605,96,306365
19812,0.004489,172.31.47.0-255,66,147671,96,306365
19813,0.006792,74.125.24.0-255,5738,153409,96,306365
19814,0.006797,172.31.47.0-255,66,153475,96,306365
19815,0.009078,74.125.24.0-255,4320,157795,96,306365
19816,0.009083,172.31.47.0-255,66,157861,96,306365
19817,0.009105,74.125.24.0-255,1484,159345,96,306365
19818,0.011364,74.125.24.0-255,4320,163665,96,306365
19819,0.011371,172.31.47.0-255,66,163731,96,306365
19820,0.01367,74.125.24.0-255,5738,169469,96,306365
19821,0.013678,172.31.47.0-255,66,169535,96,306365
19822,0.015966,74.125.24.0-255,5738,175273,96,306365
19823,0.015981,172.31.47.0-255,66,175339,96,306365
19824,0.018299,74.125.24.0-255,5738,181077,96,306365
19825,0.018305,172.31.47.0-255,66,181143,96,306365
19826,0.020618,74.125.24.0-255,4320,185463,96,306365
19827,0.020625,172.31.47.0-255,66,185529,96,306365
19828,0.020661,74.125.24.0-255,1484,187013,96,306365
19829,0.022957,74.125.24.0-255,4320,191333,96,306365
19830,0.022964,172.31.47.0-255,66,191399,96,306365
19831,0.025112,172.31.47.0-255,171,191570,96,306365
19832,0.02514,172.31.47.0-255,1134,192704,96,306365
19833,0.025168,172.31.47.0-255,1514,194218,96,306365
19834,0.02517,172.31.47.0-255,1277,195495,96,306365
19835,0.025294,74.125.24.0-255,5738,201233,96,306365
19836,0.025299,172.31.47.0-255,66,201299,96,306365
19837,0.02667,104.244.42.0-255,66,201365,96,306365
19838,0.026706,104.244.42.0-255,66,201431,96,306365
19839,0.026708,104.244.42.0-255,66,201497,96,306365
19840,0.027608,74.125.24.0-255,5738,207235,96,306365
19841,0.027615,172.31.47.0-255,66,207301,96,306365
19842,0.029949,74.125.24.0-255,4320,211621,96,306365
19843,0.029954,172.31.47.0-255,66,211687,96,306365
19844,0.029981,74.125.24.0-255,1484,213171,96,306365
19845,0.032247,74.125.24.0-255,4320,217491,96,306365
19846,0.032252,172.31.47.0-255,66,217557,96,306365
19847,0.03458,74.125.24.0-255,5738,223295,96,306365
19848,0.034585,172.31.47.0-255,66,223361,96,306365
19849,0.036901,74.125.24.0-255,4320,227681,96,306365
19850,0.036906,172.31.47.0-255,66,227747,96,306365
19851,0.036928,74.125.24.0-255,1484,229231,96,306365
19852,0.039206,74.125.24.0-255,4320,233551,96,306365
19853,0.039211,172.31.47.0-255,66,233617,96,306365
19854,0.041501,74.125.24.0-255,5738,239355,96,306365
19855,0.041506,172.31.47.0-255,66,239421,96,306365
19856,0.043819,74.125.24.0-255,5738,245159,96,306365
19857,0.043823,172.31.47.0-255,66,245225,96,306365
19858,0.046134,74.125.24.0-255,4320,249545,96,306365
19859,0.046138,172.31.47.0-255,66,249611,96,306365
19860,0.046161,74.125.24.0-255,1484,251095,96,306365
19861,0.048449,74.125.24.0-255,4320,255415,96,306365
19862,0.048454,172.31.47.0-255,66,255481,96,306365
19863,0.050804,74.125.24.0-255,5738,261219,96,306365
19864,0.050808,172.31.47.0-255,66,261285,96,306365
19865,0.053107,74.125.24.0-255,5738,267023,96,306365
19866,0.053113,172.31.47.0-255,66,267089,96,306365
19867,0.055401,74.125.24.0-255,5738,272827,96,306365
19868,0.055407,172.31.47.0-255,66,272893,96,306365
19869,0.057744,74.125.24.0-255,5738,278631,96,306365
19870,0.057749,172.31.47.0-255,66,278697,96,306365
19871,0.060024,74.125.24.0-255,5738,284435,96,306365
19872,0.060029,172.31.47.0-255,66,284501,96,306365
19873,0.062314,74.125.24.0-255,5738,290239,96,306365
19874,0.062319,172.31.47.0-255,66,290305,96,306365
19875,0.06459,74.125.24.0-255,5738,296043,96,306365
19876,0.064595,172.31.47.0-255,66,296109,96,306365
19877,0.066921,74.125.24.0-255,4320,300429,96,306365
19878,0.066925,172.31.47.0-255,66,300495,96,306365
19879,0.066953,74.125.24.0-255,1484,301979,96,306365
19880,0.069264,74.125.24.0-255,4320,306299,96,306365
19881,0.06927,172.31.47.0-255,66,306365,96,306365
19882,0.0,172.217.194.0-255,302,302,96,247763
19883,2.5e-05,172.31.47.0-255,66,368,96,247763
19884,3e-05,172.217.194.0-255,1484,1852,96,247763
19885,3.4e-05,172.31.47.0-255,66,1918,96,247763
19886,4e-05,172.217.194.0-255,4320,6238,96,247763
19887,4.2e-05,172.31.47.0-255,66,6304,96,247763
19888,8.9e-05,172.31.47.0-255,66,6370,96,247763
19889,9.5e-05,172.217.194.0-255,7156,13526,96,247763
19890,9.7e-05,172.31.47.0-255,66,13592,96,247763
19891,0.000149,172.31.47.0-255,66,13658,96,247763
19892,0.000198,172.217.194.0-255,1484,15142,96,247763
19893,0.000202,172.31.47.0-255,66,15208,96,247763
19894,0.000224,172.217.194.0-255,2902,18110,96,247763
19895,0.000227,172.31.47.0-255,66,18176,96,247763
19896,0.000233,172.217.194.0-255,5738,23914,96,247763
19897,0.000235,172.31.47.0-255,66,23980,96,247763
19898,0.000238,172.217.194.0-255,2902,26882,96,247763
19899,0.00024,172.31.47.0-255,66,26948,96,247763
19900,0.000261,172.217.194.0-255,2902,29850,96,247763
19901,0.000266,172.31.47.0-255,66,29916,96,247763
19902,0.000301,172.31.47.0-255,66,29982,96,247763
19903,0.000304,172.217.194.0-255,1484,31466,96,247763
19904,0.000306,172.31.47.0-255,66,31532,96,247763
19905,0.000351,172.217.194.0-255,3132,34664,96,247763
19906,0.000356,172.31.47.0-255,66,34730,96,247763
19907,0.000735,172.217.194.0-255,1484,36214,96,247763
19908,0.00074,172.31.47.0-255,66,36280,96,247763
19909,0.000745,172.217.194.0-255,2902,39182,96,247763
19910,0.000747,172.31.47.0-255,66,39248,96,247763
19911,0.000751,172.217.194.0-255,2902,42150,96,247763
19912,0.000758,172.31.47.0-255,66,42216,96,247763
19913,0.00078,172.217.194.0-255,7156,49372,96,247763
19914,0.000787,172.217.194.0-255,5738,55110,96,247763
19915,0.000788,172.31.47.0-255,66,55176,96,247763
19916,0.000792,172.31.47.0-255,66,55242,96,247763
19917,0.000829,172.31.47.0-255,66,55308,96,247763
19918,0.00083,172.217.194.0-255,3602,58910,96,247763
19919,0.000834,172.31.47.0-255,66,58976,96,247763
19920,0.001092,172.217.194.0-255,1484,60460,96,247763
19921,0.0011,172.217.194.0-255,2902,63362,96,247763
19922,0.001104,172.31.47.0-255,66,63428,96,247763
19923,0.00111,172.217.194.0-255,2902,66330,96,247763
19924,0.001128,172.217.194.0-255,2902,69232,96,247763
19925,0.001145,172.217.194.0-255,5738,74970,96,247763
19926,0.001164,172.217.194.0-255,7156,82126,96,247763
19927,0.00124,172.217.194.0-255,766,82892,96,247763
19928,0.001264,172.217.194.0-255,1484,84376,96,247763
19929,0.00128,172.217.194.0-255,2902,87278,96,247763
19930,0.001284,172.217.194.0-255,2902,90180,96,247763
19931,0.001298,172.217.194.0-255,2902,93082,96,247763
19932,0.001312,172.217.194.0-255,4320,97402,96,247763
19933,0.001382,172.217.194.0-255,2184,99586,96,247763
19934,0.00199,172.31.47.0-255,66,99652,96,247763
19935,0.002549,172.217.194.0-255,1484,101136,96,247763
19936,0.004545,172.217.194.0-255,4320,105456,96,247763
19937,0.004549,172.31.47.0-255,66,105522,96,247763
19938,0.007112,172.217.194.0-255,5738,111260,96,247763
19939,0.009598,172.31.47.0-255,66,111326,96,247763
19940,0.012161,172.217.194.0-255,5738,117064,96,247763
19941,0.012172,172.31.47.0-255,66,117130,96,247763
19942,0.014709,172.217.194.0-255,5738,122868,96,247763
19943,0.014716,172.31.47.0-255,66,122934,96,247763
19944,0.017261,172.217.194.0-255,5738,128672,96,247763
19945,0.017266,172.31.47.0-255,66,128738,96,247763
19946,0.019665,172.31.47.0-255,172,128910,96,247763
19947,0.019702,172.31.47.0-255,1109,130019,96,247763
19948,0.019749,172.31.47.0-255,1514,131533,96,247763
19949,0.019751,172.31.47.0-255,1304,132837,96,247763
19950,0.01984,172.217.194.0-255,5738,138575,96,247763
19951,0.019845,172.31.47.0-255,66,138641,96,247763
19952,0.021189,104.244.42.0-255,66,138707,96,247763
19953,0.021233,104.244.42.0-255,66,138773,96,247763
19954,0.021271,104.244.42.0-255,66,138839,96,247763
19955,0.022361,172.217.194.0-255,4320,143159,96,247763
19956,0.022366,172.31.47.0-255,66,143225,96,247763
19957,0.02239,172.217.194.0-255,1484,144709,96,247763
19958,0.024912,172.217.194.0-255,4320,149029,96,247763
19959,0.024918,172.31.47.0-255,66,149095,96,247763
19960,0.027449,172.217.194.0-255,5738,154833,96,247763
19961,0.027497,172.31.47.0-255,66,154899,96,247763
19962,0.03004,172.217.194.0-255,5738,160637,96,247763
19963,0.030046,172.31.47.0-255,66,160703,96,247763
19964,0.032593,172.217.194.0-255,5738,166441,96,247763
19965,0.032598,172.31.47.0-255,66,166507,96,247763
19966,0.035141,172.217.194.0-255,5738,172245,96,247763
19967,0.035148,172.31.47.0-255,66,172311,96,247763
19968,0.037683,172.217.194.0-255,5738,178049,96,247763
19969,0.037688,172.31.47.0-255,66,178115,96,247763
19970,0.040248,172.217.194.0-255,5738,183853,96,247763
19971,0.040253,172.31.47.0-255,66,183919,96,247763
19972,0.04281,172.217.194.0-255,5738,189657,96,247763
19973,0.042815,172.31.47.0-255,66,189723,96,247763
19974,0.045375,172.217.194.0-255,5738,195461,96,247763
19975,0.04538,172.31.47.0-255,66,195527,96,247763
19976,0.047941,172.217.194.0-255,5738,201265,96,247763
19977,0.047947,172.31.47.0-255,66,201331,96,247763
19978,0.050509,172.217.194.0-255,5738,207069,96,247763
19979,0.050514,172.31.47.0-255,66,207135,96,247763
19980,0.053049,172.217.194.0-255,5738,212873,96,247763
19981,0.053054,172.31.47.0-255,66,212939,96,247763
19982,0.055608,172.217.194.0-255,5738,218677,96,247763
19983,0.055614,172.31.47.0-255,66,218743,96,247763
19984,0.058164,172.217.194.0-255,5738,224481,96,247763
19985,0.058169,172.31.47.0-255,66,224547,96,247763
19986,0.060709,172.217.194.0-255,5738,230285,96,247763
19987,0.060715,172.31.47.0-255,66,230351,96,247763
19988,0.063265,172.217.194.0-255,5738,236089,96,247763
19989,0.063271,172.31.47.0-255,66,236155,96,247763
19990,0.065814,172.217.194.0-255,5738,241893,96,247763
19991,0.065822,172.31.47.0-255,66,241959,96,247763
19992,0.068376,172.217.194.0-255,5738,247697,96,247763
19993,0.068382,172.31.47.0-255,66,247763,96,247763
19994,0.0,172.31.47.0-255,105,105,96,276
19995,0.001579,157.240.13.0-255,105,210,96,276
19996,0.001591,172.31.47.0-255,66,276,96,276
19997,0.0,172.217.194.0-255,153,153,96,311010
19998,3.4e-05,172.31.47.0-255,66,219,96,311010
19999,4e-05,172.217.194.0-255,1484,1703,96,311010
20000,4.4e-05,172.31.47.0-255,66,1769,96,311010
20001,4.9e-05,172.217.194.0-255,2902,4671,96,311010
20002,5.9e-05,172.31.47.0-255,66,4737,96,311010
20003,6.5e-05,172.217.194.0-255,4320,9057,96,311010
20004,6.9e-05,172.31.47.0-255,66,9123,96,311010
20005,8e-05,172.31.47.0-255,66,9189,96,311010
20006,8.5e-05,172.217.194.0-255,4320,13509,96,311010
20007,8.9e-05,172.31.47.0-255,66,13575,96,311010
20008,0.000136,172.217.194.0-255,1484,15059,96,311010
20009,0.000139,172.31.47.0-255,66,15125,96,311010
20010,0.000171,172.217.194.0-255,6797,21922,96,311010
20011,0.000174,172.31.47.0-255,66,21988,96,311010
20012,0.000317,172.217.194.0-255,1484,23472,96,311010
20013,0.000322,172.31.47.0-255,66,23538,96,311010
20014,0.000353,172.217.194.0-255,2902,26440,96,311010
20015,0.000357,172.31.47.0-255,66,26506,96,311010
20016,0.000361,172.217.194.0-255,2902,29408,96,311010
20017,0.000363,172.31.47.0-255,66,29474,96,311010
20018,0.000366,172.217.194.0-255,1484,30958,96,311010
20019,0.000368,172.31.47.0-255,66,31024,96,311010
20020,0.0004,172.217.194.0-255,5738,36762,96,311010
20021,0.000404,172.31.47.0-255,66,36828,96,311010
20022,0.00041,172.217.194.0-255,5379,42207,96,311010
20023,0.000413,172.31.47.0-255,66,42273,96,311010
20024,0.000424,172.217.194.0-255,5738,48011,96,311010
20025,0.000427,172.31.47.0-255,66,48077,96,311010
20026,0.000465,172.31.47.0-255,66,48143,96,311010
20027,0.000499,172.217.194.0-255,118,48261,96,311010
20028,0.000655,172.217.194.0-255,1484,49745,96,311010
20029,0.00066,172.31.47.0-255,66,49811,96,311010
20030,0.000686,172.217.194.0-255,2902,52713,96,311010
20031,0.000689,172.31.47.0-255,66,52779,96,311010
20032,0.000695,172.217.194.0-255,5738,58517,96,311010
20033,0.000709,172.31.47.0-255,66,58583,96,311010
20034,0.000717,172.217.194.0-255,4320,62903,96,311010
20035,0.000724,172.31.47.0-255,66,62969,96,311010
20036,0.000744,172.217.194.0-255,5738,68707,96,311010
20037,0.000748,172.217.194.0-255,1484,70191,96,311010
20038,0.000751,172.31.47.0-255,66,70257,96,311010
20039,0.000796,172.31.47.0-255,66,70323,96,311010
20040,0.00081,172.31.47.0-255,66,70389,96,311010
20041,0.000862,172.217.194.0-255,2543,72932,96,311010
20042,0.000865,172.31.47.0-255,66,72998,96,311010
20043,0.000893,172.217.194.0-255,1484,74482,96,311010
20044,0.000915,172.217.194.0-255,2902,77384,96,311010
20045,0.00092,172.217.194.0-255,2902,80286,96,311010
20046,0.000921,172.31.47.0-255,66,80352,96,311010
20047,0.00094,172.217.194.0-255,2902,83254,96,311010
20048,0.000944,172.31.47.0-255,66,83320,96,311010
20049,0.000973,172.217.194.0-255,7156,90476,96,311010
20050,0.000981,172.31.47.0-255,66,90542,96,311010
20051,0.00102,172.217.194.0-255,2184,92726,96,311010
20052,0.00103,172.31.47.0-255,66,92792,96,311010
20053,0.001119,172.217.194.0-255,1484,94276,96,311010
20054,0.001135,172.217.194.0-255,2902,97178,96,311010
20055,0.001138,172.31.47.0-255,66,97244,96,311010
20056,0.001168,172.217.194.0-255,2902,100146,96,311010
20057,0.001173,172.217.194.0-255,4320,104466,96,311010
20058,0.001172,172.31.47.0-255,66,104532,96,311010
20059,0.001184,172.217.194.0-255,2902,107434,96,311010
20060,0.001187,172.31.47.0-255,66,107500,96,311010
20061,0.001191,172.31.47.0-255,66,107566,96,311010
20062,0.001217,172.217.194.0-255,2543,110109,96,311010
20063,0.001222,172.31.47.0-255,66,110175,96,311010
20064,0.001348,172.217.194.0-255,1484,111659,96,311010
20065,0.001365,172.217.194.0-255,2902,114561,96,311010
20066,0.001368,172.31.47.0-255,66,114627,96,311010
20067,0.001387,172.217.194.0-255,2902,117529,96,311010
20068,0.001395,172.31.47.0-255,66,117595,96,311010
20069,0.001422,172.217.194.0-255,2902,120497,96,311010
20070,0.001434,172.31.47.0-255,66,120563,96,311010
20071,0.00144,172.217.194.0-255,7156,127719,96,311010
20072,0.001439,172.31.47.0-255,66,127785,96,311010
20073,0.001453,172.31.47.0-255,66,127851,96,311010
20074,0.001475,172.217.194.0-255,3602,131453,96,311010
20075,0.001487,172.31.47.0-255,66,131519,96,311010
20076,0.001674,172.217.194.0-255,1484,133003,96,311010
20077,0.00168,172.217.194.0-255,2902,135905,96,311010
20078,0.001683,172.31.47.0-255,66,135971,96,311010
20079,0.001688,172.217.194.0-255,4320,140291,96,311010
20080,0.001701,172.31.47.0-255,66,140357,96,311010
20081,0.001739,172.217.194.0-255,1484,141841,96,311010
20082,0.001758,172.217.194.0-255,7156,148997,96,311010
20083,0.001788,172.217.194.0-255,5020,154017,96,311010
20084,0.00184,172.217.194.0-255,3602,157619,96,311010
20085,0.008161,172.31.47.0-255,66,157685,96,311010
20086,0.010191,172.217.194.0-255,5738,163423,96,311010
20087,0.010201,172.31.47.0-255,66,163489,96,311010
20088,0.012227,172.217.194.0-255,5738,169227,96,311010
20089,0.012236,172.31.47.0-255,66,169293,96,311010
20090,0.014238,172.217.194.0-255,5738,175031,96,311010
20091,0.014245,172.31.47.0-255,66,175097,96,311010
20092,0.016254,172.217.194.0-255,5738,180835,96,311010
20093,0.017824,172.31.47.0-255,66,180901,96,311010
20094,0.019866,172.217.194.0-255,5738,186639,96,311010
20095,0.019878,172.31.47.0-255,66,186705,96,311010
20096,0.021889,172.217.194.0-255,5738,192443,96,311010
20097,0.021898,172.31.47.0-255,66,192509,96,311010
20098,0.023918,172.217.194.0-255,5738,198247,96,311010
20099,0.023927,172.31.47.0-255,66,198313,96,311010
20100,0.025918,172.217.194.0-255,5738,204051,96,311010
20101,0.025925,172.31.47.0-255,66,204117,96,311010
20102,0.027924,172.217.194.0-255,5738,209855,96,311010
20103,0.027934,172.31.47.0-255,66,209921,96,311010
20104,0.02994,172.217.194.0-255,5738,215659,96,311010
20105,0.029948,172.31.47.0-255,66,215725,96,311010
20106,0.031163,172.31.47.0-255,172,215897,96,311010
20107,0.031195,172.31.47.0-255,1105,217002,96,311010
20108,0.031234,172.31.47.0-255,1514,218516,96,311010
20109,0.031236,172.31.47.0-255,1306,219822,96,311010
20110,0.031948,172.217.194.0-255,5738,225560,96,311010
20111,0.031957,172.31.47.0-255,66,225626,96,311010
20112,0.032709,104.244.42.0-255,66,225692,96,311010
20113,0.032751,104.244.42.0-255,66,225758,96,311010
20114,0.032793,104.244.42.0-255,66,225824,96,311010
20115,0.033947,172.217.194.0-255,5738,231562,96,311010
20116,0.033953,172.31.47.0-255,66,231628,96,311010
20117,0.035972,172.217.194.0-255,4320,235948,96,311010
20118,0.035977,172.31.47.0-255,66,236014,96,311010
20119,0.036006,172.217.194.0-255,1484,237498,96,311010
20120,0.037967,172.217.194.0-255,4320,241818,96,311010
20121,0.037972,172.31.47.0-255,66,241884,96,311010
20122,0.039963,172.217.194.0-255,5738,247622,96,311010
20123,0.040281,172.31.47.0-255,66,247688,96,311010
20124,0.042289,172.217.194.0-255,5738,253426,96,311010
20125,0.042295,172.31.47.0-255,66,253492,96,311010
20126,0.044319,172.217.194.0-255,5738,259230,96,311010
20127,0.044325,172.31.47.0-255,66,259296,96,311010
20128,0.046331,172.217.194.0-255,5738,265034,96,311010
20129,0.046337,172.31.47.0-255,66,265100,96,311010
20130,0.048353,172.217.194.0-255,5738,270838,96,311010
20131,0.048358,172.31.47.0-255,66,270904,96,311010
20132,0.050399,172.217.194.0-255,5738,276642,96,311010
20133,0.050404,172.31.47.0-255,66,276708,96,311010
20134,0.0524,172.217.194.0-255,5738,282446,96,311010
20135,0.052406,172.31.47.0-255,66,282512,96,311010
20136,0.054422,172.217.194.0-255,5738,288250,96,311010
20137,0.054432,172.31.47.0-255,66,288316,96,311010
20138,0.056425,172.217.194.0-255,5738,294054,96,311010
20139,0.056434,172.31.47.0-255,66,294120,96,311010
20140,0.058431,172.217.194.0-255,5738,299858,96,311010
20141,0.05844,172.31.47.0-255,66,299924,96,311010
20142,0.060446,172.217.194.0-255,5738,305662,96,311010
20143,0.060451,172.31.47.0-255,66,305728,96,311010
20144,0.06243,172.217.194.0-255,2902,308630,96,311010
20145,0.062436,172.31.47.0-255,66,308696,96,311010
20146,0.062465,172.217.194.0-255,2077,310773,96,311010
20147,0.062477,172.31.47.0-255,66,310839,96,311010
20148,0.062626,172.31.47.0-255,105,310944,96,311010
20149,0.064572,172.217.194.0-255,66,311010,96,311010
20150,0.0,172.217.26.0-255,153,153,96,253267
20151,2.6e-05,172.31.47.0-255,66,219,96,253267
20152,3.2e-05,172.217.26.0-255,1484,1703,96,253267
20153,3.6e-05,172.31.47.0-255,66,1769,96,253267
20154,4e-05,172.217.26.0-255,2902,4671,96,253267
20155,4.2e-05,172.31.47.0-255,66,4737,96,253267
20156,0.000111,172.217.26.0-255,1484,6221,96,253267
20157,0.000115,172.31.47.0-255,66,6287,96,253267
20158,0.000136,172.217.26.0-255,5738,12025,96,253267
20159,0.000139,172.31.47.0-255,66,12091,96,253267
20160,0.000311,172.217.26.0-255,2102,14193,96,253267
20161,0.000315,172.31.47.0-255,66,14259,96,253267
20162,0.000369,172.217.26.0-255,2902,17161,96,253267
20163,0.000372,172.31.47.0-255,66,17227,96,253267
20164,0.000404,172.31.47.0-255,66,17293,96,253267
20165,0.000684,172.217.26.0-255,5379,22672,96,253267
20166,0.00069,172.31.47.0-255,66,22738,96,253267
20167,0.000845,172.31.47.0-255,66,22804,96,253267
20168,0.000885,172.31.47.0-255,66,22870,96,253267
20169,0.001312,172.31.47.0-255,66,22936,96,253267
20170,0.001345,172.217.26.0-255,7125,30061,96,253267
20171,0.001348,172.31.47.0-255,66,30127,96,253267
20172,0.001778,172.31.47.0-255,66,30193,96,253267
20173,0.001812,172.31.47.0-255,66,30259,96,253267
20174,0.002274,172.217.26.0-255,7156,37415,96,253267
20175,0.002278,172.31.47.0-255,66,37481,96,253267
20176,0.002314,172.31.47.0-255,66,37547,96,253267
20177,0.002701,172.217.26.0-255,7156,44703,96,253267
20178,0.002704,172.31.47.0-255,66,44769,96,253267
20179,0.002737,172.31.47.0-255,66,44835,96,253267
20180,0.002766,172.217.26.0-255,6701,51536,96,253267
20181,0.002769,172.31.47.0-255,66,51602,96,253267
20182,0.004711,172.217.26.0-255,5738,57340,96,253267
20183,0.004716,172.31.47.0-255,66,57406,96,253267
20184,0.006662,172.217.26.0-255,5738,63144,96,253267
20185,0.006668,172.31.47.0-255,66,63210,96,253267
20186,0.008612,172.217.26.0-255,5738,68948,96,253267
20187,0.008618,172.31.47.0-255,66,69014,96,253267
20188,0.010574,172.217.26.0-255,5738,74752,96,253267
20189,0.010586,172.31.47.0-255,66,74818,96,253267
20190,0.012536,172.217.26.0-255,5738,80556,96,253267
20191,0.012547,172.31.47.0-255,66,80622,96,253267
20192,0.014509,172.217.26.0-255,5738,86360,96,253267
20193,0.014522,172.31.47.0-255,66,86426,96,253267
20194,0.016477,172.217.26.0-255,5738,92164,96,253267
20195,0.016486,172.31.47.0-255,66,92230,96,253267
20196,0.018465,172.217.26.0-255,5738,97968,96,253267
20197,0.018472,172.31.47.0-255,66,98034,96,253267
20198,0.020422,172.217.26.0-255,5738,103772,96,253267
20199,0.020429,172.31.47.0-255,66,103838,96,253267
20200,0.021407,172.31.47.0-255,172,104010,96,253267
20201,0.02144,172.31.47.0-255,1104,105114,96,253267
20202,0.021498,172.31.47.0-255,1514,106628,96,253267
20203,0.0215,172.31.47.0-255,1307,107935,96,253267
20204,0.022378,172.217.26.0-255,5738,113673,96,253267
20205,0.022385,172.31.47.0-255,66,113739,96,253267
20206,0.023,104.244.42.0-255,66,113805,96,253267
20207,0.023007,104.244.42.0-255,66,113871,96,253267
20208,0.023083,104.244.42.0-255,66,113937,96,253267
20209,0.024322,172.217.26.0-255,2902,116839,96,253267
20210,0.024327,172.31.47.0-255,66,116905,96,253267
20211,0.024363,172.217.26.0-255,2902,119807,96,253267
20212,0.024366,172.31.47.0-255,66,119873,96,253267
20213,0.026271,172.217.26.0-255,2902,122775,96,253267
20214,0.026277,172.31.47.0-255,66,122841,96,253267
20215,0.026316,172.217.26.0-255,2902,125743,96,253267
20216,0.026322,172.31.47.0-255,66,125809,96,253267
20217,0.028231,172.217.26.0-255,2902,128711,96,253267
20218,0.028236,172.31.47.0-255,66,128777,96,253267
20219,0.028268,172.217.26.0-255,2902,131679,96,253267
20220,0.028271,172.31.47.0-255,66,131745,96,253267
20221,0.030182,172.217.26.0-255,2902,134647,96,253267
20222,0.030188,172.31.47.0-255,66,134713,96,253267
20223,0.030226,172.217.26.0-255,2902,137615,96,253267
20224,0.030229,172.31.47.0-255,66,137681,96,253267
20225,0.032126,172.217.26.0-255,2902,140583,96,253267
20226,0.032132,172.31.47.0-255,66,140649,96,253267
20227,0.032163,172.217.26.0-255,2902,143551,96,253267
20228,0.032166,172.31.47.0-255,66,143617,96,253267
20229,0.034093,172.217.26.0-255,5738,149355,96,253267
20230,0.034098,172.31.47.0-255,66,149421,96,253267
20231,0.036039,172.217.26.0-255,5738,155159,96,253267
20232,0.036043,172.31.47.0-255,66,155225,96,253267
20233,0.037984,172.217.26.0-255,5738,160963,96,253267
20234,0.037988,172.31.47.0-255,66,161029,96,253267
20235,0.039923,172.217.26.0-255,4320,165349,96,253267
20236,0.039928,172.31.47.0-255,66,165415,96,253267
20237,0.039955,172.217.26.0-255,1484,166899,96,253267
20238,0.041868,172.217.26.0-255,4320,171219,96,253267
20239,0.041872,172.31.47.0-255,66,171285,96,253267
20240,0.043859,172.217.26.0-255,5738,177023,96,253267
20241,0.043864,172.31.47.0-255,66,177089,96,253267
20242,0.04584,172.217.26.0-255,5738,182827,96,253267
20243,0.045857,172.31.47.0-255,66,182893,96,253267
20244,0.047804,172.217.26.0-255,5738,188631,96,253267
20245,0.047816,172.31.47.0-255,66,188697,96,253267
20246,0.049802,172.217.26.0-255,5738,194435,96,253267
20247,0.049816,172.31.47.0-255,66,194501,96,253267
20248,0.051778,172.217.26.0-255,5738,200239,96,253267
20249,0.051793,172.31.47.0-255,66,200305,96,253267
20250,0.053741,172.217.26.0-255,5738,206043,96,253267
20251,0.053747,172.31.47.0-255,66,206109,96,253267
20252,0.055706,172.217.26.0-255,5738,211847,96,253267
20253,0.055713,172.31.47.0-255,66,211913,96,253267
20254,0.057659,172.217.26.0-255,5738,217651,96,253267
20255,0.057664,172.31.47.0-255,66,217717,96,253267
20256,0.059612,172.217.26.0-255,2902,220619,96,253267
20257,0.059617,172.31.47.0-255,66,220685,96,253267
20258,0.059649,172.217.26.0-255,2902,223587,96,253267
20259,0.059653,172.31.47.0-255,66,223653,96,253267
20260,0.06155,172.217.26.0-255,2902,226555,96,253267
20261,0.061555,172.31.47.0-255,66,226621,96,253267
20262,0.061578,172.217.26.0-255,2902,229523,96,253267
20263,0.061581,172.31.47.0-255,66,229589,96,253267
20264,0.063498,172.217.26.0-255,2902,232491,96,253267
20265,0.063504,172.31.47.0-255,66,232557,96,253267
20266,0.063539,172.217.26.0-255,2902,235459,96,253267
20267,0.063543,172.31.47.0-255,66,235525,96,253267
20268,0.065452,172.217.26.0-255,2902,238427,96,253267
20269,0.065458,172.31.47.0-255,66,238493,96,253267
20270,0.065494,172.217.26.0-255,2902,241395,96,253267
20271,0.065497,172.31.47.0-255,66,241461,96,253267
20272,0.067395,172.217.26.0-255,2902,244363,96,253267
20273,0.0674,172.31.47.0-255,66,244429,96,253267
20274,0.067427,172.217.26.0-255,2902,247331,96,253267
20275,0.067429,172.31.47.0-255,66,247397,96,253267
20276,0.069349,172.217.26.0-255,1484,248881,96,253267
20277,0.069375,172.217.26.0-255,4320,253201,96,253267
20278,0.069378,172.31.47.0-255,66,253267,96,253267
20279,0.0,172.253.118.0-255,153,153,96,297505
20280,1.5e-05,172.31.47.0-255,66,219,96,297505
20281,2.2e-05,172.253.118.0-255,1484,1703,96,297505
20282,2.6e-05,172.31.47.0-255,66,1769,96,297505
20283,3.2e-05,172.253.118.0-255,2902,4671,96,297505
20284,3.5e-05,172.31.47.0-255,66,4737,96,297505
20285,5.2e-05,172.253.118.0-255,7156,11893,96,297505
20286,5.5e-05,172.31.47.0-255,66,11959,96,297505
20287,5.9e-05,172.253.118.0-255,2142,14101,96,297505
20288,6.1e-05,172.31.47.0-255,66,14167,96,297505
20289,0.000125,172.253.118.0-255,2902,17069,96,297505
20290,0.000128,172.31.47.0-255,66,17135,96,297505
20291,0.000135,172.253.118.0-255,7156,24291,96,297505
20292,0.000138,172.31.47.0-255,66,24357,96,297505
20293,0.000169,172.253.118.0-255,6797,31154,96,297505
20294,0.000172,172.31.47.0-255,66,31220,96,297505
20295,0.0003,172.253.118.0-255,1484,32704,96,297505
20296,0.000306,172.31.47.0-255,66,32770,96,297505
20297,0.00031,172.253.118.0-255,1484,34254,96,297505
20298,0.000313,172.31.47.0-255,66,34320,96,297505
20299,0.000331,172.253.118.0-255,1484,35804,96,297505
20300,0.000333,172.31.47.0-255,66,35870,96,297505
20301,0.00034,172.253.118.0-255,5738,41608,96,297505
20302,0.000343,172.31.47.0-255,66,41674,96,297505
20303,0.000382,172.31.47.0-255,66,41740,96,297505
20304,0.000409,172.253.118.0-255,2543,44283,96,297505
20305,0.000411,172.31.47.0-255,66,44349,96,297505
20306,0.000419,172.253.118.0-255,5738,50087,96,297505
20307,0.000421,172.31.47.0-255,66,50153,96,297505
20308,0.000443,172.253.118.0-255,5379,55532,96,297505
20309,0.000445,172.31.47.0-255,66,55598,96,297505
20310,0.000569,172.253.118.0-255,646,56244,96,297505
20311,0.000901,172.253.118.0-255,1484,57728,96,297505
20312,0.000907,172.31.47.0-255,66,57794,96,297505
20313,0.000913,172.253.118.0-255,2902,60696,96,297505
20314,0.000915,172.31.47.0-255,66,60762,96,297505
20315,0.000952,172.253.118.0-255,5738,66500,96,297505
20316,0.000955,172.31.47.0-255,66,66566,96,297505
20317,0.000958,172.253.118.0-255,1484,68050,96,297505
20318,0.000991,172.31.47.0-255,66,68116,96,297505
20319,0.000997,172.253.118.0-255,5738,73854,96,297505
20320,0.001,172.31.47.0-255,66,73920,96,297505
20321,0.001027,172.253.118.0-255,4320,78240,96,297505
20322,0.00103,172.31.47.0-255,66,78306,96,297505
20323,0.001052,172.253.118.0-255,766,79072,96,297505
20324,0.001173,172.253.118.0-255,1484,80556,96,297505
20325,0.001177,172.31.47.0-255,66,80622,96,297505
20326,0.001182,172.253.118.0-255,2902,83524,96,297505
20327,0.001184,172.31.47.0-255,66,83590,96,297505
20328,0.001202,172.253.118.0-255,5738,89328,96,297505
20329,0.001205,172.31.47.0-255,66,89394,96,297505
20330,0.001244,172.31.47.0-255,66,89460,96,297505
20331,0.001251,172.253.118.0-255,7156,96616,96,297505
20332,0.001253,172.31.47.0-255,66,96682,96,297505
20333,0.001281,172.253.118.0-255,1484,98166,96,297505
20334,0.001297,172.253.118.0-255,2184,100350,96,297505
20335,0.001301,172.31.47.0-255,66,100416,96,297505
20336,0.00142,172.253.118.0-255,1484,101900,96,297505
20337,0.001424,172.253.118.0-255,1484,103384,96,297505
20338,0.001427,172.31.47.0-255,66,103450,96,297505
20339,0.001453,172.253.118.0-255,1484,104934,96,297505
20340,0.001459,172.253.118.0-255,2902,107836,96,297505
20341,0.001461,172.31.47.0-255,66,107902,96,297505
20342,0.001484,172.253.118.0-255,2902,110804,96,297505
20343,0.001486,172.31.47.0-255,66,110870,96,297505
20344,0.001493,172.253.118.0-255,5738,116608,96,297505
20345,0.001494,172.31.47.0-255,66,116674,96,297505
20346,0.001535,172.253.118.0-255,4320,120994,96,297505
20347,0.001538,172.31.47.0-255,66,121060,96,297505
20348,0.001555,172.31.47.0-255,66,121126,96,297505
20349,0.001559,172.253.118.0-255,2184,123310,96,297505
20350,0.001561,172.31.47.0-255,66,123376,96,297505
20351,0.003829,172.253.118.0-255,2902,126278,96,297505
20352,0.003836,172.31.47.0-255,66,126344,96,297505
20353,0.003864,172.253.118.0-255,2902,129246,96,297505
20354,0.003866,172.31.47.0-255,66,129312,96,297505
20355,0.006119,172.253.118.0-255,2902,132214,96,297505
20356,0.006124,172.31.47.0-255,66,132280,96,297505
20357,0.006148,172.253.118.0-255,2902,135182,96,297505
20358,0.00615,172.31.47.0-255,66,135248,96,297505
20359,0.0084,172.253.118.0-255,2902,138150,96,297505
20360,0.008406,172.31.47.0-255,66,138216,96,297505
20361,0.008432,172.253.118.0-255,2902,141118,96,297505
20362,0.008435,172.31.47.0-255,66,141184,96,297505
20363,0.010687,172.253.118.0-255,2902,144086,96,297505
20364,0.010694,172.31.47.0-255,66,144152,96,297505
20365,0.010723,172.253.118.0-255,2902,147054,96,297505
20366,0.010724,172.31.47.0-255,66,147120,96,297505
20367,0.012969,172.253.118.0-255,2902,150022,96,297505
20368,0.01298,172.31.47.0-255,66,150088,96,297505
20369,0.013043,172.253.118.0-255,2902,152990,96,297505
20370,0.013046,172.31.47.0-255,66,153056,96,297505
20371,0.015265,172.253.118.0-255,2902,155958,96,297505
20372,0.015273,172.31.47.0-255,66,156024,96,297505
20373,0.01529,172.253.118.0-255,1484,157508,96,297505
20374,0.015307,172.253.118.0-255,1484,158992,96,297505
20375,0.01531,172.31.47.0-255,66,159058,96,297505
20376,0.017549,172.253.118.0-255,2902,161960,96,297505
20377,0.017555,172.31.47.0-255,66,162026,96,297505
20378,0.017585,172.253.118.0-255,2902,164928,96,297505
20379,0.017588,172.31.47.0-255,66,164994,96,297505
20380,0.019842,172.253.118.0-255,2902,167896,96,297505
20381,0.019849,172.31.47.0-255,66,167962,96,297505
20382,0.01988,172.253.118.0-255,2902,170864,96,297505
20383,0.019883,172.31.47.0-255,66,170930,96,297505
20384,0.022122,172.253.118.0-255,2902,173832,96,297505
20385,0.022128,172.31.47.0-255,66,173898,96,297505
20386,0.022159,172.253.118.0-255,2902,176800,96,297505
20387,0.022162,172.31.47.0-255,66,176866,96,297505
20388,0.022442,172.31.47.0-255,172,177038,96,297505
20389,0.022468,172.31.47.0-255,1101,178139,96,297505
20390,0.022515,172.31.47.0-255,1514,179653,96,297505
20391,0.022535,172.31.47.0-255,1310,180963,96,297505
20392,0.023971,104.244.42.0-255,66,181029,96,297505
20393,0.024017,104.244.42.0-255,66,181095,96,297505
20394,0.02405,104.244.42.0-255,66,181161,96,297505
20395,0.024413,172.253.118.0-255,2902,184063,96,297505
20396,0.02442,172.31.47.0-255,66,184129,96,297505
20397,0.024451,172.253.118.0-255,2902,187031,96,297505
20398,0.024454,172.31.47.0-255,66,187097,96,297505
20399,0.026694,172.253.118.0-255,2902,189999,96,297505
20400,0.0267,172.31.47.0-255,66,190065,96,297505
20401,0.026725,172.253.118.0-255,2902,192967,96,297505
20402,0.026727,172.31.47.0-255,66,193033,96,297505
20403,0.028992,172.253.118.0-255,5738,198771,96,297505
20404,0.028999,172.31.47.0-255,66,198837,96,297505
20405,0.03128,172.253.118.0-255,5738,204575,96,297505
20406,0.031287,172.31.47.0-255,66,204641,96,297505
20407,0.033561,172.253.118.0-255,5738,210379,96,297505
20408,0.033568,172.31.47.0-255,66,210445,96,297505
20409,0.035883,172.253.118.0-255,5738,216183,96,297505
20410,0.035901,172.31.47.0-255,66,216249,96,297505
20411,0.038201,172.253.118.0-255,5738,221987,96,297505
20412,0.038217,172.31.47.0-255,66,222053,96,297505
20413,0.040497,172.253.118.0-255,5738,227791,96,297505
20414,0.040504,172.31.47.0-255,66,227857,96,297505
20415,0.04281,172.253.118.0-255,5738,233595,96,297505
20416,0.042827,172.31.47.0-255,66,233661,96,297505
20417,0.045137,172.253.118.0-255,5738,239399,96,297505
20418,0.045152,172.31.47.0-255,66,239465,96,297505
20419,0.047444,172.253.118.0-255,5738,245203,96,297505
20420,0.047462,172.31.47.0-255,66,245269,96,297505
20421,0.049776,172.253.118.0-255,5738,251007,96,297505
20422,0.049793,172.31.47.0-255,66,251073,96,297505
20423,0.052085,172.253.118.0-255,5738,256811,96,297505
20424,0.052096,172.31.47.0-255,66,256877,96,297505
20425,0.05437,172.253.118.0-255,5738,262615,96,297505
20426,0.05438,172.31.47.0-255,66,262681,96,297505
20427,0.056668,172.253.118.0-255,5738,268419,96,297505
20428,0.056676,172.31.47.0-255,66,268485,96,297505
20429,0.058971,172.253.118.0-255,5738,274223,96,297505
20430,0.058977,172.31.47.0-255,66,274289,96,297505
20431,0.061271,172.253.118.0-255,5738,280027,96,297505
20432,0.061277,172.31.47.0-255,66,280093,96,297505
20433,0.063573,172.253.118.0-255,5738,285831,96,297505
20434,0.06358,172.31.47.0-255,66,285897,96,297505
20435,0.065868,172.253.118.0-255,5738,291635,96,297505
20436,0.065874,172.31.47.0-255,66,291701,96,297505
20437,0.068165,172.253.118.0-255,5738,297439,96,297505
20438,0.068171,172.31.47.0-255,66,297505,96,297505
20439,0.0,74.125.24.0-255,153,153,96,261390
20440,2e-05,172.31.47.0-255,66,219,96,261390
20441,2.7e-05,74.125.24.0-255,1484,1703,96,261390
20442,3.2e-05,172.31.47.0-255,66,1769,96,261390
20443,3.7e-05,74.125.24.0-255,2902,4671,96,261390
20444,4e-05,172.31.47.0-255,66,4737,96,261390
20445,4.6e-05,74.125.24.0-255,5738,10475,96,261390
20446,5e-05,172.31.47.0-255,66,10541,96,261390
20447,6.5e-05,172.31.47.0-255,66,10607,96,261390
20448,7.2e-05,74.125.24.0-255,7156,17763,96,261390
20449,7.4e-05,172.31.47.0-255,66,17829,96,261390
20450,7.9e-05,74.125.24.0-255,2902,20731,96,261390
20451,8.2e-05,172.31.47.0-255,66,20797,96,261390
20452,0.000117,172.31.47.0-255,66,20863,96,261390
20453,0.000151,172.31.47.0-255,66,20929,96,261390
20454,0.000188,74.125.24.0-255,4320,25249,96,261390
20455,0.000191,172.31.47.0-255,66,25315,96,261390
20456,0.000209,74.125.24.0-255,4302,29617,96,261390
20457,0.000212,172.31.47.0-255,66,29683,96,261390
20458,0.000252,74.125.24.0-255,1484,31167,96,261390
20459,0.000254,172.31.47.0-255,66,31233,96,261390
20460,0.000259,74.125.24.0-255,2902,34135,96,261390
20461,0.00026,172.31.47.0-255,66,34201,96,261390
20462,0.000278,74.125.24.0-255,5738,39939,96,261390
20463,0.00028,172.31.47.0-255,66,40005,96,261390
20464,0.000286,74.125.24.0-255,4320,44325,96,261390
20465,0.000289,172.31.47.0-255,66,44391,96,261390
20466,0.000321,172.31.47.0-255,66,44457,96,261390
20467,0.000354,172.31.47.0-255,66,44523,96,261390
20468,0.00097,74.125.24.0-255,1484,46007,96,261390
20469,0.000977,74.125.24.0-255,2902,48909,96,261390
20470,0.000981,172.31.47.0-255,66,48975,96,261390
20471,0.000988,74.125.24.0-255,5738,54713,96,261390
20472,0.00099,172.31.47.0-255,66,54779,96,261390
20473,0.000995,74.125.24.0-255,4320,59099,96,261390
20474,0.000997,172.31.47.0-255,66,59165,96,261390
20475,0.001027,172.31.47.0-255,66,59231,96,261390
20476,0.001059,172.31.47.0-255,66,59297,96,261390
20477,0.001242,74.125.24.0-255,1484,60781,96,261390
20478,0.001248,74.125.24.0-255,2902,63683,96,261390
20479,0.001251,172.31.47.0-255,66,63749,96,261390
20480,0.001285,74.125.24.0-255,4320,68069,96,261390
20481,0.001288,172.31.47.0-255,66,68135,96,261390
20482,0.001303,74.125.24.0-255,1484,69619,96,261390
20483,0.001315,172.31.47.0-255,66,69685,96,261390
20484,0.001325,172.31.47.0-255,66,69751,96,261390
20485,0.001327,74.125.24.0-255,766,70517,96,261390
20486,0.001473,74.125.24.0-255,1484,72001,96,261390
20487,0.001477,172.31.47.0-255,66,72067,96,261390
20488,0.001486,74.125.24.0-255,2902,74969,96,261390
20489,0.001488,172.31.47.0-255,66,75035,96,261390
20490,0.001491,74.125.24.0-255,1484,76519,96,261390
20491,0.001507,74.125.24.0-255,4320,80839,96,261390
20492,0.001509,172.31.47.0-255,66,80905,96,261390
20493,0.001514,74.125.24.0-255,4320,85225,96,261390
20494,0.001515,172.31.47.0-255,66,85291,96,261390
20495,0.001518,74.125.24.0-255,1484,86775,96,261390
20496,0.001549,172.31.47.0-255,66,86841,96,261390
20497,0.001594,172.31.47.0-255,66,86907,96,261390
20498,0.001836,74.125.24.0-255,1484,88391,96,261390
20499,0.001856,74.125.24.0-255,2902,91293,96,261390
20500,0.001859,172.31.47.0-255,66,91359,96,261390
20501,0.001864,74.125.24.0-255,2902,94261,96,261390
20502,0.001866,172.31.47.0-255,66,94327,96,261390
20503,0.001879,74.125.24.0-255,2902,97229,96,261390
20504,0.001881,172.31.47.0-255,66,97295,96,261390
20505,0.001912,74.125.24.0-255,7156,104451,96,261390
20506,0.001914,172.31.47.0-255,66,104517,96,261390
20507,0.00193,74.125.24.0-255,1484,106001,96,261390
20508,0.001936,74.125.24.0-255,5738,111739,96,261390
20509,0.001938,172.31.47.0-255,66,111805,96,261390
20510,0.001953,74.125.24.0-255,4320,116125,96,261390
20511,0.001955,172.31.47.0-255,66,116191,96,261390
20512,0.001959,74.125.24.0-255,2902,119093,96,261390
20513,0.00196,172.31.47.0-255,66,119159,96,261390
20514,0.002011,74.125.24.0-255,2184,121343,96,261390
20515,0.002014,172.31.47.0-255,66,121409,96,261390
20516,0.002231,74.125.24.0-255,1484,122893,96,261390
20517,0.002237,74.125.24.0-255,2902,125795,96,261390
20518,0.00224,172.31.47.0-255,66,125861,96,261390
20519,0.002265,74.125.24.0-255,5738,131599,96,261390
20520,0.002267,172.31.47.0-255,66,131665,96,261390
20521,0.002271,74.125.24.0-255,2902,134567,96,261390
20522,0.002272,172.31.47.0-255,66,134633,96,261390
20523,0.002294,172.31.47.0-255,66,134699,96,261390
20524,0.002336,172.31.47.0-255,66,134765,96,261390
20525,0.002339,74.125.24.0-255,1484,136249,96,261390
20526,0.002401,74.125.24.0-255,2902,139151,96,261390
20527,0.002418,74.125.24.0-255,2184,141335,96,261390
20528,0.012984,172.31.47.0-255,66,141401,96,261390
20529,0.013373,74.125.24.0-255,1484,142885,96,261390
20530,0.015562,74.125.24.0-255,4320,147205,96,261390
20531,0.015577,172.31.47.0-255,66,147271,96,261390
20532,0.018145,74.125.24.0-255,5738,153009,96,261390
20533,0.018152,172.31.47.0-255,66,153075,96,261390
20534,0.020733,74.125.24.0-255,5738,158813,96,261390
20535,0.020743,172.31.47.0-255,66,158879,96,261390
20536,0.023341,74.125.24.0-255,5738,164617,96,261390
20537,0.02335,172.31.47.0-255,66,164683,96,261390
20538,0.025942,74.125.24.0-255,5738,170421,96,261390
20539,0.025949,172.31.47.0-255,66,170487,96,261390
20540,0.028547,74.125.24.0-255,5738,176225,96,261390
20541,0.028556,172.31.47.0-255,66,176291,96,261390
20542,0.031177,74.125.24.0-255,5738,182029,96,261390
20543,0.031196,172.31.47.0-255,66,182095,96,261390
20544,0.033791,74.125.24.0-255,5738,187833,96,261390
20545,0.033801,172.31.47.0-255,66,187899,96,261390
20546,0.036448,74.125.24.0-255,5738,193637,96,261390
20547,0.036465,172.31.47.0-255,66,193703,96,261390
20548,0.039074,74.125.24.0-255,5738,199441,96,261390
20549,0.03908,172.31.47.0-255,66,199507,96,261390
20550,0.041603,172.31.47.0-255,172,199679,96,261390
20551,0.041638,172.31.47.0-255,1101,200780,96,261390
20552,0.041663,74.125.24.0-255,4320,205100,96,261390
20553,0.041671,172.31.47.0-255,66,205166,96,261390
20554,0.041691,74.125.24.0-255,1484,206650,96,261390
20555,0.041717,172.31.47.0-255,1514,208164,96,261390
20556,0.041719,172.31.47.0-255,1514,209678,96,261390
20557,0.04172,172.31.47.0-255,1514,211192,96,261390
20558,0.041721,172.31.47.0-255,1095,212287,96,261390
20559,0.043127,104.244.42.0-255,66,212353,96,261390
20560,0.043157,104.244.42.0-255,66,212419,96,261390
20561,0.04326,104.244.42.0-255,66,212485,96,261390
20562,0.043264,104.244.42.0-255,66,212551,96,261390
20563,0.04422,74.125.24.0-255,2902,215453,96,261390
20564,0.044232,172.31.47.0-255,66,215519,96,261390
20565,0.046849,74.125.24.0-255,5738,221257,96,261390
20566,0.046867,172.31.47.0-255,66,221323,96,261390
20567,0.049442,74.125.24.0-255,5738,227061,96,261390
20568,0.049459,172.31.47.0-255,66,227127,96,261390
20569,0.052034,74.125.24.0-255,5738,232865,96,261390
20570,0.052051,172.31.47.0-255,66,232931,96,261390
20571,0.054664,74.125.24.0-255,5738,238669,96,261390
20572,0.054672,172.31.47.0-255,66,238735,96,261390
20573,0.057253,74.125.24.0-255,5738,244473,96,261390
20574,0.057259,172.31.47.0-255,66,244539,96,261390
20575,0.059842,74.125.24.0-255,5738,250277,96,261390
20576,0.059847,172.31.47.0-255,66,250343,96,261390
20577,0.062494,74.125.24.0-255,5738,256081,96,261390
20578,0.062502,172.31.47.0-255,66,256147,96,261390
20579,0.065085,74.125.24.0-255,5006,261153,96,261390
20580,0.065091,172.31.47.0-255,66,261219,96,261390
20581,0.065259,172.31.47.0-255,105,261324,96,261390
20582,0.067788,74.125.24.0-255,66,261390,96,261390
20583,0.0,74.125.24.0-255,153,153,96,213319
20584,1.4e-05,172.31.47.0-255,66,219,96,213319
20585,2e-05,74.125.24.0-255,1484,1703,96,213319
20586,2.4e-05,172.31.47.0-255,66,1769,96,213319
20587,5.2e-05,74.125.24.0-255,2902,4671,96,213319
20588,5.5e-05,172.31.47.0-255,66,4737,96,213319
20589,6.5e-05,74.125.24.0-255,7156,11893,96,213319
20590,6.8e-05,172.31.47.0-255,66,11959,96,213319
20591,7e-05,74.125.24.0-255,1484,13443,96,213319
20592,7.2e-05,172.31.47.0-255,66,13509,96,213319
20593,0.000126,74.125.24.0-255,2135,15644,96,213319
20594,0.000128,172.31.47.0-255,66,15710,96,213319
20595,0.000142,74.125.24.0-255,2902,18612,96,213319
20596,0.000144,172.31.47.0-255,66,18678,96,213319
20597,0.00015,74.125.24.0-255,7156,25834,96,213319
20598,0.000153,172.31.47.0-255,66,25900,96,213319
20599,0.000156,74.125.24.0-255,1484,27384,96,213319
20600,0.000158,172.31.47.0-255,66,27450,96,213319
20601,0.000202,74.125.24.0-255,3961,31411,96,213319
20602,0.000205,172.31.47.0-255,66,31477,96,213319
20603,0.000263,74.125.24.0-255,1484,32961,96,213319
20604,0.000266,172.31.47.0-255,66,33027,96,213319
20605,0.000271,74.125.24.0-255,2902,35929,96,213319
20606,0.000273,172.31.47.0-255,66,35995,96,213319
20607,0.000302,74.125.24.0-255,5738,41733,96,213319
20608,0.000305,172.31.47.0-255,66,41799,96,213319
20609,0.000312,74.125.24.0-255,6797,48596,96,213319
20610,0.000313,172.31.47.0-255,66,48662,96,213319
20611,0.000323,74.125.24.0-255,7156,55818,96,213319
20612,0.000325,172.31.47.0-255,66,55884,96,213319
20613,0.000351,74.125.24.0-255,1484,57368,96,213319
20614,0.000354,172.31.47.0-255,66,57434,96,213319
20615,0.000385,172.31.47.0-255,66,57500,96,213319
20616,0.000387,74.125.24.0-255,648,58148,96,213319
20617,0.000579,74.125.24.0-255,1484,59632,96,213319
20618,0.000584,74.125.24.0-255,2902,62534,96,213319
20619,0.000589,172.31.47.0-255,66,62600,96,213319
20620,0.000592,172.31.47.0-255,66,62666,96,213319
20621,0.000611,74.125.24.0-255,5738,68404,96,213319
20622,0.000613,172.31.47.0-255,66,68470,96,213319
20623,0.000618,74.125.24.0-255,4320,72790,96,213319
20624,0.00062,172.31.47.0-255,66,72856,96,213319
20625,0.000657,172.31.47.0-255,66,72922,96,213319
20626,0.000667,172.31.47.0-255,66,72988,96,213319
20627,0.000909,74.125.24.0-255,1484,74472,96,213319
20628,0.000915,74.125.24.0-255,2902,77374,96,213319
20629,0.000919,172.31.47.0-255,66,77440,96,213319
20630,0.000939,74.125.24.0-255,5738,83178,96,213319
20631,0.000942,172.31.47.0-255,66,83244,96,213319
20632,0.000968,74.125.24.0-255,4320,87564,96,213319
20633,0.00097,172.31.47.0-255,66,87630,96,213319
20634,0.000991,74.125.24.0-255,1484,89114,96,213319
20635,0.00101,74.125.24.0-255,4320,93434,96,213319
20636,0.001013,172.31.47.0-255,66,93500,96,213319
20637,0.001019,74.125.24.0-255,5738,99238,96,213319
20638,0.001022,172.31.47.0-255,66,99304,96,213319
20639,0.001079,74.125.24.0-255,5738,105042,96,213319
20640,0.001082,172.31.47.0-255,66,105108,96,213319
20641,0.001107,74.125.24.0-255,2184,107292,96,213319
20642,0.001109,172.31.47.0-255,66,107358,96,213319
20643,0.001264,74.125.24.0-255,1484,108842,96,213319
20644,0.00127,74.125.24.0-255,2902,111744,96,213319
20645,0.001273,172.31.47.0-255,66,111810,96,213319
20646,0.001306,74.125.24.0-255,5738,117548,96,213319
20647,0.001309,172.31.47.0-255,66,117614,96,213319
20648,0.001314,74.125.24.0-255,2902,120516,96,213319
20649,0.001316,172.31.47.0-255,66,120582,96,213319
20650,0.001346,172.31.47.0-255,66,120648,96,213319
20651,0.001364,172.31.47.0-255,66,120714,96,213319
20652,0.001522,74.125.24.0-255,1484,122198,96,213319
20653,0.001529,74.125.24.0-255,2902,125100,96,213319
20654,0.001532,172.31.47.0-255,66,125166,96,213319
20655,0.001537,74.125.24.0-255,2902,128068,96,213319
20656,0.001539,172.31.47.0-255,66,128134,96,213319
20657,0.001572,74.125.24.0-255,2902,131036,96,213319
20658,0.001575,172.31.47.0-255,66,131102,96,213319
20659,0.001589,172.31.47.0-255,66,131168,96,213319
20660,0.001645,74.125.24.0-255,4320,135488,96,213319
20661,0.001649,172.31.47.0-255,66,135554,96,213319
20662,0.001677,74.125.24.0-255,6438,141992,96,213319
20663,0.00168,172.31.47.0-255,66,142058,96,213319
20664,0.001704,74.125.24.0-255,1484,143542,96,213319
20665,0.00171,74.125.24.0-255,2902,146444,96,213319
20666,0.001712,172.31.47.0-255,66,146510,96,213319
20667,0.001743,74.125.24.0-255,4320,150830,96,213319
20668,0.001745,172.31.47.0-255,66,150896,96,213319
20669,0.001751,74.125.24.0-255,5738,156634,96,213319
20670,0.001754,172.31.47.0-255,66,156700,96,213319
20671,0.001785,74.125.24.0-255,7156,163856,96,213319
20672,0.001789,172.31.47.0-255,66,163922,96,213319
20673,0.001802,74.125.24.0-255,2902,166824,96,213319
20674,0.001809,172.31.47.0-255,66,166890,96,213319
20675,0.001822,172.31.47.0-255,66,166956,96,213319
20676,0.001825,74.125.24.0-255,1484,168440,96,213319
20677,0.001901,74.125.24.0-255,2184,170624,96,213319
20678,0.001913,172.31.47.0-255,66,170690,96,213319
20679,0.001941,74.125.24.0-255,2902,173592,96,213319
20680,0.001958,74.125.24.0-255,7156,180748,96,213319
20681,0.001973,172.31.47.0-255,66,180814,96,213319
20682,0.001984,74.125.24.0-255,5738,186552,96,213319
20683,0.002014,172.31.47.0-255,66,186618,96,213319
20684,0.002042,74.125.24.0-255,1484,188102,96,213319
20685,0.002047,74.125.24.0-255,2902,191004,96,213319
20686,0.00205,74.125.24.0-255,1484,192488,96,213319
20687,0.002064,74.125.24.0-255,4320,196808,96,213319
20688,0.002066,172.31.47.0-255,66,196874,96,213319
20689,0.002071,172.31.47.0-255,66,196940,96,213319
20690,0.002098,74.125.24.0-255,5738,202678,96,213319
20691,0.00213,74.125.24.0-255,2902,205580,96,213319
20692,0.00214,172.31.47.0-255,66,205646,96,213319
20693,0.00218,74.125.24.0-255,2902,208548,96,213319
20694,0.002189,172.31.47.0-255,66,208614,96,213319
20695,0.002329,172.31.47.0-255,66,208680,96,213319
20696,0.004579,74.125.24.0-255,105,208785,96,213319
20697,0.017198,172.31.47.0-255,66,208851,96,213319
20698,0.017252,172.31.47.0-255,105,208956,96,213319
20699,0.019514,74.125.24.0-255,66,209022,96,213319
20700,0.043115,172.31.47.0-255,172,209194,96,213319
20701,0.043149,172.31.47.0-255,1101,210295,96,213319
20702,0.043202,172.31.47.0-255,1514,211809,96,213319
20703,0.043203,172.31.47.0-255,1312,213121,96,213319
20704,0.044653,104.244.42.0-255,66,213187,96,213319
20705,0.044664,104.244.42.0-255,66,213253,96,213319
20706,0.044715,104.244.42.0-255,66,213319,96,213319
20707,0.0,31.13.82.0-255,105,105,96,171
20708,1.8e-05,172.31.47.0-255,66,171,96,171
20709,0.0,74.125.24.0-255,153,153,96,258816
20710,1.7e-05,172.31.47.0-255,66,219,96,258816
20711,2.3e-05,74.125.24.0-255,1484,1703,96,258816
20712,2.7e-05,172.31.47.0-255,66,1769,96,258816
20713,3.3e-05,74.125.24.0-255,2902,4671,96,258816
20714,4.1e-05,172.31.47.0-255,66,4737,96,258816
20715,4.8e-05,74.125.24.0-255,7156,11893,96,258816
20716,5.1e-05,172.31.47.0-255,66,11959,96,258816
20717,5.5e-05,74.125.24.0-255,2128,14087,96,258816
20718,5.9e-05,172.31.47.0-255,66,14153,96,258816
20719,0.000501,74.125.24.0-255,1484,15637,96,258816
20720,0.000507,172.31.47.0-255,66,15703,96,258816
20721,0.000516,74.125.24.0-255,2902,18605,96,258816
20722,0.000519,172.31.47.0-255,66,18671,96,258816
20723,0.00053,74.125.24.0-255,5738,24409,96,258816
20724,0.000531,172.31.47.0-255,66,24475,96,258816
20725,0.000547,74.125.24.0-255,1484,25959,96,258816
20726,0.000549,172.31.47.0-255,66,26025,96,258816
20727,0.000576,74.125.24.0-255,5379,31404,96,258816
20728,0.000578,172.31.47.0-255,66,31470,96,258816
20729,0.000622,74.125.24.0-255,1484,32954,96,258816
20730,0.000625,172.31.47.0-255,66,33020,96,258816
20731,0.000629,74.125.24.0-255,2902,35922,96,258816
20732,0.000631,172.31.47.0-255,66,35988,96,258816
20733,0.000635,74.125.24.0-255,2902,38890,96,258816
20734,0.000641,172.31.47.0-255,66,38956,96,258816
20735,0.000669,74.125.24.0-255,2902,41858,96,258816
20736,0.000696,172.31.47.0-255,66,41924,96,258816
20737,0.000699,172.31.47.0-255,66,41990,96,258816
20738,0.000735,172.31.47.0-255,66,42056,96,258816
20739,0.000742,74.125.24.0-255,6797,48853,96,258816
20740,0.000744,172.31.47.0-255,66,48919,96,258816
20741,0.000746,74.125.24.0-255,400,49319,96,258816
20742,0.001063,172.31.47.0-255,66,49385,96,258816
20743,0.001344,74.125.24.0-255,343,49728,96,258816
20744,0.00137,172.31.47.0-255,66,49794,96,258816
20745,0.00145,74.125.24.0-255,1484,51278,96,258816
20746,0.001458,74.125.24.0-255,2902,54180,96,258816
20747,0.001461,172.31.47.0-255,66,54246,96,258816
20748,0.001487,74.125.24.0-255,5738,59984,96,258816
20749,0.001489,172.31.47.0-255,66,60050,96,258816
20750,0.001545,74.125.24.0-255,2902,62952,96,258816
20751,0.001548,172.31.47.0-255,66,63018,96,258816
20752,0.001584,172.31.47.0-255,66,63084,96,258816
20753,0.001593,172.31.47.0-255,66,63150,96,258816
20754,0.001609,74.125.24.0-255,1125,64275,96,258816
20755,0.001787,172.31.47.0-255,66,64341,96,258816
20756,0.003593,74.125.24.0-255,4320,68661,96,258816
20757,0.003598,172.31.47.0-255,66,68727,96,258816
20758,0.003773,74.125.24.0-255,1484,70211,96,258816
20759,0.00559,74.125.24.0-255,4320,74531,96,258816
20760,0.005595,172.31.47.0-255,66,74597,96,258816
20761,0.007584,74.125.24.0-255,5738,80335,96,258816
20762,0.007591,172.31.47.0-255,66,80401,96,258816
20763,0.009604,74.125.24.0-255,5738,86139,96,258816
20764,0.009611,172.31.47.0-255,66,86205,96,258816
20765,0.011616,74.125.24.0-255,5738,91943,96,258816
20766,0.011622,172.31.47.0-255,66,92009,96,258816
20767,0.013637,74.125.24.0-255,5738,97747,96,258816
20768,0.013647,172.31.47.0-255,66,97813,96,258816
20769,0.015661,74.125.24.0-255,5738,103551,96,258816
20770,0.015668,172.31.47.0-255,66,103617,96,258816
20771,0.017681,74.125.24.0-255,5738,109355,96,258816
20772,0.017693,172.31.47.0-255,66,109421,96,258816
20773,0.019718,74.125.24.0-255,5738,115159,96,258816
20774,0.019734,172.31.47.0-255,66,115225,96,258816
20775,0.021748,74.125.24.0-255,5738,120963,96,258816
20776,0.021762,172.31.47.0-255,66,121029,96,258816
20777,0.022875,172.31.47.0-255,172,121201,96,258816
20778,0.022903,172.31.47.0-255,1109,122310,96,258816
20779,0.022952,172.31.47.0-255,1514,123824,96,258816
20780,0.022954,172.31.47.0-255,1302,125126,96,258816
20781,0.023762,74.125.24.0-255,5738,130864,96,258816
20782,0.023769,172.31.47.0-255,66,130930,96,258816
20783,0.024404,104.244.42.0-255,66,130996,96,258816
20784,0.024432,104.244.42.0-255,66,131062,96,258816
20785,0.024486,104.244.42.0-255,66,131128,96,258816
20786,0.025757,74.125.24.0-255,5738,136866,96,258816
20787,0.025764,172.31.47.0-255,66,136932,96,258816
20788,0.027752,74.125.24.0-255,5738,142670,96,258816
20789,0.02776,172.31.47.0-255,66,142736,96,258816
20790,0.029754,74.125.24.0-255,5738,148474,96,258816
20791,0.02976,172.31.47.0-255,66,148540,96,258816
20792,0.03176,74.125.24.0-255,5738,154278,96,258816
20793,0.031767,172.31.47.0-255,66,154344,96,258816
20794,0.033773,74.125.24.0-255,5738,160082,96,258816
20795,0.033779,172.31.47.0-255,66,160148,96,258816
20796,0.035797,74.125.24.0-255,5738,165886,96,258816
20797,0.035803,172.31.47.0-255,66,165952,96,258816
20798,0.037815,74.125.24.0-255,5738,171690,96,258816
20799,0.037823,172.31.47.0-255,66,171756,96,258816
20800,0.039822,74.125.24.0-255,5738,177494,96,258816
20801,0.039829,172.31.47.0-255,66,177560,96,258816
20802,0.041822,74.125.24.0-255,5738,183298,96,258816
20803,0.041829,172.31.47.0-255,66,183364,96,258816
20804,0.043856,74.125.24.0-255,5738,189102,96,258816
20805,0.043866,172.31.47.0-255,66,189168,96,258816
20806,0.045907,74.125.24.0-255,5738,194906,96,258816
20807,0.045916,172.31.47.0-255,66,194972,96,258816
20808,0.047925,74.125.24.0-255,5738,200710,96,258816
20809,0.047933,172.31.47.0-255,66,200776,96,258816
20810,0.049946,74.125.24.0-255,5738,206514,96,258816
20811,0.049953,172.31.47.0-255,66,206580,96,258816
20812,0.051965,74.125.24.0-255,5738,212318,96,258816
20813,0.051972,172.31.47.0-255,66,212384,96,258816
20814,0.054002,74.125.24.0-255,5738,218122,96,258816
20815,0.054009,172.31.47.0-255,66,218188,96,258816
20816,0.056043,74.125.24.0-255,5738,223926,96,258816
20817,0.05605,172.31.47.0-255,66,223992,96,258816
20818,0.058067,74.125.24.0-255,5738,229730,96,258816
20819,0.058073,172.31.47.0-255,66,229796,96,258816
20820,0.060091,74.125.24.0-255,5738,235534,96,258816
20821,0.060098,172.31.47.0-255,66,235600,96,258816
20822,0.062113,74.125.24.0-255,5738,241338,96,258816
20823,0.06212,172.31.47.0-255,66,241404,96,258816
20824,0.064146,74.125.24.0-255,5738,247142,96,258816
20825,0.064151,172.31.47.0-255,66,247208,96,258816
20826,0.066165,74.125.24.0-255,5738,252946,96,258816
20827,0.066171,172.31.47.0-255,66,253012,96,258816
20828,0.068188,74.125.24.0-255,5738,258750,96,258816
20829,0.068195,172.31.47.0-255,66,258816,96,258816
20830,0.0,172.31.47.0-255,105,105,96,105
20831,0.0,172.253.118.0-255,152,152,96,311893
20832,2.7e-05,172.31.47.0-255,66,218,96,311893
20833,3.3e-05,172.253.118.0-255,1484,1702,96,311893
20834,3.7e-05,172.31.47.0-255,66,1768,96,311893
20835,6.6e-05,172.253.118.0-255,2902,4670,96,311893
20836,6.9e-05,172.31.47.0-255,66,4736,96,311893
20837,7.3e-05,172.253.118.0-255,2902,7638,96,311893
20838,7.5e-05,172.31.47.0-255,66,7704,96,311893
20839,8.9e-05,172.253.118.0-255,1484,9188,96,311893
20840,9.1e-05,172.31.47.0-255,66,9254,96,311893
20841,0.000104,172.253.118.0-255,1484,10738,96,311893
20842,0.000106,172.31.47.0-255,66,10804,96,311893
20843,0.000122,172.253.118.0-255,3471,14275,96,311893
20844,0.000125,172.31.47.0-255,66,14341,96,311893
20845,0.000272,172.253.118.0-255,1484,15825,96,311893
20846,0.000276,172.31.47.0-255,66,15891,96,311893
20847,0.000282,172.253.118.0-255,2902,18793,96,311893
20848,0.000285,172.31.47.0-255,66,18859,96,311893
20849,0.000317,172.253.118.0-255,4320,23179,96,311893
20850,0.000321,172.31.47.0-255,66,23245,96,311893
20851,0.000341,172.253.118.0-255,2902,26147,96,311893
20852,0.000344,172.31.47.0-255,66,26213,96,311893
20853,0.000358,172.253.118.0-255,2902,29115,96,311893
20854,0.000361,172.31.47.0-255,66,29181,96,311893
20855,0.000365,172.253.118.0-255,2543,31724,96,311893
20856,0.000368,172.31.47.0-255,66,31790,96,311893
20857,0.000403,172.253.118.0-255,1484,33274,96,311893
20858,0.000406,172.31.47.0-255,66,33340,96,311893
20859,0.00041,172.253.118.0-255,1484,34824,96,311893
20860,0.000413,172.31.47.0-255,66,34890,96,311893
20861,0.000427,172.253.118.0-255,1484,36374,96,311893
20862,0.00043,172.31.47.0-255,66,36440,96,311893
20863,0.000437,172.253.118.0-255,5738,42178,96,311893
20864,0.000439,172.31.47.0-255,66,42244,96,311893
20865,0.000469,172.253.118.0-255,6797,49041,96,311893
20866,0.000473,172.31.47.0-255,66,49107,96,311893
20867,0.000888,172.253.118.0-255,1484,50591,96,311893
20868,0.000898,172.253.118.0-255,2902,53493,96,311893
20869,0.000902,172.31.47.0-255,66,53559,96,311893
20870,0.000919,172.253.118.0-255,4320,57879,96,311893
20871,0.000922,172.31.47.0-255,66,57945,96,311893
20872,0.000925,172.253.118.0-255,1484,59429,96,311893
20873,0.000948,172.253.118.0-255,4320,63749,96,311893
20874,0.000951,172.31.47.0-255,66,63815,96,311893
20875,0.000974,172.253.118.0-255,2543,66358,96,311893
20876,0.000977,172.31.47.0-255,66,66424,96,311893
20877,0.001072,172.253.118.0-255,1484,67908,96,311893
20878,0.001076,172.253.118.0-255,1484,69392,96,311893
20879,0.00108,172.31.47.0-255,66,69458,96,311893
20880,0.001098,172.253.118.0-255,1484,70942,96,311893
20881,0.001101,172.253.118.0-255,1484,72426,96,311893
20882,0.001104,172.31.47.0-255,66,72492,96,311893
20883,0.001125,172.253.118.0-255,4320,76812,96,311893
20884,0.001129,172.31.47.0-255,66,76878,96,311893
20885,0.001159,172.253.118.0-255,6797,83675,96,311893
20886,0.001162,172.31.47.0-255,66,83741,96,311893
20887,0.001166,172.253.118.0-255,646,84387,96,311893
20888,0.001201,172.253.118.0-255,1484,85871,96,311893
20889,0.001205,172.31.47.0-255,66,85937,96,311893
20890,0.001229,172.253.118.0-255,2902,88839,96,311893
20891,0.001232,172.31.47.0-255,66,88905,96,311893
20892,0.001238,172.253.118.0-255,5738,94643,96,311893
20893,0.001241,172.31.47.0-255,66,94709,96,311893
20894,0.001287,172.253.118.0-255,6797,101506,96,311893
20895,0.00129,172.31.47.0-255,66,101572,96,311893
20896,0.001562,172.253.118.0-255,1484,103056,96,311893
20897,0.001566,172.253.118.0-255,2902,105958,96,311893
20898,0.001568,172.31.47.0-255,66,106024,96,311893
20899,0.001589,172.253.118.0-255,5738,111762,96,311893
20900,0.001592,172.31.47.0-255,66,111828,96,311893
20901,0.00163,172.31.47.0-255,66,111894,96,311893
20902,0.001649,172.253.118.0-255,1484,113378,96,311893
20903,0.001656,172.253.118.0-255,7156,120534,96,311893
20904,0.001658,172.31.47.0-255,66,120600,96,311893
20905,0.001692,172.253.118.0-255,3602,124202,96,311893
20906,0.001694,172.31.47.0-255,66,124268,96,311893
20907,0.00225,172.253.118.0-255,1484,125752,96,311893
20908,0.00226,172.253.118.0-255,1484,127236,96,311893
20909,0.002262,172.31.47.0-255,66,127302,96,311893
20910,0.002278,172.253.118.0-255,1484,128786,96,311893
20911,0.002315,172.253.118.0-255,1484,130270,96,311893
20912,0.002317,172.31.47.0-255,66,130336,96,311893
20913,0.002321,172.253.118.0-255,2902,133238,96,311893
20914,0.002323,172.31.47.0-255,66,133304,96,311893
20915,0.002349,172.253.118.0-255,5738,139042,96,311893
20916,0.002351,172.31.47.0-255,66,139108,96,311893
20917,0.002367,172.253.118.0-255,1484,140592,96,311893
20918,0.002397,172.31.47.0-255,66,140658,96,311893
20919,0.002403,172.253.118.0-255,6438,147096,96,311893
20920,0.002405,172.31.47.0-255,66,147162,96,311893
20921,0.00475,172.253.118.0-255,4320,151482,96,311893
20922,0.004755,172.31.47.0-255,66,151548,96,311893
20923,0.00477,172.253.118.0-255,1484,153032,96,311893
20924,0.007093,172.253.118.0-255,4320,157352,96,311893
20925,0.007099,172.31.47.0-255,66,157418,96,311893
20926,0.009446,172.253.118.0-255,4320,161738,96,311893
20927,0.009454,172.31.47.0-255,66,161804,96,311893
20928,0.009473,172.253.118.0-255,1484,163288,96,311893
20929,0.011801,172.253.118.0-255,4320,167608,96,311893
20930,0.011809,172.31.47.0-255,66,167674,96,311893
20931,0.014149,172.253.118.0-255,5738,173412,96,311893
20932,0.014156,172.31.47.0-255,66,173478,96,311893
20933,0.016479,172.253.118.0-255,5738,179216,96,311893
20934,0.016487,172.31.47.0-255,66,179282,96,311893
20935,0.018836,172.253.118.0-255,5738,185020,96,311893
20936,0.018842,172.31.47.0-255,66,185086,96,311893
20937,0.021187,172.253.118.0-255,5738,190824,96,311893
20938,0.021195,172.31.47.0-255,66,190890,96,311893
20939,0.023539,172.253.118.0-255,5738,196628,96,311893
20940,0.023548,172.31.47.0-255,66,196694,96,311893
20941,0.024732,172.31.47.0-255,171,196865,96,311893
20942,0.024762,172.31.47.0-255,1134,197999,96,311893
20943,0.024795,172.31.47.0-255,1514,199513,96,311893
20944,0.024797,172.31.47.0-255,1278,200791,96,311893
20945,0.025889,172.253.118.0-255,5738,206529,96,311893
20946,0.025894,172.31.47.0-255,66,206595,96,311893
20947,0.026306,104.244.42.0-255,66,206661,96,311893
20948,0.026313,104.244.42.0-255,66,206727,96,311893
20949,0.026356,104.244.42.0-255,66,206793,96,311893
20950,0.028241,172.253.118.0-255,2902,209695,96,311893
20951,0.028246,172.31.47.0-255,66,209761,96,311893
20952,0.028276,172.253.118.0-255,2902,212663,96,311893
20953,0.028279,172.31.47.0-255,66,212729,96,311893
20954,0.030596,172.253.118.0-255,2902,215631,96,311893
20955,0.030602,172.31.47.0-255,66,215697,96,311893
20956,0.030631,172.253.118.0-255,2902,218599,96,311893
20957,0.030634,172.31.47.0-255,66,218665,96,311893
20958,0.032951,172.253.118.0-255,5738,224403,96,311893
20959,0.032958,172.31.47.0-255,66,224469,96,311893
20960,0.035318,172.253.118.0-255,5738,230207,96,311893
20961,0.035325,172.31.47.0-255,66,230273,96,311893
20962,0.037654,172.253.118.0-255,4320,234593,96,311893
20963,0.03766,172.31.47.0-255,66,234659,96,311893
20964,0.037691,172.253.118.0-255,1484,236143,96,311893
20965,0.040021,172.253.118.0-255,4320,240463,96,311893
20966,0.040027,172.31.47.0-255,66,240529,96,311893
20967,0.042452,172.253.118.0-255,2902,243431,96,311893
20968,0.042457,172.31.47.0-255,66,243497,96,311893
20969,0.042483,172.253.118.0-255,2902,246399,96,311893
20970,0.042486,172.31.47.0-255,66,246465,96,311893
20971,0.044794,172.253.118.0-255,2902,249367,96,311893
20972,0.044799,172.31.47.0-255,66,249433,96,311893
20973,0.044828,172.253.118.0-255,2902,252335,96,311893
20974,0.044831,172.31.47.0-255,66,252401,96,311893
20975,0.047137,172.253.118.0-255,2902,255303,96,311893
20976,0.047144,172.31.47.0-255,66,255369,96,311893
20977,0.047202,172.253.118.0-255,2902,258271,96,311893
20978,0.047206,172.31.47.0-255,66,258337,96,311893
20979,0.049481,172.253.118.0-255,2902,261239,96,311893
20980,0.049486,172.31.47.0-255,66,261305,96,311893
20981,0.049536,172.253.118.0-255,1484,262789,96,311893
20982,0.04955,172.253.118.0-255,1484,264273,96,311893
20983,0.049553,172.31.47.0-255,66,264339,96,311893
20984,0.051829,172.253.118.0-255,2902,267241,96,311893
20985,0.051834,172.31.47.0-255,66,267307,96,311893
20986,0.051904,172.253.118.0-255,2902,270209,96,311893
20987,0.05191,172.31.47.0-255,66,270275,96,311893
20988,0.054167,172.253.118.0-255,2902,273177,96,311893
20989,0.054171,172.31.47.0-255,66,273243,96,311893
20990,0.054232,172.253.118.0-255,2902,276145,96,311893
20991,0.054236,172.31.47.0-255,66,276211,96,311893
20992,0.056524,172.253.118.0-255,2902,279113,96,311893
20993,0.05653,172.31.47.0-255,66,279179,96,311893
20994,0.056574,172.253.118.0-255,2902,282081,96,311893
20995,0.056578,172.31.47.0-255,66,282147,96,311893
20996,0.058858,172.253.118.0-255,2902,285049,96,311893
20997,0.058862,172.31.47.0-255,66,285115,96,311893
20998,0.058909,172.253.118.0-255,2902,288017,96,311893
20999,0.058913,172.31.47.0-255,66,288083,96,311893
21000,0.06117,172.253.118.0-255,2902,290985,96,311893
21001,0.061176,172.31.47.0-255,66,291051,96,311893
21002,0.06125,172.253.118.0-255,2902,293953,96,311893
21003,0.061255,172.31.47.0-255,66,294019,96,311893
21004,0.063507,172.253.118.0-255,1484,295503,96,311893
21005,0.063529,172.253.118.0-255,1484,296987,96,311893
21006,0.063532,172.31.47.0-255,66,297053,96,311893
21007,0.06359,172.253.118.0-255,2902,299955,96,311893
21008,0.063594,172.31.47.0-255,66,300021,96,311893
21009,0.065882,172.253.118.0-255,2902,302923,96,311893
21010,0.065888,172.31.47.0-255,66,302989,96,311893
21011,0.065931,172.253.118.0-255,2902,305891,96,311893
21012,0.065935,172.31.47.0-255,66,305957,96,311893
21013,0.068221,172.253.118.0-255,2902,308859,96,311893
21014,0.068225,172.31.47.0-255,66,308925,96,311893
21015,0.06826,172.253.118.0-255,2902,311827,96,311893
21016,0.068263,172.31.47.0-255,66,311893,96,311893
21017,0.0,172.217.194.0-255,153,153,96,253049
21018,2.5e-05,172.31.47.0-255,66,219,96,253049
21019,5.7e-05,172.217.194.0-255,1484,1703,96,253049
21020,6.3e-05,172.31.47.0-255,66,1769,96,253049
21021,6.8e-05,172.217.194.0-255,2902,4671,96,253049
21022,7.1e-05,172.31.47.0-255,66,4737,96,253049
21023,7.7e-05,172.217.194.0-255,7156,11893,96,253049
21024,8e-05,172.31.47.0-255,66,11959,96,253049
21025,8.4e-05,172.217.194.0-255,1985,13944,96,253049
21026,8.8e-05,172.31.47.0-255,66,14010,96,253049
21027,0.000125,172.217.194.0-255,2902,16912,96,253049
21028,0.00013,172.31.47.0-255,66,16978,96,253049
21029,0.000134,172.217.194.0-255,4320,21298,96,253049
21030,0.000137,172.31.47.0-255,66,21364,96,253049
21031,0.000175,172.31.47.0-255,66,21430,96,253049
21032,0.000178,172.217.194.0-255,1125,22555,96,253049
21033,0.000181,172.31.47.0-255,66,22621,96,253049
21034,0.000406,172.217.194.0-255,1484,24105,96,253049
21035,0.000411,172.217.194.0-255,2902,27007,96,253049
21036,0.000414,172.31.47.0-255,66,27073,96,253049
21037,0.000419,172.31.47.0-255,66,27139,96,253049
21038,0.000446,172.217.194.0-255,5738,32877,96,253049
21039,0.00045,172.31.47.0-255,66,32943,96,253049
21040,0.000455,172.217.194.0-255,2902,35845,96,253049
21041,0.000457,172.31.47.0-255,66,35911,96,253049
21042,0.00049,172.217.194.0-255,3961,39872,96,253049
21043,0.000493,172.31.47.0-255,66,39938,96,253049
21044,0.000518,172.217.194.0-255,4320,44258,96,253049
21045,0.000521,172.31.47.0-255,66,44324,96,253049
21046,0.000545,172.31.47.0-255,66,44390,96,253049
21047,0.000567,172.217.194.0-255,1484,45874,96,253049
21048,0.000582,172.217.194.0-255,2844,48718,96,253049
21049,0.000594,172.31.47.0-255,66,48784,96,253049
21050,0.000976,172.217.194.0-255,379,49163,96,253049
21051,0.001159,172.217.194.0-255,1484,50647,96,253049
21052,0.001164,172.31.47.0-255,66,50713,96,253049
21053,0.00119,172.217.194.0-255,2902,53615,96,253049
21054,0.001193,172.217.194.0-255,1484,55099,96,253049
21055,0.001207,172.217.194.0-255,2902,58001,96,253049
21056,0.001217,172.217.194.0-255,2902,60903,96,253049
21057,0.001236,172.217.194.0-255,2902,63805,96,253049
21058,0.00125,172.217.194.0-255,2543,66348,96,253049
21059,0.001267,172.217.194.0-255,4320,70668,96,253049
21060,0.001276,172.217.194.0-255,1484,72152,96,253049
21061,0.001305,172.217.194.0-255,2902,75054,96,253049
21062,0.001697,172.31.47.0-255,66,75120,96,253049
21063,0.002057,172.217.194.0-255,1484,76604,96,253049
21064,0.002075,172.217.194.0-255,2902,79506,96,253049
21065,0.002078,172.31.47.0-255,66,79572,96,253049
21066,0.002084,172.217.194.0-255,5738,85310,96,253049
21067,0.002088,172.31.47.0-255,66,85376,96,253049
21068,0.002146,172.217.194.0-255,5738,91114,96,253049
21069,0.002148,172.31.47.0-255,66,91180,96,253049
21070,0.002152,172.31.47.0-255,66,91246,96,253049
21071,0.002159,172.217.194.0-255,2902,94148,96,253049
21072,0.002164,172.31.47.0-255,66,94214,96,253049
21073,0.002181,172.217.194.0-255,2184,96398,96,253049
21074,0.002186,172.31.47.0-255,66,96464,96,253049
21075,0.004452,172.217.194.0-255,2902,99366,96,253049
21076,0.004456,172.31.47.0-255,66,99432,96,253049
21077,0.004482,172.217.194.0-255,2902,102334,96,253049
21078,0.004486,172.31.47.0-255,66,102400,96,253049
21079,0.006748,172.217.194.0-255,2902,105302,96,253049
21080,0.006753,172.31.47.0-255,66,105368,96,253049
21081,0.006781,172.217.194.0-255,2902,108270,96,253049
21082,0.006802,172.31.47.0-255,66,108336,96,253049
21083,0.009056,172.217.194.0-255,2902,111238,96,253049
21084,0.009068,172.31.47.0-255,66,111304,96,253049
21085,0.009112,172.217.194.0-255,2902,114206,96,253049
21086,0.009161,172.31.47.0-255,66,114272,96,253049
21087,0.011388,172.217.194.0-255,2902,117174,96,253049
21088,0.011402,172.31.47.0-255,66,117240,96,253049
21089,0.011459,172.217.194.0-255,2902,120142,96,253049
21090,0.011509,172.31.47.0-255,66,120208,96,253049
21091,0.013719,172.217.194.0-255,2902,123110,96,253049
21092,0.013726,172.31.47.0-255,66,123176,96,253049
21093,0.013795,172.217.194.0-255,2902,126078,96,253049
21094,0.013818,172.31.47.0-255,66,126144,96,253049
21095,0.016023,172.217.194.0-255,2902,129046,96,253049
21096,0.01603,172.31.47.0-255,66,129112,96,253049
21097,0.016086,172.217.194.0-255,2902,132014,96,253049
21098,0.016109,172.31.47.0-255,66,132080,96,253049
21099,0.018322,172.217.194.0-255,2902,134982,96,253049
21100,0.018329,172.31.47.0-255,66,135048,96,253049
21101,0.018396,172.217.194.0-255,2902,137950,96,253049
21102,0.018442,172.31.47.0-255,66,138016,96,253049
21103,0.020657,172.217.194.0-255,2902,140918,96,253049
21104,0.020662,172.31.47.0-255,66,140984,96,253049
21105,0.020733,172.217.194.0-255,2902,143886,96,253049
21106,0.020739,172.31.47.0-255,66,143952,96,253049
21107,0.022983,172.217.194.0-255,2902,146854,96,253049
21108,0.02299,172.31.47.0-255,66,146920,96,253049
21109,0.023018,172.217.194.0-255,2902,149822,96,253049
21110,0.025292,172.217.194.0-255,2902,152724,96,253049
21111,0.029044,172.31.47.0-255,66,152790,96,253049
21112,0.029464,172.31.47.0-255,172,152962,96,253049
21113,0.029491,172.31.47.0-255,1109,154071,96,253049
21114,0.02954,172.31.47.0-255,1514,155585,96,253049
21115,0.029542,172.31.47.0-255,1302,156887,96,253049
21116,0.030945,104.244.42.0-255,66,156953,96,253049
21117,0.030975,104.244.42.0-255,66,157019,96,253049
21118,0.031038,104.244.42.0-255,66,157085,96,253049
21119,0.031346,172.217.194.0-255,4320,161405,96,253049
21120,0.031351,172.31.47.0-255,66,161471,96,253049
21121,0.031373,172.217.194.0-255,1484,162955,96,253049
21122,0.033653,172.217.194.0-255,4320,167275,96,253049
21123,0.033657,172.31.47.0-255,66,167341,96,253049
21124,0.035967,172.217.194.0-255,5738,173079,96,253049
21125,0.036015,172.31.47.0-255,66,173145,96,253049
21126,0.038307,172.217.194.0-255,5738,178883,96,253049
21127,0.038312,172.31.47.0-255,66,178949,96,253049
21128,0.040641,172.217.194.0-255,5738,184687,96,253049
21129,0.040645,172.31.47.0-255,66,184753,96,253049
21130,0.042944,172.217.194.0-255,5738,190491,96,253049
21131,0.042948,172.31.47.0-255,66,190557,96,253049
21132,0.045239,172.217.194.0-255,5738,196295,96,253049
21133,0.045243,172.31.47.0-255,66,196361,96,253049
21134,0.047544,172.217.194.0-255,5738,202099,96,253049
21135,0.047549,172.31.47.0-255,66,202165,96,253049
21136,0.049832,172.217.194.0-255,5738,207903,96,253049
21137,0.049838,172.31.47.0-255,66,207969,96,253049
21138,0.052138,172.217.194.0-255,5738,213707,96,253049
21139,0.052142,172.31.47.0-255,66,213773,96,253049
21140,0.054457,172.217.194.0-255,4320,218093,96,253049
21141,0.054462,172.31.47.0-255,66,218159,96,253049
21142,0.054488,172.217.194.0-255,1484,219643,96,253049
21143,0.056748,172.217.194.0-255,4320,223963,96,253049
21144,0.056753,172.31.47.0-255,66,224029,96,253049
21145,0.059041,172.217.194.0-255,5738,229767,96,253049
21146,0.059146,172.31.47.0-255,66,229833,96,253049
21147,0.061434,172.217.194.0-255,5738,235571,96,253049
21148,0.061438,172.31.47.0-255,66,235637,96,253049
21149,0.06374,172.217.194.0-255,5738,241375,96,253049
21150,0.063747,172.31.47.0-255,66,241441,96,253049
21151,0.066061,172.217.194.0-255,5738,247179,96,253049
21152,0.066068,172.31.47.0-255,66,247245,96,253049
21153,0.06838,172.217.194.0-255,5738,252983,96,253049
21154,0.068385,172.31.47.0-255,66,253049,96,253049
21155,0.0,74.125.24.0-255,153,153,96,352615
21156,3e-05,172.31.47.0-255,66,219,96,352615
21157,3.6e-05,74.125.24.0-255,1484,1703,96,352615
21158,4e-05,172.31.47.0-255,66,1769,96,352615
21159,4.4e-05,74.125.24.0-255,2902,4671,96,352615
21160,4.6e-05,172.31.47.0-255,66,4737,96,352615
21161,6.4e-05,74.125.24.0-255,5738,10475,96,352615
21162,6.6e-05,172.31.47.0-255,66,10541,96,352615
21163,0.000106,74.125.24.0-255,2902,13443,96,352615
21164,0.000109,172.31.47.0-255,66,13509,96,352615
21165,0.000135,172.31.47.0-255,66,13575,96,352615
21166,0.000151,74.125.24.0-255,1484,15059,96,352615
21167,0.000153,172.31.47.0-255,66,15125,96,352615
21168,0.000171,172.31.47.0-255,66,15191,96,352615
21169,0.000273,74.125.24.0-255,1484,16675,96,352615
21170,0.000277,172.31.47.0-255,66,16741,96,352615
21171,0.00028,74.125.24.0-255,1484,18225,96,352615
21172,0.000281,172.31.47.0-255,66,18291,96,352615
21173,0.000293,74.125.24.0-255,1484,19775,96,352615
21174,0.000296,172.31.47.0-255,66,19841,96,352615
21175,0.000299,74.125.24.0-255,1484,21325,96,352615
21176,0.000302,172.31.47.0-255,66,21391,96,352615
21177,0.000311,74.125.24.0-255,2902,24293,96,352615
21178,0.000313,172.31.47.0-255,66,24359,96,352615
21179,0.00036,74.125.24.0-255,4320,28679,96,352615
21180,0.000363,172.31.47.0-255,66,28745,96,352615
21181,0.000387,74.125.24.0-255,5379,34124,96,352615
21182,0.000392,172.31.47.0-255,66,34190,96,352615
21183,0.000397,172.31.47.0-255,66,34256,96,352615
21184,0.000399,74.125.24.0-255,1484,35740,96,352615
21185,0.000426,74.125.24.0-255,4274,40014,96,352615
21186,0.000428,172.31.47.0-255,66,40080,96,352615
21187,0.000431,74.125.24.0-255,109,40189,96,352615
21188,0.000528,74.125.24.0-255,329,40518,96,352615
21189,0.000571,74.125.24.0-255,1484,42002,96,352615
21190,0.000574,172.31.47.0-255,66,42068,96,352615
21191,0.000589,74.125.24.0-255,4320,46388,96,352615
21192,0.000591,172.31.47.0-255,66,46454,96,352615
21193,0.000608,74.125.24.0-255,1484,47938,96,352615
21194,0.000629,74.125.24.0-255,5738,53676,96,352615
21195,0.000632,172.31.47.0-255,66,53742,96,352615
21196,0.000656,74.125.24.0-255,1484,55226,96,352615
21197,0.000674,74.125.24.0-255,2543,57769,96,352615
21198,0.000677,172.31.47.0-255,66,57835,96,352615
21199,0.001019,74.125.24.0-255,1484,59319,96,352615
21200,0.001029,74.125.24.0-255,2902,62221,96,352615
21201,0.001033,172.31.47.0-255,66,62287,96,352615
21202,0.001039,74.125.24.0-255,4320,66607,96,352615
21203,0.001042,172.31.47.0-255,66,66673,96,352615
21204,0.001056,74.125.24.0-255,1484,68157,96,352615
21205,0.001064,74.125.24.0-255,6797,74954,96,352615
21206,0.001066,172.31.47.0-255,66,75020,96,352615
21207,0.001271,74.125.24.0-255,1484,76504,96,352615
21208,0.001278,74.125.24.0-255,2902,79406,96,352615
21209,0.001282,172.31.47.0-255,66,79472,96,352615
21210,0.001304,74.125.24.0-255,5738,85210,96,352615
21211,0.001306,172.31.47.0-255,66,85276,96,352615
21212,0.001337,74.125.24.0-255,2902,88178,96,352615
21213,0.00134,172.31.47.0-255,66,88244,96,352615
21214,0.001362,74.125.24.0-255,4320,92564,96,352615
21215,0.001364,172.31.47.0-255,66,92630,96,352615
21216,0.001433,74.125.24.0-255,5738,98368,96,352615
21217,0.001437,172.31.47.0-255,66,98434,96,352615
21218,0.001448,74.125.24.0-255,1484,99918,96,352615
21219,0.00146,74.125.24.0-255,4320,104238,96,352615
21220,0.001462,172.31.47.0-255,66,104304,96,352615
21221,0.001478,74.125.24.0-255,4320,108624,96,352615
21222,0.00148,172.31.47.0-255,66,108690,96,352615
21223,0.001483,74.125.24.0-255,766,109456,96,352615
21224,0.001622,74.125.24.0-255,1484,110940,96,352615
21225,0.001624,172.31.47.0-255,66,111006,96,352615
21226,0.001636,74.125.24.0-255,2902,113908,96,352615
21227,0.001638,172.31.47.0-255,66,113974,96,352615
21228,0.001659,74.125.24.0-255,5738,119712,96,352615
21229,0.001661,172.31.47.0-255,66,119778,96,352615
21230,0.001679,74.125.24.0-255,1484,121262,96,352615
21231,0.001706,172.31.47.0-255,66,121328,96,352615
21232,0.001721,74.125.24.0-255,1484,122812,96,352615
21233,0.001748,74.125.24.0-255,7156,129968,96,352615
21234,0.00175,172.31.47.0-255,66,130034,96,352615
21235,0.001764,74.125.24.0-255,3602,133636,96,352615
21236,0.001766,172.31.47.0-255,66,133702,96,352615
21237,0.001901,74.125.24.0-255,1484,135186,96,352615
21238,0.001919,74.125.24.0-255,2902,138088,96,352615
21239,0.001922,172.31.47.0-255,66,138154,96,352615
21240,0.001926,74.125.24.0-255,2902,141056,96,352615
21241,0.001927,172.31.47.0-255,66,141122,96,352615
21242,0.001943,74.125.24.0-255,2902,144024,96,352615
21243,0.001946,172.31.47.0-255,66,144090,96,352615
21244,0.001949,74.125.24.0-255,2902,146992,96,352615
21245,0.001951,172.31.47.0-255,66,147058,96,352615
21246,0.001991,74.125.24.0-255,1484,148542,96,352615
21247,0.002006,74.125.24.0-255,7156,155698,96,352615
21248,0.002009,172.31.47.0-255,66,155764,96,352615
21249,0.002026,74.125.24.0-255,1484,157248,96,352615
21250,0.002037,172.31.47.0-255,66,157314,96,352615
21251,0.004066,74.125.24.0-255,5738,163052,96,352615
21252,0.004071,172.31.47.0-255,66,163118,96,352615
21253,0.00608,74.125.24.0-255,4320,167438,96,352615
21254,0.006085,172.31.47.0-255,66,167504,96,352615
21255,0.006112,74.125.24.0-255,1484,168988,96,352615
21256,0.008086,74.125.24.0-255,4320,173308,96,352615
21257,0.008092,172.31.47.0-255,66,173374,96,352615
21258,0.010098,74.125.24.0-255,5738,179112,96,352615
21259,0.010105,172.31.47.0-255,66,179178,96,352615
21260,0.012116,74.125.24.0-255,5738,184916,96,352615
21261,0.012123,172.31.47.0-255,66,184982,96,352615
21262,0.014143,74.125.24.0-255,5738,190720,96,352615
21263,0.014151,172.31.47.0-255,66,190786,96,352615
21264,0.016175,74.125.24.0-255,5738,196524,96,352615
21265,0.016182,172.31.47.0-255,66,196590,96,352615
21266,0.018196,74.125.24.0-255,5738,202328,96,352615
21267,0.018205,172.31.47.0-255,66,202394,96,352615
21268,0.020239,74.125.24.0-255,5738,208132,96,352615
21269,0.020247,172.31.47.0-255,66,208198,96,352615
21270,0.022277,74.125.24.0-255,5738,213936,96,352615
21271,0.022287,172.31.47.0-255,66,214002,96,352615
21272,0.023065,172.31.47.0-255,172,214174,96,352615
21273,0.023099,172.31.47.0-255,1105,215279,96,352615
21274,0.023131,172.31.47.0-255,1514,216793,96,352615
21275,0.023133,172.31.47.0-255,1306,218099,96,352615
21276,0.024346,74.125.24.0-255,5738,223837,96,352615
21277,0.024351,172.31.47.0-255,66,223903,96,352615
21278,0.024621,104.244.42.0-255,66,223969,96,352615
21279,0.024667,104.244.42.0-255,66,224035,96,352615
21280,0.024708,104.244.42.0-255,66,224101,96,352615
21281,0.02634,74.125.24.0-255,2902,227003,96,352615
21282,0.026344,172.31.47.0-255,66,227069,96,352615
21283,0.026373,74.125.24.0-255,2902,229971,96,352615
21284,0.026376,172.31.47.0-255,66,230037,96,352615
21285,0.028351,74.125.24.0-255,2902,232939,96,352615
21286,0.028355,172.31.47.0-255,66,233005,96,352615
21287,0.028399,74.125.24.0-255,1484,234489,96,352615
21288,0.028409,74.125.24.0-255,1484,235973,96,352615
21289,0.028412,172.31.47.0-255,66,236039,96,352615
21290,0.030379,74.125.24.0-255,2902,238941,96,352615
21291,0.030384,172.31.47.0-255,66,239007,96,352615
21292,0.030449,74.125.24.0-255,2902,241909,96,352615
21293,0.030453,172.31.47.0-255,66,241975,96,352615
21294,0.032386,74.125.24.0-255,2902,244877,96,352615
21295,0.03239,172.31.47.0-255,66,244943,96,352615
21296,0.032438,74.125.24.0-255,2902,247845,96,352615
21297,0.032442,172.31.47.0-255,66,247911,96,352615
21298,0.034399,74.125.24.0-255,2902,250813,96,352615
21299,0.034404,172.31.47.0-255,66,250879,96,352615
21300,0.03445,74.125.24.0-255,2902,253781,96,352615
21301,0.034455,172.31.47.0-255,66,253847,96,352615
21302,0.036428,74.125.24.0-255,2902,256749,96,352615
21303,0.036433,172.31.47.0-255,66,256815,96,352615
21304,0.036461,74.125.24.0-255,1484,258299,96,352615
21305,0.036476,74.125.24.0-255,1484,259783,96,352615
21306,0.036479,172.31.47.0-255,66,259849,96,352615
21307,0.038438,74.125.24.0-255,2902,262751,96,352615
21308,0.038443,172.31.47.0-255,66,262817,96,352615
21309,0.038478,74.125.24.0-255,2902,265719,96,352615
21310,0.038481,172.31.47.0-255,66,265785,96,352615
21311,0.040457,74.125.24.0-255,2902,268687,96,352615
21312,0.040461,172.31.47.0-255,66,268753,96,352615
21313,0.040522,74.125.24.0-255,2902,271655,96,352615
21314,0.040526,172.31.47.0-255,66,271721,96,352615
21315,0.042454,74.125.24.0-255,2902,274623,96,352615
21316,0.042458,172.31.47.0-255,66,274689,96,352615
21317,0.042541,74.125.24.0-255,2902,277591,96,352615
21318,0.042544,172.31.47.0-255,66,277657,96,352615
21319,0.04446,74.125.24.0-255,2902,280559,96,352615
21320,0.044464,172.31.47.0-255,66,280625,96,352615
21321,0.044546,74.125.24.0-255,2902,283527,96,352615
21322,0.04455,172.31.47.0-255,66,283593,96,352615
21323,0.046466,74.125.24.0-255,2902,286495,96,352615
21324,0.046471,172.31.47.0-255,66,286561,96,352615
21325,0.046585,74.125.24.0-255,2902,289463,96,352615
21326,0.04659,172.31.47.0-255,66,289529,96,352615
21327,0.048453,74.125.24.0-255,2902,292431,96,352615
21328,0.048458,172.31.47.0-255,66,292497,96,352615
21329,0.048604,74.125.24.0-255,2902,295399,96,352615
21330,0.048609,172.31.47.0-255,66,295465,96,352615
21331,0.050466,74.125.24.0-255,1484,296949,96,352615
21332,0.050632,74.125.24.0-255,4320,301269,96,352615
21333,0.050639,172.31.47.0-255,66,301335,96,352615
21334,0.052686,74.125.24.0-255,5738,307073,96,352615
21335,0.052692,172.31.47.0-255,66,307139,96,352615
21336,0.054715,74.125.24.0-255,4320,311459,96,352615
21337,0.05472,172.31.47.0-255,66,311525,96,352615
21338,0.054749,74.125.24.0-255,1484,313009,96,352615
21339,0.056709,74.125.24.0-255,4320,317329,96,352615
21340,0.056713,172.31.47.0-255,66,317395,96,352615
21341,0.058726,74.125.24.0-255,5738,323133,96,352615
21342,0.058731,172.31.47.0-255,66,323199,96,352615
21343,0.06075,74.125.24.0-255,5738,328937,96,352615
21344,0.060754,172.31.47.0-255,66,329003,96,352615
21345,0.062775,74.125.24.0-255,5738,334741,96,352615
21346,0.062781,172.31.47.0-255,66,334807,96,352615
21347,0.064808,74.125.24.0-255,2902,337709,96,352615
21348,0.064814,172.31.47.0-255,66,337775,96,352615
21349,0.064844,74.125.24.0-255,2902,340677,96,352615
21350,0.064847,172.31.47.0-255,66,340743,96,352615
21351,0.066821,74.125.24.0-255,2902,343645,96,352615
21352,0.066826,172.31.47.0-255,66,343711,96,352615
21353,0.066851,74.125.24.0-255,2902,346613,96,352615
21354,0.066853,172.31.47.0-255,66,346679,96,352615
21355,0.068848,74.125.24.0-255,2902,349581,96,352615
21356,0.068855,172.31.47.0-255,66,349647,96,352615
21357,0.068891,74.125.24.0-255,2902,352549,96,352615
21358,0.068894,172.31.47.0-255,66,352615,96,352615
21359,0.0,172.217.160.0-255,153,153,96,331275
21360,3.4e-05,172.31.47.0-255,66,219,96,331275
21361,4.1e-05,172.217.160.0-255,1484,1703,96,331275
21362,4.6e-05,172.31.47.0-255,66,1769,96,331275
21363,5e-05,172.217.160.0-255,2902,4671,96,331275
21364,5.2e-05,172.31.47.0-255,66,4737,96,331275
21365,5.9e-05,172.217.160.0-255,7156,11893,96,331275
21366,6.2e-05,172.31.47.0-255,66,11959,96,331275
21367,6.6e-05,172.217.160.0-255,2165,14124,96,331275
21368,7e-05,172.31.47.0-255,66,14190,96,331275
21369,9.4e-05,172.217.160.0-255,2902,17092,96,331275
21370,9.8e-05,172.31.47.0-255,66,17158,96,331275
21371,0.000106,172.217.160.0-255,7156,24314,96,331275
21372,0.000108,172.31.47.0-255,66,24380,96,331275
21373,0.000144,172.217.160.0-255,6797,31177,96,331275
21374,0.000147,172.31.47.0-255,66,31243,96,331275
21375,0.000219,172.217.160.0-255,1484,32727,96,331275
21376,0.000222,172.31.47.0-255,66,32793,96,331275
21377,0.000228,172.217.160.0-255,2902,35695,96,331275
21378,0.00023,172.31.47.0-255,66,35761,96,331275
21379,0.000236,172.217.160.0-255,4320,40081,96,331275
21380,0.000239,172.31.47.0-255,66,40147,96,331275
21381,0.000253,172.217.160.0-255,1484,41631,96,331275
21382,0.000255,172.31.47.0-255,66,41697,96,331275
21383,0.000274,172.217.160.0-255,5738,47435,96,331275
21384,0.000276,172.31.47.0-255,66,47501,96,331275
21385,0.000302,172.31.47.0-255,66,47567,96,331275
21386,0.000325,172.217.160.0-255,7156,54723,96,331275
21387,0.000329,172.31.47.0-255,66,54789,96,331275
21388,0.000347,172.217.160.0-255,2813,57602,96,331275
21389,0.00035,172.31.47.0-255,66,57668,96,331275
21390,0.000712,172.217.160.0-255,120,57788,96,331275
21391,0.000716,172.31.47.0-255,66,57854,96,331275
21392,0.000872,172.217.160.0-255,1484,59338,96,331275
21393,0.000877,172.31.47.0-255,66,59404,96,331275
21394,0.000883,172.217.160.0-255,1484,60888,96,331275
21395,0.000885,172.31.47.0-255,66,60954,96,331275
21396,0.000908,172.217.160.0-255,1484,62438,96,331275
21397,0.000915,172.217.160.0-255,5738,68176,96,331275
21398,0.000917,172.31.47.0-255,66,68242,96,331275
21399,0.000938,172.217.160.0-255,6797,75039,96,331275
21400,0.000941,172.31.47.0-255,66,75105,96,331275
21401,0.000972,172.217.160.0-255,2902,78007,96,331275
21402,0.000976,172.31.47.0-255,66,78073,96,331275
21403,0.000997,172.31.47.0-255,66,78139,96,331275
21404,0.001003,172.217.160.0-255,5699,83838,96,331275
21405,0.001006,172.31.47.0-255,66,83904,96,331275
21406,0.00262,172.217.160.0-255,5738,89642,96,331275
21407,0.002626,172.31.47.0-255,66,89708,96,331275
21408,0.004228,172.217.160.0-255,2902,92610,96,331275
21409,0.004231,172.31.47.0-255,66,92676,96,331275
21410,0.004245,172.217.160.0-255,2902,95578,96,331275
21411,0.004247,172.31.47.0-255,66,95644,96,331275
21412,0.005821,172.217.160.0-255,2902,98546,96,331275
21413,0.005824,172.31.47.0-255,66,98612,96,331275
21414,0.005841,172.217.160.0-255,2902,101514,96,331275
21415,0.005843,172.31.47.0-255,66,101580,96,331275
21416,0.007432,172.217.160.0-255,5738,107318,96,331275
21417,0.00744,172.31.47.0-255,66,107384,96,331275
21418,0.009044,172.217.160.0-255,5738,113122,96,331275
21419,0.009051,172.31.47.0-255,66,113188,96,331275
21420,0.010673,172.217.160.0-255,5738,118926,96,331275
21421,0.01068,172.31.47.0-255,66,118992,96,331275
21422,0.012291,172.217.160.0-255,5738,124730,96,331275
21423,0.012298,172.31.47.0-255,66,124796,96,331275
21424,0.01391,172.217.160.0-255,5738,130534,96,331275
21425,0.013923,172.31.47.0-255,66,130600,96,331275
21426,0.015529,172.217.160.0-255,5738,136338,96,331275
21427,0.015539,172.31.47.0-255,66,136404,96,331275
21428,0.017147,172.217.160.0-255,5738,142142,96,331275
21429,0.017158,172.31.47.0-255,66,142208,96,331275
21430,0.018768,172.217.160.0-255,5738,147946,96,331275
21431,0.018775,172.31.47.0-255,66,148012,96,331275
21432,0.020383,172.217.160.0-255,5738,153750,96,331275
21433,0.02039,172.31.47.0-255,66,153816,96,331275
21434,0.022028,172.217.160.0-255,5738,159554,96,331275
21435,0.022035,172.31.47.0-255,66,159620,96,331275
21436,0.023633,172.217.160.0-255,5738,165358,96,331275
21437,0.023639,172.31.47.0-255,66,165424,96,331275
21438,0.025237,172.217.160.0-255,5738,171162,96,331275
21439,0.025242,172.31.47.0-255,66,171228,96,331275
21440,0.026195,172.31.47.0-255,172,171400,96,331275
21441,0.026226,172.31.47.0-255,1101,172501,96,331275
21442,0.026267,172.31.47.0-255,1514,174015,96,331275
21443,0.026269,172.31.47.0-255,1310,175325,96,331275
21444,0.02685,172.217.160.0-255,5738,181063,96,331275
21445,0.026859,172.31.47.0-255,66,181129,96,331275
21446,0.027749,104.244.42.0-255,66,181195,96,331275
21447,0.027781,104.244.42.0-255,66,181261,96,331275
21448,0.027837,104.244.42.0-255,66,181327,96,331275
21449,0.02846,172.217.160.0-255,5738,187065,96,331275
21450,0.028466,172.31.47.0-255,66,187131,96,331275
21451,0.030066,172.217.160.0-255,4320,191451,96,331275
21452,0.030073,172.31.47.0-255,66,191517,96,331275
21453,0.0301,172.217.160.0-255,1484,193001,96,331275
21454,0.031675,172.217.160.0-255,4320,197321,96,331275
21455,0.031681,172.31.47.0-255,66,197387,96,331275
21456,0.033306,172.217.160.0-255,5738,203125,96,331275
21457,0.033312,172.31.47.0-255,66,203191,96,331275
21458,0.034916,172.217.160.0-255,5738,208929,96,331275
21459,0.034925,172.31.47.0-255,66,208995,96,331275
21460,0.036524,172.217.160.0-255,5738,214733,96,331275
21461,0.03653,172.31.47.0-255,66,214799,96,331275
21462,0.038132,172.217.160.0-255,5738,220537,96,331275
21463,0.038138,172.31.47.0-255,66,220603,96,331275
21464,0.039748,172.217.160.0-255,2902,223505,96,331275
21465,0.039756,172.31.47.0-255,66,223571,96,331275
21466,0.039784,172.217.160.0-255,2902,226473,96,331275
21467,0.039789,172.31.47.0-255,66,226539,96,331275
21468,0.041362,172.217.160.0-255,2902,229441,96,331275
21469,0.04137,172.31.47.0-255,66,229507,96,331275
21470,0.041401,172.217.160.0-255,2902,232409,96,331275
21471,0.041404,172.31.47.0-255,66,232475,96,331275
21472,0.042998,172.217.160.0-255,2902,235377,96,331275
21473,0.043006,172.31.47.0-255,66,235443,96,331275
21474,0.04303,172.217.160.0-255,2902,238345,96,331275
21475,0.043032,172.31.47.0-255,66,238411,96,331275
21476,0.044634,172.217.160.0-255,5738,244149,96,331275
21477,0.044654,172.31.47.0-255,66,244215,96,331275
21478,0.046282,172.217.160.0-255,5738,249953,96,331275
21479,0.046305,172.31.47.0-255,66,250019,96,331275
21480,0.047948,172.217.160.0-255,5738,255757,96,331275
21481,0.047968,172.31.47.0-255,66,255823,96,331275
21482,0.049594,172.217.160.0-255,5738,261561,96,331275
21483,0.049611,172.31.47.0-255,66,261627,96,331275
21484,0.051255,172.217.160.0-255,5738,267365,96,331275
21485,0.051281,172.31.47.0-255,66,267431,96,331275
21486,0.052914,172.217.160.0-255,5738,273169,96,331275
21487,0.052937,172.31.47.0-255,66,273235,96,331275
21488,0.05456,172.217.160.0-255,5738,278973,96,331275
21489,0.05458,172.31.47.0-255,66,279039,96,331275
21490,0.056215,172.217.160.0-255,5738,284777,96,331275
21491,0.056237,172.31.47.0-255,66,284843,96,331275
21492,0.057871,172.217.160.0-255,5738,290581,96,331275
21493,0.057888,172.31.47.0-255,66,290647,96,331275
21494,0.059519,172.217.160.0-255,5738,296385,96,331275
21495,0.059541,172.31.47.0-255,66,296451,96,331275
21496,0.061166,172.217.160.0-255,5738,302189,96,331275
21497,0.06119,172.31.47.0-255,66,302255,96,331275
21498,0.062807,172.217.160.0-255,5738,307993,96,331275
21499,0.06282,172.31.47.0-255,66,308059,96,331275
21500,0.064428,172.217.160.0-255,5738,313797,96,331275
21501,0.06444,172.31.47.0-255,66,313863,96,331275
21502,0.066067,172.217.160.0-255,5738,319601,96,331275
21503,0.066088,172.31.47.0-255,66,319667,96,331275
21504,0.067699,172.217.160.0-255,5738,325405,96,331275
21505,0.067712,172.31.47.0-255,66,325471,96,331275
21506,0.069313,172.217.160.0-255,5738,331209,96,331275
21507,0.069319,172.31.47.0-255,66,331275,96,331275
21508,0.0,172.31.47.0-255,105,105,96,276
21509,0.001473,157.240.13.0-255,105,210,96,276
21510,0.001484,172.31.47.0-255,66,276,96,276
21511,0.0,172.31.47.0-255,66,66,96,66
21512,0.0,74.125.24.0-255,153,153,96,202841
21513,3.2e-05,172.31.47.0-255,66,219,96,202841
21514,3.9e-05,74.125.24.0-255,1484,1703,96,202841
21515,4.4e-05,172.31.47.0-255,66,1769,96,202841
21516,4.9e-05,74.125.24.0-255,2902,4671,96,202841
21517,5.1e-05,172.31.47.0-255,66,4737,96,202841
21518,5.8e-05,74.125.24.0-255,5738,10475,96,202841
21519,6.1e-05,172.31.47.0-255,66,10541,96,202841
21520,7.9e-05,74.125.24.0-255,4320,14861,96,202841
21521,8.1e-05,172.31.47.0-255,66,14927,96,202841
21522,0.000111,74.125.24.0-255,6362,21289,96,202841
21523,0.000114,172.31.47.0-255,66,21355,96,202841
21524,0.000134,74.125.24.0-255,4320,25675,96,202841
21525,0.000137,172.31.47.0-255,66,25741,96,202841
21526,0.000155,74.125.24.0-255,5379,31120,96,202841
21527,0.000157,172.31.47.0-255,66,31186,96,202841
21528,0.000188,74.125.24.0-255,1484,32670,96,202841
21529,0.000191,172.31.47.0-255,66,32736,96,202841
21530,0.000204,74.125.24.0-255,2902,35638,96,202841
21531,0.000206,172.31.47.0-255,66,35704,96,202841
21532,0.000213,74.125.24.0-255,5738,41442,96,202841
21533,0.000216,172.31.47.0-255,66,41508,96,202841
21534,0.000252,172.31.47.0-255,66,41574,96,202841
21535,0.000264,172.31.47.0-255,66,41640,96,202841
21536,0.00028,74.125.24.0-255,1484,43124,96,202841
21537,0.000283,172.31.47.0-255,66,43190,96,202841
21538,0.000305,74.125.24.0-255,2855,46045,96,202841
21539,0.000307,172.31.47.0-255,66,46111,96,202841
21540,0.000749,74.125.24.0-255,344,46455,96,202841
21541,0.000753,172.31.47.0-255,66,46521,96,202841
21542,0.000866,74.125.24.0-255,1484,48005,96,202841
21543,0.000874,74.125.24.0-255,2902,50907,96,202841
21544,0.000879,172.31.47.0-255,66,50973,96,202841
21545,0.000887,74.125.24.0-255,5738,56711,96,202841
21546,0.000889,172.31.47.0-255,66,56777,96,202841
21547,0.000911,172.31.47.0-255,66,56843,96,202841
21548,0.000963,74.125.24.0-255,5738,62581,96,202841
21549,0.000967,172.31.47.0-255,66,62647,96,202841
21550,0.000988,172.31.47.0-255,66,62713,96,202841
21551,0.001297,74.125.24.0-255,1484,64197,96,202841
21552,0.001306,74.125.24.0-255,2902,67099,96,202841
21553,0.00131,172.31.47.0-255,66,67165,96,202841
21554,0.001316,74.125.24.0-255,2902,70067,96,202841
21555,0.001318,172.31.47.0-255,66,70133,96,202841
21556,0.001331,74.125.24.0-255,2902,73035,96,202841
21557,0.001333,172.31.47.0-255,66,73101,96,202841
21558,0.001337,74.125.24.0-255,2902,76003,96,202841
21559,0.001339,172.31.47.0-255,66,76069,96,202841
21560,0.001366,172.31.47.0-255,66,76135,96,202841
21561,0.001376,172.31.47.0-255,66,76201,96,202841
21562,0.001404,74.125.24.0-255,766,76967,96,202841
21563,0.001476,74.125.24.0-255,1484,78451,96,202841
21564,0.00148,172.31.47.0-255,66,78517,96,202841
21565,0.001499,74.125.24.0-255,2902,81419,96,202841
21566,0.001501,172.31.47.0-255,66,81485,96,202841
21567,0.001508,74.125.24.0-255,5738,87223,96,202841
21568,0.001509,172.31.47.0-255,66,87289,96,202841
21569,0.001537,74.125.24.0-255,5738,93027,96,202841
21570,0.001539,172.31.47.0-255,66,93093,96,202841
21571,0.001559,74.125.24.0-255,1484,94577,96,202841
21572,0.001572,172.31.47.0-255,66,94643,96,202841
21573,0.001622,74.125.24.0-255,2184,96827,96,202841
21574,0.001626,172.31.47.0-255,66,96893,96,202841
21575,0.001691,74.125.24.0-255,1484,98377,96,202841
21576,0.001702,74.125.24.0-255,2902,101279,96,202841
21577,0.001706,172.31.47.0-255,66,101345,96,202841
21578,0.001709,74.125.24.0-255,1484,102829,96,202841
21579,0.001726,74.125.24.0-255,5738,108567,96,202841
21580,0.001729,172.31.47.0-255,66,108633,96,202841
21581,0.001745,74.125.24.0-255,1484,110117,96,202841
21582,0.001768,172.31.47.0-255,66,110183,96,202841
21583,0.00177,74.125.24.0-255,1484,111667,96,202841
21584,0.001813,74.125.24.0-255,4320,115987,96,202841
21585,0.001816,172.31.47.0-255,66,116053,96,202841
21586,0.001832,74.125.24.0-255,3602,119655,96,202841
21587,0.001834,172.31.47.0-255,66,119721,96,202841
21588,0.002067,74.125.24.0-255,1484,121205,96,202841
21589,0.002104,74.125.24.0-255,1484,122689,96,202841
21590,0.002106,172.31.47.0-255,66,122755,96,202841
21591,0.002122,74.125.24.0-255,1484,124239,96,202841
21592,0.002124,74.125.24.0-255,1484,125723,96,202841
21593,0.002126,172.31.47.0-255,66,125789,96,202841
21594,0.002138,74.125.24.0-255,5738,131527,96,202841
21595,0.00214,172.31.47.0-255,66,131593,96,202841
21596,0.002173,172.31.47.0-255,66,131659,96,202841
21597,0.002177,74.125.24.0-255,4320,135979,96,202841
21598,0.002179,172.31.47.0-255,66,136045,96,202841
21599,0.002202,172.31.47.0-255,66,136111,96,202841
21600,0.002206,74.125.24.0-255,4320,140431,96,202841
21601,0.002207,172.31.47.0-255,66,140497,96,202841
21602,0.002244,172.31.47.0-255,66,140563,96,202841
21603,0.002255,74.125.24.0-255,5738,146301,96,202841
21604,0.002257,172.31.47.0-255,66,146367,96,202841
21605,0.00229,74.125.24.0-255,2902,149269,96,202841
21606,0.002292,172.31.47.0-255,66,149335,96,202841
21607,0.002311,74.125.24.0-255,7156,156491,96,202841
21608,0.002313,172.31.47.0-255,66,156557,96,202841
21609,0.002328,74.125.24.0-255,6438,162995,96,202841
21610,0.00233,172.31.47.0-255,66,163061,96,202841
21611,0.002332,74.125.24.0-255,1484,164545,96,202841
21612,0.002363,172.31.47.0-255,66,164611,96,202841
21613,0.002385,74.125.24.0-255,5738,170349,96,202841
21614,0.002387,172.31.47.0-255,66,170415,96,202841
21615,0.002397,172.31.47.0-255,66,170481,96,202841
21616,0.002404,74.125.24.0-255,7156,177637,96,202841
21617,0.002406,172.31.47.0-255,66,177703,96,202841
21618,0.002434,74.125.24.0-255,2184,179887,96,202841
21619,0.002436,172.31.47.0-255,66,179953,96,202841
21620,0.002448,172.31.47.0-255,66,180019,96,202841
21621,0.002466,172.31.47.0-255,66,180085,96,202841
21622,0.002505,74.125.24.0-255,5738,185823,96,202841
21623,0.002508,172.31.47.0-255,66,185889,96,202841
21624,0.002522,74.125.24.0-255,4320,190209,96,202841
21625,0.002524,172.31.47.0-255,66,190275,96,202841
21626,0.002542,172.31.47.0-255,66,190341,96,202841
21627,0.002553,172.31.47.0-255,66,190407,96,202841
21628,0.002586,172.31.47.0-255,66,190473,96,202841
21629,0.002598,74.125.24.0-255,1484,191957,96,202841
21630,0.002601,74.125.24.0-255,1484,193441,96,202841
21631,0.002613,74.125.24.0-255,1888,195329,96,202841
21632,0.002638,74.125.24.0-255,105,195434,96,202841
21633,0.0097,172.31.47.0-255,66,195500,96,202841
21634,0.012038,172.31.47.0-255,105,195605,96,202841
21635,0.014351,74.125.24.0-255,66,195671,96,202841
21636,0.051138,172.31.47.0-255,172,195843,96,202841
21637,0.05117,172.31.47.0-255,1101,196944,96,202841
21638,0.051223,172.31.47.0-255,1514,198458,96,202841
21639,0.051225,172.31.47.0-255,1514,199972,96,202841
21640,0.051226,172.31.47.0-255,1514,201486,96,202841
21641,0.051227,172.31.47.0-255,1091,202577,96,202841
21642,0.052668,104.244.42.0-255,66,202643,96,202841
21643,0.0527,104.244.42.0-255,66,202709,96,202841
21644,0.052778,104.244.42.0-255,66,202775,96,202841
21645,0.052782,104.244.42.0-255,66,202841,96,202841
21646,0.0,74.125.68.0-255,153,153,96,385999
21647,2.7e-05,172.31.47.0-255,66,219,96,385999
21648,3.3e-05,74.125.68.0-255,1484,1703,96,385999
21649,3.7e-05,172.31.47.0-255,66,1769,96,385999
21650,6.8e-05,74.125.68.0-255,1484,3253,96,385999
21651,7e-05,172.31.47.0-255,66,3319,96,385999
21652,8.9e-05,74.125.68.0-255,2902,6221,96,385999
21653,9.3e-05,172.31.47.0-255,66,6287,96,385999
21654,0.000111,74.125.68.0-255,4320,10607,96,385999
21655,0.000113,172.31.47.0-255,66,10673,96,385999
21656,0.000149,74.125.68.0-255,2902,13575,96,385999
21657,0.000153,172.31.47.0-255,66,13641,96,385999
21658,0.000173,74.125.68.0-255,6429,20070,96,385999
21659,0.000176,172.31.47.0-255,66,20136,96,385999
21660,0.000194,74.125.68.0-255,1484,21620,96,385999
21661,0.000196,172.31.47.0-255,66,21686,96,385999
21662,0.00022,172.31.47.0-255,66,21752,96,385999
21663,0.000243,74.125.68.0-255,1125,22877,96,385999
21664,0.000246,172.31.47.0-255,66,22943,96,385999
21665,0.000319,74.125.68.0-255,1484,24427,96,385999
21666,0.000323,172.31.47.0-255,66,24493,96,385999
21667,0.000338,74.125.68.0-255,2902,27395,96,385999
21668,0.000341,172.31.47.0-255,66,27461,96,385999
21669,0.00036,74.125.68.0-255,2902,30363,96,385999
21670,0.000363,172.31.47.0-255,66,30429,96,385999
21671,0.000368,74.125.68.0-255,4320,34749,96,385999
21672,0.00037,172.31.47.0-255,66,34815,96,385999
21673,0.000403,74.125.68.0-255,2902,37717,96,385999
21674,0.000406,172.31.47.0-255,66,37783,96,385999
21675,0.000423,74.125.68.0-255,2543,40326,96,385999
21676,0.000426,172.31.47.0-255,66,40392,96,385999
21677,0.000431,74.125.68.0-255,5738,46130,96,385999
21678,0.000441,172.31.47.0-255,66,46196,96,385999
21679,0.000454,74.125.68.0-255,2902,49098,96,385999
21680,0.000465,172.31.47.0-255,66,49164,96,385999
21681,0.000486,74.125.68.0-255,110,49274,96,385999
21682,0.000492,172.31.47.0-255,66,49340,96,385999
21683,0.000543,74.125.68.0-255,332,49672,96,385999
21684,0.000711,172.31.47.0-255,66,49738,96,385999
21685,0.000871,74.125.68.0-255,1484,51222,96,385999
21686,0.000878,74.125.68.0-255,2902,54124,96,385999
21687,0.000946,74.125.68.0-255,1484,55608,96,385999
21688,0.000958,74.125.68.0-255,1484,57092,96,385999
21689,0.000974,74.125.68.0-255,2902,59994,96,385999
21690,0.001009,74.125.68.0-255,1484,61478,96,385999
21691,0.001019,74.125.68.0-255,1484,62962,96,385999
21692,0.00104,74.125.68.0-255,4320,67282,96,385999
21693,0.001062,74.125.68.0-255,5738,73020,96,385999
21694,0.001072,74.125.68.0-255,1484,74504,96,385999
21695,0.001081,74.125.68.0-255,1484,75988,96,385999
21696,0.001093,74.125.68.0-255,4320,80308,96,385999
21697,0.001107,74.125.68.0-255,2902,83210,96,385999
21698,0.001109,74.125.68.0-255,766,83976,96,385999
21699,0.001227,74.125.68.0-255,1484,85460,96,385999
21700,0.00124,74.125.68.0-255,2902,88362,96,385999
21701,0.001252,74.125.68.0-255,1484,89846,96,385999
21702,0.001265,74.125.68.0-255,4320,94166,96,385999
21703,0.001297,74.125.68.0-255,2902,97068,96,385999
21704,0.001317,74.125.68.0-255,4320,101388,96,385999
21705,0.00135,74.125.68.0-255,5738,107126,96,385999
21706,0.001367,74.125.68.0-255,7156,114282,96,385999
21707,0.001372,74.125.68.0-255,3602,117884,96,385999
21708,0.001478,74.125.68.0-255,1484,119368,96,385999
21709,0.00149,74.125.68.0-255,2902,122270,96,385999
21710,0.001508,74.125.68.0-255,1484,123754,96,385999
21711,0.001521,74.125.68.0-255,4320,128074,96,385999
21712,0.001525,74.125.68.0-255,2902,130976,96,385999
21713,0.001567,74.125.68.0-255,5738,136714,96,385999
21714,0.001586,74.125.68.0-255,4320,141034,96,385999
21715,0.001591,74.125.68.0-255,5738,146772,96,385999
21716,0.001615,74.125.68.0-255,2902,149674,96,385999
21717,0.001627,74.125.68.0-255,3602,153276,96,385999
21718,0.001629,74.125.68.0-255,1484,154760,96,385999
21719,0.001647,74.125.68.0-255,4320,159080,96,385999
21720,0.001652,74.125.68.0-255,4320,163400,96,385999
21721,0.001667,74.125.68.0-255,2902,166302,96,385999
21722,0.00168,74.125.68.0-255,2902,169204,96,385999
21723,0.001695,74.125.68.0-255,2902,172106,96,385999
21724,0.0017,74.125.68.0-255,5738,177844,96,385999
21725,0.001715,74.125.68.0-255,1484,179328,96,385999
21726,0.001729,74.125.68.0-255,2902,182230,96,385999
21727,0.001744,74.125.68.0-255,3602,185832,96,385999
21728,0.001755,74.125.68.0-255,2902,188734,96,385999
21729,0.001766,74.125.68.0-255,4320,193054,96,385999
21730,0.001788,74.125.68.0-255,2902,195956,96,385999
21731,0.001799,74.125.68.0-255,4320,200276,96,385999
21732,0.001808,74.125.68.0-255,1484,201760,96,385999
21733,0.001822,74.125.68.0-255,5738,207498,96,385999
21734,0.001834,74.125.68.0-255,4320,211818,96,385999
21735,0.00184,74.125.68.0-255,5738,217556,96,385999
21736,0.001849,74.125.68.0-255,2184,219740,96,385999
21737,0.001984,74.125.68.0-255,1484,221224,96,385999
21738,0.002035,74.125.68.0-255,1484,222708,96,385999
21739,0.002067,74.125.68.0-255,2902,225610,96,385999
21740,0.002083,74.125.68.0-255,1484,227094,96,385999
21741,0.002143,74.125.68.0-255,1484,228578,96,385999
21742,0.002173,74.125.68.0-255,2902,231480,96,385999
21743,0.002186,74.125.68.0-255,1484,232964,96,385999
21744,0.002208,74.125.68.0-255,2902,235866,96,385999
21745,0.002235,74.125.68.0-255,5738,241604,96,385999
21746,0.002239,74.125.68.0-255,2902,244506,96,385999
21747,0.002256,74.125.68.0-255,2902,247408,96,385999
21748,0.002273,74.125.68.0-255,1484,248892,96,385999
21749,0.002292,74.125.68.0-255,5020,253912,96,385999
21750,0.00237,74.125.68.0-255,1484,255396,96,385999
21751,0.002384,74.125.68.0-255,2902,258298,96,385999
21752,0.0024,74.125.68.0-255,4320,262618,96,385999
21753,0.002415,74.125.68.0-255,1484,264102,96,385999
21754,0.002429,74.125.68.0-255,7156,271258,96,385999
21755,0.002455,74.125.68.0-255,7156,278414,96,385999
21756,0.002462,74.125.68.0-255,5738,284152,96,385999
21757,0.002476,74.125.68.0-255,2902,287054,96,385999
21758,0.002489,74.125.68.0-255,766,287820,96,385999
21759,0.00282,74.125.68.0-255,1484,289304,96,385999
21760,0.002874,74.125.68.0-255,2902,292206,96,385999
21761,0.002877,74.125.68.0-255,1484,293690,96,385999
21762,0.00288,74.125.68.0-255,2902,296592,96,385999
21763,0.002894,74.125.68.0-255,1484,298076,96,385999
21764,0.002913,74.125.68.0-255,1484,299560,96,385999
21765,0.002926,74.125.68.0-255,4320,303880,96,385999
21766,0.002948,74.125.68.0-255,2902,306782,96,385999
21767,0.002962,74.125.68.0-255,4320,311102,96,385999
21768,0.002986,74.125.68.0-255,1484,312586,96,385999
21769,0.002988,74.125.68.0-255,766,313352,96,385999
21770,0.003042,74.125.68.0-255,1484,314836,96,385999
21771,0.003052,74.125.68.0-255,1484,316320,96,385999
21772,0.003076,74.125.68.0-255,1484,317804,96,385999
21773,0.003082,74.125.68.0-255,5738,323542,96,385999
21774,0.003101,74.125.68.0-255,2902,326444,96,385999
21775,0.00313,74.125.68.0-255,1484,327928,96,385999
21776,0.00315,74.125.68.0-255,7156,335084,96,385999
21777,0.003163,74.125.68.0-255,3602,338686,96,385999
21778,0.003167,74.125.68.0-255,2902,341588,96,385999
21779,0.00317,74.125.68.0-255,4320,345908,96,385999
21780,0.003193,74.125.68.0-255,4320,350228,96,385999
21781,0.003202,74.125.68.0-255,2902,353130,96,385999
21782,0.003213,74.125.68.0-255,1484,354614,96,385999
21783,0.003218,74.125.68.0-255,4320,358934,96,385999
21784,0.003236,74.125.68.0-255,5738,364672,96,385999
21785,0.003257,74.125.68.0-255,7156,371828,96,385999
21786,0.003266,74.125.68.0-255,766,372594,96,385999
21787,0.003279,74.125.68.0-255,5738,378332,96,385999
21788,0.003298,74.125.68.0-255,2902,381234,96,385999
21789,0.0033,74.125.68.0-255,927,382161,96,385999
21790,0.003342,74.125.68.0-255,105,382266,96,385999
21791,0.004945,172.31.47.0-255,66,382332,96,385999
21792,0.005826,172.31.47.0-255,101,382433,96,385999
21793,0.007457,172.31.47.0-255,105,382538,96,385999
21794,0.008315,74.125.68.0-255,66,382604,96,385999
21795,0.009937,74.125.68.0-255,66,382670,96,385999
21796,0.026219,172.31.47.0-255,172,382842,96,385999
21797,0.02625,172.31.47.0-255,1109,383951,96,385999
21798,0.026286,172.31.47.0-255,1514,385465,96,385999
21799,0.026288,172.31.47.0-255,336,385801,96,385999
21800,0.027737,104.244.42.0-255,66,385867,96,385999
21801,0.027805,104.244.42.0-255,66,385933,96,385999
21802,0.027808,104.244.42.0-255,66,385999,96,385999
21803,0.0,172.217.194.0-255,153,153,96,298261
21804,2.6e-05,172.31.47.0-255,66,219,96,298261
21805,3.2e-05,172.217.194.0-255,1484,1703,96,298261
21806,3.6e-05,172.31.47.0-255,66,1769,96,298261
21807,4.1e-05,172.217.194.0-255,2902,4671,96,298261
21808,4.4e-05,172.31.47.0-255,66,4737,96,298261
21809,5.6e-05,172.217.194.0-255,5738,10475,96,298261
21810,5.8e-05,172.31.47.0-255,66,10541,96,298261
21811,7.3e-05,172.217.194.0-255,1484,12025,96,298261
21812,7.7e-05,172.31.47.0-255,66,12091,96,298261
21813,0.000103,172.217.194.0-255,2015,14106,96,298261
21814,0.000105,172.31.47.0-255,66,14172,96,298261
21815,0.000352,172.217.194.0-255,1484,15656,96,298261
21816,0.000357,172.31.47.0-255,66,15722,96,298261
21817,0.000363,172.217.194.0-255,2902,18624,96,298261
21818,0.000365,172.31.47.0-255,66,18690,96,298261
21819,0.000386,172.217.194.0-255,5738,24428,96,298261
21820,0.00039,172.31.47.0-255,66,24494,96,298261
21821,0.000398,172.217.194.0-255,4320,28814,96,298261
21822,0.0004,172.31.47.0-255,66,28880,96,298261
21823,0.000421,172.217.194.0-255,2543,31423,96,298261
21824,0.000424,172.31.47.0-255,66,31489,96,298261
21825,0.000489,172.217.194.0-255,1484,32973,96,298261
21826,0.000493,172.31.47.0-255,66,33039,96,298261
21827,0.000502,172.217.194.0-255,2902,35941,96,298261
21828,0.000504,172.31.47.0-255,66,36007,96,298261
21829,0.000508,172.217.194.0-255,2902,38909,96,298261
21830,0.000509,172.31.47.0-255,66,38975,96,298261
21831,0.000527,172.217.194.0-255,2902,41877,96,298261
21832,0.00053,172.31.47.0-255,66,41943,96,298261
21833,0.000563,172.217.194.0-255,6797,48740,96,298261
21834,0.000566,172.31.47.0-255,66,48806,96,298261
21835,0.001425,172.217.194.0-255,1484,50290,96,298261
21836,0.001431,172.31.47.0-255,66,50356,96,298261
21837,0.001441,172.217.194.0-255,2902,53258,96,298261
21838,0.001443,172.31.47.0-255,66,53324,96,298261
21839,0.001449,172.217.194.0-255,5738,59062,96,298261
21840,0.001451,172.31.47.0-255,66,59128,96,298261
21841,0.001474,172.217.194.0-255,6797,65925,96,298261
21842,0.001476,172.31.47.0-255,66,65991,96,298261
21843,0.00157,172.217.194.0-255,1484,67475,96,298261
21844,0.001583,172.217.194.0-255,2902,70377,96,298261
21845,0.001585,172.31.47.0-255,66,70443,96,298261
21846,0.001603,172.217.194.0-255,5738,76181,96,298261
21847,0.001605,172.31.47.0-255,66,76247,96,298261
21848,0.001608,172.217.194.0-255,1484,77731,96,298261
21849,0.001632,172.217.194.0-255,5379,83110,96,298261
21850,0.001634,172.31.47.0-255,66,83176,96,298261
21851,0.001649,172.217.194.0-255,648,83824,96,298261
21852,0.001707,172.217.194.0-255,1484,85308,96,298261
21853,0.00171,172.31.47.0-255,66,85374,96,298261
21854,0.001712,172.217.194.0-255,1484,86858,96,298261
21855,0.001724,172.217.194.0-255,1484,88342,96,298261
21856,0.001726,172.31.47.0-255,66,88408,96,298261
21857,0.001732,172.217.194.0-255,5738,94146,96,298261
21858,0.001733,172.31.47.0-255,66,94212,96,298261
21859,0.001765,172.217.194.0-255,1484,95696,96,298261
21860,0.001783,172.217.194.0-255,5379,101075,96,298261
21861,0.001786,172.31.47.0-255,66,101141,96,298261
21862,0.003812,172.217.194.0-255,2902,104043,96,298261
21863,0.003815,172.31.47.0-255,66,104109,96,298261
21864,0.003836,172.217.194.0-255,2902,107011,96,298261
21865,0.003838,172.31.47.0-255,66,107077,96,298261
21866,0.005831,172.217.194.0-255,2902,109979,96,298261
21867,0.005837,172.31.47.0-255,66,110045,96,298261
21868,0.005876,172.217.194.0-255,2902,112947,96,298261
21869,0.005878,172.31.47.0-255,66,113013,96,298261
21870,0.007854,172.217.194.0-255,2902,115915,96,298261
21871,0.007861,172.31.47.0-255,66,115981,96,298261
21872,0.0079,172.217.194.0-255,2902,118883,96,298261
21873,0.007904,172.31.47.0-255,66,118949,96,298261
21874,0.009891,172.217.194.0-255,2902,121851,96,298261
21875,0.009898,172.31.47.0-255,66,121917,96,298261
21876,0.009925,172.217.194.0-255,1484,123401,96,298261
21877,0.009941,172.217.194.0-255,1484,124885,96,298261
21878,0.009944,172.31.47.0-255,66,124951,96,298261
21879,0.011912,172.217.194.0-255,2902,127853,96,298261
21880,0.011925,172.31.47.0-255,66,127919,96,298261
21881,0.011962,172.217.194.0-255,2902,130821,96,298261
21882,0.011967,172.31.47.0-255,66,130887,96,298261
21883,0.013961,172.217.194.0-255,2902,133789,96,298261
21884,0.013968,172.31.47.0-255,66,133855,96,298261
21885,0.014,172.217.194.0-255,2902,136757,96,298261
21886,0.014002,172.31.47.0-255,66,136823,96,298261
21887,0.016001,172.217.194.0-255,2902,139725,96,298261
21888,0.01601,172.31.47.0-255,66,139791,96,298261
21889,0.016028,172.217.194.0-255,2902,142693,96,298261
21890,0.016032,172.31.47.0-255,66,142759,96,298261
21891,0.018055,172.217.194.0-255,5738,148497,96,298261
21892,0.018061,172.31.47.0-255,66,148563,96,298261
21893,0.02009,172.217.194.0-255,5738,154301,96,298261
21894,0.020097,172.31.47.0-255,66,154367,96,298261
21895,0.022119,172.217.194.0-255,5738,160105,96,298261
21896,0.022127,172.31.47.0-255,66,160171,96,298261
21897,0.022203,172.31.47.0-255,172,160343,96,298261
21898,0.022241,172.31.47.0-255,1110,161453,96,298261
21899,0.022324,172.31.47.0-255,1514,162967,96,298261
21900,0.022326,172.31.47.0-255,1514,164481,96,298261
21901,0.022328,172.31.47.0-255,1514,165995,96,298261
21902,0.022329,172.31.47.0-255,1082,167077,96,298261
21903,0.023759,104.244.42.0-255,66,167143,96,298261
21904,0.023851,104.244.42.0-255,66,167209,96,298261
21905,0.023908,104.244.42.0-255,66,167275,96,298261
21906,0.023911,104.244.42.0-255,66,167341,96,298261
21907,0.024145,172.217.194.0-255,4320,171661,96,298261
21908,0.02415,172.31.47.0-255,66,171727,96,298261
21909,0.024215,172.217.194.0-255,1484,173211,96,298261
21910,0.026172,172.217.194.0-255,2902,176113,96,298261
21911,0.026177,172.31.47.0-255,66,176179,96,298261
21912,0.028204,172.217.194.0-255,5738,181917,96,298261
21913,0.028209,172.31.47.0-255,66,181983,96,298261
21914,0.030217,172.217.194.0-255,5738,187721,96,298261
21915,0.030223,172.31.47.0-255,66,187787,96,298261
21916,0.032236,172.217.194.0-255,5738,193525,96,298261
21917,0.032241,172.31.47.0-255,66,193591,96,298261
21918,0.034262,172.217.194.0-255,2902,196493,96,298261
21919,0.034267,172.31.47.0-255,66,196559,96,298261
21920,0.034298,172.217.194.0-255,2902,199461,96,298261
21921,0.034301,172.31.47.0-255,66,199527,96,298261
21922,0.036367,172.217.194.0-255,5738,205265,96,298261
21923,0.036372,172.31.47.0-255,66,205331,96,298261
21924,0.038401,172.217.194.0-255,5738,211069,96,298261
21925,0.038405,172.31.47.0-255,66,211135,96,298261
21926,0.040436,172.217.194.0-255,5738,216873,96,298261
21927,0.040441,172.31.47.0-255,66,216939,96,298261
21928,0.042463,172.217.194.0-255,5738,222677,96,298261
21929,0.042468,172.31.47.0-255,66,222743,96,298261
21930,0.044472,172.217.194.0-255,5738,228481,96,298261
21931,0.044479,172.31.47.0-255,66,228547,96,298261
21932,0.046505,172.217.194.0-255,5738,234285,96,298261
21933,0.046512,172.31.47.0-255,66,234351,96,298261
21934,0.04853,172.217.194.0-255,1484,235835,96,298261
21935,0.048559,172.217.194.0-255,4320,240155,96,298261
21936,0.048564,172.31.47.0-255,66,240221,96,298261
21937,0.050579,172.217.194.0-255,5738,245959,96,298261
21938,0.050583,172.31.47.0-255,66,246025,96,298261
21939,0.052602,172.217.194.0-255,5738,251763,96,298261
21940,0.052608,172.31.47.0-255,66,251829,96,298261
21941,0.054651,172.217.194.0-255,5738,257567,96,298261
21942,0.054656,172.31.47.0-255,66,257633,96,298261
21943,0.056696,172.217.194.0-255,5738,263371,96,298261
21944,0.056701,172.31.47.0-255,66,263437,96,298261
21945,0.058724,172.217.194.0-255,5738,269175,96,298261
21946,0.058728,172.31.47.0-255,66,269241,96,298261
21947,0.060768,172.217.194.0-255,5738,274979,96,298261
21948,0.060773,172.31.47.0-255,66,275045,96,298261
21949,0.062792,172.217.194.0-255,5738,280783,96,298261
21950,0.062798,172.31.47.0-255,66,280849,96,298261
21951,0.064818,172.217.194.0-255,5738,286587,96,298261
21952,0.064823,172.31.47.0-255,66,286653,96,298261
21953,0.066851,172.217.194.0-255,5738,292391,96,298261
21954,0.066856,172.31.47.0-255,66,292457,96,298261
21955,0.068896,172.217.194.0-255,5738,298195,96,298261
21956,0.068901,172.31.47.0-255,66,298261,96,298261
21957,0.0,172.31.47.0-255,105,105,96,105
21958,0.0,74.125.200.0-255,146,146,96,352492
21959,1.6e-05,172.31.47.0-255,66,212,96,352492
21960,2.2e-05,74.125.200.0-255,1484,1696,96,352492
21961,2.6e-05,172.31.47.0-255,66,1762,96,352492
21962,3.1e-05,74.125.200.0-255,2902,4664,96,352492
21963,3.3e-05,172.31.47.0-255,66,4730,96,352492
21964,8.3e-05,74.125.200.0-255,4320,9050,96,352492
21965,8.5e-05,172.31.47.0-255,66,9116,96,352492
21966,9.6e-05,74.125.200.0-255,2902,12018,96,352492
21967,9.9e-05,172.31.47.0-255,66,12084,96,352492
21968,0.000131,74.125.200.0-255,2902,14986,96,352492
21969,0.000133,172.31.47.0-255,66,15052,96,352492
21970,0.000156,74.125.200.0-255,4981,20033,96,352492
21971,0.000158,172.31.47.0-255,66,20099,96,352492
21972,0.00019,74.125.200.0-255,7156,27255,96,352492
21973,0.000192,172.31.47.0-255,66,27321,96,352492
21974,0.000211,74.125.200.0-255,1484,28805,96,352492
21975,0.000213,172.31.47.0-255,66,28871,96,352492
21976,0.000217,74.125.200.0-255,2543,31414,96,352492
21977,0.000219,172.31.47.0-255,66,31480,96,352492
21978,0.00025,74.125.200.0-255,1484,32964,96,352492
21979,0.000253,172.31.47.0-255,66,33030,96,352492
21980,0.000257,74.125.200.0-255,2902,35932,96,352492
21981,0.000259,172.31.47.0-255,66,35998,96,352492
21982,0.000299,74.125.200.0-255,4320,40318,96,352492
21983,0.000303,172.31.47.0-255,66,40384,96,352492
21984,0.000306,74.125.200.0-255,1484,41868,96,352492
21985,0.000307,172.31.47.0-255,66,41934,96,352492
21986,0.000336,172.31.47.0-255,66,42000,96,352492
21987,0.000343,74.125.200.0-255,7156,49156,96,352492
21988,0.000345,172.31.47.0-255,66,49222,96,352492
21989,0.000375,172.31.47.0-255,66,49288,96,352492
21990,0.000377,74.125.200.0-255,129,49417,96,352492
21991,0.000379,172.31.47.0-255,66,49483,96,352492
21992,0.000794,74.125.200.0-255,348,49831,96,352492
21993,0.000801,172.31.47.0-255,66,49897,96,352492
21994,0.001029,74.125.200.0-255,1484,51381,96,352492
21995,0.001035,172.31.47.0-255,66,51447,96,352492
21996,0.001042,74.125.200.0-255,2902,54349,96,352492
21997,0.001044,172.31.47.0-255,66,54415,96,352492
21998,0.001049,74.125.200.0-255,4320,58735,96,352492
21999,0.001051,172.31.47.0-255,66,58801,96,352492
22000,0.001075,74.125.200.0-255,1484,60285,96,352492
22001,0.001079,74.125.200.0-255,1484,61769,96,352492
22002,0.001081,172.31.47.0-255,66,61835,96,352492
22003,0.001108,74.125.200.0-255,7156,68991,96,352492
22004,0.001113,74.125.200.0-255,5738,74729,96,352492
22005,0.001118,172.31.47.0-255,66,74795,96,352492
22006,0.00112,172.31.47.0-255,66,74861,96,352492
22007,0.001136,74.125.200.0-255,4320,79181,96,352492
22008,0.001138,74.125.200.0-255,1484,80665,96,352492
22009,0.001141,172.31.47.0-255,66,80731,96,352492
22010,0.001159,74.125.200.0-255,3602,84333,96,352492
22011,0.001161,172.31.47.0-255,66,84399,96,352492
22012,0.001218,74.125.200.0-255,1484,85883,96,352492
22013,0.001224,74.125.200.0-255,2902,88785,96,352492
22014,0.001227,172.31.47.0-255,66,88851,96,352492
22015,0.001231,74.125.200.0-255,2902,91753,96,352492
22016,0.001248,74.125.200.0-255,2902,94655,96,352492
22017,0.001261,74.125.200.0-255,2902,97557,96,352492
22018,0.001264,172.31.47.0-255,66,97623,96,352492
22019,0.001269,172.31.47.0-255,66,97689,96,352492
22020,0.001298,172.31.47.0-255,66,97755,96,352492
22021,0.001307,74.125.200.0-255,4320,102075,96,352492
22022,0.001311,172.31.47.0-255,66,102141,96,352492
22023,0.001328,74.125.200.0-255,2902,105043,96,352492
22024,0.001342,74.125.200.0-255,3602,108645,96,352492
22025,0.001351,172.31.47.0-255,66,108711,96,352492
22026,0.001442,74.125.200.0-255,1484,110195,96,352492
22027,0.001458,74.125.200.0-255,2902,113097,96,352492
22028,0.00146,172.31.47.0-255,66,113163,96,352492
22029,0.001483,74.125.200.0-255,5738,118901,96,352492
22030,0.00149,172.31.47.0-255,66,118967,96,352492
22031,0.001505,74.125.200.0-255,7156,126123,96,352492
22032,0.001519,74.125.200.0-255,1484,127607,96,352492
22033,0.001523,172.31.47.0-255,66,127673,96,352492
22034,0.001557,74.125.200.0-255,1484,129157,96,352492
22035,0.001561,172.31.47.0-255,66,129223,96,352492
22036,0.001588,74.125.200.0-255,2184,131407,96,352492
22037,0.001592,172.31.47.0-255,66,131473,96,352492
22038,0.001602,74.125.200.0-255,2902,134375,96,352492
22039,0.001615,74.125.200.0-255,2902,137277,96,352492
22040,0.001626,74.125.200.0-255,2902,140179,96,352492
22041,0.001632,172.31.47.0-255,66,140245,96,352492
22042,0.00165,74.125.200.0-255,1484,141729,96,352492
22043,0.001687,172.31.47.0-255,66,141795,96,352492
22044,0.00169,74.125.200.0-255,1484,143279,96,352492
22045,0.001708,74.125.200.0-255,7156,150435,96,352492
22046,0.001724,74.125.200.0-255,3602,154037,96,352492
22047,0.001733,172.31.47.0-255,66,154103,96,352492
22048,0.001995,74.125.200.0-255,1484,155587,96,352492
22049,0.00202,74.125.200.0-255,2902,158489,96,352492
22050,0.002024,172.31.47.0-255,66,158555,96,352492
22051,0.002031,74.125.200.0-255,5738,164293,96,352492
22052,0.002062,74.125.200.0-255,1484,165777,96,352492
22053,0.002077,74.125.200.0-255,4320,170097,96,352492
22054,0.002083,74.125.200.0-255,7156,177253,96,352492
22055,0.002086,74.125.200.0-255,1484,178737,96,352492
22056,0.002105,74.125.200.0-255,7156,185893,96,352492
22057,0.00211,172.31.47.0-255,66,185959,96,352492
22058,0.002143,74.125.200.0-255,2184,188143,96,352492
22059,0.002159,172.31.47.0-255,66,188209,96,352492
22060,0.002336,74.125.200.0-255,1484,189693,96,352492
22061,0.002342,74.125.200.0-255,2902,192595,96,352492
22062,0.002344,172.31.47.0-255,66,192661,96,352492
22063,0.00235,74.125.200.0-255,4320,196981,96,352492
22064,0.002361,74.125.200.0-255,1484,198465,96,352492
22065,0.002367,172.31.47.0-255,66,198531,96,352492
22066,0.002392,74.125.200.0-255,7156,205687,96,352492
22067,0.002396,74.125.200.0-255,2902,208589,96,352492
22068,0.002403,172.31.47.0-255,66,208655,96,352492
22069,0.002412,74.125.200.0-255,4320,212975,96,352492
22070,0.002416,172.31.47.0-255,66,213041,96,352492
22071,0.002441,74.125.200.0-255,4320,217361,96,352492
22072,0.002456,172.31.47.0-255,66,217427,96,352492
22073,0.002461,74.125.200.0-255,4320,221747,96,352492
22074,0.002465,172.31.47.0-255,66,221813,96,352492
22075,0.002489,74.125.200.0-255,6438,228251,96,352492
22076,0.002493,74.125.200.0-255,1484,229735,96,352492
22077,0.002505,74.125.200.0-255,4320,234055,96,352492
22078,0.002513,172.31.47.0-255,66,234121,96,352492
22079,0.002521,74.125.200.0-255,1484,235605,96,352492
22080,0.002557,74.125.200.0-255,7156,242761,96,352492
22081,0.002565,172.31.47.0-255,66,242827,96,352492
22082,0.002604,74.125.200.0-255,2902,245729,96,352492
22083,0.002608,172.31.47.0-255,66,245795,96,352492
22084,0.002623,74.125.200.0-255,2184,247979,96,352492
22085,0.002626,74.125.200.0-255,1484,249463,96,352492
22086,0.002633,172.31.47.0-255,66,249529,96,352492
22087,0.002664,74.125.200.0-255,7156,256685,96,352492
22088,0.002671,172.31.47.0-255,66,256751,96,352492
22089,0.002708,74.125.200.0-255,2902,259653,96,352492
22090,0.002714,172.31.47.0-255,66,259719,96,352492
22091,0.002744,74.125.200.0-255,3602,263321,96,352492
22092,0.002753,172.31.47.0-255,66,263387,96,352492
22093,0.005376,74.125.200.0-255,5738,269125,96,352492
22094,0.005393,172.31.47.0-255,66,269191,96,352492
22095,0.008036,74.125.200.0-255,5738,274929,96,352492
22096,0.008052,172.31.47.0-255,66,274995,96,352492
22097,0.010668,74.125.200.0-255,5738,280733,96,352492
22098,0.01068,172.31.47.0-255,66,280799,96,352492
22099,0.013292,74.125.200.0-255,5738,286537,96,352492
22100,0.013298,172.31.47.0-255,66,286603,96,352492
22101,0.015917,74.125.200.0-255,5738,292341,96,352492
22102,0.015923,172.31.47.0-255,66,292407,96,352492
22103,0.018543,74.125.200.0-255,5738,298145,96,352492
22104,0.018552,172.31.47.0-255,66,298211,96,352492
22105,0.021183,74.125.200.0-255,5738,303949,96,352492
22106,0.021198,172.31.47.0-255,66,304015,96,352492
22107,0.02384,74.125.200.0-255,5738,309753,96,352492
22108,0.023858,172.31.47.0-255,66,309819,96,352492
22109,0.026509,74.125.200.0-255,5738,315557,96,352492
22110,0.026515,172.31.47.0-255,66,315623,96,352492
22111,0.029122,74.125.200.0-255,5738,321361,96,352492
22112,0.029126,172.31.47.0-255,66,321427,96,352492
22113,0.03176,74.125.200.0-255,5738,327165,96,352492
22114,0.031766,172.31.47.0-255,66,327231,96,352492
22115,0.034394,74.125.200.0-255,5738,332969,96,352492
22116,0.0344,172.31.47.0-255,66,333035,96,352492
22117,0.037035,74.125.200.0-255,5738,338773,96,352492
22118,0.037056,172.31.47.0-255,66,338839,96,352492
22119,0.039677,74.125.200.0-255,5738,344577,96,352492
22120,0.039684,172.31.47.0-255,66,344643,96,352492
22121,0.041471,172.31.47.0-255,172,344815,96,352492
22122,0.041501,172.31.47.0-255,1101,345916,96,352492
22123,0.041536,172.31.47.0-255,1514,347430,96,352492
22124,0.041538,172.31.47.0-255,1514,348944,96,352492
22125,0.041542,172.31.47.0-255,1514,350458,96,352492
22126,0.041543,172.31.47.0-255,1091,351549,96,352492
22127,0.042272,74.125.200.0-255,442,351991,96,352492
22128,0.043011,104.244.42.0-255,66,352057,96,352492
22129,0.043049,104.244.42.0-255,66,352123,96,352492
22130,0.043114,104.244.42.0-255,66,352189,96,352492
22131,0.04312,104.244.42.0-255,66,352255,96,352492
22132,0.045955,172.31.47.0-255,66,352321,96,352492
22133,0.045984,172.31.47.0-255,105,352426,96,352492
22134,0.048564,74.125.200.0-255,66,352492,96,352492
22135,0.0,172.31.47.0-255,66,66,96,66
22136,0.0,74.125.24.0-255,146,146,96,305832
22137,2.7e-05,172.31.47.0-255,66,212,96,305832
22138,3.4e-05,74.125.24.0-255,1484,1696,96,305832
22139,3.8e-05,172.31.47.0-255,66,1762,96,305832
22140,4.3e-05,74.125.24.0-255,2902,4664,96,305832
22141,5.3e-05,172.31.47.0-255,66,4730,96,305832
22142,5.9e-05,74.125.24.0-255,5738,10468,96,305832
22143,6.1e-05,172.31.47.0-255,66,10534,96,305832
22144,0.000101,74.125.24.0-255,3528,14062,96,305832
22145,0.000103,172.31.47.0-255,66,14128,96,305832
22146,0.000248,74.125.24.0-255,1484,15612,96,305832
22147,0.000253,172.31.47.0-255,66,15678,96,305832
22148,0.00028,74.125.24.0-255,2902,18580,96,305832
22149,0.000285,172.31.47.0-255,66,18646,96,305832
22150,0.00032,74.125.24.0-255,2902,21548,96,305832
22151,0.000323,172.31.47.0-255,66,21614,96,305832
22152,0.00033,74.125.24.0-255,7156,28770,96,305832
22153,0.000333,172.31.47.0-255,66,28836,96,305832
22154,0.000343,74.125.24.0-255,2543,31379,96,305832
22155,0.000346,172.31.47.0-255,66,31445,96,305832
22156,0.000358,74.125.24.0-255,2902,34347,96,305832
22157,0.000361,172.31.47.0-255,66,34413,96,305832
22158,0.000404,74.125.24.0-255,4320,38733,96,305832
22159,0.000408,172.31.47.0-255,66,38799,96,305832
22160,0.000414,74.125.24.0-255,5738,44537,96,305832
22161,0.000418,172.31.47.0-255,66,44603,96,305832
22162,0.000472,74.125.24.0-255,3961,48564,96,305832
22163,0.000476,172.31.47.0-255,66,48630,96,305832
22164,0.000803,74.125.24.0-255,1484,50114,96,305832
22165,0.000809,172.31.47.0-255,66,50180,96,305832
22166,0.000818,74.125.24.0-255,2902,53082,96,305832
22167,0.000827,172.31.47.0-255,66,53148,96,305832
22168,0.000834,74.125.24.0-255,4320,57468,96,305832
22169,0.000837,172.31.47.0-255,66,57534,96,305832
22170,0.000867,74.125.24.0-255,1484,59018,96,305832
22171,0.000871,172.31.47.0-255,66,59084,96,305832
22172,0.000876,74.125.24.0-255,2902,61986,96,305832
22173,0.000878,172.31.47.0-255,66,62052,96,305832
22174,0.0009,74.125.24.0-255,7156,69208,96,305832
22175,0.000904,172.31.47.0-255,66,69274,96,305832
22176,0.00093,74.125.24.0-255,3961,73235,96,305832
22177,0.000933,172.31.47.0-255,66,73301,96,305832
22178,0.000937,74.125.24.0-255,1484,74785,96,305832
22179,0.000939,172.31.47.0-255,66,74851,96,305832
22180,0.000969,172.31.47.0-255,66,74917,96,305832
22181,0.001027,74.125.24.0-255,1484,76401,96,305832
22182,0.00103,172.31.47.0-255,66,76467,96,305832
22183,0.001053,74.125.24.0-255,1484,77951,96,305832
22184,0.001055,172.31.47.0-255,66,78017,96,305832
22185,0.001082,74.125.24.0-255,1484,79501,96,305832
22186,0.001084,172.31.47.0-255,66,79567,96,305832
22187,0.00109,74.125.24.0-255,5738,85305,96,305832
22188,0.001092,172.31.47.0-255,66,85371,96,305832
22189,0.001118,74.125.24.0-255,4320,89691,96,305832
22190,0.001122,172.31.47.0-255,66,89757,96,305832
22191,0.001148,74.125.24.0-255,3124,92881,96,305832
22192,0.001151,172.31.47.0-255,66,92947,96,305832
22193,0.001492,74.125.24.0-255,1484,94431,96,305832
22194,0.001498,74.125.24.0-255,2902,97333,96,305832
22195,0.001501,172.31.47.0-255,66,97399,96,305832
22196,0.001504,74.125.24.0-255,1484,98883,96,305832
22197,0.001527,74.125.24.0-255,4320,103203,96,305832
22198,0.00153,172.31.47.0-255,66,103269,96,305832
22199,0.00154,74.125.24.0-255,1484,104753,96,305832
22200,0.00157,172.31.47.0-255,66,104819,96,305832
22201,0.001574,74.125.24.0-255,4320,109139,96,305832
22202,0.001576,172.31.47.0-255,66,109205,96,305832
22203,0.001594,74.125.24.0-255,2902,112107,96,305832
22204,0.001596,172.31.47.0-255,66,112173,96,305832
22205,0.001611,74.125.24.0-255,3602,115775,96,305832
22206,0.001613,172.31.47.0-255,66,115841,96,305832
22207,0.003678,74.125.24.0-255,1484,117325,96,305832
22208,0.003699,74.125.24.0-255,2902,120227,96,305832
22209,0.003701,172.31.47.0-255,66,120293,96,305832
22210,0.003721,74.125.24.0-255,1484,121777,96,305832
22211,0.00577,74.125.24.0-255,4320,126097,96,305832
22212,0.005777,172.31.47.0-255,66,126163,96,305832
22213,0.00787,74.125.24.0-255,5738,131901,96,305832
22214,0.007878,172.31.47.0-255,66,131967,96,305832
22215,0.009973,74.125.24.0-255,2902,134869,96,305832
22216,0.00998,172.31.47.0-255,66,134935,96,305832
22217,0.01001,74.125.24.0-255,2902,137837,96,305832
22218,0.010012,172.31.47.0-255,66,137903,96,305832
22219,0.012044,74.125.24.0-255,2902,140805,96,305832
22220,0.01205,172.31.47.0-255,66,140871,96,305832
22221,0.012075,74.125.24.0-255,2902,143773,96,305832
22222,0.012078,172.31.47.0-255,66,143839,96,305832
22223,0.014125,74.125.24.0-255,2902,146741,96,305832
22224,0.014131,172.31.47.0-255,66,146807,96,305832
22225,0.014158,74.125.24.0-255,1484,148291,96,305832
22226,0.014175,74.125.24.0-255,1484,149775,96,305832
22227,0.014179,172.31.47.0-255,66,149841,96,305832
22228,0.016203,74.125.24.0-255,2902,152743,96,305832
22229,0.016211,172.31.47.0-255,66,152809,96,305832
22230,0.016241,74.125.24.0-255,2902,155711,96,305832
22231,0.016246,172.31.47.0-255,66,155777,96,305832
22232,0.018311,74.125.24.0-255,5738,161515,96,305832
22233,0.018318,172.31.47.0-255,66,161581,96,305832
22234,0.020414,74.125.24.0-255,5738,167319,96,305832
22235,0.020423,172.31.47.0-255,66,167385,96,305832
22236,0.022491,74.125.24.0-255,5738,173123,96,305832
22237,0.022498,172.31.47.0-255,66,173189,96,305832
22238,0.024583,74.125.24.0-255,5738,178927,96,305832
22239,0.024589,172.31.47.0-255,66,178993,96,305832
22240,0.026665,74.125.24.0-255,5738,184731,96,305832
22241,0.026672,172.31.47.0-255,66,184797,96,305832
22242,0.028762,74.125.24.0-255,5738,190535,96,305832
22243,0.028768,172.31.47.0-255,66,190601,96,305832
22244,0.029415,172.31.47.0-255,172,190773,96,305832
22245,0.029454,172.31.47.0-255,1101,191874,96,305832
22246,0.029481,172.31.47.0-255,1514,193388,96,305832
22247,0.029515,172.31.47.0-255,1310,194698,96,305832
22248,0.030911,74.125.24.0-255,5738,200436,96,305832
22249,0.030916,172.31.47.0-255,66,200502,96,305832
22250,0.030956,104.244.42.0-255,66,200568,96,305832
22251,0.03098,104.244.42.0-255,66,200634,96,305832
22252,0.031093,104.244.42.0-255,66,200700,96,305832
22253,0.032978,74.125.24.0-255,5738,206438,96,305832
22254,0.032983,172.31.47.0-255,66,206504,96,305832
22255,0.03509,74.125.24.0-255,5738,212242,96,305832
22256,0.035096,172.31.47.0-255,66,212308,96,305832
22257,0.037156,74.125.24.0-255,2902,215210,96,305832
22258,0.037161,172.31.47.0-255,66,215276,96,305832
22259,0.037189,74.125.24.0-255,2902,218178,96,305832
22260,0.037192,172.31.47.0-255,66,218244,96,305832
22261,0.039227,74.125.24.0-255,2902,221146,96,305832
22262,0.039232,172.31.47.0-255,66,221212,96,305832
22263,0.039267,74.125.24.0-255,2902,224114,96,305832
22264,0.03927,172.31.47.0-255,66,224180,96,305832
22265,0.041313,74.125.24.0-255,2902,227082,96,305832
22266,0.041318,172.31.47.0-255,66,227148,96,305832
22267,0.041351,74.125.24.0-255,2902,230050,96,305832
22268,0.041354,172.31.47.0-255,66,230116,96,305832
22269,0.043411,74.125.24.0-255,2902,233018,96,305832
22270,0.043417,172.31.47.0-255,66,233084,96,305832
22271,0.043444,74.125.24.0-255,2902,235986,96,305832
22272,0.043446,172.31.47.0-255,66,236052,96,305832
22273,0.045507,74.125.24.0-255,2902,238954,96,305832
22274,0.045524,172.31.47.0-255,66,239020,96,305832
22275,0.045562,74.125.24.0-255,2902,241922,96,305832
22276,0.045566,172.31.47.0-255,66,241988,96,305832
22277,0.047637,74.125.24.0-255,5738,247726,96,305832
22278,0.047654,172.31.47.0-255,66,247792,96,305832
22279,0.049756,74.125.24.0-255,5738,253530,96,305832
22280,0.049772,172.31.47.0-255,66,253596,96,305832
22281,0.051884,74.125.24.0-255,5738,259334,96,305832
22282,0.051902,172.31.47.0-255,66,259400,96,305832
22283,0.054037,74.125.24.0-255,5738,265138,96,305832
22284,0.054067,172.31.47.0-255,66,265204,96,305832
22285,0.056177,74.125.24.0-255,5738,270942,96,305832
22286,0.056194,172.31.47.0-255,66,271008,96,305832
22287,0.058313,74.125.24.0-255,5738,276746,96,305832
22288,0.058333,172.31.47.0-255,66,276812,96,305832
22289,0.060417,74.125.24.0-255,5738,282550,96,305832
22290,0.060434,172.31.47.0-255,66,282616,96,305832
22291,0.062533,74.125.24.0-255,5738,288354,96,305832
22292,0.062548,172.31.47.0-255,66,288420,96,305832
22293,0.064689,74.125.24.0-255,5738,294158,96,305832
22294,0.064708,172.31.47.0-255,66,294224,96,305832
22295,0.066815,74.125.24.0-255,5738,299962,96,305832
22296,0.066831,172.31.47.0-255,66,300028,96,305832
22297,0.068916,74.125.24.0-255,5738,305766,96,305832
22298,0.068923,172.31.47.0-255,66,305832,96,305832
22299,0.0,74.125.200.0-255,153,153,96,231780
22300,2.8e-05,172.31.47.0-255,66,219,96,231780
22301,3.5e-05,74.125.200.0-255,1484,1703,96,231780
22302,3.9e-05,172.31.47.0-255,66,1769,96,231780
22303,6.8e-05,74.125.200.0-255,2902,4671,96,231780
22304,7.1e-05,172.31.47.0-255,66,4737,96,231780
22305,7.7e-05,74.125.200.0-255,4320,9057,96,231780
22306,7.9e-05,172.31.47.0-255,66,9123,96,231780
22307,0.000147,74.125.200.0-255,4893,14016,96,231780
22308,0.000151,172.31.47.0-255,66,14082,96,231780
22309,0.000554,74.125.200.0-255,1484,15566,96,231780
22310,0.000561,172.31.47.0-255,66,15632,96,231780
22311,0.000569,74.125.200.0-255,2902,18534,96,231780
22312,0.000572,172.31.47.0-255,66,18600,96,231780
22313,0.000598,74.125.200.0-255,5738,24338,96,231780
22314,0.000601,172.31.47.0-255,66,24404,96,231780
22315,0.000671,74.125.200.0-255,4320,28724,96,231780
22316,0.000674,172.31.47.0-255,66,28790,96,231780
22317,0.000692,74.125.200.0-255,2543,31333,96,231780
22318,0.000695,172.31.47.0-255,66,31399,96,231780
22319,0.002752,74.125.200.0-255,2902,34301,96,231780
22320,0.002758,172.31.47.0-255,66,34367,96,231780
22321,0.00279,74.125.200.0-255,2902,37269,96,231780
22322,0.002792,172.31.47.0-255,66,37335,96,231780
22323,0.004853,74.125.200.0-255,2902,40237,96,231780
22324,0.004859,172.31.47.0-255,66,40303,96,231780
22325,0.00488,74.125.200.0-255,2902,43205,96,231780
22326,0.004884,172.31.47.0-255,66,43271,96,231780
22327,0.00694,74.125.200.0-255,2902,46173,96,231780
22328,0.006945,172.31.47.0-255,66,46239,96,231780
22329,0.006973,74.125.200.0-255,2902,49141,96,231780
22330,0.006976,172.31.47.0-255,66,49207,96,231780
22331,0.009047,74.125.200.0-255,2902,52109,96,231780
22332,0.009053,172.31.47.0-255,66,52175,96,231780
22333,0.009083,74.125.200.0-255,2902,55077,96,231780
22334,0.009089,172.31.47.0-255,66,55143,96,231780
22335,0.011137,74.125.200.0-255,2902,58045,96,231780
22336,0.01115,172.31.47.0-255,66,58111,96,231780
22337,0.01119,74.125.200.0-255,2902,61013,96,231780
22338,0.011217,172.31.47.0-255,66,61079,96,231780
22339,0.013255,74.125.200.0-255,2902,63981,96,231780
22340,0.013263,172.31.47.0-255,66,64047,96,231780
22341,0.013291,74.125.200.0-255,2902,66949,96,231780
22342,0.013312,172.31.47.0-255,66,67015,96,231780
22343,0.015351,74.125.200.0-255,2902,69917,96,231780
22344,0.015359,172.31.47.0-255,66,69983,96,231780
22345,0.015405,74.125.200.0-255,2902,72885,96,231780
22346,0.015502,172.31.47.0-255,66,72951,96,231780
22347,0.017447,74.125.200.0-255,2902,75853,96,231780
22348,0.017454,172.31.47.0-255,66,75919,96,231780
22349,0.017577,74.125.200.0-255,2902,78821,96,231780
22350,0.017594,172.31.47.0-255,66,78887,96,231780
22351,0.019545,74.125.200.0-255,1484,80371,96,231780
22352,0.019558,74.125.200.0-255,1484,81855,96,231780
22353,0.019563,172.31.47.0-255,66,81921,96,231780
22354,0.01963,172.31.47.0-255,172,82093,96,231780
22355,0.01965,172.31.47.0-255,1105,83198,96,231780
22356,0.019687,74.125.200.0-255,2902,86100,96,231780
22357,0.019702,172.31.47.0-255,1514,87614,96,231780
22358,0.019704,172.31.47.0-255,1306,88920,96,231780
22359,0.019728,172.31.47.0-255,66,88986,96,231780
22360,0.021188,104.244.42.0-255,66,89052,96,231780
22361,0.021387,104.244.42.0-255,66,89118,96,231780
22362,0.021392,104.244.42.0-255,66,89184,96,231780
22363,0.021644,74.125.200.0-255,2902,92086,96,231780
22364,0.021651,172.31.47.0-255,66,92152,96,231780
22365,0.021807,74.125.200.0-255,2902,95054,96,231780
22366,0.021813,172.31.47.0-255,66,95120,96,231780
22367,0.023732,74.125.200.0-255,2902,98022,96,231780
22368,0.023737,172.31.47.0-255,66,98088,96,231780
22369,0.023893,74.125.200.0-255,2902,100990,96,231780
22370,0.023898,172.31.47.0-255,66,101056,96,231780
22371,0.025815,74.125.200.0-255,2902,103958,96,231780
22372,0.02582,172.31.47.0-255,66,104024,96,231780
22373,0.02597,74.125.200.0-255,2902,106926,96,231780
22374,0.025976,172.31.47.0-255,66,106992,96,231780
22375,0.027888,74.125.200.0-255,2902,109894,96,231780
22376,0.027893,172.31.47.0-255,66,109960,96,231780
22377,0.028055,74.125.200.0-255,2902,112862,96,231780
22378,0.02806,172.31.47.0-255,66,112928,96,231780
22379,0.029976,74.125.200.0-255,1484,114412,96,231780
22380,0.030001,74.125.200.0-255,1484,115896,96,231780
22381,0.030006,172.31.47.0-255,66,115962,96,231780
22382,0.030151,74.125.200.0-255,2902,118864,96,231780
22383,0.030156,172.31.47.0-255,66,118930,96,231780
22384,0.032081,74.125.200.0-255,2902,121832,96,231780
22385,0.032086,172.31.47.0-255,66,121898,96,231780
22386,0.032235,74.125.200.0-255,1484,123382,96,231780
22387,0.032247,74.125.200.0-255,1484,124866,96,231780
22388,0.032251,172.31.47.0-255,66,124932,96,231780
22389,0.03417,74.125.200.0-255,2902,127834,96,231780
22390,0.034175,172.31.47.0-255,66,127900,96,231780
22391,0.034324,74.125.200.0-255,2902,130802,96,231780
22392,0.03433,172.31.47.0-255,66,130868,96,231780
22393,0.036252,74.125.200.0-255,2902,133770,96,231780
22394,0.036257,172.31.47.0-255,66,133836,96,231780
22395,0.036408,74.125.200.0-255,2902,136738,96,231780
22396,0.036414,172.31.47.0-255,66,136804,96,231780
22397,0.038342,74.125.200.0-255,2902,139706,96,231780
22398,0.038346,172.31.47.0-255,66,139772,96,231780
22399,0.038494,74.125.200.0-255,2902,142674,96,231780
22400,0.038499,172.31.47.0-255,66,142740,96,231780
22401,0.040439,74.125.200.0-255,2902,145642,96,231780
22402,0.040444,172.31.47.0-255,66,145708,96,231780
22403,0.040582,74.125.200.0-255,2902,148610,96,231780
22404,0.040587,172.31.47.0-255,66,148676,96,231780
22405,0.042531,74.125.200.0-255,2902,151578,96,231780
22406,0.042535,172.31.47.0-255,66,151644,96,231780
22407,0.042658,74.125.200.0-255,2902,154546,96,231780
22408,0.042663,172.31.47.0-255,66,154612,96,231780
22409,0.044622,74.125.200.0-255,2902,157514,96,231780
22410,0.044627,172.31.47.0-255,66,157580,96,231780
22411,0.044749,74.125.200.0-255,2902,160482,96,231780
22412,0.044754,172.31.47.0-255,66,160548,96,231780
22413,0.046711,74.125.200.0-255,2902,163450,96,231780
22414,0.046716,172.31.47.0-255,66,163516,96,231780
22415,0.046839,74.125.200.0-255,2902,166418,96,231780
22416,0.046844,172.31.47.0-255,66,166484,96,231780
22417,0.048814,74.125.200.0-255,2902,169386,96,231780
22418,0.04882,172.31.47.0-255,66,169452,96,231780
22419,0.048932,74.125.200.0-255,2902,172354,96,231780
22420,0.048937,172.31.47.0-255,66,172420,96,231780
22421,0.050902,74.125.200.0-255,2902,175322,96,231780
22422,0.050907,172.31.47.0-255,66,175388,96,231780
22423,0.051001,74.125.200.0-255,2902,178290,96,231780
22424,0.051005,172.31.47.0-255,66,178356,96,231780
22425,0.052982,74.125.200.0-255,2902,181258,96,231780
22426,0.052987,172.31.47.0-255,66,181324,96,231780
22427,0.053078,74.125.200.0-255,2902,184226,96,231780
22428,0.053089,172.31.47.0-255,66,184292,96,231780
22429,0.055058,74.125.200.0-255,2902,187194,96,231780
22430,0.055064,172.31.47.0-255,66,187260,96,231780
22431,0.055186,74.125.200.0-255,2902,190162,96,231780
22432,0.055191,172.31.47.0-255,66,190228,96,231780
22433,0.05713,74.125.200.0-255,2902,193130,96,231780
22434,0.057134,172.31.47.0-255,66,193196,96,231780
22435,0.057266,74.125.200.0-255,2902,196098,96,231780
22436,0.057271,172.31.47.0-255,66,196164,96,231780
22437,0.059209,74.125.200.0-255,2902,199066,96,231780
22438,0.059214,172.31.47.0-255,66,199132,96,231780
22439,0.059352,74.125.200.0-255,2902,202034,96,231780
22440,0.059357,172.31.47.0-255,66,202100,96,231780
22441,0.06129,74.125.200.0-255,2902,205002,96,231780
22442,0.061295,172.31.47.0-255,66,205068,96,231780
22443,0.061433,74.125.200.0-255,2902,207970,96,231780
22444,0.061438,172.31.47.0-255,66,208036,96,231780
22445,0.06337,74.125.200.0-255,2902,210938,96,231780
22446,0.063376,172.31.47.0-255,66,211004,96,231780
22447,0.063521,74.125.200.0-255,2902,213906,96,231780
22448,0.063526,172.31.47.0-255,66,213972,96,231780
22449,0.065461,74.125.200.0-255,2902,216874,96,231780
22450,0.065466,172.31.47.0-255,66,216940,96,231780
22451,0.065605,74.125.200.0-255,2902,219842,96,231780
22452,0.06561,172.31.47.0-255,66,219908,96,231780
22453,0.067546,74.125.200.0-255,2902,222810,96,231780
22454,0.067552,172.31.47.0-255,66,222876,96,231780
22455,0.06768,74.125.200.0-255,2902,225778,96,231780
22456,0.067685,172.31.47.0-255,66,225844,96,231780
22457,0.069632,74.125.200.0-255,2902,228746,96,231780
22458,0.069637,172.31.47.0-255,66,228812,96,231780
22459,0.069762,74.125.200.0-255,2902,231714,96,231780
22460,0.069767,172.31.47.0-255,66,231780,96,231780
22461,0.0,117.18.237.0-255,128,128,96,743
22462,3.3e-05,172.31.47.0-255,66,194,96,743
22463,3.9e-05,117.18.237.0-255,90,284,96,743
22464,4.1e-05,172.31.47.0-255,66,350,96,743
22465,4.3e-05,117.18.237.0-255,66,416,96,743
22466,0.000171,172.31.47.0-255,105,521,96,743
22467,0.000314,172.31.47.0-255,90,611,96,743
22468,0.000325,172.31.47.0-255,66,677,96,743
22469,0.001874,117.18.237.0-255,66,743,96,743
22470,0.0,74.125.200.0-255,153,153,96,371969
22471,2.8e-05,172.31.47.0-255,66,219,96,371969
22472,3.4e-05,74.125.200.0-255,1484,1703,96,371969
22473,3.8e-05,172.31.47.0-255,66,1769,96,371969
22474,4.2e-05,74.125.200.0-255,2902,4671,96,371969
22475,5.1e-05,172.31.47.0-255,66,4737,96,371969
22476,5.5e-05,74.125.200.0-255,4320,9057,96,371969
22477,5.7e-05,172.31.47.0-255,66,9123,96,371969
22478,8.4e-05,74.125.200.0-255,1484,10607,96,371969
22479,8.6e-05,172.31.47.0-255,66,10673,96,371969
22480,0.000109,74.125.200.0-255,3481,14154,96,371969
22481,0.000111,172.31.47.0-255,66,14220,96,371969
22482,0.000373,74.125.200.0-255,1484,15704,96,371969
22483,0.000377,172.31.47.0-255,66,15770,96,371969
22484,0.000383,74.125.200.0-255,1484,17254,96,371969
22485,0.000385,172.31.47.0-255,66,17320,96,371969
22486,0.000406,74.125.200.0-255,1484,18804,96,371969
22487,0.000408,172.31.47.0-255,66,18870,96,371969
22488,0.000413,74.125.200.0-255,4320,23190,96,371969
22489,0.000415,172.31.47.0-255,66,23256,96,371969
22490,0.00044,74.125.200.0-255,5738,28994,96,371969
22491,0.000443,172.31.47.0-255,66,29060,96,371969
22492,0.000465,74.125.200.0-255,2543,31603,96,371969
22493,0.000468,172.31.47.0-255,66,31669,96,371969
22494,0.000934,74.125.200.0-255,1484,33153,96,371969
22495,0.00094,172.31.47.0-255,66,33219,96,371969
22496,0.000949,74.125.200.0-255,2902,36121,96,371969
22497,0.000952,172.31.47.0-255,66,36187,96,371969
22498,0.00096,74.125.200.0-255,1484,37671,96,371969
22499,0.000962,172.31.47.0-255,66,37737,96,371969
22500,0.000988,74.125.200.0-255,2902,40639,96,371969
22501,0.000995,172.31.47.0-255,66,40705,96,371969
22502,0.001002,74.125.200.0-255,5738,46443,96,371969
22503,0.001004,172.31.47.0-255,66,46509,96,371969
22504,0.00103,74.125.200.0-255,5379,51888,96,371969
22505,0.001035,74.125.200.0-255,5738,57626,96,371969
22506,0.001039,172.31.47.0-255,66,57692,96,371969
22507,0.00105,172.31.47.0-255,66,57758,96,371969
22508,0.001084,74.125.200.0-255,2902,60660,96,371969
22509,0.001087,172.31.47.0-255,66,60726,96,371969
22510,0.001092,74.125.200.0-255,4320,65046,96,371969
22511,0.001094,172.31.47.0-255,66,65112,96,371969
22512,0.001126,74.125.200.0-255,1437,66549,96,371969
22513,0.001142,74.125.200.0-255,109,66658,96,371969
22514,0.001252,74.125.200.0-255,1484,68142,96,371969
22515,0.001255,172.31.47.0-255,66,68208,96,371969
22516,0.001259,74.125.200.0-255,2902,71110,96,371969
22517,0.00126,172.31.47.0-255,66,71176,96,371969
22518,0.001282,74.125.200.0-255,4320,75496,96,371969
22519,0.001284,172.31.47.0-255,66,75562,96,371969
22520,0.001317,172.31.47.0-255,66,75628,96,371969
22521,0.001344,74.125.200.0-255,2902,78530,96,371969
22522,0.001345,172.31.47.0-255,66,78596,96,371969
22523,0.001362,74.125.200.0-255,2902,81498,96,371969
22524,0.001367,74.125.200.0-255,7156,88654,96,371969
22525,0.001371,74.125.200.0-255,3602,92256,96,371969
22526,0.001378,172.31.47.0-255,66,92322,96,371969
22527,0.001381,172.31.47.0-255,66,92388,96,371969
22528,0.001382,172.31.47.0-255,66,92454,96,371969
22529,0.001454,74.125.200.0-255,1484,93938,96,371969
22530,0.001471,74.125.200.0-255,1484,95422,96,371969
22531,0.001473,172.31.47.0-255,66,95488,96,371969
22532,0.001476,74.125.200.0-255,1484,96972,96,371969
22533,0.001496,74.125.200.0-255,1484,98456,96,371969
22534,0.001498,172.31.47.0-255,66,98522,96,371969
22535,0.001502,74.125.200.0-255,4320,102842,96,371969
22536,0.001504,172.31.47.0-255,66,102908,96,371969
22537,0.00152,74.125.200.0-255,1484,104392,96,371969
22538,0.001532,74.125.200.0-255,5738,110130,96,371969
22539,0.001538,172.31.47.0-255,66,110196,96,371969
22540,0.00156,74.125.200.0-255,1484,111680,96,371969
22541,0.001569,172.31.47.0-255,66,111746,96,371969
22542,0.001587,74.125.200.0-255,6438,118184,96,371969
22543,0.001589,172.31.47.0-255,66,118250,96,371969
22544,0.001615,74.125.200.0-255,7156,125406,96,371969
22545,0.001617,172.31.47.0-255,66,125472,96,371969
22546,0.001622,74.125.200.0-255,4320,129792,96,371969
22547,0.001624,172.31.47.0-255,66,129858,96,371969
22548,0.001648,74.125.200.0-255,5738,135596,96,371969
22549,0.00165,172.31.47.0-255,66,135662,96,371969
22550,0.001667,74.125.200.0-255,4320,139982,96,371969
22551,0.00167,172.31.47.0-255,66,140048,96,371969
22552,0.001704,74.125.200.0-255,7156,147204,96,371969
22553,0.001707,172.31.47.0-255,66,147270,96,371969
22554,0.001711,74.125.200.0-255,4320,151590,96,371969
22555,0.001713,172.31.47.0-255,66,151656,96,371969
22556,0.001715,74.125.200.0-255,766,152422,96,371969
22557,0.001765,74.125.200.0-255,1484,153906,96,371969
22558,0.001768,172.31.47.0-255,66,153972,96,371969
22559,0.001772,74.125.200.0-255,1484,155456,96,371969
22560,0.001793,74.125.200.0-255,2902,158358,96,371969
22561,0.001795,172.31.47.0-255,66,158424,96,371969
22562,0.001825,74.125.200.0-255,5738,164162,96,371969
22563,0.001827,172.31.47.0-255,66,164228,96,371969
22564,0.001831,74.125.200.0-255,4320,168548,96,371969
22565,0.001833,172.31.47.0-255,66,168614,96,371969
22566,0.001864,74.125.200.0-255,5738,174352,96,371969
22567,0.001867,172.31.47.0-255,66,174418,96,371969
22568,0.00187,74.125.200.0-255,2902,177320,96,371969
22569,0.001872,172.31.47.0-255,66,177386,96,371969
22570,0.001907,172.31.47.0-255,66,177452,96,371969
22571,0.00191,74.125.200.0-255,766,178218,96,371969
22572,0.002129,74.125.200.0-255,1484,179702,96,371969
22573,0.002132,172.31.47.0-255,66,179768,96,371969
22574,0.002147,74.125.200.0-255,1484,181252,96,371969
22575,0.002157,74.125.200.0-255,1484,182736,96,371969
22576,0.00216,172.31.47.0-255,66,182802,96,371969
22577,0.002169,74.125.200.0-255,4320,187122,96,371969
22578,0.002175,172.31.47.0-255,66,187188,96,371969
22579,0.002182,74.125.200.0-255,1484,188672,96,371969
22580,0.002187,74.125.200.0-255,4320,192992,96,371969
22581,0.002191,172.31.47.0-255,66,193058,96,371969
22582,0.002221,74.125.200.0-255,5738,198796,96,371969
22583,0.002223,172.31.47.0-255,66,198862,96,371969
22584,0.002253,172.31.47.0-255,66,198928,96,371969
22585,0.002275,74.125.200.0-255,1484,200412,96,371969
22586,0.002304,172.31.47.0-255,66,200478,96,371969
22587,0.002308,74.125.200.0-255,4320,204798,96,371969
22588,0.00231,172.31.47.0-255,66,204864,96,371969
22589,0.002322,74.125.200.0-255,1484,206348,96,371969
22590,0.004579,74.125.200.0-255,4320,210668,96,371969
22591,0.004586,172.31.47.0-255,66,210734,96,371969
22592,0.006908,74.125.200.0-255,4320,215054,96,371969
22593,0.006914,172.31.47.0-255,66,215120,96,371969
22594,0.006941,74.125.200.0-255,1484,216604,96,371969
22595,0.009199,74.125.200.0-255,4320,220924,96,371969
22596,0.009205,172.31.47.0-255,66,220990,96,371969
22597,0.011524,74.125.200.0-255,5738,226728,96,371969
22598,0.01153,172.31.47.0-255,66,226794,96,371969
22599,0.013803,74.125.200.0-255,5738,232532,96,371969
22600,0.013811,172.31.47.0-255,66,232598,96,371969
22601,0.016092,74.125.200.0-255,5738,238336,96,371969
22602,0.016099,172.31.47.0-255,66,238402,96,371969
22603,0.018382,74.125.200.0-255,5738,244140,96,371969
22604,0.018389,172.31.47.0-255,66,244206,96,371969
22605,0.020513,172.31.47.0-255,172,244378,96,371969
22606,0.020553,172.31.47.0-255,1105,245483,96,371969
22607,0.020613,172.31.47.0-255,1514,246997,96,371969
22608,0.020635,172.31.47.0-255,1306,248303,96,371969
22609,0.020664,74.125.200.0-255,5738,254041,96,371969
22610,0.02067,172.31.47.0-255,66,254107,96,371969
22611,0.022044,104.244.42.0-255,66,254173,96,371969
22612,0.022089,104.244.42.0-255,66,254239,96,371969
22613,0.022174,104.244.42.0-255,66,254305,96,371969
22614,0.022939,74.125.200.0-255,1484,255789,96,371969
22615,0.022966,74.125.200.0-255,4320,260109,96,371969
22616,0.02297,172.31.47.0-255,66,260175,96,371969
22617,0.025248,74.125.200.0-255,5738,265913,96,371969
22618,0.025253,172.31.47.0-255,66,265979,96,371969
22619,0.027528,74.125.200.0-255,4320,270299,96,371969
22620,0.027533,172.31.47.0-255,66,270365,96,371969
22621,0.027556,74.125.200.0-255,1484,271849,96,371969
22622,0.029806,74.125.200.0-255,2902,274751,96,371969
22623,0.02981,172.31.47.0-255,66,274817,96,371969
22624,0.032078,74.125.200.0-255,5738,280555,96,371969
22625,0.032082,172.31.47.0-255,66,280621,96,371969
22626,0.034357,74.125.200.0-255,5738,286359,96,371969
22627,0.034362,172.31.47.0-255,66,286425,96,371969
22628,0.036631,74.125.200.0-255,4320,290745,96,371969
22629,0.036636,172.31.47.0-255,66,290811,96,371969
22630,0.036661,74.125.200.0-255,1484,292295,96,371969
22631,0.038901,74.125.200.0-255,4320,296615,96,371969
22632,0.038906,172.31.47.0-255,66,296681,96,371969
22633,0.041185,74.125.200.0-255,5738,302419,96,371969
22634,0.041189,172.31.47.0-255,66,302485,96,371969
22635,0.043468,74.125.200.0-255,5738,308223,96,371969
22636,0.043473,172.31.47.0-255,66,308289,96,371969
22637,0.045814,74.125.200.0-255,5738,314027,96,371969
22638,0.045821,172.31.47.0-255,66,314093,96,371969
22639,0.048094,74.125.200.0-255,4320,318413,96,371969
22640,0.048099,172.31.47.0-255,66,318479,96,371969
22641,0.048129,74.125.200.0-255,1484,319963,96,371969
22642,0.050378,74.125.200.0-255,4320,324283,96,371969
22643,0.050384,172.31.47.0-255,66,324349,96,371969
22644,0.052658,74.125.200.0-255,2902,327251,96,371969
22645,0.052662,172.31.47.0-255,66,327317,96,371969
22646,0.052693,74.125.200.0-255,2902,330219,96,371969
22647,0.052696,172.31.47.0-255,66,330285,96,371969
22648,0.054938,74.125.200.0-255,2902,333187,96,371969
22649,0.054943,172.31.47.0-255,66,333253,96,371969
22650,0.054978,74.125.200.0-255,2902,336155,96,371969
22651,0.054981,172.31.47.0-255,66,336221,96,371969
22652,0.05721,74.125.200.0-255,2902,339123,96,371969
22653,0.057214,172.31.47.0-255,66,339189,96,371969
22654,0.057251,74.125.200.0-255,1484,340673,96,371969
22655,0.057264,74.125.200.0-255,1484,342157,96,371969
22656,0.057267,172.31.47.0-255,66,342223,96,371969
22657,0.059482,74.125.200.0-255,2902,345125,96,371969
22658,0.059486,172.31.47.0-255,66,345191,96,371969
22659,0.059537,74.125.200.0-255,2902,348093,96,371969
22660,0.05954,172.31.47.0-255,66,348159,96,371969
22661,0.061753,74.125.200.0-255,2902,351061,96,371969
22662,0.061757,172.31.47.0-255,66,351127,96,371969
22663,0.061797,74.125.200.0-255,2902,354029,96,371969
22664,0.061802,172.31.47.0-255,66,354095,96,371969
22665,0.06404,74.125.200.0-255,2902,356997,96,371969
22666,0.064044,172.31.47.0-255,66,357063,96,371969
22667,0.064083,74.125.200.0-255,2902,359965,96,371969
22668,0.064086,172.31.47.0-255,66,360031,96,371969
22669,0.066316,74.125.200.0-255,2902,362933,96,371969
22670,0.066321,172.31.47.0-255,66,362999,96,371969
22671,0.066358,74.125.200.0-255,2902,365901,96,371969
22672,0.066362,172.31.47.0-255,66,365967,96,371969
22673,0.068591,74.125.200.0-255,1484,367451,96,371969
22674,0.068614,74.125.200.0-255,1484,368935,96,371969
22675,0.068617,172.31.47.0-255,66,369001,96,371969
22676,0.068643,74.125.200.0-255,2902,371903,96,371969
22677,0.068646,172.31.47.0-255,66,371969,96,371969
22678,0.0,74.125.24.0-255,374,374,96,198621
22679,2.7e-05,172.31.47.0-255,66,440,96,198621
22680,3.3e-05,74.125.24.0-255,1484,1924,96,198621
22681,3.7e-05,172.31.47.0-255,66,1990,96,198621
22682,0.0001,74.125.24.0-255,4320,6310,96,198621
22683,0.000104,172.31.47.0-255,66,6376,96,198621
22684,0.000415,74.125.24.0-255,4320,10696,96,198621
22685,0.00042,172.31.47.0-255,66,10762,96,198621
22686,0.00073,74.125.24.0-255,4320,15082,96,198621
22687,0.000736,172.31.47.0-255,66,15148,96,198621
22688,0.000767,74.125.24.0-255,6042,21190,96,198621
22689,0.00077,172.31.47.0-255,66,21256,96,198621
22690,0.001503,172.31.47.0-255,66,21322,96,198621
22691,0.002348,74.125.24.0-255,1703,23025,96,198621
22692,0.002354,172.31.47.0-255,66,23091,96,198621
22693,0.003838,74.125.24.0-255,2902,25993,96,198621
22694,0.003844,172.31.47.0-255,66,26059,96,198621
22695,0.004686,74.125.24.0-255,2902,28961,96,198621
22696,0.004692,172.31.47.0-255,66,29027,96,198621
22697,0.006191,74.125.24.0-255,2902,31929,96,198621
22698,0.006197,172.31.47.0-255,66,31995,96,198621
22699,0.007011,74.125.24.0-255,2902,34897,96,198621
22700,0.007019,172.31.47.0-255,66,34963,96,198621
22701,0.008503,74.125.24.0-255,1265,36228,96,198621
22702,0.008508,172.31.47.0-255,66,36294,96,198621
22703,0.008538,74.125.24.0-255,1484,37778,96,198621
22704,0.008541,172.31.47.0-255,66,37844,96,198621
22705,0.009381,74.125.24.0-255,2902,40746,96,198621
22706,0.009387,172.31.47.0-255,66,40812,96,198621
22707,0.010855,74.125.24.0-255,1484,42296,96,198621
22708,0.010861,172.31.47.0-255,66,42362,96,198621
22709,0.010897,74.125.24.0-255,1484,43846,96,198621
22710,0.0109,172.31.47.0-255,66,43912,96,198621
22711,0.011716,74.125.24.0-255,2902,46814,96,198621
22712,0.011723,172.31.47.0-255,66,46880,96,198621
22713,0.013184,74.125.24.0-255,1484,48364,96,198621
22714,0.01319,172.31.47.0-255,66,48430,96,198621
22715,0.014081,74.125.24.0-255,2902,51332,96,198621
22716,0.014087,172.31.47.0-255,66,51398,96,198621
22717,0.014165,74.125.24.0-255,1484,52882,96,198621
22718,0.01417,172.31.47.0-255,66,52948,96,198621
22719,0.0155,74.125.24.0-255,1484,54432,96,198621
22720,0.015506,172.31.47.0-255,66,54498,96,198621
22721,0.016407,74.125.24.0-255,2902,57400,96,198621
22722,0.016413,172.31.47.0-255,66,57466,96,198621
22723,0.016496,74.125.24.0-255,1484,58950,96,198621
22724,0.016499,172.31.47.0-255,66,59016,96,198621
22725,0.017823,74.125.24.0-255,1484,60500,96,198621
22726,0.017828,172.31.47.0-255,66,60566,96,198621
22727,0.018452,172.31.47.0-255,172,60738,96,198621
22728,0.018483,172.31.47.0-255,1109,61847,96,198621
22729,0.018513,172.31.47.0-255,1514,63361,96,198621
22730,0.018515,172.31.47.0-255,1304,64665,96,198621
22731,0.018749,74.125.24.0-255,2902,67567,96,198621
22732,0.018754,172.31.47.0-255,66,67633,96,198621
22733,0.018821,74.125.24.0-255,1484,69117,96,198621
22734,0.018824,172.31.47.0-255,66,69183,96,198621
22735,0.020001,104.244.42.0-255,66,69249,96,198621
22736,0.020045,104.244.42.0-255,66,69315,96,198621
22737,0.020047,104.244.42.0-255,66,69381,96,198621
22738,0.020159,74.125.24.0-255,1484,70865,96,198621
22739,0.020162,172.31.47.0-255,66,70931,96,198621
22740,0.021067,74.125.24.0-255,2902,73833,96,198621
22741,0.021072,172.31.47.0-255,66,73899,96,198621
22742,0.02115,74.125.24.0-255,1484,75383,96,198621
22743,0.022463,74.125.24.0-255,1484,76867,96,198621
22744,0.022468,172.31.47.0-255,66,76933,96,198621
22745,0.023408,74.125.24.0-255,2902,79835,96,198621
22746,0.023413,172.31.47.0-255,66,79901,96,198621
22747,0.024786,74.125.24.0-255,2902,82803,96,198621
22748,0.02479,172.31.47.0-255,66,82869,96,198621
22749,0.025731,74.125.24.0-255,2902,85771,96,198621
22750,0.025735,172.31.47.0-255,66,85837,96,198621
22751,0.02709,74.125.24.0-255,2902,88739,96,198621
22752,0.027095,172.31.47.0-255,66,88805,96,198621
22753,0.028075,74.125.24.0-255,2902,91707,96,198621
22754,0.02808,172.31.47.0-255,66,91773,96,198621
22755,0.029448,74.125.24.0-255,2902,94675,96,198621
22756,0.029453,172.31.47.0-255,66,94741,96,198621
22757,0.030412,74.125.24.0-255,2902,97643,96,198621
22758,0.030416,172.31.47.0-255,66,97709,96,198621
22759,0.031748,74.125.24.0-255,2902,100611,96,198621
22760,0.031752,172.31.47.0-255,66,100677,96,198621
22761,0.032736,74.125.24.0-255,2902,103579,96,198621
22762,0.03274,172.31.47.0-255,66,103645,96,198621
22763,0.034058,74.125.24.0-255,2902,106547,96,198621
22764,0.034063,172.31.47.0-255,66,106613,96,198621
22765,0.035031,74.125.24.0-255,2902,109515,96,198621
22766,0.035035,172.31.47.0-255,66,109581,96,198621
22767,0.036364,74.125.24.0-255,2902,112483,96,198621
22768,0.036368,172.31.47.0-255,66,112549,96,198621
22769,0.037334,74.125.24.0-255,2902,115451,96,198621
22770,0.037339,172.31.47.0-255,66,115517,96,198621
22771,0.038689,74.125.24.0-255,2902,118419,96,198621
22772,0.038694,172.31.47.0-255,66,118485,96,198621
22773,0.039656,74.125.24.0-255,2902,121387,96,198621
22774,0.03966,172.31.47.0-255,66,121453,96,198621
22775,0.041021,74.125.24.0-255,2902,124355,96,198621
22776,0.041025,172.31.47.0-255,66,124421,96,198621
22777,0.041979,74.125.24.0-255,2902,127323,96,198621
22778,0.041985,172.31.47.0-255,66,127389,96,198621
22779,0.043341,74.125.24.0-255,2902,130291,96,198621
22780,0.043346,172.31.47.0-255,66,130357,96,198621
22781,0.044307,74.125.24.0-255,2902,133259,96,198621
22782,0.044311,172.31.47.0-255,66,133325,96,198621
22783,0.04567,74.125.24.0-255,2902,136227,96,198621
22784,0.045675,172.31.47.0-255,66,136293,96,198621
22785,0.046647,74.125.24.0-255,2902,139195,96,198621
22786,0.046654,172.31.47.0-255,66,139261,96,198621
22787,0.047998,74.125.24.0-255,2902,142163,96,198621
22788,0.048004,172.31.47.0-255,66,142229,96,198621
22789,0.048974,74.125.24.0-255,2902,145131,96,198621
22790,0.048979,172.31.47.0-255,66,145197,96,198621
22791,0.050341,74.125.24.0-255,2902,148099,96,198621
22792,0.050347,172.31.47.0-255,66,148165,96,198621
22793,0.051285,74.125.24.0-255,2902,151067,96,198621
22794,0.05129,172.31.47.0-255,66,151133,96,198621
22795,0.052689,74.125.24.0-255,2902,154035,96,198621
22796,0.052695,172.31.47.0-255,66,154101,96,198621
22797,0.053618,74.125.24.0-255,2902,157003,96,198621
22798,0.053625,172.31.47.0-255,66,157069,96,198621
22799,0.054999,74.125.24.0-255,2902,159971,96,198621
22800,0.055004,172.31.47.0-255,66,160037,96,198621
22801,0.055962,74.125.24.0-255,2902,162939,96,198621
22802,0.055967,172.31.47.0-255,66,163005,96,198621
22803,0.057324,74.125.24.0-255,2902,165907,96,198621
22804,0.057329,172.31.47.0-255,66,165973,96,198621
22805,0.058301,74.125.24.0-255,2902,168875,96,198621
22806,0.05832,172.31.47.0-255,66,168941,96,198621
22807,0.059654,74.125.24.0-255,2902,171843,96,198621
22808,0.059659,172.31.47.0-255,66,171909,96,198621
22809,0.060636,74.125.24.0-255,2902,174811,96,198621
22810,0.060641,172.31.47.0-255,66,174877,96,198621
22811,0.061982,74.125.24.0-255,2902,177779,96,198621
22812,0.061987,172.31.47.0-255,66,177845,96,198621
22813,0.062938,74.125.24.0-255,2902,180747,96,198621
22814,0.062943,172.31.47.0-255,66,180813,96,198621
22815,0.064307,74.125.24.0-255,2902,183715,96,198621
22816,0.064312,172.31.47.0-255,66,183781,96,198621
22817,0.065245,74.125.24.0-255,2902,186683,96,198621
22818,0.065249,172.31.47.0-255,66,186749,96,198621
22819,0.066627,74.125.24.0-255,2902,189651,96,198621
22820,0.066633,172.31.47.0-255,66,189717,96,198621
22821,0.067544,74.125.24.0-255,2902,192619,96,198621
22822,0.067548,172.31.47.0-255,66,192685,96,198621
22823,0.068943,74.125.24.0-255,2902,195587,96,198621
22824,0.068948,172.31.47.0-255,66,195653,96,198621
22825,0.069881,74.125.24.0-255,2902,198555,96,198621
22826,0.069885,172.31.47.0-255,66,198621,96,198621
22827,0.0,172.31.47.0-255,697,697,96,2812
22828,0.002337,172.217.194.0-255,66,763,96,2812
22829,0.003103,172.217.194.0-255,278,1041,96,2812
22830,0.003119,172.31.47.0-255,66,1107,96,2812
22831,0.003848,172.31.47.0-255,130,1237,96,2812
22832,0.005468,172.31.47.0-255,236,1473,96,2812
22833,0.005504,172.31.47.0-255,383,1856,96,2812
22834,0.006867,172.217.194.0-255,630,2486,96,2812
22835,0.007058,172.31.47.0-255,97,2583,96,2812
22836,0.007815,172.217.194.0-255,97,2680,96,2812
22837,0.009381,172.217.194.0-255,66,2746,96,2812
22838,0.046537,172.31.47.0-255,66,2812,96,2812
22839,0.0,172.217.194.0-255,153,153,96,277158
22840,3.3e-05,172.31.47.0-255,66,219,96,277158
22841,4e-05,172.217.194.0-255,1484,1703,96,277158
22842,4.4e-05,172.31.47.0-255,66,1769,96,277158
22843,4.9e-05,172.217.194.0-255,2902,4671,96,277158
22844,5.1e-05,172.31.47.0-255,66,4737,96,277158
22845,6.4e-05,172.217.194.0-255,7156,11893,96,277158
22846,6.6e-05,172.31.47.0-255,66,11959,96,277158
22847,8e-05,172.217.194.0-255,4775,16734,96,277158
22848,8.2e-05,172.31.47.0-255,66,16800,96,277158
22849,8.6e-05,172.217.194.0-255,2902,19702,96,277158
22850,8.9e-05,172.31.47.0-255,66,19768,96,277158
22851,0.000109,172.217.194.0-255,2902,22670,96,277158
22852,0.000112,172.31.47.0-255,66,22736,96,277158
22853,0.000148,172.31.47.0-255,66,22802,96,277158
22854,0.000485,172.217.194.0-255,1484,24286,96,277158
22855,0.000491,172.31.47.0-255,66,24352,96,277158
22856,0.000496,172.217.194.0-255,2902,27254,96,277158
22857,0.000497,172.31.47.0-255,66,27320,96,277158
22858,0.000503,172.217.194.0-255,5738,33058,96,277158
22859,0.000504,172.31.47.0-255,66,33124,96,277158
22860,0.000538,172.31.47.0-255,66,33190,96,277158
22861,0.000567,172.217.194.0-255,1125,34315,96,277158
22862,0.00057,172.31.47.0-255,66,34381,96,277158
22863,0.000581,172.31.47.0-255,66,34447,96,277158
22864,0.000589,172.217.194.0-255,4251,38698,96,277158
22865,0.000592,172.31.47.0-255,66,38764,96,277158
22866,0.00062,172.217.194.0-255,98,38862,96,277158
22867,0.000623,172.31.47.0-255,66,38928,96,277158
22868,0.000638,172.217.194.0-255,1484,40412,96,277158
22869,0.000651,172.217.194.0-255,2902,43314,96,277158
22870,0.000653,172.31.47.0-255,66,43380,96,277158
22871,0.000657,172.217.194.0-255,2902,46282,96,277158
22872,0.000669,172.31.47.0-255,66,46348,96,277158
22873,0.000681,172.217.194.0-255,4320,50668,96,277158
22874,0.000688,172.217.194.0-255,7156,57824,96,277158
22875,0.000689,172.31.47.0-255,66,57890,96,277158
22876,0.000693,172.31.47.0-255,66,57956,96,277158
22877,0.000735,172.31.47.0-255,66,58022,96,277158
22878,0.00074,172.217.194.0-255,6438,64460,96,277158
22879,0.000748,172.31.47.0-255,66,64526,96,277158
22880,0.000761,172.217.194.0-255,7156,71682,96,277158
22881,0.000775,172.31.47.0-255,66,71748,96,277158
22882,0.000778,172.217.194.0-255,365,72113,96,277158
22883,0.000782,172.217.194.0-255,2902,75015,96,277158
22884,0.00079,172.31.47.0-255,66,75081,96,277158
22885,0.000813,172.31.47.0-255,66,75147,96,277158
22886,0.000857,172.31.47.0-255,66,75213,96,277158
22887,0.000869,172.217.194.0-255,2902,78115,96,277158
22888,0.000873,172.217.194.0-255,2184,80299,96,277158
22889,0.000875,172.31.47.0-255,66,80365,96,277158
22890,0.001604,172.217.194.0-255,1484,81849,96,277158
22891,0.001611,172.217.194.0-255,1484,83333,96,277158
22892,0.001615,172.31.47.0-255,66,83399,96,277158
22893,0.001644,172.217.194.0-255,1484,84883,96,277158
22894,0.00165,172.217.194.0-255,5738,90621,96,277158
22895,0.001655,172.217.194.0-255,4320,94941,96,277158
22896,0.001671,172.217.194.0-255,2902,97843,96,277158
22897,0.001704,172.217.194.0-255,2184,100027,96,277158
22898,0.002134,172.217.194.0-255,1484,101511,96,277158
22899,0.002146,172.217.194.0-255,1484,102995,96,277158
22900,0.002155,172.217.194.0-255,1484,104479,96,277158
22901,0.002168,172.217.194.0-255,5738,110217,96,277158
22902,0.002193,172.217.194.0-255,4320,114537,96,277158
22903,0.00225,172.217.194.0-255,2902,117439,96,277158
22904,0.005452,172.31.47.0-255,66,117505,96,277158
22905,0.007709,172.217.194.0-255,5738,123243,96,277158
22906,0.007717,172.31.47.0-255,66,123309,96,277158
22907,0.009932,172.217.194.0-255,5738,129047,96,277158
22908,0.010756,172.31.47.0-255,66,129113,96,277158
22909,0.013016,172.217.194.0-255,5738,134851,96,277158
22910,0.013022,172.31.47.0-255,66,134917,96,277158
22911,0.015299,172.217.194.0-255,5738,140655,96,277158
22912,0.015305,172.31.47.0-255,66,140721,96,277158
22913,0.017576,172.217.194.0-255,5738,146459,96,277158
22914,0.01759,172.31.47.0-255,66,146525,96,277158
22915,0.019882,172.217.194.0-255,5738,152263,96,277158
22916,0.019888,172.31.47.0-255,66,152329,96,277158
22917,0.022181,172.217.194.0-255,5738,158067,96,277158
22918,0.022189,172.31.47.0-255,66,158133,96,277158
22919,0.024444,172.217.194.0-255,5738,163871,96,277158
22920,0.02445,172.31.47.0-255,66,163937,96,277158
22921,0.026716,172.217.194.0-255,5738,169675,96,277158
22922,0.026723,172.31.47.0-255,66,169741,96,277158
22923,0.028973,172.217.194.0-255,5738,175479,96,277158
22924,0.028981,172.31.47.0-255,66,175545,96,277158
22925,0.030155,172.31.47.0-255,172,175717,96,277158
22926,0.030184,172.31.47.0-255,1109,176826,96,277158
22927,0.030213,172.31.47.0-255,1514,178340,96,277158
22928,0.030215,172.31.47.0-255,1304,179644,96,277158
22929,0.031222,172.217.194.0-255,5738,185382,96,277158
22930,0.031229,172.31.47.0-255,66,185448,96,277158
22931,0.031693,104.244.42.0-255,66,185514,96,277158
22932,0.031748,104.244.42.0-255,66,185580,96,277158
22933,0.031795,104.244.42.0-255,66,185646,96,277158
22934,0.033462,172.217.194.0-255,5738,191384,96,277158
22935,0.033468,172.31.47.0-255,66,191450,96,277158
22936,0.035694,172.217.194.0-255,5738,197188,96,277158
22937,0.035699,172.31.47.0-255,66,197254,96,277158
22938,0.037967,172.217.194.0-255,5738,202992,96,277158
22939,0.037972,172.31.47.0-255,66,203058,96,277158
22940,0.04023,172.217.194.0-255,5738,208796,96,277158
22941,0.040237,172.31.47.0-255,66,208862,96,277158
22942,0.042469,172.217.194.0-255,5738,214600,96,277158
22943,0.042474,172.31.47.0-255,66,214666,96,277158
22944,0.044685,172.217.194.0-255,5738,220404,96,277158
22945,0.044691,172.31.47.0-255,66,220470,96,277158
22946,0.046971,172.217.194.0-255,4320,224790,96,277158
22947,0.046975,172.31.47.0-255,66,224856,96,277158
22948,0.046992,172.217.194.0-255,1484,226340,96,277158
22949,0.049286,172.217.194.0-255,4320,230660,96,277158
22950,0.049291,172.31.47.0-255,66,230726,96,277158
22951,0.051542,172.217.194.0-255,5738,236464,96,277158
22952,0.051584,172.31.47.0-255,66,236530,96,277158
22953,0.053833,172.217.194.0-255,5738,242268,96,277158
22954,0.053839,172.31.47.0-255,66,242334,96,277158
22955,0.056115,172.217.194.0-255,5738,248072,96,277158
22956,0.056121,172.31.47.0-255,66,248138,96,277158
22957,0.058397,172.217.194.0-255,5738,253876,96,277158
22958,0.058405,172.31.47.0-255,66,253942,96,277158
22959,0.060662,172.217.194.0-255,5738,259680,96,277158
22960,0.060668,172.31.47.0-255,66,259746,96,277158
22961,0.062897,172.217.194.0-255,5738,265484,96,277158
22962,0.063434,172.31.47.0-255,66,265550,96,277158
22963,0.065688,172.217.194.0-255,5738,271288,96,277158
22964,0.065695,172.31.47.0-255,66,271354,96,277158
22965,0.067935,172.217.194.0-255,5738,277092,96,277158
22966,0.067941,172.31.47.0-255,66,277158,96,277158
22967,0.0,74.125.24.0-255,153,153,96,315347
22968,2.3e-05,172.31.47.0-255,66,219,96,315347
22969,3e-05,74.125.24.0-255,1484,1703,96,315347
22970,3.3e-05,172.31.47.0-255,66,1769,96,315347
22971,3.7e-05,74.125.24.0-255,2902,4671,96,315347
22972,3.9e-05,172.31.47.0-255,66,4737,96,315347
22973,7.1e-05,74.125.24.0-255,7156,11893,96,315347
22974,7.3e-05,172.31.47.0-255,66,11959,96,315347
22975,0.000102,74.125.24.0-255,1976,13935,96,315347
22976,0.000104,172.31.47.0-255,66,14001,96,315347
22977,0.000107,74.125.24.0-255,2902,16903,96,315347
22978,0.000109,172.31.47.0-255,66,16969,96,315347
22979,0.000133,74.125.24.0-255,7156,24125,96,315347
22980,0.000135,172.31.47.0-255,66,24191,96,315347
22981,0.000179,74.125.24.0-255,6797,30988,96,315347
22982,0.000182,172.31.47.0-255,66,31054,96,315347
22983,0.00037,74.125.24.0-255,1484,32538,96,315347
22984,0.000375,172.31.47.0-255,66,32604,96,315347
22985,0.000378,74.125.24.0-255,1484,34088,96,315347
22986,0.000381,172.31.47.0-255,66,34154,96,315347
22987,0.000408,74.125.24.0-255,1484,35638,96,315347
22988,0.000411,74.125.24.0-255,2902,38540,96,315347
22989,0.000412,172.31.47.0-255,66,38606,96,315347
22990,0.000416,172.31.47.0-255,66,38672,96,315347
22991,0.000437,74.125.24.0-255,2902,41574,96,315347
22992,0.000444,172.31.47.0-255,66,41640,96,315347
22993,0.000465,74.125.24.0-255,6797,48437,96,315347
22994,0.000468,172.31.47.0-255,66,48503,96,315347
22995,0.000494,74.125.24.0-255,1484,49987,96,315347
22996,0.000497,172.31.47.0-255,66,50053,96,315347
22997,0.000518,74.125.24.0-255,1484,51537,96,315347
22998,0.00052,172.31.47.0-255,66,51603,96,315347
22999,0.000531,74.125.24.0-255,1484,53087,96,315347
23000,0.000541,74.125.24.0-255,4320,57407,96,315347
23001,0.000544,172.31.47.0-255,66,57473,96,315347
23002,0.000552,74.125.24.0-255,1484,58957,96,315347
23003,0.000555,74.125.24.0-255,1484,60441,96,315347
23004,0.000557,172.31.47.0-255,66,60507,96,315347
23005,0.000583,74.125.24.0-255,4320,64827,96,315347
23006,0.000586,172.31.47.0-255,66,64893,96,315347
23007,0.000602,74.125.24.0-255,1462,66355,96,315347
23008,0.000644,74.125.24.0-255,108,66463,96,315347
23009,0.000648,172.31.47.0-255,66,66529,96,315347
23010,0.000762,74.125.24.0-255,1484,68013,96,315347
23011,0.000777,74.125.24.0-255,2902,70915,96,315347
23012,0.00078,172.31.47.0-255,66,70981,96,315347
23013,0.000803,74.125.24.0-255,2902,73883,96,315347
23014,0.000806,172.31.47.0-255,66,73949,96,315347
23015,0.000823,74.125.24.0-255,2902,76851,96,315347
23016,0.000825,172.31.47.0-255,66,76917,96,315347
23017,0.000829,74.125.24.0-255,2902,79819,96,315347
23018,0.000831,172.31.47.0-255,66,79885,96,315347
23019,0.000862,74.125.24.0-255,3644,83529,96,315347
23020,0.000865,172.31.47.0-255,66,83595,96,315347
23021,0.000947,74.125.24.0-255,1484,85079,96,315347
23022,0.000953,74.125.24.0-255,1484,86563,96,315347
23023,0.000956,172.31.47.0-255,66,86629,96,315347
23024,0.000981,74.125.24.0-255,1484,88113,96,315347
23025,0.000987,74.125.24.0-255,5738,93851,96,315347
23026,0.000989,172.31.47.0-255,66,93917,96,315347
23027,0.00101,74.125.24.0-255,1484,95401,96,315347
23028,0.001029,74.125.24.0-255,5379,100780,96,315347
23029,0.001032,172.31.47.0-255,66,100846,96,315347
23030,0.001276,74.125.24.0-255,1484,102330,96,315347
23031,0.001281,74.125.24.0-255,1484,103814,96,315347
23032,0.001284,172.31.47.0-255,66,103880,96,315347
23033,0.001314,74.125.24.0-255,1484,105364,96,315347
23034,0.001321,74.125.24.0-255,5738,111102,96,315347
23035,0.001323,172.31.47.0-255,66,111168,96,315347
23036,0.001334,172.31.47.0-255,66,111234,96,315347
23037,0.001353,74.125.24.0-255,2902,114136,96,315347
23038,0.001355,172.31.47.0-255,66,114202,96,315347
23039,0.001373,172.31.47.0-255,66,114268,96,315347
23040,0.001586,74.125.24.0-255,1484,115752,96,315347
23041,0.001602,74.125.24.0-255,2902,118654,96,315347
23042,0.001605,172.31.47.0-255,66,118720,96,315347
23043,0.001628,74.125.24.0-255,5738,124458,96,315347
23044,0.00163,172.31.47.0-255,66,124524,96,315347
23045,0.001632,74.125.24.0-255,1484,126008,96,315347
23046,0.001663,172.31.47.0-255,66,126074,96,315347
23047,0.001673,172.31.47.0-255,66,126140,96,315347
23048,0.002253,74.125.24.0-255,1484,127624,96,315347
23049,0.002265,74.125.24.0-255,1484,129108,96,315347
23050,0.002267,172.31.47.0-255,66,129174,96,315347
23051,0.002292,74.125.24.0-255,1484,130658,96,315347
23052,0.002298,74.125.24.0-255,5738,136396,96,315347
23053,0.0023,172.31.47.0-255,66,136462,96,315347
23054,0.002305,74.125.24.0-255,5738,142200,96,315347
23055,0.002307,172.31.47.0-255,66,142266,96,315347
23056,0.002334,74.125.24.0-255,7156,149422,96,315347
23057,0.002337,172.31.47.0-255,66,149488,96,315347
23058,0.002342,74.125.24.0-255,5738,155226,96,315347
23059,0.002344,172.31.47.0-255,66,155292,96,315347
23060,0.002367,74.125.24.0-255,2902,158194,96,315347
23061,0.002369,172.31.47.0-255,66,158260,96,315347
23062,0.002372,74.125.24.0-255,2184,160444,96,315347
23063,0.002377,172.31.47.0-255,66,160510,96,315347
23064,0.004704,74.125.24.0-255,1484,161994,96,315347
23065,0.004759,74.125.24.0-255,4320,166314,96,315347
23066,0.004762,172.31.47.0-255,66,166380,96,315347
23067,0.007073,74.125.24.0-255,4320,170700,96,315347
23068,0.007079,172.31.47.0-255,66,170766,96,315347
23069,0.007095,74.125.24.0-255,1484,172250,96,315347
23070,0.009401,74.125.24.0-255,4320,176570,96,315347
23071,0.009408,172.31.47.0-255,66,176636,96,315347
23072,0.011762,74.125.24.0-255,5738,182374,96,315347
23073,0.011768,172.31.47.0-255,66,182440,96,315347
23074,0.01412,74.125.24.0-255,4320,186760,96,315347
23075,0.014126,172.31.47.0-255,66,186826,96,315347
23076,0.014154,74.125.24.0-255,1484,188310,96,315347
23077,0.016476,74.125.24.0-255,4320,192630,96,315347
23078,0.016482,172.31.47.0-255,66,192696,96,315347
23079,0.018823,74.125.24.0-255,5738,198434,96,315347
23080,0.018829,172.31.47.0-255,66,198500,96,315347
23081,0.021177,74.125.24.0-255,5738,204238,96,315347
23082,0.021185,172.31.47.0-255,66,204304,96,315347
23083,0.023533,74.125.24.0-255,4320,208624,96,315347
23084,0.02354,172.31.47.0-255,66,208690,96,315347
23085,0.023569,74.125.24.0-255,1484,210174,96,315347
23086,0.025888,74.125.24.0-255,4320,214494,96,315347
23087,0.025894,172.31.47.0-255,66,214560,96,315347
23088,0.028257,74.125.24.0-255,5738,220298,96,315347
23089,0.028264,172.31.47.0-255,66,220364,96,315347
23090,0.02994,172.31.47.0-255,172,220536,96,315347
23091,0.029975,172.31.47.0-255,1110,221646,96,315347
23092,0.030037,172.31.47.0-255,1514,223160,96,315347
23093,0.030039,172.31.47.0-255,1301,224461,96,315347
23094,0.030667,74.125.24.0-255,4320,228781,96,315347
23095,0.030672,172.31.47.0-255,66,228847,96,315347
23096,0.0307,74.125.24.0-255,1484,230331,96,315347
23097,0.031477,104.244.42.0-255,66,230397,96,315347
23098,0.031516,104.244.42.0-255,66,230463,96,315347
23099,0.031581,104.244.42.0-255,66,230529,96,315347
23100,0.033025,74.125.24.0-255,4320,234849,96,315347
23101,0.033028,172.31.47.0-255,66,234915,96,315347
23102,0.035346,74.125.24.0-255,5738,240653,96,315347
23103,0.035352,172.31.47.0-255,66,240719,96,315347
23104,0.037701,74.125.24.0-255,4320,245039,96,315347
23105,0.037721,172.31.47.0-255,66,245105,96,315347
23106,0.037747,74.125.24.0-255,1484,246589,96,315347
23107,0.040064,74.125.24.0-255,4320,250909,96,315347
23108,0.040069,172.31.47.0-255,66,250975,96,315347
23109,0.042413,74.125.24.0-255,4320,255295,96,315347
23110,0.042418,172.31.47.0-255,66,255361,96,315347
23111,0.042447,74.125.24.0-255,1484,256845,96,315347
23112,0.044745,74.125.24.0-255,4320,261165,96,315347
23113,0.04475,172.31.47.0-255,66,261231,96,315347
23114,0.047102,74.125.24.0-255,5738,266969,96,315347
23115,0.047106,172.31.47.0-255,66,267035,96,315347
23116,0.04948,74.125.24.0-255,4320,271355,96,315347
23117,0.049485,172.31.47.0-255,66,271421,96,315347
23118,0.049514,74.125.24.0-255,1484,272905,96,315347
23119,0.051807,74.125.24.0-255,4320,277225,96,315347
23120,0.051811,172.31.47.0-255,66,277291,96,315347
23121,0.054142,74.125.24.0-255,5738,283029,96,315347
23122,0.054148,172.31.47.0-255,66,283095,96,315347
23123,0.056451,74.125.24.0-255,2902,285997,96,315347
23124,0.056455,172.31.47.0-255,66,286063,96,315347
23125,0.056486,74.125.24.0-255,2902,288965,96,315347
23126,0.056488,172.31.47.0-255,66,289031,96,315347
23127,0.058816,74.125.24.0-255,4320,293351,96,315347
23128,0.05882,172.31.47.0-255,66,293417,96,315347
23129,0.058851,74.125.24.0-255,1484,294901,96,315347
23130,0.061183,74.125.24.0-255,4320,299221,96,315347
23131,0.061187,172.31.47.0-255,66,299287,96,315347
23132,0.063527,74.125.24.0-255,4320,303607,96,315347
23133,0.063532,172.31.47.0-255,66,303673,96,315347
23134,0.063561,74.125.24.0-255,1484,305157,96,315347
23135,0.065878,74.125.24.0-255,4320,309477,96,315347
23136,0.065883,172.31.47.0-255,66,309543,96,315347
23137,0.068199,74.125.24.0-255,5738,315281,96,315347
23138,0.068203,172.31.47.0-255,66,315347,96,315347
23139,0.0,74.125.68.0-255,153,153,96,387350
23140,3.4e-05,172.31.47.0-255,66,219,96,387350
23141,6e-05,74.125.68.0-255,1484,1703,96,387350
23142,6.5e-05,172.31.47.0-255,66,1769,96,387350
23143,6.8e-05,74.125.68.0-255,1484,3253,96,387350
23144,7.1e-05,172.31.47.0-255,66,3319,96,387350
23145,7.5e-05,74.125.68.0-255,1484,4803,96,387350
23146,7.7e-05,172.31.47.0-255,66,4869,96,387350
23147,0.000109,74.125.68.0-255,1484,6353,96,387350
23148,0.000111,172.31.47.0-255,66,6419,96,387350
23149,0.000119,74.125.68.0-255,5738,12157,96,387350
23150,0.000122,172.31.47.0-255,66,12223,96,387350
23151,0.000128,74.125.68.0-255,2098,14321,96,387350
23152,0.000131,172.31.47.0-255,66,14387,96,387350
23153,0.000135,74.125.68.0-255,2902,17289,96,387350
23154,0.000137,172.31.47.0-255,66,17355,96,387350
23155,0.000179,74.125.68.0-255,7156,24511,96,387350
23156,0.000183,172.31.47.0-255,66,24577,96,387350
23157,0.000189,74.125.68.0-255,5738,30315,96,387350
23158,0.000191,172.31.47.0-255,66,30381,96,387350
23159,0.00021,74.125.68.0-255,1125,31506,96,387350
23160,0.000212,172.31.47.0-255,66,31572,96,387350
23161,0.000279,74.125.68.0-255,1484,33056,96,387350
23162,0.000283,172.31.47.0-255,66,33122,96,387350
23163,0.000308,74.125.68.0-255,2902,36024,96,387350
23164,0.000311,172.31.47.0-255,66,36090,96,387350
23165,0.000318,74.125.68.0-255,5738,41828,96,387350
23166,0.00032,172.31.47.0-255,66,41894,96,387350
23167,0.000324,74.125.68.0-255,2902,44796,96,387350
23168,0.000326,172.31.47.0-255,66,44862,96,387350
23169,0.000329,74.125.68.0-255,1484,46346,96,387350
23170,0.000331,172.31.47.0-255,66,46412,96,387350
23171,0.000352,74.125.68.0-255,2543,48955,96,387350
23172,0.000355,172.31.47.0-255,66,49021,96,387350
23173,0.000358,74.125.68.0-255,1484,50505,96,387350
23174,0.000395,74.125.68.0-255,7156,57661,96,387350
23175,0.000399,172.31.47.0-255,66,57727,96,387350
23176,0.000404,74.125.68.0-255,2902,60629,96,387350
23177,0.000405,172.31.47.0-255,66,60695,96,387350
23178,0.000436,74.125.68.0-255,5738,66433,96,387350
23179,0.00044,172.31.47.0-255,66,66499,96,387350
23180,0.000464,74.125.68.0-255,289,66788,96,387350
23181,0.000516,74.125.68.0-255,1484,68272,96,387350
23182,0.000519,172.31.47.0-255,66,68338,96,387350
23183,0.000546,74.125.68.0-255,2902,71240,96,387350
23184,0.000549,172.31.47.0-255,66,71306,96,387350
23185,0.000554,74.125.68.0-255,2902,74208,96,387350
23186,0.000556,172.31.47.0-255,66,74274,96,387350
23187,0.000575,74.125.68.0-255,2902,77176,96,387350
23188,0.000583,172.31.47.0-255,66,77242,96,387350
23189,0.000586,74.125.68.0-255,1484,78726,96,387350
23190,0.000616,74.125.68.0-255,2902,81628,96,387350
23191,0.000619,172.31.47.0-255,66,81694,96,387350
23192,0.000643,74.125.68.0-255,1992,83686,96,387350
23193,0.000645,172.31.47.0-255,66,83752,96,387350
23194,0.000723,74.125.68.0-255,1484,85236,96,387350
23195,0.000754,74.125.68.0-255,2902,88138,96,387350
23196,0.000758,172.31.47.0-255,66,88204,96,387350
23197,0.000783,74.125.68.0-255,4320,92524,96,387350
23198,0.000786,172.31.47.0-255,66,92590,96,387350
23199,0.00079,74.125.68.0-255,1484,94074,96,387350
23200,0.000812,74.125.68.0-255,4320,98394,96,387350
23201,0.000815,172.31.47.0-255,66,98460,96,387350
23202,0.000849,172.31.47.0-255,66,98526,96,387350
23203,0.000891,172.31.47.0-255,66,98592,96,387350
23204,0.000922,74.125.68.0-255,1484,100076,96,387350
23205,0.000939,74.125.68.0-255,2902,102978,96,387350
23206,0.000942,172.31.47.0-255,66,103044,96,387350
23207,0.000971,74.125.68.0-255,1484,104528,96,387350
23208,0.000987,74.125.68.0-255,2902,107430,96,387350
23209,0.000992,172.31.47.0-255,66,107496,96,387350
23210,0.001001,74.125.68.0-255,2902,110398,96,387350
23211,0.001003,172.31.47.0-255,66,110464,96,387350
23212,0.001028,74.125.68.0-255,2902,113366,96,387350
23213,0.001031,172.31.47.0-255,66,113432,96,387350
23214,0.001035,74.125.68.0-255,2543,115975,96,387350
23215,0.001037,172.31.47.0-255,66,116041,96,387350
23216,0.001124,74.125.68.0-255,1484,117525,96,387350
23217,0.001143,74.125.68.0-255,2902,120427,96,387350
23218,0.001147,172.31.47.0-255,66,120493,96,387350
23219,0.001152,74.125.68.0-255,2902,123395,96,387350
23220,0.001153,172.31.47.0-255,66,123461,96,387350
23221,0.001175,74.125.68.0-255,2902,126363,96,387350
23222,0.001178,172.31.47.0-255,66,126429,96,387350
23223,0.001182,74.125.68.0-255,1484,127913,96,387350
23224,0.001212,74.125.68.0-255,4320,132233,96,387350
23225,0.001215,172.31.47.0-255,66,132299,96,387350
23226,0.001252,74.125.68.0-255,1484,133783,96,387350
23227,0.001277,74.125.68.0-255,5738,139521,96,387350
23228,0.00128,172.31.47.0-255,66,139587,96,387350
23229,0.001286,74.125.68.0-255,4320,143907,96,387350
23230,0.001287,172.31.47.0-255,66,143973,96,387350
23231,0.001294,74.125.68.0-255,5738,149711,96,387350
23232,0.001296,172.31.47.0-255,66,149777,96,387350
23233,0.001298,74.125.68.0-255,766,150543,96,387350
23234,0.001419,74.125.68.0-255,1484,152027,96,387350
23235,0.001423,172.31.47.0-255,66,152093,96,387350
23236,0.001427,74.125.68.0-255,1484,153577,96,387350
23237,0.001447,74.125.68.0-255,1484,155061,96,387350
23238,0.00145,172.31.47.0-255,66,155127,96,387350
23239,0.001456,74.125.68.0-255,4320,159447,96,387350
23240,0.001458,172.31.47.0-255,66,159513,96,387350
23241,0.00148,74.125.68.0-255,2902,162415,96,387350
23242,0.001483,172.31.47.0-255,66,162481,96,387350
23243,0.001513,74.125.68.0-255,6797,169278,96,387350
23244,0.001516,172.31.47.0-255,66,169344,96,387350
23245,0.00152,74.125.68.0-255,2902,172246,96,387350
23246,0.001522,172.31.47.0-255,66,172312,96,387350
23247,0.001552,74.125.68.0-255,1484,173796,96,387350
23248,0.00158,172.31.47.0-255,66,173862,96,387350
23249,0.001613,172.31.47.0-255,66,173928,96,387350
23250,0.00164,74.125.68.0-255,1484,175412,96,387350
23251,0.001662,74.125.68.0-255,3602,179014,96,387350
23252,0.001665,172.31.47.0-255,66,179080,96,387350
23253,0.001736,74.125.68.0-255,1484,180564,96,387350
23254,0.001772,74.125.68.0-255,2902,183466,96,387350
23255,0.001776,172.31.47.0-255,66,183532,96,387350
23256,0.001802,74.125.68.0-255,5738,189270,96,387350
23257,0.001805,172.31.47.0-255,66,189336,96,387350
23258,0.001808,74.125.68.0-255,2902,192238,96,387350
23259,0.00181,172.31.47.0-255,66,192304,96,387350
23260,0.001814,74.125.68.0-255,4320,196624,96,387350
23261,0.001816,172.31.47.0-255,66,196690,96,387350
23262,0.001851,74.125.68.0-255,2902,199592,96,387350
23263,0.001855,172.31.47.0-255,66,199658,96,387350
23264,0.001879,74.125.68.0-255,2902,202560,96,387350
23265,0.001882,172.31.47.0-255,66,202626,96,387350
23266,0.001892,74.125.68.0-255,7156,209782,96,387350
23267,0.001894,172.31.47.0-255,66,209848,96,387350
23268,0.001921,74.125.68.0-255,3602,213450,96,387350
23269,0.001925,172.31.47.0-255,66,213516,96,387350
23270,0.002096,74.125.68.0-255,1484,215000,96,387350
23271,0.002102,74.125.68.0-255,2902,217902,96,387350
23272,0.002104,172.31.47.0-255,66,217968,96,387350
23273,0.00213,74.125.68.0-255,2902,220870,96,387350
23274,0.002132,172.31.47.0-255,66,220936,96,387350
23275,0.002153,74.125.68.0-255,1484,222420,96,387350
23276,0.00216,74.125.68.0-255,4320,226740,96,387350
23277,0.002162,172.31.47.0-255,66,226806,96,387350
23278,0.002187,74.125.68.0-255,2902,229708,96,387350
23279,0.00219,172.31.47.0-255,66,229774,96,387350
23280,0.00222,74.125.68.0-255,7156,236930,96,387350
23281,0.002223,172.31.47.0-255,66,236996,96,387350
23282,0.002227,74.125.68.0-255,1484,238480,96,387350
23283,0.002255,74.125.68.0-255,7156,245636,96,387350
23284,0.002258,172.31.47.0-255,66,245702,96,387350
23285,0.002262,74.125.68.0-255,2184,247886,96,387350
23286,0.002264,172.31.47.0-255,66,247952,96,387350
23287,0.004568,74.125.68.0-255,5738,253690,96,387350
23288,0.004583,172.31.47.0-255,66,253756,96,387350
23289,0.006897,74.125.68.0-255,5738,259494,96,387350
23290,0.006912,172.31.47.0-255,66,259560,96,387350
23291,0.009223,74.125.68.0-255,5738,265298,96,387350
23292,0.009241,172.31.47.0-255,66,265364,96,387350
23293,0.011544,74.125.68.0-255,5738,271102,96,387350
23294,0.011551,172.31.47.0-255,66,271168,96,387350
23295,0.013843,74.125.68.0-255,4320,275488,96,387350
23296,0.013846,172.31.47.0-255,66,275554,96,387350
23297,0.013867,74.125.68.0-255,1484,277038,96,387350
23298,0.016164,74.125.68.0-255,4320,281358,96,387350
23299,0.01618,172.31.47.0-255,66,281424,96,387350
23300,0.018508,74.125.68.0-255,5738,287162,96,387350
23301,0.018525,172.31.47.0-255,66,287228,96,387350
23302,0.020818,74.125.68.0-255,5738,292966,96,387350
23303,0.020827,172.31.47.0-255,66,293032,96,387350
23304,0.023158,74.125.68.0-255,5738,298770,96,387350
23305,0.023165,172.31.47.0-255,66,298836,96,387350
23306,0.025464,74.125.68.0-255,5738,304574,96,387350
23307,0.025474,172.31.47.0-255,66,304640,96,387350
23308,0.027791,74.125.68.0-255,5738,310378,96,387350
23309,0.027806,172.31.47.0-255,66,310444,96,387350
23310,0.030115,74.125.68.0-255,5738,316182,96,387350
23311,0.03012,172.31.47.0-255,66,316248,96,387350
23312,0.032422,74.125.68.0-255,5738,321986,96,387350
23313,0.032431,172.31.47.0-255,66,322052,96,387350
23314,0.034743,74.125.68.0-255,5738,327790,96,387350
23315,0.03476,172.31.47.0-255,66,327856,96,387350
23316,0.037072,74.125.68.0-255,5738,333594,96,387350
23317,0.037088,172.31.47.0-255,66,333660,96,387350
23318,0.039394,74.125.68.0-255,5738,339398,96,387350
23319,0.039401,172.31.47.0-255,66,339464,96,387350
23320,0.041727,74.125.68.0-255,5738,345202,96,387350
23321,0.041748,172.31.47.0-255,66,345268,96,387350
23322,0.044056,74.125.68.0-255,5738,351006,96,387350
23323,0.044068,172.31.47.0-255,66,351072,96,387350
23324,0.045179,172.31.47.0-255,172,351244,96,387350
23325,0.045206,172.31.47.0-255,1101,352345,96,387350
23326,0.045234,172.31.47.0-255,1514,353859,96,387350
23327,0.045235,172.31.47.0-255,1312,355171,96,387350
23328,0.046374,74.125.68.0-255,5738,360909,96,387350
23329,0.046384,172.31.47.0-255,66,360975,96,387350
23330,0.04667,104.244.42.0-255,66,361041,96,387350
23331,0.046841,104.244.42.0-255,66,361107,96,387350
23332,0.046848,104.244.42.0-255,66,361173,96,387350
23333,0.048686,74.125.68.0-255,5738,366911,96,387350
23334,0.048693,172.31.47.0-255,66,366977,96,387350
23335,0.050984,74.125.68.0-255,5738,372715,96,387350
23336,0.051001,172.31.47.0-255,66,372781,96,387350
23337,0.053295,74.125.68.0-255,5738,378519,96,387350
23338,0.053299,172.31.47.0-255,66,378585,96,387350
23339,0.055584,74.125.68.0-255,1484,380069,96,387350
23340,0.055611,74.125.68.0-255,4320,384389,96,387350
23341,0.055616,172.31.47.0-255,66,384455,96,387350
23342,0.057897,74.125.68.0-255,2658,387113,96,387350
23343,0.057901,172.31.47.0-255,66,387179,96,387350
23344,0.05806,172.31.47.0-255,105,387284,96,387350
23345,0.060317,74.125.68.0-255,66,387350,96,387350
23346,0.0,74.125.24.0-255,298,298,96,302411
23347,2e-05,172.31.47.0-255,66,364,96,302411
23348,2.7e-05,74.125.24.0-255,1484,1848,96,302411
23349,3.1e-05,172.31.47.0-255,66,1914,96,302411
23350,4.7e-05,74.125.24.0-255,4320,6234,96,302411
23351,5.1e-05,172.31.47.0-255,66,6300,96,302411
23352,5.9e-05,74.125.24.0-255,7156,13456,96,302411
23353,6.1e-05,172.31.47.0-255,66,13522,96,302411
23354,6.4e-05,74.125.24.0-255,438,13960,96,302411
23355,6.6e-05,172.31.47.0-255,66,14026,96,302411
23356,0.000398,74.125.24.0-255,1484,15510,96,302411
23357,0.000404,172.31.47.0-255,66,15576,96,302411
23358,0.000411,74.125.24.0-255,2902,18478,96,302411
23359,0.000414,172.31.47.0-255,66,18544,96,302411
23360,0.000427,74.125.24.0-255,5738,24282,96,302411
23361,0.000429,172.31.47.0-255,66,24348,96,302411
23362,0.000457,74.125.24.0-255,6797,31145,96,302411
23363,0.000465,172.31.47.0-255,66,31211,96,302411
23364,0.000777,74.125.24.0-255,1484,32695,96,302411
23365,0.000783,172.31.47.0-255,66,32761,96,302411
23366,0.000789,74.125.24.0-255,2902,35663,96,302411
23367,0.000791,172.31.47.0-255,66,35729,96,302411
23368,0.000801,74.125.24.0-255,2902,38631,96,302411
23369,0.000803,172.31.47.0-255,66,38697,96,302411
23370,0.000843,74.125.24.0-255,2902,41599,96,302411
23371,0.000847,172.31.47.0-255,66,41665,96,302411
23372,0.000867,172.31.47.0-255,66,41731,96,302411
23373,0.000879,172.31.47.0-255,66,41797,96,302411
23374,0.001036,74.125.24.0-255,650,42447,96,302411
23375,0.001041,172.31.47.0-255,66,42513,96,302411
23376,0.001264,74.125.24.0-255,1484,43997,96,302411
23377,0.001271,74.125.24.0-255,2902,46899,96,302411
23378,0.001275,172.31.47.0-255,66,46965,96,302411
23379,0.001279,74.125.24.0-255,1484,48449,96,302411
23380,0.001307,74.125.24.0-255,4320,52769,96,302411
23381,0.001309,172.31.47.0-255,66,52835,96,302411
23382,0.001318,74.125.24.0-255,7156,59991,96,302411
23383,0.00132,172.31.47.0-255,66,60057,96,302411
23384,0.001327,74.125.24.0-255,1484,61541,96,302411
23385,0.001372,172.31.47.0-255,66,61607,96,302411
23386,0.001376,74.125.24.0-255,2184,63791,96,302411
23387,0.001378,172.31.47.0-255,66,63857,96,302411
23388,0.001428,74.125.24.0-255,1484,65341,96,302411
23389,0.001433,74.125.24.0-255,2902,68243,96,302411
23390,0.001435,172.31.47.0-255,66,68309,96,302411
23391,0.001441,74.125.24.0-255,5738,74047,96,302411
23392,0.001443,172.31.47.0-255,66,74113,96,302411
23393,0.001479,172.31.47.0-255,66,74179,96,302411
23394,0.001515,74.125.24.0-255,4320,78499,96,302411
23395,0.001518,172.31.47.0-255,66,78565,96,302411
23396,0.001556,172.31.47.0-255,66,78631,96,302411
23397,0.001712,74.125.24.0-255,1484,80115,96,302411
23398,0.001719,74.125.24.0-255,2902,83017,96,302411
23399,0.001723,172.31.47.0-255,66,83083,96,302411
23400,0.001753,74.125.24.0-255,5738,88821,96,302411
23401,0.001757,172.31.47.0-255,66,88887,96,302411
23402,0.001762,74.125.24.0-255,4320,93207,96,302411
23403,0.001764,172.31.47.0-255,66,93273,96,302411
23404,0.001775,74.125.24.0-255,4320,97593,96,302411
23405,0.001778,172.31.47.0-255,66,97659,96,302411
23406,0.001812,74.125.24.0-255,7156,104815,96,302411
23407,0.001815,172.31.47.0-255,66,104881,96,302411
23408,0.00183,172.31.47.0-255,66,104947,96,302411
23409,0.001954,74.125.24.0-255,1484,106431,96,302411
23410,0.00196,74.125.24.0-255,2902,109333,96,302411
23411,0.001963,172.31.47.0-255,66,109399,96,302411
23412,0.001997,74.125.24.0-255,5738,115137,96,302411
23413,0.002,172.31.47.0-255,66,115203,96,302411
23414,0.002005,74.125.24.0-255,2902,118105,96,302411
23415,0.002007,172.31.47.0-255,66,118171,96,302411
23416,0.002028,74.125.24.0-255,1484,119655,96,302411
23417,0.002059,172.31.47.0-255,66,119721,96,302411
23418,0.002071,172.31.47.0-255,66,119787,96,302411
23419,0.002084,74.125.24.0-255,766,120553,96,302411
23420,0.00222,74.125.24.0-255,1484,122037,96,302411
23421,0.002225,172.31.47.0-255,66,122103,96,302411
23422,0.00223,74.125.24.0-255,2902,125005,96,302411
23423,0.002232,172.31.47.0-255,66,125071,96,302411
23424,0.002237,74.125.24.0-255,2902,127973,96,302411
23425,0.002245,172.31.47.0-255,66,128039,96,302411
23426,0.002281,74.125.24.0-255,2902,130941,96,302411
23427,0.002285,172.31.47.0-255,66,131007,96,302411
23428,0.0023,172.31.47.0-255,66,131073,96,302411
23429,0.002344,172.31.47.0-255,66,131139,96,302411
23430,0.002433,74.125.24.0-255,1484,132623,96,302411
23431,0.002436,74.125.24.0-255,1484,134107,96,302411
23432,0.002441,172.31.47.0-255,66,134173,96,302411
23433,0.00245,74.125.24.0-255,1484,135657,96,302411
23434,0.00246,74.125.24.0-255,4320,139977,96,302411
23435,0.002462,172.31.47.0-255,66,140043,96,302411
23436,0.002491,74.125.24.0-255,1484,141527,96,302411
23437,0.002504,74.125.24.0-255,7156,148683,96,302411
23438,0.002507,172.31.47.0-255,66,148749,96,302411
23439,0.002528,172.31.47.0-255,66,148815,96,302411
23440,0.002532,74.125.24.0-255,2184,150999,96,302411
23441,0.002535,172.31.47.0-255,66,151065,96,302411
23442,0.002604,74.125.24.0-255,1484,152549,96,302411
23443,0.002617,74.125.24.0-255,2902,155451,96,302411
23444,0.00262,172.31.47.0-255,66,155517,96,302411
23445,0.00265,74.125.24.0-255,5738,161255,96,302411
23446,0.002653,172.31.47.0-255,66,161321,96,302411
23447,0.002688,74.125.24.0-255,7156,168477,96,302411
23448,0.002691,172.31.47.0-255,66,168543,96,302411
23449,0.005292,74.125.24.0-255,5738,174281,96,302411
23450,0.0053,172.31.47.0-255,66,174347,96,302411
23451,0.007898,74.125.24.0-255,5738,180085,96,302411
23452,0.007902,172.31.47.0-255,66,180151,96,302411
23453,0.010526,74.125.24.0-255,5738,185889,96,302411
23454,0.010532,172.31.47.0-255,66,185955,96,302411
23455,0.013148,74.125.24.0-255,5738,191693,96,302411
23456,0.013155,172.31.47.0-255,66,191759,96,302411
23457,0.015755,74.125.24.0-255,5738,197497,96,302411
23458,0.015763,172.31.47.0-255,66,197563,96,302411
23459,0.01839,74.125.24.0-255,5738,203301,96,302411
23460,0.018404,172.31.47.0-255,66,203367,96,302411
23461,0.020994,74.125.24.0-255,5738,209105,96,302411
23462,0.021002,172.31.47.0-255,66,209171,96,302411
23463,0.023632,74.125.24.0-255,5738,214909,96,302411
23464,0.023639,172.31.47.0-255,66,214975,96,302411
23465,0.026217,74.125.24.0-255,5738,220713,96,302411
23466,0.026223,172.31.47.0-255,66,220779,96,302411
23467,0.028837,74.125.24.0-255,5738,226517,96,302411
23468,0.028845,172.31.47.0-255,66,226583,96,302411
23469,0.031467,74.125.24.0-255,5738,232321,96,302411
23470,0.031478,172.31.47.0-255,66,232387,96,302411
23471,0.032604,172.31.47.0-255,176,232563,96,302411
23472,0.032638,172.31.47.0-255,1110,233673,96,302411
23473,0.032701,172.31.47.0-255,1514,235187,96,302411
23474,0.032704,172.31.47.0-255,1302,236489,96,302411
23475,0.034115,74.125.24.0-255,5738,242227,96,302411
23476,0.03413,172.31.47.0-255,66,242293,96,302411
23477,0.034141,104.244.42.0-255,66,242359,96,302411
23478,0.034153,104.244.42.0-255,66,242425,96,302411
23479,0.034234,104.244.42.0-255,66,242491,96,302411
23480,0.036752,74.125.24.0-255,5738,248229,96,302411
23481,0.036758,172.31.47.0-255,66,248295,96,302411
23482,0.039335,74.125.24.0-255,5738,254033,96,302411
23483,0.039341,172.31.47.0-255,66,254099,96,302411
23484,0.041957,74.125.24.0-255,5738,259837,96,302411
23485,0.041972,172.31.47.0-255,66,259903,96,302411
23486,0.044633,74.125.24.0-255,5738,265641,96,302411
23487,0.044639,172.31.47.0-255,66,265707,96,302411
23488,0.047274,74.125.24.0-255,5738,271445,96,302411
23489,0.04728,172.31.47.0-255,66,271511,96,302411
23490,0.049901,74.125.24.0-255,5738,277249,96,302411
23491,0.049907,172.31.47.0-255,66,277315,96,302411
23492,0.052502,74.125.24.0-255,5738,283053,96,302411
23493,0.052509,172.31.47.0-255,66,283119,96,302411
23494,0.055104,74.125.24.0-255,5738,288857,96,302411
23495,0.05511,172.31.47.0-255,66,288923,96,302411
23496,0.057769,74.125.24.0-255,5738,294661,96,302411
23497,0.05778,172.31.47.0-255,66,294727,96,302411
23498,0.060396,74.125.24.0-255,5738,300465,96,302411
23499,0.060402,172.31.47.0-255,66,300531,96,302411
23500,0.063002,74.125.24.0-255,1289,301820,96,302411
23501,0.063128,172.31.47.0-255,105,301925,96,302411
23502,0.063336,172.31.47.0-255,90,302015,96,302411
23503,0.063344,172.31.47.0-255,66,302081,96,302411
23504,0.065696,74.125.24.0-255,66,302147,96,302411
23505,0.065871,74.125.24.0-255,66,302213,96,302411
23506,0.065904,74.125.24.0-255,66,302279,96,302411
23507,0.06591,172.31.47.0-255,66,302345,96,302411
23508,0.065914,74.125.24.0-255,66,302411,96,302411
23509,0.0,74.125.24.0-255,153,153,96,207278
23510,2.9e-05,172.31.47.0-255,66,219,96,207278
23511,3.6e-05,74.125.24.0-255,1484,1703,96,207278
23512,4.1e-05,172.31.47.0-255,66,1769,96,207278
23513,4.6e-05,74.125.24.0-255,2902,4671,96,207278
23514,4.9e-05,172.31.47.0-255,66,4737,96,207278
23515,5.5e-05,74.125.24.0-255,7156,11893,96,207278
23516,5.8e-05,172.31.47.0-255,66,11959,96,207278
23517,7.2e-05,74.125.24.0-255,2902,14861,96,207278
23518,7.5e-05,172.31.47.0-255,66,14927,96,207278
23519,9.8e-05,172.31.47.0-255,66,14993,96,207278
23520,0.000118,74.125.24.0-255,1989,16982,96,207278
23521,0.00012,172.31.47.0-255,66,17048,96,207278
23522,0.000124,74.125.24.0-255,2543,19591,96,207278
23523,0.000126,172.31.47.0-255,66,19657,96,207278
23524,0.000167,74.125.24.0-255,2902,22559,96,207278
23525,0.00017,172.31.47.0-255,66,22625,96,207278
23526,0.000176,74.125.24.0-255,4320,26945,96,207278
23527,0.000178,172.31.47.0-255,66,27011,96,207278
23528,0.000211,172.31.47.0-255,66,27077,96,207278
23529,0.000225,74.125.24.0-255,2902,29979,96,207278
23530,0.000228,172.31.47.0-255,66,30045,96,207278
23531,0.000265,172.31.47.0-255,66,30111,96,207278
23532,0.001375,74.125.24.0-255,646,30757,96,207278
23533,0.001383,172.31.47.0-255,66,30823,96,207278
23534,0.001749,74.125.24.0-255,1484,32307,96,207278
23535,0.001753,172.31.47.0-255,66,32373,96,207278
23536,0.001759,74.125.24.0-255,2902,35275,96,207278
23537,0.001761,172.31.47.0-255,66,35341,96,207278
23538,0.001775,74.125.24.0-255,5738,41079,96,207278
23539,0.001777,172.31.47.0-255,66,41145,96,207278
23540,0.00178,74.125.24.0-255,1484,42629,96,207278
23541,0.001809,74.125.24.0-255,7156,49785,96,207278
23542,0.001811,172.31.47.0-255,66,49851,96,207278
23543,0.001847,74.125.24.0-255,1484,51335,96,207278
23544,0.001874,172.31.47.0-255,66,51401,96,207278
23545,0.001895,74.125.24.0-255,1484,52885,96,207278
23546,0.001907,74.125.24.0-255,2902,55787,96,207278
23547,0.001909,172.31.47.0-255,66,55853,96,207278
23548,0.001911,74.125.24.0-255,1484,57337,96,207278
23549,0.00193,74.125.24.0-255,4320,61657,96,207278
23550,0.001932,172.31.47.0-255,66,61723,96,207278
23551,0.001935,74.125.24.0-255,2902,64625,96,207278
23552,0.001936,172.31.47.0-255,66,64691,96,207278
23553,0.001952,74.125.24.0-255,7156,71847,96,207278
23554,0.001954,172.31.47.0-255,66,71913,96,207278
23555,0.001974,74.125.24.0-255,2902,74815,96,207278
23556,0.001976,172.31.47.0-255,66,74881,96,207278
23557,0.002005,172.31.47.0-255,66,74947,96,207278
23558,0.002027,74.125.24.0-255,5738,80685,96,207278
23559,0.002029,172.31.47.0-255,66,80751,96,207278
23560,0.002048,74.125.24.0-255,5738,86489,96,207278
23561,0.00205,172.31.47.0-255,66,86555,96,207278
23562,0.002052,74.125.24.0-255,1484,88039,96,207278
23563,0.002069,74.125.24.0-255,1484,89523,96,207278
23564,0.002071,172.31.47.0-255,66,89589,96,207278
23565,0.002088,74.125.24.0-255,1484,91073,96,207278
23566,0.002122,74.125.24.0-255,1484,92557,96,207278
23567,0.002124,74.125.24.0-255,2184,94741,96,207278
23568,0.002138,172.31.47.0-255,66,94807,96,207278
23569,0.002142,172.31.47.0-255,66,94873,96,207278
23570,0.002721,74.125.24.0-255,1484,96357,96,207278
23571,0.002745,74.125.24.0-255,2902,99259,96,207278
23572,0.002749,172.31.47.0-255,66,99325,96,207278
23573,0.002755,74.125.24.0-255,5738,105063,96,207278
23574,0.002757,172.31.47.0-255,66,105129,96,207278
23575,0.002762,74.125.24.0-255,4320,109449,96,207278
23576,0.002764,172.31.47.0-255,66,109515,96,207278
23577,0.002792,172.31.47.0-255,66,109581,96,207278
23578,0.002809,74.125.24.0-255,2902,112483,96,207278
23579,0.002812,172.31.47.0-255,66,112549,96,207278
23580,0.002821,172.31.47.0-255,66,112615,96,207278
23581,0.002963,74.125.24.0-255,1484,114099,96,207278
23582,0.002968,74.125.24.0-255,2902,117001,96,207278
23583,0.002971,172.31.47.0-255,66,117067,96,207278
23584,0.002977,74.125.24.0-255,5738,122805,96,207278
23585,0.002979,172.31.47.0-255,66,122871,96,207278
23586,0.003023,172.31.47.0-255,66,122937,96,207278
23587,0.003061,74.125.24.0-255,5738,128675,96,207278
23588,0.003063,172.31.47.0-255,66,128741,96,207278
23589,0.003082,74.125.24.0-255,5020,133761,96,207278
23590,0.003084,172.31.47.0-255,66,133827,96,207278
23591,0.003118,74.125.24.0-255,1484,135311,96,207278
23592,0.00313,74.125.24.0-255,2902,138213,96,207278
23593,0.003133,172.31.47.0-255,66,138279,96,207278
23594,0.003137,74.125.24.0-255,2902,141181,96,207278
23595,0.003139,172.31.47.0-255,66,141247,96,207278
23596,0.003156,74.125.24.0-255,2902,144149,96,207278
23597,0.003158,172.31.47.0-255,66,144215,96,207278
23598,0.003169,74.125.24.0-255,7156,151371,96,207278
23599,0.003171,172.31.47.0-255,66,151437,96,207278
23600,0.003175,74.125.24.0-255,2902,154339,96,207278
23601,0.003177,172.31.47.0-255,66,154405,96,207278
23602,0.003211,172.31.47.0-255,66,154471,96,207278
23603,0.003215,74.125.24.0-255,2184,156655,96,207278
23604,0.003216,172.31.47.0-255,66,156721,96,207278
23605,0.003228,74.125.24.0-255,2902,159623,96,207278
23606,0.00323,172.31.47.0-255,66,159689,96,207278
23607,0.003254,74.125.24.0-255,2902,162591,96,207278
23608,0.003256,172.31.47.0-255,66,162657,96,207278
23609,0.003271,74.125.24.0-255,2902,165559,96,207278
23610,0.003274,172.31.47.0-255,66,165625,96,207278
23611,0.00328,74.125.24.0-255,7156,172781,96,207278
23612,0.003282,172.31.47.0-255,66,172847,96,207278
23613,0.0033,74.125.24.0-255,2902,175749,96,207278
23614,0.003302,172.31.47.0-255,66,175815,96,207278
23615,0.003339,172.31.47.0-255,66,175881,96,207278
23616,0.003344,74.125.24.0-255,3602,179483,96,207278
23617,0.003346,172.31.47.0-255,66,179549,96,207278
23618,0.003352,74.125.24.0-255,5738,185287,96,207278
23619,0.003355,172.31.47.0-255,66,185353,96,207278
23620,0.003393,172.31.47.0-255,66,185419,96,207278
23621,0.003406,172.31.47.0-255,66,185485,96,207278
23622,0.003447,172.31.47.0-255,66,185551,96,207278
23623,0.003452,74.125.24.0-255,4320,189871,96,207278
23624,0.003454,172.31.47.0-255,66,189937,96,207278
23625,0.003478,172.31.47.0-255,66,190003,96,207278
23626,0.00348,74.125.24.0-255,766,190769,96,207278
23627,0.003494,74.125.24.0-255,2902,193671,96,207278
23628,0.003496,172.31.47.0-255,66,193737,96,207278
23629,0.003511,74.125.24.0-255,7156,200893,96,207278
23630,0.003513,172.31.47.0-255,66,200959,96,207278
23631,0.003537,172.31.47.0-255,66,201025,96,207278
23632,0.00355,172.31.47.0-255,66,201091,96,207278
23633,0.003553,74.125.24.0-255,1484,202575,96,207278
23634,0.003576,172.31.47.0-255,66,202641,96,207278
23635,0.003629,74.125.24.0-255,105,202746,96,207278
23636,0.005407,172.31.47.0-255,66,202812,96,207278
23637,0.005454,172.31.47.0-255,105,202917,96,207278
23638,0.007466,74.125.24.0-255,66,202983,96,207278
23639,0.025421,172.31.47.0-255,172,203155,96,207278
23640,0.025451,172.31.47.0-255,1109,204264,96,207278
23641,0.025491,172.31.47.0-255,1514,205778,96,207278
23642,0.025493,172.31.47.0-255,1302,207080,96,207278
23643,0.026941,104.244.42.0-255,66,207146,96,207278
23644,0.027,104.244.42.0-255,66,207212,96,207278
23645,0.027003,104.244.42.0-255,66,207278,96,207278
23646,0.0,172.217.194.0-255,158,158,96,140889
23647,1.5e-05,172.31.47.0-255,66,224,96,140889
23648,2e-05,172.217.194.0-255,1484,1708,96,140889
23649,2.4e-05,172.31.47.0-255,66,1774,96,140889
23650,2.8e-05,172.217.194.0-255,1484,3258,96,140889
23651,3e-05,172.31.47.0-255,66,3324,96,140889
23652,6.7e-05,172.217.194.0-255,1484,4808,96,140889
23653,7e-05,172.31.47.0-255,66,4874,96,140889
23654,7.8e-05,172.217.194.0-255,7156,12030,96,140889
23655,8e-05,172.31.47.0-255,66,12096,96,140889
23656,9.3e-05,172.31.47.0-255,66,12162,96,140889
23657,0.000128,172.217.194.0-255,6797,18959,96,140889
23658,0.000131,172.31.47.0-255,66,19025,96,140889
23659,0.000156,172.217.194.0-255,1484,20509,96,140889
23660,0.000158,172.31.47.0-255,66,20575,96,140889
23661,0.000163,172.217.194.0-255,2902,23477,96,140889
23662,0.000165,172.31.47.0-255,66,23543,96,140889
23663,0.000194,172.217.194.0-255,5738,29281,96,140889
23664,0.000197,172.31.47.0-255,66,29347,96,140889
23665,0.000249,172.31.47.0-255,66,29413,96,140889
23666,0.000288,172.31.47.0-255,66,29479,96,140889
23667,0.000291,172.217.194.0-255,98,29577,96,140889
23668,0.000294,172.31.47.0-255,66,29643,96,140889
23669,0.00033,172.217.194.0-255,364,30007,96,140889
23670,0.000333,172.31.47.0-255,66,30073,96,140889
23671,0.000527,172.217.194.0-255,1484,31557,96,140889
23672,0.00053,172.217.194.0-255,1484,33041,96,140889
23673,0.000531,172.31.47.0-255,66,33107,96,140889
23674,0.000535,172.31.47.0-255,66,33173,96,140889
23675,0.000564,172.217.194.0-255,1484,34657,96,140889
23676,0.000578,172.217.194.0-255,5738,40395,96,140889
23677,0.000581,172.31.47.0-255,66,40461,96,140889
23678,0.000589,172.217.194.0-255,7156,47617,96,140889
23679,0.000591,172.31.47.0-255,66,47683,96,140889
23680,0.000605,172.31.47.0-255,66,47749,96,140889
23681,0.000609,172.217.194.0-255,2184,49933,96,140889
23682,0.000612,172.31.47.0-255,66,49999,96,140889
23683,0.00079,172.217.194.0-255,1484,51483,96,140889
23684,0.000796,172.217.194.0-255,2902,54385,96,140889
23685,0.0008,172.31.47.0-255,66,54451,96,140889
23686,0.000805,172.217.194.0-255,2902,57353,96,140889
23687,0.000807,172.31.47.0-255,66,57419,96,140889
23688,0.000826,172.217.194.0-255,2902,60321,96,140889
23689,0.000829,172.31.47.0-255,66,60387,96,140889
23690,0.000845,172.31.47.0-255,66,60453,96,140889
23691,0.000868,172.217.194.0-255,4320,64773,96,140889
23692,0.000871,172.31.47.0-255,66,64839,96,140889
23693,0.000884,172.31.47.0-255,66,64905,96,140889
23694,0.001137,172.217.194.0-255,1484,66389,96,140889
23695,0.001144,172.217.194.0-255,2902,69291,96,140889
23696,0.001147,172.31.47.0-255,66,69357,96,140889
23697,0.001152,172.217.194.0-255,2902,72259,96,140889
23698,0.001154,172.31.47.0-255,66,72325,96,140889
23699,0.001174,172.217.194.0-255,2902,75227,96,140889
23700,0.001177,172.31.47.0-255,66,75293,96,140889
23701,0.001189,172.217.194.0-255,7156,82449,96,140889
23702,0.001192,172.31.47.0-255,66,82515,96,140889
23703,0.001197,172.217.194.0-255,5738,88253,96,140889
23704,0.0012,172.31.47.0-255,66,88319,96,140889
23705,0.001234,172.31.47.0-255,66,88385,96,140889
23706,0.001238,172.217.194.0-255,2184,90569,96,140889
23707,0.00124,172.31.47.0-255,66,90635,96,140889
23708,0.001269,172.217.194.0-255,1484,92119,96,140889
23709,0.001303,172.31.47.0-255,66,92185,96,140889
23710,0.001308,172.217.194.0-255,4320,96505,96,140889
23711,0.00131,172.31.47.0-255,66,96571,96,140889
23712,0.001349,172.31.47.0-255,66,96637,96,140889
23713,0.001353,172.217.194.0-255,2184,98821,96,140889
23714,0.001355,172.31.47.0-255,66,98887,96,140889
23715,0.001473,172.217.194.0-255,1484,100371,96,140889
23716,0.001478,172.217.194.0-255,2902,103273,96,140889
23717,0.001481,172.31.47.0-255,66,103339,96,140889
23718,0.001488,172.217.194.0-255,5738,109077,96,140889
23719,0.00149,172.31.47.0-255,66,109143,96,140889
23720,0.001512,172.217.194.0-255,5738,114881,96,140889
23721,0.001515,172.31.47.0-255,66,114947,96,140889
23722,0.001551,172.217.194.0-255,7156,122103,96,140889
23723,0.001555,172.31.47.0-255,66,122169,96,140889
23724,0.001566,172.31.47.0-255,66,122235,96,140889
23725,0.001621,172.217.194.0-255,1484,123719,96,140889
23726,0.001625,172.217.194.0-255,2902,126621,96,140889
23727,0.001628,172.31.47.0-255,66,126687,96,140889
23728,0.001635,172.217.194.0-255,5738,132425,96,140889
23729,0.001637,172.31.47.0-255,66,132491,96,140889
23730,0.001652,172.31.47.0-255,66,132557,96,140889
23731,0.001692,172.217.194.0-255,2902,135459,96,140889
23732,0.001695,172.31.47.0-255,66,135525,96,140889
23733,0.001707,172.31.47.0-255,66,135591,96,140889
23734,0.001741,172.31.47.0-255,66,135657,96,140889
23735,0.001757,172.31.47.0-255,66,135723,96,140889
23736,0.001773,172.31.47.0-255,66,135789,96,140889
23737,0.001819,172.31.47.0-255,66,135855,96,140889
23738,0.001861,172.31.47.0-255,66,135921,96,140889
23739,0.001875,172.31.47.0-255,66,135987,96,140889
23740,0.00193,172.31.47.0-255,66,136053,96,140889
23741,0.001942,172.31.47.0-255,66,136119,96,140889
23742,0.001954,172.31.47.0-255,66,136185,96,140889
23743,0.002012,172.31.47.0-255,66,136251,96,140889
23744,0.002015,172.217.194.0-255,105,136356,96,140889
23745,0.007443,172.31.47.0-255,66,136422,96,140889
23746,0.007466,172.31.47.0-255,105,136527,96,140889
23747,0.009707,172.217.194.0-255,66,136593,96,140889
23748,0.029097,172.31.47.0-255,171,136764,96,140889
23749,0.029125,172.31.47.0-255,1134,137898,96,140889
23750,0.029173,172.31.47.0-255,1514,139412,96,140889
23751,0.029175,172.31.47.0-255,1279,140691,96,140889
23752,0.030623,104.244.42.0-255,66,140757,96,140889
23753,0.030707,104.244.42.0-255,66,140823,96,140889
23754,0.03071,104.244.42.0-255,66,140889,96,140889
23755,0.0,74.125.24.0-255,153,153,96,267510
23756,3.2e-05,172.31.47.0-255,66,219,96,267510
23757,3.9e-05,74.125.24.0-255,1484,1703,96,267510
23758,4.3e-05,172.31.47.0-255,66,1769,96,267510
23759,4.8e-05,74.125.24.0-255,2902,4671,96,267510
23760,5.2e-05,172.31.47.0-255,66,4737,96,267510
23761,7.8e-05,74.125.24.0-255,7156,11893,96,267510
23762,8.4e-05,172.31.47.0-255,66,11959,96,267510
23763,0.000105,74.125.24.0-255,2161,14120,96,267510
23764,0.000108,172.31.47.0-255,66,14186,96,267510
23765,0.000217,74.125.24.0-255,1484,15670,96,267510
23766,0.000222,172.31.47.0-255,66,15736,96,267510
23767,0.000228,74.125.24.0-255,2902,18638,96,267510
23768,0.00023,172.31.47.0-255,66,18704,96,267510
23769,0.000241,74.125.24.0-255,1484,20188,96,267510
23770,0.000244,172.31.47.0-255,66,20254,96,267510
23771,0.000261,74.125.24.0-255,4320,24574,96,267510
23772,0.000264,172.31.47.0-255,66,24640,96,267510
23773,0.000302,74.125.24.0-255,6797,31437,96,267510
23774,0.000307,172.31.47.0-255,66,31503,96,267510
23775,0.000334,74.125.24.0-255,7156,38659,96,267510
23776,0.000339,172.31.47.0-255,66,38725,96,267510
23777,0.000359,74.125.24.0-255,2902,41627,96,267510
23778,0.000362,172.31.47.0-255,66,41693,96,267510
23779,0.000384,74.125.24.0-255,6797,48490,96,267510
23780,0.000388,172.31.47.0-255,66,48556,96,267510
23781,0.000408,74.125.24.0-255,1484,50040,96,267510
23782,0.00041,172.31.47.0-255,66,50106,96,267510
23783,0.000433,74.125.24.0-255,2902,53008,96,267510
23784,0.000436,172.31.47.0-255,66,53074,96,267510
23785,0.000443,74.125.24.0-255,5738,58812,96,267510
23786,0.000445,172.31.47.0-255,66,58878,96,267510
23787,0.000485,74.125.24.0-255,6797,65675,96,267510
23788,0.000489,172.31.47.0-255,66,65741,96,267510
23789,0.000507,74.125.24.0-255,645,66386,96,267510
23790,0.000694,74.125.24.0-255,1484,67870,96,267510
23791,0.000698,172.31.47.0-255,66,67936,96,267510
23792,0.000704,74.125.24.0-255,2902,70838,96,267510
23793,0.000706,172.31.47.0-255,66,70904,96,267510
23794,0.000709,74.125.24.0-255,1484,72388,96,267510
23795,0.000735,74.125.24.0-255,4320,76708,96,267510
23796,0.000739,172.31.47.0-255,66,76774,96,267510
23797,0.000763,74.125.24.0-255,6249,83023,96,267510
23798,0.000765,172.31.47.0-255,66,83089,96,267510
23799,0.001093,74.125.24.0-255,1484,84573,96,267510
23800,0.001101,74.125.24.0-255,1484,86057,96,267510
23801,0.001104,172.31.47.0-255,66,86123,96,267510
23802,0.001118,74.125.24.0-255,1484,87607,96,267510
23803,0.001125,74.125.24.0-255,5738,93345,96,267510
23804,0.001128,172.31.47.0-255,66,93411,96,267510
23805,0.001132,74.125.24.0-255,2902,96313,96,267510
23806,0.001134,172.31.47.0-255,66,96379,96,267510
23807,0.001162,172.31.47.0-255,66,96445,96,267510
23808,0.001166,74.125.24.0-255,2902,99347,96,267510
23809,0.001168,172.31.47.0-255,66,99413,96,267510
23810,0.001189,74.125.24.0-255,7156,106569,96,267510
23811,0.001191,172.31.47.0-255,66,106635,96,267510
23812,0.001194,74.125.24.0-255,766,107401,96,267510
23813,0.001381,74.125.24.0-255,1484,108885,96,267510
23814,0.001385,172.31.47.0-255,66,108951,96,267510
23815,0.00139,74.125.24.0-255,2902,111853,96,267510
23816,0.001392,172.31.47.0-255,66,111919,96,267510
23817,0.001404,74.125.24.0-255,2902,114821,96,267510
23818,0.001406,172.31.47.0-255,66,114887,96,267510
23819,0.001429,74.125.24.0-255,2902,117789,96,267510
23820,0.001432,172.31.47.0-255,66,117855,96,267510
23821,0.001447,74.125.24.0-255,5738,123593,96,267510
23822,0.001449,172.31.47.0-255,66,123659,96,267510
23823,0.001467,74.125.24.0-255,7156,130815,96,267510
23824,0.001468,172.31.47.0-255,66,130881,96,267510
23825,0.001476,74.125.24.0-255,7156,138037,96,267510
23826,0.001477,172.31.47.0-255,66,138103,96,267510
23827,0.001499,74.125.24.0-255,3602,141705,96,267510
23828,0.0015,172.31.47.0-255,66,141771,96,267510
23829,0.001793,74.125.24.0-255,1484,143255,96,267510
23830,0.0018,74.125.24.0-255,2902,146157,96,267510
23831,0.001805,172.31.47.0-255,66,146223,96,267510
23832,0.001841,74.125.24.0-255,5738,151961,96,267510
23833,0.001843,172.31.47.0-255,66,152027,96,267510
23834,0.001846,74.125.24.0-255,1484,153511,96,267510
23835,0.00187,172.31.47.0-255,66,153577,96,267510
23836,0.001876,74.125.24.0-255,5738,159315,96,267510
23837,0.001877,172.31.47.0-255,66,159381,96,267510
23838,0.001891,74.125.24.0-255,4320,163701,96,267510
23839,0.001892,172.31.47.0-255,66,163767,96,267510
23840,0.001895,74.125.24.0-255,766,164533,96,267510
23841,0.001969,74.125.24.0-255,1484,166017,96,267510
23842,0.001972,172.31.47.0-255,66,166083,96,267510
23843,0.00199,74.125.24.0-255,2902,168985,96,267510
23844,0.001992,172.31.47.0-255,66,169051,96,267510
23845,0.001997,74.125.24.0-255,4320,173371,96,267510
23846,0.001999,172.31.47.0-255,66,173437,96,267510
23847,0.002009,74.125.24.0-255,1484,174921,96,267510
23848,0.002013,74.125.24.0-255,2902,177823,96,267510
23849,0.002015,172.31.47.0-255,66,177889,96,267510
23850,0.002027,74.125.24.0-255,4320,182209,96,267510
23851,0.002029,172.31.47.0-255,66,182275,96,267510
23852,0.002046,74.125.24.0-255,2902,185177,96,267510
23853,0.002048,172.31.47.0-255,66,185243,96,267510
23854,0.002071,172.31.47.0-255,66,185309,96,267510
23855,0.002074,74.125.24.0-255,2184,187493,96,267510
23856,0.002076,172.31.47.0-255,66,187559,96,267510
23857,0.002108,74.125.24.0-255,1484,189043,96,267510
23858,0.002134,172.31.47.0-255,66,189109,96,267510
23859,0.002153,74.125.24.0-255,1484,190593,96,267510
23860,0.002167,172.31.47.0-255,66,190659,96,267510
23861,0.002184,74.125.24.0-255,2184,192843,96,267510
23862,0.002186,172.31.47.0-255,66,192909,96,267510
23863,0.002438,74.125.24.0-255,1484,194393,96,267510
23864,0.002441,74.125.24.0-255,1484,195877,96,267510
23865,0.002443,172.31.47.0-255,66,195943,96,267510
23866,0.002457,74.125.24.0-255,1484,197427,96,267510
23867,0.002462,74.125.24.0-255,4320,201747,96,267510
23868,0.002464,172.31.47.0-255,66,201813,96,267510
23869,0.002499,74.125.24.0-255,1484,203297,96,267510
23870,0.002507,172.31.47.0-255,66,203363,96,267510
23871,0.002578,172.31.47.0-255,66,203429,96,267510
23872,0.002583,74.125.24.0-255,5738,209167,96,267510
23873,0.002585,172.31.47.0-255,66,209233,96,267510
23874,0.002606,172.31.47.0-255,66,209299,96,267510
23875,0.002611,74.125.24.0-255,7156,216455,96,267510
23876,0.002613,172.31.47.0-255,66,216521,96,267510
23877,0.002648,74.125.24.0-255,2902,219423,96,267510
23878,0.00265,172.31.47.0-255,66,219489,96,267510
23879,0.002675,172.31.47.0-255,66,219555,96,267510
23880,0.002679,74.125.24.0-255,5738,225293,96,267510
23881,0.002681,172.31.47.0-255,66,225359,96,267510
23882,0.002695,74.125.24.0-255,7156,232515,96,267510
23883,0.002697,172.31.47.0-255,66,232581,96,267510
23884,0.002735,172.31.47.0-255,66,232647,96,267510
23885,0.002744,172.31.47.0-255,66,232713,96,267510
23886,0.002773,74.125.24.0-255,7156,239869,96,267510
23887,0.002775,172.31.47.0-255,66,239935,96,267510
23888,0.002792,172.31.47.0-255,66,240001,96,267510
23889,0.002814,172.31.47.0-255,66,240067,96,267510
23890,0.002818,74.125.24.0-255,3602,243669,96,267510
23891,0.00282,172.31.47.0-255,66,243735,96,267510
23892,0.002952,74.125.24.0-255,1484,245219,96,267510
23893,0.002978,74.125.24.0-255,2902,248121,96,267510
23894,0.00298,172.31.47.0-255,66,248187,96,267510
23895,0.002995,74.125.24.0-255,4320,252507,96,267510
23896,0.002996,172.31.47.0-255,66,252573,96,267510
23897,0.003028,172.31.47.0-255,66,252639,96,267510
23898,0.003031,74.125.24.0-255,2902,255541,96,267510
23899,0.003033,172.31.47.0-255,66,255607,96,267510
23900,0.003035,74.125.24.0-255,1484,257091,96,267510
23901,0.003088,74.125.24.0-255,2902,259993,96,267510
23902,0.00309,172.31.47.0-255,66,260059,96,267510
23903,0.003101,74.125.24.0-255,2749,262808,96,267510
23904,0.003102,172.31.47.0-255,66,262874,96,267510
23905,0.003105,74.125.24.0-255,105,262979,96,267510
23906,0.006295,172.31.47.0-255,66,263045,96,267510
23907,0.006329,172.31.47.0-255,105,263150,96,267510
23908,0.008902,74.125.24.0-255,66,263216,96,267510
23909,0.034753,172.31.47.0-255,171,263387,96,267510
23910,0.034784,172.31.47.0-255,1133,264520,96,267510
23911,0.034826,172.31.47.0-255,1514,266034,96,267510
23912,0.034828,172.31.47.0-255,1278,267312,96,267510
23913,0.036354,104.244.42.0-255,66,267378,96,267510
23914,0.03637,104.244.42.0-255,66,267444,96,267510
23915,0.036373,104.244.42.0-255,66,267510,96,267510
23916,0.0,172.31.47.0-255,66,66,96,66
23917,0.0,172.217.194.0-255,153,153,96,235219
23918,2.4e-05,172.31.47.0-255,66,219,96,235219
23919,3e-05,172.217.194.0-255,1484,1703,96,235219
23920,3.4e-05,172.31.47.0-255,66,1769,96,235219
23921,3.8e-05,172.217.194.0-255,2902,4671,96,235219
23922,4e-05,172.31.47.0-255,66,4737,96,235219
23923,4.3e-05,172.217.194.0-255,1484,6221,96,235219
23924,4.5e-05,172.31.47.0-255,66,6287,96,235219
23925,6.6e-05,172.217.194.0-255,5738,12025,96,235219
23926,6.9e-05,172.31.47.0-255,66,12091,96,235219
23927,7.4e-05,172.217.194.0-255,4320,16411,96,235219
23928,7.6e-05,172.31.47.0-255,66,16477,96,235219
23929,9.9e-05,172.217.194.0-255,6425,22902,96,235219
23930,0.000101,172.31.47.0-255,66,22968,96,235219
23931,0.00013,172.31.47.0-255,66,23034,96,235219
23932,0.0002,172.217.194.0-255,1484,24518,96,235219
23933,0.000203,172.31.47.0-255,66,24584,96,235219
23934,0.000215,172.217.194.0-255,2902,27486,96,235219
23935,0.000217,172.31.47.0-255,66,27552,96,235219
23936,0.000233,172.217.194.0-255,5738,33290,96,235219
23937,0.000236,172.31.47.0-255,66,33356,96,235219
23938,0.000269,172.217.194.0-255,2902,36258,96,235219
23939,0.000272,172.31.47.0-255,66,36324,96,235219
23940,0.000305,172.31.47.0-255,66,36390,96,235219
23941,0.000312,172.217.194.0-255,5738,42128,96,235219
23942,0.000314,172.31.47.0-255,66,42194,96,235219
23943,0.000345,172.217.194.0-255,3961,46155,96,235219
23944,0.000348,172.31.47.0-255,66,46221,96,235219
23945,0.000619,172.217.194.0-255,645,46866,96,235219
23946,0.000625,172.31.47.0-255,66,46932,96,235219
23947,0.000692,172.217.194.0-255,1484,48416,96,235219
23948,0.000696,172.217.194.0-255,1484,49900,96,235219
23949,0.0007,172.31.47.0-255,66,49966,96,235219
23950,0.000712,172.217.194.0-255,1484,51450,96,235219
23951,0.000718,172.217.194.0-255,5738,57188,96,235219
23952,0.000721,172.31.47.0-255,66,57254,96,235219
23953,0.000743,172.217.194.0-255,5738,62992,96,235219
23954,0.000746,172.31.47.0-255,66,63058,96,235219
23955,0.000764,172.217.194.0-255,7156,70214,96,235219
23956,0.000766,172.31.47.0-255,66,70280,96,235219
23957,0.000775,172.31.47.0-255,66,70346,96,235219
23958,0.00081,172.217.194.0-255,2184,72530,96,235219
23959,0.000812,172.31.47.0-255,66,72596,96,235219
23960,0.000815,172.217.194.0-255,2902,75498,96,235219
23961,0.000816,172.31.47.0-255,66,75564,96,235219
23962,0.000833,172.217.194.0-255,7156,82720,96,235219
23963,0.000835,172.31.47.0-255,66,82786,96,235219
23964,0.000858,172.217.194.0-255,5738,88524,96,235219
23965,0.000861,172.31.47.0-255,66,88590,96,235219
23966,0.000886,172.31.47.0-255,66,88656,96,235219
23967,0.000906,172.217.194.0-255,4320,92976,96,235219
23968,0.000908,172.31.47.0-255,66,93042,96,235219
23969,0.000931,172.217.194.0-255,5020,98062,96,235219
23970,0.000934,172.31.47.0-255,66,98128,96,235219
23971,0.000943,172.31.47.0-255,66,98194,96,235219
23972,0.000981,172.31.47.0-255,66,98260,96,235219
23973,0.000999,172.217.194.0-255,1484,99744,96,235219
23974,0.001002,172.217.194.0-255,1484,101228,96,235219
23975,0.001004,172.31.47.0-255,66,101294,96,235219
23976,0.001027,172.217.194.0-255,3602,104896,96,235219
23977,0.00103,172.31.47.0-255,66,104962,96,235219
23978,0.001035,172.217.194.0-255,5738,110700,96,235219
23979,0.001037,172.31.47.0-255,66,110766,96,235219
23980,0.001042,172.217.194.0-255,4320,115086,96,235219
23981,0.001044,172.31.47.0-255,66,115152,96,235219
23982,0.001075,172.31.47.0-255,66,115218,96,235219
23983,0.001084,172.31.47.0-255,66,115284,96,235219
23984,0.001107,172.217.194.0-255,2184,117468,96,235219
23985,0.00111,172.31.47.0-255,66,117534,96,235219
23986,0.001134,172.217.194.0-255,2902,120436,96,235219
23987,0.001136,172.31.47.0-255,66,120502,96,235219
23988,0.001139,172.217.194.0-255,1484,121986,96,235219
23989,0.00116,172.217.194.0-255,5738,127724,96,235219
23990,0.001163,172.31.47.0-255,66,127790,96,235219
23991,0.001168,172.217.194.0-255,5738,133528,96,235219
23992,0.00117,172.31.47.0-255,66,133594,96,235219
23993,0.001173,172.217.194.0-255,2902,136496,96,235219
23994,0.001175,172.31.47.0-255,66,136562,96,235219
23995,0.001212,172.31.47.0-255,66,136628,96,235219
23996,0.001217,172.217.194.0-255,3602,140230,96,235219
23997,0.001218,172.31.47.0-255,66,140296,96,235219
23998,0.001353,172.217.194.0-255,1484,141780,96,235219
23999,0.001372,172.217.194.0-255,2902,144682,96,235219
24000,0.001375,172.31.47.0-255,66,144748,96,235219
24001,0.001379,172.217.194.0-255,2902,147650,96,235219
24002,0.001381,172.31.47.0-255,66,147716,96,235219
24003,0.001396,172.217.194.0-255,2902,150618,96,235219
24004,0.001398,172.31.47.0-255,66,150684,96,235219
24005,0.001403,172.217.194.0-255,4320,155004,96,235219
24006,0.001404,172.31.47.0-255,66,155070,96,235219
24007,0.001444,172.31.47.0-255,66,155136,96,235219
24008,0.001454,172.31.47.0-255,66,155202,96,235219
24009,0.001457,172.217.194.0-255,2184,157386,96,235219
24010,0.001459,172.31.47.0-255,66,157452,96,235219
24011,0.001499,172.217.194.0-255,2902,160354,96,235219
24012,0.001502,172.31.47.0-255,66,160420,96,235219
24013,0.001507,172.217.194.0-255,4320,164740,96,235219
24014,0.001509,172.31.47.0-255,66,164806,96,235219
24015,0.001522,172.217.194.0-255,2902,167708,96,235219
24016,0.001524,172.31.47.0-255,66,167774,96,235219
24017,0.001582,172.31.47.0-255,66,167840,96,235219
24018,0.001592,172.31.47.0-255,66,167906,96,235219
24019,0.001601,172.31.47.0-255,66,167972,96,235219
24020,0.001629,172.217.194.0-255,2902,170874,96,235219
24021,0.001632,172.31.47.0-255,66,170940,96,235219
24022,0.001647,172.31.47.0-255,66,171006,96,235219
24023,0.001649,172.217.194.0-255,766,171772,96,235219
24024,0.001745,172.217.194.0-255,1484,173256,96,235219
24025,0.001748,172.31.47.0-255,66,173322,96,235219
24026,0.001752,172.217.194.0-255,2902,176224,96,235219
24027,0.001754,172.31.47.0-255,66,176290,96,235219
24028,0.001766,172.217.194.0-255,2902,179192,96,235219
24029,0.001769,172.31.47.0-255,66,179258,96,235219
24030,0.001786,172.217.194.0-255,2902,182160,96,235219
24031,0.001789,172.31.47.0-255,66,182226,96,235219
24032,0.001813,172.217.194.0-255,5738,187964,96,235219
24033,0.001815,172.31.47.0-255,66,188030,96,235219
24034,0.001834,172.217.194.0-255,1484,189514,96,235219
24035,0.001841,172.217.194.0-255,5738,195252,96,235219
24036,0.001844,172.31.47.0-255,66,195318,96,235219
24037,0.001888,172.31.47.0-255,66,195384,96,235219
24038,0.001902,172.217.194.0-255,2184,197568,96,235219
24039,0.001904,172.31.47.0-255,66,197634,96,235219
24040,0.001919,172.217.194.0-255,2902,200536,96,235219
24041,0.001922,172.31.47.0-255,66,200602,96,235219
24042,0.001942,172.217.194.0-255,1484,202086,96,235219
24043,0.001962,172.217.194.0-255,5738,207824,96,235219
24044,0.00197,172.31.47.0-255,66,207890,96,235219
24045,0.001975,172.217.194.0-255,4320,212210,96,235219
24046,0.001979,172.31.47.0-255,66,212276,96,235219
24047,0.001994,172.217.194.0-255,1484,213760,96,235219
24048,0.001997,172.217.194.0-255,1484,215244,96,235219
24049,0.001999,172.31.47.0-255,66,215310,96,235219
24050,0.002035,172.31.47.0-255,66,215376,96,235219
24051,0.004015,172.217.194.0-255,5738,221114,96,235219
24052,0.004028,172.31.47.0-255,66,221180,96,235219
24053,0.005998,172.217.194.0-255,5738,226918,96,235219
24054,0.006004,172.31.47.0-255,66,226984,96,235219
24055,0.007979,172.217.194.0-255,4670,231654,96,235219
24056,0.007985,172.31.47.0-255,66,231720,96,235219
24057,0.02084,172.31.47.0-255,105,231825,96,235219
24058,0.022806,172.217.194.0-255,66,231891,96,235219
24059,0.037668,172.31.47.0-255,172,232063,96,235219
24060,0.037704,172.31.47.0-255,1109,233172,96,235219
24061,0.037764,172.31.47.0-255,1514,234686,96,235219
24062,0.037766,172.31.47.0-255,335,235021,96,235219
24063,0.039213,104.244.42.0-255,66,235087,96,235219
24064,0.039255,104.244.42.0-255,66,235153,96,235219
24065,0.039305,104.244.42.0-255,66,235219,96,235219
24066,0.0,172.217.194.0-255,153,153,96,279251
24067,2.4e-05,172.31.47.0-255,66,219,96,279251
24068,3.1e-05,172.217.194.0-255,1484,1703,96,279251
24069,3.5e-05,172.31.47.0-255,66,1769,96,279251
24070,4.1e-05,172.217.194.0-255,2902,4671,96,279251
24071,4.3e-05,172.31.47.0-255,66,4737,96,279251
24072,5.6e-05,172.217.194.0-255,4320,9057,96,279251
24073,5.9e-05,172.31.47.0-255,66,9123,96,279251
24074,6.5e-05,172.217.194.0-255,5002,14125,96,279251
24075,6.8e-05,172.31.47.0-255,66,14191,96,279251
24076,7.4e-05,172.217.194.0-255,4320,18511,96,279251
24077,7.6e-05,172.31.47.0-255,66,18577,96,279251
24078,8.3e-05,172.217.194.0-255,5738,24315,96,279251
24079,8.6e-05,172.31.47.0-255,66,24381,96,279251
24080,0.000123,172.217.194.0-255,6797,31178,96,279251
24081,0.000126,172.31.47.0-255,66,31244,96,279251
24082,0.00013,172.217.194.0-255,1484,32728,96,279251
24083,0.000132,172.31.47.0-255,66,32794,96,279251
24084,0.000175,172.217.194.0-255,5738,38532,96,279251
24085,0.000178,172.31.47.0-255,66,38598,96,279251
24086,0.000189,172.31.47.0-255,66,38664,96,279251
24087,0.000245,172.31.47.0-255,66,38730,96,279251
24088,0.000315,172.217.194.0-255,646,39376,96,279251
24089,0.000318,172.31.47.0-255,66,39442,96,279251
24090,0.001036,172.217.194.0-255,1484,40926,96,279251
24091,0.001041,172.31.47.0-255,66,40992,96,279251
24092,0.001047,172.217.194.0-255,2902,43894,96,279251
24093,0.001048,172.31.47.0-255,66,43960,96,279251
24094,0.001055,172.217.194.0-255,5738,49698,96,279251
24095,0.001056,172.31.47.0-255,66,49764,96,279251
24096,0.001088,172.217.194.0-255,4320,54084,96,279251
24097,0.001089,172.31.47.0-255,66,54150,96,279251
24098,0.001114,172.217.194.0-255,5738,59888,96,279251
24099,0.00112,172.217.194.0-255,5738,65626,96,279251
24100,0.001123,172.31.47.0-255,66,65692,96,279251
24101,0.001129,172.31.47.0-255,66,65758,96,279251
24102,0.00114,172.31.47.0-255,66,65824,96,279251
24103,0.001669,172.217.194.0-255,1484,67308,96,279251
24104,0.00168,172.217.194.0-255,2902,70210,96,279251
24105,0.001684,172.31.47.0-255,66,70276,96,279251
24106,0.001699,172.217.194.0-255,2902,73178,96,279251
24107,0.001704,172.31.47.0-255,66,73244,96,279251
24108,0.001715,172.217.194.0-255,2902,76146,96,279251
24109,0.00172,172.31.47.0-255,66,76212,96,279251
24110,0.001741,172.217.194.0-255,5738,81950,96,279251
24111,0.001743,172.31.47.0-255,66,82016,96,279251
24112,0.001772,172.217.194.0-255,7156,89172,96,279251
24113,0.001775,172.31.47.0-255,66,89238,96,279251
24114,0.001786,172.31.47.0-255,66,89304,96,279251
24115,0.001788,172.217.194.0-255,766,90070,96,279251
24116,0.002353,172.217.194.0-255,1484,91554,96,279251
24117,0.002359,172.31.47.0-255,66,91620,96,279251
24118,0.002364,172.217.194.0-255,1484,93104,96,279251
24119,0.002384,172.217.194.0-255,1484,94588,96,279251
24120,0.002386,172.31.47.0-255,66,94654,96,279251
24121,0.002392,172.217.194.0-255,5738,100392,96,279251
24122,0.002394,172.31.47.0-255,66,100458,96,279251
24123,0.002413,172.217.194.0-255,7156,107614,96,279251
24124,0.002415,172.31.47.0-255,66,107680,96,279251
24125,0.002457,172.31.47.0-255,66,107746,96,279251
24126,0.002461,172.217.194.0-255,2184,109930,96,279251
24127,0.002463,172.31.47.0-255,66,109996,96,279251
24128,0.00248,172.217.194.0-255,4320,114316,96,279251
24129,0.002482,172.31.47.0-255,66,114382,96,279251
24130,0.002513,172.31.47.0-255,66,114448,96,279251
24131,0.00252,172.217.194.0-255,7156,121604,96,279251
24132,0.002522,172.31.47.0-255,66,121670,96,279251
24133,0.002534,172.217.194.0-255,4320,125990,96,279251
24134,0.002536,172.31.47.0-255,66,126056,96,279251
24135,0.002555,172.217.194.0-255,1484,127540,96,279251
24136,0.002576,172.217.194.0-255,2184,129724,96,279251
24137,0.002578,172.31.47.0-255,66,129790,96,279251
24138,0.005121,172.217.194.0-255,1484,131274,96,279251
24139,0.005157,172.217.194.0-255,4320,135594,96,279251
24140,0.005167,172.31.47.0-255,66,135660,96,279251
24141,0.007747,172.217.194.0-255,5738,141398,96,279251
24142,0.00776,172.31.47.0-255,66,141464,96,279251
24143,0.010348,172.217.194.0-255,5738,147202,96,279251
24144,0.010366,172.31.47.0-255,66,147268,96,279251
24145,0.012961,172.217.194.0-255,5738,153006,96,279251
24146,0.01298,172.31.47.0-255,66,153072,96,279251
24147,0.015586,172.217.194.0-255,5738,158810,96,279251
24148,0.015606,172.31.47.0-255,66,158876,96,279251
24149,0.018186,172.217.194.0-255,5738,164614,96,279251
24150,0.018199,172.31.47.0-255,66,164680,96,279251
24151,0.020778,172.217.194.0-255,5738,170418,96,279251
24152,0.02079,172.31.47.0-255,66,170484,96,279251
24153,0.023398,172.217.194.0-255,5738,176222,96,279251
24154,0.023408,172.31.47.0-255,66,176288,96,279251
24155,0.026018,172.217.194.0-255,5738,182026,96,279251
24156,0.026027,172.31.47.0-255,66,182092,96,279251
24157,0.028106,172.31.47.0-255,172,182264,96,279251
24158,0.028138,172.31.47.0-255,1109,183373,96,279251
24159,0.028186,172.31.47.0-255,1514,184887,96,279251
24160,0.028188,172.31.47.0-255,1302,186189,96,279251
24161,0.028615,172.217.194.0-255,5738,191927,96,279251
24162,0.028622,172.31.47.0-255,66,191993,96,279251
24163,0.029697,104.244.42.0-255,66,192059,96,279251
24164,0.029726,104.244.42.0-255,66,192125,96,279251
24165,0.029742,104.244.42.0-255,66,192191,96,279251
24166,0.031269,172.217.194.0-255,5738,197929,96,279251
24167,0.031273,172.31.47.0-255,66,197995,96,279251
24168,0.033868,172.217.194.0-255,5738,203733,96,279251
24169,0.033875,172.31.47.0-255,66,203799,96,279251
24170,0.036443,172.217.194.0-255,5738,209537,96,279251
24171,0.036448,172.31.47.0-255,66,209603,96,279251
24172,0.039025,172.217.194.0-255,5738,215341,96,279251
24173,0.039031,172.31.47.0-255,66,215407,96,279251
24174,0.041623,172.217.194.0-255,5738,221145,96,279251
24175,0.041631,172.31.47.0-255,66,221211,96,279251
24176,0.044263,172.217.194.0-255,5738,226949,96,279251
24177,0.044273,172.31.47.0-255,66,227015,96,279251
24178,0.046856,172.217.194.0-255,5738,232753,96,279251
24179,0.046861,172.31.47.0-255,66,232819,96,279251
24180,0.049436,172.217.194.0-255,5738,238557,96,279251
24181,0.049448,172.31.47.0-255,66,238623,96,279251
24182,0.052058,172.217.194.0-255,5738,244361,96,279251
24183,0.052073,172.31.47.0-255,66,244427,96,279251
24184,0.05466,172.217.194.0-255,5738,250165,96,279251
24185,0.054674,172.31.47.0-255,66,250231,96,279251
24186,0.057309,172.217.194.0-255,5738,255969,96,279251
24187,0.057324,172.31.47.0-255,66,256035,96,279251
24188,0.059947,172.217.194.0-255,5738,261773,96,279251
24189,0.05996,172.31.47.0-255,66,261839,96,279251
24190,0.062575,172.217.194.0-255,5738,267577,96,279251
24191,0.062588,172.31.47.0-255,66,267643,96,279251
24192,0.065171,172.217.194.0-255,5738,273381,96,279251
24193,0.065184,172.31.47.0-255,66,273447,96,279251
24194,0.067785,172.217.194.0-255,5738,279185,96,279251
24195,0.067796,172.31.47.0-255,66,279251,96,279251
24196,0.0,172.217.24.0-255,153,153,96,342127
24197,3.3e-05,172.31.47.0-255,66,219,96,342127
24198,4e-05,172.217.24.0-255,1484,1703,96,342127
24199,4.4e-05,172.31.47.0-255,66,1769,96,342127
24200,4.9e-05,172.217.24.0-255,2902,4671,96,342127
24201,5.1e-05,172.31.47.0-255,66,4737,96,342127
24202,5.5e-05,172.217.24.0-255,1484,6221,96,342127
24203,5.7e-05,172.31.47.0-255,66,6287,96,342127
24204,8.3e-05,172.217.24.0-255,2902,9189,96,342127
24205,8.7e-05,172.31.47.0-255,66,9255,96,342127
24206,0.000108,172.217.24.0-255,4984,14239,96,342127
24207,0.00011,172.31.47.0-255,66,14305,96,342127
24208,0.00026,172.217.24.0-255,1484,15789,96,342127
24209,0.000264,172.31.47.0-255,66,15855,96,342127
24210,0.00027,172.217.24.0-255,2902,18757,96,342127
24211,0.000272,172.31.47.0-255,66,18823,96,342127
24212,0.0003,172.217.24.0-255,5738,24561,96,342127
24213,0.000304,172.31.47.0-255,66,24627,96,342127
24214,0.000311,172.217.24.0-255,6797,31424,96,342127
24215,0.000313,172.31.47.0-255,66,31490,96,342127
24216,0.000377,172.217.24.0-255,1484,32974,96,342127
24217,0.000381,172.31.47.0-255,66,33040,96,342127
24218,0.000411,172.217.24.0-255,1484,34524,96,342127
24219,0.000413,172.31.47.0-255,66,34590,96,342127
24220,0.000418,172.217.24.0-255,2902,37492,96,342127
24221,0.00042,172.31.47.0-255,66,37558,96,342127
24222,0.000437,172.217.24.0-255,5738,43296,96,342127
24223,0.00044,172.31.47.0-255,66,43362,96,342127
24224,0.000462,172.217.24.0-255,5379,48741,96,342127
24225,0.000465,172.31.47.0-255,66,48807,96,342127
24226,0.000573,172.217.24.0-255,1484,50291,96,342127
24227,0.000577,172.31.47.0-255,66,50357,96,342127
24228,0.00058,172.217.24.0-255,1484,51841,96,342127
24229,0.000593,172.217.24.0-255,1484,53325,96,342127
24230,0.000596,172.31.47.0-255,66,53391,96,342127
24231,0.000599,172.217.24.0-255,1484,54875,96,342127
24232,0.000616,172.217.24.0-255,4320,59195,96,342127
24233,0.00062,172.31.47.0-255,66,59261,96,342127
24234,0.000627,172.217.24.0-255,6797,66058,96,342127
24235,0.00063,172.31.47.0-255,66,66124,96,342127
24236,0.000652,172.217.24.0-255,360,66484,96,342127
24237,0.000802,172.31.47.0-255,66,66550,96,342127
24238,0.001102,172.217.24.0-255,128,66678,96,342127
24239,0.001143,172.31.47.0-255,66,66744,96,342127
24240,0.001342,172.217.24.0-255,1484,68228,96,342127
24241,0.001351,172.217.24.0-255,2902,71130,96,342127
24242,0.001355,172.31.47.0-255,66,71196,96,342127
24243,0.00136,172.217.24.0-255,2902,74098,96,342127
24244,0.001362,172.31.47.0-255,66,74164,96,342127
24245,0.001379,172.217.24.0-255,2902,77066,96,342127
24246,0.001382,172.31.47.0-255,66,77132,96,342127
24247,0.001413,172.217.24.0-255,6797,83929,96,342127
24248,0.001417,172.31.47.0-255,66,83995,96,342127
24249,0.001419,172.217.24.0-255,1484,85479,96,342127
24250,0.001445,172.217.24.0-255,2902,88381,96,342127
24251,0.001447,172.31.47.0-255,66,88447,96,342127
24252,0.001471,172.217.24.0-255,5738,94185,96,342127
24253,0.001474,172.31.47.0-255,66,94251,96,342127
24254,0.001484,172.217.24.0-255,6797,101048,96,342127
24255,0.001486,172.31.47.0-255,66,101114,96,342127
24256,0.00162,172.217.24.0-255,1484,102598,96,342127
24257,0.001626,172.217.24.0-255,2902,105500,96,342127
24258,0.00163,172.31.47.0-255,66,105566,96,342127
24259,0.001633,172.217.24.0-255,1484,107050,96,342127
24260,0.001648,172.217.24.0-255,4320,111370,96,342127
24261,0.00165,172.31.47.0-255,66,111436,96,342127
24262,0.001682,172.31.47.0-255,66,111502,96,342127
24263,0.001703,172.217.24.0-255,4320,115822,96,342127
24264,0.001706,172.31.47.0-255,66,115888,96,342127
24265,0.001712,172.217.24.0-255,7156,123044,96,342127
24266,0.001714,172.31.47.0-255,66,123110,96,342127
24267,0.001737,172.217.24.0-255,3602,126712,96,342127
24268,0.00174,172.31.47.0-255,66,126778,96,342127
24269,0.001786,172.217.24.0-255,1484,128262,96,342127
24270,0.001789,172.217.24.0-255,1484,129746,96,342127
24271,0.001792,172.31.47.0-255,66,129812,96,342127
24272,0.001809,172.217.24.0-255,1484,131296,96,342127
24273,0.001814,172.217.24.0-255,4320,135616,96,342127
24274,0.001816,172.31.47.0-255,66,135682,96,342127
24275,0.001834,172.217.24.0-255,1484,137166,96,342127
24276,0.001845,172.31.47.0-255,66,137232,96,342127
24277,0.00185,172.217.24.0-255,5738,142970,96,342127
24278,0.001853,172.31.47.0-255,66,143036,96,342127
24279,0.001869,172.217.24.0-255,6438,149474,96,342127
24280,0.001872,172.31.47.0-255,66,149540,96,342127
24281,0.001874,172.217.24.0-255,354,149894,96,342127
24282,0.002452,172.31.47.0-255,66,149960,96,342127
24283,0.003838,172.217.24.0-255,4320,154280,96,342127
24284,0.003843,172.31.47.0-255,66,154346,96,342127
24285,0.004419,172.217.24.0-255,1484,155830,96,342127
24286,0.005821,172.217.24.0-255,4320,160150,96,342127
24287,0.005824,172.31.47.0-255,66,160216,96,342127
24288,0.007808,172.217.24.0-255,5738,165954,96,342127
24289,0.007816,172.31.47.0-255,66,166020,96,342127
24290,0.009797,172.217.24.0-255,5738,171758,96,342127
24291,0.009806,172.31.47.0-255,66,171824,96,342127
24292,0.011795,172.217.24.0-255,5738,177562,96,342127
24293,0.011807,172.31.47.0-255,66,177628,96,342127
24294,0.013791,172.217.24.0-255,5738,183366,96,342127
24295,0.013801,172.31.47.0-255,66,183432,96,342127
24296,0.015795,172.217.24.0-255,5738,189170,96,342127
24297,0.015805,172.31.47.0-255,66,189236,96,342127
24298,0.017814,172.217.24.0-255,5738,194974,96,342127
24299,0.017823,172.31.47.0-255,66,195040,96,342127
24300,0.019802,172.217.24.0-255,5738,200778,96,342127
24301,0.01981,172.31.47.0-255,66,200844,96,342127
24302,0.021794,172.217.24.0-255,5738,206582,96,342127
24303,0.021806,172.31.47.0-255,66,206648,96,342127
24304,0.023797,172.217.24.0-255,5738,212386,96,342127
24305,0.023806,172.31.47.0-255,66,212452,96,342127
24306,0.024795,172.31.47.0-255,172,212624,96,342127
24307,0.024824,172.31.47.0-255,1101,213725,96,342127
24308,0.024864,172.31.47.0-255,1514,215239,96,342127
24309,0.024865,172.31.47.0-255,1310,216549,96,342127
24310,0.025793,172.217.24.0-255,4320,220869,96,342127
24311,0.0258,172.31.47.0-255,66,220935,96,342127
24312,0.025833,172.217.24.0-255,1484,222419,96,342127
24313,0.026335,104.244.42.0-255,66,222485,96,342127
24314,0.026368,104.244.42.0-255,66,222551,96,342127
24315,0.026416,104.244.42.0-255,66,222617,96,342127
24316,0.027771,172.217.24.0-255,4320,226937,96,342127
24317,0.027774,172.31.47.0-255,66,227003,96,342127
24318,0.029767,172.217.24.0-255,5738,232741,96,342127
24319,0.029773,172.31.47.0-255,66,232807,96,342127
24320,0.03178,172.217.24.0-255,5738,238545,96,342127
24321,0.031802,172.31.47.0-255,66,238611,96,342127
24322,0.033793,172.217.24.0-255,5738,244349,96,342127
24323,0.033809,172.31.47.0-255,66,244415,96,342127
24324,0.035798,172.217.24.0-255,5738,250153,96,342127
24325,0.035812,172.31.47.0-255,66,250219,96,342127
24326,0.038044,172.217.24.0-255,5738,255957,96,342127
24327,0.038059,172.31.47.0-255,66,256023,96,342127
24328,0.040071,172.217.24.0-255,5738,261761,96,342127
24329,0.040088,172.31.47.0-255,66,261827,96,342127
24330,0.042085,172.217.24.0-255,5738,267565,96,342127
24331,0.042105,172.31.47.0-255,66,267631,96,342127
24332,0.044119,172.217.24.0-255,5738,273369,96,342127
24333,0.044139,172.31.47.0-255,66,273435,96,342127
24334,0.046138,172.217.24.0-255,5738,279173,96,342127
24335,0.046153,172.31.47.0-255,66,279239,96,342127
24336,0.048164,172.217.24.0-255,5738,284977,96,342127
24337,0.048184,172.31.47.0-255,66,285043,96,342127
24338,0.050181,172.217.24.0-255,5738,290781,96,342127
24339,0.050201,172.31.47.0-255,66,290847,96,342127
24340,0.05221,172.217.24.0-255,5738,296585,96,342127
24341,0.05223,172.31.47.0-255,66,296651,96,342127
24342,0.054226,172.217.24.0-255,5738,302389,96,342127
24343,0.054245,172.31.47.0-255,66,302455,96,342127
24344,0.056252,172.217.24.0-255,5738,308193,96,342127
24345,0.056264,172.31.47.0-255,66,308259,96,342127
24346,0.058231,172.217.24.0-255,5738,313997,96,342127
24347,0.058237,172.31.47.0-255,66,314063,96,342127
24348,0.060207,172.217.24.0-255,4320,318383,96,342127
24349,0.060213,172.31.47.0-255,66,318449,96,342127
24350,0.06024,172.217.24.0-255,1484,319933,96,342127
24351,0.062191,172.217.24.0-255,4320,324253,96,342127
24352,0.062198,172.31.47.0-255,66,324319,96,342127
24353,0.064178,172.217.24.0-255,2902,327221,96,342127
24354,0.064184,172.31.47.0-255,66,327287,96,342127
24355,0.064216,172.217.24.0-255,2902,330189,96,342127
24356,0.06422,172.31.47.0-255,66,330255,96,342127
24357,0.066157,172.217.24.0-255,2902,333157,96,342127
24358,0.066162,172.31.47.0-255,66,333223,96,342127
24359,0.066195,172.217.24.0-255,2902,336125,96,342127
24360,0.066198,172.31.47.0-255,66,336191,96,342127
24361,0.068145,172.217.24.0-255,2902,339093,96,342127
24362,0.06815,172.31.47.0-255,66,339159,96,342127
24363,0.068177,172.217.24.0-255,2902,342061,96,342127
24364,0.06818,172.31.47.0-255,66,342127,96,342127
24365,0.0,172.217.26.0-255,146,146,96,253322
24366,1.4e-05,172.31.47.0-255,66,212,96,253322
24367,2e-05,172.217.26.0-255,1484,1696,96,253322
24368,2.4e-05,172.31.47.0-255,66,1762,96,253322
24369,3.6e-05,172.217.26.0-255,2902,4664,96,253322
24370,3.9e-05,172.31.47.0-255,66,4730,96,253322
24371,5.7e-05,172.217.26.0-255,4320,9050,96,253322
24372,6e-05,172.31.47.0-255,66,9116,96,253322
24373,8.9e-05,172.217.26.0-255,2902,12018,96,253322
24374,9.1e-05,172.31.47.0-255,66,12084,96,253322
24375,0.000155,172.217.26.0-255,2218,14302,96,253322
24376,0.000158,172.31.47.0-255,66,14368,96,253322
24377,0.000187,172.217.26.0-255,7156,21524,96,253322
24378,0.000189,172.31.47.0-255,66,21590,96,253322
24379,0.000208,172.217.26.0-255,4320,25910,96,253322
24380,0.00021,172.31.47.0-255,66,25976,96,253322
24381,0.000374,172.217.26.0-255,5379,31355,96,253322
24382,0.000379,172.31.47.0-255,66,31421,96,253322
24383,0.000441,172.217.26.0-255,5738,37159,96,253322
24384,0.000445,172.31.47.0-255,66,37225,96,253322
24385,0.000479,172.31.47.0-255,66,37291,96,253322
24386,0.000666,172.217.26.0-255,2902,40193,96,253322
24387,0.00067,172.31.47.0-255,66,40259,96,253322
24388,0.000709,172.31.47.0-255,66,40325,96,253322
24389,0.000718,172.217.26.0-255,1448,41773,96,253322
24390,0.000724,172.31.47.0-255,66,41839,96,253322
24391,0.000886,172.217.26.0-255,119,41958,96,253322
24392,0.00089,172.31.47.0-255,66,42024,96,253322
24393,0.00101,172.217.26.0-255,1484,43508,96,253322
24394,0.001014,172.31.47.0-255,66,43574,96,253322
24395,0.001021,172.217.26.0-255,2902,46476,96,253322
24396,0.001023,172.31.47.0-255,66,46542,96,253322
24397,0.001048,172.217.26.0-255,5738,52280,96,253322
24398,0.00105,172.31.47.0-255,66,52346,96,253322
24399,0.001139,172.31.47.0-255,66,52412,96,253322
24400,0.001258,172.217.26.0-255,4320,56732,96,253322
24401,0.001261,172.31.47.0-255,66,56798,96,253322
24402,0.001288,172.217.26.0-255,5738,62536,96,253322
24403,0.00129,172.31.47.0-255,66,62602,96,253322
24404,0.001404,172.217.26.0-255,3961,66563,96,253322
24405,0.001408,172.31.47.0-255,66,66629,96,253322
24406,0.001451,172.217.26.0-255,4320,70949,96,253322
24407,0.001453,172.31.47.0-255,66,71015,96,253322
24408,0.00152,172.217.26.0-255,4320,75335,96,253322
24409,0.001523,172.31.47.0-255,66,75401,96,253322
24410,0.00154,172.217.26.0-255,5738,81139,96,253322
24411,0.001542,172.31.47.0-255,66,81205,96,253322
24412,0.001671,172.217.26.0-255,4320,85525,96,253322
24413,0.001675,172.31.47.0-255,66,85591,96,253322
24414,0.001692,172.217.26.0-255,4320,89911,96,253322
24415,0.001936,172.217.26.0-255,1484,91395,96,253322
24416,0.002117,172.217.26.0-255,2902,94297,96,253322
24417,0.002416,172.217.26.0-255,2902,97199,96,253322
24418,0.010829,172.217.26.0-255,1484,98683,96,253322
24419,0.014529,172.31.47.0-255,66,98749,96,253322
24420,0.016504,172.217.26.0-255,5738,104487,96,253322
24421,0.016518,172.31.47.0-255,66,104553,96,253322
24422,0.018574,172.217.26.0-255,5738,110291,96,253322
24423,0.018582,172.31.47.0-255,66,110357,96,253322
24424,0.020581,172.217.26.0-255,5738,116095,96,253322
24425,0.02263,172.31.47.0-255,66,116161,96,253322
24426,0.023527,172.31.47.0-255,172,116333,96,253322
24427,0.023555,172.31.47.0-255,1105,117438,96,253322
24428,0.0236,172.31.47.0-255,1514,118952,96,253322
24429,0.023601,172.31.47.0-255,1306,120258,96,253322
24430,0.024573,172.217.26.0-255,5738,125996,96,253322
24431,0.024578,172.31.47.0-255,66,126062,96,253322
24432,0.025047,104.244.42.0-255,66,126128,96,253322
24433,0.025113,104.244.42.0-255,66,126194,96,253322
24434,0.025164,104.244.42.0-255,66,126260,96,253322
24435,0.026522,172.217.26.0-255,4320,130580,96,253322
24436,0.026529,172.31.47.0-255,66,130646,96,253322
24437,0.026557,172.217.26.0-255,1484,132130,96,253322
24438,0.028481,172.217.26.0-255,4320,136450,96,253322
24439,0.028488,172.31.47.0-255,66,136516,96,253322
24440,0.03045,172.217.26.0-255,5738,142254,96,253322
24441,0.03048,172.31.47.0-255,66,142320,96,253322
24442,0.032428,172.217.26.0-255,5738,148058,96,253322
24443,0.032434,172.31.47.0-255,66,148124,96,253322
24444,0.034391,172.217.26.0-255,5738,153862,96,253322
24445,0.034396,172.31.47.0-255,66,153928,96,253322
24446,0.036355,172.217.26.0-255,5738,159666,96,253322
24447,0.036359,172.31.47.0-255,66,159732,96,253322
24448,0.038308,172.217.26.0-255,5738,165470,96,253322
24449,0.038312,172.31.47.0-255,66,165536,96,253322
24450,0.040256,172.217.26.0-255,5738,171274,96,253322
24451,0.040262,172.31.47.0-255,66,171340,96,253322
24452,0.042211,172.217.26.0-255,5738,177078,96,253322
24453,0.042215,172.31.47.0-255,66,177144,96,253322
24454,0.044157,172.217.26.0-255,5738,182882,96,253322
24455,0.044162,172.31.47.0-255,66,182948,96,253322
24456,0.046148,172.217.26.0-255,5738,188686,96,253322
24457,0.046153,172.31.47.0-255,66,188752,96,253322
24458,0.048109,172.217.26.0-255,5738,194490,96,253322
24459,0.048115,172.31.47.0-255,66,194556,96,253322
24460,0.050066,172.217.26.0-255,5738,200294,96,253322
24461,0.050072,172.31.47.0-255,66,200360,96,253322
24462,0.052011,172.217.26.0-255,5738,206098,96,253322
24463,0.052016,172.31.47.0-255,66,206164,96,253322
24464,0.053962,172.217.26.0-255,5738,211902,96,253322
24465,0.053966,172.31.47.0-255,66,211968,96,253322
24466,0.055912,172.217.26.0-255,5738,217706,96,253322
24467,0.055917,172.31.47.0-255,66,217772,96,253322
24468,0.057861,172.217.26.0-255,5738,223510,96,253322
24469,0.057866,172.31.47.0-255,66,223576,96,253322
24470,0.059816,172.217.26.0-255,5738,229314,96,253322
24471,0.059822,172.31.47.0-255,66,229380,96,253322
24472,0.061773,172.217.26.0-255,4320,233700,96,253322
24473,0.061778,172.31.47.0-255,66,233766,96,253322
24474,0.061804,172.217.26.0-255,1484,235250,96,253322
24475,0.063724,172.217.26.0-255,4320,239570,96,253322
24476,0.06373,172.31.47.0-255,66,239636,96,253322
24477,0.065713,172.217.26.0-255,5738,245374,96,253322
24478,0.065718,172.31.47.0-255,66,245440,96,253322
24479,0.067662,172.217.26.0-255,5738,251178,96,253322
24480,0.067667,172.31.47.0-255,66,251244,96,253322
24481,0.069613,172.217.26.0-255,1907,253151,96,253322
24482,0.069618,172.31.47.0-255,66,253217,96,253322
24483,0.069786,172.31.47.0-255,105,253322,96,253322
24484,0.0,172.217.194.0-255,153,153,96,193381
24485,2.4e-05,172.31.47.0-255,66,219,96,193381
24486,3e-05,172.217.194.0-255,1484,1703,96,193381
24487,3.4e-05,172.31.47.0-255,66,1769,96,193381
24488,3.9e-05,172.217.194.0-255,2902,4671,96,193381
24489,4.1e-05,172.31.47.0-255,66,4737,96,193381
24490,4.9e-05,172.217.194.0-255,1484,6221,96,193381
24491,5.2e-05,172.31.47.0-255,66,6287,96,193381
24492,7.7e-05,172.217.194.0-255,2902,9189,96,193381
24493,8.4e-05,172.31.47.0-255,66,9255,96,193381
24494,0.00012,172.217.194.0-255,4320,13575,96,193381
24495,0.000124,172.31.47.0-255,66,13641,96,193381
24496,0.000154,172.217.194.0-255,2083,15724,96,193381
24497,0.000157,172.31.47.0-255,66,15790,96,193381
24498,0.000163,172.217.194.0-255,7156,22946,96,193381
24499,0.000165,172.31.47.0-255,66,23012,96,193381
24500,0.000179,172.31.47.0-255,66,23078,96,193381
24501,0.000221,172.217.194.0-255,7156,30234,96,193381
24502,0.000225,172.31.47.0-255,66,30300,96,193381
24503,0.000234,172.31.47.0-255,66,30366,96,193381
24504,0.000261,172.217.194.0-255,2902,33268,96,193381
24505,0.000266,172.31.47.0-255,66,33334,96,193381
24506,0.000278,172.217.194.0-255,5738,39072,96,193381
24507,0.000285,172.31.47.0-255,66,39138,96,193381
24508,0.000307,172.217.194.0-255,7156,46294,96,193381
24509,0.000311,172.31.47.0-255,66,46360,96,193381
24510,0.000314,172.217.194.0-255,2825,49185,96,193381
24511,0.000316,172.31.47.0-255,66,49251,96,193381
24512,0.000392,172.217.194.0-255,1484,50735,96,193381
24513,0.000395,172.31.47.0-255,66,50801,96,193381
24514,0.000421,172.217.194.0-255,2902,53703,96,193381
24515,0.000424,172.31.47.0-255,66,53769,96,193381
24516,0.00043,172.217.194.0-255,5738,59507,96,193381
24517,0.000432,172.31.47.0-255,66,59573,96,193381
24518,0.000462,172.217.194.0-255,2902,62475,96,193381
24519,0.000465,172.31.47.0-255,66,62541,96,193381
24520,0.000489,172.217.194.0-255,3961,66502,96,193381
24521,0.000492,172.31.47.0-255,66,66568,96,193381
24522,0.000499,172.217.194.0-255,7156,73724,96,193381
24523,0.000501,172.31.47.0-255,66,73790,96,193381
24524,0.000537,172.31.47.0-255,66,73856,96,193381
24525,0.000864,172.217.194.0-255,1484,75340,96,193381
24526,0.00088,172.217.194.0-255,2902,78242,96,193381
24527,0.000883,172.31.47.0-255,66,78308,96,193381
24528,0.000889,172.217.194.0-255,5738,84046,96,193381
24529,0.000891,172.31.47.0-255,66,84112,96,193381
24530,0.00092,172.217.194.0-255,1484,85596,96,193381
24531,0.000952,172.31.47.0-255,66,85662,96,193381
24532,0.000969,172.31.47.0-255,66,85728,96,193381
24533,0.001505,172.217.194.0-255,1484,87212,96,193381
24534,0.001531,172.217.194.0-255,2902,90114,96,193381
24535,0.001536,172.31.47.0-255,66,90180,96,193381
24536,0.001543,172.217.194.0-255,5738,95918,96,193381
24537,0.001545,172.31.47.0-255,66,95984,96,193381
24538,0.001549,172.217.194.0-255,2902,98886,96,193381
24539,0.001556,172.31.47.0-255,66,98952,96,193381
24540,0.001589,172.217.194.0-255,5738,104690,96,193381
24541,0.001594,172.31.47.0-255,66,104756,96,193381
24542,0.001611,172.31.47.0-255,66,104822,96,193381
24543,0.001618,172.217.194.0-255,5020,109842,96,193381
24544,0.001621,172.31.47.0-255,66,109908,96,193381
24545,0.001627,172.217.194.0-255,5738,115646,96,193381
24546,0.001629,172.31.47.0-255,66,115712,96,193381
24547,0.001674,172.31.47.0-255,66,115778,96,193381
24548,0.001697,172.31.47.0-255,66,115844,96,193381
24549,0.001699,172.217.194.0-255,766,116610,96,193381
24550,0.001703,172.217.194.0-255,1484,118094,96,193381
24551,0.001704,172.31.47.0-255,66,118160,96,193381
24552,0.00171,172.217.194.0-255,4320,122480,96,193381
24553,0.001712,172.31.47.0-255,66,122546,96,193381
24554,0.001793,172.31.47.0-255,66,122612,96,193381
24555,0.001811,172.31.47.0-255,66,122678,96,193381
24556,0.001816,172.217.194.0-255,5020,127698,96,193381
24557,0.001818,172.31.47.0-255,66,127764,96,193381
24558,0.001912,172.217.194.0-255,1484,129248,96,193381
24559,0.001929,172.217.194.0-255,2902,132150,96,193381
24560,0.001931,172.31.47.0-255,66,132216,96,193381
24561,0.001935,172.217.194.0-255,1484,133700,96,193381
24562,0.001959,172.217.194.0-255,4320,138020,96,193381
24563,0.001962,172.31.47.0-255,66,138086,96,193381
24564,0.001969,172.217.194.0-255,7156,145242,96,193381
24565,0.001971,172.31.47.0-255,66,145308,96,193381
24566,0.002003,172.217.194.0-255,5738,151046,96,193381
24567,0.002006,172.31.47.0-255,66,151112,96,193381
24568,0.002022,172.31.47.0-255,66,151178,96,193381
24569,0.002085,172.217.194.0-255,1484,152662,96,193381
24570,0.002097,172.217.194.0-255,1484,154146,96,193381
24571,0.002099,172.31.47.0-255,66,154212,96,193381
24572,0.002124,172.217.194.0-255,1484,155696,96,193381
24573,0.00213,172.217.194.0-255,5738,161434,96,193381
24574,0.002132,172.31.47.0-255,66,161500,96,193381
24575,0.002144,172.31.47.0-255,66,161566,96,193381
24576,0.002168,172.217.194.0-255,1484,163050,96,193381
24577,0.002181,172.31.47.0-255,66,163116,96,193381
24578,0.002202,172.217.194.0-255,1484,164600,96,193381
24579,0.002213,172.217.194.0-255,2902,167502,96,193381
24580,0.002215,172.31.47.0-255,66,167568,96,193381
24581,0.002219,172.217.194.0-255,2902,170470,96,193381
24582,0.002221,172.31.47.0-255,66,170536,96,193381
24583,0.002251,172.217.194.0-255,2902,173438,96,193381
24584,0.002253,172.31.47.0-255,66,173504,96,193381
24585,0.002265,172.31.47.0-255,66,173570,96,193381
24586,0.002281,172.31.47.0-255,66,173636,96,193381
24587,0.002305,172.217.194.0-255,1484,175120,96,193381
24588,0.00232,172.217.194.0-255,2902,178022,96,193381
24589,0.002322,172.31.47.0-255,66,178088,96,193381
24590,0.002328,172.217.194.0-255,5738,183826,96,193381
24591,0.002331,172.31.47.0-255,66,183892,96,193381
24592,0.002361,172.31.47.0-255,66,183958,96,193381
24593,0.002385,172.217.194.0-255,1484,185442,96,193381
24594,0.002396,172.31.47.0-255,66,185508,96,193381
24595,0.00243,172.31.47.0-255,66,185574,96,193381
24596,0.002461,172.31.47.0-255,66,185640,96,193381
24597,0.00248,172.31.47.0-255,66,185706,96,193381
24598,0.002493,172.31.47.0-255,66,185772,96,193381
24599,0.002495,172.217.194.0-255,97,185869,96,193381
24600,0.002553,172.217.194.0-255,105,185974,96,193381
24601,0.006736,172.31.47.0-255,66,186040,96,193381
24602,0.00676,172.31.47.0-255,105,186145,96,193381
24603,0.009244,172.217.194.0-255,66,186211,96,193381
24604,0.027787,172.31.47.0-255,172,186383,96,193381
24605,0.027812,172.31.47.0-255,1110,187493,96,193381
24606,0.027852,172.31.47.0-255,1514,189007,96,193381
24607,0.027854,172.31.47.0-255,1514,190521,96,193381
24608,0.027855,172.31.47.0-255,1514,192035,96,193381
24609,0.027856,172.31.47.0-255,1082,193117,96,193381
24610,0.02932,104.244.42.0-255,66,193183,96,193381
24611,0.029366,104.244.42.0-255,66,193249,96,193381
24612,0.02942,104.244.42.0-255,66,193315,96,193381
24613,0.029421,104.244.42.0-255,66,193381,96,193381
24614,0.0,172.217.194.0-255,153,153,96,285663
24615,3e-05,172.31.47.0-255,66,219,96,285663
24616,5.2e-05,172.217.194.0-255,1484,1703,96,285663
24617,5.6e-05,172.31.47.0-255,66,1769,96,285663
24618,6e-05,172.217.194.0-255,2902,4671,96,285663
24619,6.2e-05,172.31.47.0-255,66,4737,96,285663
24620,6.9e-05,172.217.194.0-255,7156,11893,96,285663
24621,7.1e-05,172.31.47.0-255,66,11959,96,285663
24622,7.3e-05,172.217.194.0-255,1484,13443,96,285663
24623,7.7e-05,172.31.47.0-255,66,13509,96,285663
24624,9.5e-05,172.217.194.0-255,595,14104,96,285663
24625,9.7e-05,172.31.47.0-255,66,14170,96,285663
24626,0.000508,172.217.194.0-255,1484,15654,96,285663
24627,0.000513,172.31.47.0-255,66,15720,96,285663
24628,0.00052,172.217.194.0-255,2902,18622,96,285663
24629,0.000523,172.31.47.0-255,66,18688,96,285663
24630,0.000527,172.217.194.0-255,2902,21590,96,285663
24631,0.000529,172.31.47.0-255,66,21656,96,285663
24632,0.000542,172.217.194.0-255,2902,24558,96,285663
24633,0.000545,172.31.47.0-255,66,24624,96,285663
24634,0.000565,172.217.194.0-255,4320,28944,96,285663
24635,0.000568,172.31.47.0-255,66,29010,96,285663
24636,0.000579,172.217.194.0-255,2543,31553,96,285663
24637,0.000583,172.31.47.0-255,66,31619,96,285663
24638,0.000748,172.217.194.0-255,1484,33103,96,285663
24639,0.000753,172.31.47.0-255,66,33169,96,285663
24640,0.000759,172.217.194.0-255,2902,36071,96,285663
24641,0.000761,172.31.47.0-255,66,36137,96,285663
24642,0.000783,172.217.194.0-255,2902,39039,96,285663
24643,0.000786,172.31.47.0-255,66,39105,96,285663
24644,0.000803,172.217.194.0-255,2902,42007,96,285663
24645,0.000805,172.31.47.0-255,66,42073,96,285663
24646,0.000838,172.31.47.0-255,66,42139,96,285663
24647,0.000847,172.31.47.0-255,66,42205,96,285663
24648,0.000849,172.217.194.0-255,365,42570,96,285663
24649,0.000852,172.217.194.0-255,380,42950,96,285663
24650,0.001428,172.217.194.0-255,1484,44434,96,285663
24651,0.001432,172.31.47.0-255,66,44500,96,285663
24652,0.001437,172.217.194.0-255,2902,47402,96,285663
24653,0.00144,172.31.47.0-255,66,47468,96,285663
24654,0.001442,172.217.194.0-255,1484,48952,96,285663
24655,0.001455,172.217.194.0-255,4320,53272,96,285663
24656,0.001457,172.31.47.0-255,66,53338,96,285663
24657,0.001463,172.217.194.0-255,5738,59076,96,285663
24658,0.001465,172.31.47.0-255,66,59142,96,285663
24659,0.001491,172.217.194.0-255,7156,66298,96,285663
24660,0.001493,172.31.47.0-255,66,66364,96,285663
24661,0.001516,172.217.194.0-255,2902,69266,96,285663
24662,0.001518,172.31.47.0-255,66,69332,96,285663
24663,0.00154,172.31.47.0-255,66,69398,96,285663
24664,0.002039,172.217.194.0-255,1484,70882,96,285663
24665,0.002042,172.217.194.0-255,1484,72366,96,285663
24666,0.002045,172.31.47.0-255,66,72432,96,285663
24667,0.002064,172.217.194.0-255,1484,73916,96,285663
24668,0.002069,172.217.194.0-255,5738,79654,96,285663
24669,0.002071,172.31.47.0-255,66,79720,96,285663
24670,0.002076,172.217.194.0-255,4320,84040,96,285663
24671,0.002078,172.31.47.0-255,66,84106,96,285663
24672,0.002088,172.217.194.0-255,1484,85590,96,285663
24673,0.002101,172.217.194.0-255,4320,89910,96,285663
24674,0.002103,172.31.47.0-255,66,89976,96,285663
24675,0.002123,172.31.47.0-255,66,90042,96,285663
24676,0.002126,172.217.194.0-255,2902,92944,96,285663
24677,0.002128,172.31.47.0-255,66,93010,96,285663
24678,0.002149,172.217.194.0-255,2184,95194,96,285663
24679,0.002151,172.31.47.0-255,66,95260,96,285663
24680,0.002153,172.217.194.0-255,1484,96744,96,285663
24681,0.002169,172.217.194.0-255,4320,101064,96,285663
24682,0.002171,172.31.47.0-255,66,101130,96,285663
24683,0.002174,172.217.194.0-255,1484,102614,96,285663
24684,0.002194,172.31.47.0-255,66,102680,96,285663
24685,0.002223,172.31.47.0-255,66,102746,96,285663
24686,0.002241,172.217.194.0-255,4320,107066,96,285663
24687,0.002242,172.31.47.0-255,66,107132,96,285663
24688,0.002244,172.217.194.0-255,766,107898,96,285663
24689,0.002314,172.217.194.0-255,1484,109382,96,285663
24690,0.002316,172.31.47.0-255,66,109448,96,285663
24691,0.002332,172.217.194.0-255,2902,112350,96,285663
24692,0.002333,172.31.47.0-255,66,112416,96,285663
24693,0.002338,172.217.194.0-255,4320,116736,96,285663
24694,0.00234,172.31.47.0-255,66,116802,96,285663
24695,0.002359,172.217.194.0-255,1484,118286,96,285663
24696,0.00238,172.31.47.0-255,66,118352,96,285663
24697,0.002408,172.31.47.0-255,66,118418,96,285663
24698,0.002516,172.217.194.0-255,1484,119902,96,285663
24699,0.002526,172.217.194.0-255,2902,122804,96,285663
24700,0.002529,172.31.47.0-255,66,122870,96,285663
24701,0.002547,172.217.194.0-255,5738,128608,96,285663
24702,0.002549,172.31.47.0-255,66,128674,96,285663
24703,0.002552,172.217.194.0-255,1484,130158,96,285663
24704,0.002588,172.31.47.0-255,66,130224,96,285663
24705,0.002602,172.31.47.0-255,66,130290,96,285663
24706,0.005165,172.217.194.0-255,5738,136028,96,285663
24707,0.005172,172.31.47.0-255,66,136094,96,285663
24708,0.007711,172.217.194.0-255,5738,141832,96,285663
24709,0.00772,172.31.47.0-255,66,141898,96,285663
24710,0.010308,172.217.194.0-255,5738,147636,96,285663
24711,0.010316,172.31.47.0-255,66,147702,96,285663
24712,0.012846,172.217.194.0-255,5738,153440,96,285663
24713,0.012852,172.31.47.0-255,66,153506,96,285663
24714,0.015382,172.217.194.0-255,5738,159244,96,285663
24715,0.015391,172.31.47.0-255,66,159310,96,285663
24716,0.017951,172.217.194.0-255,5738,165048,96,285663
24717,0.017958,172.31.47.0-255,66,165114,96,285663
24718,0.020493,172.217.194.0-255,5738,170852,96,285663
24719,0.020502,172.31.47.0-255,66,170918,96,285663
24720,0.021537,172.31.47.0-255,172,171090,96,285663
24721,0.021567,172.31.47.0-255,1110,172200,96,285663
24722,0.02161,172.31.47.0-255,1514,173714,96,285663
24723,0.021612,172.31.47.0-255,1301,175015,96,285663
24724,0.023029,172.217.194.0-255,5738,180753,96,285663
24725,0.023035,172.31.47.0-255,66,180819,96,285663
24726,0.023072,104.244.42.0-255,66,180885,96,285663
24727,0.023079,104.244.42.0-255,66,180951,96,285663
24728,0.02316,104.244.42.0-255,66,181017,96,285663
24729,0.025332,104.244.42.0-255,108,181125,96,285663
24730,0.025338,172.31.47.0-255,66,181191,96,285663
24731,0.025574,172.217.194.0-255,5738,186929,96,285663
24732,0.025579,172.31.47.0-255,66,186995,96,285663
24733,0.028122,172.217.194.0-255,5738,192733,96,285663
24734,0.028128,172.31.47.0-255,66,192799,96,285663
24735,0.030697,172.217.194.0-255,5738,198537,96,285663
24736,0.030704,172.31.47.0-255,66,198603,96,285663
24737,0.033305,172.217.194.0-255,5738,204341,96,285663
24738,0.033311,172.31.47.0-255,66,204407,96,285663
24739,0.035861,172.217.194.0-255,5738,210145,96,285663
24740,0.035867,172.31.47.0-255,66,210211,96,285663
24741,0.038431,172.217.194.0-255,5738,215949,96,285663
24742,0.038437,172.31.47.0-255,66,216015,96,285663
24743,0.040977,172.217.194.0-255,5738,221753,96,285663
24744,0.040986,172.31.47.0-255,66,221819,96,285663
24745,0.043545,172.217.194.0-255,5738,227557,96,285663
24746,0.043552,172.31.47.0-255,66,227623,96,285663
24747,0.046122,172.217.194.0-255,5738,233361,96,285663
24748,0.046129,172.31.47.0-255,66,233427,96,285663
24749,0.048698,172.217.194.0-255,5738,239165,96,285663
24750,0.048703,172.31.47.0-255,66,239231,96,285663
24751,0.051248,172.217.194.0-255,5738,244969,96,285663
24752,0.051254,172.31.47.0-255,66,245035,96,285663
24753,0.053812,172.217.194.0-255,5738,250773,96,285663
24754,0.053817,172.31.47.0-255,66,250839,96,285663
24755,0.056361,172.217.194.0-255,5738,256577,96,285663
24756,0.056366,172.31.47.0-255,66,256643,96,285663
24757,0.058923,172.217.194.0-255,5738,262381,96,285663
24758,0.058929,172.31.47.0-255,66,262447,96,285663
24759,0.06149,172.217.194.0-255,5738,268185,96,285663
24760,0.061495,172.31.47.0-255,66,268251,96,285663
24761,0.064044,172.217.194.0-255,5738,273989,96,285663
24762,0.064049,172.31.47.0-255,66,274055,96,285663
24763,0.066621,172.217.194.0-255,5738,279793,96,285663
24764,0.066628,172.31.47.0-255,66,279859,96,285663
24765,0.069209,172.217.194.0-255,5738,285597,96,285663
24766,0.069216,172.31.47.0-255,66,285663,96,285663
24767,0.0,74.125.24.0-255,152,152,96,277913
24768,2.7e-05,172.31.47.0-255,66,218,96,277913
24769,3.5e-05,74.125.24.0-255,1484,1702,96,277913
24770,4.1e-05,172.31.47.0-255,66,1768,96,277913
24771,4.7e-05,74.125.24.0-255,2902,4670,96,277913
24772,5e-05,172.31.47.0-255,66,4736,96,277913
24773,5.9e-05,74.125.24.0-255,7156,11892,96,277913
24774,6.2e-05,172.31.47.0-255,66,11958,96,277913
24775,6.7e-05,74.125.24.0-255,2165,14123,96,277913
24776,7e-05,172.31.47.0-255,66,14189,96,277913
24777,8.3e-05,172.31.47.0-255,66,14255,96,277913
24778,0.000108,74.125.24.0-255,2902,17157,96,277913
24779,0.000111,172.31.47.0-255,66,17223,96,277913
24780,0.000118,74.125.24.0-255,5379,22602,96,277913
24781,0.000122,172.31.47.0-255,66,22668,96,277913
24782,0.000162,74.125.24.0-255,1484,24152,96,277913
24783,0.000164,172.31.47.0-255,66,24218,96,277913
24784,0.00017,74.125.24.0-255,2902,27120,96,277913
24785,0.000172,172.31.47.0-255,66,27186,96,277913
24786,0.000175,74.125.24.0-255,1484,28670,96,277913
24787,0.000177,172.31.47.0-255,66,28736,96,277913
24788,0.000196,74.125.24.0-255,4320,33056,96,277913
24789,0.000199,172.31.47.0-255,66,33122,96,277913
24790,0.000213,74.125.24.0-255,1484,34606,96,277913
24791,0.000215,172.31.47.0-255,66,34672,96,277913
24792,0.000255,172.31.47.0-255,66,34738,96,277913
24793,0.000258,74.125.24.0-255,1484,36222,96,277913
24794,0.00026,172.31.47.0-255,66,36288,96,277913
24795,0.000288,172.31.47.0-255,66,36354,96,277913
24796,0.00106,74.125.24.0-255,131,36485,96,277913
24797,0.001092,172.31.47.0-255,66,36551,96,277913
24798,0.001218,74.125.24.0-255,1484,38035,96,277913
24799,0.001227,74.125.24.0-255,2902,40937,96,277913
24800,0.00123,172.31.47.0-255,66,41003,96,277913
24801,0.001248,74.125.24.0-255,1484,42487,96,277913
24802,0.00127,74.125.24.0-255,4320,46807,96,277913
24803,0.001272,172.31.47.0-255,66,46873,96,277913
24804,0.001298,74.125.24.0-255,7156,54029,96,277913
24805,0.0013,172.31.47.0-255,66,54095,96,277913
24806,0.001321,74.125.24.0-255,4320,58415,96,277913
24807,0.001323,172.31.47.0-255,66,58481,96,277913
24808,0.001334,74.125.24.0-255,1484,59965,96,277913
24809,0.001354,74.125.24.0-255,5738,65703,96,277913
24810,0.001356,172.31.47.0-255,66,65769,96,277913
24811,0.001376,74.125.24.0-255,5020,70789,96,277913
24812,0.001378,172.31.47.0-255,66,70855,96,277913
24813,0.002069,74.125.24.0-255,1484,72339,96,277913
24814,0.002075,74.125.24.0-255,2902,75241,96,277913
24815,0.002078,172.31.47.0-255,66,75307,96,277913
24816,0.002083,74.125.24.0-255,2902,78209,96,277913
24817,0.002085,172.31.47.0-255,66,78275,96,277913
24818,0.002099,74.125.24.0-255,2902,81177,96,277913
24819,0.002101,172.31.47.0-255,66,81243,96,277913
24820,0.00213,172.31.47.0-255,66,81309,96,277913
24821,0.002145,74.125.24.0-255,4320,85629,96,277913
24822,0.002147,172.31.47.0-255,66,85695,96,277913
24823,0.002183,172.31.47.0-255,66,85761,96,277913
24824,0.002219,74.125.24.0-255,1484,87245,96,277913
24825,0.002233,74.125.24.0-255,2902,90147,96,277913
24826,0.002235,172.31.47.0-255,66,90213,96,277913
24827,0.002252,74.125.24.0-255,5738,95951,96,277913
24828,0.002254,172.31.47.0-255,66,96017,96,277913
24829,0.002275,74.125.24.0-255,5738,101755,96,277913
24830,0.002278,172.31.47.0-255,66,101821,96,277913
24831,0.002302,74.125.24.0-255,7156,108977,96,277913
24832,0.002304,172.31.47.0-255,66,109043,96,277913
24833,0.002316,172.31.47.0-255,66,109109,96,277913
24834,0.002355,172.31.47.0-255,66,109175,96,277913
24835,0.002381,172.31.47.0-255,66,109241,96,277913
24836,0.002408,172.31.47.0-255,66,109307,96,277913
24837,0.004744,74.125.24.0-255,5738,115045,96,277913
24838,0.004765,172.31.47.0-255,66,115111,96,277913
24839,0.007141,74.125.24.0-255,5738,120849,96,277913
24840,0.007153,172.31.47.0-255,66,120915,96,277913
24841,0.009044,172.31.47.0-255,105,121020,96,277913
24842,0.009505,74.125.24.0-255,5738,126758,96,277913
24843,0.009513,172.31.47.0-255,66,126824,96,277913
24844,0.011111,157.240.13.0-255,105,126929,96,277913
24845,0.011126,172.31.47.0-255,66,126995,96,277913
24846,0.011826,74.125.24.0-255,5738,132733,96,277913
24847,0.011833,172.31.47.0-255,66,132799,96,277913
24848,0.014198,74.125.24.0-255,5738,138537,96,277913
24849,0.014212,172.31.47.0-255,66,138603,96,277913
24850,0.016571,74.125.24.0-255,5738,144341,96,277913
24851,0.01658,172.31.47.0-255,66,144407,96,277913
24852,0.018929,74.125.24.0-255,5738,150145,96,277913
24853,0.018947,172.31.47.0-255,66,150211,96,277913
24854,0.021256,74.125.24.0-255,5738,155949,96,277913
24855,0.021266,172.31.47.0-255,66,156015,96,277913
24856,0.023604,74.125.24.0-255,5738,161753,96,277913
24857,0.023612,172.31.47.0-255,66,161819,96,277913
24858,0.025948,74.125.24.0-255,5738,167557,96,277913
24859,0.025959,172.31.47.0-255,66,167623,96,277913
24860,0.028322,74.125.24.0-255,5738,173361,96,277913
24861,0.028332,172.31.47.0-255,66,173427,96,277913
24862,0.030647,74.125.24.0-255,5738,179165,96,277913
24863,0.030656,172.31.47.0-255,66,179231,96,277913
24864,0.030872,172.31.47.0-255,172,179403,96,277913
24865,0.030902,172.31.47.0-255,1109,180512,96,277913
24866,0.031038,172.31.47.0-255,1514,182026,96,277913
24867,0.03104,172.31.47.0-255,1514,183540,96,277913
24868,0.031044,172.31.47.0-255,1514,185054,96,277913
24869,0.031045,172.31.47.0-255,1083,186137,96,277913
24870,0.032447,104.244.42.0-255,66,186203,96,277913
24871,0.032455,104.244.42.0-255,66,186269,96,277913
24872,0.03259,104.244.42.0-255,66,186335,96,277913
24873,0.032594,104.244.42.0-255,66,186401,96,277913
24874,0.032968,74.125.24.0-255,5738,192139,96,277913
24875,0.032973,172.31.47.0-255,66,192205,96,277913
24876,0.035296,74.125.24.0-255,5738,197943,96,277913
24877,0.035302,172.31.47.0-255,66,198009,96,277913
24878,0.037633,74.125.24.0-255,5738,203747,96,277913
24879,0.037652,172.31.47.0-255,66,203813,96,277913
24880,0.040015,74.125.24.0-255,5738,209551,96,277913
24881,0.040025,172.31.47.0-255,66,209617,96,277913
24882,0.042376,74.125.24.0-255,5738,215355,96,277913
24883,0.042383,172.31.47.0-255,66,215421,96,277913
24884,0.044732,74.125.24.0-255,5738,221159,96,277913
24885,0.044739,172.31.47.0-255,66,221225,96,277913
24886,0.047069,74.125.24.0-255,4320,225545,96,277913
24887,0.047077,172.31.47.0-255,66,225611,96,277913
24888,0.047096,74.125.24.0-255,1484,227095,96,277913
24889,0.04941,74.125.24.0-255,4320,231415,96,277913
24890,0.049416,172.31.47.0-255,66,231481,96,277913
24891,0.051755,74.125.24.0-255,5738,237219,96,277913
24892,0.051762,172.31.47.0-255,66,237285,96,277913
24893,0.054109,74.125.24.0-255,5738,243023,96,277913
24894,0.054123,172.31.47.0-255,66,243089,96,277913
24895,0.05646,74.125.24.0-255,5738,248827,96,277913
24896,0.056468,172.31.47.0-255,66,248893,96,277913
24897,0.058793,74.125.24.0-255,5738,254631,96,277913
24898,0.058801,172.31.47.0-255,66,254697,96,277913
24899,0.061148,74.125.24.0-255,5738,260435,96,277913
24900,0.061154,172.31.47.0-255,66,260501,96,277913
24901,0.063495,74.125.24.0-255,5738,266239,96,277913
24902,0.063501,172.31.47.0-255,66,266305,96,277913
24903,0.065858,74.125.24.0-255,5738,272043,96,277913
24904,0.065867,172.31.47.0-255,66,272109,96,277913
24905,0.068229,74.125.24.0-255,5738,277847,96,277913
24906,0.068245,172.31.47.0-255,66,277913,96,277913
24907,0.0,172.253.118.0-255,298,298,96,313349
24908,2.2e-05,172.31.47.0-255,66,364,96,313349
24909,2.9e-05,172.253.118.0-255,1484,1848,96,313349
24910,3.3e-05,172.31.47.0-255,66,1914,96,313349
24911,3.9e-05,172.253.118.0-255,4320,6234,96,313349
24912,4.2e-05,172.31.47.0-255,66,6300,96,313349
24913,4.8e-05,172.253.118.0-255,5738,12038,96,313349
24914,5e-05,172.31.47.0-255,66,12104,96,313349
24915,9.4e-05,172.253.118.0-255,1814,13918,96,313349
24916,9.6e-05,172.31.47.0-255,66,13984,96,313349
24917,0.000174,172.253.118.0-255,1484,15468,96,313349
24918,0.000177,172.31.47.0-255,66,15534,96,313349
24919,0.000182,172.253.118.0-255,2902,18436,96,313349
24920,0.000184,172.31.47.0-255,66,18502,96,313349
24921,0.000195,172.253.118.0-255,1484,19986,96,313349
24922,0.000197,172.31.47.0-255,66,20052,96,313349
24923,0.00021,172.253.118.0-255,4320,24372,96,313349
24924,0.000212,172.31.47.0-255,66,24438,96,313349
24925,0.000238,172.253.118.0-255,6797,31235,96,313349
24926,0.000241,172.31.47.0-255,66,31301,96,313349
24927,0.000453,172.253.118.0-255,1484,32785,96,313349
24928,0.000457,172.31.47.0-255,66,32851,96,313349
24929,0.000463,172.253.118.0-255,2902,35753,96,313349
24930,0.000465,172.31.47.0-255,66,35819,96,313349
24931,0.000472,172.253.118.0-255,5738,41557,96,313349
24932,0.000474,172.31.47.0-255,66,41623,96,313349
24933,0.000476,172.253.118.0-255,1484,43107,96,313349
24934,0.000478,172.31.47.0-255,66,43173,96,313349
24935,0.000504,172.253.118.0-255,2902,46075,96,313349
24936,0.000507,172.31.47.0-255,66,46141,96,313349
24937,0.000536,172.253.118.0-255,2543,48684,96,313349
24938,0.000539,172.31.47.0-255,66,48750,96,313349
24939,0.000712,172.253.118.0-255,1484,50234,96,313349
24940,0.000727,172.253.118.0-255,2902,53136,96,313349
24941,0.00073,172.31.47.0-255,66,53202,96,313349
24942,0.000754,172.253.118.0-255,4320,57522,96,313349
24943,0.000756,172.31.47.0-255,66,57588,96,313349
24944,0.00078,172.253.118.0-255,5738,63326,96,313349
24945,0.000783,172.31.47.0-255,66,63392,96,313349
24946,0.000787,172.253.118.0-255,3124,66516,96,313349
24947,0.000789,172.31.47.0-255,66,66582,96,313349
24948,0.000926,172.253.118.0-255,1484,68066,96,313349
24949,0.00093,172.253.118.0-255,2902,70968,96,313349
24950,0.000932,172.253.118.0-255,1484,72452,96,313349
24951,0.000951,172.31.47.0-255,66,72518,96,313349
24952,0.000959,172.253.118.0-255,4320,76838,96,313349
24953,0.000962,172.31.47.0-255,66,76904,96,313349
24954,0.000998,172.253.118.0-255,2902,79806,96,313349
24955,0.001,172.31.47.0-255,66,79872,96,313349
24956,0.00102,172.253.118.0-255,3961,83833,96,313349
24957,0.001023,172.31.47.0-255,66,83899,96,313349
24958,0.00194,172.253.118.0-255,1484,85383,96,313349
24959,0.001948,172.253.118.0-255,2902,88285,96,313349
24960,0.001952,172.31.47.0-255,66,88351,96,313349
24961,0.001959,172.253.118.0-255,5738,94089,96,313349
24962,0.001961,172.31.47.0-255,66,94155,96,313349
24963,0.002004,172.253.118.0-255,6797,100952,96,313349
24964,0.002007,172.31.47.0-255,66,101018,96,313349
24965,0.002071,172.253.118.0-255,1484,102502,96,313349
24966,0.002085,172.253.118.0-255,2902,105404,96,313349
24967,0.002087,172.31.47.0-255,66,105470,96,313349
24968,0.002106,172.253.118.0-255,4320,109790,96,313349
24969,0.002108,172.31.47.0-255,66,109856,96,313349
24970,0.002123,172.253.118.0-255,1484,111340,96,313349
24971,0.002137,172.253.118.0-255,5738,117078,96,313349
24972,0.002139,172.31.47.0-255,66,117144,96,313349
24973,0.00216,172.253.118.0-255,1484,118628,96,313349
24974,0.002171,172.31.47.0-255,66,118694,96,313349
24975,0.002201,172.253.118.0-255,5738,124432,96,313349
24976,0.002203,172.31.47.0-255,66,124498,96,313349
24977,0.002221,172.253.118.0-255,2184,126682,96,313349
24978,0.002223,172.31.47.0-255,66,126748,96,313349
24979,0.002254,172.253.118.0-255,1484,128232,96,313349
24980,0.002276,172.253.118.0-255,2902,131134,96,313349
24981,0.002278,172.31.47.0-255,66,131200,96,313349
24982,0.002284,172.253.118.0-255,5738,136938,96,313349
24983,0.002285,172.31.47.0-255,66,137004,96,313349
24984,0.002289,172.253.118.0-255,2902,139906,96,313349
24985,0.002291,172.31.47.0-255,66,139972,96,313349
24986,0.002311,172.253.118.0-255,4320,144292,96,313349
24987,0.002327,172.253.118.0-255,1484,145776,96,313349
24988,0.00235,172.253.118.0-255,1484,147260,96,313349
24989,0.002371,172.253.118.0-255,5020,152280,96,313349
24990,0.006253,172.31.47.0-255,66,152346,96,313349
24991,0.008564,172.253.118.0-255,5738,158084,96,313349
24992,0.008571,172.31.47.0-255,66,158150,96,313349
24993,0.010886,172.253.118.0-255,5738,163888,96,313349
24994,0.010894,172.31.47.0-255,66,163954,96,313349
24995,0.013205,172.253.118.0-255,5738,169692,96,313349
24996,0.013211,172.31.47.0-255,66,169758,96,313349
24997,0.015514,172.253.118.0-255,5738,175496,96,313349
24998,0.015526,172.31.47.0-255,66,175562,96,313349
24999,0.017862,172.253.118.0-255,5738,181300,96,313349
25000,0.017874,172.31.47.0-255,66,181366,96,313349
25001,0.020184,172.253.118.0-255,5738,187104,96,313349
25002,0.020193,172.31.47.0-255,66,187170,96,313349
25003,0.022492,172.253.118.0-255,5738,192908,96,313349
25004,0.022498,172.31.47.0-255,66,192974,96,313349
25005,0.02481,172.253.118.0-255,5738,198712,96,313349
25006,0.024816,172.31.47.0-255,66,198778,96,313349
25007,0.027131,172.253.118.0-255,5738,204516,96,313349
25008,0.027138,172.31.47.0-255,66,204582,96,313349
25009,0.028107,172.31.47.0-255,172,204754,96,313349
25010,0.028141,172.31.47.0-255,1110,205864,96,313349
25011,0.028201,172.31.47.0-255,1514,207378,96,313349
25012,0.028203,172.31.47.0-255,1301,208679,96,313349
25013,0.029445,172.253.118.0-255,5738,214417,96,313349
25014,0.029452,172.31.47.0-255,66,214483,96,313349
25015,0.029658,104.244.42.0-255,66,214549,96,313349
25016,0.029703,104.244.42.0-255,66,214615,96,313349
25017,0.02975,104.244.42.0-255,66,214681,96,313349
25018,0.031765,172.253.118.0-255,5738,220419,96,313349
25019,0.03177,172.31.47.0-255,66,220485,96,313349
25020,0.034088,172.253.118.0-255,5738,226223,96,313349
25021,0.034094,172.31.47.0-255,66,226289,96,313349
25022,0.036394,172.253.118.0-255,5738,232027,96,313349
25023,0.036401,172.31.47.0-255,66,232093,96,313349
25024,0.038726,172.253.118.0-255,5738,237831,96,313349
25025,0.038733,172.31.47.0-255,66,237897,96,313349
25026,0.041035,172.253.118.0-255,5738,243635,96,313349
25027,0.041042,172.31.47.0-255,66,243701,96,313349
25028,0.04335,172.253.118.0-255,5738,249439,96,313349
25029,0.043355,172.31.47.0-255,66,249505,96,313349
25030,0.045643,172.253.118.0-255,5738,255243,96,313349
25031,0.045649,172.31.47.0-255,66,255309,96,313349
25032,0.047947,172.253.118.0-255,5738,261047,96,313349
25033,0.047955,172.31.47.0-255,66,261113,96,313349
25034,0.050263,172.253.118.0-255,5738,266851,96,313349
25035,0.050269,172.31.47.0-255,66,266917,96,313349
25036,0.052574,172.253.118.0-255,5738,272655,96,313349
25037,0.052581,172.31.47.0-255,66,272721,96,313349
25038,0.054902,172.253.118.0-255,5738,278459,96,313349
25039,0.054909,172.31.47.0-255,66,278525,96,313349
25040,0.057201,172.253.118.0-255,5738,284263,96,313349
25041,0.057207,172.31.47.0-255,66,284329,96,313349
25042,0.059513,172.253.118.0-255,5738,290067,96,313349
25043,0.059518,172.31.47.0-255,66,290133,96,313349
25044,0.061819,172.253.118.0-255,5738,295871,96,313349
25045,0.061824,172.31.47.0-255,66,295937,96,313349
25046,0.06414,172.253.118.0-255,5738,301675,96,313349
25047,0.064145,172.31.47.0-255,66,301741,96,313349
25048,0.066476,172.253.118.0-255,5738,307479,96,313349
25049,0.066482,172.31.47.0-255,66,307545,96,313349
25050,0.068793,172.253.118.0-255,5738,313283,96,313349
25051,0.068799,172.31.47.0-255,66,313349,96,313349
25052,0.0,74.125.24.0-255,152,152,96,271246
25053,2.3e-05,172.31.47.0-255,66,218,96,271246
25054,3e-05,74.125.24.0-255,1484,1702,96,271246
25055,3.4e-05,172.31.47.0-255,66,1768,96,271246
25056,4e-05,74.125.24.0-255,2902,4670,96,271246
25057,5.1e-05,172.31.47.0-255,66,4736,96,271246
25058,5.9e-05,74.125.24.0-255,7156,11892,96,271246
25059,6.2e-05,172.31.47.0-255,66,11958,96,271246
25060,6.7e-05,74.125.24.0-255,2054,14012,96,271246
25061,6.8e-05,172.31.47.0-255,66,14078,96,271246
25062,0.000101,74.125.24.0-255,2902,16980,96,271246
25063,0.000104,172.31.47.0-255,66,17046,96,271246
25064,0.000108,74.125.24.0-255,2902,19948,96,271246
25065,0.00011,172.31.47.0-255,66,20014,96,271246
25066,0.00013,74.125.24.0-255,4320,24334,96,271246
25067,0.000137,172.31.47.0-255,66,24400,96,271246
25068,0.000174,74.125.24.0-255,2902,27302,96,271246
25069,0.000177,172.31.47.0-255,66,27368,96,271246
25070,0.000206,74.125.24.0-255,3961,31329,96,271246
25071,0.000209,172.31.47.0-255,66,31395,96,271246
25072,0.000252,74.125.24.0-255,1484,32879,96,271246
25073,0.000254,172.31.47.0-255,66,32945,96,271246
25074,0.000259,74.125.24.0-255,2902,35847,96,271246
25075,0.00026,172.31.47.0-255,66,35913,96,271246
25076,0.000291,74.125.24.0-255,5738,41651,96,271246
25077,0.000294,172.31.47.0-255,66,41717,96,271246
25078,0.000327,74.125.24.0-255,4320,46037,96,271246
25079,0.00033,172.31.47.0-255,66,46103,96,271246
25080,0.000354,74.125.24.0-255,2543,48646,96,271246
25081,0.000356,172.31.47.0-255,66,48712,96,271246
25082,0.000549,74.125.24.0-255,1484,50196,96,271246
25083,0.000554,172.31.47.0-255,66,50262,96,271246
25084,0.000559,74.125.24.0-255,2902,53164,96,271246
25085,0.000561,172.31.47.0-255,66,53230,96,271246
25086,0.000567,74.125.24.0-255,5738,58968,96,271246
25087,0.000573,172.31.47.0-255,66,59034,96,271246
25088,0.000579,74.125.24.0-255,5738,64772,96,271246
25089,0.000581,172.31.47.0-255,66,64838,96,271246
25090,0.00062,74.125.24.0-255,1472,66310,96,271246
25091,0.000732,74.125.24.0-255,329,66639,96,271246
25092,0.000735,172.31.47.0-255,66,66705,96,271246
25093,0.000922,74.125.24.0-255,1484,68189,96,271246
25094,0.000928,74.125.24.0-255,2902,71091,96,271246
25095,0.00093,172.31.47.0-255,66,71157,96,271246
25096,0.000935,74.125.24.0-255,2902,74059,96,271246
25097,0.000936,172.31.47.0-255,66,74125,96,271246
25098,0.000951,74.125.24.0-255,1484,75609,96,271246
25099,0.000954,74.125.24.0-255,1484,77093,96,271246
25100,0.000956,172.31.47.0-255,66,77159,96,271246
25101,0.000991,74.125.24.0-255,4320,81479,96,271246
25102,0.000995,74.125.24.0-255,2543,84022,96,271246
25103,0.000998,172.31.47.0-255,66,84088,96,271246
25104,0.001005,172.31.47.0-255,66,84154,96,271246
25105,0.001012,74.125.24.0-255,2902,87056,96,271246
25106,0.001014,172.31.47.0-255,66,87122,96,271246
25107,0.001017,74.125.24.0-255,1484,88606,96,271246
25108,0.001052,74.125.24.0-255,5738,94344,96,271246
25109,0.001054,172.31.47.0-255,66,94410,96,271246
25110,0.001061,74.125.24.0-255,6797,101207,96,271246
25111,0.001063,172.31.47.0-255,66,101273,96,271246
25112,0.001875,74.125.24.0-255,1484,102757,96,271246
25113,0.001885,74.125.24.0-255,2902,105659,96,271246
25114,0.001889,172.31.47.0-255,66,105725,96,271246
25115,0.001896,74.125.24.0-255,5738,111463,96,271246
25116,0.001898,172.31.47.0-255,66,111529,96,271246
25117,0.00194,172.31.47.0-255,66,111595,96,271246
25118,0.001964,74.125.24.0-255,4320,115915,96,271246
25119,0.001967,172.31.47.0-255,66,115981,96,271246
25120,0.001995,172.31.47.0-255,66,116047,96,271246
25121,0.00454,74.125.24.0-255,5738,121785,96,271246
25122,0.004545,172.31.47.0-255,66,121851,96,271246
25123,0.00709,74.125.24.0-255,5738,127589,96,271246
25124,0.007096,172.31.47.0-255,66,127655,96,271246
25125,0.009623,74.125.24.0-255,5738,133393,96,271246
25126,0.009631,172.31.47.0-255,66,133459,96,271246
25127,0.012147,74.125.24.0-255,5738,139197,96,271246
25128,0.012154,172.31.47.0-255,66,139263,96,271246
25129,0.014673,74.125.24.0-255,5738,145001,96,271246
25130,0.014683,172.31.47.0-255,66,145067,96,271246
25131,0.017244,74.125.24.0-255,5738,150805,96,271246
25132,0.017252,172.31.47.0-255,66,150871,96,271246
25133,0.019788,74.125.24.0-255,5738,156609,96,271246
25134,0.019796,172.31.47.0-255,66,156675,96,271246
25135,0.022356,74.125.24.0-255,5738,162413,96,271246
25136,0.022365,172.31.47.0-255,66,162479,96,271246
25137,0.024941,74.125.24.0-255,5738,168217,96,271246
25138,0.024955,172.31.47.0-255,66,168283,96,271246
25139,0.027407,172.31.47.0-255,172,168455,96,271246
25140,0.027439,172.31.47.0-255,1105,169560,96,271246
25141,0.027471,74.125.24.0-255,5738,175298,96,271246
25142,0.027475,172.31.47.0-255,66,175364,96,271246
25143,0.027694,172.31.47.0-255,1514,176878,96,271246
25144,0.027697,172.31.47.0-255,1306,178184,96,271246
25145,0.028958,104.244.42.0-255,66,178250,96,271246
25146,0.029033,104.244.42.0-255,66,178316,96,271246
25147,0.029313,104.244.42.0-255,66,178382,96,271246
25148,0.030005,74.125.24.0-255,5738,184120,96,271246
25149,0.030009,172.31.47.0-255,66,184186,96,271246
25150,0.032594,74.125.24.0-255,5738,189924,96,271246
25151,0.032601,172.31.47.0-255,66,189990,96,271246
25152,0.035148,74.125.24.0-255,5738,195728,96,271246
25153,0.035155,172.31.47.0-255,66,195794,96,271246
25154,0.0377,74.125.24.0-255,5738,201532,96,271246
25155,0.037707,172.31.47.0-255,66,201598,96,271246
25156,0.040256,74.125.24.0-255,5738,207336,96,271246
25157,0.040265,172.31.47.0-255,66,207402,96,271246
25158,0.042824,74.125.24.0-255,5738,213140,96,271246
25159,0.042829,172.31.47.0-255,66,213206,96,271246
25160,0.045352,74.125.24.0-255,5738,218944,96,271246
25161,0.045359,172.31.47.0-255,66,219010,96,271246
25162,0.0479,74.125.24.0-255,5738,224748,96,271246
25163,0.047907,172.31.47.0-255,66,224814,96,271246
25164,0.050439,74.125.24.0-255,5738,230552,96,271246
25165,0.050445,172.31.47.0-255,66,230618,96,271246
25166,0.052984,74.125.24.0-255,5738,236356,96,271246
25167,0.052991,172.31.47.0-255,66,236422,96,271246
25168,0.055548,74.125.24.0-255,5738,242160,96,271246
25169,0.055554,172.31.47.0-255,66,242226,96,271246
25170,0.05812,74.125.24.0-255,5738,247964,96,271246
25171,0.058125,172.31.47.0-255,66,248030,96,271246
25172,0.060666,74.125.24.0-255,5738,253768,96,271246
25173,0.060673,172.31.47.0-255,66,253834,96,271246
25174,0.063198,74.125.24.0-255,5738,259572,96,271246
25175,0.063203,172.31.47.0-255,66,259638,96,271246
25176,0.065773,74.125.24.0-255,5738,265376,96,271246
25177,0.06578,172.31.47.0-255,66,265442,96,271246
25178,0.068311,74.125.24.0-255,5738,271180,96,271246
25179,0.068318,172.31.47.0-255,66,271246,96,271246
25180,0.0,74.125.24.0-255,153,153,96,224914
25181,2.3e-05,172.31.47.0-255,66,219,96,224914
25182,2.9e-05,74.125.24.0-255,1484,1703,96,224914
25183,3.3e-05,172.31.47.0-255,66,1769,96,224914
25184,5.4e-05,74.125.24.0-255,2902,4671,96,224914
25185,5.7e-05,172.31.47.0-255,66,4737,96,224914
25186,6e-05,74.125.24.0-255,1484,6221,96,224914
25187,6.1e-05,172.31.47.0-255,66,6287,96,224914
25188,9.2e-05,74.125.24.0-255,5738,12025,96,224914
25189,9.5e-05,172.31.47.0-255,66,12091,96,224914
25190,9.8e-05,74.125.24.0-255,2081,14172,96,224914
25191,0.0001,172.31.47.0-255,66,14238,96,224914
25192,0.000217,74.125.24.0-255,1484,15722,96,224914
25193,0.000222,172.31.47.0-255,66,15788,96,224914
25194,0.000227,74.125.24.0-255,2902,18690,96,224914
25195,0.00023,172.31.47.0-255,66,18756,96,224914
25196,0.000259,74.125.24.0-255,5738,24494,96,224914
25197,0.000263,172.31.47.0-255,66,24560,96,224914
25198,0.000289,74.125.24.0-255,5738,30298,96,224914
25199,0.000292,172.31.47.0-255,66,30364,96,224914
25200,0.000328,172.31.47.0-255,66,30430,96,224914
25201,0.000339,172.31.47.0-255,66,30496,96,224914
25202,0.000342,74.125.24.0-255,1484,31980,96,224914
25203,0.000344,172.31.47.0-255,66,32046,96,224914
25204,0.000358,74.125.24.0-255,1484,33530,96,224914
25205,0.000361,172.31.47.0-255,66,33596,96,224914
25206,0.000373,74.125.24.0-255,4320,37916,96,224914
25207,0.000376,172.31.47.0-255,66,37982,96,224914
25208,0.000384,74.125.24.0-255,7156,45138,96,224914
25209,0.000387,172.31.47.0-255,66,45204,96,224914
25210,0.000414,74.125.24.0-255,1484,46688,96,224914
25211,0.000418,74.125.24.0-255,1397,48085,96,224914
25212,0.000421,172.31.47.0-255,66,48151,96,224914
25213,0.000461,74.125.24.0-255,382,48533,96,224914
25214,0.000596,74.125.24.0-255,1484,50017,96,224914
25215,0.0006,172.31.47.0-255,66,50083,96,224914
25216,0.000627,74.125.24.0-255,2902,52985,96,224914
25217,0.00063,172.31.47.0-255,66,53051,96,224914
25218,0.000636,74.125.24.0-255,5738,58789,96,224914
25219,0.000642,172.31.47.0-255,66,58855,96,224914
25220,0.000668,74.125.24.0-255,7156,66011,96,224914
25221,0.000671,172.31.47.0-255,66,66077,96,224914
25222,0.000701,74.125.24.0-255,6797,72874,96,224914
25223,0.000704,172.31.47.0-255,66,72940,96,224914
25224,0.000711,74.125.24.0-255,7156,80096,96,224914
25225,0.000713,172.31.47.0-255,66,80162,96,224914
25226,0.000738,74.125.24.0-255,2543,82705,96,224914
25227,0.000741,172.31.47.0-255,66,82771,96,224914
25228,0.000955,74.125.24.0-255,1484,84255,96,224914
25229,0.000959,74.125.24.0-255,1484,85739,96,224914
25230,0.000962,172.31.47.0-255,66,85805,96,224914
25231,0.000987,74.125.24.0-255,1484,87289,96,224914
25232,0.000992,74.125.24.0-255,4320,91609,96,224914
25233,0.000995,172.31.47.0-255,66,91675,96,224914
25234,0.001043,74.125.24.0-255,4320,95995,96,224914
25235,0.001043,172.31.47.0-255,66,96061,96,224914
25236,0.001047,172.31.47.0-255,66,96127,96,224914
25237,0.001077,74.125.24.0-255,5738,101865,96,224914
25238,0.001081,172.31.47.0-255,66,101931,96,224914
25239,0.001093,74.125.24.0-255,6438,108369,96,224914
25240,0.001096,172.31.47.0-255,66,108435,96,224914
25241,0.00116,74.125.24.0-255,1484,109919,96,224914
25242,0.00118,74.125.24.0-255,2902,112821,96,224914
25243,0.001185,172.31.47.0-255,66,112887,96,224914
25244,0.001222,74.125.24.0-255,4320,117207,96,224914
25245,0.001226,172.31.47.0-255,66,117273,96,224914
25246,0.001255,74.125.24.0-255,1484,118757,96,224914
25247,0.00127,172.31.47.0-255,66,118823,96,224914
25248,0.001276,74.125.24.0-255,7156,125979,96,224914
25249,0.001278,172.31.47.0-255,66,126045,96,224914
25250,0.00129,74.125.24.0-255,3602,129647,96,224914
25251,0.001292,172.31.47.0-255,66,129713,96,224914
25252,0.001611,74.125.24.0-255,1484,131197,96,224914
25253,0.001619,74.125.24.0-255,2902,134099,96,224914
25254,0.001623,172.31.47.0-255,66,134165,96,224914
25255,0.001651,74.125.24.0-255,5738,139903,96,224914
25256,0.001654,172.31.47.0-255,66,139969,96,224914
25257,0.001678,74.125.24.0-255,1484,141453,96,224914
25258,0.001699,74.125.24.0-255,7156,148609,96,224914
25259,0.001702,172.31.47.0-255,66,148675,96,224914
25260,0.001734,74.125.24.0-255,4320,152995,96,224914
25261,0.001737,172.31.47.0-255,66,153061,96,224914
25262,0.00175,172.31.47.0-255,66,153127,96,224914
25263,0.001794,74.125.24.0-255,1484,154611,96,224914
25264,0.001798,74.125.24.0-255,1484,156095,96,224914
25265,0.001801,172.31.47.0-255,66,156161,96,224914
25266,0.001824,74.125.24.0-255,1484,157645,96,224914
25267,0.00183,74.125.24.0-255,5738,163383,96,224914
25268,0.001833,172.31.47.0-255,66,163449,96,224914
25269,0.001841,74.125.24.0-255,7156,170605,96,224914
25270,0.001843,172.31.47.0-255,66,170671,96,224914
25271,0.001865,74.125.24.0-255,1484,172155,96,224914
25272,0.00187,74.125.24.0-255,2902,175057,96,224914
25273,0.001872,172.31.47.0-255,66,175123,96,224914
25274,0.001918,172.31.47.0-255,66,175189,96,224914
25275,0.001933,172.31.47.0-255,66,175255,96,224914
25276,0.001959,74.125.24.0-255,4320,179575,96,224914
25277,0.001963,172.31.47.0-255,66,179641,96,224914
25278,0.00197,74.125.24.0-255,7156,186797,96,224914
25279,0.001973,172.31.47.0-255,66,186863,96,224914
25280,0.002011,74.125.24.0-255,6438,193301,96,224914
25281,0.002014,172.31.47.0-255,66,193367,96,224914
25282,0.002047,74.125.24.0-255,1484,194851,96,224914
25283,0.002077,74.125.24.0-255,2902,197753,96,224914
25284,0.00208,172.31.47.0-255,66,197819,96,224914
25285,0.00211,74.125.24.0-255,2902,200721,96,224914
25286,0.002113,172.31.47.0-255,66,200787,96,224914
25287,0.002138,74.125.24.0-255,2902,203689,96,224914
25288,0.002141,172.31.47.0-255,66,203755,96,224914
25289,0.002174,74.125.24.0-255,1484,205239,96,224914
25290,0.00219,74.125.24.0-255,7156,212395,96,224914
25291,0.002194,172.31.47.0-255,66,212461,96,224914
25292,0.002199,74.125.24.0-255,4320,216781,96,224914
25293,0.002201,172.31.47.0-255,66,216847,96,224914
25294,0.002234,172.31.47.0-255,66,216913,96,224914
25295,0.002254,172.31.47.0-255,66,216979,96,224914
25296,0.00227,172.31.47.0-255,66,217045,96,224914
25297,0.002278,172.31.47.0-255,66,217111,96,224914
25298,0.002302,172.31.47.0-255,66,217177,96,224914
25299,0.002349,74.125.24.0-255,1484,218661,96,224914
25300,0.002399,172.31.47.0-255,66,218727,96,224914
25301,0.002402,74.125.24.0-255,1484,220211,96,224914
25302,0.002418,172.31.47.0-255,66,220277,96,224914
25303,0.002421,74.125.24.0-255,105,220382,96,224914
25304,0.003488,172.31.47.0-255,66,220448,96,224914
25305,0.00351,172.31.47.0-255,105,220553,96,224914
25306,0.006052,74.125.24.0-255,66,220619,96,224914
25307,0.026821,172.31.47.0-255,172,220791,96,224914
25308,0.026849,172.31.47.0-255,1110,221901,96,224914
25309,0.026882,172.31.47.0-255,1514,223415,96,224914
25310,0.026884,172.31.47.0-255,1301,224716,96,224914
25311,0.028344,104.244.42.0-255,66,224782,96,224914
25312,0.028368,104.244.42.0-255,66,224848,96,224914
25313,0.028446,104.244.42.0-255,66,224914,96,224914
25314,0.0,74.125.130.0-255,153,153,96,309588
25315,2.2e-05,172.31.47.0-255,66,219,96,309588
25316,4.1e-05,74.125.130.0-255,1484,1703,96,309588
25317,4.4e-05,172.31.47.0-255,66,1769,96,309588
25318,4.9e-05,74.125.130.0-255,2902,4671,96,309588
25319,5.2e-05,172.31.47.0-255,66,4737,96,309588
25320,7.3e-05,74.125.130.0-255,1484,6221,96,309588
25321,7.5e-05,172.31.47.0-255,66,6287,96,309588
25322,0.000101,74.125.130.0-255,4320,10607,96,309588
25323,0.000104,172.31.47.0-255,66,10673,96,309588
25324,0.000112,74.125.130.0-255,3557,14230,96,309588
25325,0.000115,172.31.47.0-255,66,14296,96,309588
25326,0.000215,74.125.130.0-255,1484,15780,96,309588
25327,0.000219,172.31.47.0-255,66,15846,96,309588
25328,0.000223,74.125.130.0-255,1484,17330,96,309588
25329,0.000224,172.31.47.0-255,66,17396,96,309588
25330,0.000254,74.125.130.0-255,1484,18880,96,309588
25331,0.000257,172.31.47.0-255,66,18946,96,309588
25332,0.000262,74.125.130.0-255,5738,24684,96,309588
25333,0.000265,172.31.47.0-255,66,24750,96,309588
25334,0.000268,74.125.130.0-255,2902,27652,96,309588
25335,0.000274,172.31.47.0-255,66,27718,96,309588
25336,0.0003,74.125.130.0-255,3961,31679,96,309588
25337,0.000307,172.31.47.0-255,66,31745,96,309588
25338,0.000361,74.125.130.0-255,1484,33229,96,309588
25339,0.000363,172.31.47.0-255,66,33295,96,309588
25340,0.000367,74.125.130.0-255,2902,36197,96,309588
25341,0.000369,172.31.47.0-255,66,36263,96,309588
25342,0.000403,74.125.130.0-255,5738,42001,96,309588
25343,0.000407,74.125.130.0-255,2902,44903,96,309588
25344,0.000408,172.31.47.0-255,66,44969,96,309588
25345,0.000411,172.31.47.0-255,66,45035,96,309588
25346,0.000419,74.125.130.0-255,3961,48996,96,309588
25347,0.000421,172.31.47.0-255,66,49062,96,309588
25348,0.001072,74.125.130.0-255,1484,50546,96,309588
25349,0.001113,74.125.130.0-255,2902,53448,96,309588
25350,0.001119,172.31.47.0-255,66,53514,96,309588
25351,0.001122,74.125.130.0-255,1484,54998,96,309588
25352,0.001149,74.125.130.0-255,2902,57900,96,309588
25353,0.001152,172.31.47.0-255,66,57966,96,309588
25354,0.001177,172.31.47.0-255,66,58032,96,309588
25355,0.001214,172.31.47.0-255,66,58098,96,309588
25356,0.001217,74.125.130.0-255,1484,59582,96,309588
25357,0.001249,74.125.130.0-255,6797,66379,96,309588
25358,0.001252,172.31.47.0-255,66,66445,96,309588
25359,0.001358,74.125.130.0-255,1484,67929,96,309588
25360,0.001362,74.125.130.0-255,1484,69413,96,309588
25361,0.001365,172.31.47.0-255,66,69479,96,309588
25362,0.001392,74.125.130.0-255,2902,72381,96,309588
25363,0.001395,172.31.47.0-255,66,72447,96,309588
25364,0.001427,74.125.130.0-255,1484,73931,96,309588
25365,0.001459,74.125.130.0-255,1484,75415,96,309588
25366,0.001462,172.31.47.0-255,66,75481,96,309588
25367,0.001487,74.125.130.0-255,1484,76965,96,309588
25368,0.001493,74.125.130.0-255,4320,81285,96,309588
25369,0.001495,172.31.47.0-255,66,81351,96,309588
25370,0.001519,74.125.130.0-255,1484,82835,96,309588
25371,0.001532,74.125.130.0-255,1704,84539,96,309588
25372,0.001535,172.31.47.0-255,66,84605,96,309588
25373,0.001698,74.125.130.0-255,1484,86089,96,309588
25374,0.001704,74.125.130.0-255,2902,88991,96,309588
25375,0.001707,172.31.47.0-255,66,89057,96,309588
25376,0.001736,74.125.130.0-255,2902,91959,96,309588
25377,0.001738,172.31.47.0-255,66,92025,96,309588
25378,0.001743,74.125.130.0-255,4320,96345,96,309588
25379,0.001745,172.31.47.0-255,66,96411,96,309588
25380,0.001776,74.125.130.0-255,7156,103567,96,309588
25381,0.001778,172.31.47.0-255,66,103633,96,309588
25382,0.001803,74.125.130.0-255,1981,105614,96,309588
25383,0.001805,172.31.47.0-255,66,105680,96,309588
25384,0.001809,74.125.130.0-255,2902,108582,96,309588
25385,0.001811,172.31.47.0-255,66,108648,96,309588
25386,0.001843,74.125.130.0-255,1484,110132,96,309588
25387,0.001879,172.31.47.0-255,66,110198,96,309588
25388,0.001883,74.125.130.0-255,4320,114518,96,309588
25389,0.001885,172.31.47.0-255,66,114584,96,309588
25390,0.001914,172.31.47.0-255,66,114650,96,309588
25391,0.003887,74.125.130.0-255,5738,120388,96,309588
25392,0.003892,172.31.47.0-255,66,120454,96,309588
25393,0.005883,74.125.130.0-255,5738,126192,96,309588
25394,0.005888,172.31.47.0-255,66,126258,96,309588
25395,0.007883,74.125.130.0-255,5738,131996,96,309588
25396,0.007891,172.31.47.0-255,66,132062,96,309588
25397,0.009879,74.125.130.0-255,5738,137800,96,309588
25398,0.009887,172.31.47.0-255,66,137866,96,309588
25399,0.011865,74.125.130.0-255,5738,143604,96,309588
25400,0.011873,172.31.47.0-255,66,143670,96,309588
25401,0.013862,74.125.130.0-255,5738,149408,96,309588
25402,0.013872,172.31.47.0-255,66,149474,96,309588
25403,0.015858,74.125.130.0-255,5738,155212,96,309588
25404,0.015867,172.31.47.0-255,66,155278,96,309588
25405,0.017843,74.125.130.0-255,5738,161016,96,309588
25406,0.017851,172.31.47.0-255,66,161082,96,309588
25407,0.01983,74.125.130.0-255,4320,165402,96,309588
25408,0.019839,172.31.47.0-255,66,165468,96,309588
25409,0.019874,74.125.130.0-255,1484,166952,96,309588
25410,0.02182,74.125.130.0-255,4320,171272,96,309588
25411,0.021826,172.31.47.0-255,66,171338,96,309588
25412,0.0235,172.31.47.0-255,172,171510,96,309588
25413,0.023528,172.31.47.0-255,1104,172614,96,309588
25414,0.023565,172.31.47.0-255,1514,174128,96,309588
25415,0.023567,172.31.47.0-255,1308,175436,96,309588
25416,0.023804,74.125.130.0-255,5738,181174,96,309588
25417,0.023814,172.31.47.0-255,66,181240,96,309588
25418,0.025018,104.244.42.0-255,66,181306,96,309588
25419,0.025051,104.244.42.0-255,66,181372,96,309588
25420,0.025111,104.244.42.0-255,66,181438,96,309588
25421,0.025787,74.125.130.0-255,1484,182922,96,309588
25422,0.025809,74.125.130.0-255,4320,187242,96,309588
25423,0.025814,172.31.47.0-255,66,187308,96,309588
25424,0.027808,74.125.130.0-255,5738,193046,96,309588
25425,0.027814,172.31.47.0-255,66,193112,96,309588
25426,0.02981,74.125.130.0-255,5738,198850,96,309588
25427,0.029822,172.31.47.0-255,66,198916,96,309588
25428,0.031805,74.125.130.0-255,5738,204654,96,309588
25429,0.031813,172.31.47.0-255,66,204720,96,309588
25430,0.033791,74.125.130.0-255,5738,210458,96,309588
25431,0.033799,172.31.47.0-255,66,210524,96,309588
25432,0.03577,74.125.130.0-255,4320,214844,96,309588
25433,0.035775,172.31.47.0-255,66,214910,96,309588
25434,0.035808,74.125.130.0-255,1484,216394,96,309588
25435,0.037778,74.125.130.0-255,4320,220714,96,309588
25436,0.037795,172.31.47.0-255,66,220780,96,309588
25437,0.039809,74.125.130.0-255,5738,226518,96,309588
25438,0.039822,172.31.47.0-255,66,226584,96,309588
25439,0.041813,74.125.130.0-255,5738,232322,96,309588
25440,0.041827,172.31.47.0-255,66,232388,96,309588
25441,0.043809,74.125.130.0-255,5738,238126,96,309588
25442,0.043817,172.31.47.0-255,66,238192,96,309588
25443,0.045842,74.125.130.0-255,5738,243930,96,309588
25444,0.045852,172.31.47.0-255,66,243996,96,309588
25445,0.047822,74.125.130.0-255,4320,248316,96,309588
25446,0.047828,172.31.47.0-255,66,248382,96,309588
25447,0.04786,74.125.130.0-255,1484,249866,96,309588
25448,0.049813,74.125.130.0-255,4320,254186,96,309588
25449,0.049818,172.31.47.0-255,66,254252,96,309588
25450,0.051804,74.125.130.0-255,4320,258572,96,309588
25451,0.051809,172.31.47.0-255,66,258638,96,309588
25452,0.051841,74.125.130.0-255,1484,260122,96,309588
25453,0.053795,74.125.130.0-255,4320,264442,96,309588
25454,0.053803,172.31.47.0-255,66,264508,96,309588
25455,0.055814,74.125.130.0-255,5738,270246,96,309588
25456,0.055821,172.31.47.0-255,66,270312,96,309588
25457,0.05781,74.125.130.0-255,5738,276050,96,309588
25458,0.057817,172.31.47.0-255,66,276116,96,309588
25459,0.059839,74.125.130.0-255,5738,281854,96,309588
25460,0.059846,172.31.47.0-255,66,281920,96,309588
25461,0.061845,74.125.130.0-255,5738,287658,96,309588
25462,0.061851,172.31.47.0-255,66,287724,96,309588
25463,0.063838,74.125.130.0-255,4320,292044,96,309588
25464,0.063845,172.31.47.0-255,66,292110,96,309588
25465,0.063876,74.125.130.0-255,1484,293594,96,309588
25466,0.065825,74.125.130.0-255,4320,297914,96,309588
25467,0.065831,172.31.47.0-255,66,297980,96,309588
25468,0.067813,74.125.130.0-255,5738,303718,96,309588
25469,0.06782,172.31.47.0-255,66,303784,96,309588
25470,0.069818,74.125.130.0-255,5738,309522,96,309588
25471,0.069831,172.31.47.0-255,66,309588,96,309588
25472,0.0,74.125.200.0-255,152,152,96,334597
25473,3.2e-05,172.31.47.0-255,66,218,96,334597
25474,3.8e-05,74.125.200.0-255,1484,1702,96,334597
25475,4.2e-05,172.31.47.0-255,66,1768,96,334597
25476,4.7e-05,74.125.200.0-255,2902,4670,96,334597
25477,4.9e-05,172.31.47.0-255,66,4736,96,334597
25478,5.5e-05,74.125.200.0-255,5738,10474,96,334597
25479,5.8e-05,172.31.47.0-255,66,10540,96,334597
25480,7.8e-05,74.125.200.0-255,3367,13907,96,334597
25481,8e-05,172.31.47.0-255,66,13973,96,334597
25482,0.000245,74.125.200.0-255,1484,15457,96,334597
25483,0.00025,172.31.47.0-255,66,15523,96,334597
25484,0.000254,74.125.200.0-255,2902,18425,96,334597
25485,0.000257,172.31.47.0-255,66,18491,96,334597
25486,0.000275,74.125.200.0-255,5738,24229,96,334597
25487,0.000278,172.31.47.0-255,66,24295,96,334597
25488,0.000281,74.125.200.0-255,2902,27197,96,334597
25489,0.000284,172.31.47.0-255,66,27263,96,334597
25490,0.000306,74.125.200.0-255,3961,31224,96,334597
25491,0.000309,172.31.47.0-255,66,31290,96,334597
25492,0.000312,74.125.200.0-255,1484,32774,96,334597
25493,0.000314,172.31.47.0-255,66,32840,96,334597
25494,0.000347,74.125.200.0-255,5738,38578,96,334597
25495,0.00035,172.31.47.0-255,66,38644,96,334597
25496,0.000363,74.125.200.0-255,1484,40128,96,334597
25497,0.000365,172.31.47.0-255,66,40194,96,334597
25498,0.00037,74.125.200.0-255,4320,44514,96,334597
25499,0.000372,172.31.47.0-255,66,44580,96,334597
25500,0.000382,172.31.47.0-255,66,44646,96,334597
25501,0.000406,74.125.200.0-255,4320,48966,96,334597
25502,0.000409,172.31.47.0-255,66,49032,96,334597
25503,0.000415,74.125.200.0-255,6438,55470,96,334597
25504,0.000422,172.31.47.0-255,66,55536,96,334597
25505,0.00044,74.125.200.0-255,396,55932,96,334597
25506,0.000444,74.125.200.0-255,110,56042,96,334597
25507,0.000467,74.125.200.0-255,334,56376,96,334597
25508,0.000684,74.125.200.0-255,1484,57860,96,334597
25509,0.000687,172.31.47.0-255,66,57926,96,334597
25510,0.000692,74.125.200.0-255,2902,60828,96,334597
25511,0.000694,172.31.47.0-255,66,60894,96,334597
25512,0.000709,74.125.200.0-255,1484,62378,96,334597
25513,0.000723,74.125.200.0-255,4320,66698,96,334597
25514,0.000725,172.31.47.0-255,66,66764,96,334597
25515,0.000753,172.31.47.0-255,66,66830,96,334597
25516,0.000779,74.125.200.0-255,2902,69732,96,334597
25517,0.000781,172.31.47.0-255,66,69798,96,334597
25518,0.000793,172.31.47.0-255,66,69864,96,334597
25519,0.001215,74.125.200.0-255,1484,71348,96,334597
25520,0.001225,74.125.200.0-255,1484,72832,96,334597
25521,0.001228,172.31.47.0-255,66,72898,96,334597
25522,0.001247,74.125.200.0-255,1484,74382,96,334597
25523,0.00125,74.125.200.0-255,1484,75866,96,334597
25524,0.001252,172.31.47.0-255,66,75932,96,334597
25525,0.001256,74.125.200.0-255,2902,78834,96,334597
25526,0.001257,172.31.47.0-255,66,78900,96,334597
25527,0.001287,74.125.200.0-255,5738,84638,96,334597
25528,0.001289,172.31.47.0-255,66,84704,96,334597
25529,0.001292,74.125.200.0-255,1484,86188,96,334597
25530,0.001319,172.31.47.0-255,66,86254,96,334597
25531,0.001361,172.31.47.0-255,66,86320,96,334597
25532,0.001601,74.125.200.0-255,1484,87804,96,334597
25533,0.001608,74.125.200.0-255,2902,90706,96,334597
25534,0.001611,172.31.47.0-255,66,90772,96,334597
25535,0.001635,74.125.200.0-255,5738,96510,96,334597
25536,0.001637,172.31.47.0-255,66,96576,96,334597
25537,0.001641,74.125.200.0-255,2902,99478,96,334597
25538,0.001642,172.31.47.0-255,66,99544,96,334597
25539,0.001665,74.125.200.0-255,1484,101028,96,334597
25540,0.00167,74.125.200.0-255,5738,106766,96,334597
25541,0.001673,172.31.47.0-255,66,106832,96,334597
25542,0.001696,74.125.200.0-255,5738,112570,96,334597
25543,0.0017,172.31.47.0-255,66,112636,96,334597
25544,0.001716,74.125.200.0-255,2902,115538,96,334597
25545,0.001718,172.31.47.0-255,66,115604,96,334597
25546,0.001739,74.125.200.0-255,4320,119924,96,334597
25547,0.001742,74.125.200.0-255,766,120690,96,334597
25548,0.001744,172.31.47.0-255,66,120756,96,334597
25549,0.001823,74.125.200.0-255,1484,122240,96,334597
25550,0.001827,172.31.47.0-255,66,122306,96,334597
25551,0.001846,74.125.200.0-255,2902,125208,96,334597
25552,0.001848,172.31.47.0-255,66,125274,96,334597
25553,0.001851,74.125.200.0-255,1484,126758,96,334597
25554,0.001855,74.125.200.0-255,2902,129660,96,334597
25555,0.001857,172.31.47.0-255,66,129726,96,334597
25556,0.001902,74.125.200.0-255,5738,135464,96,334597
25557,0.001905,172.31.47.0-255,66,135530,96,334597
25558,0.001911,74.125.200.0-255,5738,141268,96,334597
25559,0.001912,172.31.47.0-255,66,141334,96,334597
25560,0.001935,74.125.200.0-255,5738,147072,96,334597
25561,0.001937,172.31.47.0-255,66,147138,96,334597
25562,0.001956,74.125.200.0-255,1484,148622,96,334597
25563,0.00196,74.125.200.0-255,4320,152942,96,334597
25564,0.001962,172.31.47.0-255,66,153008,96,334597
25565,0.002005,74.125.200.0-255,2184,155192,96,334597
25566,0.002008,172.31.47.0-255,66,155258,96,334597
25567,0.002321,74.125.200.0-255,1484,156742,96,334597
25568,0.002336,74.125.200.0-255,2902,159644,96,334597
25569,0.002339,172.31.47.0-255,66,159710,96,334597
25570,0.002361,74.125.200.0-255,5738,165448,96,334597
25571,0.002363,172.31.47.0-255,66,165514,96,334597
25572,0.002385,74.125.200.0-255,7156,172670,96,334597
25573,0.002387,172.31.47.0-255,66,172736,96,334597
25574,0.00239,74.125.200.0-255,1484,174220,96,334597
25575,0.004739,74.125.200.0-255,4320,178540,96,334597
25576,0.004743,172.31.47.0-255,66,178606,96,334597
25577,0.007124,74.125.200.0-255,5738,184344,96,334597
25578,0.00714,172.31.47.0-255,66,184410,96,334597
25579,0.009513,74.125.200.0-255,5738,190148,96,334597
25580,0.009529,172.31.47.0-255,66,190214,96,334597
25581,0.011919,74.125.200.0-255,5738,195952,96,334597
25582,0.011931,172.31.47.0-255,66,196018,96,334597
25583,0.014317,74.125.200.0-255,5738,201756,96,334597
25584,0.014336,172.31.47.0-255,66,201822,96,334597
25585,0.016736,74.125.200.0-255,5738,207560,96,334597
25586,0.016748,172.31.47.0-255,66,207626,96,334597
25587,0.019137,74.125.200.0-255,5738,213364,96,334597
25588,0.019155,172.31.47.0-255,66,213430,96,334597
25589,0.02153,74.125.200.0-255,5738,219168,96,334597
25590,0.021547,172.31.47.0-255,66,219234,96,334597
25591,0.023908,74.125.200.0-255,1484,220718,96,334597
25592,0.023928,74.125.200.0-255,4320,225038,96,334597
25593,0.023934,172.31.47.0-255,66,225104,96,334597
25594,0.024645,172.31.47.0-255,172,225276,96,334597
25595,0.024676,172.31.47.0-255,1109,226385,96,334597
25596,0.024701,172.31.47.0-255,1514,227899,96,334597
25597,0.024702,172.31.47.0-255,1302,229201,96,334597
25598,0.026197,104.244.42.0-255,66,229267,96,334597
25599,0.026258,104.244.42.0-255,66,229333,96,334597
25600,0.026264,104.244.42.0-255,66,229399,96,334597
25601,0.026303,74.125.200.0-255,2902,232301,96,334597
25602,0.026313,172.31.47.0-255,66,232367,96,334597
25603,0.026339,74.125.200.0-255,2902,235269,96,334597
25604,0.026344,172.31.47.0-255,66,235335,96,334597
25605,0.028694,74.125.200.0-255,4320,239655,96,334597
25606,0.028708,172.31.47.0-255,66,239721,96,334597
25607,0.02873,74.125.200.0-255,1484,241205,96,334597
25608,0.031072,74.125.200.0-255,1484,242689,96,334597
25609,0.031081,172.31.47.0-255,66,242755,96,334597
25610,0.0311,74.125.200.0-255,2902,245657,96,334597
25611,0.031103,172.31.47.0-255,66,245723,96,334597
25612,0.03348,74.125.200.0-255,4320,250043,96,334597
25613,0.033491,172.31.47.0-255,66,250109,96,334597
25614,0.033506,74.125.200.0-255,1484,251593,96,334597
25615,0.035867,74.125.200.0-255,4320,255913,96,334597
25616,0.035878,172.31.47.0-255,66,255979,96,334597
25617,0.038251,74.125.200.0-255,4320,260299,96,334597
25618,0.038259,172.31.47.0-255,66,260365,96,334597
25619,0.038275,74.125.200.0-255,1484,261849,96,334597
25620,0.040626,74.125.200.0-255,4320,266169,96,334597
25621,0.040636,172.31.47.0-255,66,266235,96,334597
25622,0.043009,74.125.200.0-255,5738,271973,96,334597
25623,0.043018,172.31.47.0-255,66,272039,96,334597
25624,0.045401,74.125.200.0-255,5738,277777,96,334597
25625,0.045411,172.31.47.0-255,66,277843,96,334597
25626,0.047793,74.125.200.0-255,4320,282163,96,334597
25627,0.0478,172.31.47.0-255,66,282229,96,334597
25628,0.04782,74.125.200.0-255,1484,283713,96,334597
25629,0.050164,74.125.200.0-255,4320,288033,96,334597
25630,0.05017,172.31.47.0-255,66,288099,96,334597
25631,0.052546,74.125.200.0-255,5738,293837,96,334597
25632,0.052556,172.31.47.0-255,66,293903,96,334597
25633,0.054927,74.125.200.0-255,5738,299641,96,334597
25634,0.054935,172.31.47.0-255,66,299707,96,334597
25635,0.057311,74.125.200.0-255,5738,305445,96,334597
25636,0.057317,172.31.47.0-255,66,305511,96,334597
25637,0.059684,74.125.200.0-255,5738,311249,96,334597
25638,0.059697,172.31.47.0-255,66,311315,96,334597
25639,0.062105,74.125.200.0-255,5738,317053,96,334597
25640,0.062117,172.31.47.0-255,66,317119,96,334597
25641,0.064484,74.125.200.0-255,5738,322857,96,334597
25642,0.064492,172.31.47.0-255,66,322923,96,334597
25643,0.066876,74.125.200.0-255,5738,328661,96,334597
25644,0.066884,172.31.47.0-255,66,328727,96,334597
25645,0.069262,74.125.200.0-255,4320,333047,96,334597
25646,0.069274,172.31.47.0-255,66,333113,96,334597
25647,0.069294,74.125.200.0-255,1484,334597,96,334597
25648,0.0,172.217.194.0-255,152,152,96,196718
25649,2.9e-05,172.31.47.0-255,66,218,96,196718
25650,3.6e-05,172.217.194.0-255,1484,1702,96,196718
25651,4e-05,172.31.47.0-255,66,1768,96,196718
25652,4.4e-05,172.217.194.0-255,2902,4670,96,196718
25653,4.6e-05,172.31.47.0-255,66,4736,96,196718
25654,6.1e-05,172.217.194.0-255,7156,11892,96,196718
25655,6.3e-05,172.31.47.0-255,66,11958,96,196718
25656,0.000106,172.217.194.0-255,4320,16278,96,196718
25657,0.000108,172.31.47.0-255,66,16344,96,196718
25658,0.000134,172.217.194.0-255,2219,18563,96,196718
25659,0.000137,172.31.47.0-255,66,18629,96,196718
25660,0.000143,172.217.194.0-255,7156,25785,96,196718
25661,0.000145,172.31.47.0-255,66,25851,96,196718
25662,0.000147,172.217.194.0-255,1484,27335,96,196718
25663,0.000149,172.31.47.0-255,66,27401,96,196718
25664,0.000178,172.217.194.0-255,3961,31362,96,196718
25665,0.000181,172.31.47.0-255,66,31428,96,196718
25666,0.000337,172.217.194.0-255,1484,32912,96,196718
25667,0.000341,172.31.47.0-255,66,32978,96,196718
25668,0.000344,172.217.194.0-255,1484,34462,96,196718
25669,0.000346,172.31.47.0-255,66,34528,96,196718
25670,0.000365,172.217.194.0-255,1484,36012,96,196718
25671,0.000374,172.217.194.0-255,5738,41750,96,196718
25672,0.000371,172.31.47.0-255,66,41816,96,196718
25673,0.000377,172.31.47.0-255,66,41882,96,196718
25674,0.000408,172.31.47.0-255,66,41948,96,196718
25675,0.000411,172.217.194.0-255,1484,43432,96,196718
25676,0.000412,172.31.47.0-255,66,43498,96,196718
25677,0.000453,172.31.47.0-255,66,43564,96,196718
25678,0.000456,172.217.194.0-255,408,43972,96,196718
25679,0.000521,172.217.194.0-255,1484,45456,96,196718
25680,0.000525,172.31.47.0-255,66,45522,96,196718
25681,0.000529,172.217.194.0-255,2902,48424,96,196718
25682,0.000531,172.31.47.0-255,66,48490,96,196718
25683,0.000534,172.217.194.0-255,1484,49974,96,196718
25684,0.00056,172.217.194.0-255,4320,54294,96,196718
25685,0.000563,172.31.47.0-255,66,54360,96,196718
25686,0.000598,172.31.47.0-255,66,54426,96,196718
25687,0.000648,172.31.47.0-255,66,54492,96,196718
25688,0.000698,172.217.194.0-255,1484,55976,96,196718
25689,0.000702,172.217.194.0-255,2902,58878,96,196718
25690,0.000705,172.31.47.0-255,66,58944,96,196718
25691,0.000731,172.217.194.0-255,5738,64682,96,196718
25692,0.000734,172.31.47.0-255,66,64748,96,196718
25693,0.00074,172.217.194.0-255,5738,70486,96,196718
25694,0.000741,172.31.47.0-255,66,70552,96,196718
25695,0.000773,172.217.194.0-255,7156,77708,96,196718
25696,0.000776,172.31.47.0-255,66,77774,96,196718
25697,0.000781,172.217.194.0-255,4320,82094,96,196718
25698,0.000783,172.31.47.0-255,66,82160,96,196718
25699,0.000804,172.217.194.0-255,6438,88598,96,196718
25700,0.000812,172.31.47.0-255,66,88664,96,196718
25701,0.001065,172.217.194.0-255,1484,90148,96,196718
25702,0.00107,172.217.194.0-255,2902,93050,96,196718
25703,0.001072,172.31.47.0-255,66,93116,96,196718
25704,0.001098,172.217.194.0-255,5738,98854,96,196718
25705,0.001101,172.31.47.0-255,66,98920,96,196718
25706,0.001125,172.217.194.0-255,4320,103240,96,196718
25707,0.001128,172.31.47.0-255,66,103306,96,196718
25708,0.001161,172.31.47.0-255,66,103372,96,196718
25709,0.001176,172.31.47.0-255,66,103438,96,196718
25710,0.001181,172.217.194.0-255,5738,109176,96,196718
25711,0.001183,172.31.47.0-255,66,109242,96,196718
25712,0.00123,172.31.47.0-255,66,109308,96,196718
25713,0.001239,172.31.47.0-255,66,109374,96,196718
25714,0.001417,172.217.194.0-255,1484,110858,96,196718
25715,0.001422,172.217.194.0-255,2902,113760,96,196718
25716,0.001424,172.31.47.0-255,66,113826,96,196718
25717,0.00145,172.217.194.0-255,5738,119564,96,196718
25718,0.001453,172.31.47.0-255,66,119630,96,196718
25719,0.001462,172.31.47.0-255,66,119696,96,196718
25720,0.001507,172.217.194.0-255,2902,122598,96,196718
25721,0.00151,172.31.47.0-255,66,122664,96,196718
25722,0.001541,172.31.47.0-255,66,122730,96,196718
25723,0.001757,172.217.194.0-255,1484,124214,96,196718
25724,0.001774,172.217.194.0-255,2902,127116,96,196718
25725,0.001778,172.217.194.0-255,2902,130018,96,196718
25726,0.001778,172.31.47.0-255,66,130084,96,196718
25727,0.001782,172.31.47.0-255,66,130150,96,196718
25728,0.001797,172.217.194.0-255,2902,133052,96,196718
25729,0.0018,172.31.47.0-255,66,133118,96,196718
25730,0.001803,172.217.194.0-255,1484,134602,96,196718
25731,0.001842,172.31.47.0-255,66,134668,96,196718
25732,0.001849,172.217.194.0-255,7156,141824,96,196718
25733,0.001851,172.31.47.0-255,66,141890,96,196718
25734,0.001882,172.217.194.0-255,6438,148328,96,196718
25735,0.001885,172.31.47.0-255,66,148394,96,196718
25736,0.001896,172.31.47.0-255,66,148460,96,196718
25737,0.001967,172.31.47.0-255,66,148526,96,196718
25738,0.001977,172.31.47.0-255,66,148592,96,196718
25739,0.001982,172.217.194.0-255,4320,152912,96,196718
25740,0.001983,172.31.47.0-255,66,152978,96,196718
25741,0.002015,172.217.194.0-255,5738,158716,96,196718
25742,0.002022,172.217.194.0-255,7156,165872,96,196718
25743,0.002022,172.31.47.0-255,66,165938,96,196718
25744,0.002025,172.31.47.0-255,66,166004,96,196718
25745,0.002059,172.31.47.0-255,66,166070,96,196718
25746,0.002064,172.217.194.0-255,4320,170390,96,196718
25747,0.002066,172.31.47.0-255,66,170456,96,196718
25748,0.002095,172.217.194.0-255,5738,176194,96,196718
25749,0.002098,172.31.47.0-255,66,176260,96,196718
25750,0.002113,172.31.47.0-255,66,176326,96,196718
25751,0.002116,172.217.194.0-255,2902,179228,96,196718
25752,0.002118,172.31.47.0-255,66,179294,96,196718
25753,0.002167,172.31.47.0-255,66,179360,96,196718
25754,0.002179,172.31.47.0-255,66,179426,96,196718
25755,0.002189,172.31.47.0-255,66,179492,96,196718
25756,0.002224,172.31.47.0-255,66,179558,96,196718
25757,0.00223,172.217.194.0-255,7156,186714,96,196718
25758,0.002232,172.31.47.0-255,66,186780,96,196718
25759,0.002262,172.217.194.0-255,5235,192015,96,196718
25760,0.002264,172.217.194.0-255,105,192120,96,196718
25761,0.002266,172.31.47.0-255,66,192186,96,196718
25762,0.003005,172.31.47.0-255,66,192252,96,196718
25763,0.003028,172.31.47.0-255,105,192357,96,196718
25764,0.005235,172.217.194.0-255,66,192423,96,196718
25765,0.031005,172.31.47.0-255,172,192595,96,196718
25766,0.031032,172.31.47.0-255,1105,193700,96,196718
25767,0.031062,172.31.47.0-255,1514,195214,96,196718
25768,0.031063,172.31.47.0-255,1306,196520,96,196718
25769,0.032542,104.244.42.0-255,66,196586,96,196718
25770,0.032593,104.244.42.0-255,66,196652,96,196718
25771,0.03264,104.244.42.0-255,66,196718,96,196718
25772,0.0,74.125.130.0-255,153,153,96,399833
25773,2.2e-05,172.31.47.0-255,66,219,96,399833
25774,4.4e-05,74.125.130.0-255,1484,1703,96,399833
25775,4.8e-05,172.31.47.0-255,66,1769,96,399833
25776,6.4e-05,74.125.130.0-255,1484,3253,96,399833
25777,6.7e-05,172.31.47.0-255,66,3319,96,399833
25778,7.1e-05,74.125.130.0-255,2902,6221,96,399833
25779,7.4e-05,172.31.47.0-255,66,6287,96,399833
25780,9.1e-05,74.125.130.0-255,2902,9189,96,399833
25781,9.3e-05,172.31.47.0-255,66,9255,96,399833
25782,0.000106,74.125.130.0-255,2902,12157,96,399833
25783,0.000108,172.31.47.0-255,66,12223,96,399833
25784,0.00011,74.125.130.0-255,1484,13707,96,399833
25785,0.000112,172.31.47.0-255,66,13773,96,399833
25786,0.000127,74.125.130.0-255,2093,15866,96,399833
25787,0.000129,172.31.47.0-255,66,15932,96,399833
25788,0.00015,74.125.130.0-255,1484,17416,96,399833
25789,0.000151,172.31.47.0-255,66,17482,96,399833
25790,0.000163,74.125.130.0-255,2902,20384,96,399833
25791,0.000165,172.31.47.0-255,66,20450,96,399833
25792,0.000176,74.125.130.0-255,1484,21934,96,399833
25793,0.000178,172.31.47.0-255,66,22000,96,399833
25794,0.000183,74.125.130.0-255,4320,26320,96,399833
25795,0.000185,172.31.47.0-255,66,26386,96,399833
25796,0.000196,74.125.130.0-255,2902,29288,96,399833
25797,0.000198,172.31.47.0-255,66,29354,96,399833
25798,0.000202,74.125.130.0-255,2543,31897,96,399833
25799,0.000204,172.31.47.0-255,66,31963,96,399833
25800,0.000426,74.125.130.0-255,1484,33447,96,399833
25801,0.000429,172.31.47.0-255,66,33513,96,399833
25802,0.000446,74.125.130.0-255,2902,36415,96,399833
25803,0.000448,172.31.47.0-255,66,36481,96,399833
25804,0.00047,74.125.130.0-255,4320,40801,96,399833
25805,0.000472,172.31.47.0-255,66,40867,96,399833
25806,0.000493,74.125.130.0-255,5738,46605,96,399833
25807,0.000495,172.31.47.0-255,66,46671,96,399833
25808,0.000511,74.125.130.0-255,2543,49214,96,399833
25809,0.000513,172.31.47.0-255,66,49280,96,399833
25810,0.000535,74.125.130.0-255,2902,52182,96,399833
25811,0.000537,172.31.47.0-255,66,52248,96,399833
25812,0.000572,74.125.130.0-255,7156,59404,96,399833
25813,0.000575,172.31.47.0-255,66,59470,96,399833
25814,0.000577,74.125.130.0-255,1484,60954,96,399833
25815,0.000581,74.125.130.0-255,2902,63856,96,399833
25816,0.000583,172.31.47.0-255,66,63922,96,399833
25817,0.000611,74.125.130.0-255,2543,66465,96,399833
25818,0.000614,172.31.47.0-255,66,66531,96,399833
25819,0.000653,74.125.130.0-255,646,67177,96,399833
25820,0.000686,172.31.47.0-255,66,67243,96,399833
25821,0.00085,74.125.130.0-255,1484,68727,96,399833
25822,0.000857,74.125.130.0-255,1484,70211,96,399833
25823,0.00086,172.31.47.0-255,66,70277,96,399833
25824,0.000879,74.125.130.0-255,1484,71761,96,399833
25825,0.000884,74.125.130.0-255,4320,76081,96,399833
25826,0.000886,172.31.47.0-255,66,76147,96,399833
25827,0.000903,74.125.130.0-255,2902,79049,96,399833
25828,0.000906,172.31.47.0-255,66,79115,96,399833
25829,0.000922,74.125.130.0-255,5738,84853,96,399833
25830,0.000924,172.31.47.0-255,66,84919,96,399833
25831,0.00093,74.125.130.0-255,7156,92075,96,399833
25832,0.000932,172.31.47.0-255,66,92141,96,399833
25833,0.000935,74.125.130.0-255,1484,93625,96,399833
25834,0.000955,74.125.130.0-255,7156,100781,96,399833
25835,0.000957,172.31.47.0-255,66,100847,96,399833
25836,0.000961,74.125.130.0-255,766,101613,96,399833
25837,0.001072,74.125.130.0-255,1484,103097,96,399833
25838,0.001076,172.31.47.0-255,66,103163,96,399833
25839,0.001081,74.125.130.0-255,2902,106065,96,399833
25840,0.001083,172.31.47.0-255,66,106131,96,399833
25841,0.001113,74.125.130.0-255,4320,110451,96,399833
25842,0.001115,172.31.47.0-255,66,110517,96,399833
25843,0.001131,74.125.130.0-255,1484,112001,96,399833
25844,0.001146,74.125.130.0-255,1484,113485,96,399833
25845,0.001148,172.31.47.0-255,66,113551,96,399833
25846,0.001164,74.125.130.0-255,5738,119289,96,399833
25847,0.001167,172.31.47.0-255,66,119355,96,399833
25848,0.00117,74.125.130.0-255,2902,122257,96,399833
25849,0.001173,172.31.47.0-255,66,122323,96,399833
25850,0.001187,74.125.130.0-255,4320,126643,96,399833
25851,0.001189,172.31.47.0-255,66,126709,96,399833
25852,0.001218,74.125.130.0-255,2902,129611,96,399833
25853,0.001221,172.31.47.0-255,66,129677,96,399833
25854,0.001239,74.125.130.0-255,4320,133997,96,399833
25855,0.001241,172.31.47.0-255,66,134063,96,399833
25856,0.001269,74.125.130.0-255,4320,138383,96,399833
25857,0.001271,172.31.47.0-255,66,138449,96,399833
25858,0.001288,74.125.130.0-255,3602,142051,96,399833
25859,0.00129,172.31.47.0-255,66,142117,96,399833
25860,0.001299,172.31.47.0-255,66,142183,96,399833
25861,0.00133,172.31.47.0-255,66,142249,96,399833
25862,0.001344,74.125.130.0-255,1484,143733,96,399833
25863,0.001367,74.125.130.0-255,2902,146635,96,399833
25864,0.001369,172.31.47.0-255,66,146701,96,399833
25865,0.001388,74.125.130.0-255,6438,153139,96,399833
25866,0.00139,172.31.47.0-255,66,153205,96,399833
25867,0.001529,74.125.130.0-255,1484,154689,96,399833
25868,0.001532,74.125.130.0-255,1484,156173,96,399833
25869,0.001533,172.31.47.0-255,66,156239,96,399833
25870,0.001549,74.125.130.0-255,1484,157723,96,399833
25871,0.001554,74.125.130.0-255,4320,162043,96,399833
25872,0.001556,172.31.47.0-255,66,162109,96,399833
25873,0.00157,74.125.130.0-255,1484,163593,96,399833
25874,0.001575,74.125.130.0-255,4320,167913,96,399833
25875,0.001577,172.31.47.0-255,66,167979,96,399833
25876,0.001593,74.125.130.0-255,1484,169463,96,399833
25877,0.001599,74.125.130.0-255,7156,176619,96,399833
25878,0.001601,172.31.47.0-255,66,176685,96,399833
25879,0.001634,172.31.47.0-255,66,176751,96,399833
25880,0.001649,74.125.130.0-255,2184,178935,96,399833
25881,0.001651,172.31.47.0-255,66,179001,96,399833
25882,0.00193,74.125.130.0-255,1484,180485,96,399833
25883,0.001943,74.125.130.0-255,2902,183387,96,399833
25884,0.001945,172.31.47.0-255,66,183453,96,399833
25885,0.001956,74.125.130.0-255,4320,187773,96,399833
25886,0.001958,172.31.47.0-255,66,187839,96,399833
25887,0.001979,74.125.130.0-255,1484,189323,96,399833
25888,0.001983,74.125.130.0-255,4320,193643,96,399833
25889,0.001984,172.31.47.0-255,66,193709,96,399833
25890,0.001989,74.125.130.0-255,4320,198029,96,399833
25891,0.00199,172.31.47.0-255,66,198095,96,399833
25892,0.002,74.125.130.0-255,1484,199579,96,399833
25893,0.002015,74.125.130.0-255,4320,203899,96,399833
25894,0.002017,172.31.47.0-255,66,203965,96,399833
25895,0.002038,74.125.130.0-255,7156,211121,96,399833
25896,0.002039,172.31.47.0-255,66,211187,96,399833
25897,0.002043,74.125.130.0-255,2184,213371,96,399833
25898,0.002044,172.31.47.0-255,66,213437,96,399833
25899,0.002167,74.125.130.0-255,1484,214921,96,399833
25900,0.002186,74.125.130.0-255,2902,217823,96,399833
25901,0.002188,172.31.47.0-255,66,217889,96,399833
25902,0.002212,74.125.130.0-255,2902,220791,96,399833
25903,0.002214,172.31.47.0-255,66,220857,96,399833
25904,0.00223,74.125.130.0-255,2902,223759,96,399833
25905,0.002232,172.31.47.0-255,66,223825,96,399833
25906,0.002238,74.125.130.0-255,1484,225309,96,399833
25907,0.002242,74.125.130.0-255,2902,228211,96,399833
25908,0.002244,172.31.47.0-255,66,228277,96,399833
25909,0.002263,74.125.130.0-255,1484,229761,96,399833
25910,0.002274,74.125.130.0-255,2902,232663,96,399833
25911,0.002276,172.31.47.0-255,66,232729,96,399833
25912,0.00229,74.125.130.0-255,1484,234213,96,399833
25913,0.0023,74.125.130.0-255,2902,237115,96,399833
25914,0.002301,172.31.47.0-255,66,237181,96,399833
25915,0.002318,74.125.130.0-255,4320,241501,96,399833
25916,0.00232,172.31.47.0-255,66,241567,96,399833
25917,0.002324,74.125.130.0-255,2902,244469,96,399833
25918,0.002325,172.31.47.0-255,66,244535,96,399833
25919,0.002329,74.125.130.0-255,2902,247437,96,399833
25920,0.002331,172.31.47.0-255,66,247503,96,399833
25921,0.004616,74.125.130.0-255,4320,251823,96,399833
25922,0.004623,172.31.47.0-255,66,251889,96,399833
25923,0.00464,74.125.130.0-255,1484,253373,96,399833
25924,0.006922,74.125.130.0-255,4320,257693,96,399833
25925,0.006927,172.31.47.0-255,66,257759,96,399833
25926,0.009237,74.125.130.0-255,4320,262079,96,399833
25927,0.009242,172.31.47.0-255,66,262145,96,399833
25928,0.009257,74.125.130.0-255,1484,263629,96,399833
25929,0.011547,74.125.130.0-255,4320,267949,96,399833
25930,0.011554,172.31.47.0-255,66,268015,96,399833
25931,0.01389,74.125.130.0-255,5738,273753,96,399833
25932,0.013897,172.31.47.0-255,66,273819,96,399833
25933,0.016203,74.125.130.0-255,5738,279557,96,399833
25934,0.016212,172.31.47.0-255,66,279623,96,399833
25935,0.018521,74.125.130.0-255,5738,285361,96,399833
25936,0.018528,172.31.47.0-255,66,285427,96,399833
25937,0.020829,74.125.130.0-255,5738,291165,96,399833
25938,0.020836,172.31.47.0-255,66,291231,96,399833
25939,0.023137,74.125.130.0-255,5738,296969,96,399833
25940,0.023144,172.31.47.0-255,66,297035,96,399833
25941,0.025453,74.125.130.0-255,5738,302773,96,399833
25942,0.025462,172.31.47.0-255,66,302839,96,399833
25943,0.027014,172.31.47.0-255,172,303011,96,399833
25944,0.027043,172.31.47.0-255,1110,304121,96,399833
25945,0.027084,172.31.47.0-255,1514,305635,96,399833
25946,0.027085,172.31.47.0-255,1301,306936,96,399833
25947,0.027767,74.125.130.0-255,5738,312674,96,399833
25948,0.027774,172.31.47.0-255,66,312740,96,399833
25949,0.028535,104.244.42.0-255,66,312806,96,399833
25950,0.028696,104.244.42.0-255,66,312872,96,399833
25951,0.028699,104.244.42.0-255,66,312938,96,399833
25952,0.030073,74.125.130.0-255,5738,318676,96,399833
25953,0.030079,172.31.47.0-255,66,318742,96,399833
25954,0.032386,74.125.130.0-255,5738,324480,96,399833
25955,0.032392,172.31.47.0-255,66,324546,96,399833
25956,0.034687,74.125.130.0-255,5738,330284,96,399833
25957,0.034694,172.31.47.0-255,66,330350,96,399833
25958,0.03701,74.125.130.0-255,5738,336088,96,399833
25959,0.037016,172.31.47.0-255,66,336154,96,399833
25960,0.039315,74.125.130.0-255,5738,341892,96,399833
25961,0.03932,172.31.47.0-255,66,341958,96,399833
25962,0.041627,74.125.130.0-255,5738,347696,96,399833
25963,0.041631,172.31.47.0-255,66,347762,96,399833
25964,0.043924,74.125.130.0-255,5738,353500,96,399833
25965,0.043928,172.31.47.0-255,66,353566,96,399833
25966,0.04622,74.125.130.0-255,5738,359304,96,399833
25967,0.046225,172.31.47.0-255,66,359370,96,399833
25968,0.048565,74.125.130.0-255,5738,365108,96,399833
25969,0.048582,172.31.47.0-255,66,365174,96,399833
25970,0.050881,74.125.130.0-255,2902,368076,96,399833
25971,0.050886,172.31.47.0-255,66,368142,96,399833
25972,0.05091,74.125.130.0-255,2902,371044,96,399833
25973,0.050912,172.31.47.0-255,66,371110,96,399833
25974,0.053199,74.125.130.0-255,2902,374012,96,399833
25975,0.053204,172.31.47.0-255,66,374078,96,399833
25976,0.053231,74.125.130.0-255,2902,376980,96,399833
25977,0.053234,172.31.47.0-255,66,377046,96,399833
25978,0.05549,74.125.130.0-255,2902,379948,96,399833
25979,0.055495,172.31.47.0-255,66,380014,96,399833
25980,0.055525,74.125.130.0-255,2902,382916,96,399833
25981,0.055528,172.31.47.0-255,66,382982,96,399833
25982,0.057793,74.125.130.0-255,2902,385884,96,399833
25983,0.057799,172.31.47.0-255,66,385950,96,399833
25984,0.057828,74.125.130.0-255,2902,388852,96,399833
25985,0.057831,172.31.47.0-255,66,388918,96,399833
25986,0.060087,74.125.130.0-255,2902,391820,96,399833
25987,0.060092,172.31.47.0-255,66,391886,96,399833
25988,0.060118,74.125.130.0-255,2902,394788,96,399833
25989,0.06012,172.31.47.0-255,66,394854,96,399833
25990,0.062384,74.125.130.0-255,2902,397756,96,399833
25991,0.062388,172.31.47.0-255,66,397822,96,399833
25992,0.062445,74.125.130.0-255,1484,399306,96,399833
25993,0.062462,74.125.130.0-255,290,399596,96,399833
25994,0.062465,172.31.47.0-255,66,399662,96,399833
25995,0.062555,172.31.47.0-255,105,399767,96,399833
25996,0.064801,74.125.130.0-255,66,399833,96,399833
25997,0.0,172.31.47.0-255,105,105,96,286184
25998,0.001864,157.240.13.0-255,105,210,96,286184
25999,0.001876,172.31.47.0-255,66,276,96,286184
26000,0.012498,172.217.194.0-255,146,422,96,286184
26001,0.012505,172.31.47.0-255,66,488,96,286184
26002,0.012523,172.217.194.0-255,1484,1972,96,286184
26003,0.012528,172.31.47.0-255,66,2038,96,286184
26004,0.012544,172.217.194.0-255,2902,4940,96,286184
26005,0.012546,172.31.47.0-255,66,5006,96,286184
26006,0.012575,172.217.194.0-255,7156,12162,96,286184
26007,0.012577,172.31.47.0-255,66,12228,96,286184
26008,0.012592,172.217.194.0-255,1959,14187,96,286184
26009,0.012594,172.31.47.0-255,66,14253,96,286184
26010,0.012707,172.217.194.0-255,1484,15737,96,286184
26011,0.012711,172.31.47.0-255,66,15803,96,286184
26012,0.012726,172.217.194.0-255,2902,18705,96,286184
26013,0.012728,172.31.47.0-255,66,18771,96,286184
26014,0.012732,172.217.194.0-255,2902,21673,96,286184
26015,0.012734,172.31.47.0-255,66,21739,96,286184
26016,0.01276,172.217.194.0-255,4320,26059,96,286184
26017,0.012763,172.31.47.0-255,66,26125,96,286184
26018,0.01278,172.217.194.0-255,1484,27609,96,286184
26019,0.012782,172.31.47.0-255,66,27675,96,286184
26020,0.012801,172.217.194.0-255,3961,31636,96,286184
26021,0.012803,172.31.47.0-255,66,31702,96,286184
26022,0.012824,172.217.194.0-255,5738,37440,96,286184
26023,0.012827,172.31.47.0-255,66,37506,96,286184
26024,0.012831,172.217.194.0-255,2902,40408,96,286184
26025,0.012833,172.31.47.0-255,66,40474,96,286184
26026,0.012847,172.217.194.0-255,2902,43376,96,286184
26027,0.012849,172.31.47.0-255,66,43442,96,286184
26028,0.012887,172.217.194.0-255,2902,46344,96,286184
26029,0.01289,172.31.47.0-255,66,46410,96,286184
26030,0.012904,172.217.194.0-255,2543,48953,96,286184
26031,0.012907,172.31.47.0-255,66,49019,96,286184
26032,0.013241,172.217.194.0-255,1484,50503,96,286184
26033,0.013246,172.31.47.0-255,66,50569,96,286184
26034,0.013253,172.217.194.0-255,2902,53471,96,286184
26035,0.013255,172.31.47.0-255,66,53537,96,286184
26036,0.013258,172.217.194.0-255,1484,55021,96,286184
26037,0.013259,172.31.47.0-255,66,55087,96,286184
26038,0.013287,172.217.194.0-255,4320,59407,96,286184
26039,0.013289,172.31.47.0-255,66,59473,96,286184
26040,0.013293,172.217.194.0-255,2902,62375,96,286184
26041,0.013294,172.31.47.0-255,66,62441,96,286184
26042,0.013309,172.217.194.0-255,3961,66402,96,286184
26043,0.013311,172.31.47.0-255,66,66468,96,286184
26044,0.01333,172.217.194.0-255,648,67116,96,286184
26045,0.013332,172.31.47.0-255,66,67182,96,286184
26046,0.013409,172.217.194.0-255,1484,68666,96,286184
26047,0.013412,172.31.47.0-255,66,68732,96,286184
26048,0.013417,172.217.194.0-255,2902,71634,96,286184
26049,0.013419,172.31.47.0-255,66,71700,96,286184
26050,0.01344,172.217.194.0-255,4320,76020,96,286184
26051,0.013442,172.31.47.0-255,66,76086,96,286184
26052,0.01346,172.217.194.0-255,1484,77570,96,286184
26053,0.013462,172.31.47.0-255,66,77636,96,286184
26054,0.013472,172.31.47.0-255,66,77702,96,286184
26055,0.013504,172.217.194.0-255,1484,79186,96,286184
26056,0.013506,172.31.47.0-255,66,79252,96,286184
26057,0.013541,172.31.47.0-255,66,79318,96,286184
26058,0.014011,172.217.194.0-255,1484,80802,96,286184
26059,0.014016,172.31.47.0-255,66,80868,96,286184
26060,0.014022,172.217.194.0-255,2902,83770,96,286184
26061,0.014024,172.31.47.0-255,66,83836,96,286184
26062,0.014027,172.217.194.0-255,1484,85320,96,286184
26063,0.014029,172.31.47.0-255,66,85386,96,286184
26064,0.01405,172.217.194.0-255,4320,89706,96,286184
26065,0.014052,172.31.47.0-255,66,89772,96,286184
26066,0.014056,172.217.194.0-255,2902,92674,96,286184
26067,0.014058,172.31.47.0-255,66,92740,96,286184
26068,0.014077,172.217.194.0-255,4320,97060,96,286184
26069,0.01408,172.31.47.0-255,66,97126,96,286184
26070,0.014085,172.217.194.0-255,4320,101446,96,286184
26071,0.014088,172.31.47.0-255,66,101512,96,286184
26072,0.014118,172.31.47.0-255,66,101578,96,286184
26073,0.014122,172.217.194.0-255,2184,103762,96,286184
26074,0.014124,172.31.47.0-255,66,103828,96,286184
26075,0.014299,172.217.194.0-255,1484,105312,96,286184
26076,0.014302,172.31.47.0-255,66,105378,96,286184
26077,0.014307,172.217.194.0-255,2902,108280,96,286184
26078,0.014309,172.31.47.0-255,66,108346,96,286184
26079,0.014311,172.217.194.0-255,1484,109830,96,286184
26080,0.014313,172.31.47.0-255,66,109896,96,286184
26081,0.014331,172.217.194.0-255,4320,114216,96,286184
26082,0.014333,172.31.47.0-255,66,114282,96,286184
26083,0.014335,172.217.194.0-255,1484,115766,96,286184
26084,0.014337,172.31.47.0-255,66,115832,96,286184
26085,0.01437,172.31.47.0-255,66,115898,96,286184
26086,0.01438,172.31.47.0-255,66,115964,96,286184
26087,0.014425,172.217.194.0-255,2184,118148,96,286184
26088,0.014427,172.31.47.0-255,66,118214,96,286184
26089,0.014431,172.217.194.0-255,2902,121116,96,286184
26090,0.014433,172.31.47.0-255,66,121182,96,286184
26091,0.014465,172.217.194.0-255,1484,122666,96,286184
26092,0.014467,172.31.47.0-255,66,122732,96,286184
26093,0.014471,172.217.194.0-255,2902,125634,96,286184
26094,0.014473,172.31.47.0-255,66,125700,96,286184
26095,0.014479,172.217.194.0-255,5738,131438,96,286184
26096,0.014481,172.31.47.0-255,66,131504,96,286184
26097,0.014515,172.217.194.0-255,2902,134406,96,286184
26098,0.014517,172.31.47.0-255,66,134472,96,286184
26099,0.014544,172.31.47.0-255,66,134538,96,286184
26100,0.014572,172.217.194.0-255,2902,137440,96,286184
26101,0.014575,172.31.47.0-255,66,137506,96,286184
26102,0.014596,172.217.194.0-255,5020,142526,96,286184
26103,0.014598,172.31.47.0-255,66,142592,96,286184
26104,0.016849,172.217.194.0-255,5738,148330,96,286184
26105,0.016855,172.31.47.0-255,66,148396,96,286184
26106,0.019098,172.217.194.0-255,5738,154134,96,286184
26107,0.019103,172.31.47.0-255,66,154200,96,286184
26108,0.02137,172.217.194.0-255,5738,159938,96,286184
26109,0.021376,172.31.47.0-255,66,160004,96,286184
26110,0.023625,172.217.194.0-255,5738,165742,96,286184
26111,0.023633,172.31.47.0-255,66,165808,96,286184
26112,0.0259,172.217.194.0-255,5738,171546,96,286184
26113,0.025908,172.31.47.0-255,66,171612,96,286184
26114,0.028151,172.217.194.0-255,5738,177350,96,286184
26115,0.02816,172.31.47.0-255,66,177416,96,286184
26116,0.030383,172.217.194.0-255,5738,183154,96,286184
26117,0.03039,172.31.47.0-255,66,183220,96,286184
26118,0.032661,172.217.194.0-255,5738,188958,96,286184
26119,0.032669,172.31.47.0-255,66,189024,96,286184
26120,0.034929,172.217.194.0-255,5738,194762,96,286184
26121,0.034936,172.31.47.0-255,66,194828,96,286184
26122,0.037185,172.217.194.0-255,5738,200566,96,286184
26123,0.037194,172.31.47.0-255,66,200632,96,286184
26124,0.037229,172.31.47.0-255,172,200804,96,286184
26125,0.037251,172.31.47.0-255,1110,201914,96,286184
26126,0.037363,172.31.47.0-255,1514,203428,96,286184
26127,0.037365,172.31.47.0-255,1302,204730,96,286184
26128,0.038793,104.244.42.0-255,66,204796,96,286184
26129,0.038828,104.244.42.0-255,66,204862,96,286184
26130,0.038948,104.244.42.0-255,66,204928,96,286184
26131,0.039433,172.217.194.0-255,5738,210666,96,286184
26132,0.039438,172.31.47.0-255,66,210732,96,286184
26133,0.041694,172.217.194.0-255,5738,216470,96,286184
26134,0.041699,172.31.47.0-255,66,216536,96,286184
26135,0.043966,172.217.194.0-255,5738,222274,96,286184
26136,0.043973,172.31.47.0-255,66,222340,96,286184
26137,0.046219,172.217.194.0-255,5738,228078,96,286184
26138,0.046236,172.31.47.0-255,66,228144,96,286184
26139,0.048476,172.217.194.0-255,5738,233882,96,286184
26140,0.048482,172.31.47.0-255,66,233948,96,286184
26141,0.050712,172.217.194.0-255,5738,239686,96,286184
26142,0.050717,172.31.47.0-255,66,239752,96,286184
26143,0.052975,172.217.194.0-255,5738,245490,96,286184
26144,0.052981,172.31.47.0-255,66,245556,96,286184
26145,0.055212,172.217.194.0-255,5738,251294,96,286184
26146,0.055217,172.31.47.0-255,66,251360,96,286184
26147,0.057488,172.217.194.0-255,5738,257098,96,286184
26148,0.057494,172.31.47.0-255,66,257164,96,286184
26149,0.059745,172.217.194.0-255,5738,262902,96,286184
26150,0.059751,172.31.47.0-255,66,262968,96,286184
26151,0.062003,172.217.194.0-255,5738,268706,96,286184
26152,0.062008,172.31.47.0-255,66,268772,96,286184
26153,0.064257,172.217.194.0-255,5738,274510,96,286184
26154,0.064262,172.31.47.0-255,66,274576,96,286184
26155,0.066496,172.217.194.0-255,5738,280314,96,286184
26156,0.066502,172.31.47.0-255,66,280380,96,286184
26157,0.068756,172.217.194.0-255,5738,286118,96,286184
26158,0.068763,172.31.47.0-255,66,286184,96,286184
26159,0.0,172.217.194.0-255,153,153,96,235334
26160,3.2e-05,172.31.47.0-255,66,219,96,235334
26161,4e-05,172.217.194.0-255,1484,1703,96,235334
26162,4.4e-05,172.31.47.0-255,66,1769,96,235334
26163,4.9e-05,172.217.194.0-255,2902,4671,96,235334
26164,5.1e-05,172.31.47.0-255,66,4737,96,235334
26165,6.6e-05,172.217.194.0-255,7156,11893,96,235334
26166,7e-05,172.31.47.0-255,66,11959,96,235334
26167,7.4e-05,172.217.194.0-255,2140,14099,96,235334
26168,7.6e-05,172.31.47.0-255,66,14165,96,235334
26169,0.000161,172.217.194.0-255,1484,15649,96,235334
26170,0.000165,172.31.47.0-255,66,15715,96,235334
26171,0.000171,172.217.194.0-255,2902,18617,96,235334
26172,0.000175,172.31.47.0-255,66,18683,96,235334
26173,0.000197,172.217.194.0-255,5738,24421,96,235334
26174,0.000208,172.31.47.0-255,66,24487,96,235334
26175,0.000215,172.217.194.0-255,4320,28807,96,235334
26176,0.000217,172.31.47.0-255,66,28873,96,235334
26177,0.000248,172.217.194.0-255,2543,31416,96,235334
26178,0.000251,172.31.47.0-255,66,31482,96,235334
26179,0.000353,172.217.194.0-255,1484,32966,96,235334
26180,0.000357,172.31.47.0-255,66,33032,96,235334
26181,0.000362,172.217.194.0-255,2902,35934,96,235334
26182,0.000365,172.31.47.0-255,66,36000,96,235334
26183,0.000377,172.217.194.0-255,5738,41738,96,235334
26184,0.00038,172.31.47.0-255,66,41804,96,235334
26185,0.000437,172.217.194.0-255,5738,47542,96,235334
26186,0.000437,172.31.47.0-255,66,47608,96,235334
26187,0.00044,172.31.47.0-255,66,47674,96,235334
26188,0.000463,172.217.194.0-255,2902,50576,96,235334
26189,0.000467,172.31.47.0-255,66,50642,96,235334
26190,0.000474,172.217.194.0-255,6797,57439,96,235334
26191,0.000477,172.31.47.0-255,66,57505,96,235334
26192,0.001018,172.217.194.0-255,648,58153,96,235334
26193,0.001207,172.217.194.0-255,1484,59637,96,235334
26194,0.001213,172.31.47.0-255,66,59703,96,235334
26195,0.001219,172.217.194.0-255,2902,62605,96,235334
26196,0.001221,172.31.47.0-255,66,62671,96,235334
26197,0.001234,172.217.194.0-255,5738,68409,96,235334
26198,0.001236,172.31.47.0-255,66,68475,96,235334
26199,0.001241,172.217.194.0-255,2902,71377,96,235334
26200,0.001242,172.31.47.0-255,66,71443,96,235334
26201,0.001274,172.217.194.0-255,2902,74345,96,235334
26202,0.001277,172.31.47.0-255,66,74411,96,235334
26203,0.001291,172.31.47.0-255,66,74477,96,235334
26204,0.001323,172.217.194.0-255,1484,75961,96,235334
26205,0.001348,172.217.194.0-255,3602,79563,96,235334
26206,0.001352,172.31.47.0-255,66,79629,96,235334
26207,0.001369,172.217.194.0-255,1484,81113,96,235334
26208,0.001375,172.217.194.0-255,2902,84015,96,235334
26209,0.001377,172.31.47.0-255,66,84081,96,235334
26210,0.001383,172.217.194.0-255,4320,88401,96,235334
26211,0.001385,172.31.47.0-255,66,88467,96,235334
26212,0.00142,172.217.194.0-255,1484,89951,96,235334
26213,0.001436,172.31.47.0-255,66,90017,96,235334
26214,0.00145,172.31.47.0-255,66,90083,96,235334
26215,0.001453,172.217.194.0-255,215,90298,96,235334
26216,0.001475,172.217.194.0-255,1484,91782,96,235334
26217,0.001478,172.31.47.0-255,66,91848,96,235334
26218,0.001483,172.217.194.0-255,4320,96168,96,235334
26219,0.001485,172.31.47.0-255,66,96234,96,235334
26220,0.001516,172.31.47.0-255,66,96300,96,235334
26221,0.001527,172.31.47.0-255,66,96366,96,235334
26222,0.001568,172.217.194.0-255,4320,100686,96,235334
26223,0.00157,172.31.47.0-255,66,100752,96,235334
26224,0.001602,172.217.194.0-255,6438,107190,96,235334
26225,0.001604,172.31.47.0-255,66,107256,96,235334
26226,0.001676,172.217.194.0-255,1484,108740,96,235334
26227,0.001679,172.217.194.0-255,1484,110224,96,235334
26228,0.001681,172.31.47.0-255,66,110290,96,235334
26229,0.001706,172.217.194.0-255,1484,111774,96,235334
26230,0.001712,172.217.194.0-255,5738,117512,96,235334
26231,0.001714,172.31.47.0-255,66,117578,96,235334
26232,0.001718,172.217.194.0-255,4320,121898,96,235334
26233,0.001721,172.31.47.0-255,66,121964,96,235334
26234,0.00176,172.31.47.0-255,66,122030,96,235334
26235,0.001775,172.31.47.0-255,66,122096,96,235334
26236,0.001818,172.31.47.0-255,66,122162,96,235334
26237,0.001837,172.217.194.0-255,4320,126482,96,235334
26238,0.001839,172.31.47.0-255,66,126548,96,235334
26239,0.001841,172.217.194.0-255,1484,128032,96,235334
26240,0.001848,172.217.194.0-255,6438,134470,96,235334
26241,0.00185,172.31.47.0-255,66,134536,96,235334
26242,0.002068,172.217.194.0-255,1484,136020,96,235334
26243,0.002079,172.217.194.0-255,2902,138922,96,235334
26244,0.002082,172.31.47.0-255,66,138988,96,235334
26245,0.002085,172.217.194.0-255,2902,141890,96,235334
26246,0.002087,172.31.47.0-255,66,141956,96,235334
26247,0.002105,172.217.194.0-255,2902,144858,96,235334
26248,0.002108,172.31.47.0-255,66,144924,96,235334
26249,0.002121,172.217.194.0-255,7156,152080,96,235334
26250,0.002129,172.31.47.0-255,66,152146,96,235334
26251,0.002159,172.217.194.0-255,5738,157884,96,235334
26252,0.002161,172.31.47.0-255,66,157950,96,235334
26253,0.002178,172.31.47.0-255,66,158016,96,235334
26254,0.002189,172.31.47.0-255,66,158082,96,235334
26255,0.002231,172.217.194.0-255,7156,165238,96,235334
26256,0.002233,172.31.47.0-255,66,165304,96,235334
26257,0.002265,172.217.194.0-255,2902,168206,96,235334
26258,0.002268,172.31.47.0-255,66,168272,96,235334
26259,0.00228,172.31.47.0-255,66,168338,96,235334
26260,0.002496,172.217.194.0-255,1484,169822,96,235334
26261,0.002516,172.217.194.0-255,2902,172724,96,235334
26262,0.002519,172.31.47.0-255,66,172790,96,235334
26263,0.002524,172.217.194.0-255,4320,177110,96,235334
26264,0.002526,172.31.47.0-255,66,177176,96,235334
26265,0.002561,172.217.194.0-255,1484,178660,96,235334
26266,0.002572,172.31.47.0-255,66,178726,96,235334
26267,0.002598,172.217.194.0-255,7156,185882,96,235334
26268,0.002601,172.31.47.0-255,66,185948,96,235334
26269,0.00263,172.217.194.0-255,6438,192386,96,235334
26270,0.002632,172.31.47.0-255,66,192452,96,235334
26271,0.002635,172.217.194.0-255,1484,193936,96,235334
26272,0.002647,172.31.47.0-255,66,194002,96,235334
26273,0.002678,172.217.194.0-255,4320,198322,96,235334
26274,0.00268,172.31.47.0-255,66,198388,96,235334
26275,0.00269,172.31.47.0-255,66,198454,96,235334
26276,0.002714,172.217.194.0-255,5020,203474,96,235334
26277,0.002717,172.31.47.0-255,66,203540,96,235334
26278,0.002719,172.217.194.0-255,1484,205024,96,235334
26279,0.002743,172.217.194.0-255,2902,207926,96,235334
26280,0.002745,172.31.47.0-255,66,207992,96,235334
26281,0.002751,172.217.194.0-255,5738,213730,96,235334
26282,0.002753,172.31.47.0-255,66,213796,96,235334
26283,0.0028,172.31.47.0-255,66,213862,96,235334
26284,0.002811,172.31.47.0-255,66,213928,96,235334
26285,0.002845,172.217.194.0-255,4320,218248,96,235334
26286,0.002847,172.31.47.0-255,66,218314,96,235334
26287,0.00286,172.217.194.0-255,7156,225470,96,235334
26288,0.002866,172.31.47.0-255,66,225536,96,235334
26289,0.002887,172.217.194.0-255,2123,227659,96,235334
26290,0.002889,172.31.47.0-255,66,227725,96,235334
26291,0.002892,172.217.194.0-255,97,227822,96,235334
26292,0.002894,172.217.194.0-255,105,227927,96,235334
26293,0.00763,172.31.47.0-255,66,227993,96,235334
26294,0.007659,172.31.47.0-255,105,228098,96,235334
26295,0.009887,172.217.194.0-255,66,228164,96,235334
26296,0.042039,172.31.47.0-255,172,228336,96,235334
26297,0.04209,172.31.47.0-255,1101,229437,96,235334
26298,0.042112,172.31.47.0-255,1514,230951,96,235334
26299,0.042114,172.31.47.0-255,1514,232465,96,235334
26300,0.042115,172.31.47.0-255,1514,233979,96,235334
26301,0.042116,172.31.47.0-255,1091,235070,96,235334
26302,0.043576,104.244.42.0-255,66,235136,96,235334
26303,0.04367,104.244.42.0-255,66,235202,96,235334
26304,0.043712,104.244.42.0-255,66,235268,96,235334
26305,0.043716,104.244.42.0-255,66,235334,96,235334
26306,0.0,172.217.194.0-255,153,153,96,236596
26307,2.2e-05,172.31.47.0-255,66,219,96,236596
26308,2.8e-05,172.217.194.0-255,1484,1703,96,236596
26309,3.2e-05,172.31.47.0-255,66,1769,96,236596
26310,3.9e-05,172.217.194.0-255,2902,4671,96,236596
26311,4.2e-05,172.31.47.0-255,66,4737,96,236596
26312,6.6e-05,172.217.194.0-255,7156,11893,96,236596
26313,7e-05,172.31.47.0-255,66,11959,96,236596
26314,7.3e-05,172.217.194.0-255,1484,13443,96,236596
26315,7.4e-05,172.31.47.0-255,66,13509,96,236596
26316,0.000102,172.217.194.0-255,576,14085,96,236596
26317,0.000104,172.31.47.0-255,66,14151,96,236596
26318,0.000135,172.217.194.0-255,1484,15635,96,236596
26319,0.000137,172.31.47.0-255,66,15701,96,236596
26320,0.000155,172.217.194.0-255,2902,18603,96,236596
26321,0.000158,172.31.47.0-255,66,18669,96,236596
26322,0.000174,172.217.194.0-255,1484,20153,96,236596
26323,0.000176,172.31.47.0-255,66,20219,96,236596
26324,0.000183,172.217.194.0-255,4320,24539,96,236596
26325,0.000185,172.31.47.0-255,66,24605,96,236596
26326,0.000211,172.217.194.0-255,4320,28925,96,236596
26327,0.000214,172.31.47.0-255,66,28991,96,236596
26328,0.00022,172.217.194.0-255,4320,33311,96,236596
26329,0.000223,172.31.47.0-255,66,33377,96,236596
26330,0.00025,172.31.47.0-255,66,33443,96,236596
26331,0.000267,172.217.194.0-255,3961,37404,96,236596
26332,0.00027,172.31.47.0-255,66,37470,96,236596
26333,0.000866,172.217.194.0-255,1484,38954,96,236596
26334,0.000872,172.31.47.0-255,66,39020,96,236596
26335,0.000878,172.217.194.0-255,2902,41922,96,236596
26336,0.000881,172.31.47.0-255,66,41988,96,236596
26337,0.000886,172.217.194.0-255,2902,44890,96,236596
26338,0.000889,172.31.47.0-255,66,44956,96,236596
26339,0.000916,172.217.194.0-255,2902,47858,96,236596
26340,0.000919,172.31.47.0-255,66,47924,96,236596
26341,0.000948,172.217.194.0-255,6797,54721,96,236596
26342,0.000955,172.217.194.0-255,7156,61877,96,236596
26343,0.000985,172.31.47.0-255,66,61943,96,236596
26344,0.000988,172.31.47.0-255,66,62009,96,236596
26345,0.001022,172.31.47.0-255,66,62075,96,236596
26346,0.001027,172.217.194.0-255,2902,64977,96,236596
26347,0.001029,172.31.47.0-255,66,65043,96,236596
26348,0.001067,172.31.47.0-255,66,65109,96,236596
26349,0.001098,172.217.194.0-255,5379,70488,96,236596
26350,0.001102,172.31.47.0-255,66,70554,96,236596
26351,0.001698,172.217.194.0-255,1484,72038,96,236596
26352,0.001716,172.217.194.0-255,2902,74940,96,236596
26353,0.00172,172.31.47.0-255,66,75006,96,236596
26354,0.001728,172.217.194.0-255,5738,80744,96,236596
26355,0.00173,172.31.47.0-255,66,80810,96,236596
26356,0.001732,172.217.194.0-255,1484,82294,96,236596
26357,0.001753,172.217.194.0-255,2902,85196,96,236596
26358,0.001755,172.31.47.0-255,66,85262,96,236596
26359,0.001781,172.31.47.0-255,66,85328,96,236596
26360,0.001789,172.217.194.0-255,7156,92484,96,236596
26361,0.00179,172.31.47.0-255,66,92550,96,236596
26362,0.00181,172.217.194.0-255,2184,94734,96,236596
26363,0.001812,172.31.47.0-255,66,94800,96,236596
26364,0.001831,172.217.194.0-255,4320,99120,96,236596
26365,0.001834,172.31.47.0-255,66,99186,96,236596
26366,0.001863,172.217.194.0-255,4320,103506,96,236596
26367,0.001865,172.31.47.0-255,66,103572,96,236596
26368,0.001877,172.31.47.0-255,66,103638,96,236596
26369,0.001882,172.217.194.0-255,4320,107958,96,236596
26370,0.001884,172.31.47.0-255,66,108024,96,236596
26371,0.001918,172.31.47.0-255,66,108090,96,236596
26372,0.001995,172.217.194.0-255,1484,109574,96,236596
26373,0.002018,172.217.194.0-255,2902,112476,96,236596
26374,0.002022,172.31.47.0-255,66,112542,96,236596
26375,0.002028,172.217.194.0-255,5738,118280,96,236596
26376,0.00203,172.31.47.0-255,66,118346,96,236596
26377,0.002035,172.217.194.0-255,4320,122666,96,236596
26378,0.002037,172.31.47.0-255,66,122732,96,236596
26379,0.002056,172.217.194.0-255,2902,125634,96,236596
26380,0.002058,172.31.47.0-255,66,125700,96,236596
26381,0.002072,172.31.47.0-255,66,125766,96,236596
26382,0.002076,172.217.194.0-255,2184,127950,96,236596
26383,0.002078,172.31.47.0-255,66,128016,96,236596
26384,0.002255,172.217.194.0-255,1484,129500,96,236596
26385,0.002263,172.217.194.0-255,2902,132402,96,236596
26386,0.002267,172.31.47.0-255,66,132468,96,236596
26387,0.00227,172.217.194.0-255,1484,133952,96,236596
26388,0.002291,172.217.194.0-255,4320,138272,96,236596
26389,0.002293,172.31.47.0-255,66,138338,96,236596
26390,0.002296,172.217.194.0-255,1484,139822,96,236596
26391,0.002319,172.31.47.0-255,66,139888,96,236596
26392,0.002339,172.217.194.0-255,1484,141372,96,236596
26393,0.002341,172.217.194.0-255,1484,142856,96,236596
26394,0.002343,172.31.47.0-255,66,142922,96,236596
26395,0.002355,172.31.47.0-255,66,142988,96,236596
26396,0.00238,172.217.194.0-255,2902,145890,96,236596
26397,0.002383,172.31.47.0-255,66,145956,96,236596
26398,0.002404,172.31.47.0-255,66,146022,96,236596
26399,0.002414,172.217.194.0-255,4320,150342,96,236596
26400,0.002416,172.31.47.0-255,66,150408,96,236596
26401,0.002442,172.217.194.0-255,7156,157564,96,236596
26402,0.002444,172.31.47.0-255,66,157630,96,236596
26403,0.002481,172.217.194.0-255,7156,164786,96,236596
26404,0.002483,172.31.47.0-255,66,164852,96,236596
26405,0.002505,172.217.194.0-255,3602,168454,96,236596
26406,0.002508,172.31.47.0-255,66,168520,96,236596
26407,0.002688,172.217.194.0-255,1484,170004,96,236596
26408,0.002694,172.217.194.0-255,2902,172906,96,236596
26409,0.002698,172.31.47.0-255,66,172972,96,236596
26410,0.002704,172.217.194.0-255,4320,177292,96,236596
26411,0.002706,172.31.47.0-255,66,177358,96,236596
26412,0.002718,172.217.194.0-255,1484,178842,96,236596
26413,0.002749,172.31.47.0-255,66,178908,96,236596
26414,0.002751,172.217.194.0-255,1484,180392,96,236596
26415,0.002769,172.217.194.0-255,5738,186130,96,236596
26416,0.002772,172.31.47.0-255,66,186196,96,236596
26417,0.002806,172.217.194.0-255,3602,189798,96,236596
26418,0.002808,172.31.47.0-255,66,189864,96,236596
26419,0.002822,172.31.47.0-255,66,189930,96,236596
26420,0.002832,172.31.47.0-255,66,189996,96,236596
26421,0.00288,172.31.47.0-255,66,190062,96,236596
26422,0.002898,172.217.194.0-255,2184,192246,96,236596
26423,0.0029,172.31.47.0-255,66,192312,96,236596
26424,0.002916,172.31.47.0-255,66,192378,96,236596
26425,0.002928,172.31.47.0-255,66,192444,96,236596
26426,0.002966,172.31.47.0-255,66,192510,96,236596
26427,0.003629,172.217.194.0-255,1484,193994,96,236596
26428,0.003648,172.217.194.0-255,2902,196896,96,236596
26429,0.00365,172.31.47.0-255,66,196962,96,236596
26430,0.003654,172.217.194.0-255,1484,198446,96,236596
26431,0.003672,172.217.194.0-255,4320,202766,96,236596
26432,0.003675,172.31.47.0-255,66,202832,96,236596
26433,0.003681,172.217.194.0-255,5738,208570,96,236596
26434,0.003683,172.31.47.0-255,66,208636,96,236596
26435,0.00371,172.31.47.0-255,66,208702,96,236596
26436,0.00374,172.217.194.0-255,1484,210186,96,236596
26437,0.003746,172.217.194.0-255,5020,215206,96,236596
26438,0.003749,172.31.47.0-255,66,215272,96,236596
26439,0.003755,172.217.194.0-255,4320,219592,96,236596
26440,0.003757,172.31.47.0-255,66,219658,96,236596
26441,0.003782,172.217.194.0-255,1484,221142,96,236596
26442,0.003789,172.217.194.0-255,5738,226880,96,236596
26443,0.003792,172.31.47.0-255,66,226946,96,236596
26444,0.003808,172.217.194.0-255,4850,231796,96,236596
26445,0.003811,172.31.47.0-255,66,231862,96,236596
26446,0.003825,172.217.194.0-255,97,231959,96,236596
26447,0.003871,172.217.194.0-255,105,232064,96,236596
26448,0.007052,172.31.47.0-255,66,232130,96,236596
26449,0.007085,172.31.47.0-255,105,232235,96,236596
26450,0.009151,172.217.194.0-255,66,232301,96,236596
26451,0.02979,172.31.47.0-255,172,232473,96,236596
26452,0.029821,172.31.47.0-255,1110,233583,96,236596
26453,0.029872,172.31.47.0-255,1514,235097,96,236596
26454,0.029874,172.31.47.0-255,1301,236398,96,236596
26455,0.031379,104.244.42.0-255,66,236464,96,236596
26456,0.031389,104.244.42.0-255,66,236530,96,236596
26457,0.031483,104.244.42.0-255,66,236596,96,236596
26458,0.0,172.217.160.0-255,153,153,96,374066
26459,3.2e-05,172.31.47.0-255,66,219,96,374066
26460,3.9e-05,172.217.160.0-255,1484,1703,96,374066
26461,4.2e-05,172.31.47.0-255,66,1769,96,374066
26462,4.6e-05,172.217.160.0-255,2902,4671,96,374066
26463,4.8e-05,172.31.47.0-255,66,4737,96,374066
26464,5.5e-05,172.217.160.0-255,7156,11893,96,374066
26465,5.7e-05,172.31.47.0-255,66,11959,96,374066
26466,8.6e-05,172.31.47.0-255,66,12025,96,374066
26467,0.000106,172.217.160.0-255,4823,16848,96,374066
26468,0.000108,172.31.47.0-255,66,16914,96,374066
26469,0.000112,172.217.160.0-255,2543,19457,96,374066
26470,0.000114,172.31.47.0-255,66,19523,96,374066
26471,0.000192,172.217.160.0-255,1484,21007,96,374066
26472,0.000195,172.31.47.0-255,66,21073,96,374066
26473,0.0002,172.217.160.0-255,2902,23975,96,374066
26474,0.000202,172.31.47.0-255,66,24041,96,374066
26475,0.000206,172.217.160.0-255,4320,28361,96,374066
26476,0.000208,172.31.47.0-255,66,28427,96,374066
26477,0.000218,172.217.160.0-255,1484,29911,96,374066
26478,0.00022,172.31.47.0-255,66,29977,96,374066
26479,0.000226,172.217.160.0-255,5738,35715,96,374066
26480,0.000228,172.31.47.0-255,66,35781,96,374066
26481,0.000258,172.217.160.0-255,1125,36906,96,374066
26482,0.00026,172.31.47.0-255,66,36972,96,374066
26483,0.00043,172.217.160.0-255,1484,38456,96,374066
26484,0.000434,172.31.47.0-255,66,38522,96,374066
26485,0.000439,172.217.160.0-255,2902,41424,96,374066
26486,0.00044,172.31.47.0-255,66,41490,96,374066
26487,0.000443,172.217.160.0-255,1484,42974,96,374066
26488,0.000445,172.31.47.0-255,66,43040,96,374066
26489,0.000469,172.217.160.0-255,4320,47360,96,374066
26490,0.000472,172.31.47.0-255,66,47426,96,374066
26491,0.000486,172.217.160.0-255,2902,50328,96,374066
26492,0.000489,172.31.47.0-255,66,50394,96,374066
26493,0.000511,172.217.160.0-255,4229,54623,96,374066
26494,0.000513,172.31.47.0-255,66,54689,96,374066
26495,0.000744,172.217.160.0-255,125,54814,96,374066
26496,0.000857,172.217.160.0-255,1484,56298,96,374066
26497,0.000861,172.31.47.0-255,66,56364,96,374066
26498,0.000867,172.217.160.0-255,2902,59266,96,374066
26499,0.000869,172.31.47.0-255,66,59332,96,374066
26500,0.000883,172.217.160.0-255,5738,65070,96,374066
26501,0.000886,172.31.47.0-255,66,65136,96,374066
26502,0.000918,172.217.160.0-255,2902,68038,96,374066
26503,0.000921,172.31.47.0-255,66,68104,96,374066
26504,0.000941,172.217.160.0-255,3961,72065,96,374066
26505,0.000944,172.31.47.0-255,66,72131,96,374066
26506,0.000954,172.31.47.0-255,66,72197,96,374066
26507,0.000997,172.217.160.0-255,5738,77935,96,374066
26508,0.001,172.31.47.0-255,66,78001,96,374066
26509,0.001016,172.217.160.0-255,2543,80544,96,374066
26510,0.001018,172.31.47.0-255,66,80610,96,374066
26511,0.001145,172.217.160.0-255,1484,82094,96,374066
26512,0.001151,172.217.160.0-255,2902,84996,96,374066
26513,0.001154,172.31.47.0-255,66,85062,96,374066
26514,0.001158,172.217.160.0-255,1484,86546,96,374066
26515,0.001175,172.217.160.0-255,4320,90866,96,374066
26516,0.001177,172.31.47.0-255,66,90932,96,374066
26517,0.001184,172.217.160.0-255,5738,96670,96,374066
26518,0.001186,172.31.47.0-255,66,96736,96,374066
26519,0.001203,172.217.160.0-255,7156,103892,96,374066
26520,0.001206,172.31.47.0-255,66,103958,96,374066
26521,0.001216,172.31.47.0-255,66,104024,96,374066
26522,0.001258,172.217.160.0-255,766,104790,96,374066
26523,0.001309,172.217.160.0-255,1484,106274,96,374066
26524,0.001314,172.31.47.0-255,66,106340,96,374066
26525,0.001319,172.217.160.0-255,2902,109242,96,374066
26526,0.001323,172.31.47.0-255,66,109308,96,374066
26527,0.001328,172.217.160.0-255,5738,115046,96,374066
26528,0.001329,172.31.47.0-255,66,115112,96,374066
26529,0.001349,172.217.160.0-255,1484,116596,96,374066
26530,0.00136,172.217.160.0-255,4320,120916,96,374066
26531,0.001362,172.31.47.0-255,66,120982,96,374066
26532,0.001382,172.217.160.0-255,7156,128138,96,374066
26533,0.001384,172.31.47.0-255,66,128204,96,374066
26534,0.001392,172.31.47.0-255,66,128270,96,374066
26535,0.001414,172.217.160.0-255,2184,130454,96,374066
26536,0.001415,172.31.47.0-255,66,130520,96,374066
26537,0.003032,172.217.160.0-255,2902,133422,96,374066
26538,0.003034,172.31.47.0-255,66,133488,96,374066
26539,0.003057,172.217.160.0-255,2902,136390,96,374066
26540,0.003059,172.31.47.0-255,66,136456,96,374066
26541,0.004681,172.217.160.0-255,2902,139358,96,374066
26542,0.004684,172.31.47.0-255,66,139424,96,374066
26543,0.0047,172.217.160.0-255,2902,142326,96,374066
26544,0.004703,172.31.47.0-255,66,142392,96,374066
26545,0.006351,172.217.160.0-255,2902,145294,96,374066
26546,0.006357,172.31.47.0-255,66,145360,96,374066
26547,0.006377,172.217.160.0-255,2902,148262,96,374066
26548,0.00638,172.31.47.0-255,66,148328,96,374066
26549,0.008009,172.217.160.0-255,2902,151230,96,374066
26550,0.008016,172.31.47.0-255,66,151296,96,374066
26551,0.008038,172.217.160.0-255,2902,154198,96,374066
26552,0.008041,172.31.47.0-255,66,154264,96,374066
26553,0.009673,172.217.160.0-255,2902,157166,96,374066
26554,0.00968,172.31.47.0-255,66,157232,96,374066
26555,0.009699,172.217.160.0-255,2902,160134,96,374066
26556,0.009702,172.31.47.0-255,66,160200,96,374066
26557,0.011333,172.217.160.0-255,2902,163102,96,374066
26558,0.01134,172.31.47.0-255,66,163168,96,374066
26559,0.01136,172.217.160.0-255,2902,166070,96,374066
26560,0.011363,172.31.47.0-255,66,166136,96,374066
26561,0.013042,172.217.160.0-255,5738,171874,96,374066
26562,0.013054,172.31.47.0-255,66,171940,96,374066
26563,0.014719,172.217.160.0-255,5738,177678,96,374066
26564,0.014727,172.31.47.0-255,66,177744,96,374066
26565,0.016385,172.217.160.0-255,5738,183482,96,374066
26566,0.016394,172.31.47.0-255,66,183548,96,374066
26567,0.018052,172.217.160.0-255,5738,189286,96,374066
26568,0.018059,172.31.47.0-255,66,189352,96,374066
26569,0.019711,172.217.160.0-255,5738,195090,96,374066
26570,0.019718,172.31.47.0-255,66,195156,96,374066
26571,0.021367,172.217.160.0-255,4320,199476,96,374066
26572,0.021373,172.31.47.0-255,66,199542,96,374066
26573,0.0214,172.217.160.0-255,1484,201026,96,374066
26574,0.023032,172.217.160.0-255,4320,205346,96,374066
26575,0.023039,172.31.47.0-255,66,205412,96,374066
26576,0.024696,172.217.160.0-255,5738,211150,96,374066
26577,0.024703,172.31.47.0-255,66,211216,96,374066
26578,0.026375,172.217.160.0-255,5738,216954,96,374066
26579,0.026382,172.31.47.0-255,66,217020,96,374066
26580,0.028032,172.217.160.0-255,5738,222758,96,374066
26581,0.028038,172.31.47.0-255,66,222824,96,374066
26582,0.028388,172.31.47.0-255,171,222995,96,374066
26583,0.028415,172.31.47.0-255,1133,224128,96,374066
26584,0.028448,172.31.47.0-255,1514,225642,96,374066
26585,0.028449,172.31.47.0-255,1278,226920,96,374066
26586,0.029701,172.217.160.0-255,5738,232658,96,374066
26587,0.029707,172.31.47.0-255,66,232724,96,374066
26588,0.02992,104.244.42.0-255,66,232790,96,374066
26589,0.029977,104.244.42.0-255,66,232856,96,374066
26590,0.030027,104.244.42.0-255,66,232922,96,374066
26591,0.031381,172.217.160.0-255,5738,238660,96,374066
26592,0.031386,172.31.47.0-255,66,238726,96,374066
26593,0.033049,172.217.160.0-255,5738,244464,96,374066
26594,0.033057,172.31.47.0-255,66,244530,96,374066
26595,0.034735,172.217.160.0-255,5738,250268,96,374066
26596,0.034741,172.31.47.0-255,66,250334,96,374066
26597,0.036396,172.217.160.0-255,5738,256072,96,374066
26598,0.036402,172.31.47.0-255,66,256138,96,374066
26599,0.038059,172.217.160.0-255,5738,261876,96,374066
26600,0.038067,172.31.47.0-255,66,261942,96,374066
26601,0.039721,172.217.160.0-255,5738,267680,96,374066
26602,0.039726,172.31.47.0-255,66,267746,96,374066
26603,0.041375,172.217.160.0-255,5738,273484,96,374066
26604,0.041379,172.31.47.0-255,66,273550,96,374066
26605,0.043035,172.217.160.0-255,5738,279288,96,374066
26606,0.043039,172.31.47.0-255,66,279354,96,374066
26607,0.044695,172.217.160.0-255,5738,285092,96,374066
26608,0.044698,172.31.47.0-255,66,285158,96,374066
26609,0.046354,172.217.160.0-255,5738,290896,96,374066
26610,0.04636,172.31.47.0-255,66,290962,96,374066
26611,0.048004,172.217.160.0-255,2902,293864,96,374066
26612,0.048008,172.31.47.0-255,66,293930,96,374066
26613,0.048037,172.217.160.0-255,2902,296832,96,374066
26614,0.04804,172.31.47.0-255,66,296898,96,374066
26615,0.049666,172.217.160.0-255,2902,299800,96,374066
26616,0.049672,172.31.47.0-255,66,299866,96,374066
26617,0.0497,172.217.160.0-255,2902,302768,96,374066
26618,0.049702,172.31.47.0-255,66,302834,96,374066
26619,0.051357,172.217.160.0-255,2902,305736,96,374066
26620,0.051362,172.31.47.0-255,66,305802,96,374066
26621,0.051384,172.217.160.0-255,2902,308704,96,374066
26622,0.051387,172.31.47.0-255,66,308770,96,374066
26623,0.053016,172.217.160.0-255,2902,311672,96,374066
26624,0.053021,172.31.47.0-255,66,311738,96,374066
26625,0.053047,172.217.160.0-255,2902,314640,96,374066
26626,0.053049,172.31.47.0-255,66,314706,96,374066
26627,0.054673,172.217.160.0-255,2902,317608,96,374066
26628,0.054678,172.31.47.0-255,66,317674,96,374066
26629,0.054708,172.217.160.0-255,2902,320576,96,374066
26630,0.054711,172.31.47.0-255,66,320642,96,374066
26631,0.056343,172.217.160.0-255,2902,323544,96,374066
26632,0.05635,172.31.47.0-255,66,323610,96,374066
26633,0.05637,172.217.160.0-255,2902,326512,96,374066
26634,0.056373,172.31.47.0-255,66,326578,96,374066
26635,0.058007,172.217.160.0-255,2902,329480,96,374066
26636,0.058015,172.31.47.0-255,66,329546,96,374066
26637,0.058052,172.217.160.0-255,2902,332448,96,374066
26638,0.058055,172.31.47.0-255,66,332514,96,374066
26639,0.059671,172.217.160.0-255,2902,335416,96,374066
26640,0.05968,172.31.47.0-255,66,335482,96,374066
26641,0.059701,172.217.160.0-255,2902,338384,96,374066
26642,0.059704,172.31.47.0-255,66,338450,96,374066
26643,0.061347,172.217.160.0-255,2902,341352,96,374066
26644,0.061355,172.31.47.0-255,66,341418,96,374066
26645,0.061375,172.217.160.0-255,2902,344320,96,374066
26646,0.06138,172.31.47.0-255,66,344386,96,374066
26647,0.06304,172.217.160.0-255,2902,347288,96,374066
26648,0.063049,172.31.47.0-255,66,347354,96,374066
26649,0.063069,172.217.160.0-255,2902,350256,96,374066
26650,0.063071,172.31.47.0-255,66,350322,96,374066
26651,0.064704,172.217.160.0-255,2902,353224,96,374066
26652,0.06471,172.31.47.0-255,66,353290,96,374066
26653,0.064749,172.217.160.0-255,2902,356192,96,374066
26654,0.064754,172.31.47.0-255,66,356258,96,374066
26655,0.06641,172.217.160.0-255,2902,359160,96,374066
26656,0.066419,172.31.47.0-255,66,359226,96,374066
26657,0.066456,172.217.160.0-255,2902,362128,96,374066
26658,0.06646,172.31.47.0-255,66,362194,96,374066
26659,0.068069,172.217.160.0-255,2902,365096,96,374066
26660,0.068075,172.31.47.0-255,66,365162,96,374066
26661,0.068113,172.217.160.0-255,2902,368064,96,374066
26662,0.068117,172.31.47.0-255,66,368130,96,374066
26663,0.069748,172.217.160.0-255,2902,371032,96,374066
26664,0.069754,172.31.47.0-255,66,371098,96,374066
26665,0.069788,172.217.160.0-255,2902,374000,96,374066
26666,0.06979,172.31.47.0-255,66,374066,96,374066
26667,0.0,74.125.24.0-255,153,153,96,341778
26668,3.2e-05,172.31.47.0-255,66,219,96,341778
26669,3.9e-05,74.125.24.0-255,1484,1703,96,341778
26670,4.3e-05,172.31.47.0-255,66,1769,96,341778
26671,4.8e-05,74.125.24.0-255,2902,4671,96,341778
26672,5.1e-05,172.31.47.0-255,66,4737,96,341778
26673,5.8e-05,74.125.24.0-255,7156,11893,96,341778
26674,6.1e-05,172.31.47.0-255,66,11959,96,341778
26675,8.6e-05,74.125.24.0-255,2208,14167,96,341778
26676,8.9e-05,172.31.47.0-255,66,14233,96,341778
26677,0.000142,74.125.24.0-255,1484,15717,96,341778
26678,0.000145,172.31.47.0-255,66,15783,96,341778
26679,0.000166,74.125.24.0-255,2902,18685,96,341778
26680,0.000171,172.31.47.0-255,66,18751,96,341778
26681,0.000177,74.125.24.0-255,5738,24489,96,341778
26682,0.000179,172.31.47.0-255,66,24555,96,341778
26683,0.000183,74.125.24.0-255,2902,27457,96,341778
26684,0.000185,172.31.47.0-255,66,27523,96,341778
26685,0.000205,74.125.24.0-255,3961,31484,96,341778
26686,0.000209,172.31.47.0-255,66,31550,96,341778
26687,0.000297,74.125.24.0-255,1484,33034,96,341778
26688,0.000301,172.31.47.0-255,66,33100,96,341778
26689,0.000307,74.125.24.0-255,2902,36002,96,341778
26690,0.000309,172.31.47.0-255,66,36068,96,341778
26691,0.000314,74.125.24.0-255,2902,38970,96,341778
26692,0.000316,172.31.47.0-255,66,39036,96,341778
26693,0.000347,74.125.24.0-255,2902,41938,96,341778
26694,0.00035,172.31.47.0-255,66,42004,96,341778
26695,0.000356,74.125.24.0-255,6797,48801,96,341778
26696,0.000359,172.31.47.0-255,66,48867,96,341778
26697,0.000364,74.125.24.0-255,4320,53187,96,341778
26698,0.000366,172.31.47.0-255,66,53253,96,341778
26699,0.000396,172.31.47.0-255,66,53319,96,341778
26700,0.000403,74.125.24.0-255,2543,55862,96,341778
26701,0.000405,172.31.47.0-255,66,55928,96,341778
26702,0.000911,74.125.24.0-255,397,56325,96,341778
26703,0.000947,74.125.24.0-255,1484,57809,96,341778
26704,0.000951,172.31.47.0-255,66,57875,96,341778
26705,0.000958,74.125.24.0-255,4320,62195,96,341778
26706,0.00096,172.31.47.0-255,66,62261,96,341778
26707,0.000973,74.125.24.0-255,1484,63745,96,341778
26708,0.000997,172.31.47.0-255,66,63811,96,341778
26709,0.001,74.125.24.0-255,1484,65295,96,341778
26710,0.001019,172.31.47.0-255,66,65361,96,341778
26711,0.001039,74.125.24.0-255,2902,68263,96,341778
26712,0.001041,172.31.47.0-255,66,68329,96,341778
26713,0.001046,74.125.24.0-255,3602,71931,96,341778
26714,0.001047,172.31.47.0-255,66,71997,96,341778
26715,0.001332,74.125.24.0-255,1484,73481,96,341778
26716,0.001347,74.125.24.0-255,2902,76383,96,341778
26717,0.00135,172.31.47.0-255,66,76449,96,341778
26718,0.001354,74.125.24.0-255,2902,79351,96,341778
26719,0.001355,172.31.47.0-255,66,79417,96,341778
26720,0.00137,74.125.24.0-255,2902,82319,96,341778
26721,0.001372,172.31.47.0-255,66,82385,96,341778
26722,0.001376,74.125.24.0-255,4320,86705,96,341778
26723,0.001378,172.31.47.0-255,66,86771,96,341778
26724,0.001403,172.31.47.0-255,66,86837,96,341778
26725,0.001413,172.31.47.0-255,66,86903,96,341778
26726,0.001453,74.125.24.0-255,2902,89805,96,341778
26727,0.001454,172.31.47.0-255,66,89871,96,341778
26728,0.001487,172.31.47.0-255,66,89937,96,341778
26729,0.001524,74.125.24.0-255,2902,92839,96,341778
26730,0.001525,172.31.47.0-255,66,92905,96,341778
26731,0.001547,74.125.24.0-255,6438,99343,96,341778
26732,0.001549,172.31.47.0-255,66,99409,96,341778
26733,0.001636,74.125.24.0-255,1484,100893,96,341778
26734,0.001661,74.125.24.0-255,2902,103795,96,341778
26735,0.001663,172.31.47.0-255,66,103861,96,341778
26736,0.001695,74.125.24.0-255,5738,109599,96,341778
26737,0.001697,172.31.47.0-255,66,109665,96,341778
26738,0.001724,74.125.24.0-255,1484,111149,96,341778
26739,0.001739,74.125.24.0-255,2902,114051,96,341778
26740,0.001741,172.31.47.0-255,66,114117,96,341778
26741,0.001755,74.125.24.0-255,1484,115601,96,341778
26742,0.001774,74.125.24.0-255,4320,119921,96,341778
26743,0.001776,172.31.47.0-255,66,119987,96,341778
26744,0.00178,74.125.24.0-255,4320,124307,96,341778
26745,0.001782,172.31.47.0-255,66,124373,96,341778
26746,0.001821,74.125.24.0-255,2902,127275,96,341778
26747,0.001822,172.31.47.0-255,66,127341,96,341778
26748,0.001841,74.125.24.0-255,6438,133779,96,341778
26749,0.001843,172.31.47.0-255,66,133845,96,341778
26750,0.001887,74.125.24.0-255,1484,135329,96,341778
26751,0.001902,74.125.24.0-255,2902,138231,96,341778
26752,0.001905,172.31.47.0-255,66,138297,96,341778
26753,0.001916,74.125.24.0-255,1484,139781,96,341778
26754,0.001931,74.125.24.0-255,2902,142683,96,341778
26755,0.001932,172.31.47.0-255,66,142749,96,341778
26756,0.001979,74.125.24.0-255,4320,147069,96,341778
26757,0.001982,172.31.47.0-255,66,147135,96,341778
26758,0.001993,74.125.24.0-255,4320,151455,96,341778
26759,0.001995,172.31.47.0-255,66,151521,96,341778
26760,0.001999,74.125.24.0-255,4320,155841,96,341778
26761,0.002,172.31.47.0-255,66,155907,96,341778
26762,0.002014,74.125.24.0-255,5738,161645,96,341778
26763,0.002016,172.31.47.0-255,66,161711,96,341778
26764,0.002025,74.125.24.0-255,1484,163195,96,341778
26765,0.002038,74.125.24.0-255,5020,168215,96,341778
26766,0.00204,172.31.47.0-255,66,168281,96,341778
26767,0.002166,74.125.24.0-255,1484,169765,96,341778
26768,0.002184,74.125.24.0-255,1484,171249,96,341778
26769,0.002186,172.31.47.0-255,66,171315,96,341778
26770,0.002196,74.125.24.0-255,1484,172799,96,341778
26771,0.0022,74.125.24.0-255,2902,175701,96,341778
26772,0.002202,172.31.47.0-255,66,175767,96,341778
26773,0.002214,74.125.24.0-255,2902,178669,96,341778
26774,0.002216,172.31.47.0-255,66,178735,96,341778
26775,0.002229,74.125.24.0-255,4320,183055,96,341778
26776,0.002235,172.31.47.0-255,66,183121,96,341778
26777,0.002261,74.125.24.0-255,5738,188859,96,341778
26778,0.002264,172.31.47.0-255,66,188925,96,341778
26779,0.002274,172.31.47.0-255,66,188991,96,341778
26780,0.002277,74.125.24.0-255,2184,191175,96,341778
26781,0.002279,172.31.47.0-255,66,191241,96,341778
26782,0.004565,74.125.24.0-255,5738,196979,96,341778
26783,0.004573,172.31.47.0-255,66,197045,96,341778
26784,0.00684,74.125.24.0-255,5738,202783,96,341778
26785,0.006845,172.31.47.0-255,66,202849,96,341778
26786,0.009138,74.125.24.0-255,5738,208587,96,341778
26787,0.009144,172.31.47.0-255,66,208653,96,341778
26788,0.011444,74.125.24.0-255,5738,214391,96,341778
26789,0.011451,172.31.47.0-255,66,214457,96,341778
26790,0.01372,74.125.24.0-255,5738,220195,96,341778
26791,0.013726,172.31.47.0-255,66,220261,96,341778
26792,0.016017,74.125.24.0-255,5738,225999,96,341778
26793,0.016025,172.31.47.0-255,66,226065,96,341778
26794,0.018309,74.125.24.0-255,5738,231803,96,341778
26795,0.018314,172.31.47.0-255,66,231869,96,341778
26796,0.020609,74.125.24.0-255,5738,237607,96,341778
26797,0.020616,172.31.47.0-255,66,237673,96,341778
26798,0.022132,172.31.47.0-255,172,237845,96,341778
26799,0.022159,172.31.47.0-255,1109,238954,96,341778
26800,0.022188,172.31.47.0-255,1514,240468,96,341778
26801,0.022189,172.31.47.0-255,335,240803,96,341778
26802,0.022909,74.125.24.0-255,5738,246541,96,341778
26803,0.022914,172.31.47.0-255,66,246607,96,341778
26804,0.023684,104.244.42.0-255,66,246673,96,341778
26805,0.023741,104.244.42.0-255,66,246739,96,341778
26806,0.023745,104.244.42.0-255,66,246805,96,341778
26807,0.025211,74.125.24.0-255,5738,252543,96,341778
26808,0.025216,172.31.47.0-255,66,252609,96,341778
26809,0.027499,74.125.24.0-255,4320,256929,96,341778
26810,0.027504,172.31.47.0-255,66,256995,96,341778
26811,0.02753,74.125.24.0-255,1484,258479,96,341778
26812,0.029776,74.125.24.0-255,2902,261381,96,341778
26813,0.029781,172.31.47.0-255,66,261447,96,341778
26814,0.032095,74.125.24.0-255,5738,267185,96,341778
26815,0.032101,172.31.47.0-255,66,267251,96,341778
26816,0.034427,74.125.24.0-255,5738,272989,96,341778
26817,0.034433,172.31.47.0-255,66,273055,96,341778
26818,0.036698,74.125.24.0-255,5738,278793,96,341778
26819,0.036703,172.31.47.0-255,66,278859,96,341778
26820,0.038966,74.125.24.0-255,4320,283179,96,341778
26821,0.03897,172.31.47.0-255,66,283245,96,341778
26822,0.038997,74.125.24.0-255,1484,284729,96,341778
26823,0.041253,74.125.24.0-255,4320,289049,96,341778
26824,0.041258,172.31.47.0-255,66,289115,96,341778
26825,0.043506,74.125.24.0-255,5738,294853,96,341778
26826,0.043511,172.31.47.0-255,66,294919,96,341778
26827,0.045777,74.125.24.0-255,5738,300657,96,341778
26828,0.045782,172.31.47.0-255,66,300723,96,341778
26829,0.048082,74.125.24.0-255,5738,306461,96,341778
26830,0.048087,172.31.47.0-255,66,306527,96,341778
26831,0.050354,74.125.24.0-255,5738,312265,96,341778
26832,0.050359,172.31.47.0-255,66,312331,96,341778
26833,0.05265,74.125.24.0-255,5738,318069,96,341778
26834,0.052655,172.31.47.0-255,66,318135,96,341778
26835,0.054946,74.125.24.0-255,5738,323873,96,341778
26836,0.054951,172.31.47.0-255,66,323939,96,341778
26837,0.057237,74.125.24.0-255,5738,329677,96,341778
26838,0.057241,172.31.47.0-255,66,329743,96,341778
26839,0.059503,74.125.24.0-255,5738,335481,96,341778
26840,0.059507,172.31.47.0-255,66,335547,96,341778
26841,0.061791,74.125.24.0-255,5738,341285,96,341778
26842,0.061797,172.31.47.0-255,66,341351,96,341778
26843,0.064064,74.125.24.0-255,190,341541,96,341778
26844,0.064219,172.31.47.0-255,66,341607,96,341778
26845,0.064245,172.31.47.0-255,105,341712,96,341778
26846,0.066482,74.125.24.0-255,66,341778,96,341778
26847,0.0,74.125.24.0-255,152,152,96,264202
26848,2.8e-05,172.31.47.0-255,66,218,96,264202
26849,3.5e-05,74.125.24.0-255,1484,1702,96,264202
26850,3.9e-05,172.31.47.0-255,66,1768,96,264202
26851,4.4e-05,74.125.24.0-255,2902,4670,96,264202
26852,5.4e-05,172.31.47.0-255,66,4736,96,264202
26853,6e-05,74.125.24.0-255,5738,10474,96,264202
26854,6.2e-05,172.31.47.0-255,66,10540,96,264202
26855,9e-05,74.125.24.0-255,3628,14168,96,264202
26856,9.3e-05,172.31.47.0-255,66,14234,96,264202
26857,0.000266,74.125.24.0-255,1484,15718,96,264202
26858,0.000272,172.31.47.0-255,66,15784,96,264202
26859,0.000298,74.125.24.0-255,2902,18686,96,264202
26860,0.000303,172.31.47.0-255,66,18752,96,264202
26861,0.000309,74.125.24.0-255,5738,24490,96,264202
26862,0.000311,172.31.47.0-255,66,24556,96,264202
26863,0.000357,172.31.47.0-255,66,24622,96,264202
26864,0.000369,172.31.47.0-255,66,24688,96,264202
26865,0.000412,74.125.24.0-255,5738,30426,96,264202
26866,0.000415,172.31.47.0-255,66,30492,96,264202
26867,0.000446,172.31.47.0-255,66,30558,96,264202
26868,0.000449,74.125.24.0-255,709,31267,96,264202
26869,0.000451,172.31.47.0-255,66,31333,96,264202
26870,0.000614,74.125.24.0-255,1484,32817,96,264202
26871,0.000618,172.31.47.0-255,66,32883,96,264202
26872,0.000623,74.125.24.0-255,2902,35785,96,264202
26873,0.000625,172.31.47.0-255,66,35851,96,264202
26874,0.000631,74.125.24.0-255,5738,41589,96,264202
26875,0.000638,172.31.47.0-255,66,41655,96,264202
26876,0.000664,74.125.24.0-255,7156,48811,96,264202
26877,0.000669,172.31.47.0-255,66,48877,96,264202
26878,0.000693,74.125.24.0-255,1484,50361,96,264202
26879,0.000705,172.31.47.0-255,66,50427,96,264202
26880,0.000711,74.125.24.0-255,5020,55447,96,264202
26881,0.000714,172.31.47.0-255,66,55513,96,264202
26882,0.001184,74.125.24.0-255,1484,56997,96,264202
26883,0.001193,74.125.24.0-255,2902,59899,96,264202
26884,0.001196,172.31.47.0-255,66,59965,96,264202
26885,0.001222,74.125.24.0-255,5738,65703,96,264202
26886,0.001226,172.31.47.0-255,66,65769,96,264202
26887,0.001259,172.31.47.0-255,66,65835,96,264202
26888,0.001264,74.125.24.0-255,4320,70155,96,264202
26889,0.001266,172.31.47.0-255,66,70221,96,264202
26890,0.001298,74.125.24.0-255,6438,76659,96,264202
26891,0.001302,172.31.47.0-255,66,76725,96,264202
26892,0.001356,74.125.24.0-255,1484,78209,96,264202
26893,0.001361,74.125.24.0-255,2902,81111,96,264202
26894,0.001364,172.31.47.0-255,66,81177,96,264202
26895,0.001367,74.125.24.0-255,1484,82661,96,264202
26896,0.001393,74.125.24.0-255,4320,86981,96,264202
26897,0.001395,172.31.47.0-255,66,87047,96,264202
26898,0.00142,172.31.47.0-255,66,87113,96,264202
26899,0.001424,74.125.24.0-255,4320,91433,96,264202
26900,0.001426,172.31.47.0-255,66,91499,96,264202
26901,0.001458,172.31.47.0-255,66,91565,96,264202
26902,0.001483,74.125.24.0-255,1484,93049,96,264202
26903,0.001495,74.125.24.0-255,2902,95951,96,264202
26904,0.001498,172.31.47.0-255,66,96017,96,264202
26905,0.001507,74.125.24.0-255,1484,97501,96,264202
26906,0.001526,74.125.24.0-255,4320,101821,96,264202
26907,0.001529,172.31.47.0-255,66,101887,96,264202
26908,0.001532,74.125.24.0-255,1484,103371,96,264202
26909,0.001565,172.31.47.0-255,66,103437,96,264202
26910,0.00157,74.125.24.0-255,5738,109175,96,264202
26911,0.001572,172.31.47.0-255,66,109241,96,264202
26912,0.001604,74.125.24.0-255,5020,114261,96,264202
26913,0.001607,172.31.47.0-255,66,114327,96,264202
26914,0.002106,74.125.24.0-255,1484,115811,96,264202
26915,0.002119,74.125.24.0-255,2902,118713,96,264202
26916,0.002122,172.31.47.0-255,66,118779,96,264202
26917,0.002125,74.125.24.0-255,1484,120263,96,264202
26918,0.002144,74.125.24.0-255,4320,124583,96,264202
26919,0.002147,172.31.47.0-255,66,124649,96,264202
26920,0.002151,74.125.24.0-255,2902,127551,96,264202
26921,0.002152,172.31.47.0-255,66,127617,96,264202
26922,0.002197,172.31.47.0-255,66,127683,96,264202
26923,0.002206,172.31.47.0-255,66,127749,96,264202
26924,0.002308,74.125.24.0-255,1484,129233,96,264202
26925,0.002314,74.125.24.0-255,2902,132135,96,264202
26926,0.002317,172.31.47.0-255,66,132201,96,264202
26927,0.002343,74.125.24.0-255,5738,137939,96,264202
26928,0.002346,172.31.47.0-255,66,138005,96,264202
26929,0.002388,74.125.24.0-255,2902,140907,96,264202
26930,0.002391,172.31.47.0-255,66,140973,96,264202
26931,0.002428,172.31.47.0-255,66,141039,96,264202
26932,0.002441,172.31.47.0-255,66,141105,96,264202
26933,0.002454,172.31.47.0-255,66,141171,96,264202
26934,0.002489,172.31.47.0-255,66,141237,96,264202
26935,0.004876,74.125.24.0-255,5738,146975,96,264202
26936,0.004882,172.31.47.0-255,66,147041,96,264202
26937,0.007287,74.125.24.0-255,5738,152779,96,264202
26938,0.007292,172.31.47.0-255,66,152845,96,264202
26939,0.009682,74.125.24.0-255,5738,158583,96,264202
26940,0.00969,172.31.47.0-255,66,158649,96,264202
26941,0.012096,74.125.24.0-255,5738,164387,96,264202
26942,0.012103,172.31.47.0-255,66,164453,96,264202
26943,0.014503,74.125.24.0-255,5738,170191,96,264202
26944,0.014513,172.31.47.0-255,66,170257,96,264202
26945,0.016901,74.125.24.0-255,5738,175995,96,264202
26946,0.016908,172.31.47.0-255,66,176061,96,264202
26947,0.01931,74.125.24.0-255,5738,181799,96,264202
26948,0.019317,172.31.47.0-255,66,181865,96,264202
26949,0.021733,74.125.24.0-255,5738,187603,96,264202
26950,0.021739,172.31.47.0-255,66,187669,96,264202
26951,0.024156,74.125.24.0-255,5738,193407,96,264202
26952,0.024162,172.31.47.0-255,66,193473,96,264202
26953,0.024197,172.31.47.0-255,172,193645,96,264202
26954,0.02422,172.31.47.0-255,1109,194754,96,264202
26955,0.024258,172.31.47.0-255,1514,196268,96,264202
26956,0.02426,172.31.47.0-255,1302,197570,96,264202
26957,0.025762,104.244.42.0-255,66,197636,96,264202
26958,0.025769,104.244.42.0-255,66,197702,96,264202
26959,0.02579,104.244.42.0-255,66,197768,96,264202
26960,0.026556,74.125.24.0-255,4320,202088,96,264202
26961,0.02656,172.31.47.0-255,66,202154,96,264202
26962,0.026586,74.125.24.0-255,1484,203638,96,264202
26963,0.02893,74.125.24.0-255,4320,207958,96,264202
26964,0.028935,172.31.47.0-255,66,208024,96,264202
26965,0.031321,74.125.24.0-255,5738,213762,96,264202
26966,0.031326,172.31.47.0-255,66,213828,96,264202
26967,0.033712,74.125.24.0-255,2902,216730,96,264202
26968,0.033717,172.31.47.0-255,66,216796,96,264202
26969,0.033748,74.125.24.0-255,2902,219698,96,264202
26970,0.03375,172.31.47.0-255,66,219764,96,264202
26971,0.036115,74.125.24.0-255,2902,222666,96,264202
26972,0.036119,172.31.47.0-255,66,222732,96,264202
26973,0.036149,74.125.24.0-255,2902,225634,96,264202
26974,0.036152,172.31.47.0-255,66,225700,96,264202
26975,0.038507,74.125.24.0-255,2902,228602,96,264202
26976,0.038512,172.31.47.0-255,66,228668,96,264202
26977,0.038542,74.125.24.0-255,2902,231570,96,264202
26978,0.038545,172.31.47.0-255,66,231636,96,264202
26979,0.040916,74.125.24.0-255,2902,234538,96,264202
26980,0.04092,172.31.47.0-255,66,234604,96,264202
26981,0.040947,74.125.24.0-255,2902,237506,96,264202
26982,0.04095,172.31.47.0-255,66,237572,96,264202
26983,0.04332,74.125.24.0-255,2902,240474,96,264202
26984,0.043325,172.31.47.0-255,66,240540,96,264202
26985,0.043354,74.125.24.0-255,2902,243442,96,264202
26986,0.043356,172.31.47.0-255,66,243508,96,264202
26987,0.04571,74.125.24.0-255,2902,246410,96,264202
26988,0.045715,172.31.47.0-255,66,246476,96,264202
26989,0.045755,74.125.24.0-255,1484,247960,96,264202
26990,0.04577,74.125.24.0-255,1484,249444,96,264202
26991,0.045773,172.31.47.0-255,66,249510,96,264202
26992,0.048134,74.125.24.0-255,2902,252412,96,264202
26993,0.048139,172.31.47.0-255,66,252478,96,264202
26994,0.048158,74.125.24.0-255,2902,255380,96,264202
26995,0.04816,172.31.47.0-255,66,255446,96,264202
26996,0.050514,74.125.24.0-255,2902,258348,96,264202
26997,0.050521,172.31.47.0-255,66,258414,96,264202
26998,0.050551,74.125.24.0-255,2902,261316,96,264202
26999,0.050554,172.31.47.0-255,66,261382,96,264202
27000,0.052911,74.125.24.0-255,2583,263965,96,264202
27001,0.052916,172.31.47.0-255,66,264031,96,264202
27002,0.053058,172.31.47.0-255,105,264136,96,264202
27003,0.055442,74.125.24.0-255,66,264202,96,264202
27004,0.0,172.31.47.0-255,105,105,96,105
27005,0.0,74.125.68.0-255,153,153,96,315315
27006,2.6e-05,172.31.47.0-255,66,219,96,315315
27007,3.2e-05,74.125.68.0-255,1484,1703,96,315315
27008,3.7e-05,172.31.47.0-255,66,1769,96,315315
27009,4.3e-05,74.125.68.0-255,2902,4671,96,315315
27010,4.7e-05,172.31.47.0-255,66,4737,96,315315
27011,5e-05,74.125.68.0-255,1484,6221,96,315315
27012,5.4e-05,172.31.47.0-255,66,6287,96,315315
27013,7.9e-05,74.125.68.0-255,4320,10607,96,315315
27014,8.2e-05,172.31.47.0-255,66,10673,96,315315
27015,9.8e-05,74.125.68.0-255,1484,12157,96,315315
27016,0.0001,172.31.47.0-255,66,12223,96,315315
27017,0.000117,74.125.68.0-255,1946,14169,96,315315
27018,0.00012,172.31.47.0-255,66,14235,96,315315
27019,0.000259,74.125.68.0-255,1484,15719,96,315315
27020,0.000264,172.31.47.0-255,66,15785,96,315315
27021,0.000298,74.125.68.0-255,1484,17269,96,315315
27022,0.0003,172.31.47.0-255,66,17335,96,315315
27023,0.000314,74.125.68.0-255,2902,20237,96,315315
27024,0.000317,172.31.47.0-255,66,20303,96,315315
27025,0.000335,74.125.68.0-255,2902,23205,96,315315
27026,0.000337,172.31.47.0-255,66,23271,96,315315
27027,0.000362,74.125.68.0-255,2902,26173,96,315315
27028,0.000365,172.31.47.0-255,66,26239,96,315315
27029,0.000368,74.125.68.0-255,1484,27723,96,315315
27030,0.00037,172.31.47.0-255,66,27789,96,315315
27031,0.000374,74.125.68.0-255,2902,30691,96,315315
27032,0.000376,172.31.47.0-255,66,30757,96,315315
27033,0.000379,74.125.68.0-255,1125,31882,96,315315
27034,0.000381,172.31.47.0-255,66,31948,96,315315
27035,0.000443,74.125.68.0-255,1484,33432,96,315315
27036,0.000446,172.31.47.0-255,66,33498,96,315315
27037,0.000473,74.125.68.0-255,2902,36400,96,315315
27038,0.000476,172.31.47.0-255,66,36466,96,315315
27039,0.000494,74.125.68.0-255,1484,37950,96,315315
27040,0.00051,74.125.68.0-255,2902,40852,96,315315
27041,0.000513,172.31.47.0-255,66,40918,96,315315
27042,0.000536,74.125.68.0-255,5738,46656,96,315315
27043,0.00054,74.125.68.0-255,2543,49199,96,315315
27044,0.000544,172.31.47.0-255,66,49265,96,315315
27045,0.000547,172.31.47.0-255,66,49331,96,315315
27046,0.001404,74.125.68.0-255,1484,50815,96,315315
27047,0.001417,74.125.68.0-255,2902,53717,96,315315
27048,0.001421,172.31.47.0-255,66,53783,96,315315
27049,0.001447,74.125.68.0-255,1484,55267,96,315315
27050,0.001465,74.125.68.0-255,4320,59587,96,315315
27051,0.001468,172.31.47.0-255,66,59653,96,315315
27052,0.001474,74.125.68.0-255,5738,65391,96,315315
27053,0.001476,172.31.47.0-255,66,65457,96,315315
27054,0.001491,74.125.68.0-255,1125,66582,96,315315
27055,0.001769,74.125.68.0-255,1484,68066,96,315315
27056,0.001775,172.31.47.0-255,66,68132,96,315315
27057,0.001782,74.125.68.0-255,2902,71034,96,315315
27058,0.001784,172.31.47.0-255,66,71100,96,315315
27059,0.0018,74.125.68.0-255,4320,75420,96,315315
27060,0.001802,172.31.47.0-255,66,75486,96,315315
27061,0.001813,74.125.68.0-255,1484,76970,96,315315
27062,0.001817,74.125.68.0-255,2902,79872,96,315315
27063,0.00182,172.31.47.0-255,66,79938,96,315315
27064,0.001824,74.125.68.0-255,2902,82840,96,315315
27065,0.001826,172.31.47.0-255,66,82906,96,315315
27066,0.001852,74.125.68.0-255,7156,90062,96,315315
27067,0.001854,172.31.47.0-255,66,90128,96,315315
27068,0.00186,74.125.68.0-255,5738,95866,96,315315
27069,0.001862,172.31.47.0-255,66,95932,96,315315
27070,0.00188,74.125.68.0-255,4320,100252,96,315315
27071,0.001884,172.31.47.0-255,66,100318,96,315315
27072,0.001906,74.125.68.0-255,766,101084,96,315315
27073,0.001918,74.125.68.0-255,1484,102568,96,315315
27074,0.001921,172.31.47.0-255,66,102634,96,315315
27075,0.001933,74.125.68.0-255,1484,104118,96,315315
27076,0.001952,74.125.68.0-255,2902,107020,96,315315
27077,0.001954,172.31.47.0-255,66,107086,96,315315
27078,0.001958,74.125.68.0-255,2902,109988,96,315315
27079,0.001961,172.31.47.0-255,66,110054,96,315315
27080,0.00198,74.125.68.0-255,5738,115792,96,315315
27081,0.001983,172.31.47.0-255,66,115858,96,315315
27082,0.003913,74.125.68.0-255,2902,118760,96,315315
27083,0.003916,172.31.47.0-255,66,118826,96,315315
27084,0.003935,74.125.68.0-255,2902,121728,96,315315
27085,0.003938,172.31.47.0-255,66,121794,96,315315
27086,0.005846,74.125.68.0-255,2902,124696,96,315315
27087,0.005852,172.31.47.0-255,66,124762,96,315315
27088,0.005874,74.125.68.0-255,2902,127664,96,315315
27089,0.005876,172.31.47.0-255,66,127730,96,315315
27090,0.007781,74.125.68.0-255,2902,130632,96,315315
27091,0.007789,172.31.47.0-255,66,130698,96,315315
27092,0.00781,74.125.68.0-255,2902,133600,96,315315
27093,0.007813,172.31.47.0-255,66,133666,96,315315
27094,0.009723,74.125.68.0-255,2902,136568,96,315315
27095,0.009729,172.31.47.0-255,66,136634,96,315315
27096,0.009751,74.125.68.0-255,2902,139536,96,315315
27097,0.009754,172.31.47.0-255,66,139602,96,315315
27098,0.011661,74.125.68.0-255,4320,143922,96,315315
27099,0.011668,172.31.47.0-255,66,143988,96,315315
27100,0.011688,74.125.68.0-255,1484,145472,96,315315
27101,0.013607,74.125.68.0-255,4320,149792,96,315315
27102,0.013615,172.31.47.0-255,66,149858,96,315315
27103,0.015548,74.125.68.0-255,5738,155596,96,315315
27104,0.015555,172.31.47.0-255,66,155662,96,315315
27105,0.017488,74.125.68.0-255,5738,161400,96,315315
27106,0.017495,172.31.47.0-255,66,161466,96,315315
27107,0.019433,74.125.68.0-255,5738,167204,96,315315
27108,0.019439,172.31.47.0-255,66,167270,96,315315
27109,0.02138,74.125.68.0-255,5738,173008,96,315315
27110,0.021389,172.31.47.0-255,66,173074,96,315315
27111,0.02333,74.125.68.0-255,5738,178812,96,315315
27112,0.023338,172.31.47.0-255,66,178878,96,315315
27113,0.024619,172.31.47.0-255,172,179050,96,315315
27114,0.024646,172.31.47.0-255,1109,180159,96,315315
27115,0.024698,172.31.47.0-255,1514,181673,96,315315
27116,0.024699,172.31.47.0-255,1304,182977,96,315315
27117,0.025265,74.125.68.0-255,5738,188715,96,315315
27118,0.025272,172.31.47.0-255,66,188781,96,315315
27119,0.026103,104.244.42.0-255,66,188847,96,315315
27120,0.026282,104.244.42.0-255,66,188913,96,315315
27121,0.026286,104.244.42.0-255,66,188979,96,315315
27122,0.027202,74.125.68.0-255,5738,194717,96,315315
27123,0.027209,172.31.47.0-255,66,194783,96,315315
27124,0.029141,74.125.68.0-255,4320,199103,96,315315
27125,0.029146,172.31.47.0-255,66,199169,96,315315
27126,0.02916,74.125.68.0-255,1484,200653,96,315315
27127,0.031087,74.125.68.0-255,4320,204973,96,315315
27128,0.031093,172.31.47.0-255,66,205039,96,315315
27129,0.033034,74.125.68.0-255,5738,210777,96,315315
27130,0.03304,172.31.47.0-255,66,210843,96,315315
27131,0.034982,74.125.68.0-255,5738,216581,96,315315
27132,0.034987,172.31.47.0-255,66,216647,96,315315
27133,0.036923,74.125.68.0-255,5738,222385,96,315315
27134,0.036928,172.31.47.0-255,66,222451,96,315315
27135,0.038877,74.125.68.0-255,5738,228189,96,315315
27136,0.038882,172.31.47.0-255,66,228255,96,315315
27137,0.040827,74.125.68.0-255,5738,233993,96,315315
27138,0.040834,172.31.47.0-255,66,234059,96,315315
27139,0.042768,74.125.68.0-255,5738,239797,96,315315
27140,0.042774,172.31.47.0-255,66,239863,96,315315
27141,0.044755,74.125.68.0-255,5738,245601,96,315315
27142,0.044762,172.31.47.0-255,66,245667,96,315315
27143,0.046689,74.125.68.0-255,5738,251405,96,315315
27144,0.046694,172.31.47.0-255,66,251471,96,315315
27145,0.04863,74.125.68.0-255,5738,257209,96,315315
27146,0.048637,172.31.47.0-255,66,257275,96,315315
27147,0.050565,74.125.68.0-255,5738,263013,96,315315
27148,0.050571,172.31.47.0-255,66,263079,96,315315
27149,0.052506,74.125.68.0-255,5738,268817,96,315315
27150,0.052511,172.31.47.0-255,66,268883,96,315315
27151,0.054446,74.125.68.0-255,5738,274621,96,315315
27152,0.054452,172.31.47.0-255,66,274687,96,315315
27153,0.056399,74.125.68.0-255,5738,280425,96,315315
27154,0.056408,172.31.47.0-255,66,280491,96,315315
27155,0.058346,74.125.68.0-255,5738,286229,96,315315
27156,0.058353,172.31.47.0-255,66,286295,96,315315
27157,0.060287,74.125.68.0-255,5738,292033,96,315315
27158,0.060292,172.31.47.0-255,66,292099,96,315315
27159,0.062242,74.125.68.0-255,5738,297837,96,315315
27160,0.062249,172.31.47.0-255,66,297903,96,315315
27161,0.064185,74.125.68.0-255,5738,303641,96,315315
27162,0.064192,172.31.47.0-255,66,303707,96,315315
27163,0.06613,74.125.68.0-255,5738,309445,96,315315
27164,0.066137,172.31.47.0-255,66,309511,96,315315
27165,0.068066,74.125.68.0-255,5738,315249,96,315315
27166,0.068072,172.31.47.0-255,66,315315,96,315315
27167,0.0,172.217.194.0-255,157,157,96,306609
27168,2.5e-05,172.31.47.0-255,66,223,96,306609
27169,3e-05,172.217.194.0-255,1484,1707,96,306609
27170,3.3e-05,172.31.47.0-255,66,1773,96,306609
27171,4.8e-05,172.217.194.0-255,2902,4675,96,306609
27172,5e-05,172.31.47.0-255,66,4741,96,306609
27173,7.7e-05,172.217.194.0-255,5738,10479,96,306609
27174,8e-05,172.31.47.0-255,66,10545,96,306609
27175,0.0001,172.217.194.0-255,5002,15547,96,306609
27176,0.000103,172.31.47.0-255,66,15613,96,306609
27177,0.000128,172.31.47.0-255,66,15679,96,306609
27178,0.000149,172.217.194.0-255,2902,18581,96,306609
27179,0.000151,172.31.47.0-255,66,18647,96,306609
27180,0.000155,172.217.194.0-255,2543,21190,96,306609
27181,0.000157,172.31.47.0-255,66,21256,96,306609
27182,0.00018,172.217.194.0-255,2902,24158,96,306609
27183,0.000183,172.31.47.0-255,66,24224,96,306609
27184,0.000197,172.217.194.0-255,1484,25708,96,306609
27185,0.000199,172.31.47.0-255,66,25774,96,306609
27186,0.000219,172.217.194.0-255,2902,28676,96,306609
27187,0.000222,172.31.47.0-255,66,28742,96,306609
27188,0.000231,172.31.47.0-255,66,28808,96,306609
27189,0.000261,172.217.194.0-255,1484,30292,96,306609
27190,0.000264,172.31.47.0-255,66,30358,96,306609
27191,0.00029,172.31.47.0-255,66,30424,96,306609
27192,0.000304,172.217.194.0-255,1484,31908,96,306609
27193,0.000307,172.31.47.0-255,66,31974,96,306609
27194,0.00032,172.217.194.0-255,5269,37243,96,306609
27195,0.000323,172.31.47.0-255,66,37309,96,306609
27196,0.000326,172.217.194.0-255,121,37430,96,306609
27197,0.000327,172.217.194.0-255,381,37811,96,306609
27198,0.000384,172.217.194.0-255,1484,39295,96,306609
27199,0.000389,172.31.47.0-255,66,39361,96,306609
27200,0.000398,172.217.194.0-255,2902,42263,96,306609
27201,0.0004,172.31.47.0-255,66,42329,96,306609
27202,0.000424,172.217.194.0-255,5738,48067,96,306609
27203,0.000427,172.31.47.0-255,66,48133,96,306609
27204,0.000452,172.217.194.0-255,4320,52453,96,306609
27205,0.000455,172.31.47.0-255,66,52519,96,306609
27206,0.000472,172.217.194.0-255,1995,54514,96,306609
27207,0.000475,172.31.47.0-255,66,54580,96,306609
27208,0.000684,172.217.194.0-255,1484,56064,96,306609
27209,0.000701,172.217.194.0-255,2902,58966,96,306609
27210,0.000704,172.31.47.0-255,66,59032,96,306609
27211,0.000724,172.217.194.0-255,4320,63352,96,306609
27212,0.000727,172.31.47.0-255,66,63418,96,306609
27213,0.000743,172.217.194.0-255,1484,64902,96,306609
27214,0.00075,172.217.194.0-255,7156,72058,96,306609
27215,0.000752,172.31.47.0-255,66,72124,96,306609
27216,0.000769,172.217.194.0-255,5738,77862,96,306609
27217,0.000772,172.31.47.0-255,66,77928,96,306609
27218,0.000783,172.31.47.0-255,66,77994,96,306609
27219,0.000868,172.217.194.0-255,1484,79478,96,306609
27220,0.000882,172.217.194.0-255,2902,82380,96,306609
27221,0.000885,172.31.47.0-255,66,82446,96,306609
27222,0.000888,172.217.194.0-255,1484,83930,96,306609
27223,0.000904,172.217.194.0-255,4320,88250,96,306609
27224,0.000907,172.31.47.0-255,66,88316,96,306609
27225,0.000928,172.217.194.0-255,6797,95113,96,306609
27226,0.000931,172.31.47.0-255,66,95179,96,306609
27227,0.001051,172.217.194.0-255,1484,96663,96,306609
27228,0.001064,172.217.194.0-255,2902,99565,96,306609
27229,0.001067,172.31.47.0-255,66,99631,96,306609
27230,0.00107,172.217.194.0-255,1484,101115,96,306609
27231,0.001088,172.217.194.0-255,4320,105435,96,306609
27232,0.001091,172.31.47.0-255,66,105501,96,306609
27233,0.001106,172.217.194.0-255,1484,106985,96,306609
27234,0.00113,172.31.47.0-255,66,107051,96,306609
27235,0.001139,172.31.47.0-255,66,107117,96,306609
27236,0.001162,172.217.194.0-255,2184,109301,96,306609
27237,0.001164,172.31.47.0-255,66,109367,96,306609
27238,0.001793,172.217.194.0-255,1484,110851,96,306609
27239,0.001804,172.217.194.0-255,2902,113753,96,306609
27240,0.001808,172.31.47.0-255,66,113819,96,306609
27241,0.001815,172.217.194.0-255,5738,119557,96,306609
27242,0.001817,172.31.47.0-255,66,119623,96,306609
27243,0.001819,172.217.194.0-255,1484,121107,96,306609
27244,0.001842,172.217.194.0-255,7156,128263,96,306609
27245,0.001844,172.31.47.0-255,66,128329,96,306609
27246,0.001883,172.217.194.0-255,7156,135485,96,306609
27247,0.001885,172.31.47.0-255,66,135551,96,306609
27248,0.001905,172.31.47.0-255,66,135617,96,306609
27249,0.001909,172.217.194.0-255,2902,138519,96,306609
27250,0.00191,172.31.47.0-255,66,138585,96,306609
27251,0.001941,172.31.47.0-255,66,138651,96,306609
27252,0.001946,172.217.194.0-255,5738,144389,96,306609
27253,0.001948,172.31.47.0-255,66,144455,96,306609
27254,0.001959,172.217.194.0-255,2902,147357,96,306609
27255,0.001961,172.31.47.0-255,66,147423,96,306609
27256,0.001997,172.31.47.0-255,66,147489,96,306609
27257,0.002246,172.217.194.0-255,1484,148973,96,306609
27258,0.002263,172.217.194.0-255,2902,151875,96,306609
27259,0.002264,172.31.47.0-255,66,151941,96,306609
27260,0.002268,172.217.194.0-255,2902,154843,96,306609
27261,0.002269,172.31.47.0-255,66,154909,96,306609
27262,0.002282,172.217.194.0-255,2902,157811,96,306609
27263,0.002284,172.31.47.0-255,66,157877,96,306609
27264,0.002288,172.217.194.0-255,4320,162197,96,306609
27265,0.00229,172.31.47.0-255,66,162263,96,306609
27266,0.002327,172.31.47.0-255,66,162329,96,306609
27267,0.002352,172.31.47.0-255,66,162395,96,306609
27268,0.00251,172.217.194.0-255,1484,163879,96,306609
27269,0.002525,172.217.194.0-255,2902,166781,96,306609
27270,0.002527,172.31.47.0-255,66,166847,96,306609
27271,0.002544,172.217.194.0-255,1484,168331,96,306609
27272,0.002546,172.217.194.0-255,1484,169815,96,306609
27273,0.002549,172.31.47.0-255,66,169881,96,306609
27274,0.002565,172.217.194.0-255,1484,171365,96,306609
27275,0.00257,172.217.194.0-255,4320,175685,96,306609
27276,0.002572,172.31.47.0-255,66,175751,96,306609
27277,0.002593,172.217.194.0-255,1484,177235,96,306609
27278,0.002602,172.31.47.0-255,66,177301,96,306609
27279,0.002606,172.217.194.0-255,4320,181621,96,306609
27280,0.002608,172.31.47.0-255,66,181687,96,306609
27281,0.002624,172.217.194.0-255,5738,187425,96,306609
27282,0.002626,172.31.47.0-255,66,187491,96,306609
27283,0.002628,172.217.194.0-255,766,188257,96,306609
27284,0.003746,172.31.47.0-255,66,188323,96,306609
27285,0.005211,172.217.194.0-255,4320,192643,96,306609
27286,0.005216,172.31.47.0-255,66,192709,96,306609
27287,0.006347,172.217.194.0-255,1484,194193,96,306609
27288,0.007825,172.217.194.0-255,4320,198513,96,306609
27289,0.007831,172.31.47.0-255,66,198579,96,306609
27290,0.010429,172.217.194.0-255,2902,201481,96,306609
27291,0.010437,172.31.47.0-255,66,201547,96,306609
27292,0.010457,172.217.194.0-255,2902,204449,96,306609
27293,0.01046,172.31.47.0-255,66,204515,96,306609
27294,0.013047,172.217.194.0-255,5738,210253,96,306609
27295,0.013057,172.31.47.0-255,66,210319,96,306609
27296,0.015649,172.217.194.0-255,5738,216057,96,306609
27297,0.015658,172.31.47.0-255,66,216123,96,306609
27298,0.018256,172.217.194.0-255,5738,221861,96,306609
27299,0.018262,172.31.47.0-255,66,221927,96,306609
27300,0.020859,172.217.194.0-255,5738,227665,96,306609
27301,0.020866,172.31.47.0-255,66,227731,96,306609
27302,0.023494,172.217.194.0-255,5738,233469,96,306609
27303,0.023503,172.31.47.0-255,66,233535,96,306609
27304,0.026121,172.217.194.0-255,5738,239273,96,306609
27305,0.026128,172.31.47.0-255,66,239339,96,306609
27306,0.027823,172.31.47.0-255,172,239511,96,306609
27307,0.027855,172.31.47.0-255,1109,240620,96,306609
27308,0.02789,172.31.47.0-255,1514,242134,96,306609
27309,0.027892,172.31.47.0-255,1302,243436,96,306609
27310,0.028766,172.217.194.0-255,5738,249174,96,306609
27311,0.028772,172.31.47.0-255,66,249240,96,306609
27312,0.029422,104.244.42.0-255,66,249306,96,306609
27313,0.02943,104.244.42.0-255,66,249372,96,306609
27314,0.029466,104.244.42.0-255,66,249438,96,306609
27315,0.03136,172.217.194.0-255,4320,253758,96,306609
27316,0.031365,172.31.47.0-255,66,253824,96,306609
27317,0.031389,172.217.194.0-255,1484,255308,96,306609
27318,0.033945,172.217.194.0-255,4320,259628,96,306609
27319,0.033949,172.31.47.0-255,66,259694,96,306609
27320,0.036549,172.217.194.0-255,5738,265432,96,306609
27321,0.036553,172.31.47.0-255,66,265498,96,306609
27322,0.039147,172.217.194.0-255,5738,271236,96,306609
27323,0.039153,172.31.47.0-255,66,271302,96,306609
27324,0.041782,172.217.194.0-255,5738,277040,96,306609
27325,0.041787,172.31.47.0-255,66,277106,96,306609
27326,0.044392,172.217.194.0-255,2902,280008,96,306609
27327,0.044396,172.31.47.0-255,66,280074,96,306609
27328,0.044421,172.217.194.0-255,2902,282976,96,306609
27329,0.044424,172.31.47.0-255,66,283042,96,306609
27330,0.04701,172.217.194.0-255,2902,285944,96,306609
27331,0.047014,172.31.47.0-255,66,286010,96,306609
27332,0.04705,172.217.194.0-255,2902,288912,96,306609
27333,0.047054,172.31.47.0-255,66,288978,96,306609
27334,0.049604,172.217.194.0-255,2902,291880,96,306609
27335,0.049609,172.31.47.0-255,66,291946,96,306609
27336,0.049639,172.217.194.0-255,2902,294848,96,306609
27337,0.049642,172.31.47.0-255,66,294914,96,306609
27338,0.052215,172.217.194.0-255,2902,297816,96,306609
27339,0.052219,172.31.47.0-255,66,297882,96,306609
27340,0.052267,172.217.194.0-255,2902,300784,96,306609
27341,0.052272,172.31.47.0-255,66,300850,96,306609
27342,0.054799,172.217.194.0-255,2902,303752,96,306609
27343,0.054803,172.31.47.0-255,66,303818,96,306609
27344,0.054871,172.217.194.0-255,2554,306372,96,306609
27345,0.054875,172.31.47.0-255,66,306438,96,306609
27346,0.054998,172.31.47.0-255,105,306543,96,306609
27347,0.057562,172.217.194.0-255,66,306609,96,306609
27348,0.0,74.125.24.0-255,297,297,96,189863
27349,3.4e-05,172.31.47.0-255,66,363,96,189863
27350,4.1e-05,74.125.24.0-255,1484,1847,96,189863
27351,4.4e-05,172.31.47.0-255,66,1913,96,189863
27352,5e-05,74.125.24.0-255,4320,6233,96,189863
27353,5.3e-05,172.31.47.0-255,66,6299,96,189863
27354,5.8e-05,74.125.24.0-255,4320,10619,96,189863
27355,6.1e-05,172.31.47.0-255,66,10685,96,189863
27356,8.2e-05,74.125.24.0-255,2902,13587,96,189863
27357,8.5e-05,172.31.47.0-255,66,13653,96,189863
27358,9.4e-05,172.31.47.0-255,66,13719,96,189863
27359,0.000123,172.31.47.0-255,66,13785,96,189863
27360,0.000205,74.125.24.0-255,1484,15269,96,189863
27361,0.000209,172.31.47.0-255,66,15335,96,189863
27362,0.00026,74.125.24.0-255,2902,18237,96,189863
27363,0.000262,172.31.47.0-255,66,18303,96,189863
27364,0.000268,74.125.24.0-255,5738,24041,96,189863
27365,0.000271,172.31.47.0-255,66,24107,96,189863
27366,0.000278,74.125.24.0-255,6797,30904,96,189863
27367,0.00028,172.31.47.0-255,66,30970,96,189863
27368,0.000287,74.125.24.0-255,7156,38126,96,189863
27369,0.00029,172.31.47.0-255,66,38192,96,189863
27370,0.000305,74.125.24.0-255,1484,39676,96,189863
27371,0.000307,172.31.47.0-255,66,39742,96,189863
27372,0.000339,172.31.47.0-255,66,39808,96,189863
27373,0.000547,74.125.24.0-255,110,39918,96,189863
27374,0.000551,172.31.47.0-255,66,39984,96,189863
27375,0.000583,74.125.24.0-255,1484,41468,96,189863
27376,0.000586,172.31.47.0-255,66,41534,96,189863
27377,0.00059,74.125.24.0-255,2902,44436,96,189863
27378,0.000597,172.31.47.0-255,66,44502,96,189863
27379,0.000624,74.125.24.0-255,5738,50240,96,189863
27380,0.000627,172.31.47.0-255,66,50306,96,189863
27381,0.00065,74.125.24.0-255,7156,57462,96,189863
27382,0.000654,172.31.47.0-255,66,57528,96,189863
27383,0.000655,74.125.24.0-255,4320,61848,96,189863
27384,0.000657,172.31.47.0-255,66,61914,96,189863
27385,0.00069,172.31.47.0-255,66,61980,96,189863
27386,0.000694,74.125.24.0-255,2184,64164,96,189863
27387,0.000696,172.31.47.0-255,66,64230,96,189863
27388,0.000843,74.125.24.0-255,1484,65714,96,189863
27389,0.000861,74.125.24.0-255,2902,68616,96,189863
27390,0.000865,172.31.47.0-255,66,68682,96,189863
27391,0.000869,74.125.24.0-255,1484,70166,96,189863
27392,0.000885,74.125.24.0-255,4320,74486,96,189863
27393,0.000888,172.31.47.0-255,66,74552,96,189863
27394,0.000909,74.125.24.0-255,7156,81708,96,189863
27395,0.000912,172.31.47.0-255,66,81774,96,189863
27396,0.000934,74.125.24.0-255,2902,84676,96,189863
27397,0.000937,172.31.47.0-255,66,84742,96,189863
27398,0.000941,74.125.24.0-255,2902,87644,96,189863
27399,0.000945,172.31.47.0-255,66,87710,96,189863
27400,0.000969,172.31.47.0-255,66,87776,96,189863
27401,0.000995,74.125.24.0-255,766,88542,96,189863
27402,0.001203,74.125.24.0-255,1484,90026,96,189863
27403,0.001209,172.31.47.0-255,66,90092,96,189863
27404,0.001214,74.125.24.0-255,2902,92994,96,189863
27405,0.001216,172.31.47.0-255,66,93060,96,189863
27406,0.001229,74.125.24.0-255,1484,94544,96,189863
27407,0.001245,74.125.24.0-255,2902,97446,96,189863
27408,0.001247,172.31.47.0-255,66,97512,96,189863
27409,0.001254,74.125.24.0-255,5738,103250,96,189863
27410,0.001256,172.31.47.0-255,66,103316,96,189863
27411,0.001294,172.31.47.0-255,66,103382,96,189863
27412,0.0013,74.125.24.0-255,7156,110538,96,189863
27413,0.001303,172.31.47.0-255,66,110604,96,189863
27414,0.001338,172.31.47.0-255,66,110670,96,189863
27415,0.001366,172.31.47.0-255,66,110736,96,189863
27416,0.00138,172.31.47.0-255,66,110802,96,189863
27417,0.001439,74.125.24.0-255,1484,112286,96,189863
27418,0.001457,74.125.24.0-255,2902,115188,96,189863
27419,0.00146,172.31.47.0-255,66,115254,96,189863
27420,0.001475,74.125.24.0-255,5738,120992,96,189863
27421,0.001478,172.31.47.0-255,66,121058,96,189863
27422,0.001546,74.125.24.0-255,7156,128214,96,189863
27423,0.001551,172.31.47.0-255,66,128280,96,189863
27424,0.001567,74.125.24.0-255,2902,131182,96,189863
27425,0.00157,172.31.47.0-255,66,131248,96,189863
27426,0.001583,172.31.47.0-255,66,131314,96,189863
27427,0.001586,74.125.24.0-255,2184,133498,96,189863
27428,0.001588,172.31.47.0-255,66,133564,96,189863
27429,0.001593,74.125.24.0-255,2902,136466,96,189863
27430,0.001595,172.31.47.0-255,66,136532,96,189863
27431,0.001602,74.125.24.0-255,7156,143688,96,189863
27432,0.001607,172.31.47.0-255,66,143754,96,189863
27433,0.001644,74.125.24.0-255,5738,149492,96,189863
27434,0.001649,172.31.47.0-255,66,149558,96,189863
27435,0.001667,74.125.24.0-255,5738,155296,96,189863
27436,0.00167,172.31.47.0-255,66,155362,96,189863
27437,0.001677,74.125.24.0-255,5738,161100,96,189863
27438,0.001679,172.31.47.0-255,66,161166,96,189863
27439,0.001715,74.125.24.0-255,4320,165486,96,189863
27440,0.001719,172.31.47.0-255,66,165552,96,189863
27441,0.001754,172.31.47.0-255,66,165618,96,189863
27442,0.001772,172.31.47.0-255,66,165684,96,189863
27443,0.001777,74.125.24.0-255,3602,169286,96,189863
27444,0.001779,172.31.47.0-255,66,169352,96,189863
27445,0.001819,74.125.24.0-255,2902,172254,96,189863
27446,0.001823,172.31.47.0-255,66,172320,96,189863
27447,0.001851,172.31.47.0-255,66,172386,96,189863
27448,0.001864,172.31.47.0-255,66,172452,96,189863
27449,0.00189,74.125.24.0-255,7156,179608,96,189863
27450,0.001892,172.31.47.0-255,66,179674,96,189863
27451,0.001897,74.125.24.0-255,3602,183276,96,189863
27452,0.001899,172.31.47.0-255,66,183342,96,189863
27453,0.00191,172.31.47.0-255,66,183408,96,189863
27454,0.001944,172.31.47.0-255,66,183474,96,189863
27455,0.001957,172.31.47.0-255,66,183540,96,189863
27456,0.001979,74.125.24.0-255,1484,185024,96,189863
27457,0.00201,172.31.47.0-255,66,185090,96,189863
27458,0.002044,172.31.47.0-255,66,185156,96,189863
27459,0.002058,172.31.47.0-255,66,185222,96,189863
27460,0.004041,74.125.24.0-255,105,185327,96,189863
27461,0.008413,172.31.47.0-255,66,185393,96,189863
27462,0.008441,172.31.47.0-255,105,185498,96,189863
27463,0.010433,74.125.24.0-255,66,185564,96,189863
27464,0.032925,172.31.47.0-255,176,185740,96,189863
27465,0.032957,172.31.47.0-255,1110,186850,96,189863
27466,0.033019,172.31.47.0-255,1514,188364,96,189863
27467,0.033026,172.31.47.0-255,1301,189665,96,189863
27468,0.034462,104.244.42.0-255,66,189731,96,189863
27469,0.034507,104.244.42.0-255,66,189797,96,189863
27470,0.034596,104.244.42.0-255,66,189863,96,189863
27471,0.0,172.217.194.0-255,153,153,96,279590
27472,1.5e-05,172.31.47.0-255,66,219,96,279590
27473,2.1e-05,172.217.194.0-255,1484,1703,96,279590
27474,2.5e-05,172.31.47.0-255,66,1769,96,279590
27475,3e-05,172.217.194.0-255,2902,4671,96,279590
27476,3.3e-05,172.31.47.0-255,66,4737,96,279590
27477,4.6e-05,172.217.194.0-255,7156,11893,96,279590
27478,4.9e-05,172.31.47.0-255,66,11959,96,279590
27479,5.3e-05,172.217.194.0-255,2014,13973,96,279590
27480,5.5e-05,172.31.47.0-255,66,14039,96,279590
27481,0.000124,172.31.47.0-255,66,14105,96,279590
27482,0.000129,172.217.194.0-255,2902,17007,96,279590
27483,0.00013,172.31.47.0-255,66,17073,96,279590
27484,0.000152,172.217.194.0-255,2543,19616,96,279590
27485,0.000155,172.31.47.0-255,66,19682,96,279590
27486,0.000176,172.217.194.0-255,1484,21166,96,279590
27487,0.000177,172.31.47.0-255,66,21232,96,279590
27488,0.000182,172.217.194.0-255,2902,24134,96,279590
27489,0.000183,172.31.47.0-255,66,24200,96,279590
27490,0.000186,172.217.194.0-255,1484,25684,96,279590
27491,0.000187,172.31.47.0-255,66,25750,96,279590
27492,0.000208,172.217.194.0-255,4320,30070,96,279590
27493,0.00021,172.31.47.0-255,66,30136,96,279590
27494,0.000218,172.217.194.0-255,2902,33038,96,279590
27495,0.00022,172.31.47.0-255,66,33104,96,279590
27496,0.000245,172.217.194.0-255,3961,37065,96,279590
27497,0.000247,172.31.47.0-255,66,37131,96,279590
27498,0.000278,172.217.194.0-255,7156,44287,96,279590
27499,0.00028,172.31.47.0-255,66,44353,96,279590
27500,0.000284,172.217.194.0-255,2902,47255,96,279590
27501,0.000285,172.31.47.0-255,66,47321,96,279590
27502,0.000313,172.217.194.0-255,2902,50223,96,279590
27503,0.000326,172.217.194.0-255,4287,54510,96,279590
27504,0.000396,172.217.194.0-255,383,54893,96,279590
27505,0.000493,172.31.47.0-255,66,54959,96,279590
27506,0.001075,172.217.194.0-255,1484,56443,96,279590
27507,0.001084,172.217.194.0-255,2902,59345,96,279590
27508,0.001088,172.31.47.0-255,66,59411,96,279590
27509,0.001121,172.217.194.0-255,5738,65149,96,279590
27510,0.001136,172.217.194.0-255,1484,66633,96,279590
27511,0.001191,172.217.194.0-255,2902,69535,96,279590
27512,0.001249,172.217.194.0-255,4320,73855,96,279590
27513,0.001275,172.217.194.0-255,766,74621,96,279590
27514,0.001368,172.217.194.0-255,1484,76105,96,279590
27515,0.001389,172.217.194.0-255,2902,79007,96,279590
27516,0.001393,172.217.194.0-255,2902,81909,96,279590
27517,0.00141,172.217.194.0-255,2902,84811,96,279590
27518,0.001417,172.217.194.0-255,5738,90549,96,279590
27519,0.001433,172.217.194.0-255,4320,94869,96,279590
27520,0.001458,172.217.194.0-255,5738,100607,96,279590
27521,0.002188,172.217.194.0-255,1484,102091,96,279590
27522,0.002197,172.217.194.0-255,2902,104993,96,279590
27523,0.002203,172.217.194.0-255,5738,110731,96,279590
27524,0.002219,172.217.194.0-255,4320,115051,96,279590
27525,0.002236,172.217.194.0-255,5738,120789,96,279590
27526,0.002282,172.217.194.0-255,4320,125109,96,279590
27527,0.00233,172.217.194.0-255,7156,132265,96,279590
27528,0.002343,172.217.194.0-255,2184,134449,96,279590
27529,0.002677,172.217.194.0-255,1484,135933,96,279590
27530,0.005914,172.31.47.0-255,66,135999,96,279590
27531,0.008546,172.217.194.0-255,5738,141737,96,279590
27532,0.008552,172.31.47.0-255,66,141803,96,279590
27533,0.011176,172.217.194.0-255,5738,147541,96,279590
27534,0.011184,172.31.47.0-255,66,147607,96,279590
27535,0.013823,172.217.194.0-255,5738,153345,96,279590
27536,0.013832,172.31.47.0-255,66,153411,96,279590
27537,0.016448,172.217.194.0-255,5738,159149,96,279590
27538,0.016457,172.31.47.0-255,66,159215,96,279590
27539,0.019074,172.217.194.0-255,5738,164953,96,279590
27540,0.019087,172.31.47.0-255,66,165019,96,279590
27541,0.021718,172.217.194.0-255,5738,170757,96,279590
27542,0.021728,172.31.47.0-255,66,170823,96,279590
27543,0.024334,172.217.194.0-255,5738,176561,96,279590
27544,0.024342,172.31.47.0-255,66,176627,96,279590
27545,0.025885,172.31.47.0-255,172,176799,96,279590
27546,0.025912,172.31.47.0-255,1111,177910,96,279590
27547,0.025962,172.31.47.0-255,1514,179424,96,279590
27548,0.02598,172.31.47.0-255,1300,180724,96,279590
27549,0.026958,172.217.194.0-255,5738,186462,96,279590
27550,0.026966,172.31.47.0-255,66,186528,96,279590
27551,0.027484,104.244.42.0-255,66,186594,96,279590
27552,0.027491,104.244.42.0-255,66,186660,96,279590
27553,0.027527,104.244.42.0-255,66,186726,96,279590
27554,0.029573,172.217.194.0-255,5738,192464,96,279590
27555,0.029579,172.31.47.0-255,66,192530,96,279590
27556,0.032199,172.217.194.0-255,5738,198268,96,279590
27557,0.032207,172.31.47.0-255,66,198334,96,279590
27558,0.034815,172.217.194.0-255,5738,204072,96,279590
27559,0.034821,172.31.47.0-255,66,204138,96,279590
27560,0.037429,172.217.194.0-255,5738,209876,96,279590
27561,0.037437,172.31.47.0-255,66,209942,96,279590
27562,0.040057,172.217.194.0-255,5738,215680,96,279590
27563,0.040064,172.31.47.0-255,66,215746,96,279590
27564,0.042672,172.217.194.0-255,5738,221484,96,279590
27565,0.042678,172.31.47.0-255,66,221550,96,279590
27566,0.045269,172.217.194.0-255,5738,227288,96,279590
27567,0.045275,172.31.47.0-255,66,227354,96,279590
27568,0.047886,172.217.194.0-255,5738,233092,96,279590
27569,0.047893,172.31.47.0-255,66,233158,96,279590
27570,0.050517,172.217.194.0-255,5738,238896,96,279590
27571,0.050524,172.31.47.0-255,66,238962,96,279590
27572,0.05315,172.217.194.0-255,5738,244700,96,279590
27573,0.053156,172.31.47.0-255,66,244766,96,279590
27574,0.055808,172.217.194.0-255,5738,250504,96,279590
27575,0.055814,172.31.47.0-255,66,250570,96,279590
27576,0.058455,172.217.194.0-255,5738,256308,96,279590
27577,0.058461,172.31.47.0-255,66,256374,96,279590
27578,0.061051,172.217.194.0-255,5738,262112,96,279590
27579,0.061056,172.31.47.0-255,66,262178,96,279590
27580,0.063663,172.217.194.0-255,5738,267916,96,279590
27581,0.063668,172.31.47.0-255,66,267982,96,279590
27582,0.066281,172.217.194.0-255,5738,273720,96,279590
27583,0.066286,172.31.47.0-255,66,273786,96,279590
27584,0.068886,172.217.194.0-255,5738,279524,96,279590
27585,0.068892,172.31.47.0-255,66,279590,96,279590
27586,0.0,172.31.47.0-255,105,105,96,276
27587,0.002122,157.240.13.0-255,105,210,96,276
27588,0.002133,172.31.47.0-255,66,276,96,276
27589,0.0,172.217.194.0-255,153,153,96,261730
27590,3.3e-05,172.31.47.0-255,66,219,96,261730
27591,4e-05,172.217.194.0-255,1484,1703,96,261730
27592,4.5e-05,172.31.47.0-255,66,1769,96,261730
27593,5e-05,172.217.194.0-255,2902,4671,96,261730
27594,5.3e-05,172.31.47.0-255,66,4737,96,261730
27595,5.8e-05,172.217.194.0-255,4320,9057,96,261730
27596,6.1e-05,172.31.47.0-255,66,9123,96,261730
27597,8.5e-05,172.217.194.0-255,1484,10607,96,261730
27598,8.9e-05,172.31.47.0-255,66,10673,96,261730
27599,0.000109,172.217.194.0-255,1484,12157,96,261730
27600,0.000112,172.31.47.0-255,66,12223,96,261730
27601,0.00013,172.217.194.0-255,2140,14363,96,261730
27602,0.000132,172.31.47.0-255,66,14429,96,261730
27603,0.00023,172.217.194.0-255,1484,15913,96,261730
27604,0.000234,172.31.47.0-255,66,15979,96,261730
27605,0.00024,172.217.194.0-255,2902,18881,96,261730
27606,0.000243,172.31.47.0-255,66,18947,96,261730
27607,0.000246,172.217.194.0-255,1484,20431,96,261730
27608,0.000248,172.31.47.0-255,66,20497,96,261730
27609,0.000272,172.217.194.0-255,4320,24817,96,261730
27610,0.000277,172.31.47.0-255,66,24883,96,261730
27611,0.000278,172.217.194.0-255,5738,30621,96,261730
27612,0.00028,172.31.47.0-255,66,30687,96,261730
27613,0.000293,172.217.194.0-255,1125,31812,96,261730
27614,0.000296,172.31.47.0-255,66,31878,96,261730
27615,0.000309,172.31.47.0-255,66,31944,96,261730
27616,0.000325,172.217.194.0-255,4320,36264,96,261730
27617,0.000328,172.31.47.0-255,66,36330,96,261730
27618,0.000338,172.31.47.0-255,66,36396,96,261730
27619,0.000362,172.217.194.0-255,5738,42134,96,261730
27620,0.000368,172.31.47.0-255,66,42200,96,261730
27621,0.000375,172.217.194.0-255,2902,45102,96,261730
27622,0.000382,172.31.47.0-255,66,45168,96,261730
27623,0.000388,172.217.194.0-255,2459,47627,96,261730
27624,0.000397,172.31.47.0-255,66,47693,96,261730
27625,0.000519,172.217.194.0-255,118,47811,96,261730
27626,0.000585,172.217.194.0-255,1484,49295,96,261730
27627,0.000589,172.31.47.0-255,66,49361,96,261730
27628,0.000594,172.217.194.0-255,2902,52263,96,261730
27629,0.000601,172.217.194.0-255,5738,58001,96,261730
27630,0.000604,172.31.47.0-255,66,58067,96,261730
27631,0.000609,172.31.47.0-255,66,58133,96,261730
27632,0.000619,172.217.194.0-255,1484,59617,96,261730
27633,0.000642,172.217.194.0-255,5674,65291,96,261730
27634,0.000647,172.31.47.0-255,66,65357,96,261730
27635,0.000915,172.217.194.0-255,1484,66841,96,261730
27636,0.00092,172.217.194.0-255,2902,69743,96,261730
27637,0.000923,172.31.47.0-255,66,69809,96,261730
27638,0.000945,172.217.194.0-255,5738,75547,96,261730
27639,0.000951,172.31.47.0-255,66,75613,96,261730
27640,0.000958,172.217.194.0-255,4320,79933,96,261730
27641,0.000963,172.31.47.0-255,66,79999,96,261730
27642,0.000992,172.31.47.0-255,66,80065,96,261730
27643,0.001037,172.217.194.0-255,4320,84385,96,261730
27644,0.00104,172.31.47.0-255,66,84451,96,261730
27645,0.001059,172.217.194.0-255,6438,90889,96,261730
27646,0.001068,172.31.47.0-255,66,90955,96,261730
27647,0.00107,172.217.194.0-255,2902,93857,96,261730
27648,0.001081,172.31.47.0-255,66,93923,96,261730
27649,0.001101,172.31.47.0-255,66,93989,96,261730
27650,0.001105,172.31.47.0-255,66,94055,96,261730
27651,0.00113,172.217.194.0-255,1484,95539,96,261730
27652,0.001154,172.31.47.0-255,66,95605,96,261730
27653,0.001177,172.31.47.0-255,66,95671,96,261730
27654,0.00119,172.31.47.0-255,66,95737,96,261730
27655,0.001468,172.217.194.0-255,1484,97221,96,261730
27656,0.001488,172.217.194.0-255,2902,100123,96,261730
27657,0.001491,172.31.47.0-255,66,100189,96,261730
27658,0.001497,172.217.194.0-255,5738,105927,96,261730
27659,0.0015,172.31.47.0-255,66,105993,96,261730
27660,0.001533,172.31.47.0-255,66,106059,96,261730
27661,0.001559,172.217.194.0-255,5738,111797,96,261730
27662,0.001563,172.31.47.0-255,66,111863,96,261730
27663,0.001582,172.31.47.0-255,66,111929,96,261730
27664,0.001646,172.217.194.0-255,1484,113413,96,261730
27665,0.00165,172.217.194.0-255,2902,116315,96,261730
27666,0.001653,172.31.47.0-255,66,116381,96,261730
27667,0.001661,172.217.194.0-255,1484,117865,96,261730
27668,0.001677,172.217.194.0-255,4320,122185,96,261730
27669,0.001681,172.217.194.0-255,2902,125087,96,261730
27670,0.001687,172.31.47.0-255,66,125153,96,261730
27671,0.001719,172.217.194.0-255,7156,132309,96,261730
27672,0.001718,172.31.47.0-255,66,132375,96,261730
27673,0.001721,172.31.47.0-255,66,132441,96,261730
27674,0.00174,172.217.194.0-255,3602,136043,96,261730
27675,0.001746,172.31.47.0-255,66,136109,96,261730
27676,0.001752,172.217.194.0-255,2902,139011,96,261730
27677,0.001758,172.31.47.0-255,66,139077,96,261730
27678,0.001781,172.31.47.0-255,66,139143,96,261730
27679,0.001784,172.31.47.0-255,66,139209,96,261730
27680,0.00183,172.217.194.0-255,4320,143529,96,261730
27681,0.001833,172.31.47.0-255,66,143595,96,261730
27682,0.001856,172.31.47.0-255,66,143661,96,261730
27683,0.001879,172.217.194.0-255,1484,145145,96,261730
27684,0.001894,172.217.194.0-255,2902,148047,96,261730
27685,0.001905,172.31.47.0-255,66,148113,96,261730
27686,0.001919,172.217.194.0-255,5738,153851,96,261730
27687,0.001922,172.217.194.0-255,1484,155335,96,261730
27688,0.001929,172.31.47.0-255,66,155401,96,261730
27689,0.001948,172.217.194.0-255,7156,162557,96,261730
27690,0.001958,172.31.47.0-255,66,162623,96,261730
27691,0.00197,172.31.47.0-255,66,162689,96,261730
27692,0.001998,172.217.194.0-255,5020,167709,96,261730
27693,0.002008,172.217.194.0-255,1484,169193,96,261730
27694,0.002009,172.31.47.0-255,66,169259,96,261730
27695,0.002023,172.217.194.0-255,1484,170743,96,261730
27696,0.002031,172.31.47.0-255,66,170809,96,261730
27697,0.002038,172.217.194.0-255,4320,175129,96,261730
27698,0.002043,172.31.47.0-255,66,175195,96,261730
27699,0.002079,172.31.47.0-255,66,175261,96,261730
27700,0.002086,172.217.194.0-255,1484,176745,96,261730
27701,0.002137,172.31.47.0-255,66,176811,96,261730
27702,0.004459,172.217.194.0-255,5738,182549,96,261730
27703,0.004478,172.31.47.0-255,66,182615,96,261730
27704,0.006762,172.217.194.0-255,5738,188353,96,261730
27705,0.009883,172.31.47.0-255,66,188419,96,261730
27706,0.012155,172.217.194.0-255,5738,194157,96,261730
27707,0.01217,172.31.47.0-255,66,194223,96,261730
27708,0.014499,172.217.194.0-255,5738,199961,96,261730
27709,0.014511,172.31.47.0-255,66,200027,96,261730
27710,0.016807,172.217.194.0-255,5738,205765,96,261730
27711,0.017626,172.31.47.0-255,66,205831,96,261730
27712,0.019927,172.217.194.0-255,5738,211569,96,261730
27713,0.019936,172.31.47.0-255,66,211635,96,261730
27714,0.022209,172.217.194.0-255,5738,217373,96,261730
27715,0.022217,172.31.47.0-255,66,217439,96,261730
27716,0.024515,172.217.194.0-255,5738,223177,96,261730
27717,0.024522,172.31.47.0-255,66,223243,96,261730
27718,0.026789,172.217.194.0-255,5738,228981,96,261730
27719,0.026799,172.31.47.0-255,66,229047,96,261730
27720,0.029116,172.217.194.0-255,5738,234785,96,261730
27721,0.029124,172.31.47.0-255,66,234851,96,261730
27722,0.031238,172.31.47.0-255,172,235023,96,261730
27723,0.031284,172.31.47.0-255,1104,236127,96,261730
27724,0.031348,172.31.47.0-255,1514,237641,96,261730
27725,0.03135,172.31.47.0-255,1307,238948,96,261730
27726,0.031407,172.217.194.0-255,5738,244686,96,261730
27727,0.031412,172.31.47.0-255,66,244752,96,261730
27728,0.032745,104.244.42.0-255,66,244818,96,261730
27729,0.032856,104.244.42.0-255,66,244884,96,261730
27730,0.032872,104.244.42.0-255,66,244950,96,261730
27731,0.0337,172.217.194.0-255,4320,249270,96,261730
27732,0.033704,172.31.47.0-255,66,249336,96,261730
27733,0.033731,172.217.194.0-255,1484,250820,96,261730
27734,0.035989,172.217.194.0-255,4320,255140,96,261730
27735,0.035994,172.31.47.0-255,66,255206,96,261730
27736,0.038295,172.217.194.0-255,5738,260944,96,261730
27737,0.03844,172.31.47.0-255,66,261010,96,261730
27738,0.040691,172.217.194.0-255,483,261493,96,261730
27739,0.040843,172.31.47.0-255,66,261559,96,261730
27740,0.04087,172.31.47.0-255,105,261664,96,261730
27741,0.043097,172.217.194.0-255,66,261730,96,261730
27742,0.0,74.125.24.0-255,152,152,96,221500
27743,3.4e-05,172.31.47.0-255,66,218,96,221500
27744,4.2e-05,74.125.24.0-255,1484,1702,96,221500
27745,4.6e-05,172.31.47.0-255,66,1768,96,221500
27746,5.9e-05,74.125.24.0-255,2902,4670,96,221500
27747,6.2e-05,172.31.47.0-255,66,4736,96,221500
27748,7.1e-05,74.125.24.0-255,7156,11892,96,221500
27749,7.4e-05,172.31.47.0-255,66,11958,96,221500
27750,7.7e-05,74.125.24.0-255,2160,14118,96,221500
27751,8e-05,172.31.47.0-255,66,14184,96,221500
27752,9.3e-05,172.31.47.0-255,66,14250,96,221500
27753,9.9e-05,74.125.24.0-255,5379,19629,96,221500
27754,0.000101,172.31.47.0-255,66,19695,96,221500
27755,0.000164,74.125.24.0-255,1484,21179,96,221500
27756,0.00017,172.31.47.0-255,66,21245,96,221500
27757,0.000174,74.125.24.0-255,2902,24147,96,221500
27758,0.000176,172.31.47.0-255,66,24213,96,221500
27759,0.000211,74.125.24.0-255,5738,29951,96,221500
27760,0.000215,172.31.47.0-255,66,30017,96,221500
27761,0.00023,74.125.24.0-255,6797,36814,96,221500
27762,0.000233,172.31.47.0-255,66,36880,96,221500
27763,0.000254,172.31.47.0-255,66,36946,96,221500
27764,0.000258,74.125.24.0-255,2818,39764,96,221500
27765,0.00026,172.31.47.0-255,66,39830,96,221500
27766,0.000264,74.125.24.0-255,129,39959,96,221500
27767,0.000266,172.31.47.0-255,66,40025,96,221500
27768,0.000367,74.125.24.0-255,1484,41509,96,221500
27769,0.000372,172.31.47.0-255,66,41575,96,221500
27770,0.000376,74.125.24.0-255,2902,44477,96,221500
27771,0.000379,172.31.47.0-255,66,44543,96,221500
27772,0.000417,74.125.24.0-255,5738,50281,96,221500
27773,0.000421,74.125.24.0-255,4320,54601,96,221500
27774,0.000422,172.31.47.0-255,66,54667,96,221500
27775,0.000426,172.31.47.0-255,66,54733,96,221500
27776,0.000437,74.125.24.0-255,5738,60471,96,221500
27777,0.000444,172.31.47.0-255,66,60537,96,221500
27778,0.000478,74.125.24.0-255,6797,67334,96,221500
27779,0.000482,172.31.47.0-255,66,67400,96,221500
27780,0.000484,74.125.24.0-255,6499,73899,96,221500
27781,0.000487,172.31.47.0-255,66,73965,96,221500
27782,0.000554,172.31.47.0-255,66,74031,96,221500
27783,0.00056,74.125.24.0-255,5379,79410,96,221500
27784,0.000563,172.31.47.0-255,66,79476,96,221500
27785,0.000718,74.125.24.0-255,1484,80960,96,221500
27786,0.000724,74.125.24.0-255,2902,83862,96,221500
27787,0.000727,172.31.47.0-255,66,83928,96,221500
27788,0.000759,74.125.24.0-255,5738,89666,96,221500
27789,0.000763,172.31.47.0-255,66,89732,96,221500
27790,0.00077,74.125.24.0-255,7156,96888,96,221500
27791,0.000772,172.31.47.0-255,66,96954,96,221500
27792,0.000785,74.125.24.0-255,7156,104110,96,221500
27793,0.000788,172.31.47.0-255,66,104176,96,221500
27794,0.000824,74.125.24.0-255,7156,111332,96,221500
27795,0.000827,172.31.47.0-255,66,111398,96,221500
27796,0.000831,74.125.24.0-255,2184,113582,96,221500
27797,0.000833,172.31.47.0-255,66,113648,96,221500
27798,0.000971,74.125.24.0-255,1484,115132,96,221500
27799,0.000976,74.125.24.0-255,1484,116616,96,221500
27800,0.000979,172.31.47.0-255,66,116682,96,221500
27801,0.000997,74.125.24.0-255,1484,118166,96,221500
27802,0.001003,74.125.24.0-255,5738,123904,96,221500
27803,0.001005,172.31.47.0-255,66,123970,96,221500
27804,0.00101,74.125.24.0-255,2902,126872,96,221500
27805,0.001012,172.31.47.0-255,66,126938,96,221500
27806,0.00104,74.125.24.0-255,7156,134094,96,221500
27807,0.001044,172.31.47.0-255,66,134160,96,221500
27808,0.001074,74.125.24.0-255,4320,138480,96,221500
27809,0.001077,172.31.47.0-255,66,138546,96,221500
27810,0.001113,172.31.47.0-255,66,138612,96,221500
27811,0.001125,172.31.47.0-255,66,138678,96,221500
27812,0.001158,74.125.24.0-255,4320,142998,96,221500
27813,0.001162,172.31.47.0-255,66,143064,96,221500
27814,0.001169,74.125.24.0-255,7156,150220,96,221500
27815,0.001171,172.31.47.0-255,66,150286,96,221500
27816,0.001184,74.125.24.0-255,7156,157442,96,221500
27817,0.001187,172.31.47.0-255,66,157508,96,221500
27818,0.001218,74.125.24.0-255,5020,162528,96,221500
27819,0.001222,172.31.47.0-255,66,162594,96,221500
27820,0.001348,74.125.24.0-255,1484,164078,96,221500
27821,0.001361,74.125.24.0-255,2902,166980,96,221500
27822,0.001364,172.31.47.0-255,66,167046,96,221500
27823,0.001393,74.125.24.0-255,5738,172784,96,221500
27824,0.001396,172.31.47.0-255,66,172850,96,221500
27825,0.001399,74.125.24.0-255,1484,174334,96,221500
27826,0.001416,172.31.47.0-255,66,174400,96,221500
27827,0.001453,172.31.47.0-255,66,174466,96,221500
27828,0.001477,74.125.24.0-255,2184,176650,96,221500
27829,0.00148,172.31.47.0-255,66,176716,96,221500
27830,0.001766,74.125.24.0-255,1484,178200,96,221500
27831,0.00179,74.125.24.0-255,2902,181102,96,221500
27832,0.001794,172.31.47.0-255,66,181168,96,221500
27833,0.0018,74.125.24.0-255,5738,186906,96,221500
27834,0.001802,172.31.47.0-255,66,186972,96,221500
27835,0.001846,172.31.47.0-255,66,187038,96,221500
27836,0.001854,74.125.24.0-255,7156,194194,96,221500
27837,0.001856,172.31.47.0-255,66,194260,96,221500
27838,0.001947,172.31.47.0-255,66,194326,96,221500
27839,0.001949,74.125.24.0-255,1484,195810,96,221500
27840,0.00196,172.31.47.0-255,66,195876,96,221500
27841,0.001974,74.125.24.0-255,2184,198060,96,221500
27842,0.001977,172.31.47.0-255,66,198126,96,221500
27843,0.001986,74.125.24.0-255,4320,202446,96,221500
27844,0.001988,172.31.47.0-255,66,202512,96,221500
27845,0.002027,172.31.47.0-255,66,202578,96,221500
27846,0.002037,172.31.47.0-255,66,202644,96,221500
27847,0.002068,172.31.47.0-255,66,202710,96,221500
27848,0.002081,74.125.24.0-255,5020,207730,96,221500
27849,0.002088,172.31.47.0-255,66,207796,96,221500
27850,0.002102,172.31.47.0-255,66,207862,96,221500
27851,0.002135,74.125.24.0-255,2902,210764,96,221500
27852,0.002138,172.31.47.0-255,66,210830,96,221500
27853,0.002149,172.31.47.0-255,66,210896,96,221500
27854,0.00216,74.125.24.0-255,5738,216634,96,221500
27855,0.002163,172.31.47.0-255,66,216700,96,221500
27856,0.002217,172.31.47.0-255,66,216766,96,221500
27857,0.002219,74.125.24.0-255,97,216863,96,221500
27858,0.002221,74.125.24.0-255,105,216968,96,221500
27859,0.003308,172.31.47.0-255,66,217034,96,221500
27860,0.003334,172.31.47.0-255,105,217139,96,221500
27861,0.005563,74.125.24.0-255,66,217205,96,221500
27862,0.03269,172.31.47.0-255,172,217377,96,221500
27863,0.032718,172.31.47.0-255,1109,218486,96,221500
27864,0.032753,172.31.47.0-255,1514,220000,96,221500
27865,0.032755,172.31.47.0-255,1302,221302,96,221500
27866,0.034217,104.244.42.0-255,66,221368,96,221500
27867,0.034383,104.244.42.0-255,66,221434,96,221500
27868,0.034407,104.244.42.0-255,66,221500,96,221500
27869,0.0,172.217.194.0-255,153,153,96,342773
27870,1.8e-05,172.31.47.0-255,66,219,96,342773
27871,2.3e-05,172.217.194.0-255,1484,1703,96,342773
27872,2.7e-05,172.31.47.0-255,66,1769,96,342773
27873,3.2e-05,172.217.194.0-255,2902,4671,96,342773
27874,3.4e-05,172.31.47.0-255,66,4737,96,342773
27875,4.7e-05,172.217.194.0-255,7156,11893,96,342773
27876,4.9e-05,172.31.47.0-255,66,11959,96,342773
27877,5.5e-05,172.217.194.0-255,5738,17697,96,342773
27878,5.7e-05,172.31.47.0-255,66,17763,96,342773
27879,8.5e-05,172.217.194.0-255,3565,21328,96,342773
27880,9.1e-05,172.31.47.0-255,66,21394,96,342773
27881,9.7e-05,172.217.194.0-255,7156,28550,96,342773
27882,9.9e-05,172.31.47.0-255,66,28616,96,342773
27883,0.000117,172.217.194.0-255,2543,31159,96,342773
27884,0.000119,172.31.47.0-255,66,31225,96,342773
27885,0.000175,172.217.194.0-255,1484,32709,96,342773
27886,0.000178,172.31.47.0-255,66,32775,96,342773
27887,0.0002,172.217.194.0-255,2902,35677,96,342773
27888,0.000202,172.31.47.0-255,66,35743,96,342773
27889,0.000206,172.217.194.0-255,2902,38645,96,342773
27890,0.000208,172.31.47.0-255,66,38711,96,342773
27891,0.00023,172.217.194.0-255,4320,43031,96,342773
27892,0.000232,172.31.47.0-255,66,43097,96,342773
27893,0.000235,172.217.194.0-255,1484,44581,96,342773
27894,0.000237,172.31.47.0-255,66,44647,96,342773
27895,0.000277,172.217.194.0-255,7156,51803,96,342773
27896,0.00028,172.31.47.0-255,66,51869,96,342773
27897,0.000289,172.31.47.0-255,66,51935,96,342773
27898,0.000315,172.217.194.0-255,3602,55537,96,342773
27899,0.000317,172.31.47.0-255,66,55603,96,342773
27900,0.000358,172.217.194.0-255,4642,60245,96,342773
27901,0.000361,172.31.47.0-255,66,60311,96,342773
27902,0.000366,172.217.194.0-255,2902,63213,96,342773
27903,0.000368,172.31.47.0-255,66,63279,96,342773
27904,0.000389,172.217.194.0-255,2902,66181,96,342773
27905,0.000391,172.31.47.0-255,66,66247,96,342773
27906,0.000461,172.31.47.0-255,66,66313,96,342773
27907,0.000479,172.31.47.0-255,66,66379,96,342773
27908,0.000483,172.217.194.0-255,2504,68883,96,342773
27909,0.000486,172.31.47.0-255,66,68949,96,342773
27910,0.00061,172.217.194.0-255,1484,70433,96,342773
27911,0.000625,172.217.194.0-255,2902,73335,96,342773
27912,0.000629,172.31.47.0-255,66,73401,96,342773
27913,0.000663,172.217.194.0-255,5738,79139,96,342773
27914,0.000667,172.31.47.0-255,66,79205,96,342773
27915,0.000673,172.217.194.0-255,5738,84943,96,342773
27916,0.000675,172.31.47.0-255,66,85009,96,342773
27917,0.000702,172.217.194.0-255,4320,89329,96,342773
27918,0.000704,172.31.47.0-255,66,89395,96,342773
27919,0.000735,172.31.47.0-255,66,89461,96,342773
27920,0.00074,172.217.194.0-255,5020,94481,96,342773
27921,0.000742,172.31.47.0-255,66,94547,96,342773
27922,0.000781,172.217.194.0-255,1484,96031,96,342773
27923,0.000796,172.217.194.0-255,2902,98933,96,342773
27924,0.000799,172.31.47.0-255,66,98999,96,342773
27925,0.000829,172.217.194.0-255,5738,104737,96,342773
27926,0.000832,172.31.47.0-255,66,104803,96,342773
27927,0.000839,172.217.194.0-255,7156,111959,96,342773
27928,0.000841,172.31.47.0-255,66,112025,96,342773
27929,0.000878,172.217.194.0-255,2184,114209,96,342773
27930,0.000882,172.31.47.0-255,66,114275,96,342773
27931,0.000885,172.31.47.0-255,66,114341,96,342773
27932,0.001494,172.217.194.0-255,1484,115825,96,342773
27933,0.001506,172.217.194.0-255,1484,117309,96,342773
27934,0.001514,172.31.47.0-255,66,117375,96,342773
27935,0.001518,172.217.194.0-255,1484,118859,96,342773
27936,0.001521,172.217.194.0-255,2902,121761,96,342773
27937,0.001523,172.31.47.0-255,66,121827,96,342773
27938,0.001547,172.217.194.0-255,2902,124729,96,342773
27939,0.001549,172.31.47.0-255,66,124795,96,342773
27940,0.001554,172.217.194.0-255,5738,130533,96,342773
27941,0.001556,172.31.47.0-255,66,130599,96,342773
27942,0.001592,172.217.194.0-255,1484,132083,96,342773
27943,0.001595,172.31.47.0-255,66,132149,96,342773
27944,0.00161,172.217.194.0-255,3602,135751,96,342773
27945,0.001611,172.31.47.0-255,66,135817,96,342773
27946,0.001656,172.217.194.0-255,1484,137301,96,342773
27947,0.001668,172.217.194.0-255,2902,140203,96,342773
27948,0.00167,172.31.47.0-255,66,140269,96,342773
27949,0.001689,172.217.194.0-255,2902,143171,96,342773
27950,0.001693,172.31.47.0-255,66,143237,96,342773
27951,0.001717,172.217.194.0-255,2902,146139,96,342773
27952,0.001719,172.217.194.0-255,1484,147623,96,342773
27953,0.001729,172.31.47.0-255,66,147689,96,342773
27954,0.001733,172.31.47.0-255,66,147755,96,342773
27955,0.001756,172.217.194.0-255,7156,154911,96,342773
27956,0.001761,172.31.47.0-255,66,154977,96,342773
27957,0.001787,172.217.194.0-255,6438,161415,96,342773
27958,0.001789,172.31.47.0-255,66,161481,96,342773
27959,0.001817,172.217.194.0-255,1484,162965,96,342773
27960,0.001834,172.217.194.0-255,2902,165867,96,342773
27961,0.001836,172.31.47.0-255,66,165933,96,342773
27962,0.001863,172.217.194.0-255,5738,171671,96,342773
27963,0.001865,172.31.47.0-255,66,171737,96,342773
27964,0.001898,172.217.194.0-255,5738,177475,96,342773
27965,0.001901,172.31.47.0-255,66,177541,96,342773
27966,0.001929,172.217.194.0-255,7156,184697,96,342773
27967,0.001932,172.31.47.0-255,66,184763,96,342773
27968,0.001937,172.217.194.0-255,5738,190501,96,342773
27969,0.001939,172.31.47.0-255,66,190567,96,342773
27970,0.001992,172.217.194.0-255,5020,195587,96,342773
27971,0.001994,172.31.47.0-255,66,195653,96,342773
27972,0.0023,172.217.194.0-255,1484,197137,96,342773
27973,0.002322,172.217.194.0-255,2902,200039,96,342773
27974,0.002326,172.31.47.0-255,66,200105,96,342773
27975,0.002331,172.217.194.0-255,5738,205843,96,342773
27976,0.002333,172.31.47.0-255,66,205909,96,342773
27977,0.002357,172.217.194.0-255,1484,207393,96,342773
27978,0.002375,172.217.194.0-255,5738,213131,96,342773
27979,0.002377,172.31.47.0-255,66,213197,96,342773
27980,0.002406,172.217.194.0-255,5738,218935,96,342773
27981,0.002409,172.31.47.0-255,66,219001,96,342773
27982,0.002434,172.217.194.0-255,5738,224739,96,342773
27983,0.002436,172.31.47.0-255,66,224805,96,342773
27984,0.002464,172.217.194.0-255,5020,229825,96,342773
27985,0.002466,172.31.47.0-255,66,229891,96,342773
27986,0.00254,172.217.194.0-255,1484,231375,96,342773
27987,0.002544,172.217.194.0-255,1484,232859,96,342773
27988,0.002546,172.31.47.0-255,66,232925,96,342773
27989,0.002569,172.217.194.0-255,1484,234409,96,342773
27990,0.002574,172.217.194.0-255,5738,240147,96,342773
27991,0.002576,172.31.47.0-255,66,240213,96,342773
27992,0.002616,172.217.194.0-255,2902,243115,96,342773
27993,0.002619,172.31.47.0-255,66,243181,96,342773
27994,0.002676,172.217.194.0-255,5738,248919,96,342773
27995,0.00268,172.31.47.0-255,66,248985,96,342773
27996,0.002684,172.217.194.0-255,1484,250469,96,342773
27997,0.002691,172.217.194.0-255,7156,257625,96,342773
27998,0.002698,172.31.47.0-255,66,257691,96,342773
27999,0.002701,172.217.194.0-255,1484,259175,96,342773
28000,0.002706,172.217.194.0-255,5020,264195,96,342773
28001,0.002709,172.31.47.0-255,66,264261,96,342773
28002,0.002853,172.217.194.0-255,1484,265745,96,342773
28003,0.002871,172.217.194.0-255,2902,268647,96,342773
28004,0.002874,172.31.47.0-255,66,268713,96,342773
28005,0.002878,172.217.194.0-255,1484,270197,96,342773
28006,0.002904,172.217.194.0-255,7156,277353,96,342773
28007,0.002907,172.31.47.0-255,66,277419,96,342773
28008,0.002932,172.217.194.0-255,1484,278903,96,342773
28009,0.002937,172.217.194.0-255,2902,281805,96,342773
28010,0.002939,172.31.47.0-255,66,281871,96,342773
28011,0.002942,172.217.194.0-255,1484,283355,96,342773
28012,0.002949,172.217.194.0-255,7156,290511,96,342773
28013,0.002955,172.31.47.0-255,66,290577,96,342773
28014,0.002983,172.217.194.0-255,1484,292061,96,342773
28015,0.002986,172.217.194.0-255,1484,293545,96,342773
28016,0.002989,172.31.47.0-255,66,293611,96,342773
28017,0.002994,172.217.194.0-255,4320,297931,96,342773
28018,0.002996,172.31.47.0-255,66,297997,96,342773
28019,0.002999,172.217.194.0-255,766,298763,96,342773
28020,0.003031,172.217.194.0-255,1484,300247,96,342773
28021,0.003034,172.31.47.0-255,66,300313,96,342773
28022,0.003038,172.217.194.0-255,2902,303215,96,342773
28023,0.00304,172.31.47.0-255,66,303281,96,342773
28024,0.003072,172.217.194.0-255,5738,309019,96,342773
28025,0.003076,172.31.47.0-255,66,309085,96,342773
28026,0.003081,172.217.194.0-255,4320,313405,96,342773
28027,0.003083,172.31.47.0-255,66,313471,96,342773
28028,0.003114,172.217.194.0-255,2902,316373,96,342773
28029,0.003117,172.31.47.0-255,66,316439,96,342773
28030,0.003128,172.31.47.0-255,66,316505,96,342773
28031,0.003152,172.217.194.0-255,5738,322243,96,342773
28032,0.003155,172.31.47.0-255,66,322309,96,342773
28033,0.003173,172.217.194.0-255,3602,325911,96,342773
28034,0.003176,172.31.47.0-255,66,325977,96,342773
28035,0.00318,172.217.194.0-255,2902,328879,96,342773
28036,0.003182,172.31.47.0-255,66,328945,96,342773
28037,0.003211,172.217.194.0-255,1484,330429,96,342773
28038,0.003219,172.217.194.0-255,7156,337585,96,342773
28039,0.003221,172.31.47.0-255,66,337651,96,342773
28040,0.003244,172.217.194.0-255,322,337973,96,342773
28041,0.003247,172.217.194.0-255,97,338070,96,342773
28042,0.00329,172.217.194.0-255,105,338175,96,342773
28043,0.00543,172.31.47.0-255,66,338241,96,342773
28044,0.005468,172.31.47.0-255,105,338346,96,342773
28045,0.008063,172.217.194.0-255,66,338412,96,342773
28046,0.050269,172.31.47.0-255,172,338584,96,342773
28047,0.050304,172.31.47.0-255,1101,339685,96,342773
28048,0.050367,172.31.47.0-255,1514,341199,96,342773
28049,0.050389,172.31.47.0-255,1310,342509,96,342773
28050,0.051802,104.244.42.0-255,66,342575,96,342773
28051,0.05183,104.244.42.0-255,66,342641,96,342773
28052,0.051884,104.244.42.0-255,66,342707,96,342773
28053,0.051936,104.244.42.0-255,66,342773,96,342773
28054,0.0,172.217.194.0-255,153,153,96,276822
28055,3.2e-05,172.31.47.0-255,66,219,96,276822
28056,3.9e-05,172.217.194.0-255,1484,1703,96,276822
28057,4.3e-05,172.31.47.0-255,66,1769,96,276822
28058,4.8e-05,172.217.194.0-255,2902,4671,96,276822
28059,5.1e-05,172.31.47.0-255,66,4737,96,276822
28060,6.6e-05,172.217.194.0-255,7156,11893,96,276822
28061,6.9e-05,172.31.47.0-255,66,11959,96,276822
28062,7.3e-05,172.217.194.0-255,2012,13971,96,276822
28063,7.5e-05,172.31.47.0-255,66,14037,96,276822
28064,0.000125,172.217.194.0-255,1484,15521,96,276822
28065,0.000128,172.31.47.0-255,66,15587,96,276822
28066,0.000133,172.217.194.0-255,2902,18489,96,276822
28067,0.000136,172.31.47.0-255,66,18555,96,276822
28068,0.000171,172.217.194.0-255,2902,21457,96,276822
28069,0.000173,172.31.47.0-255,66,21523,96,276822
28070,0.000197,172.217.194.0-255,2902,24425,96,276822
28071,0.000199,172.31.47.0-255,66,24491,96,276822
28072,0.000207,172.217.194.0-255,6797,31288,96,276822
28073,0.000209,172.31.47.0-255,66,31354,96,276822
28074,0.000237,172.217.194.0-255,1484,32838,96,276822
28075,0.00024,172.31.47.0-255,66,32904,96,276822
28076,0.000244,172.217.194.0-255,2902,35806,96,276822
28077,0.000246,172.31.47.0-255,66,35872,96,276822
28078,0.000252,172.217.194.0-255,5738,41610,96,276822
28079,0.000261,172.31.47.0-255,66,41676,96,276822
28080,0.000268,172.217.194.0-255,6797,48473,96,276822
28081,0.000271,172.31.47.0-255,66,48539,96,276822
28082,0.001259,172.217.194.0-255,1484,50023,96,276822
28083,0.001265,172.31.47.0-255,66,50089,96,276822
28084,0.001274,172.217.194.0-255,2902,52991,96,276822
28085,0.001275,172.31.47.0-255,66,53057,96,276822
28086,0.001285,172.217.194.0-255,5738,58795,96,276822
28087,0.001287,172.31.47.0-255,66,58861,96,276822
28088,0.001329,172.217.194.0-255,6797,65658,96,276822
28089,0.001331,172.31.47.0-255,66,65724,96,276822
28090,0.001531,172.217.194.0-255,1484,67208,96,276822
28091,0.001538,172.217.194.0-255,2902,70110,96,276822
28092,0.001541,172.31.47.0-255,66,70176,96,276822
28093,0.001569,172.217.194.0-255,5738,75914,96,276822
28094,0.001571,172.31.47.0-255,66,75980,96,276822
28095,0.001576,172.217.194.0-255,4320,80300,96,276822
28096,0.001578,172.31.47.0-255,66,80366,96,276822
28097,0.001619,172.31.47.0-255,66,80432,96,276822
28098,0.001628,172.31.47.0-255,66,80498,96,276822
28099,0.00358,172.217.194.0-255,5738,86236,96,276822
28100,0.003585,172.31.47.0-255,66,86302,96,276822
28101,0.005576,172.217.194.0-255,5738,92040,96,276822
28102,0.005582,172.31.47.0-255,66,92106,96,276822
28103,0.007531,172.217.194.0-255,5738,97844,96,276822
28104,0.007537,172.31.47.0-255,66,97910,96,276822
28105,0.009494,172.217.194.0-255,5738,103648,96,276822
28106,0.0095,172.31.47.0-255,66,103714,96,276822
28107,0.01147,172.217.194.0-255,5738,109452,96,276822
28108,0.011478,172.31.47.0-255,66,109518,96,276822
28109,0.013435,172.217.194.0-255,5738,115256,96,276822
28110,0.013442,172.31.47.0-255,66,115322,96,276822
28111,0.015413,172.217.194.0-255,5738,121060,96,276822
28112,0.01542,172.31.47.0-255,66,121126,96,276822
28113,0.017402,172.217.194.0-255,5738,126864,96,276822
28114,0.017408,172.31.47.0-255,66,126930,96,276822
28115,0.019049,172.31.47.0-255,172,127102,96,276822
28116,0.019091,172.31.47.0-255,1111,128213,96,276822
28117,0.019151,172.31.47.0-255,1514,129727,96,276822
28118,0.019152,172.31.47.0-255,1301,131028,96,276822
28119,0.019401,172.217.194.0-255,5738,136766,96,276822
28120,0.019406,172.31.47.0-255,66,136832,96,276822
28121,0.020567,104.244.42.0-255,66,136898,96,276822
28122,0.020655,104.244.42.0-255,66,136964,96,276822
28123,0.020707,104.244.42.0-255,66,137030,96,276822
28124,0.021363,172.217.194.0-255,5738,142768,96,276822
28125,0.021368,172.31.47.0-255,66,142834,96,276822
28126,0.023354,172.217.194.0-255,5738,148572,96,276822
28127,0.023359,172.31.47.0-255,66,148638,96,276822
28128,0.025323,172.217.194.0-255,4320,152958,96,276822
28129,0.025327,172.31.47.0-255,66,153024,96,276822
28130,0.025352,172.217.194.0-255,1484,154508,96,276822
28131,0.027284,172.217.194.0-255,4320,158828,96,276822
28132,0.027288,172.31.47.0-255,66,158894,96,276822
28133,0.029247,172.217.194.0-255,5738,164632,96,276822
28134,0.029251,172.31.47.0-255,66,164698,96,276822
28135,0.031207,172.217.194.0-255,5738,170436,96,276822
28136,0.031212,172.31.47.0-255,66,170502,96,276822
28137,0.03317,172.217.194.0-255,4320,174822,96,276822
28138,0.033175,172.31.47.0-255,66,174888,96,276822
28139,0.033202,172.217.194.0-255,1484,176372,96,276822
28140,0.035122,172.217.194.0-255,4320,180692,96,276822
28141,0.035126,172.31.47.0-255,66,180758,96,276822
28142,0.037074,172.217.194.0-255,4320,185078,96,276822
28143,0.037079,172.31.47.0-255,66,185144,96,276822
28144,0.037103,172.217.194.0-255,1484,186628,96,276822
28145,0.03908,172.217.194.0-255,4320,190948,96,276822
28146,0.039084,172.31.47.0-255,66,191014,96,276822
28147,0.041048,172.217.194.0-255,5738,196752,96,276822
28148,0.041053,172.31.47.0-255,66,196818,96,276822
28149,0.043027,172.217.194.0-255,5738,202556,96,276822
28150,0.043032,172.31.47.0-255,66,202622,96,276822
28151,0.044972,172.217.194.0-255,4320,206942,96,276822
28152,0.044976,172.31.47.0-255,66,207008,96,276822
28153,0.045003,172.217.194.0-255,1484,208492,96,276822
28154,0.046944,172.217.194.0-255,2902,211394,96,276822
28155,0.046949,172.31.47.0-255,66,211460,96,276822
28156,0.046979,172.217.194.0-255,1484,212944,96,276822
28157,0.048903,172.217.194.0-255,4320,217264,96,276822
28158,0.048907,172.31.47.0-255,66,217330,96,276822
28159,0.050853,172.217.194.0-255,2902,220232,96,276822
28160,0.050858,172.31.47.0-255,66,220298,96,276822
28161,0.050886,172.217.194.0-255,2902,223200,96,276822
28162,0.050888,172.31.47.0-255,66,223266,96,276822
28163,0.052815,172.217.194.0-255,2902,226168,96,276822
28164,0.052819,172.31.47.0-255,66,226234,96,276822
28165,0.052855,172.217.194.0-255,1484,227718,96,276822
28166,0.052872,172.217.194.0-255,1484,229202,96,276822
28167,0.052875,172.31.47.0-255,66,229268,96,276822
28168,0.054777,172.217.194.0-255,2902,232170,96,276822
28169,0.054782,172.31.47.0-255,66,232236,96,276822
28170,0.054832,172.217.194.0-255,2902,235138,96,276822
28171,0.054835,172.31.47.0-255,66,235204,96,276822
28172,0.056737,172.217.194.0-255,2902,238106,96,276822
28173,0.056741,172.31.47.0-255,66,238172,96,276822
28174,0.056776,172.217.194.0-255,2902,241074,96,276822
28175,0.05678,172.31.47.0-255,66,241140,96,276822
28176,0.05873,172.217.194.0-255,2902,244042,96,276822
28177,0.058735,172.31.47.0-255,66,244108,96,276822
28178,0.058762,172.217.194.0-255,2902,247010,96,276822
28179,0.058765,172.31.47.0-255,66,247076,96,276822
28180,0.060709,172.217.194.0-255,2902,249978,96,276822
28181,0.060714,172.31.47.0-255,66,250044,96,276822
28182,0.060745,172.217.194.0-255,2902,252946,96,276822
28183,0.060749,172.31.47.0-255,66,253012,96,276822
28184,0.062672,172.217.194.0-255,2902,255914,96,276822
28185,0.062676,172.31.47.0-255,66,255980,96,276822
28186,0.06271,172.217.194.0-255,2902,258882,96,276822
28187,0.062712,172.31.47.0-255,66,258948,96,276822
28188,0.064642,172.217.194.0-255,2902,261850,96,276822
28189,0.064646,172.31.47.0-255,66,261916,96,276822
28190,0.064676,172.217.194.0-255,2902,264818,96,276822
28191,0.064679,172.31.47.0-255,66,264884,96,276822
28192,0.066603,172.217.194.0-255,2902,267786,96,276822
28193,0.066609,172.31.47.0-255,66,267852,96,276822
28194,0.066641,172.217.194.0-255,1484,269336,96,276822
28195,0.066652,172.217.194.0-255,1484,270820,96,276822
28196,0.066655,172.31.47.0-255,66,270886,96,276822
28197,0.06856,172.217.194.0-255,2902,273788,96,276822
28198,0.068565,172.31.47.0-255,66,273854,96,276822
28199,0.068598,172.217.194.0-255,2902,276756,96,276822
28200,0.068602,172.31.47.0-255,66,276822,96,276822
28201,0.0,74.125.24.0-255,152,152,96,349367
28202,2.7e-05,172.31.47.0-255,66,218,96,349367
28203,3.3e-05,74.125.24.0-255,1484,1702,96,349367
28204,3.7e-05,172.31.47.0-255,66,1768,96,349367
28205,4.1e-05,74.125.24.0-255,2902,4670,96,349367
28206,4.3e-05,172.31.47.0-255,66,4736,96,349367
28207,4.9e-05,74.125.24.0-255,7156,11892,96,349367
28208,5.1e-05,172.31.47.0-255,66,11958,96,349367
28209,7.1e-05,74.125.24.0-255,2216,14174,96,349367
28210,7.4e-05,172.31.47.0-255,66,14240,96,349367
28211,0.000161,74.125.24.0-255,1484,15724,96,349367
28212,0.000165,172.31.47.0-255,66,15790,96,349367
28213,0.000168,74.125.24.0-255,1484,17274,96,349367
28214,0.00017,172.31.47.0-255,66,17340,96,349367
28215,0.000187,74.125.24.0-255,1484,18824,96,349367
28216,0.000189,172.31.47.0-255,66,18890,96,349367
28217,0.000194,74.125.24.0-255,5738,24628,96,349367
28218,0.000196,172.31.47.0-255,66,24694,96,349367
28219,0.000241,74.125.24.0-255,6797,31491,96,349367
28220,0.000244,172.31.47.0-255,66,31557,96,349367
28221,0.000336,74.125.24.0-255,1484,33041,96,349367
28222,0.000339,172.31.47.0-255,66,33107,96,349367
28223,0.000344,74.125.24.0-255,2902,36009,96,349367
28224,0.000348,172.31.47.0-255,66,36075,96,349367
28225,0.000355,74.125.24.0-255,1484,37559,96,349367
28226,0.000357,172.31.47.0-255,66,37625,96,349367
28227,0.000378,74.125.24.0-255,4320,41945,96,349367
28228,0.000381,172.31.47.0-255,66,42011,96,349367
28229,0.000387,74.125.24.0-255,6797,48808,96,349367
28230,0.000389,172.31.47.0-255,66,48874,96,349367
28231,0.000467,74.125.24.0-255,1484,50358,96,349367
28232,0.00047,172.31.47.0-255,66,50424,96,349367
28233,0.000474,74.125.24.0-255,2902,53326,96,349367
28234,0.000476,172.31.47.0-255,66,53392,96,349367
28235,0.000489,74.125.24.0-255,1484,54876,96,349367
28236,0.000502,74.125.24.0-255,2902,57778,96,349367
28237,0.000505,172.31.47.0-255,66,57844,96,349367
28238,0.000523,74.125.24.0-255,2902,60746,96,349367
28239,0.000525,172.31.47.0-255,66,60812,96,349367
28240,0.000545,74.125.24.0-255,5712,66524,96,349367
28241,0.000549,172.31.47.0-255,66,66590,96,349367
28242,0.000564,74.125.24.0-255,376,66966,96,349367
28243,0.000699,172.31.47.0-255,66,67032,96,349367
28244,0.000939,74.125.24.0-255,1484,68516,96,349367
28245,0.000947,74.125.24.0-255,2902,71418,96,349367
28246,0.000951,172.31.47.0-255,66,71484,96,349367
28247,0.000956,74.125.24.0-255,2902,74386,96,349367
28248,0.000958,172.31.47.0-255,66,74452,96,349367
28249,0.000969,74.125.24.0-255,2902,77354,96,349367
28250,0.00097,172.31.47.0-255,66,77420,96,349367
28251,0.000986,74.125.24.0-255,1484,78904,96,349367
28252,0.001008,172.31.47.0-255,66,78970,96,349367
28253,0.001025,74.125.24.0-255,1484,80454,96,349367
28254,0.001049,74.125.24.0-255,4320,84774,96,349367
28255,0.001052,172.31.47.0-255,66,84840,96,349367
28256,0.001072,74.125.24.0-255,6438,91278,96,349367
28257,0.001074,172.31.47.0-255,66,91344,96,349367
28258,0.001625,74.125.24.0-255,1484,92828,96,349367
28259,0.001633,74.125.24.0-255,2902,95730,96,349367
28260,0.001636,172.31.47.0-255,66,95796,96,349367
28261,0.001642,74.125.24.0-255,5738,101534,96,349367
28262,0.001644,172.31.47.0-255,66,101600,96,349367
28263,0.001673,172.31.47.0-255,66,101666,96,349367
28264,0.001683,74.125.24.0-255,1484,103150,96,349367
28265,0.001718,172.31.47.0-255,66,103216,96,349367
28266,0.001734,74.125.24.0-255,766,103982,96,349367
28267,0.001823,74.125.24.0-255,1484,105466,96,349367
28268,0.001827,172.31.47.0-255,66,105532,96,349367
28269,0.001832,74.125.24.0-255,1484,107016,96,349367
28270,0.001844,74.125.24.0-255,1484,108500,96,349367
28271,0.001846,172.31.47.0-255,66,108566,96,349367
28272,0.001849,74.125.24.0-255,1484,110050,96,349367
28273,0.001865,74.125.24.0-255,4320,114370,96,349367
28274,0.001867,172.31.47.0-255,66,114436,96,349367
28275,0.001908,172.31.47.0-255,66,114502,96,349367
28276,0.001914,74.125.24.0-255,7156,121658,96,349367
28277,0.001916,172.31.47.0-255,66,121724,96,349367
28278,0.001963,74.125.24.0-255,3602,125326,96,349367
28279,0.001966,172.31.47.0-255,66,125392,96,349367
28280,0.002211,74.125.24.0-255,1484,126876,96,349367
28281,0.002237,74.125.24.0-255,2902,129778,96,349367
28282,0.002241,172.31.47.0-255,66,129844,96,349367
28283,0.002258,74.125.24.0-255,4320,134164,96,349367
28284,0.002261,172.31.47.0-255,66,134230,96,349367
28285,0.002277,74.125.24.0-255,1484,135714,96,349367
28286,0.00228,74.125.24.0-255,2902,138616,96,349367
28287,0.002282,172.31.47.0-255,66,138682,96,349367
28288,0.002285,74.125.24.0-255,1484,140166,96,349367
28289,0.002312,172.31.47.0-255,66,140232,96,349367
28290,0.002325,74.125.24.0-255,4320,144552,96,349367
28291,0.002327,172.31.47.0-255,66,144618,96,349367
28292,0.002344,74.125.24.0-255,6438,151056,96,349367
28293,0.002347,172.31.47.0-255,66,151122,96,349367
28294,0.002417,74.125.24.0-255,1484,152606,96,349367
28295,0.002421,74.125.24.0-255,1484,154090,96,349367
28296,0.002423,172.31.47.0-255,66,154156,96,349367
28297,0.002439,74.125.24.0-255,1484,155640,96,349367
28298,0.002444,74.125.24.0-255,5738,161378,96,349367
28299,0.002447,172.31.47.0-255,66,161444,96,349367
28300,0.002471,74.125.24.0-255,2902,164346,96,349367
28301,0.002473,172.31.47.0-255,66,164412,96,349367
28302,0.002498,172.31.47.0-255,66,164478,96,349367
28303,0.002531,74.125.24.0-255,7156,171634,96,349367
28304,0.002534,172.31.47.0-255,66,171700,96,349367
28305,0.002545,74.125.24.0-255,3602,175302,96,349367
28306,0.002547,172.31.47.0-255,66,175368,96,349367
28307,0.002596,74.125.24.0-255,1484,176852,96,349367
28308,0.002614,74.125.24.0-255,2902,179754,96,349367
28309,0.002617,172.31.47.0-255,66,179820,96,349367
28310,0.002623,74.125.24.0-255,5738,185558,96,349367
28311,0.002624,172.31.47.0-255,66,185624,96,349367
28312,0.002655,74.125.24.0-255,5738,191362,96,349367
28313,0.002658,172.31.47.0-255,66,191428,96,349367
28314,0.00269,74.125.24.0-255,7156,198584,96,349367
28315,0.002693,172.31.47.0-255,66,198650,96,349367
28316,0.002696,74.125.24.0-255,1484,200134,96,349367
28317,0.005316,74.125.24.0-255,4320,204454,96,349367
28318,0.005323,172.31.47.0-255,66,204520,96,349367
28319,0.007948,74.125.24.0-255,5738,210258,96,349367
28320,0.007954,172.31.47.0-255,66,210324,96,349367
28321,0.010596,74.125.24.0-255,5738,216062,96,349367
28322,0.010602,172.31.47.0-255,66,216128,96,349367
28323,0.013256,74.125.24.0-255,5738,221866,96,349367
28324,0.013263,172.31.47.0-255,66,221932,96,349367
28325,0.015901,74.125.24.0-255,5738,227670,96,349367
28326,0.015912,172.31.47.0-255,66,227736,96,349367
28327,0.018552,74.125.24.0-255,5738,233474,96,349367
28328,0.018558,172.31.47.0-255,66,233540,96,349367
28329,0.021208,74.125.24.0-255,5738,239278,96,349367
28330,0.021213,172.31.47.0-255,66,239344,96,349367
28331,0.023831,74.125.24.0-255,5738,245082,96,349367
28332,0.023837,172.31.47.0-255,66,245148,96,349367
28333,0.025173,172.31.47.0-255,172,245320,96,349367
28334,0.025194,172.31.47.0-255,1105,246425,96,349367
28335,0.025282,172.31.47.0-255,1514,247939,96,349367
28336,0.025284,172.31.47.0-255,1308,249247,96,349367
28337,0.026467,74.125.24.0-255,5738,254985,96,349367
28338,0.026472,172.31.47.0-255,66,255051,96,349367
28339,0.026657,104.244.42.0-255,66,255117,96,349367
28340,0.026682,104.244.42.0-255,66,255183,96,349367
28341,0.026788,104.244.42.0-255,66,255249,96,349367
28342,0.029085,74.125.24.0-255,5738,260987,96,349367
28343,0.02909,172.31.47.0-255,66,261053,96,349367
28344,0.031702,74.125.24.0-255,2902,263955,96,349367
28345,0.031706,172.31.47.0-255,66,264021,96,349367
28346,0.031737,74.125.24.0-255,2902,266923,96,349367
28347,0.03174,172.31.47.0-255,66,266989,96,349367
28348,0.034318,74.125.24.0-255,2902,269891,96,349367
28349,0.034322,172.31.47.0-255,66,269957,96,349367
28350,0.034346,74.125.24.0-255,2902,272859,96,349367
28351,0.034349,172.31.47.0-255,66,272925,96,349367
28352,0.036907,74.125.24.0-255,2902,275827,96,349367
28353,0.036911,172.31.47.0-255,66,275893,96,349367
28354,0.036982,74.125.24.0-255,2902,278795,96,349367
28355,0.036986,172.31.47.0-255,66,278861,96,349367
28356,0.039527,74.125.24.0-255,2902,281763,96,349367
28357,0.039531,172.31.47.0-255,66,281829,96,349367
28358,0.039602,74.125.24.0-255,2902,284731,96,349367
28359,0.039605,172.31.47.0-255,66,284797,96,349367
28360,0.042144,74.125.24.0-255,2902,287699,96,349367
28361,0.042149,172.31.47.0-255,66,287765,96,349367
28362,0.042228,74.125.24.0-255,2902,290667,96,349367
28363,0.042233,172.31.47.0-255,66,290733,96,349367
28364,0.044771,74.125.24.0-255,2902,293635,96,349367
28365,0.044789,172.31.47.0-255,66,293701,96,349367
28366,0.044843,74.125.24.0-255,2902,296603,96,349367
28367,0.044846,172.31.47.0-255,66,296669,96,349367
28368,0.047374,74.125.24.0-255,2902,299571,96,349367
28369,0.047379,172.31.47.0-255,66,299637,96,349367
28370,0.047449,74.125.24.0-255,2902,302539,96,349367
28371,0.047455,172.31.47.0-255,66,302605,96,349367
28372,0.049986,74.125.24.0-255,2902,305507,96,349367
28373,0.04999,172.31.47.0-255,66,305573,96,349367
28374,0.050022,74.125.24.0-255,2902,308475,96,349367
28375,0.050025,172.31.47.0-255,66,308541,96,349367
28376,0.052612,74.125.24.0-255,5738,314279,96,349367
28377,0.052617,172.31.47.0-255,66,314345,96,349367
28378,0.05522,74.125.24.0-255,5738,320083,96,349367
28379,0.055225,172.31.47.0-255,66,320149,96,349367
28380,0.057825,74.125.24.0-255,5738,325887,96,349367
28381,0.057831,172.31.47.0-255,66,325953,96,349367
28382,0.060417,74.125.24.0-255,5738,331691,96,349367
28383,0.060421,172.31.47.0-255,66,331757,96,349367
28384,0.063028,74.125.24.0-255,2902,334659,96,349367
28385,0.063032,172.31.47.0-255,66,334725,96,349367
28386,0.063054,74.125.24.0-255,2902,337627,96,349367
28387,0.063057,172.31.47.0-255,66,337693,96,349367
28388,0.065627,74.125.24.0-255,1484,339177,96,349367
28389,0.065655,74.125.24.0-255,4320,343497,96,349367
28390,0.065658,172.31.47.0-255,66,343563,96,349367
28391,0.068271,74.125.24.0-255,5738,349301,96,349367
28392,0.068276,172.31.47.0-255,66,349367,96,349367
28393,0.0,74.125.24.0-255,152,152,96,250130
28394,3.2e-05,172.31.47.0-255,66,218,96,250130
28395,3.9e-05,74.125.24.0-255,1484,1702,96,250130
28396,4.2e-05,172.31.47.0-255,66,1768,96,250130
28397,4.7e-05,74.125.24.0-255,2902,4670,96,250130
28398,5.6e-05,172.31.47.0-255,66,4736,96,250130
28399,6.2e-05,74.125.24.0-255,7156,11892,96,250130
28400,6.5e-05,172.31.47.0-255,66,11958,96,250130
28401,6.9e-05,74.125.24.0-255,4934,16892,96,250130
28402,7.2e-05,172.31.47.0-255,66,16958,96,250130
28403,8.4e-05,172.31.47.0-255,66,17024,96,250130
28404,0.000138,74.125.24.0-255,1484,18508,96,250130
28405,0.000143,172.31.47.0-255,66,18574,96,250130
28406,0.000147,74.125.24.0-255,2902,21476,96,250130
28407,0.000149,172.31.47.0-255,66,21542,96,250130
28408,0.000177,74.125.24.0-255,5738,27280,96,250130
28409,0.000181,172.31.47.0-255,66,27346,96,250130
28410,0.000187,74.125.24.0-255,5738,33084,96,250130
28411,0.000191,172.31.47.0-255,66,33150,96,250130
28412,0.000219,74.125.24.0-255,7156,40306,96,250130
28413,0.000221,172.31.47.0-255,66,40372,96,250130
28414,0.000244,74.125.24.0-255,6797,47169,96,250130
28415,0.000247,172.31.47.0-255,66,47235,96,250130
28416,0.00025,74.125.24.0-255,1484,48719,96,250130
28417,0.000252,172.31.47.0-255,66,48785,96,250130
28418,0.00028,74.125.24.0-255,2821,51606,96,250130
28419,0.000283,172.31.47.0-255,66,51672,96,250130
28420,0.000456,74.125.24.0-255,131,51803,96,250130
28421,0.00046,172.31.47.0-255,66,51869,96,250130
28422,0.000585,74.125.24.0-255,1484,53353,96,250130
28423,0.000588,172.31.47.0-255,66,53419,96,250130
28424,0.000594,74.125.24.0-255,2902,56321,96,250130
28425,0.000596,172.31.47.0-255,66,56387,96,250130
28426,0.000642,74.125.24.0-255,5738,62125,96,250130
28427,0.000645,172.31.47.0-255,66,62191,96,250130
28428,0.000654,172.31.47.0-255,66,62257,96,250130
28429,0.000681,74.125.24.0-255,5379,67636,96,250130
28430,0.000684,172.31.47.0-255,66,67702,96,250130
28431,0.000709,74.125.24.0-255,2902,70604,96,250130
28432,0.000712,172.31.47.0-255,66,70670,96,250130
28433,0.000738,74.125.24.0-255,6797,77467,96,250130
28434,0.000741,172.31.47.0-255,66,77533,96,250130
28435,0.000934,74.125.24.0-255,1484,79017,96,250130
28436,0.00094,74.125.24.0-255,2902,81919,96,250130
28437,0.000942,172.31.47.0-255,66,81985,96,250130
28438,0.000946,74.125.24.0-255,2902,84887,96,250130
28439,0.000948,172.31.47.0-255,66,84953,96,250130
28440,0.000967,74.125.24.0-255,2902,87855,96,250130
28441,0.000969,172.31.47.0-255,66,87921,96,250130
28442,0.000992,74.125.24.0-255,4320,92241,96,250130
28443,0.000995,172.31.47.0-255,66,92307,96,250130
28444,0.001025,172.31.47.0-255,66,92373,96,250130
28445,0.001028,74.125.24.0-255,1484,93857,96,250130
28446,0.001068,74.125.24.0-255,4320,98177,96,250130
28447,0.001071,172.31.47.0-255,66,98243,96,250130
28448,0.001094,74.125.24.0-255,5020,103263,96,250130
28449,0.001096,172.31.47.0-255,66,103329,96,250130
28450,0.001138,74.125.24.0-255,1484,104813,96,250130
28451,0.001142,74.125.24.0-255,2902,107715,96,250130
28452,0.001145,172.31.47.0-255,66,107781,96,250130
28453,0.001167,74.125.24.0-255,4320,112101,96,250130
28454,0.00117,172.31.47.0-255,66,112167,96,250130
28455,0.001187,74.125.24.0-255,1484,113651,96,250130
28456,0.001198,172.31.47.0-255,66,113717,96,250130
28457,0.001201,74.125.24.0-255,1484,115201,96,250130
28458,0.001233,172.31.47.0-255,66,115267,96,250130
28459,0.001266,74.125.24.0-255,3602,118869,96,250130
28460,0.001272,172.31.47.0-255,66,118935,96,250130
28461,0.00128,172.31.47.0-255,66,119001,96,250130
28462,0.001293,172.31.47.0-255,66,119067,96,250130
28463,0.001295,74.125.24.0-255,1484,120551,96,250130
28464,0.001299,74.125.24.0-255,2902,123453,96,250130
28465,0.001301,172.31.47.0-255,66,123519,96,250130
28466,0.001305,74.125.24.0-255,5738,129257,96,250130
28467,0.001308,172.31.47.0-255,66,129323,96,250130
28468,0.001319,172.31.47.0-255,66,129389,96,250130
28469,0.001324,74.125.24.0-255,5738,135127,96,250130
28470,0.001326,172.31.47.0-255,66,135193,96,250130
28471,0.001349,74.125.24.0-255,2902,138095,96,250130
28472,0.001352,172.31.47.0-255,66,138161,96,250130
28473,0.001356,74.125.24.0-255,2184,140345,96,250130
28474,0.001358,172.31.47.0-255,66,140411,96,250130
28475,0.001388,74.125.24.0-255,2902,143313,96,250130
28476,0.00139,172.31.47.0-255,66,143379,96,250130
28477,0.001395,74.125.24.0-255,2902,146281,96,250130
28478,0.001396,172.31.47.0-255,66,146347,96,250130
28479,0.001419,74.125.24.0-255,4320,150667,96,250130
28480,0.001421,172.31.47.0-255,66,150733,96,250130
28481,0.001473,172.31.47.0-255,66,150799,96,250130
28482,0.001513,74.125.24.0-255,1484,152283,96,250130
28483,0.001532,172.31.47.0-255,66,152349,96,250130
28484,0.001545,172.31.47.0-255,66,152415,96,250130
28485,0.001554,172.31.47.0-255,66,152481,96,250130
28486,0.001584,74.125.24.0-255,2902,155383,96,250130
28487,0.001586,172.31.47.0-255,66,155449,96,250130
28488,0.001617,74.125.24.0-255,6015,161464,96,250130
28489,0.00162,172.31.47.0-255,66,161530,96,250130
28490,0.001629,172.31.47.0-255,66,161596,96,250130
28491,0.001652,74.125.24.0-255,1484,163080,96,250130
28492,0.001659,74.125.24.0-255,7156,170236,96,250130
28493,0.001669,172.31.47.0-255,66,170302,96,250130
28494,0.001693,74.125.24.0-255,1484,171786,96,250130
28495,0.001714,74.125.24.0-255,6438,178224,96,250130
28496,0.00172,172.31.47.0-255,66,178290,96,250130
28497,0.001757,74.125.24.0-255,1484,179774,96,250130
28498,0.001769,74.125.24.0-255,2902,182676,96,250130
28499,0.001771,172.31.47.0-255,66,182742,96,250130
28500,0.001774,74.125.24.0-255,1484,184226,96,250130
28501,0.001795,74.125.24.0-255,4320,188546,96,250130
28502,0.001797,74.125.24.0-255,1484,190030,96,250130
28503,0.001799,172.31.47.0-255,66,190096,96,250130
28504,0.001799,74.125.24.0-255,1484,191580,96,250130
28505,0.001803,172.31.47.0-255,66,191646,96,250130
28506,0.001837,74.125.24.0-255,7156,198802,96,250130
28507,0.001844,172.31.47.0-255,66,198868,96,250130
28508,0.001851,74.125.24.0-255,1484,200352,96,250130
28509,0.001883,172.31.47.0-255,66,200418,96,250130
28510,0.003824,74.125.24.0-255,5738,206156,96,250130
28511,0.003831,172.31.47.0-255,66,206222,96,250130
28512,0.005795,74.125.24.0-255,5738,211960,96,250130
28513,0.005799,172.31.47.0-255,66,212026,96,250130
28514,0.007716,74.125.24.0-255,5738,217764,96,250130
28515,0.007721,172.31.47.0-255,66,217830,96,250130
28516,0.009693,74.125.24.0-255,2902,220732,96,250130
28517,0.009699,172.31.47.0-255,66,220798,96,250130
28518,0.009728,74.125.24.0-255,2902,223700,96,250130
28519,0.009731,172.31.47.0-255,66,223766,96,250130
28520,0.011654,74.125.24.0-255,2902,226668,96,250130
28521,0.011666,172.31.47.0-255,66,226734,96,250130
28522,0.011696,74.125.24.0-255,2902,229636,96,250130
28523,0.011699,172.31.47.0-255,66,229702,96,250130
28524,0.013578,74.125.24.0-255,2902,232604,96,250130
28525,0.013584,172.31.47.0-255,66,232670,96,250130
28526,0.013615,74.125.24.0-255,2902,235572,96,250130
28527,0.013619,172.31.47.0-255,66,235638,96,250130
28528,0.01551,74.125.24.0-255,2902,238540,96,250130
28529,0.015519,172.31.47.0-255,66,238606,96,250130
28530,0.015548,74.125.24.0-255,2902,241508,96,250130
28531,0.01555,172.31.47.0-255,66,241574,96,250130
28532,0.01746,74.125.24.0-255,4024,245598,96,250130
28533,0.017467,172.31.47.0-255,66,245664,96,250130
28534,0.017667,172.31.47.0-255,105,245769,96,250130
28535,0.019573,74.125.24.0-255,66,245835,96,250130
28536,0.029272,172.31.47.0-255,172,246007,96,250130
28537,0.029302,172.31.47.0-255,1105,247112,96,250130
28538,0.029332,172.31.47.0-255,1514,248626,96,250130
28539,0.029334,172.31.47.0-255,1306,249932,96,250130
28540,0.030828,104.244.42.0-255,66,249998,96,250130
28541,0.030872,104.244.42.0-255,66,250064,96,250130
28542,0.030876,104.244.42.0-255,66,250130,96,250130
28543,0.0,172.31.47.0-255,164,164,96,230
28544,0.005824,216.58.203.0-255,66,230,96,230
28545,0.0,172.217.24.0-255,153,153,96,351183
28546,2.5e-05,172.31.47.0-255,66,219,96,351183
28547,3.1e-05,172.217.24.0-255,1484,1703,96,351183
28548,3.5e-05,172.31.47.0-255,66,1769,96,351183
28549,3.9e-05,172.217.24.0-255,2902,4671,96,351183
28550,4.1e-05,172.31.47.0-255,66,4737,96,351183
28551,5.3e-05,172.217.24.0-255,7156,11893,96,351183
28552,5.6e-05,172.31.47.0-255,66,11959,96,351183
28553,5.9e-05,172.217.24.0-255,2103,14062,96,351183
28554,6.1e-05,172.31.47.0-255,66,14128,96,351183
28555,0.000205,172.217.24.0-255,1484,15612,96,351183
28556,0.00021,172.31.47.0-255,66,15678,96,351183
28557,0.000214,172.217.24.0-255,2902,18580,96,351183
28558,0.000216,172.31.47.0-255,66,18646,96,351183
28559,0.000245,172.217.24.0-255,5738,24384,96,351183
28560,0.000248,172.31.47.0-255,66,24450,96,351183
28561,0.000284,172.31.47.0-255,66,24516,96,351183
28562,0.000292,172.217.24.0-255,7156,31672,96,351183
28563,0.000294,172.31.47.0-255,66,31738,96,351183
28564,0.000322,172.217.24.0-255,2902,34640,96,351183
28565,0.000325,172.31.47.0-255,66,34706,96,351183
28566,0.000335,172.31.47.0-255,66,34772,96,351183
28567,0.000366,172.217.24.0-255,5738,40510,96,351183
28568,0.00037,172.31.47.0-255,66,40576,96,351183
28569,0.000371,172.217.24.0-255,6438,47014,96,351183
28570,0.000373,172.31.47.0-255,66,47080,96,351183
28571,0.000375,172.217.24.0-255,356,47436,96,351183
28572,0.000376,172.31.47.0-255,66,47502,96,351183
28573,0.001054,172.217.24.0-255,386,47888,96,351183
28574,0.001061,172.31.47.0-255,66,47954,96,351183
28575,0.001228,172.217.24.0-255,1484,49438,96,351183
28576,0.001234,172.217.24.0-255,2902,52340,96,351183
28577,0.001238,172.31.47.0-255,66,52406,96,351183
28578,0.001266,172.217.24.0-255,5738,58144,96,351183
28579,0.001269,172.31.47.0-255,66,58210,96,351183
28580,0.001285,172.217.24.0-255,2902,61112,96,351183
28581,0.001287,172.31.47.0-255,66,61178,96,351183
28582,0.001315,172.217.24.0-255,7156,68334,96,351183
28583,0.001317,172.31.47.0-255,66,68400,96,351183
28584,0.001327,172.31.47.0-255,66,68466,96,351183
28585,0.00133,172.217.24.0-255,2184,70650,96,351183
28586,0.001331,172.31.47.0-255,66,70716,96,351183
28587,0.001387,172.217.24.0-255,1484,72200,96,351183
28588,0.001396,172.217.24.0-255,2902,75102,96,351183
28589,0.001398,172.31.47.0-255,66,75168,96,351183
28590,0.001401,172.217.24.0-255,1484,76652,96,351183
28591,0.001424,172.217.24.0-255,4320,80972,96,351183
28592,0.001426,172.31.47.0-255,66,81038,96,351183
28593,0.001428,172.217.24.0-255,1484,82522,96,351183
28594,0.001445,172.217.24.0-255,2902,85424,96,351183
28595,0.001447,172.31.47.0-255,66,85490,96,351183
28596,0.001452,172.217.24.0-255,5738,91228,96,351183
28597,0.001453,172.31.47.0-255,66,91294,96,351183
28598,0.001486,172.217.24.0-255,7156,98450,96,351183
28599,0.001487,172.31.47.0-255,66,98516,96,351183
28600,0.001491,172.217.24.0-255,4320,102836,96,351183
28601,0.001493,172.31.47.0-255,66,102902,96,351183
28602,0.001543,172.217.24.0-255,2184,105086,96,351183
28603,0.001545,172.31.47.0-255,66,105152,96,351183
28604,0.00158,172.217.24.0-255,1484,106636,96,351183
28605,0.001589,172.217.24.0-255,1484,108120,96,351183
28606,0.001591,172.31.47.0-255,66,108186,96,351183
28607,0.001614,172.217.24.0-255,1484,109670,96,351183
28608,0.001618,172.217.24.0-255,5738,115408,96,351183
28609,0.00162,172.31.47.0-255,66,115474,96,351183
28610,0.00163,172.217.24.0-255,1484,116958,96,351183
28611,0.001665,172.31.47.0-255,66,117024,96,351183
28612,0.001689,172.217.24.0-255,4320,121344,96,351183
28613,0.001691,172.31.47.0-255,66,121410,96,351183
28614,0.001715,172.217.24.0-255,6438,127848,96,351183
28615,0.001717,172.31.47.0-255,66,127914,96,351183
28616,0.001739,172.217.24.0-255,5738,133652,96,351183
28617,0.001741,172.31.47.0-255,66,133718,96,351183
28618,0.001755,172.217.24.0-255,1484,135202,96,351183
28619,0.001767,172.31.47.0-255,66,135268,96,351183
28620,0.001802,172.31.47.0-255,66,135334,96,351183
28621,0.001805,172.217.24.0-255,766,136100,96,351183
28622,0.001846,172.217.24.0-255,1484,137584,96,351183
28623,0.001848,172.31.47.0-255,66,137650,96,351183
28624,0.001852,172.217.24.0-255,2902,140552,96,351183
28625,0.001853,172.31.47.0-255,66,140618,96,351183
28626,0.001855,172.217.24.0-255,1484,142102,96,351183
28627,0.001885,172.217.24.0-255,4320,146422,96,351183
28628,0.001887,172.31.47.0-255,66,146488,96,351183
28629,0.001893,172.217.24.0-255,7156,153644,96,351183
28630,0.001895,172.31.47.0-255,66,153710,96,351183
28631,0.001931,172.217.24.0-255,5738,159448,96,351183
28632,0.001933,172.31.47.0-255,66,159514,96,351183
28633,0.001942,172.31.47.0-255,66,159580,96,351183
28634,0.001944,172.217.24.0-255,766,160346,96,351183
28635,0.003855,172.217.24.0-255,2902,163248,96,351183
28636,0.003859,172.31.47.0-255,66,163314,96,351183
28637,0.003884,172.217.24.0-255,1484,164798,96,351183
28638,0.005795,172.217.24.0-255,4320,169118,96,351183
28639,0.005801,172.31.47.0-255,66,169184,96,351183
28640,0.007732,172.217.24.0-255,5738,174922,96,351183
28641,0.007737,172.31.47.0-255,66,174988,96,351183
28642,0.009687,172.217.24.0-255,5738,180726,96,351183
28643,0.009693,172.31.47.0-255,66,180792,96,351183
28644,0.011626,172.217.24.0-255,5738,186530,96,351183
28645,0.011632,172.31.47.0-255,66,186596,96,351183
28646,0.013564,172.217.24.0-255,5738,192334,96,351183
28647,0.01357,172.31.47.0-255,66,192400,96,351183
28648,0.015504,172.217.24.0-255,5738,198138,96,351183
28649,0.015511,172.31.47.0-255,66,198204,96,351183
28650,0.017447,172.217.24.0-255,5738,203942,96,351183
28651,0.017453,172.31.47.0-255,66,204008,96,351183
28652,0.019381,172.217.24.0-255,5738,209746,96,351183
28653,0.019388,172.31.47.0-255,66,209812,96,351183
28654,0.021329,172.217.24.0-255,5738,215550,96,351183
28655,0.021336,172.31.47.0-255,66,215616,96,351183
28656,0.023265,172.217.24.0-255,5738,221354,96,351183
28657,0.023271,172.31.47.0-255,66,221420,96,351183
28658,0.024526,172.31.47.0-255,172,221592,96,351183
28659,0.024557,172.31.47.0-255,1105,222697,96,351183
28660,0.0246,172.31.47.0-255,1514,224211,96,351183
28661,0.024602,172.31.47.0-255,1306,225517,96,351183
28662,0.025197,172.217.24.0-255,5738,231255,96,351183
28663,0.025203,172.31.47.0-255,66,231321,96,351183
28664,0.026091,104.244.42.0-255,66,231387,96,351183
28665,0.026098,104.244.42.0-255,66,231453,96,351183
28666,0.026158,104.244.42.0-255,66,231519,96,351183
28667,0.027132,172.217.24.0-255,5738,237257,96,351183
28668,0.027137,172.31.47.0-255,66,237323,96,351183
28669,0.029077,172.217.24.0-255,5738,243061,96,351183
28670,0.029084,172.31.47.0-255,66,243127,96,351183
28671,0.031041,172.217.24.0-255,5738,248865,96,351183
28672,0.031046,172.31.47.0-255,66,248931,96,351183
28673,0.032973,172.217.24.0-255,5738,254669,96,351183
28674,0.032978,172.31.47.0-255,66,254735,96,351183
28675,0.034913,172.217.24.0-255,5738,260473,96,351183
28676,0.034919,172.31.47.0-255,66,260539,96,351183
28677,0.036842,172.217.24.0-255,5738,266277,96,351183
28678,0.036847,172.31.47.0-255,66,266343,96,351183
28679,0.038782,172.217.24.0-255,4320,270663,96,351183
28680,0.038786,172.31.47.0-255,66,270729,96,351183
28681,0.038816,172.217.24.0-255,1484,272213,96,351183
28682,0.040712,172.217.24.0-255,4320,276533,96,351183
28683,0.040717,172.31.47.0-255,66,276599,96,351183
28684,0.04265,172.217.24.0-255,5738,282337,96,351183
28685,0.042654,172.31.47.0-255,66,282403,96,351183
28686,0.044591,172.217.24.0-255,5738,288141,96,351183
28687,0.044596,172.31.47.0-255,66,288207,96,351183
28688,0.046534,172.217.24.0-255,5738,293945,96,351183
28689,0.046542,172.31.47.0-255,66,294011,96,351183
28690,0.048473,172.217.24.0-255,5738,299749,96,351183
28691,0.048479,172.31.47.0-255,66,299815,96,351183
28692,0.050403,172.217.24.0-255,5738,305553,96,351183
28693,0.050407,172.31.47.0-255,66,305619,96,351183
28694,0.052337,172.217.24.0-255,4320,309939,96,351183
28695,0.052342,172.31.47.0-255,66,310005,96,351183
28696,0.052373,172.217.24.0-255,1484,311489,96,351183
28697,0.054285,172.217.24.0-255,4320,315809,96,351183
28698,0.054291,172.31.47.0-255,66,315875,96,351183
28699,0.056216,172.217.24.0-255,2902,318777,96,351183
28700,0.056221,172.31.47.0-255,66,318843,96,351183
28701,0.056256,172.217.24.0-255,2902,321745,96,351183
28702,0.05626,172.31.47.0-255,66,321811,96,351183
28703,0.058147,172.217.24.0-255,2902,324713,96,351183
28704,0.058151,172.31.47.0-255,66,324779,96,351183
28705,0.058182,172.217.24.0-255,2902,327681,96,351183
28706,0.058185,172.31.47.0-255,66,327747,96,351183
28707,0.060075,172.217.24.0-255,2902,330649,96,351183
28708,0.06008,172.31.47.0-255,66,330715,96,351183
28709,0.060114,172.217.24.0-255,2902,333617,96,351183
28710,0.060117,172.31.47.0-255,66,333683,96,351183
28711,0.062006,172.217.24.0-255,2902,336585,96,351183
28712,0.06201,172.31.47.0-255,66,336651,96,351183
28713,0.062044,172.217.24.0-255,2902,339553,96,351183
28714,0.062046,172.31.47.0-255,66,339619,96,351183
28715,0.063934,172.217.24.0-255,2902,342521,96,351183
28716,0.063939,172.31.47.0-255,66,342587,96,351183
28717,0.063969,172.217.24.0-255,2902,345489,96,351183
28718,0.063972,172.31.47.0-255,66,345555,96,351183
28719,0.065868,172.217.24.0-255,2902,348457,96,351183
28720,0.065873,172.31.47.0-255,66,348523,96,351183
28721,0.065907,172.217.24.0-255,2423,350946,96,351183
28722,0.06591,172.31.47.0-255,66,351012,96,351183
28723,0.066095,172.31.47.0-255,105,351117,96,351183
28724,0.067996,172.217.24.0-255,66,351183,96,351183
28725,0.0,172.31.47.0-255,105,105,96,105
28726,0.0,74.125.130.0-255,153,153,96,274472
28727,2.3e-05,172.31.47.0-255,66,219,96,274472
28728,2.8e-05,74.125.130.0-255,1484,1703,96,274472
28729,3.2e-05,172.31.47.0-255,66,1769,96,274472
28730,3.7e-05,74.125.130.0-255,2902,4671,96,274472
28731,4.5e-05,172.31.47.0-255,66,4737,96,274472
28732,4.9e-05,74.125.130.0-255,2902,7639,96,274472
28733,5.2e-05,172.31.47.0-255,66,7705,96,274472
28734,5.7e-05,74.125.130.0-255,4320,12025,96,274472
28735,5.9e-05,172.31.47.0-255,66,12091,96,274472
28736,9.3e-05,74.125.130.0-255,2046,14137,96,274472
28737,9.6e-05,172.31.47.0-255,66,14203,96,274472
28738,0.000118,74.125.130.0-255,2902,17105,96,274472
28739,0.000121,172.31.47.0-255,66,17171,96,274472
28740,0.00015,74.125.130.0-255,7156,24327,96,274472
28741,0.000154,172.31.47.0-255,66,24393,96,274472
28742,0.00016,74.125.130.0-255,6797,31190,96,274472
28743,0.000162,172.31.47.0-255,66,31256,96,274472
28744,0.000565,74.125.130.0-255,1484,32740,96,274472
28745,0.00057,172.31.47.0-255,66,32806,96,274472
28746,0.000578,74.125.130.0-255,2902,35708,96,274472
28747,0.000581,172.31.47.0-255,66,35774,96,274472
28748,0.000592,74.125.130.0-255,5738,41512,96,274472
28749,0.000595,172.31.47.0-255,66,41578,96,274472
28750,0.000624,74.125.130.0-255,6797,48375,96,274472
28751,0.000627,172.31.47.0-255,66,48441,96,274472
28752,0.000634,74.125.130.0-255,5738,54179,96,274472
28753,0.000636,172.31.47.0-255,66,54245,96,274472
28754,0.000664,74.125.130.0-255,1484,55729,96,274472
28755,0.000667,172.31.47.0-255,66,55795,96,274472
28756,0.000679,172.31.47.0-255,66,55861,96,274472
28757,0.000686,74.125.130.0-255,377,56238,96,274472
28758,0.000785,74.125.130.0-255,365,56603,96,274472
28759,0.000972,74.125.130.0-255,1484,58087,96,274472
28760,0.000977,172.31.47.0-255,66,58153,96,274472
28761,0.000982,74.125.130.0-255,2902,61055,96,274472
28762,0.000984,172.31.47.0-255,66,61121,96,274472
28763,0.001015,74.125.130.0-255,5738,66859,96,274472
28764,0.001018,172.31.47.0-255,66,66925,96,274472
28765,0.00102,74.125.130.0-255,1484,68409,96,274472
28766,0.00106,172.31.47.0-255,66,68475,96,274472
28767,0.001069,172.31.47.0-255,66,68541,96,274472
28768,0.001337,74.125.130.0-255,1484,70025,96,274472
28769,0.001342,74.125.130.0-255,1484,71509,96,274472
28770,0.001345,172.31.47.0-255,66,71575,96,274472
28771,0.001371,74.125.130.0-255,1484,73059,96,274472
28772,0.001376,74.125.130.0-255,5738,78797,96,274472
28773,0.001378,172.31.47.0-255,66,78863,96,274472
28774,0.001383,74.125.130.0-255,5738,84601,96,274472
28775,0.001385,172.31.47.0-255,66,84667,96,274472
28776,0.001415,74.125.130.0-255,7156,91823,96,274472
28777,0.001417,172.31.47.0-255,66,91889,96,274472
28778,0.001426,172.31.47.0-255,66,91955,96,274472
28779,0.001428,74.125.130.0-255,766,92721,96,274472
28780,0.001458,74.125.130.0-255,1484,94205,96,274472
28781,0.001461,172.31.47.0-255,66,94271,96,274472
28782,0.001486,74.125.130.0-255,4320,98591,96,274472
28783,0.001488,172.31.47.0-255,66,98657,96,274472
28784,0.00149,74.125.130.0-255,1484,100141,96,274472
28785,0.001518,172.31.47.0-255,66,100207,96,274472
28786,0.001527,172.31.47.0-255,66,100273,96,274472
28787,0.001557,74.125.130.0-255,4320,104593,96,274472
28788,0.001559,172.31.47.0-255,66,104659,96,274472
28789,0.001584,74.125.130.0-255,2184,106843,96,274472
28790,0.001586,172.31.47.0-255,66,106909,96,274472
28791,0.001663,74.125.130.0-255,1484,108393,96,274472
28792,0.001667,74.125.130.0-255,2902,111295,96,274472
28793,0.00167,172.31.47.0-255,66,111361,96,274472
28794,0.001696,74.125.130.0-255,5738,117099,96,274472
28795,0.001698,172.31.47.0-255,66,117165,96,274472
28796,0.001701,74.125.130.0-255,1484,118649,96,274472
28797,0.001731,172.31.47.0-255,66,118715,96,274472
28798,0.001736,74.125.130.0-255,7156,125871,96,274472
28799,0.001739,172.31.47.0-255,66,125937,96,274472
28800,0.001766,74.125.130.0-255,4320,130257,96,274472
28801,0.001768,172.31.47.0-255,66,130323,96,274472
28802,0.001771,74.125.130.0-255,2184,132507,96,274472
28803,0.001773,172.31.47.0-255,66,132573,96,274472
28804,0.001878,74.125.130.0-255,1484,134057,96,274472
28805,0.001893,74.125.130.0-255,2902,136959,96,274472
28806,0.001896,172.31.47.0-255,66,137025,96,274472
28807,0.001901,74.125.130.0-255,4320,141345,96,274472
28808,0.001902,172.31.47.0-255,66,141411,96,274472
28809,0.001905,74.125.130.0-255,1484,142895,96,274472
28810,0.001933,74.125.130.0-255,4320,147215,96,274472
28811,0.001935,172.31.47.0-255,66,147281,96,274472
28812,0.001938,74.125.130.0-255,1484,148765,96,274472
28813,0.001974,172.31.47.0-255,66,148831,96,274472
28814,0.001982,172.31.47.0-255,66,148897,96,274472
28815,0.002108,74.125.130.0-255,1484,150381,96,274472
28816,0.002111,74.125.130.0-255,1484,151865,96,274472
28817,0.002114,172.31.47.0-255,66,151931,96,274472
28818,0.002125,74.125.130.0-255,1484,153415,96,274472
28819,0.002134,74.125.130.0-255,5738,159153,96,274472
28820,0.002136,172.31.47.0-255,66,159219,96,274472
28821,0.0022,172.31.47.0-255,66,159285,96,274472
28822,0.002225,74.125.130.0-255,1484,160769,96,274472
28823,0.002237,172.31.47.0-255,66,160835,96,274472
28824,0.002247,172.31.47.0-255,66,160901,96,274472
28825,0.002261,172.31.47.0-255,66,160967,96,274472
28826,0.002267,74.125.130.0-255,6438,167405,96,274472
28827,0.002269,172.31.47.0-255,66,167471,96,274472
28828,0.00229,74.125.130.0-255,1484,168955,96,274472
28829,0.002315,74.125.130.0-255,5738,174693,96,274472
28830,0.002318,172.31.47.0-255,66,174759,96,274472
28831,0.002323,74.125.130.0-255,5738,180497,96,274472
28832,0.002324,172.31.47.0-255,66,180563,96,274472
28833,0.002364,172.31.47.0-255,66,180629,96,274472
28834,0.002369,74.125.130.0-255,6438,187067,96,274472
28835,0.002371,172.31.47.0-255,66,187133,96,274472
28836,0.004693,74.125.130.0-255,5738,192871,96,274472
28837,0.004697,172.31.47.0-255,66,192937,96,274472
28838,0.007035,74.125.130.0-255,5738,198675,96,274472
28839,0.007041,172.31.47.0-255,66,198741,96,274472
28840,0.009369,74.125.130.0-255,5738,204479,96,274472
28841,0.009375,172.31.47.0-255,66,204545,96,274472
28842,0.01171,74.125.130.0-255,5738,210283,96,274472
28843,0.011716,172.31.47.0-255,66,210349,96,274472
28844,0.014053,74.125.130.0-255,5738,216087,96,274472
28845,0.014061,172.31.47.0-255,66,216153,96,274472
28846,0.016406,74.125.130.0-255,5738,221891,96,274472
28847,0.016413,172.31.47.0-255,66,221957,96,274472
28848,0.018758,74.125.130.0-255,5738,227695,96,274472
28849,0.018766,172.31.47.0-255,66,227761,96,274472
28850,0.021132,74.125.130.0-255,5738,233499,96,274472
28851,0.021137,172.31.47.0-255,66,233565,96,274472
28852,0.02347,74.125.130.0-255,5738,239303,96,274472
28853,0.023478,172.31.47.0-255,66,239369,96,274472
28854,0.025815,74.125.130.0-255,5738,245107,96,274472
28855,0.025821,172.31.47.0-255,66,245173,96,274472
28856,0.028146,74.125.130.0-255,5738,250911,96,274472
28857,0.028152,172.31.47.0-255,66,250977,96,274472
28858,0.028487,172.31.47.0-255,172,251149,96,274472
28859,0.028544,172.31.47.0-255,1110,252259,96,274472
28860,0.028619,172.31.47.0-255,1514,253773,96,274472
28861,0.028622,172.31.47.0-255,1514,255287,96,274472
28862,0.028623,172.31.47.0-255,1514,256801,96,274472
28863,0.028624,172.31.47.0-255,1082,257883,96,274472
28864,0.03002,104.244.42.0-255,66,257949,96,274472
28865,0.030117,104.244.42.0-255,66,258015,96,274472
28866,0.030175,104.244.42.0-255,66,258081,96,274472
28867,0.030177,104.244.42.0-255,66,258147,96,274472
28868,0.030478,74.125.130.0-255,4320,262467,96,274472
28869,0.030482,172.31.47.0-255,66,262533,96,274472
28870,0.030515,74.125.130.0-255,1484,264017,96,274472
28871,0.032809,74.125.130.0-255,4320,268337,96,274472
28872,0.032814,172.31.47.0-255,66,268403,96,274472
28873,0.035135,74.125.130.0-255,2902,271305,96,274472
28874,0.035139,172.31.47.0-255,66,271371,96,274472
28875,0.035171,74.125.130.0-255,2864,274235,96,274472
28876,0.035173,172.31.47.0-255,66,274301,96,274472
28877,0.035296,172.31.47.0-255,105,274406,96,274472
28878,0.037594,74.125.130.0-255,66,274472,96,274472
28879,0.0,172.217.194.0-255,297,297,96,189372
28880,1.9e-05,172.31.47.0-255,66,363,96,189372
28881,2.3e-05,172.217.194.0-255,1484,1847,96,189372
28882,2.7e-05,172.31.47.0-255,66,1913,96,189372
28883,4.5e-05,172.217.194.0-255,4320,6233,96,189372
28884,4.7e-05,172.31.47.0-255,66,6299,96,189372
28885,5.9e-05,172.217.194.0-255,1484,7783,96,189372
28886,6.1e-05,172.31.47.0-255,66,7849,96,189372
28887,8.6e-05,172.217.194.0-255,6103,13952,96,189372
28888,8.9e-05,172.31.47.0-255,66,14018,96,189372
28889,9.5e-05,172.217.194.0-255,7156,21174,96,189372
28890,9.7e-05,172.31.47.0-255,66,21240,96,189372
28891,0.000116,172.217.194.0-255,7156,28396,96,189372
28892,0.000118,172.31.47.0-255,66,28462,96,189372
28893,0.000121,172.217.194.0-255,2543,31005,96,189372
28894,0.000123,172.31.47.0-255,66,31071,96,189372
28895,0.000155,172.217.194.0-255,1484,32555,96,189372
28896,0.000158,172.31.47.0-255,66,32621,96,189372
28897,0.000177,172.217.194.0-255,2902,35523,96,189372
28898,0.00018,172.31.47.0-255,66,35589,96,189372
28899,0.000185,172.217.194.0-255,5738,41327,96,189372
28900,0.000187,172.31.47.0-255,66,41393,96,189372
28901,0.000202,172.217.194.0-255,1484,42877,96,189372
28902,0.000204,172.31.47.0-255,66,42943,96,189372
28903,0.00023,172.31.47.0-255,66,43009,96,189372
28904,0.000236,172.217.194.0-255,7156,50165,96,189372
28905,0.000238,172.31.47.0-255,66,50231,96,189372
28906,0.000262,172.217.194.0-255,2833,53064,96,189372
28907,0.000265,172.31.47.0-255,66,53130,96,189372
28908,0.000267,172.217.194.0-255,99,53229,96,189372
28909,0.000269,172.31.47.0-255,66,53295,96,189372
28910,0.000464,172.217.194.0-255,363,53658,96,189372
28911,0.000652,172.217.194.0-255,1484,55142,96,189372
28912,0.000656,172.217.194.0-255,2902,58044,96,189372
28913,0.000657,172.31.47.0-255,66,58110,96,189372
28914,0.000661,172.31.47.0-255,66,58176,96,189372
28915,0.000675,172.217.194.0-255,5738,63914,96,189372
28916,0.000677,172.31.47.0-255,66,63980,96,189372
28917,0.00068,172.217.194.0-255,1484,65464,96,189372
28918,0.000708,172.217.194.0-255,4320,69784,96,189372
28919,0.000713,172.31.47.0-255,66,69850,96,189372
28920,0.000714,172.217.194.0-255,7156,77006,96,189372
28921,0.000716,172.31.47.0-255,66,77072,96,189372
28922,0.00073,172.217.194.0-255,1484,78556,96,189372
28923,0.00076,172.31.47.0-255,66,78622,96,189372
28924,0.001031,172.217.194.0-255,1484,80106,96,189372
28925,0.001039,172.217.194.0-255,2902,83008,96,189372
28926,0.001042,172.31.47.0-255,66,83074,96,189372
28927,0.001049,172.217.194.0-255,5738,88812,96,189372
28928,0.00105,172.31.47.0-255,66,88878,96,189372
28929,0.001082,172.31.47.0-255,66,88944,96,189372
28930,0.001103,172.217.194.0-255,4320,93264,96,189372
28931,0.001106,172.31.47.0-255,66,93330,96,189372
28932,0.001117,172.31.47.0-255,66,93396,96,189372
28933,0.001222,172.217.194.0-255,1484,94880,96,189372
28934,0.001227,172.217.194.0-255,1484,96364,96,189372
28935,0.00123,172.31.47.0-255,66,96430,96,189372
28936,0.001246,172.217.194.0-255,1484,97914,96,189372
28937,0.001252,172.217.194.0-255,5738,103652,96,189372
28938,0.001255,172.31.47.0-255,66,103718,96,189372
28939,0.001281,172.31.47.0-255,66,103784,96,189372
28940,0.001297,172.217.194.0-255,1484,105268,96,189372
28941,0.001322,172.31.47.0-255,66,105334,96,189372
28942,0.001352,172.217.194.0-255,2184,107518,96,189372
28943,0.001354,172.31.47.0-255,66,107584,96,189372
28944,0.001369,172.31.47.0-255,66,107650,96,189372
28945,0.001376,172.31.47.0-255,66,107716,96,189372
28946,0.001399,172.217.194.0-255,1484,109200,96,189372
28947,0.001413,172.217.194.0-255,2902,112102,96,189372
28948,0.001416,172.31.47.0-255,66,112168,96,189372
28949,0.001419,172.217.194.0-255,2902,115070,96,189372
28950,0.001421,172.31.47.0-255,66,115136,96,189372
28951,0.001437,172.217.194.0-255,2902,118038,96,189372
28952,0.001439,172.31.47.0-255,66,118104,96,189372
28953,0.001442,172.217.194.0-255,1484,119588,96,189372
28954,0.001463,172.31.47.0-255,66,119654,96,189372
28955,0.00149,172.217.194.0-255,2902,122556,96,189372
28956,0.001492,172.31.47.0-255,66,122622,96,189372
28957,0.001503,172.31.47.0-255,66,122688,96,189372
28958,0.001585,172.217.194.0-255,1484,124172,96,189372
28959,0.001598,172.217.194.0-255,2902,127074,96,189372
28960,0.001602,172.31.47.0-255,66,127140,96,189372
28961,0.001605,172.217.194.0-255,1484,128624,96,189372
28962,0.001623,172.217.194.0-255,4320,132944,96,189372
28963,0.001626,172.31.47.0-255,66,133010,96,189372
28964,0.001669,172.31.47.0-255,66,133076,96,189372
28965,0.001695,172.217.194.0-255,2902,135978,96,189372
28966,0.001698,172.31.47.0-255,66,136044,96,189372
28967,0.001717,172.31.47.0-255,66,136110,96,189372
28968,0.001731,172.31.47.0-255,66,136176,96,189372
28969,0.001741,172.31.47.0-255,66,136242,96,189372
28970,0.001846,172.217.194.0-255,1484,137726,96,189372
28971,0.001863,172.217.194.0-255,2902,140628,96,189372
28972,0.001866,172.31.47.0-255,66,140694,96,189372
28973,0.001871,172.217.194.0-255,5738,146432,96,189372
28974,0.001874,172.31.47.0-255,66,146498,96,189372
28975,0.001903,172.31.47.0-255,66,146564,96,189372
28976,0.001922,172.217.194.0-255,5738,152302,96,189372
28977,0.001924,172.31.47.0-255,66,152368,96,189372
28978,0.001941,172.217.194.0-255,5020,157388,96,189372
28979,0.001943,172.31.47.0-255,66,157454,96,189372
28980,0.001946,172.217.194.0-255,2902,160356,96,189372
28981,0.001947,172.31.47.0-255,66,160422,96,189372
28982,0.001977,172.31.47.0-255,66,160488,96,189372
28983,0.001986,172.31.47.0-255,66,160554,96,189372
28984,0.001999,172.217.194.0-255,5738,166292,96,189372
28985,0.002,172.31.47.0-255,66,166358,96,189372
28986,0.002015,172.217.194.0-255,1484,167842,96,189372
28987,0.002047,172.31.47.0-255,66,167908,96,189372
28988,0.002071,172.217.194.0-255,6438,174346,96,189372
28989,0.002073,172.31.47.0-255,66,174412,96,189372
28990,0.002077,172.217.194.0-255,4320,178732,96,189372
28991,0.002079,172.31.47.0-255,66,178798,96,189372
28992,0.002083,172.217.194.0-255,4320,183118,96,189372
28993,0.002085,172.31.47.0-255,66,183184,96,189372
28994,0.002087,172.217.194.0-255,1484,184668,96,189372
28995,0.002126,172.31.47.0-255,66,184734,96,189372
28996,0.002128,172.217.194.0-255,105,184839,96,189372
28997,0.007428,172.31.47.0-255,66,184905,96,189372
28998,0.007451,172.31.47.0-255,105,185010,96,189372
28999,0.009431,172.217.194.0-255,66,185076,96,189372
29000,0.034051,172.31.47.0-255,172,185248,96,189372
29001,0.034081,172.31.47.0-255,1110,186358,96,189372
29002,0.034123,172.31.47.0-255,1514,187872,96,189372
29003,0.034125,172.31.47.0-255,1302,189174,96,189372
29004,0.035604,104.244.42.0-255,66,189240,96,189372
29005,0.035655,104.244.42.0-255,66,189306,96,189372
29006,0.035709,104.244.42.0-255,66,189372,96,189372
29007,0.0,172.31.47.0-255,105,105,96,105
29008,0.0,74.125.24.0-255,153,153,96,288070
29009,4.6e-05,172.31.47.0-255,66,219,96,288070
29010,5.5e-05,74.125.24.0-255,1484,1703,96,288070
29011,6e-05,172.31.47.0-255,66,1769,96,288070
29012,6.5e-05,74.125.24.0-255,2902,4671,96,288070
29013,6.7e-05,172.31.47.0-255,66,4737,96,288070
29014,7.5e-05,74.125.24.0-255,7156,11893,96,288070
29015,7.7e-05,172.31.47.0-255,66,11959,96,288070
29016,8.2e-05,74.125.24.0-255,2098,14057,96,288070
29017,8.5e-05,172.31.47.0-255,66,14123,96,288070
29018,0.000559,74.125.24.0-255,1484,15607,96,288070
29019,0.000566,172.31.47.0-255,66,15673,96,288070
29020,0.000572,74.125.24.0-255,2902,18575,96,288070
29021,0.000576,172.31.47.0-255,66,18641,96,288070
29022,0.000583,74.125.24.0-255,5738,24379,96,288070
29023,0.000585,172.31.47.0-255,66,24445,96,288070
29024,0.000591,74.125.24.0-255,5738,30183,96,288070
29025,0.000593,172.31.47.0-255,66,30249,96,288070
29026,0.000616,74.125.24.0-255,1125,31374,96,288070
29027,0.000619,172.31.47.0-255,66,31440,96,288070
29028,0.000643,172.31.47.0-255,66,31506,96,288070
29029,0.000668,74.125.24.0-255,4320,35826,96,288070
29030,0.00067,172.31.47.0-255,66,35892,96,288070
29031,0.000675,74.125.24.0-255,2543,38435,96,288070
29032,0.000678,172.31.47.0-255,66,38501,96,288070
29033,0.00112,74.125.24.0-255,1484,39985,96,288070
29034,0.001126,172.31.47.0-255,66,40051,96,288070
29035,0.001136,74.125.24.0-255,2902,42953,96,288070
29036,0.001139,172.31.47.0-255,66,43019,96,288070
29037,0.001145,74.125.24.0-255,5738,48757,96,288070
29038,0.001147,172.31.47.0-255,66,48823,96,288070
29039,0.001174,172.31.47.0-255,66,48889,96,288070
29040,0.001274,74.125.24.0-255,1484,50373,96,288070
29041,0.001281,74.125.24.0-255,2902,53275,96,288070
29042,0.001284,172.31.47.0-255,66,53341,96,288070
29043,0.001292,74.125.24.0-255,5738,59079,96,288070
29044,0.001294,172.31.47.0-255,66,59145,96,288070
29045,0.001317,74.125.24.0-255,2902,62047,96,288070
29046,0.001319,172.31.47.0-255,66,62113,96,288070
29047,0.00136,172.31.47.0-255,66,62179,96,288070
29048,0.001367,74.125.24.0-255,5738,67917,96,288070
29049,0.001369,172.31.47.0-255,66,67983,96,288070
29050,0.001385,74.125.24.0-255,5379,73362,96,288070
29051,0.001389,172.31.47.0-255,66,73428,96,288070
29052,0.001788,74.125.24.0-255,1484,74912,96,288070
29053,0.001796,74.125.24.0-255,2902,77814,96,288070
29054,0.001799,172.31.47.0-255,66,77880,96,288070
29055,0.001819,74.125.24.0-255,4320,82200,96,288070
29056,0.001822,172.31.47.0-255,66,82266,96,288070
29057,0.001834,74.125.24.0-255,1484,83750,96,288070
29058,0.001837,74.125.24.0-255,1484,85234,96,288070
29059,0.001839,172.31.47.0-255,66,85300,96,288070
29060,0.001876,172.31.47.0-255,66,85366,96,288070
29061,0.001887,172.31.47.0-255,66,85432,96,288070
29062,0.00203,74.125.24.0-255,766,86198,96,288070
29063,0.003887,74.125.24.0-255,1484,87682,96,288070
29064,0.00389,172.31.47.0-255,66,87748,96,288070
29065,0.003906,74.125.24.0-255,2902,90650,96,288070
29066,0.003909,172.31.47.0-255,66,90716,96,288070
29067,0.005875,74.125.24.0-255,5738,96454,96,288070
29068,0.005884,172.31.47.0-255,66,96520,96,288070
29069,0.00787,74.125.24.0-255,5738,102258,96,288070
29070,0.007878,172.31.47.0-255,66,102324,96,288070
29071,0.009871,74.125.24.0-255,5738,108062,96,288070
29072,0.00988,172.31.47.0-255,66,108128,96,288070
29073,0.011868,74.125.24.0-255,5738,113866,96,288070
29074,0.011878,172.31.47.0-255,66,113932,96,288070
29075,0.013875,74.125.24.0-255,5738,119670,96,288070
29076,0.013892,172.31.47.0-255,66,119736,96,288070
29077,0.015905,74.125.24.0-255,5738,125474,96,288070
29078,0.015923,172.31.47.0-255,66,125540,96,288070
29079,0.017925,74.125.24.0-255,5738,131278,96,288070
29080,0.017942,172.31.47.0-255,66,131344,96,288070
29081,0.019944,74.125.24.0-255,5738,137082,96,288070
29082,0.019957,172.31.47.0-255,66,137148,96,288070
29083,0.02195,74.125.24.0-255,5738,142886,96,288070
29084,0.021966,172.31.47.0-255,66,142952,96,288070
29085,0.023953,74.125.24.0-255,5738,148690,96,288070
29086,0.023967,172.31.47.0-255,66,148756,96,288070
29087,0.025941,74.125.24.0-255,4320,153076,96,288070
29088,0.025955,172.31.47.0-255,66,153142,96,288070
29089,0.025978,74.125.24.0-255,1484,154626,96,288070
29090,0.027934,74.125.24.0-255,4320,158946,96,288070
29091,0.027948,172.31.47.0-255,66,159012,96,288070
29092,0.029959,74.125.24.0-255,5738,164750,96,288070
29093,0.029968,172.31.47.0-255,66,164816,96,288070
29094,0.031492,172.31.47.0-255,176,164992,96,288070
29095,0.031542,172.31.47.0-255,1105,166097,96,288070
29096,0.031619,172.31.47.0-255,1514,167611,96,288070
29097,0.031622,172.31.47.0-255,1514,169125,96,288070
29098,0.031627,172.31.47.0-255,1514,170639,96,288070
29099,0.031628,172.31.47.0-255,1087,171726,96,288070
29100,0.031977,74.125.24.0-255,5738,177464,96,288070
29101,0.031986,172.31.47.0-255,66,177530,96,288070
29102,0.033054,104.244.42.0-255,66,177596,96,288070
29103,0.033067,104.244.42.0-255,66,177662,96,288070
29104,0.033153,104.244.42.0-255,66,177728,96,288070
29105,0.033157,104.244.42.0-255,66,177794,96,288070
29106,0.033965,74.125.24.0-255,5738,183532,96,288070
29107,0.033974,172.31.47.0-255,66,183598,96,288070
29108,0.035967,74.125.24.0-255,5738,189336,96,288070
29109,0.035976,172.31.47.0-255,66,189402,96,288070
29110,0.037934,74.125.24.0-255,5738,195140,96,288070
29111,0.037946,172.31.47.0-255,66,195206,96,288070
29112,0.039941,74.125.24.0-255,5738,200944,96,288070
29113,0.039951,172.31.47.0-255,66,201010,96,288070
29114,0.041938,74.125.24.0-255,5738,206748,96,288070
29115,0.041946,172.31.47.0-255,66,206814,96,288070
29116,0.043943,74.125.24.0-255,5738,212552,96,288070
29117,0.043955,172.31.47.0-255,66,212618,96,288070
29118,0.045961,74.125.24.0-255,5738,218356,96,288070
29119,0.045974,172.31.47.0-255,66,218422,96,288070
29120,0.047969,74.125.24.0-255,5738,224160,96,288070
29121,0.047982,172.31.47.0-255,66,224226,96,288070
29122,0.04996,74.125.24.0-255,5738,229964,96,288070
29123,0.049975,172.31.47.0-255,66,230030,96,288070
29124,0.051961,74.125.24.0-255,5738,235768,96,288070
29125,0.051972,172.31.47.0-255,66,235834,96,288070
29126,0.053961,74.125.24.0-255,5738,241572,96,288070
29127,0.053968,172.31.47.0-255,66,241638,96,288070
29128,0.055934,74.125.24.0-255,5738,247376,96,288070
29129,0.055944,172.31.47.0-255,66,247442,96,288070
29130,0.057945,74.125.24.0-255,5738,253180,96,288070
29131,0.057951,172.31.47.0-255,66,253246,96,288070
29132,0.059931,74.125.24.0-255,5738,258984,96,288070
29133,0.059939,172.31.47.0-255,66,259050,96,288070
29134,0.061924,74.125.24.0-255,5738,264788,96,288070
29135,0.061937,172.31.47.0-255,66,264854,96,288070
29136,0.063958,74.125.24.0-255,5738,270592,96,288070
29137,0.063981,172.31.47.0-255,66,270658,96,288070
29138,0.065996,74.125.24.0-255,5738,276396,96,288070
29139,0.066013,172.31.47.0-255,66,276462,96,288070
29140,0.067988,74.125.24.0-255,5738,282200,96,288070
29141,0.068,172.31.47.0-255,66,282266,96,288070
29142,0.069982,74.125.24.0-255,5738,288004,96,288070
29143,0.069996,172.31.47.0-255,66,288070,96,288070
29144,0.0,74.125.24.0-255,153,153,96,163209
29145,2.8e-05,172.31.47.0-255,66,219,96,163209
29146,3.4e-05,74.125.24.0-255,1484,1703,96,163209
29147,3.7e-05,172.31.47.0-255,66,1769,96,163209
29148,4.3e-05,74.125.24.0-255,2902,4671,96,163209
29149,4.6e-05,172.31.47.0-255,66,4737,96,163209
29150,7e-05,74.125.24.0-255,5738,10475,96,163209
29151,7.3e-05,172.31.47.0-255,66,10541,96,163209
29152,0.0001,74.125.24.0-255,1484,12025,96,163209
29153,0.000102,172.31.47.0-255,66,12091,96,163209
29154,0.000138,74.125.24.0-255,5738,17829,96,163209
29155,0.000141,172.31.47.0-255,66,17895,96,163209
29156,0.000157,74.125.24.0-255,4835,22730,96,163209
29157,0.00016,172.31.47.0-255,66,22796,96,163209
29158,0.000257,74.125.24.0-255,5738,28534,96,163209
29159,0.000261,172.31.47.0-255,66,28600,96,163209
29160,0.000281,74.125.24.0-255,5738,34338,96,163209
29161,0.000284,172.31.47.0-255,66,34404,96,163209
29162,0.000387,74.125.24.0-255,4320,38724,96,163209
29163,0.00039,172.31.47.0-255,66,38790,96,163209
29164,0.000415,172.31.47.0-255,66,38856,96,163209
29165,0.000551,74.125.24.0-255,7156,46012,96,163209
29166,0.000554,172.31.47.0-255,66,46078,96,163209
29167,0.000567,74.125.24.0-255,4320,50398,96,163209
29168,0.00057,172.31.47.0-255,66,50464,96,163209
29169,0.000697,172.31.47.0-255,66,50530,96,163209
29170,0.000721,172.31.47.0-255,66,50596,96,163209
29171,0.000936,172.31.47.0-255,66,50662,96,163209
29172,0.000959,172.31.47.0-255,66,50728,96,163209
29173,0.001131,172.31.47.0-255,66,50794,96,163209
29174,0.001146,74.125.24.0-255,1484,52278,96,163209
29175,0.001304,74.125.24.0-255,2902,55180,96,163209
29176,0.001306,172.31.47.0-255,66,55246,96,163209
29177,0.001335,172.31.47.0-255,66,55312,96,163209
29178,0.001493,74.125.24.0-255,2902,58214,96,163209
29179,0.001495,172.31.47.0-255,66,58280,96,163209
29180,0.001522,172.31.47.0-255,66,58346,96,163209
29181,0.001556,172.31.47.0-255,66,58412,96,163209
29182,0.001882,172.31.47.0-255,66,58478,96,163209
29183,0.001945,172.31.47.0-255,66,58544,96,163209
29184,0.001967,74.125.24.0-255,5020,63564,96,163209
29185,0.001969,172.31.47.0-255,66,63630,96,163209
29186,0.002267,74.125.24.0-255,7156,70786,96,163209
29187,0.00227,172.31.47.0-255,66,70852,96,163209
29188,0.00229,172.31.47.0-255,66,70918,96,163209
29189,0.002327,172.31.47.0-255,66,70984,96,163209
29190,0.002373,172.31.47.0-255,66,71050,96,163209
29191,0.003011,74.125.24.0-255,5738,76788,96,163209
29192,0.003015,172.31.47.0-255,66,76854,96,163209
29193,0.003062,172.31.47.0-255,66,76920,96,163209
29194,0.006011,172.31.47.0-255,66,76986,96,163209
29195,0.008251,74.125.24.0-255,5738,82724,96,163209
29196,0.008257,172.31.47.0-255,66,82790,96,163209
29197,0.010497,74.125.24.0-255,5738,88528,96,163209
29198,0.010504,172.31.47.0-255,66,88594,96,163209
29199,0.012777,74.125.24.0-255,5738,94332,96,163209
29200,0.012785,172.31.47.0-255,66,94398,96,163209
29201,0.015074,74.125.24.0-255,5738,100136,96,163209
29202,0.015083,172.31.47.0-255,66,100202,96,163209
29203,0.017325,74.125.24.0-255,5738,105940,96,163209
29204,0.017333,172.31.47.0-255,66,106006,96,163209
29205,0.019574,74.125.24.0-255,5738,111744,96,163209
29206,0.019581,172.31.47.0-255,66,111810,96,163209
29207,0.021895,74.125.24.0-255,5738,117548,96,163209
29208,0.021907,172.31.47.0-255,66,117614,96,163209
29209,0.024172,74.125.24.0-255,5738,123352,96,163209
29210,0.024179,172.31.47.0-255,66,123418,96,163209
29211,0.026437,74.125.24.0-255,5738,129156,96,163209
29212,0.026443,172.31.47.0-255,66,129222,96,163209
29213,0.026941,172.31.47.0-255,172,129394,96,163209
29214,0.026976,172.31.47.0-255,1109,130503,96,163209
29215,0.027038,172.31.47.0-255,1514,132017,96,163209
29216,0.027039,172.31.47.0-255,1304,133321,96,163209
29217,0.028477,104.244.42.0-255,66,133387,96,163209
29218,0.028541,104.244.42.0-255,66,133453,96,163209
29219,0.028627,104.244.42.0-255,66,133519,96,163209
29220,0.028708,74.125.24.0-255,5738,139257,96,163209
29221,0.028712,172.31.47.0-255,66,139323,96,163209
29222,0.031017,74.125.24.0-255,5738,145061,96,163209
29223,0.031022,172.31.47.0-255,66,145127,96,163209
29224,0.033275,74.125.24.0-255,5738,150865,96,163209
29225,0.03328,172.31.47.0-255,66,150931,96,163209
29226,0.03552,74.125.24.0-255,2902,153833,96,163209
29227,0.035525,172.31.47.0-255,66,153899,96,163209
29228,0.035551,74.125.24.0-255,2902,156801,96,163209
29229,0.035554,172.31.47.0-255,66,156867,96,163209
29230,0.03781,74.125.24.0-255,5738,162605,96,163209
29231,0.037814,172.31.47.0-255,66,162671,96,163209
29232,0.040018,74.125.24.0-255,301,162972,96,163209
29233,0.04014,172.31.47.0-255,66,163038,96,163209
29234,0.040163,172.31.47.0-255,105,163143,96,163209
29235,0.042379,74.125.24.0-255,66,163209,96,163209
29236,0.0,74.125.24.0-255,152,152,96,275960
29237,2.7e-05,172.31.47.0-255,66,218,96,275960
29238,3.4e-05,74.125.24.0-255,1484,1702,96,275960
29239,3.8e-05,172.31.47.0-255,66,1768,96,275960
29240,4.3e-05,74.125.24.0-255,2902,4670,96,275960
29241,5.5e-05,172.31.47.0-255,66,4736,96,275960
29242,6.2e-05,74.125.24.0-255,4320,9056,96,275960
29243,6.4e-05,172.31.47.0-255,66,9122,96,275960
29244,7.6e-05,172.31.47.0-255,66,9188,96,275960
29245,0.000113,172.31.47.0-255,66,9254,96,275960
29246,0.000139,74.125.24.0-255,3961,13215,96,275960
29247,0.000142,172.31.47.0-255,66,13281,96,275960
29248,0.000199,74.125.24.0-255,1484,14765,96,275960
29249,0.000202,172.31.47.0-255,66,14831,96,275960
29250,0.000205,74.125.24.0-255,1484,16315,96,275960
29251,0.000208,172.31.47.0-255,66,16381,96,275960
29252,0.00024,74.125.24.0-255,1484,17865,96,275960
29253,0.000243,172.31.47.0-255,66,17931,96,275960
29254,0.00025,74.125.24.0-255,5738,23669,96,275960
29255,0.000252,172.31.47.0-255,66,23735,96,275960
29256,0.000259,74.125.24.0-255,6797,30532,96,275960
29257,0.000262,172.31.47.0-255,66,30598,96,275960
29258,0.000265,74.125.24.0-255,1484,32082,96,275960
29259,0.000267,172.31.47.0-255,66,32148,96,275960
29260,0.000305,74.125.24.0-255,7156,39304,96,275960
29261,0.000309,172.31.47.0-255,66,39370,96,275960
29262,0.000383,74.125.24.0-255,5738,45108,96,275960
29263,0.000387,172.31.47.0-255,66,45174,96,275960
29264,0.000392,74.125.24.0-255,2543,47717,96,275960
29265,0.000394,74.125.24.0-255,395,48112,96,275960
29266,0.000395,74.125.24.0-255,380,48492,96,275960
29267,0.000399,172.31.47.0-255,66,48558,96,275960
29268,0.00079,172.31.47.0-255,66,48624,96,275960
29269,0.001151,74.125.24.0-255,1484,50108,96,275960
29270,0.001161,74.125.24.0-255,2902,53010,96,275960
29271,0.001164,172.31.47.0-255,66,53076,96,275960
29272,0.001171,74.125.24.0-255,5738,58814,96,275960
29273,0.001173,172.31.47.0-255,66,58880,96,275960
29274,0.001194,74.125.24.0-255,7156,66036,96,275960
29275,0.001197,172.31.47.0-255,66,66102,96,275960
29276,0.001218,74.125.24.0-255,5738,71840,96,275960
29277,0.00122,172.31.47.0-255,66,71906,96,275960
29278,0.001231,172.31.47.0-255,66,71972,96,275960
29279,0.001233,74.125.24.0-255,766,72738,96,275960
29280,0.001713,172.31.47.0-255,66,72804,96,275960
29281,0.002059,74.125.24.0-255,1484,74288,96,275960
29282,0.002066,74.125.24.0-255,2902,77190,96,275960
29283,0.002069,172.31.47.0-255,66,77256,96,275960
29284,0.003744,74.125.24.0-255,1484,78740,96,275960
29285,0.004104,74.125.24.0-255,1484,80224,96,275960
29286,0.004106,172.31.47.0-255,66,80290,96,275960
29287,0.004128,74.125.24.0-255,2902,83192,96,275960
29288,0.00413,172.31.47.0-255,66,83258,96,275960
29289,0.006157,74.125.24.0-255,5738,88996,96,275960
29290,0.006165,172.31.47.0-255,66,89062,96,275960
29291,0.008234,74.125.24.0-255,5738,94800,96,275960
29292,0.008247,172.31.47.0-255,66,94866,96,275960
29293,0.01029,74.125.24.0-255,5738,100604,96,275960
29294,0.010296,172.31.47.0-255,66,100670,96,275960
29295,0.012351,74.125.24.0-255,5738,106408,96,275960
29296,0.012366,172.31.47.0-255,66,106474,96,275960
29297,0.014411,74.125.24.0-255,5738,112212,96,275960
29298,0.014422,172.31.47.0-255,66,112278,96,275960
29299,0.016467,74.125.24.0-255,5738,118016,96,275960
29300,0.016473,172.31.47.0-255,66,118082,96,275960
29301,0.018525,74.125.24.0-255,5738,123820,96,275960
29302,0.018531,172.31.47.0-255,66,123886,96,275960
29303,0.020549,74.125.24.0-255,5738,129624,96,275960
29304,0.020555,172.31.47.0-255,66,129690,96,275960
29305,0.021222,172.31.47.0-255,172,129862,96,275960
29306,0.021258,172.31.47.0-255,1110,130972,96,275960
29307,0.021328,172.31.47.0-255,1514,132486,96,275960
29308,0.021351,172.31.47.0-255,1514,134000,96,275960
29309,0.021355,172.31.47.0-255,1514,135514,96,275960
29310,0.021374,172.31.47.0-255,1082,136596,96,275960
29311,0.0226,74.125.24.0-255,4320,140916,96,275960
29312,0.022605,172.31.47.0-255,66,140982,96,275960
29313,0.022636,74.125.24.0-255,1484,142466,96,275960
29314,0.022789,104.244.42.0-255,66,142532,96,275960
29315,0.022828,104.244.42.0-255,66,142598,96,275960
29316,0.022931,104.244.42.0-255,66,142664,96,275960
29317,0.022935,104.244.42.0-255,66,142730,96,275960
29318,0.022937,104.244.42.0-255,66,142796,96,275960
29319,0.024646,74.125.24.0-255,4320,147116,96,275960
29320,0.024649,172.31.47.0-255,66,147182,96,275960
29321,0.02667,74.125.24.0-255,5738,152920,96,275960
29322,0.026675,172.31.47.0-255,66,152986,96,275960
29323,0.028719,74.125.24.0-255,4320,157306,96,275960
29324,0.028724,172.31.47.0-255,66,157372,96,275960
29325,0.028751,74.125.24.0-255,1484,158856,96,275960
29326,0.030753,74.125.24.0-255,4320,163176,96,275960
29327,0.030758,172.31.47.0-255,66,163242,96,275960
29328,0.032806,74.125.24.0-255,5738,168980,96,275960
29329,0.032811,172.31.47.0-255,66,169046,96,275960
29330,0.034879,74.125.24.0-255,2902,171948,96,275960
29331,0.034884,172.31.47.0-255,66,172014,96,275960
29332,0.034917,74.125.24.0-255,2902,174916,96,275960
29333,0.034919,172.31.47.0-255,66,174982,96,275960
29334,0.036938,74.125.24.0-255,2902,177884,96,275960
29335,0.036943,172.31.47.0-255,66,177950,96,275960
29336,0.036975,74.125.24.0-255,2902,180852,96,275960
29337,0.036978,172.31.47.0-255,66,180918,96,275960
29338,0.038975,74.125.24.0-255,2902,183820,96,275960
29339,0.03898,172.31.47.0-255,66,183886,96,275960
29340,0.039012,74.125.24.0-255,2902,186788,96,275960
29341,0.039015,172.31.47.0-255,66,186854,96,275960
29342,0.041003,74.125.24.0-255,2902,189756,96,275960
29343,0.041009,172.31.47.0-255,66,189822,96,275960
29344,0.04104,74.125.24.0-255,2902,192724,96,275960
29345,0.041043,172.31.47.0-255,66,192790,96,275960
29346,0.043033,74.125.24.0-255,2902,195692,96,275960
29347,0.043037,172.31.47.0-255,66,195758,96,275960
29348,0.043076,74.125.24.0-255,2902,198660,96,275960
29349,0.04308,172.31.47.0-255,66,198726,96,275960
29350,0.045062,74.125.24.0-255,2902,201628,96,275960
29351,0.045068,172.31.47.0-255,66,201694,96,275960
29352,0.0451,74.125.24.0-255,2902,204596,96,275960
29353,0.045103,172.31.47.0-255,66,204662,96,275960
29354,0.047145,74.125.24.0-255,2902,207564,96,275960
29355,0.04715,172.31.47.0-255,66,207630,96,275960
29356,0.047183,74.125.24.0-255,2902,210532,96,275960
29357,0.047186,172.31.47.0-255,66,210598,96,275960
29358,0.049174,74.125.24.0-255,2902,213500,96,275960
29359,0.049178,172.31.47.0-255,66,213566,96,275960
29360,0.049208,74.125.24.0-255,2902,216468,96,275960
29361,0.049211,172.31.47.0-255,66,216534,96,275960
29362,0.051221,74.125.24.0-255,2902,219436,96,275960
29363,0.051226,172.31.47.0-255,66,219502,96,275960
29364,0.051259,74.125.24.0-255,2902,222404,96,275960
29365,0.051263,172.31.47.0-255,66,222470,96,275960
29366,0.053283,74.125.24.0-255,2902,225372,96,275960
29367,0.053288,172.31.47.0-255,66,225438,96,275960
29368,0.053326,74.125.24.0-255,2902,228340,96,275960
29369,0.05333,172.31.47.0-255,66,228406,96,275960
29370,0.05532,74.125.24.0-255,2902,231308,96,275960
29371,0.055325,172.31.47.0-255,66,231374,96,275960
29372,0.055358,74.125.24.0-255,2902,234276,96,275960
29373,0.055361,172.31.47.0-255,66,234342,96,275960
29374,0.057339,74.125.24.0-255,2902,237244,96,275960
29375,0.057344,172.31.47.0-255,66,237310,96,275960
29376,0.057393,74.125.24.0-255,2902,240212,96,275960
29377,0.057398,172.31.47.0-255,66,240278,96,275960
29378,0.059373,74.125.24.0-255,2902,243180,96,275960
29379,0.059378,172.31.47.0-255,66,243246,96,275960
29380,0.059413,74.125.24.0-255,2902,246148,96,275960
29381,0.059417,172.31.47.0-255,66,246214,96,275960
29382,0.061398,74.125.24.0-255,2902,249116,96,275960
29383,0.061405,172.31.47.0-255,66,249182,96,275960
29384,0.061443,74.125.24.0-255,2902,252084,96,275960
29385,0.061447,172.31.47.0-255,66,252150,96,275960
29386,0.063445,74.125.24.0-255,2902,255052,96,275960
29387,0.06345,172.31.47.0-255,66,255118,96,275960
29388,0.0635,74.125.24.0-255,1484,256602,96,275960
29389,0.063512,74.125.24.0-255,1484,258086,96,275960
29390,0.063515,172.31.47.0-255,66,258152,96,275960
29391,0.065517,74.125.24.0-255,2902,261054,96,275960
29392,0.065523,172.31.47.0-255,66,261120,96,275960
29393,0.065556,74.125.24.0-255,2902,264022,96,275960
29394,0.06556,172.31.47.0-255,66,264088,96,275960
29395,0.06759,74.125.24.0-255,2902,266990,96,275960
29396,0.067595,172.31.47.0-255,66,267056,96,275960
29397,0.067668,74.125.24.0-255,2902,269958,96,275960
29398,0.067674,172.31.47.0-255,66,270024,96,275960
29399,0.06963,74.125.24.0-255,2902,272926,96,275960
29400,0.069635,172.31.47.0-255,66,272992,96,275960
29401,0.069722,74.125.24.0-255,2902,275894,96,275960
29402,0.069727,172.31.47.0-255,66,275960,96,275960
29403,0.0,172.31.47.0-255,105,105,96,276
29404,0.00176,157.240.13.0-255,105,210,96,276
29405,0.001771,172.31.47.0-255,66,276,96,276
29406,0.0,172.31.47.0-255,105,105,96,105
29407,0.0,74.125.200.0-255,153,153,96,186516
29408,1.7e-05,172.31.47.0-255,66,219,96,186516
29409,2.4e-05,74.125.200.0-255,1484,1703,96,186516
29410,2.8e-05,172.31.47.0-255,66,1769,96,186516
29411,4.1e-05,74.125.200.0-255,2902,4671,96,186516
29412,4.6e-05,172.31.47.0-255,66,4737,96,186516
29413,8e-05,74.125.200.0-255,5738,10475,96,186516
29414,8.4e-05,172.31.47.0-255,66,10541,96,186516
29415,0.000107,74.125.200.0-255,1484,12025,96,186516
29416,0.000109,172.31.47.0-255,66,12091,96,186516
29417,0.000218,74.125.200.0-255,2174,14265,96,186516
29418,0.000222,172.31.47.0-255,66,14331,96,186516
29419,0.000267,172.31.47.0-255,66,14397,96,186516
29420,0.000292,74.125.200.0-255,2902,17299,96,186516
29421,0.000295,172.31.47.0-255,66,17365,96,186516
29422,0.000478,74.125.200.0-255,4320,21685,96,186516
29423,0.000484,172.31.47.0-255,66,21751,96,186516
29424,0.000568,74.125.200.0-255,5738,27489,96,186516
29425,0.000572,172.31.47.0-255,66,27555,96,186516
29426,0.000618,172.31.47.0-255,66,27621,96,186516
29427,0.001009,172.31.47.0-255,66,27687,96,186516
29428,0.001264,172.31.47.0-255,66,27753,96,186516
29429,0.001318,172.31.47.0-255,66,27819,96,186516
29430,0.001916,74.125.200.0-255,5738,33557,96,186516
29431,0.001921,172.31.47.0-255,66,33623,96,186516
29432,0.001976,172.31.47.0-255,66,33689,96,186516
29433,0.002578,74.125.200.0-255,4320,38009,96,186516
29434,0.003741,172.31.47.0-255,66,38075,96,186516
29435,0.006295,74.125.200.0-255,5738,43813,96,186516
29436,0.006302,172.31.47.0-255,66,43879,96,186516
29437,0.00885,74.125.200.0-255,5738,49617,96,186516
29438,0.008858,172.31.47.0-255,66,49683,96,186516
29439,0.011459,74.125.200.0-255,5738,55421,96,186516
29440,0.011468,172.31.47.0-255,66,55487,96,186516
29441,0.014026,74.125.200.0-255,2902,58389,96,186516
29442,0.014033,172.31.47.0-255,66,58455,96,186516
29443,0.014057,74.125.200.0-255,2902,61357,96,186516
29444,0.01406,172.31.47.0-255,66,61423,96,186516
29445,0.016578,74.125.200.0-255,2902,64325,96,186516
29446,0.016584,172.31.47.0-255,66,64391,96,186516
29447,0.016631,74.125.200.0-255,2902,67293,96,186516
29448,0.016634,172.31.47.0-255,66,67359,96,186516
29449,0.019131,74.125.200.0-255,2902,70261,96,186516
29450,0.01915,172.31.47.0-255,66,70327,96,186516
29451,0.019181,74.125.200.0-255,2902,73229,96,186516
29452,0.019184,172.31.47.0-255,66,73295,96,186516
29453,0.02172,74.125.200.0-255,5738,79033,96,186516
29454,0.021735,172.31.47.0-255,66,79099,96,186516
29455,0.02431,74.125.200.0-255,5738,84837,96,186516
29456,0.024326,172.31.47.0-255,66,84903,96,186516
29457,0.026903,74.125.200.0-255,5738,90641,96,186516
29458,0.026921,172.31.47.0-255,66,90707,96,186516
29459,0.029469,74.125.200.0-255,5738,96445,96,186516
29460,0.029476,172.31.47.0-255,66,96511,96,186516
29461,0.032045,74.125.200.0-255,5738,102249,96,186516
29462,0.032061,172.31.47.0-255,66,102315,96,186516
29463,0.034609,74.125.200.0-255,5738,108053,96,186516
29464,0.034615,172.31.47.0-255,66,108119,96,186516
29465,0.035495,172.31.47.0-255,172,108291,96,186516
29466,0.035523,172.31.47.0-255,1101,109392,96,186516
29467,0.035574,172.31.47.0-255,1514,110906,96,186516
29468,0.035576,172.31.47.0-255,1312,112218,96,186516
29469,0.037013,104.244.42.0-255,66,112284,96,186516
29470,0.037031,104.244.42.0-255,66,112350,96,186516
29471,0.037133,104.244.42.0-255,66,112416,96,186516
29472,0.037148,74.125.200.0-255,4320,116736,96,186516
29473,0.037153,172.31.47.0-255,66,116802,96,186516
29474,0.037172,74.125.200.0-255,1484,118286,96,186516
29475,0.039739,74.125.200.0-255,4320,122606,96,186516
29476,0.039757,172.31.47.0-255,66,122672,96,186516
29477,0.042313,74.125.200.0-255,5738,128410,96,186516
29478,0.042326,172.31.47.0-255,66,128476,96,186516
29479,0.044891,74.125.200.0-255,5738,134214,96,186516
29480,0.044909,172.31.47.0-255,66,134280,96,186516
29481,0.047476,74.125.200.0-255,5738,140018,96,186516
29482,0.047493,172.31.47.0-255,66,140084,96,186516
29483,0.050059,74.125.200.0-255,5738,145822,96,186516
29484,0.050076,172.31.47.0-255,66,145888,96,186516
29485,0.052665,74.125.200.0-255,5738,151626,96,186516
29486,0.052696,172.31.47.0-255,66,151692,96,186516
29487,0.055241,74.125.200.0-255,5738,157430,96,186516
29488,0.055247,172.31.47.0-255,66,157496,96,186516
29489,0.05779,74.125.200.0-255,5738,163234,96,186516
29490,0.057796,172.31.47.0-255,66,163300,96,186516
29491,0.060348,74.125.200.0-255,5738,169038,96,186516
29492,0.060355,172.31.47.0-255,66,169104,96,186516
29493,0.062903,74.125.200.0-255,5738,174842,96,186516
29494,0.062909,172.31.47.0-255,66,174908,96,186516
29495,0.065483,74.125.200.0-255,5738,180646,96,186516
29496,0.065489,172.31.47.0-255,66,180712,96,186516
29497,0.068035,74.125.200.0-255,5738,186450,96,186516
29498,0.06804,172.31.47.0-255,66,186516,96,186516
29499,0.0,74.125.24.0-255,153,153,96,242401
29500,2.4e-05,172.31.47.0-255,66,219,96,242401
29501,2.9e-05,74.125.24.0-255,1484,1703,96,242401
29502,3.3e-05,172.31.47.0-255,66,1769,96,242401
29503,3.7e-05,74.125.24.0-255,2902,4671,96,242401
29504,3.9e-05,172.31.47.0-255,66,4737,96,242401
29505,5.4e-05,74.125.24.0-255,7156,11893,96,242401
29506,5.7e-05,172.31.47.0-255,66,11959,96,242401
29507,9.1e-05,74.125.24.0-255,2175,14134,96,242401
29508,9.4e-05,172.31.47.0-255,66,14200,96,242401
29509,0.000133,74.125.24.0-255,1484,15684,96,242401
29510,0.000135,172.31.47.0-255,66,15750,96,242401
29511,0.00014,74.125.24.0-255,2902,18652,96,242401
29512,0.000142,172.31.47.0-255,66,18718,96,242401
29513,0.000146,74.125.24.0-255,2902,21620,96,242401
29514,0.000147,172.31.47.0-255,66,21686,96,242401
29515,0.000164,74.125.24.0-255,2902,24588,96,242401
29516,0.000167,172.31.47.0-255,66,24654,96,242401
29517,0.000179,74.125.24.0-255,2902,27556,96,242401
29518,0.000181,172.31.47.0-255,66,27622,96,242401
29519,0.000196,74.125.24.0-255,3961,31583,96,242401
29520,0.000202,172.31.47.0-255,66,31649,96,242401
29521,0.000208,74.125.24.0-255,7156,38805,96,242401
29522,0.000211,172.31.47.0-255,66,38871,96,242401
29523,0.000232,74.125.24.0-255,2902,41773,96,242401
29524,0.000235,172.31.47.0-255,66,41839,96,242401
29525,0.000258,74.125.24.0-255,6797,48636,96,242401
29526,0.000261,172.31.47.0-255,66,48702,96,242401
29527,0.000286,74.125.24.0-255,2902,51604,96,242401
29528,0.000289,172.31.47.0-255,66,51670,96,242401
29529,0.000293,74.125.24.0-255,4320,55990,96,242401
29530,0.000296,172.31.47.0-255,66,56056,96,242401
29531,0.0003,74.125.24.0-255,2902,58958,96,242401
29532,0.000306,172.31.47.0-255,66,59024,96,242401
29533,0.000321,74.125.24.0-255,5738,64762,96,242401
29534,0.000325,74.125.24.0-255,1125,65887,96,242401
29535,0.00033,172.31.47.0-255,66,65953,96,242401
29536,0.000523,74.125.24.0-255,358,66311,96,242401
29537,0.000553,74.125.24.0-255,136,66447,96,242401
29538,0.00062,74.125.24.0-255,1484,67931,96,242401
29539,0.000623,172.31.47.0-255,66,67997,96,242401
29540,0.000628,74.125.24.0-255,2902,70899,96,242401
29541,0.000635,172.31.47.0-255,66,70965,96,242401
29542,0.00065,74.125.24.0-255,5738,76703,96,242401
29543,0.00066,172.31.47.0-255,66,76769,96,242401
29544,0.000693,74.125.24.0-255,4320,81089,96,242401
29545,0.000694,172.31.47.0-255,66,81155,96,242401
29546,0.000716,172.31.47.0-255,66,81221,96,242401
29547,0.000724,74.125.24.0-255,6438,87659,96,242401
29548,0.000726,74.125.24.0-255,348,88007,96,242401
29549,0.000728,172.31.47.0-255,66,88073,96,242401
29550,0.000902,172.31.47.0-255,66,88139,96,242401
29551,0.000903,74.125.24.0-255,1484,89623,96,242401
29552,0.000916,74.125.24.0-255,2902,92525,96,242401
29553,0.000922,74.125.24.0-255,1484,94009,96,242401
29554,0.000924,172.31.47.0-255,66,94075,96,242401
29555,0.000951,74.125.24.0-255,4320,98395,96,242401
29556,0.000963,172.31.47.0-255,66,98461,96,242401
29557,0.000987,74.125.24.0-255,4320,102781,96,242401
29558,0.000993,172.31.47.0-255,66,102847,96,242401
29559,0.001017,74.125.24.0-255,6438,109285,96,242401
29560,0.001021,172.31.47.0-255,66,109351,96,242401
29561,0.001101,74.125.24.0-255,1484,110835,96,242401
29562,0.001104,74.125.24.0-255,1484,112319,96,242401
29563,0.001106,172.31.47.0-255,66,112385,96,242401
29564,0.001127,74.125.24.0-255,1484,113869,96,242401
29565,0.001132,74.125.24.0-255,5738,119607,96,242401
29566,0.001134,74.125.24.0-255,1484,121091,96,242401
29567,0.001143,172.31.47.0-255,66,121157,96,242401
29568,0.001153,74.125.24.0-255,7156,128313,96,242401
29569,0.001164,172.31.47.0-255,66,128379,96,242401
29570,0.001174,74.125.24.0-255,4320,132699,96,242401
29571,0.001182,74.125.24.0-255,7156,139855,96,242401
29572,0.001183,172.31.47.0-255,66,139921,96,242401
29573,0.001187,172.31.47.0-255,66,139987,96,242401
29574,0.001211,74.125.24.0-255,3602,143589,96,242401
29575,0.001215,172.31.47.0-255,66,143655,96,242401
29576,0.001322,74.125.24.0-255,1484,145139,96,242401
29577,0.001326,74.125.24.0-255,2902,148041,96,242401
29578,0.001329,172.31.47.0-255,66,148107,96,242401
29579,0.001382,74.125.24.0-255,5738,153845,96,242401
29580,0.001385,172.31.47.0-255,66,153911,96,242401
29581,0.001392,74.125.24.0-255,7156,161067,96,242401
29582,0.001396,172.31.47.0-255,66,161133,96,242401
29583,0.001408,172.31.47.0-255,66,161199,96,242401
29584,0.001416,74.125.24.0-255,2184,163383,96,242401
29585,0.001419,172.31.47.0-255,66,163449,96,242401
29586,0.001458,172.31.47.0-255,66,163515,96,242401
29587,0.001464,74.125.24.0-255,4320,167835,96,242401
29588,0.001469,172.31.47.0-255,66,167901,96,242401
29589,0.001492,74.125.24.0-255,5738,173639,96,242401
29590,0.001504,172.31.47.0-255,66,173705,96,242401
29591,0.001507,172.31.47.0-255,66,173771,96,242401
29592,0.001531,74.125.24.0-255,5020,178791,96,242401
29593,0.001537,172.31.47.0-255,66,178857,96,242401
29594,0.001556,74.125.24.0-255,1484,180341,96,242401
29595,0.001561,74.125.24.0-255,2902,183243,96,242401
29596,0.001564,74.125.24.0-255,2902,186145,96,242401
29597,0.001566,172.31.47.0-255,66,186211,96,242401
29598,0.00157,172.31.47.0-255,66,186277,96,242401
29599,0.001583,74.125.24.0-255,2902,189179,96,242401
29600,0.001587,74.125.24.0-255,2902,192081,96,242401
29601,0.00159,172.31.47.0-255,66,192147,96,242401
29602,0.001632,74.125.24.0-255,7156,199303,96,242401
29603,0.001642,172.31.47.0-255,66,199369,96,242401
29604,0.001663,74.125.24.0-255,3602,202971,96,242401
29605,0.001675,172.31.47.0-255,66,203037,96,242401
29606,0.001689,74.125.24.0-255,4320,207357,96,242401
29607,0.001696,74.125.24.0-255,1484,208841,96,242401
29608,0.001696,172.31.47.0-255,66,208907,96,242401
29609,0.001708,74.125.24.0-255,2902,211809,96,242401
29610,0.001711,172.31.47.0-255,66,211875,96,242401
29611,0.001728,74.125.24.0-255,5738,217613,96,242401
29612,0.001731,172.31.47.0-255,66,217679,96,242401
29613,0.001743,74.125.24.0-255,4320,221999,96,242401
29614,0.001753,172.31.47.0-255,66,222065,96,242401
29615,0.001756,74.125.24.0-255,1484,223549,96,242401
29616,0.001767,74.125.24.0-255,4320,227869,96,242401
29617,0.001777,172.31.47.0-255,66,227935,96,242401
29618,0.001793,172.31.47.0-255,66,228001,96,242401
29619,0.001808,74.125.24.0-255,5020,233021,96,242401
29620,0.001811,172.31.47.0-255,66,233087,96,242401
29621,0.001825,172.31.47.0-255,66,233153,96,242401
29622,0.001871,172.31.47.0-255,66,233219,96,242401
29623,0.001884,172.31.47.0-255,66,233285,96,242401
29624,0.001929,172.31.47.0-255,66,233351,96,242401
29625,0.001972,172.31.47.0-255,66,233417,96,242401
29626,0.002009,172.31.47.0-255,66,233483,96,242401
29627,0.00202,172.31.47.0-255,66,233549,96,242401
29628,0.002021,74.125.24.0-255,4149,237698,96,242401
29629,0.002035,172.31.47.0-255,66,237764,96,242401
29630,0.002045,74.125.24.0-255,105,237869,96,242401
29631,0.014763,172.31.47.0-255,66,237935,96,242401
29632,0.014791,172.31.47.0-255,105,238040,96,242401
29633,0.01709,74.125.24.0-255,66,238106,96,242401
29634,0.039524,172.31.47.0-255,172,238278,96,242401
29635,0.039551,172.31.47.0-255,1101,239379,96,242401
29636,0.039602,172.31.47.0-255,1514,240893,96,242401
29637,0.039603,172.31.47.0-255,1310,242203,96,242401
29638,0.041112,104.244.42.0-255,66,242269,96,242401
29639,0.041125,104.244.42.0-255,66,242335,96,242401
29640,0.041201,104.244.42.0-255,66,242401,96,242401
29641,0.0,74.125.24.0-255,297,297,96,271337
29642,2.9e-05,172.31.47.0-255,66,363,96,271337
29643,3.6e-05,74.125.24.0-255,1484,1847,96,271337
29644,3.9e-05,172.31.47.0-255,66,1913,96,271337
29645,4.5e-05,74.125.24.0-255,4320,6233,96,271337
29646,4.7e-05,172.31.47.0-255,66,6299,96,271337
29647,6.8e-05,74.125.24.0-255,1484,7783,96,271337
29648,7e-05,172.31.47.0-255,66,7849,96,271337
29649,8.8e-05,74.125.24.0-255,6014,13863,96,271337
29650,9e-05,172.31.47.0-255,66,13929,96,271337
29651,0.000113,74.125.24.0-255,1484,15413,96,271337
29652,0.000115,172.31.47.0-255,66,15479,96,271337
29653,0.00012,74.125.24.0-255,2902,18381,96,271337
29654,0.000122,172.31.47.0-255,66,18447,96,271337
29655,0.000137,74.125.24.0-255,5738,24185,96,271337
29656,0.00014,172.31.47.0-255,66,24251,96,271337
29657,0.000156,74.125.24.0-255,1484,25735,96,271337
29658,0.000158,172.31.47.0-255,66,25801,96,271337
29659,0.000171,74.125.24.0-255,5379,31180,96,271337
29660,0.000173,172.31.47.0-255,66,31246,96,271337
29661,0.000471,74.125.24.0-255,1484,32730,96,271337
29662,0.000476,172.31.47.0-255,66,32796,96,271337
29663,0.000482,74.125.24.0-255,2902,35698,96,271337
29664,0.000484,172.31.47.0-255,66,35764,96,271337
29665,0.000514,74.125.24.0-255,5738,41502,96,271337
29666,0.000518,172.31.47.0-255,66,41568,96,271337
29667,0.000525,74.125.24.0-255,6797,48365,96,271337
29668,0.000527,172.31.47.0-255,66,48431,96,271337
29669,0.00053,74.125.24.0-255,1484,49915,96,271337
29670,0.000533,172.31.47.0-255,66,49981,96,271337
29671,0.000568,172.31.47.0-255,66,50047,96,271337
29672,0.000572,74.125.24.0-255,2852,52899,96,271337
29673,0.000576,172.31.47.0-255,66,52965,96,271337
29674,0.000964,74.125.24.0-255,111,53076,96,271337
29675,0.001055,74.125.24.0-255,1484,54560,96,271337
29676,0.00106,172.31.47.0-255,66,54626,96,271337
29677,0.001065,74.125.24.0-255,2902,57528,96,271337
29678,0.001067,172.31.47.0-255,66,57594,96,271337
29679,0.001072,74.125.24.0-255,4320,61914,96,271337
29680,0.001074,172.31.47.0-255,66,61980,96,271337
29681,0.001092,74.125.24.0-255,1484,63464,96,271337
29682,0.001106,74.125.24.0-255,4320,67784,96,271337
29683,0.001109,172.31.47.0-255,66,67850,96,271337
29684,0.001126,74.125.24.0-255,2543,70393,96,271337
29685,0.001128,172.31.47.0-255,66,70459,96,271337
29686,0.001143,74.125.24.0-255,2902,73361,96,271337
29687,0.001145,172.31.47.0-255,66,73427,96,271337
29688,0.001164,74.125.24.0-255,4320,77747,96,271337
29689,0.001166,172.31.47.0-255,66,77813,96,271337
29690,0.001171,74.125.24.0-255,4320,82133,96,271337
29691,0.001173,172.31.47.0-255,66,82199,96,271337
29692,0.001201,74.125.24.0-255,2902,85101,96,271337
29693,0.001203,172.31.47.0-255,66,85167,96,271337
29694,0.001217,74.125.24.0-255,2543,87710,96,271337
29695,0.001219,172.31.47.0-255,66,87776,96,271337
29696,0.003409,74.125.24.0-255,5738,93514,96,271337
29697,0.003416,172.31.47.0-255,66,93580,96,271337
29698,0.005615,74.125.24.0-255,5738,99318,96,271337
29699,0.005619,172.31.47.0-255,66,99384,96,271337
29700,0.007831,74.125.24.0-255,4320,103704,96,271337
29701,0.007836,172.31.47.0-255,66,103770,96,271337
29702,0.007853,74.125.24.0-255,1484,105254,96,271337
29703,0.010051,74.125.24.0-255,4320,109574,96,271337
29704,0.010058,172.31.47.0-255,66,109640,96,271337
29705,0.012279,74.125.24.0-255,5738,115378,96,271337
29706,0.012287,172.31.47.0-255,66,115444,96,271337
29707,0.014478,74.125.24.0-255,5738,121182,96,271337
29708,0.014488,172.31.47.0-255,66,121248,96,271337
29709,0.016698,74.125.24.0-255,5738,126986,96,271337
29710,0.016705,172.31.47.0-255,66,127052,96,271337
29711,0.018915,74.125.24.0-255,5738,132790,96,271337
29712,0.018923,172.31.47.0-255,66,132856,96,271337
29713,0.021135,74.125.24.0-255,5738,138594,96,271337
29714,0.021143,172.31.47.0-255,66,138660,96,271337
29715,0.023343,74.125.24.0-255,5738,144398,96,271337
29716,0.02335,172.31.47.0-255,66,144464,96,271337
29717,0.024945,172.31.47.0-255,172,144636,96,271337
29718,0.024977,172.31.47.0-255,1110,145746,96,271337
29719,0.025019,172.31.47.0-255,1514,147260,96,271337
29720,0.025021,172.31.47.0-255,1301,148561,96,271337
29721,0.02556,74.125.24.0-255,5738,154299,96,271337
29722,0.025565,172.31.47.0-255,66,154365,96,271337
29723,0.026483,104.244.42.0-255,66,154431,96,271337
29724,0.026506,104.244.42.0-255,66,154497,96,271337
29725,0.026549,104.244.42.0-255,66,154563,96,271337
29726,0.027766,74.125.24.0-255,5738,160301,96,271337
29727,0.02777,172.31.47.0-255,66,160367,96,271337
29728,0.029956,74.125.24.0-255,4320,164687,96,271337
29729,0.029961,172.31.47.0-255,66,164753,96,271337
29730,0.029989,74.125.24.0-255,1484,166237,96,271337
29731,0.032166,74.125.24.0-255,4320,170557,96,271337
29732,0.032172,172.31.47.0-255,66,170623,96,271337
29733,0.034376,74.125.24.0-255,1484,172107,96,271337
29734,0.034406,74.125.24.0-255,4320,176427,96,271337
29735,0.03441,172.31.47.0-255,66,176493,96,271337
29736,0.036632,74.125.24.0-255,5738,182231,96,271337
29737,0.036638,172.31.47.0-255,66,182297,96,271337
29738,0.038843,74.125.24.0-255,5738,188035,96,271337
29739,0.038849,172.31.47.0-255,66,188101,96,271337
29740,0.041027,74.125.24.0-255,2902,191003,96,271337
29741,0.041032,172.31.47.0-255,66,191069,96,271337
29742,0.041063,74.125.24.0-255,2902,193971,96,271337
29743,0.041065,172.31.47.0-255,66,194037,96,271337
29744,0.043218,74.125.24.0-255,2902,196939,96,271337
29745,0.043223,172.31.47.0-255,66,197005,96,271337
29746,0.043258,74.125.24.0-255,2902,199907,96,271337
29747,0.04326,172.31.47.0-255,66,199973,96,271337
29748,0.045419,74.125.24.0-255,2902,202875,96,271337
29749,0.045424,172.31.47.0-255,66,202941,96,271337
29750,0.045497,74.125.24.0-255,2902,205843,96,271337
29751,0.045501,172.31.47.0-255,66,205909,96,271337
29752,0.04761,74.125.24.0-255,2902,208811,96,271337
29753,0.047614,172.31.47.0-255,66,208877,96,271337
29754,0.047695,74.125.24.0-255,2902,211779,96,271337
29755,0.047699,172.31.47.0-255,66,211845,96,271337
29756,0.049824,74.125.24.0-255,2902,214747,96,271337
29757,0.04983,172.31.47.0-255,66,214813,96,271337
29758,0.049888,74.125.24.0-255,2902,217715,96,271337
29759,0.049893,172.31.47.0-255,66,217781,96,271337
29760,0.052037,74.125.24.0-255,2902,220683,96,271337
29761,0.052041,172.31.47.0-255,66,220749,96,271337
29762,0.052071,74.125.24.0-255,1484,222233,96,271337
29763,0.052081,74.125.24.0-255,1484,223717,96,271337
29764,0.052085,172.31.47.0-255,66,223783,96,271337
29765,0.054219,74.125.24.0-255,2902,226685,96,271337
29766,0.054224,172.31.47.0-255,66,226751,96,271337
29767,0.054267,74.125.24.0-255,2902,229653,96,271337
29768,0.054271,172.31.47.0-255,66,229719,96,271337
29769,0.056397,74.125.24.0-255,2902,232621,96,271337
29770,0.056401,172.31.47.0-255,66,232687,96,271337
29771,0.056448,74.125.24.0-255,2902,235589,96,271337
29772,0.056451,172.31.47.0-255,66,235655,96,271337
29773,0.058599,74.125.24.0-255,2902,238557,96,271337
29774,0.058604,172.31.47.0-255,66,238623,96,271337
29775,0.058661,74.125.24.0-255,1484,240107,96,271337
29776,0.058674,74.125.24.0-255,1484,241591,96,271337
29777,0.058677,172.31.47.0-255,66,241657,96,271337
29778,0.06081,74.125.24.0-255,2902,244559,96,271337
29779,0.060814,172.31.47.0-255,66,244625,96,271337
29780,0.060886,74.125.24.0-255,2902,247527,96,271337
29781,0.06089,172.31.47.0-255,66,247593,96,271337
29782,0.063001,74.125.24.0-255,2902,250495,96,271337
29783,0.063007,172.31.47.0-255,66,250561,96,271337
29784,0.063077,74.125.24.0-255,2902,253463,96,271337
29785,0.063081,172.31.47.0-255,66,253529,96,271337
29786,0.065196,74.125.24.0-255,2902,256431,96,271337
29787,0.065201,172.31.47.0-255,66,256497,96,271337
29788,0.065282,74.125.24.0-255,2902,259399,96,271337
29789,0.065286,172.31.47.0-255,66,259465,96,271337
29790,0.067395,74.125.24.0-255,2902,262367,96,271337
29791,0.0674,172.31.47.0-255,66,262433,96,271337
29792,0.067527,74.125.24.0-255,2902,265335,96,271337
29793,0.067532,172.31.47.0-255,66,265401,96,271337
29794,0.069602,74.125.24.0-255,2902,268303,96,271337
29795,0.069607,172.31.47.0-255,66,268369,96,271337
29796,0.069725,74.125.24.0-255,2902,271271,96,271337
29797,0.06973,172.31.47.0-255,66,271337,96,271337
29798,0.0,172.217.194.0-255,157,157,96,200921
29799,2.2e-05,172.31.47.0-255,66,223,96,200921
29800,2.9e-05,172.217.194.0-255,1484,1707,96,200921
29801,3.3e-05,172.31.47.0-255,66,1773,96,200921
29802,3.7e-05,172.217.194.0-255,2902,4675,96,200921
29803,4e-05,172.31.47.0-255,66,4741,96,200921
29804,4.4e-05,172.217.194.0-255,2902,7643,96,200921
29805,4.5e-05,172.31.47.0-255,66,7709,96,200921
29806,7.3e-05,172.217.194.0-255,4320,12029,96,200921
29807,7.6e-05,172.31.47.0-255,66,12095,96,200921
29808,8e-05,172.217.194.0-255,2065,14160,96,200921
29809,8.2e-05,172.31.47.0-255,66,14226,96,200921
29810,0.000119,172.217.194.0-255,1484,15710,96,200921
29811,0.000121,172.31.47.0-255,66,15776,96,200921
29812,0.00014,172.217.194.0-255,2902,18678,96,200921
29813,0.000142,172.31.47.0-255,66,18744,96,200921
29814,0.000149,172.217.194.0-255,5738,24482,96,200921
29815,0.000151,172.31.47.0-255,66,24548,96,200921
29816,0.000179,172.217.194.0-255,6797,31345,96,200921
29817,0.000182,172.31.47.0-255,66,31411,96,200921
29818,0.000184,172.217.194.0-255,1484,32895,96,200921
29819,0.000186,172.31.47.0-255,66,32961,96,200921
29820,0.000212,172.31.47.0-255,66,33027,96,200921
29821,0.000236,172.217.194.0-255,1484,34511,96,200921
29822,0.000238,172.31.47.0-255,66,34577,96,200921
29823,0.000242,172.217.194.0-255,2543,37120,96,200921
29824,0.000243,172.31.47.0-255,66,37186,96,200921
29825,0.000281,172.217.194.0-255,7156,44342,96,200921
29826,0.000284,172.31.47.0-255,66,44408,96,200921
29827,0.000314,172.31.47.0-255,66,44474,96,200921
29828,0.000317,172.217.194.0-255,407,44881,96,200921
29829,0.000342,172.217.194.0-255,366,45247,96,200921
29830,0.000381,172.217.194.0-255,1484,46731,96,200921
29831,0.000383,172.31.47.0-255,66,46797,96,200921
29832,0.000411,172.217.194.0-255,4320,51117,96,200921
29833,0.000414,172.31.47.0-255,66,51183,96,200921
29834,0.000416,172.217.194.0-255,1484,52667,96,200921
29835,0.000433,172.217.194.0-255,2902,55569,96,200921
29836,0.000435,172.31.47.0-255,66,55635,96,200921
29837,0.000463,172.217.194.0-255,5738,61373,96,200921
29838,0.000465,172.31.47.0-255,66,61439,96,200921
29839,0.000491,172.217.194.0-255,5379,66818,96,200921
29840,0.000493,172.31.47.0-255,66,66884,96,200921
29841,0.000502,172.31.47.0-255,66,66950,96,200921
29842,0.000518,172.217.194.0-255,1484,68434,96,200921
29843,0.000531,172.217.194.0-255,2543,70977,96,200921
29844,0.000533,172.31.47.0-255,66,71043,96,200921
29845,0.000795,172.217.194.0-255,1484,72527,96,200921
29846,0.0008,172.217.194.0-255,2902,75429,96,200921
29847,0.000803,172.31.47.0-255,66,75495,96,200921
29848,0.000828,172.217.194.0-255,5738,81233,96,200921
29849,0.00083,172.31.47.0-255,66,81299,96,200921
29850,0.000833,172.217.194.0-255,1484,82783,96,200921
29851,0.000854,172.217.194.0-255,5738,88521,96,200921
29852,0.000856,172.31.47.0-255,66,88587,96,200921
29853,0.000887,172.31.47.0-255,66,88653,96,200921
29854,0.000891,172.217.194.0-255,2184,90837,96,200921
29855,0.000892,172.31.47.0-255,66,90903,96,200921
29856,0.001219,172.217.194.0-255,1484,92387,96,200921
29857,0.001224,172.217.194.0-255,2902,95289,96,200921
29858,0.001227,172.31.47.0-255,66,95355,96,200921
29859,0.001251,172.217.194.0-255,5738,101093,96,200921
29860,0.001253,172.31.47.0-255,66,101159,96,200921
29861,0.00128,172.217.194.0-255,1484,102643,96,200921
29862,0.001304,172.31.47.0-255,66,102709,96,200921
29863,0.001314,172.31.47.0-255,66,102775,96,200921
29864,0.001354,172.217.194.0-255,1484,104259,96,200921
29865,0.001358,172.217.194.0-255,2902,107161,96,200921
29866,0.001361,172.31.47.0-255,66,107227,96,200921
29867,0.001383,172.217.194.0-255,5738,112965,96,200921
29868,0.001385,172.31.47.0-255,66,113031,96,200921
29869,0.001392,172.217.194.0-255,7156,120187,96,200921
29870,0.001393,172.31.47.0-255,66,120253,96,200921
29871,0.001422,172.31.47.0-255,66,120319,96,200921
29872,0.001446,172.217.194.0-255,4320,124639,96,200921
29873,0.001448,172.31.47.0-255,66,124705,96,200921
29874,0.001452,172.217.194.0-255,2184,126889,96,200921
29875,0.001454,172.31.47.0-255,66,126955,96,200921
29876,0.001859,172.217.194.0-255,1484,128439,96,200921
29877,0.001877,172.217.194.0-255,2902,131341,96,200921
29878,0.001882,172.217.194.0-255,4320,135661,96,200921
29879,0.001885,172.31.47.0-255,66,135727,96,200921
29880,0.001888,172.31.47.0-255,66,135793,96,200921
29881,0.001899,172.217.194.0-255,1484,137277,96,200921
29882,0.001909,172.31.47.0-255,66,137343,96,200921
29883,0.001957,172.217.194.0-255,2902,140245,96,200921
29884,0.00196,172.31.47.0-255,66,140311,96,200921
29885,0.00198,172.31.47.0-255,66,140377,96,200921
29886,0.001998,172.217.194.0-255,766,141143,96,200921
29887,0.002021,172.217.194.0-255,1484,142627,96,200921
29888,0.002024,172.31.47.0-255,66,142693,96,200921
29889,0.002028,172.217.194.0-255,2902,145595,96,200921
29890,0.00203,172.31.47.0-255,66,145661,96,200921
29891,0.002035,172.217.194.0-255,5738,151399,96,200921
29892,0.002037,172.31.47.0-255,66,151465,96,200921
29893,0.00207,172.217.194.0-255,5738,157203,96,200921
29894,0.002073,172.31.47.0-255,66,157269,96,200921
29895,0.002103,172.217.194.0-255,5738,163007,96,200921
29896,0.002105,172.31.47.0-255,66,163073,96,200921
29897,0.002118,172.31.47.0-255,66,163139,96,200921
29898,0.002123,172.217.194.0-255,5738,168877,96,200921
29899,0.002125,172.31.47.0-255,66,168943,96,200921
29900,0.002159,172.31.47.0-255,66,169009,96,200921
29901,0.002164,172.217.194.0-255,4320,173329,96,200921
29902,0.002165,172.31.47.0-255,66,173395,96,200921
29903,0.00219,172.31.47.0-255,66,173461,96,200921
29904,0.002199,172.31.47.0-255,66,173527,96,200921
29905,0.002231,172.31.47.0-255,66,173593,96,200921
29906,0.002243,172.31.47.0-255,66,173659,96,200921
29907,0.002302,172.31.47.0-255,66,173725,96,200921
29908,0.002344,172.31.47.0-255,66,173791,96,200921
29909,0.00235,172.217.194.0-255,7156,180947,96,200921
29910,0.002352,172.31.47.0-255,66,181013,96,200921
29911,0.002375,172.31.47.0-255,66,181079,96,200921
29912,0.002399,172.31.47.0-255,66,181145,96,200921
29913,0.004662,172.217.194.0-255,5738,186883,96,200921
29914,0.00467,172.31.47.0-255,66,186949,96,200921
29915,0.006948,172.217.194.0-255,2902,189851,96,200921
29916,0.006952,172.31.47.0-255,66,189917,96,200921
29917,0.006969,172.217.194.0-255,2902,192819,96,200921
29918,0.00697,172.31.47.0-255,66,192885,96,200921
29919,0.009264,172.217.194.0-255,3504,196389,96,200921
29920,0.009271,172.31.47.0-255,66,196455,96,200921
29921,0.009656,172.31.47.0-255,105,196560,96,200921
29922,0.011923,172.217.194.0-255,66,196626,96,200921
29923,0.028593,172.31.47.0-255,172,196798,96,200921
29924,0.028623,172.31.47.0-255,1105,197903,96,200921
29925,0.028668,172.31.47.0-255,1514,199417,96,200921
29926,0.028669,172.31.47.0-255,1306,200723,96,200921
29927,0.030176,104.244.42.0-255,66,200789,96,200921
29928,0.030204,104.244.42.0-255,66,200855,96,200921
29929,0.030232,104.244.42.0-255,66,200921,96,200921
29930,0.0,172.31.47.0-255,105,105,96,459
29931,0.000284,172.31.47.0-255,90,195,96,459
29932,0.000293,172.31.47.0-255,66,261,96,459
29933,0.002494,74.125.130.0-255,66,327,96,459
29934,0.002518,74.125.130.0-255,66,393,96,459
29935,0.002528,172.31.47.0-255,66,459,96,459
29936,0.0,216.58.221.0-255,298,298,96,308127
29937,2.3e-05,172.31.47.0-255,66,364,96,308127
29938,2.9e-05,216.58.221.0-255,1484,1848,96,308127
29939,3.2e-05,172.31.47.0-255,66,1914,96,308127
29940,3.7e-05,216.58.221.0-255,2902,4816,96,308127
29941,4.6e-05,172.31.47.0-255,66,4882,96,308127
29942,5.2e-05,216.58.221.0-255,4320,9202,96,308127
29943,5.4e-05,172.31.47.0-255,66,9268,96,308127
29944,9.2e-05,172.31.47.0-255,66,9334,96,308127
29945,9.7e-05,216.58.221.0-255,4320,13654,96,308127
29946,9.8e-05,172.31.47.0-255,66,13720,96,308127
29947,0.000115,216.58.221.0-255,4320,18040,96,308127
29948,0.000117,172.31.47.0-255,66,18106,96,308127
29949,0.00014,216.58.221.0-255,1484,19590,96,308127
29950,0.000142,172.31.47.0-255,66,19656,96,308127
29951,0.000146,216.58.221.0-255,2543,22199,96,308127
29952,0.000148,172.31.47.0-255,66,22265,96,308127
29953,0.000262,216.58.221.0-255,1484,23749,96,308127
29954,0.000265,172.31.47.0-255,66,23815,96,308127
29955,0.00027,216.58.221.0-255,2902,26717,96,308127
29956,0.000272,172.31.47.0-255,66,26783,96,308127
29957,0.000277,216.58.221.0-255,5738,32521,96,308127
29958,0.000279,172.31.47.0-255,66,32587,96,308127
29959,0.000317,172.31.47.0-255,66,32653,96,308127
29960,0.000322,216.58.221.0-255,4320,36973,96,308127
29961,0.000324,172.31.47.0-255,66,37039,96,308127
29962,0.000343,216.58.221.0-255,4320,41359,96,308127
29963,0.000349,172.31.47.0-255,66,41425,96,308127
29964,0.000378,216.58.221.0-255,4320,45745,96,308127
29965,0.00038,172.31.47.0-255,66,45811,96,308127
29966,0.000391,216.58.221.0-255,2872,48683,96,308127
29967,0.000396,172.31.47.0-255,66,48749,96,308127
29968,0.001149,216.58.221.0-255,349,49098,96,308127
29969,0.001174,172.31.47.0-255,66,49164,96,308127
29970,0.001253,216.58.221.0-255,1484,50648,96,308127
29971,0.001261,216.58.221.0-255,2902,53550,96,308127
29972,0.001264,172.31.47.0-255,66,53616,96,308127
29973,0.00127,216.58.221.0-255,2902,56518,96,308127
29974,0.001271,172.31.47.0-255,66,56584,96,308127
29975,0.001296,216.58.221.0-255,2902,59486,96,308127
29976,0.001298,172.31.47.0-255,66,59552,96,308127
29977,0.001301,216.58.221.0-255,1484,61036,96,308127
29978,0.001324,216.58.221.0-255,5379,66415,96,308127
29979,0.001327,172.31.47.0-255,66,66481,96,308127
29980,0.001351,216.58.221.0-255,1484,67965,96,308127
29981,0.001368,216.58.221.0-255,1484,69449,96,308127
29982,0.001371,172.31.47.0-255,66,69515,96,308127
29983,0.001383,216.58.221.0-255,1484,70999,96,308127
29984,0.00139,216.58.221.0-255,2902,73901,96,308127
29985,0.001392,172.31.47.0-255,66,73967,96,308127
29986,0.001398,216.58.221.0-255,4320,78287,96,308127
29987,0.001399,172.31.47.0-255,66,78353,96,308127
29988,0.001405,216.58.221.0-255,5379,83732,96,308127
29989,0.001406,172.31.47.0-255,66,83798,96,308127
29990,0.001731,216.58.221.0-255,1484,85282,96,308127
29991,0.001754,216.58.221.0-255,2902,88184,96,308127
29992,0.001758,172.31.47.0-255,66,88250,96,308127
29993,0.001763,216.58.221.0-255,2902,91152,96,308127
29994,0.001764,172.31.47.0-255,66,91218,96,308127
29995,0.001788,216.58.221.0-255,2902,94120,96,308127
29996,0.00179,172.31.47.0-255,66,94186,96,308127
29997,0.001795,216.58.221.0-255,4320,98506,96,308127
29998,0.001797,172.31.47.0-255,66,98572,96,308127
29999,0.001825,216.58.221.0-255,2902,101474,96,308127
30000,0.001827,172.31.47.0-255,66,101540,96,308127
30001,0.001832,216.58.221.0-255,2902,104442,96,308127
30002,0.001833,172.31.47.0-255,66,104508,96,308127
30003,0.001877,172.31.47.0-255,66,104574,96,308127
30004,0.001881,216.58.221.0-255,2184,106758,96,308127
30005,0.001883,172.31.47.0-255,66,106824,96,308127
30006,0.003807,216.58.221.0-255,2902,109726,96,308127
30007,0.003812,172.31.47.0-255,66,109792,96,308127
30008,0.003841,216.58.221.0-255,2902,112694,96,308127
30009,0.003843,172.31.47.0-255,66,112760,96,308127
30010,0.005739,216.58.221.0-255,2902,115662,96,308127
30011,0.005744,172.31.47.0-255,66,115728,96,308127
30012,0.005777,216.58.221.0-255,2902,118630,96,308127
30013,0.00578,172.31.47.0-255,66,118696,96,308127
30014,0.007673,216.58.221.0-255,2902,121598,96,308127
30015,0.007678,172.31.47.0-255,66,121664,96,308127
30016,0.007707,216.58.221.0-255,2902,124566,96,308127
30017,0.00771,172.31.47.0-255,66,124632,96,308127
30018,0.009619,216.58.221.0-255,2902,127534,96,308127
30019,0.009625,172.31.47.0-255,66,127600,96,308127
30020,0.00965,216.58.221.0-255,2902,130502,96,308127
30021,0.009652,172.31.47.0-255,66,130568,96,308127
30022,0.011557,216.58.221.0-255,2902,133470,96,308127
30023,0.011563,172.31.47.0-255,66,133536,96,308127
30024,0.011591,216.58.221.0-255,2902,136438,96,308127
30025,0.011593,172.31.47.0-255,66,136504,96,308127
30026,0.013502,216.58.221.0-255,2902,139406,96,308127
30027,0.01351,172.31.47.0-255,66,139472,96,308127
30028,0.013536,216.58.221.0-255,2902,142374,96,308127
30029,0.013538,172.31.47.0-255,66,142440,96,308127
30030,0.015442,216.58.221.0-255,2902,145342,96,308127
30031,0.015449,172.31.47.0-255,66,145408,96,308127
30032,0.015476,216.58.221.0-255,2902,148310,96,308127
30033,0.015479,172.31.47.0-255,66,148376,96,308127
30034,0.017381,216.58.221.0-255,2902,151278,96,308127
30035,0.017387,172.31.47.0-255,66,151344,96,308127
30036,0.017421,216.58.221.0-255,2902,154246,96,308127
30037,0.017423,172.31.47.0-255,66,154312,96,308127
30038,0.01933,216.58.221.0-255,2902,157214,96,308127
30039,0.019339,172.31.47.0-255,66,157280,96,308127
30040,0.01937,216.58.221.0-255,2902,160182,96,308127
30041,0.019373,172.31.47.0-255,66,160248,96,308127
30042,0.021286,216.58.221.0-255,2902,163150,96,308127
30043,0.021294,172.31.47.0-255,66,163216,96,308127
30044,0.021326,216.58.221.0-255,2902,166118,96,308127
30045,0.021329,172.31.47.0-255,66,166184,96,308127
30046,0.023241,216.58.221.0-255,2902,169086,96,308127
30047,0.023247,172.31.47.0-255,66,169152,96,308127
30048,0.023275,216.58.221.0-255,2902,172054,96,308127
30049,0.023278,172.31.47.0-255,66,172120,96,308127
30050,0.025197,216.58.221.0-255,2902,175022,96,308127
30051,0.025205,172.31.47.0-255,66,175088,96,308127
30052,0.025237,216.58.221.0-255,2902,177990,96,308127
30053,0.02524,172.31.47.0-255,66,178056,96,308127
30054,0.027153,216.58.221.0-255,2902,180958,96,308127
30055,0.02716,172.31.47.0-255,66,181024,96,308127
30056,0.027191,216.58.221.0-255,2902,183926,96,308127
30057,0.027193,172.31.47.0-255,66,183992,96,308127
30058,0.029139,216.58.221.0-255,2902,186894,96,308127
30059,0.029145,172.31.47.0-255,66,186960,96,308127
30060,0.02917,216.58.221.0-255,2902,189862,96,308127
30061,0.029172,172.31.47.0-255,66,189928,96,308127
30062,0.031084,216.58.221.0-255,2902,192830,96,308127
30063,0.031089,172.31.47.0-255,66,192896,96,308127
30064,0.031114,216.58.221.0-255,2902,195798,96,308127
30065,0.031117,172.31.47.0-255,66,195864,96,308127
30066,0.031252,172.31.47.0-255,172,196036,96,308127
30067,0.031275,172.31.47.0-255,1105,197141,96,308127
30068,0.031339,172.31.47.0-255,1514,198655,96,308127
30069,0.031341,172.31.47.0-255,1306,199961,96,308127
30070,0.032786,104.244.42.0-255,66,200027,96,308127
30071,0.032828,104.244.42.0-255,66,200093,96,308127
30072,0.032882,104.244.42.0-255,66,200159,96,308127
30073,0.033014,216.58.221.0-255,2902,203061,96,308127
30074,0.033019,172.31.47.0-255,66,203127,96,308127
30075,0.033047,216.58.221.0-255,2902,206029,96,308127
30076,0.033049,172.31.47.0-255,66,206095,96,308127
30077,0.034949,216.58.221.0-255,2902,208997,96,308127
30078,0.034954,172.31.47.0-255,66,209063,96,308127
30079,0.034981,216.58.221.0-255,2902,211965,96,308127
30080,0.034984,172.31.47.0-255,66,212031,96,308127
30081,0.036897,216.58.221.0-255,2902,214933,96,308127
30082,0.036902,172.31.47.0-255,66,214999,96,308127
30083,0.036923,216.58.221.0-255,2902,217901,96,308127
30084,0.036926,172.31.47.0-255,66,217967,96,308127
30085,0.038853,216.58.221.0-255,4320,222287,96,308127
30086,0.03886,172.31.47.0-255,66,222353,96,308127
30087,0.038883,216.58.221.0-255,1484,223837,96,308127
30088,0.040841,216.58.221.0-255,4320,228157,96,308127
30089,0.040851,172.31.47.0-255,66,228223,96,308127
30090,0.042796,216.58.221.0-255,5738,233961,96,308127
30091,0.042806,172.31.47.0-255,66,234027,96,308127
30092,0.04477,216.58.221.0-255,5738,239765,96,308127
30093,0.044776,172.31.47.0-255,66,239831,96,308127
30094,0.046717,216.58.221.0-255,5738,245569,96,308127
30095,0.046724,172.31.47.0-255,66,245635,96,308127
30096,0.048678,216.58.221.0-255,5738,251373,96,308127
30097,0.048683,172.31.47.0-255,66,251439,96,308127
30098,0.050623,216.58.221.0-255,5738,257177,96,308127
30099,0.050628,172.31.47.0-255,66,257243,96,308127
30100,0.052583,216.58.221.0-255,5738,262981,96,308127
30101,0.052588,172.31.47.0-255,66,263047,96,308127
30102,0.054534,216.58.221.0-255,5738,268785,96,308127
30103,0.05454,172.31.47.0-255,66,268851,96,308127
30104,0.056479,216.58.221.0-255,5738,274589,96,308127
30105,0.056485,172.31.47.0-255,66,274655,96,308127
30106,0.058424,216.58.221.0-255,4320,278975,96,308127
30107,0.058429,172.31.47.0-255,66,279041,96,308127
30108,0.058455,216.58.221.0-255,1484,280525,96,308127
30109,0.060356,216.58.221.0-255,4320,284845,96,308127
30110,0.060362,172.31.47.0-255,66,284911,96,308127
30111,0.062308,216.58.221.0-255,5738,290649,96,308127
30112,0.062313,172.31.47.0-255,66,290715,96,308127
30113,0.064248,216.58.221.0-255,5738,296453,96,308127
30114,0.064253,172.31.47.0-255,66,296519,96,308127
30115,0.066197,216.58.221.0-255,5738,302257,96,308127
30116,0.066202,172.31.47.0-255,66,302323,96,308127
30117,0.068143,216.58.221.0-255,5738,308061,96,308127
30118,0.068149,172.31.47.0-255,66,308127,96,308127
30119,0.0,74.125.24.0-255,153,153,96,300436
30120,2e-05,172.31.47.0-255,66,219,96,300436
30121,2.7e-05,74.125.24.0-255,1484,1703,96,300436
30122,3.2e-05,172.31.47.0-255,66,1769,96,300436
30123,3.7e-05,74.125.24.0-255,2902,4671,96,300436
30124,4e-05,172.31.47.0-255,66,4737,96,300436
30125,4.3e-05,74.125.24.0-255,1484,6221,96,300436
30126,4.5e-05,172.31.47.0-255,66,6287,96,300436
30127,7.1e-05,74.125.24.0-255,5738,12025,96,300436
30128,7.4e-05,172.31.47.0-255,66,12091,96,300436
30129,7.7e-05,74.125.24.0-255,1985,14076,96,300436
30130,7.9e-05,172.31.47.0-255,66,14142,96,300436
30131,0.000271,74.125.24.0-255,1484,15626,96,300436
30132,0.000277,172.31.47.0-255,66,15692,96,300436
30133,0.00028,74.125.24.0-255,1484,17176,96,300436
30134,0.000282,172.31.47.0-255,66,17242,96,300436
30135,0.000296,74.125.24.0-255,1484,18726,96,300436
30136,0.000298,172.31.47.0-255,66,18792,96,300436
30137,0.000304,74.125.24.0-255,5738,24530,96,300436
30138,0.000306,172.31.47.0-255,66,24596,96,300436
30139,0.00031,74.125.24.0-255,2902,27498,96,300436
30140,0.000311,172.31.47.0-255,66,27564,96,300436
30141,0.000361,74.125.24.0-255,3961,31525,96,300436
30142,0.000365,172.31.47.0-255,66,31591,96,300436
30143,0.00062,74.125.24.0-255,1484,33075,96,300436
30144,0.000624,172.31.47.0-255,66,33141,96,300436
30145,0.000631,74.125.24.0-255,2902,36043,96,300436
30146,0.000633,172.31.47.0-255,66,36109,96,300436
30147,0.000653,74.125.24.0-255,2902,39011,96,300436
30148,0.000656,172.31.47.0-255,66,39077,96,300436
30149,0.000686,74.125.24.0-255,2902,41979,96,300436
30150,0.000688,172.31.47.0-255,66,42045,96,300436
30151,0.000693,74.125.24.0-255,4320,46365,96,300436
30152,0.000695,172.31.47.0-255,66,46431,96,300436
30153,0.000718,74.125.24.0-255,2543,48974,96,300436
30154,0.00072,172.31.47.0-255,66,49040,96,300436
30155,0.001012,74.125.24.0-255,1484,50524,96,300436
30156,0.001019,74.125.24.0-255,2902,53426,96,300436
30157,0.001022,172.31.47.0-255,66,53492,96,300436
30158,0.001029,74.125.24.0-255,5738,59230,96,300436
30159,0.00103,172.31.47.0-255,66,59296,96,300436
30160,0.001081,74.125.24.0-255,2902,62198,96,300436
30161,0.001084,172.31.47.0-255,66,62264,96,300436
30162,0.001103,74.125.24.0-255,4291,66555,96,300436
30163,0.001106,172.31.47.0-255,66,66621,96,300436
30164,0.001148,74.125.24.0-255,1484,68105,96,300436
30165,0.001166,74.125.24.0-255,2902,71007,96,300436
30166,0.001168,172.31.47.0-255,66,71073,96,300436
30167,0.001171,74.125.24.0-255,1484,72557,96,300436
30168,0.001189,74.125.24.0-255,4320,76877,96,300436
30169,0.001192,172.31.47.0-255,66,76943,96,300436
30170,0.001215,74.125.24.0-255,1484,78427,96,300436
30171,0.001226,74.125.24.0-255,1484,79911,96,300436
30172,0.001228,172.31.47.0-255,66,79977,96,300436
30173,0.001248,74.125.24.0-255,3961,83938,96,300436
30174,0.00125,172.31.47.0-255,66,84004,96,300436
30175,0.001716,74.125.24.0-255,1484,85488,96,300436
30176,0.001722,74.125.24.0-255,2902,88390,96,300436
30177,0.001726,172.31.47.0-255,66,88456,96,300436
30178,0.001746,74.125.24.0-255,5738,94194,96,300436
30179,0.001749,172.31.47.0-255,66,94260,96,300436
30180,0.001779,74.125.24.0-255,2902,97162,96,300436
30181,0.001781,172.31.47.0-255,66,97228,96,300436
30182,0.001798,74.125.24.0-255,4242,101470,96,300436
30183,0.0018,172.31.47.0-255,66,101536,96,300436
30184,0.00376,74.125.24.0-255,1484,103020,96,300436
30185,0.003828,74.125.24.0-255,1484,104504,96,300436
30186,0.003838,172.31.47.0-255,66,104570,96,300436
30187,0.003855,74.125.24.0-255,2902,107472,96,300436
30188,0.003857,172.31.47.0-255,66,107538,96,300436
30189,0.005869,74.125.24.0-255,5738,113276,96,300436
30190,0.005875,172.31.47.0-255,66,113342,96,300436
30191,0.007906,74.125.24.0-255,5738,119080,96,300436
30192,0.007913,172.31.47.0-255,66,119146,96,300436
30193,0.009927,74.125.24.0-255,5738,124884,96,300436
30194,0.009934,172.31.47.0-255,66,124950,96,300436
30195,0.011973,74.125.24.0-255,5738,130688,96,300436
30196,0.01198,172.31.47.0-255,66,130754,96,300436
30197,0.013993,74.125.24.0-255,5738,136492,96,300436
30198,0.014002,172.31.47.0-255,66,136558,96,300436
30199,0.016013,74.125.24.0-255,5738,142296,96,300436
30200,0.01602,172.31.47.0-255,66,142362,96,300436
30201,0.018042,74.125.24.0-255,5738,148100,96,300436
30202,0.018049,172.31.47.0-255,66,148166,96,300436
30203,0.020088,74.125.24.0-255,5738,153904,96,300436
30204,0.0201,172.31.47.0-255,66,153970,96,300436
30205,0.022126,74.125.24.0-255,5738,159708,96,300436
30206,0.022135,172.31.47.0-255,66,159774,96,300436
30207,0.022576,172.31.47.0-255,172,159946,96,300436
30208,0.022611,172.31.47.0-255,1109,161055,96,300436
30209,0.022668,172.31.47.0-255,1514,162569,96,300436
30210,0.022669,172.31.47.0-255,1514,164083,96,300436
30211,0.022674,172.31.47.0-255,1514,165597,96,300436
30212,0.022675,172.31.47.0-255,1083,166680,96,300436
30213,0.024125,104.244.42.0-255,66,166746,96,300436
30214,0.02416,104.244.42.0-255,66,166812,96,300436
30215,0.024238,74.125.24.0-255,5738,172550,96,300436
30216,0.024244,172.31.47.0-255,66,172616,96,300436
30217,0.024259,104.244.42.0-255,66,172682,96,300436
30218,0.024267,104.244.42.0-255,66,172748,96,300436
30219,0.026238,74.125.24.0-255,5738,178486,96,300436
30220,0.026244,172.31.47.0-255,66,178552,96,300436
30221,0.02825,74.125.24.0-255,5738,184290,96,300436
30222,0.028256,172.31.47.0-255,66,184356,96,300436
30223,0.030273,74.125.24.0-255,5738,190094,96,300436
30224,0.030278,172.31.47.0-255,66,190160,96,300436
30225,0.032302,74.125.24.0-255,5738,195898,96,300436
30226,0.032307,172.31.47.0-255,66,195964,96,300436
30227,0.034339,74.125.24.0-255,5738,201702,96,300436
30228,0.034346,172.31.47.0-255,66,201768,96,300436
30229,0.036366,74.125.24.0-255,5738,207506,96,300436
30230,0.036372,172.31.47.0-255,66,207572,96,300436
30231,0.038423,74.125.24.0-255,5738,213310,96,300436
30232,0.038429,172.31.47.0-255,66,213376,96,300436
30233,0.040445,74.125.24.0-255,5738,219114,96,300436
30234,0.040451,172.31.47.0-255,66,219180,96,300436
30235,0.042443,74.125.24.0-255,5738,224918,96,300436
30236,0.042449,172.31.47.0-255,66,224984,96,300436
30237,0.044505,74.125.24.0-255,5738,230722,96,300436
30238,0.044514,172.31.47.0-255,66,230788,96,300436
30239,0.046535,74.125.24.0-255,5738,236526,96,300436
30240,0.046543,172.31.47.0-255,66,236592,96,300436
30241,0.048588,74.125.24.0-255,5738,242330,96,300436
30242,0.048595,172.31.47.0-255,66,242396,96,300436
30243,0.05061,74.125.24.0-255,5738,248134,96,300436
30244,0.050616,172.31.47.0-255,66,248200,96,300436
30245,0.052656,74.125.24.0-255,5738,253938,96,300436
30246,0.052662,172.31.47.0-255,66,254004,96,300436
30247,0.054735,74.125.24.0-255,5738,259742,96,300436
30248,0.054742,172.31.47.0-255,66,259808,96,300436
30249,0.05675,74.125.24.0-255,5738,265546,96,300436
30250,0.056755,172.31.47.0-255,66,265612,96,300436
30251,0.05877,74.125.24.0-255,5738,271350,96,300436
30252,0.058776,172.31.47.0-255,66,271416,96,300436
30253,0.060799,74.125.24.0-255,5738,277154,96,300436
30254,0.060806,172.31.47.0-255,66,277220,96,300436
30255,0.06282,74.125.24.0-255,5738,282958,96,300436
30256,0.062825,172.31.47.0-255,66,283024,96,300436
30257,0.064816,74.125.24.0-255,5738,288762,96,300436
30258,0.064823,172.31.47.0-255,66,288828,96,300436
30259,0.066836,74.125.24.0-255,5738,294566,96,300436
30260,0.066841,172.31.47.0-255,66,294632,96,300436
30261,0.068881,74.125.24.0-255,5738,300370,96,300436
30262,0.068887,172.31.47.0-255,66,300436,96,300436
30263,0.0,74.125.24.0-255,152,152,96,266999
30264,2.5e-05,172.31.47.0-255,66,218,96,266999
30265,4.9e-05,74.125.24.0-255,1484,1702,96,266999
30266,5.4e-05,172.31.47.0-255,66,1768,96,266999
30267,6e-05,74.125.24.0-255,2902,4670,96,266999
30268,6.3e-05,172.31.47.0-255,66,4736,96,266999
30269,6.6e-05,74.125.24.0-255,1484,6220,96,266999
30270,6.8e-05,172.31.47.0-255,66,6286,96,266999
30271,0.000102,74.125.24.0-255,2902,9188,96,266999
30272,0.000105,172.31.47.0-255,66,9254,96,266999
30273,0.000136,74.125.24.0-255,4924,14178,96,266999
30274,0.00014,172.31.47.0-255,66,14244,96,266999
30275,0.000176,74.125.24.0-255,1484,15728,96,266999
30276,0.000179,172.31.47.0-255,66,15794,96,266999
30277,0.000196,74.125.24.0-255,2902,18696,96,266999
30278,0.000198,172.31.47.0-255,66,18762,96,266999
30279,0.00023,74.125.24.0-255,1484,20246,96,266999
30280,0.000233,172.31.47.0-255,66,20312,96,266999
30281,0.000264,74.125.24.0-255,2902,23214,96,266999
30282,0.000268,172.31.47.0-255,66,23280,96,266999
30283,0.000274,74.125.24.0-255,5738,29018,96,266999
30284,0.000276,172.31.47.0-255,66,29084,96,266999
30285,0.000281,74.125.24.0-255,2543,31627,96,266999
30286,0.000283,172.31.47.0-255,66,31693,96,266999
30287,0.000425,74.125.24.0-255,1484,33177,96,266999
30288,0.00043,172.31.47.0-255,66,33243,96,266999
30289,0.000435,74.125.24.0-255,2902,36145,96,266999
30290,0.000438,172.31.47.0-255,66,36211,96,266999
30291,0.000469,74.125.24.0-255,5738,41949,96,266999
30292,0.000474,172.31.47.0-255,66,42015,96,266999
30293,0.000478,74.125.24.0-255,2902,44917,96,266999
30294,0.000481,172.31.47.0-255,66,44983,96,266999
30295,0.000518,172.31.47.0-255,66,45049,96,266999
30296,0.000548,74.125.24.0-255,2543,47592,96,266999
30297,0.000551,172.31.47.0-255,66,47658,96,266999
30298,0.000565,172.31.47.0-255,66,47724,96,266999
30299,0.000916,74.125.24.0-255,377,48101,96,266999
30300,0.00093,172.31.47.0-255,66,48167,96,266999
30301,0.001094,74.125.24.0-255,1484,49651,96,266999
30302,0.001099,172.31.47.0-255,66,49717,96,266999
30303,0.001105,74.125.24.0-255,2902,52619,96,266999
30304,0.001107,172.31.47.0-255,66,52685,96,266999
30305,0.001141,74.125.24.0-255,5738,58423,96,266999
30306,0.001144,172.31.47.0-255,66,58489,96,266999
30307,0.001148,74.125.24.0-255,4320,62809,96,266999
30308,0.001151,172.31.47.0-255,66,62875,96,266999
30309,0.001155,74.125.24.0-255,2902,65777,96,266999
30310,0.001157,172.31.47.0-255,66,65843,96,266999
30311,0.001206,172.31.47.0-255,66,65909,96,266999
30312,0.001213,74.125.24.0-255,6797,72706,96,266999
30313,0.001216,172.31.47.0-255,66,72772,96,266999
30314,0.001732,74.125.24.0-255,1484,74256,96,266999
30315,0.001736,172.31.47.0-255,66,74322,96,266999
30316,0.001741,74.125.24.0-255,1484,75806,96,266999
30317,0.001742,172.31.47.0-255,66,75872,96,266999
30318,0.001772,74.125.24.0-255,1484,77356,96,266999
30319,0.001774,172.31.47.0-255,66,77422,96,266999
30320,0.00178,74.125.24.0-255,5738,83160,96,266999
30321,0.001782,172.31.47.0-255,66,83226,96,266999
30322,0.001785,74.125.24.0-255,1484,84710,96,266999
30323,0.001787,172.31.47.0-255,66,84776,96,266999
30324,0.001826,172.31.47.0-255,66,84842,96,266999
30325,0.001829,74.125.24.0-255,1484,86326,96,266999
30326,0.00183,172.31.47.0-255,66,86392,96,266999
30327,0.001866,172.31.47.0-255,66,86458,96,266999
30328,0.002117,74.125.24.0-255,1484,87942,96,266999
30329,0.002142,74.125.24.0-255,1484,89426,96,266999
30330,0.002158,74.125.24.0-255,2902,92328,96,266999
30331,0.00217,74.125.24.0-255,4320,96648,96,266999
30332,0.00218,74.125.24.0-255,1484,98132,96,266999
30333,0.002197,74.125.24.0-255,2902,101034,96,266999
30334,0.002219,74.125.24.0-255,1484,102518,96,266999
30335,0.002258,74.125.24.0-255,4320,106838,96,266999
30336,0.00228,74.125.24.0-255,5020,111858,96,266999
30337,0.002351,74.125.24.0-255,766,112624,96,266999
30338,0.00417,172.31.47.0-255,66,112690,96,266999
30339,0.006568,74.125.24.0-255,4320,117010,96,266999
30340,0.006573,172.31.47.0-255,66,117076,96,266999
30341,0.006603,74.125.24.0-255,1484,118560,96,266999
30342,0.006605,172.31.47.0-255,66,118626,96,266999
30343,0.008946,74.125.24.0-255,4320,122946,96,266999
30344,0.008951,172.31.47.0-255,66,123012,96,266999
30345,0.008983,74.125.24.0-255,1484,124496,96,266999
30346,0.008985,172.31.47.0-255,66,124562,96,266999
30347,0.011347,74.125.24.0-255,4320,128882,96,266999
30348,0.011355,172.31.47.0-255,66,128948,96,266999
30349,0.011386,74.125.24.0-255,1484,130432,96,266999
30350,0.011389,172.31.47.0-255,66,130498,96,266999
30351,0.013741,74.125.24.0-255,4320,134818,96,266999
30352,0.013778,74.125.24.0-255,1484,136302,96,266999
30353,0.015522,172.31.47.0-255,66,136368,96,266999
30354,0.017935,74.125.24.0-255,4320,140688,96,266999
30355,0.017942,172.31.47.0-255,66,140754,96,266999
30356,0.017972,74.125.24.0-255,1484,142238,96,266999
30357,0.02036,74.125.24.0-255,4320,146558,96,266999
30358,0.020367,172.31.47.0-255,66,146624,96,266999
30359,0.022738,74.125.24.0-255,5738,152362,96,266999
30360,0.022791,172.31.47.0-255,66,152428,96,266999
30361,0.025218,74.125.24.0-255,5738,158166,96,266999
30362,0.025227,172.31.47.0-255,66,158232,96,266999
30363,0.027638,74.125.24.0-255,5738,163970,96,266999
30364,0.027647,172.31.47.0-255,66,164036,96,266999
30365,0.030041,74.125.24.0-255,5738,169774,96,266999
30366,0.030049,172.31.47.0-255,66,169840,96,266999
30367,0.032459,74.125.24.0-255,5738,175578,96,266999
30368,0.032467,172.31.47.0-255,66,175644,96,266999
30369,0.032951,172.31.47.0-255,172,175816,96,266999
30370,0.032974,172.31.47.0-255,1110,176926,96,266999
30371,0.033027,172.31.47.0-255,1514,178440,96,266999
30372,0.033047,172.31.47.0-255,1301,179741,96,266999
30373,0.034487,104.244.42.0-255,66,179807,96,266999
30374,0.034529,104.244.42.0-255,66,179873,96,266999
30375,0.034572,104.244.42.0-255,66,179939,96,266999
30376,0.034891,74.125.24.0-255,5738,185677,96,266999
30377,0.034897,172.31.47.0-255,66,185743,96,266999
30378,0.037291,74.125.24.0-255,5738,191481,96,266999
30379,0.037297,172.31.47.0-255,66,191547,96,266999
30380,0.039714,74.125.24.0-255,5738,197285,96,266999
30381,0.039722,172.31.47.0-255,66,197351,96,266999
30382,0.04211,74.125.24.0-255,5738,203089,96,266999
30383,0.042117,172.31.47.0-255,66,203155,96,266999
30384,0.044521,74.125.24.0-255,5738,208893,96,266999
30385,0.044528,172.31.47.0-255,66,208959,96,266999
30386,0.046947,74.125.24.0-255,5738,214697,96,266999
30387,0.046954,172.31.47.0-255,66,214763,96,266999
30388,0.049345,74.125.24.0-255,5738,220501,96,266999
30389,0.049352,172.31.47.0-255,66,220567,96,266999
30390,0.05175,74.125.24.0-255,5738,226305,96,266999
30391,0.051757,172.31.47.0-255,66,226371,96,266999
30392,0.054167,74.125.24.0-255,5738,232109,96,266999
30393,0.054174,172.31.47.0-255,66,232175,96,266999
30394,0.056622,74.125.24.0-255,5738,237913,96,266999
30395,0.056628,172.31.47.0-255,66,237979,96,266999
30396,0.059039,74.125.24.0-255,5738,243717,96,266999
30397,0.059046,172.31.47.0-255,66,243783,96,266999
30398,0.061433,74.125.24.0-255,5738,249521,96,266999
30399,0.061443,172.31.47.0-255,66,249587,96,266999
30400,0.063826,74.125.24.0-255,5738,255325,96,266999
30401,0.063832,172.31.47.0-255,66,255391,96,266999
30402,0.066249,74.125.24.0-255,5738,261129,96,266999
30403,0.066255,172.31.47.0-255,66,261195,96,266999
30404,0.068631,74.125.24.0-255,5738,266933,96,266999
30405,0.068638,172.31.47.0-255,66,266999,96,266999
30406,0.0,172.217.194.0-255,146,146,96,288430
30407,3.4e-05,172.31.47.0-255,66,212,96,288430
30408,4.1e-05,172.217.194.0-255,1484,1696,96,288430
30409,4.5e-05,172.31.47.0-255,66,1762,96,288430
30410,5.1e-05,172.217.194.0-255,2902,4664,96,288430
30411,5.4e-05,172.31.47.0-255,66,4730,96,288430
30412,6.2e-05,172.217.194.0-255,7156,11886,96,288430
30413,6.5e-05,172.31.47.0-255,66,11952,96,288430
30414,6.8e-05,172.217.194.0-255,2037,13989,96,288430
30415,7.1e-05,172.31.47.0-255,66,14055,96,288430
30416,0.000213,172.217.194.0-255,1484,15539,96,288430
30417,0.000218,172.31.47.0-255,66,15605,96,288430
30418,0.000223,172.217.194.0-255,2902,18507,96,288430
30419,0.000226,172.31.47.0-255,66,18573,96,288430
30420,0.00023,172.217.194.0-255,2902,21475,96,288430
30421,0.000233,172.31.47.0-255,66,21541,96,288430
30422,0.000253,172.217.194.0-255,2902,24443,96,288430
30423,0.000256,172.31.47.0-255,66,24509,96,288430
30424,0.00029,172.217.194.0-255,4320,28829,96,288430
30425,0.000294,172.31.47.0-255,66,28895,96,288430
30426,0.00031,172.217.194.0-255,2543,31438,96,288430
30427,0.000313,172.31.47.0-255,66,31504,96,288430
30428,0.000364,172.217.194.0-255,1484,32988,96,288430
30429,0.000367,172.31.47.0-255,66,33054,96,288430
30430,0.000371,172.217.194.0-255,2902,35956,96,288430
30431,0.000375,172.31.47.0-255,66,36022,96,288430
30432,0.000381,172.217.194.0-255,5738,41760,96,288430
30433,0.000383,172.31.47.0-255,66,41826,96,288430
30434,0.000417,172.217.194.0-255,7156,48982,96,288430
30435,0.000421,172.31.47.0-255,66,49048,96,288430
30436,0.000447,172.217.194.0-255,6797,55845,96,288430
30437,0.00045,172.31.47.0-255,66,55911,96,288430
30438,0.000461,172.31.47.0-255,66,55977,96,288430
30439,0.000464,172.217.194.0-255,1428,57405,96,288430
30440,0.000529,172.217.194.0-255,377,57782,96,288430
30441,0.000532,172.31.47.0-255,66,57848,96,288430
30442,0.000926,172.217.194.0-255,1484,59332,96,288430
30443,0.000936,172.217.194.0-255,2902,62234,96,288430
30444,0.00094,172.31.47.0-255,66,62300,96,288430
30445,0.000945,172.217.194.0-255,2902,65202,96,288430
30446,0.000947,172.31.47.0-255,66,65268,96,288430
30447,0.000967,172.217.194.0-255,2902,68170,96,288430
30448,0.00097,172.31.47.0-255,66,68236,96,288430
30449,0.000983,172.31.47.0-255,66,68302,96,288430
30450,0.001024,172.31.47.0-255,66,68368,96,288430
30451,0.001257,172.217.194.0-255,1484,69852,96,288430
30452,0.001264,172.217.194.0-255,2902,72754,96,288430
30453,0.001268,172.31.47.0-255,66,72820,96,288430
30454,0.001274,172.217.194.0-255,5738,78558,96,288430
30455,0.001276,172.31.47.0-255,66,78624,96,288430
30456,0.001293,172.217.194.0-255,2902,81526,96,288430
30457,0.001296,172.31.47.0-255,66,81592,96,288430
30458,0.001301,172.217.194.0-255,4320,85912,96,288430
30459,0.001302,172.31.47.0-255,66,85978,96,288430
30460,0.001332,172.31.47.0-255,66,86044,96,288430
30461,0.001336,172.217.194.0-255,1484,87528,96,288430
30462,0.001356,172.217.194.0-255,6438,93966,96,288430
30463,0.00136,172.31.47.0-255,66,94032,96,288430
30464,0.001407,172.217.194.0-255,1484,95516,96,288430
30465,0.001413,172.217.194.0-255,2902,98418,96,288430
30466,0.001416,172.31.47.0-255,66,98484,96,288430
30467,0.001439,172.217.194.0-255,5738,104222,96,288430
30468,0.001442,172.31.47.0-255,66,104288,96,288430
30469,0.00145,172.217.194.0-255,7156,111444,96,288430
30470,0.001453,172.31.47.0-255,66,111510,96,288430
30471,0.001479,172.217.194.0-255,2902,114412,96,288430
30472,0.001482,172.31.47.0-255,66,114478,96,288430
30473,0.001517,172.31.47.0-255,66,114544,96,288430
30474,0.001521,172.217.194.0-255,2184,116728,96,288430
30475,0.001523,172.31.47.0-255,66,116794,96,288430
30476,0.001562,172.217.194.0-255,1484,118278,96,288430
30477,0.001596,172.217.194.0-255,2902,121180,96,288430
30478,0.001603,172.217.194.0-255,5738,126918,96,288430
30479,0.001608,172.217.194.0-255,5738,132656,96,288430
30480,0.001614,172.31.47.0-255,66,132722,96,288430
30481,0.001624,172.31.47.0-255,66,132788,96,288430
30482,0.001627,172.31.47.0-255,66,132854,96,288430
30483,0.001642,172.31.47.0-255,66,132920,96,288430
30484,0.001647,172.217.194.0-255,2902,135822,96,288430
30485,0.00165,172.31.47.0-255,66,135888,96,288430
30486,0.001669,172.217.194.0-255,2184,138072,96,288430
30487,0.001672,172.31.47.0-255,66,138138,96,288430
30488,0.001728,172.217.194.0-255,1484,139622,96,288430
30489,0.001732,172.217.194.0-255,1484,141106,96,288430
30490,0.001735,172.31.47.0-255,66,141172,96,288430
30491,0.001751,172.217.194.0-255,1484,142656,96,288430
30492,0.001756,172.217.194.0-255,4320,146976,96,288430
30493,0.00176,172.31.47.0-255,66,147042,96,288430
30494,0.00177,172.31.47.0-255,66,147108,96,288430
30495,0.001847,172.31.47.0-255,66,147174,96,288430
30496,0.001851,172.217.194.0-255,766,147940,96,288430
30497,0.001866,172.217.194.0-255,1484,149424,96,288430
30498,0.001868,172.31.47.0-255,66,149490,96,288430
30499,0.001874,172.217.194.0-255,4320,153810,96,288430
30500,0.001876,172.31.47.0-255,66,153876,96,288430
30501,0.001913,172.31.47.0-255,66,153942,96,288430
30502,0.001923,172.217.194.0-255,2902,156844,96,288430
30503,0.001925,172.31.47.0-255,66,156910,96,288430
30504,0.001951,172.217.194.0-255,7156,164066,96,288430
30505,0.001955,172.31.47.0-255,66,164132,96,288430
30506,0.001967,172.31.47.0-255,66,164198,96,288430
30507,0.001995,172.217.194.0-255,2184,166382,96,288430
30508,0.002008,172.217.194.0-255,1484,167866,96,288430
30509,0.002012,172.31.47.0-255,66,167932,96,288430
30510,0.002016,172.31.47.0-255,66,167998,96,288430
30511,0.002046,172.31.47.0-255,66,168064,96,288430
30512,0.004022,172.217.194.0-255,5738,173802,96,288430
30513,0.004028,172.31.47.0-255,66,173868,96,288430
30514,0.006025,172.217.194.0-255,4320,178188,96,288430
30515,0.006029,172.31.47.0-255,66,178254,96,288430
30516,0.006041,172.217.194.0-255,1484,179738,96,288430
30517,0.008023,172.217.194.0-255,4320,184058,96,288430
30518,0.008027,172.31.47.0-255,66,184124,96,288430
30519,0.010001,172.217.194.0-255,5738,189862,96,288430
30520,0.010009,172.31.47.0-255,66,189928,96,288430
30521,0.01199,172.217.194.0-255,5738,195666,96,288430
30522,0.011997,172.31.47.0-255,66,195732,96,288430
30523,0.013989,172.217.194.0-255,5738,201470,96,288430
30524,0.013995,172.31.47.0-255,66,201536,96,288430
30525,0.015977,172.217.194.0-255,5738,207274,96,288430
30526,0.015985,172.31.47.0-255,66,207340,96,288430
30527,0.017985,172.217.194.0-255,5738,213078,96,288430
30528,0.017993,172.31.47.0-255,66,213144,96,288430
30529,0.019967,172.217.194.0-255,5738,218882,96,288430
30530,0.019975,172.31.47.0-255,66,218948,96,288430
30531,0.021972,172.217.194.0-255,5738,224686,96,288430
30532,0.021979,172.31.47.0-255,66,224752,96,288430
30533,0.023971,172.217.194.0-255,5738,230490,96,288430
30534,0.023979,172.31.47.0-255,66,230556,96,288430
30535,0.025706,172.31.47.0-255,172,230728,96,288430
30536,0.025732,172.31.47.0-255,1110,231838,96,288430
30537,0.025783,172.31.47.0-255,1514,233352,96,288430
30538,0.025785,172.31.47.0-255,1303,234655,96,288430
30539,0.025981,172.217.194.0-255,5738,240393,96,288430
30540,0.025986,172.31.47.0-255,66,240459,96,288430
30541,0.027245,104.244.42.0-255,66,240525,96,288430
30542,0.027297,104.244.42.0-255,66,240591,96,288430
30543,0.027342,104.244.42.0-255,66,240657,96,288430
30544,0.027986,172.217.194.0-255,5738,246395,96,288430
30545,0.027992,172.31.47.0-255,66,246461,96,288430
30546,0.029991,172.217.194.0-255,5738,252199,96,288430
30547,0.029998,172.31.47.0-255,66,252265,96,288430
30548,0.03198,172.217.194.0-255,5738,258003,96,288430
30549,0.03199,172.31.47.0-255,66,258069,96,288430
30550,0.033978,172.217.194.0-255,5738,263807,96,288430
30551,0.033984,172.31.47.0-255,66,263873,96,288430
30552,0.035973,172.217.194.0-255,5738,269611,96,288430
30553,0.035978,172.31.47.0-255,66,269677,96,288430
30554,0.037993,172.217.194.0-255,5738,275415,96,288430
30555,0.037998,172.31.47.0-255,66,275481,96,288430
30556,0.039994,172.217.194.0-255,5738,281219,96,288430
30557,0.039999,172.31.47.0-255,66,281285,96,288430
30558,0.041999,172.217.194.0-255,5738,287023,96,288430
30559,0.042004,172.31.47.0-255,66,287089,96,288430
30560,0.043974,172.217.194.0-255,1104,288193,96,288430
30561,0.044111,172.31.47.0-255,66,288259,96,288430
30562,0.044134,172.31.47.0-255,105,288364,96,288430
30563,0.046103,172.217.194.0-255,66,288430,96,288430
30564,0.0,172.31.47.0-255,105,105,96,459
30565,0.000273,172.31.47.0-255,90,195,96,459
30566,0.000281,172.31.47.0-255,66,261,96,459
30567,0.002356,74.125.24.0-255,66,327,96,459
30568,0.002368,74.125.24.0-255,66,393,96,459
30569,0.002377,172.31.47.0-255,66,459,96,459
30570,0.0,74.125.24.0-255,298,298,96,301166
30571,3.3e-05,172.31.47.0-255,66,364,96,301166
30572,3.9e-05,74.125.24.0-255,1484,1848,96,301166
30573,4.4e-05,172.31.47.0-255,66,1914,96,301166
30574,5.6e-05,74.125.24.0-255,4320,6234,96,301166
30575,5.9e-05,172.31.47.0-255,66,6300,96,301166
30576,7.1e-05,172.31.47.0-255,66,6366,96,301166
30577,0.000111,172.31.47.0-255,66,6432,96,301166
30578,0.000143,74.125.24.0-255,3961,10393,96,301166
30579,0.000146,172.31.47.0-255,66,10459,96,301166
30580,0.000152,74.125.24.0-255,4320,14779,96,301166
30581,0.000154,172.31.47.0-255,66,14845,96,301166
30582,0.000161,74.125.24.0-255,7156,22001,96,301166
30583,0.000164,172.31.47.0-255,66,22067,96,301166
30584,0.000186,74.125.24.0-255,2902,24969,96,301166
30585,0.000189,172.31.47.0-255,66,25035,96,301166
30586,0.000194,74.125.24.0-255,2543,27578,96,301166
30587,0.000196,172.31.47.0-255,66,27644,96,301166
30588,0.000667,74.125.24.0-255,1484,29128,96,301166
30589,0.000673,172.31.47.0-255,66,29194,96,301166
30590,0.000698,74.125.24.0-255,1484,30678,96,301166
30591,0.000703,172.31.47.0-255,66,30744,96,301166
30592,0.000731,74.125.24.0-255,2902,33646,96,301166
30593,0.000734,172.31.47.0-255,66,33712,96,301166
30594,0.000741,74.125.24.0-255,5738,39450,96,301166
30595,0.000744,172.31.47.0-255,66,39516,96,301166
30596,0.000751,74.125.24.0-255,5379,44895,96,301166
30597,0.000754,172.31.47.0-255,66,44961,96,301166
30598,0.000793,74.125.24.0-255,1484,46445,96,301166
30599,0.000796,172.31.47.0-255,66,46511,96,301166
30600,0.000801,74.125.24.0-255,2902,49413,96,301166
30601,0.000807,74.125.24.0-255,4320,53733,96,301166
30602,0.000811,172.31.47.0-255,66,53799,96,301166
30603,0.00083,74.125.24.0-255,1484,55283,96,301166
30604,0.000851,74.125.24.0-255,4320,59603,96,301166
30605,0.000856,172.31.47.0-255,66,59669,96,301166
30606,0.000867,74.125.24.0-255,3123,62792,96,301166
30607,0.000878,172.31.47.0-255,66,62858,96,301166
30608,0.001111,74.125.24.0-255,1484,64342,96,301166
30609,0.00112,74.125.24.0-255,2902,67244,96,301166
30610,0.001125,172.31.47.0-255,66,67310,96,301166
30611,0.001132,74.125.24.0-255,5738,73048,96,301166
30612,0.001157,74.125.24.0-255,5738,78786,96,301166
30613,0.001164,74.125.24.0-255,5738,84524,96,301166
30614,0.001183,74.125.24.0-255,7156,91680,96,301166
30615,0.001187,74.125.24.0-255,2902,94582,96,301166
30616,0.001202,74.125.24.0-255,1621,96203,96,301166
30617,0.001327,74.125.24.0-255,1484,97687,96,301166
30618,0.001332,74.125.24.0-255,1484,99171,96,301166
30619,0.001346,74.125.24.0-255,1484,100655,96,301166
30620,0.001368,74.125.24.0-255,5738,106393,96,301166
30621,0.001372,74.125.24.0-255,2902,109295,96,301166
30622,0.001388,74.125.24.0-255,4320,113615,96,301166
30623,0.001401,74.125.24.0-255,4320,117935,96,301166
30624,0.001428,74.125.24.0-255,2184,120119,96,301166
30625,0.002006,74.125.24.0-255,1484,121603,96,301166
30626,0.00201,74.125.24.0-255,1484,123087,96,301166
30627,0.002028,74.125.24.0-255,1484,124571,96,301166
30628,0.002033,74.125.24.0-255,5738,130309,96,301166
30629,0.002051,74.125.24.0-255,1484,131793,96,301166
30630,0.002297,74.125.24.0-255,1484,133277,96,301166
30631,0.002311,74.125.24.0-255,2902,136179,96,301166
30632,0.002314,74.125.24.0-255,1484,137663,96,301166
30633,0.005787,172.31.47.0-255,66,137729,96,301166
30634,0.008107,74.125.24.0-255,5738,143467,96,301166
30635,0.008113,172.31.47.0-255,66,143533,96,301166
30636,0.010404,74.125.24.0-255,5738,149271,96,301166
30637,0.010412,172.31.47.0-255,66,149337,96,301166
30638,0.012577,172.31.47.0-255,101,149438,96,301166
30639,0.012672,74.125.24.0-255,2902,152340,96,301166
30640,0.012689,74.125.24.0-255,2902,155242,96,301166
30641,0.014409,172.31.47.0-255,66,155308,96,301166
30642,0.014841,74.125.24.0-255,66,155374,96,301166
30643,0.016695,74.125.24.0-255,2902,158276,96,301166
30644,0.016701,172.31.47.0-255,66,158342,96,301166
30645,0.016735,74.125.24.0-255,2902,161244,96,301166
30646,0.016749,172.31.47.0-255,66,161310,96,301166
30647,0.018975,74.125.24.0-255,2902,164212,96,301166
30648,0.018981,172.31.47.0-255,66,164278,96,301166
30649,0.019007,74.125.24.0-255,2902,167180,96,301166
30650,0.019233,172.31.47.0-255,66,167246,96,301166
30651,0.021276,74.125.24.0-255,2902,170148,96,301166
30652,0.021283,172.31.47.0-255,66,170214,96,301166
30653,0.021517,74.125.24.0-255,2902,173116,96,301166
30654,0.021523,172.31.47.0-255,66,173182,96,301166
30655,0.022789,172.31.47.0-255,172,173354,96,301166
30656,0.022815,172.31.47.0-255,1109,174463,96,301166
30657,0.022848,172.31.47.0-255,1514,175977,96,301166
30658,0.02285,172.31.47.0-255,335,176312,96,301166
30659,0.023564,74.125.24.0-255,2902,179214,96,301166
30660,0.023569,172.31.47.0-255,66,179280,96,301166
30661,0.023794,74.125.24.0-255,2902,182182,96,301166
30662,0.023799,172.31.47.0-255,66,182248,96,301166
30663,0.024353,104.244.42.0-255,66,182314,96,301166
30664,0.024359,104.244.42.0-255,66,182380,96,301166
30665,0.024403,104.244.42.0-255,66,182446,96,301166
30666,0.025851,74.125.24.0-255,2902,185348,96,301166
30667,0.025855,172.31.47.0-255,66,185414,96,301166
30668,0.026077,74.125.24.0-255,2902,188316,96,301166
30669,0.026082,172.31.47.0-255,66,188382,96,301166
30670,0.028121,74.125.24.0-255,2902,191284,96,301166
30671,0.028125,172.31.47.0-255,66,191350,96,301166
30672,0.028382,74.125.24.0-255,2902,194252,96,301166
30673,0.028387,172.31.47.0-255,66,194318,96,301166
30674,0.030387,74.125.24.0-255,2902,197220,96,301166
30675,0.030393,172.31.47.0-255,66,197286,96,301166
30676,0.030683,74.125.24.0-255,2902,200188,96,301166
30677,0.030688,172.31.47.0-255,66,200254,96,301166
30678,0.032647,74.125.24.0-255,2902,203156,96,301166
30679,0.032652,172.31.47.0-255,66,203222,96,301166
30680,0.032974,74.125.24.0-255,2902,206124,96,301166
30681,0.032978,172.31.47.0-255,66,206190,96,301166
30682,0.034916,74.125.24.0-255,2902,209092,96,301166
30683,0.034922,172.31.47.0-255,66,209158,96,301166
30684,0.035258,74.125.24.0-255,2902,212060,96,301166
30685,0.035263,172.31.47.0-255,66,212126,96,301166
30686,0.037183,74.125.24.0-255,2902,215028,96,301166
30687,0.037189,172.31.47.0-255,66,215094,96,301166
30688,0.037531,74.125.24.0-255,2902,217996,96,301166
30689,0.037536,172.31.47.0-255,66,218062,96,301166
30690,0.039475,74.125.24.0-255,2902,220964,96,301166
30691,0.03948,172.31.47.0-255,66,221030,96,301166
30692,0.039817,74.125.24.0-255,2902,223932,96,301166
30693,0.039822,172.31.47.0-255,66,223998,96,301166
30694,0.041736,74.125.24.0-255,2902,226900,96,301166
30695,0.041741,172.31.47.0-255,66,226966,96,301166
30696,0.042104,74.125.24.0-255,2902,229868,96,301166
30697,0.042109,172.31.47.0-255,66,229934,96,301166
30698,0.044018,74.125.24.0-255,2902,232836,96,301166
30699,0.044023,172.31.47.0-255,66,232902,96,301166
30700,0.04439,74.125.24.0-255,2902,235804,96,301166
30701,0.044396,172.31.47.0-255,66,235870,96,301166
30702,0.046307,74.125.24.0-255,2902,238772,96,301166
30703,0.046313,172.31.47.0-255,66,238838,96,301166
30704,0.046677,74.125.24.0-255,2902,241740,96,301166
30705,0.046682,172.31.47.0-255,66,241806,96,301166
30706,0.048607,74.125.24.0-255,2902,244708,96,301166
30707,0.048612,172.31.47.0-255,66,244774,96,301166
30708,0.048955,74.125.24.0-255,2902,247676,96,301166
30709,0.04896,172.31.47.0-255,66,247742,96,301166
30710,0.050873,74.125.24.0-255,2902,250644,96,301166
30711,0.050878,172.31.47.0-255,66,250710,96,301166
30712,0.051229,74.125.24.0-255,2902,253612,96,301166
30713,0.051234,172.31.47.0-255,66,253678,96,301166
30714,0.053131,74.125.24.0-255,2902,256580,96,301166
30715,0.053136,172.31.47.0-255,66,256646,96,301166
30716,0.053534,74.125.24.0-255,2902,259548,96,301166
30717,0.053539,172.31.47.0-255,66,259614,96,301166
30718,0.055435,74.125.24.0-255,2902,262516,96,301166
30719,0.05544,172.31.47.0-255,66,262582,96,301166
30720,0.055803,74.125.24.0-255,2902,265484,96,301166
30721,0.055807,172.31.47.0-255,66,265550,96,301166
30722,0.057694,74.125.24.0-255,2902,268452,96,301166
30723,0.057711,172.31.47.0-255,66,268518,96,301166
30724,0.058068,74.125.24.0-255,2902,271420,96,301166
30725,0.058073,172.31.47.0-255,66,271486,96,301166
30726,0.059974,74.125.24.0-255,2902,274388,96,301166
30727,0.059979,172.31.47.0-255,66,274454,96,301166
30728,0.060381,74.125.24.0-255,2902,277356,96,301166
30729,0.060388,172.31.47.0-255,66,277422,96,301166
30730,0.06228,74.125.24.0-255,2902,280324,96,301166
30731,0.062285,172.31.47.0-255,66,280390,96,301166
30732,0.062655,74.125.24.0-255,2902,283292,96,301166
30733,0.062659,172.31.47.0-255,66,283358,96,301166
30734,0.064554,74.125.24.0-255,2902,286260,96,301166
30735,0.064558,172.31.47.0-255,66,286326,96,301166
30736,0.064909,74.125.24.0-255,2902,289228,96,301166
30737,0.064913,172.31.47.0-255,66,289294,96,301166
30738,0.066857,74.125.24.0-255,2902,292196,96,301166
30739,0.066863,172.31.47.0-255,66,292262,96,301166
30740,0.067184,74.125.24.0-255,2902,295164,96,301166
30741,0.06719,172.31.47.0-255,66,295230,96,301166
30742,0.069129,74.125.24.0-255,2902,298132,96,301166
30743,0.069134,172.31.47.0-255,66,298198,96,301166
30744,0.06945,74.125.24.0-255,2902,301100,96,301166
30745,0.069468,172.31.47.0-255,66,301166,96,301166
30746,0.0,74.125.24.0-255,145,145,96,269892
30747,1.5e-05,172.31.47.0-255,66,211,96,269892
30748,2.2e-05,74.125.24.0-255,1484,1695,96,269892
30749,2.6e-05,172.31.47.0-255,66,1761,96,269892
30750,3.2e-05,74.125.24.0-255,2902,4663,96,269892
30751,3.5e-05,172.31.47.0-255,66,4729,96,269892
30752,3.9e-05,74.125.24.0-255,1484,6213,96,269892
30753,4.7e-05,172.31.47.0-255,66,6279,96,269892
30754,5.5e-05,74.125.24.0-255,5738,12017,96,269892
30755,5.7e-05,172.31.47.0-255,66,12083,96,269892
30756,7.3e-05,74.125.24.0-255,2161,14244,96,269892
30757,8.1e-05,172.31.47.0-255,66,14310,96,269892
30758,0.000302,74.125.24.0-255,1484,15794,96,269892
30759,0.000308,172.31.47.0-255,66,15860,96,269892
30760,0.000314,74.125.24.0-255,2902,18762,96,269892
30761,0.000316,172.31.47.0-255,66,18828,96,269892
30762,0.000351,74.125.24.0-255,5738,24566,96,269892
30763,0.000354,172.31.47.0-255,66,24632,96,269892
30764,0.000362,74.125.24.0-255,6797,31429,96,269892
30765,0.000364,172.31.47.0-255,66,31495,96,269892
30766,0.000391,74.125.24.0-255,5738,37233,96,269892
30767,0.000393,172.31.47.0-255,66,37299,96,269892
30768,0.000431,172.31.47.0-255,66,37365,96,269892
30769,0.000436,74.125.24.0-255,2543,39908,96,269892
30770,0.000438,172.31.47.0-255,66,39974,96,269892
30771,0.000476,172.31.47.0-255,66,40040,96,269892
30772,0.000516,74.125.24.0-255,5738,45778,96,269892
30773,0.000521,172.31.47.0-255,66,45844,96,269892
30774,0.000526,74.125.24.0-255,2837,48681,96,269892
30775,0.000528,172.31.47.0-255,66,48747,96,269892
30776,0.000531,74.125.24.0-255,135,48882,96,269892
30777,0.000539,172.31.47.0-255,66,48948,96,269892
30778,0.000648,74.125.24.0-255,344,49292,96,269892
30779,0.000652,172.31.47.0-255,66,49358,96,269892
30780,0.000906,74.125.24.0-255,1484,50842,96,269892
30781,0.000912,172.31.47.0-255,66,50908,96,269892
30782,0.000918,74.125.24.0-255,2902,53810,96,269892
30783,0.00092,172.31.47.0-255,66,53876,96,269892
30784,0.000932,74.125.24.0-255,5738,59614,96,269892
30785,0.000934,172.31.47.0-255,66,59680,96,269892
30786,0.000969,74.125.24.0-255,6797,66477,96,269892
30787,0.000972,172.31.47.0-255,66,66543,96,269892
30788,0.001474,74.125.24.0-255,1484,68027,96,269892
30789,0.001478,172.31.47.0-255,66,68093,96,269892
30790,0.001483,74.125.24.0-255,2902,70995,96,269892
30791,0.001485,172.31.47.0-255,66,71061,96,269892
30792,0.001516,74.125.24.0-255,5738,76799,96,269892
30793,0.001518,172.31.47.0-255,66,76865,96,269892
30794,0.001531,74.125.24.0-255,4320,81185,96,269892
30795,0.001537,172.31.47.0-255,66,81251,96,269892
30796,0.001553,74.125.24.0-255,2543,83794,96,269892
30797,0.001555,172.31.47.0-255,66,83860,96,269892
30798,0.002237,74.125.24.0-255,1484,85344,96,269892
30799,0.002247,74.125.24.0-255,2902,88246,96,269892
30800,0.002251,172.31.47.0-255,66,88312,96,269892
30801,0.002256,74.125.24.0-255,1484,89796,96,269892
30802,0.002278,74.125.24.0-255,4320,94116,96,269892
30803,0.00228,172.31.47.0-255,66,94182,96,269892
30804,0.002286,74.125.24.0-255,5738,99920,96,269892
30805,0.002288,172.31.47.0-255,66,99986,96,269892
30806,0.002299,74.125.24.0-255,7156,107142,96,269892
30807,0.002301,172.31.47.0-255,66,107208,96,269892
30808,0.00234,172.31.47.0-255,66,107274,96,269892
30809,0.002473,74.125.24.0-255,1484,108758,96,269892
30810,0.002485,74.125.24.0-255,2902,111660,96,269892
30811,0.002487,172.31.47.0-255,66,111726,96,269892
30812,0.002513,74.125.24.0-255,5738,117464,96,269892
30813,0.002515,172.31.47.0-255,66,117530,96,269892
30814,0.00252,74.125.24.0-255,4320,121850,96,269892
30815,0.002522,172.31.47.0-255,66,121916,96,269892
30816,0.002558,172.31.47.0-255,66,121982,96,269892
30817,0.002567,172.31.47.0-255,66,122048,96,269892
30818,0.002573,74.125.24.0-255,1484,123532,96,269892
30819,0.002575,74.125.24.0-255,766,124298,96,269892
30820,0.002577,172.31.47.0-255,66,124364,96,269892
30821,0.003003,74.125.24.0-255,1484,125848,96,269892
30822,0.003006,74.125.24.0-255,1484,127332,96,269892
30823,0.003008,172.31.47.0-255,66,127398,96,269892
30824,0.003038,74.125.24.0-255,1484,128882,96,269892
30825,0.003045,74.125.24.0-255,5738,134620,96,269892
30826,0.003049,74.125.24.0-255,2902,137522,96,269892
30827,0.003079,74.125.24.0-255,1484,139006,96,269892
30828,0.003103,74.125.24.0-255,2902,141908,96,269892
30829,0.003117,74.125.24.0-255,6438,148346,96,269892
30830,0.003412,74.125.24.0-255,1484,149830,96,269892
30831,0.003428,74.125.24.0-255,2902,152732,96,269892
30832,0.003449,74.125.24.0-255,5738,158470,96,269892
30833,0.003476,74.125.24.0-255,2902,161372,96,269892
30834,0.003533,74.125.24.0-255,2902,164274,96,269892
30835,0.003859,74.125.24.0-255,1484,165758,96,269892
30836,0.003869,74.125.24.0-255,1484,167242,96,269892
30837,0.00388,74.125.24.0-255,1484,168726,96,269892
30838,0.003895,74.125.24.0-255,5738,174464,96,269892
30839,0.003957,74.125.24.0-255,1484,175948,96,269892
30840,0.004013,74.125.24.0-255,1484,177432,96,269892
30841,0.004032,74.125.24.0-255,2902,180334,96,269892
30842,0.004038,74.125.24.0-255,5738,186072,96,269892
30843,0.004049,74.125.24.0-255,1484,187556,96,269892
30844,0.004099,74.125.24.0-255,4320,191876,96,269892
30845,0.004116,74.125.24.0-255,6438,198314,96,269892
30846,0.004151,74.125.24.0-255,1484,199798,96,269892
30847,0.004153,74.125.24.0-255,1484,201282,96,269892
30848,0.004166,74.125.24.0-255,1484,202766,96,269892
30849,0.004179,74.125.24.0-255,5738,208504,96,269892
30850,0.004198,74.125.24.0-255,2902,211406,96,269892
30851,0.00423,74.125.24.0-255,2902,214308,96,269892
30852,0.004447,74.125.24.0-255,1484,215792,96,269892
30853,0.004461,74.125.24.0-255,2902,218694,96,269892
30854,0.004483,74.125.24.0-255,5738,224432,96,269892
30855,0.004495,74.125.24.0-255,4320,228752,96,269892
30856,0.004546,74.125.24.0-255,4320,233072,96,269892
30857,0.004549,74.125.24.0-255,1484,234556,96,269892
30858,0.004566,74.125.24.0-255,5020,239576,96,269892
30859,0.004582,74.125.24.0-255,2902,242478,96,269892
30860,0.004605,74.125.24.0-255,2902,245380,96,269892
30861,0.004611,74.125.24.0-255,5738,251118,96,269892
30862,0.004616,74.125.24.0-255,5738,256856,96,269892
30863,0.00464,74.125.24.0-255,2902,259758,96,269892
30864,0.00468,74.125.24.0-255,5431,265189,96,269892
30865,0.004698,172.31.47.0-255,66,265255,96,269892
30866,0.004714,74.125.24.0-255,105,265360,96,269892
30867,0.006867,172.31.47.0-255,66,265426,96,269892
30868,0.0069,172.31.47.0-255,105,265531,96,269892
30869,0.009129,74.125.24.0-255,66,265597,96,269892
30870,0.032125,172.31.47.0-255,172,265769,96,269892
30871,0.03216,172.31.47.0-255,1109,266878,96,269892
30872,0.03222,172.31.47.0-255,1514,268392,96,269892
30873,0.032222,172.31.47.0-255,1302,269694,96,269892
30874,0.033667,104.244.42.0-255,66,269760,96,269892
30875,0.033712,104.244.42.0-255,66,269826,96,269892
30876,0.033761,104.244.42.0-255,66,269892,96,269892
30877,0.0,172.253.118.0-255,160,160,96,273005
30878,3.1e-05,172.31.47.0-255,66,226,96,273005
30879,6.2e-05,172.253.118.0-255,1484,1710,96,273005
30880,6.6e-05,172.31.47.0-255,66,1776,96,273005
30881,6.9e-05,172.253.118.0-255,1484,3260,96,273005
30882,7.2e-05,172.31.47.0-255,66,3326,96,273005
30883,7.8e-05,172.253.118.0-255,4320,7646,96,273005
30884,8.1e-05,172.31.47.0-255,66,7712,96,273005
30885,0.000116,172.253.118.0-255,6428,14140,96,273005
30886,0.000119,172.31.47.0-255,66,14206,96,273005
30887,0.000251,172.253.118.0-255,1484,15690,96,273005
30888,0.000255,172.31.47.0-255,66,15756,96,273005
30889,0.00026,172.253.118.0-255,2902,18658,96,273005
30890,0.000263,172.31.47.0-255,66,18724,96,273005
30891,0.000284,172.253.118.0-255,5738,24462,96,273005
30892,0.000287,172.31.47.0-255,66,24528,96,273005
30893,0.000326,172.31.47.0-255,66,24594,96,273005
30894,0.000362,172.31.47.0-255,66,24660,96,273005
30895,0.000364,172.253.118.0-255,1484,26144,96,273005
30896,0.000368,172.31.47.0-255,66,26210,96,273005
30897,0.000402,172.31.47.0-255,66,26276,96,273005
30898,0.000428,172.253.118.0-255,3602,29878,96,273005
30899,0.000431,172.31.47.0-255,66,29944,96,273005
30900,0.000736,172.253.118.0-255,400,30344,96,273005
30901,0.000741,172.31.47.0-255,66,30410,96,273005
30902,0.000793,172.253.118.0-255,110,30520,96,273005
30903,0.000796,172.31.47.0-255,66,30586,96,273005
30904,0.000892,172.253.118.0-255,1484,32070,96,273005
30905,0.000896,172.31.47.0-255,66,32136,96,273005
30906,0.000903,172.253.118.0-255,2902,35038,96,273005
30907,0.000905,172.31.47.0-255,66,35104,96,273005
30908,0.000917,172.253.118.0-255,5738,40842,96,273005
30909,0.000919,172.31.47.0-255,66,40908,96,273005
30910,0.000921,172.253.118.0-255,1484,42392,96,273005
30911,0.000944,172.253.118.0-255,2902,45294,96,273005
30912,0.000946,172.31.47.0-255,66,45360,96,273005
30913,0.000952,172.253.118.0-255,7156,52516,96,273005
30914,0.000954,172.31.47.0-255,66,52582,96,273005
30915,0.000977,172.253.118.0-255,4320,56902,96,273005
30916,0.00098,172.31.47.0-255,66,56968,96,273005
30917,0.00099,172.31.47.0-255,66,57034,96,273005
30918,0.001034,172.253.118.0-255,332,57366,96,273005
30919,0.001314,172.253.118.0-255,1484,58850,96,273005
30920,0.00132,172.31.47.0-255,66,58916,96,273005
30921,0.001326,172.253.118.0-255,2902,61818,96,273005
30922,0.001328,172.31.47.0-255,66,61884,96,273005
30923,0.001334,172.253.118.0-255,5738,67622,96,273005
30924,0.001342,172.31.47.0-255,66,67688,96,273005
30925,0.001349,172.253.118.0-255,7156,74844,96,273005
30926,0.001351,172.31.47.0-255,66,74910,96,273005
30927,0.001389,172.31.47.0-255,66,74976,96,273005
30928,0.001413,172.253.118.0-255,2902,77878,96,273005
30929,0.001416,172.31.47.0-255,66,77944,96,273005
30930,0.001435,172.253.118.0-255,2184,80128,96,273005
30931,0.001437,172.31.47.0-255,66,80194,96,273005
30932,0.001472,172.253.118.0-255,2902,83096,96,273005
30933,0.001474,172.31.47.0-255,66,83162,96,273005
30934,0.001494,172.253.118.0-255,2902,86064,96,273005
30935,0.001496,172.31.47.0-255,66,86130,96,273005
30936,0.001522,172.253.118.0-255,7156,93286,96,273005
30937,0.001524,172.31.47.0-255,66,93352,96,273005
30938,0.001545,172.31.47.0-255,66,93418,96,273005
30939,0.001563,172.253.118.0-255,5738,99156,96,273005
30940,0.001565,172.31.47.0-255,66,99222,96,273005
30941,0.001587,172.253.118.0-255,5738,104960,96,273005
30942,0.001589,172.31.47.0-255,66,105026,96,273005
30943,0.001609,172.253.118.0-255,766,105792,96,273005
30944,0.001633,172.253.118.0-255,1484,107276,96,273005
30945,0.001635,172.31.47.0-255,66,107342,96,273005
30946,0.001652,172.253.118.0-255,2902,110244,96,273005
30947,0.001654,172.31.47.0-255,66,110310,96,273005
30948,0.001659,172.253.118.0-255,5738,116048,96,273005
30949,0.001661,172.31.47.0-255,66,116114,96,273005
30950,0.001663,172.253.118.0-255,1484,117598,96,273005
30951,0.001706,172.31.47.0-255,66,117664,96,273005
30952,0.001711,172.253.118.0-255,4320,121984,96,273005
30953,0.001713,172.31.47.0-255,66,122050,96,273005
30954,0.001758,172.31.47.0-255,66,122116,96,273005
30955,0.00179,172.253.118.0-255,1484,123600,96,273005
30956,0.0018,172.253.118.0-255,2902,126502,96,273005
30957,0.001802,172.31.47.0-255,66,126568,96,273005
30958,0.001804,172.253.118.0-255,1484,128052,96,273005
30959,0.001821,172.253.118.0-255,4320,132372,96,273005
30960,0.001823,172.31.47.0-255,66,132438,96,273005
30961,0.001844,172.253.118.0-255,2902,135340,96,273005
30962,0.001845,172.31.47.0-255,66,135406,96,273005
30963,0.00185,172.253.118.0-255,4320,139726,96,273005
30964,0.001852,172.31.47.0-255,66,139792,96,273005
30965,0.00188,172.31.47.0-255,66,139858,96,273005
30966,0.001915,172.31.47.0-255,66,139924,96,273005
30967,0.001976,172.253.118.0-255,1484,141408,96,273005
30968,0.001979,172.253.118.0-255,1484,142892,96,273005
30969,0.001981,172.31.47.0-255,66,142958,96,273005
30970,0.001995,172.253.118.0-255,1484,144442,96,273005
30971,0.002001,172.253.118.0-255,5738,150180,96,273005
30972,0.002003,172.31.47.0-255,66,150246,96,273005
30973,0.002062,172.31.47.0-255,66,150312,96,273005
30974,0.002077,172.31.47.0-255,66,150378,96,273005
30975,0.002114,172.253.118.0-255,1484,151862,96,273005
30976,0.002125,172.253.118.0-255,2902,154764,96,273005
30977,0.002127,172.31.47.0-255,66,154830,96,273005
30978,0.002138,172.253.118.0-255,1484,156314,96,273005
30979,0.002159,172.253.118.0-255,4320,160634,96,273005
30980,0.002161,172.31.47.0-255,66,160700,96,273005
30981,0.002167,172.253.118.0-255,7156,167856,96,273005
30982,0.002168,172.31.47.0-255,66,167922,96,273005
30983,0.002231,172.31.47.0-255,66,167988,96,273005
30984,0.002234,172.253.118.0-255,2184,170172,96,273005
30985,0.002236,172.31.47.0-255,66,170238,96,273005
30986,0.002531,172.253.118.0-255,1484,171722,96,273005
30987,0.002543,172.253.118.0-255,1484,173206,96,273005
30988,0.002545,172.31.47.0-255,66,173272,96,273005
30989,0.002567,172.253.118.0-255,1484,174756,96,273005
30990,0.002572,172.253.118.0-255,5738,180494,96,273005
30991,0.002574,172.31.47.0-255,66,180560,96,273005
30992,0.002604,172.31.47.0-255,66,180626,96,273005
30993,0.002607,172.253.118.0-255,1484,182110,96,273005
30994,0.005159,172.253.118.0-255,4320,186430,96,273005
30995,0.005165,172.31.47.0-255,66,186496,96,273005
30996,0.007722,172.253.118.0-255,4320,190816,96,273005
30997,0.007727,172.31.47.0-255,66,190882,96,273005
30998,0.007746,172.253.118.0-255,1484,192366,96,273005
30999,0.010281,172.253.118.0-255,4320,196686,96,273005
31000,0.010293,172.31.47.0-255,66,196752,96,273005
31001,0.012863,172.253.118.0-255,5738,202490,96,273005
31002,0.012871,172.31.47.0-255,66,202556,96,273005
31003,0.015427,172.253.118.0-255,5738,208294,96,273005
31004,0.015436,172.31.47.0-255,66,208360,96,273005
31005,0.018011,172.253.118.0-255,5738,214098,96,273005
31006,0.018017,172.31.47.0-255,66,214164,96,273005
31007,0.020578,172.253.118.0-255,5738,219902,96,273005
31008,0.020583,172.31.47.0-255,66,219968,96,273005
31009,0.022766,172.31.47.0-255,172,220140,96,273005
31010,0.022795,172.31.47.0-255,1109,221249,96,273005
31011,0.02283,172.31.47.0-255,1514,222763,96,273005
31012,0.022831,172.31.47.0-255,335,223098,96,273005
31013,0.023135,172.253.118.0-255,5738,228836,96,273005
31014,0.023141,172.31.47.0-255,66,228902,96,273005
31015,0.024237,104.244.42.0-255,66,228968,96,273005
31016,0.024264,104.244.42.0-255,66,229034,96,273005
31017,0.024311,104.244.42.0-255,66,229100,96,273005
31018,0.025704,172.253.118.0-255,5738,234838,96,273005
31019,0.025711,172.31.47.0-255,66,234904,96,273005
31020,0.028271,172.253.118.0-255,5738,240642,96,273005
31021,0.028276,172.31.47.0-255,66,240708,96,273005
31022,0.030845,172.253.118.0-255,5738,246446,96,273005
31023,0.03085,172.31.47.0-255,66,246512,96,273005
31024,0.033402,172.253.118.0-255,5738,252250,96,273005
31025,0.033409,172.31.47.0-255,66,252316,96,273005
31026,0.035964,172.253.118.0-255,5738,258054,96,273005
31027,0.035969,172.31.47.0-255,66,258120,96,273005
31028,0.038518,172.253.118.0-255,5738,263858,96,273005
31029,0.038524,172.31.47.0-255,66,263924,96,273005
31030,0.041086,172.253.118.0-255,5738,269662,96,273005
31031,0.041091,172.31.47.0-255,66,269728,96,273005
31032,0.043639,172.253.118.0-255,3040,272768,96,273005
31033,0.043645,172.31.47.0-255,66,272834,96,273005
31034,0.043832,172.31.47.0-255,105,272939,96,273005
31035,0.046364,172.253.118.0-255,66,273005,96,273005
31036,0.0,74.125.200.0-255,297,297,96,345426
31037,2.7e-05,172.31.47.0-255,66,363,96,345426
31038,3.3e-05,74.125.200.0-255,1484,1847,96,345426
31039,3.6e-05,172.31.47.0-255,66,1913,96,345426
31040,4e-05,74.125.200.0-255,2902,4815,96,345426
31041,4.3e-05,172.31.47.0-255,66,4881,96,345426
31042,5.4e-05,74.125.200.0-255,5738,10619,96,345426
31043,5.6e-05,172.31.47.0-255,66,10685,96,345426
31044,5.8e-05,74.125.200.0-255,1484,12169,96,345426
31045,5.9e-05,172.31.47.0-255,66,12235,96,345426
31046,8.2e-05,74.125.200.0-255,1484,13719,96,345426
31047,8.7e-05,172.31.47.0-255,66,13785,96,345426
31048,0.000109,74.125.200.0-255,531,14316,96,345426
31049,0.00011,172.31.47.0-255,66,14382,96,345426
31050,0.000231,74.125.200.0-255,1484,15866,96,345426
31051,0.000236,172.31.47.0-255,66,15932,96,345426
31052,0.000241,74.125.200.0-255,2902,18834,96,345426
31053,0.000243,172.31.47.0-255,66,18900,96,345426
31054,0.00029,74.125.200.0-255,1484,20384,96,345426
31055,0.000292,172.31.47.0-255,66,20450,96,345426
31056,0.000319,74.125.200.0-255,4320,24770,96,345426
31057,0.000322,172.31.47.0-255,66,24836,96,345426
31058,0.000329,74.125.200.0-255,6797,31633,96,345426
31059,0.000331,172.31.47.0-255,66,31699,96,345426
31060,0.000406,74.125.200.0-255,1484,33183,96,345426
31061,0.00041,172.31.47.0-255,66,33249,96,345426
31062,0.000414,74.125.200.0-255,1484,34733,96,345426
31063,0.000415,172.31.47.0-255,66,34799,96,345426
31064,0.000458,74.125.200.0-255,2902,37701,96,345426
31065,0.000462,172.31.47.0-255,66,37767,96,345426
31066,0.000468,74.125.200.0-255,5738,43505,96,345426
31067,0.00047,172.31.47.0-255,66,43571,96,345426
31068,0.000475,74.125.200.0-255,5379,48950,96,345426
31069,0.000477,172.31.47.0-255,66,49016,96,345426
31070,0.001198,74.125.200.0-255,1484,50500,96,345426
31071,0.001206,74.125.200.0-255,2902,53402,96,345426
31072,0.001209,172.31.47.0-255,66,53468,96,345426
31073,0.001215,74.125.200.0-255,2902,56370,96,345426
31074,0.001217,172.31.47.0-255,66,56436,96,345426
31075,0.001241,74.125.200.0-255,1484,57920,96,345426
31076,0.001251,74.125.200.0-255,5738,63658,96,345426
31077,0.001253,172.31.47.0-255,66,63724,96,345426
31078,0.001283,74.125.200.0-255,3124,66848,96,345426
31079,0.001286,172.31.47.0-255,66,66914,96,345426
31080,0.001353,74.125.200.0-255,1484,68398,96,345426
31081,0.001369,74.125.200.0-255,2902,71300,96,345426
31082,0.001372,172.31.47.0-255,66,71366,96,345426
31083,0.001376,74.125.200.0-255,2902,74268,96,345426
31084,0.001378,172.31.47.0-255,66,74334,96,345426
31085,0.001396,74.125.200.0-255,1484,75818,96,345426
31086,0.001441,74.125.200.0-255,4320,80138,96,345426
31087,0.001445,172.31.47.0-255,66,80204,96,345426
31088,0.001476,74.125.200.0-255,3961,84165,96,345426
31089,0.001479,172.31.47.0-255,66,84231,96,345426
31090,0.001538,74.125.200.0-255,1484,85715,96,345426
31091,0.001575,74.125.200.0-255,2902,88617,96,345426
31092,0.00158,172.31.47.0-255,66,88683,96,345426
31093,0.001606,74.125.200.0-255,4320,93003,96,345426
31094,0.001609,172.31.47.0-255,66,93069,96,345426
31095,0.001638,74.125.200.0-255,7156,100225,96,345426
31096,0.001641,172.31.47.0-255,66,100291,96,345426
31097,0.001665,74.125.200.0-255,1125,101416,96,345426
31098,0.001924,74.125.200.0-255,1484,102900,96,345426
31099,0.001929,172.31.47.0-255,66,102966,96,345426
31100,0.001934,74.125.200.0-255,2902,105868,96,345426
31101,0.001937,172.31.47.0-255,66,105934,96,345426
31102,0.001941,74.125.200.0-255,2902,108836,96,345426
31103,0.001943,172.31.47.0-255,66,108902,96,345426
31104,0.001966,74.125.200.0-255,2902,111804,96,345426
31105,0.001978,172.31.47.0-255,66,111870,96,345426
31106,0.001985,74.125.200.0-255,5738,117608,96,345426
31107,0.001987,172.31.47.0-255,66,117674,96,345426
31108,0.002017,74.125.200.0-255,2902,120576,96,345426
31109,0.002019,172.31.47.0-255,66,120642,96,345426
31110,0.002029,172.31.47.0-255,66,120708,96,345426
31111,0.002039,74.125.200.0-255,5020,125728,96,345426
31112,0.002041,172.31.47.0-255,66,125794,96,345426
31113,0.002366,74.125.200.0-255,1484,127278,96,345426
31114,0.002371,74.125.200.0-255,2902,130180,96,345426
31115,0.002374,172.31.47.0-255,66,130246,96,345426
31116,0.002403,74.125.200.0-255,5738,135984,96,345426
31117,0.002406,172.31.47.0-255,66,136050,96,345426
31118,0.002408,74.125.200.0-255,1484,137534,96,345426
31119,0.002434,74.125.200.0-255,7156,144690,96,345426
31120,0.002436,172.31.47.0-255,66,144756,96,345426
31121,0.002463,74.125.200.0-255,4320,149076,96,345426
31122,0.002465,172.31.47.0-255,66,149142,96,345426
31123,0.002474,172.31.47.0-255,66,149208,96,345426
31124,0.002476,74.125.200.0-255,766,149974,96,345426
31125,0.002683,74.125.200.0-255,1484,151458,96,345426
31126,0.002687,172.31.47.0-255,66,151524,96,345426
31127,0.002691,74.125.200.0-255,1484,153008,96,345426
31128,0.002711,74.125.200.0-255,1484,154492,96,345426
31129,0.002713,172.31.47.0-255,66,154558,96,345426
31130,0.002719,74.125.200.0-255,5738,160296,96,345426
31131,0.00272,172.31.47.0-255,66,160362,96,345426
31132,0.002747,172.31.47.0-255,66,160428,96,345426
31133,0.002771,74.125.200.0-255,7156,167584,96,345426
31134,0.002773,172.31.47.0-255,66,167650,96,345426
31135,0.002796,74.125.200.0-255,2902,170552,96,345426
31136,0.002798,172.31.47.0-255,66,170618,96,345426
31137,0.002803,74.125.200.0-255,5020,175638,96,345426
31138,0.002805,172.31.47.0-255,66,175704,96,345426
31139,0.00299,74.125.200.0-255,1484,177188,96,345426
31140,0.003009,74.125.200.0-255,2902,180090,96,345426
31141,0.003012,172.31.47.0-255,66,180156,96,345426
31142,0.003018,74.125.200.0-255,5738,185894,96,345426
31143,0.003019,172.31.47.0-255,66,185960,96,345426
31144,0.003047,74.125.200.0-255,5738,191698,96,345426
31145,0.003049,172.31.47.0-255,66,191764,96,345426
31146,0.003055,74.125.200.0-255,7156,198920,96,345426
31147,0.003057,172.31.47.0-255,66,198986,96,345426
31148,0.003084,74.125.200.0-255,2902,201888,96,345426
31149,0.003086,172.31.47.0-255,66,201954,96,345426
31150,0.003117,172.31.47.0-255,66,202020,96,345426
31151,0.003459,74.125.200.0-255,1484,203504,96,345426
31152,0.003477,74.125.200.0-255,2902,206406,96,345426
31153,0.00348,172.31.47.0-255,66,206472,96,345426
31154,0.003507,74.125.200.0-255,5738,212210,96,345426
31155,0.003509,172.31.47.0-255,66,212276,96,345426
31156,0.003518,74.125.200.0-255,4320,216596,96,345426
31157,0.003519,172.31.47.0-255,66,216662,96,345426
31158,0.003528,74.125.200.0-255,5738,222400,96,345426
31159,0.00353,172.31.47.0-255,66,222466,96,345426
31160,0.003566,172.31.47.0-255,66,222532,96,345426
31161,0.003569,74.125.200.0-255,2184,224716,96,345426
31162,0.00357,172.31.47.0-255,66,224782,96,345426
31163,0.003793,74.125.200.0-255,1484,226266,96,345426
31164,0.003797,74.125.200.0-255,1484,227750,96,345426
31165,0.0038,172.31.47.0-255,66,227816,96,345426
31166,0.003817,74.125.200.0-255,2902,230718,96,345426
31167,0.003819,172.31.47.0-255,66,230784,96,345426
31168,0.003822,74.125.200.0-255,1484,232268,96,345426
31169,0.003846,74.125.200.0-255,4320,236588,96,345426
31170,0.003848,172.31.47.0-255,66,236654,96,345426
31171,0.00386,74.125.200.0-255,4320,240974,96,345426
31172,0.003865,172.31.47.0-255,66,241040,96,345426
31173,0.003891,74.125.200.0-255,5738,246778,96,345426
31174,0.003894,172.31.47.0-255,66,246844,96,345426
31175,0.003903,172.31.47.0-255,66,246910,96,345426
31176,0.00392,74.125.200.0-255,2902,249812,96,345426
31177,0.003922,172.31.47.0-255,66,249878,96,345426
31178,0.003924,74.125.200.0-255,766,250644,96,345426
31179,0.004328,74.125.200.0-255,1484,252128,96,345426
31180,0.004333,172.31.47.0-255,66,252194,96,345426
31181,0.004338,74.125.200.0-255,2902,255096,96,345426
31182,0.00434,172.31.47.0-255,66,255162,96,345426
31183,0.004344,74.125.200.0-255,1484,256646,96,345426
31184,0.004367,74.125.200.0-255,2902,259548,96,345426
31185,0.004369,172.31.47.0-255,66,259614,96,345426
31186,0.004399,74.125.200.0-255,5738,265352,96,345426
31187,0.004402,172.31.47.0-255,66,265418,96,345426
31188,0.004427,172.31.47.0-255,66,265484,96,345426
31189,0.00443,74.125.200.0-255,1484,266968,96,345426
31190,0.004472,74.125.200.0-255,7156,274124,96,345426
31191,0.004476,172.31.47.0-255,66,274190,96,345426
31192,0.0045,74.125.200.0-255,2184,276374,96,345426
31193,0.004502,172.31.47.0-255,66,276440,96,345426
31194,0.004779,74.125.200.0-255,1484,277924,96,345426
31195,0.0048,74.125.200.0-255,2902,280826,96,345426
31196,0.004802,172.31.47.0-255,66,280892,96,345426
31197,0.004805,74.125.200.0-255,1484,282376,96,345426
31198,0.004831,74.125.200.0-255,2902,285278,96,345426
31199,0.004833,172.31.47.0-255,66,285344,96,345426
31200,0.004839,74.125.200.0-255,5738,291082,96,345426
31201,0.004841,172.31.47.0-255,66,291148,96,345426
31202,0.004856,74.125.200.0-255,2902,294050,96,345426
31203,0.004858,172.31.47.0-255,66,294116,96,345426
31204,0.004896,172.31.47.0-255,66,294182,96,345426
31205,0.004901,74.125.200.0-255,4320,298502,96,345426
31206,0.004903,172.31.47.0-255,66,298568,96,345426
31207,0.00493,74.125.200.0-255,3602,302170,96,345426
31208,0.004932,172.31.47.0-255,66,302236,96,345426
31209,0.005291,74.125.200.0-255,1484,303720,96,345426
31210,0.005297,74.125.200.0-255,2902,306622,96,345426
31211,0.0053,172.31.47.0-255,66,306688,96,345426
31212,0.005322,74.125.200.0-255,4320,311008,96,345426
31213,0.005325,172.31.47.0-255,66,311074,96,345426
31214,0.005337,74.125.200.0-255,1484,312558,96,345426
31215,0.005346,74.125.200.0-255,4320,316878,96,345426
31216,0.00535,172.31.47.0-255,66,316944,96,345426
31217,0.005386,74.125.200.0-255,4320,321264,96,345426
31218,0.00539,172.31.47.0-255,66,321330,96,345426
31219,0.005422,74.125.200.0-255,1484,322814,96,345426
31220,0.005435,172.31.47.0-255,66,322880,96,345426
31221,0.005438,74.125.200.0-255,2184,325064,96,345426
31222,0.00544,172.31.47.0-255,66,325130,96,345426
31223,0.005566,74.125.200.0-255,1484,326614,96,345426
31224,0.005572,74.125.200.0-255,1484,328098,96,345426
31225,0.005577,172.31.47.0-255,66,328164,96,345426
31226,0.005608,74.125.200.0-255,2902,331066,96,345426
31227,0.005611,172.31.47.0-255,66,331132,96,345426
31228,0.005617,74.125.200.0-255,5738,336870,96,345426
31229,0.005619,172.31.47.0-255,66,336936,96,345426
31230,0.005649,74.125.200.0-255,3495,340431,96,345426
31231,0.005651,172.31.47.0-255,66,340497,96,345426
31232,0.005713,74.125.200.0-255,105,340602,96,345426
31233,0.018001,172.31.47.0-255,105,340707,96,345426
31234,0.018232,172.31.47.0-255,90,340797,96,345426
31235,0.018245,172.31.47.0-255,66,340863,96,345426
31236,0.020006,74.125.200.0-255,66,340929,96,345426
31237,0.020196,74.125.200.0-255,66,340995,96,345426
31238,0.020228,74.125.200.0-255,66,341061,96,345426
31239,0.020242,172.31.47.0-255,66,341127,96,345426
31240,0.042551,172.31.47.0-255,176,341303,96,345426
31241,0.04258,172.31.47.0-255,1101,342404,96,345426
31242,0.042639,172.31.47.0-255,1514,343918,96,345426
31243,0.042641,172.31.47.0-255,1310,345228,96,345426
31244,0.044087,104.244.42.0-255,66,345294,96,345426
31245,0.044096,104.244.42.0-255,66,345360,96,345426
31246,0.044168,104.244.42.0-255,66,345426,96,345426
31247,0.0,172.217.194.0-255,153,153,96,207787
31248,1.2e-05,172.31.47.0-255,66,219,96,207787
31249,1.8e-05,172.217.194.0-255,1484,1703,96,207787
31250,2.2e-05,172.31.47.0-255,66,1769,96,207787
31251,5.1e-05,172.217.194.0-255,2902,4671,96,207787
31252,5.4e-05,172.31.47.0-255,66,4737,96,207787
31253,6e-05,172.217.194.0-255,4320,9057,96,207787
31254,6.2e-05,172.31.47.0-255,66,9123,96,207787
31255,0.000108,172.217.194.0-255,5047,14170,96,207787
31256,0.00011,172.31.47.0-255,66,14236,96,207787
31257,0.000134,172.217.194.0-255,5738,19974,96,207787
31258,0.000137,172.31.47.0-255,66,20040,96,207787
31259,0.000155,172.217.194.0-255,5738,25778,96,207787
31260,0.000157,172.31.47.0-255,66,25844,96,207787
31261,0.000209,172.217.194.0-255,1484,27328,96,207787
31262,0.000211,172.31.47.0-255,66,27394,96,207787
31263,0.000238,172.217.194.0-255,3961,31355,96,207787
31264,0.00024,172.31.47.0-255,66,31421,96,207787
31265,0.000258,172.217.194.0-255,1484,32905,96,207787
31266,0.00026,172.31.47.0-255,66,32971,96,207787
31267,0.000264,172.217.194.0-255,2902,35873,96,207787
31268,0.000266,172.31.47.0-255,66,35939,96,207787
31269,0.000271,172.217.194.0-255,4320,40259,96,207787
31270,0.000273,172.31.47.0-255,66,40325,96,207787
31271,0.000298,172.217.194.0-255,1484,41809,96,207787
31272,0.000301,172.31.47.0-255,66,41875,96,207787
31273,0.000307,172.217.194.0-255,5738,47613,96,207787
31274,0.000309,172.31.47.0-255,66,47679,96,207787
31275,0.000337,172.31.47.0-255,66,47745,96,207787
31276,0.00036,172.217.194.0-255,2902,50647,96,207787
31277,0.000362,172.31.47.0-255,66,50713,96,207787
31278,0.000388,172.217.194.0-255,7091,57804,96,207787
31279,0.00039,172.31.47.0-255,66,57870,96,207787
31280,0.000393,172.217.194.0-255,383,58253,96,207787
31281,0.000553,172.217.194.0-255,1484,59737,96,207787
31282,0.000557,172.31.47.0-255,66,59803,96,207787
31283,0.000562,172.217.194.0-255,2902,62705,96,207787
31284,0.000564,172.31.47.0-255,66,62771,96,207787
31285,0.000586,172.217.194.0-255,5738,68509,96,207787
31286,0.000588,172.31.47.0-255,66,68575,96,207787
31287,0.000627,172.31.47.0-255,66,68641,96,207787
31288,0.000637,172.31.47.0-255,66,68707,96,207787
31289,0.00068,172.217.194.0-255,2184,70891,96,207787
31290,0.000682,172.31.47.0-255,66,70957,96,207787
31291,0.000702,172.217.194.0-255,2902,73859,96,207787
31292,0.000704,172.31.47.0-255,66,73925,96,207787
31293,0.000707,172.217.194.0-255,1484,75409,96,207787
31294,0.000729,172.217.194.0-255,2902,78311,96,207787
31295,0.000732,172.31.47.0-255,66,78377,96,207787
31296,0.000741,172.31.47.0-255,66,78443,96,207787
31297,0.000787,172.31.47.0-255,66,78509,96,207787
31298,0.000827,172.217.194.0-255,5738,84247,96,207787
31299,0.00083,172.31.47.0-255,66,84313,96,207787
31300,0.000863,172.217.194.0-255,766,85079,96,207787
31301,0.000872,172.217.194.0-255,7156,92235,96,207787
31302,0.000874,172.31.47.0-255,66,92301,96,207787
31303,0.00088,172.217.194.0-255,5738,98039,96,207787
31304,0.000882,172.31.47.0-255,66,98105,96,207787
31305,0.000886,172.217.194.0-255,2902,101007,96,207787
31306,0.000888,172.31.47.0-255,66,101073,96,207787
31307,0.000927,172.31.47.0-255,66,101139,96,207787
31308,0.000935,172.217.194.0-255,6438,107577,96,207787
31309,0.000937,172.31.47.0-255,66,107643,96,207787
31310,0.000965,172.217.194.0-255,7156,114799,96,207787
31311,0.00097,172.31.47.0-255,66,114865,96,207787
31312,0.000984,172.217.194.0-255,1484,116349,96,207787
31313,0.001019,172.217.194.0-255,7156,123505,96,207787
31314,0.001022,172.31.47.0-255,66,123571,96,207787
31315,0.00103,172.217.194.0-255,7156,130727,96,207787
31316,0.001032,172.31.47.0-255,66,130793,96,207787
31317,0.001072,172.31.47.0-255,66,130859,96,207787
31318,0.001076,172.217.194.0-255,2184,133043,96,207787
31319,0.001078,172.31.47.0-255,66,133109,96,207787
31320,0.001104,172.217.194.0-255,2902,136011,96,207787
31321,0.001108,172.217.194.0-255,2902,138913,96,207787
31322,0.001118,172.31.47.0-255,66,138979,96,207787
31323,0.001126,172.31.47.0-255,66,139045,96,207787
31324,0.001132,172.217.194.0-255,4320,143365,96,207787
31325,0.001134,172.31.47.0-255,66,143431,96,207787
31326,0.001139,172.217.194.0-255,4320,147751,96,207787
31327,0.001141,172.31.47.0-255,66,147817,96,207787
31328,0.001172,172.217.194.0-255,4320,152137,96,207787
31329,0.001174,172.31.47.0-255,66,152203,96,207787
31330,0.001179,172.217.194.0-255,2902,155105,96,207787
31331,0.001181,172.31.47.0-255,66,155171,96,207787
31332,0.001228,172.31.47.0-255,66,155237,96,207787
31333,0.001259,172.217.194.0-255,1484,156721,96,207787
31334,0.001264,172.217.194.0-255,2902,159623,96,207787
31335,0.001266,172.31.47.0-255,66,159689,96,207787
31336,0.001292,172.217.194.0-255,5738,165427,96,207787
31337,0.001295,172.31.47.0-255,66,165493,96,207787
31338,0.0013,172.217.194.0-255,2902,168395,96,207787
31339,0.001302,172.31.47.0-255,66,168461,96,207787
31340,0.001345,172.31.47.0-255,66,168527,96,207787
31341,0.001359,172.31.47.0-255,66,168593,96,207787
31342,0.001394,172.217.194.0-255,1484,170077,96,207787
31343,0.0014,172.217.194.0-255,2902,172979,96,207787
31344,0.001402,172.31.47.0-255,66,173045,96,207787
31345,0.001436,172.217.194.0-255,5738,178783,96,207787
31346,0.001439,172.31.47.0-255,66,178849,96,207787
31347,0.00145,172.31.47.0-255,66,178915,96,207787
31348,0.001518,172.31.47.0-255,66,178981,96,207787
31349,0.001524,172.217.194.0-255,5738,184719,96,207787
31350,0.001526,172.31.47.0-255,66,184785,96,207787
31351,0.001557,172.31.47.0-255,66,184851,96,207787
31352,0.001568,172.31.47.0-255,66,184917,96,207787
31353,0.001625,172.31.47.0-255,66,184983,96,207787
31354,0.00168,172.217.194.0-255,2902,187885,96,207787
31355,0.001686,172.31.47.0-255,66,187951,96,207787
31356,0.001698,172.217.194.0-255,1484,189435,96,207787
31357,0.001709,172.217.194.0-255,5738,195173,96,207787
31358,0.001714,172.217.194.0-255,2902,198075,96,207787
31359,0.001762,172.217.194.0-255,2184,200259,96,207787
31360,0.00177,172.31.47.0-255,66,200325,96,207787
31361,0.001818,172.217.194.0-255,913,201238,96,207787
31362,0.001841,172.217.194.0-255,105,201343,96,207787
31363,0.001851,172.31.47.0-255,66,201409,96,207787
31364,0.009337,172.31.47.0-255,105,201514,96,207787
31365,0.011938,172.217.194.0-255,66,201580,96,207787
31366,0.025656,172.31.47.0-255,172,201752,96,207787
31367,0.02569,172.31.47.0-255,1109,202861,96,207787
31368,0.025756,172.31.47.0-255,1514,204375,96,207787
31369,0.025758,172.31.47.0-255,1514,205889,96,207787
31370,0.025759,172.31.47.0-255,1514,207403,96,207787
31371,0.02576,172.31.47.0-255,120,207523,96,207787
31372,0.027222,104.244.42.0-255,66,207589,96,207787
31373,0.027247,104.244.42.0-255,66,207655,96,207787
31374,0.027298,104.244.42.0-255,66,207721,96,207787
31375,0.027309,104.244.42.0-255,66,207787,96,207787
31376,0.0,74.125.24.0-255,152,152,96,152997
31377,3.6e-05,172.31.47.0-255,66,218,96,152997
31378,4.3e-05,74.125.24.0-255,1484,1702,96,152997
31379,4.8e-05,172.31.47.0-255,66,1768,96,152997
31380,6e-05,74.125.24.0-255,2902,4670,96,152997
31381,6.2e-05,172.31.47.0-255,66,4736,96,152997
31382,7e-05,74.125.24.0-255,7156,11892,96,152997
31383,7.2e-05,172.31.47.0-255,66,11958,96,152997
31384,7.6e-05,74.125.24.0-255,2201,14159,96,152997
31385,7.9e-05,172.31.47.0-255,66,14225,96,152997
31386,9.2e-05,172.31.47.0-255,66,14291,96,152997
31387,0.000113,74.125.24.0-255,1484,15775,96,152997
31388,0.000116,172.31.47.0-255,66,15841,96,152997
31389,0.000148,74.125.24.0-255,3961,19802,96,152997
31390,0.000152,172.31.47.0-255,66,19868,96,152997
31391,0.000156,74.125.24.0-255,2902,22770,96,152997
31392,0.000159,172.31.47.0-255,66,22836,96,152997
31393,0.000164,74.125.24.0-255,4320,27156,96,152997
31394,0.000166,172.31.47.0-255,66,27222,96,152997
31395,0.000171,74.125.24.0-255,5738,32960,96,152997
31396,0.000173,172.31.47.0-255,66,33026,96,152997
31397,0.000196,74.125.24.0-255,2902,35928,96,152997
31398,0.000199,172.31.47.0-255,66,35994,96,152997
31399,0.000206,74.125.24.0-255,5738,41732,96,152997
31400,0.000208,172.31.47.0-255,66,41798,96,152997
31401,0.000253,172.31.47.0-255,66,41864,96,152997
31402,0.000256,74.125.24.0-255,365,42229,96,152997
31403,0.000258,172.31.47.0-255,66,42295,96,152997
31404,0.000294,74.125.24.0-255,131,42426,96,152997
31405,0.000298,172.31.47.0-255,66,42492,96,152997
31406,0.000424,74.125.24.0-255,1484,43976,96,152997
31407,0.000429,74.125.24.0-255,2902,46878,96,152997
31408,0.000433,172.31.47.0-255,66,46944,96,152997
31409,0.000462,74.125.24.0-255,5738,52682,96,152997
31410,0.000465,172.31.47.0-255,66,52748,96,152997
31411,0.000473,74.125.24.0-255,7156,59904,96,152997
31412,0.000476,172.31.47.0-255,66,59970,96,152997
31413,0.0005,74.125.24.0-255,2902,62872,96,152997
31414,0.000503,74.125.24.0-255,1484,64356,96,152997
31415,0.000505,172.31.47.0-255,66,64422,96,152997
31416,0.000545,172.31.47.0-255,66,64488,96,152997
31417,0.000573,74.125.24.0-255,1484,65972,96,152997
31418,0.000578,74.125.24.0-255,2902,68874,96,152997
31419,0.000581,172.31.47.0-255,66,68940,96,152997
31420,0.000588,74.125.24.0-255,5738,74678,96,152997
31421,0.00059,172.31.47.0-255,66,74744,96,152997
31422,0.000598,74.125.24.0-255,1484,76228,96,152997
31423,0.000644,172.31.47.0-255,66,76294,96,152997
31424,0.000648,172.31.47.0-255,66,76360,96,152997
31425,0.000686,74.125.24.0-255,2184,78544,96,152997
31426,0.00069,172.31.47.0-255,66,78610,96,152997
31427,0.000703,172.31.47.0-255,66,78676,96,152997
31428,0.000708,74.125.24.0-255,2902,81578,96,152997
31429,0.00071,172.31.47.0-255,66,81644,96,152997
31430,0.000757,172.31.47.0-255,66,81710,96,152997
31431,0.000771,172.31.47.0-255,66,81776,96,152997
31432,0.000803,74.125.24.0-255,4320,86096,96,152997
31433,0.000808,172.31.47.0-255,66,86162,96,152997
31434,0.000815,172.31.47.0-255,66,86228,96,152997
31435,0.00082,74.125.24.0-255,4320,90548,96,152997
31436,0.000822,172.31.47.0-255,66,90614,96,152997
31437,0.000872,172.31.47.0-255,66,90680,96,152997
31438,0.000883,172.31.47.0-255,66,90746,96,152997
31439,0.000954,74.125.24.0-255,2902,93648,96,152997
31440,0.000958,172.31.47.0-255,66,93714,96,152997
31441,0.000964,74.125.24.0-255,4320,98034,96,152997
31442,0.000966,172.31.47.0-255,66,98100,96,152997
31443,0.000976,172.31.47.0-255,66,98166,96,152997
31444,0.000992,172.31.47.0-255,66,98232,96,152997
31445,0.001028,172.31.47.0-255,66,98298,96,152997
31446,0.00103,74.125.24.0-255,1484,99782,96,152997
31447,0.001035,74.125.24.0-255,2902,102684,96,152997
31448,0.001037,172.31.47.0-255,66,102750,96,152997
31449,0.001043,74.125.24.0-255,5738,108488,96,152997
31450,0.001045,172.31.47.0-255,66,108554,96,152997
31451,0.001092,172.31.47.0-255,66,108620,96,152997
31452,0.001099,74.125.24.0-255,7156,115776,96,152997
31453,0.001101,172.31.47.0-255,66,115842,96,152997
31454,0.001142,172.31.47.0-255,66,115908,96,152997
31455,0.001166,172.31.47.0-255,66,115974,96,152997
31456,0.001169,74.125.24.0-255,1484,117458,96,152997
31457,0.001211,172.31.47.0-255,66,117524,96,152997
31458,0.001267,74.125.24.0-255,1484,119008,96,152997
31459,0.001284,74.125.24.0-255,2902,121910,96,152997
31460,0.001287,172.31.47.0-255,66,121976,96,152997
31461,0.001293,74.125.24.0-255,5738,127714,96,152997
31462,0.001296,172.31.47.0-255,66,127780,96,152997
31463,0.001326,74.125.24.0-255,7156,134936,96,152997
31464,0.001329,172.31.47.0-255,66,135002,96,152997
31465,0.001358,74.125.24.0-255,5738,140740,96,152997
31466,0.001361,172.31.47.0-255,66,140806,96,152997
31467,0.001367,74.125.24.0-255,7156,147962,96,152997
31468,0.00137,172.31.47.0-255,66,148028,96,152997
31469,0.001391,172.31.47.0-255,66,148094,96,152997
31470,0.001433,172.31.47.0-255,66,148160,96,152997
31471,0.001444,172.31.47.0-255,66,148226,96,152997
31472,0.001455,172.31.47.0-255,66,148292,96,152997
31473,0.001494,172.31.47.0-255,66,148358,96,152997
31474,0.001498,74.125.24.0-255,105,148463,96,152997
31475,0.003277,172.31.47.0-255,66,148529,96,152997
31476,0.003301,172.31.47.0-255,105,148634,96,152997
31477,0.005568,74.125.24.0-255,66,148700,96,152997
31478,0.030397,172.31.47.0-255,172,148872,96,152997
31479,0.030429,172.31.47.0-255,1109,149981,96,152997
31480,0.030468,172.31.47.0-255,1514,151495,96,152997
31481,0.030498,172.31.47.0-255,1304,152799,96,152997
31482,0.031934,104.244.42.0-255,66,152865,96,152997
31483,0.031944,104.244.42.0-255,66,152931,96,152997
31484,0.032028,104.244.42.0-255,66,152997,96,152997
31485,0.0,74.125.24.0-255,153,153,96,323104
31486,2.4e-05,172.31.47.0-255,66,219,96,323104
31487,3e-05,74.125.24.0-255,1484,1703,96,323104
31488,3.4e-05,172.31.47.0-255,66,1769,96,323104
31489,3.8e-05,74.125.24.0-255,2902,4671,96,323104
31490,4.8e-05,172.31.47.0-255,66,4737,96,323104
31491,5.4e-05,74.125.24.0-255,5738,10475,96,323104
31492,5.7e-05,172.31.47.0-255,66,10541,96,323104
31493,7.8e-05,74.125.24.0-255,1484,12025,96,323104
31494,8.1e-05,172.31.47.0-255,66,12091,96,323104
31495,8.5e-05,74.125.24.0-255,2902,14993,96,323104
31496,8.7e-05,172.31.47.0-255,66,15059,96,323104
31497,0.00013,172.31.47.0-255,66,15125,96,323104
31498,0.000136,74.125.24.0-255,5379,20504,96,323104
31499,0.000138,172.31.47.0-255,66,20570,96,323104
31500,0.000174,74.125.24.0-255,1484,22054,96,323104
31501,0.000177,172.31.47.0-255,66,22120,96,323104
31502,0.000202,74.125.24.0-255,2902,25022,96,323104
31503,0.000205,172.31.47.0-255,66,25088,96,323104
31504,0.00021,74.125.24.0-255,5738,30826,96,323104
31505,0.000212,172.31.47.0-255,66,30892,96,323104
31506,0.000263,172.31.47.0-255,66,30958,96,323104
31507,0.000269,74.125.24.0-255,4320,35278,96,323104
31508,0.00027,172.31.47.0-255,66,35344,96,323104
31509,0.000291,74.125.24.0-255,2902,38246,96,323104
31510,0.000294,172.31.47.0-255,66,38312,96,323104
31511,0.000297,74.125.24.0-255,1484,39796,96,323104
31512,0.000299,172.31.47.0-255,66,39862,96,323104
31513,0.000325,74.125.24.0-255,1392,41254,96,323104
31514,0.00033,172.31.47.0-255,66,41320,96,323104
31515,0.000449,74.125.24.0-255,135,41455,96,323104
31516,0.000452,172.31.47.0-255,66,41521,96,323104
31517,0.000625,74.125.24.0-255,1484,43005,96,323104
31518,0.000638,74.125.24.0-255,2902,45907,96,323104
31519,0.000641,172.31.47.0-255,66,45973,96,323104
31520,0.000668,74.125.24.0-255,5738,51711,96,323104
31521,0.000671,172.31.47.0-255,66,51777,96,323104
31522,0.000676,74.125.24.0-255,5738,57515,96,323104
31523,0.00068,172.31.47.0-255,66,57581,96,323104
31524,0.000683,74.125.24.0-255,6797,64378,96,323104
31525,0.000691,172.31.47.0-255,66,64444,96,323104
31526,0.000717,74.125.24.0-255,4320,68764,96,323104
31527,0.000732,172.31.47.0-255,66,68830,96,323104
31528,0.000741,74.125.24.0-255,6797,75627,96,323104
31529,0.000748,172.31.47.0-255,66,75693,96,323104
31530,0.000803,74.125.24.0-255,1484,77177,96,323104
31531,0.000817,74.125.24.0-255,2902,80079,96,323104
31532,0.00083,74.125.24.0-255,2902,82981,96,323104
31533,0.000831,172.31.47.0-255,66,83047,96,323104
31534,0.000835,172.31.47.0-255,66,83113,96,323104
31535,0.000855,74.125.24.0-255,2902,86015,96,323104
31536,0.000858,172.31.47.0-255,66,86081,96,323104
31537,0.000859,74.125.24.0-255,4320,90401,96,323104
31538,0.000872,172.31.47.0-255,66,90467,96,323104
31539,0.000902,74.125.24.0-255,7156,97623,96,323104
31540,0.000904,172.31.47.0-255,66,97689,96,323104
31541,0.000908,172.31.47.0-255,66,97755,96,323104
31542,0.000934,74.125.24.0-255,3602,101357,96,323104
31543,0.000938,172.31.47.0-255,66,101423,96,323104
31544,0.001342,74.125.24.0-255,1484,102907,96,323104
31545,0.001347,172.31.47.0-255,66,102973,96,323104
31546,0.001353,74.125.24.0-255,2902,105875,96,323104
31547,0.001377,74.125.24.0-255,5738,111613,96,323104
31548,0.001383,74.125.24.0-255,5738,117351,96,323104
31549,0.0014,74.125.24.0-255,4320,121671,96,323104
31550,0.001447,74.125.24.0-255,4320,125991,96,323104
31551,0.001533,74.125.24.0-255,1484,127475,96,323104
31552,0.001536,74.125.24.0-255,1484,128959,96,323104
31553,0.001546,74.125.24.0-255,1484,130443,96,323104
31554,0.001557,74.125.24.0-255,1484,131927,96,323104
31555,0.00158,74.125.24.0-255,4320,136247,96,323104
31556,0.001587,74.125.24.0-255,6501,142748,96,323104
31557,0.001602,74.125.24.0-255,2902,145650,96,323104
31558,0.001625,74.125.24.0-255,1484,147134,96,323104
31559,0.001642,74.125.24.0-255,4320,151454,96,323104
31560,0.001682,74.125.24.0-255,2902,154356,96,323104
31561,0.001773,74.125.24.0-255,1484,155840,96,323104
31562,0.001777,74.125.24.0-255,1484,157324,96,323104
31563,0.001789,74.125.24.0-255,1484,158808,96,323104
31564,0.001826,74.125.24.0-255,2902,161710,96,323104
31565,0.001848,74.125.24.0-255,2902,164612,96,323104
31566,0.001882,74.125.24.0-255,2184,166796,96,323104
31567,0.002085,74.125.24.0-255,1484,168280,96,323104
31568,0.002091,74.125.24.0-255,2902,171182,96,323104
31569,0.002095,74.125.24.0-255,1484,172666,96,323104
31570,0.002116,74.125.24.0-255,4320,176986,96,323104
31571,0.00213,74.125.24.0-255,1484,178470,96,323104
31572,0.002147,74.125.24.0-255,5738,184208,96,323104
31573,0.002167,74.125.24.0-255,5738,189946,96,323104
31574,0.002185,74.125.24.0-255,4320,194266,96,323104
31575,0.002205,74.125.24.0-255,4320,198586,96,323104
31576,0.002232,74.125.24.0-255,1484,200070,96,323104
31577,0.002245,74.125.24.0-255,4320,204390,96,323104
31578,0.002288,74.125.24.0-255,6438,210828,96,323104
31579,0.002307,74.125.24.0-255,5738,216566,96,323104
31580,0.002322,74.125.24.0-255,6438,223004,96,323104
31581,0.002338,74.125.24.0-255,1484,224488,96,323104
31582,0.002343,74.125.24.0-255,2902,227390,96,323104
31583,0.002355,74.125.24.0-255,2902,230292,96,323104
31584,0.002368,74.125.24.0-255,2902,233194,96,323104
31585,0.002372,74.125.24.0-255,4320,237514,96,323104
31586,0.002385,74.125.24.0-255,7156,244670,96,323104
31587,0.006708,172.31.47.0-255,66,244736,96,323104
31588,0.009018,74.125.24.0-255,5738,250474,96,323104
31589,0.009024,172.31.47.0-255,66,250540,96,323104
31590,0.011359,74.125.24.0-255,5738,256278,96,323104
31591,0.011366,172.31.47.0-255,66,256344,96,323104
31592,0.013677,74.125.24.0-255,5738,262082,96,323104
31593,0.01414,172.31.47.0-255,66,262148,96,323104
31594,0.016437,74.125.24.0-255,5738,267886,96,323104
31595,0.016444,172.31.47.0-255,66,267952,96,323104
31596,0.018759,74.125.24.0-255,5738,273690,96,323104
31597,0.018766,172.31.47.0-255,66,273756,96,323104
31598,0.021049,74.125.24.0-255,5738,279494,96,323104
31599,0.021055,172.31.47.0-255,66,279560,96,323104
31600,0.023376,74.125.24.0-255,5738,285298,96,323104
31601,0.023383,172.31.47.0-255,66,285364,96,323104
31602,0.025703,74.125.24.0-255,5738,291102,96,323104
31603,0.025709,172.31.47.0-255,66,291168,96,323104
31604,0.028023,74.125.24.0-255,5738,296906,96,323104
31605,0.028029,172.31.47.0-255,66,296972,96,323104
31606,0.030347,74.125.24.0-255,5738,302710,96,323104
31607,0.030353,172.31.47.0-255,66,302776,96,323104
31608,0.030704,172.31.47.0-255,172,302948,96,323104
31609,0.030731,172.31.47.0-255,1109,304057,96,323104
31610,0.030774,172.31.47.0-255,1514,305571,96,323104
31611,0.030776,172.31.47.0-255,1302,306873,96,323104
31612,0.032254,104.244.42.0-255,66,306939,96,323104
31613,0.032425,104.244.42.0-255,66,307005,96,323104
31614,0.032427,104.244.42.0-255,66,307071,96,323104
31615,0.03267,74.125.24.0-255,1484,308555,96,323104
31616,0.032674,172.31.47.0-255,66,308621,96,323104
31617,0.032711,74.125.24.0-255,4320,312941,96,323104
31618,0.032734,172.31.47.0-255,66,313007,96,323104
31619,0.03498,74.125.24.0-255,1484,314491,96,323104
31620,0.035062,74.125.24.0-255,4320,318811,96,323104
31621,0.035525,172.31.47.0-255,66,318877,96,323104
31622,0.037809,74.125.24.0-255,3990,322867,96,323104
31623,0.037814,172.31.47.0-255,66,322933,96,323104
31624,0.038014,172.31.47.0-255,105,323038,96,323104
31625,0.040288,74.125.24.0-255,66,323104,96,323104
31626,0.0,74.125.200.0-255,153,153,96,368559
31627,3e-05,172.31.47.0-255,66,219,96,368559
31628,3.6e-05,74.125.200.0-255,1484,1703,96,368559
31629,4e-05,172.31.47.0-255,66,1769,96,368559
31630,7.4e-05,74.125.200.0-255,2902,4671,96,368559
31631,7.7e-05,172.31.47.0-255,66,4737,96,368559
31632,8e-05,74.125.200.0-255,1484,6221,96,368559
31633,8.2e-05,172.31.47.0-255,66,6287,96,368559
31634,0.000102,74.125.200.0-255,5738,12025,96,368559
31635,0.000104,172.31.47.0-255,66,12091,96,368559
31636,0.000107,74.125.200.0-255,2064,14155,96,368559
31637,0.000114,172.31.47.0-255,66,14221,96,368559
31638,0.000184,74.125.200.0-255,1484,15705,96,368559
31639,0.000188,172.31.47.0-255,66,15771,96,368559
31640,0.000213,74.125.200.0-255,2902,18673,96,368559
31641,0.000215,172.31.47.0-255,66,18739,96,368559
31642,0.00024,74.125.200.0-255,4320,23059,96,368559
31643,0.000244,172.31.47.0-255,66,23125,96,368559
31644,0.000268,74.125.200.0-255,4320,27445,96,368559
31645,0.000271,172.31.47.0-255,66,27511,96,368559
31646,0.00029,74.125.200.0-255,2902,30413,96,368559
31647,0.000293,172.31.47.0-255,66,30479,96,368559
31648,0.00031,74.125.200.0-255,1125,31604,96,368559
31649,0.000312,172.31.47.0-255,66,31670,96,368559
31650,0.000391,74.125.200.0-255,1484,33154,96,368559
31651,0.000394,172.31.47.0-255,66,33220,96,368559
31652,0.000398,74.125.200.0-255,1484,34704,96,368559
31653,0.0004,172.31.47.0-255,66,34770,96,368559
31654,0.000419,74.125.200.0-255,1484,36254,96,368559
31655,0.000421,172.31.47.0-255,66,36320,96,368559
31656,0.00044,74.125.200.0-255,4320,40640,96,368559
31657,0.000442,172.31.47.0-255,66,40706,96,368559
31658,0.000445,74.125.200.0-255,1484,42190,96,368559
31659,0.000459,74.125.200.0-255,4320,46510,96,368559
31660,0.000461,172.31.47.0-255,66,46576,96,368559
31661,0.000469,74.125.200.0-255,1484,48060,96,368559
31662,0.00049,74.125.200.0-255,1125,49185,96,368559
31663,0.000493,172.31.47.0-255,66,49251,96,368559
31664,0.000637,74.125.200.0-255,1484,50735,96,368559
31665,0.000657,74.125.200.0-255,1484,52219,96,368559
31666,0.00066,172.31.47.0-255,66,52285,96,368559
31667,0.000672,74.125.200.0-255,1484,53769,96,368559
31668,0.000682,74.125.200.0-255,4320,58089,96,368559
31669,0.000684,172.31.47.0-255,66,58155,96,368559
31670,0.000689,74.125.200.0-255,4320,62475,96,368559
31671,0.000691,172.31.47.0-255,66,62541,96,368559
31672,0.000714,74.125.200.0-255,1484,64025,96,368559
31673,0.000732,74.125.200.0-255,2877,66902,96,368559
31674,0.000736,172.31.47.0-255,66,66968,96,368559
31675,0.00084,74.125.200.0-255,110,67078,96,368559
31676,0.000852,74.125.200.0-255,329,67407,96,368559
31677,0.001219,74.125.200.0-255,1484,68891,96,368559
31678,0.001224,172.31.47.0-255,66,68957,96,368559
31679,0.001249,74.125.200.0-255,2902,71859,96,368559
31680,0.00125,172.31.47.0-255,66,71925,96,368559
31681,0.001256,74.125.200.0-255,4320,76245,96,368559
31682,0.001257,172.31.47.0-255,66,76311,96,368559
31683,0.001281,74.125.200.0-255,1484,77795,96,368559
31684,0.001294,74.125.200.0-255,2902,80697,96,368559
31685,0.001295,172.31.47.0-255,66,80763,96,368559
31686,0.001319,74.125.200.0-255,3961,84724,96,368559
31687,0.001321,172.31.47.0-255,66,84790,96,368559
31688,0.001484,74.125.200.0-255,1484,86274,96,368559
31689,0.001512,74.125.200.0-255,2902,89176,96,368559
31690,0.001514,172.31.47.0-255,66,89242,96,368559
31691,0.001516,74.125.200.0-255,1484,90726,96,368559
31692,0.001536,74.125.200.0-255,1484,92210,96,368559
31693,0.001538,172.31.47.0-255,66,92276,96,368559
31694,0.001562,74.125.200.0-255,5738,98014,96,368559
31695,0.001564,172.31.47.0-255,66,98080,96,368559
31696,0.001583,74.125.200.0-255,1484,99564,96,368559
31697,0.001595,74.125.200.0-255,1484,101048,96,368559
31698,0.001596,172.31.47.0-255,66,101114,96,368559
31699,0.001609,74.125.200.0-255,5738,106852,96,368559
31700,0.001611,172.31.47.0-255,66,106918,96,368559
31701,0.001652,172.31.47.0-255,66,106984,96,368559
31702,0.001656,74.125.200.0-255,3602,110586,96,368559
31703,0.001658,172.31.47.0-255,66,110652,96,368559
31704,0.001675,74.125.200.0-255,1484,112136,96,368559
31705,0.001697,74.125.200.0-255,2902,115038,96,368559
31706,0.001699,172.31.47.0-255,66,115104,96,368559
31707,0.001718,74.125.200.0-255,1484,116588,96,368559
31708,0.001732,74.125.200.0-255,2902,119490,96,368559
31709,0.001734,172.31.47.0-255,66,119556,96,368559
31710,0.001785,74.125.200.0-255,2902,122458,96,368559
31711,0.001787,172.31.47.0-255,66,122524,96,368559
31712,0.001807,74.125.200.0-255,2902,125426,96,368559
31713,0.001809,172.31.47.0-255,66,125492,96,368559
31714,0.001814,74.125.200.0-255,5738,131230,96,368559
31715,0.001816,172.31.47.0-255,66,131296,96,368559
31716,0.001836,74.125.200.0-255,4320,135616,96,368559
31717,0.001838,172.31.47.0-255,66,135682,96,368559
31718,0.001842,74.125.200.0-255,2902,138584,96,368559
31719,0.001843,172.31.47.0-255,66,138650,96,368559
31720,0.001876,74.125.200.0-255,6438,145088,96,368559
31721,0.001878,172.31.47.0-255,66,145154,96,368559
31722,0.001898,74.125.200.0-255,1484,146638,96,368559
31723,0.001912,74.125.200.0-255,2902,149540,96,368559
31724,0.001914,172.31.47.0-255,66,149606,96,368559
31725,0.00194,74.125.200.0-255,2902,152508,96,368559
31726,0.001942,172.31.47.0-255,66,152574,96,368559
31727,0.001967,74.125.200.0-255,2902,155476,96,368559
31728,0.001969,172.31.47.0-255,66,155542,96,368559
31729,0.001983,74.125.200.0-255,7156,162698,96,368559
31730,0.001985,172.31.47.0-255,66,162764,96,368559
31731,0.001993,74.125.200.0-255,5738,168502,96,368559
31732,0.001995,172.31.47.0-255,66,168568,96,368559
31733,0.001998,74.125.200.0-255,2902,171470,96,368559
31734,0.002,172.31.47.0-255,66,171536,96,368559
31735,0.002028,74.125.200.0-255,4320,175856,96,368559
31736,0.00203,172.31.47.0-255,66,175922,96,368559
31737,0.002034,74.125.200.0-255,3602,179524,96,368559
31738,0.002036,172.31.47.0-255,66,179590,96,368559
31739,0.004009,74.125.200.0-255,1484,181074,96,368559
31740,0.004022,74.125.200.0-255,2902,183976,96,368559
31741,0.004025,172.31.47.0-255,66,184042,96,368559
31742,0.004047,74.125.200.0-255,1484,185526,96,368559
31743,0.006023,74.125.200.0-255,4320,189846,96,368559
31744,0.00603,172.31.47.0-255,66,189912,96,368559
31745,0.008037,74.125.200.0-255,5738,195650,96,368559
31746,0.008043,172.31.47.0-255,66,195716,96,368559
31747,0.01005,74.125.200.0-255,5738,201454,96,368559
31748,0.010057,172.31.47.0-255,66,201520,96,368559
31749,0.012063,74.125.200.0-255,5738,207258,96,368559
31750,0.01207,172.31.47.0-255,66,207324,96,368559
31751,0.014079,74.125.200.0-255,5738,213062,96,368559
31752,0.014086,172.31.47.0-255,66,213128,96,368559
31753,0.016079,74.125.200.0-255,4320,217448,96,368559
31754,0.016085,172.31.47.0-255,66,217514,96,368559
31755,0.016109,74.125.200.0-255,1484,218998,96,368559
31756,0.018086,74.125.200.0-255,4320,223318,96,368559
31757,0.018092,172.31.47.0-255,66,223384,96,368559
31758,0.020094,74.125.200.0-255,5738,229122,96,368559
31759,0.0201,172.31.47.0-255,66,229188,96,368559
31760,0.022106,74.125.200.0-255,5738,234926,96,368559
31761,0.022113,172.31.47.0-255,66,234992,96,368559
31762,0.024125,74.125.200.0-255,5738,240730,96,368559
31763,0.024137,172.31.47.0-255,66,240796,96,368559
31764,0.026151,74.125.200.0-255,5738,246534,96,368559
31765,0.026156,172.31.47.0-255,66,246600,96,368559
31766,0.027632,172.31.47.0-255,172,246772,96,368559
31767,0.027663,172.31.47.0-255,1105,247877,96,368559
31768,0.027689,172.31.47.0-255,1514,249391,96,368559
31769,0.02769,172.31.47.0-255,1306,250697,96,368559
31770,0.028155,74.125.200.0-255,5738,256435,96,368559
31771,0.028161,172.31.47.0-255,66,256501,96,368559
31772,0.029197,104.244.42.0-255,66,256567,96,368559
31773,0.029237,104.244.42.0-255,66,256633,96,368559
31774,0.02924,104.244.42.0-255,66,256699,96,368559
31775,0.030161,74.125.200.0-255,5738,262437,96,368559
31776,0.030165,172.31.47.0-255,66,262503,96,368559
31777,0.032184,74.125.200.0-255,5738,268241,96,368559
31778,0.032195,172.31.47.0-255,66,268307,96,368559
31779,0.034209,74.125.200.0-255,5738,274045,96,368559
31780,0.034219,172.31.47.0-255,66,274111,96,368559
31781,0.036233,74.125.200.0-255,5738,279849,96,368559
31782,0.036243,172.31.47.0-255,66,279915,96,368559
31783,0.038251,74.125.200.0-255,4320,284235,96,368559
31784,0.038263,172.31.47.0-255,66,284301,96,368559
31785,0.038297,74.125.200.0-255,1484,285785,96,368559
31786,0.040256,74.125.200.0-255,4320,290105,96,368559
31787,0.04026,172.31.47.0-255,66,290171,96,368559
31788,0.042267,74.125.200.0-255,4320,294491,96,368559
31789,0.042271,172.31.47.0-255,66,294557,96,368559
31790,0.042298,74.125.200.0-255,1484,296041,96,368559
31791,0.044278,74.125.200.0-255,4320,300361,96,368559
31792,0.044282,172.31.47.0-255,66,300427,96,368559
31793,0.046282,74.125.200.0-255,4320,304747,96,368559
31794,0.046286,172.31.47.0-255,66,304813,96,368559
31795,0.046315,74.125.200.0-255,1484,306297,96,368559
31796,0.048288,74.125.200.0-255,2902,309199,96,368559
31797,0.048293,172.31.47.0-255,66,309265,96,368559
31798,0.048322,74.125.200.0-255,1484,310749,96,368559
31799,0.050308,74.125.200.0-255,4320,315069,96,368559
31800,0.050312,172.31.47.0-255,66,315135,96,368559
31801,0.05231,74.125.200.0-255,2902,318037,96,368559
31802,0.052315,172.31.47.0-255,66,318103,96,368559
31803,0.052344,74.125.200.0-255,2902,321005,96,368559
31804,0.052347,172.31.47.0-255,66,321071,96,368559
31805,0.054317,74.125.200.0-255,2902,323973,96,368559
31806,0.054321,172.31.47.0-255,66,324039,96,368559
31807,0.054352,74.125.200.0-255,2902,326941,96,368559
31808,0.054355,172.31.47.0-255,66,327007,96,368559
31809,0.056316,74.125.200.0-255,2902,329909,96,368559
31810,0.05632,172.31.47.0-255,66,329975,96,368559
31811,0.056356,74.125.200.0-255,2902,332877,96,368559
31812,0.05636,172.31.47.0-255,66,332943,96,368559
31813,0.058319,74.125.200.0-255,2902,335845,96,368559
31814,0.058324,172.31.47.0-255,66,335911,96,368559
31815,0.058355,74.125.200.0-255,2902,338813,96,368559
31816,0.058358,172.31.47.0-255,66,338879,96,368559
31817,0.060322,74.125.200.0-255,2902,341781,96,368559
31818,0.060326,172.31.47.0-255,66,341847,96,368559
31819,0.060357,74.125.200.0-255,2902,344749,96,368559
31820,0.06036,172.31.47.0-255,66,344815,96,368559
31821,0.062341,74.125.200.0-255,2902,347717,96,368559
31822,0.062347,172.31.47.0-255,66,347783,96,368559
31823,0.062372,74.125.200.0-255,2902,350685,96,368559
31824,0.062374,172.31.47.0-255,66,350751,96,368559
31825,0.064345,74.125.200.0-255,2902,353653,96,368559
31826,0.06435,172.31.47.0-255,66,353719,96,368559
31827,0.064379,74.125.200.0-255,2902,356621,96,368559
31828,0.064381,172.31.47.0-255,66,356687,96,368559
31829,0.06635,74.125.200.0-255,2902,359589,96,368559
31830,0.066355,172.31.47.0-255,66,359655,96,368559
31831,0.066387,74.125.200.0-255,2902,362557,96,368559
31832,0.06639,172.31.47.0-255,66,362623,96,368559
31833,0.068345,74.125.200.0-255,2902,365525,96,368559
31834,0.06835,172.31.47.0-255,66,365591,96,368559
31835,0.068381,74.125.200.0-255,2902,368493,96,368559
31836,0.068384,172.31.47.0-255,66,368559,96,368559
31837,0.0,74.125.130.0-255,152,152,96,295752
31838,1.9e-05,172.31.47.0-255,66,218,96,295752
31839,2.7e-05,74.125.130.0-255,1484,1702,96,295752
31840,3.2e-05,172.31.47.0-255,66,1768,96,295752
31841,3.5e-05,74.125.130.0-255,1484,3252,96,295752
31842,3.8e-05,172.31.47.0-255,66,3318,96,295752
31843,7.5e-05,74.125.130.0-255,2902,6220,96,295752
31844,7.8e-05,172.31.47.0-255,66,6286,96,295752
31845,9e-05,74.125.130.0-255,5738,12024,96,295752
31846,9.2e-05,172.31.47.0-255,66,12090,96,295752
31847,9.6e-05,74.125.130.0-255,1484,13574,96,295752
31848,9.8e-05,172.31.47.0-255,66,13640,96,295752
31849,0.000133,74.125.130.0-255,2252,15892,96,295752
31850,0.000137,172.31.47.0-255,66,15958,96,295752
31851,0.000143,74.125.130.0-255,5738,21696,96,295752
31852,0.000145,172.31.47.0-255,66,21762,96,295752
31853,0.000148,74.125.130.0-255,2902,24664,96,295752
31854,0.00015,172.31.47.0-255,66,24730,96,295752
31855,0.000179,74.125.130.0-255,4320,29050,96,295752
31856,0.000187,172.31.47.0-255,66,29116,96,295752
31857,0.000213,74.125.130.0-255,2543,31659,96,295752
31858,0.000216,172.31.47.0-255,66,31725,96,295752
31859,0.000381,74.125.130.0-255,1484,33209,96,295752
31860,0.000388,172.31.47.0-255,66,33275,96,295752
31861,0.000394,74.125.130.0-255,2902,36177,96,295752
31862,0.000396,172.31.47.0-255,66,36243,96,295752
31863,0.000407,74.125.130.0-255,5738,41981,96,295752
31864,0.00041,172.31.47.0-255,66,42047,96,295752
31865,0.000439,74.125.130.0-255,6797,48844,96,295752
31866,0.000442,172.31.47.0-255,66,48910,96,295752
31867,0.0006,74.125.130.0-255,1484,50394,96,295752
31868,0.000606,172.31.47.0-255,66,50460,96,295752
31869,0.000613,74.125.130.0-255,2902,53362,96,295752
31870,0.000615,172.31.47.0-255,66,53428,96,295752
31871,0.000627,74.125.130.0-255,2902,56330,96,295752
31872,0.00063,172.31.47.0-255,66,56396,96,295752
31873,0.000663,74.125.130.0-255,2902,59298,96,295752
31874,0.000667,172.31.47.0-255,66,59364,96,295752
31875,0.000675,74.125.130.0-255,6797,66161,96,295752
31876,0.000677,172.31.47.0-255,66,66227,96,295752
31877,0.000825,74.125.130.0-255,646,66873,96,295752
31878,0.001158,172.31.47.0-255,66,66939,96,295752
31879,0.001258,74.125.130.0-255,1484,68423,96,295752
31880,0.001264,74.125.130.0-255,1484,69907,96,295752
31881,0.001267,172.31.47.0-255,66,69973,96,295752
31882,0.001293,74.125.130.0-255,1484,71457,96,295752
31883,0.001296,74.125.130.0-255,1484,72941,96,295752
31884,0.001297,172.31.47.0-255,66,73007,96,295752
31885,0.001323,74.125.130.0-255,4320,77327,96,295752
31886,0.001325,172.31.47.0-255,66,77393,96,295752
31887,0.001328,74.125.130.0-255,1484,78877,96,295752
31888,0.001331,74.125.130.0-255,2902,81779,96,295752
31889,0.001332,172.31.47.0-255,66,81845,96,295752
31890,0.001358,74.125.130.0-255,4320,86165,96,295752
31891,0.00136,172.31.47.0-255,66,86231,96,295752
31892,0.001369,74.125.130.0-255,1484,87715,96,295752
31893,0.001398,74.125.130.0-255,2902,90617,96,295752
31894,0.0014,172.31.47.0-255,66,90683,96,295752
31895,0.001425,74.125.130.0-255,4320,95003,96,295752
31896,0.001427,172.31.47.0-255,66,95069,96,295752
31897,0.001433,74.125.130.0-255,6438,101507,96,295752
31898,0.001434,172.31.47.0-255,66,101573,96,295752
31899,0.002155,74.125.130.0-255,1484,103057,96,295752
31900,0.002186,74.125.130.0-255,1484,104541,96,295752
31901,0.002189,172.31.47.0-255,66,104607,96,295752
31902,0.002211,74.125.130.0-255,2902,107509,96,295752
31903,0.002213,172.31.47.0-255,66,107575,96,295752
31904,0.002234,74.125.130.0-255,1484,109059,96,295752
31905,0.002252,74.125.130.0-255,1484,110543,96,295752
31906,0.002254,172.31.47.0-255,66,110609,96,295752
31907,0.002273,74.125.130.0-255,1484,112093,96,295752
31908,0.002297,74.125.130.0-255,2902,114995,96,295752
31909,0.002299,172.31.47.0-255,66,115061,96,295752
31910,0.00231,74.125.130.0-255,2902,117963,96,295752
31911,0.002315,172.31.47.0-255,66,118029,96,295752
31912,0.002349,74.125.130.0-255,5738,123767,96,295752
31913,0.002352,172.31.47.0-255,66,123833,96,295752
31914,0.004652,74.125.130.0-255,5738,129571,96,295752
31915,0.004657,172.31.47.0-255,66,129637,96,295752
31916,0.006971,74.125.130.0-255,5738,135375,96,295752
31917,0.006977,172.31.47.0-255,66,135441,96,295752
31918,0.0093,74.125.130.0-255,5738,141179,96,295752
31919,0.009307,172.31.47.0-255,66,141245,96,295752
31920,0.011634,74.125.130.0-255,5738,146983,96,295752
31921,0.011644,172.31.47.0-255,66,147049,96,295752
31922,0.013941,74.125.130.0-255,5738,152787,96,295752
31923,0.013952,172.31.47.0-255,66,152853,96,295752
31924,0.016254,74.125.130.0-255,5738,158591,96,295752
31925,0.016262,172.31.47.0-255,66,158657,96,295752
31926,0.018569,74.125.130.0-255,4320,162977,96,295752
31927,0.018576,172.31.47.0-255,66,163043,96,295752
31928,0.018602,74.125.130.0-255,1484,164527,96,295752
31929,0.02096,74.125.130.0-255,4320,168847,96,295752
31930,0.020967,172.31.47.0-255,66,168913,96,295752
31931,0.023255,74.125.130.0-255,5738,174651,96,295752
31932,0.023262,172.31.47.0-255,66,174717,96,295752
31933,0.024801,172.31.47.0-255,172,174889,96,295752
31934,0.024829,172.31.47.0-255,1105,175994,96,295752
31935,0.024861,172.31.47.0-255,1514,177508,96,295752
31936,0.024863,172.31.47.0-255,1306,178814,96,295752
31937,0.025551,74.125.130.0-255,5738,184552,96,295752
31938,0.025556,172.31.47.0-255,66,184618,96,295752
31939,0.026335,104.244.42.0-255,66,184684,96,295752
31940,0.026369,104.244.42.0-255,66,184750,96,295752
31941,0.026421,104.244.42.0-255,66,184816,96,295752
31942,0.02784,74.125.130.0-255,5738,190554,96,295752
31943,0.027846,172.31.47.0-255,66,190620,96,295752
31944,0.030127,74.125.130.0-255,2902,193522,96,295752
31945,0.030132,172.31.47.0-255,66,193588,96,295752
31946,0.030161,74.125.130.0-255,2902,196490,96,295752
31947,0.030165,172.31.47.0-255,66,196556,96,295752
31948,0.032435,74.125.130.0-255,5738,202294,96,295752
31949,0.03244,172.31.47.0-255,66,202360,96,295752
31950,0.034721,74.125.130.0-255,5738,208098,96,295752
31951,0.034726,172.31.47.0-255,66,208164,96,295752
31952,0.03701,74.125.130.0-255,5738,213902,96,295752
31953,0.037014,172.31.47.0-255,66,213968,96,295752
31954,0.039313,74.125.130.0-255,5738,219706,96,295752
31955,0.039318,172.31.47.0-255,66,219772,96,295752
31956,0.041604,74.125.130.0-255,5738,225510,96,295752
31957,0.04161,172.31.47.0-255,66,225576,96,295752
31958,0.043909,74.125.130.0-255,2902,228478,96,295752
31959,0.043915,172.31.47.0-255,66,228544,96,295752
31960,0.043959,74.125.130.0-255,2902,231446,96,295752
31961,0.043963,172.31.47.0-255,66,231512,96,295752
31962,0.046221,74.125.130.0-255,2902,234414,96,295752
31963,0.046225,172.31.47.0-255,66,234480,96,295752
31964,0.046254,74.125.130.0-255,2902,237382,96,295752
31965,0.046256,172.31.47.0-255,66,237448,96,295752
31966,0.048523,74.125.130.0-255,1484,238932,96,295752
31967,0.048552,74.125.130.0-255,4320,243252,96,295752
31968,0.048556,172.31.47.0-255,66,243318,96,295752
31969,0.050849,74.125.130.0-255,5738,249056,96,295752
31970,0.050854,172.31.47.0-255,66,249122,96,295752
31971,0.053179,74.125.130.0-255,5738,254860,96,295752
31972,0.053186,172.31.47.0-255,66,254926,96,295752
31973,0.055489,74.125.130.0-255,5738,260664,96,295752
31974,0.055499,172.31.47.0-255,66,260730,96,295752
31975,0.057802,74.125.130.0-255,5738,266468,96,295752
31976,0.057809,172.31.47.0-255,66,266534,96,295752
31977,0.060096,74.125.130.0-255,1484,268018,96,295752
31978,0.060134,74.125.130.0-255,4320,272338,96,295752
31979,0.060139,172.31.47.0-255,66,272404,96,295752
31980,0.062424,74.125.130.0-255,1484,273888,96,295752
31981,0.062453,74.125.130.0-255,4320,278208,96,295752
31982,0.062457,172.31.47.0-255,66,278274,96,295752
31983,0.06474,74.125.130.0-255,1484,279758,96,295752
31984,0.064771,74.125.130.0-255,4320,284078,96,295752
31985,0.064775,172.31.47.0-255,66,284144,96,295752
31986,0.067061,74.125.130.0-255,5738,289882,96,295752
31987,0.067066,172.31.47.0-255,66,289948,96,295752
31988,0.069355,74.125.130.0-255,5738,295686,96,295752
31989,0.06936,172.31.47.0-255,66,295752,96,295752
31990,0.0,172.217.24.0-255,152,152,96,325682
31991,1.5e-05,172.31.47.0-255,66,218,96,325682
31992,2.2e-05,172.217.24.0-255,1484,1702,96,325682
31993,2.7e-05,172.31.47.0-255,66,1768,96,325682
31994,4e-05,172.217.24.0-255,2902,4670,96,325682
31995,4.3e-05,172.31.47.0-255,66,4736,96,325682
31996,5.1e-05,172.217.24.0-255,7156,11892,96,325682
31997,5.4e-05,172.31.47.0-255,66,11958,96,325682
31998,9.6e-05,172.31.47.0-255,66,12024,96,325682
31999,0.000127,172.217.24.0-255,2127,14151,96,325682
32000,0.00013,172.31.47.0-255,66,14217,96,325682
32001,0.000135,172.217.24.0-255,3961,18178,96,325682
32002,0.000138,172.31.47.0-255,66,18244,96,325682
32003,0.000141,172.217.24.0-255,1484,19728,96,325682
32004,0.000148,172.31.47.0-255,66,19794,96,325682
32005,0.000184,172.217.24.0-255,2902,22696,96,325682
32006,0.000186,172.31.47.0-255,66,22762,96,325682
32007,0.000194,172.217.24.0-255,5738,28500,96,325682
32008,0.000197,172.31.47.0-255,66,28566,96,325682
32009,0.000208,172.217.24.0-255,6797,35363,96,325682
32010,0.000211,172.31.47.0-255,66,35429,96,325682
32011,0.000429,172.217.24.0-255,1484,36913,96,325682
32012,0.000433,172.31.47.0-255,66,36979,96,325682
32013,0.000439,172.217.24.0-255,2902,39881,96,325682
32014,0.000442,172.31.47.0-255,66,39947,96,325682
32015,0.000462,172.217.24.0-255,5738,45685,96,325682
32016,0.000465,172.31.47.0-255,66,45751,96,325682
32017,0.000471,172.217.24.0-255,6797,52548,96,325682
32018,0.000473,172.31.47.0-255,66,52614,96,325682
32019,0.000494,172.217.24.0-255,392,53006,96,325682
32020,0.000497,172.31.47.0-255,66,53072,96,325682
32021,0.000844,172.217.24.0-255,351,53423,96,325682
32022,0.000934,172.31.47.0-255,66,53489,96,325682
32023,0.001061,172.217.24.0-255,1484,54973,96,325682
32024,0.00107,172.217.24.0-255,2902,57875,96,325682
32025,0.001073,172.31.47.0-255,66,57941,96,325682
32026,0.00108,172.217.24.0-255,5738,63679,96,325682
32027,0.001082,172.31.47.0-255,66,63745,96,325682
32028,0.001113,172.31.47.0-255,66,63811,96,325682
32029,0.001143,172.217.24.0-255,5379,69190,96,325682
32030,0.001146,172.31.47.0-255,66,69256,96,325682
32031,0.001155,172.31.47.0-255,66,69322,96,325682
32032,0.001161,172.217.24.0-255,1125,70447,96,325682
32033,0.001404,172.217.24.0-255,1484,71931,96,325682
32034,0.001409,172.31.47.0-255,66,71997,96,325682
32035,0.001415,172.217.24.0-255,2902,74899,96,325682
32036,0.001417,172.31.47.0-255,66,74965,96,325682
32037,0.001422,172.217.24.0-255,4320,79285,96,325682
32038,0.001423,172.31.47.0-255,66,79351,96,325682
32039,0.001465,172.31.47.0-255,66,79417,96,325682
32040,0.00147,172.217.24.0-255,4320,83737,96,325682
32041,0.001472,172.31.47.0-255,66,83803,96,325682
32042,0.001511,172.31.47.0-255,66,83869,96,325682
32043,0.001531,172.217.24.0-255,1484,85353,96,325682
32044,0.001535,172.217.24.0-255,2902,88255,96,325682
32045,0.001538,172.31.47.0-255,66,88321,96,325682
32046,0.001567,172.217.24.0-255,5738,94059,96,325682
32047,0.001569,172.31.47.0-255,66,94125,96,325682
32048,0.001579,172.31.47.0-255,66,94191,96,325682
32049,0.001605,172.217.24.0-255,4320,98511,96,325682
32050,0.001623,172.217.24.0-255,4320,102831,96,325682
32051,0.001644,172.217.24.0-255,6438,109269,96,325682
32052,0.001789,172.217.24.0-255,1484,110753,96,325682
32053,0.001796,172.217.24.0-255,2902,113655,96,325682
32054,0.0018,172.217.24.0-255,2902,116557,96,325682
32055,0.001814,172.217.24.0-255,2902,119459,96,325682
32056,0.001827,172.217.24.0-255,5738,125197,96,325682
32057,0.001852,172.217.24.0-255,4320,129517,96,325682
32058,0.001872,172.217.24.0-255,2184,131701,96,325682
32059,0.004991,172.31.47.0-255,66,131767,96,325682
32060,0.006928,172.217.24.0-255,5738,137505,96,325682
32061,0.006933,172.31.47.0-255,66,137571,96,325682
32062,0.008839,172.217.24.0-255,5738,143309,96,325682
32063,0.008846,172.31.47.0-255,66,143375,96,325682
32064,0.010741,172.217.24.0-255,5738,149113,96,325682
32065,0.01075,172.31.47.0-255,66,149179,96,325682
32066,0.012666,172.217.24.0-255,5738,154917,96,325682
32067,0.012679,172.31.47.0-255,66,154983,96,325682
32068,0.014592,172.217.24.0-255,5738,160721,96,325682
32069,0.014607,172.31.47.0-255,66,160787,96,325682
32070,0.01651,172.217.24.0-255,2902,163689,96,325682
32071,0.01652,172.31.47.0-255,66,163755,96,325682
32072,0.016547,172.217.24.0-255,2902,166657,96,325682
32073,0.01655,172.31.47.0-255,66,166723,96,325682
32074,0.01842,172.217.24.0-255,2902,169625,96,325682
32075,0.018432,172.31.47.0-255,66,169691,96,325682
32076,0.018466,172.217.24.0-255,2902,172593,96,325682
32077,0.018469,172.31.47.0-255,66,172659,96,325682
32078,0.020334,172.217.24.0-255,2902,175561,96,325682
32079,0.020341,172.31.47.0-255,66,175627,96,325682
32080,0.020371,172.217.24.0-255,2902,178529,96,325682
32081,0.020374,172.31.47.0-255,66,178595,96,325682
32082,0.02224,172.217.24.0-255,2902,181497,96,325682
32083,0.022246,172.31.47.0-255,66,181563,96,325682
32084,0.02228,172.217.24.0-255,2902,184465,96,325682
32085,0.022283,172.31.47.0-255,66,184531,96,325682
32086,0.024144,172.217.24.0-255,2902,187433,96,325682
32087,0.024153,172.31.47.0-255,66,187499,96,325682
32088,0.024189,172.217.24.0-255,2902,190401,96,325682
32089,0.024192,172.31.47.0-255,66,190467,96,325682
32090,0.026053,172.217.24.0-255,2902,193369,96,325682
32091,0.02606,172.31.47.0-255,66,193435,96,325682
32092,0.026091,172.217.24.0-255,2902,196337,96,325682
32093,0.026094,172.31.47.0-255,66,196403,96,325682
32094,0.02751,172.31.47.0-255,172,196575,96,325682
32095,0.027542,172.31.47.0-255,1109,197684,96,325682
32096,0.0276,172.31.47.0-255,1514,199198,96,325682
32097,0.027602,172.31.47.0-255,1302,200500,96,325682
32098,0.028,172.217.24.0-255,4320,204820,96,325682
32099,0.028007,172.31.47.0-255,66,204886,96,325682
32100,0.028035,172.217.24.0-255,1484,206370,96,325682
32101,0.029058,104.244.42.0-255,66,206436,96,325682
32102,0.029093,104.244.42.0-255,66,206502,96,325682
32103,0.029141,104.244.42.0-255,66,206568,96,325682
32104,0.029899,172.217.24.0-255,4320,210888,96,325682
32105,0.029905,172.31.47.0-255,66,210954,96,325682
32106,0.031803,172.217.24.0-255,5738,216692,96,325682
32107,0.03181,172.31.47.0-255,66,216758,96,325682
32108,0.033725,172.217.24.0-255,5738,222496,96,325682
32109,0.033732,172.31.47.0-255,66,222562,96,325682
32110,0.035621,172.217.24.0-255,5738,228300,96,325682
32111,0.035627,172.31.47.0-255,66,228366,96,325682
32112,0.037574,172.217.24.0-255,5738,234104,96,325682
32113,0.037579,172.31.47.0-255,66,234170,96,325682
32114,0.039482,172.217.24.0-255,5738,239908,96,325682
32115,0.03949,172.31.47.0-255,66,239974,96,325682
32116,0.041391,172.217.24.0-255,5738,245712,96,325682
32117,0.041396,172.31.47.0-255,66,245778,96,325682
32118,0.04331,172.217.24.0-255,5738,251516,96,325682
32119,0.043316,172.31.47.0-255,66,251582,96,325682
32120,0.045223,172.217.24.0-255,4320,255902,96,325682
32121,0.045229,172.31.47.0-255,66,255968,96,325682
32122,0.045255,172.217.24.0-255,1484,257452,96,325682
32123,0.047121,172.217.24.0-255,4320,261772,96,325682
32124,0.047127,172.31.47.0-255,66,261838,96,325682
32125,0.049026,172.217.24.0-255,5738,267576,96,325682
32126,0.049032,172.31.47.0-255,66,267642,96,325682
32127,0.050926,172.217.24.0-255,5738,273380,96,325682
32128,0.050932,172.31.47.0-255,66,273446,96,325682
32129,0.052826,172.217.24.0-255,5738,279184,96,325682
32130,0.052833,172.31.47.0-255,66,279250,96,325682
32131,0.054748,172.217.24.0-255,5738,284988,96,325682
32132,0.054753,172.31.47.0-255,66,285054,96,325682
32133,0.056653,172.217.24.0-255,5738,290792,96,325682
32134,0.056659,172.31.47.0-255,66,290858,96,325682
32135,0.058558,172.217.24.0-255,5738,296596,96,325682
32136,0.058563,172.31.47.0-255,66,296662,96,325682
32137,0.06046,172.217.24.0-255,5738,302400,96,325682
32138,0.060465,172.31.47.0-255,66,302466,96,325682
32139,0.062368,172.217.24.0-255,5738,308204,96,325682
32140,0.062374,172.31.47.0-255,66,308270,96,325682
32141,0.064267,172.217.24.0-255,5738,314008,96,325682
32142,0.064274,172.31.47.0-255,66,314074,96,325682
32143,0.06618,172.217.24.0-255,5738,319812,96,325682
32144,0.066187,172.31.47.0-255,66,319878,96,325682
32145,0.068093,172.217.24.0-255,5738,325616,96,325682
32146,0.0681,172.31.47.0-255,66,325682,96,325682
32147,0.0,74.125.200.0-255,153,153,96,252595
32148,1.6e-05,172.31.47.0-255,66,219,96,252595
32149,2.2e-05,74.125.200.0-255,1484,1703,96,252595
32150,2.7e-05,172.31.47.0-255,66,1769,96,252595
32151,3.9e-05,74.125.200.0-255,2902,4671,96,252595
32152,4.2e-05,172.31.47.0-255,66,4737,96,252595
32153,4.7e-05,74.125.200.0-255,4320,9057,96,252595
32154,5e-05,172.31.47.0-255,66,9123,96,252595
32155,7.8e-05,74.125.200.0-255,1484,10607,96,252595
32156,8.1e-05,172.31.47.0-255,66,10673,96,252595
32157,0.000105,74.125.200.0-255,3420,14093,96,252595
32158,0.000107,172.31.47.0-255,66,14159,96,252595
32159,0.000132,74.125.200.0-255,4320,18479,96,252595
32160,0.000134,172.31.47.0-255,66,18545,96,252595
32161,0.000137,74.125.200.0-255,1484,20029,96,252595
32162,0.000139,172.31.47.0-255,66,20095,96,252595
32163,0.00016,74.125.200.0-255,4320,24415,96,252595
32164,0.000162,172.31.47.0-255,66,24481,96,252595
32165,0.000167,74.125.200.0-255,4320,28801,96,252595
32166,0.000169,172.31.47.0-255,66,28867,96,252595
32167,0.00019,74.125.200.0-255,2543,31410,96,252595
32168,0.000192,172.31.47.0-255,66,31476,96,252595
32169,0.000277,74.125.200.0-255,1484,32960,96,252595
32170,0.000281,172.31.47.0-255,66,33026,96,252595
32171,0.000298,74.125.200.0-255,2902,35928,96,252595
32172,0.000301,172.31.47.0-255,66,35994,96,252595
32173,0.000326,74.125.200.0-255,4320,40314,96,252595
32174,0.000328,172.31.47.0-255,66,40380,96,252595
32175,0.000352,74.125.200.0-255,5738,46118,96,252595
32176,0.000355,172.31.47.0-255,66,46184,96,252595
32177,0.000378,74.125.200.0-255,2543,48727,96,252595
32178,0.00038,172.31.47.0-255,66,48793,96,252595
32179,0.000385,74.125.200.0-255,4320,53113,96,252595
32180,0.000387,172.31.47.0-255,66,53179,96,252595
32181,0.000416,74.125.200.0-255,4320,57499,96,252595
32182,0.000419,172.31.47.0-255,66,57565,96,252595
32183,0.000429,172.31.47.0-255,66,57631,96,252595
32184,0.000435,74.125.200.0-255,405,58036,96,252595
32185,0.000484,74.125.200.0-255,340,58376,96,252595
32186,0.000703,74.125.200.0-255,1484,59860,96,252595
32187,0.000707,172.31.47.0-255,66,59926,96,252595
32188,0.000712,74.125.200.0-255,2902,62828,96,252595
32189,0.000714,172.31.47.0-255,66,62894,96,252595
32190,0.000749,74.125.200.0-255,5738,68632,96,252595
32191,0.000753,172.31.47.0-255,66,68698,96,252595
32192,0.000786,172.31.47.0-255,66,68764,96,252595
32193,0.000798,172.31.47.0-255,66,68830,96,252595
32194,0.000805,74.125.200.0-255,2184,71014,96,252595
32195,0.000808,172.31.47.0-255,66,71080,96,252595
32196,0.001578,74.125.200.0-255,1484,72564,96,252595
32197,0.001586,74.125.200.0-255,2902,75466,96,252595
32198,0.00159,172.31.47.0-255,66,75532,96,252595
32199,0.001607,74.125.200.0-255,2902,78434,96,252595
32200,0.001609,172.31.47.0-255,66,78500,96,252595
32201,0.001643,74.125.200.0-255,2902,81402,96,252595
32202,0.001646,172.31.47.0-255,66,81468,96,252595
32203,0.001653,74.125.200.0-255,7156,88624,96,252595
32204,0.001654,172.31.47.0-255,66,88690,96,252595
32205,0.001677,172.31.47.0-255,66,88756,96,252595
32206,0.0017,74.125.200.0-255,2902,91658,96,252595
32207,0.001702,172.31.47.0-255,66,91724,96,252595
32208,0.001706,74.125.200.0-255,2902,94626,96,252595
32209,0.001708,172.31.47.0-255,66,94692,96,252595
32210,0.001729,74.125.200.0-255,766,95458,96,252595
32211,0.001757,74.125.200.0-255,4320,99778,96,252595
32212,0.001759,172.31.47.0-255,66,99844,96,252595
32213,0.001784,74.125.200.0-255,5738,105582,96,252595
32214,0.001786,172.31.47.0-255,66,105648,96,252595
32215,0.001796,74.125.200.0-255,1484,107132,96,252595
32216,0.001829,172.31.47.0-255,66,107198,96,252595
32217,0.001835,74.125.200.0-255,4320,111518,96,252595
32218,0.001837,172.31.47.0-255,66,111584,96,252595
32219,0.001864,74.125.200.0-255,2902,114486,96,252595
32220,0.001866,172.31.47.0-255,66,114552,96,252595
32221,0.001892,74.125.200.0-255,5020,119572,96,252595
32222,0.001894,172.31.47.0-255,66,119638,96,252595
32223,0.001955,74.125.200.0-255,1484,121122,96,252595
32224,0.001987,74.125.200.0-255,2902,124024,96,252595
32225,0.00199,172.31.47.0-255,66,124090,96,252595
32226,0.001996,74.125.200.0-255,5738,129828,96,252595
32227,0.001998,172.31.47.0-255,66,129894,96,252595
32228,0.002014,74.125.200.0-255,2902,132796,96,252595
32229,0.002016,172.31.47.0-255,66,132862,96,252595
32230,0.00205,172.31.47.0-255,66,132928,96,252595
32231,0.002053,74.125.200.0-255,1484,134412,96,252595
32232,0.002091,172.31.47.0-255,66,134478,96,252595
32233,0.002178,74.125.200.0-255,1484,135962,96,252595
32234,0.002185,74.125.200.0-255,2902,138864,96,252595
32235,0.002188,172.31.47.0-255,66,138930,96,252595
32236,0.002217,74.125.200.0-255,5738,144668,96,252595
32237,0.00222,172.31.47.0-255,66,144734,96,252595
32238,0.002223,74.125.200.0-255,1484,146218,96,252595
32239,0.002256,172.31.47.0-255,66,146284,96,252595
32240,0.002285,74.125.200.0-255,4320,150604,96,252595
32241,0.002287,172.31.47.0-255,66,150670,96,252595
32242,0.002294,74.125.200.0-255,5738,156408,96,252595
32243,0.002297,172.31.47.0-255,66,156474,96,252595
32244,0.002333,172.31.47.0-255,66,156540,96,252595
32245,0.002372,172.31.47.0-255,66,156606,96,252595
32246,0.002432,172.31.47.0-255,66,156672,96,252595
32247,0.00245,172.31.47.0-255,66,156738,96,252595
32248,0.002453,74.125.200.0-255,1484,158222,96,252595
32249,0.002484,172.31.47.0-255,66,158288,96,252595
32250,0.0025,74.125.200.0-255,1484,159772,96,252595
32251,0.002507,74.125.200.0-255,5738,165510,96,252595
32252,0.00251,172.31.47.0-255,66,165576,96,252595
32253,0.002543,172.31.47.0-255,66,165642,96,252595
32254,0.002582,172.31.47.0-255,66,165708,96,252595
32255,0.002593,172.31.47.0-255,66,165774,96,252595
32256,0.002601,74.125.200.0-255,2184,167958,96,252595
32257,0.002603,172.31.47.0-255,66,168024,96,252595
32258,0.00515,74.125.200.0-255,4320,172344,96,252595
32259,0.005154,172.31.47.0-255,66,172410,96,252595
32260,0.005177,74.125.200.0-255,1484,173894,96,252595
32261,0.007724,74.125.200.0-255,4320,178214,96,252595
32262,0.007735,172.31.47.0-255,66,178280,96,252595
32263,0.010318,74.125.200.0-255,5738,184018,96,252595
32264,0.010325,172.31.47.0-255,66,184084,96,252595
32265,0.012901,74.125.200.0-255,5738,189822,96,252595
32266,0.012909,172.31.47.0-255,66,189888,96,252595
32267,0.015486,74.125.200.0-255,5738,195626,96,252595
32268,0.015495,172.31.47.0-255,66,195692,96,252595
32269,0.01808,74.125.200.0-255,5738,201430,96,252595
32270,0.01809,172.31.47.0-255,66,201496,96,252595
32271,0.020658,74.125.200.0-255,5738,207234,96,252595
32272,0.020665,172.31.47.0-255,66,207300,96,252595
32273,0.023251,74.125.200.0-255,5738,213038,96,252595
32274,0.023258,172.31.47.0-255,66,213104,96,252595
32275,0.025829,74.125.200.0-255,5738,218842,96,252595
32276,0.025837,172.31.47.0-255,66,218908,96,252595
32277,0.028272,172.31.47.0-255,171,219079,96,252595
32278,0.028299,172.31.47.0-255,1134,220213,96,252595
32279,0.028353,172.31.47.0-255,1514,221727,96,252595
32280,0.028354,172.31.47.0-255,1277,223004,96,252595
32281,0.028403,74.125.200.0-255,4320,227324,96,252595
32282,0.028407,172.31.47.0-255,66,227390,96,252595
32283,0.028434,74.125.200.0-255,1484,228874,96,252595
32284,0.029829,104.244.42.0-255,66,228940,96,252595
32285,0.029852,104.244.42.0-255,66,229006,96,252595
32286,0.029886,104.244.42.0-255,66,229072,96,252595
32287,0.030974,74.125.200.0-255,4320,233392,96,252595
32288,0.030979,172.31.47.0-255,66,233458,96,252595
32289,0.033551,74.125.200.0-255,5738,239196,96,252595
32290,0.033558,172.31.47.0-255,66,239262,96,252595
32291,0.036136,74.125.200.0-255,5738,245000,96,252595
32292,0.036143,172.31.47.0-255,66,245066,96,252595
32293,0.038708,74.125.200.0-255,5738,250804,96,252595
32294,0.038715,172.31.47.0-255,66,250870,96,252595
32295,0.041292,74.125.200.0-255,1488,252358,96,252595
32296,0.041298,172.31.47.0-255,66,252424,96,252595
32297,0.041451,172.31.47.0-255,105,252529,96,252595
32298,0.043984,74.125.200.0-255,66,252595,96,252595
32299,0.0,74.125.24.0-255,152,152,96,329218
32300,2.1e-05,172.31.47.0-255,66,218,96,329218
32301,2.7e-05,74.125.24.0-255,1484,1702,96,329218
32302,3.1e-05,172.31.47.0-255,66,1768,96,329218
32303,3.5e-05,74.125.24.0-255,2902,4670,96,329218
32304,3.8e-05,172.31.47.0-255,66,4736,96,329218
32305,4.9e-05,74.125.24.0-255,4320,9056,96,329218
32306,5.2e-05,172.31.47.0-255,66,9122,96,329218
32307,8.6e-05,74.125.24.0-255,4320,13442,96,329218
32308,9.2e-05,172.31.47.0-255,66,13508,96,329218
32309,0.000115,74.125.24.0-255,711,14219,96,329218
32310,0.000117,172.31.47.0-255,66,14285,96,329218
32311,0.000122,74.125.24.0-255,5738,20023,96,329218
32312,0.000124,172.31.47.0-255,66,20089,96,329218
32313,0.000161,74.125.24.0-255,7156,27245,96,329218
32314,0.000163,172.31.47.0-255,66,27311,96,329218
32315,0.000187,74.125.24.0-255,3961,31272,96,329218
32316,0.000188,172.31.47.0-255,66,31338,96,329218
32317,0.000292,74.125.24.0-255,1484,32822,96,329218
32318,0.000296,172.31.47.0-255,66,32888,96,329218
32319,0.0003,74.125.24.0-255,2902,35790,96,329218
32320,0.000302,172.31.47.0-255,66,35856,96,329218
32321,0.000334,74.125.24.0-255,5738,41594,96,329218
32322,0.000336,172.31.47.0-255,66,41660,96,329218
32323,0.000369,172.31.47.0-255,66,41726,96,329218
32324,0.000374,74.125.24.0-255,7156,48882,96,329218
32325,0.000376,172.31.47.0-255,66,48948,96,329218
32326,0.000397,74.125.24.0-255,1484,50432,96,329218
32327,0.000398,172.31.47.0-255,66,50498,96,329218
32328,0.000405,74.125.24.0-255,7110,57608,96,329218
32329,0.000406,172.31.47.0-255,66,57674,96,329218
32330,0.000427,74.125.24.0-255,375,58049,96,329218
32331,0.000624,74.125.24.0-255,1484,59533,96,329218
32332,0.000629,74.125.24.0-255,2902,62435,96,329218
32333,0.000645,74.125.24.0-255,5738,68173,96,329218
32334,0.00065,172.31.47.0-255,66,68239,96,329218
32335,0.000668,74.125.24.0-255,5738,73977,96,329218
32336,0.000676,172.31.47.0-255,66,74043,96,329218
32337,0.000685,74.125.24.0-255,7156,81199,96,329218
32338,0.000693,172.31.47.0-255,66,81265,96,329218
32339,0.000724,172.31.47.0-255,66,81331,96,329218
32340,0.000926,74.125.24.0-255,1484,82815,96,329218
32341,0.000931,74.125.24.0-255,2902,85717,96,329218
32342,0.000933,172.31.47.0-255,66,85783,96,329218
32343,0.000962,74.125.24.0-255,5738,91521,96,329218
32344,0.000973,74.125.24.0-255,4320,95841,96,329218
32345,0.000975,172.31.47.0-255,66,95907,96,329218
32346,0.000979,172.31.47.0-255,66,95973,96,329218
32347,0.001029,172.31.47.0-255,66,96039,96,329218
32348,0.001176,74.125.24.0-255,1484,97523,96,329218
32349,0.00119,74.125.24.0-255,2902,100425,96,329218
32350,0.001193,172.31.47.0-255,66,100491,96,329218
32351,0.001198,74.125.24.0-255,5738,106229,96,329218
32352,0.001221,74.125.24.0-255,5738,111967,96,329218
32353,0.001224,172.31.47.0-255,66,112033,96,329218
32354,0.001227,172.31.47.0-255,66,112099,96,329218
32355,0.001255,74.125.24.0-255,7156,119255,96,329218
32356,0.001268,172.31.47.0-255,66,119321,96,329218
32357,0.001333,74.125.24.0-255,1484,120805,96,329218
32358,0.001338,74.125.24.0-255,2902,123707,96,329218
32359,0.00134,172.31.47.0-255,66,123773,96,329218
32360,0.001365,74.125.24.0-255,5738,129511,96,329218
32361,0.001369,172.31.47.0-255,66,129577,96,329218
32362,0.001379,74.125.24.0-255,7156,136733,96,329218
32363,0.001401,74.125.24.0-255,5738,142471,96,329218
32364,0.00143,172.31.47.0-255,66,142537,96,329218
32365,0.001459,172.31.47.0-255,66,142603,96,329218
32366,0.001723,74.125.24.0-255,1484,144087,96,329218
32367,0.001742,74.125.24.0-255,2902,146989,96,329218
32368,0.001745,172.31.47.0-255,66,147055,96,329218
32369,0.00175,74.125.24.0-255,4320,151375,96,329218
32370,0.001753,172.31.47.0-255,66,151441,96,329218
32371,0.001769,74.125.24.0-255,1484,152925,96,329218
32372,0.001773,74.125.24.0-255,2902,155827,96,329218
32373,0.001797,74.125.24.0-255,7156,162983,96,329218
32374,0.001807,172.31.47.0-255,66,163049,96,329218
32375,0.001811,74.125.24.0-255,4320,167369,96,329218
32376,0.001815,172.31.47.0-255,66,167435,96,329218
32377,0.001849,172.31.47.0-255,66,167501,96,329218
32378,0.00201,74.125.24.0-255,1484,168985,96,329218
32379,0.002013,74.125.24.0-255,1484,170469,96,329218
32380,0.002016,172.31.47.0-255,66,170535,96,329218
32381,0.002136,74.125.24.0-255,1484,172019,96,329218
32382,0.002142,74.125.24.0-255,5738,177757,96,329218
32383,0.002144,172.31.47.0-255,66,177823,96,329218
32384,0.002148,74.125.24.0-255,4320,182143,96,329218
32385,0.00217,74.125.24.0-255,5738,187881,96,329218
32386,0.002183,74.125.24.0-255,2184,190065,96,329218
32387,0.002202,172.31.47.0-255,66,190131,96,329218
32388,0.002229,74.125.24.0-255,1484,191615,96,329218
32389,0.002234,74.125.24.0-255,2902,194517,96,329218
32390,0.002261,74.125.24.0-255,5738,200255,96,329218
32391,0.002268,74.125.24.0-255,7156,207411,96,329218
32392,0.002289,172.31.47.0-255,66,207477,96,329218
32393,0.002314,74.125.24.0-255,2184,209661,96,329218
32394,0.002327,172.31.47.0-255,66,209727,96,329218
32395,0.004625,74.125.24.0-255,5738,215465,96,329218
32396,0.004631,172.31.47.0-255,66,215531,96,329218
32397,0.006936,74.125.24.0-255,5738,221269,96,329218
32398,0.013243,172.31.47.0-255,66,221335,96,329218
32399,0.014671,74.125.24.0-255,1484,222819,96,329218
32400,0.015542,74.125.24.0-255,4320,227139,96,329218
32401,0.015549,172.31.47.0-255,66,227205,96,329218
32402,0.017842,74.125.24.0-255,5738,232943,96,329218
32403,0.018632,172.31.47.0-255,66,233009,96,329218
32404,0.020932,74.125.24.0-255,5738,238747,96,329218
32405,0.020941,172.31.47.0-255,66,238813,96,329218
32406,0.023239,74.125.24.0-255,5738,244551,96,329218
32407,0.023248,172.31.47.0-255,66,244617,96,329218
32408,0.025547,74.125.24.0-255,5738,250355,96,329218
32409,0.025555,172.31.47.0-255,66,250421,96,329218
32410,0.027846,74.125.24.0-255,5738,256159,96,329218
32411,0.027851,172.31.47.0-255,66,256225,96,329218
32412,0.03015,74.125.24.0-255,5738,261963,96,329218
32413,0.030155,172.31.47.0-255,66,262029,96,329218
32414,0.032255,172.31.47.0-255,171,262200,96,329218
32415,0.032283,172.31.47.0-255,1133,263333,96,329218
32416,0.032326,172.31.47.0-255,1514,264847,96,329218
32417,0.032328,172.31.47.0-255,1280,266127,96,329218
32418,0.032455,74.125.24.0-255,5738,271865,96,329218
32419,0.032461,172.31.47.0-255,66,271931,96,329218
32420,0.033733,104.244.42.0-255,66,271997,96,329218
32421,0.033918,104.244.42.0-255,66,272063,96,329218
32422,0.033922,104.244.42.0-255,66,272129,96,329218
32423,0.034748,74.125.24.0-255,5738,277867,96,329218
32424,0.034754,172.31.47.0-255,66,277933,96,329218
32425,0.03709,74.125.24.0-255,5738,283671,96,329218
32426,0.037095,172.31.47.0-255,66,283737,96,329218
32427,0.03937,74.125.24.0-255,5738,289475,96,329218
32428,0.039376,172.31.47.0-255,66,289541,96,329218
32429,0.041671,74.125.24.0-255,5738,295279,96,329218
32430,0.041677,172.31.47.0-255,66,295345,96,329218
32431,0.043987,74.125.24.0-255,5738,301083,96,329218
32432,0.043993,172.31.47.0-255,66,301149,96,329218
32433,0.046289,74.125.24.0-255,5738,306887,96,329218
32434,0.046294,172.31.47.0-255,66,306953,96,329218
32435,0.04859,74.125.24.0-255,2902,309855,96,329218
32436,0.048595,172.31.47.0-255,66,309921,96,329218
32437,0.048625,74.125.24.0-255,2902,312823,96,329218
32438,0.048631,172.31.47.0-255,66,312889,96,329218
32439,0.050885,74.125.24.0-255,2902,315791,96,329218
32440,0.05089,172.31.47.0-255,66,315857,96,329218
32441,0.050931,74.125.24.0-255,2902,318759,96,329218
32442,0.050947,172.31.47.0-255,66,318825,96,329218
32443,0.053198,74.125.24.0-255,2902,321727,96,329218
32444,0.05321,172.31.47.0-255,66,321793,96,329218
32445,0.05325,74.125.24.0-255,2902,324695,96,329218
32446,0.053324,172.31.47.0-255,66,324761,96,329218
32447,0.055523,74.125.24.0-255,2902,327663,96,329218
32448,0.055528,172.31.47.0-255,66,327729,96,329218
32449,0.055613,74.125.24.0-255,1252,328981,96,329218
32450,0.055705,172.31.47.0-255,66,329047,96,329218
32451,0.055728,172.31.47.0-255,105,329152,96,329218
32452,0.05798,74.125.24.0-255,66,329218,96,329218
32453,0.0,74.125.24.0-255,153,153,96,361765
32454,3.2e-05,172.31.47.0-255,66,219,96,361765
32455,3.9e-05,74.125.24.0-255,1484,1703,96,361765
32456,4.5e-05,172.31.47.0-255,66,1769,96,361765
32457,4.9e-05,74.125.24.0-255,2902,4671,96,361765
32458,5.9e-05,172.31.47.0-255,66,4737,96,361765
32459,6.5e-05,74.125.24.0-255,5738,10475,96,361765
32460,6.8e-05,172.31.47.0-255,66,10541,96,361765
32461,9.3e-05,74.125.24.0-255,3393,13934,96,361765
32462,9.6e-05,172.31.47.0-255,66,14000,96,361765
32463,0.000154,74.125.24.0-255,1484,15484,96,361765
32464,0.000158,172.31.47.0-255,66,15550,96,361765
32465,0.000164,74.125.24.0-255,2902,18452,96,361765
32466,0.000166,172.31.47.0-255,66,18518,96,361765
32467,0.000171,74.125.24.0-255,5738,24256,96,361765
32468,0.000174,172.31.47.0-255,66,24322,96,361765
32469,0.000184,74.125.24.0-255,1484,25806,96,361765
32470,0.000188,172.31.47.0-255,66,25872,96,361765
32471,0.000222,74.125.24.0-255,4320,30192,96,361765
32472,0.000227,172.31.47.0-255,66,30258,96,361765
32473,0.00023,74.125.24.0-255,1125,31383,96,361765
32474,0.000232,172.31.47.0-255,66,31449,96,361765
32475,0.000352,74.125.24.0-255,1484,32933,96,361765
32476,0.000356,172.31.47.0-255,66,32999,96,361765
32477,0.000361,74.125.24.0-255,1484,34483,96,361765
32478,0.000363,172.31.47.0-255,66,34549,96,361765
32479,0.00039,74.125.24.0-255,1484,36033,96,361765
32480,0.000393,172.31.47.0-255,66,36099,96,361765
32481,0.0004,74.125.24.0-255,5738,41837,96,361765
32482,0.000403,172.31.47.0-255,66,41903,96,361765
32483,0.000439,74.125.24.0-255,5738,47641,96,361765
32484,0.000443,172.31.47.0-255,66,47707,96,361765
32485,0.000466,74.125.24.0-255,1125,48832,96,361765
32486,0.000501,74.125.24.0-255,1484,50316,96,361765
32487,0.000504,172.31.47.0-255,66,50382,96,361765
32488,0.000509,74.125.24.0-255,2902,53284,96,361765
32489,0.000511,172.31.47.0-255,66,53350,96,361765
32490,0.000532,74.125.24.0-255,4320,57670,96,361765
32491,0.000535,172.31.47.0-255,66,57736,96,361765
32492,0.00056,74.125.24.0-255,1484,59220,96,361765
32493,0.000566,74.125.24.0-255,4320,63540,96,361765
32494,0.00057,172.31.47.0-255,66,63606,96,361765
32495,0.000594,74.125.24.0-255,2889,66495,96,361765
32496,0.000597,172.31.47.0-255,66,66561,96,361765
32497,0.000662,74.125.24.0-255,332,66893,96,361765
32498,0.000784,172.31.47.0-255,66,66959,96,361765
32499,0.000906,74.125.24.0-255,1484,68443,96,361765
32500,0.000913,74.125.24.0-255,2902,71345,96,361765
32501,0.000916,172.31.47.0-255,66,71411,96,361765
32502,0.000949,74.125.24.0-255,5738,77149,96,361765
32503,0.000952,172.31.47.0-255,66,77215,96,361765
32504,0.000976,74.125.24.0-255,2902,80117,96,361765
32505,0.000978,172.31.47.0-255,66,80183,96,361765
32506,0.001004,74.125.24.0-255,3961,84144,96,361765
32507,0.001007,172.31.47.0-255,66,84210,96,361765
32508,0.001028,74.125.24.0-255,1484,85694,96,361765
32509,0.001043,74.125.24.0-255,2902,88596,96,361765
32510,0.001046,172.31.47.0-255,66,88662,96,361765
32511,0.001067,74.125.24.0-255,1484,90146,96,361765
32512,0.001087,74.125.24.0-255,4320,94466,96,361765
32513,0.001091,172.31.47.0-255,66,94532,96,361765
32514,0.001096,74.125.24.0-255,2902,97434,96,361765
32515,0.001098,172.31.47.0-255,66,97500,96,361765
32516,0.001121,74.125.24.0-255,3961,101461,96,361765
32517,0.001123,172.31.47.0-255,66,101527,96,361765
32518,0.001416,74.125.24.0-255,1484,103011,96,361765
32519,0.001423,74.125.24.0-255,2902,105913,96,361765
32520,0.001427,172.31.47.0-255,66,105979,96,361765
32521,0.001431,74.125.24.0-255,1484,107463,96,361765
32522,0.001456,74.125.24.0-255,4320,111783,96,361765
32523,0.001458,172.31.47.0-255,66,111849,96,361765
32524,0.001462,74.125.24.0-255,2902,114751,96,361765
32525,0.001464,172.31.47.0-255,66,114817,96,361765
32526,0.001504,172.31.47.0-255,66,114883,96,361765
32527,0.001509,74.125.24.0-255,5738,120621,96,361765
32528,0.001511,172.31.47.0-255,66,120687,96,361765
32529,0.001538,74.125.24.0-255,5020,125707,96,361765
32530,0.001541,172.31.47.0-255,66,125773,96,361765
32531,0.001587,74.125.24.0-255,1484,127257,96,361765
32532,0.001591,74.125.24.0-255,2902,130159,96,361765
32533,0.001594,172.31.47.0-255,66,130225,96,361765
32534,0.001618,74.125.24.0-255,4320,134545,96,361765
32535,0.001621,172.31.47.0-255,66,134611,96,361765
32536,0.001643,74.125.24.0-255,1484,136095,96,361765
32537,0.001649,74.125.24.0-255,7156,143251,96,361765
32538,0.001651,172.31.47.0-255,66,143317,96,361765
32539,0.001678,74.125.24.0-255,4320,147637,96,361765
32540,0.001681,172.31.47.0-255,66,147703,96,361765
32541,0.001716,172.31.47.0-255,66,147769,96,361765
32542,0.001718,74.125.24.0-255,1484,149253,96,361765
32543,0.001721,74.125.24.0-255,766,150019,96,361765
32544,0.001723,172.31.47.0-255,66,150085,96,361765
32545,0.001864,74.125.24.0-255,1484,151569,96,361765
32546,0.001868,74.125.24.0-255,2902,154471,96,361765
32547,0.00187,172.31.47.0-255,66,154537,96,361765
32548,0.001873,74.125.24.0-255,1484,156021,96,361765
32549,0.001898,74.125.24.0-255,4320,160341,96,361765
32550,0.0019,172.31.47.0-255,66,160407,96,361765
32551,0.001904,74.125.24.0-255,2902,163309,96,361765
32552,0.001906,172.31.47.0-255,66,163375,96,361765
32553,0.001945,172.31.47.0-255,66,163441,96,361765
32554,0.001957,172.31.47.0-255,66,163507,96,361765
32555,0.002022,74.125.24.0-255,1484,164991,96,361765
32556,0.002026,74.125.24.0-255,2902,167893,96,361765
32557,0.002028,172.31.47.0-255,66,167959,96,361765
32558,0.002034,74.125.24.0-255,5738,173697,96,361765
32559,0.002036,172.31.47.0-255,66,173763,96,361765
32560,0.002054,172.31.47.0-255,66,173829,96,361765
32561,0.002065,172.31.47.0-255,66,173895,96,361765
32562,0.004101,74.125.24.0-255,5738,179633,96,361765
32563,0.004107,172.31.47.0-255,66,179699,96,361765
32564,0.006109,74.125.24.0-255,5738,185437,96,361765
32565,0.006129,172.31.47.0-255,66,185503,96,361765
32566,0.008127,74.125.24.0-255,5738,191241,96,361765
32567,0.008132,172.31.47.0-255,66,191307,96,361765
32568,0.010156,74.125.24.0-255,5738,197045,96,361765
32569,0.010163,172.31.47.0-255,66,197111,96,361765
32570,0.012175,74.125.24.0-255,5738,202849,96,361765
32571,0.012182,172.31.47.0-255,66,202915,96,361765
32572,0.0142,74.125.24.0-255,5738,208653,96,361765
32573,0.014207,172.31.47.0-255,66,208719,96,361765
32574,0.016208,74.125.24.0-255,5738,214457,96,361765
32575,0.016221,172.31.47.0-255,66,214523,96,361765
32576,0.018246,74.125.24.0-255,4320,218843,96,361765
32577,0.018252,172.31.47.0-255,66,218909,96,361765
32578,0.01828,74.125.24.0-255,1484,220393,96,361765
32579,0.020262,74.125.24.0-255,4320,224713,96,361765
32580,0.020268,172.31.47.0-255,66,224779,96,361765
32581,0.022285,74.125.24.0-255,5738,230517,96,361765
32582,0.022295,172.31.47.0-255,66,230583,96,361765
32583,0.024307,74.125.24.0-255,5738,236321,96,361765
32584,0.024316,172.31.47.0-255,66,236387,96,361765
32585,0.026311,74.125.24.0-255,5738,242125,96,361765
32586,0.026318,172.31.47.0-255,66,242191,96,361765
32587,0.027184,172.31.47.0-255,172,242363,96,361765
32588,0.027209,172.31.47.0-255,1111,243474,96,361765
32589,0.027244,172.31.47.0-255,1514,244988,96,361765
32590,0.027245,172.31.47.0-255,1301,246289,96,361765
32591,0.028329,74.125.24.0-255,5738,252027,96,361765
32592,0.028334,172.31.47.0-255,66,252093,96,361765
32593,0.028757,104.244.42.0-255,66,252159,96,361765
32594,0.028764,104.244.42.0-255,66,252225,96,361765
32595,0.028793,104.244.42.0-255,66,252291,96,361765
32596,0.030349,74.125.24.0-255,5738,258029,96,361765
32597,0.030354,172.31.47.0-255,66,258095,96,361765
32598,0.032364,74.125.24.0-255,5738,263833,96,361765
32599,0.032371,172.31.47.0-255,66,263899,96,361765
32600,0.03437,74.125.24.0-255,4320,268219,96,361765
32601,0.034374,172.31.47.0-255,66,268285,96,361765
32602,0.034397,74.125.24.0-255,1484,269769,96,361765
32603,0.036417,74.125.24.0-255,4320,274089,96,361765
32604,0.036423,172.31.47.0-255,66,274155,96,361765
32605,0.038438,74.125.24.0-255,5738,279893,96,361765
32606,0.038443,172.31.47.0-255,66,279959,96,361765
32607,0.040444,74.125.24.0-255,5738,285697,96,361765
32608,0.040448,172.31.47.0-255,66,285763,96,361765
32609,0.042443,74.125.24.0-255,5738,291501,96,361765
32610,0.042448,172.31.47.0-255,66,291567,96,361765
32611,0.044454,74.125.24.0-255,5738,297305,96,361765
32612,0.044459,172.31.47.0-255,66,297371,96,361765
32613,0.046467,74.125.24.0-255,5738,303109,96,361765
32614,0.046474,172.31.47.0-255,66,303175,96,361765
32615,0.048485,74.125.24.0-255,5738,308913,96,361765
32616,0.048492,172.31.47.0-255,66,308979,96,361765
32617,0.050482,74.125.24.0-255,5738,314717,96,361765
32618,0.050486,172.31.47.0-255,66,314783,96,361765
32619,0.052483,74.125.24.0-255,4320,319103,96,361765
32620,0.052488,172.31.47.0-255,66,319169,96,361765
32621,0.052519,74.125.24.0-255,1484,320653,96,361765
32622,0.054506,74.125.24.0-255,1484,322137,96,361765
32623,0.054511,172.31.47.0-255,66,322203,96,361765
32624,0.054541,74.125.24.0-255,2902,325105,96,361765
32625,0.054544,172.31.47.0-255,66,325171,96,361765
32626,0.05654,74.125.24.0-255,2902,328073,96,361765
32627,0.056546,172.31.47.0-255,66,328139,96,361765
32628,0.056582,74.125.24.0-255,2902,331041,96,361765
32629,0.056586,172.31.47.0-255,66,331107,96,361765
32630,0.058542,74.125.24.0-255,2902,334009,96,361765
32631,0.058547,172.31.47.0-255,66,334075,96,361765
32632,0.058594,74.125.24.0-255,2902,336977,96,361765
32633,0.058597,172.31.47.0-255,66,337043,96,361765
32634,0.06056,74.125.24.0-255,2902,339945,96,361765
32635,0.060565,172.31.47.0-255,66,340011,96,361765
32636,0.060588,74.125.24.0-255,2902,342913,96,361765
32637,0.06059,172.31.47.0-255,66,342979,96,361765
32638,0.062604,74.125.24.0-255,4320,347299,96,361765
32639,0.062609,172.31.47.0-255,66,347365,96,361765
32640,0.062631,74.125.24.0-255,1484,348849,96,361765
32641,0.064597,74.125.24.0-255,4320,353169,96,361765
32642,0.064602,172.31.47.0-255,66,353235,96,361765
32643,0.066625,74.125.24.0-255,4320,357555,96,361765
32644,0.066631,172.31.47.0-255,66,357621,96,361765
32645,0.06666,74.125.24.0-255,1484,359105,96,361765
32646,0.068659,74.125.24.0-255,2489,361594,96,361765
32647,0.068663,172.31.47.0-255,66,361660,96,361765
32648,0.06882,172.31.47.0-255,105,361765,96,361765
32649,0.0,172.217.194.0-255,153,153,96,346356
32650,2.7e-05,172.31.47.0-255,66,219,96,346356
32651,3.3e-05,172.217.194.0-255,1484,1703,96,346356
32652,3.7e-05,172.31.47.0-255,66,1769,96,346356
32653,4.2e-05,172.217.194.0-255,2902,4671,96,346356
32654,4.4e-05,172.31.47.0-255,66,4737,96,346356
32655,5.2e-05,172.217.194.0-255,7156,11893,96,346356
32656,5.5e-05,172.31.47.0-255,66,11959,96,346356
32657,5.9e-05,172.217.194.0-255,2031,13990,96,346356
32658,6.1e-05,172.31.47.0-255,66,14056,96,346356
32659,0.000109,172.217.194.0-255,1484,15540,96,346356
32660,0.000112,172.31.47.0-255,66,15606,96,346356
32661,0.000133,172.217.194.0-255,2902,18508,96,346356
32662,0.000136,172.31.47.0-255,66,18574,96,346356
32663,0.000143,172.217.194.0-255,5738,24312,96,346356
32664,0.000145,172.31.47.0-255,66,24378,96,346356
32665,0.000168,172.217.194.0-255,6797,31175,96,346356
32666,0.000172,172.31.47.0-255,66,31241,96,346356
32667,0.000179,172.217.194.0-255,7156,38397,96,346356
32668,0.000181,172.31.47.0-255,66,38463,96,346356
32669,0.000212,172.217.194.0-255,7156,45619,96,346356
32670,0.000214,172.31.47.0-255,66,45685,96,346356
32671,0.000233,172.217.194.0-255,2543,48228,96,346356
32672,0.000235,172.31.47.0-255,66,48294,96,346356
32673,0.000249,172.217.194.0-255,1484,49778,96,346356
32674,0.000252,172.31.47.0-255,66,49844,96,346356
32675,0.000256,172.217.194.0-255,2902,52746,96,346356
32676,0.000258,172.31.47.0-255,66,52812,96,346356
32677,0.000286,172.217.194.0-255,5738,58550,96,346356
32678,0.000289,172.31.47.0-255,66,58616,96,346356
32679,0.00031,172.217.194.0-255,6797,65413,96,346356
32680,0.000316,172.31.47.0-255,66,65479,96,346356
32681,0.000345,172.217.194.0-255,377,65856,96,346356
32682,0.00037,172.217.194.0-255,1484,67340,96,346356
32683,0.000373,172.31.47.0-255,66,67406,96,346356
32684,0.000392,172.217.194.0-255,4320,71726,96,346356
32685,0.000397,172.31.47.0-255,66,71792,96,346356
32686,0.00043,172.31.47.0-255,66,71858,96,346356
32687,0.000433,172.217.194.0-255,845,72703,96,346356
32688,0.000727,172.217.194.0-255,1484,74187,96,346356
32689,0.000731,172.31.47.0-255,66,74253,96,346356
32690,0.000737,172.217.194.0-255,2902,77155,96,346356
32691,0.000739,172.31.47.0-255,66,77221,96,346356
32692,0.000746,172.217.194.0-255,5738,82959,96,346356
32693,0.000748,172.31.47.0-255,66,83025,96,346356
32694,0.000772,172.217.194.0-255,4320,87345,96,346356
32695,0.000775,172.31.47.0-255,66,87411,96,346356
32696,0.000796,172.217.194.0-255,5379,92790,96,346356
32697,0.000799,172.31.47.0-255,66,92856,96,346356
32698,0.000811,172.31.47.0-255,66,92922,96,346356
32699,0.000835,172.217.194.0-255,2902,95824,96,346356
32700,0.000841,172.31.47.0-255,66,95890,96,346356
32701,0.00086,172.31.47.0-255,66,95956,96,346356
32702,0.00088,172.217.194.0-255,2184,98140,96,346356
32703,0.000883,172.31.47.0-255,66,98206,96,346356
32704,0.001219,172.217.194.0-255,1484,99690,96,346356
32705,0.001223,172.217.194.0-255,1484,101174,96,346356
32706,0.001227,172.31.47.0-255,66,101240,96,346356
32707,0.00125,172.217.194.0-255,1484,102724,96,346356
32708,0.001257,172.217.194.0-255,5738,108462,96,346356
32709,0.001259,172.31.47.0-255,66,108528,96,346356
32710,0.001266,172.217.194.0-255,5738,114266,96,346356
32711,0.001269,172.31.47.0-255,66,114332,96,346356
32712,0.001298,172.217.194.0-255,7156,121488,96,346356
32713,0.001301,172.31.47.0-255,66,121554,96,346356
32714,0.001304,172.217.194.0-255,1484,123038,96,346356
32715,0.001336,172.31.47.0-255,66,123104,96,346356
32716,0.00182,172.217.194.0-255,1484,124588,96,346356
32717,0.00183,172.217.194.0-255,2902,127490,96,346356
32718,0.001834,172.31.47.0-255,66,127556,96,346356
32719,0.001841,172.217.194.0-255,5738,133294,96,346356
32720,0.001843,172.31.47.0-255,66,133360,96,346356
32721,0.00185,172.217.194.0-255,5738,139098,96,346356
32722,0.001852,172.31.47.0-255,66,139164,96,346356
32723,0.001884,172.217.194.0-255,7156,146320,96,346356
32724,0.001887,172.31.47.0-255,66,146386,96,346356
32725,0.0019,172.31.47.0-255,66,146452,96,346356
32726,0.00192,172.217.194.0-255,1484,147936,96,346356
32727,0.001924,172.217.194.0-255,1484,149420,96,346356
32728,0.001926,172.31.47.0-255,66,149486,96,346356
32729,0.001945,172.217.194.0-255,1484,150970,96,346356
32730,0.00195,172.217.194.0-255,5738,156708,96,346356
32731,0.001953,172.31.47.0-255,66,156774,96,346356
32732,0.001957,172.217.194.0-255,2902,159676,96,346356
32733,0.001959,172.31.47.0-255,66,159742,96,346356
32734,0.001983,172.31.47.0-255,66,159808,96,346356
32735,0.001996,172.31.47.0-255,66,159874,96,346356
32736,0.004017,172.217.194.0-255,5738,165612,96,346356
32737,0.004022,172.31.47.0-255,66,165678,96,346356
32738,0.006045,172.217.194.0-255,5738,171416,96,346356
32739,0.006047,172.31.47.0-255,66,171482,96,346356
32740,0.00805,172.217.194.0-255,5738,177220,96,346356
32741,0.008056,172.31.47.0-255,66,177286,96,346356
32742,0.010061,172.217.194.0-255,5738,183024,96,346356
32743,0.010067,172.31.47.0-255,66,183090,96,346356
32744,0.012095,172.217.194.0-255,5738,188828,96,346356
32745,0.012102,172.31.47.0-255,66,188894,96,346356
32746,0.014128,172.217.194.0-255,5738,194632,96,346356
32747,0.014134,172.31.47.0-255,66,194698,96,346356
32748,0.016154,172.217.194.0-255,5738,200436,96,346356
32749,0.016161,172.31.47.0-255,66,200502,96,346356
32750,0.018147,172.217.194.0-255,5738,206240,96,346356
32751,0.018152,172.31.47.0-255,66,206306,96,346356
32752,0.020173,172.217.194.0-255,5738,212044,96,346356
32753,0.020178,172.31.47.0-255,66,212110,96,346356
32754,0.022188,172.217.194.0-255,5738,217848,96,346356
32755,0.022195,172.31.47.0-255,66,217914,96,346356
32756,0.022564,172.31.47.0-255,172,218086,96,346356
32757,0.022594,172.31.47.0-255,1105,219191,96,346356
32758,0.022632,172.31.47.0-255,1514,220705,96,346356
32759,0.022633,172.31.47.0-255,341,221046,96,346356
32760,0.02407,104.244.42.0-255,66,221112,96,346356
32761,0.024078,104.244.42.0-255,66,221178,96,346356
32762,0.024156,104.244.42.0-255,66,221244,96,346356
32763,0.024199,172.217.194.0-255,4320,225564,96,346356
32764,0.024203,172.31.47.0-255,66,225630,96,346356
32765,0.024236,172.217.194.0-255,1484,227114,96,346356
32766,0.026214,172.217.194.0-255,2902,230016,96,346356
32767,0.026221,172.31.47.0-255,66,230082,96,346356
32768,0.028237,172.217.194.0-255,4320,234402,96,346356
32769,0.028243,172.31.47.0-255,66,234468,96,346356
32770,0.028271,172.217.194.0-255,1484,235952,96,346356
32771,0.030252,172.217.194.0-255,4320,240272,96,346356
32772,0.030256,172.31.47.0-255,66,240338,96,346356
32773,0.032244,172.217.194.0-255,4320,244658,96,346356
32774,0.03225,172.31.47.0-255,66,244724,96,346356
32775,0.032282,172.217.194.0-255,1484,246208,96,346356
32776,0.034243,172.217.194.0-255,4320,250528,96,346356
32777,0.034247,172.31.47.0-255,66,250594,96,346356
32778,0.036236,172.217.194.0-255,5738,256332,96,346356
32779,0.03624,172.31.47.0-255,66,256398,96,346356
32780,0.038238,172.217.194.0-255,5738,262136,96,346356
32781,0.038245,172.31.47.0-255,66,262202,96,346356
32782,0.040241,172.217.194.0-255,5738,267940,96,346356
32783,0.040247,172.31.47.0-255,66,268006,96,346356
32784,0.042239,172.217.194.0-255,5738,273744,96,346356
32785,0.042245,172.31.47.0-255,66,273810,96,346356
32786,0.044226,172.217.194.0-255,2902,276712,96,346356
32787,0.044232,172.31.47.0-255,66,276778,96,346356
32788,0.044256,172.217.194.0-255,2902,279680,96,346356
32789,0.044259,172.31.47.0-255,66,279746,96,346356
32790,0.046255,172.217.194.0-255,5738,285484,96,346356
32791,0.046261,172.31.47.0-255,66,285550,96,346356
32792,0.048282,172.217.194.0-255,5738,291288,96,346356
32793,0.048287,172.31.47.0-255,66,291354,96,346356
32794,0.050297,172.217.194.0-255,5738,297092,96,346356
32795,0.050304,172.31.47.0-255,66,297158,96,346356
32796,0.052316,172.217.194.0-255,5738,302896,96,346356
32797,0.052321,172.31.47.0-255,66,302962,96,346356
32798,0.054322,172.217.194.0-255,5738,308700,96,346356
32799,0.054327,172.31.47.0-255,66,308766,96,346356
32800,0.056348,172.217.194.0-255,5738,314504,96,346356
32801,0.056353,172.31.47.0-255,66,314570,96,346356
32802,0.058366,172.217.194.0-255,5738,320308,96,346356
32803,0.058371,172.31.47.0-255,66,320374,96,346356
32804,0.060384,172.217.194.0-255,5738,326112,96,346356
32805,0.06039,172.31.47.0-255,66,326178,96,346356
32806,0.062407,172.217.194.0-255,5738,331916,96,346356
32807,0.062414,172.31.47.0-255,66,331982,96,346356
32808,0.064432,172.217.194.0-255,5738,337720,96,346356
32809,0.064436,172.31.47.0-255,66,337786,96,346356
32810,0.066442,172.217.194.0-255,4320,342106,96,346356
32811,0.066447,172.31.47.0-255,66,342172,96,346356
32812,0.06647,172.217.194.0-255,1484,343656,96,346356
32813,0.0685,172.217.194.0-255,2529,346185,96,346356
32814,0.068504,172.31.47.0-255,66,346251,96,346356
32815,0.068657,172.31.47.0-255,105,346356,96,346356
32816,0.0,172.217.194.0-255,153,153,96,244957
32817,1.9e-05,172.31.47.0-255,66,219,96,244957
32818,3.7e-05,172.217.194.0-255,1484,1703,96,244957
32819,4.1e-05,172.31.47.0-255,66,1769,96,244957
32820,4.6e-05,172.217.194.0-255,2902,4671,96,244957
32821,4.9e-05,172.31.47.0-255,66,4737,96,244957
32822,5.2e-05,172.217.194.0-255,1484,6221,96,244957
32823,5.4e-05,172.31.47.0-255,66,6287,96,244957
32824,7.9e-05,172.217.194.0-255,5738,12025,96,244957
32825,8.1e-05,172.31.47.0-255,66,12091,96,244957
32826,0.00011,172.217.194.0-255,7156,19247,96,244957
32827,0.000112,172.31.47.0-255,66,19313,96,244957
32828,0.000127,172.217.194.0-255,2149,21462,96,244957
32829,0.000129,172.31.47.0-255,66,21528,96,244957
32830,0.000142,172.31.47.0-255,66,21594,96,244957
32831,0.000879,172.217.194.0-255,1484,23078,96,244957
32832,0.000885,172.31.47.0-255,66,23144,96,244957
32833,0.000893,172.217.194.0-255,1484,24628,96,244957
32834,0.000894,172.31.47.0-255,66,24694,96,244957
32835,0.000909,172.217.194.0-255,1484,26178,96,244957
32836,0.000912,172.31.47.0-255,66,26244,96,244957
32837,0.000933,172.217.194.0-255,2902,29146,96,244957
32838,0.000936,172.31.47.0-255,66,29212,96,244957
32839,0.000947,172.217.194.0-255,2902,32114,96,244957
32840,0.00095,172.31.47.0-255,66,32180,96,244957
32841,0.000953,172.217.194.0-255,1484,33664,96,244957
32842,0.000955,172.31.47.0-255,66,33730,96,244957
32843,0.000995,172.217.194.0-255,5379,39109,96,244957
32844,0.000999,172.31.47.0-255,66,39175,96,244957
32845,0.001006,172.217.194.0-255,5738,44913,96,244957
32846,0.001007,172.31.47.0-255,66,44979,96,244957
32847,0.001019,172.217.194.0-255,1484,46463,96,244957
32848,0.001049,172.217.194.0-255,7156,53619,96,244957
32849,0.001052,172.31.47.0-255,66,53685,96,244957
32850,0.001071,172.217.194.0-255,2837,56522,96,244957
32851,0.001074,172.31.47.0-255,66,56588,96,244957
32852,0.001744,172.217.194.0-255,382,56970,96,244957
32853,0.00188,172.217.194.0-255,1484,58454,96,244957
32854,0.001883,172.31.47.0-255,66,58520,96,244957
32855,0.001895,172.217.194.0-255,2902,61422,96,244957
32856,0.001898,172.31.47.0-255,66,61488,96,244957
32857,0.001923,172.217.194.0-255,4320,65808,96,244957
32858,0.001925,172.31.47.0-255,66,65874,96,244957
32859,0.00194,172.217.194.0-255,1484,67358,96,244957
32860,0.001947,172.217.194.0-255,7156,74514,96,244957
32861,0.001949,172.31.47.0-255,66,74580,96,244957
32862,0.00196,172.217.194.0-255,2902,77482,96,244957
32863,0.001962,172.31.47.0-255,66,77548,96,244957
32864,0.001995,172.31.47.0-255,66,77614,96,244957
32865,0.001998,172.217.194.0-255,2184,79798,96,244957
32866,0.002001,172.31.47.0-255,66,79864,96,244957
32867,0.00438,172.217.194.0-255,5738,85602,96,244957
32868,0.004389,172.31.47.0-255,66,85668,96,244957
32869,0.006739,172.217.194.0-255,5738,91406,96,244957
32870,0.00675,172.31.47.0-255,66,91472,96,244957
32871,0.009104,172.217.194.0-255,5738,97210,96,244957
32872,0.009109,172.31.47.0-255,66,97276,96,244957
32873,0.011494,172.217.194.0-255,5738,103014,96,244957
32874,0.011502,172.31.47.0-255,66,103080,96,244957
32875,0.013851,172.217.194.0-255,5738,108818,96,244957
32876,0.013858,172.31.47.0-255,66,108884,96,244957
32877,0.016228,172.217.194.0-255,5738,114622,96,244957
32878,0.016235,172.31.47.0-255,66,114688,96,244957
32879,0.01863,172.217.194.0-255,5738,120426,96,244957
32880,0.018639,172.31.47.0-255,66,120492,96,244957
32881,0.021027,172.217.194.0-255,5738,126230,96,244957
32882,0.021036,172.31.47.0-255,66,126296,96,244957
32883,0.023386,172.217.194.0-255,5738,132034,96,244957
32884,0.023394,172.31.47.0-255,66,132100,96,244957
32885,0.025789,172.217.194.0-255,5738,137838,96,244957
32886,0.025794,172.31.47.0-255,66,137904,96,244957
32887,0.028135,172.217.194.0-255,4320,142224,96,244957
32888,0.028141,172.31.47.0-255,66,142290,96,244957
32889,0.028168,172.217.194.0-255,1484,143774,96,244957
32890,0.030499,172.217.194.0-255,2902,146676,96,244957
32891,0.030506,172.31.47.0-255,66,146742,96,244957
32892,0.031079,172.31.47.0-255,172,146914,96,244957
32893,0.03111,172.31.47.0-255,1104,148018,96,244957
32894,0.031146,172.31.47.0-255,1514,149532,96,244957
32895,0.031148,172.31.47.0-255,1307,150839,96,244957
32896,0.032629,104.244.42.0-255,66,150905,96,244957
32897,0.032673,104.244.42.0-255,66,150971,96,244957
32898,0.032717,104.244.42.0-255,66,151037,96,244957
32899,0.032913,172.217.194.0-255,5738,156775,96,244957
32900,0.032917,172.31.47.0-255,66,156841,96,244957
32901,0.03527,172.217.194.0-255,5738,162579,96,244957
32902,0.035276,172.31.47.0-255,66,162645,96,244957
32903,0.037663,172.217.194.0-255,5738,168383,96,244957
32904,0.037669,172.31.47.0-255,66,168449,96,244957
32905,0.040042,172.217.194.0-255,5738,174187,96,244957
32906,0.040047,172.31.47.0-255,66,174253,96,244957
32907,0.042394,172.217.194.0-255,5738,179991,96,244957
32908,0.042399,172.31.47.0-255,66,180057,96,244957
32909,0.044736,172.217.194.0-255,2902,182959,96,244957
32910,0.04474,172.31.47.0-255,66,183025,96,244957
32911,0.044766,172.217.194.0-255,2902,185927,96,244957
32912,0.044769,172.31.47.0-255,66,185993,96,244957
32913,0.047083,172.217.194.0-255,2902,188895,96,244957
32914,0.047089,172.31.47.0-255,66,188961,96,244957
32915,0.047153,172.217.194.0-255,2902,191863,96,244957
32916,0.047158,172.31.47.0-255,66,191929,96,244957
32917,0.04943,172.217.194.0-255,2902,194831,96,244957
32918,0.049434,172.31.47.0-255,66,194897,96,244957
32919,0.049521,172.217.194.0-255,2902,197799,96,244957
32920,0.049525,172.31.47.0-255,66,197865,96,244957
32921,0.051813,172.217.194.0-255,2902,200767,96,244957
32922,0.051819,172.31.47.0-255,66,200833,96,244957
32923,0.051893,172.217.194.0-255,2902,203735,96,244957
32924,0.051898,172.31.47.0-255,66,203801,96,244957
32925,0.054184,172.217.194.0-255,2902,206703,96,244957
32926,0.054189,172.31.47.0-255,66,206769,96,244957
32927,0.054242,172.217.194.0-255,2902,209671,96,244957
32928,0.054246,172.31.47.0-255,66,209737,96,244957
32929,0.056536,172.217.194.0-255,2902,212639,96,244957
32930,0.056542,172.31.47.0-255,66,212705,96,244957
32931,0.056594,172.217.194.0-255,2902,215607,96,244957
32932,0.056598,172.31.47.0-255,66,215673,96,244957
32933,0.058885,172.217.194.0-255,2902,218575,96,244957
32934,0.058889,172.31.47.0-255,66,218641,96,244957
32935,0.058932,172.217.194.0-255,2902,221543,96,244957
32936,0.058936,172.31.47.0-255,66,221609,96,244957
32937,0.061257,172.217.194.0-255,2902,224511,96,244957
32938,0.061267,172.31.47.0-255,66,224577,96,244957
32939,0.061302,172.217.194.0-255,2902,227479,96,244957
32940,0.061305,172.31.47.0-255,66,227545,96,244957
32941,0.063679,172.217.194.0-255,5738,233283,96,244957
32942,0.063686,172.31.47.0-255,66,233349,96,244957
32943,0.066101,172.217.194.0-255,5738,239087,96,244957
32944,0.066123,172.31.47.0-255,66,239153,96,244957
32945,0.068557,172.217.194.0-255,5738,244891,96,244957
32946,0.0686,172.31.47.0-255,66,244957,96,244957
32947,0.0,74.125.68.0-255,297,297,96,341722
32948,3e-05,172.31.47.0-255,66,363,96,341722
32949,3.6e-05,74.125.68.0-255,1484,1847,96,341722
32950,4e-05,172.31.47.0-255,66,1913,96,341722
32951,4.5e-05,74.125.68.0-255,4320,6233,96,341722
32952,4.8e-05,172.31.47.0-255,66,6299,96,341722
32953,5.9e-05,74.125.68.0-255,4320,10619,96,341722
32954,6.2e-05,172.31.47.0-255,66,10685,96,341722
32955,6.4e-05,74.125.68.0-255,1484,12169,96,341722
32956,6.6e-05,172.31.47.0-255,66,12235,96,341722
32957,9.7e-05,74.125.68.0-255,3368,15603,96,341722
32958,0.0001,172.31.47.0-255,66,15669,96,341722
32959,0.000108,172.31.47.0-255,66,15735,96,341722
32960,0.000154,74.125.68.0-255,2902,18637,96,341722
32961,0.000157,172.31.47.0-255,66,18703,96,341722
32962,0.000189,74.125.68.0-255,3961,22664,96,341722
32963,0.000192,172.31.47.0-255,66,22730,96,341722
32964,0.000269,74.125.68.0-255,1484,24214,96,341722
32965,0.000272,172.31.47.0-255,66,24280,96,341722
32966,0.000296,74.125.68.0-255,2902,27182,96,341722
32967,0.000298,74.125.68.0-255,1484,28666,96,341722
32968,0.0003,172.31.47.0-255,66,28732,96,341722
32969,0.000306,172.31.47.0-255,66,28798,96,341722
32970,0.000329,74.125.68.0-255,2902,31700,96,341722
32971,0.000336,172.31.47.0-255,66,31766,96,341722
32972,0.000341,74.125.68.0-255,5738,37504,96,341722
32973,0.000344,172.31.47.0-255,66,37570,96,341722
32974,0.000349,74.125.68.0-255,2902,40472,96,341722
32975,0.000351,172.31.47.0-255,66,40538,96,341722
32976,0.000376,74.125.68.0-255,4320,44858,96,341722
32977,0.00038,172.31.47.0-255,66,44924,96,341722
32978,0.000393,172.31.47.0-255,66,44990,96,341722
32979,0.000397,74.125.68.0-255,3602,48592,96,341722
32980,0.000398,172.31.47.0-255,66,48658,96,341722
32981,0.000439,74.125.68.0-255,357,49015,96,341722
32982,0.000595,74.125.68.0-255,130,49145,96,341722
32983,0.000763,172.31.47.0-255,66,49211,96,341722
32984,0.000884,74.125.68.0-255,1484,50695,96,341722
32985,0.000888,172.31.47.0-255,66,50761,96,341722
32986,0.000896,74.125.68.0-255,2902,53663,96,341722
32987,0.000899,172.31.47.0-255,66,53729,96,341722
32988,0.000926,74.125.68.0-255,5738,59467,96,341722
32989,0.000931,74.125.68.0-255,2902,62369,96,341722
32990,0.000947,74.125.68.0-255,2902,65271,96,341722
32991,0.000957,74.125.68.0-255,1484,66755,96,341722
32992,0.000966,172.31.47.0-255,66,66821,96,341722
32993,0.000977,74.125.68.0-255,2902,69723,96,341722
32994,0.001,74.125.68.0-255,4320,74043,96,341722
32995,0.001012,74.125.68.0-255,1484,75527,96,341722
32996,0.001026,74.125.68.0-255,7156,82683,96,341722
32997,0.001044,74.125.68.0-255,766,83449,96,341722
32998,0.001053,172.31.47.0-255,66,83515,96,341722
32999,0.001711,74.125.68.0-255,1484,84999,96,341722
33000,0.001716,172.31.47.0-255,66,85065,96,341722
33001,0.001724,74.125.68.0-255,2902,87967,96,341722
33002,0.001727,74.125.68.0-255,1484,89451,96,341722
33003,0.001746,74.125.68.0-255,2902,92353,96,341722
33004,0.001759,74.125.68.0-255,2902,95255,96,341722
33005,0.001772,172.31.47.0-255,66,95321,96,341722
33006,0.001783,74.125.68.0-255,5738,101059,96,341722
33007,0.001789,74.125.68.0-255,5738,106797,96,341722
33008,0.001824,74.125.68.0-255,5738,112535,96,341722
33009,0.001831,172.31.47.0-255,66,112601,96,341722
33010,0.001858,74.125.68.0-255,1484,114085,96,341722
33011,0.001863,74.125.68.0-255,3602,117687,96,341722
33012,0.001883,172.31.47.0-255,66,117753,96,341722
33013,0.001961,74.125.68.0-255,1484,119237,96,341722
33014,0.001965,74.125.68.0-255,1484,120721,96,341722
33015,0.001976,74.125.68.0-255,1484,122205,96,341722
33016,0.00199,74.125.68.0-255,5738,127943,96,341722
33017,0.001996,172.31.47.0-255,66,128009,96,341722
33018,0.002016,74.125.68.0-255,4320,132329,96,341722
33019,0.002031,172.31.47.0-255,66,132395,96,341722
33020,0.002051,74.125.68.0-255,5738,138133,96,341722
33021,0.002059,74.125.68.0-255,7156,145289,96,341722
33022,0.002081,74.125.68.0-255,4320,149609,96,341722
33023,0.002085,74.125.68.0-255,2184,151793,96,341722
33024,0.002089,74.125.68.0-255,1484,153277,96,341722
33025,0.002094,172.31.47.0-255,66,153343,96,341722
33026,0.002103,74.125.68.0-255,1484,154827,96,341722
33027,0.002119,74.125.68.0-255,2902,157729,96,341722
33028,0.002132,74.125.68.0-255,2902,160631,96,341722
33029,0.002146,74.125.68.0-255,1484,162115,96,341722
33030,0.002154,172.31.47.0-255,66,162181,96,341722
33031,0.002166,74.125.68.0-255,4320,166501,96,341722
33032,0.002191,74.125.68.0-255,2902,169403,96,341722
33033,0.002205,172.31.47.0-255,66,169469,96,341722
33034,0.002271,172.31.47.0-255,66,169535,96,341722
33035,0.00452,74.125.68.0-255,5738,175273,96,341722
33036,0.004524,172.31.47.0-255,66,175339,96,341722
33037,0.006781,74.125.68.0-255,5738,181077,96,341722
33038,0.006786,172.31.47.0-255,66,181143,96,341722
33039,0.009057,74.125.68.0-255,5738,186881,96,341722
33040,0.009063,172.31.47.0-255,66,186947,96,341722
33041,0.011323,74.125.68.0-255,5738,192685,96,341722
33042,0.01133,172.31.47.0-255,66,192751,96,341722
33043,0.013621,74.125.68.0-255,5738,198489,96,341722
33044,0.01363,172.31.47.0-255,66,198555,96,341722
33045,0.015884,74.125.68.0-255,5738,204293,96,341722
33046,0.015892,172.31.47.0-255,66,204359,96,341722
33047,0.018149,74.125.68.0-255,4320,208679,96,341722
33048,0.018154,172.31.47.0-255,66,208745,96,341722
33049,0.018179,74.125.68.0-255,1484,210229,96,341722
33050,0.020409,74.125.68.0-255,4320,214549,96,341722
33051,0.020415,172.31.47.0-255,66,214615,96,341722
33052,0.022688,74.125.68.0-255,5738,220353,96,341722
33053,0.022728,172.31.47.0-255,66,220419,96,341722
33054,0.025004,74.125.68.0-255,5738,226157,96,341722
33055,0.025023,172.31.47.0-255,66,226223,96,341722
33056,0.027302,74.125.68.0-255,5738,231961,96,341722
33057,0.02732,172.31.47.0-255,66,232027,96,341722
33058,0.02958,74.125.68.0-255,5738,237765,96,341722
33059,0.029622,172.31.47.0-255,66,237831,96,341722
33060,0.031888,74.125.68.0-255,5738,243569,96,341722
33061,0.031907,172.31.47.0-255,66,243635,96,341722
33062,0.034153,74.125.68.0-255,5738,249373,96,341722
33063,0.03416,172.31.47.0-255,66,249439,96,341722
33064,0.03662,74.125.68.0-255,5738,255177,96,341722
33065,0.036627,172.31.47.0-255,66,255243,96,341722
33066,0.03842,172.31.47.0-255,176,255419,96,341722
33067,0.038464,172.31.47.0-255,1101,256520,96,341722
33068,0.038542,172.31.47.0-255,1514,258034,96,341722
33069,0.038544,172.31.47.0-255,1310,259344,96,341722
33070,0.038883,74.125.68.0-255,5738,265082,96,341722
33071,0.038893,172.31.47.0-255,66,265148,96,341722
33072,0.039961,104.244.42.0-255,66,265214,96,341722
33073,0.040008,104.244.42.0-255,66,265280,96,341722
33074,0.040104,104.244.42.0-255,66,265346,96,341722
33075,0.041158,74.125.68.0-255,5738,271084,96,341722
33076,0.041171,172.31.47.0-255,66,271150,96,341722
33077,0.043442,74.125.68.0-255,5738,276888,96,341722
33078,0.043456,172.31.47.0-255,66,276954,96,341722
33079,0.045804,74.125.68.0-255,5738,282692,96,341722
33080,0.045821,172.31.47.0-255,66,282758,96,341722
33081,0.048107,74.125.68.0-255,5738,288496,96,341722
33082,0.048125,172.31.47.0-255,66,288562,96,341722
33083,0.050388,74.125.68.0-255,5738,294300,96,341722
33084,0.050403,172.31.47.0-255,66,294366,96,341722
33085,0.052652,74.125.68.0-255,5738,300104,96,341722
33086,0.052657,172.31.47.0-255,66,300170,96,341722
33087,0.054888,74.125.68.0-255,2902,303072,96,341722
33088,0.054893,172.31.47.0-255,66,303138,96,341722
33089,0.054925,74.125.68.0-255,2902,306040,96,341722
33090,0.054933,172.31.47.0-255,66,306106,96,341722
33091,0.057148,74.125.68.0-255,2902,309008,96,341722
33092,0.057154,172.31.47.0-255,66,309074,96,341722
33093,0.057189,74.125.68.0-255,2902,311976,96,341722
33094,0.057203,172.31.47.0-255,66,312042,96,341722
33095,0.059403,74.125.68.0-255,2902,314944,96,341722
33096,0.059408,172.31.47.0-255,66,315010,96,341722
33097,0.059443,74.125.68.0-255,2902,317912,96,341722
33098,0.05945,172.31.47.0-255,66,317978,96,341722
33099,0.061661,74.125.68.0-255,2902,320880,96,341722
33100,0.061666,172.31.47.0-255,66,320946,96,341722
33101,0.061693,74.125.68.0-255,2902,323848,96,341722
33102,0.061709,172.31.47.0-255,66,323914,96,341722
33103,0.06391,74.125.68.0-255,2902,326816,96,341722
33104,0.063916,172.31.47.0-255,66,326882,96,341722
33105,0.063943,74.125.68.0-255,2902,329784,96,341722
33106,0.065318,172.31.47.0-255,66,329850,96,341722
33107,0.066161,74.125.68.0-255,2902,332752,96,341722
33108,0.066165,172.31.47.0-255,66,332818,96,341722
33109,0.067562,74.125.68.0-255,2902,335720,96,341722
33110,0.067568,172.31.47.0-255,66,335786,96,341722
33111,0.068454,74.125.68.0-255,2902,338688,96,341722
33112,0.068458,172.31.47.0-255,66,338754,96,341722
33113,0.069817,74.125.68.0-255,2902,341656,96,341722
33114,0.069821,172.31.47.0-255,66,341722,96,341722
33115,0.0,172.31.47.0-255,105,105,96,276
33116,0.001804,157.240.7.0-255,105,210,96,276
33117,0.001819,172.31.47.0-255,66,276,96,276
33118,0.0,74.125.130.0-255,152,152,96,322269
33119,4e-05,172.31.47.0-255,66,218,96,322269
33120,4.6e-05,74.125.130.0-255,1484,1702,96,322269
33121,5.1e-05,172.31.47.0-255,66,1768,96,322269
33122,5.4e-05,74.125.130.0-255,1484,3252,96,322269
33123,6.4e-05,172.31.47.0-255,66,3318,96,322269
33124,9.1e-05,74.125.130.0-255,1484,4802,96,322269
33125,9.4e-05,172.31.47.0-255,66,4868,96,322269
33126,0.000103,74.125.130.0-255,4320,9188,96,322269
33127,0.000106,172.31.47.0-255,66,9254,96,322269
33128,0.000116,74.125.130.0-255,4938,14192,96,322269
33129,0.000118,172.31.47.0-255,66,14258,96,322269
33130,0.000149,74.125.130.0-255,1484,15742,96,322269
33131,0.000152,172.31.47.0-255,66,15808,96,322269
33132,0.000182,74.125.130.0-255,2902,18710,96,322269
33133,0.000185,172.31.47.0-255,66,18776,96,322269
33134,0.000188,74.125.130.0-255,1484,20260,96,322269
33135,0.00019,172.31.47.0-255,66,20326,96,322269
33136,0.000194,74.125.130.0-255,2902,23228,96,322269
33137,0.000196,172.31.47.0-255,66,23294,96,322269
33138,0.000232,74.125.130.0-255,5738,29032,96,322269
33139,0.000235,172.31.47.0-255,66,29098,96,322269
33140,0.000238,74.125.130.0-255,1484,30582,96,322269
33141,0.00024,172.31.47.0-255,66,30648,96,322269
33142,0.000259,74.125.130.0-255,2902,33550,96,322269
33143,0.000266,172.31.47.0-255,66,33616,96,322269
33144,0.000284,74.125.130.0-255,4320,37936,96,322269
33145,0.000288,172.31.47.0-255,66,38002,96,322269
33146,0.000298,74.125.130.0-255,1484,39486,96,322269
33147,0.000305,172.31.47.0-255,66,39552,96,322269
33148,0.000315,74.125.130.0-255,1484,41036,96,322269
33149,0.000322,172.31.47.0-255,66,41102,96,322269
33150,0.000342,74.125.130.0-255,5738,46840,96,322269
33151,0.000346,172.31.47.0-255,66,46906,96,322269
33152,0.00035,74.125.130.0-255,2184,49090,96,322269
33153,0.000352,172.31.47.0-255,66,49156,96,322269
33154,0.000545,74.125.130.0-255,1484,50640,96,322269
33155,0.00055,74.125.130.0-255,1484,52124,96,322269
33156,0.000553,172.31.47.0-255,66,52190,96,322269
33157,0.000578,74.125.130.0-255,1484,53674,96,322269
33158,0.000584,74.125.130.0-255,5738,59412,96,322269
33159,0.000587,172.31.47.0-255,66,59478,96,322269
33160,0.000592,74.125.130.0-255,2902,62380,96,322269
33161,0.000593,172.31.47.0-255,66,62446,96,322269
33162,0.000596,74.125.130.0-255,1484,63930,96,322269
33163,0.000621,74.125.130.0-255,2831,66761,96,322269
33164,0.000623,172.31.47.0-255,66,66827,96,322269
33165,0.000626,74.125.130.0-255,99,66926,96,322269
33166,0.000794,172.31.47.0-255,66,66992,96,322269
33167,0.000997,74.125.130.0-255,1484,68476,96,322269
33168,0.001008,74.125.130.0-255,2902,71378,96,322269
33169,0.001012,172.31.47.0-255,66,71444,96,322269
33170,0.001049,74.125.130.0-255,5738,77182,96,322269
33171,0.001053,172.31.47.0-255,66,77248,96,322269
33172,0.001058,74.125.130.0-255,4320,81568,96,322269
33173,0.00106,172.31.47.0-255,66,81634,96,322269
33174,0.001071,74.125.130.0-255,4320,85954,96,322269
33175,0.001074,172.31.47.0-255,66,86020,96,322269
33176,0.001105,74.125.130.0-255,1484,87504,96,322269
33177,0.001119,172.31.47.0-255,66,87570,96,322269
33178,0.001165,74.125.130.0-255,2184,89754,96,322269
33179,0.001168,172.31.47.0-255,66,89820,96,322269
33180,0.001234,74.125.130.0-255,1484,91304,96,322269
33181,0.001257,74.125.130.0-255,2902,94206,96,322269
33182,0.001261,172.31.47.0-255,66,94272,96,322269
33183,0.001266,74.125.130.0-255,2902,97174,96,322269
33184,0.001267,172.31.47.0-255,66,97240,96,322269
33185,0.001302,74.125.130.0-255,2902,100142,96,322269
33186,0.001306,172.31.47.0-255,66,100208,96,322269
33187,0.001323,172.31.47.0-255,66,100274,96,322269
33188,0.00133,74.125.130.0-255,7156,107430,96,322269
33189,0.001333,172.31.47.0-255,66,107496,96,322269
33190,0.001358,74.125.130.0-255,4320,111816,96,322269
33191,0.001363,172.31.47.0-255,66,111882,96,322269
33192,0.001372,74.125.130.0-255,2184,114066,96,322269
33193,0.001374,172.31.47.0-255,66,114132,96,322269
33194,0.001379,74.125.130.0-255,2902,117034,96,322269
33195,0.001381,172.31.47.0-255,66,117100,96,322269
33196,0.001383,74.125.130.0-255,1484,118584,96,322269
33197,0.001424,74.125.130.0-255,5738,124322,96,322269
33198,0.001427,74.125.130.0-255,1484,125806,96,322269
33199,0.001431,74.125.130.0-255,2902,128708,96,322269
33200,0.001435,172.31.47.0-255,66,128774,96,322269
33201,0.001438,172.31.47.0-255,66,128840,96,322269
33202,0.001448,74.125.130.0-255,4320,133160,96,322269
33203,0.00145,172.31.47.0-255,66,133226,96,322269
33204,0.00147,74.125.130.0-255,1484,134710,96,322269
33205,0.001478,74.125.130.0-255,4320,139030,96,322269
33206,0.00148,172.31.47.0-255,66,139096,96,322269
33207,0.001499,74.125.130.0-255,2902,141998,96,322269
33208,0.001501,172.31.47.0-255,66,142064,96,322269
33209,0.001505,74.125.130.0-255,4320,146384,96,322269
33210,0.001507,172.31.47.0-255,66,146450,96,322269
33211,0.001546,74.125.130.0-255,2184,148634,96,322269
33212,0.001548,172.31.47.0-255,66,148700,96,322269
33213,0.003783,74.125.130.0-255,2902,151602,96,322269
33214,0.003787,172.31.47.0-255,66,151668,96,322269
33215,0.003837,74.125.130.0-255,2902,154570,96,322269
33216,0.00384,172.31.47.0-255,66,154636,96,322269
33217,0.006081,74.125.130.0-255,2902,157538,96,322269
33218,0.006086,172.31.47.0-255,66,157604,96,322269
33219,0.00612,74.125.130.0-255,2902,160506,96,322269
33220,0.006123,172.31.47.0-255,66,160572,96,322269
33221,0.008381,74.125.130.0-255,2902,163474,96,322269
33222,0.00839,172.31.47.0-255,66,163540,96,322269
33223,0.008424,74.125.130.0-255,2902,166442,96,322269
33224,0.008427,172.31.47.0-255,66,166508,96,322269
33225,0.010703,74.125.130.0-255,2902,169410,96,322269
33226,0.010713,172.31.47.0-255,66,169476,96,322269
33227,0.010748,74.125.130.0-255,2902,172378,96,322269
33228,0.010751,172.31.47.0-255,66,172444,96,322269
33229,0.013013,74.125.130.0-255,2902,175346,96,322269
33230,0.013023,172.31.47.0-255,66,175412,96,322269
33231,0.013058,74.125.130.0-255,2902,178314,96,322269
33232,0.013062,172.31.47.0-255,66,178380,96,322269
33233,0.015318,74.125.130.0-255,2902,181282,96,322269
33234,0.015332,172.31.47.0-255,66,181348,96,322269
33235,0.015373,74.125.130.0-255,2902,184250,96,322269
33236,0.015378,172.31.47.0-255,66,184316,96,322269
33237,0.017627,74.125.130.0-255,2902,187218,96,322269
33238,0.017634,172.31.47.0-255,66,187284,96,322269
33239,0.017658,74.125.130.0-255,2902,190186,96,322269
33240,0.01766,172.31.47.0-255,66,190252,96,322269
33241,0.019926,74.125.130.0-255,2902,193154,96,322269
33242,0.019933,172.31.47.0-255,66,193220,96,322269
33243,0.019965,74.125.130.0-255,2902,196122,96,322269
33244,0.019969,172.31.47.0-255,66,196188,96,322269
33245,0.022233,74.125.130.0-255,2902,199090,96,322269
33246,0.02224,172.31.47.0-255,66,199156,96,322269
33247,0.022285,74.125.130.0-255,2902,202058,96,322269
33248,0.022288,172.31.47.0-255,66,202124,96,322269
33249,0.024547,74.125.130.0-255,2902,205026,96,322269
33250,0.024558,172.31.47.0-255,66,205092,96,322269
33251,0.024594,74.125.130.0-255,2902,207994,96,322269
33252,0.024597,172.31.47.0-255,66,208060,96,322269
33253,0.02666,172.31.47.0-255,172,208232,96,322269
33254,0.026713,172.31.47.0-255,1104,209336,96,322269
33255,0.026786,172.31.47.0-255,1514,210850,96,322269
33256,0.026789,172.31.47.0-255,1307,212157,96,322269
33257,0.026862,74.125.130.0-255,2902,215059,96,322269
33258,0.026868,172.31.47.0-255,66,215125,96,322269
33259,0.026905,74.125.130.0-255,2902,218027,96,322269
33260,0.026909,172.31.47.0-255,66,218093,96,322269
33261,0.028227,104.244.42.0-255,66,218159,96,322269
33262,0.028337,104.244.42.0-255,66,218225,96,322269
33263,0.028341,104.244.42.0-255,66,218291,96,322269
33264,0.02917,74.125.130.0-255,2902,221193,96,322269
33265,0.029177,172.31.47.0-255,66,221259,96,322269
33266,0.029211,74.125.130.0-255,2902,224161,96,322269
33267,0.029214,172.31.47.0-255,66,224227,96,322269
33268,0.031483,74.125.130.0-255,2902,227129,96,322269
33269,0.031494,172.31.47.0-255,66,227195,96,322269
33270,0.031527,74.125.130.0-255,2902,230097,96,322269
33271,0.031531,172.31.47.0-255,66,230163,96,322269
33272,0.0338,74.125.130.0-255,2902,233065,96,322269
33273,0.033815,172.31.47.0-255,66,233131,96,322269
33274,0.033865,74.125.130.0-255,2902,236033,96,322269
33275,0.033869,172.31.47.0-255,66,236099,96,322269
33276,0.036112,74.125.130.0-255,2902,239001,96,322269
33277,0.036121,172.31.47.0-255,66,239067,96,322269
33278,0.036156,74.125.130.0-255,2902,241969,96,322269
33279,0.03616,172.31.47.0-255,66,242035,96,322269
33280,0.038432,74.125.130.0-255,2902,244937,96,322269
33281,0.038447,172.31.47.0-255,66,245003,96,322269
33282,0.038481,74.125.130.0-255,2902,247905,96,322269
33283,0.038485,172.31.47.0-255,66,247971,96,322269
33284,0.040729,74.125.130.0-255,1484,249455,96,322269
33285,0.040761,74.125.130.0-255,1484,250939,96,322269
33286,0.040765,172.31.47.0-255,66,251005,96,322269
33287,0.040769,74.125.130.0-255,2902,253907,96,322269
33288,0.040771,172.31.47.0-255,66,253973,96,322269
33289,0.043052,74.125.130.0-255,5738,259711,96,322269
33290,0.043057,172.31.47.0-255,66,259777,96,322269
33291,0.045373,74.125.130.0-255,5738,265515,96,322269
33292,0.045378,172.31.47.0-255,66,265581,96,322269
33293,0.047672,74.125.130.0-255,5738,271319,96,322269
33294,0.047678,172.31.47.0-255,66,271385,96,322269
33295,0.049969,74.125.130.0-255,5738,277123,96,322269
33296,0.049975,172.31.47.0-255,66,277189,96,322269
33297,0.052276,74.125.130.0-255,5738,282927,96,322269
33298,0.052281,172.31.47.0-255,66,282993,96,322269
33299,0.054588,74.125.130.0-255,5738,288731,96,322269
33300,0.054594,172.31.47.0-255,66,288797,96,322269
33301,0.056896,74.125.130.0-255,5738,294535,96,322269
33302,0.056901,172.31.47.0-255,66,294601,96,322269
33303,0.059196,74.125.130.0-255,5738,300339,96,322269
33304,0.059201,172.31.47.0-255,66,300405,96,322269
33305,0.061511,74.125.130.0-255,5738,306143,96,322269
33306,0.061516,172.31.47.0-255,66,306209,96,322269
33307,0.063811,74.125.130.0-255,5738,311947,96,322269
33308,0.063819,172.31.47.0-255,66,312013,96,322269
33309,0.066116,74.125.130.0-255,4320,316333,96,322269
33310,0.066122,172.31.47.0-255,66,316399,96,322269
33311,0.066157,74.125.130.0-255,1484,317883,96,322269
33312,0.068408,74.125.130.0-255,4320,322203,96,322269
33313,0.068413,172.31.47.0-255,66,322269,96,322269
33314,0.0,74.125.24.0-255,153,153,96,244816
33315,3e-05,172.31.47.0-255,66,219,96,244816
33316,3.7e-05,74.125.24.0-255,1484,1703,96,244816
33317,4e-05,172.31.47.0-255,66,1769,96,244816
33318,4.5e-05,74.125.24.0-255,2902,4671,96,244816
33319,4.7e-05,172.31.47.0-255,66,4737,96,244816
33320,5.3e-05,74.125.24.0-255,7156,11893,96,244816
33321,5.6e-05,172.31.47.0-255,66,11959,96,244816
33322,6.1e-05,74.125.24.0-255,4901,16860,96,244816
33323,6.3e-05,172.31.47.0-255,66,16926,96,244816
33324,0.000105,172.31.47.0-255,66,16992,96,244816
33325,0.00016,74.125.24.0-255,1484,18476,96,244816
33326,0.000164,172.31.47.0-255,66,18542,96,244816
33327,0.000183,74.125.24.0-255,2902,21444,96,244816
33328,0.000185,172.31.47.0-255,66,21510,96,244816
33329,0.000192,74.125.24.0-255,5738,27248,96,244816
33330,0.000194,172.31.47.0-255,66,27314,96,244816
33331,0.000237,74.125.24.0-255,7156,34470,96,244816
33332,0.00024,172.31.47.0-255,66,34536,96,244816
33333,0.000259,74.125.24.0-255,6797,41333,96,244816
33334,0.000261,172.31.47.0-255,66,41399,96,244816
33335,0.000265,74.125.24.0-255,2902,44301,96,244816
33336,0.000267,172.31.47.0-255,66,44367,96,244816
33337,0.000273,74.125.24.0-255,7108,51475,96,244816
33338,0.000275,172.31.47.0-255,66,51541,96,244816
33339,0.000323,74.125.24.0-255,109,51650,96,244816
33340,0.000326,172.31.47.0-255,66,51716,96,244816
33341,0.000329,74.125.24.0-255,332,52048,96,244816
33342,0.000331,172.31.47.0-255,66,52114,96,244816
33343,0.000777,74.125.24.0-255,1484,53598,96,244816
33344,0.000782,172.31.47.0-255,66,53664,96,244816
33345,0.00079,74.125.24.0-255,2902,56566,96,244816
33346,0.000793,74.125.24.0-255,1484,58050,96,244816
33347,0.00081,74.125.24.0-255,4320,62370,96,244816
33348,0.000829,74.125.24.0-255,5738,68108,96,244816
33349,0.000845,74.125.24.0-255,4320,72428,96,244816
33350,0.000855,172.31.47.0-255,66,72494,96,244816
33351,0.000874,74.125.24.0-255,5020,77514,96,244816
33352,0.000909,74.125.24.0-255,1484,78998,96,244816
33353,0.000913,74.125.24.0-255,1484,80482,96,244816
33354,0.000922,172.31.47.0-255,66,80548,96,244816
33355,0.000931,74.125.24.0-255,1484,82032,96,244816
33356,0.000935,74.125.24.0-255,2902,84934,96,244816
33357,0.000945,172.31.47.0-255,66,85000,96,244816
33358,0.000949,74.125.24.0-255,2902,87902,96,244816
33359,0.000951,74.125.24.0-255,1484,89386,96,244816
33360,0.000979,74.125.24.0-255,4320,93706,96,244816
33361,0.000994,74.125.24.0-255,1484,95190,96,244816
33362,0.001021,74.125.24.0-255,5020,100210,96,244816
33363,0.001034,172.31.47.0-255,66,100276,96,244816
33364,0.001086,74.125.24.0-255,1484,101760,96,244816
33365,0.001091,74.125.24.0-255,2902,104662,96,244816
33366,0.001108,74.125.24.0-255,5738,110400,96,244816
33367,0.001146,172.31.47.0-255,66,110466,96,244816
33368,0.001179,74.125.24.0-255,7156,117622,96,244816
33369,0.001214,172.31.47.0-255,66,117688,96,244816
33370,0.001219,172.31.47.0-255,66,117754,96,244816
33371,0.001233,74.125.24.0-255,1484,119238,96,244816
33372,0.001248,74.125.24.0-255,2902,122140,96,244816
33373,0.001252,74.125.24.0-255,1484,123624,96,244816
33374,0.001261,172.31.47.0-255,66,123690,96,244816
33375,0.00127,74.125.24.0-255,4320,128010,96,244816
33376,0.001274,74.125.24.0-255,4320,132330,96,244816
33377,0.001286,74.125.24.0-255,7156,139486,96,244816
33378,0.001288,172.31.47.0-255,66,139552,96,244816
33379,0.001297,74.125.24.0-255,1484,141036,96,244816
33380,0.001313,172.31.47.0-255,66,141102,96,244816
33381,0.001322,74.125.24.0-255,2902,144004,96,244816
33382,0.001348,172.31.47.0-255,66,144070,96,244816
33383,0.001362,74.125.24.0-255,6438,150508,96,244816
33384,0.001369,74.125.24.0-255,7156,157664,96,244816
33385,0.001383,74.125.24.0-255,7156,164820,96,244816
33386,0.001403,172.31.47.0-255,66,164886,96,244816
33387,0.001442,74.125.24.0-255,7156,172042,96,244816
33388,0.001446,172.31.47.0-255,66,172108,96,244816
33389,0.001498,74.125.24.0-255,1484,173592,96,244816
33390,0.001513,172.31.47.0-255,66,173658,96,244816
33391,0.001525,172.31.47.0-255,66,173724,96,244816
33392,0.001556,172.31.47.0-255,66,173790,96,244816
33393,0.001574,74.125.24.0-255,4320,178110,96,244816
33394,0.001579,172.31.47.0-255,66,178176,96,244816
33395,0.001612,74.125.24.0-255,1484,179660,96,244816
33396,0.001616,172.31.47.0-255,66,179726,96,244816
33397,0.001653,74.125.24.0-255,766,180492,96,244816
33398,0.001664,172.31.47.0-255,66,180558,96,244816
33399,0.001687,74.125.24.0-255,1484,182042,96,244816
33400,0.001701,74.125.24.0-255,2902,184944,96,244816
33401,0.001717,74.125.24.0-255,2902,187846,96,244816
33402,0.00172,172.31.47.0-255,66,187912,96,244816
33403,0.001724,172.31.47.0-255,66,187978,96,244816
33404,0.001734,74.125.24.0-255,2902,190880,96,244816
33405,0.001739,74.125.24.0-255,5738,196618,96,244816
33406,0.001748,74.125.24.0-255,1484,198102,96,244816
33407,0.00176,74.125.24.0-255,2902,201004,96,244816
33408,0.001765,172.31.47.0-255,66,201070,96,244816
33409,0.001782,74.125.24.0-255,5020,206090,96,244816
33410,0.001807,172.31.47.0-255,66,206156,96,244816
33411,0.001852,74.125.24.0-255,1484,207640,96,244816
33412,0.001872,74.125.24.0-255,2902,210542,96,244816
33413,0.001876,172.31.47.0-255,66,210608,96,244816
33414,0.001903,74.125.24.0-255,5738,216346,96,244816
33415,0.001909,74.125.24.0-255,7156,223502,96,244816
33416,0.001912,172.31.47.0-255,66,223568,96,244816
33417,0.001947,172.31.47.0-255,66,223634,96,244816
33418,0.001951,74.125.24.0-255,4320,227954,96,244816
33419,0.001954,74.125.24.0-255,2184,230138,96,244816
33420,0.001962,172.31.47.0-255,66,230204,96,244816
33421,0.001999,74.125.24.0-255,7156,237360,96,244816
33422,0.002014,74.125.24.0-255,2753,240113,96,244816
33423,0.002016,74.125.24.0-255,105,240218,96,244816
33424,0.002043,172.31.47.0-255,66,240284,96,244816
33425,0.002052,172.31.47.0-255,66,240350,96,244816
33426,0.003887,172.31.47.0-255,105,240455,96,244816
33427,0.006215,74.125.24.0-255,66,240521,96,244816
33428,0.025851,172.31.47.0-255,172,240693,96,244816
33429,0.025896,172.31.47.0-255,1105,241798,96,244816
33430,0.025957,172.31.47.0-255,1514,243312,96,244816
33431,0.025958,172.31.47.0-255,1306,244618,96,244816
33432,0.027416,104.244.42.0-255,66,244684,96,244816
33433,0.027455,104.244.42.0-255,66,244750,96,244816
33434,0.027494,104.244.42.0-255,66,244816,96,244816
33435,0.0,172.217.27.0-255,153,153,96,328184
33436,1.3e-05,172.31.47.0-255,66,219,96,328184
33437,1.9e-05,172.217.27.0-255,1484,1703,96,328184
33438,2.4e-05,172.31.47.0-255,66,1769,96,328184
33439,3.1e-05,172.217.27.0-255,2902,4671,96,328184
33440,3.4e-05,172.31.47.0-255,66,4737,96,328184
33441,3.9e-05,172.217.27.0-255,4320,9057,96,328184
33442,4.1e-05,172.31.47.0-255,66,9123,96,328184
33443,7.2e-05,172.217.27.0-255,2902,12025,96,328184
33444,7.4e-05,172.31.47.0-255,66,12091,96,328184
33445,7.9e-05,172.217.27.0-255,3552,15643,96,328184
33446,8.1e-05,172.31.47.0-255,66,15709,96,328184
33447,8.6e-05,172.217.27.0-255,4320,20029,96,328184
33448,8.8e-05,172.31.47.0-255,66,20095,96,328184
33449,9.9e-05,172.31.47.0-255,66,20161,96,328184
33450,0.000102,172.217.27.0-255,1125,21286,96,328184
33451,0.000104,172.31.47.0-255,66,21352,96,328184
33452,0.000203,172.217.27.0-255,1484,22836,96,328184
33453,0.000207,172.31.47.0-255,66,22902,96,328184
33454,0.000212,172.217.27.0-255,2902,25804,96,328184
33455,0.000214,172.31.47.0-255,66,25870,96,328184
33456,0.000232,172.217.27.0-255,5738,31608,96,328184
33457,0.000235,172.31.47.0-255,66,31674,96,328184
33458,0.000257,172.217.27.0-255,2902,34576,96,328184
33459,0.00026,172.31.47.0-255,66,34642,96,328184
33460,0.000279,172.217.27.0-255,3961,38603,96,328184
33461,0.000281,172.31.47.0-255,66,38669,96,328184
33462,0.000287,172.217.27.0-255,7156,45825,96,328184
33463,0.000289,172.31.47.0-255,66,45891,96,328184
33464,0.000326,172.31.47.0-255,66,45957,96,328184
33465,0.000807,172.217.27.0-255,382,46339,96,328184
33466,0.0009,172.31.47.0-255,66,46405,96,328184
33467,0.001013,172.217.27.0-255,1484,47889,96,328184
33468,0.001021,172.217.27.0-255,2902,50791,96,328184
33469,0.001024,172.31.47.0-255,66,50857,96,328184
33470,0.001028,172.217.27.0-255,2902,53759,96,328184
33471,0.001029,172.31.47.0-255,66,53825,96,328184
33472,0.001044,172.217.27.0-255,2902,56727,96,328184
33473,0.001046,172.31.47.0-255,66,56793,96,328184
33474,0.001071,172.217.27.0-255,6797,63590,96,328184
33475,0.001073,172.31.47.0-255,66,63656,96,328184
33476,0.001078,172.217.27.0-255,5738,69394,96,328184
33477,0.00108,172.31.47.0-255,66,69460,96,328184
33478,0.001091,172.217.27.0-255,1484,70944,96,328184
33479,0.00112,172.31.47.0-255,66,71010,96,328184
33480,0.001163,172.217.27.0-255,1484,72494,96,328184
33481,0.001175,172.217.27.0-255,2902,75396,96,328184
33482,0.001177,172.31.47.0-255,66,75462,96,328184
33483,0.001181,172.217.27.0-255,1484,76946,96,328184
33484,0.0012,172.217.27.0-255,4320,81266,96,328184
33485,0.001204,172.217.27.0-255,4320,85586,96,328184
33486,0.001209,172.217.27.0-255,5738,91324,96,328184
33487,0.001212,172.31.47.0-255,66,91390,96,328184
33488,0.001218,172.31.47.0-255,66,91456,96,328184
33489,0.00122,172.31.47.0-255,66,91522,96,328184
33490,0.001222,172.217.27.0-255,1484,93006,96,328184
33491,0.001253,172.31.47.0-255,66,93072,96,328184
33492,0.001256,172.217.27.0-255,2184,95256,96,328184
33493,0.001258,172.31.47.0-255,66,95322,96,328184
33494,0.001306,172.217.27.0-255,1484,96806,96,328184
33495,0.00131,172.217.27.0-255,2902,99708,96,328184
33496,0.001312,172.31.47.0-255,66,99774,96,328184
33497,0.001332,172.217.27.0-255,5738,105512,96,328184
33498,0.001334,172.31.47.0-255,66,105578,96,328184
33499,0.001367,172.31.47.0-255,66,105644,96,328184
33500,0.001376,172.31.47.0-255,66,105710,96,328184
33501,0.00142,172.217.27.0-255,2184,107894,96,328184
33502,0.001422,172.31.47.0-255,66,107960,96,328184
33503,0.001437,172.217.27.0-255,2902,110862,96,328184
33504,0.001441,172.31.47.0-255,66,110928,96,328184
33505,0.001459,172.217.27.0-255,4320,115248,96,328184
33506,0.001461,172.31.47.0-255,66,115314,96,328184
33507,0.001487,172.217.27.0-255,2902,118216,96,328184
33508,0.00149,172.31.47.0-255,66,118282,96,328184
33509,0.001498,172.31.47.0-255,66,118348,96,328184
33510,0.001518,172.217.27.0-255,5738,124086,96,328184
33511,0.00152,172.31.47.0-255,66,124152,96,328184
33512,0.001548,172.31.47.0-255,66,124218,96,328184
33513,0.001569,172.217.27.0-255,4320,128538,96,328184
33514,0.001571,172.31.47.0-255,66,128604,96,328184
33515,0.001576,172.217.27.0-255,5738,134342,96,328184
33516,0.001578,172.31.47.0-255,66,134408,96,328184
33517,0.001589,172.217.27.0-255,1484,135892,96,328184
33518,0.00162,172.31.47.0-255,66,135958,96,328184
33519,0.00163,172.31.47.0-255,66,136024,96,328184
33520,0.001639,172.217.27.0-255,766,136790,96,328184
33521,0.002398,172.31.47.0-255,66,136856,96,328184
33522,0.003241,172.217.27.0-255,4320,141176,96,328184
33523,0.003245,172.31.47.0-255,66,141242,96,328184
33524,0.004017,172.217.27.0-255,1484,142726,96,328184
33525,0.004853,172.217.27.0-255,4320,147046,96,328184
33526,0.004857,172.31.47.0-255,66,147112,96,328184
33527,0.006478,172.217.27.0-255,5738,152850,96,328184
33528,0.00649,172.31.47.0-255,66,152916,96,328184
33529,0.008113,172.217.27.0-255,5738,158654,96,328184
33530,0.008119,172.31.47.0-255,66,158720,96,328184
33531,0.00975,172.217.27.0-255,5738,164458,96,328184
33532,0.009762,172.31.47.0-255,66,164524,96,328184
33533,0.011397,172.217.27.0-255,5738,170262,96,328184
33534,0.011414,172.31.47.0-255,66,170328,96,328184
33535,0.013051,172.217.27.0-255,5738,176066,96,328184
33536,0.013063,172.31.47.0-255,66,176132,96,328184
33537,0.014682,172.217.27.0-255,5738,181870,96,328184
33538,0.014693,172.31.47.0-255,66,181936,96,328184
33539,0.016324,172.217.27.0-255,5738,187674,96,328184
33540,0.016331,172.31.47.0-255,66,187740,96,328184
33541,0.017955,172.217.27.0-255,5738,193478,96,328184
33542,0.017963,172.31.47.0-255,66,193544,96,328184
33543,0.019589,172.217.27.0-255,5738,199282,96,328184
33544,0.019596,172.31.47.0-255,66,199348,96,328184
33545,0.02123,172.217.27.0-255,5738,205086,96,328184
33546,0.021244,172.31.47.0-255,66,205152,96,328184
33547,0.022876,172.217.27.0-255,5738,210890,96,328184
33548,0.022888,172.31.47.0-255,66,210956,96,328184
33549,0.024522,172.217.27.0-255,5738,216694,96,328184
33550,0.024536,172.31.47.0-255,66,216760,96,328184
33551,0.026161,172.217.27.0-255,5738,222498,96,328184
33552,0.026169,172.31.47.0-255,66,222564,96,328184
33553,0.0278,172.217.27.0-255,5738,228302,96,328184
33554,0.027805,172.31.47.0-255,66,228368,96,328184
33555,0.029433,172.217.27.0-255,5738,234106,96,328184
33556,0.029438,172.31.47.0-255,66,234172,96,328184
33557,0.03105,172.217.27.0-255,5738,239910,96,328184
33558,0.031056,172.31.47.0-255,66,239976,96,328184
33559,0.032677,172.217.27.0-255,5738,245714,96,328184
33560,0.032686,172.31.47.0-255,66,245780,96,328184
33561,0.034332,172.217.27.0-255,5738,251518,96,328184
33562,0.034338,172.31.47.0-255,66,251584,96,328184
33563,0.035968,172.217.27.0-255,5738,257322,96,328184
33564,0.035974,172.31.47.0-255,66,257388,96,328184
33565,0.036559,172.31.47.0-255,172,257560,96,328184
33566,0.0366,172.31.47.0-255,1101,258661,96,328184
33567,0.036667,172.31.47.0-255,1514,260175,96,328184
33568,0.03667,172.31.47.0-255,1310,261485,96,328184
33569,0.037602,172.217.27.0-255,5738,267223,96,328184
33570,0.03761,172.31.47.0-255,66,267289,96,328184
33571,0.038097,104.244.42.0-255,66,267355,96,328184
33572,0.038153,104.244.42.0-255,66,267421,96,328184
33573,0.038201,104.244.42.0-255,66,267487,96,328184
33574,0.039226,172.217.27.0-255,5738,273225,96,328184
33575,0.039234,172.31.47.0-255,66,273291,96,328184
33576,0.04088,172.217.27.0-255,5738,279029,96,328184
33577,0.040891,172.31.47.0-255,66,279095,96,328184
33578,0.042526,172.217.27.0-255,5738,284833,96,328184
33579,0.042534,172.31.47.0-255,66,284899,96,328184
33580,0.044148,172.217.27.0-255,5738,290637,96,328184
33581,0.044155,172.31.47.0-255,66,290703,96,328184
33582,0.045779,172.217.27.0-255,5738,296441,96,328184
33583,0.045784,172.31.47.0-255,66,296507,96,328184
33584,0.047406,172.217.27.0-255,5738,302245,96,328184
33585,0.047415,172.31.47.0-255,66,302311,96,328184
33586,0.049031,172.217.27.0-255,5738,308049,96,328184
33587,0.049038,172.31.47.0-255,66,308115,96,328184
33588,0.050664,172.217.27.0-255,5738,313853,96,328184
33589,0.05067,172.31.47.0-255,66,313919,96,328184
33590,0.052289,172.217.27.0-255,5738,319657,96,328184
33591,0.052293,172.31.47.0-255,66,319723,96,328184
33592,0.053926,172.217.27.0-255,5738,325461,96,328184
33593,0.053931,172.31.47.0-255,66,325527,96,328184
33594,0.055541,172.217.27.0-255,2066,327593,96,328184
33595,0.055546,172.31.47.0-255,66,327659,96,328184
33596,0.056234,172.31.47.0-255,105,327764,96,328184
33597,0.056482,172.31.47.0-255,90,327854,96,328184
33598,0.056491,172.31.47.0-255,66,327920,96,328184
33599,0.057822,172.217.27.0-255,66,327986,96,328184
33600,0.058055,172.217.27.0-255,66,328052,96,328184
33601,0.058085,172.217.27.0-255,66,328118,96,328184
33602,0.05809,172.31.47.0-255,66,328184,96,328184
33603,0.0,74.125.24.0-255,152,152,96,310268
33604,3.3e-05,172.31.47.0-255,66,218,96,310268
33605,4e-05,74.125.24.0-255,1484,1702,96,310268
33606,4.3e-05,172.31.47.0-255,66,1768,96,310268
33607,4.8e-05,74.125.24.0-255,2902,4670,96,310268
33608,5.2e-05,172.31.47.0-255,66,4736,96,310268
33609,5.9e-05,74.125.24.0-255,7156,11892,96,310268
33610,6.2e-05,172.31.47.0-255,66,11958,96,310268
33611,6.7e-05,74.125.24.0-255,4320,16278,96,310268
33612,7e-05,172.31.47.0-255,66,16344,96,310268
33613,0.000109,172.31.47.0-255,66,16410,96,310268
33614,0.000113,74.125.24.0-255,2543,18953,96,310268
33615,0.000116,172.31.47.0-255,66,19019,96,310268
33616,0.000299,74.125.24.0-255,1484,20503,96,310268
33617,0.000304,172.31.47.0-255,66,20569,96,310268
33618,0.000309,74.125.24.0-255,2902,23471,96,310268
33619,0.000312,172.31.47.0-255,66,23537,96,310268
33620,0.000337,74.125.24.0-255,5738,29275,96,310268
33621,0.000341,172.31.47.0-255,66,29341,96,310268
33622,0.000377,74.125.24.0-255,6797,36138,96,310268
33623,0.00038,172.31.47.0-255,66,36204,96,310268
33624,0.000384,74.125.24.0-255,2902,39106,96,310268
33625,0.000387,172.31.47.0-255,66,39172,96,310268
33626,0.000402,74.125.24.0-255,4320,43492,96,310268
33627,0.000404,172.31.47.0-255,66,43558,96,310268
33628,0.00044,172.31.47.0-255,66,43624,96,310268
33629,0.000832,74.125.24.0-255,646,44270,96,310268
33630,0.000837,172.31.47.0-255,66,44336,96,310268
33631,0.000865,74.125.24.0-255,1484,45820,96,310268
33632,0.000867,172.31.47.0-255,66,45886,96,310268
33633,0.000872,74.125.24.0-255,2902,48788,96,310268
33634,0.000874,172.31.47.0-255,66,48854,96,310268
33635,0.000885,74.125.24.0-255,1484,50338,96,310268
33636,0.000935,172.31.47.0-255,66,50404,96,310268
33637,0.000941,74.125.24.0-255,5738,56142,96,310268
33638,0.000943,172.31.47.0-255,66,56208,96,310268
33639,0.000972,74.125.24.0-255,5738,61946,96,310268
33640,0.000975,172.31.47.0-255,66,62012,96,310268
33641,0.000989,74.125.24.0-255,6438,68450,96,310268
33642,0.000992,172.31.47.0-255,66,68516,96,310268
33643,0.001086,74.125.24.0-255,1484,70000,96,310268
33644,0.001092,74.125.24.0-255,2902,72902,96,310268
33645,0.001094,172.31.47.0-255,66,72968,96,310268
33646,0.001098,74.125.24.0-255,1484,74452,96,310268
33647,0.00111,74.125.24.0-255,4320,78772,96,310268
33648,0.001112,172.31.47.0-255,66,78838,96,310268
33649,0.001117,74.125.24.0-255,4320,83158,96,310268
33650,0.001119,172.31.47.0-255,66,83224,96,310268
33651,0.001146,172.31.47.0-255,66,83290,96,310268
33652,0.001163,74.125.24.0-255,2902,86192,96,310268
33653,0.001165,172.31.47.0-255,66,86258,96,310268
33654,0.00117,74.125.24.0-255,4320,90578,96,310268
33655,0.001172,172.31.47.0-255,66,90644,96,310268
33656,0.001183,74.125.24.0-255,3602,94246,96,310268
33657,0.001185,172.31.47.0-255,66,94312,96,310268
33658,0.002081,74.125.24.0-255,1484,95796,96,310268
33659,0.002087,74.125.24.0-255,2902,98698,96,310268
33660,0.002091,172.31.47.0-255,66,98764,96,310268
33661,0.002113,74.125.24.0-255,5738,104502,96,310268
33662,0.002116,172.31.47.0-255,66,104568,96,310268
33663,0.002118,74.125.24.0-255,1484,106052,96,310268
33664,0.002139,172.31.47.0-255,66,106118,96,310268
33665,0.002158,74.125.24.0-255,2902,109020,96,310268
33666,0.00216,172.31.47.0-255,66,109086,96,310268
33667,0.002166,74.125.24.0-255,7156,116242,96,310268
33668,0.002168,172.31.47.0-255,66,116308,96,310268
33669,0.002188,74.125.24.0-255,3602,119910,96,310268
33670,0.00219,172.31.47.0-255,66,119976,96,310268
33671,0.002192,74.125.24.0-255,1484,121460,96,310268
33672,0.002228,74.125.24.0-255,2902,124362,96,310268
33673,0.00223,172.31.47.0-255,66,124428,96,310268
33674,0.002239,172.31.47.0-255,66,124494,96,310268
33675,0.002243,74.125.24.0-255,4320,128814,96,310268
33676,0.002244,172.31.47.0-255,66,128880,96,310268
33677,0.002266,74.125.24.0-255,7156,136036,96,310268
33678,0.002268,172.31.47.0-255,66,136102,96,310268
33679,0.002272,74.125.24.0-255,4320,140422,96,310268
33680,0.002274,172.31.47.0-255,66,140488,96,310268
33681,0.002303,172.31.47.0-255,66,140554,96,310268
33682,0.002313,172.31.47.0-255,66,140620,96,310268
33683,0.002347,74.125.24.0-255,7156,147776,96,310268
33684,0.002349,172.31.47.0-255,66,147842,96,310268
33685,0.002374,172.31.47.0-255,66,147908,96,310268
33686,0.002378,74.125.24.0-255,4320,152228,96,310268
33687,0.002379,172.31.47.0-255,66,152294,96,310268
33688,0.002405,172.31.47.0-255,66,152360,96,310268
33689,0.002414,172.31.47.0-255,66,152426,96,310268
33690,0.002461,74.125.24.0-255,6438,158864,96,310268
33691,0.002463,172.31.47.0-255,66,158930,96,310268
33692,0.004866,74.125.24.0-255,2902,161832,96,310268
33693,0.004869,172.31.47.0-255,66,161898,96,310268
33694,0.004886,74.125.24.0-255,2902,164800,96,310268
33695,0.004888,172.31.47.0-255,66,164866,96,310268
33696,0.007316,74.125.24.0-255,5738,170604,96,310268
33697,0.007325,172.31.47.0-255,66,170670,96,310268
33698,0.009733,74.125.24.0-255,5738,176408,96,310268
33699,0.009741,172.31.47.0-255,66,176474,96,310268
33700,0.012088,74.125.24.0-255,5738,182212,96,310268
33701,0.012095,172.31.47.0-255,66,182278,96,310268
33702,0.014454,74.125.24.0-255,5738,188016,96,310268
33703,0.01446,172.31.47.0-255,66,188082,96,310268
33704,0.016883,74.125.24.0-255,5738,193820,96,310268
33705,0.016891,172.31.47.0-255,66,193886,96,310268
33706,0.01931,74.125.24.0-255,5738,199624,96,310268
33707,0.019317,172.31.47.0-255,66,199690,96,310268
33708,0.021697,74.125.24.0-255,5738,205428,96,310268
33709,0.021721,172.31.47.0-255,66,205494,96,310268
33710,0.024091,74.125.24.0-255,5738,211232,96,310268
33711,0.024102,172.31.47.0-255,66,211298,96,310268
33712,0.02651,74.125.24.0-255,5738,217036,96,310268
33713,0.026515,172.31.47.0-255,66,217102,96,310268
33714,0.028919,74.125.24.0-255,5738,222840,96,310268
33715,0.028927,172.31.47.0-255,66,222906,96,310268
33716,0.031324,74.125.24.0-255,5738,228644,96,310268
33717,0.031332,172.31.47.0-255,66,228710,96,310268
33718,0.033728,74.125.24.0-255,5738,234448,96,310268
33719,0.033734,172.31.47.0-255,66,234514,96,310268
33720,0.034284,172.31.47.0-255,172,234686,96,310268
33721,0.034312,172.31.47.0-255,1105,235791,96,310268
33722,0.03434,172.31.47.0-255,1514,237305,96,310268
33723,0.034341,172.31.47.0-255,1306,238611,96,310268
33724,0.03583,104.244.42.0-255,66,238677,96,310268
33725,0.035863,104.244.42.0-255,66,238743,96,310268
33726,0.035908,104.244.42.0-255,66,238809,96,310268
33727,0.036097,74.125.24.0-255,5738,244547,96,310268
33728,0.036101,172.31.47.0-255,66,244613,96,310268
33729,0.038438,74.125.24.0-255,4320,248933,96,310268
33730,0.038442,172.31.47.0-255,66,248999,96,310268
33731,0.038465,74.125.24.0-255,1484,250483,96,310268
33732,0.040839,74.125.24.0-255,4320,254803,96,310268
33733,0.040844,172.31.47.0-255,66,254869,96,310268
33734,0.04321,74.125.24.0-255,2902,257771,96,310268
33735,0.043239,172.31.47.0-255,66,257837,96,310268
33736,0.043258,74.125.24.0-255,2902,260739,96,310268
33737,0.043261,172.31.47.0-255,66,260805,96,310268
33738,0.045653,74.125.24.0-255,5738,266543,96,310268
33739,0.045658,172.31.47.0-255,66,266609,96,310268
33740,0.048079,74.125.24.0-255,5738,272347,96,310268
33741,0.048084,172.31.47.0-255,66,272413,96,310268
33742,0.05046,74.125.24.0-255,5738,278151,96,310268
33743,0.050465,172.31.47.0-255,66,278217,96,310268
33744,0.052852,74.125.24.0-255,5738,283955,96,310268
33745,0.052856,172.31.47.0-255,66,284021,96,310268
33746,0.05529,74.125.24.0-255,5738,289759,96,310268
33747,0.055298,172.31.47.0-255,66,289825,96,310268
33748,0.057653,74.125.24.0-255,5738,295563,96,310268
33749,0.057658,172.31.47.0-255,66,295629,96,310268
33750,0.060071,74.125.24.0-255,2902,298531,96,310268
33751,0.060076,172.31.47.0-255,66,298597,96,310268
33752,0.060104,74.125.24.0-255,2902,301499,96,310268
33753,0.060108,172.31.47.0-255,66,301565,96,310268
33754,0.062484,74.125.24.0-255,4320,305885,96,310268
33755,0.062489,172.31.47.0-255,66,305951,96,310268
33756,0.062517,74.125.24.0-255,1484,307435,96,310268
33757,0.064884,74.125.24.0-255,2596,310031,96,310268
33758,0.064889,172.31.47.0-255,66,310097,96,310268
33759,0.065029,172.31.47.0-255,105,310202,96,310268
33760,0.067413,74.125.24.0-255,66,310268,96,310268
33761,0.0,172.217.194.0-255,157,157,96,197632
33762,2.5e-05,172.31.47.0-255,66,223,96,197632
33763,3.1e-05,172.217.194.0-255,1484,1707,96,197632
33764,3.5e-05,172.31.47.0-255,66,1773,96,197632
33765,3.9e-05,172.217.194.0-255,2902,4675,96,197632
33766,4.1e-05,172.31.47.0-255,66,4741,96,197632
33767,4.4e-05,172.217.194.0-255,1484,6225,96,197632
33768,4.6e-05,172.31.47.0-255,66,6291,96,197632
33769,6.7e-05,172.217.194.0-255,2902,9193,96,197632
33770,6.9e-05,172.31.47.0-255,66,9259,96,197632
33771,7.5e-05,172.217.194.0-255,7156,16415,96,197632
33772,7.7e-05,172.31.47.0-255,66,16481,96,197632
33773,9.3e-05,172.217.194.0-255,2064,18545,96,197632
33774,9.5e-05,172.31.47.0-255,66,18611,96,197632
33775,0.0001,172.217.194.0-255,4320,22931,96,197632
33776,0.000102,172.31.47.0-255,66,22997,96,197632
33777,0.000131,172.31.47.0-255,66,23063,96,197632
33778,0.000257,172.217.194.0-255,1484,24547,96,197632
33779,0.000261,172.31.47.0-255,66,24613,96,197632
33780,0.000281,172.217.194.0-255,2902,27515,96,197632
33781,0.000283,172.31.47.0-255,66,27581,96,197632
33782,0.000288,172.217.194.0-255,5738,33319,96,197632
33783,0.00029,172.31.47.0-255,66,33385,96,197632
33784,0.000293,172.217.194.0-255,1484,34869,96,197632
33785,0.000295,172.31.47.0-255,66,34935,96,197632
33786,0.000322,172.217.194.0-255,5379,40314,96,197632
33787,0.000325,172.31.47.0-255,66,40380,96,197632
33788,0.000329,172.217.194.0-255,2902,43282,96,197632
33789,0.000333,172.31.47.0-255,66,43348,96,197632
33790,0.000354,172.31.47.0-255,66,43414,96,197632
33791,0.000357,172.217.194.0-255,2834,46248,96,197632
33792,0.000361,172.31.47.0-255,66,46314,96,197632
33793,0.000383,172.217.194.0-255,395,46709,96,197632
33794,0.000543,172.217.194.0-255,1484,48193,96,197632
33795,0.000547,172.31.47.0-255,66,48259,96,197632
33796,0.00055,172.217.194.0-255,1484,49743,96,197632
33797,0.000562,172.217.194.0-255,1484,51227,96,197632
33798,0.000564,172.31.47.0-255,66,51293,96,197632
33799,0.00057,172.217.194.0-255,5738,57031,96,197632
33800,0.000572,172.31.47.0-255,66,57097,96,197632
33801,0.000605,172.31.47.0-255,66,57163,96,197632
33802,0.000632,172.31.47.0-255,66,57229,96,197632
33803,0.000727,172.217.194.0-255,1484,58713,96,197632
33804,0.000732,172.217.194.0-255,2902,61615,96,197632
33805,0.000734,172.31.47.0-255,66,61681,96,197632
33806,0.000755,172.217.194.0-255,5738,67419,96,197632
33807,0.000758,172.31.47.0-255,66,67485,96,197632
33808,0.00076,172.217.194.0-255,1484,68969,96,197632
33809,0.000784,172.31.47.0-255,66,69035,96,197632
33810,0.000811,172.217.194.0-255,2902,71937,96,197632
33811,0.000813,172.31.47.0-255,66,72003,96,197632
33812,0.000839,172.31.47.0-255,66,72069,96,197632
33813,0.000842,172.217.194.0-255,2184,74253,96,197632
33814,0.000844,172.31.47.0-255,66,74319,96,197632
33815,0.000866,172.217.194.0-255,1484,75803,96,197632
33816,0.000882,172.217.194.0-255,4320,80123,96,197632
33817,0.000885,172.31.47.0-255,66,80189,96,197632
33818,0.00091,172.31.47.0-255,66,80255,96,197632
33819,0.000921,172.31.47.0-255,66,80321,96,197632
33820,0.000947,172.217.194.0-255,7156,87477,96,197632
33821,0.000949,172.31.47.0-255,66,87543,96,197632
33822,0.000952,172.217.194.0-255,766,88309,96,197632
33823,0.001285,172.31.47.0-255,66,88375,96,197632
33824,0.00181,172.217.194.0-255,1484,89859,96,197632
33825,0.001822,172.217.194.0-255,2902,92761,96,197632
33826,0.001829,172.31.47.0-255,66,92827,96,197632
33827,0.001838,172.217.194.0-255,5738,98565,96,197632
33828,0.00184,172.31.47.0-255,66,98631,96,197632
33829,0.001845,172.217.194.0-255,4320,102951,96,197632
33830,0.001847,172.31.47.0-255,66,103017,96,197632
33831,0.001888,172.31.47.0-255,66,103083,96,197632
33832,0.001901,172.31.47.0-255,66,103149,96,197632
33833,0.001927,172.217.194.0-255,1484,104633,96,197632
33834,0.001951,172.217.194.0-255,1484,106117,96,197632
33835,0.001953,172.31.47.0-255,66,106183,96,197632
33836,0.001969,172.217.194.0-255,1484,107667,96,197632
33837,0.001979,172.217.194.0-255,1484,109151,96,197632
33838,0.001996,172.31.47.0-255,66,109217,96,197632
33839,0.002015,172.217.194.0-255,4320,113537,96,197632
33840,0.002017,172.31.47.0-255,66,113603,96,197632
33841,0.002027,172.31.47.0-255,66,113669,96,197632
33842,0.002054,172.217.194.0-255,2902,116571,96,197632
33843,0.002056,172.31.47.0-255,66,116637,96,197632
33844,0.002077,172.217.194.0-255,7156,123793,96,197632
33845,0.002079,172.31.47.0-255,66,123859,96,197632
33846,0.002096,172.217.194.0-255,5020,128879,96,197632
33847,0.002098,172.31.47.0-255,66,128945,96,197632
33848,0.002141,172.217.194.0-255,1484,130429,96,197632
33849,0.002144,172.217.194.0-255,1484,131913,96,197632
33850,0.002146,172.31.47.0-255,66,131979,96,197632
33851,0.002161,172.217.194.0-255,1484,133463,96,197632
33852,0.002167,172.217.194.0-255,5738,139201,96,197632
33853,0.002169,172.31.47.0-255,66,139267,96,197632
33854,0.002191,172.217.194.0-255,7156,146423,96,197632
33855,0.002194,172.31.47.0-255,66,146489,96,197632
33856,0.002217,172.217.194.0-255,5738,152227,96,197632
33857,0.00222,172.31.47.0-255,66,152293,96,197632
33858,0.002229,172.31.47.0-255,66,152359,96,197632
33859,0.002245,172.217.194.0-255,2184,154543,96,197632
33860,0.002247,172.31.47.0-255,66,154609,96,197632
33861,0.00229,172.217.194.0-255,2902,157511,96,197632
33862,0.002292,172.31.47.0-255,66,157577,96,197632
33863,0.002311,172.217.194.0-255,4320,161897,96,197632
33864,0.002313,172.31.47.0-255,66,161963,96,197632
33865,0.002318,172.217.194.0-255,4320,166283,96,197632
33866,0.002321,172.31.47.0-255,66,166349,96,197632
33867,0.002337,172.217.194.0-255,4320,170669,96,197632
33868,0.002339,172.31.47.0-255,66,170735,96,197632
33869,0.002384,172.31.47.0-255,66,170801,96,197632
33870,0.002423,172.217.194.0-255,7156,177957,96,197632
33871,0.002425,172.31.47.0-255,66,178023,96,197632
33872,0.00245,172.31.47.0-255,66,178089,96,197632
33873,0.002462,172.31.47.0-255,66,178155,96,197632
33874,0.002472,172.31.47.0-255,66,178221,96,197632
33875,0.00251,172.31.47.0-255,66,178287,96,197632
33876,0.002532,172.217.194.0-255,7156,185443,96,197632
33877,0.002534,172.31.47.0-255,66,185509,96,197632
33878,0.002555,172.31.47.0-255,66,185575,96,197632
33879,0.002566,172.31.47.0-255,66,185641,96,197632
33880,0.002597,172.217.194.0-255,7156,192797,96,197632
33881,0.002599,172.31.47.0-255,66,192863,96,197632
33882,0.002609,172.31.47.0-255,66,192929,96,197632
33883,0.002619,172.31.47.0-255,66,192995,96,197632
33884,0.002622,172.217.194.0-255,105,193100,96,197632
33885,0.008803,172.31.47.0-255,66,193166,96,197632
33886,0.008833,172.31.47.0-255,105,193271,96,197632
33887,0.011369,172.217.194.0-255,66,193337,96,197632
33888,0.026958,172.31.47.0-255,172,193509,96,197632
33889,0.026988,172.31.47.0-255,1105,194614,96,197632
33890,0.027016,172.31.47.0-255,1514,196128,96,197632
33891,0.027018,172.31.47.0-255,1306,197434,96,197632
33892,0.028532,104.244.42.0-255,66,197500,96,197632
33893,0.02854,104.244.42.0-255,66,197566,96,197632
33894,0.028568,104.244.42.0-255,66,197632,96,197632
33895,0.0,74.125.24.0-255,153,153,96,266712
33896,2.2e-05,172.31.47.0-255,66,219,96,266712
33897,5.9e-05,74.125.24.0-255,1484,1703,96,266712
33898,6.3e-05,172.31.47.0-255,66,1769,96,266712
33899,6.9e-05,74.125.24.0-255,2902,4671,96,266712
33900,7.2e-05,172.31.47.0-255,66,4737,96,266712
33901,8.4e-05,74.125.24.0-255,5738,10475,96,266712
33902,8.7e-05,172.31.47.0-255,66,10541,96,266712
33903,9.2e-05,74.125.24.0-255,3486,14027,96,266712
33904,9.5e-05,172.31.47.0-255,66,14093,96,266712
33905,0.000135,172.31.47.0-255,66,14159,96,266712
33906,0.000163,74.125.24.0-255,5379,19538,96,266712
33907,0.000166,172.31.47.0-255,66,19604,96,266712
33908,0.000214,74.125.24.0-255,1484,21088,96,266712
33909,0.000217,172.31.47.0-255,66,21154,96,266712
33910,0.000222,74.125.24.0-255,2902,24056,96,266712
33911,0.000224,172.31.47.0-255,66,24122,96,266712
33912,0.000258,74.125.24.0-255,5738,29860,96,266712
33913,0.000261,172.31.47.0-255,66,29926,96,266712
33914,0.000266,74.125.24.0-255,2902,32828,96,266712
33915,0.000268,172.31.47.0-255,66,32894,96,266712
33916,0.000312,172.31.47.0-255,66,32960,96,266712
33917,0.000339,74.125.24.0-255,7156,40116,96,266712
33918,0.000342,172.31.47.0-255,66,40182,96,266712
33919,0.000366,74.125.24.0-255,3895,44077,96,266712
33920,0.000369,172.31.47.0-255,66,44143,96,266712
33921,0.0004,74.125.24.0-255,383,44526,96,266712
33922,0.000403,172.31.47.0-255,66,44592,96,266712
33923,0.000578,74.125.24.0-255,1484,46076,96,266712
33924,0.000582,172.31.47.0-255,66,46142,96,266712
33925,0.000608,74.125.24.0-255,1484,47626,96,266712
33926,0.000626,74.125.24.0-255,1484,49110,96,266712
33927,0.000633,74.125.24.0-255,5738,54848,96,266712
33928,0.000654,172.31.47.0-255,66,54914,96,266712
33929,0.00067,74.125.24.0-255,4320,59234,96,266712
33930,0.000673,74.125.24.0-255,1484,60718,96,266712
33931,0.00068,74.125.24.0-255,7156,67874,96,266712
33932,0.000693,74.125.24.0-255,2184,70058,96,266712
33933,0.000705,172.31.47.0-255,66,70124,96,266712
33934,0.000759,74.125.24.0-255,1484,71608,96,266712
33935,0.000772,74.125.24.0-255,2902,74510,96,266712
33936,0.000794,74.125.24.0-255,1484,75994,96,266712
33937,0.000808,74.125.24.0-255,1484,77478,96,266712
33938,0.000813,172.31.47.0-255,66,77544,96,266712
33939,0.000823,74.125.24.0-255,4320,81864,96,266712
33940,0.000842,172.31.47.0-255,66,81930,96,266712
33941,0.000847,74.125.24.0-255,1484,83414,96,266712
33942,0.000868,74.125.24.0-255,4320,87734,96,266712
33943,0.000893,172.31.47.0-255,66,87800,96,266712
33944,0.000898,74.125.24.0-255,2902,90702,96,266712
33945,0.000904,172.31.47.0-255,66,90768,96,266712
33946,0.000923,74.125.24.0-255,5738,96506,96,266712
33947,0.00094,74.125.24.0-255,2902,99408,96,266712
33948,0.000966,74.125.24.0-255,4472,103880,96,266712
33949,0.000978,74.125.24.0-255,2902,106782,96,266712
33950,0.000981,172.31.47.0-255,66,106848,96,266712
33951,0.000987,172.31.47.0-255,66,106914,96,266712
33952,0.00101,74.125.24.0-255,7156,114070,96,266712
33953,0.001022,74.125.24.0-255,7156,121226,96,266712
33954,0.001038,74.125.24.0-255,7156,128382,96,266712
33955,0.001049,74.125.24.0-255,1484,129866,96,266712
33956,0.001056,74.125.24.0-255,7156,137022,96,266712
33957,0.00107,172.31.47.0-255,66,137088,96,266712
33958,0.001114,172.31.47.0-255,66,137154,96,266712
33959,0.001121,74.125.24.0-255,1484,138638,96,266712
33960,0.001143,74.125.24.0-255,2184,140822,96,266712
33961,0.001158,172.31.47.0-255,66,140888,96,266712
33962,0.001526,74.125.24.0-255,1484,142372,96,266712
33963,0.001532,74.125.24.0-255,1484,143856,96,266712
33964,0.001543,74.125.24.0-255,1484,145340,96,266712
33965,0.001554,172.31.47.0-255,66,145406,96,266712
33966,0.001588,74.125.24.0-255,5738,151144,96,266712
33967,0.0016,172.31.47.0-255,66,151210,96,266712
33968,0.001677,74.125.24.0-255,1484,152694,96,266712
33969,0.001698,172.31.47.0-255,66,152760,96,266712
33970,0.00176,74.125.24.0-255,1484,154244,96,266712
33971,0.001777,74.125.24.0-255,2902,157146,96,266712
33972,0.001794,172.31.47.0-255,66,157212,96,266712
33973,0.001805,74.125.24.0-255,2902,160114,96,266712
33974,0.001821,74.125.24.0-255,2902,163016,96,266712
33975,0.001823,172.31.47.0-255,66,163082,96,266712
33976,0.001862,74.125.24.0-255,1484,164566,96,266712
33977,0.001871,172.31.47.0-255,66,164632,96,266712
33978,0.001922,172.31.47.0-255,66,164698,96,266712
33979,0.001965,74.125.24.0-255,1484,166182,96,266712
33980,0.00197,74.125.24.0-255,2902,169084,96,266712
33981,0.001974,74.125.24.0-255,2902,171986,96,266712
33982,0.001983,172.31.47.0-255,66,172052,96,266712
33983,0.002005,74.125.24.0-255,2902,174954,96,266712
33984,0.002009,74.125.24.0-255,1484,176438,96,266712
33985,0.002024,74.125.24.0-255,7156,183594,96,266712
33986,0.002035,172.31.47.0-255,66,183660,96,266712
33987,0.002042,74.125.24.0-255,6438,190098,96,266712
33988,0.002062,172.31.47.0-255,66,190164,96,266712
33989,0.002175,74.125.24.0-255,1484,191648,96,266712
33990,0.002182,74.125.24.0-255,2902,194550,96,266712
33991,0.002188,74.125.24.0-255,5738,200288,96,266712
33992,0.002224,172.31.47.0-255,66,200354,96,266712
33993,0.002244,74.125.24.0-255,4320,204674,96,266712
33994,0.00227,172.31.47.0-255,66,204740,96,266712
33995,0.002279,74.125.24.0-255,4320,209060,96,266712
33996,0.002284,172.31.47.0-255,66,209126,96,266712
33997,0.002341,74.125.24.0-255,5020,214146,96,266712
33998,0.002353,172.31.47.0-255,66,214212,96,266712
33999,0.004664,74.125.24.0-255,5738,219950,96,266712
34000,0.00467,172.31.47.0-255,66,220016,96,266712
34001,0.007048,74.125.24.0-255,4320,224336,96,266712
34002,0.007065,74.125.24.0-255,1484,225820,96,266712
34003,0.010308,172.31.47.0-255,66,225886,96,266712
34004,0.012625,74.125.24.0-255,5738,231624,96,266712
34005,0.012634,172.31.47.0-255,66,231690,96,266712
34006,0.01497,74.125.24.0-255,5738,237428,96,266712
34007,0.017618,172.31.47.0-255,66,237494,96,266712
34008,0.019938,74.125.24.0-255,5738,243232,96,266712
34009,0.019947,172.31.47.0-255,66,243298,96,266712
34010,0.022294,74.125.24.0-255,5738,249036,96,266712
34011,0.022302,172.31.47.0-255,66,249102,96,266712
34012,0.024624,74.125.24.0-255,5738,254840,96,266712
34013,0.024631,172.31.47.0-255,66,254906,96,266712
34014,0.026945,74.125.24.0-255,5364,260270,96,266712
34015,0.026951,172.31.47.0-255,66,260336,96,266712
34016,0.028943,172.31.47.0-255,105,260441,96,266712
34017,0.030603,172.31.47.0-255,172,260613,96,266712
34018,0.030635,172.31.47.0-255,1105,261718,96,266712
34019,0.030696,172.31.47.0-255,1514,263232,96,266712
34020,0.030698,172.31.47.0-255,1514,264746,96,266712
34021,0.030699,172.31.47.0-255,1514,266260,96,266712
34022,0.0307,172.31.47.0-255,122,266382,96,266712
34023,0.031244,74.125.24.0-255,66,266448,96,266712
34024,0.03217,104.244.42.0-255,66,266514,96,266712
34025,0.032198,104.244.42.0-255,66,266580,96,266712
34026,0.03224,104.244.42.0-255,66,266646,96,266712
34027,0.032253,104.244.42.0-255,66,266712,96,266712
34028,0.0,172.31.47.0-255,105,105,96,105
34029,0.0,172.217.194.0-255,153,153,96,249924
34030,3.1e-05,172.31.47.0-255,66,219,96,249924
34031,3.7e-05,172.217.194.0-255,1484,1703,96,249924
34032,4.1e-05,172.31.47.0-255,66,1769,96,249924
34033,4.6e-05,172.217.194.0-255,2902,4671,96,249924
34034,4.8e-05,172.31.47.0-255,66,4737,96,249924
34035,6.2e-05,172.217.194.0-255,7156,11893,96,249924
34036,6.5e-05,172.31.47.0-255,66,11959,96,249924
34037,0.000117,172.31.47.0-255,66,12025,96,249924
34038,0.00012,172.217.194.0-255,1484,13509,96,249924
34039,0.000122,172.31.47.0-255,66,13575,96,249924
34040,0.000151,172.217.194.0-255,6797,20372,96,249924
34041,0.000159,172.31.47.0-255,66,20438,96,249924
34042,0.000227,172.217.194.0-255,1484,21922,96,249924
34043,0.00023,172.31.47.0-255,66,21988,96,249924
34044,0.000256,172.217.194.0-255,2902,24890,96,249924
34045,0.000258,172.31.47.0-255,66,24956,96,249924
34046,0.000263,172.217.194.0-255,5738,30694,96,249924
34047,0.000265,172.31.47.0-255,66,30760,96,249924
34048,0.000291,172.217.194.0-255,7156,37916,96,249924
34049,0.000294,172.31.47.0-255,66,37982,96,249924
34050,0.000314,172.217.194.0-255,5379,43361,96,249924
34051,0.000316,172.31.47.0-255,66,43427,96,249924
34052,0.000321,172.217.194.0-255,2902,46329,96,249924
34053,0.000324,172.31.47.0-255,66,46395,96,249924
34054,0.000361,172.217.194.0-255,398,46793,96,249924
34055,0.000364,172.31.47.0-255,66,46859,96,249924
34056,0.000367,172.31.47.0-255,66,46925,96,249924
34057,0.00042,172.217.194.0-255,1484,48409,96,249924
34058,0.000424,172.31.47.0-255,66,48475,96,249924
34059,0.000428,172.217.194.0-255,2902,51377,96,249924
34060,0.00043,172.31.47.0-255,66,51443,96,249924
34061,0.000433,172.217.194.0-255,1484,52927,96,249924
34062,0.000435,172.31.47.0-255,66,52993,96,249924
34063,0.000461,172.217.194.0-255,4320,57313,96,249924
34064,0.000468,172.31.47.0-255,66,57379,96,249924
34065,0.000469,172.217.194.0-255,7156,64535,96,249924
34066,0.000474,172.31.47.0-255,66,64601,96,249924
34067,0.000509,172.217.194.0-255,5738,70339,96,249924
34068,0.000512,172.31.47.0-255,66,70405,96,249924
34069,0.000529,172.31.47.0-255,66,70471,96,249924
34070,0.001022,172.217.194.0-255,1484,71955,96,249924
34071,0.001031,172.217.194.0-255,2902,74857,96,249924
34072,0.001034,172.31.47.0-255,66,74923,96,249924
34073,0.001039,172.217.194.0-255,5738,80661,96,249924
34074,0.001041,172.31.47.0-255,66,80727,96,249924
34075,0.001071,172.31.47.0-255,66,80793,96,249924
34076,0.001109,172.31.47.0-255,66,80859,96,249924
34077,0.001851,172.217.194.0-255,1484,82343,96,249924
34078,0.001859,172.217.194.0-255,2902,85245,96,249924
34079,0.001863,172.31.47.0-255,66,85311,96,249924
34080,0.001867,172.217.194.0-255,1484,86795,96,249924
34081,0.001891,172.217.194.0-255,4320,91115,96,249924
34082,0.001893,172.31.47.0-255,66,91181,96,249924
34083,0.001904,172.31.47.0-255,66,91247,96,249924
34084,0.001933,172.217.194.0-255,2902,94149,96,249924
34085,0.001936,172.31.47.0-255,66,94215,96,249924
34086,0.001948,172.31.47.0-255,66,94281,96,249924
34087,0.002011,172.217.194.0-255,4320,98601,96,249924
34088,0.002114,172.217.194.0-255,3602,102203,96,249924
34089,0.002131,172.217.194.0-255,4320,106523,96,249924
34090,0.002145,172.217.194.0-255,4320,110843,96,249924
34091,0.002162,172.217.194.0-255,5738,116581,96,249924
34092,0.002193,172.217.194.0-255,2902,119483,96,249924
34093,0.002219,172.217.194.0-255,6438,125921,96,249924
34094,0.002257,172.217.194.0-255,5738,131659,96,249924
34095,0.002277,172.217.194.0-255,1484,133143,96,249924
34096,0.002284,172.217.194.0-255,7156,140299,96,249924
34097,0.002288,172.217.194.0-255,2902,143201,96,249924
34098,0.002323,172.217.194.0-255,5738,148939,96,249924
34099,0.002352,172.217.194.0-255,2184,151123,96,249924
34100,0.009722,172.31.47.0-255,66,151189,96,249924
34101,0.011559,172.217.194.0-255,1484,152673,96,249924
34102,0.012064,172.217.194.0-255,4320,156993,96,249924
34103,0.012071,172.31.47.0-255,66,157059,96,249924
34104,0.014403,172.217.194.0-255,5738,162797,96,249924
34105,0.014419,172.31.47.0-255,66,162863,96,249924
34106,0.016735,172.217.194.0-255,5738,168601,96,249924
34107,0.016754,172.31.47.0-255,66,168667,96,249924
34108,0.019052,172.217.194.0-255,5738,174405,96,249924
34109,0.01906,172.31.47.0-255,66,174471,96,249924
34110,0.021384,172.217.194.0-255,5738,180209,96,249924
34111,0.021391,172.31.47.0-255,66,180275,96,249924
34112,0.023718,172.217.194.0-255,5738,186013,96,249924
34113,0.023729,172.31.47.0-255,66,186079,96,249924
34114,0.026048,172.217.194.0-255,5738,191817,96,249924
34115,0.026057,172.31.47.0-255,66,191883,96,249924
34116,0.028362,172.217.194.0-255,5738,197621,96,249924
34117,0.02837,172.31.47.0-255,66,197687,96,249924
34118,0.030673,172.217.194.0-255,5738,203425,96,249924
34119,0.03069,172.31.47.0-255,66,203491,96,249924
34120,0.032997,172.217.194.0-255,5738,209229,96,249924
34121,0.033008,172.31.47.0-255,66,209295,96,249924
34122,0.035418,172.217.194.0-255,5738,215033,96,249924
34123,0.035441,172.31.47.0-255,66,215099,96,249924
34124,0.037753,172.217.194.0-255,5738,220837,96,249924
34125,0.037761,172.31.47.0-255,66,220903,96,249924
34126,0.040079,172.217.194.0-255,5738,226641,96,249924
34127,0.040088,172.31.47.0-255,66,226707,96,249924
34128,0.042395,172.217.194.0-255,5738,232445,96,249924
34129,0.042405,172.31.47.0-255,66,232511,96,249924
34130,0.044711,172.217.194.0-255,5738,238249,96,249924
34131,0.04472,172.31.47.0-255,66,238315,96,249924
34132,0.047058,172.217.194.0-255,5738,244053,96,249924
34133,0.047075,172.31.47.0-255,66,244119,96,249924
34134,0.049386,172.217.194.0-255,1267,245386,96,249924
34135,0.049539,172.31.47.0-255,66,245452,96,249924
34136,0.049568,172.31.47.0-255,105,245557,96,249924
34137,0.050385,172.31.47.0-255,176,245733,96,249924
34138,0.050416,172.31.47.0-255,1101,246834,96,249924
34139,0.05045,172.31.47.0-255,1514,248348,96,249924
34140,0.050469,172.31.47.0-255,1312,249660,96,249924
34141,0.051867,172.217.194.0-255,66,249726,96,249924
34142,0.051909,104.244.42.0-255,66,249792,96,249924
34143,0.052081,104.244.42.0-255,66,249858,96,249924
34144,0.052135,104.244.42.0-255,66,249924,96,249924
34145,0.0,74.125.24.0-255,153,153,96,286991
34146,3.1e-05,172.31.47.0-255,66,219,96,286991
34147,3.7e-05,74.125.24.0-255,1484,1703,96,286991
34148,4.1e-05,172.31.47.0-255,66,1769,96,286991
34149,4.6e-05,74.125.24.0-255,2902,4671,96,286991
34150,5.5e-05,172.31.47.0-255,66,4737,96,286991
34151,6.1e-05,74.125.24.0-255,5738,10475,96,286991
34152,6.4e-05,172.31.47.0-255,66,10541,96,286991
34153,0.000108,74.125.24.0-255,3404,13945,96,286991
34154,0.000111,172.31.47.0-255,66,14011,96,286991
34155,0.000203,74.125.24.0-255,1484,15495,96,286991
34156,0.000208,172.31.47.0-255,66,15561,96,286991
34157,0.000213,74.125.24.0-255,2902,18463,96,286991
34158,0.000215,172.31.47.0-255,66,18529,96,286991
34159,0.000218,74.125.24.0-255,1484,20013,96,286991
34160,0.000226,172.31.47.0-255,66,20079,96,286991
34161,0.000258,74.125.24.0-255,4320,24399,96,286991
34162,0.000261,172.31.47.0-255,66,24465,96,286991
34163,0.000269,74.125.24.0-255,6797,31262,96,286991
34164,0.000271,172.31.47.0-255,66,31328,96,286991
34165,0.000474,74.125.24.0-255,1484,32812,96,286991
34166,0.000478,172.31.47.0-255,66,32878,96,286991
34167,0.000483,74.125.24.0-255,2902,35780,96,286991
34168,0.000486,172.31.47.0-255,66,35846,96,286991
34169,0.000522,74.125.24.0-255,5738,41584,96,286991
34170,0.000525,172.31.47.0-255,66,41650,96,286991
34171,0.000528,74.125.24.0-255,1484,43134,96,286991
34172,0.00053,172.31.47.0-255,66,43200,96,286991
34173,0.000556,74.125.24.0-255,5379,48579,96,286991
34174,0.000565,172.31.47.0-255,66,48645,96,286991
34175,0.00095,74.125.24.0-255,1484,50129,96,286991
34176,0.000957,172.31.47.0-255,66,50195,96,286991
34177,0.000966,74.125.24.0-255,2902,53097,96,286991
34178,0.00097,172.31.47.0-255,66,53163,96,286991
34179,0.000983,74.125.24.0-255,5738,58901,96,286991
34180,0.000986,172.31.47.0-255,66,58967,96,286991
34181,0.001036,74.125.24.0-255,6797,65764,96,286991
34182,0.00104,172.31.47.0-255,66,65830,96,286991
34183,0.001113,74.125.24.0-255,1484,67314,96,286991
34184,0.00112,74.125.24.0-255,2902,70216,96,286991
34185,0.001123,172.31.47.0-255,66,70282,96,286991
34186,0.001155,74.125.24.0-255,5738,76020,96,286991
34187,0.001158,172.31.47.0-255,66,76086,96,286991
34188,0.001193,172.31.47.0-255,66,76152,96,286991
34189,0.001633,74.125.24.0-255,1484,77636,96,286991
34190,0.001642,74.125.24.0-255,2902,80538,96,286991
34191,0.001646,172.31.47.0-255,66,80604,96,286991
34192,0.001652,74.125.24.0-255,2902,83506,96,286991
34193,0.001653,172.31.47.0-255,66,83572,96,286991
34194,0.001689,74.125.24.0-255,2902,86474,96,286991
34195,0.001692,172.31.47.0-255,66,86540,96,286991
34196,0.001703,172.31.47.0-255,66,86606,96,286991
34197,0.001715,172.31.47.0-255,66,86672,96,286991
34198,0.001803,74.125.24.0-255,1484,88156,96,286991
34199,0.001807,74.125.24.0-255,2902,91058,96,286991
34200,0.001813,172.31.47.0-255,66,91124,96,286991
34201,0.00183,74.125.24.0-255,4320,95444,96,286991
34202,0.001832,172.31.47.0-255,66,95510,96,286991
34203,0.001855,74.125.24.0-255,1484,96994,96,286991
34204,0.001858,74.125.24.0-255,1484,98478,96,286991
34205,0.00186,172.31.47.0-255,66,98544,96,286991
34206,0.001889,74.125.24.0-255,5379,103923,96,286991
34207,0.001892,172.31.47.0-255,66,103989,96,286991
34208,0.001928,74.125.24.0-255,1484,105473,96,286991
34209,0.001945,74.125.24.0-255,2902,108375,96,286991
34210,0.001947,172.31.47.0-255,66,108441,96,286991
34211,0.001952,74.125.24.0-255,2902,111343,96,286991
34212,0.001954,172.31.47.0-255,66,111409,96,286991
34213,0.001979,74.125.24.0-255,2902,114311,96,286991
34214,0.001985,172.31.47.0-255,66,114377,96,286991
34215,0.001995,172.31.47.0-255,66,114443,96,286991
34216,0.002014,74.125.24.0-255,1484,115927,96,286991
34217,0.002048,172.31.47.0-255,66,115993,96,286991
34218,0.002661,74.125.24.0-255,1484,117477,96,286991
34219,0.002669,74.125.24.0-255,2902,120379,96,286991
34220,0.002673,172.31.47.0-255,66,120445,96,286991
34221,0.00268,74.125.24.0-255,5738,126183,96,286991
34222,0.002682,172.31.47.0-255,66,126249,96,286991
34223,0.002692,74.125.24.0-255,5738,131987,96,286991
34224,0.002694,172.31.47.0-255,66,132053,96,286991
34225,0.002697,74.125.24.0-255,1484,133537,96,286991
34226,0.002728,172.31.47.0-255,66,133603,96,286991
34227,0.002734,74.125.24.0-255,5020,138623,96,286991
34228,0.002735,172.31.47.0-255,66,138689,96,286991
34229,0.002778,74.125.24.0-255,1484,140173,96,286991
34230,0.002791,74.125.24.0-255,1484,141657,96,286991
34231,0.002793,172.31.47.0-255,66,141723,96,286991
34232,0.002804,74.125.24.0-255,1484,143207,96,286991
34233,0.002811,74.125.24.0-255,1484,144691,96,286991
34234,0.002813,172.31.47.0-255,66,144757,96,286991
34235,0.002818,74.125.24.0-255,2902,147659,96,286991
34236,0.002819,172.31.47.0-255,66,147725,96,286991
34237,0.002843,74.125.24.0-255,5738,153463,96,286991
34238,0.002847,172.31.47.0-255,66,153529,96,286991
34239,0.002851,74.125.24.0-255,2902,156431,96,286991
34240,0.002853,172.31.47.0-255,66,156497,96,286991
34241,0.002916,172.31.47.0-255,66,156563,96,286991
34242,0.002942,74.125.24.0-255,1484,158047,96,286991
34243,0.002947,74.125.24.0-255,3602,161649,96,286991
34244,0.002949,172.31.47.0-255,66,161715,96,286991
34245,0.002952,74.125.24.0-255,1484,163199,96,286991
34246,0.002955,74.125.24.0-255,2902,166101,96,286991
34247,0.002957,172.31.47.0-255,66,166167,96,286991
34248,0.002962,74.125.24.0-255,4320,170487,96,286991
34249,0.002964,172.31.47.0-255,66,170553,96,286991
34250,0.00299,74.125.24.0-255,1484,172037,96,286991
34251,0.00302,172.31.47.0-255,66,172103,96,286991
34252,0.003047,74.125.24.0-255,2902,175005,96,286991
34253,0.00305,172.31.47.0-255,66,175071,96,286991
34254,0.003084,172.31.47.0-255,66,175137,96,286991
34255,0.003222,74.125.24.0-255,1484,176621,96,286991
34256,0.003237,74.125.24.0-255,2902,179523,96,286991
34257,0.003246,172.31.47.0-255,66,179589,96,286991
34258,0.003265,74.125.24.0-255,4320,183909,96,286991
34259,0.003268,172.31.47.0-255,66,183975,96,286991
34260,0.003272,74.125.24.0-255,1484,185459,96,286991
34261,0.003299,74.125.24.0-255,7156,192615,96,286991
34262,0.003303,172.31.47.0-255,66,192681,96,286991
34263,0.003318,172.31.47.0-255,66,192747,96,286991
34264,0.003346,74.125.24.0-255,2902,195649,96,286991
34265,0.00335,172.31.47.0-255,66,195715,96,286991
34266,0.00338,74.125.24.0-255,5020,200735,96,286991
34267,0.003383,172.31.47.0-255,66,200801,96,286991
34268,0.003477,74.125.24.0-255,1484,202285,96,286991
34269,0.00348,74.125.24.0-255,1484,203769,96,286991
34270,0.003484,172.31.47.0-255,66,203835,96,286991
34271,0.003506,74.125.24.0-255,1484,205319,96,286991
34272,0.003508,74.125.24.0-255,1484,206803,96,286991
34273,0.003511,172.31.47.0-255,66,206869,96,286991
34274,0.003532,74.125.24.0-255,1484,208353,96,286991
34275,0.003546,74.125.24.0-255,2902,211255,96,286991
34276,0.003549,172.31.47.0-255,66,211321,96,286991
34277,0.003574,74.125.24.0-255,1484,212805,96,286991
34278,0.003587,172.31.47.0-255,66,212871,96,286991
34279,0.003591,74.125.24.0-255,4320,217191,96,286991
34280,0.003594,172.31.47.0-255,66,217257,96,286991
34281,0.003623,74.125.24.0-255,5020,222277,96,286991
34282,0.003626,172.31.47.0-255,66,222343,96,286991
34283,0.004186,74.125.24.0-255,1484,223827,96,286991
34284,0.004207,74.125.24.0-255,2902,226729,96,286991
34285,0.004211,172.31.47.0-255,66,226795,96,286991
34286,0.004234,74.125.24.0-255,4320,231115,96,286991
34287,0.004238,172.31.47.0-255,66,231181,96,286991
34288,0.004245,74.125.24.0-255,1484,232665,96,286991
34289,0.004266,74.125.24.0-255,4320,236985,96,286991
34290,0.004269,74.125.24.0-255,2902,239887,96,286991
34291,0.00427,74.125.24.0-255,1484,241371,96,286991
34292,0.004273,172.31.47.0-255,66,241437,96,286991
34293,0.004275,172.31.47.0-255,66,241503,96,286991
34294,0.004311,74.125.24.0-255,4320,245823,96,286991
34295,0.004314,172.31.47.0-255,66,245889,96,286991
34296,0.00435,172.31.47.0-255,66,245955,96,286991
34297,0.004409,74.125.24.0-255,1484,247439,96,286991
34298,0.004423,74.125.24.0-255,2902,250341,96,286991
34299,0.004425,172.31.47.0-255,66,250407,96,286991
34300,0.004451,74.125.24.0-255,5738,256145,96,286991
34301,0.004453,172.31.47.0-255,66,256211,96,286991
34302,0.004458,74.125.24.0-255,4320,260531,96,286991
34303,0.004459,172.31.47.0-255,66,260597,96,286991
34304,0.00448,74.125.24.0-255,7156,267753,96,286991
34305,0.004484,172.31.47.0-255,66,267819,96,286991
34306,0.004487,74.125.24.0-255,1484,269303,96,286991
34307,0.004506,74.125.24.0-255,2902,272205,96,286991
34308,0.004508,172.31.47.0-255,66,272271,96,286991
34309,0.004539,172.31.47.0-255,66,272337,96,286991
34310,0.004668,74.125.24.0-255,1484,273821,96,286991
34311,0.004686,74.125.24.0-255,2902,276723,96,286991
34312,0.004689,172.31.47.0-255,66,276789,96,286991
34313,0.004734,74.125.24.0-255,2902,279691,96,286991
34314,0.004736,172.31.47.0-255,66,279757,96,286991
34315,0.004762,74.125.24.0-255,2531,282288,96,286991
34316,0.004764,172.31.47.0-255,66,282354,96,286991
34317,0.004767,74.125.24.0-255,105,282459,96,286991
34318,0.005282,172.31.47.0-255,66,282525,96,286991
34319,0.005314,172.31.47.0-255,105,282630,96,286991
34320,0.007841,74.125.24.0-255,66,282696,96,286991
34321,0.027055,172.31.47.0-255,172,282868,96,286991
34322,0.027109,172.31.47.0-255,1109,283977,96,286991
34323,0.027179,172.31.47.0-255,1514,285491,96,286991
34324,0.027181,172.31.47.0-255,1302,286793,96,286991
34325,0.028602,104.244.42.0-255,66,286859,96,286991
34326,0.02865,104.244.42.0-255,66,286925,96,286991
34327,0.028755,104.244.42.0-255,66,286991,96,286991
34328,0.0,74.125.68.0-255,153,153,96,355342
34329,2.4e-05,172.31.47.0-255,66,219,96,355342
34330,3e-05,74.125.68.0-255,1484,1703,96,355342
34331,3.4e-05,172.31.47.0-255,66,1769,96,355342
34332,3.8e-05,74.125.68.0-255,2902,4671,96,355342
34333,3.9e-05,172.31.47.0-255,66,4737,96,355342
34334,5.6e-05,74.125.68.0-255,1484,6221,96,355342
34335,5.8e-05,172.31.47.0-255,66,6287,96,355342
34336,7.8e-05,74.125.68.0-255,5738,12025,96,355342
34337,8e-05,172.31.47.0-255,66,12091,96,355342
34338,8.4e-05,74.125.68.0-255,2003,14094,96,355342
34339,8.6e-05,172.31.47.0-255,66,14160,96,355342
34340,9e-05,74.125.68.0-255,2902,17062,96,355342
34341,9.2e-05,172.31.47.0-255,66,17128,96,355342
34342,0.00011,74.125.68.0-255,2902,20030,96,355342
34343,0.000113,172.31.47.0-255,66,20096,96,355342
34344,0.000128,74.125.68.0-255,4320,24416,96,355342
34345,0.00013,172.31.47.0-255,66,24482,96,355342
34346,0.000134,74.125.68.0-255,4320,28802,96,355342
34347,0.000135,172.31.47.0-255,66,28868,96,355342
34348,0.000173,74.125.68.0-255,2543,31411,96,355342
34349,0.000176,172.31.47.0-255,66,31477,96,355342
34350,0.000213,74.125.68.0-255,2902,34379,96,355342
34351,0.000216,172.31.47.0-255,66,34445,96,355342
34352,0.000234,74.125.68.0-255,2902,37347,96,355342
34353,0.000236,172.31.47.0-255,66,37413,96,355342
34354,0.000249,74.125.68.0-255,2902,40315,96,355342
34355,0.000252,172.31.47.0-255,66,40381,96,355342
34356,0.000258,74.125.68.0-255,7156,47537,96,355342
34357,0.00026,172.31.47.0-255,66,47603,96,355342
34358,0.00028,74.125.68.0-255,1125,48728,96,355342
34359,0.000283,172.31.47.0-255,66,48794,96,355342
34360,0.000508,74.125.68.0-255,1484,50278,96,355342
34361,0.000512,74.125.68.0-255,1484,51762,96,355342
34362,0.000515,172.31.47.0-255,66,51828,96,355342
34363,0.000533,74.125.68.0-255,1484,53312,96,355342
34364,0.000537,74.125.68.0-255,1484,54796,96,355342
34365,0.000539,172.31.47.0-255,66,54862,96,355342
34366,0.000542,74.125.68.0-255,2902,57764,96,355342
34367,0.000544,172.31.47.0-255,66,57830,96,355342
34368,0.000563,74.125.68.0-255,2902,60732,96,355342
34369,0.000565,172.31.47.0-255,66,60798,96,355342
34370,0.000586,74.125.68.0-255,2902,63700,96,355342
34371,0.000588,172.31.47.0-255,66,63766,96,355342
34372,0.000592,74.125.68.0-255,2543,66309,96,355342
34373,0.000593,172.31.47.0-255,66,66375,96,355342
34374,0.00086,74.125.68.0-255,646,67021,96,355342
34375,0.000893,74.125.68.0-255,1484,68505,96,355342
34376,0.000897,172.31.47.0-255,66,68571,96,355342
34377,0.00092,74.125.68.0-255,4320,72891,96,355342
34378,0.000922,172.31.47.0-255,66,72957,96,355342
34379,0.000962,74.125.68.0-255,4320,77277,96,355342
34380,0.000966,172.31.47.0-255,66,77343,96,355342
34381,0.000979,74.125.68.0-255,1484,78827,96,355342
34382,0.000995,74.125.68.0-255,4320,83147,96,355342
34383,0.000997,172.31.47.0-255,66,83213,96,355342
34384,0.001001,74.125.68.0-255,2902,86115,96,355342
34385,0.001002,172.31.47.0-255,66,86181,96,355342
34386,0.001019,74.125.68.0-255,4320,90501,96,355342
34387,0.001021,172.31.47.0-255,66,90567,96,355342
34388,0.001024,74.125.68.0-255,1484,92051,96,355342
34389,0.001046,74.125.68.0-255,7156,99207,96,355342
34390,0.001048,172.31.47.0-255,66,99273,96,355342
34391,0.001051,74.125.68.0-255,2184,101457,96,355342
34392,0.001053,172.31.47.0-255,66,101523,96,355342
34393,0.001089,74.125.68.0-255,1484,103007,96,355342
34394,0.001101,74.125.68.0-255,2902,105909,96,355342
34395,0.001103,172.31.47.0-255,66,105975,96,355342
34396,0.00113,74.125.68.0-255,5738,111713,96,355342
34397,0.001132,172.31.47.0-255,66,111779,96,355342
34398,0.001135,74.125.68.0-255,1484,113263,96,355342
34399,0.001151,74.125.68.0-255,7156,120419,96,355342
34400,0.001154,172.31.47.0-255,66,120485,96,355342
34401,0.001183,172.31.47.0-255,66,120551,96,355342
34402,0.001197,74.125.68.0-255,1484,122035,96,355342
34403,0.001202,74.125.68.0-255,5020,127055,96,355342
34404,0.001205,172.31.47.0-255,66,127121,96,355342
34405,0.001247,74.125.68.0-255,1484,128605,96,355342
34406,0.001252,74.125.68.0-255,2902,131507,96,355342
34407,0.001255,172.31.47.0-255,66,131573,96,355342
34408,0.001275,74.125.68.0-255,5738,137311,96,355342
34409,0.001278,172.31.47.0-255,66,137377,96,355342
34410,0.001289,74.125.68.0-255,4320,141697,96,355342
34411,0.001292,172.31.47.0-255,66,141763,96,355342
34412,0.001308,74.125.68.0-255,5738,147501,96,355342
34413,0.00131,172.31.47.0-255,66,147567,96,355342
34414,0.001314,74.125.68.0-255,2902,150469,96,355342
34415,0.001315,172.31.47.0-255,66,150535,96,355342
34416,0.00135,172.31.47.0-255,66,150601,96,355342
34417,0.001353,74.125.68.0-255,2184,152785,96,355342
34418,0.001355,172.31.47.0-255,66,152851,96,355342
34419,0.001839,74.125.68.0-255,1484,154335,96,355342
34420,0.001877,74.125.68.0-255,2902,157237,96,355342
34421,0.00188,172.31.47.0-255,66,157303,96,355342
34422,0.001923,74.125.68.0-255,1484,158787,96,355342
34423,0.001943,74.125.68.0-255,1484,160271,96,355342
34424,0.001945,172.31.47.0-255,66,160337,96,355342
34425,0.001962,74.125.68.0-255,1484,161821,96,355342
34426,0.00201,74.125.68.0-255,2902,164723,96,355342
34427,0.002012,172.31.47.0-255,66,164789,96,355342
34428,0.002042,74.125.68.0-255,1484,166273,96,355342
34429,0.002056,74.125.68.0-255,2902,169175,96,355342
34430,0.002059,172.31.47.0-255,66,169241,96,355342
34431,0.004063,74.125.68.0-255,1484,170725,96,355342
34432,0.004104,74.125.68.0-255,2902,173627,96,355342
34433,0.004106,172.31.47.0-255,66,173693,96,355342
34434,0.004126,74.125.68.0-255,1484,175177,96,355342
34435,0.006163,74.125.68.0-255,1484,176661,96,355342
34436,0.006168,172.31.47.0-255,66,176727,96,355342
34437,0.006198,74.125.68.0-255,2902,179629,96,355342
34438,0.006201,172.31.47.0-255,66,179695,96,355342
34439,0.008232,74.125.68.0-255,4320,184015,96,355342
34440,0.008238,172.31.47.0-255,66,184081,96,355342
34441,0.008257,74.125.68.0-255,1484,185565,96,355342
34442,0.010307,74.125.68.0-255,4320,189885,96,355342
34443,0.010313,172.31.47.0-255,66,189951,96,355342
34444,0.012383,74.125.68.0-255,5738,195689,96,355342
34445,0.012394,172.31.47.0-255,66,195755,96,355342
34446,0.014445,74.125.68.0-255,5738,201493,96,355342
34447,0.014451,172.31.47.0-255,66,201559,96,355342
34448,0.016513,74.125.68.0-255,5738,207297,96,355342
34449,0.016519,172.31.47.0-255,66,207363,96,355342
34450,0.018571,74.125.68.0-255,2902,210265,96,355342
34451,0.018576,172.31.47.0-255,66,210331,96,355342
34452,0.018603,74.125.68.0-255,2902,213233,96,355342
34453,0.018606,172.31.47.0-255,66,213299,96,355342
34454,0.020624,74.125.68.0-255,2902,216201,96,355342
34455,0.020631,172.31.47.0-255,66,216267,96,355342
34456,0.020662,74.125.68.0-255,2902,219169,96,355342
34457,0.020665,172.31.47.0-255,66,219235,96,355342
34458,0.021667,172.31.47.0-255,172,219407,96,355342
34459,0.021697,172.31.47.0-255,1110,220517,96,355342
34460,0.021725,172.31.47.0-255,1514,222031,96,355342
34461,0.021727,172.31.47.0-255,1301,223332,96,355342
34462,0.02269,74.125.68.0-255,2902,226234,96,355342
34463,0.022695,172.31.47.0-255,66,226300,96,355342
34464,0.022725,74.125.68.0-255,2902,229202,96,355342
34465,0.022727,172.31.47.0-255,66,229268,96,355342
34466,0.023203,104.244.42.0-255,66,229334,96,355342
34467,0.023256,104.244.42.0-255,66,229400,96,355342
34468,0.023258,104.244.42.0-255,66,229466,96,355342
34469,0.024751,74.125.68.0-255,2902,232368,96,355342
34470,0.024756,172.31.47.0-255,66,232434,96,355342
34471,0.024807,74.125.68.0-255,2902,235336,96,355342
34472,0.02481,172.31.47.0-255,66,235402,96,355342
34473,0.026811,74.125.68.0-255,2902,238304,96,355342
34474,0.026817,172.31.47.0-255,66,238370,96,355342
34475,0.026857,74.125.68.0-255,2902,241272,96,355342
34476,0.026861,172.31.47.0-255,66,241338,96,355342
34477,0.028872,74.125.68.0-255,2902,244240,96,355342
34478,0.028877,172.31.47.0-255,66,244306,96,355342
34479,0.028899,74.125.68.0-255,1484,245790,96,355342
34480,0.028909,74.125.68.0-255,1484,247274,96,355342
34481,0.028912,172.31.47.0-255,66,247340,96,355342
34482,0.030933,74.125.68.0-255,2902,250242,96,355342
34483,0.030939,172.31.47.0-255,66,250308,96,355342
34484,0.030971,74.125.68.0-255,2902,253210,96,355342
34485,0.030974,172.31.47.0-255,66,253276,96,355342
34486,0.032995,74.125.68.0-255,2902,256178,96,355342
34487,0.033001,172.31.47.0-255,66,256244,96,355342
34488,0.033029,74.125.68.0-255,2902,259146,96,355342
34489,0.033032,172.31.47.0-255,66,259212,96,355342
34490,0.035067,74.125.68.0-255,2902,262114,96,355342
34491,0.035072,172.31.47.0-255,66,262180,96,355342
34492,0.035098,74.125.68.0-255,2902,265082,96,355342
34493,0.0351,172.31.47.0-255,66,265148,96,355342
34494,0.03712,74.125.68.0-255,2902,268050,96,355342
34495,0.037125,172.31.47.0-255,66,268116,96,355342
34496,0.037154,74.125.68.0-255,2902,271018,96,355342
34497,0.037157,172.31.47.0-255,66,271084,96,355342
34498,0.039171,74.125.68.0-255,2902,273986,96,355342
34499,0.039175,172.31.47.0-255,66,274052,96,355342
34500,0.039204,74.125.68.0-255,1484,275536,96,355342
34501,0.039215,74.125.68.0-255,1484,277020,96,355342
34502,0.039219,172.31.47.0-255,66,277086,96,355342
34503,0.041236,74.125.68.0-255,2902,279988,96,355342
34504,0.041241,172.31.47.0-255,66,280054,96,355342
34505,0.041274,74.125.68.0-255,2902,282956,96,355342
34506,0.041277,172.31.47.0-255,66,283022,96,355342
34507,0.043288,74.125.68.0-255,2902,285924,96,355342
34508,0.043293,172.31.47.0-255,66,285990,96,355342
34509,0.043325,74.125.68.0-255,2902,288892,96,355342
34510,0.043328,172.31.47.0-255,66,288958,96,355342
34511,0.045364,74.125.68.0-255,2902,291860,96,355342
34512,0.04537,172.31.47.0-255,66,291926,96,355342
34513,0.045399,74.125.68.0-255,2902,294828,96,355342
34514,0.045402,172.31.47.0-255,66,294894,96,355342
34515,0.047412,74.125.68.0-255,2902,297796,96,355342
34516,0.047418,172.31.47.0-255,66,297862,96,355342
34517,0.047446,74.125.68.0-255,1484,299346,96,355342
34518,0.047464,74.125.68.0-255,1484,300830,96,355342
34519,0.047467,172.31.47.0-255,66,300896,96,355342
34520,0.049467,74.125.68.0-255,2902,303798,96,355342
34521,0.049472,172.31.47.0-255,66,303864,96,355342
34522,0.049504,74.125.68.0-255,1484,305348,96,355342
34523,0.049521,74.125.68.0-255,1484,306832,96,355342
34524,0.049525,172.31.47.0-255,66,306898,96,355342
34525,0.051522,74.125.68.0-255,2902,309800,96,355342
34526,0.051528,172.31.47.0-255,66,309866,96,355342
34527,0.051568,74.125.68.0-255,2902,312768,96,355342
34528,0.051571,172.31.47.0-255,66,312834,96,355342
34529,0.053592,74.125.68.0-255,2902,315736,96,355342
34530,0.053597,172.31.47.0-255,66,315802,96,355342
34531,0.053629,74.125.68.0-255,2902,318704,96,355342
34532,0.053632,172.31.47.0-255,66,318770,96,355342
34533,0.055666,74.125.68.0-255,4320,323090,96,355342
34534,0.055671,172.31.47.0-255,66,323156,96,355342
34535,0.055702,74.125.68.0-255,1484,324640,96,355342
34536,0.05772,74.125.68.0-255,2902,327542,96,355342
34537,0.057725,172.31.47.0-255,66,327608,96,355342
34538,0.057756,74.125.68.0-255,1484,329092,96,355342
34539,0.05978,74.125.68.0-255,2902,331994,96,355342
34540,0.059784,172.31.47.0-255,66,332060,96,355342
34541,0.059812,74.125.68.0-255,1484,333544,96,355342
34542,0.061848,74.125.68.0-255,4320,337864,96,355342
34543,0.061854,172.31.47.0-255,66,337930,96,355342
34544,0.06391,74.125.68.0-255,5738,343668,96,355342
34545,0.063915,172.31.47.0-255,66,343734,96,355342
34546,0.065969,74.125.68.0-255,5738,349472,96,355342
34547,0.065975,172.31.47.0-255,66,349538,96,355342
34548,0.068025,74.125.68.0-255,5738,355276,96,355342
34549,0.06803,172.31.47.0-255,66,355342,96,355342
34550,0.0,172.217.194.0-255,153,153,96,277997
34551,2.8e-05,172.31.47.0-255,66,219,96,277997
34552,3.5e-05,172.217.194.0-255,1484,1703,96,277997
34553,3.9e-05,172.31.47.0-255,66,1769,96,277997
34554,4.4e-05,172.217.194.0-255,2902,4671,96,277997
34555,4.6e-05,172.31.47.0-255,66,4737,96,277997
34556,5.3e-05,172.217.194.0-255,5738,10475,96,277997
34557,5.6e-05,172.31.47.0-255,66,10541,96,277997
34558,8.4e-05,172.217.194.0-255,6263,16804,96,277997
34559,8.7e-05,172.31.47.0-255,66,16870,96,277997
34560,0.00011,172.217.194.0-255,5738,22608,96,277997
34561,0.000112,172.31.47.0-255,66,22674,96,277997
34562,0.000135,172.31.47.0-255,66,22740,96,277997
34563,0.000186,172.217.194.0-255,1484,24224,96,277997
34564,0.000189,172.31.47.0-255,66,24290,96,277997
34565,0.000194,172.217.194.0-255,2902,27192,96,277997
34566,0.000196,172.31.47.0-255,66,27258,96,277997
34567,0.000211,172.217.194.0-255,4320,31578,96,277997
34568,0.000214,172.31.47.0-255,66,31644,96,277997
34569,0.000229,172.217.194.0-255,1484,33128,96,277997
34570,0.000232,172.31.47.0-255,66,33194,96,277997
34571,0.000259,172.217.194.0-255,4320,37514,96,277997
34572,0.000264,172.31.47.0-255,66,37580,96,277997
34573,0.000276,172.217.194.0-255,5379,42959,96,277997
34574,0.000279,172.31.47.0-255,66,43025,96,277997
34575,0.000283,172.217.194.0-255,2902,45927,96,277997
34576,0.000286,172.31.47.0-255,66,45993,96,277997
34577,0.000314,172.217.194.0-255,7156,53149,96,277997
34578,0.000317,172.31.47.0-255,66,53215,96,277997
34579,0.000322,172.217.194.0-255,3961,57176,96,277997
34580,0.000326,172.31.47.0-255,66,57242,96,277997
34581,0.001309,172.217.194.0-255,646,57888,96,277997
34582,0.001554,172.217.194.0-255,1484,59372,96,277997
34583,0.00156,172.31.47.0-255,66,59438,96,277997
34584,0.001579,172.217.194.0-255,2902,62340,96,277997
34585,0.001581,172.31.47.0-255,66,62406,96,277997
34586,0.001585,172.217.194.0-255,1484,63890,96,277997
34587,0.001605,172.217.194.0-255,4320,68210,96,277997
34588,0.001607,172.31.47.0-255,66,68276,96,277997
34589,0.001644,172.31.47.0-255,66,68342,96,277997
34590,0.001666,172.217.194.0-255,4320,72662,96,277997
34591,0.001668,172.31.47.0-255,66,72728,96,277997
34592,0.001681,172.31.47.0-255,66,72794,96,277997
34593,0.00199,172.217.194.0-255,1484,74278,96,277997
34594,0.002007,172.217.194.0-255,2902,77180,96,277997
34595,0.002009,172.31.47.0-255,66,77246,96,277997
34596,0.002028,172.217.194.0-255,5738,82984,96,277997
34597,0.00203,172.31.47.0-255,66,83050,96,277997
34598,0.00205,172.217.194.0-255,1484,84534,96,277997
34599,0.002077,172.31.47.0-255,66,84600,96,277997
34600,0.002084,172.217.194.0-255,7156,91756,96,277997
34601,0.002085,172.31.47.0-255,66,91822,96,277997
34602,0.002119,172.217.194.0-255,2902,94724,96,277997
34603,0.002121,172.31.47.0-255,66,94790,96,277997
34604,0.002134,172.217.194.0-255,766,95556,96,277997
34605,0.002268,172.217.194.0-255,1484,97040,96,277997
34606,0.002271,172.31.47.0-255,66,97106,96,277997
34607,0.004393,172.217.194.0-255,2902,100008,96,277997
34608,0.004399,172.31.47.0-255,66,100074,96,277997
34609,0.004556,172.217.194.0-255,2902,102976,96,277997
34610,0.004559,172.31.47.0-255,66,103042,96,277997
34611,0.006629,172.217.194.0-255,2902,105944,96,277997
34612,0.006635,172.31.47.0-255,66,106010,96,277997
34613,0.006815,172.217.194.0-255,2902,108912,96,277997
34614,0.00682,172.31.47.0-255,66,108978,96,277997
34615,0.00887,172.217.194.0-255,2902,111880,96,277997
34616,0.008876,172.31.47.0-255,66,111946,96,277997
34617,0.009072,172.217.194.0-255,2902,114848,96,277997
34618,0.009078,172.31.47.0-255,66,114914,96,277997
34619,0.011124,172.217.194.0-255,2902,117816,96,277997
34620,0.011134,172.31.47.0-255,66,117882,96,277997
34621,0.01131,172.217.194.0-255,2902,120784,96,277997
34622,0.011316,172.31.47.0-255,66,120850,96,277997
34623,0.013413,172.217.194.0-255,2902,123752,96,277997
34624,0.013423,172.31.47.0-255,66,123818,96,277997
34625,0.013566,172.217.194.0-255,2902,126720,96,277997
34626,0.013572,172.31.47.0-255,66,126786,96,277997
34627,0.015681,172.217.194.0-255,2902,129688,96,277997
34628,0.015687,172.31.47.0-255,66,129754,96,277997
34629,0.015811,172.217.194.0-255,2902,132656,96,277997
34630,0.015813,172.31.47.0-255,66,132722,96,277997
34631,0.017946,172.217.194.0-255,2902,135624,96,277997
34632,0.017953,172.31.47.0-255,66,135690,96,277997
34633,0.018073,172.217.194.0-255,2902,138592,96,277997
34634,0.018079,172.31.47.0-255,66,138658,96,277997
34635,0.020207,172.217.194.0-255,2902,141560,96,277997
34636,0.020213,172.31.47.0-255,66,141626,96,277997
34637,0.02035,172.217.194.0-255,2902,144528,96,277997
34638,0.020355,172.31.47.0-255,66,144594,96,277997
34639,0.022448,172.217.194.0-255,2902,147496,96,277997
34640,0.022455,172.31.47.0-255,66,147562,96,277997
34641,0.022616,172.217.194.0-255,2902,150464,96,277997
34642,0.022621,172.31.47.0-255,66,150530,96,277997
34643,0.024744,172.217.194.0-255,2902,153432,96,277997
34644,0.02475,172.31.47.0-255,66,153498,96,277997
34645,0.024869,172.217.194.0-255,2902,156400,96,277997
34646,0.024873,172.31.47.0-255,66,156466,96,277997
34647,0.026995,172.217.194.0-255,2902,159368,96,277997
34648,0.027001,172.31.47.0-255,66,159434,96,277997
34649,0.027152,172.217.194.0-255,2902,162336,96,277997
34650,0.027156,172.31.47.0-255,66,162402,96,277997
34651,0.029234,172.217.194.0-255,2902,165304,96,277997
34652,0.029241,172.31.47.0-255,66,165370,96,277997
34653,0.029404,172.217.194.0-255,2902,168272,96,277997
34654,0.029409,172.31.47.0-255,66,168338,96,277997
34655,0.030898,172.31.47.0-255,172,168510,96,277997
34656,0.030925,172.31.47.0-255,1111,169621,96,277997
34657,0.030956,172.31.47.0-255,1514,171135,96,277997
34658,0.030958,172.31.47.0-255,1300,172435,96,277997
34659,0.031482,172.217.194.0-255,2902,175337,96,277997
34660,0.031489,172.31.47.0-255,66,175403,96,277997
34661,0.031652,172.217.194.0-255,2902,178305,96,277997
34662,0.031656,172.31.47.0-255,66,178371,96,277997
34663,0.032441,104.244.42.0-255,66,178437,96,277997
34664,0.032475,104.244.42.0-255,66,178503,96,277997
34665,0.032539,104.244.42.0-255,66,178569,96,277997
34666,0.033717,172.217.194.0-255,2902,181471,96,277997
34667,0.033724,172.31.47.0-255,66,181537,96,277997
34668,0.033894,172.217.194.0-255,2902,184439,96,277997
34669,0.033897,172.31.47.0-255,66,184505,96,277997
34670,0.035974,172.217.194.0-255,2902,187407,96,277997
34671,0.035979,172.31.47.0-255,66,187473,96,277997
34672,0.036153,172.217.194.0-255,2902,190375,96,277997
34673,0.036158,172.31.47.0-255,66,190441,96,277997
34674,0.038223,172.217.194.0-255,2902,193343,96,277997
34675,0.038228,172.31.47.0-255,66,193409,96,277997
34676,0.038399,172.217.194.0-255,2902,196311,96,277997
34677,0.038405,172.31.47.0-255,66,196377,96,277997
34678,0.040473,172.217.194.0-255,2902,199279,96,277997
34679,0.040478,172.31.47.0-255,66,199345,96,277997
34680,0.040625,172.217.194.0-255,2902,202247,96,277997
34681,0.04063,172.31.47.0-255,66,202313,96,277997
34682,0.04273,172.217.194.0-255,2902,205215,96,277997
34683,0.042749,172.31.47.0-255,66,205281,96,277997
34684,0.042867,172.217.194.0-255,2902,208183,96,277997
34685,0.042873,172.31.47.0-255,66,208249,96,277997
34686,0.044992,172.217.194.0-255,2902,211151,96,277997
34687,0.044997,172.31.47.0-255,66,211217,96,277997
34688,0.045117,172.217.194.0-255,2902,214119,96,277997
34689,0.045122,172.31.47.0-255,66,214185,96,277997
34690,0.047244,172.217.194.0-255,2902,217087,96,277997
34691,0.047249,172.31.47.0-255,66,217153,96,277997
34692,0.047356,172.217.194.0-255,2902,220055,96,277997
34693,0.047359,172.31.47.0-255,66,220121,96,277997
34694,0.0495,172.217.194.0-255,2902,223023,96,277997
34695,0.049507,172.31.47.0-255,66,223089,96,277997
34696,0.049578,172.217.194.0-255,1484,224573,96,277997
34697,0.049591,172.217.194.0-255,1484,226057,96,277997
34698,0.049594,172.31.47.0-255,66,226123,96,277997
34699,0.051773,172.217.194.0-255,2902,229025,96,277997
34700,0.051779,172.31.47.0-255,66,229091,96,277997
34701,0.05184,172.217.194.0-255,1484,230575,96,277997
34702,0.05189,172.217.194.0-255,1484,232059,96,277997
34703,0.051894,172.31.47.0-255,66,232125,96,277997
34704,0.054036,172.217.194.0-255,2902,235027,96,277997
34705,0.054041,172.31.47.0-255,66,235093,96,277997
34706,0.054151,172.217.194.0-255,2902,237995,96,277997
34707,0.054155,172.31.47.0-255,66,238061,96,277997
34708,0.056285,172.217.194.0-255,2902,240963,96,277997
34709,0.056289,172.31.47.0-255,66,241029,96,277997
34710,0.056393,172.217.194.0-255,2902,243931,96,277997
34711,0.056397,172.31.47.0-255,66,243997,96,277997
34712,0.058563,172.217.194.0-255,2902,246899,96,277997
34713,0.058567,172.31.47.0-255,66,246965,96,277997
34714,0.058633,172.217.194.0-255,2902,249867,96,277997
34715,0.058637,172.31.47.0-255,66,249933,96,277997
34716,0.06082,172.217.194.0-255,2902,252835,96,277997
34717,0.060827,172.31.47.0-255,66,252901,96,277997
34718,0.060866,172.217.194.0-255,2902,255803,96,277997
34719,0.060869,172.31.47.0-255,66,255869,96,277997
34720,0.063081,172.217.194.0-255,2902,258771,96,277997
34721,0.063087,172.31.47.0-255,66,258837,96,277997
34722,0.063114,172.217.194.0-255,2902,261739,96,277997
34723,0.063117,172.31.47.0-255,66,261805,96,277997
34724,0.065358,172.217.194.0-255,2902,264707,96,277997
34725,0.065372,172.31.47.0-255,66,264773,96,277997
34726,0.065392,172.217.194.0-255,2902,267675,96,277997
34727,0.065396,172.31.47.0-255,66,267741,96,277997
34728,0.067664,172.217.194.0-255,4320,272061,96,277997
34729,0.067669,172.31.47.0-255,66,272127,96,277997
34730,0.067699,172.217.194.0-255,1484,273611,96,277997
34731,0.06991,172.217.194.0-255,4320,277931,96,277997
34732,0.069914,172.31.47.0-255,66,277997,96,277997
34733,0.0,172.217.194.0-255,304,304,96,270169
34734,2.5e-05,172.31.47.0-255,66,370,96,270169
34735,3.2e-05,172.217.194.0-255,1484,1854,96,270169
34736,3.6e-05,172.31.47.0-255,66,1920,96,270169
34737,4.3e-05,172.217.194.0-255,4320,6240,96,270169
34738,5.4e-05,172.31.47.0-255,66,6306,96,270169
34739,6.8e-05,172.31.47.0-255,66,6372,96,270169
34740,0.000109,172.217.194.0-255,5738,12110,96,270169
34741,0.000112,172.31.47.0-255,66,12176,96,270169
34742,0.000145,172.31.47.0-255,66,12242,96,270169
34743,0.00016,172.31.47.0-255,66,12308,96,270169
34744,0.000193,172.31.47.0-255,66,12374,96,270169
34745,0.0002,172.217.194.0-255,5738,18112,96,270169
34746,0.000202,172.31.47.0-255,66,18178,96,270169
34747,0.000227,172.217.194.0-255,4320,22498,96,270169
34748,0.00023,172.31.47.0-255,66,22564,96,270169
34749,0.000235,172.217.194.0-255,3961,26525,96,270169
34750,0.000238,172.31.47.0-255,66,26591,96,270169
34751,0.000271,172.217.194.0-255,4320,30911,96,270169
34752,0.000274,172.31.47.0-255,66,30977,96,270169
34753,0.000286,172.31.47.0-255,66,31043,96,270169
34754,0.000289,172.217.194.0-255,1484,32527,96,270169
34755,0.000291,172.31.47.0-255,66,32593,96,270169
34756,0.000341,172.217.194.0-255,7156,39749,96,270169
34757,0.000345,172.31.47.0-255,66,39815,96,270169
34758,0.000373,172.31.47.0-255,66,39881,96,270169
34759,0.000527,172.217.194.0-255,1484,41365,96,270169
34760,0.000535,172.217.194.0-255,2902,44267,96,270169
34761,0.000566,172.217.194.0-255,5738,50005,96,270169
34762,0.000578,172.217.194.0-255,1484,51489,96,270169
34763,0.000642,172.217.194.0-255,4320,55809,96,270169
34764,0.000661,172.217.194.0-255,6438,62247,96,270169
34765,0.000761,172.31.47.0-255,66,62313,96,270169
34766,0.000861,172.217.194.0-255,1484,63797,96,270169
34767,0.000876,172.217.194.0-255,2902,66699,96,270169
34768,0.000888,172.217.194.0-255,2902,69601,96,270169
34769,0.000917,172.217.194.0-255,7156,76757,96,270169
34770,0.000943,172.217.194.0-255,2902,79659,96,270169
34771,0.000982,172.217.194.0-255,4320,83979,96,270169
34772,0.000984,172.217.194.0-255,1484,85463,96,270169
34773,0.000987,172.217.194.0-255,1138,86601,96,270169
34774,0.00099,172.217.194.0-255,1484,88085,96,270169
34775,0.001012,172.217.194.0-255,4320,92405,96,270169
34776,0.001094,172.217.194.0-255,4320,96725,96,270169
34777,0.001106,172.217.194.0-255,766,97491,96,270169
34778,0.001156,172.31.47.0-255,66,97557,96,270169
34779,0.003454,172.217.194.0-255,5738,103295,96,270169
34780,0.003461,172.31.47.0-255,66,103361,96,270169
34781,0.005757,172.217.194.0-255,5738,109099,96,270169
34782,0.00768,172.31.47.0-255,66,109165,96,270169
34783,0.009964,172.217.194.0-255,5738,114903,96,270169
34784,0.009971,172.31.47.0-255,66,114969,96,270169
34785,0.012244,172.217.194.0-255,5738,120707,96,270169
34786,0.012264,172.31.47.0-255,66,120773,96,270169
34787,0.014535,172.217.194.0-255,5738,126511,96,270169
34788,0.014543,172.31.47.0-255,66,126577,96,270169
34789,0.016836,172.217.194.0-255,5738,132315,96,270169
34790,0.016844,172.31.47.0-255,66,132381,96,270169
34791,0.019115,172.217.194.0-255,5738,138119,96,270169
34792,0.019138,172.31.47.0-255,66,138185,96,270169
34793,0.021434,172.217.194.0-255,5738,143923,96,270169
34794,0.021441,172.31.47.0-255,66,143989,96,270169
34795,0.023718,172.217.194.0-255,5738,149727,96,270169
34796,0.023726,172.31.47.0-255,66,149793,96,270169
34797,0.026012,172.217.194.0-255,5738,155531,96,270169
34798,0.026018,172.31.47.0-255,66,155597,96,270169
34799,0.027083,172.31.47.0-255,172,155769,96,270169
34800,0.027113,172.31.47.0-255,1105,156874,96,270169
34801,0.027161,172.31.47.0-255,1514,158388,96,270169
34802,0.027162,172.31.47.0-255,1307,159695,96,270169
34803,0.028309,172.217.194.0-255,5738,165433,96,270169
34804,0.028316,172.31.47.0-255,66,165499,96,270169
34805,0.028619,104.244.42.0-255,66,165565,96,270169
34806,0.028682,104.244.42.0-255,66,165631,96,270169
34807,0.028699,104.244.42.0-255,66,165697,96,270169
34808,0.030613,172.217.194.0-255,5738,171435,96,270169
34809,0.030618,172.31.47.0-255,66,171501,96,270169
34810,0.032918,172.217.194.0-255,5738,177239,96,270169
34811,0.032925,172.31.47.0-255,66,177305,96,270169
34812,0.035223,172.217.194.0-255,5738,183043,96,270169
34813,0.035233,172.31.47.0-255,66,183109,96,270169
34814,0.037521,172.217.194.0-255,5738,188847,96,270169
34815,0.037528,172.31.47.0-255,66,188913,96,270169
34816,0.039824,172.217.194.0-255,5738,194651,96,270169
34817,0.039835,172.31.47.0-255,66,194717,96,270169
34818,0.04214,172.217.194.0-255,5738,200455,96,270169
34819,0.042146,172.31.47.0-255,66,200521,96,270169
34820,0.044453,172.217.194.0-255,5738,206259,96,270169
34821,0.044458,172.31.47.0-255,66,206325,96,270169
34822,0.046749,172.217.194.0-255,5738,212063,96,270169
34823,0.046754,172.31.47.0-255,66,212129,96,270169
34824,0.04905,172.217.194.0-255,5738,217867,96,270169
34825,0.049056,172.31.47.0-255,66,217933,96,270169
34826,0.051335,172.217.194.0-255,5738,223671,96,270169
34827,0.051345,172.31.47.0-255,66,223737,96,270169
34828,0.053649,172.217.194.0-255,5738,229475,96,270169
34829,0.053658,172.31.47.0-255,66,229541,96,270169
34830,0.055937,172.217.194.0-255,5738,235279,96,270169
34831,0.055944,172.31.47.0-255,66,235345,96,270169
34832,0.058245,172.217.194.0-255,5738,241083,96,270169
34833,0.058254,172.31.47.0-255,66,241149,96,270169
34834,0.06054,172.217.194.0-255,5738,246887,96,270169
34835,0.060547,172.31.47.0-255,66,246953,96,270169
34836,0.062834,172.217.194.0-255,5738,252691,96,270169
34837,0.06284,172.31.47.0-255,66,252757,96,270169
34838,0.065113,172.217.194.0-255,5738,258495,96,270169
34839,0.065118,172.31.47.0-255,66,258561,96,270169
34840,0.067407,172.217.194.0-255,5738,264299,96,270169
34841,0.067412,172.31.47.0-255,66,264365,96,270169
34842,0.069693,172.217.194.0-255,5738,270103,96,270169
34843,0.0697,172.31.47.0-255,66,270169,96,270169
34844,0.0,172.217.194.0-255,297,297,96,137573
34845,2.4e-05,172.31.47.0-255,66,363,96,137573
34846,3e-05,172.217.194.0-255,1484,1847,96,137573
34847,3.3e-05,172.31.47.0-255,66,1913,96,137573
34848,4e-05,172.217.194.0-255,4320,6233,96,137573
34849,4.2e-05,172.31.47.0-255,66,6299,96,137573
34850,4.5e-05,172.217.194.0-255,1484,7783,96,137573
34851,4.7e-05,172.31.47.0-255,66,7849,96,137573
34852,8.2e-05,172.31.47.0-255,66,7915,96,137573
34853,9.5e-05,172.31.47.0-255,66,7981,96,137573
34854,0.000122,172.217.194.0-255,2543,10524,96,137573
34855,0.000124,172.31.47.0-255,66,10590,96,137573
34856,0.000128,172.217.194.0-255,2902,13492,96,137573
34857,0.000129,172.31.47.0-255,66,13558,96,137573
34858,0.000147,172.217.194.0-255,7156,20714,96,137573
34859,0.00015,172.31.47.0-255,66,20780,96,137573
34860,0.000181,172.31.47.0-255,66,20846,96,137573
34861,0.00019,172.31.47.0-255,66,20912,96,137573
34862,0.000207,172.217.194.0-255,646,21558,96,137573
34863,0.000211,172.31.47.0-255,66,21624,96,137573
34864,0.000539,172.217.194.0-255,1484,23108,96,137573
34865,0.000544,172.217.194.0-255,2902,26010,96,137573
34866,0.000549,172.31.47.0-255,66,26076,96,137573
34867,0.000552,172.31.47.0-255,66,26142,96,137573
34868,0.000563,172.217.194.0-255,5738,31880,96,137573
34869,0.000565,172.31.47.0-255,66,31946,96,137573
34870,0.000584,172.217.194.0-255,2902,34848,96,137573
34871,0.000586,172.31.47.0-255,66,34914,96,137573
34872,0.000615,172.31.47.0-255,66,34980,96,137573
34873,0.000618,172.217.194.0-255,1484,36464,96,137573
34874,0.000673,172.31.47.0-255,66,36530,96,137573
34875,0.001041,172.217.194.0-255,1484,38014,96,137573
34876,0.00105,172.217.194.0-255,2902,40916,96,137573
34877,0.001054,172.31.47.0-255,66,40982,96,137573
34878,0.001062,172.217.194.0-255,5738,46720,96,137573
34879,0.001065,172.31.47.0-255,66,46786,96,137573
34880,0.001069,172.217.194.0-255,1484,48270,96,137573
34881,0.001103,172.31.47.0-255,66,48336,96,137573
34882,0.00112,172.31.47.0-255,66,48402,96,137573
34883,0.001215,172.217.194.0-255,1484,49886,96,137573
34884,0.001224,172.217.194.0-255,2902,52788,96,137573
34885,0.001227,172.31.47.0-255,66,52854,96,137573
34886,0.001236,172.217.194.0-255,5738,58592,96,137573
34887,0.00124,172.31.47.0-255,66,58658,96,137573
34888,0.001249,172.217.194.0-255,7156,65814,96,137573
34889,0.001252,172.31.47.0-255,66,65880,96,137573
34890,0.001285,172.217.194.0-255,5738,71618,96,137573
34891,0.001288,172.31.47.0-255,66,71684,96,137573
34892,0.001305,172.31.47.0-255,66,71750,96,137573
34893,0.001398,172.217.194.0-255,1484,73234,96,137573
34894,0.001418,172.217.194.0-255,2902,76136,96,137573
34895,0.001423,172.31.47.0-255,66,76202,96,137573
34896,0.00143,172.217.194.0-255,5738,81940,96,137573
34897,0.001434,172.31.47.0-255,66,82006,96,137573
34898,0.001483,172.31.47.0-255,66,82072,96,137573
34899,0.001523,172.31.47.0-255,66,82138,96,137573
34900,0.001545,172.217.194.0-255,2184,84322,96,137573
34901,0.001548,172.31.47.0-255,66,84388,96,137573
34902,0.001573,172.217.194.0-255,5738,90126,96,137573
34903,0.001581,172.217.194.0-255,7156,97282,96,137573
34904,0.001587,172.31.47.0-255,66,97348,96,137573
34905,0.001597,172.31.47.0-255,66,97414,96,137573
34906,0.001616,172.31.47.0-255,66,97480,96,137573
34907,0.001624,172.217.194.0-255,6438,103918,96,137573
34908,0.001627,172.31.47.0-255,66,103984,96,137573
34909,0.001682,172.31.47.0-255,66,104050,96,137573
34910,0.001808,172.217.194.0-255,1484,105534,96,137573
34911,0.001823,172.31.47.0-255,66,105600,96,137573
34912,0.001827,172.31.47.0-255,66,105666,96,137573
34913,0.00183,172.31.47.0-255,66,105732,96,137573
34914,0.001841,172.31.47.0-255,66,105798,96,137573
34915,0.001853,172.31.47.0-255,66,105864,96,137573
34916,0.001865,172.31.47.0-255,66,105930,96,137573
34917,0.00187,172.217.194.0-255,2902,108832,96,137573
34918,0.001873,172.31.47.0-255,66,108898,96,137573
34919,0.001897,172.31.47.0-255,66,108964,96,137573
34920,0.001921,172.217.194.0-255,2902,111866,96,137573
34921,0.001925,172.31.47.0-255,66,111932,96,137573
34922,0.001956,172.31.47.0-255,66,111998,96,137573
34923,0.001959,172.217.194.0-255,1484,113482,96,137573
34924,0.001991,172.217.194.0-255,4320,117802,96,137573
34925,0.001997,172.217.194.0-255,3602,121404,96,137573
34926,0.002008,172.31.47.0-255,66,121470,96,137573
34927,0.002032,172.217.194.0-255,7156,128626,96,137573
34928,0.002047,172.31.47.0-255,66,128692,96,137573
34929,0.00208,172.217.194.0-255,1484,130176,96,137573
34930,0.002121,172.217.194.0-255,2694,132870,96,137573
34931,0.002157,172.217.194.0-255,105,132975,96,137573
34932,0.00216,172.31.47.0-255,66,133041,96,137573
34933,0.02956,172.31.47.0-255,66,133107,96,137573
34934,0.029624,172.31.47.0-255,105,133212,96,137573
34935,0.031874,172.217.194.0-255,66,133278,96,137573
34936,0.066186,172.31.47.0-255,172,133450,96,137573
34937,0.066244,172.31.47.0-255,1105,134555,96,137573
34938,0.066326,172.31.47.0-255,1514,136069,96,137573
34939,0.066328,172.31.47.0-255,1306,137375,96,137573
34940,0.067729,104.244.42.0-255,66,137441,96,137573
34941,0.067871,104.244.42.0-255,66,137507,96,137573
34942,0.067876,104.244.42.0-255,66,137573,96,137573
34943,0.0,74.125.24.0-255,153,153,96,204628
34944,2.5e-05,172.31.47.0-255,66,219,96,204628
34945,3.1e-05,74.125.24.0-255,1484,1703,96,204628
34946,3.5e-05,172.31.47.0-255,66,1769,96,204628
34947,3.9e-05,74.125.24.0-255,2902,4671,96,204628
34948,4.1e-05,172.31.47.0-255,66,4737,96,204628
34949,4.7e-05,74.125.24.0-255,7156,11893,96,204628
34950,5e-05,172.31.47.0-255,66,11959,96,204628
34951,5.3e-05,74.125.24.0-255,2015,13974,96,204628
34952,5.5e-05,172.31.47.0-255,66,14040,96,204628
34953,5.8e-05,74.125.24.0-255,1484,15524,96,204628
34954,5.9e-05,172.31.47.0-255,66,15590,96,204628
34955,8.8e-05,172.31.47.0-255,66,15656,96,204628
34956,0.000113,74.125.24.0-255,5379,21035,96,204628
34957,0.000115,172.31.47.0-255,66,21101,96,204628
34958,0.000149,74.125.24.0-255,1484,22585,96,204628
34959,0.000151,172.31.47.0-255,66,22651,96,204628
34960,0.000155,74.125.24.0-255,1484,24135,96,204628
34961,0.000157,172.31.47.0-255,66,24201,96,204628
34962,0.00017,74.125.24.0-255,1484,25685,96,204628
34963,0.000172,172.31.47.0-255,66,25751,96,204628
34964,0.000178,74.125.24.0-255,5738,31489,96,204628
34965,0.00018,172.31.47.0-255,66,31555,96,204628
34966,0.000192,74.125.24.0-255,2902,34457,96,204628
34967,0.000194,172.31.47.0-255,66,34523,96,204628
34968,0.00021,74.125.24.0-255,6797,41320,96,204628
34969,0.000213,172.31.47.0-255,66,41386,96,204628
34970,0.000217,74.125.24.0-255,2902,44288,96,204628
34971,0.000219,172.31.47.0-255,66,44354,96,204628
34972,0.000246,74.125.24.0-255,7156,51510,96,204628
34973,0.000249,172.31.47.0-255,66,51576,96,204628
34974,0.000254,74.125.24.0-255,4234,55810,96,204628
34975,0.000256,172.31.47.0-255,66,55876,96,204628
34976,0.000446,74.125.24.0-255,132,56008,96,204628
34977,0.000542,74.125.24.0-255,1484,57492,96,204628
34978,0.000546,172.31.47.0-255,66,57558,96,204628
34979,0.00055,74.125.24.0-255,2902,60460,96,204628
34980,0.000552,172.31.47.0-255,66,60526,96,204628
34981,0.000564,74.125.24.0-255,1484,62010,96,204628
34982,0.000584,74.125.24.0-255,4320,66330,96,204628
34983,0.000586,172.31.47.0-255,66,66396,96,204628
34984,0.000615,172.31.47.0-255,66,66462,96,204628
34985,0.000651,74.125.24.0-255,5738,72200,96,204628
34986,0.000654,172.31.47.0-255,66,72266,96,204628
34987,0.000666,74.125.24.0-255,1484,73750,96,204628
34988,0.000669,74.125.24.0-255,2804,76554,96,204628
34989,0.000671,172.31.47.0-255,66,76620,96,204628
34990,0.000675,74.125.24.0-255,2902,79522,96,204628
34991,0.000677,172.31.47.0-255,66,79588,96,204628
34992,0.000682,74.125.24.0-255,7156,86744,96,204628
34993,0.000685,172.31.47.0-255,66,86810,96,204628
34994,0.0007,74.125.24.0-255,1484,88294,96,204628
34995,0.000713,74.125.24.0-255,2902,91196,96,204628
34996,0.000716,172.31.47.0-255,66,91262,96,204628
34997,0.000746,172.31.47.0-255,66,91328,96,204628
34998,0.000756,172.31.47.0-255,66,91394,96,204628
34999,0.000916,74.125.24.0-255,1484,92878,96,204628
35000,0.00092,74.125.24.0-255,2902,95780,96,204628
35001,0.000923,172.31.47.0-255,66,95846,96,204628
35002,0.000926,74.125.24.0-255,1484,97330,96,204628
35003,0.000945,74.125.24.0-255,4320,101650,96,204628
35004,0.000947,172.31.47.0-255,66,101716,96,204628
35005,0.000952,74.125.24.0-255,2902,104618,96,204628
35006,0.000954,172.31.47.0-255,66,104684,96,204628
35007,0.000995,172.31.47.0-255,66,104750,96,204628
35008,0.001001,74.125.24.0-255,7156,111906,96,204628
35009,0.001004,172.31.47.0-255,66,111972,96,204628
35010,0.001009,74.125.24.0-255,5738,117710,96,204628
35011,0.001011,172.31.47.0-255,66,117776,96,204628
35012,0.00106,172.31.47.0-255,66,117842,96,204628
35013,0.001071,172.31.47.0-255,66,117908,96,204628
35014,0.001101,172.31.47.0-255,66,117974,96,204628
35015,0.001135,172.31.47.0-255,66,118040,96,204628
35016,0.001158,74.125.24.0-255,5020,123060,96,204628
35017,0.001161,172.31.47.0-255,66,123126,96,204628
35018,0.001165,74.125.24.0-255,2184,125310,96,204628
35019,0.001167,172.31.47.0-255,66,125376,96,204628
35020,0.00117,74.125.24.0-255,2902,128278,96,204628
35021,0.001174,172.31.47.0-255,66,128344,96,204628
35022,0.001181,74.125.24.0-255,7156,135500,96,204628
35023,0.001184,172.31.47.0-255,66,135566,96,204628
35024,0.0012,172.31.47.0-255,66,135632,96,204628
35025,0.001252,172.31.47.0-255,66,135698,96,204628
35026,0.0013,172.31.47.0-255,66,135764,96,204628
35027,0.001322,74.125.24.0-255,7156,142920,96,204628
35028,0.001325,172.31.47.0-255,66,142986,96,204628
35029,0.00134,172.31.47.0-255,66,143052,96,204628
35030,0.001343,74.125.24.0-255,1484,144536,96,204628
35031,0.001348,74.125.24.0-255,2902,147438,96,204628
35032,0.00135,172.31.47.0-255,66,147504,96,204628
35033,0.001357,74.125.24.0-255,5738,153242,96,204628
35034,0.001359,172.31.47.0-255,66,153308,96,204628
35035,0.001382,172.31.47.0-255,66,153374,96,204628
35036,0.0014,74.125.24.0-255,4320,157694,96,204628
35037,0.001403,172.31.47.0-255,66,157760,96,204628
35038,0.001409,74.125.24.0-255,7156,164916,96,204628
35039,0.001412,172.31.47.0-255,66,164982,96,204628
35040,0.001429,74.125.24.0-255,3602,168584,96,204628
35041,0.001433,172.31.47.0-255,66,168650,96,204628
35042,0.001475,74.125.24.0-255,2902,171552,96,204628
35043,0.001478,172.31.47.0-255,66,171618,96,204628
35044,0.001484,74.125.24.0-255,4320,175938,96,204628
35045,0.001486,172.31.47.0-255,66,176004,96,204628
35046,0.001522,172.31.47.0-255,66,176070,96,204628
35047,0.001525,74.125.24.0-255,1484,177554,96,204628
35048,0.001552,172.31.47.0-255,66,177620,96,204628
35049,0.001592,172.31.47.0-255,66,177686,96,204628
35050,0.001606,74.125.24.0-255,1484,179170,96,204628
35051,0.001623,74.125.24.0-255,7156,186326,96,204628
35052,0.001626,172.31.47.0-255,66,186392,96,204628
35053,0.001633,74.125.24.0-255,5738,192130,96,204628
35054,0.001635,172.31.47.0-255,66,192196,96,204628
35055,0.00165,74.125.24.0-255,2902,195098,96,204628
35056,0.001653,172.31.47.0-255,66,195164,96,204628
35057,0.001683,74.125.24.0-255,2902,198066,96,204628
35058,0.001689,172.31.47.0-255,66,198132,96,204628
35059,0.001722,172.31.47.0-255,66,198198,96,204628
35060,0.001733,172.31.47.0-255,66,198264,96,204628
35061,0.001756,74.125.24.0-255,1661,199925,96,204628
35062,0.00176,172.31.47.0-255,66,199991,96,204628
35063,0.001763,74.125.24.0-255,105,200096,96,204628
35064,0.003458,172.31.47.0-255,66,200162,96,204628
35065,0.003484,172.31.47.0-255,105,200267,96,204628
35066,0.005995,74.125.24.0-255,66,200333,96,204628
35067,0.030321,172.31.47.0-255,172,200505,96,204628
35068,0.03035,172.31.47.0-255,1110,201615,96,204628
35069,0.030394,172.31.47.0-255,1514,203129,96,204628
35070,0.030396,172.31.47.0-255,1301,204430,96,204628
35071,0.031856,104.244.42.0-255,66,204496,96,204628
35072,0.032033,104.244.42.0-255,66,204562,96,204628
35073,0.032036,104.244.42.0-255,66,204628,96,204628
35074,0.0,172.31.47.0-255,66,66,96,66
35075,0.0,74.125.24.0-255,153,153,96,280615
35076,2.6e-05,172.31.47.0-255,66,219,96,280615
35077,3.2e-05,74.125.24.0-255,1484,1703,96,280615
35078,3.6e-05,172.31.47.0-255,66,1769,96,280615
35079,4.1e-05,74.125.24.0-255,2902,4671,96,280615
35080,4.3e-05,172.31.47.0-255,66,4737,96,280615
35081,4.6e-05,74.125.24.0-255,1484,6221,96,280615
35082,4.8e-05,172.31.47.0-255,66,6287,96,280615
35083,7.6e-05,74.125.24.0-255,5738,12025,96,280615
35084,7.9e-05,74.125.24.0-255,2206,14231,96,280615
35085,8e-05,172.31.47.0-255,66,14297,96,280615
35086,8.4e-05,172.31.47.0-255,66,14363,96,280615
35087,0.00011,74.125.24.0-255,2902,17265,96,280615
35088,0.000114,172.31.47.0-255,66,17331,96,280615
35089,0.000137,172.31.47.0-255,66,17397,96,280615
35090,0.000144,74.125.24.0-255,5379,22776,96,280615
35091,0.000146,172.31.47.0-255,66,22842,96,280615
35092,0.000181,74.125.24.0-255,1484,24326,96,280615
35093,0.000184,172.31.47.0-255,66,24392,96,280615
35094,0.000188,74.125.24.0-255,1484,25876,96,280615
35095,0.000189,172.31.47.0-255,66,25942,96,280615
35096,0.000203,74.125.24.0-255,1484,27426,96,280615
35097,0.000205,172.31.47.0-255,66,27492,96,280615
35098,0.000212,74.125.24.0-255,5738,33230,96,280615
35099,0.000215,172.31.47.0-255,66,33296,96,280615
35100,0.000218,74.125.24.0-255,1484,34780,96,280615
35101,0.000219,172.31.47.0-255,66,34846,96,280615
35102,0.000246,74.125.24.0-255,5379,40225,96,280615
35103,0.000249,172.31.47.0-255,66,40291,96,280615
35104,0.000543,74.125.24.0-255,1484,41775,96,280615
35105,0.000548,172.31.47.0-255,66,41841,96,280615
35106,0.000563,74.125.24.0-255,2902,44743,96,280615
35107,0.000566,172.31.47.0-255,66,44809,96,280615
35108,0.000571,74.125.24.0-255,2902,47711,96,280615
35109,0.000573,172.31.47.0-255,66,47777,96,280615
35110,0.000591,74.125.24.0-255,2902,50679,96,280615
35111,0.000594,74.125.24.0-255,1484,52163,96,280615
35112,0.000596,172.31.47.0-255,66,52229,96,280615
35113,0.000631,74.125.24.0-255,5379,57608,96,280615
35114,0.000635,172.31.47.0-255,66,57674,96,280615
35115,0.000658,74.125.24.0-255,5738,63412,96,280615
35116,0.000662,172.31.47.0-255,66,63478,96,280615
35117,0.000704,172.31.47.0-255,66,63544,96,280615
35118,0.000738,74.125.24.0-255,2902,66446,96,280615
35119,0.000741,172.31.47.0-255,66,66512,96,280615
35120,0.000775,172.31.47.0-255,66,66578,96,280615
35121,0.00078,74.125.24.0-255,2902,69480,96,280615
35122,0.000782,172.31.47.0-255,66,69546,96,280615
35123,0.000786,74.125.24.0-255,4320,73866,96,280615
35124,0.000789,172.31.47.0-255,66,73932,96,280615
35125,0.000792,74.125.24.0-255,1484,75416,96,280615
35126,0.000809,74.125.24.0-255,7156,82572,96,280615
35127,0.000814,172.31.47.0-255,66,82638,96,280615
35128,0.000867,172.31.47.0-255,66,82704,96,280615
35129,0.000906,74.125.24.0-255,3602,86306,96,280615
35130,0.000909,172.31.47.0-255,66,86372,96,280615
35131,0.000955,74.125.24.0-255,2902,89274,96,280615
35132,0.000959,172.31.47.0-255,66,89340,96,280615
35133,0.000982,74.125.24.0-255,1484,90824,96,280615
35134,0.000994,172.31.47.0-255,66,90890,96,280615
35135,0.001004,172.31.47.0-255,66,90956,96,280615
35136,0.001045,74.125.24.0-255,7156,98112,96,280615
35137,0.001049,172.31.47.0-255,66,98178,96,280615
35138,0.001066,74.125.24.0-255,3602,101780,96,280615
35139,0.001069,172.31.47.0-255,66,101846,96,280615
35140,0.00154,74.125.24.0-255,1484,103330,96,280615
35141,0.001547,74.125.24.0-255,2902,106232,96,280615
35142,0.001551,172.31.47.0-255,66,106298,96,280615
35143,0.001557,74.125.24.0-255,5738,112036,96,280615
35144,0.001559,172.31.47.0-255,66,112102,96,280615
35145,0.001577,74.125.24.0-255,2902,115004,96,280615
35146,0.00158,172.31.47.0-255,66,115070,96,280615
35147,0.001613,172.31.47.0-255,66,115136,96,280615
35148,0.001626,172.31.47.0-255,66,115202,96,280615
35149,0.002301,74.125.24.0-255,1484,116686,96,280615
35150,0.002313,74.125.24.0-255,2902,119588,96,280615
35151,0.002317,172.31.47.0-255,66,119654,96,280615
35152,0.002325,74.125.24.0-255,5738,125392,96,280615
35153,0.002327,172.31.47.0-255,66,125458,96,280615
35154,0.002363,172.31.47.0-255,66,125524,96,280615
35155,0.002382,74.125.24.0-255,1484,127008,96,280615
35156,0.002415,172.31.47.0-255,66,127074,96,280615
35157,0.004939,74.125.24.0-255,5738,132812,96,280615
35158,0.004943,172.31.47.0-255,66,132878,96,280615
35159,0.007499,74.125.24.0-255,5738,138616,96,280615
35160,0.007504,172.31.47.0-255,66,138682,96,280615
35161,0.010058,74.125.24.0-255,5738,144420,96,280615
35162,0.010089,172.31.47.0-255,66,144486,96,280615
35163,0.012638,74.125.24.0-255,5738,150224,96,280615
35164,0.012646,172.31.47.0-255,66,150290,96,280615
35165,0.015183,74.125.24.0-255,5738,156028,96,280615
35166,0.015191,172.31.47.0-255,66,156094,96,280615
35167,0.017733,74.125.24.0-255,5738,161832,96,280615
35168,0.017739,172.31.47.0-255,66,161898,96,280615
35169,0.020341,74.125.24.0-255,5738,167636,96,280615
35170,0.020348,172.31.47.0-255,66,167702,96,280615
35171,0.021938,172.31.47.0-255,172,167874,96,280615
35172,0.02197,172.31.47.0-255,1109,168983,96,280615
35173,0.022006,172.31.47.0-255,1514,170497,96,280615
35174,0.022008,172.31.47.0-255,336,170833,96,280615
35175,0.022906,74.125.24.0-255,5738,176571,96,280615
35176,0.022913,172.31.47.0-255,66,176637,96,280615
35177,0.02347,104.244.42.0-255,66,176703,96,280615
35178,0.023659,104.244.42.0-255,66,176769,96,280615
35179,0.023661,104.244.42.0-255,66,176835,96,280615
35180,0.025446,74.125.24.0-255,2902,179737,96,280615
35181,0.025449,172.31.47.0-255,66,179803,96,280615
35182,0.025476,74.125.24.0-255,2902,182705,96,280615
35183,0.025478,172.31.47.0-255,66,182771,96,280615
35184,0.028005,74.125.24.0-255,5738,188509,96,280615
35185,0.02801,172.31.47.0-255,66,188575,96,280615
35186,0.030572,74.125.24.0-255,5738,194313,96,280615
35187,0.030576,172.31.47.0-255,66,194379,96,280615
35188,0.03311,74.125.24.0-255,2902,197281,96,280615
35189,0.033115,172.31.47.0-255,66,197347,96,280615
35190,0.033145,74.125.24.0-255,2902,200249,96,280615
35191,0.033148,172.31.47.0-255,66,200315,96,280615
35192,0.035648,74.125.24.0-255,2902,203217,96,280615
35193,0.035653,172.31.47.0-255,66,203283,96,280615
35194,0.035681,74.125.24.0-255,2902,206185,96,280615
35195,0.035683,172.31.47.0-255,66,206251,96,280615
35196,0.03821,74.125.24.0-255,5738,211989,96,280615
35197,0.038214,172.31.47.0-255,66,212055,96,280615
35198,0.040772,74.125.24.0-255,5738,217793,96,280615
35199,0.040793,172.31.47.0-255,66,217859,96,280615
35200,0.043341,74.125.24.0-255,5738,223597,96,280615
35201,0.043347,172.31.47.0-255,66,223663,96,280615
35202,0.045873,74.125.24.0-255,5738,229401,96,280615
35203,0.045877,172.31.47.0-255,66,229467,96,280615
35204,0.048404,74.125.24.0-255,5738,235205,96,280615
35205,0.048409,172.31.47.0-255,66,235271,96,280615
35206,0.050948,74.125.24.0-255,5738,241009,96,280615
35207,0.050953,172.31.47.0-255,66,241075,96,280615
35208,0.053474,74.125.24.0-255,5738,246813,96,280615
35209,0.053477,172.31.47.0-255,66,246879,96,280615
35210,0.05601,74.125.24.0-255,5738,252617,96,280615
35211,0.056014,172.31.47.0-255,66,252683,96,280615
35212,0.058568,74.125.24.0-255,5738,258421,96,280615
35213,0.058573,172.31.47.0-255,66,258487,96,280615
35214,0.061098,74.125.24.0-255,4320,262807,96,280615
35215,0.061103,172.31.47.0-255,66,262873,96,280615
35216,0.06113,74.125.24.0-255,1484,264357,96,280615
35217,0.063633,74.125.24.0-255,4320,268677,96,280615
35218,0.063639,172.31.47.0-255,66,268743,96,280615
35219,0.066194,74.125.24.0-255,2902,271645,96,280615
35220,0.066199,172.31.47.0-255,66,271711,96,280615
35221,0.066227,74.125.24.0-255,2902,274613,96,280615
35222,0.066229,172.31.47.0-255,66,274679,96,280615
35223,0.068733,74.125.24.0-255,2902,277581,96,280615
35224,0.068739,172.31.47.0-255,66,277647,96,280615
35225,0.068767,74.125.24.0-255,2902,280549,96,280615
35226,0.06877,172.31.47.0-255,66,280615,96,280615
35227,0.0,74.125.24.0-255,153,153,96,275635
35228,1.6e-05,172.31.47.0-255,66,219,96,275635
35229,2.2e-05,74.125.24.0-255,1484,1703,96,275635
35230,2.6e-05,172.31.47.0-255,66,1769,96,275635
35231,3.2e-05,74.125.24.0-255,2902,4671,96,275635
35232,3.6e-05,172.31.47.0-255,66,4737,96,275635
35233,4.2e-05,74.125.24.0-255,4320,9057,96,275635
35234,4.5e-05,172.31.47.0-255,66,9123,96,275635
35235,7.8e-05,74.125.24.0-255,4867,13990,96,275635
35236,8.2e-05,172.31.47.0-255,66,14056,96,275635
35237,0.000105,74.125.24.0-255,5738,19794,96,275635
35238,0.000108,172.31.47.0-255,66,19860,96,275635
35239,0.000121,74.125.24.0-255,1484,21344,96,275635
35240,0.000124,172.31.47.0-255,66,21410,96,275635
35241,0.000152,172.31.47.0-255,66,21476,96,275635
35242,0.000172,74.125.24.0-255,1125,22601,96,275635
35243,0.000174,172.31.47.0-255,66,22667,96,275635
35244,0.000215,74.125.24.0-255,1484,24151,96,275635
35245,0.000218,172.31.47.0-255,66,24217,96,275635
35246,0.000223,74.125.24.0-255,2902,27119,96,275635
35247,0.000225,172.31.47.0-255,66,27185,96,275635
35248,0.000237,74.125.24.0-255,2902,30087,96,275635
35249,0.000239,172.31.47.0-255,66,30153,96,275635
35250,0.000258,74.125.24.0-255,2902,33055,96,275635
35251,0.00026,172.31.47.0-255,66,33121,96,275635
35252,0.000295,172.31.47.0-255,66,33187,96,275635
35253,0.000315,74.125.24.0-255,5379,38566,96,275635
35254,0.000318,172.31.47.0-255,66,38632,96,275635
35255,0.000333,74.125.24.0-255,4320,42952,96,275635
35256,0.000336,172.31.47.0-255,66,43018,96,275635
35257,0.000353,74.125.24.0-255,5379,48397,96,275635
35258,0.000356,172.31.47.0-255,66,48463,96,275635
35259,0.000508,74.125.24.0-255,647,49110,96,275635
35260,0.000892,74.125.24.0-255,1484,50594,96,275635
35261,0.000897,172.31.47.0-255,66,50660,96,275635
35262,0.000903,74.125.24.0-255,2902,53562,96,275635
35263,0.000905,172.31.47.0-255,66,53628,96,275635
35264,0.000911,74.125.24.0-255,4320,57948,96,275635
35265,0.000913,172.31.47.0-255,66,58014,96,275635
35266,0.00093,74.125.24.0-255,1484,59498,96,275635
35267,0.000934,74.125.24.0-255,2902,62400,96,275635
35268,0.000937,172.31.47.0-255,66,62466,96,275635
35269,0.000972,172.31.47.0-255,66,62532,96,275635
35270,0.000975,74.125.24.0-255,1484,64016,96,275635
35271,0.001001,172.31.47.0-255,66,64082,96,275635
35272,0.001251,74.125.24.0-255,1484,65566,96,275635
35273,0.001257,74.125.24.0-255,2902,68468,96,275635
35274,0.00126,172.31.47.0-255,66,68534,96,275635
35275,0.001265,74.125.24.0-255,1484,70018,96,275635
35276,0.001284,74.125.24.0-255,4320,74338,96,275635
35277,0.001287,172.31.47.0-255,66,74404,96,275635
35278,0.001297,172.31.47.0-255,66,74470,96,275635
35279,0.001312,74.125.24.0-255,2902,77372,96,275635
35280,0.001315,172.31.47.0-255,66,77438,96,275635
35281,0.001344,74.125.24.0-255,4320,81758,96,275635
35282,0.001347,172.31.47.0-255,66,81824,96,275635
35283,0.001373,172.31.47.0-255,66,81890,96,275635
35284,0.001384,74.125.24.0-255,1484,83374,96,275635
35285,0.001397,74.125.24.0-255,2902,86276,96,275635
35286,0.001399,172.31.47.0-255,66,86342,96,275635
35287,0.001402,74.125.24.0-255,1484,87826,96,275635
35288,0.001422,74.125.24.0-255,4320,92146,96,275635
35289,0.001425,172.31.47.0-255,66,92212,96,275635
35290,0.001437,172.31.47.0-255,66,92278,96,275635
35291,0.001459,74.125.24.0-255,1484,93762,96,275635
35292,0.001471,172.31.47.0-255,66,93828,96,275635
35293,0.001507,74.125.24.0-255,3602,97430,96,275635
35294,0.001511,172.31.47.0-255,66,97496,96,275635
35295,0.001516,74.125.24.0-255,4320,101816,96,275635
35296,0.001518,172.31.47.0-255,66,101882,96,275635
35297,0.001521,74.125.24.0-255,1484,103366,96,275635
35298,0.001548,172.31.47.0-255,66,103432,96,275635
35299,0.001555,74.125.24.0-255,7156,110588,96,275635
35300,0.001558,172.31.47.0-255,66,110654,96,275635
35301,0.001627,172.31.47.0-255,66,110720,96,275635
35302,0.001643,74.125.24.0-255,1484,112204,96,275635
35303,0.001661,74.125.24.0-255,2902,115106,96,275635
35304,0.001663,172.31.47.0-255,66,115172,96,275635
35305,0.001669,74.125.24.0-255,5738,120910,96,275635
35306,0.001671,172.31.47.0-255,66,120976,96,275635
35307,0.001704,172.31.47.0-255,66,121042,96,275635
35308,0.001728,74.125.24.0-255,4320,125362,96,275635
35309,0.001731,172.31.47.0-255,66,125428,96,275635
35310,0.001743,172.31.47.0-255,66,125494,96,275635
35311,0.001746,74.125.24.0-255,766,126260,96,275635
35312,0.001888,74.125.24.0-255,1484,127744,96,275635
35313,0.001895,172.31.47.0-255,66,127810,96,275635
35314,0.001899,74.125.24.0-255,1484,129294,96,275635
35315,0.001913,74.125.24.0-255,1484,130778,96,275635
35316,0.001915,172.31.47.0-255,66,130844,96,275635
35317,0.001922,74.125.24.0-255,5738,136582,96,275635
35318,0.001925,172.31.47.0-255,66,136648,96,275635
35319,0.001948,74.125.24.0-255,1484,138132,96,275635
35320,0.001974,172.31.47.0-255,66,138198,96,275635
35321,0.001992,74.125.24.0-255,1484,139682,96,275635
35322,0.001995,74.125.24.0-255,1484,141166,96,275635
35323,0.001998,172.31.47.0-255,66,141232,96,275635
35324,0.00204,74.125.24.0-255,4320,145552,96,275635
35325,0.002044,172.31.47.0-255,66,145618,96,275635
35326,0.002067,74.125.24.0-255,5020,150638,96,275635
35327,0.002071,172.31.47.0-255,66,150704,96,275635
35328,0.002103,172.31.47.0-255,66,150770,96,275635
35329,0.002122,74.125.24.0-255,1484,152254,96,275635
35330,0.002128,74.125.24.0-255,5738,157992,96,275635
35331,0.002132,172.31.47.0-255,66,158058,96,275635
35332,0.002142,172.31.47.0-255,66,158124,96,275635
35333,0.002162,172.31.47.0-255,66,158190,96,275635
35334,0.002165,74.125.24.0-255,766,158956,96,275635
35335,0.00469,74.125.24.0-255,4320,163276,96,275635
35336,0.004698,172.31.47.0-255,66,163342,96,275635
35337,0.007253,74.125.24.0-255,5738,169080,96,275635
35338,0.00726,172.31.47.0-255,66,169146,96,275635
35339,0.009824,74.125.24.0-255,5738,174884,96,275635
35340,0.009831,172.31.47.0-255,66,174950,96,275635
35341,0.012375,74.125.24.0-255,5738,180688,96,275635
35342,0.012388,172.31.47.0-255,66,180754,96,275635
35343,0.014945,74.125.24.0-255,5738,186492,96,275635
35344,0.014953,172.31.47.0-255,66,186558,96,275635
35345,0.017497,74.125.24.0-255,5738,192296,96,275635
35346,0.017504,172.31.47.0-255,66,192362,96,275635
35347,0.020035,74.125.24.0-255,5738,198100,96,275635
35348,0.020043,172.31.47.0-255,66,198166,96,275635
35349,0.022587,74.125.24.0-255,5738,203904,96,275635
35350,0.022594,172.31.47.0-255,66,203970,96,275635
35351,0.02515,74.125.24.0-255,5738,209708,96,275635
35352,0.025157,172.31.47.0-255,66,209774,96,275635
35353,0.0277,74.125.24.0-255,5738,215512,96,275635
35354,0.027707,172.31.47.0-255,66,215578,96,275635
35355,0.02824,172.31.47.0-255,172,215750,96,275635
35356,0.028268,172.31.47.0-255,1105,216855,96,275635
35357,0.028317,172.31.47.0-255,1514,218369,96,275635
35358,0.028318,172.31.47.0-255,339,218708,96,275635
35359,0.029813,104.244.42.0-255,66,218774,96,275635
35360,0.02982,104.244.42.0-255,66,218840,96,275635
35361,0.029868,104.244.42.0-255,66,218906,96,275635
35362,0.030217,74.125.24.0-255,5738,224644,96,275635
35363,0.030223,172.31.47.0-255,66,224710,96,275635
35364,0.032787,74.125.24.0-255,5738,230448,96,275635
35365,0.032799,172.31.47.0-255,66,230514,96,275635
35366,0.035335,74.125.24.0-255,5738,236252,96,275635
35367,0.035343,172.31.47.0-255,66,236318,96,275635
35368,0.037893,74.125.24.0-255,5738,242056,96,275635
35369,0.0379,172.31.47.0-255,66,242122,96,275635
35370,0.040429,74.125.24.0-255,5738,247860,96,275635
35371,0.040436,172.31.47.0-255,66,247926,96,275635
35372,0.042966,74.125.24.0-255,5738,253664,96,275635
35373,0.042974,172.31.47.0-255,66,253730,96,275635
35374,0.045508,74.125.24.0-255,5738,259468,96,275635
35375,0.045514,172.31.47.0-255,66,259534,96,275635
35376,0.048063,74.125.24.0-255,5738,265272,96,275635
35377,0.048073,172.31.47.0-255,66,265338,96,275635
35378,0.05064,74.125.24.0-255,5738,271076,96,275635
35379,0.050646,172.31.47.0-255,66,271142,96,275635
35380,0.053198,74.125.24.0-255,4256,275398,96,275635
35381,0.053205,172.31.47.0-255,66,275464,96,275635
35382,0.053393,172.31.47.0-255,105,275569,96,275635
35383,0.055897,74.125.24.0-255,66,275635,96,275635
35384,0.0,172.217.194.0-255,152,152,96,219538
35385,3.1e-05,172.31.47.0-255,66,218,96,219538
35386,3.8e-05,172.217.194.0-255,1484,1702,96,219538
35387,4.1e-05,172.31.47.0-255,66,1768,96,219538
35388,4.6e-05,172.217.194.0-255,2902,4670,96,219538
35389,4.9e-05,172.31.47.0-255,66,4736,96,219538
35390,0.00012,172.217.194.0-255,4320,9056,96,219538
35391,0.000123,172.31.47.0-255,66,9122,96,219538
35392,0.00023,172.217.194.0-255,4933,14055,96,219538
35393,0.000235,172.31.47.0-255,66,14121,96,219538
35394,0.000333,172.217.194.0-255,5738,19859,96,219538
35395,0.000338,172.31.47.0-255,66,19925,96,219538
35396,0.00046,172.217.194.0-255,5738,25663,96,219538
35397,0.000464,172.31.47.0-255,66,25729,96,219538
35398,0.000486,172.217.194.0-255,6797,32526,96,219538
35399,0.000489,172.31.47.0-255,66,32592,96,219538
35400,0.000766,172.31.47.0-255,66,32658,96,219538
35401,0.000802,172.31.47.0-255,66,32724,96,219538
35402,0.001358,172.217.194.0-255,7079,39803,96,219538
35403,0.001365,172.31.47.0-255,66,39869,96,219538
35404,0.001536,172.31.47.0-255,66,39935,96,219538
35405,0.001575,172.31.47.0-255,66,40001,96,219538
35406,0.002297,172.217.194.0-255,1484,41485,96,219538
35407,0.002301,172.31.47.0-255,66,41551,96,219538
35408,0.002341,172.217.194.0-255,2902,44453,96,219538
35409,0.002344,172.31.47.0-255,66,44519,96,219538
35410,0.002405,172.217.194.0-255,4320,48839,96,219538
35411,0.002409,172.31.47.0-255,66,48905,96,219538
35412,0.002423,172.217.194.0-255,1484,50389,96,219538
35413,0.002535,172.217.194.0-255,2902,53291,96,219538
35414,0.002538,172.31.47.0-255,66,53357,96,219538
35415,0.002579,172.31.47.0-255,66,53423,96,219538
35416,0.002838,172.217.194.0-255,4320,57743,96,219538
35417,0.002841,172.31.47.0-255,66,57809,96,219538
35418,0.002886,172.31.47.0-255,66,57875,96,219538
35419,0.003483,172.217.194.0-255,1484,59359,96,219538
35420,0.003534,172.31.47.0-255,66,59425,96,219538
35421,0.003579,172.31.47.0-255,66,59491,96,219538
35422,0.005894,172.217.194.0-255,5738,65229,96,219538
35423,0.005901,172.31.47.0-255,66,65295,96,219538
35424,0.00823,172.217.194.0-255,4320,69615,96,219538
35425,0.008245,172.31.47.0-255,66,69681,96,219538
35426,0.008271,172.217.194.0-255,1484,71165,96,219538
35427,0.01056,172.217.194.0-255,4320,75485,96,219538
35428,0.010573,172.31.47.0-255,66,75551,96,219538
35429,0.012909,172.217.194.0-255,5738,81289,96,219538
35430,0.012966,172.31.47.0-255,66,81355,96,219538
35431,0.015322,172.217.194.0-255,5738,87093,96,219538
35432,0.015337,172.31.47.0-255,66,87159,96,219538
35433,0.017634,172.217.194.0-255,5738,92897,96,219538
35434,0.017645,172.31.47.0-255,66,92963,96,219538
35435,0.019938,172.217.194.0-255,5738,98701,96,219538
35436,0.019947,172.31.47.0-255,66,98767,96,219538
35437,0.022243,172.217.194.0-255,5738,104505,96,219538
35438,0.022254,172.31.47.0-255,66,104571,96,219538
35439,0.024544,172.217.194.0-255,5738,110309,96,219538
35440,0.024556,172.31.47.0-255,66,110375,96,219538
35441,0.026561,172.31.47.0-255,172,110547,96,219538
35442,0.026615,172.31.47.0-255,1105,111652,96,219538
35443,0.026686,172.31.47.0-255,1514,113166,96,219538
35444,0.026688,172.31.47.0-255,1306,114472,96,219538
35445,0.026905,172.217.194.0-255,5738,120210,96,219538
35446,0.026913,172.31.47.0-255,66,120276,96,219538
35447,0.028105,104.244.42.0-255,66,120342,96,219538
35448,0.028162,104.244.42.0-255,66,120408,96,219538
35449,0.028268,104.244.42.0-255,66,120474,96,219538
35450,0.029269,172.217.194.0-255,4320,124794,96,219538
35451,0.029276,172.31.47.0-255,66,124860,96,219538
35452,0.029291,172.217.194.0-255,1484,126344,96,219538
35453,0.031567,172.217.194.0-255,4320,130664,96,219538
35454,0.031573,172.31.47.0-255,66,130730,96,219538
35455,0.033942,172.217.194.0-255,5738,136468,96,219538
35456,0.033995,172.31.47.0-255,66,136534,96,219538
35457,0.036292,172.217.194.0-255,4320,140854,96,219538
35458,0.036298,172.31.47.0-255,66,140920,96,219538
35459,0.036331,172.217.194.0-255,1484,142404,96,219538
35460,0.038602,172.217.194.0-255,4320,146724,96,219538
35461,0.038608,172.31.47.0-255,66,146790,96,219538
35462,0.040896,172.217.194.0-255,5738,152528,96,219538
35463,0.040949,172.31.47.0-255,66,152594,96,219538
35464,0.043272,172.217.194.0-255,5738,158332,96,219538
35465,0.043277,172.31.47.0-255,66,158398,96,219538
35466,0.045609,172.217.194.0-255,5738,164136,96,219538
35467,0.045615,172.31.47.0-255,66,164202,96,219538
35468,0.047974,172.217.194.0-255,5738,169940,96,219538
35469,0.04798,172.31.47.0-255,66,170006,96,219538
35470,0.050327,172.217.194.0-255,5738,175744,96,219538
35471,0.050332,172.31.47.0-255,66,175810,96,219538
35472,0.052656,172.217.194.0-255,5738,181548,96,219538
35473,0.052663,172.31.47.0-255,66,181614,96,219538
35474,0.055016,172.217.194.0-255,5738,187352,96,219538
35475,0.055022,172.31.47.0-255,66,187418,96,219538
35476,0.057314,172.217.194.0-255,5738,193156,96,219538
35477,0.05732,172.31.47.0-255,66,193222,96,219538
35478,0.059675,172.217.194.0-255,5738,198960,96,219538
35479,0.059681,172.31.47.0-255,66,199026,96,219538
35480,0.061984,172.217.194.0-255,4320,203346,96,219538
35481,0.06199,172.31.47.0-255,66,203412,96,219538
35482,0.062022,172.217.194.0-255,1484,204896,96,219538
35483,0.064334,172.217.194.0-255,2902,207798,96,219538
35484,0.064339,172.31.47.0-255,66,207864,96,219538
35485,0.066633,172.217.194.0-255,4320,212184,96,219538
35486,0.066664,172.217.194.0-255,1484,213668,96,219538
35487,0.066689,172.31.47.0-255,66,213734,96,219538
35488,0.068993,172.217.194.0-255,5738,219472,96,219538
35489,0.069,172.31.47.0-255,66,219538,96,219538
35490,0.0,74.125.24.0-255,153,153,96,277572
35491,1.3e-05,172.31.47.0-255,66,219,96,277572
35492,1.8e-05,74.125.24.0-255,1484,1703,96,277572
35493,2.2e-05,172.31.47.0-255,66,1769,96,277572
35494,2.7e-05,74.125.24.0-255,2902,4671,96,277572
35495,2.9e-05,172.31.47.0-255,66,4737,96,277572
35496,3.4e-05,74.125.24.0-255,4320,9057,96,277572
35497,3.6e-05,172.31.47.0-255,66,9123,96,277572
35498,6.1e-05,74.125.24.0-255,2902,12025,96,277572
35499,6.3e-05,172.31.47.0-255,66,12091,96,277572
35500,6.7e-05,74.125.24.0-255,2181,14272,96,277572
35501,6.9e-05,172.31.47.0-255,66,14338,96,277572
35502,0.000635,74.125.24.0-255,1484,15822,96,277572
35503,0.000641,172.31.47.0-255,66,15888,96,277572
35504,0.000647,74.125.24.0-255,2902,18790,96,277572
35505,0.000649,172.31.47.0-255,66,18856,96,277572
35506,0.000655,74.125.24.0-255,5738,24594,96,277572
35507,0.000657,172.31.47.0-255,66,24660,96,277572
35508,0.000661,74.125.24.0-255,4320,28980,96,277572
35509,0.000663,172.31.47.0-255,66,29046,96,277572
35510,0.000697,74.125.24.0-255,5738,34784,96,277572
35511,0.0007,172.31.47.0-255,66,34850,96,277572
35512,0.000716,74.125.24.0-255,6797,41647,96,277572
35513,0.000718,172.31.47.0-255,66,41713,96,277572
35514,0.000742,74.125.24.0-255,1484,43197,96,277572
35515,0.000744,172.31.47.0-255,66,43263,96,277572
35516,0.000764,74.125.24.0-255,5379,48642,96,277572
35517,0.000767,172.31.47.0-255,66,48708,96,277572
35518,0.000873,74.125.24.0-255,1484,50192,96,277572
35519,0.000877,172.31.47.0-255,66,50258,96,277572
35520,0.000882,74.125.24.0-255,2902,53160,96,277572
35521,0.000883,172.31.47.0-255,66,53226,96,277572
35522,0.000886,74.125.24.0-255,1484,54710,96,277572
35523,0.000913,74.125.24.0-255,4320,59030,96,277572
35524,0.000916,172.31.47.0-255,66,59096,96,277572
35525,0.00092,74.125.24.0-255,4320,63416,96,277572
35526,0.000922,172.31.47.0-255,66,63482,96,277572
35527,0.000948,74.125.24.0-255,3123,66605,96,277572
35528,0.000951,172.31.47.0-255,66,66671,96,277572
35529,0.000998,74.125.24.0-255,1484,68155,96,277572
35530,0.001016,74.125.24.0-255,2902,71057,96,277572
35531,0.001018,172.31.47.0-255,66,71123,96,277572
35532,0.001024,74.125.24.0-255,4320,75443,96,277572
35533,0.001026,172.31.47.0-255,66,75509,96,277572
35534,0.001037,74.125.24.0-255,1484,76993,96,277572
35535,0.001053,74.125.24.0-255,4320,81313,96,277572
35536,0.001055,172.31.47.0-255,66,81379,96,277572
35537,0.001085,172.31.47.0-255,66,81445,96,277572
35538,0.001108,74.125.24.0-255,5738,87183,96,277572
35539,0.00111,172.31.47.0-255,66,87249,96,277572
35540,0.001129,74.125.24.0-255,3961,91210,96,277572
35541,0.001131,172.31.47.0-255,66,91276,96,277572
35542,0.001393,74.125.24.0-255,1484,92760,96,277572
35543,0.001405,74.125.24.0-255,2902,95662,96,277572
35544,0.001407,172.31.47.0-255,66,95728,96,277572
35545,0.001412,74.125.24.0-255,4320,100048,96,277572
35546,0.001415,172.31.47.0-255,66,100114,96,277572
35547,0.001428,74.125.24.0-255,1484,101598,96,277572
35548,0.00144,74.125.24.0-255,2902,104500,96,277572
35549,0.001443,172.31.47.0-255,66,104566,96,277572
35550,0.001464,172.31.47.0-255,66,104632,96,277572
35551,0.001506,172.31.47.0-255,66,104698,96,277572
35552,0.003781,74.125.24.0-255,5738,110436,96,277572
35553,0.003787,172.31.47.0-255,66,110502,96,277572
35554,0.006067,74.125.24.0-255,5738,116240,96,277572
35555,0.006074,172.31.47.0-255,66,116306,96,277572
35556,0.008366,74.125.24.0-255,5738,122044,96,277572
35557,0.008373,172.31.47.0-255,66,122110,96,277572
35558,0.010642,74.125.24.0-255,5738,127848,96,277572
35559,0.01065,172.31.47.0-255,66,127914,96,277572
35560,0.012913,74.125.24.0-255,5738,133652,96,277572
35561,0.012919,172.31.47.0-255,66,133718,96,277572
35562,0.015231,74.125.24.0-255,5738,139456,96,277572
35563,0.01524,172.31.47.0-255,66,139522,96,277572
35564,0.017533,74.125.24.0-255,5738,145260,96,277572
35565,0.01754,172.31.47.0-255,66,145326,96,277572
35566,0.019815,74.125.24.0-255,5738,151064,96,277572
35567,0.019821,172.31.47.0-255,66,151130,96,277572
35568,0.020466,172.31.47.0-255,171,151301,96,277572
35569,0.020497,172.31.47.0-255,1133,152434,96,277572
35570,0.020556,172.31.47.0-255,1514,153948,96,277572
35571,0.020558,172.31.47.0-255,1278,155226,96,277572
35572,0.021995,104.244.42.0-255,66,155292,96,277572
35573,0.022074,104.244.42.0-255,66,155358,96,277572
35574,0.022082,74.125.24.0-255,2902,158260,96,277572
35575,0.022087,172.31.47.0-255,66,158326,96,277572
35576,0.022107,74.125.24.0-255,2902,161228,96,277572
35577,0.02211,172.31.47.0-255,66,161294,96,277572
35578,0.022126,104.244.42.0-255,66,161360,96,277572
35579,0.024344,74.125.24.0-255,2902,164262,96,277572
35580,0.02435,172.31.47.0-255,66,164328,96,277572
35581,0.024374,74.125.24.0-255,2902,167230,96,277572
35582,0.024376,172.31.47.0-255,66,167296,96,277572
35583,0.026641,74.125.24.0-255,5738,173034,96,277572
35584,0.026646,172.31.47.0-255,66,173100,96,277572
35585,0.028897,74.125.24.0-255,5738,178838,96,277572
35586,0.028904,172.31.47.0-255,66,178904,96,277572
35587,0.031171,74.125.24.0-255,5738,184642,96,277572
35588,0.031177,172.31.47.0-255,66,184708,96,277572
35589,0.033458,74.125.24.0-255,5738,190446,96,277572
35590,0.033463,172.31.47.0-255,66,190512,96,277572
35591,0.035718,74.125.24.0-255,5738,196250,96,277572
35592,0.035724,172.31.47.0-255,66,196316,96,277572
35593,0.038006,74.125.24.0-255,5738,202054,96,277572
35594,0.038012,172.31.47.0-255,66,202120,96,277572
35595,0.040278,74.125.24.0-255,5738,207858,96,277572
35596,0.040286,172.31.47.0-255,66,207924,96,277572
35597,0.042568,74.125.24.0-255,5738,213662,96,277572
35598,0.042575,172.31.47.0-255,66,213728,96,277572
35599,0.04487,74.125.24.0-255,5738,219466,96,277572
35600,0.044876,172.31.47.0-255,66,219532,96,277572
35601,0.047149,74.125.24.0-255,5738,225270,96,277572
35602,0.047154,172.31.47.0-255,66,225336,96,277572
35603,0.049444,74.125.24.0-255,5738,231074,96,277572
35604,0.04945,172.31.47.0-255,66,231140,96,277572
35605,0.051716,74.125.24.0-255,5738,236878,96,277572
35606,0.051721,172.31.47.0-255,66,236944,96,277572
35607,0.054014,74.125.24.0-255,5738,242682,96,277572
35608,0.054019,172.31.47.0-255,66,242748,96,277572
35609,0.056297,74.125.24.0-255,5738,248486,96,277572
35610,0.056303,172.31.47.0-255,66,248552,96,277572
35611,0.05859,74.125.24.0-255,5738,254290,96,277572
35612,0.058595,172.31.47.0-255,66,254356,96,277572
35613,0.060885,74.125.24.0-255,5738,260094,96,277572
35614,0.060891,172.31.47.0-255,66,260160,96,277572
35615,0.063161,74.125.24.0-255,5738,265898,96,277572
35616,0.063167,172.31.47.0-255,66,265964,96,277572
35617,0.06545,74.125.24.0-255,5738,271702,96,277572
35618,0.065457,172.31.47.0-255,66,271768,96,277572
35619,0.067736,74.125.24.0-255,5738,277506,96,277572
35620,0.067741,172.31.47.0-255,66,277572,96,277572
35621,0.0,172.253.118.0-255,157,157,96,364587
35622,1.7e-05,172.31.47.0-255,66,223,96,364587
35623,2.2e-05,172.253.118.0-255,1484,1707,96,364587
35624,2.6e-05,172.31.47.0-255,66,1773,96,364587
35625,3.7e-05,172.253.118.0-255,2902,4675,96,364587
35626,4.1e-05,172.31.47.0-255,66,4741,96,364587
35627,4.6e-05,172.253.118.0-255,5738,10479,96,364587
35628,4.9e-05,172.31.47.0-255,66,10545,96,364587
35629,7.5e-05,172.253.118.0-255,2902,13447,96,364587
35630,7.7e-05,172.31.47.0-255,66,13513,96,364587
35631,0.000108,172.31.47.0-255,66,13579,96,364587
35632,0.000112,172.253.118.0-255,2902,16481,96,364587
35633,0.000114,172.31.47.0-255,66,16547,96,364587
35634,0.000183,172.253.118.0-255,3961,20508,96,364587
35635,0.000187,172.31.47.0-255,66,20574,96,364587
35636,0.000203,172.253.118.0-255,1484,22058,96,364587
35637,0.000205,172.31.47.0-255,66,22124,96,364587
35638,0.000209,172.253.118.0-255,2902,25026,96,364587
35639,0.000211,172.31.47.0-255,66,25092,96,364587
35640,0.000214,172.253.118.0-255,1484,26576,96,364587
35641,0.000216,172.31.47.0-255,66,26642,96,364587
35642,0.000244,172.253.118.0-255,4320,30962,96,364587
35643,0.000247,172.31.47.0-255,66,31028,96,364587
35644,0.000254,172.253.118.0-255,6797,37825,96,364587
35645,0.000256,172.31.47.0-255,66,37891,96,364587
35646,0.000386,172.253.118.0-255,1484,39375,96,364587
35647,0.000389,172.31.47.0-255,66,39441,96,364587
35648,0.000395,172.253.118.0-255,2902,42343,96,364587
35649,0.000397,172.31.47.0-255,66,42409,96,364587
35650,0.000402,172.253.118.0-255,2902,45311,96,364587
35651,0.000404,172.31.47.0-255,66,45377,96,364587
35652,0.000429,172.253.118.0-255,2902,48279,96,364587
35653,0.000432,172.31.47.0-255,66,48345,96,364587
35654,0.000446,172.253.118.0-255,4320,52665,96,364587
35655,0.000452,172.31.47.0-255,66,52731,96,364587
35656,0.000471,172.253.118.0-255,2877,55608,96,364587
35657,0.000473,172.31.47.0-255,66,55674,96,364587
35658,0.000523,172.253.118.0-255,343,56017,96,364587
35659,0.00075,172.253.118.0-255,1484,57501,96,364587
35660,0.000754,172.31.47.0-255,66,57567,96,364587
35661,0.00076,172.253.118.0-255,2902,60469,96,364587
35662,0.000761,172.31.47.0-255,66,60535,96,364587
35663,0.000788,172.253.118.0-255,5738,66273,96,364587
35664,0.00079,172.31.47.0-255,66,66339,96,364587
35665,0.000794,172.253.118.0-255,2902,69241,96,364587
35666,0.000796,172.31.47.0-255,66,69307,96,364587
35667,0.000822,172.253.118.0-255,3961,73268,96,364587
35668,0.000825,172.31.47.0-255,66,73334,96,364587
35669,0.000868,172.253.118.0-255,1484,74818,96,364587
35670,0.000873,172.253.118.0-255,2902,77720,96,364587
35671,0.000875,172.31.47.0-255,66,77786,96,364587
35672,0.000881,172.253.118.0-255,5738,83524,96,364587
35673,0.000883,172.31.47.0-255,66,83590,96,364587
35674,0.000903,172.253.118.0-255,6797,90387,96,364587
35675,0.000905,172.31.47.0-255,66,90453,96,364587
35676,0.001319,172.253.118.0-255,1484,91937,96,364587
35677,0.001325,172.253.118.0-255,2902,94839,96,364587
35678,0.001328,172.31.47.0-255,66,94905,96,364587
35679,0.001332,172.253.118.0-255,1484,96389,96,364587
35680,0.001355,172.253.118.0-255,4320,100709,96,364587
35681,0.001357,172.31.47.0-255,66,100775,96,364587
35682,0.001362,172.253.118.0-255,4320,105095,96,364587
35683,0.001364,172.31.47.0-255,66,105161,96,364587
35684,0.001367,172.253.118.0-255,1484,106645,96,364587
35685,0.001403,172.253.118.0-255,5738,112383,96,364587
35686,0.001407,172.31.47.0-255,66,112449,96,364587
35687,0.00141,172.31.47.0-255,66,112515,96,364587
35688,0.001429,172.253.118.0-255,2184,114699,96,364587
35689,0.001431,172.31.47.0-255,66,114765,96,364587
35690,0.001523,172.253.118.0-255,1484,116249,96,364587
35691,0.001528,172.253.118.0-255,2902,119151,96,364587
35692,0.00153,172.31.47.0-255,66,119217,96,364587
35693,0.001533,172.253.118.0-255,1484,120701,96,364587
35694,0.001555,172.253.118.0-255,4320,125021,96,364587
35695,0.001557,172.31.47.0-255,66,125087,96,364587
35696,0.00156,172.253.118.0-255,1484,126571,96,364587
35697,0.001579,172.253.118.0-255,2902,129473,96,364587
35698,0.001581,172.31.47.0-255,66,129539,96,364587
35699,0.001613,172.253.118.0-255,5738,135277,96,364587
35700,0.001615,172.31.47.0-255,66,135343,96,364587
35701,0.001625,172.31.47.0-255,66,135409,96,364587
35702,0.001649,172.253.118.0-255,1484,136893,96,364587
35703,0.001663,172.253.118.0-255,2184,139077,96,364587
35704,0.001665,172.31.47.0-255,66,139143,96,364587
35705,0.001677,172.253.118.0-255,1484,140627,96,364587
35706,0.001693,172.253.118.0-255,2902,143529,96,364587
35707,0.001695,172.253.118.0-255,1484,145013,96,364587
35708,0.001698,172.31.47.0-255,66,145079,96,364587
35709,0.001735,172.31.47.0-255,66,145145,96,364587
35710,0.001746,172.31.47.0-255,66,145211,96,364587
35711,0.001765,172.253.118.0-255,1484,146695,96,364587
35712,0.001794,172.253.118.0-255,6438,153133,96,364587
35713,0.001798,172.31.47.0-255,66,153199,96,364587
35714,0.001965,172.253.118.0-255,1484,154683,96,364587
35715,0.001996,172.253.118.0-255,2902,157585,96,364587
35716,0.001999,172.31.47.0-255,66,157651,96,364587
35717,0.002027,172.253.118.0-255,4320,161971,96,364587
35718,0.002029,172.31.47.0-255,66,162037,96,364587
35719,0.002055,172.31.47.0-255,66,162103,96,364587
35720,0.002082,172.253.118.0-255,7156,169259,96,364587
35721,0.002084,172.31.47.0-255,66,169325,96,364587
35722,0.002117,172.253.118.0-255,2902,172227,96,364587
35723,0.002119,172.31.47.0-255,66,172293,96,364587
35724,0.002126,172.253.118.0-255,6438,178731,96,364587
35725,0.002128,172.31.47.0-255,66,178797,96,364587
35726,0.004224,172.253.118.0-255,5738,184535,96,364587
35727,0.004233,172.31.47.0-255,66,184601,96,364587
35728,0.006341,172.253.118.0-255,2902,187503,96,364587
35729,0.006344,172.31.47.0-255,66,187569,96,364587
35730,0.006362,172.253.118.0-255,2902,190471,96,364587
35731,0.006364,172.31.47.0-255,66,190537,96,364587
35732,0.008452,172.253.118.0-255,2902,193439,96,364587
35733,0.00846,172.31.47.0-255,66,193505,96,364587
35734,0.008489,172.253.118.0-255,2902,196407,96,364587
35735,0.008492,172.31.47.0-255,66,196473,96,364587
35736,0.01056,172.253.118.0-255,2902,199375,96,364587
35737,0.010567,172.31.47.0-255,66,199441,96,364587
35738,0.010594,172.253.118.0-255,2902,202343,96,364587
35739,0.010597,172.31.47.0-255,66,202409,96,364587
35740,0.012664,172.253.118.0-255,2902,205311,96,364587
35741,0.012678,172.31.47.0-255,66,205377,96,364587
35742,0.012708,172.253.118.0-255,2902,208279,96,364587
35743,0.012712,172.31.47.0-255,66,208345,96,364587
35744,0.014811,172.253.118.0-255,2902,211247,96,364587
35745,0.014818,172.31.47.0-255,66,211313,96,364587
35746,0.014841,172.253.118.0-255,2902,214215,96,364587
35747,0.014844,172.31.47.0-255,66,214281,96,364587
35748,0.016924,172.253.118.0-255,5738,220019,96,364587
35749,0.016931,172.31.47.0-255,66,220085,96,364587
35750,0.019053,172.253.118.0-255,5738,225823,96,364587
35751,0.019061,172.31.47.0-255,66,225889,96,364587
35752,0.021171,172.253.118.0-255,5738,231627,96,364587
35753,0.021179,172.31.47.0-255,66,231693,96,364587
35754,0.023292,172.253.118.0-255,5738,237431,96,364587
35755,0.023298,172.31.47.0-255,66,237497,96,364587
35756,0.025398,172.253.118.0-255,5738,243235,96,364587
35757,0.025405,172.31.47.0-255,66,243301,96,364587
35758,0.027499,172.253.118.0-255,5738,249039,96,364587
35759,0.027505,172.31.47.0-255,66,249105,96,364587
35760,0.029614,172.253.118.0-255,5738,254843,96,364587
35761,0.029624,172.31.47.0-255,66,254909,96,364587
35762,0.031724,172.253.118.0-255,5738,260647,96,364587
35763,0.031731,172.31.47.0-255,66,260713,96,364587
35764,0.033833,172.253.118.0-255,5738,266451,96,364587
35765,0.033837,172.31.47.0-255,66,266517,96,364587
35766,0.034856,172.31.47.0-255,172,266689,96,364587
35767,0.034885,172.31.47.0-255,1109,267798,96,364587
35768,0.034935,172.31.47.0-255,1514,269312,96,364587
35769,0.034936,172.31.47.0-255,1304,270616,96,364587
35770,0.035918,172.253.118.0-255,5738,276354,96,364587
35771,0.035925,172.31.47.0-255,66,276420,96,364587
35772,0.036378,104.244.42.0-255,66,276486,96,364587
35773,0.036408,104.244.42.0-255,66,276552,96,364587
35774,0.036467,104.244.42.0-255,66,276618,96,364587
35775,0.038026,172.253.118.0-255,5738,282356,96,364587
35776,0.038033,172.31.47.0-255,66,282422,96,364587
35777,0.040133,172.253.118.0-255,5738,288160,96,364587
35778,0.040142,172.31.47.0-255,66,288226,96,364587
35779,0.042247,172.253.118.0-255,5738,293964,96,364587
35780,0.042254,172.31.47.0-255,66,294030,96,364587
35781,0.044354,172.253.118.0-255,5738,299768,96,364587
35782,0.044361,172.31.47.0-255,66,299834,96,364587
35783,0.046455,172.253.118.0-255,5738,305572,96,364587
35784,0.046462,172.31.47.0-255,66,305638,96,364587
35785,0.048562,172.253.118.0-255,5738,311376,96,364587
35786,0.048569,172.31.47.0-255,66,311442,96,364587
35787,0.050664,172.253.118.0-255,5738,317180,96,364587
35788,0.05067,172.31.47.0-255,66,317246,96,364587
35789,0.052793,172.253.118.0-255,5738,322984,96,364587
35790,0.052798,172.31.47.0-255,66,323050,96,364587
35791,0.054897,172.253.118.0-255,5738,328788,96,364587
35792,0.054903,172.31.47.0-255,66,328854,96,364587
35793,0.05701,172.253.118.0-255,5738,334592,96,364587
35794,0.057016,172.31.47.0-255,66,334658,96,364587
35795,0.059118,172.253.118.0-255,5738,340396,96,364587
35796,0.059127,172.31.47.0-255,66,340462,96,364587
35797,0.061222,172.253.118.0-255,5738,346200,96,364587
35798,0.061228,172.31.47.0-255,66,346266,96,364587
35799,0.063337,172.253.118.0-255,5738,352004,96,364587
35800,0.063343,172.31.47.0-255,66,352070,96,364587
35801,0.065462,172.253.118.0-255,5738,357808,96,364587
35802,0.065471,172.31.47.0-255,66,357874,96,364587
35803,0.067582,172.253.118.0-255,5738,363612,96,364587
35804,0.06759,172.31.47.0-255,66,363678,96,364587
35805,0.069676,172.253.118.0-255,738,364416,96,364587
35806,0.069818,172.31.47.0-255,66,364482,96,364587
35807,0.069856,172.31.47.0-255,105,364587,96,364587
35808,0.0,172.217.194.0-255,153,153,96,241772
35809,1.6e-05,172.31.47.0-255,66,219,96,241772
35810,2.2e-05,172.217.194.0-255,1484,1703,96,241772
35811,2.5e-05,172.31.47.0-255,66,1769,96,241772
35812,2.9e-05,172.217.194.0-255,2902,4671,96,241772
35813,3.1e-05,172.31.47.0-255,66,4737,96,241772
35814,3.3e-05,172.217.194.0-255,1484,6221,96,241772
35815,4.1e-05,172.31.47.0-255,66,6287,96,241772
35816,6.7e-05,172.217.194.0-255,5738,12025,96,241772
35817,6.9e-05,172.31.47.0-255,66,12091,96,241772
35818,7.2e-05,172.217.194.0-255,1990,14081,96,241772
35819,7.3e-05,172.31.47.0-255,66,14147,96,241772
35820,0.000225,172.217.194.0-255,1484,15631,96,241772
35821,0.000231,172.31.47.0-255,66,15697,96,241772
35822,0.000236,172.217.194.0-255,2902,18599,96,241772
35823,0.000237,172.31.47.0-255,66,18665,96,241772
35824,0.00027,172.217.194.0-255,5738,24403,96,241772
35825,0.000273,172.31.47.0-255,66,24469,96,241772
35826,0.000305,172.217.194.0-255,5738,30207,96,241772
35827,0.000307,172.31.47.0-255,66,30273,96,241772
35828,0.000333,172.217.194.0-255,1125,31398,96,241772
35829,0.000335,172.31.47.0-255,66,31464,96,241772
35830,0.000342,172.217.194.0-255,7156,38620,96,241772
35831,0.000344,172.31.47.0-255,66,38686,96,241772
35832,0.000383,172.31.47.0-255,66,38752,96,241772
35833,0.002013,172.217.194.0-255,1484,40236,96,241772
35834,0.002017,172.31.47.0-255,66,40302,96,241772
35835,0.002024,172.217.194.0-255,2902,43204,96,241772
35836,0.002026,172.31.47.0-255,66,43270,96,241772
35837,0.00203,172.217.194.0-255,2902,46172,96,241772
35838,0.002031,172.31.47.0-255,66,46238,96,241772
35839,0.002061,172.217.194.0-255,2902,49140,96,241772
35840,0.002065,172.217.194.0-255,2902,52042,96,241772
35841,0.002077,172.217.194.0-255,5738,57780,96,241772
35842,0.002092,172.217.194.0-255,5379,63159,96,241772
35843,0.00213,172.217.194.0-255,2902,66061,96,241772
35844,0.002151,172.217.194.0-255,5738,71799,96,241772
35845,0.006015,172.31.47.0-255,66,71865,96,241772
35846,0.008146,172.217.194.0-255,5738,77603,96,241772
35847,0.008156,172.31.47.0-255,66,77669,96,241772
35848,0.010273,172.217.194.0-255,5738,83407,96,241772
35849,0.010287,172.31.47.0-255,66,83473,96,241772
35850,0.012381,172.217.194.0-255,5738,89211,96,241772
35851,0.012908,172.31.47.0-255,66,89277,96,241772
35852,0.014995,172.217.194.0-255,5738,95015,96,241772
35853,0.015003,172.31.47.0-255,66,95081,96,241772
35854,0.017125,172.217.194.0-255,5738,100819,96,241772
35855,0.017136,172.31.47.0-255,66,100885,96,241772
35856,0.019252,172.217.194.0-255,5738,106623,96,241772
35857,0.019258,172.31.47.0-255,66,106689,96,241772
35858,0.019994,172.31.47.0-255,172,106861,96,241772
35859,0.020019,172.31.47.0-255,1109,107970,96,241772
35860,0.020069,172.31.47.0-255,1514,109484,96,241772
35861,0.020071,172.31.47.0-255,1302,110786,96,241772
35862,0.021376,172.217.194.0-255,5738,116524,96,241772
35863,0.021384,172.31.47.0-255,66,116590,96,241772
35864,0.02154,104.244.42.0-255,66,116656,96,241772
35865,0.021569,104.244.42.0-255,66,116722,96,241772
35866,0.021591,104.244.42.0-255,66,116788,96,241772
35867,0.023491,172.217.194.0-255,5738,122526,96,241772
35868,0.023497,172.31.47.0-255,66,122592,96,241772
35869,0.025616,172.217.194.0-255,5738,128330,96,241772
35870,0.025622,172.31.47.0-255,66,128396,96,241772
35871,0.027721,172.217.194.0-255,5738,134134,96,241772
35872,0.027725,172.31.47.0-255,66,134200,96,241772
35873,0.029849,172.217.194.0-255,5738,139938,96,241772
35874,0.029855,172.31.47.0-255,66,140004,96,241772
35875,0.031948,172.217.194.0-255,5738,145742,96,241772
35876,0.031954,172.31.47.0-255,66,145808,96,241772
35877,0.034055,172.217.194.0-255,4320,150128,96,241772
35878,0.034061,172.31.47.0-255,66,150194,96,241772
35879,0.034087,172.217.194.0-255,1484,151678,96,241772
35880,0.036166,172.217.194.0-255,4320,155998,96,241772
35881,0.036173,172.31.47.0-255,66,156064,96,241772
35882,0.03826,172.217.194.0-255,5738,161802,96,241772
35883,0.038299,172.31.47.0-255,66,161868,96,241772
35884,0.040416,172.217.194.0-255,5738,167606,96,241772
35885,0.040425,172.31.47.0-255,66,167672,96,241772
35886,0.042536,172.217.194.0-255,5738,173410,96,241772
35887,0.042541,172.31.47.0-255,66,173476,96,241772
35888,0.044652,172.217.194.0-255,5738,179214,96,241772
35889,0.044657,172.31.47.0-255,66,179280,96,241772
35890,0.046773,172.217.194.0-255,5738,185018,96,241772
35891,0.046779,172.31.47.0-255,66,185084,96,241772
35892,0.048902,172.217.194.0-255,5738,190822,96,241772
35893,0.048909,172.31.47.0-255,66,190888,96,241772
35894,0.051023,172.217.194.0-255,5738,196626,96,241772
35895,0.051031,172.31.47.0-255,66,196692,96,241772
35896,0.05313,172.217.194.0-255,5738,202430,96,241772
35897,0.053135,172.31.47.0-255,66,202496,96,241772
35898,0.055264,172.217.194.0-255,5738,208234,96,241772
35899,0.055271,172.31.47.0-255,66,208300,96,241772
35900,0.057373,172.217.194.0-255,4320,212620,96,241772
35901,0.057378,172.31.47.0-255,66,212686,96,241772
35902,0.057404,172.217.194.0-255,1484,214170,96,241772
35903,0.059477,172.217.194.0-255,4320,218490,96,241772
35904,0.059483,172.31.47.0-255,66,218556,96,241772
35905,0.061593,172.217.194.0-255,5738,224294,96,241772
35906,0.061628,172.31.47.0-255,66,224360,96,241772
35907,0.063725,172.217.194.0-255,5738,230098,96,241772
35908,0.063732,172.31.47.0-255,66,230164,96,241772
35909,0.065854,172.217.194.0-255,5738,235902,96,241772
35910,0.065859,172.31.47.0-255,66,235968,96,241772
35911,0.067965,172.217.194.0-255,5738,241706,96,241772
35912,0.067971,172.31.47.0-255,66,241772,96,241772
35913,0.0,216.58.221.0-255,146,146,96,297190
35914,2.8e-05,172.31.47.0-255,66,212,96,297190
35915,3.5e-05,216.58.221.0-255,1484,1696,96,297190
35916,3.9e-05,172.31.47.0-255,66,1762,96,297190
35917,4.4e-05,216.58.221.0-255,2902,4664,96,297190
35918,5.6e-05,172.31.47.0-255,66,4730,96,297190
35919,8.5e-05,216.58.221.0-255,5738,10468,96,297190
35920,8.8e-05,172.31.47.0-255,66,10534,96,297190
35921,0.000163,216.58.221.0-255,1484,12018,96,297190
35922,0.000166,172.31.47.0-255,66,12084,96,297190
35923,0.000204,172.31.47.0-255,66,12150,96,297190
35924,0.000404,216.58.221.0-255,6797,18947,96,297190
35925,0.000409,172.31.47.0-255,66,19013,96,297190
35926,0.000512,216.58.221.0-255,4320,23333,96,297190
35927,0.000516,172.31.47.0-255,66,23399,96,297190
35928,0.000534,216.58.221.0-255,2902,26301,96,297190
35929,0.000536,172.31.47.0-255,66,26367,96,297190
35930,0.000637,216.58.221.0-255,5738,32105,96,297190
35931,0.000641,172.31.47.0-255,66,32171,96,297190
35932,0.000681,172.31.47.0-255,66,32237,96,297190
35933,0.0009,216.58.221.0-255,4320,36557,96,297190
35934,0.000904,172.31.47.0-255,66,36623,96,297190
35935,0.000939,216.58.221.0-255,6767,43390,96,297190
35936,0.000943,172.31.47.0-255,66,43456,96,297190
35937,0.00134,216.58.221.0-255,112,43568,96,297190
35938,0.001345,172.31.47.0-255,66,43634,96,297190
35939,0.001382,216.58.221.0-255,1484,45118,96,297190
35940,0.001385,172.31.47.0-255,66,45184,96,297190
35941,0.001389,216.58.221.0-255,2902,48086,96,297190
35942,0.00139,172.31.47.0-255,66,48152,96,297190
35943,0.001437,216.58.221.0-255,5738,53890,96,297190
35944,0.001452,172.31.47.0-255,66,53956,96,297190
35945,0.00154,216.58.221.0-255,4320,58276,96,297190
35946,0.001544,172.31.47.0-255,66,58342,96,297190
35947,0.001576,172.31.47.0-255,66,58408,96,297190
35948,0.001754,216.58.221.0-255,1484,59892,96,297190
35949,0.001757,172.31.47.0-255,66,59958,96,297190
35950,0.001785,216.58.221.0-255,5738,65696,96,297190
35951,0.001787,172.31.47.0-255,66,65762,96,297190
35952,0.001876,216.58.221.0-255,3602,69364,96,297190
35953,0.001879,172.31.47.0-255,66,69430,96,297190
35954,0.001933,216.58.221.0-255,4320,73750,96,297190
35955,0.001936,172.31.47.0-255,66,73816,96,297190
35956,0.002018,216.58.221.0-255,5738,79554,96,297190
35957,0.002021,172.31.47.0-255,66,79620,96,297190
35958,0.002048,216.58.221.0-255,4320,83940,96,297190
35959,0.002056,172.31.47.0-255,66,84006,96,297190
35960,0.002176,216.58.221.0-255,2902,86908,96,297190
35961,0.002179,172.31.47.0-255,66,86974,96,297190
35962,0.002216,172.31.47.0-255,66,87040,96,297190
35963,0.002372,216.58.221.0-255,7156,94196,96,297190
35964,0.002376,172.31.47.0-255,66,94262,96,297190
35965,0.002396,216.58.221.0-255,766,95028,96,297190
35966,0.002452,172.31.47.0-255,66,95094,96,297190
35967,0.004293,216.58.221.0-255,1484,96578,96,297190
35968,0.004313,216.58.221.0-255,2902,99480,96,297190
35969,0.00432,172.31.47.0-255,66,99546,96,297190
35970,0.004372,216.58.221.0-255,1484,101030,96,297190
35971,0.006256,216.58.221.0-255,4320,105350,96,297190
35972,0.006262,172.31.47.0-255,66,105416,96,297190
35973,0.008192,216.58.221.0-255,5738,111154,96,297190
35974,0.008229,172.31.47.0-255,66,111220,96,297190
35975,0.010177,216.58.221.0-255,5738,116958,96,297190
35976,0.010191,172.31.47.0-255,66,117024,96,297190
35977,0.012132,216.58.221.0-255,5738,122762,96,297190
35978,0.01214,172.31.47.0-255,66,122828,96,297190
35979,0.014075,216.58.221.0-255,5738,128566,96,297190
35980,0.014082,172.31.47.0-255,66,128632,96,297190
35981,0.016017,216.58.221.0-255,4320,132952,96,297190
35982,0.016023,172.31.47.0-255,66,133018,96,297190
35983,0.016048,216.58.221.0-255,1484,134502,96,297190
35984,0.01796,216.58.221.0-255,4320,138822,96,297190
35985,0.017968,172.31.47.0-255,66,138888,96,297190
35986,0.019901,216.58.221.0-255,5738,144626,96,297190
35987,0.019947,172.31.47.0-255,66,144692,96,297190
35988,0.020607,172.31.47.0-255,172,144864,96,297190
35989,0.020642,172.31.47.0-255,1110,145974,96,297190
35990,0.020704,172.31.47.0-255,1514,147488,96,297190
35991,0.020706,172.31.47.0-255,1302,148790,96,297190
35992,0.021892,216.58.221.0-255,5738,154528,96,297190
35993,0.021899,172.31.47.0-255,66,154594,96,297190
35994,0.022149,104.244.42.0-255,66,154660,96,297190
35995,0.022209,104.244.42.0-255,66,154726,96,297190
35996,0.022249,104.244.42.0-255,66,154792,96,297190
35997,0.023833,216.58.221.0-255,5738,160530,96,297190
35998,0.023838,172.31.47.0-255,66,160596,96,297190
35999,0.025764,216.58.221.0-255,2902,163498,96,297190
36000,0.025769,172.31.47.0-255,66,163564,96,297190
36001,0.025786,216.58.221.0-255,2902,166466,96,297190
36002,0.025807,172.31.47.0-255,66,166532,96,297190
36003,0.02771,216.58.221.0-255,2902,169434,96,297190
36004,0.027715,172.31.47.0-255,66,169500,96,297190
36005,0.027739,216.58.221.0-255,2902,172402,96,297190
36006,0.027755,172.31.47.0-255,66,172468,96,297190
36007,0.029647,216.58.221.0-255,2902,175370,96,297190
36008,0.029654,172.31.47.0-255,66,175436,96,297190
36009,0.029682,216.58.221.0-255,2902,178338,96,297190
36010,0.029709,172.31.47.0-255,66,178404,96,297190
36011,0.031589,216.58.221.0-255,2902,181306,96,297190
36012,0.031594,172.31.47.0-255,66,181372,96,297190
36013,0.031628,216.58.221.0-255,2902,184274,96,297190
36014,0.031641,172.31.47.0-255,66,184340,96,297190
36015,0.033525,216.58.221.0-255,2902,187242,96,297190
36016,0.033531,172.31.47.0-255,66,187308,96,297190
36017,0.033576,216.58.221.0-255,2902,190210,96,297190
36018,0.033596,172.31.47.0-255,66,190276,96,297190
36019,0.035468,216.58.221.0-255,2902,193178,96,297190
36020,0.035474,172.31.47.0-255,66,193244,96,297190
36021,0.035517,216.58.221.0-255,2902,196146,96,297190
36022,0.035536,172.31.47.0-255,66,196212,96,297190
36023,0.037416,216.58.221.0-255,2902,199114,96,297190
36024,0.037422,172.31.47.0-255,66,199180,96,297190
36025,0.03749,216.58.221.0-255,2902,202082,96,297190
36026,0.037501,172.31.47.0-255,66,202148,96,297190
36027,0.039351,216.58.221.0-255,2902,205050,96,297190
36028,0.039357,172.31.47.0-255,66,205116,96,297190
36029,0.039424,216.58.221.0-255,2902,208018,96,297190
36030,0.039612,172.31.47.0-255,66,208084,96,297190
36031,0.041326,216.58.221.0-255,2902,210986,96,297190
36032,0.04133,172.31.47.0-255,66,211052,96,297190
36033,0.041537,216.58.221.0-255,2902,213954,96,297190
36034,0.041541,172.31.47.0-255,66,214020,96,297190
36035,0.043256,216.58.221.0-255,2902,216922,96,297190
36036,0.04326,172.31.47.0-255,66,216988,96,297190
36037,0.043473,216.58.221.0-255,2902,219890,96,297190
36038,0.043477,172.31.47.0-255,66,219956,96,297190
36039,0.045209,216.58.221.0-255,2902,222858,96,297190
36040,0.045213,172.31.47.0-255,66,222924,96,297190
36041,0.045469,216.58.221.0-255,2902,225826,96,297190
36042,0.046213,172.31.47.0-255,66,225892,96,297190
36043,0.047134,216.58.221.0-255,2902,228794,96,297190
36044,0.047139,172.31.47.0-255,66,228860,96,297190
36045,0.048146,216.58.221.0-255,2902,231762,96,297190
36046,0.048151,172.31.47.0-255,66,231828,96,297190
36047,0.049068,216.58.221.0-255,2902,234730,96,297190
36048,0.049072,172.31.47.0-255,66,234796,96,297190
36049,0.050109,216.58.221.0-255,2902,237698,96,297190
36050,0.050114,172.31.47.0-255,66,237764,96,297190
36051,0.051016,216.58.221.0-255,2902,240666,96,297190
36052,0.05102,172.31.47.0-255,66,240732,96,297190
36053,0.052038,216.58.221.0-255,2902,243634,96,297190
36054,0.052043,172.31.47.0-255,66,243700,96,297190
36055,0.052952,216.58.221.0-255,1484,245184,96,297190
36056,0.052964,216.58.221.0-255,1484,246668,96,297190
36057,0.053492,172.31.47.0-255,66,246734,96,297190
36058,0.053968,216.58.221.0-255,2902,249636,96,297190
36059,0.053973,172.31.47.0-255,66,249702,96,297190
36060,0.055455,216.58.221.0-255,2902,252604,96,297190
36061,0.055459,172.31.47.0-255,66,252670,96,297190
36062,0.055904,216.58.221.0-255,2902,255572,96,297190
36063,0.05591,172.31.47.0-255,66,255638,96,297190
36064,0.057493,216.58.221.0-255,2902,258540,96,297190
36065,0.057499,172.31.47.0-255,66,258606,96,297190
36066,0.057847,216.58.221.0-255,2902,261508,96,297190
36067,0.057852,172.31.47.0-255,66,261574,96,297190
36068,0.059427,216.58.221.0-255,2902,264476,96,297190
36069,0.059434,172.31.47.0-255,66,264542,96,297190
36070,0.059777,216.58.221.0-255,2902,267444,96,297190
36071,0.059783,172.31.47.0-255,66,267510,96,297190
36072,0.061432,216.58.221.0-255,2902,270412,96,297190
36073,0.061437,172.31.47.0-255,66,270478,96,297190
36074,0.061708,216.58.221.0-255,2902,273380,96,297190
36075,0.061713,172.31.47.0-255,66,273446,96,297190
36076,0.063366,216.58.221.0-255,2902,276348,96,297190
36077,0.063371,172.31.47.0-255,66,276414,96,297190
36078,0.063633,216.58.221.0-255,2902,279316,96,297190
36079,0.063638,172.31.47.0-255,66,279382,96,297190
36080,0.065296,216.58.221.0-255,2902,282284,96,297190
36081,0.0653,172.31.47.0-255,66,282350,96,297190
36082,0.065558,216.58.221.0-255,2902,285252,96,297190
36083,0.065563,172.31.47.0-255,66,285318,96,297190
36084,0.067226,216.58.221.0-255,2902,288220,96,297190
36085,0.067231,172.31.47.0-255,66,288286,96,297190
36086,0.067487,216.58.221.0-255,2902,291188,96,297190
36087,0.067492,172.31.47.0-255,66,291254,96,297190
36088,0.069155,216.58.221.0-255,2902,294156,96,297190
36089,0.069159,172.31.47.0-255,66,294222,96,297190
36090,0.069435,216.58.221.0-255,2902,297124,96,297190
36091,0.069457,172.31.47.0-255,66,297190,96,297190
36092,0.0,74.125.24.0-255,152,152,96,257490
36093,2.6e-05,172.31.47.0-255,66,218,96,257490
36094,3.2e-05,74.125.24.0-255,1484,1702,96,257490
36095,3.6e-05,172.31.47.0-255,66,1768,96,257490
36096,3.9e-05,74.125.24.0-255,1484,3252,96,257490
36097,4.2e-05,172.31.47.0-255,66,3318,96,257490
36098,5.6e-05,74.125.24.0-255,1484,4802,96,257490
36099,5.8e-05,172.31.47.0-255,66,4868,96,257490
36100,6.5e-05,74.125.24.0-255,5738,10606,96,257490
36101,6.7e-05,172.31.47.0-255,66,10672,96,257490
36102,9.3e-05,74.125.24.0-255,2902,13574,96,257490
36103,9.6e-05,172.31.47.0-255,66,13640,96,257490
36104,0.000125,172.31.47.0-255,66,13706,96,257490
36105,0.000127,74.125.24.0-255,1484,15190,96,257490
36106,0.00013,172.31.47.0-255,66,15256,96,257490
36107,0.000151,74.125.24.0-255,5379,20635,96,257490
36108,0.000154,172.31.47.0-255,66,20701,96,257490
36109,0.000247,74.125.24.0-255,1484,22185,96,257490
36110,0.00025,172.31.47.0-255,66,22251,96,257490
36111,0.000272,74.125.24.0-255,2902,25153,96,257490
36112,0.000277,74.125.24.0-255,5738,30891,96,257490
36113,0.000278,172.31.47.0-255,66,30957,96,257490
36114,0.000282,172.31.47.0-255,66,31023,96,257490
36115,0.000319,172.31.47.0-255,66,31089,96,257490
36116,0.00034,74.125.24.0-255,1484,32573,96,257490
36117,0.000342,172.31.47.0-255,66,32639,96,257490
36118,0.000355,172.31.47.0-255,66,32705,96,257490
36119,0.000359,74.125.24.0-255,2184,34889,96,257490
36120,0.000363,172.31.47.0-255,66,34955,96,257490
36121,0.000683,74.125.24.0-255,363,35318,96,257490
36122,0.000755,172.31.47.0-255,66,35384,96,257490
36123,0.001386,74.125.24.0-255,127,35511,96,257490
36124,0.001427,74.125.24.0-255,1484,36995,96,257490
36125,0.001431,172.31.47.0-255,66,37061,96,257490
36126,0.00145,74.125.24.0-255,2902,39963,96,257490
36127,0.001452,172.31.47.0-255,66,40029,96,257490
36128,0.001456,74.125.24.0-255,1484,41513,96,257490
36129,0.001476,74.125.24.0-255,5738,47251,96,257490
36130,0.001478,172.31.47.0-255,66,47317,96,257490
36131,0.001483,74.125.24.0-255,5738,53055,96,257490
36132,0.001485,172.31.47.0-255,66,53121,96,257490
36133,0.001496,74.125.24.0-255,1484,54605,96,257490
36134,0.00153,74.125.24.0-255,4320,58925,96,257490
36135,0.001532,172.31.47.0-255,66,58991,96,257490
36136,0.001556,172.31.47.0-255,66,59057,96,257490
36137,0.003541,74.125.24.0-255,5738,64795,96,257490
36138,0.003545,172.31.47.0-255,66,64861,96,257490
36139,0.005561,74.125.24.0-255,5738,70599,96,257490
36140,0.005567,172.31.47.0-255,66,70665,96,257490
36141,0.007574,74.125.24.0-255,5738,76403,96,257490
36142,0.00758,172.31.47.0-255,66,76469,96,257490
36143,0.009606,74.125.24.0-255,5738,82207,96,257490
36144,0.009616,172.31.47.0-255,66,82273,96,257490
36145,0.011602,74.125.24.0-255,5738,88011,96,257490
36146,0.011609,172.31.47.0-255,66,88077,96,257490
36147,0.01362,74.125.24.0-255,5738,93815,96,257490
36148,0.013633,172.31.47.0-255,66,93881,96,257490
36149,0.015632,74.125.24.0-255,5738,99619,96,257490
36150,0.015641,172.31.47.0-255,66,99685,96,257490
36151,0.017676,74.125.24.0-255,5738,105423,96,257490
36152,0.017683,172.31.47.0-255,66,105489,96,257490
36153,0.019675,74.125.24.0-255,5738,111227,96,257490
36154,0.019686,172.31.47.0-255,66,111293,96,257490
36155,0.021703,74.125.24.0-255,5738,117031,96,257490
36156,0.02171,172.31.47.0-255,66,117097,96,257490
36157,0.023193,172.31.47.0-255,172,117269,96,257490
36158,0.023231,172.31.47.0-255,1109,118378,96,257490
36159,0.023289,172.31.47.0-255,1514,119892,96,257490
36160,0.023291,172.31.47.0-255,1302,121194,96,257490
36161,0.023712,74.125.24.0-255,5738,126932,96,257490
36162,0.023716,172.31.47.0-255,66,126998,96,257490
36163,0.024729,104.244.42.0-255,66,127064,96,257490
36164,0.024968,104.244.42.0-255,66,127130,96,257490
36165,0.02497,104.244.42.0-255,66,127196,96,257490
36166,0.025723,74.125.24.0-255,1484,128680,96,257490
36167,0.02575,74.125.24.0-255,4320,133000,96,257490
36168,0.025754,172.31.47.0-255,66,133066,96,257490
36169,0.02773,74.125.24.0-255,5738,138804,96,257490
36170,0.027734,172.31.47.0-255,66,138870,96,257490
36171,0.029754,74.125.24.0-255,5738,144608,96,257490
36172,0.029759,172.31.47.0-255,66,144674,96,257490
36173,0.031761,74.125.24.0-255,5738,150412,96,257490
36174,0.031766,172.31.47.0-255,66,150478,96,257490
36175,0.033765,74.125.24.0-255,4320,154798,96,257490
36176,0.033769,172.31.47.0-255,66,154864,96,257490
36177,0.033797,74.125.24.0-255,1484,156348,96,257490
36178,0.035753,74.125.24.0-255,4320,160668,96,257490
36179,0.035757,172.31.47.0-255,66,160734,96,257490
36180,0.037746,74.125.24.0-255,2902,163636,96,257490
36181,0.037751,172.31.47.0-255,66,163702,96,257490
36182,0.037777,74.125.24.0-255,2902,166604,96,257490
36183,0.03778,172.31.47.0-255,66,166670,96,257490
36184,0.039717,74.125.24.0-255,2902,169572,96,257490
36185,0.039723,172.31.47.0-255,66,169638,96,257490
36186,0.039756,74.125.24.0-255,2902,172540,96,257490
36187,0.039759,172.31.47.0-255,66,172606,96,257490
36188,0.041713,74.125.24.0-255,2902,175508,96,257490
36189,0.041717,172.31.47.0-255,66,175574,96,257490
36190,0.041757,74.125.24.0-255,2902,178476,96,257490
36191,0.041761,172.31.47.0-255,66,178542,96,257490
36192,0.043702,74.125.24.0-255,2902,181444,96,257490
36193,0.043707,172.31.47.0-255,66,181510,96,257490
36194,0.043744,74.125.24.0-255,2902,184412,96,257490
36195,0.043747,172.31.47.0-255,66,184478,96,257490
36196,0.045704,74.125.24.0-255,2902,187380,96,257490
36197,0.04571,172.31.47.0-255,66,187446,96,257490
36198,0.04574,74.125.24.0-255,2902,190348,96,257490
36199,0.045744,172.31.47.0-255,66,190414,96,257490
36200,0.047704,74.125.24.0-255,2902,193316,96,257490
36201,0.047713,172.31.47.0-255,66,193382,96,257490
36202,0.047748,74.125.24.0-255,2902,196284,96,257490
36203,0.047751,172.31.47.0-255,66,196350,96,257490
36204,0.049735,74.125.24.0-255,5738,202088,96,257490
36205,0.049743,172.31.47.0-255,66,202154,96,257490
36206,0.051732,74.125.24.0-255,5738,207892,96,257490
36207,0.051738,172.31.47.0-255,66,207958,96,257490
36208,0.053743,74.125.24.0-255,5738,213696,96,257490
36209,0.05375,172.31.47.0-255,66,213762,96,257490
36210,0.055759,74.125.24.0-255,5738,219500,96,257490
36211,0.055765,172.31.47.0-255,66,219566,96,257490
36212,0.057784,74.125.24.0-255,5738,225304,96,257490
36213,0.05779,172.31.47.0-255,66,225370,96,257490
36214,0.059785,74.125.24.0-255,5738,231108,96,257490
36215,0.059791,172.31.47.0-255,66,231174,96,257490
36216,0.061794,74.125.24.0-255,5738,236912,96,257490
36217,0.061799,172.31.47.0-255,66,236978,96,257490
36218,0.063782,74.125.24.0-255,4320,241298,96,257490
36219,0.063787,172.31.47.0-255,66,241364,96,257490
36220,0.06382,74.125.24.0-255,1484,242848,96,257490
36221,0.065818,74.125.24.0-255,4320,247168,96,257490
36222,0.065823,172.31.47.0-255,66,247234,96,257490
36223,0.06782,74.125.24.0-255,4320,251554,96,257490
36224,0.067825,172.31.47.0-255,66,251620,96,257490
36225,0.067857,74.125.24.0-255,1484,253104,96,257490
36226,0.069828,74.125.24.0-255,4320,257424,96,257490
36227,0.069834,172.31.47.0-255,66,257490,96,257490
36228,0.0,172.217.194.0-255,153,153,96,220899
36229,3.2e-05,172.31.47.0-255,66,219,96,220899
36230,4e-05,172.217.194.0-255,1484,1703,96,220899
36231,4.4e-05,172.31.47.0-255,66,1769,96,220899
36232,5.5e-05,172.217.194.0-255,2902,4671,96,220899
36233,5.9e-05,172.31.47.0-255,66,4737,96,220899
36234,6.5e-05,172.217.194.0-255,4320,9057,96,220899
36235,6.7e-05,172.31.47.0-255,66,9123,96,220899
36236,0.000115,172.31.47.0-255,66,9189,96,220899
36237,0.000148,172.31.47.0-255,66,9255,96,220899
36238,0.000349,172.217.194.0-255,1484,10739,96,220899
36239,0.000355,172.31.47.0-255,66,10805,96,220899
36240,0.000361,172.217.194.0-255,2902,13707,96,220899
36241,0.000363,172.31.47.0-255,66,13773,96,220899
36242,0.000376,172.217.194.0-255,4320,18093,96,220899
36243,0.000379,172.31.47.0-255,66,18159,96,220899
36244,0.000382,172.217.194.0-255,1484,19643,96,220899
36245,0.000384,172.31.47.0-255,66,19709,96,220899
36246,0.00043,172.31.47.0-255,66,19775,96,220899
36247,0.000442,172.31.47.0-255,66,19841,96,220899
36248,0.000474,172.217.194.0-255,5960,25801,96,220899
36249,0.000477,172.31.47.0-255,66,25867,96,220899
36250,0.00051,172.217.194.0-255,1484,27351,96,220899
36251,0.000514,172.31.47.0-255,66,27417,96,220899
36252,0.000519,172.217.194.0-255,2902,30319,96,220899
36253,0.000521,172.31.47.0-255,66,30385,96,220899
36254,0.000558,172.217.194.0-255,5738,36123,96,220899
36255,0.000562,172.31.47.0-255,66,36189,96,220899
36256,0.000582,172.31.47.0-255,66,36255,96,220899
36257,0.000596,172.31.47.0-255,66,36321,96,220899
36258,0.001133,172.217.194.0-255,1484,37805,96,220899
36259,0.001144,172.217.194.0-255,2902,40707,96,220899
36260,0.001147,172.31.47.0-255,66,40773,96,220899
36261,0.001155,172.217.194.0-255,5738,46511,96,220899
36262,0.001157,172.31.47.0-255,66,46577,96,220899
36263,0.001205,172.31.47.0-255,66,46643,96,220899
36264,0.001211,172.217.194.0-255,4320,50963,96,220899
36265,0.001213,172.31.47.0-255,66,51029,96,220899
36266,0.001263,172.217.194.0-255,6438,57467,96,220899
36267,0.001268,172.31.47.0-255,66,57533,96,220899
36268,0.001275,172.217.194.0-255,7156,64689,96,220899
36269,0.001277,172.31.47.0-255,66,64755,96,220899
36270,0.001301,172.217.194.0-255,7156,71911,96,220899
36271,0.001304,172.31.47.0-255,66,71977,96,220899
36272,0.001335,172.217.194.0-255,5738,77715,96,220899
36273,0.001341,172.217.194.0-255,5738,83453,96,220899
36274,0.001346,172.31.47.0-255,66,83519,96,220899
36275,0.001349,172.31.47.0-255,66,83585,96,220899
36276,0.001379,172.31.47.0-255,66,83651,96,220899
36277,0.001393,172.31.47.0-255,66,83717,96,220899
36278,0.001397,172.217.194.0-255,2902,86619,96,220899
36279,0.001399,172.31.47.0-255,66,86685,96,220899
36280,0.001459,172.217.194.0-255,7156,93841,96,220899
36281,0.001465,172.31.47.0-255,66,93907,96,220899
36282,0.001507,172.31.47.0-255,66,93973,96,220899
36283,0.001528,172.31.47.0-255,66,94039,96,220899
36284,0.001585,172.31.47.0-255,66,94105,96,220899
36285,0.001615,172.217.194.0-255,766,94871,96,220899
36286,0.001742,172.217.194.0-255,1484,96355,96,220899
36287,0.001748,172.31.47.0-255,66,96421,96,220899
36288,0.001753,172.217.194.0-255,2902,99323,96,220899
36289,0.001755,172.31.47.0-255,66,99389,96,220899
36290,0.001783,172.217.194.0-255,4320,103709,96,220899
36291,0.001787,172.31.47.0-255,66,103775,96,220899
36292,0.001794,172.217.194.0-255,1484,105259,96,220899
36293,0.001798,172.217.194.0-255,2902,108161,96,220899
36294,0.001805,172.31.47.0-255,66,108227,96,220899
36295,0.001829,172.217.194.0-255,2902,111129,96,220899
36296,0.001832,172.31.47.0-255,66,111195,96,220899
36297,0.001844,172.217.194.0-255,7156,118351,96,220899
36298,0.001846,172.31.47.0-255,66,118417,96,220899
36299,0.001882,172.31.47.0-255,66,118483,96,220899
36300,0.00201,172.217.194.0-255,1484,119967,96,220899
36301,0.002029,172.217.194.0-255,2902,122869,96,220899
36302,0.002032,172.31.47.0-255,66,122935,96,220899
36303,0.002055,172.217.194.0-255,5738,128673,96,220899
36304,0.002057,172.31.47.0-255,66,128739,96,220899
36305,0.00206,172.217.194.0-255,1484,130223,96,220899
36306,0.002088,172.31.47.0-255,66,130289,96,220899
36307,0.002111,172.217.194.0-255,2902,133191,96,220899
36308,0.002114,172.31.47.0-255,66,133257,96,220899
36309,0.00214,172.31.47.0-255,66,133323,96,220899
36310,0.002195,172.31.47.0-255,66,133389,96,220899
36311,0.002212,172.31.47.0-255,66,133455,96,220899
36312,0.00444,172.217.194.0-255,5738,139193,96,220899
36313,0.004445,172.31.47.0-255,66,139259,96,220899
36314,0.006683,172.217.194.0-255,5738,144997,96,220899
36315,0.006697,172.31.47.0-255,66,145063,96,220899
36316,0.008955,172.217.194.0-255,5738,150801,96,220899
36317,0.008963,172.31.47.0-255,66,150867,96,220899
36318,0.011227,172.217.194.0-255,5738,156605,96,220899
36319,0.011241,172.31.47.0-255,66,156671,96,220899
36320,0.013504,172.217.194.0-255,5738,162409,96,220899
36321,0.013521,172.31.47.0-255,66,162475,96,220899
36322,0.015771,172.217.194.0-255,5738,168213,96,220899
36323,0.015782,172.31.47.0-255,66,168279,96,220899
36324,0.01806,172.217.194.0-255,5738,174017,96,220899
36325,0.018071,172.31.47.0-255,66,174083,96,220899
36326,0.020303,172.217.194.0-255,5738,179821,96,220899
36327,0.020311,172.31.47.0-255,66,179887,96,220899
36328,0.022562,172.217.194.0-255,5738,185625,96,220899
36329,0.02257,172.31.47.0-255,66,185691,96,220899
36330,0.02483,172.217.194.0-255,5738,191429,96,220899
36331,0.024838,172.31.47.0-255,66,191495,96,220899
36332,0.027093,172.217.194.0-255,5738,197233,96,220899
36333,0.027104,172.31.47.0-255,66,197299,96,220899
36334,0.029364,172.217.194.0-255,5738,203037,96,220899
36335,0.029373,172.31.47.0-255,66,203103,96,220899
36336,0.030215,172.31.47.0-255,172,203275,96,220899
36337,0.030244,172.31.47.0-255,1109,204384,96,220899
36338,0.03031,172.31.47.0-255,1514,205898,96,220899
36339,0.030312,172.31.47.0-255,1514,207412,96,220899
36340,0.030317,172.31.47.0-255,1514,208926,96,220899
36341,0.030318,172.31.47.0-255,1083,210009,96,220899
36342,0.031599,172.217.194.0-255,5738,215747,96,220899
36343,0.031607,172.31.47.0-255,66,215813,96,220899
36344,0.031736,104.244.42.0-255,66,215879,96,220899
36345,0.031891,104.244.42.0-255,66,215945,96,220899
36346,0.031896,104.244.42.0-255,66,216011,96,220899
36347,0.032031,104.244.42.0-255,66,216077,96,220899
36348,0.033861,172.217.194.0-255,4585,220662,96,220899
36349,0.033867,172.31.47.0-255,66,220728,96,220899
36350,0.034063,172.31.47.0-255,105,220833,96,220899
36351,0.036259,172.217.194.0-255,66,220899,96,220899
36352,0.0,172.31.47.0-255,105,105,96,276
36353,0.002089,157.240.13.0-255,105,210,96,276
36354,0.041836,172.31.47.0-255,66,276,96,276
36355,0.0,172.31.47.0-255,105,105,96,276
36356,0.067634,31.13.82.0-255,105,210,96,276
36357,0.067655,172.31.47.0-255,66,276,96,276
36358,0.0,74.125.24.0-255,226,226,96,196289
36359,2.5e-05,172.31.47.0-255,66,292,96,196289
36360,3.1e-05,74.125.24.0-255,1484,1776,96,196289
36361,3.6e-05,172.31.47.0-255,66,1842,96,196289
36362,7e-05,74.125.24.0-255,4320,6162,96,196289
36363,7.5e-05,172.31.47.0-255,66,6228,96,196289
36364,0.000259,74.125.24.0-255,5738,11966,96,196289
36365,0.000264,172.31.47.0-255,66,12032,96,196289
36366,0.000277,74.125.24.0-255,1975,14007,96,196289
36367,0.000284,172.31.47.0-255,66,14073,96,196289
36368,0.000597,74.125.24.0-255,1484,15557,96,196289
36369,0.000602,172.31.47.0-255,66,15623,96,196289
36370,0.000662,74.125.24.0-255,2902,18525,96,196289
36371,0.000666,172.31.47.0-255,66,18591,96,196289
36372,0.000788,74.125.24.0-255,5738,24329,96,196289
36373,0.000792,172.31.47.0-255,66,24395,96,196289
36374,0.001043,74.125.24.0-255,4320,28715,96,196289
36375,0.001048,172.31.47.0-255,66,28781,96,196289
36376,0.00107,74.125.24.0-255,2809,31590,96,196289
36377,0.001073,172.31.47.0-255,66,31656,96,196289
36378,0.00356,74.125.24.0-255,2902,34558,96,196289
36379,0.003571,172.31.47.0-255,66,34624,96,196289
36380,0.003608,74.125.24.0-255,2902,37526,96,196289
36381,0.003612,172.31.47.0-255,66,37592,96,196289
36382,0.006099,74.125.24.0-255,2902,40494,96,196289
36383,0.00611,172.31.47.0-255,66,40560,96,196289
36384,0.006144,74.125.24.0-255,2902,43462,96,196289
36385,0.006149,172.31.47.0-255,66,43528,96,196289
36386,0.008624,74.125.24.0-255,2902,46430,96,196289
36387,0.008633,172.31.47.0-255,66,46496,96,196289
36388,0.008674,74.125.24.0-255,2902,49398,96,196289
36389,0.008679,172.31.47.0-255,66,49464,96,196289
36390,0.011149,74.125.24.0-255,2902,52366,96,196289
36391,0.011155,172.31.47.0-255,66,52432,96,196289
36392,0.011199,74.125.24.0-255,2902,55334,96,196289
36393,0.011201,172.31.47.0-255,66,55400,96,196289
36394,0.01368,74.125.24.0-255,2902,58302,96,196289
36395,0.013685,172.31.47.0-255,66,58368,96,196289
36396,0.01373,74.125.24.0-255,2902,61270,96,196289
36397,0.013733,172.31.47.0-255,66,61336,96,196289
36398,0.016206,74.125.24.0-255,2902,64238,96,196289
36399,0.016217,172.31.47.0-255,66,64304,96,196289
36400,0.016257,74.125.24.0-255,2902,67206,96,196289
36401,0.01626,172.31.47.0-255,66,67272,96,196289
36402,0.018731,74.125.24.0-255,2902,70174,96,196289
36403,0.018743,172.31.47.0-255,66,70240,96,196289
36404,0.018782,74.125.24.0-255,2902,73142,96,196289
36405,0.018785,172.31.47.0-255,66,73208,96,196289
36406,0.021273,74.125.24.0-255,2902,76110,96,196289
36407,0.021281,172.31.47.0-255,66,76176,96,196289
36408,0.021315,74.125.24.0-255,2902,79078,96,196289
36409,0.021319,172.31.47.0-255,66,79144,96,196289
36410,0.023818,74.125.24.0-255,2902,82046,96,196289
36411,0.023826,172.31.47.0-255,66,82112,96,196289
36412,0.023873,74.125.24.0-255,2902,85014,96,196289
36413,0.023878,172.31.47.0-255,66,85080,96,196289
36414,0.024293,172.31.47.0-255,172,85252,96,196289
36415,0.024323,172.31.47.0-255,1111,86363,96,196289
36416,0.024361,172.31.47.0-255,1514,87877,96,196289
36417,0.024363,172.31.47.0-255,1300,89177,96,196289
36418,0.025843,104.244.42.0-255,66,89243,96,196289
36419,0.025875,104.244.42.0-255,66,89309,96,196289
36420,0.025903,104.244.42.0-255,66,89375,96,196289
36421,0.026367,74.125.24.0-255,1484,90859,96,196289
36422,0.02637,172.31.47.0-255,66,90925,96,196289
36423,0.026401,74.125.24.0-255,1484,92409,96,196289
36424,0.026404,172.31.47.0-255,66,92475,96,196289
36425,0.02643,74.125.24.0-255,2902,95377,96,196289
36426,0.026434,172.31.47.0-255,66,95443,96,196289
36427,0.028892,74.125.24.0-255,1484,96927,96,196289
36428,0.028921,74.125.24.0-255,4320,101247,96,196289
36429,0.028925,172.31.47.0-255,66,101313,96,196289
36430,0.031459,74.125.24.0-255,5738,107051,96,196289
36431,0.031465,172.31.47.0-255,66,107117,96,196289
36432,0.034007,74.125.24.0-255,2902,110019,96,196289
36433,0.034015,172.31.47.0-255,66,110085,96,196289
36434,0.03408,74.125.24.0-255,2902,112987,96,196289
36435,0.034084,172.31.47.0-255,66,113053,96,196289
36436,0.036536,74.125.24.0-255,2902,115955,96,196289
36437,0.036541,172.31.47.0-255,66,116021,96,196289
36438,0.036605,74.125.24.0-255,2902,118923,96,196289
36439,0.036608,172.31.47.0-255,66,118989,96,196289
36440,0.039077,74.125.24.0-255,2902,121891,96,196289
36441,0.039082,172.31.47.0-255,66,121957,96,196289
36442,0.03912,74.125.24.0-255,2902,124859,96,196289
36443,0.039122,172.31.47.0-255,66,124925,96,196289
36444,0.041604,74.125.24.0-255,2902,127827,96,196289
36445,0.041609,172.31.47.0-255,66,127893,96,196289
36446,0.041658,74.125.24.0-255,2902,130795,96,196289
36447,0.041661,172.31.47.0-255,66,130861,96,196289
36448,0.044123,74.125.24.0-255,2902,133763,96,196289
36449,0.044128,172.31.47.0-255,66,133829,96,196289
36450,0.044175,74.125.24.0-255,2902,136731,96,196289
36451,0.044178,172.31.47.0-255,66,136797,96,196289
36452,0.046643,74.125.24.0-255,2902,139699,96,196289
36453,0.046648,172.31.47.0-255,66,139765,96,196289
36454,0.046681,74.125.24.0-255,1484,141249,96,196289
36455,0.046684,172.31.47.0-255,66,141315,96,196289
36456,0.046703,74.125.24.0-255,1484,142799,96,196289
36457,0.046705,172.31.47.0-255,66,142865,96,196289
36458,0.04918,74.125.24.0-255,2902,145767,96,196289
36459,0.049185,172.31.47.0-255,66,145833,96,196289
36460,0.049219,74.125.24.0-255,2902,148735,96,196289
36461,0.049222,172.31.47.0-255,66,148801,96,196289
36462,0.0517,74.125.24.0-255,2902,151703,96,196289
36463,0.051705,172.31.47.0-255,66,151769,96,196289
36464,0.051751,74.125.24.0-255,2902,154671,96,196289
36465,0.051754,172.31.47.0-255,66,154737,96,196289
36466,0.054238,74.125.24.0-255,2902,157639,96,196289
36467,0.054243,172.31.47.0-255,66,157705,96,196289
36468,0.054281,74.125.24.0-255,2902,160607,96,196289
36469,0.054283,172.31.47.0-255,66,160673,96,196289
36470,0.056811,74.125.24.0-255,2902,163575,96,196289
36471,0.056817,172.31.47.0-255,66,163641,96,196289
36472,0.056851,74.125.24.0-255,2902,166543,96,196289
36473,0.056854,172.31.47.0-255,66,166609,96,196289
36474,0.059344,74.125.24.0-255,2902,169511,96,196289
36475,0.05935,172.31.47.0-255,66,169577,96,196289
36476,0.05938,74.125.24.0-255,2902,172479,96,196289
36477,0.059382,172.31.47.0-255,66,172545,96,196289
36478,0.061875,74.125.24.0-255,2902,175447,96,196289
36479,0.061881,172.31.47.0-255,66,175513,96,196289
36480,0.061914,74.125.24.0-255,2902,178415,96,196289
36481,0.061917,172.31.47.0-255,66,178481,96,196289
36482,0.064424,74.125.24.0-255,2902,181383,96,196289
36483,0.064429,172.31.47.0-255,66,181449,96,196289
36484,0.064452,74.125.24.0-255,2902,184351,96,196289
36485,0.064454,172.31.47.0-255,66,184417,96,196289
36486,0.066962,74.125.24.0-255,2902,187319,96,196289
36487,0.066967,172.31.47.0-255,66,187385,96,196289
36488,0.067007,74.125.24.0-255,2902,190287,96,196289
36489,0.06701,172.31.47.0-255,66,190353,96,196289
36490,0.069524,74.125.24.0-255,2902,193255,96,196289
36491,0.069532,172.31.47.0-255,66,193321,96,196289
36492,0.069558,74.125.24.0-255,2902,196223,96,196289
36493,0.069561,172.31.47.0-255,66,196289,96,196289
36494,0.0,172.31.47.0-255,105,105,96,105
36495,0.0,172.217.194.0-255,152,152,96,158259
36496,3.4e-05,172.31.47.0-255,66,218,96,158259
36497,4.1e-05,172.217.194.0-255,1484,1702,96,158259
36498,4.6e-05,172.31.47.0-255,66,1768,96,158259
36499,5e-05,172.217.194.0-255,2902,4670,96,158259
36500,5.3e-05,172.31.47.0-255,66,4736,96,158259
36501,5.9e-05,172.217.194.0-255,7156,11892,96,158259
36502,6.2e-05,172.31.47.0-255,66,11958,96,158259
36503,0.000124,172.217.194.0-255,1484,13442,96,158259
36504,0.000128,172.31.47.0-255,66,13508,96,158259
36505,0.000148,172.217.194.0-255,4320,17828,96,158259
36506,0.000152,172.31.47.0-255,66,17894,96,158259
36507,0.000184,172.31.47.0-255,66,17960,96,158259
36508,0.000307,172.217.194.0-255,2543,20503,96,158259
36509,0.000312,172.31.47.0-255,66,20569,96,158259
36510,0.000332,172.217.194.0-255,2902,23471,96,158259
36511,0.000335,172.31.47.0-255,66,23537,96,158259
36512,0.000368,172.217.194.0-255,4320,27857,96,158259
36513,0.000372,172.31.47.0-255,66,27923,96,158259
36514,0.000391,172.217.194.0-255,2902,30825,96,158259
36515,0.000394,172.31.47.0-255,66,30891,96,158259
36516,0.000446,172.31.47.0-255,66,30957,96,158259
36517,0.000467,172.217.194.0-255,7156,38113,96,158259
36518,0.00047,172.31.47.0-255,66,38179,96,158259
36519,0.000623,172.217.194.0-255,5738,43917,96,158259
36520,0.000627,172.31.47.0-255,66,43983,96,158259
36521,0.00064,172.217.194.0-255,2531,46514,96,158259
36522,0.000643,172.31.47.0-255,66,46580,96,158259
36523,0.000708,172.217.194.0-255,2902,49482,96,158259
36524,0.000711,172.31.47.0-255,66,49548,96,158259
36525,0.000752,172.31.47.0-255,66,49614,96,158259
36526,0.000999,172.31.47.0-255,66,49680,96,158259
36527,0.001019,172.217.194.0-255,5020,54700,96,158259
36528,0.00103,172.31.47.0-255,66,54766,96,158259
36529,0.001143,172.217.194.0-255,2902,57668,96,158259
36530,0.001147,172.31.47.0-255,66,57734,96,158259
36531,0.001191,172.217.194.0-255,7156,64890,96,158259
36532,0.001192,172.31.47.0-255,66,64956,96,158259
36533,0.001197,172.31.47.0-255,66,65022,96,158259
36534,0.001213,172.217.194.0-255,3317,68339,96,158259
36535,0.001219,172.31.47.0-255,66,68405,96,158259
36536,0.001444,172.217.194.0-255,4320,72725,96,158259
36537,0.001448,172.31.47.0-255,66,72791,96,158259
36538,0.001832,172.217.194.0-255,1484,74275,96,158259
36539,0.00218,172.217.194.0-255,7156,81431,96,158259
36540,0.00257,172.217.194.0-255,4320,85751,96,158259
36541,0.002704,172.217.194.0-255,7156,92907,96,158259
36542,0.003284,172.217.194.0-255,5738,98645,96,158259
36543,0.003389,172.217.194.0-255,7156,105801,96,158259
36544,0.003397,172.217.194.0-255,1484,107285,96,158259
36545,0.00426,172.31.47.0-255,66,107351,96,158259
36546,0.006228,172.217.194.0-255,5738,113089,96,158259
36547,0.006234,172.31.47.0-255,66,113155,96,158259
36548,0.008247,172.217.194.0-255,4320,117475,96,158259
36549,0.008255,172.31.47.0-255,66,117541,96,158259
36550,0.008263,172.217.194.0-255,1484,119025,96,158259
36551,0.01027,172.217.194.0-255,4320,123345,96,158259
36552,0.010278,172.31.47.0-255,66,123411,96,158259
36553,0.01229,172.217.194.0-255,5738,129149,96,158259
36554,0.012887,172.31.47.0-255,66,129215,96,158259
36555,0.014885,172.217.194.0-255,5738,134953,96,158259
36556,0.014893,172.31.47.0-255,66,135019,96,158259
36557,0.01688,172.217.194.0-255,5738,140757,96,158259
36558,0.016959,172.31.47.0-255,66,140823,96,158259
36559,0.018951,172.217.194.0-255,5738,146561,96,158259
36560,0.018958,172.31.47.0-255,66,146627,96,158259
36561,0.020937,172.217.194.0-255,5738,152365,96,158259
36562,0.020943,172.31.47.0-255,66,152431,96,158259
36563,0.022939,172.217.194.0-255,1296,153727,96,158259
36564,0.02306,172.31.47.0-255,66,153793,96,158259
36565,0.023084,172.31.47.0-255,105,153898,96,158259
36566,0.025024,172.217.194.0-255,66,153964,96,158259
36567,0.027275,172.31.47.0-255,172,154136,96,158259
36568,0.027302,172.31.47.0-255,1105,155241,96,158259
36569,0.027329,172.31.47.0-255,1514,156755,96,158259
36570,0.02733,172.31.47.0-255,1306,158061,96,158259
36571,0.02885,104.244.42.0-255,66,158127,96,158259
36572,0.028856,104.244.42.0-255,66,158193,96,158259
36573,0.028858,104.244.42.0-255,66,158259,96,158259
36574,0.0,172.31.47.0-255,105,105,96,276
36575,0.001793,157.240.13.0-255,105,210,96,276
36576,0.001802,172.31.47.0-255,66,276,96,276
36577,0.0,74.125.200.0-255,152,152,96,290022
36578,1.4e-05,172.31.47.0-255,66,218,96,290022
36579,2e-05,74.125.200.0-255,1484,1702,96,290022
36580,2.4e-05,172.31.47.0-255,66,1768,96,290022
36581,3.7e-05,74.125.200.0-255,2902,4670,96,290022
36582,4e-05,172.31.47.0-255,66,4736,96,290022
36583,4.6e-05,74.125.200.0-255,5738,10474,96,290022
36584,4.8e-05,172.31.47.0-255,66,10540,96,290022
36585,8.1e-05,74.125.200.0-255,3510,14050,96,290022
36586,8.3e-05,172.31.47.0-255,66,14116,96,290022
36587,0.000197,74.125.200.0-255,1484,15600,96,290022
36588,0.000201,172.31.47.0-255,66,15666,96,290022
36589,0.000219,74.125.200.0-255,2902,18568,96,290022
36590,0.000221,172.31.47.0-255,66,18634,96,290022
36591,0.000248,74.125.200.0-255,4320,22954,96,290022
36592,0.00025,172.31.47.0-255,66,23020,96,290022
36593,0.000299,172.31.47.0-255,66,23086,96,290022
36594,0.000399,74.125.200.0-255,1484,24570,96,290022
36595,0.000402,172.31.47.0-255,66,24636,96,290022
36596,0.000434,74.125.200.0-255,2902,27538,96,290022
36597,0.000437,172.31.47.0-255,66,27604,96,290022
36598,0.000441,74.125.200.0-255,2902,30506,96,290022
36599,0.000443,172.31.47.0-255,66,30572,96,290022
36600,0.000448,74.125.200.0-255,4320,34892,96,290022
36601,0.000453,172.31.47.0-255,66,34958,96,290022
36602,0.000492,74.125.200.0-255,5379,40337,96,290022
36603,0.000495,172.31.47.0-255,66,40403,96,290022
36604,0.001295,74.125.200.0-255,1484,41887,96,290022
36605,0.001301,172.31.47.0-255,66,41953,96,290022
36606,0.001309,74.125.200.0-255,2902,44855,96,290022
36607,0.001311,172.31.47.0-255,66,44921,96,290022
36608,0.001319,74.125.200.0-255,1484,46405,96,290022
36609,0.001344,74.125.200.0-255,4320,50725,96,290022
36610,0.001346,172.31.47.0-255,66,50791,96,290022
36611,0.001353,74.125.200.0-255,6797,57588,96,290022
36612,0.001354,172.31.47.0-255,66,57654,96,290022
36613,0.001361,74.125.200.0-255,645,58299,96,290022
36614,0.001413,74.125.200.0-255,1484,59783,96,290022
36615,0.001416,172.31.47.0-255,66,59849,96,290022
36616,0.001419,74.125.200.0-255,1484,61333,96,290022
36617,0.001444,74.125.200.0-255,2902,64235,96,290022
36618,0.001446,172.31.47.0-255,66,64301,96,290022
36619,0.001452,74.125.200.0-255,5738,70039,96,290022
36620,0.001454,172.31.47.0-255,66,70105,96,290022
36621,0.001479,74.125.200.0-255,4320,74425,96,290022
36622,0.001481,172.31.47.0-255,66,74491,96,290022
36623,0.001502,74.125.200.0-255,1125,75616,96,290022
36624,0.001521,74.125.200.0-255,2902,78518,96,290022
36625,0.001524,172.31.47.0-255,66,78584,96,290022
36626,0.001552,74.125.200.0-255,2902,81486,96,290022
36627,0.001554,172.31.47.0-255,66,81552,96,290022
36628,0.001558,74.125.200.0-255,2902,84454,96,290022
36629,0.001559,172.31.47.0-255,66,84520,96,290022
36630,0.001594,74.125.200.0-255,5738,90258,96,290022
36631,0.001596,172.31.47.0-255,66,90324,96,290022
36632,0.00162,74.125.200.0-255,2543,92867,96,290022
36633,0.001622,172.31.47.0-255,66,92933,96,290022
36634,0.002042,74.125.200.0-255,1484,94417,96,290022
36635,0.002064,74.125.200.0-255,1484,95901,96,290022
36636,0.002068,172.31.47.0-255,66,95967,96,290022
36637,0.002083,74.125.200.0-255,1484,97451,96,290022
36638,0.002106,74.125.200.0-255,5738,103189,96,290022
36639,0.002109,172.31.47.0-255,66,103255,96,290022
36640,0.002112,74.125.200.0-255,2902,106157,96,290022
36641,0.002114,172.31.47.0-255,66,106223,96,290022
36642,0.002136,74.125.200.0-255,7156,113379,96,290022
36643,0.002143,172.31.47.0-255,66,113445,96,290022
36644,0.002168,74.125.200.0-255,2902,116347,96,290022
36645,0.00217,172.31.47.0-255,66,116413,96,290022
36646,0.002181,172.31.47.0-255,66,116479,96,290022
36647,0.002183,74.125.200.0-255,766,117245,96,290022
36648,0.002295,74.125.200.0-255,1484,118729,96,290022
36649,0.002297,172.31.47.0-255,66,118795,96,290022
36650,0.004467,74.125.200.0-255,2902,121697,96,290022
36651,0.00447,172.31.47.0-255,66,121763,96,290022
36652,0.00458,74.125.200.0-255,2902,124665,96,290022
36653,0.004583,172.31.47.0-255,66,124731,96,290022
36654,0.006762,74.125.200.0-255,2902,127633,96,290022
36655,0.006769,172.31.47.0-255,66,127699,96,290022
36656,0.006872,74.125.200.0-255,2902,130601,96,290022
36657,0.006876,172.31.47.0-255,66,130667,96,290022
36658,0.009077,74.125.200.0-255,2902,133569,96,290022
36659,0.009083,172.31.47.0-255,66,133635,96,290022
36660,0.009153,74.125.200.0-255,2902,136537,96,290022
36661,0.009158,172.31.47.0-255,66,136603,96,290022
36662,0.01138,74.125.200.0-255,2902,139505,96,290022
36663,0.011387,172.31.47.0-255,66,139571,96,290022
36664,0.011431,74.125.200.0-255,2902,142473,96,290022
36665,0.011433,172.31.47.0-255,66,142539,96,290022
36666,0.013682,74.125.200.0-255,2902,145441,96,290022
36667,0.013692,172.31.47.0-255,66,145507,96,290022
36668,0.013724,74.125.200.0-255,2902,148409,96,290022
36669,0.013727,172.31.47.0-255,66,148475,96,290022
36670,0.015981,74.125.200.0-255,2902,151377,96,290022
36671,0.015989,172.31.47.0-255,66,151443,96,290022
36672,0.016025,74.125.200.0-255,2902,154345,96,290022
36673,0.016028,172.31.47.0-255,66,154411,96,290022
36674,0.018289,74.125.200.0-255,2902,157313,96,290022
36675,0.018299,172.31.47.0-255,66,157379,96,290022
36676,0.01833,74.125.200.0-255,2902,160281,96,290022
36677,0.018333,172.31.47.0-255,66,160347,96,290022
36678,0.020585,74.125.200.0-255,2902,163249,96,290022
36679,0.020592,172.31.47.0-255,66,163315,96,290022
36680,0.020617,74.125.200.0-255,2902,166217,96,290022
36681,0.02062,172.31.47.0-255,66,166283,96,290022
36682,0.02289,74.125.200.0-255,4320,170603,96,290022
36683,0.022897,172.31.47.0-255,66,170669,96,290022
36684,0.02292,74.125.200.0-255,1484,172153,96,290022
36685,0.025189,74.125.200.0-255,4320,176473,96,290022
36686,0.025195,172.31.47.0-255,66,176539,96,290022
36687,0.026192,172.31.47.0-255,172,176711,96,290022
36688,0.026219,172.31.47.0-255,1110,177821,96,290022
36689,0.026265,172.31.47.0-255,1514,179335,96,290022
36690,0.026267,172.31.47.0-255,1301,180636,96,290022
36691,0.027489,74.125.200.0-255,5738,186374,96,290022
36692,0.027494,172.31.47.0-255,66,186440,96,290022
36693,0.027728,104.244.42.0-255,66,186506,96,290022
36694,0.027735,104.244.42.0-255,66,186572,96,290022
36695,0.027812,104.244.42.0-255,66,186638,96,290022
36696,0.029804,74.125.200.0-255,2902,189540,96,290022
36697,0.029809,172.31.47.0-255,66,189606,96,290022
36698,0.029834,74.125.200.0-255,2902,192508,96,290022
36699,0.029836,172.31.47.0-255,66,192574,96,290022
36700,0.0321,74.125.200.0-255,2902,195476,96,290022
36701,0.032108,172.31.47.0-255,66,195542,96,290022
36702,0.032138,74.125.200.0-255,2902,198444,96,290022
36703,0.03214,172.31.47.0-255,66,198510,96,290022
36704,0.034452,74.125.200.0-255,5738,204248,96,290022
36705,0.03446,172.31.47.0-255,66,204314,96,290022
36706,0.036754,74.125.200.0-255,5738,210052,96,290022
36707,0.03676,172.31.47.0-255,66,210118,96,290022
36708,0.039045,74.125.200.0-255,5738,215856,96,290022
36709,0.039051,172.31.47.0-255,66,215922,96,290022
36710,0.041349,74.125.200.0-255,5738,221660,96,290022
36711,0.041356,172.31.47.0-255,66,221726,96,290022
36712,0.04366,74.125.200.0-255,5738,227464,96,290022
36713,0.043667,172.31.47.0-255,66,227530,96,290022
36714,0.045967,74.125.200.0-255,5738,233268,96,290022
36715,0.045974,172.31.47.0-255,66,233334,96,290022
36716,0.048269,74.125.200.0-255,5738,239072,96,290022
36717,0.048275,172.31.47.0-255,66,239138,96,290022
36718,0.050569,74.125.200.0-255,5738,244876,96,290022
36719,0.050575,172.31.47.0-255,66,244942,96,290022
36720,0.052884,74.125.200.0-255,5738,250680,96,290022
36721,0.05289,172.31.47.0-255,66,250746,96,290022
36722,0.055176,74.125.200.0-255,5738,256484,96,290022
36723,0.055182,172.31.47.0-255,66,256550,96,290022
36724,0.05748,74.125.200.0-255,5738,262288,96,290022
36725,0.057486,172.31.47.0-255,66,262354,96,290022
36726,0.059788,74.125.200.0-255,5738,268092,96,290022
36727,0.059793,172.31.47.0-255,66,268158,96,290022
36728,0.062081,74.125.200.0-255,4320,272478,96,290022
36729,0.062089,172.31.47.0-255,66,272544,96,290022
36730,0.062114,74.125.200.0-255,1484,274028,96,290022
36731,0.064397,74.125.200.0-255,4320,278348,96,290022
36732,0.064402,172.31.47.0-255,66,278414,96,290022
36733,0.066711,74.125.200.0-255,5738,284152,96,290022
36734,0.066716,172.31.47.0-255,66,284218,96,290022
36735,0.069009,74.125.200.0-255,5738,289956,96,290022
36736,0.069015,172.31.47.0-255,66,290022,96,290022
36737,0.0,172.217.160.0-255,153,153,96,312454
36738,1.4e-05,172.31.47.0-255,66,219,96,312454
36739,2.9e-05,172.217.160.0-255,1484,1703,96,312454
36740,3.3e-05,172.31.47.0-255,66,1769,96,312454
36741,3.8e-05,172.217.160.0-255,2902,4671,96,312454
36742,4.1e-05,172.31.47.0-255,66,4737,96,312454
36743,6.6e-05,172.217.160.0-255,5738,10475,96,312454
36744,6.9e-05,172.31.47.0-255,66,10541,96,312454
36745,7.4e-05,172.217.160.0-255,2902,13443,96,312454
36746,7.6e-05,172.31.47.0-255,66,13509,96,312454
36747,0.000105,172.217.160.0-255,803,14312,96,312454
36748,0.000107,172.31.47.0-255,66,14378,96,312454
36749,0.000142,172.217.160.0-255,1484,15862,96,312454
36750,0.000145,172.31.47.0-255,66,15928,96,312454
36751,0.000166,172.217.160.0-255,4320,20248,96,312454
36752,0.000169,172.31.47.0-255,66,20314,96,312454
36753,0.000173,172.217.160.0-255,4320,24634,96,312454
36754,0.000175,172.31.47.0-255,66,24700,96,312454
36755,0.00023,172.217.160.0-255,5738,30438,96,312454
36756,0.000233,172.31.47.0-255,66,30504,96,312454
36757,0.000262,172.217.160.0-255,5379,35883,96,312454
36758,0.000264,172.31.47.0-255,66,35949,96,312454
36759,0.000282,172.217.160.0-255,7156,43105,96,312454
36760,0.000285,172.31.47.0-255,66,43171,96,312454
36761,0.00029,172.217.160.0-255,5379,48550,96,312454
36762,0.000292,172.31.47.0-255,66,48616,96,312454
36763,0.0009,172.217.160.0-255,1484,50100,96,312454
36764,0.000905,172.31.47.0-255,66,50166,96,312454
36765,0.000911,172.217.160.0-255,2902,53068,96,312454
36766,0.000913,172.31.47.0-255,66,53134,96,312454
36767,0.000917,172.217.160.0-255,2902,56036,96,312454
36768,0.000918,172.31.47.0-255,66,56102,96,312454
36769,0.000944,172.217.160.0-255,2902,59004,96,312454
36770,0.000947,172.31.47.0-255,66,59070,96,312454
36771,0.000971,172.217.160.0-255,1484,60554,96,312454
36772,0.000992,172.217.160.0-255,5379,65933,96,312454
36773,0.000996,172.31.47.0-255,66,65999,96,312454
36774,0.001105,172.217.160.0-255,1484,67483,96,312454
36775,0.00111,172.217.160.0-255,2902,70385,96,312454
36776,0.001113,172.217.160.0-255,2902,73287,96,312454
36777,0.001118,172.31.47.0-255,66,73353,96,312454
36778,0.00112,172.31.47.0-255,66,73419,96,312454
36779,0.001129,172.217.160.0-255,2902,76321,96,312454
36780,0.001131,172.31.47.0-255,66,76387,96,312454
36781,0.001146,172.217.160.0-255,4320,80707,96,312454
36782,0.001149,172.31.47.0-255,66,80773,96,312454
36783,0.001167,172.217.160.0-255,2543,83316,96,312454
36784,0.001169,172.31.47.0-255,66,83382,96,312454
36785,0.001202,172.217.160.0-255,1484,84866,96,312454
36786,0.00122,172.217.160.0-255,2902,87768,96,312454
36787,0.001222,172.31.47.0-255,66,87834,96,312454
36788,0.001225,172.217.160.0-255,1484,89318,96,312454
36789,0.001242,172.217.160.0-255,4320,93638,96,312454
36790,0.001245,172.31.47.0-255,66,93704,96,312454
36791,0.001265,172.217.160.0-255,6797,100501,96,312454
36792,0.001267,172.31.47.0-255,66,100567,96,312454
36793,0.003166,172.217.160.0-255,5738,106305,96,312454
36794,0.00317,172.31.47.0-255,66,106371,96,312454
36795,0.005066,172.217.160.0-255,5738,112109,96,312454
36796,0.005073,172.31.47.0-255,66,112175,96,312454
36797,0.006966,172.217.160.0-255,5738,117913,96,312454
36798,0.006973,172.31.47.0-255,66,117979,96,312454
36799,0.008873,172.217.160.0-255,5738,123717,96,312454
36800,0.00888,172.31.47.0-255,66,123783,96,312454
36801,0.010798,172.217.160.0-255,5738,129521,96,312454
36802,0.010807,172.31.47.0-255,66,129587,96,312454
36803,0.012706,172.217.160.0-255,5738,135325,96,312454
36804,0.012712,172.31.47.0-255,66,135391,96,312454
36805,0.01461,172.217.160.0-255,5738,141129,96,312454
36806,0.014616,172.31.47.0-255,66,141195,96,312454
36807,0.016511,172.217.160.0-255,5738,146933,96,312454
36808,0.016518,172.31.47.0-255,66,146999,96,312454
36809,0.018428,172.217.160.0-255,5738,152737,96,312454
36810,0.018434,172.31.47.0-255,66,152803,96,312454
36811,0.020328,172.217.160.0-255,5738,158541,96,312454
36812,0.020334,172.31.47.0-255,66,158607,96,312454
36813,0.021548,172.31.47.0-255,172,158779,96,312454
36814,0.02158,172.31.47.0-255,1109,159888,96,312454
36815,0.02163,172.31.47.0-255,1514,161402,96,312454
36816,0.021632,172.31.47.0-255,1302,162704,96,312454
36817,0.022229,172.217.160.0-255,5738,168442,96,312454
36818,0.022235,172.31.47.0-255,66,168508,96,312454
36819,0.023085,104.244.42.0-255,66,168574,96,312454
36820,0.023114,104.244.42.0-255,66,168640,96,312454
36821,0.023147,104.244.42.0-255,66,168706,96,312454
36822,0.024125,172.217.160.0-255,5738,174444,96,312454
36823,0.024129,172.31.47.0-255,66,174510,96,312454
36824,0.026034,172.217.160.0-255,5738,180248,96,312454
36825,0.02604,172.31.47.0-255,66,180314,96,312454
36826,0.027956,172.217.160.0-255,5738,186052,96,312454
36827,0.027962,172.31.47.0-255,66,186118,96,312454
36828,0.029871,172.217.160.0-255,5738,191856,96,312454
36829,0.029877,172.31.47.0-255,66,191922,96,312454
36830,0.031778,172.217.160.0-255,5738,197660,96,312454
36831,0.031783,172.31.47.0-255,66,197726,96,312454
36832,0.033678,172.217.160.0-255,5738,203464,96,312454
36833,0.033684,172.31.47.0-255,66,203530,96,312454
36834,0.035583,172.217.160.0-255,4320,207850,96,312454
36835,0.035589,172.31.47.0-255,66,207916,96,312454
36836,0.035625,172.217.160.0-255,1484,209400,96,312454
36837,0.037494,172.217.160.0-255,4320,213720,96,312454
36838,0.037499,172.31.47.0-255,66,213786,96,312454
36839,0.039459,172.217.160.0-255,5738,219524,96,312454
36840,0.039466,172.31.47.0-255,66,219590,96,312454
36841,0.041359,172.217.160.0-255,5738,225328,96,312454
36842,0.041365,172.31.47.0-255,66,225394,96,312454
36843,0.043258,172.217.160.0-255,5738,231132,96,312454
36844,0.043265,172.31.47.0-255,66,231198,96,312454
36845,0.045157,172.217.160.0-255,5738,236936,96,312454
36846,0.045162,172.31.47.0-255,66,237002,96,312454
36847,0.047056,172.217.160.0-255,5738,242740,96,312454
36848,0.047062,172.31.47.0-255,66,242806,96,312454
36849,0.048972,172.217.160.0-255,5738,248544,96,312454
36850,0.048978,172.31.47.0-255,66,248610,96,312454
36851,0.050885,172.217.160.0-255,5738,254348,96,312454
36852,0.05089,172.31.47.0-255,66,254414,96,312454
36853,0.052792,172.217.160.0-255,5738,260152,96,312454
36854,0.052798,172.31.47.0-255,66,260218,96,312454
36855,0.05472,172.217.160.0-255,5738,265956,96,312454
36856,0.054725,172.31.47.0-255,66,266022,96,312454
36857,0.056631,172.217.160.0-255,5738,271760,96,312454
36858,0.056637,172.31.47.0-255,66,271826,96,312454
36859,0.05854,172.217.160.0-255,5738,277564,96,312454
36860,0.058546,172.31.47.0-255,66,277630,96,312454
36861,0.060456,172.217.160.0-255,5738,283368,96,312454
36862,0.060462,172.31.47.0-255,66,283434,96,312454
36863,0.062365,172.217.160.0-255,5738,289172,96,312454
36864,0.062371,172.31.47.0-255,66,289238,96,312454
36865,0.064262,172.217.160.0-255,5738,294976,96,312454
36866,0.064267,172.31.47.0-255,66,295042,96,312454
36867,0.066167,172.217.160.0-255,5738,300780,96,312454
36868,0.066173,172.31.47.0-255,66,300846,96,312454
36869,0.068068,172.217.160.0-255,5738,306584,96,312454
36870,0.068075,172.31.47.0-255,66,306650,96,312454
36871,0.069967,172.217.160.0-255,5738,312388,96,312454
36872,0.069972,172.31.47.0-255,66,312454,96,312454
36873,0.0,172.217.27.0-255,153,153,96,367578
36874,2.2e-05,172.31.47.0-255,66,219,96,367578
36875,2.9e-05,172.217.27.0-255,1484,1703,96,367578
36876,3.2e-05,172.31.47.0-255,66,1769,96,367578
36877,3.7e-05,172.217.27.0-255,2902,4671,96,367578
36878,3.9e-05,172.31.47.0-255,66,4737,96,367578
36879,4.4e-05,172.217.27.0-255,4320,9057,96,367578
36880,4.6e-05,172.31.47.0-255,66,9123,96,367578
36881,8.1e-05,172.217.27.0-255,4320,13443,96,367578
36882,8.4e-05,172.31.47.0-255,66,13509,96,367578
36883,9.8e-05,172.217.27.0-255,790,14299,96,367578
36884,0.000101,172.31.47.0-255,66,14365,96,367578
36885,0.000148,172.217.27.0-255,1484,15849,96,367578
36886,0.000151,172.31.47.0-255,66,15915,96,367578
36887,0.000156,172.217.27.0-255,2902,18817,96,367578
36888,0.000157,172.31.47.0-255,66,18883,96,367578
36889,0.000171,172.217.27.0-255,4320,23203,96,367578
36890,0.000174,172.31.47.0-255,66,23269,96,367578
36891,0.000195,172.217.27.0-255,1484,24753,96,367578
36892,0.000197,172.31.47.0-255,66,24819,96,367578
36893,0.000203,172.217.27.0-255,6797,31616,96,367578
36894,0.000205,172.31.47.0-255,66,31682,96,367578
36895,0.00025,172.217.27.0-255,7156,38838,96,367578
36896,0.000253,172.31.47.0-255,66,38904,96,367578
36897,0.000259,172.217.27.0-255,5738,44642,96,367578
36898,0.000261,172.31.47.0-255,66,44708,96,367578
36899,0.000287,172.217.27.0-255,3961,48669,96,367578
36900,0.000289,172.31.47.0-255,66,48735,96,367578
36901,0.000666,172.217.27.0-255,1484,50219,96,367578
36902,0.00067,172.31.47.0-255,66,50285,96,367578
36903,0.000678,172.217.27.0-255,2902,53187,96,367578
36904,0.00068,172.31.47.0-255,66,53253,96,367578
36905,0.000686,172.217.27.0-255,5738,58991,96,367578
36906,0.000689,172.217.27.0-255,1484,60475,96,367578
36907,0.00071,172.217.27.0-255,2902,63377,96,367578
36908,0.000738,172.217.27.0-255,2543,65920,96,367578
36909,0.000747,172.217.27.0-255,1484,67404,96,367578
36910,0.000758,172.217.27.0-255,1484,68888,96,367578
36911,0.000769,172.217.27.0-255,4320,73208,96,367578
36912,0.00078,172.217.27.0-255,2902,76110,96,367578
36913,0.000791,172.217.27.0-255,5738,81848,96,367578
36914,0.000801,172.217.27.0-255,1125,82973,96,367578
36915,0.000993,172.217.27.0-255,1484,84457,96,367578
36916,0.001011,172.217.27.0-255,2902,87359,96,367578
36917,0.001031,172.217.27.0-255,5738,93097,96,367578
36918,0.001055,172.217.27.0-255,6797,99894,96,367578
36919,0.001061,172.217.27.0-255,7156,107050,96,367578
36920,0.001096,172.217.27.0-255,4320,111370,96,367578
36921,0.00111,172.217.27.0-255,5267,116637,96,367578
36922,0.00137,172.217.27.0-255,209,116846,96,367578
36923,0.00141,172.217.27.0-255,1484,118330,96,367578
36924,0.001429,172.217.27.0-255,2902,121232,96,367578
36925,0.001437,172.217.27.0-255,1484,122716,96,367578
36926,0.001455,172.217.27.0-255,2902,125618,96,367578
36927,0.00147,172.217.27.0-255,5738,131356,96,367578
36928,0.001486,172.217.27.0-255,1484,132840,96,367578
36929,0.001512,172.217.27.0-255,4320,137160,96,367578
36930,0.001562,172.217.27.0-255,1484,138644,96,367578
36931,0.001579,172.217.27.0-255,3602,142246,96,367578
36932,0.003499,172.31.47.0-255,66,142312,96,367578
36933,0.005135,172.217.27.0-255,5738,148050,96,367578
36934,0.00514,172.31.47.0-255,66,148116,96,367578
36935,0.006756,172.217.27.0-255,5738,153854,96,367578
36936,0.006761,172.31.47.0-255,66,153920,96,367578
36937,0.008384,172.217.27.0-255,5738,159658,96,367578
36938,0.00839,172.31.47.0-255,66,159724,96,367578
36939,0.01002,172.217.27.0-255,5738,165462,96,367578
36940,0.011583,172.31.47.0-255,66,165528,96,367578
36941,0.013198,172.217.27.0-255,5738,171266,96,367578
36942,0.013205,172.31.47.0-255,66,171332,96,367578
36943,0.014824,172.217.27.0-255,5738,177070,96,367578
36944,0.014831,172.31.47.0-255,66,177136,96,367578
36945,0.016446,172.217.27.0-255,5738,182874,96,367578
36946,0.016451,172.31.47.0-255,66,182940,96,367578
36947,0.018063,172.217.27.0-255,5738,188678,96,367578
36948,0.018068,172.31.47.0-255,66,188744,96,367578
36949,0.019685,172.217.27.0-255,5738,194482,96,367578
36950,0.019691,172.31.47.0-255,66,194548,96,367578
36951,0.019694,172.31.47.0-255,172,194720,96,367578
36952,0.019722,172.31.47.0-255,1109,195829,96,367578
36953,0.019749,172.31.47.0-255,1514,197343,96,367578
36954,0.019751,172.31.47.0-255,335,197678,96,367578
36955,0.021268,104.244.42.0-255,66,197744,96,367578
36956,0.021274,104.244.42.0-255,66,197810,96,367578
36957,0.021292,104.244.42.0-255,66,197876,96,367578
36958,0.021303,172.217.27.0-255,1484,199360,96,367578
36959,0.02133,172.217.27.0-255,4320,203680,96,367578
36960,0.021334,172.31.47.0-255,66,203746,96,367578
36961,0.023057,172.217.27.0-255,5738,209484,96,367578
36962,0.023062,172.31.47.0-255,66,209550,96,367578
36963,0.024677,172.217.27.0-255,5738,215288,96,367578
36964,0.024683,172.31.47.0-255,66,215354,96,367578
36965,0.026298,172.217.27.0-255,5738,221092,96,367578
36966,0.026303,172.31.47.0-255,66,221158,96,367578
36967,0.027923,172.217.27.0-255,4320,225478,96,367578
36968,0.027927,172.31.47.0-255,66,225544,96,367578
36969,0.027951,172.217.27.0-255,1484,227028,96,367578
36970,0.029543,172.217.27.0-255,4320,231348,96,367578
36971,0.029547,172.31.47.0-255,66,231414,96,367578
36972,0.031157,172.217.27.0-255,5738,237152,96,367578
36973,0.031202,172.31.47.0-255,66,237218,96,367578
36974,0.032814,172.217.27.0-255,5738,242956,96,367578
36975,0.03282,172.31.47.0-255,66,243022,96,367578
36976,0.034454,172.217.27.0-255,5738,248760,96,367578
36977,0.034461,172.31.47.0-255,66,248826,96,367578
36978,0.036078,172.217.27.0-255,5738,254564,96,367578
36979,0.036083,172.31.47.0-255,66,254630,96,367578
36980,0.037696,172.217.27.0-255,5738,260368,96,367578
36981,0.037701,172.31.47.0-255,66,260434,96,367578
36982,0.039309,172.217.27.0-255,5738,266172,96,367578
36983,0.039314,172.31.47.0-255,66,266238,96,367578
36984,0.040956,172.217.27.0-255,5738,271976,96,367578
36985,0.040962,172.31.47.0-255,66,272042,96,367578
36986,0.042571,172.217.27.0-255,5738,277780,96,367578
36987,0.042577,172.31.47.0-255,66,277846,96,367578
36988,0.04419,172.217.27.0-255,5738,283584,96,367578
36989,0.044196,172.31.47.0-255,66,283650,96,367578
36990,0.045812,172.217.27.0-255,5738,289388,96,367578
36991,0.045816,172.31.47.0-255,66,289454,96,367578
36992,0.047429,172.217.27.0-255,5738,295192,96,367578
36993,0.047433,172.31.47.0-255,66,295258,96,367578
36994,0.049071,172.217.27.0-255,5738,300996,96,367578
36995,0.049077,172.31.47.0-255,66,301062,96,367578
36996,0.050703,172.217.27.0-255,4320,305382,96,367578
36997,0.050707,172.31.47.0-255,66,305448,96,367578
36998,0.050733,172.217.27.0-255,1484,306932,96,367578
36999,0.052325,172.217.27.0-255,2902,309834,96,367578
37000,0.052331,172.31.47.0-255,66,309900,96,367578
37001,0.052356,172.217.27.0-255,1484,311384,96,367578
37002,0.053953,172.217.27.0-255,4320,315704,96,367578
37003,0.054007,172.31.47.0-255,66,315770,96,367578
37004,0.055623,172.217.27.0-255,4320,320090,96,367578
37005,0.055628,172.31.47.0-255,66,320156,96,367578
37006,0.055653,172.217.27.0-255,1484,321640,96,367578
37007,0.057236,172.217.27.0-255,4320,325960,96,367578
37008,0.057241,172.31.47.0-255,66,326026,96,367578
37009,0.058851,172.217.27.0-255,2902,328928,96,367578
37010,0.058855,172.31.47.0-255,66,328994,96,367578
37011,0.058885,172.217.27.0-255,2902,331896,96,367578
37012,0.058903,172.31.47.0-255,66,331962,96,367578
37013,0.060463,172.217.27.0-255,2902,334864,96,367578
37014,0.060468,172.31.47.0-255,66,334930,96,367578
37015,0.060509,172.217.27.0-255,2902,337832,96,367578
37016,0.060566,172.31.47.0-255,66,337898,96,367578
37017,0.062118,172.217.27.0-255,2902,340800,96,367578
37018,0.062123,172.31.47.0-255,66,340866,96,367578
37019,0.062167,172.217.27.0-255,2902,343768,96,367578
37020,0.062187,172.31.47.0-255,66,343834,96,367578
37021,0.063734,172.217.27.0-255,2902,346736,96,367578
37022,0.06374,172.31.47.0-255,66,346802,96,367578
37023,0.063791,172.217.27.0-255,2902,349704,96,367578
37024,0.063816,172.31.47.0-255,66,349770,96,367578
37025,0.065357,172.217.27.0-255,2902,352672,96,367578
37026,0.065362,172.31.47.0-255,66,352738,96,367578
37027,0.065422,172.217.27.0-255,2902,355640,96,367578
37028,0.065444,172.31.47.0-255,66,355706,96,367578
37029,0.066973,172.217.27.0-255,2902,358608,96,367578
37030,0.066978,172.31.47.0-255,66,358674,96,367578
37031,0.067053,172.217.27.0-255,2902,361576,96,367578
37032,0.067056,172.31.47.0-255,66,361642,96,367578
37033,0.068589,172.217.27.0-255,2902,364544,96,367578
37034,0.068593,172.31.47.0-255,66,364610,96,367578
37035,0.068665,172.217.27.0-255,2902,367512,96,367578
37036,0.068669,172.31.47.0-255,66,367578,96,367578
37037,0.0,74.125.24.0-255,153,153,96,182523
37038,2.7e-05,172.31.47.0-255,66,219,96,182523
37039,3.3e-05,74.125.24.0-255,1484,1703,96,182523
37040,3.8e-05,172.31.47.0-255,66,1769,96,182523
37041,4.2e-05,74.125.24.0-255,2902,4671,96,182523
37042,4.5e-05,172.31.47.0-255,66,4737,96,182523
37043,5.8e-05,74.125.24.0-255,7156,11893,96,182523
37044,6.1e-05,172.31.47.0-255,66,11959,96,182523
37045,6.7e-05,74.125.24.0-255,6267,18226,96,182523
37046,6.9e-05,172.31.47.0-255,66,18292,96,182523
37047,0.000115,172.31.47.0-255,66,18358,96,182523
37048,0.000141,74.125.24.0-255,3961,22319,96,182523
37049,0.000144,172.31.47.0-255,66,22385,96,182523
37050,0.000156,74.125.24.0-255,1484,23869,96,182523
37051,0.000163,172.31.47.0-255,66,23935,96,182523
37052,0.000197,172.31.47.0-255,66,24001,96,182523
37053,0.000231,74.125.24.0-255,1484,25485,96,182523
37054,0.000234,172.31.47.0-255,66,25551,96,182523
37055,0.00026,74.125.24.0-255,6797,32348,96,182523
37056,0.000263,172.31.47.0-255,66,32414,96,182523
37057,0.000279,172.31.47.0-255,66,32480,96,182523
37058,0.000285,74.125.24.0-255,5379,37859,96,182523
37059,0.000287,172.31.47.0-255,66,37925,96,182523
37060,0.000313,74.125.24.0-255,646,38571,96,182523
37061,0.000315,172.31.47.0-255,66,38637,96,182523
37062,0.000464,74.125.24.0-255,1484,40121,96,182523
37063,0.000467,172.31.47.0-255,66,40187,96,182523
37064,0.000472,74.125.24.0-255,2902,43089,96,182523
37065,0.000473,172.31.47.0-255,66,43155,96,182523
37066,0.000504,74.125.24.0-255,5738,48893,96,182523
37067,0.000507,172.31.47.0-255,66,48959,96,182523
37068,0.000513,74.125.24.0-255,4320,53279,96,182523
37069,0.000516,172.31.47.0-255,66,53345,96,182523
37070,0.000534,74.125.24.0-255,1994,55339,96,182523
37071,0.00054,172.31.47.0-255,66,55405,96,182523
37072,0.000969,74.125.24.0-255,1484,56889,96,182523
37073,0.000974,172.31.47.0-255,66,56955,96,182523
37074,0.000983,74.125.24.0-255,2902,59857,96,182523
37075,0.000986,172.31.47.0-255,66,59923,96,182523
37076,0.000998,74.125.24.0-255,5738,65661,96,182523
37077,0.001,172.31.47.0-255,66,65727,96,182523
37078,0.001003,74.125.24.0-255,1484,67211,96,182523
37079,0.001049,172.31.47.0-255,66,67277,96,182523
37080,0.001055,74.125.24.0-255,7156,74433,96,182523
37081,0.001057,172.31.47.0-255,66,74499,96,182523
37082,0.00109,74.125.24.0-255,3602,78101,96,182523
37083,0.001095,172.31.47.0-255,66,78167,96,182523
37084,0.001873,74.125.24.0-255,1484,79651,96,182523
37085,0.001883,74.125.24.0-255,2902,82553,96,182523
37086,0.001888,172.31.47.0-255,66,82619,96,182523
37087,0.001895,74.125.24.0-255,5738,88357,96,182523
37088,0.001897,172.31.47.0-255,66,88423,96,182523
37089,0.001938,172.31.47.0-255,66,88489,96,182523
37090,0.001949,172.31.47.0-255,66,88555,96,182523
37091,0.002571,74.125.24.0-255,1484,90039,96,182523
37092,0.002579,74.125.24.0-255,2902,92941,96,182523
37093,0.002583,172.31.47.0-255,66,93007,96,182523
37094,0.002588,74.125.24.0-255,2902,95909,96,182523
37095,0.00259,172.31.47.0-255,66,95975,96,182523
37096,0.002608,74.125.24.0-255,2902,98877,96,182523
37097,0.00261,172.31.47.0-255,66,98943,96,182523
37098,0.00262,74.125.24.0-255,4320,103263,96,182523
37099,0.002622,172.31.47.0-255,66,103329,96,182523
37100,0.002662,172.31.47.0-255,66,103395,96,182523
37101,0.002672,172.31.47.0-255,66,103461,96,182523
37102,0.0027,74.125.24.0-255,2184,105645,96,182523
37103,0.002702,172.31.47.0-255,66,105711,96,182523
37104,0.004001,74.125.24.0-255,1484,107195,96,182523
37105,0.004023,74.125.24.0-255,2902,110097,96,182523
37106,0.004027,172.31.47.0-255,66,110163,96,182523
37107,0.004034,74.125.24.0-255,5738,115901,96,182523
37108,0.004035,172.31.47.0-255,66,115967,96,182523
37109,0.004076,172.31.47.0-255,66,116033,96,182523
37110,0.004086,172.31.47.0-255,66,116099,96,182523
37111,0.004111,74.125.24.0-255,2184,118283,96,182523
37112,0.004114,172.31.47.0-255,66,118349,96,182523
37113,0.004298,74.125.24.0-255,1484,119833,96,182523
37114,0.004304,74.125.24.0-255,2902,122735,96,182523
37115,0.004307,172.31.47.0-255,66,122801,96,182523
37116,0.004344,74.125.24.0-255,5738,128539,96,182523
37117,0.004346,172.31.47.0-255,66,128605,96,182523
37118,0.004391,172.31.47.0-255,66,128671,96,182523
37119,0.004419,74.125.24.0-255,4320,132991,96,182523
37120,0.004422,172.31.47.0-255,66,133057,96,182523
37121,0.004433,172.31.47.0-255,66,133123,96,182523
37122,0.004461,172.31.47.0-255,66,133189,96,182523
37123,0.004466,74.125.24.0-255,4320,137509,96,182523
37124,0.004515,74.125.24.0-255,7156,144665,96,182523
37125,0.00454,74.125.24.0-255,3602,148267,96,182523
37126,0.004592,74.125.24.0-255,1484,149751,96,182523
37127,0.004596,74.125.24.0-255,2902,152653,96,182523
37128,0.004617,74.125.24.0-255,5738,158391,96,182523
37129,0.004647,74.125.24.0-255,7156,165547,96,182523
37130,0.00469,74.125.24.0-255,2184,167731,96,182523
37131,0.004703,74.125.24.0-255,4320,172051,96,182523
37132,0.004728,74.125.24.0-255,5738,177789,96,182523
37133,0.004812,74.125.24.0-255,97,177886,96,182523
37134,0.004859,74.125.24.0-255,105,177991,96,182523
37135,0.00506,172.31.47.0-255,66,178057,96,182523
37136,0.006565,172.31.47.0-255,105,178162,96,182523
37137,0.008777,74.125.24.0-255,66,178228,96,182523
37138,0.023069,172.31.47.0-255,172,178400,96,182523
37139,0.023118,172.31.47.0-255,1111,179511,96,182523
37140,0.023181,172.31.47.0-255,1514,181025,96,182523
37141,0.023182,172.31.47.0-255,1300,182325,96,182523
37142,0.024613,104.244.42.0-255,66,182391,96,182523
37143,0.024656,104.244.42.0-255,66,182457,96,182523
37144,0.024752,104.244.42.0-255,66,182523,96,182523
37145,0.0,74.125.24.0-255,297,297,96,305598
37146,2.2e-05,172.31.47.0-255,66,363,96,305598
37147,2.8e-05,74.125.24.0-255,1484,1847,96,305598
37148,3.1e-05,172.31.47.0-255,66,1913,96,305598
37149,3.7e-05,74.125.24.0-255,4320,6233,96,305598
37150,3.8e-05,172.31.47.0-255,66,6299,96,305598
37151,4.1e-05,74.125.24.0-255,1484,7783,96,305598
37152,4.3e-05,172.31.47.0-255,66,7849,96,305598
37153,6.6e-05,74.125.24.0-255,4320,12169,96,305598
37154,6.8e-05,172.31.47.0-255,66,12235,96,305598
37155,7.1e-05,74.125.24.0-255,1484,13719,96,305598
37156,7.4e-05,172.31.47.0-255,66,13785,96,305598
37157,9.5e-05,172.31.47.0-255,66,13851,96,305598
37158,0.000101,74.125.24.0-255,6797,20648,96,305598
37159,0.000103,172.31.47.0-255,66,20714,96,305598
37160,0.000257,74.125.24.0-255,1484,22198,96,305598
37161,0.000261,172.31.47.0-255,66,22264,96,305598
37162,0.000266,74.125.24.0-255,2902,25166,96,305598
37163,0.000268,172.31.47.0-255,66,25232,96,305598
37164,0.000288,74.125.24.0-255,2902,28134,96,305598
37165,0.000292,172.31.47.0-255,66,28200,96,305598
37166,0.000309,74.125.24.0-255,2902,31102,96,305598
37167,0.000312,172.31.47.0-255,66,31168,96,305598
37168,0.000318,74.125.24.0-255,6797,37965,96,305598
37169,0.000321,172.31.47.0-255,66,38031,96,305598
37170,0.000336,74.125.24.0-255,1484,39515,96,305598
37171,0.000339,172.31.47.0-255,66,39581,96,305598
37172,0.000365,74.125.24.0-255,2902,42483,96,305598
37173,0.000368,172.31.47.0-255,66,42549,96,305598
37174,0.000374,74.125.24.0-255,5738,48287,96,305598
37175,0.000376,172.31.47.0-255,66,48353,96,305598
37176,0.000395,74.125.24.0-255,4320,52673,96,305598
37177,0.000398,172.31.47.0-255,66,52739,96,305598
37178,0.000409,74.125.24.0-255,2543,55282,96,305598
37179,0.000411,172.31.47.0-255,66,55348,96,305598
37180,0.000422,74.125.24.0-255,398,55746,96,305598
37181,0.000465,74.125.24.0-255,112,55858,96,305598
37182,0.000559,74.125.24.0-255,1484,57342,96,305598
37183,0.000563,172.31.47.0-255,66,57408,96,305598
37184,0.000567,74.125.24.0-255,2902,60310,96,305598
37185,0.000569,172.31.47.0-255,66,60376,96,305598
37186,0.000596,74.125.24.0-255,5738,66114,96,305598
37187,0.000598,172.31.47.0-255,66,66180,96,305598
37188,0.000605,74.125.24.0-255,6797,72977,96,305598
37189,0.000607,172.31.47.0-255,66,73043,96,305598
37190,0.000621,74.125.24.0-255,332,73375,96,305598
37191,0.000676,74.125.24.0-255,1484,74859,96,305598
37192,0.000679,172.31.47.0-255,66,74925,96,305598
37193,0.000692,74.125.24.0-255,4320,79245,96,305598
37194,0.000695,172.31.47.0-255,66,79311,96,305598
37195,0.000698,74.125.24.0-255,2902,82213,96,305598
37196,0.0007,172.31.47.0-255,66,82279,96,305598
37197,0.00072,74.125.24.0-255,1484,83763,96,305598
37198,0.000754,74.125.24.0-255,4320,88083,96,305598
37199,0.000757,172.31.47.0-255,66,88149,96,305598
37200,0.000773,74.125.24.0-255,2543,90692,96,305598
37201,0.000776,172.31.47.0-255,66,90758,96,305598
37202,0.00145,74.125.24.0-255,1484,92242,96,305598
37203,0.001459,74.125.24.0-255,2902,95144,96,305598
37204,0.001463,172.31.47.0-255,66,95210,96,305598
37205,0.001469,74.125.24.0-255,4320,99530,96,305598
37206,0.00147,172.31.47.0-255,66,99596,96,305598
37207,0.001482,74.125.24.0-255,1484,101080,96,305598
37208,0.001495,74.125.24.0-255,5738,106818,96,305598
37209,0.001498,172.31.47.0-255,66,106884,96,305598
37210,0.00152,74.125.24.0-255,7156,114040,96,305598
37211,0.001522,172.31.47.0-255,66,114106,96,305598
37212,0.001531,172.31.47.0-255,66,114172,96,305598
37213,0.001862,74.125.24.0-255,1484,115656,96,305598
37214,0.001869,74.125.24.0-255,2902,118558,96,305598
37215,0.001872,172.31.47.0-255,66,118624,96,305598
37216,0.001892,74.125.24.0-255,5738,124362,96,305598
37217,0.001894,172.31.47.0-255,66,124428,96,305598
37218,0.001916,74.125.24.0-255,1484,125912,96,305598
37219,0.001936,172.31.47.0-255,66,125978,96,305598
37220,0.001953,74.125.24.0-255,1484,127462,96,305598
37221,0.001964,172.31.47.0-255,66,127528,96,305598
37222,0.002157,74.125.24.0-255,1484,129012,96,305598
37223,0.002161,74.125.24.0-255,2902,131914,96,305598
37224,0.002164,172.31.47.0-255,66,131980,96,305598
37225,0.002168,74.125.24.0-255,2902,134882,96,305598
37226,0.002171,172.31.47.0-255,66,134948,96,305598
37227,0.002184,74.125.24.0-255,2902,137850,96,305598
37228,0.002186,172.31.47.0-255,66,137916,96,305598
37229,0.002218,172.31.47.0-255,66,137982,96,305598
37230,0.002223,74.125.24.0-255,5738,143720,96,305598
37231,0.002226,172.31.47.0-255,66,143786,96,305598
37232,0.002255,74.125.24.0-255,5020,148806,96,305598
37233,0.002257,172.31.47.0-255,66,148872,96,305598
37234,0.004849,74.125.24.0-255,5738,154610,96,305598
37235,0.004855,172.31.47.0-255,66,154676,96,305598
37236,0.007457,74.125.24.0-255,5738,160414,96,305598
37237,0.007463,172.31.47.0-255,66,160480,96,305598
37238,0.010069,74.125.24.0-255,5738,166218,96,305598
37239,0.010075,172.31.47.0-255,66,166284,96,305598
37240,0.012638,74.125.24.0-255,5738,172022,96,305598
37241,0.012645,172.31.47.0-255,66,172088,96,305598
37242,0.015219,74.125.24.0-255,5738,177826,96,305598
37243,0.015228,172.31.47.0-255,66,177892,96,305598
37244,0.017788,74.125.24.0-255,5738,183630,96,305598
37245,0.017795,172.31.47.0-255,66,183696,96,305598
37246,0.02034,74.125.24.0-255,5738,189434,96,305598
37247,0.020347,172.31.47.0-255,66,189500,96,305598
37248,0.022913,74.125.24.0-255,5738,195238,96,305598
37249,0.02292,172.31.47.0-255,66,195304,96,305598
37250,0.024447,172.31.47.0-255,172,195476,96,305598
37251,0.024485,172.31.47.0-255,1101,196577,96,305598
37252,0.024556,172.31.47.0-255,1514,198091,96,305598
37253,0.024558,172.31.47.0-255,1514,199605,96,305598
37254,0.024559,172.31.47.0-255,1514,201119,96,305598
37255,0.024559,172.31.47.0-255,1095,202214,96,305598
37256,0.025488,74.125.24.0-255,5738,207952,96,305598
37257,0.025496,172.31.47.0-255,66,208018,96,305598
37258,0.025926,104.244.42.0-255,66,208084,96,305598
37259,0.025962,104.244.42.0-255,66,208150,96,305598
37260,0.026056,104.244.42.0-255,66,208216,96,305598
37261,0.02606,104.244.42.0-255,66,208282,96,305598
37262,0.028076,74.125.24.0-255,5738,214020,96,305598
37263,0.028092,172.31.47.0-255,66,214086,96,305598
37264,0.03069,74.125.24.0-255,5738,219824,96,305598
37265,0.030708,172.31.47.0-255,66,219890,96,305598
37266,0.033293,74.125.24.0-255,5738,225628,96,305598
37267,0.033312,172.31.47.0-255,66,225694,96,305598
37268,0.035903,74.125.24.0-255,5738,231432,96,305598
37269,0.035916,172.31.47.0-255,66,231498,96,305598
37270,0.038494,74.125.24.0-255,5738,237236,96,305598
37271,0.038516,172.31.47.0-255,66,237302,96,305598
37272,0.041097,74.125.24.0-255,5738,243040,96,305598
37273,0.041118,172.31.47.0-255,66,243106,96,305598
37274,0.04371,74.125.24.0-255,5738,248844,96,305598
37275,0.043729,172.31.47.0-255,66,248910,96,305598
37276,0.046312,74.125.24.0-255,5738,254648,96,305598
37277,0.046332,172.31.47.0-255,66,254714,96,305598
37278,0.048914,74.125.24.0-255,5738,260452,96,305598
37279,0.048924,172.31.47.0-255,66,260518,96,305598
37280,0.051494,74.125.24.0-255,5738,266256,96,305598
37281,0.051499,172.31.47.0-255,66,266322,96,305598
37282,0.054082,74.125.24.0-255,5738,272060,96,305598
37283,0.054086,172.31.47.0-255,66,272126,96,305598
37284,0.056641,74.125.24.0-255,5738,277864,96,305598
37285,0.056647,172.31.47.0-255,66,277930,96,305598
37286,0.059196,74.125.24.0-255,5738,283668,96,305598
37287,0.0592,172.31.47.0-255,66,283734,96,305598
37288,0.061776,74.125.24.0-255,5738,289472,96,305598
37289,0.061781,172.31.47.0-255,66,289538,96,305598
37290,0.064345,74.125.24.0-255,4320,293858,96,305598
37291,0.06435,172.31.47.0-255,66,293924,96,305598
37292,0.064377,74.125.24.0-255,1484,295408,96,305598
37293,0.066894,74.125.24.0-255,4320,299728,96,305598
37294,0.066899,172.31.47.0-255,66,299794,96,305598
37295,0.069469,74.125.24.0-255,5738,305532,96,305598
37296,0.069474,172.31.47.0-255,66,305598,96,305598
37297,0.0,172.31.47.0-255,66,66,96,66
37298,0.0,172.217.24.0-255,153,153,96,342103
37299,1.8e-05,172.31.47.0-255,66,219,96,342103
37300,2.4e-05,172.217.24.0-255,1484,1703,96,342103
37301,2.9e-05,172.31.47.0-255,66,1769,96,342103
37302,3.5e-05,172.217.24.0-255,2902,4671,96,342103
37303,3.8e-05,172.31.47.0-255,66,4737,96,342103
37304,7.4e-05,172.217.24.0-255,7156,11893,96,342103
37305,7.7e-05,172.31.47.0-255,66,11959,96,342103
37306,0.000152,172.217.24.0-255,2064,14023,96,342103
37307,0.000157,172.31.47.0-255,66,14089,96,342103
37308,0.000233,172.217.24.0-255,1484,15573,96,342103
37309,0.000237,172.31.47.0-255,66,15639,96,342103
37310,0.000244,172.217.24.0-255,2902,18541,96,342103
37311,0.000247,172.31.47.0-255,66,18607,96,342103
37312,0.000276,172.217.24.0-255,1484,20091,96,342103
37313,0.00028,172.31.47.0-255,66,20157,96,342103
37314,0.000299,172.217.24.0-255,2902,23059,96,342103
37315,0.000302,172.31.47.0-255,66,23125,96,342103
37316,0.00035,172.217.24.0-255,2902,26027,96,342103
37317,0.000354,172.31.47.0-255,66,26093,96,342103
37318,0.000377,172.217.24.0-255,2902,28995,96,342103
37319,0.00038,172.31.47.0-255,66,29061,96,342103
37320,0.000411,172.217.24.0-255,2543,31604,96,342103
37321,0.000414,172.31.47.0-255,66,31670,96,342103
37322,0.000455,172.217.24.0-255,2902,34572,96,342103
37323,0.000458,172.31.47.0-255,66,34638,96,342103
37324,0.000478,172.217.24.0-255,2902,37540,96,342103
37325,0.00048,172.31.47.0-255,66,37606,96,342103
37326,0.0005,172.217.24.0-255,4320,41926,96,342103
37327,0.000503,172.31.47.0-255,66,41992,96,342103
37328,0.000586,172.217.24.0-255,6797,48789,96,342103
37329,0.000592,172.31.47.0-255,66,48855,96,342103
37330,0.00068,172.217.24.0-255,7156,56011,96,342103
37331,0.000706,172.31.47.0-255,66,56077,96,342103
37332,0.000773,172.217.24.0-255,5738,61815,96,342103
37333,0.000792,172.217.24.0-255,4290,66105,96,342103
37334,0.000802,172.31.47.0-255,66,66171,96,342103
37335,0.0012,172.217.24.0-255,114,66285,96,342103
37336,0.001275,172.217.24.0-255,1484,67769,96,342103
37337,0.001281,172.31.47.0-255,66,67835,96,342103
37338,0.001287,172.217.24.0-255,2902,70737,96,342103
37339,0.001321,172.217.24.0-255,5738,76475,96,342103
37340,0.001327,172.31.47.0-255,66,76541,96,342103
37341,0.001338,172.31.47.0-255,66,76607,96,342103
37342,0.001392,172.217.24.0-255,4320,80927,96,342103
37343,0.0014,172.31.47.0-255,66,80993,96,342103
37344,0.001416,172.217.24.0-255,2543,83536,96,342103
37345,0.001429,172.31.47.0-255,66,83602,96,342103
37346,0.001485,172.217.24.0-255,5738,89340,96,342103
37347,0.001488,172.31.47.0-255,66,89406,96,342103
37348,0.001512,172.217.24.0-255,7156,96562,96,342103
37349,0.001517,172.31.47.0-255,66,96628,96,342103
37350,0.001665,172.217.24.0-255,3961,100589,96,342103
37351,0.001681,172.31.47.0-255,66,100655,96,342103
37352,0.001742,172.217.24.0-255,1484,102139,96,342103
37353,0.001746,172.217.24.0-255,2902,105041,96,342103
37354,0.001749,172.31.47.0-255,66,105107,96,342103
37355,0.00178,172.217.24.0-255,1484,106591,96,342103
37356,0.001797,172.217.24.0-255,4320,110911,96,342103
37357,0.001801,172.31.47.0-255,66,110977,96,342103
37358,0.001853,172.217.24.0-255,2902,113879,96,342103
37359,0.001859,172.31.47.0-255,66,113945,96,342103
37360,0.001869,172.217.24.0-255,1484,115429,96,342103
37361,0.001916,172.217.24.0-255,4320,119749,96,342103
37362,0.001925,172.31.47.0-255,66,119815,96,342103
37363,0.001944,172.217.24.0-255,7156,126971,96,342103
37364,0.001951,172.31.47.0-255,66,127037,96,342103
37365,0.00208,172.31.47.0-255,66,127103,96,342103
37366,0.003971,172.217.24.0-255,2902,130005,96,342103
37367,0.003975,172.31.47.0-255,66,130071,96,342103
37368,0.003996,172.217.24.0-255,2902,132973,96,342103
37369,0.00401,172.31.47.0-255,66,133039,96,342103
37370,0.005861,172.217.24.0-255,2902,135941,96,342103
37371,0.005867,172.31.47.0-255,66,136007,96,342103
37372,0.005888,172.217.24.0-255,2902,138909,96,342103
37373,0.00592,172.31.47.0-255,66,138975,96,342103
37374,0.007772,172.217.24.0-255,2902,141877,96,342103
37375,0.00778,172.31.47.0-255,66,141943,96,342103
37376,0.007805,172.217.24.0-255,2902,144845,96,342103
37377,0.007834,172.31.47.0-255,66,144911,96,342103
37378,0.009673,172.217.24.0-255,2902,147813,96,342103
37379,0.009685,172.31.47.0-255,66,147879,96,342103
37380,0.009714,172.217.24.0-255,2902,150781,96,342103
37381,0.009769,172.31.47.0-255,66,150847,96,342103
37382,0.011595,172.217.24.0-255,2902,153749,96,342103
37383,0.011608,172.31.47.0-255,66,153815,96,342103
37384,0.011666,172.217.24.0-255,2902,156717,96,342103
37385,0.011697,172.31.47.0-255,66,156783,96,342103
37386,0.013492,172.217.24.0-255,2902,159685,96,342103
37387,0.013499,172.31.47.0-255,66,159751,96,342103
37388,0.013572,172.217.24.0-255,2902,162653,96,342103
37389,0.013586,172.31.47.0-255,66,162719,96,342103
37390,0.015395,172.217.24.0-255,2902,165621,96,342103
37391,0.015403,172.31.47.0-255,66,165687,96,342103
37392,0.015459,172.217.24.0-255,2902,168589,96,342103
37393,0.015475,172.31.47.0-255,66,168655,96,342103
37394,0.017298,172.217.24.0-255,2902,171557,96,342103
37395,0.017305,172.31.47.0-255,66,171623,96,342103
37396,0.017337,172.217.24.0-255,1484,173107,96,342103
37397,0.017353,172.217.24.0-255,1484,174591,96,342103
37398,0.018204,172.31.47.0-255,66,174657,96,342103
37399,0.019214,172.217.24.0-255,2902,177559,96,342103
37400,0.019221,172.31.47.0-255,66,177625,96,342103
37401,0.020097,172.217.24.0-255,2902,180527,96,342103
37402,0.020104,172.31.47.0-255,66,180593,96,342103
37403,0.021097,172.217.24.0-255,2902,183495,96,342103
37404,0.021102,172.31.47.0-255,66,183561,96,342103
37405,0.021999,172.217.24.0-255,2902,186463,96,342103
37406,0.022006,172.31.47.0-255,66,186529,96,342103
37407,0.022999,172.217.24.0-255,2902,189431,96,342103
37408,0.023006,172.31.47.0-255,66,189497,96,342103
37409,0.023912,172.217.24.0-255,2902,192399,96,342103
37410,0.023917,172.31.47.0-255,66,192465,96,342103
37411,0.024893,172.217.24.0-255,2902,195367,96,342103
37412,0.024899,172.31.47.0-255,66,195433,96,342103
37413,0.025813,172.217.24.0-255,2902,198335,96,342103
37414,0.025819,172.31.47.0-255,66,198401,96,342103
37415,0.026362,172.31.47.0-255,176,198577,96,342103
37416,0.026389,172.31.47.0-255,1105,199682,96,342103
37417,0.02643,172.31.47.0-255,1514,201196,96,342103
37418,0.026432,172.31.47.0-255,1514,202710,96,342103
37419,0.026433,172.31.47.0-255,1514,204224,96,342103
37420,0.026434,172.31.47.0-255,1087,205311,96,342103
37421,0.026826,172.217.24.0-255,2902,208213,96,342103
37422,0.026832,172.31.47.0-255,66,208279,96,342103
37423,0.027714,172.217.24.0-255,2902,211181,96,342103
37424,0.02772,172.31.47.0-255,66,211247,96,342103
37425,0.027906,104.244.42.0-255,66,211313,96,342103
37426,0.027939,104.244.42.0-255,66,211379,96,342103
37427,0.027992,104.244.42.0-255,66,211445,96,342103
37428,0.027996,104.244.42.0-255,66,211511,96,342103
37429,0.028731,172.217.24.0-255,2902,214413,96,342103
37430,0.028737,172.31.47.0-255,66,214479,96,342103
37431,0.029607,172.217.24.0-255,2902,217381,96,342103
37432,0.02962,172.31.47.0-255,66,217447,96,342103
37433,0.030619,172.217.24.0-255,2902,220349,96,342103
37434,0.030626,172.31.47.0-255,66,220415,96,342103
37435,0.031515,172.217.24.0-255,2902,223317,96,342103
37436,0.031521,172.31.47.0-255,66,223383,96,342103
37437,0.032507,172.217.24.0-255,2902,226285,96,342103
37438,0.032512,172.31.47.0-255,66,226351,96,342103
37439,0.033406,172.217.24.0-255,2902,229253,96,342103
37440,0.033411,172.31.47.0-255,66,229319,96,342103
37441,0.03441,172.217.24.0-255,2902,232221,96,342103
37442,0.034417,172.31.47.0-255,66,232287,96,342103
37443,0.035295,172.217.24.0-255,2902,235189,96,342103
37444,0.035302,172.31.47.0-255,66,235255,96,342103
37445,0.036296,172.217.24.0-255,2902,238157,96,342103
37446,0.036302,172.31.47.0-255,66,238223,96,342103
37447,0.037198,172.217.24.0-255,2902,241125,96,342103
37448,0.037204,172.31.47.0-255,66,241191,96,342103
37449,0.038188,172.217.24.0-255,2902,244093,96,342103
37450,0.038195,172.31.47.0-255,66,244159,96,342103
37451,0.039088,172.217.24.0-255,2902,247061,96,342103
37452,0.039095,172.31.47.0-255,66,247127,96,342103
37453,0.040098,172.217.24.0-255,2902,250029,96,342103
37454,0.040104,172.31.47.0-255,66,250095,96,342103
37455,0.040982,172.217.24.0-255,2902,252997,96,342103
37456,0.040988,172.31.47.0-255,66,253063,96,342103
37457,0.041993,172.217.24.0-255,2902,255965,96,342103
37458,0.042,172.31.47.0-255,66,256031,96,342103
37459,0.04287,172.217.24.0-255,2902,258933,96,342103
37460,0.042875,172.31.47.0-255,66,258999,96,342103
37461,0.043897,172.217.24.0-255,2902,261901,96,342103
37462,0.043903,172.31.47.0-255,66,261967,96,342103
37463,0.044754,172.217.24.0-255,2902,264869,96,342103
37464,0.04476,172.31.47.0-255,66,264935,96,342103
37465,0.045796,172.217.24.0-255,2902,267837,96,342103
37466,0.045805,172.31.47.0-255,66,267903,96,342103
37467,0.046641,172.217.24.0-255,2902,270805,96,342103
37468,0.046649,172.31.47.0-255,66,270871,96,342103
37469,0.047685,172.217.24.0-255,2902,273773,96,342103
37470,0.04769,172.31.47.0-255,66,273839,96,342103
37471,0.04853,172.217.24.0-255,2902,276741,96,342103
37472,0.048535,172.31.47.0-255,66,276807,96,342103
37473,0.049574,172.217.24.0-255,2902,279709,96,342103
37474,0.049579,172.31.47.0-255,66,279775,96,342103
37475,0.050414,172.217.24.0-255,2902,282677,96,342103
37476,0.050418,172.31.47.0-255,66,282743,96,342103
37477,0.05148,172.217.24.0-255,2902,285645,96,342103
37478,0.051486,172.31.47.0-255,66,285711,96,342103
37479,0.052304,172.217.24.0-255,2902,288613,96,342103
37480,0.05231,172.31.47.0-255,66,288679,96,342103
37481,0.05337,172.217.24.0-255,2902,291581,96,342103
37482,0.053377,172.31.47.0-255,66,291647,96,342103
37483,0.054205,172.217.24.0-255,2902,294549,96,342103
37484,0.05421,172.31.47.0-255,66,294615,96,342103
37485,0.055272,172.217.24.0-255,2902,297517,96,342103
37486,0.055276,172.31.47.0-255,66,297583,96,342103
37487,0.056088,172.217.24.0-255,2902,300485,96,342103
37488,0.056104,172.31.47.0-255,66,300551,96,342103
37489,0.057152,172.217.24.0-255,2902,303453,96,342103
37490,0.057159,172.31.47.0-255,66,303519,96,342103
37491,0.057986,172.217.24.0-255,2902,306421,96,342103
37492,0.058002,172.31.47.0-255,66,306487,96,342103
37493,0.059042,172.217.24.0-255,2902,309389,96,342103
37494,0.059048,172.31.47.0-255,66,309455,96,342103
37495,0.059905,172.217.24.0-255,2902,312357,96,342103
37496,0.059912,172.31.47.0-255,66,312423,96,342103
37497,0.060936,172.217.24.0-255,2902,315325,96,342103
37498,0.060943,172.31.47.0-255,66,315391,96,342103
37499,0.061829,172.217.24.0-255,2902,318293,96,342103
37500,0.061836,172.31.47.0-255,66,318359,96,342103
37501,0.062838,172.217.24.0-255,2902,321261,96,342103
37502,0.062852,172.31.47.0-255,66,321327,96,342103
37503,0.063714,172.217.24.0-255,2902,324229,96,342103
37504,0.063721,172.31.47.0-255,66,324295,96,342103
37505,0.064734,172.217.24.0-255,2902,327197,96,342103
37506,0.064741,172.31.47.0-255,66,327263,96,342103
37507,0.065603,172.217.24.0-255,2902,330165,96,342103
37508,0.065609,172.31.47.0-255,66,330231,96,342103
37509,0.066624,172.217.24.0-255,2902,333133,96,342103
37510,0.066629,172.31.47.0-255,66,333199,96,342103
37511,0.067495,172.217.24.0-255,2902,336101,96,342103
37512,0.0675,172.31.47.0-255,66,336167,96,342103
37513,0.06851,172.217.24.0-255,2902,339069,96,342103
37514,0.068518,172.31.47.0-255,66,339135,96,342103
37515,0.069398,172.217.24.0-255,2902,342037,96,342103
37516,0.069408,172.31.47.0-255,66,342103,96,342103
37517,0.0,172.217.194.0-255,152,152,96,347147
37518,2.6e-05,172.31.47.0-255,66,218,96,347147
37519,3.3e-05,172.217.194.0-255,1484,1702,96,347147
37520,3.7e-05,172.31.47.0-255,66,1768,96,347147
37521,4.2e-05,172.217.194.0-255,2902,4670,96,347147
37522,4.5e-05,172.31.47.0-255,66,4736,96,347147
37523,6.8e-05,172.217.194.0-255,1484,6220,96,347147
37524,7.1e-05,172.31.47.0-255,66,6286,96,347147
37525,9.6e-05,172.217.194.0-255,4320,10606,96,347147
37526,9.8e-05,172.31.47.0-255,66,10672,96,347147
37527,0.000105,172.217.194.0-255,6357,17029,96,347147
37528,0.000107,172.31.47.0-255,66,17095,96,347147
37529,0.000129,172.217.194.0-255,2902,19997,96,347147
37530,0.000132,172.31.47.0-255,66,20063,96,347147
37531,0.00015,172.31.47.0-255,66,20129,96,347147
37532,0.000169,172.217.194.0-255,2543,22672,96,347147
37533,0.000171,172.31.47.0-255,66,22738,96,347147
37534,0.000204,172.217.194.0-255,1484,24222,96,347147
37535,0.000208,172.31.47.0-255,66,24288,96,347147
37536,0.000226,172.217.194.0-255,2902,27190,96,347147
37537,0.000228,172.31.47.0-255,66,27256,96,347147
37538,0.000232,172.217.194.0-255,1484,28740,96,347147
37539,0.000234,172.31.47.0-255,66,28806,96,347147
37540,0.000261,172.217.194.0-255,4320,33126,96,347147
37541,0.000264,172.31.47.0-255,66,33192,96,347147
37542,0.000289,172.217.194.0-255,6797,39989,96,347147
37543,0.000292,172.31.47.0-255,66,40055,96,347147
37544,0.000298,172.217.194.0-255,7156,47211,96,347147
37545,0.0003,172.31.47.0-255,66,47277,96,347147
37546,0.000334,172.31.47.0-255,66,47343,96,347147
37547,0.000371,172.217.194.0-255,1484,48827,96,347147
37548,0.000395,172.217.194.0-255,4353,53180,96,347147
37549,0.000402,172.31.47.0-255,66,53246,96,347147
37550,0.000403,172.217.194.0-255,7156,60402,96,347147
37551,0.00041,172.31.47.0-255,66,60468,96,347147
37552,0.000422,172.217.194.0-255,3961,64429,96,347147
37553,0.000435,172.31.47.0-255,66,64495,96,347147
37554,0.000468,172.217.194.0-255,2902,67397,96,347147
37555,0.000474,172.31.47.0-255,66,67463,96,347147
37556,0.000479,172.217.194.0-255,1484,68947,96,347147
37557,0.000482,172.217.194.0-255,1484,70431,96,347147
37558,0.00049,172.31.47.0-255,66,70497,96,347147
37559,0.000495,172.217.194.0-255,4320,74817,96,347147
37560,0.000525,172.31.47.0-255,66,74883,96,347147
37561,0.000527,172.217.194.0-255,2902,77785,96,347147
37562,0.00054,172.31.47.0-255,66,77851,96,347147
37563,0.000547,172.217.194.0-255,4259,82110,96,347147
37564,0.000558,172.31.47.0-255,66,82176,96,347147
37565,0.001054,172.217.194.0-255,1484,83660,96,347147
37566,0.001068,172.217.194.0-255,2902,86562,96,347147
37567,0.001072,172.31.47.0-255,66,86628,96,347147
37568,0.001097,172.217.194.0-255,1484,88112,96,347147
37569,0.001113,172.217.194.0-255,2902,91014,96,347147
37570,0.001117,172.31.47.0-255,66,91080,96,347147
37571,0.001138,172.217.194.0-255,5738,96818,96,347147
37572,0.001141,172.217.194.0-255,1484,98302,96,347147
37573,0.001142,172.31.47.0-255,66,98368,96,347147
37574,0.001163,172.217.194.0-255,5738,104106,96,347147
37575,0.001166,172.31.47.0-255,66,104172,96,347147
37576,0.001198,172.217.194.0-255,5738,109910,96,347147
37577,0.001209,172.31.47.0-255,66,109976,96,347147
37578,0.001226,172.31.47.0-255,66,110042,96,347147
37579,0.001245,172.31.47.0-255,66,110108,96,347147
37580,0.001255,172.217.194.0-255,5738,115846,96,347147
37581,0.001259,172.31.47.0-255,66,115912,96,347147
37582,0.001322,172.31.47.0-255,66,115978,96,347147
37583,0.001342,172.217.194.0-255,2902,118880,96,347147
37584,0.001347,172.31.47.0-255,66,118946,96,347147
37585,0.001348,172.217.194.0-255,3602,122548,96,347147
37586,0.001351,172.31.47.0-255,66,122614,96,347147
37587,0.001476,172.217.194.0-255,1484,124098,96,347147
37588,0.001482,172.217.194.0-255,2902,127000,96,347147
37589,0.001492,172.31.47.0-255,66,127066,96,347147
37590,0.001512,172.217.194.0-255,4320,131386,96,347147
37591,0.001515,172.217.194.0-255,1484,132870,96,347147
37592,0.001521,172.31.47.0-255,66,132936,96,347147
37593,0.00154,172.217.194.0-255,7156,140092,96,347147
37594,0.001543,172.217.194.0-255,1484,141576,96,347147
37595,0.001546,172.31.47.0-255,66,141642,96,347147
37596,0.001559,172.217.194.0-255,2902,144544,96,347147
37597,0.001568,172.31.47.0-255,66,144610,96,347147
37598,0.001573,172.217.194.0-255,4320,148930,96,347147
37599,0.001585,172.31.47.0-255,66,148996,96,347147
37600,0.001597,172.31.47.0-255,66,149062,96,347147
37601,0.001644,172.217.194.0-255,1484,150546,96,347147
37602,0.001659,172.217.194.0-255,2902,153448,96,347147
37603,0.001671,172.31.47.0-255,66,153514,96,347147
37604,0.001678,172.217.194.0-255,4320,157834,96,347147
37605,0.00169,172.217.194.0-255,1484,159318,96,347147
37606,0.001695,172.31.47.0-255,66,159384,96,347147
37607,0.001744,172.217.194.0-255,7156,166540,96,347147
37608,0.001747,172.31.47.0-255,66,166606,96,347147
37609,0.001753,172.217.194.0-255,4320,170926,96,347147
37610,0.001763,172.31.47.0-255,66,170992,96,347147
37611,0.001778,172.217.194.0-255,4320,175312,96,347147
37612,0.001783,172.217.194.0-255,4320,179632,96,347147
37613,0.001788,172.31.47.0-255,66,179698,96,347147
37614,0.001807,172.217.194.0-255,3602,183300,96,347147
37615,0.001812,172.31.47.0-255,66,183366,96,347147
37616,0.001849,172.217.194.0-255,1484,184850,96,347147
37617,0.001871,172.217.194.0-255,2902,187752,96,347147
37618,0.00188,172.31.47.0-255,66,187818,96,347147
37619,0.001888,172.217.194.0-255,4320,192138,96,347147
37620,0.001891,172.31.47.0-255,66,192204,96,347147
37621,0.001915,172.217.194.0-255,1484,193688,96,347147
37622,0.001926,172.217.194.0-255,5738,199426,96,347147
37623,0.001931,172.217.194.0-255,2902,202328,96,347147
37624,0.001935,172.31.47.0-255,66,202394,96,347147
37625,0.001971,172.217.194.0-255,5020,207414,96,347147
37626,0.001971,172.31.47.0-255,66,207480,96,347147
37627,0.001976,172.31.47.0-255,66,207546,96,347147
37628,0.002182,172.217.194.0-255,1484,209030,96,347147
37629,0.002201,172.217.194.0-255,2902,211932,96,347147
37630,0.002204,172.31.47.0-255,66,211998,96,347147
37631,0.002245,172.217.194.0-255,5738,217736,96,347147
37632,0.002249,172.31.47.0-255,66,217802,96,347147
37633,0.002267,172.217.194.0-255,5738,223540,96,347147
37634,0.002272,172.31.47.0-255,66,223606,96,347147
37635,0.002292,172.217.194.0-255,7156,230762,96,347147
37636,0.002296,172.31.47.0-255,66,230828,96,347147
37637,0.002321,172.31.47.0-255,66,230894,96,347147
37638,0.002327,172.217.194.0-255,2184,233078,96,347147
37639,0.002331,172.217.194.0-255,2902,235980,96,347147
37640,0.002334,172.31.47.0-255,66,236046,96,347147
37641,0.002338,172.31.47.0-255,66,236112,96,347147
37642,0.002363,172.217.194.0-255,7156,243268,96,347147
37643,0.002376,172.31.47.0-255,66,243334,96,347147
37644,0.00466,172.217.194.0-255,5738,249072,96,347147
37645,0.004667,172.31.47.0-255,66,249138,96,347147
37646,0.006982,172.217.194.0-255,5738,254876,96,347147
37647,0.006987,172.31.47.0-255,66,254942,96,347147
37648,0.009371,172.217.194.0-255,5738,260680,96,347147
37649,0.009387,172.31.47.0-255,66,260746,96,347147
37650,0.011683,172.217.194.0-255,5738,266484,96,347147
37651,0.011697,172.31.47.0-255,66,266550,96,347147
37652,0.013958,172.217.194.0-255,5738,272288,96,347147
37653,0.013965,172.31.47.0-255,66,272354,96,347147
37654,0.016276,172.217.194.0-255,5738,278092,96,347147
37655,0.016284,172.31.47.0-255,66,278158,96,347147
37656,0.018612,172.217.194.0-255,5738,283896,96,347147
37657,0.01862,172.31.47.0-255,66,283962,96,347147
37658,0.020945,172.217.194.0-255,5738,289700,96,347147
37659,0.020951,172.31.47.0-255,66,289766,96,347147
37660,0.023288,172.217.194.0-255,5738,295504,96,347147
37661,0.023296,172.31.47.0-255,66,295570,96,347147
37662,0.025596,172.217.194.0-255,5738,301308,96,347147
37663,0.025602,172.31.47.0-255,66,301374,96,347147
37664,0.027895,172.217.194.0-255,5738,307112,96,347147
37665,0.027912,172.31.47.0-255,66,307178,96,347147
37666,0.030179,172.217.194.0-255,5738,312916,96,347147
37667,0.030192,172.31.47.0-255,66,312982,96,347147
37668,0.032509,172.217.194.0-255,5738,318720,96,347147
37669,0.032524,172.31.47.0-255,66,318786,96,347147
37670,0.033335,172.31.47.0-255,172,318958,96,347147
37671,0.03337,172.31.47.0-255,1104,320062,96,347147
37672,0.033431,172.31.47.0-255,1514,321576,96,347147
37673,0.033433,172.31.47.0-255,1307,322883,96,347147
37674,0.034792,172.217.194.0-255,5738,328621,96,347147
37675,0.034798,172.31.47.0-255,66,328687,96,347147
37676,0.034903,104.244.42.0-255,66,328753,96,347147
37677,0.034977,104.244.42.0-255,66,328819,96,347147
37678,0.035069,104.244.42.0-255,66,328885,96,347147
37679,0.03707,172.217.194.0-255,5738,334623,96,347147
37680,0.037077,172.31.47.0-255,66,334689,96,347147
37681,0.039395,172.217.194.0-255,5738,340427,96,347147
37682,0.039416,172.31.47.0-255,66,340493,96,347147
37683,0.0417,172.217.194.0-255,5738,346231,96,347147
37684,0.041706,172.31.47.0-255,66,346297,96,347147
37685,0.043981,172.217.194.0-255,613,346910,96,347147
37686,0.04412,172.31.47.0-255,66,346976,96,347147
37687,0.044149,172.31.47.0-255,105,347081,96,347147
37688,0.046408,172.217.194.0-255,66,347147,96,347147
37689,0.0,74.125.24.0-255,153,153,96,292716
37690,1.4e-05,172.31.47.0-255,66,219,96,292716
37691,2e-05,74.125.24.0-255,1484,1703,96,292716
37692,2.4e-05,172.31.47.0-255,66,1769,96,292716
37693,2.9e-05,74.125.24.0-255,2902,4671,96,292716
37694,3.1e-05,172.31.47.0-255,66,4737,96,292716
37695,3.6e-05,74.125.24.0-255,4320,9057,96,292716
37696,3.9e-05,172.31.47.0-255,66,9123,96,292716
37697,8.6e-05,74.125.24.0-255,5010,14133,96,292716
37698,8.9e-05,172.31.47.0-255,66,14199,96,292716
37699,0.000801,74.125.24.0-255,1484,15683,96,292716
37700,0.000808,172.31.47.0-255,66,15749,96,292716
37701,0.000816,74.125.24.0-255,2902,18651,96,292716
37702,0.000818,172.31.47.0-255,66,18717,96,292716
37703,0.000822,74.125.24.0-255,1484,20201,96,292716
37704,0.000824,172.31.47.0-255,66,20267,96,292716
37705,0.000847,74.125.24.0-255,2902,23169,96,292716
37706,0.000849,172.31.47.0-255,66,23235,96,292716
37707,0.000867,74.125.24.0-255,5738,28973,96,292716
37708,0.000869,172.31.47.0-255,66,29039,96,292716
37709,0.000895,74.125.24.0-255,3961,33000,96,292716
37710,0.000898,172.31.47.0-255,66,33066,96,292716
37711,0.000904,74.125.24.0-255,7156,40222,96,292716
37712,0.000906,172.31.47.0-255,66,40288,96,292716
37713,0.000917,172.31.47.0-255,66,40354,96,292716
37714,0.000948,74.125.24.0-255,7156,47510,96,292716
37715,0.000954,74.125.24.0-255,6438,53948,96,292716
37716,0.000957,172.31.47.0-255,66,54014,96,292716
37717,0.000964,172.31.47.0-255,66,54080,96,292716
37718,0.000967,74.125.24.0-255,360,54440,96,292716
37719,0.000969,172.31.47.0-255,66,54506,96,292716
37720,0.000992,74.125.24.0-255,130,54636,96,292716
37721,0.001143,74.125.24.0-255,1484,56120,96,292716
37722,0.001147,172.31.47.0-255,66,56186,96,292716
37723,0.001151,74.125.24.0-255,2902,59088,96,292716
37724,0.001153,172.31.47.0-255,66,59154,96,292716
37725,0.001172,74.125.24.0-255,5738,64892,96,292716
37726,0.001174,172.31.47.0-255,66,64958,96,292716
37727,0.001196,74.125.24.0-255,5738,70696,96,292716
37728,0.001199,172.31.47.0-255,66,70762,96,292716
37729,0.001213,74.125.24.0-255,2902,73664,96,292716
37730,0.001215,172.31.47.0-255,66,73730,96,292716
37731,0.001237,74.125.24.0-255,1484,75214,96,292716
37732,0.001269,172.31.47.0-255,66,75280,96,292716
37733,0.001714,74.125.24.0-255,1484,76764,96,292716
37734,0.001722,74.125.24.0-255,2902,79666,96,292716
37735,0.001725,172.31.47.0-255,66,79732,96,292716
37736,0.001732,74.125.24.0-255,5738,85470,96,292716
37737,0.001734,172.31.47.0-255,66,85536,96,292716
37738,0.001752,74.125.24.0-255,1484,87020,96,292716
37739,0.001772,172.31.47.0-255,66,87086,96,292716
37740,0.001796,74.125.24.0-255,4320,91406,96,292716
37741,0.001798,172.31.47.0-255,66,91472,96,292716
37742,0.001824,172.31.47.0-255,66,91538,96,292716
37743,0.002259,74.125.24.0-255,1484,93022,96,292716
37744,0.002266,74.125.24.0-255,1484,94506,96,292716
37745,0.002269,172.31.47.0-255,66,94572,96,292716
37746,0.002283,74.125.24.0-255,1484,96056,96,292716
37747,0.002289,74.125.24.0-255,5738,101794,96,292716
37748,0.002291,172.31.47.0-255,66,101860,96,292716
37749,0.002295,74.125.24.0-255,2902,104762,96,292716
37750,0.002297,172.31.47.0-255,66,104828,96,292716
37751,0.002328,74.125.24.0-255,2902,107730,96,292716
37752,0.002331,172.31.47.0-255,66,107796,96,292716
37753,0.002337,74.125.24.0-255,7156,114952,96,292716
37754,0.002339,172.31.47.0-255,66,115018,96,292716
37755,0.002361,74.125.24.0-255,4320,119338,96,292716
37756,0.002363,172.31.47.0-255,66,119404,96,292716
37757,0.002385,74.125.24.0-255,6438,125842,96,292716
37758,0.002387,172.31.47.0-255,66,125908,96,292716
37759,0.00474,74.125.24.0-255,5738,131646,96,292716
37760,0.004744,172.31.47.0-255,66,131712,96,292716
37761,0.007101,74.125.24.0-255,5738,137450,96,292716
37762,0.007107,172.31.47.0-255,66,137516,96,292716
37763,0.009441,74.125.24.0-255,5738,143254,96,292716
37764,0.009449,172.31.47.0-255,66,143320,96,292716
37765,0.011788,74.125.24.0-255,5738,149058,96,292716
37766,0.011797,172.31.47.0-255,66,149124,96,292716
37767,0.014159,74.125.24.0-255,5738,154862,96,292716
37768,0.014168,172.31.47.0-255,66,154928,96,292716
37769,0.016527,74.125.24.0-255,5738,160666,96,292716
37770,0.016534,172.31.47.0-255,66,160732,96,292716
37771,0.018911,74.125.24.0-255,5738,166470,96,292716
37772,0.018919,172.31.47.0-255,66,166536,96,292716
37773,0.021239,74.125.24.0-255,5738,172274,96,292716
37774,0.021247,172.31.47.0-255,66,172340,96,292716
37775,0.022778,172.31.47.0-255,172,172512,96,292716
37776,0.02281,172.31.47.0-255,1101,173613,96,292716
37777,0.022895,172.31.47.0-255,1514,175127,96,292716
37778,0.022897,172.31.47.0-255,1311,176438,96,292716
37779,0.02363,74.125.24.0-255,5738,182176,96,292716
37780,0.023635,172.31.47.0-255,66,182242,96,292716
37781,0.024349,104.244.42.0-255,66,182308,96,292716
37782,0.024379,104.244.42.0-255,66,182374,96,292716
37783,0.024434,104.244.42.0-255,66,182440,96,292716
37784,0.025992,74.125.24.0-255,5738,188178,96,292716
37785,0.025997,172.31.47.0-255,66,188244,96,292716
37786,0.028353,74.125.24.0-255,5738,193982,96,292716
37787,0.028359,172.31.47.0-255,66,194048,96,292716
37788,0.030726,74.125.24.0-255,5738,199786,96,292716
37789,0.030732,172.31.47.0-255,66,199852,96,292716
37790,0.033055,74.125.24.0-255,5738,205590,96,292716
37791,0.033061,172.31.47.0-255,66,205656,96,292716
37792,0.035418,74.125.24.0-255,5738,211394,96,292716
37793,0.035424,172.31.47.0-255,66,211460,96,292716
37794,0.037769,74.125.24.0-255,5738,217198,96,292716
37795,0.037787,172.31.47.0-255,66,217264,96,292716
37796,0.040161,74.125.24.0-255,5738,223002,96,292716
37797,0.04018,172.31.47.0-255,66,223068,96,292716
37798,0.042578,74.125.24.0-255,5738,228806,96,292716
37799,0.042594,172.31.47.0-255,66,228872,96,292716
37800,0.044969,74.125.24.0-255,5738,234610,96,292716
37801,0.044986,172.31.47.0-255,66,234676,96,292716
37802,0.047352,74.125.24.0-255,5738,240414,96,292716
37803,0.047367,172.31.47.0-255,66,240480,96,292716
37804,0.049726,74.125.24.0-255,5738,246218,96,292716
37805,0.049735,172.31.47.0-255,66,246284,96,292716
37806,0.052098,74.125.24.0-255,5738,252022,96,292716
37807,0.052116,172.31.47.0-255,66,252088,96,292716
37808,0.05449,74.125.24.0-255,5738,257826,96,292716
37809,0.054507,172.31.47.0-255,66,257892,96,292716
37810,0.056854,74.125.24.0-255,5738,263630,96,292716
37811,0.05687,172.31.47.0-255,66,263696,96,292716
37812,0.059259,74.125.24.0-255,5738,269434,96,292716
37813,0.059278,172.31.47.0-255,66,269500,96,292716
37814,0.061646,74.125.24.0-255,5738,275238,96,292716
37815,0.061664,172.31.47.0-255,66,275304,96,292716
37816,0.064055,74.125.24.0-255,5738,281042,96,292716
37817,0.06407,172.31.47.0-255,66,281108,96,292716
37818,0.066422,74.125.24.0-255,5738,286846,96,292716
37819,0.06643,172.31.47.0-255,66,286912,96,292716
37820,0.068785,74.125.24.0-255,5738,292650,96,292716
37821,0.068791,172.31.47.0-255,66,292716,96,292716
37822,0.0,172.217.194.0-255,146,146,96,253742
37823,1.4e-05,172.31.47.0-255,66,212,96,253742
37824,2e-05,172.217.194.0-255,1484,1696,96,253742
37825,2.4e-05,172.31.47.0-255,66,1762,96,253742
37826,2.9e-05,172.217.194.0-255,2902,4664,96,253742
37827,3.2e-05,172.31.47.0-255,66,4730,96,253742
37828,7.7e-05,172.217.194.0-255,7156,11886,96,253742
37829,7.9e-05,172.31.47.0-255,66,11952,96,253742
37830,8.3e-05,172.217.194.0-255,2254,14206,96,253742
37831,8.5e-05,172.31.47.0-255,66,14272,96,253742
37832,9.9e-05,172.217.194.0-255,2902,17174,96,253742
37833,0.000101,172.31.47.0-255,66,17240,96,253742
37834,0.000134,172.217.194.0-255,2902,20142,96,253742
37835,0.000136,172.31.47.0-255,66,20208,96,253742
37836,0.000147,172.217.194.0-255,2902,23110,96,253742
37837,0.000149,172.31.47.0-255,66,23176,96,253742
37838,0.000152,172.217.194.0-255,1484,24660,96,253742
37839,0.000153,172.31.47.0-255,66,24726,96,253742
37840,0.000182,172.217.194.0-255,5738,30464,96,253742
37841,0.000185,172.217.194.0-255,1125,31589,96,253742
37842,0.000188,172.31.47.0-255,66,31655,96,253742
37843,0.000191,172.31.47.0-255,66,31721,96,253742
37844,0.000201,172.217.194.0-255,1484,33205,96,253742
37845,0.000203,172.31.47.0-255,66,33271,96,253742
37846,0.000226,172.217.194.0-255,4320,37591,96,253742
37847,0.000228,172.31.47.0-255,66,37657,96,253742
37848,0.000238,172.31.47.0-255,66,37723,96,253742
37849,0.000247,172.217.194.0-255,1484,39207,96,253742
37850,0.000249,172.31.47.0-255,66,39273,96,253742
37851,0.000268,172.217.194.0-255,5738,45011,96,253742
37852,0.00027,172.31.47.0-255,66,45077,96,253742
37853,0.000305,172.31.47.0-255,66,45143,96,253742
37854,0.000308,172.217.194.0-255,1422,46565,96,253742
37855,0.00031,172.31.47.0-255,66,46631,96,253742
37856,0.000593,172.217.194.0-255,381,47012,96,253742
37857,0.000598,172.31.47.0-255,66,47078,96,253742
37858,0.000777,172.217.194.0-255,1484,48562,96,253742
37859,0.000782,172.31.47.0-255,66,48628,96,253742
37860,0.000787,172.217.194.0-255,2902,51530,96,253742
37861,0.00079,172.31.47.0-255,66,51596,96,253742
37862,0.000793,172.217.194.0-255,1484,53080,96,253742
37863,0.000795,172.31.47.0-255,66,53146,96,253742
37864,0.000812,172.217.194.0-255,4320,57466,96,253742
37865,0.000834,172.31.47.0-255,66,57532,96,253742
37866,0.000853,172.217.194.0-255,5738,63270,96,253742
37867,0.000879,172.31.47.0-255,66,63336,96,253742
37868,0.000884,172.31.47.0-255,66,63402,96,253742
37869,0.001319,172.217.194.0-255,1484,64886,96,253742
37870,0.001324,172.217.194.0-255,2902,67788,96,253742
37871,0.001329,172.31.47.0-255,66,67854,96,253742
37872,0.001332,172.31.47.0-255,66,67920,96,253742
37873,0.001353,172.217.194.0-255,5738,73658,96,253742
37874,0.001356,172.31.47.0-255,66,73724,96,253742
37875,0.001382,172.31.47.0-255,66,73790,96,253742
37876,0.001403,172.217.194.0-255,4320,78110,96,253742
37877,0.00141,172.31.47.0-255,66,78176,96,253742
37878,0.001428,172.31.47.0-255,66,78242,96,253742
37879,0.001576,172.217.194.0-255,1484,79726,96,253742
37880,0.001592,172.217.194.0-255,2902,82628,96,253742
37881,0.001595,172.31.47.0-255,66,82694,96,253742
37882,0.001601,172.217.194.0-255,2902,85596,96,253742
37883,0.001605,172.31.47.0-255,66,85662,96,253742
37884,0.001614,172.217.194.0-255,2902,88564,96,253742
37885,0.001632,172.217.194.0-255,4320,92884,96,253742
37886,0.001643,172.31.47.0-255,66,92950,96,253742
37887,0.001665,172.217.194.0-255,4320,97270,96,253742
37888,0.001691,172.31.47.0-255,66,97336,96,253742
37889,0.00171,172.217.194.0-255,3602,100938,96,253742
37890,0.001725,172.217.194.0-255,4320,105258,96,253742
37891,0.001732,172.31.47.0-255,66,105324,96,253742
37892,0.001794,172.217.194.0-255,4320,109644,96,253742
37893,0.001801,172.31.47.0-255,66,109710,96,253742
37894,0.001845,172.31.47.0-255,66,109776,96,253742
37895,0.001858,172.217.194.0-255,2184,111960,96,253742
37896,0.001878,172.217.194.0-255,6438,118398,96,253742
37897,0.001884,172.217.194.0-255,5738,124136,96,253742
37898,0.0019,172.217.194.0-255,1484,125620,96,253742
37899,0.001903,172.31.47.0-255,66,125686,96,253742
37900,0.001918,172.217.194.0-255,4320,130006,96,253742
37901,0.001962,172.217.194.0-255,2902,132908,96,253742
37902,0.001969,172.31.47.0-255,66,132974,96,253742
37903,0.002003,172.31.47.0-255,66,133040,96,253742
37904,0.002041,172.217.194.0-255,1484,134524,96,253742
37905,0.002044,172.217.194.0-255,1484,136008,96,253742
37906,0.002058,172.217.194.0-255,1484,137492,96,253742
37907,0.002064,172.217.194.0-255,5738,143230,96,253742
37908,0.00208,172.31.47.0-255,66,143296,96,253742
37909,0.002094,172.217.194.0-255,5738,149034,96,253742
37910,0.002106,172.31.47.0-255,66,149100,96,253742
37911,0.002156,172.217.194.0-255,7156,156256,96,253742
37912,0.002215,172.217.194.0-255,1484,157740,96,253742
37913,0.00222,172.217.194.0-255,2902,160642,96,253742
37914,0.002226,172.217.194.0-255,5738,166380,96,253742
37915,0.002256,172.217.194.0-255,4320,170700,96,253742
37916,0.007432,172.31.47.0-255,66,170766,96,253742
37917,0.009705,172.217.194.0-255,5738,176504,96,253742
37918,0.009714,172.31.47.0-255,66,176570,96,253742
37919,0.011989,172.217.194.0-255,5738,182308,96,253742
37920,0.011995,172.31.47.0-255,66,182374,96,253742
37921,0.014252,172.217.194.0-255,5738,188112,96,253742
37922,0.01426,172.31.47.0-255,66,188178,96,253742
37923,0.01654,172.217.194.0-255,5738,193916,96,253742
37924,0.017346,172.31.47.0-255,66,193982,96,253742
37925,0.019618,172.217.194.0-255,5738,199720,96,253742
37926,0.019627,172.31.47.0-255,66,199786,96,253742
37927,0.021903,172.217.194.0-255,5738,205524,96,253742
37928,0.023341,172.31.47.0-255,66,205590,96,253742
37929,0.025567,172.217.194.0-255,5738,211328,96,253742
37930,0.025577,172.31.47.0-255,66,211394,96,253742
37931,0.027826,172.217.194.0-255,5738,217132,96,253742
37932,0.027833,172.31.47.0-255,66,217198,96,253742
37933,0.030074,172.217.194.0-255,5738,222936,96,253742
37934,0.03008,172.31.47.0-255,66,223002,96,253742
37935,0.032331,172.217.194.0-255,5738,228740,96,253742
37936,0.032335,172.31.47.0-255,66,228806,96,253742
37937,0.033253,172.31.47.0-255,172,228978,96,253742
37938,0.033284,172.31.47.0-255,1105,230083,96,253742
37939,0.033331,172.31.47.0-255,1514,231597,96,253742
37940,0.033333,172.31.47.0-255,1306,232903,96,253742
37941,0.034577,172.217.194.0-255,5738,238641,96,253742
37942,0.034584,172.31.47.0-255,66,238707,96,253742
37943,0.034757,104.244.42.0-255,66,238773,96,253742
37944,0.034813,104.244.42.0-255,66,238839,96,253742
37945,0.034849,104.244.42.0-255,66,238905,96,253742
37946,0.036844,172.217.194.0-255,5738,244643,96,253742
37947,0.03685,172.31.47.0-255,66,244709,96,253742
37948,0.039075,172.217.194.0-255,5738,250447,96,253742
37949,0.039081,172.31.47.0-255,66,250513,96,253742
37950,0.041363,172.217.194.0-255,2992,253505,96,253742
37951,0.041369,172.31.47.0-255,66,253571,96,253742
37952,0.041505,172.31.47.0-255,105,253676,96,253742
37953,0.043731,172.217.194.0-255,66,253742,96,253742
37954,0.0,74.125.24.0-255,146,146,96,223242
37955,2.4e-05,172.31.47.0-255,66,212,96,223242
37956,3.1e-05,74.125.24.0-255,1484,1696,96,223242
37957,3.6e-05,172.31.47.0-255,66,1762,96,223242
37958,4.8e-05,74.125.24.0-255,2902,4664,96,223242
37959,5.1e-05,172.31.47.0-255,66,4730,96,223242
37960,9.7e-05,74.125.24.0-255,7156,11886,96,223242
37961,0.0001,172.31.47.0-255,66,11952,96,223242
37962,0.000261,74.125.24.0-255,6419,18371,96,223242
37963,0.000266,172.31.47.0-255,66,18437,96,223242
37964,0.000397,74.125.24.0-255,7156,25593,96,223242
37965,0.000401,172.31.47.0-255,66,25659,96,223242
37966,0.00043,74.125.24.0-255,5379,31038,96,223242
37967,0.000432,172.31.47.0-255,66,31104,96,223242
37968,0.000684,74.125.24.0-255,7156,38260,96,223242
37969,0.000688,172.31.47.0-255,66,38326,96,223242
37970,0.000732,172.31.47.0-255,66,38392,96,223242
37971,0.00118,74.125.24.0-255,5738,44130,96,223242
37972,0.001185,172.31.47.0-255,66,44196,96,223242
37973,0.001215,74.125.24.0-255,6797,50993,96,223242
37974,0.001217,172.31.47.0-255,66,51059,96,223242
37975,0.001474,172.31.47.0-255,66,51125,96,223242
37976,0.001522,172.31.47.0-255,66,51191,96,223242
37977,0.002222,74.125.24.0-255,7156,58347,96,223242
37978,0.002227,172.31.47.0-255,66,58413,96,223242
37979,0.002269,172.31.47.0-255,66,58479,96,223242
37980,0.002305,172.31.47.0-255,66,58545,96,223242
37981,0.003189,74.125.24.0-255,1484,60029,96,223242
37982,0.003192,172.31.47.0-255,66,60095,96,223242
37983,0.003251,172.31.47.0-255,66,60161,96,223242
37984,0.005476,74.125.24.0-255,2902,63063,96,223242
37985,0.005479,172.31.47.0-255,66,63129,96,223242
37986,0.005506,74.125.24.0-255,2902,66031,96,223242
37987,0.005508,172.31.47.0-255,66,66097,96,223242
37988,0.00775,74.125.24.0-255,2902,68999,96,223242
37989,0.007758,172.31.47.0-255,66,69065,96,223242
37990,0.007785,74.125.24.0-255,2902,71967,96,223242
37991,0.007787,172.31.47.0-255,66,72033,96,223242
37992,0.01004,74.125.24.0-255,2902,74935,96,223242
37993,0.010059,74.125.24.0-255,2902,77837,96,223242
37994,0.011531,172.31.47.0-255,66,77903,96,223242
37995,0.013827,74.125.24.0-255,4320,82223,96,223242
37996,0.01384,172.31.47.0-255,66,82289,96,223242
37997,0.01387,74.125.24.0-255,1484,83773,96,223242
37998,0.016105,74.125.24.0-255,4320,88093,96,223242
37999,0.016118,172.31.47.0-255,66,88159,96,223242
38000,0.018401,74.125.24.0-255,5738,93897,96,223242
38001,0.018482,172.31.47.0-255,66,93963,96,223242
38002,0.020781,74.125.24.0-255,5738,99701,96,223242
38003,0.02079,172.31.47.0-255,66,99767,96,223242
38004,0.023056,74.125.24.0-255,5738,105505,96,223242
38005,0.023064,172.31.47.0-255,66,105571,96,223242
38006,0.024139,172.31.47.0-255,172,105743,96,223242
38007,0.024165,172.31.47.0-255,1109,106852,96,223242
38008,0.024215,172.31.47.0-255,1514,108366,96,223242
38009,0.024217,172.31.47.0-255,1302,109668,96,223242
38010,0.025347,74.125.24.0-255,5738,115406,96,223242
38011,0.025353,172.31.47.0-255,66,115472,96,223242
38012,0.025663,104.244.42.0-255,66,115538,96,223242
38013,0.025733,104.244.42.0-255,66,115604,96,223242
38014,0.025806,104.244.42.0-255,66,115670,96,223242
38015,0.02762,74.125.24.0-255,5738,121408,96,223242
38016,0.027629,172.31.47.0-255,66,121474,96,223242
38017,0.02992,74.125.24.0-255,5738,127212,96,223242
38018,0.029937,172.31.47.0-255,66,127278,96,223242
38019,0.032179,74.125.24.0-255,4320,131598,96,223242
38020,0.032187,172.31.47.0-255,66,131664,96,223242
38021,0.032218,74.125.24.0-255,1484,133148,96,223242
38022,0.034465,74.125.24.0-255,4320,137468,96,223242
38023,0.034472,172.31.47.0-255,66,137534,96,223242
38024,0.036749,74.125.24.0-255,5738,143272,96,223242
38025,0.036805,172.31.47.0-255,66,143338,96,223242
38026,0.039075,74.125.24.0-255,5738,149076,96,223242
38027,0.039083,172.31.47.0-255,66,149142,96,223242
38028,0.04132,74.125.24.0-255,5738,154880,96,223242
38029,0.041326,172.31.47.0-255,66,154946,96,223242
38030,0.043676,74.125.24.0-255,5738,160684,96,223242
38031,0.043682,172.31.47.0-255,66,160750,96,223242
38032,0.045983,74.125.24.0-255,5738,166488,96,223242
38033,0.045988,172.31.47.0-255,66,166554,96,223242
38034,0.048235,74.125.24.0-255,5738,172292,96,223242
38035,0.048241,172.31.47.0-255,66,172358,96,223242
38036,0.05052,74.125.24.0-255,5738,178096,96,223242
38037,0.050526,172.31.47.0-255,66,178162,96,223242
38038,0.052831,74.125.24.0-255,5738,183900,96,223242
38039,0.052837,172.31.47.0-255,66,183966,96,223242
38040,0.055095,74.125.24.0-255,5738,189704,96,223242
38041,0.055101,172.31.47.0-255,66,189770,96,223242
38042,0.057364,74.125.24.0-255,5738,195508,96,223242
38043,0.057371,172.31.47.0-255,66,195574,96,223242
38044,0.059652,74.125.24.0-255,4320,199894,96,223242
38045,0.059659,172.31.47.0-255,66,199960,96,223242
38046,0.059685,74.125.24.0-255,1484,201444,96,223242
38047,0.061915,74.125.24.0-255,4320,205764,96,223242
38048,0.061928,172.31.47.0-255,66,205830,96,223242
38049,0.064188,74.125.24.0-255,5738,211568,96,223242
38050,0.064194,172.31.47.0-255,66,211634,96,223242
38051,0.066542,74.125.24.0-255,5738,217372,96,223242
38052,0.066549,172.31.47.0-255,66,217438,96,223242
38053,0.068838,74.125.24.0-255,5738,223176,96,223242
38054,0.068845,172.31.47.0-255,66,223242,96,223242
38055,0.0,172.217.194.0-255,153,153,96,203934
38056,2.7e-05,172.31.47.0-255,66,219,96,203934
38057,3.4e-05,172.217.194.0-255,1484,1703,96,203934
38058,3.8e-05,172.31.47.0-255,66,1769,96,203934
38059,4.3e-05,172.217.194.0-255,2902,4671,96,203934
38060,4.6e-05,172.31.47.0-255,66,4737,96,203934
38061,5.1e-05,172.217.194.0-255,2902,7639,96,203934
38062,5.3e-05,172.31.47.0-255,66,7705,96,203934
38063,8.1e-05,172.217.194.0-255,2902,10607,96,203934
38064,8.3e-05,172.31.47.0-255,66,10673,96,203934
38065,8.8e-05,172.217.194.0-255,4320,14993,96,203934
38066,9e-05,172.31.47.0-255,66,15059,96,203934
38067,0.000116,172.31.47.0-255,66,15125,96,203934
38068,0.000122,172.217.194.0-255,6797,21922,96,203934
38069,0.000124,172.31.47.0-255,66,21988,96,203934
38070,0.000213,172.217.194.0-255,1484,23472,96,203934
38071,0.000215,172.31.47.0-255,66,23538,96,203934
38072,0.00022,172.217.194.0-255,2902,26440,96,203934
38073,0.000221,172.31.47.0-255,66,26506,96,203934
38074,0.00024,172.217.194.0-255,5738,32244,96,203934
38075,0.000243,172.31.47.0-255,66,32310,96,203934
38076,0.000267,172.217.194.0-255,6797,39107,96,203934
38077,0.000269,172.31.47.0-255,66,39173,96,203934
38078,0.000273,172.217.194.0-255,2902,42075,96,203934
38079,0.000275,172.31.47.0-255,66,42141,96,203934
38080,0.000301,172.31.47.0-255,66,42207,96,203934
38081,0.000304,172.217.194.0-255,2543,44750,96,203934
38082,0.000307,172.31.47.0-255,66,44816,96,203934
38083,0.000341,172.217.194.0-255,645,45461,96,203934
38084,0.000344,172.31.47.0-255,66,45527,96,203934
38085,0.000665,172.217.194.0-255,1484,47011,96,203934
38086,0.00067,172.31.47.0-255,66,47077,96,203934
38087,0.000675,172.217.194.0-255,2902,49979,96,203934
38088,0.000677,172.31.47.0-255,66,50045,96,203934
38089,0.000681,172.217.194.0-255,2902,52947,96,203934
38090,0.000683,172.31.47.0-255,66,53013,96,203934
38091,0.000697,172.217.194.0-255,2902,55915,96,203934
38092,0.000699,172.31.47.0-255,66,55981,96,203934
38093,0.000738,172.217.194.0-255,5738,61719,96,203934
38094,0.00074,172.31.47.0-255,66,61785,96,203934
38095,0.000764,172.217.194.0-255,5379,67164,96,203934
38096,0.000766,172.31.47.0-255,66,67230,96,203934
38097,0.000776,172.31.47.0-255,66,67296,96,203934
38098,0.000778,172.217.194.0-255,1125,68421,96,203934
38099,0.00078,172.31.47.0-255,66,68487,96,203934
38100,0.001294,172.217.194.0-255,1484,69971,96,203934
38101,0.001303,172.31.47.0-255,66,70037,96,203934
38102,0.001309,172.217.194.0-255,2902,72939,96,203934
38103,0.001311,172.31.47.0-255,66,73005,96,203934
38104,0.001318,172.217.194.0-255,5738,78743,96,203934
38105,0.00132,172.31.47.0-255,66,78809,96,203934
38106,0.001325,172.217.194.0-255,4320,83129,96,203934
38107,0.001327,172.31.47.0-255,66,83195,96,203934
38108,0.001364,172.31.47.0-255,66,83261,96,203934
38109,0.001368,172.217.194.0-255,2902,86163,96,203934
38110,0.001425,172.217.194.0-255,5020,91183,96,203934
38111,0.001432,172.217.194.0-255,4320,95503,96,203934
38112,0.001444,172.217.194.0-255,1484,96987,96,203934
38113,0.001481,172.217.194.0-255,2902,99889,96,203934
38114,0.001488,172.217.194.0-255,7156,107045,96,203934
38115,0.001512,172.217.194.0-255,7156,114201,96,203934
38116,0.001515,172.217.194.0-255,766,114967,96,203934
38117,0.001595,172.217.194.0-255,1484,116451,96,203934
38118,0.001599,172.217.194.0-255,2902,119353,96,203934
38119,0.001623,172.217.194.0-255,5738,125091,96,203934
38120,0.001689,172.217.194.0-255,4320,129411,96,203934
38121,0.001771,172.217.194.0-255,1484,130895,96,203934
38122,0.001776,172.217.194.0-255,2902,133797,96,203934
38123,0.001808,172.217.194.0-255,5738,139535,96,203934
38124,0.001813,172.217.194.0-255,2902,142437,96,203934
38125,0.001842,172.217.194.0-255,5738,148175,96,203934
38126,0.001864,172.217.194.0-255,5020,153195,96,203934
38127,0.001884,172.217.194.0-255,2902,156097,96,203934
38128,0.001889,172.217.194.0-255,2902,158999,96,203934
38129,0.001903,172.217.194.0-255,1484,160483,96,203934
38130,0.001917,172.217.194.0-255,5738,166221,96,203934
38131,0.001934,172.217.194.0-255,2902,169123,96,203934
38132,0.001944,172.217.194.0-255,4320,173443,96,203934
38133,0.002046,172.217.194.0-255,7156,180599,96,203934
38134,0.002099,172.217.194.0-255,4320,184919,96,203934
38135,0.002166,172.217.194.0-255,5738,190657,96,203934
38136,0.00222,172.217.194.0-255,5738,196395,96,203934
38137,0.002251,172.217.194.0-255,2902,199297,96,203934
38138,0.002303,172.217.194.0-255,105,199402,96,203934
38139,0.005308,172.31.47.0-255,66,199468,96,203934
38140,0.00801,172.31.47.0-255,105,199573,96,203934
38141,0.010526,172.217.194.0-255,66,199639,96,203934
38142,0.03434,172.31.47.0-255,172,199811,96,203934
38143,0.034377,172.31.47.0-255,1105,200916,96,203934
38144,0.034416,172.31.47.0-255,1514,202430,96,203934
38145,0.034418,172.31.47.0-255,1306,203736,96,203934
38146,0.035872,104.244.42.0-255,66,203802,96,203934
38147,0.03593,104.244.42.0-255,66,203868,96,203934
38148,0.035946,104.244.42.0-255,66,203934,96,203934
38149,0.0,172.31.47.0-255,105,105,96,276
38150,0.001521,157.240.13.0-255,105,210,96,276
38151,0.001536,172.31.47.0-255,66,276,96,276
38152,0.0,172.253.118.0-255,153,153,96,267973
38153,2.8e-05,172.31.47.0-255,66,219,96,267973
38154,3.6e-05,172.253.118.0-255,1484,1703,96,267973
38155,4.1e-05,172.31.47.0-255,66,1769,96,267973
38156,5e-05,172.253.118.0-255,2902,4671,96,267973
38157,5.6e-05,172.31.47.0-255,66,4737,96,267973
38158,6.8e-05,172.253.118.0-255,7156,11893,96,267973
38159,7.1e-05,172.31.47.0-255,66,11959,96,267973
38160,7.6e-05,172.253.118.0-255,2128,14087,96,267973
38161,7.9e-05,172.31.47.0-255,66,14153,96,267973
38162,0.000332,172.253.118.0-255,1484,15637,96,267973
38163,0.000339,172.31.47.0-255,66,15703,96,267973
38164,0.000347,172.253.118.0-255,2902,18605,96,267973
38165,0.000351,172.31.47.0-255,66,18671,96,267973
38166,0.00036,172.253.118.0-255,5738,24409,96,267973
38167,0.000364,172.31.47.0-255,66,24475,96,267973
38168,0.000386,172.253.118.0-255,6797,31272,96,267973
38169,0.00039,172.31.47.0-255,66,31338,96,267973
38170,0.000526,172.253.118.0-255,1484,32822,96,267973
38171,0.000532,172.31.47.0-255,66,32888,96,267973
38172,0.000538,172.253.118.0-255,2902,35790,96,267973
38173,0.000541,172.31.47.0-255,66,35856,96,267973
38174,0.00055,172.253.118.0-255,5738,41594,96,267973
38175,0.000554,172.31.47.0-255,66,41660,96,267973
38176,0.000596,172.253.118.0-255,6797,48457,96,267973
38177,0.000601,172.31.47.0-255,66,48523,96,267973
38178,0.000663,172.253.118.0-255,1484,50007,96,267973
38179,0.000669,172.31.47.0-255,66,50073,96,267973
38180,0.000685,172.253.118.0-255,2902,52975,96,267973
38181,0.000689,172.31.47.0-255,66,53041,96,267973
38182,0.000697,172.253.118.0-255,5738,58779,96,267973
38183,0.0007,172.31.47.0-255,66,58845,96,267973
38184,0.000764,172.31.47.0-255,66,58911,96,267973
38185,0.001431,172.253.118.0-255,331,59242,96,267973
38186,0.001497,172.31.47.0-255,66,59308,96,267973
38187,0.001876,172.253.118.0-255,1484,60792,96,267973
38188,0.001893,172.253.118.0-255,2902,63694,96,267973
38189,0.001898,172.31.47.0-255,66,63760,96,267973
38190,0.001907,172.253.118.0-255,5738,69498,96,267973
38191,0.00191,172.31.47.0-255,66,69564,96,267973
38192,0.001922,172.253.118.0-255,7156,76720,96,267973
38193,0.001927,172.31.47.0-255,66,76786,96,267973
38194,0.001948,172.31.47.0-255,66,76852,96,267973
38195,0.001952,172.253.118.0-255,2184,79036,96,267973
38196,0.001955,172.31.47.0-255,66,79102,96,267973
38197,0.004027,172.253.118.0-255,4320,83422,96,267973
38198,0.004034,172.31.47.0-255,66,83488,96,267973
38199,0.004053,172.253.118.0-255,1484,84972,96,267973
38200,0.006093,172.253.118.0-255,4320,89292,96,267973
38201,0.006097,172.31.47.0-255,66,89358,96,267973
38202,0.008182,172.253.118.0-255,5738,95096,96,267973
38203,0.008188,172.31.47.0-255,66,95162,96,267973
38204,0.010266,172.253.118.0-255,5738,100900,96,267973
38205,0.010274,172.31.47.0-255,66,100966,96,267973
38206,0.012347,172.253.118.0-255,5738,106704,96,267973
38207,0.012353,172.31.47.0-255,66,106770,96,267973
38208,0.014456,172.253.118.0-255,5738,112508,96,267973
38209,0.014466,172.31.47.0-255,66,112574,96,267973
38210,0.016536,172.253.118.0-255,5738,118312,96,267973
38211,0.016542,172.31.47.0-255,66,118378,96,267973
38212,0.018628,172.253.118.0-255,5738,124116,96,267973
38213,0.018632,172.31.47.0-255,66,124182,96,267973
38214,0.020701,172.253.118.0-255,5738,129920,96,267973
38215,0.020707,172.31.47.0-255,66,129986,96,267973
38216,0.022762,172.253.118.0-255,5738,135724,96,267973
38217,0.022769,172.31.47.0-255,66,135790,96,267973
38218,0.023715,172.31.47.0-255,172,135962,96,267973
38219,0.023747,172.31.47.0-255,1101,137063,96,267973
38220,0.023803,172.31.47.0-255,1514,138577,96,267973
38221,0.023805,172.31.47.0-255,1312,139889,96,267973
38222,0.024838,172.253.118.0-255,5738,145627,96,267973
38223,0.024848,172.31.47.0-255,66,145693,96,267973
38224,0.025238,104.244.42.0-255,66,145759,96,267973
38225,0.0253,104.244.42.0-255,66,145825,96,267973
38226,0.025304,104.244.42.0-255,66,145891,96,267973
38227,0.026905,172.253.118.0-255,5738,151629,96,267973
38228,0.026909,172.31.47.0-255,66,151695,96,267973
38229,0.028988,172.253.118.0-255,5738,157433,96,267973
38230,0.028993,172.31.47.0-255,66,157499,96,267973
38231,0.031067,172.253.118.0-255,5738,163237,96,267973
38232,0.031072,172.31.47.0-255,66,163303,96,267973
38233,0.033152,172.253.118.0-255,5738,169041,96,267973
38234,0.033158,172.31.47.0-255,66,169107,96,267973
38235,0.035198,172.253.118.0-255,5738,174845,96,267973
38236,0.035204,172.31.47.0-255,66,174911,96,267973
38237,0.037276,172.253.118.0-255,5738,180649,96,267973
38238,0.037281,172.31.47.0-255,66,180715,96,267973
38239,0.039346,172.253.118.0-255,5738,186453,96,267973
38240,0.039351,172.31.47.0-255,66,186519,96,267973
38241,0.041414,172.253.118.0-255,5738,192257,96,267973
38242,0.041435,172.31.47.0-255,66,192323,96,267973
38243,0.04351,172.253.118.0-255,5738,198061,96,267973
38244,0.043515,172.31.47.0-255,66,198127,96,267973
38245,0.045584,172.253.118.0-255,5738,203865,96,267973
38246,0.045589,172.31.47.0-255,66,203931,96,267973
38247,0.047655,172.253.118.0-255,5738,209669,96,267973
38248,0.047661,172.31.47.0-255,66,209735,96,267973
38249,0.049727,172.253.118.0-255,2902,212637,96,267973
38250,0.049732,172.31.47.0-255,66,212703,96,267973
38251,0.049765,172.253.118.0-255,2902,215605,96,267973
38252,0.049769,172.31.47.0-255,66,215671,96,267973
38253,0.051795,172.253.118.0-255,1484,217155,96,267973
38254,0.051826,172.253.118.0-255,4320,221475,96,267973
38255,0.051831,172.31.47.0-255,66,221541,96,267973
38256,0.053922,172.253.118.0-255,5738,227279,96,267973
38257,0.053926,172.31.47.0-255,66,227345,96,267973
38258,0.056025,172.253.118.0-255,5738,233083,96,267973
38259,0.05603,172.31.47.0-255,66,233149,96,267973
38260,0.058104,172.253.118.0-255,5738,238887,96,267973
38261,0.058119,172.31.47.0-255,66,238953,96,267973
38262,0.060219,172.253.118.0-255,5738,244691,96,267973
38263,0.060239,172.31.47.0-255,66,244757,96,267973
38264,0.062328,172.253.118.0-255,5738,250495,96,267973
38265,0.062345,172.31.47.0-255,66,250561,96,267973
38266,0.06443,172.253.118.0-255,5738,256299,96,267973
38267,0.064446,172.31.47.0-255,66,256365,96,267973
38268,0.066531,172.253.118.0-255,5738,262103,96,267973
38269,0.066547,172.31.47.0-255,66,262169,96,267973
38270,0.06865,172.253.118.0-255,5738,267907,96,267973
38271,0.068671,172.31.47.0-255,66,267973,96,267973
38272,0.0,172.31.47.0-255,105,105,96,276
38273,0.067255,31.13.82.0-255,105,210,96,276
38274,0.067271,172.31.47.0-255,66,276,96,276
38275,0.0,74.125.68.0-255,158,158,96,395217
38276,1.5e-05,172.31.47.0-255,66,224,96,395217
38277,2e-05,74.125.68.0-255,1484,1708,96,395217
38278,2.5e-05,172.31.47.0-255,66,1774,96,395217
38279,5e-05,74.125.68.0-255,2902,4676,96,395217
38280,5.3e-05,172.31.47.0-255,66,4742,96,395217
38281,5.6e-05,74.125.68.0-255,1484,6226,96,395217
38282,5.8e-05,172.31.47.0-255,66,6292,96,395217
38283,7.4e-05,74.125.68.0-255,2902,9194,96,395217
38284,7.6e-05,172.31.47.0-255,66,9260,96,395217
38285,9.2e-05,74.125.68.0-255,1484,10744,96,395217
38286,9.4e-05,172.31.47.0-255,66,10810,96,395217
38287,0.000114,74.125.68.0-255,4837,15647,96,395217
38288,0.000117,172.31.47.0-255,66,15713,96,395217
38289,0.000122,74.125.68.0-255,5738,21451,96,395217
38290,0.000124,172.31.47.0-255,66,21517,96,395217
38291,0.000128,74.125.68.0-255,2902,24419,96,395217
38292,0.000129,172.31.47.0-255,66,24485,96,395217
38293,0.000148,74.125.68.0-255,4320,28805,96,395217
38294,0.00015,172.31.47.0-255,66,28871,96,395217
38295,0.000161,74.125.68.0-255,2543,31414,96,395217
38296,0.000163,172.31.47.0-255,66,31480,96,395217
38297,0.000417,74.125.68.0-255,1484,32964,96,395217
38298,0.000422,172.31.47.0-255,66,33030,96,395217
38299,0.000427,74.125.68.0-255,2902,35932,96,395217
38300,0.000429,172.31.47.0-255,66,35998,96,395217
38301,0.000458,74.125.68.0-255,5738,41736,96,395217
38302,0.000461,172.31.47.0-255,66,41802,96,395217
38303,0.000465,74.125.68.0-255,2902,44704,96,395217
38304,0.000467,172.31.47.0-255,66,44770,96,395217
38305,0.000479,74.125.68.0-255,3961,48731,96,395217
38306,0.000481,172.31.47.0-255,66,48797,96,395217
38307,0.000514,74.125.68.0-255,1484,50281,96,395217
38308,0.000539,74.125.68.0-255,2902,53183,96,395217
38309,0.000542,172.31.47.0-255,66,53249,96,395217
38310,0.000566,74.125.68.0-255,5738,58987,96,395217
38311,0.000568,172.31.47.0-255,66,59053,96,395217
38312,0.000594,74.125.68.0-255,7071,66124,96,395217
38313,0.000598,172.31.47.0-255,66,66190,96,395217
38314,0.000613,74.125.68.0-255,134,66324,96,395217
38315,0.000688,74.125.68.0-255,1484,67808,96,395217
38316,0.000692,172.31.47.0-255,66,67874,96,395217
38317,0.000714,74.125.68.0-255,2902,70776,96,395217
38318,0.000717,172.31.47.0-255,66,70842,96,395217
38319,0.00072,74.125.68.0-255,1484,72326,96,395217
38320,0.000724,74.125.68.0-255,2902,75228,96,395217
38321,0.000725,172.31.47.0-255,66,75294,96,395217
38322,0.000728,74.125.68.0-255,1484,76778,96,395217
38323,0.000743,74.125.68.0-255,4320,81098,96,395217
38324,0.000746,172.31.47.0-255,66,81164,96,395217
38325,0.000772,74.125.68.0-255,5738,86902,96,395217
38326,0.000775,172.31.47.0-255,66,86968,96,395217
38327,0.00079,74.125.68.0-255,5738,92706,96,395217
38328,0.000793,172.31.47.0-255,66,92772,96,395217
38329,0.00083,74.125.68.0-255,7156,99928,96,395217
38330,0.000833,172.31.47.0-255,66,99994,96,395217
38331,0.000855,74.125.68.0-255,766,100760,96,395217
38332,0.000885,74.125.68.0-255,1484,102244,96,395217
38333,0.000888,172.31.47.0-255,66,102310,96,395217
38334,0.000925,74.125.68.0-255,2902,105212,96,395217
38335,0.000928,172.31.47.0-255,66,105278,96,395217
38336,0.000938,74.125.68.0-255,1484,106762,96,395217
38337,0.000954,74.125.68.0-255,2902,109664,96,395217
38338,0.000956,172.31.47.0-255,66,109730,96,395217
38339,0.000982,172.31.47.0-255,66,109796,96,395217
38340,0.001031,172.31.47.0-255,66,109862,96,395217
38341,0.001038,74.125.68.0-255,6438,116300,96,395217
38342,0.001039,172.31.47.0-255,66,116366,96,395217
38343,0.001076,74.125.68.0-255,1484,117850,96,395217
38344,0.00108,74.125.68.0-255,1484,119334,96,395217
38345,0.001082,172.31.47.0-255,66,119400,96,395217
38346,0.001098,74.125.68.0-255,1484,120884,96,395217
38347,0.00111,74.125.68.0-255,4320,125204,96,395217
38348,0.001112,172.31.47.0-255,66,125270,96,395217
38349,0.00113,74.125.68.0-255,1484,126754,96,395217
38350,0.001147,74.125.68.0-255,4320,131074,96,395217
38351,0.001149,172.31.47.0-255,66,131140,96,395217
38352,0.001169,74.125.68.0-255,4320,135460,96,395217
38353,0.001171,172.31.47.0-255,66,135526,96,395217
38354,0.001185,74.125.68.0-255,1484,137010,96,395217
38355,0.001223,74.125.68.0-255,4320,141330,96,395217
38356,0.001225,172.31.47.0-255,66,141396,96,395217
38357,0.001243,74.125.68.0-255,2902,144298,96,395217
38358,0.001245,172.31.47.0-255,66,144364,96,395217
38359,0.00126,74.125.68.0-255,2902,147266,96,395217
38360,0.001262,172.31.47.0-255,66,147332,96,395217
38361,0.001279,74.125.68.0-255,2902,150234,96,395217
38362,0.001282,172.31.47.0-255,66,150300,96,395217
38363,0.001314,74.125.68.0-255,766,151066,96,395217
38364,0.001609,74.125.68.0-255,1484,152550,96,395217
38365,0.001615,172.31.47.0-255,66,152616,96,395217
38366,0.00162,74.125.68.0-255,2902,155518,96,395217
38367,0.001623,172.31.47.0-255,66,155584,96,395217
38368,0.001625,74.125.68.0-255,1484,157068,96,395217
38369,0.001647,74.125.68.0-255,2902,159970,96,395217
38370,0.00165,172.31.47.0-255,66,160036,96,395217
38371,0.001653,74.125.68.0-255,2902,162938,96,395217
38372,0.001655,172.31.47.0-255,66,163004,96,395217
38373,0.001669,74.125.68.0-255,2902,165906,96,395217
38374,0.001671,172.31.47.0-255,66,165972,96,395217
38375,0.001703,172.31.47.0-255,66,166038,96,395217
38376,0.001738,74.125.68.0-255,5738,171776,96,395217
38377,0.00174,172.31.47.0-255,66,171842,96,395217
38378,0.001757,74.125.68.0-255,3602,175444,96,395217
38379,0.001759,172.31.47.0-255,66,175510,96,395217
38380,0.001806,74.125.68.0-255,1484,176994,96,395217
38381,0.001824,74.125.68.0-255,2902,179896,96,395217
38382,0.001826,172.31.47.0-255,66,179962,96,395217
38383,0.001841,74.125.68.0-255,1484,181446,96,395217
38384,0.001854,74.125.68.0-255,2902,184348,96,395217
38385,0.001856,172.31.47.0-255,66,184414,96,395217
38386,0.001875,74.125.68.0-255,7156,191570,96,395217
38387,0.001877,172.31.47.0-255,66,191636,96,395217
38388,0.001892,74.125.68.0-255,1484,193120,96,395217
38389,0.001896,74.125.68.0-255,4320,197440,96,395217
38390,0.001898,172.31.47.0-255,66,197506,96,395217
38391,0.001944,74.125.68.0-255,5738,203244,96,395217
38392,0.001947,172.31.47.0-255,66,203310,96,395217
38393,0.001966,74.125.68.0-255,6438,209748,96,395217
38394,0.001968,172.31.47.0-255,66,209814,96,395217
38395,0.001983,74.125.68.0-255,1484,211298,96,395217
38396,0.003947,74.125.68.0-255,4320,215618,96,395217
38397,0.00395,172.31.47.0-255,66,215684,96,395217
38398,0.005939,74.125.68.0-255,5738,221422,96,395217
38399,0.005947,172.31.47.0-255,66,221488,96,395217
38400,0.007941,74.125.68.0-255,5738,227226,96,395217
38401,0.007946,172.31.47.0-255,66,227292,96,395217
38402,0.009938,74.125.68.0-255,5738,233030,96,395217
38403,0.009944,172.31.47.0-255,66,233096,96,395217
38404,0.011929,74.125.68.0-255,5738,238834,96,395217
38405,0.011936,172.31.47.0-255,66,238900,96,395217
38406,0.013939,74.125.68.0-255,5738,244638,96,395217
38407,0.013948,172.31.47.0-255,66,244704,96,395217
38408,0.015946,74.125.68.0-255,5738,250442,96,395217
38409,0.01596,172.31.47.0-255,66,250508,96,395217
38410,0.017948,74.125.68.0-255,5738,256246,96,395217
38411,0.017955,172.31.47.0-255,66,256312,96,395217
38412,0.019948,74.125.68.0-255,5738,262050,96,395217
38413,0.019958,172.31.47.0-255,66,262116,96,395217
38414,0.021944,74.125.68.0-255,5738,267854,96,395217
38415,0.02195,172.31.47.0-255,66,267920,96,395217
38416,0.023944,74.125.68.0-255,5738,273658,96,395217
38417,0.023951,172.31.47.0-255,66,273724,96,395217
38418,0.02597,74.125.68.0-255,5738,279462,96,395217
38419,0.025976,172.31.47.0-255,66,279528,96,395217
38420,0.027974,74.125.68.0-255,5738,285266,96,395217
38421,0.027981,172.31.47.0-255,66,285332,96,395217
38422,0.02997,74.125.68.0-255,5738,291070,96,395217
38423,0.029976,172.31.47.0-255,66,291136,96,395217
38424,0.031887,172.31.47.0-255,172,291308,96,395217
38425,0.031918,172.31.47.0-255,1109,292417,96,395217
38426,0.031961,74.125.68.0-255,5738,298155,96,395217
38427,0.031966,172.31.47.0-255,66,298221,96,395217
38428,0.032009,172.31.47.0-255,1514,299735,96,395217
38429,0.032011,172.31.47.0-255,1304,301039,96,395217
38430,0.033402,104.244.42.0-255,66,301105,96,395217
38431,0.033431,104.244.42.0-255,66,301171,96,395217
38432,0.033539,104.244.42.0-255,66,301237,96,395217
38433,0.033953,74.125.68.0-255,5738,306975,96,395217
38434,0.033957,172.31.47.0-255,66,307041,96,395217
38435,0.035938,74.125.68.0-255,5738,312779,96,395217
38436,0.035943,172.31.47.0-255,66,312845,96,395217
38437,0.037938,74.125.68.0-255,5738,318583,96,395217
38438,0.037943,172.31.47.0-255,66,318649,96,395217
38439,0.03994,74.125.68.0-255,5738,324387,96,395217
38440,0.039946,172.31.47.0-255,66,324453,96,395217
38441,0.041939,74.125.68.0-255,5738,330191,96,395217
38442,0.041946,172.31.47.0-255,66,330257,96,395217
38443,0.043934,74.125.68.0-255,5738,335995,96,395217
38444,0.04394,172.31.47.0-255,66,336061,96,395217
38445,0.045933,74.125.68.0-255,5738,341799,96,395217
38446,0.045939,172.31.47.0-255,66,341865,96,395217
38447,0.047939,74.125.68.0-255,5738,347603,96,395217
38448,0.047945,172.31.47.0-255,66,347669,96,395217
38449,0.049939,74.125.68.0-255,5738,353407,96,395217
38450,0.049944,172.31.47.0-255,66,353473,96,395217
38451,0.051936,74.125.68.0-255,5738,359211,96,395217
38452,0.051942,172.31.47.0-255,66,359277,96,395217
38453,0.053938,74.125.68.0-255,5738,365015,96,395217
38454,0.053946,172.31.47.0-255,66,365081,96,395217
38455,0.055944,74.125.68.0-255,5738,370819,96,395217
38456,0.055951,172.31.47.0-255,66,370885,96,395217
38457,0.057939,74.125.68.0-255,5738,376623,96,395217
38458,0.057945,172.31.47.0-255,66,376689,96,395217
38459,0.059942,74.125.68.0-255,5738,382427,96,395217
38460,0.059948,172.31.47.0-255,66,382493,96,395217
38461,0.061946,74.125.68.0-255,5738,388231,96,395217
38462,0.061951,172.31.47.0-255,66,388297,96,395217
38463,0.06394,74.125.68.0-255,5738,394035,96,395217
38464,0.063947,172.31.47.0-255,66,394101,96,395217
38465,0.065917,74.125.68.0-255,879,394980,96,395217
38466,0.066033,172.31.47.0-255,66,395046,96,395217
38467,0.066062,172.31.47.0-255,105,395151,96,395217
38468,0.068023,74.125.68.0-255,66,395217,96,395217
38469,0.0,74.125.24.0-255,153,153,96,335346
38470,2.3e-05,172.31.47.0-255,66,219,96,335346
38471,3e-05,74.125.24.0-255,1484,1703,96,335346
38472,3.4e-05,172.31.47.0-255,66,1769,96,335346
38473,4e-05,74.125.24.0-255,2902,4671,96,335346
38474,4.3e-05,172.31.47.0-255,66,4737,96,335346
38475,5.1e-05,74.125.24.0-255,7156,11893,96,335346
38476,5.3e-05,172.31.47.0-255,66,11959,96,335346
38477,5.7e-05,74.125.24.0-255,2209,14168,96,335346
38478,6.1e-05,172.31.47.0-255,66,14234,96,335346
38479,0.000116,74.125.24.0-255,1484,15718,96,335346
38480,0.000119,172.31.47.0-255,66,15784,96,335346
38481,0.000124,74.125.24.0-255,2902,18686,96,335346
38482,0.000126,172.31.47.0-255,66,18752,96,335346
38483,0.000128,74.125.24.0-255,1484,20236,96,335346
38484,0.00013,172.31.47.0-255,66,20302,96,335346
38485,0.000145,74.125.24.0-255,4320,24622,96,335346
38486,0.000147,172.31.47.0-255,66,24688,96,335346
38487,0.000185,74.125.24.0-255,6797,31485,96,335346
38488,0.000188,172.31.47.0-255,66,31551,96,335346
38489,0.000196,74.125.24.0-255,7156,38707,96,335346
38490,0.000198,172.31.47.0-255,66,38773,96,335346
38491,0.000219,74.125.24.0-255,7156,45929,96,335346
38492,0.000222,172.31.47.0-255,66,45995,96,335346
38493,0.00024,74.125.24.0-255,2543,48538,96,335346
38494,0.000242,172.31.47.0-255,66,48604,96,335346
38495,0.000398,74.125.24.0-255,1484,50088,96,335346
38496,0.000405,172.31.47.0-255,66,50154,96,335346
38497,0.000411,74.125.24.0-255,2902,53056,96,335346
38498,0.000415,172.31.47.0-255,66,53122,96,335346
38499,0.00042,74.125.24.0-255,4320,57442,96,335346
38500,0.000423,172.31.47.0-255,66,57508,96,335346
38501,0.000446,74.125.24.0-255,1484,58992,96,335346
38502,0.000449,172.31.47.0-255,66,59058,96,335346
38503,0.000463,74.125.24.0-255,2902,61960,96,335346
38504,0.000465,172.31.47.0-255,66,62026,96,335346
38505,0.000489,74.125.24.0-255,3961,65987,96,335346
38506,0.000493,172.31.47.0-255,66,66053,96,335346
38507,0.000519,74.125.24.0-255,1484,67537,96,335346
38508,0.000522,172.31.47.0-255,66,67603,96,335346
38509,0.000528,74.125.24.0-255,2902,70505,96,335346
38510,0.00053,172.31.47.0-255,66,70571,96,335346
38511,0.000533,74.125.24.0-255,1484,72055,96,335346
38512,0.000535,172.31.47.0-255,66,72121,96,335346
38513,0.00056,74.125.24.0-255,4320,76441,96,335346
38514,0.000563,172.31.47.0-255,66,76507,96,335346
38515,0.000568,74.125.24.0-255,7156,83663,96,335346
38516,0.00057,172.31.47.0-255,66,83729,96,335346
38517,0.000585,74.125.24.0-255,3961,87690,96,335346
38518,0.000587,172.31.47.0-255,66,87756,96,335346
38519,0.000619,74.125.24.0-255,7156,94912,96,335346
38520,0.000622,172.31.47.0-255,66,94978,96,335346
38521,0.000634,74.125.24.0-255,5379,100357,96,335346
38522,0.000688,172.31.47.0-255,66,100423,96,335346
38523,0.000991,74.125.24.0-255,1484,101907,96,335346
38524,0.000997,74.125.24.0-255,1484,103391,96,335346
38525,0.001002,172.31.47.0-255,66,103457,96,335346
38526,0.001022,74.125.24.0-255,1484,104941,96,335346
38527,0.001029,74.125.24.0-255,5738,110679,96,335346
38528,0.001044,74.125.24.0-255,1484,112163,96,335346
38529,0.001061,74.125.24.0-255,6783,118946,96,335346
38530,0.001073,172.31.47.0-255,66,119012,96,335346
38531,0.001103,74.125.24.0-255,1533,120545,96,335346
38532,0.001119,74.125.24.0-255,7156,127701,96,335346
38533,0.001143,74.125.24.0-255,1125,128826,96,335346
38534,0.00116,172.31.47.0-255,66,128892,96,335346
38535,0.001314,74.125.24.0-255,1484,130376,96,335346
38536,0.00132,74.125.24.0-255,2902,133278,96,335346
38537,0.001327,74.125.24.0-255,5738,139016,96,335346
38538,0.001351,74.125.24.0-255,7156,146172,96,335346
38539,0.001366,74.125.24.0-255,5738,151910,96,335346
38540,0.001372,172.31.47.0-255,66,151976,96,335346
38541,0.001389,172.31.47.0-255,66,152042,96,335346
38542,0.001412,74.125.24.0-255,2184,154226,96,335346
38543,0.001419,172.31.47.0-255,66,154292,96,335346
38544,0.001474,74.125.24.0-255,1484,155776,96,335346
38545,0.001479,74.125.24.0-255,2902,158678,96,335346
38546,0.001498,74.125.24.0-255,5738,164416,96,335346
38547,0.001502,172.31.47.0-255,66,164482,96,335346
38548,0.001511,172.31.47.0-255,66,164548,96,335346
38549,0.001513,74.125.24.0-255,1484,166032,96,335346
38550,0.001549,74.125.24.0-255,5738,171770,96,335346
38551,0.001569,74.125.24.0-255,5020,176790,96,335346
38552,0.001574,172.31.47.0-255,66,176856,96,335346
38553,0.001592,74.125.24.0-255,1484,178340,96,335346
38554,0.001604,74.125.24.0-255,2902,181242,96,335346
38555,0.001607,74.125.24.0-255,2902,184144,96,335346
38556,0.001624,74.125.24.0-255,2902,187046,96,335346
38557,0.001659,74.125.24.0-255,2902,189948,96,335346
38558,0.001666,172.31.47.0-255,66,190014,96,335346
38559,0.001688,74.125.24.0-255,766,190780,96,335346
38560,0.001698,172.31.47.0-255,66,190846,96,335346
38561,0.001718,74.125.24.0-255,1484,192330,96,335346
38562,0.001734,74.125.24.0-255,2902,195232,96,335346
38563,0.001746,74.125.24.0-255,1484,196716,96,335346
38564,0.001751,74.125.24.0-255,5738,202454,96,335346
38565,0.001766,74.125.24.0-255,4320,206774,96,335346
38566,0.001783,74.125.24.0-255,7156,213930,96,335346
38567,0.001806,74.125.24.0-255,7156,221086,96,335346
38568,0.00182,74.125.24.0-255,3602,224688,96,335346
38569,0.002067,74.125.24.0-255,1484,226172,96,335346
38570,0.002071,74.125.24.0-255,1484,227656,96,335346
38571,0.002082,74.125.24.0-255,1484,229140,96,335346
38572,0.002086,74.125.24.0-255,2902,232042,96,335346
38573,0.002089,172.31.47.0-255,66,232108,96,335346
38574,0.002096,74.125.24.0-255,2902,235010,96,335346
38575,0.002107,74.125.24.0-255,2902,237912,96,335346
38576,0.002108,172.31.47.0-255,66,237978,96,335346
38577,0.002121,74.125.24.0-255,2902,240880,96,335346
38578,0.002137,74.125.24.0-255,4320,245200,96,335346
38579,0.002145,172.31.47.0-255,66,245266,96,335346
38580,0.002168,74.125.24.0-255,5020,250286,96,335346
38581,0.002178,172.31.47.0-255,66,250352,96,335346
38582,0.002216,74.125.24.0-255,2902,253254,96,335346
38583,0.00222,172.31.47.0-255,66,253320,96,335346
38584,0.002245,74.125.24.0-255,1484,254804,96,335346
38585,0.002249,172.31.47.0-255,66,254870,96,335346
38586,0.002255,74.125.24.0-255,1484,256354,96,335346
38587,0.002268,74.125.24.0-255,2902,259256,96,335346
38588,0.002282,74.125.24.0-255,2902,262158,96,335346
38589,0.002289,172.31.47.0-255,66,262224,96,335346
38590,0.002305,74.125.24.0-255,4320,266544,96,335346
38591,0.002316,172.31.47.0-255,66,266610,96,335346
38592,0.002336,74.125.24.0-255,4320,270930,96,335346
38593,0.002354,74.125.24.0-255,5738,276668,96,335346
38594,0.00236,172.31.47.0-255,66,276734,96,335346
38595,0.002369,74.125.24.0-255,1484,278218,96,335346
38596,0.004617,74.125.24.0-255,4320,282538,96,335346
38597,0.004621,172.31.47.0-255,66,282604,96,335346
38598,0.007151,74.125.24.0-255,5738,288342,96,335346
38599,0.007158,172.31.47.0-255,66,288408,96,335346
38600,0.009426,74.125.24.0-255,5738,294146,96,335346
38601,0.009433,172.31.47.0-255,66,294212,96,335346
38602,0.011707,74.125.24.0-255,5738,299950,96,335346
38603,0.011717,172.31.47.0-255,66,300016,96,335346
38604,0.014013,74.125.24.0-255,5738,305754,96,335346
38605,0.014019,172.31.47.0-255,66,305820,96,335346
38606,0.016285,74.125.24.0-255,5738,311558,96,335346
38607,0.016291,172.31.47.0-255,66,311624,96,335346
38608,0.018543,74.125.24.0-255,5738,317362,96,335346
38609,0.018548,172.31.47.0-255,66,317428,96,335346
38610,0.020854,74.125.24.0-255,5738,323166,96,335346
38611,0.020861,172.31.47.0-255,66,323232,96,335346
38612,0.023179,74.125.24.0-255,5738,328970,96,335346
38613,0.023185,172.31.47.0-255,66,329036,96,335346
38614,0.025444,74.125.24.0-255,1778,330814,96,335346
38615,0.02545,172.31.47.0-255,66,330880,96,335346
38616,0.025476,172.31.47.0-255,172,331052,96,335346
38617,0.025498,172.31.47.0-255,1109,332161,96,335346
38618,0.025539,172.31.47.0-255,1514,333675,96,335346
38619,0.025541,172.31.47.0-255,1302,334977,96,335346
38620,0.02564,172.31.47.0-255,105,335082,96,335346
38621,0.027054,104.244.42.0-255,66,335148,96,335346
38622,0.027063,104.244.42.0-255,66,335214,96,335346
38623,0.027081,104.244.42.0-255,66,335280,96,335346
38624,0.027892,74.125.24.0-255,66,335346,96,335346
38625,0.0,74.125.24.0-255,152,152,96,190298
38626,2e-05,172.31.47.0-255,66,218,96,190298
38627,2.7e-05,74.125.24.0-255,1484,1702,96,190298
38628,3.1e-05,172.31.47.0-255,66,1768,96,190298
38629,3.6e-05,74.125.24.0-255,2902,4670,96,190298
38630,4.5e-05,172.31.47.0-255,66,4736,96,190298
38631,5.2e-05,74.125.24.0-255,7156,11892,96,190298
38632,5.5e-05,172.31.47.0-255,66,11958,96,190298
38633,5.9e-05,74.125.24.0-255,2902,14860,96,190298
38634,6.1e-05,172.31.47.0-255,66,14926,96,190298
38635,8.3e-05,74.125.24.0-255,6415,21341,96,190298
38636,8.5e-05,172.31.47.0-255,66,21407,96,190298
38637,9.9e-05,172.31.47.0-255,66,21473,96,190298
38638,0.000118,74.125.24.0-255,1125,22598,96,190298
38639,0.00012,172.31.47.0-255,66,22664,96,190298
38640,0.000231,74.125.24.0-255,1484,24148,96,190298
38641,0.000235,172.31.47.0-255,66,24214,96,190298
38642,0.00024,74.125.24.0-255,2902,27116,96,190298
38643,0.000242,172.31.47.0-255,66,27182,96,190298
38644,0.000268,74.125.24.0-255,5738,32920,96,190298
38645,0.000271,172.31.47.0-255,66,32986,96,190298
38646,0.000295,74.125.24.0-255,4320,37306,96,190298
38647,0.000297,172.31.47.0-255,66,37372,96,190298
38648,0.000329,172.31.47.0-255,66,37438,96,190298
38649,0.00034,172.31.47.0-255,66,37504,96,190298
38650,0.000603,74.125.24.0-255,132,37636,96,190298
38651,0.000608,172.31.47.0-255,66,37702,96,190298
38652,0.000636,74.125.24.0-255,1484,39186,96,190298
38653,0.000639,172.31.47.0-255,66,39252,96,190298
38654,0.000651,74.125.24.0-255,2902,42154,96,190298
38655,0.000657,172.31.47.0-255,66,42220,96,190298
38656,0.000661,74.125.24.0-255,2902,45122,96,190298
38657,0.000663,172.31.47.0-255,66,45188,96,190298
38658,0.000703,172.31.47.0-255,66,45254,96,190298
38659,0.000747,172.31.47.0-255,66,45320,96,190298
38660,0.000749,74.125.24.0-255,341,45661,96,190298
38661,0.000966,74.125.24.0-255,1484,47145,96,190298
38662,0.00097,172.31.47.0-255,66,47211,96,190298
38663,0.000974,74.125.24.0-255,2902,50113,96,190298
38664,0.000976,172.31.47.0-255,66,50179,96,190298
38665,0.000998,74.125.24.0-255,5738,55917,96,190298
38666,0.001004,172.31.47.0-255,66,55983,96,190298
38667,0.001029,172.31.47.0-255,66,56049,96,190298
38668,0.001038,74.125.24.0-255,4320,60369,96,190298
38669,0.00104,172.31.47.0-255,66,60435,96,190298
38670,0.001054,172.31.47.0-255,66,60501,96,190298
38671,0.00145,74.125.24.0-255,1484,61985,96,190298
38672,0.001456,74.125.24.0-255,2902,64887,96,190298
38673,0.001459,172.31.47.0-255,66,64953,96,190298
38674,0.001482,74.125.24.0-255,1484,66437,96,190298
38675,0.001486,74.125.24.0-255,2902,69339,96,190298
38676,0.001488,172.31.47.0-255,66,69405,96,190298
38677,0.001491,74.125.24.0-255,1484,70889,96,190298
38678,0.001516,74.125.24.0-255,4320,75209,96,190298
38679,0.001518,172.31.47.0-255,66,75275,96,190298
38680,0.001548,172.31.47.0-255,66,75341,96,190298
38681,0.001569,74.125.24.0-255,1484,76825,96,190298
38682,0.001574,74.125.24.0-255,4320,81145,96,190298
38683,0.001576,172.31.47.0-255,66,81211,96,190298
38684,0.00158,74.125.24.0-255,2184,83395,96,190298
38685,0.001582,172.31.47.0-255,66,83461,96,190298
38686,0.00162,74.125.24.0-255,2902,86363,96,190298
38687,0.001622,172.31.47.0-255,66,86429,96,190298
38688,0.001652,74.125.24.0-255,7156,93585,96,190298
38689,0.001655,172.31.47.0-255,66,93651,96,190298
38690,0.001678,74.125.24.0-255,1484,95135,96,190298
38691,0.001682,74.125.24.0-255,2902,98037,96,190298
38692,0.001684,172.31.47.0-255,66,98103,96,190298
38693,0.00169,74.125.24.0-255,5738,103841,96,190298
38694,0.001692,172.31.47.0-255,66,103907,96,190298
38695,0.001694,74.125.24.0-255,1484,105391,96,190298
38696,0.001713,74.125.24.0-255,2902,108293,96,190298
38697,0.001714,172.31.47.0-255,66,108359,96,190298
38698,0.001741,74.125.24.0-255,5738,114097,96,190298
38699,0.001745,74.125.24.0-255,3602,117699,96,190298
38700,0.001749,172.31.47.0-255,66,117765,96,190298
38701,0.001752,172.31.47.0-255,66,117831,96,190298
38702,0.001911,74.125.24.0-255,1484,119315,96,190298
38703,0.001916,74.125.24.0-255,2902,122217,96,190298
38704,0.001919,172.31.47.0-255,66,122283,96,190298
38705,0.001941,74.125.24.0-255,5738,128021,96,190298
38706,0.001943,172.31.47.0-255,66,128087,96,190298
38707,0.001949,74.125.24.0-255,5738,133825,96,190298
38708,0.00195,172.31.47.0-255,66,133891,96,190298
38709,0.001983,172.31.47.0-255,66,133957,96,190298
38710,0.002017,74.125.24.0-255,5020,138977,96,190298
38711,0.002022,172.31.47.0-255,66,139043,96,190298
38712,0.002097,74.125.24.0-255,1484,140527,96,190298
38713,0.00211,74.125.24.0-255,2902,143429,96,190298
38714,0.002114,172.31.47.0-255,66,143495,96,190298
38715,0.002121,74.125.24.0-255,5738,149233,96,190298
38716,0.002123,172.31.47.0-255,66,149299,96,190298
38717,0.002191,172.31.47.0-255,66,149365,96,190298
38718,0.002204,172.31.47.0-255,66,149431,96,190298
38719,0.00221,74.125.24.0-255,7156,156587,96,190298
38720,0.002212,172.31.47.0-255,66,156653,96,190298
38721,0.002248,74.125.24.0-255,7156,163809,96,190298
38722,0.00225,172.31.47.0-255,66,163875,96,190298
38723,0.002266,172.31.47.0-255,66,163941,96,190298
38724,0.002271,74.125.24.0-255,3602,167543,96,190298
38725,0.002278,172.31.47.0-255,66,167609,96,190298
38726,0.002309,74.125.24.0-255,4320,171929,96,190298
38727,0.002312,172.31.47.0-255,66,171995,96,190298
38728,0.002355,74.125.24.0-255,2902,174897,96,190298
38729,0.002391,74.125.24.0-255,5020,179917,96,190298
38730,0.00246,74.125.24.0-255,4320,184237,96,190298
38731,0.002521,74.125.24.0-255,1422,185659,96,190298
38732,0.002524,74.125.24.0-255,105,185764,96,190298
38733,0.006741,172.31.47.0-255,66,185830,96,190298
38734,0.008398,172.31.47.0-255,105,185935,96,190298
38735,0.010906,74.125.24.0-255,66,186001,96,190298
38736,0.02755,172.31.47.0-255,172,186173,96,190298
38737,0.027581,172.31.47.0-255,1109,187282,96,190298
38738,0.027632,172.31.47.0-255,1514,188796,96,190298
38739,0.027651,172.31.47.0-255,1304,190100,96,190298
38740,0.029033,104.244.42.0-255,66,190166,96,190298
38741,0.029065,104.244.42.0-255,66,190232,96,190298
38742,0.029132,104.244.42.0-255,66,190298,96,190298
38743,0.0,172.217.194.0-255,153,153,96,223379
38744,3.3e-05,172.31.47.0-255,66,219,96,223379
38745,4e-05,172.217.194.0-255,1484,1703,96,223379
38746,4.5e-05,172.31.47.0-255,66,1769,96,223379
38747,5e-05,172.217.194.0-255,2902,4671,96,223379
38748,5.4e-05,172.31.47.0-255,66,4737,96,223379
38749,6.2e-05,172.217.194.0-255,7156,11893,96,223379
38750,6.5e-05,172.31.47.0-255,66,11959,96,223379
38751,7e-05,172.217.194.0-255,3536,15495,96,223379
38752,7.2e-05,172.31.47.0-255,66,15561,96,223379
38753,8.6e-05,172.31.47.0-255,66,15627,96,223379
38754,8.9e-05,172.217.194.0-255,2543,18170,96,223379
38755,9.2e-05,172.31.47.0-255,66,18236,96,223379
38756,0.000138,172.217.194.0-255,1484,19720,96,223379
38757,0.000141,172.31.47.0-255,66,19786,96,223379
38758,0.000147,172.217.194.0-255,2902,22688,96,223379
38759,0.00015,172.31.47.0-255,66,22754,96,223379
38760,0.000154,172.217.194.0-255,1484,24238,96,223379
38761,0.000155,172.31.47.0-255,66,24304,96,223379
38762,0.000183,172.217.194.0-255,4320,28624,96,223379
38763,0.000186,172.31.47.0-255,66,28690,96,223379
38764,0.000195,172.217.194.0-255,7156,35846,96,223379
38765,0.000197,172.31.47.0-255,66,35912,96,223379
38766,0.00023,172.217.194.0-255,6797,42709,96,223379
38767,0.000232,172.31.47.0-255,66,42775,96,223379
38768,0.000243,172.31.47.0-255,66,42841,96,223379
38769,0.000246,172.217.194.0-255,1417,44258,96,223379
38770,0.000249,172.31.47.0-255,66,44324,96,223379
38771,0.000513,172.217.194.0-255,365,44689,96,223379
38772,0.000517,172.31.47.0-255,66,44755,96,223379
38773,0.000756,172.217.194.0-255,1484,46239,96,223379
38774,0.000762,172.217.194.0-255,2902,49141,96,223379
38775,0.000765,172.31.47.0-255,66,49207,96,223379
38776,0.00077,172.217.194.0-255,2902,52109,96,223379
38777,0.000781,172.31.47.0-255,66,52175,96,223379
38778,0.000783,172.217.194.0-255,2902,55077,96,223379
38779,0.000786,172.217.194.0-255,1484,56561,96,223379
38780,0.000803,172.31.47.0-255,66,56627,96,223379
38781,0.000827,172.217.194.0-255,7156,63783,96,223379
38782,0.000831,172.31.47.0-255,66,63849,96,223379
38783,0.000845,172.217.194.0-255,4320,68169,96,223379
38784,0.00085,172.31.47.0-255,66,68235,96,223379
38785,0.000856,172.217.194.0-255,2184,70419,96,223379
38786,0.000856,172.31.47.0-255,66,70485,96,223379
38787,0.000871,172.31.47.0-255,66,70551,96,223379
38788,0.001081,172.217.194.0-255,1484,72035,96,223379
38789,0.001089,172.217.194.0-255,2902,74937,96,223379
38790,0.001092,172.31.47.0-255,66,75003,96,223379
38791,0.001112,172.217.194.0-255,5738,80741,96,223379
38792,0.001205,172.217.194.0-255,4320,85061,96,223379
38793,0.001222,172.217.194.0-255,6438,91499,96,223379
38794,0.001251,172.217.194.0-255,1484,92983,96,223379
38795,0.001278,172.217.194.0-255,1484,94467,96,223379
38796,0.001304,172.217.194.0-255,4320,98787,96,223379
38797,0.001334,172.217.194.0-255,6438,105225,96,223379
38798,0.001379,172.217.194.0-255,4320,109545,96,223379
38799,0.001443,172.217.194.0-255,5020,114565,96,223379
38800,0.001501,172.217.194.0-255,1484,116049,96,223379
38801,0.001514,172.217.194.0-255,2902,118951,96,223379
38802,0.001537,172.217.194.0-255,5738,124689,96,223379
38803,0.001551,172.217.194.0-255,1484,126173,96,223379
38804,0.001627,172.217.194.0-255,1484,127657,96,223379
38805,0.001629,172.217.194.0-255,1484,129141,96,223379
38806,0.001641,172.217.194.0-255,1484,130625,96,223379
38807,0.001655,172.217.194.0-255,2902,133527,96,223379
38808,0.001669,172.217.194.0-255,2902,136429,96,223379
38809,0.001671,172.217.194.0-255,1484,137913,96,223379
38810,0.001685,172.217.194.0-255,7156,145069,96,223379
38811,0.001731,172.217.194.0-255,1484,146553,96,223379
38812,0.001848,172.217.194.0-255,1484,148037,96,223379
38813,0.001863,172.217.194.0-255,2902,150939,96,223379
38814,0.001888,172.217.194.0-255,5738,156677,96,223379
38815,0.001892,172.217.194.0-255,4320,160997,96,223379
38816,0.001906,172.217.194.0-255,5738,166735,96,223379
38817,0.001919,172.217.194.0-255,5738,172473,96,223379
38818,0.001938,172.217.194.0-255,5738,178211,96,223379
38819,0.001948,172.217.194.0-255,2184,180395,96,223379
38820,0.001983,172.217.194.0-255,1484,181879,96,223379
38821,0.001986,172.217.194.0-255,1484,183363,96,223379
38822,0.001994,172.217.194.0-255,1484,184847,96,223379
38823,0.002007,172.217.194.0-255,5738,190585,96,223379
38824,0.00204,172.217.194.0-255,4320,194905,96,223379
38825,0.002057,172.217.194.0-255,5738,200643,96,223379
38826,0.002097,172.217.194.0-255,7156,207799,96,223379
38827,0.002129,172.217.194.0-255,2902,210701,96,223379
38828,0.002178,172.217.194.0-255,3602,214303,96,223379
38829,0.002209,172.217.194.0-255,4320,218623,96,223379
38830,0.002241,172.217.194.0-255,105,218728,96,223379
38831,0.009928,172.217.194.0-255,105,218833,96,223379
38832,0.009954,172.31.47.0-255,78,218911,96,223379
38833,0.014261,172.31.47.0-255,105,219016,96,223379
38834,0.016491,172.217.194.0-255,66,219082,96,223379
38835,0.046176,172.31.47.0-255,172,219254,96,223379
38836,0.046209,172.31.47.0-255,1101,220355,96,223379
38837,0.046237,172.31.47.0-255,1514,221869,96,223379
38838,0.046238,172.31.47.0-255,1312,223181,96,223379
38839,0.047751,104.244.42.0-255,66,223247,96,223379
38840,0.047869,104.244.42.0-255,66,223313,96,223379
38841,0.047875,104.244.42.0-255,66,223379,96,223379
38842,0.0,172.217.27.0-255,153,153,96,331023
38843,2.2e-05,172.31.47.0-255,66,219,96,331023
38844,2.9e-05,172.217.27.0-255,1484,1703,96,331023
38845,3.4e-05,172.31.47.0-255,66,1769,96,331023
38846,3.9e-05,172.217.27.0-255,2902,4671,96,331023
38847,4.1e-05,172.31.47.0-255,66,4737,96,331023
38848,4.9e-05,172.217.27.0-255,7156,11893,96,331023
38849,5.3e-05,172.31.47.0-255,66,11959,96,331023
38850,5.7e-05,172.217.27.0-255,2097,14056,96,331023
38851,5.9e-05,172.31.47.0-255,66,14122,96,331023
38852,0.000154,172.217.27.0-255,1484,15606,96,331023
38853,0.000157,172.31.47.0-255,66,15672,96,331023
38854,0.000162,172.217.27.0-255,2902,18574,96,331023
38855,0.000165,172.31.47.0-255,66,18640,96,331023
38856,0.000168,172.217.27.0-255,1484,20124,96,331023
38857,0.00017,172.31.47.0-255,66,20190,96,331023
38858,0.000185,172.217.27.0-255,2902,23092,96,331023
38859,0.000188,172.31.47.0-255,66,23158,96,331023
38860,0.000194,172.217.27.0-255,5738,28896,96,331023
38861,0.000197,172.31.47.0-255,66,28962,96,331023
38862,0.000233,172.217.27.0-255,2902,31864,96,331023
38863,0.000236,172.31.47.0-255,66,31930,96,331023
38864,0.000258,172.217.27.0-255,5379,37309,96,331023
38865,0.000261,172.31.47.0-255,66,37375,96,331023
38866,0.000272,172.31.47.0-255,66,37441,96,331023
38867,0.000295,172.217.27.0-255,2543,39984,96,331023
38868,0.000298,172.31.47.0-255,66,40050,96,331023
38869,0.000328,172.217.27.0-255,1484,41534,96,331023
38870,0.000331,172.31.47.0-255,66,41600,96,331023
38871,0.000356,172.217.27.0-255,2902,44502,96,331023
38872,0.000359,172.31.47.0-255,66,44568,96,331023
38873,0.000365,172.217.27.0-255,5738,50306,96,331023
38874,0.000368,172.31.47.0-255,66,50372,96,331023
38875,0.000371,172.217.27.0-255,1484,51856,96,331023
38876,0.000373,172.31.47.0-255,66,51922,96,331023
38877,0.000378,172.217.27.0-255,2902,54824,96,331023
38878,0.000405,172.217.27.0-255,2543,57367,96,331023
38879,0.000488,172.31.47.0-255,66,57433,96,331023
38880,0.000721,172.217.27.0-255,646,58079,96,331023
38881,0.001197,172.217.27.0-255,1484,59563,96,331023
38882,0.001201,172.31.47.0-255,66,59629,96,331023
38883,0.001207,172.217.27.0-255,2902,62531,96,331023
38884,0.00121,172.217.27.0-255,1484,64015,96,331023
38885,0.001216,172.31.47.0-255,66,64081,96,331023
38886,0.001225,172.217.27.0-255,4320,68401,96,331023
38887,0.001228,172.217.27.0-255,1484,69885,96,331023
38888,0.00123,172.31.47.0-255,66,69951,96,331023
38889,0.001257,172.217.27.0-255,5738,75689,96,331023
38890,0.00126,172.217.27.0-255,1484,77173,96,331023
38891,0.001263,172.31.47.0-255,66,77239,96,331023
38892,0.001271,172.217.27.0-255,2902,80141,96,331023
38893,0.00128,172.31.47.0-255,66,80207,96,331023
38894,0.001294,172.217.27.0-255,2184,82391,96,331023
38895,0.001305,172.31.47.0-255,66,82457,96,331023
38896,0.001519,172.217.27.0-255,1484,83941,96,331023
38897,0.001524,172.31.47.0-255,66,84007,96,331023
38898,0.001529,172.217.27.0-255,2902,86909,96,331023
38899,0.001531,172.31.47.0-255,66,86975,96,331023
38900,0.001535,172.217.27.0-255,1484,88459,96,331023
38901,0.001537,172.31.47.0-255,66,88525,96,331023
38902,0.00156,172.217.27.0-255,4320,92845,96,331023
38903,0.001565,172.217.27.0-255,2902,95747,96,331023
38904,0.001569,172.31.47.0-255,66,95813,96,331023
38905,0.001601,172.31.47.0-255,66,95879,96,331023
38906,0.001614,172.31.47.0-255,66,95945,96,331023
38907,0.001622,172.217.27.0-255,2184,98129,96,331023
38908,0.001627,172.31.47.0-255,66,98195,96,331023
38909,0.003232,172.217.27.0-255,5738,103933,96,331023
38910,0.003239,172.31.47.0-255,66,103999,96,331023
38911,0.004845,172.217.27.0-255,4320,108319,96,331023
38912,0.004856,172.217.27.0-255,1484,109803,96,331023
38913,0.007511,172.31.47.0-255,66,109869,96,331023
38914,0.00913,172.217.27.0-255,5738,115607,96,331023
38915,0.009137,172.31.47.0-255,66,115673,96,331023
38916,0.01077,172.217.27.0-255,5738,121411,96,331023
38917,0.010776,172.31.47.0-255,66,121477,96,331023
38918,0.012409,172.217.27.0-255,5738,127215,96,331023
38919,0.012415,172.31.47.0-255,66,127281,96,331023
38920,0.014043,172.217.27.0-255,5738,133019,96,331023
38921,0.014051,172.31.47.0-255,66,133085,96,331023
38922,0.015702,172.217.27.0-255,5738,138823,96,331023
38923,0.015707,172.31.47.0-255,66,138889,96,331023
38924,0.017334,172.217.27.0-255,5738,144627,96,331023
38925,0.017343,172.31.47.0-255,66,144693,96,331023
38926,0.01897,172.217.27.0-255,5738,150431,96,331023
38927,0.018977,172.31.47.0-255,66,150497,96,331023
38928,0.02059,172.217.27.0-255,5738,156235,96,331023
38929,0.020596,172.31.47.0-255,66,156301,96,331023
38930,0.022209,172.217.27.0-255,5738,162039,96,331023
38931,0.022215,172.31.47.0-255,66,162105,96,331023
38932,0.023843,172.217.27.0-255,5738,167843,96,331023
38933,0.023849,172.31.47.0-255,66,167909,96,331023
38934,0.025465,172.217.27.0-255,5738,173647,96,331023
38935,0.02547,172.31.47.0-255,66,173713,96,331023
38936,0.027095,172.217.27.0-255,4320,178033,96,331023
38937,0.027096,172.31.47.0-255,171,178204,96,331023
38938,0.027099,172.31.47.0-255,66,178270,96,331023
38939,0.027115,172.217.27.0-255,1484,179754,96,331023
38940,0.027118,172.31.47.0-255,1129,180883,96,331023
38941,0.02717,172.31.47.0-255,1514,182397,96,331023
38942,0.027172,172.31.47.0-255,1282,183679,96,331023
38943,0.028647,104.244.42.0-255,66,183745,96,331023
38944,0.028681,104.244.42.0-255,66,183811,96,331023
38945,0.028715,172.217.27.0-255,4320,188131,96,331023
38946,0.028721,172.31.47.0-255,66,188197,96,331023
38947,0.02874,104.244.42.0-255,66,188263,96,331023
38948,0.030336,172.217.27.0-255,4320,192583,96,331023
38949,0.030342,172.31.47.0-255,66,192649,96,331023
38950,0.030377,172.217.27.0-255,1484,194133,96,331023
38951,0.03195,172.217.27.0-255,2902,197035,96,331023
38952,0.031955,172.31.47.0-255,66,197101,96,331023
38953,0.031982,172.217.27.0-255,1484,198585,96,331023
38954,0.033561,172.217.27.0-255,4320,202905,96,331023
38955,0.033606,172.31.47.0-255,66,202971,96,331023
38956,0.03522,172.217.27.0-255,5738,208709,96,331023
38957,0.035272,172.31.47.0-255,66,208775,96,331023
38958,0.036906,172.217.27.0-255,5738,214513,96,331023
38959,0.036911,172.31.47.0-255,66,214579,96,331023
38960,0.038537,172.217.27.0-255,5738,220317,96,331023
38961,0.038541,172.31.47.0-255,66,220383,96,331023
38962,0.040153,172.217.27.0-255,5738,226121,96,331023
38963,0.040159,172.31.47.0-255,66,226187,96,331023
38964,0.041786,172.217.27.0-255,5738,231925,96,331023
38965,0.041791,172.31.47.0-255,66,231991,96,331023
38966,0.043416,172.217.27.0-255,4320,236311,96,331023
38967,0.043421,172.31.47.0-255,66,236377,96,331023
38968,0.043443,172.217.27.0-255,1484,237861,96,331023
38969,0.045034,172.217.27.0-255,4320,242181,96,331023
38970,0.04504,172.31.47.0-255,66,242247,96,331023
38971,0.046652,172.217.27.0-255,5738,247985,96,331023
38972,0.0467,172.31.47.0-255,66,248051,96,331023
38973,0.048306,172.217.27.0-255,1484,249535,96,331023
38974,0.048311,172.31.47.0-255,66,249601,96,331023
38975,0.048339,172.217.27.0-255,4320,253921,96,331023
38976,0.048354,172.31.47.0-255,66,253987,96,331023
38977,0.049925,172.217.27.0-255,1484,255471,96,331023
38978,0.049958,172.217.27.0-255,4320,259791,96,331023
38979,0.049984,172.31.47.0-255,66,259857,96,331023
38980,0.051596,172.217.27.0-255,2902,262759,96,331023
38981,0.051601,172.31.47.0-255,66,262825,96,331023
38982,0.05163,172.217.27.0-255,2902,265727,96,331023
38983,0.051649,172.31.47.0-255,66,265793,96,331023
38984,0.053207,172.217.27.0-255,2902,268695,96,331023
38985,0.053212,172.31.47.0-255,66,268761,96,331023
38986,0.05325,172.217.27.0-255,2902,271663,96,331023
38987,0.053256,172.31.47.0-255,66,271729,96,331023
38988,0.054831,172.217.27.0-255,2902,274631,96,331023
38989,0.054842,172.31.47.0-255,66,274697,96,331023
38990,0.05486,172.217.27.0-255,2902,277599,96,331023
38991,0.054902,172.31.47.0-255,66,277665,96,331023
38992,0.056465,172.217.27.0-255,2902,280567,96,331023
38993,0.05647,172.31.47.0-255,66,280633,96,331023
38994,0.056503,172.217.27.0-255,2902,283535,96,331023
38995,0.056522,172.31.47.0-255,66,283601,96,331023
38996,0.058083,172.217.27.0-255,2902,286503,96,331023
38997,0.058089,172.31.47.0-255,66,286569,96,331023
38998,0.058125,172.217.27.0-255,2902,289471,96,331023
38999,0.058139,172.31.47.0-255,66,289537,96,331023
39000,0.059701,172.217.27.0-255,2902,292439,96,331023
39001,0.059707,172.31.47.0-255,66,292505,96,331023
39002,0.059747,172.217.27.0-255,2902,295407,96,331023
39003,0.059771,172.31.47.0-255,66,295473,96,331023
39004,0.061318,172.217.27.0-255,2902,298375,96,331023
39005,0.061322,172.31.47.0-255,66,298441,96,331023
39006,0.061389,172.217.27.0-255,2902,301343,96,331023
39007,0.061439,172.31.47.0-255,66,301409,96,331023
39008,0.062933,172.217.27.0-255,2902,304311,96,331023
39009,0.062938,172.31.47.0-255,66,304377,96,331023
39010,0.063055,172.217.27.0-255,2902,307279,96,331023
39011,0.063126,172.31.47.0-255,66,307345,96,331023
39012,0.064552,172.217.27.0-255,2902,310247,96,331023
39013,0.064556,172.31.47.0-255,66,310313,96,331023
39014,0.064736,172.217.27.0-255,2902,313215,96,331023
39015,0.064837,172.31.47.0-255,66,313281,96,331023
39016,0.066162,172.217.27.0-255,2902,316183,96,331023
39017,0.066166,172.31.47.0-255,66,316249,96,331023
39018,0.066481,172.217.27.0-255,2902,319151,96,331023
39019,0.066486,172.31.47.0-255,66,319217,96,331023
39020,0.067789,172.217.27.0-255,2902,322119,96,331023
39021,0.067793,172.31.47.0-255,66,322185,96,331023
39022,0.068084,172.217.27.0-255,2902,325087,96,331023
39023,0.068089,172.31.47.0-255,66,325153,96,331023
39024,0.069445,172.217.27.0-255,2902,328055,96,331023
39025,0.069451,172.31.47.0-255,66,328121,96,331023
39026,0.069691,172.217.27.0-255,2902,331023,96,331023
39027,0.0,216.58.203.0-255,153,153,96,311099
39028,2.4e-05,172.31.47.0-255,66,219,96,311099
39029,3e-05,216.58.203.0-255,1484,1703,96,311099
39030,3.3e-05,172.31.47.0-255,66,1769,96,311099
39031,3.8e-05,216.58.203.0-255,2902,4671,96,311099
39032,4e-05,172.31.47.0-255,66,4737,96,311099
39033,7.2e-05,216.58.203.0-255,5738,10475,96,311099
39034,7.4e-05,172.31.47.0-255,66,10541,96,311099
39035,8.5e-05,216.58.203.0-255,1484,12025,96,311099
39036,8.7e-05,172.31.47.0-255,66,12091,96,311099
39037,0.000195,216.58.203.0-255,1973,14064,96,311099
39038,0.000198,172.31.47.0-255,66,14130,96,311099
39039,0.000226,216.58.203.0-255,1484,15614,96,311099
39040,0.000229,172.31.47.0-255,66,15680,96,311099
39041,0.000263,216.58.203.0-255,5738,21418,96,311099
39042,0.000267,172.31.47.0-255,66,21484,96,311099
39043,0.000349,216.58.203.0-255,2902,24386,96,311099
39044,0.000353,172.31.47.0-255,66,24452,96,311099
39045,0.000373,216.58.203.0-255,6797,31249,96,311099
39046,0.000376,172.31.47.0-255,66,31315,96,311099
39047,0.000522,216.58.203.0-255,1484,32799,96,311099
39048,0.000526,172.31.47.0-255,66,32865,96,311099
39049,0.000556,216.58.203.0-255,2902,35767,96,311099
39050,0.00056,172.31.47.0-255,66,35833,96,311099
39051,0.000598,216.58.203.0-255,2902,38735,96,311099
39052,0.000601,172.31.47.0-255,66,38801,96,311099
39053,0.000618,216.58.203.0-255,2902,41703,96,311099
39054,0.000621,172.31.47.0-255,66,41769,96,311099
39055,0.000709,216.58.203.0-255,5738,47507,96,311099
39056,0.000713,172.31.47.0-255,66,47573,96,311099
39057,0.000732,172.31.47.0-255,66,47639,96,311099
39058,0.000945,216.58.203.0-255,5738,53377,96,311099
39059,0.000949,172.31.47.0-255,66,53443,96,311099
39060,0.00097,216.58.203.0-255,4270,57713,96,311099
39061,0.00129,216.58.203.0-255,1484,59197,96,311099
39062,0.001324,216.58.203.0-255,2543,61740,96,311099
39063,0.001515,216.58.203.0-255,4320,66060,96,311099
39064,0.001936,216.58.203.0-255,2902,68962,96,311099
39065,0.001956,216.58.203.0-255,7156,76118,96,311099
39066,0.00211,216.58.203.0-255,4320,80438,96,311099
39067,0.002126,216.58.203.0-255,5738,86176,96,311099
39068,0.002136,216.58.203.0-255,2184,88360,96,311099
39069,0.002335,216.58.203.0-255,4320,92680,96,311099
39070,0.003128,172.31.47.0-255,66,92746,96,311099
39071,0.004786,216.58.203.0-255,4320,97066,96,311099
39072,0.004791,172.31.47.0-255,66,97132,96,311099
39073,0.004806,216.58.203.0-255,1484,98616,96,311099
39074,0.006449,216.58.203.0-255,4320,102936,96,311099
39075,0.006456,172.31.47.0-255,66,103002,96,311099
39076,0.00811,216.58.203.0-255,5738,108740,96,311099
39077,0.011256,172.31.47.0-255,66,108806,96,311099
39078,0.012928,216.58.203.0-255,5738,114544,96,311099
39079,0.01294,172.31.47.0-255,66,114610,96,311099
39080,0.014592,216.58.203.0-255,4320,118930,96,311099
39081,0.014597,172.31.47.0-255,66,118996,96,311099
39082,0.014628,216.58.203.0-255,1484,120480,96,311099
39083,0.016257,216.58.203.0-255,4320,124800,96,311099
39084,0.016264,172.31.47.0-255,66,124866,96,311099
39085,0.017917,216.58.203.0-255,5738,130604,96,311099
39086,0.01796,172.31.47.0-255,66,130670,96,311099
39087,0.019645,216.58.203.0-255,5738,136408,96,311099
39088,0.019652,172.31.47.0-255,66,136474,96,311099
39089,0.021323,216.58.203.0-255,5738,142212,96,311099
39090,0.02133,172.31.47.0-255,66,142278,96,311099
39091,0.02299,216.58.203.0-255,5738,148016,96,311099
39092,0.022997,172.31.47.0-255,66,148082,96,311099
39093,0.024669,216.58.203.0-255,5738,153820,96,311099
39094,0.024676,172.31.47.0-255,66,153886,96,311099
39095,0.026243,172.31.47.0-255,172,154058,96,311099
39096,0.026271,172.31.47.0-255,1111,155169,96,311099
39097,0.026314,172.31.47.0-255,1514,156683,96,311099
39098,0.026315,172.31.47.0-255,1302,157985,96,311099
39099,0.026335,216.58.203.0-255,5738,163723,96,311099
39100,0.026339,172.31.47.0-255,66,163789,96,311099
39101,0.027765,104.244.42.0-255,66,163855,96,311099
39102,0.027804,104.244.42.0-255,66,163921,96,311099
39103,0.027852,104.244.42.0-255,66,163987,96,311099
39104,0.027983,216.58.203.0-255,5738,169725,96,311099
39105,0.027987,172.31.47.0-255,66,169791,96,311099
39106,0.029644,216.58.203.0-255,5738,175529,96,311099
39107,0.029649,172.31.47.0-255,66,175595,96,311099
39108,0.031305,216.58.203.0-255,5738,181333,96,311099
39109,0.03131,172.31.47.0-255,66,181399,96,311099
39110,0.032968,216.58.203.0-255,5738,187137,96,311099
39111,0.032973,172.31.47.0-255,66,187203,96,311099
39112,0.03462,216.58.203.0-255,5738,192941,96,311099
39113,0.034625,172.31.47.0-255,66,193007,96,311099
39114,0.036284,216.58.203.0-255,5738,198745,96,311099
39115,0.03629,172.31.47.0-255,66,198811,96,311099
39116,0.037943,216.58.203.0-255,5738,204549,96,311099
39117,0.037948,172.31.47.0-255,66,204615,96,311099
39118,0.039599,216.58.203.0-255,5738,210353,96,311099
39119,0.039603,172.31.47.0-255,66,210419,96,311099
39120,0.041257,216.58.203.0-255,5738,216157,96,311099
39121,0.041262,172.31.47.0-255,66,216223,96,311099
39122,0.042917,216.58.203.0-255,5738,221961,96,311099
39123,0.042922,172.31.47.0-255,66,222027,96,311099
39124,0.044574,216.58.203.0-255,4320,226347,96,311099
39125,0.044578,172.31.47.0-255,66,226413,96,311099
39126,0.044601,216.58.203.0-255,1484,227897,96,311099
39127,0.046238,216.58.203.0-255,4320,232217,96,311099
39128,0.046243,172.31.47.0-255,66,232283,96,311099
39129,0.04789,216.58.203.0-255,4320,236603,96,311099
39130,0.047894,172.31.47.0-255,66,236669,96,311099
39131,0.047917,216.58.203.0-255,1484,238153,96,311099
39132,0.049541,216.58.203.0-255,4320,242473,96,311099
39133,0.049546,172.31.47.0-255,66,242539,96,311099
39134,0.051199,216.58.203.0-255,5738,248277,96,311099
39135,0.051239,172.31.47.0-255,66,248343,96,311099
39136,0.052896,216.58.203.0-255,4320,252663,96,311099
39137,0.052901,172.31.47.0-255,66,252729,96,311099
39138,0.052927,216.58.203.0-255,1484,254213,96,311099
39139,0.054553,216.58.203.0-255,4320,258533,96,311099
39140,0.054558,172.31.47.0-255,66,258599,96,311099
39141,0.056207,216.58.203.0-255,5738,264337,96,311099
39142,0.056248,172.31.47.0-255,66,264403,96,311099
39143,0.057907,216.58.203.0-255,5738,270141,96,311099
39144,0.057912,172.31.47.0-255,66,270207,96,311099
39145,0.059568,216.58.203.0-255,5738,275945,96,311099
39146,0.059574,172.31.47.0-255,66,276011,96,311099
39147,0.061257,216.58.203.0-255,5738,281749,96,311099
39148,0.061262,172.31.47.0-255,66,281815,96,311099
39149,0.062913,216.58.203.0-255,5738,287553,96,311099
39150,0.062919,172.31.47.0-255,66,287619,96,311099
39151,0.064577,216.58.203.0-255,5738,293357,96,311099
39152,0.064582,172.31.47.0-255,66,293423,96,311099
39153,0.066239,216.58.203.0-255,5738,299161,96,311099
39154,0.066245,172.31.47.0-255,66,299227,96,311099
39155,0.067893,216.58.203.0-255,2902,302129,96,311099
39156,0.067897,172.31.47.0-255,66,302195,96,311099
39157,0.06792,216.58.203.0-255,2902,305097,96,311099
39158,0.067939,172.31.47.0-255,66,305163,96,311099
39159,0.06955,216.58.203.0-255,2902,308065,96,311099
39160,0.069554,172.31.47.0-255,66,308131,96,311099
39161,0.069579,216.58.203.0-255,2902,311033,96,311099
39162,0.0696,172.31.47.0-255,66,311099,96,311099
39163,0.0,74.125.68.0-255,153,153,96,277888
39164,1.8e-05,172.31.47.0-255,66,219,96,277888
39165,2.5e-05,74.125.68.0-255,1484,1703,96,277888
39166,3e-05,172.31.47.0-255,66,1769,96,277888
39167,9.9e-05,74.125.68.0-255,2902,4671,96,277888
39168,0.000103,172.31.47.0-255,66,4737,96,277888
39169,0.000109,74.125.68.0-255,5738,10475,96,277888
39170,0.000111,172.31.47.0-255,66,10541,96,277888
39171,0.000152,74.125.68.0-255,3554,14095,96,277888
39172,0.000156,172.31.47.0-255,66,14161,96,277888
39173,0.000376,74.125.68.0-255,1484,15645,96,277888
39174,0.000383,172.31.47.0-255,66,15711,96,277888
39175,0.000389,74.125.68.0-255,2902,18613,96,277888
39176,0.000393,172.31.47.0-255,66,18679,96,277888
39177,0.000421,74.125.68.0-255,5738,24417,96,277888
39178,0.000425,172.31.47.0-255,66,24483,96,277888
39179,0.000452,74.125.68.0-255,1484,25967,96,277888
39180,0.000455,172.31.47.0-255,66,26033,96,277888
39181,0.000484,74.125.68.0-255,5379,31412,96,277888
39182,0.000487,172.31.47.0-255,66,31478,96,277888
39183,0.00065,74.125.68.0-255,1484,32962,96,277888
39184,0.000655,172.31.47.0-255,66,33028,96,277888
39185,0.000664,74.125.68.0-255,2902,35930,96,277888
39186,0.000666,172.31.47.0-255,66,35996,96,277888
39187,0.000705,74.125.68.0-255,5738,41734,96,277888
39188,0.000708,172.31.47.0-255,66,41800,96,277888
39189,0.000713,74.125.68.0-255,2902,44702,96,277888
39190,0.000716,172.31.47.0-255,66,44768,96,277888
39191,0.000747,74.125.68.0-255,4320,49088,96,277888
39192,0.00075,172.31.47.0-255,66,49154,96,277888
39193,0.000784,74.125.68.0-255,6797,55951,96,277888
39194,0.000787,172.31.47.0-255,66,56017,96,277888
39195,0.000816,172.31.47.0-255,66,56083,96,277888
39196,0.001197,74.125.68.0-255,415,56498,96,277888
39197,0.001462,74.125.68.0-255,328,56826,96,277888
39198,0.001484,74.125.68.0-255,1484,58310,96,277888
39199,0.001488,172.31.47.0-255,66,58376,96,277888
39200,0.001494,74.125.68.0-255,2902,61278,96,277888
39201,0.001497,172.31.47.0-255,66,61344,96,277888
39202,0.00152,74.125.68.0-255,1484,62828,96,277888
39203,0.001525,74.125.68.0-255,2902,65730,96,277888
39204,0.001527,172.31.47.0-255,66,65796,96,277888
39205,0.001531,74.125.68.0-255,2902,68698,96,277888
39206,0.001533,172.31.47.0-255,66,68764,96,277888
39207,0.001565,74.125.68.0-255,5738,74502,96,277888
39208,0.001569,172.31.47.0-255,66,74568,96,277888
39209,0.001585,172.31.47.0-255,66,74634,96,277888
39210,0.001609,74.125.68.0-255,5020,79654,96,277888
39211,0.001611,172.31.47.0-255,66,79720,96,277888
39212,0.00243,74.125.68.0-255,1484,81204,96,277888
39213,0.002468,74.125.68.0-255,2902,84106,96,277888
39214,0.00247,172.31.47.0-255,66,84172,96,277888
39215,0.002526,74.125.68.0-255,2902,87074,96,277888
39216,0.002541,172.31.47.0-255,66,87140,96,277888
39217,0.002565,74.125.68.0-255,4320,91460,96,277888
39218,0.002569,172.31.47.0-255,66,91526,96,277888
39219,0.002572,74.125.68.0-255,1484,93010,96,277888
39220,0.002621,74.125.68.0-255,2902,95912,96,277888
39221,0.002624,172.31.47.0-255,66,95978,96,277888
39222,0.00266,74.125.68.0-255,1484,97462,96,277888
39223,0.002671,74.125.68.0-255,2902,100364,96,277888
39224,0.002674,172.31.47.0-255,66,100430,96,277888
39225,0.002701,74.125.68.0-255,4320,104750,96,277888
39226,0.002704,172.31.47.0-255,66,104816,96,277888
39227,0.00274,172.31.47.0-255,66,104882,96,277888
39228,0.002742,74.125.68.0-255,766,105648,96,277888
39229,0.003057,74.125.68.0-255,1484,107132,96,277888
39230,0.00306,172.31.47.0-255,66,107198,96,277888
39231,0.003065,74.125.68.0-255,2902,110100,96,277888
39232,0.003067,172.31.47.0-255,66,110166,96,277888
39233,0.0031,74.125.68.0-255,1484,111650,96,277888
39234,0.003111,74.125.68.0-255,2902,114552,96,277888
39235,0.003114,172.31.47.0-255,66,114618,96,277888
39236,0.003138,74.125.68.0-255,5738,120356,96,277888
39237,0.00314,172.31.47.0-255,66,120422,96,277888
39238,0.003172,74.125.68.0-255,7156,127578,96,277888
39239,0.003174,172.31.47.0-255,66,127644,96,277888
39240,0.003192,74.125.68.0-255,4320,131964,96,277888
39241,0.003194,172.31.47.0-255,66,132030,96,277888
39242,0.003222,172.31.47.0-255,66,132096,96,277888
39243,0.003433,74.125.68.0-255,1484,133580,96,277888
39244,0.003451,74.125.68.0-255,2902,136482,96,277888
39245,0.003454,172.31.47.0-255,66,136548,96,277888
39246,0.003487,74.125.68.0-255,5738,142286,96,277888
39247,0.00349,172.31.47.0-255,66,142352,96,277888
39248,0.0035,172.31.47.0-255,66,142418,96,277888
39249,0.003567,172.31.47.0-255,66,142484,96,277888
39250,0.003571,74.125.68.0-255,2184,144668,96,277888
39251,0.003572,172.31.47.0-255,66,144734,96,277888
39252,0.00446,74.125.68.0-255,1484,146218,96,277888
39253,0.004468,74.125.68.0-255,2902,149120,96,277888
39254,0.00447,172.31.47.0-255,66,149186,96,277888
39255,0.004496,74.125.68.0-255,5738,154924,96,277888
39256,0.004498,172.31.47.0-255,66,154990,96,277888
39257,0.004501,74.125.68.0-255,2902,157892,96,277888
39258,0.004503,172.31.47.0-255,66,157958,96,277888
39259,0.004505,74.125.68.0-255,1484,159442,96,277888
39260,0.004537,74.125.68.0-255,2902,162344,96,277888
39261,0.004539,172.31.47.0-255,66,162410,96,277888
39262,0.004547,172.31.47.0-255,66,162476,96,277888
39263,0.004554,74.125.68.0-255,2902,165378,96,277888
39264,0.004556,172.31.47.0-255,66,165444,96,277888
39265,0.004579,74.125.68.0-255,2902,168346,96,277888
39266,0.004581,172.31.47.0-255,66,168412,96,277888
39267,0.004604,74.125.68.0-255,5020,173432,96,277888
39268,0.004606,172.31.47.0-255,66,173498,96,277888
39269,0.00461,74.125.68.0-255,2902,176400,96,277888
39270,0.004611,172.31.47.0-255,66,176466,96,277888
39271,0.004633,74.125.68.0-255,2902,179368,96,277888
39272,0.004634,172.31.47.0-255,66,179434,96,277888
39273,0.00467,74.125.68.0-255,7156,186590,96,277888
39274,0.004672,172.31.47.0-255,66,186656,96,277888
39275,0.004688,74.125.68.0-255,5738,192394,96,277888
39276,0.00469,172.31.47.0-255,66,192460,96,277888
39277,0.004707,74.125.68.0-255,4320,196780,96,277888
39278,0.004708,172.31.47.0-255,66,196846,96,277888
39279,0.00474,172.31.47.0-255,66,196912,96,277888
39280,0.004903,74.125.68.0-255,1484,198396,96,277888
39281,0.004916,74.125.68.0-255,2902,201298,96,277888
39282,0.004919,172.31.47.0-255,66,201364,96,277888
39283,0.004932,74.125.68.0-255,2902,204266,96,277888
39284,0.004938,172.31.47.0-255,66,204332,96,277888
39285,0.004965,74.125.68.0-255,2902,207234,96,277888
39286,0.004967,172.31.47.0-255,66,207300,96,277888
39287,0.004973,74.125.68.0-255,5738,213038,96,277888
39288,0.004974,172.31.47.0-255,66,213104,96,277888
39289,0.004985,74.125.68.0-255,7156,220260,96,277888
39290,0.004988,172.31.47.0-255,66,220326,96,277888
39291,0.00503,172.31.47.0-255,66,220392,96,277888
39292,0.005051,74.125.68.0-255,2184,222576,96,277888
39293,0.005053,172.31.47.0-255,66,222642,96,277888
39294,0.005131,74.125.68.0-255,1484,224126,96,277888
39295,0.00514,74.125.68.0-255,2902,227028,96,277888
39296,0.005144,172.31.47.0-255,66,227094,96,277888
39297,0.005154,74.125.68.0-255,5738,232832,96,277888
39298,0.005168,172.31.47.0-255,66,232898,96,277888
39299,0.005174,74.125.68.0-255,2902,235800,96,277888
39300,0.005177,172.31.47.0-255,66,235866,96,277888
39301,0.005239,172.31.47.0-255,66,235932,96,277888
39302,0.005246,74.125.68.0-255,2902,238834,96,277888
39303,0.00525,172.31.47.0-255,66,238900,96,277888
39304,0.005319,172.31.47.0-255,66,238966,96,277888
39305,0.005344,172.31.47.0-255,66,239032,96,277888
39306,0.005351,74.125.68.0-255,4320,243352,96,277888
39307,0.005355,172.31.47.0-255,66,243418,96,277888
39308,0.005359,74.125.68.0-255,1484,244902,96,277888
39309,0.005403,74.125.68.0-255,5738,250640,96,277888
39310,0.005407,172.31.47.0-255,66,250706,96,277888
39311,0.005412,74.125.68.0-255,3602,254308,96,277888
39312,0.005415,172.31.47.0-255,66,254374,96,277888
39313,0.005418,74.125.68.0-255,1484,255858,96,277888
39314,0.005518,74.125.68.0-255,7156,263014,96,277888
39315,0.005522,172.31.47.0-255,66,263080,96,277888
39316,0.005551,172.31.47.0-255,66,263146,96,277888
39317,0.005567,172.31.47.0-255,66,263212,96,277888
39318,0.00557,74.125.68.0-255,766,263978,96,277888
39319,0.005923,74.125.68.0-255,1484,265462,96,277888
39320,0.005926,172.31.47.0-255,66,265528,96,277888
39321,0.005932,74.125.68.0-255,2902,268430,96,277888
39322,0.005934,172.31.47.0-255,66,268496,96,277888
39323,0.005979,74.125.68.0-255,2902,271398,96,277888
39324,0.005983,172.31.47.0-255,66,271464,96,277888
39325,0.006013,74.125.68.0-255,1720,273184,96,277888
39326,0.006016,172.31.47.0-255,66,273250,96,277888
39327,0.006036,74.125.68.0-255,105,273355,96,277888
39328,0.011928,172.31.47.0-255,66,273421,96,277888
39329,0.011957,172.31.47.0-255,105,273526,96,277888
39330,0.014581,74.125.68.0-255,66,273592,96,277888
39331,0.042588,172.31.47.0-255,172,273764,96,277888
39332,0.042615,172.31.47.0-255,1101,274865,96,277888
39333,0.042652,172.31.47.0-255,1514,276379,96,277888
39334,0.042654,172.31.47.0-255,1311,277690,96,277888
39335,0.044128,104.244.42.0-255,66,277756,96,277888
39336,0.044143,104.244.42.0-255,66,277822,96,277888
39337,0.0442,104.244.42.0-255,66,277888,96,277888
39338,0.0,74.125.200.0-255,153,153,96,346882
39339,3.2e-05,172.31.47.0-255,66,219,96,346882
39340,3.9e-05,74.125.200.0-255,1484,1703,96,346882
39341,4.4e-05,172.31.47.0-255,66,1769,96,346882
39342,4.6e-05,74.125.200.0-255,1484,3253,96,346882
39343,4.9e-05,172.31.47.0-255,66,3319,96,346882
39344,5.4e-05,74.125.200.0-255,2902,6221,96,346882
39345,5.7e-05,172.31.47.0-255,66,6287,96,346882
39346,6.3e-05,74.125.200.0-255,5738,12025,96,346882
39347,6.5e-05,172.31.47.0-255,66,12091,96,346882
39348,8.8e-05,74.125.200.0-255,2170,14261,96,346882
39349,9.3e-05,172.31.47.0-255,66,14327,96,346882
39350,0.000131,74.125.200.0-255,2902,17229,96,346882
39351,0.000134,172.31.47.0-255,66,17295,96,346882
39352,0.000156,74.125.200.0-255,4320,21615,96,346882
39353,0.000158,172.31.47.0-255,66,21681,96,346882
39354,0.000184,74.125.200.0-255,4320,26001,96,346882
39355,0.000186,172.31.47.0-255,66,26067,96,346882
39356,0.000203,74.125.200.0-255,2902,28969,96,346882
39357,0.000206,172.31.47.0-255,66,29035,96,346882
39358,0.000244,74.125.200.0-255,2543,31578,96,346882
39359,0.000246,172.31.47.0-255,66,31644,96,346882
39360,0.000369,74.125.200.0-255,1484,33128,96,346882
39361,0.000373,172.31.47.0-255,66,33194,96,346882
39362,0.000392,74.125.200.0-255,2902,36096,96,346882
39363,0.000396,172.31.47.0-255,66,36162,96,346882
39364,0.000421,74.125.200.0-255,4320,40482,96,346882
39365,0.000424,172.31.47.0-255,66,40548,96,346882
39366,0.00044,74.125.200.0-255,4320,44868,96,346882
39367,0.000443,172.31.47.0-255,66,44934,96,346882
39368,0.000467,74.125.200.0-255,3961,48895,96,346882
39369,0.00047,172.31.47.0-255,66,48961,96,346882
39370,0.000481,172.31.47.0-255,66,49027,96,346882
39371,0.000484,74.125.200.0-255,1484,50511,96,346882
39372,0.000486,172.31.47.0-255,66,50577,96,346882
39373,0.00051,74.125.200.0-255,7075,57652,96,346882
39374,0.000512,172.31.47.0-255,66,57718,96,346882
39375,0.000515,74.125.200.0-255,130,57848,96,346882
39376,0.000517,74.125.200.0-255,345,58193,96,346882
39377,0.00083,172.31.47.0-255,66,58259,96,346882
39378,0.000833,74.125.200.0-255,1484,59743,96,346882
39379,0.000851,74.125.200.0-255,2902,62645,96,346882
39380,0.000854,172.31.47.0-255,66,62711,96,346882
39381,0.000874,74.125.200.0-255,5738,68449,96,346882
39382,0.000877,172.31.47.0-255,66,68515,96,346882
39383,0.00093,172.31.47.0-255,66,68581,96,346882
39384,0.000951,74.125.200.0-255,4320,72901,96,346882
39385,0.000955,172.31.47.0-255,66,72967,96,346882
39386,0.000976,74.125.200.0-255,6438,79405,96,346882
39387,0.000978,172.31.47.0-255,66,79471,96,346882
39388,0.001282,74.125.200.0-255,1484,80955,96,346882
39389,0.001292,74.125.200.0-255,2902,83857,96,346882
39390,0.001296,172.31.47.0-255,66,83923,96,346882
39391,0.0013,74.125.200.0-255,1484,85407,96,346882
39392,0.001315,74.125.200.0-255,1484,86891,96,346882
39393,0.001317,172.31.47.0-255,66,86957,96,346882
39394,0.001324,74.125.200.0-255,4320,91277,96,346882
39395,0.001326,172.31.47.0-255,66,91343,96,346882
39396,0.001359,172.31.47.0-255,66,91409,96,346882
39397,0.001364,74.125.200.0-255,2902,94311,96,346882
39398,0.001367,172.31.47.0-255,66,94377,96,346882
39399,0.00137,74.125.200.0-255,1484,95861,96,346882
39400,0.001392,74.125.200.0-255,2902,98763,96,346882
39401,0.001394,172.31.47.0-255,66,98829,96,346882
39402,0.001411,74.125.200.0-255,6438,105267,96,346882
39403,0.001414,172.31.47.0-255,66,105333,96,346882
39404,0.001728,74.125.200.0-255,1484,106817,96,346882
39405,0.001735,74.125.200.0-255,1484,108301,96,346882
39406,0.001739,172.31.47.0-255,66,108367,96,346882
39407,0.00176,74.125.200.0-255,1484,109851,96,346882
39408,0.001766,74.125.200.0-255,5738,115589,96,346882
39409,0.001768,172.31.47.0-255,66,115655,96,346882
39410,0.001772,74.125.200.0-255,2902,118557,96,346882
39411,0.001774,172.31.47.0-255,66,118623,96,346882
39412,0.001781,74.125.200.0-255,4320,122943,96,346882
39413,0.001784,172.31.47.0-255,66,123009,96,346882
39414,0.001788,74.125.200.0-255,4320,127329,96,346882
39415,0.001791,172.31.47.0-255,66,127395,96,346882
39416,0.001814,74.125.200.0-255,4320,131715,96,346882
39417,0.001822,74.125.200.0-255,7156,138871,96,346882
39418,0.001838,74.125.200.0-255,766,139637,96,346882
39419,0.001934,74.125.200.0-255,1484,141121,96,346882
39420,0.001949,74.125.200.0-255,2902,144023,96,346882
39421,0.001975,74.125.200.0-255,2902,146925,96,346882
39422,0.001986,74.125.200.0-255,1484,148409,96,346882
39423,0.001992,74.125.200.0-255,5738,154147,96,346882
39424,0.002032,74.125.200.0-255,2902,157049,96,346882
39425,0.002046,74.125.200.0-255,5020,162069,96,346882
39426,0.004901,172.31.47.0-255,66,162135,96,346882
39427,0.006922,74.125.200.0-255,5738,167873,96,346882
39428,0.00695,172.31.47.0-255,66,167939,96,346882
39429,0.00897,74.125.200.0-255,5738,173677,96,346882
39430,0.008978,172.31.47.0-255,66,173743,96,346882
39431,0.010993,74.125.200.0-255,5738,179481,96,346882
39432,0.011001,172.31.47.0-255,66,179547,96,346882
39433,0.013025,74.125.200.0-255,5738,185285,96,346882
39434,0.013035,172.31.47.0-255,66,185351,96,346882
39435,0.015073,74.125.200.0-255,5738,191089,96,346882
39436,0.015088,172.31.47.0-255,66,191155,96,346882
39437,0.017113,74.125.200.0-255,5738,196893,96,346882
39438,0.017126,172.31.47.0-255,66,196959,96,346882
39439,0.019159,74.125.200.0-255,5738,202697,96,346882
39440,0.019169,172.31.47.0-255,66,202763,96,346882
39441,0.021187,74.125.200.0-255,5738,208501,96,346882
39442,0.021195,172.31.47.0-255,66,208567,96,346882
39443,0.02324,74.125.200.0-255,5738,214305,96,346882
39444,0.023252,172.31.47.0-255,66,214371,96,346882
39445,0.025365,74.125.200.0-255,5738,220109,96,346882
39446,0.025383,172.31.47.0-255,66,220175,96,346882
39447,0.027422,74.125.200.0-255,5738,225913,96,346882
39448,0.027441,172.31.47.0-255,66,225979,96,346882
39449,0.029482,74.125.200.0-255,5738,231717,96,346882
39450,0.029497,172.31.47.0-255,66,231783,96,346882
39451,0.031525,74.125.200.0-255,5738,237521,96,346882
39452,0.031537,172.31.47.0-255,66,237587,96,346882
39453,0.033565,74.125.200.0-255,5738,243325,96,346882
39454,0.033572,172.31.47.0-255,66,243391,96,346882
39455,0.035601,74.125.200.0-255,5738,249129,96,346882
39456,0.035618,172.31.47.0-255,66,249195,96,346882
39457,0.037654,74.125.200.0-255,5738,254933,96,346882
39458,0.037673,172.31.47.0-255,66,254999,96,346882
39459,0.039702,74.125.200.0-255,5738,260737,96,346882
39460,0.039728,172.31.47.0-255,66,260803,96,346882
39461,0.041748,74.125.200.0-255,5738,266541,96,346882
39462,0.041754,172.31.47.0-255,66,266607,96,346882
39463,0.043779,74.125.200.0-255,5738,272345,96,346882
39464,0.043788,172.31.47.0-255,66,272411,96,346882
39465,0.045817,74.125.200.0-255,5738,278149,96,346882
39466,0.045828,172.31.47.0-255,66,278215,96,346882
39467,0.046261,172.31.47.0-255,172,278387,96,346882
39468,0.046288,172.31.47.0-255,1101,279488,96,346882
39469,0.046332,172.31.47.0-255,1514,281002,96,346882
39470,0.046334,172.31.47.0-255,1310,282312,96,346882
39471,0.047789,104.244.42.0-255,66,282378,96,346882
39472,0.047839,74.125.200.0-255,5738,288116,96,346882
39473,0.047847,172.31.47.0-255,66,288182,96,346882
39474,0.047951,104.244.42.0-255,66,288248,96,346882
39475,0.047988,104.244.42.0-255,66,288314,96,346882
39476,0.049892,74.125.200.0-255,5738,294052,96,346882
39477,0.04991,172.31.47.0-255,66,294118,96,346882
39478,0.051944,74.125.200.0-255,5738,299856,96,346882
39479,0.05196,172.31.47.0-255,66,299922,96,346882
39480,0.05398,74.125.200.0-255,5738,305660,96,346882
39481,0.053987,172.31.47.0-255,66,305726,96,346882
39482,0.055995,74.125.200.0-255,5738,311464,96,346882
39483,0.056001,172.31.47.0-255,66,311530,96,346882
39484,0.058053,74.125.200.0-255,5738,317268,96,346882
39485,0.05806,172.31.47.0-255,66,317334,96,346882
39486,0.060074,74.125.200.0-255,5738,323072,96,346882
39487,0.06008,172.31.47.0-255,66,323138,96,346882
39488,0.062092,74.125.200.0-255,2902,326040,96,346882
39489,0.062097,172.31.47.0-255,66,326106,96,346882
39490,0.062127,74.125.200.0-255,2902,329008,96,346882
39491,0.06213,172.31.47.0-255,66,329074,96,346882
39492,0.064103,74.125.200.0-255,2902,331976,96,346882
39493,0.064109,172.31.47.0-255,66,332042,96,346882
39494,0.06414,74.125.200.0-255,2902,334944,96,346882
39495,0.064142,172.31.47.0-255,66,335010,96,346882
39496,0.066118,74.125.200.0-255,2902,337912,96,346882
39497,0.066124,172.31.47.0-255,66,337978,96,346882
39498,0.066152,74.125.200.0-255,2902,340880,96,346882
39499,0.066155,172.31.47.0-255,66,340946,96,346882
39500,0.068132,74.125.200.0-255,2902,343848,96,346882
39501,0.068138,172.31.47.0-255,66,343914,96,346882
39502,0.068171,74.125.200.0-255,2902,346816,96,346882
39503,0.068174,172.31.47.0-255,66,346882,96,346882
39504,0.0,172.31.47.0-255,66,66,96,66
39505,0.0,172.217.194.0-255,146,146,96,260393
39506,2.8e-05,172.31.47.0-255,66,212,96,260393
39507,3.5e-05,172.217.194.0-255,1484,1696,96,260393
39508,3.9e-05,172.31.47.0-255,66,1762,96,260393
39509,4.3e-05,172.217.194.0-255,2902,4664,96,260393
39510,4.5e-05,172.31.47.0-255,66,4730,96,260393
39511,5.8e-05,172.217.194.0-255,7156,11886,96,260393
39512,6e-05,172.31.47.0-255,66,11952,96,260393
39513,8.6e-05,172.217.194.0-255,1987,13939,96,260393
39514,8.8e-05,172.31.47.0-255,66,14005,96,260393
39515,0.000254,172.217.194.0-255,1484,15489,96,260393
39516,0.000259,172.31.47.0-255,66,15555,96,260393
39517,0.000264,172.217.194.0-255,2902,18457,96,260393
39518,0.000266,172.31.47.0-255,66,18523,96,260393
39519,0.00027,172.217.194.0-255,2902,21425,96,260393
39520,0.000277,172.31.47.0-255,66,21491,96,260393
39521,0.000289,172.217.194.0-255,2902,24393,96,260393
39522,0.000291,172.31.47.0-255,66,24459,96,260393
39523,0.000298,172.217.194.0-255,1484,25943,96,260393
39524,0.000301,172.31.47.0-255,66,26009,96,260393
39525,0.00033,172.217.194.0-255,4320,30329,96,260393
39526,0.000333,172.31.47.0-255,66,30395,96,260393
39527,0.000364,172.217.194.0-255,5379,35774,96,260393
39528,0.000367,172.31.47.0-255,66,35840,96,260393
39529,0.000378,172.31.47.0-255,66,35906,96,260393
39530,0.000407,172.217.194.0-255,2543,38449,96,260393
39531,0.00041,172.31.47.0-255,66,38515,96,260393
39532,0.000798,172.217.194.0-255,1484,39999,96,260393
39533,0.000803,172.31.47.0-255,66,40065,96,260393
39534,0.000811,172.217.194.0-255,2902,42967,96,260393
39535,0.000814,172.31.47.0-255,66,43033,96,260393
39536,0.000825,172.217.194.0-255,5738,48771,96,260393
39537,0.000828,172.31.47.0-255,66,48837,96,260393
39538,0.000851,172.217.194.0-255,5738,54575,96,260393
39539,0.000854,172.31.47.0-255,66,54641,96,260393
39540,0.000876,172.217.194.0-255,1708,56349,96,260393
39541,0.000878,172.31.47.0-255,66,56415,96,260393
39542,0.000897,172.217.194.0-255,1484,57899,96,260393
39543,0.000899,172.31.47.0-255,66,57965,96,260393
39544,0.000903,172.217.194.0-255,1484,59449,96,260393
39545,0.000905,172.31.47.0-255,66,59515,96,260393
39546,0.000935,172.217.194.0-255,1484,60999,96,260393
39547,0.000937,172.31.47.0-255,66,61065,96,260393
39548,0.000944,172.217.194.0-255,5738,66803,96,260393
39549,0.000946,172.31.47.0-255,66,66869,96,260393
39550,0.000951,172.217.194.0-255,4320,71189,96,260393
39551,0.000955,172.31.47.0-255,66,71255,96,260393
39552,0.000974,172.217.194.0-255,2543,73798,96,260393
39553,0.000976,172.31.47.0-255,66,73864,96,260393
39554,0.000984,172.217.194.0-255,7156,81020,96,260393
39555,0.000988,172.31.47.0-255,66,81086,96,260393
39556,0.001021,172.31.47.0-255,66,81152,96,260393
39557,0.002052,172.217.194.0-255,1484,82636,96,260393
39558,0.002057,172.31.47.0-255,66,82702,96,260393
39559,0.002062,172.217.194.0-255,2902,85604,96,260393
39560,0.002064,172.31.47.0-255,66,85670,96,260393
39561,0.002089,172.217.194.0-255,5738,91408,96,260393
39562,0.002091,172.31.47.0-255,66,91474,96,260393
39563,0.002128,172.217.194.0-255,2902,94376,96,260393
39564,0.00213,172.31.47.0-255,66,94442,96,260393
39565,0.00215,172.31.47.0-255,66,94508,96,260393
39566,0.002153,172.217.194.0-255,2902,97410,96,260393
39567,0.002156,172.31.47.0-255,66,97476,96,260393
39568,0.004396,172.31.47.0-255,66,97542,96,260393
39569,0.006729,172.217.194.0-255,5738,103280,96,260393
39570,0.006735,172.31.47.0-255,66,103346,96,260393
39571,0.009065,172.217.194.0-255,5738,109084,96,260393
39572,0.009071,172.31.47.0-255,66,109150,96,260393
39573,0.011375,172.217.194.0-255,5738,114888,96,260393
39574,0.011382,172.31.47.0-255,66,114954,96,260393
39575,0.013716,172.217.194.0-255,1484,116438,96,260393
39576,0.013721,172.31.47.0-255,66,116504,96,260393
39577,0.013745,172.217.194.0-255,4320,120824,96,260393
39578,0.014266,172.31.47.0-255,66,120890,96,260393
39579,0.016037,172.217.194.0-255,1484,122374,96,260393
39580,0.016044,172.31.47.0-255,66,122440,96,260393
39581,0.016575,172.217.194.0-255,4320,126760,96,260393
39582,0.016631,172.31.47.0-255,66,126826,96,260393
39583,0.018359,172.217.194.0-255,1484,128310,96,260393
39584,0.01837,172.31.47.0-255,66,128376,96,260393
39585,0.018925,172.217.194.0-255,4320,132696,96,260393
39586,0.018965,172.31.47.0-255,66,132762,96,260393
39587,0.020714,172.217.194.0-255,1484,134246,96,260393
39588,0.021299,172.217.194.0-255,4320,138566,96,260393
39589,0.021304,172.31.47.0-255,66,138632,96,260393
39590,0.023631,172.217.194.0-255,5738,144370,96,260393
39591,0.023685,172.31.47.0-255,66,144436,96,260393
39592,0.026007,172.217.194.0-255,5738,150174,96,260393
39593,0.026013,172.31.47.0-255,66,150240,96,260393
39594,0.028339,172.217.194.0-255,5738,155978,96,260393
39595,0.028346,172.31.47.0-255,66,156044,96,260393
39596,0.029582,172.31.47.0-255,172,156216,96,260393
39597,0.029611,172.31.47.0-255,1109,157325,96,260393
39598,0.029642,172.31.47.0-255,1514,158839,96,260393
39599,0.029663,172.31.47.0-255,1302,160141,96,260393
39600,0.03066,172.217.194.0-255,5738,165879,96,260393
39601,0.030666,172.31.47.0-255,66,165945,96,260393
39602,0.03113,104.244.42.0-255,66,166011,96,260393
39603,0.031163,104.244.42.0-255,66,166077,96,260393
39604,0.031212,104.244.42.0-255,66,166143,96,260393
39605,0.031214,104.244.42.0-255,66,166209,96,260393
39606,0.032953,172.217.194.0-255,5738,171947,96,260393
39607,0.032958,172.31.47.0-255,66,172013,96,260393
39608,0.03531,172.217.194.0-255,5738,177751,96,260393
39609,0.035326,172.31.47.0-255,66,177817,96,260393
39610,0.03766,172.217.194.0-255,5738,183555,96,260393
39611,0.037679,172.31.47.0-255,66,183621,96,260393
39612,0.039994,172.217.194.0-255,5738,189359,96,260393
39613,0.040009,172.31.47.0-255,66,189425,96,260393
39614,0.04233,172.217.194.0-255,5738,195163,96,260393
39615,0.042344,172.31.47.0-255,66,195229,96,260393
39616,0.044697,172.217.194.0-255,5738,200967,96,260393
39617,0.044707,172.31.47.0-255,66,201033,96,260393
39618,0.047024,172.217.194.0-255,2902,203935,96,260393
39619,0.047029,172.31.47.0-255,66,204001,96,260393
39620,0.047061,172.217.194.0-255,2902,206903,96,260393
39621,0.047075,172.31.47.0-255,66,206969,96,260393
39622,0.049343,172.217.194.0-255,2902,209871,96,260393
39623,0.049348,172.31.47.0-255,66,209937,96,260393
39624,0.049382,172.217.194.0-255,2902,212839,96,260393
39625,0.049388,172.31.47.0-255,66,212905,96,260393
39626,0.051642,172.217.194.0-255,2902,215807,96,260393
39627,0.051647,172.31.47.0-255,66,215873,96,260393
39628,0.05168,172.217.194.0-255,2902,218775,96,260393
39629,0.052094,172.31.47.0-255,66,218841,96,260393
39630,0.053991,172.217.194.0-255,2902,221743,96,260393
39631,0.053998,172.31.47.0-255,66,221809,96,260393
39632,0.054401,172.217.194.0-255,2902,224711,96,260393
39633,0.054406,172.31.47.0-255,66,224777,96,260393
39634,0.056313,172.217.194.0-255,2902,227679,96,260393
39635,0.056318,172.31.47.0-255,66,227745,96,260393
39636,0.056743,172.217.194.0-255,2902,230647,96,260393
39637,0.056748,172.31.47.0-255,66,230713,96,260393
39638,0.05862,172.217.194.0-255,2902,233615,96,260393
39639,0.058624,172.31.47.0-255,66,233681,96,260393
39640,0.059067,172.217.194.0-255,2902,236583,96,260393
39641,0.059071,172.31.47.0-255,66,236649,96,260393
39642,0.06091,172.217.194.0-255,2902,239551,96,260393
39643,0.060914,172.31.47.0-255,66,239617,96,260393
39644,0.061366,172.217.194.0-255,2902,242519,96,260393
39645,0.06137,172.31.47.0-255,66,242585,96,260393
39646,0.063205,172.217.194.0-255,2902,245487,96,260393
39647,0.06321,172.31.47.0-255,66,245553,96,260393
39648,0.063679,172.217.194.0-255,2902,248455,96,260393
39649,0.063684,172.31.47.0-255,66,248521,96,260393
39650,0.065525,172.217.194.0-255,2902,251423,96,260393
39651,0.06553,172.31.47.0-255,66,251489,96,260393
39652,0.066011,172.217.194.0-255,2902,254391,96,260393
39653,0.066016,172.31.47.0-255,66,254457,96,260393
39654,0.067841,172.217.194.0-255,2902,257359,96,260393
39655,0.067847,172.31.47.0-255,66,257425,96,260393
39656,0.068314,172.217.194.0-255,2902,260327,96,260393
39657,0.068319,172.31.47.0-255,66,260393,96,260393
39658,0.0,172.217.194.0-255,153,153,96,299307
39659,2.9e-05,172.31.47.0-255,66,219,96,299307
39660,3.9e-05,172.217.194.0-255,1484,1703,96,299307
39661,4.6e-05,172.31.47.0-255,66,1769,96,299307
39662,5.3e-05,172.217.194.0-255,2902,4671,96,299307
39663,5.7e-05,172.31.47.0-255,66,4737,96,299307
39664,6.6e-05,172.217.194.0-255,7156,11893,96,299307
39665,7e-05,172.31.47.0-255,66,11959,96,299307
39666,8.6e-05,172.31.47.0-255,66,12025,96,299307
39667,0.000119,172.217.194.0-255,4320,16345,96,299307
39668,0.000122,172.31.47.0-255,66,16411,96,299307
39669,0.000146,172.217.194.0-255,5379,21790,96,299307
39670,0.000149,172.31.47.0-255,66,21856,96,299307
39671,0.000413,172.217.194.0-255,1484,23340,96,299307
39672,0.000418,172.31.47.0-255,66,23406,96,299307
39673,0.000425,172.217.194.0-255,2902,26308,96,299307
39674,0.000427,172.31.47.0-255,66,26374,96,299307
39675,0.000457,172.217.194.0-255,5738,32112,96,299307
39676,0.000459,172.31.47.0-255,66,32178,96,299307
39677,0.000468,172.217.194.0-255,6797,38975,96,299307
39678,0.00047,172.31.47.0-255,66,39041,96,299307
39679,0.000473,172.217.194.0-255,1484,40525,96,299307
39680,0.000476,172.31.47.0-255,66,40591,96,299307
39681,0.000539,172.31.47.0-255,66,40657,96,299307
39682,0.000543,172.217.194.0-255,2794,43451,96,299307
39683,0.000545,172.31.47.0-255,66,43517,96,299307
39684,0.000616,172.217.194.0-255,119,43636,96,299307
39685,0.000619,172.31.47.0-255,66,43702,96,299307
39686,0.000708,172.217.194.0-255,1484,45186,96,299307
39687,0.000712,172.31.47.0-255,66,45252,96,299307
39688,0.000718,172.217.194.0-255,2902,48154,96,299307
39689,0.000721,172.31.47.0-255,66,48220,96,299307
39690,0.000726,172.217.194.0-255,2902,51122,96,299307
39691,0.000728,172.31.47.0-255,66,51188,96,299307
39692,0.000745,172.217.194.0-255,2902,54090,96,299307
39693,0.000748,172.31.47.0-255,66,54156,96,299307
39694,0.000752,172.217.194.0-255,1484,55640,96,299307
39695,0.000773,172.217.194.0-255,5379,61019,96,299307
39696,0.000776,172.31.47.0-255,66,61085,96,299307
39697,0.000782,172.217.194.0-255,4320,65405,96,299307
39698,0.000785,172.31.47.0-255,66,65471,96,299307
39699,0.000798,172.217.194.0-255,2902,68373,96,299307
39700,0.0008,172.31.47.0-255,66,68439,96,299307
39701,0.000805,172.217.194.0-255,2902,71341,96,299307
39702,0.000808,172.31.47.0-255,66,71407,96,299307
39703,0.000832,172.217.194.0-255,6797,78204,96,299307
39704,0.000835,172.31.47.0-255,66,78270,96,299307
39705,0.001961,172.217.194.0-255,1484,79754,96,299307
39706,0.001974,172.217.194.0-255,2902,82656,96,299307
39707,0.00198,172.31.47.0-255,66,82722,96,299307
39708,0.001988,172.217.194.0-255,5738,88460,96,299307
39709,0.00199,172.31.47.0-255,66,88526,96,299307
39710,0.002017,172.217.194.0-255,5738,94264,96,299307
39711,0.00202,172.31.47.0-255,66,94330,96,299307
39712,0.002046,172.217.194.0-255,7156,101486,96,299307
39713,0.002048,172.31.47.0-255,66,101552,96,299307
39714,0.002059,172.31.47.0-255,66,101618,96,299307
39715,0.002084,172.217.194.0-255,2184,103802,96,299307
39716,0.002087,172.31.47.0-255,66,103868,96,299307
39717,0.00209,172.217.194.0-255,1484,105352,96,299307
39718,0.002105,172.217.194.0-255,1484,106836,96,299307
39719,0.002107,172.31.47.0-255,66,106902,96,299307
39720,0.002116,172.217.194.0-255,4320,111222,96,299307
39721,0.002117,172.31.47.0-255,66,111288,96,299307
39722,0.002144,172.217.194.0-255,2902,114190,96,299307
39723,0.002147,172.31.47.0-255,66,114256,96,299307
39724,0.002156,172.217.194.0-255,7156,121412,96,299307
39725,0.002157,172.31.47.0-255,66,121478,96,299307
39726,0.002164,172.217.194.0-255,5738,127216,96,299307
39727,0.002167,172.31.47.0-255,66,127282,96,299307
39728,0.002196,172.31.47.0-255,66,127348,96,299307
39729,0.002199,172.217.194.0-255,766,128114,96,299307
39730,0.004551,172.217.194.0-255,4320,132434,96,299307
39731,0.004569,172.31.47.0-255,66,132500,96,299307
39732,0.006918,172.217.194.0-255,5738,138238,96,299307
39733,0.006932,172.31.47.0-255,66,138304,96,299307
39734,0.009229,172.217.194.0-255,5738,144042,96,299307
39735,0.009241,172.31.47.0-255,66,144108,96,299307
39736,0.01158,172.217.194.0-255,5738,149846,96,299307
39737,0.011606,172.31.47.0-255,66,149912,96,299307
39738,0.013924,172.217.194.0-255,5738,155650,96,299307
39739,0.013947,172.31.47.0-255,66,155716,96,299307
39740,0.016292,172.217.194.0-255,5738,161454,96,299307
39741,0.016314,172.31.47.0-255,66,161520,96,299307
39742,0.018625,172.217.194.0-255,5738,167258,96,299307
39743,0.018644,172.31.47.0-255,66,167324,96,299307
39744,0.020962,172.217.194.0-255,5738,173062,96,299307
39745,0.020978,172.31.47.0-255,66,173128,96,299307
39746,0.023308,172.217.194.0-255,5738,178866,96,299307
39747,0.023319,172.31.47.0-255,66,178932,96,299307
39748,0.025658,172.217.194.0-255,5738,184670,96,299307
39749,0.025675,172.31.47.0-255,66,184736,96,299307
39750,0.027968,172.217.194.0-255,5738,190474,96,299307
39751,0.02798,172.31.47.0-255,66,190540,96,299307
39752,0.030264,172.31.47.0-255,172,190712,96,299307
39753,0.0303,172.217.194.0-255,5738,196450,96,299307
39754,0.030305,172.31.47.0-255,66,196516,96,299307
39755,0.030311,172.31.47.0-255,1105,197621,96,299307
39756,0.03038,172.31.47.0-255,1514,199135,96,299307
39757,0.030381,172.31.47.0-255,1306,200441,96,299307
39758,0.031806,104.244.42.0-255,66,200507,96,299307
39759,0.031846,104.244.42.0-255,66,200573,96,299307
39760,0.031938,104.244.42.0-255,66,200639,96,299307
39761,0.032624,172.217.194.0-255,5738,206377,96,299307
39762,0.032631,172.31.47.0-255,66,206443,96,299307
39763,0.03495,172.217.194.0-255,5738,212181,96,299307
39764,0.034958,172.31.47.0-255,66,212247,96,299307
39765,0.037266,172.217.194.0-255,5738,217985,96,299307
39766,0.037273,172.31.47.0-255,66,218051,96,299307
39767,0.039591,172.217.194.0-255,5738,223789,96,299307
39768,0.039599,172.31.47.0-255,66,223855,96,299307
39769,0.041918,172.217.194.0-255,5738,229593,96,299307
39770,0.041928,172.31.47.0-255,66,229659,96,299307
39771,0.044269,172.217.194.0-255,5738,235397,96,299307
39772,0.044276,172.31.47.0-255,66,235463,96,299307
39773,0.046569,172.217.194.0-255,5738,241201,96,299307
39774,0.046574,172.31.47.0-255,66,241267,96,299307
39775,0.048867,172.217.194.0-255,5738,247005,96,299307
39776,0.048874,172.31.47.0-255,66,247071,96,299307
39777,0.051188,172.217.194.0-255,5738,252809,96,299307
39778,0.051194,172.31.47.0-255,66,252875,96,299307
39779,0.053507,172.217.194.0-255,5738,258613,96,299307
39780,0.053514,172.31.47.0-255,66,258679,96,299307
39781,0.055782,172.217.194.0-255,5738,264417,96,299307
39782,0.05579,172.31.47.0-255,66,264483,96,299307
39783,0.058069,172.217.194.0-255,5738,270221,96,299307
39784,0.058078,172.31.47.0-255,66,270287,96,299307
39785,0.060413,172.217.194.0-255,5738,276025,96,299307
39786,0.06042,172.31.47.0-255,66,276091,96,299307
39787,0.062764,172.217.194.0-255,5738,281829,96,299307
39788,0.062772,172.31.47.0-255,66,281895,96,299307
39789,0.065052,172.217.194.0-255,5738,287633,96,299307
39790,0.065063,172.31.47.0-255,66,287699,96,299307
39791,0.067407,172.217.194.0-255,5738,293437,96,299307
39792,0.067416,172.31.47.0-255,66,293503,96,299307
39793,0.069764,172.217.194.0-255,5738,299241,96,299307
39794,0.069771,172.31.47.0-255,66,299307,96,299307
39795,0.0,74.125.200.0-255,146,146,96,273363
39796,2.6e-05,172.31.47.0-255,66,212,96,273363
39797,3.2e-05,74.125.200.0-255,1484,1696,96,273363
39798,3.6e-05,172.31.47.0-255,66,1762,96,273363
39799,3.9e-05,74.125.200.0-255,1484,3246,96,273363
39800,4.2e-05,172.31.47.0-255,66,3312,96,273363
39801,6.3e-05,74.125.200.0-255,1484,4796,96,273363
39802,6.6e-05,172.31.47.0-255,66,4862,96,273363
39803,7.2e-05,74.125.200.0-255,4320,9182,96,273363
39804,7.4e-05,172.31.47.0-255,66,9248,96,273363
39805,8.7e-05,74.125.200.0-255,2902,12150,96,273363
39806,8.9e-05,172.31.47.0-255,66,12216,96,273363
39807,9.2e-05,74.125.200.0-255,2201,14417,96,273363
39808,9.5e-05,172.31.47.0-255,66,14483,96,273363
39809,0.000179,74.125.200.0-255,1484,15967,96,273363
39810,0.000182,172.31.47.0-255,66,16033,96,273363
39811,0.000201,74.125.200.0-255,2902,18935,96,273363
39812,0.000203,172.31.47.0-255,66,19001,96,273363
39813,0.000209,74.125.200.0-255,5738,24739,96,273363
39814,0.000211,172.31.47.0-255,66,24805,96,273363
39815,0.000237,74.125.200.0-255,6797,31602,96,273363
39816,0.000239,172.31.47.0-255,66,31668,96,273363
39817,0.000259,74.125.200.0-255,7156,38824,96,273363
39818,0.000262,172.31.47.0-255,66,38890,96,273363
39819,0.000291,172.31.47.0-255,66,38956,96,273363
39820,0.000294,74.125.200.0-255,1484,40440,96,273363
39821,0.000296,172.31.47.0-255,66,40506,96,273363
39822,0.000321,172.31.47.0-255,66,40572,96,273363
39823,0.000324,74.125.200.0-255,1484,42056,96,273363
39824,0.000325,172.31.47.0-255,66,42122,96,273363
39825,0.000344,74.125.200.0-255,3602,45724,96,273363
39826,0.000347,172.31.47.0-255,66,45790,96,273363
39827,0.000361,74.125.200.0-255,398,46188,96,273363
39828,0.000364,172.31.47.0-255,66,46254,96,273363
39829,0.000401,74.125.200.0-255,346,46600,96,273363
39830,0.000404,172.31.47.0-255,66,46666,96,273363
39831,0.000586,74.125.200.0-255,1484,48150,96,273363
39832,0.00059,172.31.47.0-255,66,48216,96,273363
39833,0.000602,74.125.200.0-255,2902,51118,96,273363
39834,0.000605,74.125.200.0-255,1484,52602,96,273363
39835,0.000606,172.31.47.0-255,66,52668,96,273363
39836,0.000621,74.125.200.0-255,4320,56988,96,273363
39837,0.000624,74.125.200.0-255,1484,58472,96,273363
39838,0.000625,172.31.47.0-255,66,58538,96,273363
39839,0.00065,74.125.200.0-255,5738,64276,96,273363
39840,0.000655,74.125.200.0-255,4320,68596,96,273363
39841,0.000656,172.31.47.0-255,66,68662,96,273363
39842,0.000661,172.31.47.0-255,66,68728,96,273363
39843,0.000675,74.125.200.0-255,4320,73048,96,273363
39844,0.000681,172.31.47.0-255,66,73114,96,273363
39845,0.000695,172.31.47.0-255,66,73180,96,273363
39846,0.000791,74.125.200.0-255,1484,74664,96,273363
39847,0.000808,74.125.200.0-255,1484,76148,96,273363
39848,0.000811,172.31.47.0-255,66,76214,96,273363
39849,0.000828,74.125.200.0-255,1484,77698,96,273363
39850,0.000833,74.125.200.0-255,5738,83436,96,273363
39851,0.000836,74.125.200.0-255,2902,86338,96,273363
39852,0.00084,172.31.47.0-255,66,86404,96,273363
39853,0.000873,74.125.200.0-255,4320,90724,96,273363
39854,0.000876,172.31.47.0-255,66,90790,96,273363
39855,0.000893,74.125.200.0-255,5738,96528,96,273363
39856,0.000896,172.31.47.0-255,66,96594,96,273363
39857,0.000898,74.125.200.0-255,5738,102332,96,273363
39858,0.000907,172.31.47.0-255,66,102398,96,273363
39859,0.000945,74.125.200.0-255,5020,107418,96,273363
39860,0.000951,172.31.47.0-255,66,107484,96,273363
39861,0.000967,74.125.200.0-255,1484,108968,96,273363
39862,0.000988,74.125.200.0-255,4320,113288,96,273363
39863,0.000992,74.125.200.0-255,2902,116190,96,273363
39864,0.000995,172.31.47.0-255,66,116256,96,273363
39865,0.000995,74.125.200.0-255,2902,119158,96,273363
39866,0.000999,172.31.47.0-255,66,119224,96,273363
39867,0.001007,74.125.200.0-255,1484,120708,96,273363
39868,0.001034,172.31.47.0-255,66,120774,96,273363
39869,0.001038,74.125.200.0-255,2902,123676,96,273363
39870,0.00105,172.31.47.0-255,66,123742,96,273363
39871,0.001054,74.125.200.0-255,5738,129480,96,273363
39872,0.001065,172.31.47.0-255,66,129546,96,273363
39873,0.001097,74.125.200.0-255,3602,133148,96,273363
39874,0.001101,172.31.47.0-255,66,133214,96,273363
39875,0.001115,74.125.200.0-255,4320,137534,96,273363
39876,0.001121,172.31.47.0-255,66,137600,96,273363
39877,0.001166,172.31.47.0-255,66,137666,96,273363
39878,0.001177,172.31.47.0-255,66,137732,96,273363
39879,0.0012,74.125.200.0-255,5738,143470,96,273363
39880,0.001203,172.31.47.0-255,66,143536,96,273363
39881,0.001223,74.125.200.0-255,5020,148556,96,273363
39882,0.001232,172.31.47.0-255,66,148622,96,273363
39883,0.001292,74.125.200.0-255,1484,150106,96,273363
39884,0.001304,74.125.200.0-255,2902,153008,96,273363
39885,0.001313,172.31.47.0-255,66,153074,96,273363
39886,0.001325,74.125.200.0-255,5738,158812,96,273363
39887,0.001331,172.31.47.0-255,66,158878,96,273363
39888,0.001345,74.125.200.0-255,4320,163198,96,273363
39889,0.001348,172.31.47.0-255,66,163264,96,273363
39890,0.001365,74.125.200.0-255,4320,167584,96,273363
39891,0.001367,74.125.200.0-255,1484,169068,96,273363
39892,0.00137,172.31.47.0-255,66,169134,96,273363
39893,0.001399,74.125.200.0-255,5020,174154,96,273363
39894,0.001399,172.31.47.0-255,66,174220,96,273363
39895,0.001403,172.31.47.0-255,66,174286,96,273363
39896,0.001525,74.125.200.0-255,1484,175770,96,273363
39897,0.001541,74.125.200.0-255,2902,178672,96,273363
39898,0.001544,172.31.47.0-255,66,178738,96,273363
39899,0.001549,74.125.200.0-255,2902,181640,96,273363
39900,0.001556,172.31.47.0-255,66,181706,96,273363
39901,0.001562,74.125.200.0-255,1484,183190,96,273363
39902,0.001588,74.125.200.0-255,2902,186092,96,273363
39903,0.001593,172.31.47.0-255,66,186158,96,273363
39904,0.001613,74.125.200.0-255,5738,191896,96,273363
39905,0.00162,172.31.47.0-255,66,191962,96,273363
39906,0.001644,74.125.200.0-255,2902,194864,96,273363
39907,0.001647,172.31.47.0-255,66,194930,96,273363
39908,0.00167,74.125.200.0-255,5020,199950,96,273363
39909,0.001674,172.31.47.0-255,66,200016,96,273363
39910,0.001764,74.125.200.0-255,1484,201500,96,273363
39911,0.001769,74.125.200.0-255,2902,204402,96,273363
39912,0.001772,172.31.47.0-255,66,204468,96,273363
39913,0.001793,74.125.200.0-255,5738,210206,96,273363
39914,0.001797,74.125.200.0-255,2902,213108,96,273363
39915,0.0018,172.31.47.0-255,66,213174,96,273363
39916,0.001825,74.125.200.0-255,4320,217494,96,273363
39917,0.001832,172.31.47.0-255,66,217560,96,273363
39918,0.001842,74.125.200.0-255,5738,223298,96,273363
39919,0.001845,74.125.200.0-255,1484,224782,96,273363
39920,0.001845,172.31.47.0-255,66,224848,96,273363
39921,0.001891,172.31.47.0-255,66,224914,96,273363
39922,0.001933,172.31.47.0-255,66,224980,96,273363
39923,0.001938,74.125.200.0-255,4320,229300,96,273363
39924,0.001949,172.31.47.0-255,66,229366,96,273363
39925,0.001953,74.125.200.0-255,5738,235104,96,273363
39926,0.001961,172.31.47.0-255,66,235170,96,273363
39927,0.001982,74.125.200.0-255,766,235936,96,273363
39928,0.001983,172.31.47.0-255,66,236002,96,273363
39929,0.002015,74.125.200.0-255,2902,238904,96,273363
39930,0.002027,172.31.47.0-255,66,238970,96,273363
39931,0.002038,172.31.47.0-255,66,239036,96,273363
39932,0.002052,74.125.200.0-255,5738,244774,96,273363
39933,0.00206,172.31.47.0-255,66,244840,96,273363
39934,0.002091,172.31.47.0-255,66,244906,96,273363
39935,0.002098,74.125.200.0-255,2902,247808,96,273363
39936,0.002103,172.31.47.0-255,66,247874,96,273363
39937,0.002121,74.125.200.0-255,2902,250776,96,273363
39938,0.002127,172.31.47.0-255,66,250842,96,273363
39939,0.002135,74.125.200.0-255,2902,253744,96,273363
39940,0.002141,172.31.47.0-255,66,253810,96,273363
39941,0.002164,74.125.200.0-255,2902,256712,96,273363
39942,0.00217,172.31.47.0-255,66,256778,96,273363
39943,0.002192,172.31.47.0-255,66,256844,96,273363
39944,0.002201,74.125.200.0-255,6438,263282,96,273363
39945,0.002205,172.31.47.0-255,66,263348,96,273363
39946,0.002205,74.125.200.0-255,2433,265781,96,273363
39947,0.002208,172.31.47.0-255,66,265847,96,273363
39948,0.002225,74.125.200.0-255,105,265952,96,273363
39949,0.007161,172.31.47.0-255,66,266018,96,273363
39950,0.007185,172.31.47.0-255,105,266123,96,273363
39951,0.009473,74.125.200.0-255,66,266189,96,273363
39952,0.024386,172.31.47.0-255,172,266361,96,273363
39953,0.024414,172.31.47.0-255,1109,267470,96,273363
39954,0.024451,172.31.47.0-255,1514,268984,96,273363
39955,0.024453,172.31.47.0-255,1514,270498,96,273363
39956,0.024454,172.31.47.0-255,1514,272012,96,273363
39957,0.024455,172.31.47.0-255,1087,273099,96,273363
39958,0.025898,104.244.42.0-255,66,273165,96,273363
39959,0.02595,104.244.42.0-255,66,273231,96,273363
39960,0.026002,104.244.42.0-255,66,273297,96,273363
39961,0.026005,104.244.42.0-255,66,273363,96,273363
39962,0.0,172.217.194.0-255,153,153,96,214631
39963,2.4e-05,172.31.47.0-255,66,219,96,214631
39964,3.2e-05,172.217.194.0-255,1484,1703,96,214631
39965,3.5e-05,172.31.47.0-255,66,1769,96,214631
39966,4e-05,172.217.194.0-255,2902,4671,96,214631
39967,4.8e-05,172.31.47.0-255,66,4737,96,214631
39968,5.3e-05,172.217.194.0-255,4320,9057,96,214631
39969,5.6e-05,172.31.47.0-255,66,9123,96,214631
39970,0.000115,172.31.47.0-255,66,9189,96,214631
39971,0.000122,172.217.194.0-255,7156,16345,96,214631
39972,0.000124,172.31.47.0-255,66,16411,96,214631
39973,0.000145,172.217.194.0-255,1484,17895,96,214631
39974,0.000148,172.31.47.0-255,66,17961,96,214631
39975,0.000154,172.217.194.0-255,5379,23340,96,214631
39976,0.000161,172.31.47.0-255,66,23406,96,214631
39977,0.000187,172.217.194.0-255,5738,29144,96,214631
39978,0.000195,172.31.47.0-255,66,29210,96,214631
39979,0.00023,172.31.47.0-255,66,29276,96,214631
39980,0.000323,172.217.194.0-255,1484,30760,96,214631
39981,0.000327,172.31.47.0-255,66,30826,96,214631
39982,0.000332,172.217.194.0-255,2902,33728,96,214631
39983,0.000335,172.31.47.0-255,66,33794,96,214631
39984,0.000339,172.217.194.0-255,2902,36696,96,214631
39985,0.000348,172.31.47.0-255,66,36762,96,214631
39986,0.00038,172.217.194.0-255,2902,39664,96,214631
39987,0.000383,172.31.47.0-255,66,39730,96,214631
39988,0.00039,172.217.194.0-255,6797,46527,96,214631
39989,0.000392,172.31.47.0-255,66,46593,96,214631
39990,0.000395,172.217.194.0-255,361,46954,96,214631
39991,0.000403,172.31.47.0-255,66,47020,96,214631
39992,0.00067,172.217.194.0-255,382,47402,96,214631
39993,0.000802,172.31.47.0-255,66,47468,96,214631
39994,0.000881,172.217.194.0-255,1484,48952,96,214631
39995,0.00089,172.217.194.0-255,2902,51854,96,214631
39996,0.000893,172.31.47.0-255,66,51920,96,214631
39997,0.0009,172.217.194.0-255,5738,57658,96,214631
39998,0.000902,172.31.47.0-255,66,57724,96,214631
39999,0.000927,172.217.194.0-255,6797,64521,96,214631
40000,0.000935,172.31.47.0-255,66,64587,96,214631
40001,0.000976,172.31.47.0-255,66,64653,96,214631
40002,0.00098,172.217.194.0-255,2543,67196,96,214631
40003,0.000982,172.31.47.0-255,66,67262,96,214631
40004,0.001392,172.217.194.0-255,1484,68746,96,214631
40005,0.001402,172.217.194.0-255,2902,71648,96,214631
40006,0.001406,172.31.47.0-255,66,71714,96,214631
40007,0.001413,172.217.194.0-255,5738,77452,96,214631
40008,0.001415,172.31.47.0-255,66,77518,96,214631
40009,0.001459,172.31.47.0-255,66,77584,96,214631
40010,0.001525,172.31.47.0-255,66,77650,96,214631
40011,0.001538,172.217.194.0-255,2184,79834,96,214631
40012,0.00154,172.31.47.0-255,66,79900,96,214631
40013,0.001555,172.31.47.0-255,66,79966,96,214631
40014,0.001565,172.31.47.0-255,66,80032,96,214631
40015,0.001591,172.217.194.0-255,7156,87188,96,214631
40016,0.001593,172.31.47.0-255,66,87254,96,214631
40017,0.001618,172.217.194.0-255,3602,90856,96,214631
40018,0.001625,172.31.47.0-255,66,90922,96,214631
40019,0.001647,172.217.194.0-255,1484,92406,96,214631
40020,0.001675,172.217.194.0-255,2902,95308,96,214631
40021,0.001678,172.31.47.0-255,66,95374,96,214631
40022,0.001681,172.217.194.0-255,1484,96858,96,214631
40023,0.001704,172.217.194.0-255,4320,101178,96,214631
40024,0.001707,172.31.47.0-255,66,101244,96,214631
40025,0.001712,172.217.194.0-255,5738,106982,96,214631
40026,0.001715,172.31.47.0-255,66,107048,96,214631
40027,0.001721,172.217.194.0-255,1484,108532,96,214631
40028,0.001756,172.31.47.0-255,66,108598,96,214631
40029,0.001762,172.217.194.0-255,5020,113618,96,214631
40030,0.001764,172.31.47.0-255,66,113684,96,214631
40031,0.001785,172.217.194.0-255,5738,119422,96,214631
40032,0.001791,172.31.47.0-255,66,119488,96,214631
40033,0.001794,172.217.194.0-255,1484,120972,96,214631
40034,0.00183,172.31.47.0-255,66,121038,96,214631
40035,0.001849,172.31.47.0-255,66,121104,96,214631
40036,0.001854,172.217.194.0-255,3602,124706,96,214631
40037,0.001856,172.31.47.0-255,66,124772,96,214631
40038,0.001889,172.217.194.0-255,4320,129092,96,214631
40039,0.001893,172.31.47.0-255,66,129158,96,214631
40040,0.001903,172.31.47.0-255,66,129224,96,214631
40041,0.001924,172.31.47.0-255,66,129290,96,214631
40042,0.001946,172.217.194.0-255,1484,130774,96,214631
40043,0.001973,172.217.194.0-255,6438,137212,96,214631
40044,0.001976,172.31.47.0-255,66,137278,96,214631
40045,0.001983,172.217.194.0-255,7156,144434,96,214631
40046,0.001985,172.31.47.0-255,66,144500,96,214631
40047,0.002008,172.217.194.0-255,1484,145984,96,214631
40048,0.002011,172.217.194.0-255,1484,147468,96,214631
40049,0.002013,172.31.47.0-255,66,147534,96,214631
40050,0.002052,172.31.47.0-255,66,147600,96,214631
40051,0.002057,172.217.194.0-255,4320,151920,96,214631
40052,0.002059,172.31.47.0-255,66,151986,96,214631
40053,0.002086,172.217.194.0-255,3602,155588,96,214631
40054,0.002088,172.31.47.0-255,66,155654,96,214631
40055,0.002098,172.31.47.0-255,66,155720,96,214631
40056,0.002146,172.31.47.0-255,66,155786,96,214631
40057,0.002172,172.217.194.0-255,7156,162942,96,214631
40058,0.002174,172.31.47.0-255,66,163008,96,214631
40059,0.002181,172.217.194.0-255,6438,169446,96,214631
40060,0.002183,172.31.47.0-255,66,169512,96,214631
40061,0.002202,172.31.47.0-255,66,169578,96,214631
40062,0.002244,172.31.47.0-255,66,169644,96,214631
40063,0.004598,172.217.194.0-255,5738,175382,96,214631
40064,0.004603,172.31.47.0-255,66,175448,96,214631
40065,0.006957,172.217.194.0-255,5738,181186,96,214631
40066,0.006962,172.31.47.0-255,66,181252,96,214631
40067,0.009316,172.217.194.0-255,5738,186990,96,214631
40068,0.009322,172.31.47.0-255,66,187056,96,214631
40069,0.01168,172.217.194.0-255,4320,191376,96,214631
40070,0.011687,172.31.47.0-255,66,191442,96,214631
40071,0.011715,172.217.194.0-255,1484,192926,96,214631
40072,0.014057,172.217.194.0-255,4320,197246,96,214631
40073,0.014066,172.31.47.0-255,66,197312,96,214631
40074,0.016415,172.217.194.0-255,5738,203050,96,214631
40075,0.01642,172.31.47.0-255,66,203116,96,214631
40076,0.018761,172.217.194.0-255,5738,208854,96,214631
40077,0.018766,172.31.47.0-255,66,208920,96,214631
40078,0.02114,172.217.194.0-255,4511,213431,96,214631
40079,0.021149,172.31.47.0-255,66,213497,96,214631
40080,0.021404,172.31.47.0-255,105,213602,96,214631
40081,0.021817,172.31.47.0-255,172,213774,96,214631
40082,0.02185,172.31.47.0-255,659,214433,96,214631
40083,0.023372,104.244.42.0-255,66,214499,96,214631
40084,0.023377,104.244.42.0-255,66,214565,96,214631
40085,0.023714,172.217.194.0-255,66,214631,96,214631
40086,0.0,172.31.47.0-255,105,105,96,276
40087,0.069873,31.13.82.0-255,105,210,96,276
40088,0.069889,172.31.47.0-255,66,276,96,276
40089,0.0,172.217.160.0-255,152,152,96,169014
40090,2.1e-05,172.31.47.0-255,66,218,96,169014
40091,2.7e-05,172.217.160.0-255,1484,1702,96,169014
40092,3.1e-05,172.31.47.0-255,66,1768,96,169014
40093,3.7e-05,172.217.160.0-255,2902,4670,96,169014
40094,4e-05,172.31.47.0-255,66,4736,96,169014
40095,4.7e-05,172.217.160.0-255,7156,11892,96,169014
40096,4.9e-05,172.31.47.0-255,66,11958,96,169014
40097,7.7e-05,172.31.47.0-255,66,12024,96,169014
40098,9.6e-05,172.217.160.0-255,5738,17762,96,169014
40099,9.8e-05,172.31.47.0-255,66,17828,96,169014
40100,0.000117,172.217.160.0-255,5379,23207,96,169014
40101,0.00012,172.31.47.0-255,66,23273,96,169014
40102,0.000202,172.217.160.0-255,1484,24757,96,169014
40103,0.000205,172.31.47.0-255,66,24823,96,169014
40104,0.000211,172.217.160.0-255,2902,27725,96,169014
40105,0.000213,172.31.47.0-255,66,27791,96,169014
40106,0.000236,172.217.160.0-255,5738,33529,96,169014
40107,0.000239,172.31.47.0-255,66,33595,96,169014
40108,0.000256,172.217.160.0-255,1484,35079,96,169014
40109,0.000258,172.31.47.0-255,66,35145,96,169014
40110,0.000276,172.217.160.0-255,4320,39465,96,169014
40111,0.000278,172.31.47.0-255,66,39531,96,169014
40112,0.000295,172.217.160.0-255,5379,44910,96,169014
40113,0.000297,172.31.47.0-255,66,44976,96,169014
40114,0.000309,172.31.47.0-255,66,45042,96,169014
40115,0.000327,172.217.160.0-255,375,45417,96,169014
40116,0.000329,172.31.47.0-255,66,45483,96,169014
40117,0.000531,172.217.160.0-255,101,45584,96,169014
40118,0.000534,172.31.47.0-255,66,45650,96,169014
40119,0.00066,172.217.160.0-255,1484,47134,96,169014
40120,0.000667,172.217.160.0-255,2902,50036,96,169014
40121,0.00067,172.31.47.0-255,66,50102,96,169014
40122,0.000676,172.217.160.0-255,4320,54422,96,169014
40123,0.000679,172.31.47.0-255,66,54488,96,169014
40124,0.000691,172.217.160.0-255,1484,55972,96,169014
40125,0.000702,172.217.160.0-255,1484,57456,96,169014
40126,0.000705,172.31.47.0-255,66,57522,96,169014
40127,0.000752,172.31.47.0-255,66,57588,96,169014
40128,0.000756,172.31.47.0-255,66,57654,96,169014
40129,0.000778,172.217.160.0-255,1484,59138,96,169014
40130,0.000784,172.217.160.0-255,2902,62040,96,169014
40131,0.000786,172.31.47.0-255,66,62106,96,169014
40132,0.000815,172.217.160.0-255,5738,67844,96,169014
40133,0.000818,172.31.47.0-255,66,67910,96,169014
40134,0.000821,172.217.160.0-255,1484,69394,96,169014
40135,0.000851,172.31.47.0-255,66,69460,96,169014
40136,0.000859,172.217.160.0-255,7156,76616,96,169014
40137,0.000862,172.31.47.0-255,66,76682,96,169014
40138,0.000885,172.217.160.0-255,1484,78166,96,169014
40139,0.000896,172.31.47.0-255,66,78232,96,169014
40140,0.000921,172.217.160.0-255,766,78998,96,169014
40141,0.000934,172.31.47.0-255,66,79064,96,169014
40142,0.000977,172.217.160.0-255,7156,86220,96,169014
40143,0.00098,172.31.47.0-255,66,86286,96,169014
40144,0.001003,172.31.47.0-255,66,86352,96,169014
40145,0.001018,172.31.47.0-255,66,86418,96,169014
40146,0.001034,172.31.47.0-255,66,86484,96,169014
40147,0.001037,172.217.160.0-255,766,87250,96,169014
40148,0.001083,172.217.160.0-255,5738,92988,96,169014
40149,0.001086,172.31.47.0-255,66,93054,96,169014
40150,0.001121,172.31.47.0-255,66,93120,96,169014
40151,0.001162,172.31.47.0-255,66,93186,96,169014
40152,0.001172,172.217.160.0-255,1902,95088,96,169014
40153,0.001174,172.31.47.0-255,66,95154,96,169014
40154,0.001181,172.217.160.0-255,5738,100892,96,169014
40155,0.001183,172.31.47.0-255,66,100958,96,169014
40156,0.001219,172.31.47.0-255,66,101024,96,169014
40157,0.00125,172.31.47.0-255,66,101090,96,169014
40158,0.001256,172.217.160.0-255,3602,104692,96,169014
40159,0.001257,172.31.47.0-255,66,104758,96,169014
40160,0.001262,172.217.160.0-255,4320,109078,96,169014
40161,0.001264,172.31.47.0-255,66,109144,96,169014
40162,0.00127,172.217.160.0-255,7156,116300,96,169014
40163,0.001272,172.31.47.0-255,66,116366,96,169014
40164,0.001308,172.217.160.0-255,2902,119268,96,169014
40165,0.001312,172.31.47.0-255,66,119334,96,169014
40166,0.001324,172.31.47.0-255,66,119400,96,169014
40167,0.001328,172.217.160.0-255,2902,122302,96,169014
40168,0.00133,172.31.47.0-255,66,122368,96,169014
40169,0.001352,172.217.160.0-255,5020,127388,96,169014
40170,0.001355,172.31.47.0-255,66,127454,96,169014
40171,0.001365,172.31.47.0-255,66,127520,96,169014
40172,0.001408,172.31.47.0-255,66,127586,96,169014
40173,0.001414,172.217.160.0-255,5020,132606,96,169014
40174,0.001416,172.31.47.0-255,66,132672,96,169014
40175,0.001444,172.217.160.0-255,1484,134156,96,169014
40176,0.001449,172.217.160.0-255,2902,137058,96,169014
40177,0.001452,172.31.47.0-255,66,137124,96,169014
40178,0.001459,172.217.160.0-255,5738,142862,96,169014
40179,0.001461,172.31.47.0-255,66,142928,96,169014
40180,0.001537,172.31.47.0-255,66,142994,96,169014
40181,0.001548,172.31.47.0-255,66,143060,96,169014
40182,0.001553,172.217.160.0-255,3602,146662,96,169014
40183,0.001555,172.31.47.0-255,66,146728,96,169014
40184,0.00156,172.217.160.0-255,4320,151048,96,169014
40185,0.001562,172.31.47.0-255,66,151114,96,169014
40186,0.001573,172.31.47.0-255,66,151180,96,169014
40187,0.001593,172.217.160.0-255,1484,152664,96,169014
40188,0.001601,172.217.160.0-255,7156,159820,96,169014
40189,0.001604,172.31.47.0-255,66,159886,96,169014
40190,0.001632,172.31.47.0-255,66,159952,96,169014
40191,0.001635,172.217.160.0-255,1484,161436,96,169014
40192,0.00166,172.31.47.0-255,66,161502,96,169014
40193,0.003277,172.217.160.0-255,105,161607,96,169014
40194,0.004536,172.31.47.0-255,66,161673,96,169014
40195,0.004573,172.31.47.0-255,105,161778,96,169014
40196,0.006183,172.217.160.0-255,66,161844,96,169014
40197,0.028725,172.31.47.0-255,172,162016,96,169014
40198,0.028768,172.31.47.0-255,1109,163125,96,169014
40199,0.028824,172.31.47.0-255,1514,164639,96,169014
40200,0.028826,172.31.47.0-255,1514,166153,96,169014
40201,0.028827,172.31.47.0-255,1514,167667,96,169014
40202,0.028828,172.31.47.0-255,1083,168750,96,169014
40203,0.030302,104.244.42.0-255,66,168816,96,169014
40204,0.030398,104.244.42.0-255,66,168882,96,169014
40205,0.030419,104.244.42.0-255,66,168948,96,169014
40206,0.03043,104.244.42.0-255,66,169014,96,169014
40207,0.0,172.217.194.0-255,153,153,96,322546
40208,2.5e-05,172.31.47.0-255,66,219,96,322546
40209,3.2e-05,172.217.194.0-255,1484,1703,96,322546
40210,3.6e-05,172.31.47.0-255,66,1769,96,322546
40211,4e-05,172.217.194.0-255,2902,4671,96,322546
40212,4.2e-05,172.31.47.0-255,66,4737,96,322546
40213,4.6e-05,172.217.194.0-255,2902,7639,96,322546
40214,4.8e-05,172.31.47.0-255,66,7705,96,322546
40215,7.2e-05,172.217.194.0-255,4320,12025,96,322546
40216,7.4e-05,172.31.47.0-255,66,12091,96,322546
40217,7.7e-05,172.217.194.0-255,2144,14235,96,322546
40218,7.9e-05,172.31.47.0-255,66,14301,96,322546
40219,8.3e-05,172.217.194.0-255,2902,17203,96,322546
40220,8.4e-05,172.31.47.0-255,66,17269,96,322546
40221,8.8e-05,172.217.194.0-255,4320,21589,96,322546
40222,9.1e-05,172.31.47.0-255,66,21655,96,322546
40223,0.000107,172.217.194.0-255,2902,24557,96,322546
40224,0.000109,172.31.47.0-255,66,24623,96,322546
40225,0.000128,172.217.194.0-255,6797,31420,96,322546
40226,0.000131,172.31.47.0-255,66,31486,96,322546
40227,0.000213,172.217.194.0-255,1484,32970,96,322546
40228,0.000216,172.31.47.0-255,66,33036,96,322546
40229,0.000232,172.217.194.0-255,2902,35938,96,322546
40230,0.000235,172.31.47.0-255,66,36004,96,322546
40231,0.000261,172.217.194.0-255,5738,41742,96,322546
40232,0.000264,172.31.47.0-255,66,41808,96,322546
40233,0.000276,172.217.194.0-255,4320,46128,96,322546
40234,0.000279,172.31.47.0-255,66,46194,96,322546
40235,0.000303,172.217.194.0-255,2543,48737,96,322546
40236,0.000306,172.31.47.0-255,66,48803,96,322546
40237,0.000312,172.217.194.0-255,7156,55959,96,322546
40238,0.000314,172.31.47.0-255,66,56025,96,322546
40239,0.000368,172.217.194.0-255,117,56142,96,322546
40240,0.000369,172.217.194.0-255,377,56519,96,322546
40241,0.00037,172.31.47.0-255,66,56585,96,322546
40242,0.000687,172.31.47.0-255,66,56651,96,322546
40243,0.00076,172.217.194.0-255,1484,58135,96,322546
40244,0.000768,172.217.194.0-255,2902,61037,96,322546
40245,0.000772,172.31.47.0-255,66,61103,96,322546
40246,0.000788,172.217.194.0-255,5738,66841,96,322546
40247,0.000791,172.31.47.0-255,66,66907,96,322546
40248,0.000817,172.217.194.0-255,5738,72645,96,322546
40249,0.00082,172.31.47.0-255,66,72711,96,322546
40250,0.000845,172.217.194.0-255,7156,79867,96,322546
40251,0.000848,172.31.47.0-255,66,79933,96,322546
40252,0.00086,172.31.47.0-255,66,79999,96,322546
40253,0.000929,172.217.194.0-255,1484,81483,96,322546
40254,0.000934,172.217.194.0-255,1484,82967,96,322546
40255,0.000937,172.31.47.0-255,66,83033,96,322546
40256,0.00096,172.217.194.0-255,1484,84517,96,322546
40257,0.000967,172.217.194.0-255,5738,90255,96,322546
40258,0.000969,172.31.47.0-255,66,90321,96,322546
40259,0.000973,172.217.194.0-255,2902,93223,96,322546
40260,0.000975,172.31.47.0-255,66,93289,96,322546
40261,0.001007,172.31.47.0-255,66,93355,96,322546
40262,0.001024,172.217.194.0-255,1484,94839,96,322546
40263,0.001057,172.31.47.0-255,66,94905,96,322546
40264,0.001654,172.217.194.0-255,1484,96389,96,322546
40265,0.001661,172.217.194.0-255,1484,97873,96,322546
40266,0.001665,172.31.47.0-255,66,97939,96,322546
40267,0.001697,172.217.194.0-255,1484,99423,96,322546
40268,0.001704,172.217.194.0-255,5738,105161,96,322546
40269,0.001707,172.31.47.0-255,66,105227,96,322546
40270,0.001711,172.217.194.0-255,4320,109547,96,322546
40271,0.001713,172.31.47.0-255,66,109613,96,322546
40272,0.001717,172.217.194.0-255,4320,113933,96,322546
40273,0.001718,172.31.47.0-255,66,113999,96,322546
40274,0.001735,172.217.194.0-255,7156,121155,96,322546
40275,0.001738,172.31.47.0-255,66,121221,96,322546
40276,0.001769,172.217.194.0-255,1484,122705,96,322546
40277,0.001787,172.217.194.0-255,6438,129143,96,322546
40278,0.00179,172.31.47.0-255,66,129209,96,322546
40279,0.002116,172.217.194.0-255,1484,130693,96,322546
40280,0.002121,172.217.194.0-255,1484,132177,96,322546
40281,0.002123,172.31.47.0-255,66,132243,96,322546
40282,0.00214,172.217.194.0-255,1484,133727,96,322546
40283,0.00219,172.217.194.0-255,5738,139465,96,322546
40284,0.002193,172.31.47.0-255,66,139531,96,322546
40285,0.002196,172.217.194.0-255,1484,141015,96,322546
40286,0.002199,172.217.194.0-255,2902,143917,96,322546
40287,0.002201,172.31.47.0-255,66,143983,96,322546
40288,0.00222,172.217.194.0-255,5738,149721,96,322546
40289,0.002221,172.31.47.0-255,66,149787,96,322546
40290,0.00223,172.31.47.0-255,66,149853,96,322546
40291,0.002251,172.217.194.0-255,3602,153455,96,322546
40292,0.002253,172.31.47.0-255,66,153521,96,322546
40293,0.002256,172.217.194.0-255,1484,155005,96,322546
40294,0.002283,172.31.47.0-255,66,155071,96,322546
40295,0.002286,172.217.194.0-255,2902,157973,96,322546
40296,0.002287,172.31.47.0-255,66,158039,96,322546
40297,0.00229,172.217.194.0-255,1484,159523,96,322546
40298,0.002321,172.31.47.0-255,66,159589,96,322546
40299,0.002323,172.217.194.0-255,766,160355,96,322546
40300,0.00266,172.31.47.0-255,66,160421,96,322546
40301,0.00456,172.217.194.0-255,4320,164741,96,322546
40302,0.004564,172.31.47.0-255,66,164807,96,322546
40303,0.004908,172.217.194.0-255,1484,166291,96,322546
40304,0.00681,172.217.194.0-255,2902,169193,96,322546
40305,0.006815,172.31.47.0-255,66,169259,96,322546
40306,0.006831,172.217.194.0-255,1484,170743,96,322546
40307,0.009072,172.217.194.0-255,4320,175063,96,322546
40308,0.00908,172.31.47.0-255,66,175129,96,322546
40309,0.011365,172.217.194.0-255,5738,180867,96,322546
40310,0.011379,172.31.47.0-255,66,180933,96,322546
40311,0.013707,172.217.194.0-255,5738,186671,96,322546
40312,0.013726,172.31.47.0-255,66,186737,96,322546
40313,0.01602,172.217.194.0-255,5738,192475,96,322546
40314,0.01604,172.31.47.0-255,66,192541,96,322546
40315,0.018315,172.217.194.0-255,5738,198279,96,322546
40316,0.018333,172.31.47.0-255,66,198345,96,322546
40317,0.020626,172.217.194.0-255,5738,204083,96,322546
40318,0.020635,172.31.47.0-255,66,204149,96,322546
40319,0.022903,172.217.194.0-255,5738,209887,96,322546
40320,0.02291,172.31.47.0-255,66,209953,96,322546
40321,0.025165,172.217.194.0-255,5738,215691,96,322546
40322,0.025171,172.31.47.0-255,66,215757,96,322546
40323,0.027437,172.217.194.0-255,5738,221495,96,322546
40324,0.027445,172.31.47.0-255,66,221561,96,322546
40325,0.028535,172.31.47.0-255,172,221733,96,322546
40326,0.028577,172.31.47.0-255,1104,222837,96,322546
40327,0.028639,172.31.47.0-255,1514,224351,96,322546
40328,0.02864,172.31.47.0-255,1307,225658,96,322546
40329,0.029711,172.217.194.0-255,5738,231396,96,322546
40330,0.029718,172.31.47.0-255,66,231462,96,322546
40331,0.030111,104.244.42.0-255,66,231528,96,322546
40332,0.030298,104.244.42.0-255,66,231594,96,322546
40333,0.030354,104.244.42.0-255,66,231660,96,322546
40334,0.031973,172.217.194.0-255,4320,235980,96,322546
40335,0.031976,172.31.47.0-255,66,236046,96,322546
40336,0.032006,172.217.194.0-255,1484,237530,96,322546
40337,0.034241,172.217.194.0-255,4320,241850,96,322546
40338,0.034248,172.31.47.0-255,66,241916,96,322546
40339,0.0365,172.217.194.0-255,5738,247654,96,322546
40340,0.036506,172.31.47.0-255,66,247720,96,322546
40341,0.038737,172.217.194.0-255,5738,253458,96,322546
40342,0.038742,172.31.47.0-255,66,253524,96,322546
40343,0.04099,172.217.194.0-255,5738,259262,96,322546
40344,0.040995,172.31.47.0-255,66,259328,96,322546
40345,0.043265,172.217.194.0-255,5738,265066,96,322546
40346,0.043271,172.31.47.0-255,66,265132,96,322546
40347,0.045515,172.217.194.0-255,5738,270870,96,322546
40348,0.045521,172.31.47.0-255,66,270936,96,322546
40349,0.047769,172.217.194.0-255,5738,276674,96,322546
40350,0.047775,172.31.47.0-255,66,276740,96,322546
40351,0.05001,172.217.194.0-255,4320,281060,96,322546
40352,0.050014,172.31.47.0-255,66,281126,96,322546
40353,0.050042,172.217.194.0-255,1484,282610,96,322546
40354,0.052301,172.217.194.0-255,2902,285512,96,322546
40355,0.052307,172.31.47.0-255,66,285578,96,322546
40356,0.052336,172.217.194.0-255,1484,287062,96,322546
40357,0.054567,172.217.194.0-255,1484,288546,96,322546
40358,0.054571,172.31.47.0-255,66,288612,96,322546
40359,0.054601,172.217.194.0-255,2902,291514,96,322546
40360,0.054604,172.31.47.0-255,66,291580,96,322546
40361,0.056829,172.217.194.0-255,2902,294482,96,322546
40362,0.056834,172.31.47.0-255,66,294548,96,322546
40363,0.056854,172.217.194.0-255,2902,297450,96,322546
40364,0.056856,172.31.47.0-255,66,297516,96,322546
40365,0.059056,172.217.194.0-255,1484,299000,96,322546
40366,0.05908,172.217.194.0-255,2902,301902,96,322546
40367,0.059085,172.31.47.0-255,66,301968,96,322546
40368,0.059103,172.217.194.0-255,1484,303452,96,322546
40369,0.061327,172.217.194.0-255,2902,306354,96,322546
40370,0.061332,172.31.47.0-255,66,306420,96,322546
40371,0.061347,172.217.194.0-255,1484,307904,96,322546
40372,0.063577,172.217.194.0-255,4320,312224,96,322546
40373,0.063582,172.31.47.0-255,66,312290,96,322546
40374,0.065849,172.217.194.0-255,4320,316610,96,322546
40375,0.065855,172.31.47.0-255,66,316676,96,322546
40376,0.065871,172.217.194.0-255,1484,318160,96,322546
40377,0.068095,172.217.194.0-255,4320,322480,96,322546
40378,0.068101,172.31.47.0-255,66,322546,96,322546
40379,0.0,74.125.24.0-255,156,156,96,346294
40380,1.6e-05,172.31.47.0-255,66,222,96,346294
40381,2.1e-05,74.125.24.0-255,1484,1706,96,346294
40382,2.4e-05,172.31.47.0-255,66,1772,96,346294
40383,5.4e-05,74.125.24.0-255,2902,4674,96,346294
40384,5.8e-05,172.31.47.0-255,66,4740,96,346294
40385,7.3e-05,74.125.24.0-255,7156,11896,96,346294
40386,7.6e-05,172.31.47.0-255,66,11962,96,346294
40387,7.9e-05,74.125.24.0-255,1975,13937,96,346294
40388,8.1e-05,172.31.47.0-255,66,14003,96,346294
40389,0.00011,74.125.24.0-255,4320,18323,96,346294
40390,0.000113,172.31.47.0-255,66,18389,96,346294
40391,0.000131,74.125.24.0-255,1484,19873,96,346294
40392,0.000137,74.125.24.0-255,7156,27029,96,346294
40393,0.00014,172.31.47.0-255,66,27095,96,346294
40394,0.000142,172.31.47.0-255,66,27161,96,346294
40395,0.000158,74.125.24.0-255,3961,31122,96,346294
40396,0.00016,172.31.47.0-255,66,31188,96,346294
40397,0.00019,74.125.24.0-255,4320,35508,96,346294
40398,0.000192,172.31.47.0-255,66,35574,96,346294
40399,0.000208,74.125.24.0-255,1484,37058,96,346294
40400,0.00021,172.31.47.0-255,66,37124,96,346294
40401,0.000234,74.125.24.0-255,7156,44280,96,346294
40402,0.000236,172.31.47.0-255,66,44346,96,346294
40403,0.000273,74.125.24.0-255,3961,48307,96,346294
40404,0.000275,172.31.47.0-255,66,48373,96,346294
40405,0.000322,74.125.24.0-255,1484,49857,96,346294
40406,0.000324,172.31.47.0-255,66,49923,96,346294
40407,0.000328,74.125.24.0-255,1484,51407,96,346294
40408,0.000329,172.31.47.0-255,66,51473,96,346294
40409,0.000339,74.125.24.0-255,1484,52957,96,346294
40410,0.000341,172.31.47.0-255,66,53023,96,346294
40411,0.000361,74.125.24.0-255,5738,58761,96,346294
40412,0.000364,172.31.47.0-255,66,58827,96,346294
40413,0.000367,74.125.24.0-255,2902,61729,96,346294
40414,0.000369,172.31.47.0-255,66,61795,96,346294
40415,0.000416,74.125.24.0-255,4572,66367,96,346294
40416,0.000419,172.31.47.0-255,66,66433,96,346294
40417,0.000487,74.125.24.0-255,1484,67917,96,346294
40418,0.000492,74.125.24.0-255,2902,70819,96,346294
40419,0.000496,172.31.47.0-255,66,70885,96,346294
40420,0.00052,74.125.24.0-255,5738,76623,96,346294
40421,0.000524,172.31.47.0-255,66,76689,96,346294
40422,0.000528,74.125.24.0-255,4320,81009,96,346294
40423,0.000531,172.31.47.0-255,66,81075,96,346294
40424,0.000562,74.125.24.0-255,2543,83618,96,346294
40425,0.000566,172.31.47.0-255,66,83684,96,346294
40426,0.00057,74.125.24.0-255,2902,86586,96,346294
40427,0.000572,172.31.47.0-255,66,86652,96,346294
40428,0.000588,74.125.24.0-255,5738,92390,96,346294
40429,0.000591,172.31.47.0-255,66,92456,96,346294
40430,0.000613,74.125.24.0-255,1484,93940,96,346294
40431,0.00062,74.125.24.0-255,5738,99678,96,346294
40432,0.000624,172.31.47.0-255,66,99744,96,346294
40433,0.000643,74.125.24.0-255,1125,100869,96,346294
40434,0.001137,74.125.24.0-255,1484,102353,96,346294
40435,0.001142,172.31.47.0-255,66,102419,96,346294
40436,0.001147,74.125.24.0-255,2902,105321,96,346294
40437,0.001149,172.31.47.0-255,66,105387,96,346294
40438,0.001151,74.125.24.0-255,1484,106871,96,346294
40439,0.001166,74.125.24.0-255,4320,111191,96,346294
40440,0.001167,172.31.47.0-255,66,111257,96,346294
40441,0.001171,74.125.24.0-255,2902,114159,96,346294
40442,0.001173,172.31.47.0-255,66,114225,96,346294
40443,0.001191,74.125.24.0-255,4320,118545,96,346294
40444,0.001193,172.31.47.0-255,66,118611,96,346294
40445,0.001199,74.125.24.0-255,7156,125767,96,346294
40446,0.001201,172.31.47.0-255,66,125833,96,346294
40447,0.001216,74.125.24.0-255,7156,132989,96,346294
40448,0.001218,172.31.47.0-255,66,133055,96,346294
40449,0.001222,74.125.24.0-255,2184,135239,96,346294
40450,0.001223,172.31.47.0-255,66,135305,96,346294
40451,0.00125,74.125.24.0-255,2902,138207,96,346294
40452,0.001252,172.31.47.0-255,66,138273,96,346294
40453,0.00127,74.125.24.0-255,4320,142593,96,346294
40454,0.001272,172.31.47.0-255,66,142659,96,346294
40455,0.001288,74.125.24.0-255,2902,145561,96,346294
40456,0.00129,172.31.47.0-255,66,145627,96,346294
40457,0.001292,74.125.24.0-255,1484,147111,96,346294
40458,0.001296,74.125.24.0-255,2902,150013,96,346294
40459,0.001298,172.31.47.0-255,66,150079,96,346294
40460,0.00133,172.31.47.0-255,66,150145,96,346294
40461,0.001338,172.31.47.0-255,66,150211,96,346294
40462,0.001709,74.125.24.0-255,1484,151695,96,346294
40463,0.001714,74.125.24.0-255,1484,153179,96,346294
40464,0.001717,172.31.47.0-255,66,153245,96,346294
40465,0.001737,74.125.24.0-255,1484,154729,96,346294
40466,0.001743,74.125.24.0-255,5738,160467,96,346294
40467,0.001745,172.31.47.0-255,66,160533,96,346294
40468,0.001751,74.125.24.0-255,5738,166271,96,346294
40469,0.001753,172.31.47.0-255,66,166337,96,346294
40470,0.001769,74.125.24.0-255,7156,173493,96,346294
40471,0.001771,172.31.47.0-255,66,173559,96,346294
40472,0.001808,172.31.47.0-255,66,173625,96,346294
40473,0.001867,74.125.24.0-255,1484,175109,96,346294
40474,0.001872,74.125.24.0-255,2902,178011,96,346294
40475,0.001875,172.31.47.0-255,66,178077,96,346294
40476,0.001896,74.125.24.0-255,5738,183815,96,346294
40477,0.001898,172.31.47.0-255,66,183881,96,346294
40478,0.001927,172.31.47.0-255,66,183947,96,346294
40479,0.001948,74.125.24.0-255,4320,188267,96,346294
40480,0.001951,172.31.47.0-255,66,188333,96,346294
40481,0.001962,172.31.47.0-255,66,188399,96,346294
40482,0.001973,172.31.47.0-255,66,188465,96,346294
40483,0.002027,172.31.47.0-255,66,188531,96,346294
40484,0.002032,74.125.24.0-255,3602,192133,96,346294
40485,0.002035,172.31.47.0-255,66,192199,96,346294
40486,0.002096,74.125.24.0-255,1484,193683,96,346294
40487,0.002101,74.125.24.0-255,2902,196585,96,346294
40488,0.002104,172.31.47.0-255,66,196651,96,346294
40489,0.002122,74.125.24.0-255,5738,202389,96,346294
40490,0.002124,172.31.47.0-255,66,202455,96,346294
40491,0.002127,74.125.24.0-255,1484,203939,96,346294
40492,0.00215,74.125.24.0-255,4320,208259,96,346294
40493,0.002156,74.125.24.0-255,5738,213997,96,346294
40494,0.002164,172.31.47.0-255,66,214063,96,346294
40495,0.002172,172.31.47.0-255,66,214129,96,346294
40496,0.002179,74.125.24.0-255,7156,221285,96,346294
40497,0.002181,172.31.47.0-255,66,221351,96,346294
40498,0.002185,74.125.24.0-255,2902,224253,96,346294
40499,0.002187,172.31.47.0-255,66,224319,96,346294
40500,0.002207,74.125.24.0-255,2184,226503,96,346294
40501,0.002211,172.31.47.0-255,66,226569,96,346294
40502,0.00446,74.125.24.0-255,2902,229471,96,346294
40503,0.004466,172.31.47.0-255,66,229537,96,346294
40504,0.004507,74.125.24.0-255,2902,232439,96,346294
40505,0.00451,172.31.47.0-255,66,232505,96,346294
40506,0.006777,74.125.24.0-255,2902,235407,96,346294
40507,0.006782,172.31.47.0-255,66,235473,96,346294
40508,0.006807,74.125.24.0-255,2902,238375,96,346294
40509,0.00681,172.31.47.0-255,66,238441,96,346294
40510,0.009073,74.125.24.0-255,2902,241343,96,346294
40511,0.009081,172.31.47.0-255,66,241409,96,346294
40512,0.009122,74.125.24.0-255,2902,244311,96,346294
40513,0.009126,172.31.47.0-255,66,244377,96,346294
40514,0.011446,74.125.24.0-255,5738,250115,96,346294
40515,0.011458,172.31.47.0-255,66,250181,96,346294
40516,0.013776,74.125.24.0-255,5738,255919,96,346294
40517,0.013784,172.31.47.0-255,66,255985,96,346294
40518,0.016077,74.125.24.0-255,5738,261723,96,346294
40519,0.016083,172.31.47.0-255,66,261789,96,346294
40520,0.018393,74.125.24.0-255,5738,267527,96,346294
40521,0.018399,172.31.47.0-255,66,267593,96,346294
40522,0.020703,74.125.24.0-255,5738,273331,96,346294
40523,0.020715,172.31.47.0-255,66,273397,96,346294
40524,0.023022,74.125.24.0-255,5738,279135,96,346294
40525,0.023029,172.31.47.0-255,66,279201,96,346294
40526,0.023496,172.31.47.0-255,172,279373,96,346294
40527,0.023536,172.31.47.0-255,1111,280484,96,346294
40528,0.023607,172.31.47.0-255,1514,281998,96,346294
40529,0.023609,172.31.47.0-255,1300,283298,96,346294
40530,0.025041,104.244.42.0-255,66,283364,96,346294
40531,0.025092,104.244.42.0-255,66,283430,96,346294
40532,0.025184,104.244.42.0-255,66,283496,96,346294
40533,0.025324,74.125.24.0-255,5738,289234,96,346294
40534,0.025327,172.31.47.0-255,66,289300,96,346294
40535,0.027645,74.125.24.0-255,5738,295038,96,346294
40536,0.027649,172.31.47.0-255,66,295104,96,346294
40537,0.02993,74.125.24.0-255,4320,299424,96,346294
40538,0.029934,172.31.47.0-255,66,299490,96,346294
40539,0.029967,74.125.24.0-255,1484,300974,96,346294
40540,0.032267,74.125.24.0-255,4320,305294,96,346294
40541,0.032273,172.31.47.0-255,66,305360,96,346294
40542,0.034609,74.125.24.0-255,5738,311098,96,346294
40543,0.034614,172.31.47.0-255,66,311164,96,346294
40544,0.036943,74.125.24.0-255,5738,316902,96,346294
40545,0.036948,172.31.47.0-255,66,316968,96,346294
40546,0.0393,74.125.24.0-255,5738,322706,96,346294
40547,0.039304,172.31.47.0-255,66,322772,96,346294
40548,0.041621,74.125.24.0-255,4320,327092,96,346294
40549,0.041627,172.31.47.0-255,66,327158,96,346294
40550,0.04169,74.125.24.0-255,1484,328642,96,346294
40551,0.043913,74.125.24.0-255,2902,331544,96,346294
40552,0.043918,172.31.47.0-255,66,331610,96,346294
40553,0.043942,74.125.24.0-255,1484,333094,96,346294
40554,0.046272,74.125.24.0-255,4320,337414,96,346294
40555,0.046278,172.31.47.0-255,66,337480,96,346294
40556,0.04859,74.125.24.0-255,5738,343218,96,346294
40557,0.048597,172.31.47.0-255,66,343284,96,346294
40558,0.050879,74.125.24.0-255,2773,346057,96,346294
40559,0.050884,172.31.47.0-255,66,346123,96,346294
40560,0.05107,172.31.47.0-255,105,346228,96,346294
40561,0.053353,74.125.24.0-255,66,346294,96,346294
40562,0.0,172.31.47.0-255,105,105,96,342
40563,0.001712,157.240.13.0-255,66,171,96,342
40564,0.001735,157.240.13.0-255,105,276,96,342
40565,0.001737,172.31.47.0-255,66,342,96,342
40566,0.0,172.31.47.0-255,105,105,96,276
40567,0.001458,157.240.13.0-255,105,210,96,276
40568,0.001467,172.31.47.0-255,66,276,96,276
40569,0.0,74.125.24.0-255,152,152,96,268028
40570,2.2e-05,172.31.47.0-255,66,218,96,268028
40571,3.6e-05,74.125.24.0-255,1484,1702,96,268028
40572,4e-05,172.31.47.0-255,66,1768,96,268028
40573,5.1e-05,74.125.24.0-255,2902,4670,96,268028
40574,5.3e-05,172.31.47.0-255,66,4736,96,268028
40575,8.5e-05,74.125.24.0-255,2902,7638,96,268028
40576,8.8e-05,172.31.47.0-255,66,7704,96,268028
40577,0.000117,74.125.24.0-255,4320,12024,96,268028
40578,0.00012,172.31.47.0-255,66,12090,96,268028
40579,0.000142,74.125.24.0-255,2055,14145,96,268028
40580,0.000145,172.31.47.0-255,66,14211,96,268028
40581,0.00028,74.125.24.0-255,1484,15695,96,268028
40582,0.000284,172.31.47.0-255,66,15761,96,268028
40583,0.000289,74.125.24.0-255,2902,18663,96,268028
40584,0.000292,172.31.47.0-255,66,18729,96,268028
40585,0.000322,74.125.24.0-255,5738,24467,96,268028
40586,0.000325,172.31.47.0-255,66,24533,96,268028
40587,0.000331,74.125.24.0-255,5738,30271,96,268028
40588,0.000334,172.31.47.0-255,66,30337,96,268028
40589,0.000346,74.125.24.0-255,1484,31821,96,268028
40590,0.000348,172.31.47.0-255,66,31887,96,268028
40591,0.000385,172.31.47.0-255,66,31953,96,268028
40592,0.000389,74.125.24.0-255,2902,34855,96,268028
40593,0.000392,172.31.47.0-255,66,34921,96,268028
40594,0.00042,74.125.24.0-255,1484,36405,96,268028
40595,0.000423,172.31.47.0-255,66,36471,96,268028
40596,0.000467,172.31.47.0-255,66,36537,96,268028
40597,0.00047,74.125.24.0-255,441,36978,96,268028
40598,0.000472,172.31.47.0-255,66,37044,96,268028
40599,0.001286,74.125.24.0-255,332,37376,96,268028
40600,0.001292,172.31.47.0-255,66,37442,96,268028
40601,0.001754,74.125.24.0-255,1484,38926,96,268028
40602,0.00176,172.31.47.0-255,66,38992,96,268028
40603,0.001767,74.125.24.0-255,2902,41894,96,268028
40604,0.001769,172.31.47.0-255,66,41960,96,268028
40605,0.001782,74.125.24.0-255,5738,47698,96,268028
40606,0.001784,172.31.47.0-255,66,47764,96,268028
40607,0.001787,74.125.24.0-255,1484,49248,96,268028
40608,0.001789,172.31.47.0-255,66,49314,96,268028
40609,0.001825,172.31.47.0-255,66,49380,96,268028
40610,0.001862,74.125.24.0-255,5738,55118,96,268028
40611,0.001865,172.31.47.0-255,66,55184,96,268028
40612,0.001895,74.125.24.0-255,5020,60204,96,268028
40613,0.001897,172.31.47.0-255,66,60270,96,268028
40614,0.002652,74.125.24.0-255,1484,61754,96,268028
40615,0.002659,74.125.24.0-255,1484,63238,96,268028
40616,0.002662,172.31.47.0-255,66,63304,96,268028
40617,0.002687,74.125.24.0-255,1484,64788,96,268028
40618,0.002693,74.125.24.0-255,5738,70526,96,268028
40619,0.002695,172.31.47.0-255,66,70592,96,268028
40620,0.002708,74.125.24.0-255,4320,74912,96,268028
40621,0.00271,172.31.47.0-255,66,74978,96,268028
40622,0.00274,74.125.24.0-255,5738,80716,96,268028
40623,0.002742,172.31.47.0-255,66,80782,96,268028
40624,0.002747,74.125.24.0-255,4320,85102,96,268028
40625,0.002749,172.31.47.0-255,66,85168,96,268028
40626,0.002808,172.31.47.0-255,66,85234,96,268028
40627,0.002844,74.125.24.0-255,1484,86718,96,268028
40628,0.002848,74.125.24.0-255,2902,89620,96,268028
40629,0.00285,172.31.47.0-255,66,89686,96,268028
40630,0.002854,74.125.24.0-255,2902,92588,96,268028
40631,0.002856,172.31.47.0-255,66,92654,96,268028
40632,0.002885,74.125.24.0-255,2902,95556,96,268028
40633,0.002887,172.31.47.0-255,66,95622,96,268028
40634,0.002891,74.125.24.0-255,2902,98524,96,268028
40635,0.002893,172.31.47.0-255,66,98590,96,268028
40636,0.002935,172.31.47.0-255,66,98656,96,268028
40637,0.002946,172.31.47.0-255,66,98722,96,268028
40638,0.003034,74.125.24.0-255,1484,100206,96,268028
40639,0.00305,74.125.24.0-255,2902,103108,96,268028
40640,0.003052,172.31.47.0-255,66,103174,96,268028
40641,0.003058,74.125.24.0-255,4320,107494,96,268028
40642,0.00306,172.31.47.0-255,66,107560,96,268028
40643,0.003079,74.125.24.0-255,1484,109044,96,268028
40644,0.003086,74.125.24.0-255,5738,114782,96,268028
40645,0.003088,172.31.47.0-255,66,114848,96,268028
40646,0.003115,74.125.24.0-255,7156,122004,96,268028
40647,0.003118,172.31.47.0-255,66,122070,96,268028
40648,0.003129,172.31.47.0-255,66,122136,96,268028
40649,0.003485,74.125.24.0-255,1484,123620,96,268028
40650,0.003492,74.125.24.0-255,2902,126522,96,268028
40651,0.003496,172.31.47.0-255,66,126588,96,268028
40652,0.003523,74.125.24.0-255,5738,132326,96,268028
40653,0.003527,74.125.24.0-255,2902,135228,96,268028
40654,0.003531,172.31.47.0-255,66,135294,96,268028
40655,0.003538,172.31.47.0-255,66,135360,96,268028
40656,0.003541,74.125.24.0-255,1484,136844,96,268028
40657,0.003562,74.125.24.0-255,5738,142582,96,268028
40658,0.003564,172.31.47.0-255,66,142648,96,268028
40659,0.003588,74.125.24.0-255,5738,148386,96,268028
40660,0.00359,172.31.47.0-255,66,148452,96,268028
40661,0.003599,172.31.47.0-255,66,148518,96,268028
40662,0.003628,74.125.24.0-255,1484,150002,96,268028
40663,0.003631,74.125.24.0-255,1484,151486,96,268028
40664,0.003633,172.31.47.0-255,66,151552,96,268028
40665,0.003656,74.125.24.0-255,1484,153036,96,268028
40666,0.003662,74.125.24.0-255,5738,158774,96,268028
40667,0.003664,172.31.47.0-255,66,158840,96,268028
40668,0.003695,74.125.24.0-255,5738,164578,96,268028
40669,0.003698,172.31.47.0-255,66,164644,96,268028
40670,0.003721,74.125.24.0-255,1484,166128,96,268028
40671,0.003732,172.31.47.0-255,66,166194,96,268028
40672,0.003737,74.125.24.0-255,4320,170514,96,268028
40673,0.003739,172.31.47.0-255,66,170580,96,268028
40674,0.003784,74.125.24.0-255,3602,174182,96,268028
40675,0.003787,172.31.47.0-255,66,174248,96,268028
40676,0.003885,74.125.24.0-255,1484,175732,96,268028
40677,0.0039,74.125.24.0-255,2902,178634,96,268028
40678,0.003903,172.31.47.0-255,66,178700,96,268028
40679,0.003909,74.125.24.0-255,4320,183020,96,268028
40680,0.003911,172.31.47.0-255,66,183086,96,268028
40681,0.003939,74.125.24.0-255,1484,184570,96,268028
40682,0.003951,172.31.47.0-255,66,184636,96,268028
40683,0.003964,74.125.24.0-255,4320,188956,96,268028
40684,0.00397,172.31.47.0-255,66,189022,96,268028
40685,0.003988,74.125.24.0-255,5738,194760,96,268028
40686,0.00399,172.31.47.0-255,66,194826,96,268028
40687,0.003996,74.125.24.0-255,5020,199846,96,268028
40688,0.003998,172.31.47.0-255,66,199912,96,268028
40689,0.004293,74.125.24.0-255,1484,201396,96,268028
40690,0.004299,74.125.24.0-255,2902,204298,96,268028
40691,0.004303,172.31.47.0-255,66,204364,96,268028
40692,0.004348,74.125.24.0-255,4320,208684,96,268028
40693,0.00435,172.31.47.0-255,66,208750,96,268028
40694,0.004377,74.125.24.0-255,1484,210234,96,268028
40695,0.00439,172.31.47.0-255,66,210300,96,268028
40696,0.004401,172.31.47.0-255,66,210366,96,268028
40697,0.00441,172.31.47.0-255,66,210432,96,268028
40698,0.004413,74.125.24.0-255,1484,211916,96,268028
40699,0.00444,74.125.24.0-255,5738,217654,96,268028
40700,0.004442,172.31.47.0-255,66,217720,96,268028
40701,0.004474,74.125.24.0-255,5738,223458,96,268028
40702,0.004477,172.31.47.0-255,66,223524,96,268028
40703,0.004481,74.125.24.0-255,4320,227844,96,268028
40704,0.004483,172.31.47.0-255,66,227910,96,268028
40705,0.004486,74.125.24.0-255,1484,229394,96,268028
40706,0.004497,74.125.24.0-255,7156,236550,96,268028
40707,0.004499,172.31.47.0-255,66,236616,96,268028
40708,0.004502,74.125.24.0-255,766,237382,96,268028
40709,0.004594,74.125.24.0-255,1484,238866,96,268028
40710,0.004598,172.31.47.0-255,66,238932,96,268028
40711,0.004603,74.125.24.0-255,2902,241834,96,268028
40712,0.004605,172.31.47.0-255,66,241900,96,268028
40713,0.004608,74.125.24.0-255,1484,243384,96,268028
40714,0.004637,74.125.24.0-255,4320,247704,96,268028
40715,0.004639,172.31.47.0-255,66,247770,96,268028
40716,0.004645,74.125.24.0-255,5738,253508,96,268028
40717,0.004647,172.31.47.0-255,66,253574,96,268028
40718,0.004682,74.125.24.0-255,7156,260730,96,268028
40719,0.004685,172.31.47.0-255,66,260796,96,268028
40720,0.004695,172.31.47.0-255,66,260862,96,268028
40721,0.004702,74.125.24.0-255,1484,262346,96,268028
40722,0.004734,172.31.47.0-255,66,262412,96,268028
40723,0.004736,74.125.24.0-255,979,263391,96,268028
40724,0.004781,74.125.24.0-255,105,263496,96,268028
40725,0.006403,172.31.47.0-255,66,263562,96,268028
40726,0.006449,172.31.47.0-255,105,263667,96,268028
40727,0.009004,74.125.24.0-255,66,263733,96,268028
40728,0.028726,172.31.47.0-255,172,263905,96,268028
40729,0.028771,172.31.47.0-255,1105,265010,96,268028
40730,0.028834,172.31.47.0-255,1514,266524,96,268028
40731,0.028836,172.31.47.0-255,1306,267830,96,268028
40732,0.030295,104.244.42.0-255,66,267896,96,268028
40733,0.03034,104.244.42.0-255,66,267962,96,268028
40734,0.030389,104.244.42.0-255,66,268028,96,268028
40735,0.0,74.125.24.0-255,158,158,96,192883
40736,1.7e-05,172.31.47.0-255,66,224,96,192883
40737,2.3e-05,74.125.24.0-255,1484,1708,96,192883
40738,2.6e-05,172.31.47.0-255,66,1774,96,192883
40739,3e-05,74.125.24.0-255,2902,4676,96,192883
40740,3.2e-05,172.31.47.0-255,66,4742,96,192883
40741,4.4e-05,74.125.24.0-255,7156,11898,96,192883
40742,4.7e-05,172.31.47.0-255,66,11964,96,192883
40743,5e-05,74.125.24.0-255,2014,13978,96,192883
40744,5.2e-05,172.31.47.0-255,66,14044,96,192883
40745,0.000262,74.125.24.0-255,1484,15528,96,192883
40746,0.000267,172.31.47.0-255,66,15594,96,192883
40747,0.000272,74.125.24.0-255,2902,18496,96,192883
40748,0.000275,172.31.47.0-255,66,18562,96,192883
40749,0.00028,74.125.24.0-255,5738,24300,96,192883
40750,0.000287,172.31.47.0-255,66,24366,96,192883
40751,0.000308,74.125.24.0-255,1484,25850,96,192883
40752,0.00031,172.31.47.0-255,66,25916,96,192883
40753,0.000331,74.125.24.0-255,5379,31295,96,192883
40754,0.000333,172.31.47.0-255,66,31361,96,192883
40755,0.000387,74.125.24.0-255,1484,32845,96,192883
40756,0.00039,172.31.47.0-255,66,32911,96,192883
40757,0.000395,74.125.24.0-255,2902,35813,96,192883
40758,0.000397,172.31.47.0-255,66,35879,96,192883
40759,0.000425,74.125.24.0-255,5738,41617,96,192883
40760,0.000428,172.31.47.0-255,66,41683,96,192883
40761,0.000454,74.125.24.0-255,5738,47421,96,192883
40762,0.000456,172.31.47.0-255,66,47487,96,192883
40763,0.000495,172.31.47.0-255,66,47553,96,192883
40764,0.000504,172.31.47.0-255,66,47619,96,192883
40765,0.000517,74.125.24.0-255,1396,49015,96,192883
40766,0.000554,74.125.24.0-255,417,49432,96,192883
40767,0.000557,172.31.47.0-255,66,49498,96,192883
40768,0.000715,74.125.24.0-255,1484,50982,96,192883
40769,0.00072,74.125.24.0-255,2902,53884,96,192883
40770,0.00073,172.31.47.0-255,66,53950,96,192883
40771,0.000736,74.125.24.0-255,5738,59688,96,192883
40772,0.000739,172.31.47.0-255,66,59754,96,192883
40773,0.000764,74.125.24.0-255,4320,64074,96,192883
40774,0.000767,172.31.47.0-255,66,64140,96,192883
40775,0.000805,172.31.47.0-255,66,64206,96,192883
40776,0.000812,74.125.24.0-255,7156,71362,96,192883
40777,0.000814,172.31.47.0-255,66,71428,96,192883
40778,0.000823,74.125.24.0-255,3602,75030,96,192883
40779,0.000825,172.31.47.0-255,66,75096,96,192883
40780,0.000854,74.125.24.0-255,4320,79416,96,192883
40781,0.000858,172.31.47.0-255,66,79482,96,192883
40782,0.000861,74.125.24.0-255,1484,80966,96,192883
40783,0.000889,74.125.24.0-255,7156,88122,96,192883
40784,0.000892,172.31.47.0-255,66,88188,96,192883
40785,0.000897,74.125.24.0-255,4320,92508,96,192883
40786,0.000899,172.31.47.0-255,66,92574,96,192883
40787,0.000926,172.31.47.0-255,66,92640,96,192883
40788,0.000936,74.125.24.0-255,6438,99078,96,192883
40789,0.000939,172.31.47.0-255,66,99144,96,192883
40790,0.000973,74.125.24.0-255,7156,106300,96,192883
40791,0.000978,74.125.24.0-255,4320,110620,96,192883
40792,0.000989,172.31.47.0-255,66,110686,96,192883
40793,0.000992,172.31.47.0-255,66,110752,96,192883
40794,0.000997,74.125.24.0-255,5738,116490,96,192883
40795,0.000999,172.31.47.0-255,66,116556,96,192883
40796,0.001037,74.125.24.0-255,7156,123712,96,192883
40797,0.001041,172.31.47.0-255,66,123778,96,192883
40798,0.001052,172.31.47.0-255,66,123844,96,192883
40799,0.001116,74.125.24.0-255,1484,125328,96,192883
40800,0.001126,74.125.24.0-255,1484,126812,96,192883
40801,0.001129,172.31.47.0-255,66,126878,96,192883
40802,0.001153,74.125.24.0-255,1484,128362,96,192883
40803,0.001158,74.125.24.0-255,5738,134100,96,192883
40804,0.00116,172.31.47.0-255,66,134166,96,192883
40805,0.001171,172.31.47.0-255,66,134232,96,192883
40806,0.001194,74.125.24.0-255,1484,135716,96,192883
40807,0.001204,172.31.47.0-255,66,135782,96,192883
40808,0.001272,172.31.47.0-255,66,135848,96,192883
40809,0.001275,74.125.24.0-255,2902,138750,96,192883
40810,0.001277,172.31.47.0-255,66,138816,96,192883
40811,0.001304,172.31.47.0-255,66,138882,96,192883
40812,0.00132,172.31.47.0-255,66,138948,96,192883
40813,0.001329,74.125.24.0-255,4320,143268,96,192883
40814,0.00133,172.31.47.0-255,66,143334,96,192883
40815,0.001369,172.31.47.0-255,66,143400,96,192883
40816,0.001374,74.125.24.0-255,3602,147002,96,192883
40817,0.001375,172.31.47.0-255,66,147068,96,192883
40818,0.00138,74.125.24.0-255,4320,151388,96,192883
40819,0.001381,172.31.47.0-255,66,151454,96,192883
40820,0.001384,74.125.24.0-255,1484,152938,96,192883
40821,0.001429,74.125.24.0-255,4320,157258,96,192883
40822,0.001433,172.31.47.0-255,66,157324,96,192883
40823,0.001437,172.31.47.0-255,66,157390,96,192883
40824,0.001472,172.31.47.0-255,66,157456,96,192883
40825,0.001508,74.125.24.0-255,1484,158940,96,192883
40826,0.001523,74.125.24.0-255,2902,161842,96,192883
40827,0.001533,74.125.24.0-255,2902,164744,96,192883
40828,0.00154,172.31.47.0-255,66,164810,96,192883
40829,0.00157,74.125.24.0-255,2902,167712,96,192883
40830,0.001597,74.125.24.0-255,2184,169896,96,192883
40831,0.001602,172.31.47.0-255,66,169962,96,192883
40832,0.001656,172.31.47.0-255,66,170028,96,192883
40833,0.00169,172.31.47.0-255,66,170094,96,192883
40834,0.001704,74.125.24.0-255,766,170860,96,192883
40835,0.001718,74.125.24.0-255,2902,173762,96,192883
40836,0.001728,172.31.47.0-255,66,173828,96,192883
40837,0.001754,74.125.24.0-255,7156,180984,96,192883
40838,0.001791,172.31.47.0-255,66,181050,96,192883
40839,0.001833,74.125.24.0-255,4251,185301,96,192883
40840,0.001846,172.31.47.0-255,66,185367,96,192883
40841,0.001848,74.125.24.0-255,105,185472,96,192883
40842,0.004125,172.31.47.0-255,66,185538,96,192883
40843,0.004161,172.31.47.0-255,105,185643,96,192883
40844,0.006476,74.125.24.0-255,66,185709,96,192883
40845,0.022013,172.31.47.0-255,172,185881,96,192883
40846,0.022055,172.31.47.0-255,1111,186992,96,192883
40847,0.022136,172.31.47.0-255,1514,188506,96,192883
40848,0.022138,172.31.47.0-255,1514,190020,96,192883
40849,0.022142,172.31.47.0-255,1514,191534,96,192883
40850,0.022143,172.31.47.0-255,1085,192619,96,192883
40851,0.023571,104.244.42.0-255,66,192685,96,192883
40852,0.023611,104.244.42.0-255,66,192751,96,192883
40853,0.023669,104.244.42.0-255,66,192817,96,192883
40854,0.023672,104.244.42.0-255,66,192883,96,192883
40855,0.0,74.125.24.0-255,152,152,96,267683
40856,2e-05,172.31.47.0-255,66,218,96,267683
40857,2.6e-05,74.125.24.0-255,1484,1702,96,267683
40858,3e-05,172.31.47.0-255,66,1768,96,267683
40859,3.5e-05,74.125.24.0-255,2902,4670,96,267683
40860,3.7e-05,172.31.47.0-255,66,4736,96,267683
40861,4.4e-05,74.125.24.0-255,7156,11892,96,267683
40862,4.8e-05,172.31.47.0-255,66,11958,96,267683
40863,9.8e-05,74.125.24.0-255,7156,19114,96,267683
40864,0.000103,172.31.47.0-255,66,19180,96,267683
40865,0.000133,172.31.47.0-255,66,19246,96,267683
40866,0.000136,74.125.24.0-255,2543,21789,96,267683
40867,0.000138,172.31.47.0-255,66,21855,96,267683
40868,0.000141,74.125.24.0-255,1484,23339,96,267683
40869,0.000143,172.31.47.0-255,66,23405,96,267683
40870,0.000157,74.125.24.0-255,1484,24889,96,267683
40871,0.000159,172.31.47.0-255,66,24955,96,267683
40872,0.000165,74.125.24.0-255,5738,30693,96,267683
40873,0.000168,172.31.47.0-255,66,30759,96,267683
40874,0.000186,74.125.24.0-255,1484,32243,96,267683
40875,0.000189,172.31.47.0-255,66,32309,96,267683
40876,0.000194,74.125.24.0-255,4320,36629,96,267683
40877,0.000196,172.31.47.0-255,66,36695,96,267683
40878,0.000232,74.125.24.0-255,2543,39238,96,267683
40879,0.000236,172.31.47.0-255,66,39304,96,267683
40880,0.00024,74.125.24.0-255,2902,42206,96,267683
40881,0.000242,172.31.47.0-255,66,42272,96,267683
40882,0.000248,74.125.24.0-255,5738,48010,96,267683
40883,0.00025,172.31.47.0-255,66,48076,96,267683
40884,0.000283,74.125.24.0-255,1484,49560,96,267683
40885,0.000285,172.31.47.0-255,66,49626,96,267683
40886,0.000292,74.125.24.0-255,6797,56423,96,267683
40887,0.000312,74.125.24.0-255,648,57071,96,267683
40888,0.000475,172.31.47.0-255,66,57137,96,267683
40889,0.000506,74.125.24.0-255,1484,58621,96,267683
40890,0.000512,74.125.24.0-255,2902,61523,96,267683
40891,0.000541,74.125.24.0-255,5738,67261,96,267683
40892,0.000549,172.31.47.0-255,66,67327,96,267683
40893,0.000587,74.125.24.0-255,6246,73573,96,267683
40894,0.000604,172.31.47.0-255,66,73639,96,267683
40895,0.000788,74.125.24.0-255,1484,75123,96,267683
40896,0.000794,74.125.24.0-255,2902,78025,96,267683
40897,0.000796,74.125.24.0-255,1484,79509,96,267683
40898,0.000816,74.125.24.0-255,4320,83829,96,267683
40899,0.000842,172.31.47.0-255,66,83895,96,267683
40900,0.000849,74.125.24.0-255,1484,85379,96,267683
40901,0.000854,74.125.24.0-255,5738,91117,96,267683
40902,0.000867,172.31.47.0-255,66,91183,96,267683
40903,0.000888,74.125.24.0-255,5020,96203,96,267683
40904,0.000911,74.125.24.0-255,5738,101941,96,267683
40905,0.000917,172.31.47.0-255,66,102007,96,267683
40906,0.000937,74.125.24.0-255,5738,107745,96,267683
40907,0.000961,74.125.24.0-255,7156,114901,96,267683
40908,0.000965,74.125.24.0-255,2902,117803,96,267683
40909,0.000971,172.31.47.0-255,66,117869,96,267683
40910,0.000982,74.125.24.0-255,2902,120771,96,267683
40911,0.000985,74.125.24.0-255,1484,122255,96,267683
40912,0.001002,172.31.47.0-255,66,122321,96,267683
40913,0.001026,172.31.47.0-255,66,122387,96,267683
40914,0.001039,74.125.24.0-255,1484,123871,96,267683
40915,0.001044,74.125.24.0-255,2902,126773,96,267683
40916,0.001066,74.125.24.0-255,4320,131093,96,267683
40917,0.001082,74.125.24.0-255,1484,132577,96,267683
40918,0.001086,74.125.24.0-255,4320,136897,96,267683
40919,0.001093,172.31.47.0-255,66,136963,96,267683
40920,0.001124,74.125.24.0-255,7156,144119,96,267683
40921,0.001137,74.125.24.0-255,1484,145603,96,267683
40922,0.001148,172.31.47.0-255,66,145669,96,267683
40923,0.001151,74.125.24.0-255,2184,147853,96,267683
40924,0.001156,172.31.47.0-255,66,147919,96,267683
40925,0.001242,74.125.24.0-255,1484,149403,96,267683
40926,0.001274,74.125.24.0-255,2902,152305,96,267683
40927,0.001291,172.31.47.0-255,66,152371,96,267683
40928,0.001309,74.125.24.0-255,1484,153855,96,267683
40929,0.00132,74.125.24.0-255,2902,156757,96,267683
40930,0.001327,172.31.47.0-255,66,156823,96,267683
40931,0.001351,74.125.24.0-255,5738,162561,96,267683
40932,0.001353,74.125.24.0-255,1484,164045,96,267683
40933,0.001395,74.125.24.0-255,1484,165529,96,267683
40934,0.001408,172.31.47.0-255,66,165595,96,267683
40935,0.001427,172.31.47.0-255,66,165661,96,267683
40936,0.001519,74.125.24.0-255,1484,167145,96,267683
40937,0.001536,74.125.24.0-255,2902,170047,96,267683
40938,0.001552,74.125.24.0-255,4320,174367,96,267683
40939,0.001555,172.31.47.0-255,66,174433,96,267683
40940,0.001565,172.31.47.0-255,66,174499,96,267683
40941,0.001604,74.125.24.0-255,4320,178819,96,267683
40942,0.001611,172.31.47.0-255,66,178885,96,267683
40943,0.001641,172.31.47.0-255,66,178951,96,267683
40944,0.001701,74.125.24.0-255,1484,180435,96,267683
40945,0.001705,74.125.24.0-255,1484,181919,96,267683
40946,0.001722,74.125.24.0-255,1484,183403,96,267683
40947,0.001728,74.125.24.0-255,5738,189141,96,267683
40948,0.001739,74.125.24.0-255,2902,192043,96,267683
40949,0.001743,172.31.47.0-255,66,192109,96,267683
40950,0.001767,74.125.24.0-255,7156,199265,96,267683
40951,0.001803,74.125.24.0-255,3602,202867,96,267683
40952,0.001814,172.31.47.0-255,66,202933,96,267683
40953,0.001963,74.125.24.0-255,1484,204417,96,267683
40954,0.001967,74.125.24.0-255,1484,205901,96,267683
40955,0.001972,172.31.47.0-255,66,205967,96,267683
40956,0.001979,74.125.24.0-255,1484,207451,96,267683
40957,0.001999,74.125.24.0-255,5738,213189,96,267683
40958,0.002005,172.31.47.0-255,66,213255,96,267683
40959,0.002041,172.31.47.0-255,66,213321,96,267683
40960,0.002049,74.125.24.0-255,4320,217641,96,267683
40961,0.002053,172.31.47.0-255,66,217707,96,267683
40962,0.002097,172.31.47.0-255,66,217773,96,267683
40963,0.002123,172.31.47.0-255,66,217839,96,267683
40964,0.002171,172.31.47.0-255,66,217905,96,267683
40965,0.002246,74.125.24.0-255,1484,219389,96,267683
40966,0.002251,74.125.24.0-255,2902,222291,96,267683
40967,0.002255,172.31.47.0-255,66,222357,96,267683
40968,0.002264,74.125.24.0-255,1484,223841,96,267683
40969,0.002277,74.125.24.0-255,4320,228161,96,267683
40970,0.002291,74.125.24.0-255,4320,232481,96,267683
40971,0.002311,74.125.24.0-255,2902,235383,96,267683
40972,0.002316,172.31.47.0-255,66,235449,96,267683
40973,0.00238,172.31.47.0-255,66,235515,96,267683
40974,0.004664,74.125.24.0-255,5738,241253,96,267683
40975,0.004673,172.31.47.0-255,66,241319,96,267683
40976,0.006966,74.125.24.0-255,5738,247057,96,267683
40977,0.008523,172.31.47.0-255,66,247123,96,267683
40978,0.010846,74.125.24.0-255,5738,252861,96,267683
40979,0.010856,172.31.47.0-255,66,252927,96,267683
40980,0.013146,74.125.24.0-255,5738,258665,96,267683
40981,0.013155,172.31.47.0-255,66,258731,96,267683
40982,0.015447,74.125.24.0-255,4420,263151,96,267683
40983,0.015455,172.31.47.0-255,66,263217,96,267683
40984,0.017702,172.31.47.0-255,105,263322,96,267683
40985,0.019943,74.125.24.0-255,66,263388,96,267683
40986,0.02618,172.31.47.0-255,172,263560,96,267683
40987,0.026208,172.31.47.0-255,1110,264670,96,267683
40988,0.026256,172.31.47.0-255,1514,266184,96,267683
40989,0.026258,172.31.47.0-255,1301,267485,96,267683
40990,0.027687,104.244.42.0-255,66,267551,96,267683
40991,0.02775,104.244.42.0-255,66,267617,96,267683
40992,0.027798,104.244.42.0-255,66,267683,96,267683
40993,0.0,172.217.194.0-255,298,298,96,299467
40994,3.1e-05,172.31.47.0-255,66,364,96,299467
40995,3.7e-05,172.217.194.0-255,1484,1848,96,299467
40996,4.2e-05,172.31.47.0-255,66,1914,96,299467
40997,4.7e-05,172.217.194.0-255,4320,6234,96,299467
40998,5e-05,172.31.47.0-255,66,6300,96,299467
40999,5.5e-05,172.217.194.0-255,5738,12038,96,299467
41000,5.8e-05,172.31.47.0-255,66,12104,96,299467
41001,9.2e-05,172.217.194.0-255,1812,13916,96,299467
41002,9.5e-05,172.31.47.0-255,66,13982,96,299467
41003,0.000336,172.217.194.0-255,1484,15466,96,299467
41004,0.000341,172.31.47.0-255,66,15532,96,299467
41005,0.000347,172.217.194.0-255,2902,18434,96,299467
41006,0.00035,172.31.47.0-255,66,18500,96,299467
41007,0.000353,172.217.194.0-255,1484,19984,96,299467
41008,0.000355,172.31.47.0-255,66,20050,96,299467
41009,0.000383,172.217.194.0-255,4320,24370,96,299467
41010,0.000386,172.31.47.0-255,66,24436,96,299467
41011,0.000394,172.217.194.0-255,6797,31233,96,299467
41012,0.000397,172.31.47.0-255,66,31299,96,299467
41013,0.000534,172.217.194.0-255,1484,32783,96,299467
41014,0.000538,172.31.47.0-255,66,32849,96,299467
41015,0.000559,172.217.194.0-255,2902,35751,96,299467
41016,0.000561,172.31.47.0-255,66,35817,96,299467
41017,0.000567,172.217.194.0-255,5738,41555,96,299467
41018,0.000569,172.31.47.0-255,66,41621,96,299467
41019,0.000607,172.31.47.0-255,66,41687,96,299467
41020,0.00062,172.31.47.0-255,66,41753,96,299467
41021,0.00065,172.217.194.0-255,4219,45972,96,299467
41022,0.000653,172.31.47.0-255,66,46038,96,299467
41023,0.000691,172.217.194.0-255,117,46155,96,299467
41024,0.000695,172.217.194.0-255,377,46532,96,299467
41025,0.000837,172.31.47.0-255,66,46598,96,299467
41026,0.000915,172.217.194.0-255,1484,48082,96,299467
41027,0.000933,172.217.194.0-255,2902,50984,96,299467
41028,0.000937,172.31.47.0-255,66,51050,96,299467
41029,0.000943,172.217.194.0-255,5738,56788,96,299467
41030,0.000945,172.31.47.0-255,66,56854,96,299467
41031,0.000962,172.217.194.0-255,7156,64010,96,299467
41032,0.000964,172.31.47.0-255,66,64076,96,299467
41033,0.000979,172.217.194.0-255,5738,69814,96,299467
41034,0.000981,172.31.47.0-255,66,69880,96,299467
41035,0.001005,172.217.194.0-255,5738,75618,96,299467
41036,0.001008,172.31.47.0-255,66,75684,96,299467
41037,0.001022,172.217.194.0-255,5020,80704,96,299467
41038,0.001024,172.31.47.0-255,66,80770,96,299467
41039,0.001692,172.217.194.0-255,1484,82254,96,299467
41040,0.001702,172.217.194.0-255,2902,85156,96,299467
41041,0.001705,172.31.47.0-255,66,85222,96,299467
41042,0.001712,172.217.194.0-255,5738,90960,96,299467
41043,0.001713,172.31.47.0-255,66,91026,96,299467
41044,0.001739,172.217.194.0-255,7156,98182,96,299467
41045,0.001741,172.31.47.0-255,66,98248,96,299467
41046,0.001764,172.217.194.0-255,5738,103986,96,299467
41047,0.001767,172.31.47.0-255,66,104052,96,299467
41048,0.001777,172.31.47.0-255,66,104118,96,299467
41049,0.001801,172.217.194.0-255,766,104884,96,299467
41050,0.00202,172.31.47.0-255,66,104950,96,299467
41051,0.002044,172.217.194.0-255,1484,106434,96,299467
41052,0.002049,172.217.194.0-255,2902,109336,96,299467
41053,0.002051,172.31.47.0-255,66,109402,96,299467
41054,0.002057,172.217.194.0-255,5738,115140,96,299467
41055,0.002059,172.31.47.0-255,66,115206,96,299467
41056,0.002099,172.31.47.0-255,66,115272,96,299467
41057,0.002121,172.217.194.0-255,2902,118174,96,299467
41058,0.002124,172.31.47.0-255,66,118240,96,299467
41059,0.00213,172.217.194.0-255,7156,125396,96,299467
41060,0.002132,172.31.47.0-255,66,125462,96,299467
41061,0.002156,172.217.194.0-255,3602,129064,96,299467
41062,0.002159,172.31.47.0-255,66,129130,96,299467
41063,0.004391,172.217.194.0-255,1484,130614,96,299467
41064,0.004419,172.217.194.0-255,1484,132098,96,299467
41065,0.004424,172.31.47.0-255,66,132164,96,299467
41066,0.00444,172.217.194.0-255,2902,135066,96,299467
41067,0.004442,172.31.47.0-255,66,135132,96,299467
41068,0.006717,172.217.194.0-255,5738,140870,96,299467
41069,0.006723,172.31.47.0-255,66,140936,96,299467
41070,0.009006,172.217.194.0-255,5738,146674,96,299467
41071,0.009012,172.31.47.0-255,66,146740,96,299467
41072,0.011276,172.217.194.0-255,5738,152478,96,299467
41073,0.011283,172.31.47.0-255,66,152544,96,299467
41074,0.013574,172.217.194.0-255,5738,158282,96,299467
41075,0.013582,172.31.47.0-255,66,158348,96,299467
41076,0.015875,172.217.194.0-255,5738,164086,96,299467
41077,0.015884,172.31.47.0-255,66,164152,96,299467
41078,0.018173,172.217.194.0-255,5738,169890,96,299467
41079,0.01818,172.31.47.0-255,66,169956,96,299467
41080,0.020452,172.217.194.0-255,5738,175694,96,299467
41081,0.020458,172.31.47.0-255,66,175760,96,299467
41082,0.02063,172.31.47.0-255,172,175932,96,299467
41083,0.020672,172.31.47.0-255,1111,177043,96,299467
41084,0.020732,172.31.47.0-255,1514,178557,96,299467
41085,0.020734,172.31.47.0-255,1300,179857,96,299467
41086,0.022174,104.244.42.0-255,66,179923,96,299467
41087,0.022218,104.244.42.0-255,66,179989,96,299467
41088,0.022257,104.244.42.0-255,66,180055,96,299467
41089,0.022727,172.217.194.0-255,2902,182957,96,299467
41090,0.022731,172.31.47.0-255,66,183023,96,299467
41091,0.022757,172.217.194.0-255,2902,185925,96,299467
41092,0.02276,172.31.47.0-255,66,185991,96,299467
41093,0.024979,172.217.194.0-255,2902,188893,96,299467
41094,0.024983,172.31.47.0-255,66,188959,96,299467
41095,0.025015,172.217.194.0-255,2902,191861,96,299467
41096,0.025018,172.31.47.0-255,66,191927,96,299467
41097,0.027287,172.217.194.0-255,4320,196247,96,299467
41098,0.027292,172.31.47.0-255,66,196313,96,299467
41099,0.027314,172.217.194.0-255,1484,197797,96,299467
41100,0.029573,172.217.194.0-255,2902,200699,96,299467
41101,0.029577,172.31.47.0-255,66,200765,96,299467
41102,0.031876,172.217.194.0-255,5738,206503,96,299467
41103,0.031882,172.31.47.0-255,66,206569,96,299467
41104,0.034187,172.217.194.0-255,5738,212307,96,299467
41105,0.034209,172.31.47.0-255,66,212373,96,299467
41106,0.036483,172.217.194.0-255,5738,218111,96,299467
41107,0.036487,172.31.47.0-255,66,218177,96,299467
41108,0.038738,172.217.194.0-255,2902,221079,96,299467
41109,0.038743,172.31.47.0-255,66,221145,96,299467
41110,0.038769,172.217.194.0-255,2902,224047,96,299467
41111,0.038772,172.31.47.0-255,66,224113,96,299467
41112,0.040986,172.217.194.0-255,2902,227015,96,299467
41113,0.04099,172.31.47.0-255,66,227081,96,299467
41114,0.041065,172.217.194.0-255,2902,229983,96,299467
41115,0.041069,172.31.47.0-255,66,230049,96,299467
41116,0.043257,172.217.194.0-255,2902,232951,96,299467
41117,0.043262,172.31.47.0-255,66,233017,96,299467
41118,0.043333,172.217.194.0-255,2902,235919,96,299467
41119,0.043337,172.31.47.0-255,66,235985,96,299467
41120,0.045525,172.217.194.0-255,2902,238887,96,299467
41121,0.04553,172.31.47.0-255,66,238953,96,299467
41122,0.045598,172.217.194.0-255,2902,241855,96,299467
41123,0.045602,172.31.47.0-255,66,241921,96,299467
41124,0.047774,172.217.194.0-255,2902,244823,96,299467
41125,0.047779,172.31.47.0-255,66,244889,96,299467
41126,0.047866,172.217.194.0-255,2902,247791,96,299467
41127,0.04787,172.31.47.0-255,66,247857,96,299467
41128,0.050037,172.217.194.0-255,2902,250759,96,299467
41129,0.050043,172.31.47.0-255,66,250825,96,299467
41130,0.050121,172.217.194.0-255,2902,253727,96,299467
41131,0.050126,172.31.47.0-255,66,253793,96,299467
41132,0.052328,172.217.194.0-255,2902,256695,96,299467
41133,0.052332,172.31.47.0-255,66,256761,96,299467
41134,0.052359,172.217.194.0-255,1484,258245,96,299467
41135,0.052369,172.217.194.0-255,1484,259729,96,299467
41136,0.052371,172.31.47.0-255,66,259795,96,299467
41137,0.054603,172.217.194.0-255,2902,262697,96,299467
41138,0.054612,172.31.47.0-255,66,262763,96,299467
41139,0.054646,172.217.194.0-255,2902,265665,96,299467
41140,0.054649,172.31.47.0-255,66,265731,96,299467
41141,0.056888,172.217.194.0-255,2902,268633,96,299467
41142,0.056894,172.31.47.0-255,66,268699,96,299467
41143,0.056926,172.217.194.0-255,2902,271601,96,299467
41144,0.056929,172.31.47.0-255,66,271667,96,299467
41145,0.059173,172.217.194.0-255,2902,274569,96,299467
41146,0.059177,172.31.47.0-255,66,274635,96,299467
41147,0.059206,172.217.194.0-255,2902,277537,96,299467
41148,0.059208,172.31.47.0-255,66,277603,96,299467
41149,0.06147,172.217.194.0-255,5738,283341,96,299467
41150,0.061474,172.31.47.0-255,66,283407,96,299467
41151,0.063721,172.217.194.0-255,5738,289145,96,299467
41152,0.063727,172.31.47.0-255,66,289211,96,299467
41153,0.06598,172.217.194.0-255,4320,293531,96,299467
41154,0.065984,172.31.47.0-255,66,293597,96,299467
41155,0.06601,172.217.194.0-255,1484,295081,96,299467
41156,0.068245,172.217.194.0-255,4320,299401,96,299467
41157,0.068249,172.31.47.0-255,66,299467,96,299467
41158,0.0,74.125.130.0-255,159,159,96,260256
41159,2.9e-05,172.31.47.0-255,66,225,96,260256
41160,3.5e-05,74.125.130.0-255,1484,1709,96,260256
41161,3.9e-05,172.31.47.0-255,66,1775,96,260256
41162,6.2e-05,74.125.130.0-255,2902,4677,96,260256
41163,6.8e-05,172.31.47.0-255,66,4743,96,260256
41164,7.8e-05,74.125.130.0-255,1484,6227,96,260256
41165,8.3e-05,172.31.47.0-255,66,6293,96,260256
41166,0.00011,74.125.130.0-255,4320,10613,96,260256
41167,0.000113,172.31.47.0-255,66,10679,96,260256
41168,0.000116,74.125.130.0-255,1484,12163,96,260256
41169,0.000118,172.31.47.0-255,66,12229,96,260256
41170,0.000122,74.125.130.0-255,2125,14354,96,260256
41171,0.000124,172.31.47.0-255,66,14420,96,260256
41172,0.000232,74.125.130.0-255,1484,15904,96,260256
41173,0.000236,172.31.47.0-255,66,15970,96,260256
41174,0.000259,74.125.130.0-255,2902,18872,96,260256
41175,0.000262,172.31.47.0-255,66,18938,96,260256
41176,0.000317,74.125.130.0-255,1484,20422,96,260256
41177,0.00032,172.31.47.0-255,66,20488,96,260256
41178,0.000336,74.125.130.0-255,1484,21972,96,260256
41179,0.000338,172.31.47.0-255,66,22038,96,260256
41180,0.000366,74.125.130.0-255,2902,24940,96,260256
41181,0.00037,172.31.47.0-255,66,25006,96,260256
41182,0.000376,74.125.130.0-255,5738,30744,96,260256
41183,0.000378,172.31.47.0-255,66,30810,96,260256
41184,0.000381,74.125.130.0-255,1125,31935,96,260256
41185,0.000388,172.31.47.0-255,66,32001,96,260256
41186,0.000746,74.125.130.0-255,1484,33485,96,260256
41187,0.000752,172.31.47.0-255,66,33551,96,260256
41188,0.000762,74.125.130.0-255,2902,36453,96,260256
41189,0.000771,172.31.47.0-255,66,36519,96,260256
41190,0.000778,74.125.130.0-255,5738,42257,96,260256
41191,0.000779,172.31.47.0-255,66,42323,96,260256
41192,0.000828,74.125.130.0-255,6797,49120,96,260256
41193,0.000832,172.31.47.0-255,66,49186,96,260256
41194,0.00084,74.125.130.0-255,7156,56342,96,260256
41195,0.000848,172.31.47.0-255,66,56408,96,260256
41196,0.000856,74.125.130.0-255,7156,63564,96,260256
41197,0.000859,172.31.47.0-255,66,63630,96,260256
41198,0.0009,74.125.130.0-255,2832,66462,96,260256
41199,0.000905,172.31.47.0-255,66,66528,96,260256
41200,0.001021,74.125.130.0-255,100,66628,96,260256
41201,0.001134,74.125.130.0-255,362,66990,96,260256
41202,0.001615,172.31.47.0-255,66,67056,96,260256
41203,0.001633,74.125.130.0-255,1484,68540,96,260256
41204,0.00165,74.125.130.0-255,2902,71442,96,260256
41205,0.001653,172.31.47.0-255,66,71508,96,260256
41206,0.001684,74.125.130.0-255,4320,75828,96,260256
41207,0.001688,172.31.47.0-255,66,75894,96,260256
41208,0.001716,74.125.130.0-255,5738,81632,96,260256
41209,0.001719,172.31.47.0-255,66,81698,96,260256
41210,0.001747,74.125.130.0-255,2902,84600,96,260256
41211,0.00175,172.31.47.0-255,66,84666,96,260256
41212,0.001753,74.125.130.0-255,1484,86150,96,260256
41213,0.001777,74.125.130.0-255,2902,89052,96,260256
41214,0.00178,172.31.47.0-255,66,89118,96,260256
41215,0.001783,74.125.130.0-255,1484,90602,96,260256
41216,0.001805,74.125.130.0-255,2902,93504,96,260256
41217,0.001808,172.31.47.0-255,66,93570,96,260256
41218,0.001839,74.125.130.0-255,5738,99308,96,260256
41219,0.001842,172.31.47.0-255,66,99374,96,260256
41220,0.001877,74.125.130.0-255,2184,101558,96,260256
41221,0.00188,172.31.47.0-255,66,101624,96,260256
41222,0.004373,74.125.130.0-255,2902,104526,96,260256
41223,0.004376,172.31.47.0-255,66,104592,96,260256
41224,0.004407,74.125.130.0-255,2902,107494,96,260256
41225,0.00441,172.31.47.0-255,66,107560,96,260256
41226,0.006904,74.125.130.0-255,2902,110462,96,260256
41227,0.006912,172.31.47.0-255,66,110528,96,260256
41228,0.006942,74.125.130.0-255,2902,113430,96,260256
41229,0.006945,172.31.47.0-255,66,113496,96,260256
41230,0.009439,74.125.130.0-255,2902,116398,96,260256
41231,0.009447,172.31.47.0-255,66,116464,96,260256
41232,0.00948,74.125.130.0-255,2902,119366,96,260256
41233,0.009483,172.31.47.0-255,66,119432,96,260256
41234,0.011977,74.125.130.0-255,2902,122334,96,260256
41235,0.011985,172.31.47.0-255,66,122400,96,260256
41236,0.012022,74.125.130.0-255,2902,125302,96,260256
41237,0.012026,172.31.47.0-255,66,125368,96,260256
41238,0.014523,74.125.130.0-255,2902,128270,96,260256
41239,0.014539,172.31.47.0-255,66,128336,96,260256
41240,0.014579,74.125.130.0-255,2902,131238,96,260256
41241,0.014582,172.31.47.0-255,66,131304,96,260256
41242,0.017069,74.125.130.0-255,2902,134206,96,260256
41243,0.017075,172.31.47.0-255,66,134272,96,260256
41244,0.017109,74.125.130.0-255,2902,137174,96,260256
41245,0.017113,172.31.47.0-255,66,137240,96,260256
41246,0.019608,74.125.130.0-255,2902,140142,96,260256
41247,0.019612,172.31.47.0-255,66,140208,96,260256
41248,0.019645,74.125.130.0-255,2902,143110,96,260256
41249,0.019648,172.31.47.0-255,66,143176,96,260256
41250,0.022149,74.125.130.0-255,2902,146078,96,260256
41251,0.022157,172.31.47.0-255,66,146144,96,260256
41252,0.022194,74.125.130.0-255,2902,149046,96,260256
41253,0.022199,172.31.47.0-255,66,149112,96,260256
41254,0.024698,74.125.130.0-255,2902,152014,96,260256
41255,0.024704,172.31.47.0-255,66,152080,96,260256
41256,0.024727,74.125.130.0-255,2902,154982,96,260256
41257,0.024731,172.31.47.0-255,66,155048,96,260256
41258,0.025128,172.31.47.0-255,172,155220,96,260256
41259,0.025157,172.31.47.0-255,1109,156329,96,260256
41260,0.025185,172.31.47.0-255,1514,157843,96,260256
41261,0.025187,172.31.47.0-255,1303,159146,96,260256
41262,0.026706,104.244.42.0-255,66,159212,96,260256
41263,0.026714,104.244.42.0-255,66,159278,96,260256
41264,0.02674,104.244.42.0-255,66,159344,96,260256
41265,0.027288,74.125.130.0-255,2902,162246,96,260256
41266,0.027295,172.31.47.0-255,66,162312,96,260256
41267,0.02733,74.125.130.0-255,2902,165214,96,260256
41268,0.027334,172.31.47.0-255,66,165280,96,260256
41269,0.029842,74.125.130.0-255,2902,168182,96,260256
41270,0.02985,172.31.47.0-255,66,168248,96,260256
41271,0.029903,74.125.130.0-255,2902,171150,96,260256
41272,0.029906,172.31.47.0-255,66,171216,96,260256
41273,0.032379,74.125.130.0-255,2902,174118,96,260256
41274,0.032384,172.31.47.0-255,66,174184,96,260256
41275,0.032431,74.125.130.0-255,2902,177086,96,260256
41276,0.032435,172.31.47.0-255,66,177152,96,260256
41277,0.034903,74.125.130.0-255,2902,180054,96,260256
41278,0.034908,172.31.47.0-255,66,180120,96,260256
41279,0.03496,74.125.130.0-255,2902,183022,96,260256
41280,0.034965,172.31.47.0-255,66,183088,96,260256
41281,0.037432,74.125.130.0-255,2902,185990,96,260256
41282,0.037438,172.31.47.0-255,66,186056,96,260256
41283,0.037488,74.125.130.0-255,2902,188958,96,260256
41284,0.037493,172.31.47.0-255,66,189024,96,260256
41285,0.039966,74.125.130.0-255,2902,191926,96,260256
41286,0.039974,172.31.47.0-255,66,191992,96,260256
41287,0.040011,74.125.130.0-255,2902,194894,96,260256
41288,0.040014,172.31.47.0-255,66,194960,96,260256
41289,0.04251,74.125.130.0-255,2902,197862,96,260256
41290,0.042535,172.31.47.0-255,66,197928,96,260256
41291,0.042563,74.125.130.0-255,2902,200830,96,260256
41292,0.042567,172.31.47.0-255,66,200896,96,260256
41293,0.045069,74.125.130.0-255,2902,203798,96,260256
41294,0.045078,172.31.47.0-255,66,203864,96,260256
41295,0.045103,74.125.130.0-255,2902,206766,96,260256
41296,0.045107,172.31.47.0-255,66,206832,96,260256
41297,0.047618,74.125.130.0-255,2902,209734,96,260256
41298,0.047626,172.31.47.0-255,66,209800,96,260256
41299,0.047665,74.125.130.0-255,2902,212702,96,260256
41300,0.047669,172.31.47.0-255,66,212768,96,260256
41301,0.050162,74.125.130.0-255,2902,215670,96,260256
41302,0.050167,172.31.47.0-255,66,215736,96,260256
41303,0.050202,74.125.130.0-255,2902,218638,96,260256
41304,0.050205,172.31.47.0-255,66,218704,96,260256
41305,0.05271,74.125.130.0-255,2902,221606,96,260256
41306,0.052715,172.31.47.0-255,66,221672,96,260256
41307,0.052751,74.125.130.0-255,2902,224574,96,260256
41308,0.052754,172.31.47.0-255,66,224640,96,260256
41309,0.055235,74.125.130.0-255,2902,227542,96,260256
41310,0.05524,172.31.47.0-255,66,227608,96,260256
41311,0.05531,74.125.130.0-255,2902,230510,96,260256
41312,0.055314,172.31.47.0-255,66,230576,96,260256
41313,0.05778,74.125.130.0-255,2902,233478,96,260256
41314,0.057787,172.31.47.0-255,66,233544,96,260256
41315,0.057835,74.125.130.0-255,2902,236446,96,260256
41316,0.057839,172.31.47.0-255,66,236512,96,260256
41317,0.06032,74.125.130.0-255,2902,239414,96,260256
41318,0.060327,172.31.47.0-255,66,239480,96,260256
41319,0.060366,74.125.130.0-255,2902,242382,96,260256
41320,0.060369,172.31.47.0-255,66,242448,96,260256
41321,0.062879,74.125.130.0-255,2902,245350,96,260256
41322,0.062889,172.31.47.0-255,66,245416,96,260256
41323,0.062917,74.125.130.0-255,2902,248318,96,260256
41324,0.062923,172.31.47.0-255,66,248384,96,260256
41325,0.065425,74.125.130.0-255,2902,251286,96,260256
41326,0.065437,172.31.47.0-255,66,251352,96,260256
41327,0.065473,74.125.130.0-255,2902,254254,96,260256
41328,0.065478,172.31.47.0-255,66,254320,96,260256
41329,0.067978,74.125.130.0-255,2902,257222,96,260256
41330,0.067984,172.31.47.0-255,66,257288,96,260256
41331,0.06802,74.125.130.0-255,2902,260190,96,260256
41332,0.068023,172.31.47.0-255,66,260256,96,260256
41333,0.0,74.125.24.0-255,153,153,96,316836
41334,3e-05,172.31.47.0-255,66,219,96,316836
41335,3.6e-05,74.125.24.0-255,1484,1703,96,316836
41336,4e-05,172.31.47.0-255,66,1769,96,316836
41337,4.4e-05,74.125.24.0-255,2902,4671,96,316836
41338,4.7e-05,172.31.47.0-255,66,4737,96,316836
41339,5.3e-05,74.125.24.0-255,7156,11893,96,316836
41340,5.5e-05,172.31.47.0-255,66,11959,96,316836
41341,5.8e-05,74.125.24.0-255,1484,13443,96,316836
41342,6e-05,172.31.47.0-255,66,13509,96,316836
41343,8.8e-05,74.125.24.0-255,4972,18481,96,316836
41344,9e-05,172.31.47.0-255,66,18547,96,316836
41345,0.000108,74.125.24.0-255,2902,21449,96,316836
41346,0.000111,172.31.47.0-255,66,21515,96,316836
41347,0.000137,172.31.47.0-255,66,21581,96,316836
41348,0.000498,74.125.24.0-255,1484,23065,96,316836
41349,0.000504,172.31.47.0-255,66,23131,96,316836
41350,0.00051,74.125.24.0-255,2902,26033,96,316836
41351,0.000513,172.31.47.0-255,66,26099,96,316836
41352,0.000518,74.125.24.0-255,4320,30419,96,316836
41353,0.00052,172.31.47.0-255,66,30485,96,316836
41354,0.000526,74.125.24.0-255,5738,36223,96,316836
41355,0.000528,172.31.47.0-255,66,36289,96,316836
41356,0.000563,74.125.24.0-255,4320,40609,96,316836
41357,0.000566,172.31.47.0-255,66,40675,96,316836
41358,0.000596,172.31.47.0-255,66,40741,96,316836
41359,0.0006,74.125.24.0-255,4320,45061,96,316836
41360,0.000602,172.31.47.0-255,66,45127,96,316836
41361,0.000618,74.125.24.0-255,2543,47670,96,316836
41362,0.000621,172.31.47.0-255,66,47736,96,316836
41363,0.000655,74.125.24.0-255,415,48151,96,316836
41364,0.000813,172.31.47.0-255,66,48217,96,316836
41365,0.001101,74.125.24.0-255,329,48546,96,316836
41366,0.001286,74.125.24.0-255,1484,50030,96,316836
41367,0.001292,172.31.47.0-255,66,50096,96,316836
41368,0.0013,74.125.24.0-255,2902,52998,96,316836
41369,0.001301,172.31.47.0-255,66,53064,96,316836
41370,0.001335,74.125.24.0-255,2902,55966,96,316836
41371,0.001338,172.31.47.0-255,66,56032,96,316836
41372,0.001356,74.125.24.0-255,2902,58934,96,316836
41373,0.001359,172.31.47.0-255,66,59000,96,316836
41374,0.00137,172.31.47.0-255,66,59066,96,316836
41375,0.001381,172.31.47.0-255,66,59132,96,316836
41376,0.001387,74.125.24.0-255,3961,63093,96,316836
41377,0.001389,172.31.47.0-255,66,63159,96,316836
41378,0.00163,74.125.24.0-255,1484,64643,96,316836
41379,0.001644,74.125.24.0-255,2902,67545,96,316836
41380,0.001647,172.31.47.0-255,66,67611,96,316836
41381,0.001662,74.125.24.0-255,5738,73349,96,316836
41382,0.001664,172.31.47.0-255,66,73415,96,316836
41383,0.001683,74.125.24.0-255,1484,74899,96,316836
41384,0.001699,74.125.24.0-255,5738,80637,96,316836
41385,0.001701,172.31.47.0-255,66,80703,96,316836
41386,0.00172,74.125.24.0-255,5738,86441,96,316836
41387,0.001722,172.31.47.0-255,66,86507,96,316836
41388,0.001753,74.125.24.0-255,4320,90827,96,316836
41389,0.001755,172.31.47.0-255,66,90893,96,316836
41390,0.001775,74.125.24.0-255,6438,97331,96,316836
41391,0.001777,172.31.47.0-255,66,97397,96,316836
41392,0.001904,74.125.24.0-255,1484,98881,96,316836
41393,0.001916,74.125.24.0-255,2902,101783,96,316836
41394,0.001918,172.31.47.0-255,66,101849,96,316836
41395,0.00194,74.125.24.0-255,5738,107587,96,316836
41396,0.001942,172.31.47.0-255,66,107653,96,316836
41397,0.001946,74.125.24.0-255,4320,111973,96,316836
41398,0.001947,172.31.47.0-255,66,112039,96,316836
41399,0.001966,74.125.24.0-255,7156,119195,96,316836
41400,0.001968,172.31.47.0-255,66,119261,96,316836
41401,0.001985,74.125.24.0-255,4320,123581,96,316836
41402,0.001987,172.31.47.0-255,66,123647,96,316836
41403,0.002014,172.31.47.0-255,66,123713,96,316836
41404,0.004023,74.125.24.0-255,4320,128033,96,316836
41405,0.004027,172.31.47.0-255,66,128099,96,316836
41406,0.004043,74.125.24.0-255,1484,129583,96,316836
41407,0.006026,74.125.24.0-255,4320,133903,96,316836
41408,0.006033,172.31.47.0-255,66,133969,96,316836
41409,0.008047,74.125.24.0-255,5738,139707,96,316836
41410,0.008054,172.31.47.0-255,66,139773,96,316836
41411,0.010066,74.125.24.0-255,5738,145511,96,316836
41412,0.010073,172.31.47.0-255,66,145577,96,316836
41413,0.012067,74.125.24.0-255,5738,151315,96,316836
41414,0.012075,172.31.47.0-255,66,151381,96,316836
41415,0.014084,74.125.24.0-255,4320,155701,96,316836
41416,0.01409,172.31.47.0-255,66,155767,96,316836
41417,0.014111,74.125.24.0-255,1484,157251,96,316836
41418,0.016118,74.125.24.0-255,4320,161571,96,316836
41419,0.016126,172.31.47.0-255,66,161637,96,316836
41420,0.01813,74.125.24.0-255,5738,167375,96,316836
41421,0.018138,172.31.47.0-255,66,167441,96,316836
41422,0.020139,74.125.24.0-255,5738,173179,96,316836
41423,0.020145,172.31.47.0-255,66,173245,96,316836
41424,0.02215,74.125.24.0-255,5738,178983,96,316836
41425,0.022156,172.31.47.0-255,66,179049,96,316836
41426,0.022952,172.31.47.0-255,172,179221,96,316836
41427,0.022991,172.31.47.0-255,1101,180322,96,316836
41428,0.02306,172.31.47.0-255,1514,181836,96,316836
41429,0.023061,172.31.47.0-255,1310,183146,96,316836
41430,0.024181,74.125.24.0-255,5738,188884,96,316836
41431,0.024186,172.31.47.0-255,66,188950,96,316836
41432,0.024533,104.244.42.0-255,66,189016,96,316836
41433,0.02456,104.244.42.0-255,66,189082,96,316836
41434,0.024625,104.244.42.0-255,66,189148,96,316836
41435,0.026202,74.125.24.0-255,5738,194886,96,316836
41436,0.026208,172.31.47.0-255,66,194952,96,316836
41437,0.028223,74.125.24.0-255,5738,200690,96,316836
41438,0.028229,172.31.47.0-255,66,200756,96,316836
41439,0.030264,74.125.24.0-255,5738,206494,96,316836
41440,0.03027,172.31.47.0-255,66,206560,96,316836
41441,0.032279,74.125.24.0-255,5738,212298,96,316836
41442,0.032285,172.31.47.0-255,66,212364,96,316836
41443,0.034367,74.125.24.0-255,5738,218102,96,316836
41444,0.034387,172.31.47.0-255,66,218168,96,316836
41445,0.036427,74.125.24.0-255,5738,223906,96,316836
41446,0.036445,172.31.47.0-255,66,223972,96,316836
41447,0.038475,74.125.24.0-255,5738,229710,96,316836
41448,0.038493,172.31.47.0-255,66,229776,96,316836
41449,0.040522,74.125.24.0-255,5738,235514,96,316836
41450,0.04054,172.31.47.0-255,66,235580,96,316836
41451,0.042575,74.125.24.0-255,5738,241318,96,316836
41452,0.042587,172.31.47.0-255,66,241384,96,316836
41453,0.044621,74.125.24.0-255,5738,247122,96,316836
41454,0.044638,172.31.47.0-255,66,247188,96,316836
41455,0.046668,74.125.24.0-255,5738,252926,96,316836
41456,0.046688,172.31.47.0-255,66,252992,96,316836
41457,0.048716,74.125.24.0-255,5738,258730,96,316836
41458,0.048733,172.31.47.0-255,66,258796,96,316836
41459,0.050749,74.125.24.0-255,5738,264534,96,316836
41460,0.050767,172.31.47.0-255,66,264600,96,316836
41461,0.052796,74.125.24.0-255,5738,270338,96,316836
41462,0.052814,172.31.47.0-255,66,270404,96,316836
41463,0.05482,74.125.24.0-255,5738,276142,96,316836
41464,0.054855,172.31.47.0-255,66,276208,96,316836
41465,0.056857,74.125.24.0-255,5738,281946,96,316836
41466,0.056863,172.31.47.0-255,66,282012,96,316836
41467,0.058907,74.125.24.0-255,5738,287750,96,316836
41468,0.058911,172.31.47.0-255,66,287816,96,316836
41469,0.060913,74.125.24.0-255,5738,293554,96,316836
41470,0.060919,172.31.47.0-255,66,293620,96,316836
41471,0.062896,74.125.24.0-255,5738,299358,96,316836
41472,0.062902,172.31.47.0-255,66,299424,96,316836
41473,0.064905,74.125.24.0-255,5738,305162,96,316836
41474,0.06491,172.31.47.0-255,66,305228,96,316836
41475,0.066907,74.125.24.0-255,5738,310966,96,316836
41476,0.066913,172.31.47.0-255,66,311032,96,316836
41477,0.068941,74.125.24.0-255,5738,316770,96,316836
41478,0.068945,172.31.47.0-255,66,316836,96,316836
41479,0.0,74.125.24.0-255,153,153,96,179003
41480,1.6e-05,172.31.47.0-255,66,219,96,179003
41481,2.3e-05,74.125.24.0-255,1484,1703,96,179003
41482,2.7e-05,172.31.47.0-255,66,1769,96,179003
41483,3.3e-05,74.125.24.0-255,2902,4671,96,179003
41484,3.7e-05,172.31.47.0-255,66,4737,96,179003
41485,7e-05,74.125.24.0-255,5738,10475,96,179003
41486,7.3e-05,172.31.47.0-255,66,10541,96,179003
41487,8.7e-05,74.125.24.0-255,1484,12025,96,179003
41488,8.9e-05,172.31.47.0-255,66,12091,96,179003
41489,0.00012,74.125.24.0-255,2182,14273,96,179003
41490,0.000123,172.31.47.0-255,66,14339,96,179003
41491,0.000141,74.125.24.0-255,2902,17241,96,179003
41492,0.000144,172.31.47.0-255,66,17307,96,179003
41493,0.000166,74.125.24.0-255,7156,24463,96,179003
41494,0.000168,172.31.47.0-255,66,24529,96,179003
41495,0.000192,74.125.24.0-255,6797,31326,96,179003
41496,0.000194,172.31.47.0-255,66,31392,96,179003
41497,0.000314,74.125.24.0-255,1484,32876,96,179003
41498,0.000319,172.31.47.0-255,66,32942,96,179003
41499,0.000339,74.125.24.0-255,2902,35844,96,179003
41500,0.000341,172.31.47.0-255,66,35910,96,179003
41501,0.000366,74.125.24.0-255,5738,41648,96,179003
41502,0.00037,172.31.47.0-255,66,41714,96,179003
41503,0.000385,74.125.24.0-255,5738,47452,96,179003
41504,0.000388,172.31.47.0-255,66,47518,96,179003
41505,0.000406,74.125.24.0-255,2902,50420,96,179003
41506,0.000408,172.31.47.0-255,66,50486,96,179003
41507,0.000426,74.125.24.0-255,3961,54447,96,179003
41508,0.000429,172.31.47.0-255,66,54513,96,179003
41509,0.000436,74.125.24.0-255,7156,61669,96,179003
41510,0.000439,172.31.47.0-255,66,61735,96,179003
41511,0.000477,74.125.24.0-255,4292,66027,96,179003
41512,0.00048,172.31.47.0-255,66,66093,96,179003
41513,0.002145,74.125.24.0-255,110,66203,96,179003
41514,0.002191,74.125.24.0-255,1484,67687,96,179003
41515,0.002197,172.31.47.0-255,66,67753,96,179003
41516,0.002204,74.125.24.0-255,2902,70655,96,179003
41517,0.002206,172.31.47.0-255,66,70721,96,179003
41518,0.002234,74.125.24.0-255,1484,72205,96,179003
41519,0.002239,74.125.24.0-255,2902,75107,96,179003
41520,0.002241,172.31.47.0-255,66,75173,96,179003
41521,0.002248,74.125.24.0-255,5738,80911,96,179003
41522,0.00225,172.31.47.0-255,66,80977,96,179003
41523,0.002279,172.31.47.0-255,66,81043,96,179003
41524,0.002282,74.125.24.0-255,1484,82527,96,179003
41525,0.002323,74.125.24.0-255,5020,87547,96,179003
41526,0.002325,172.31.47.0-255,66,87613,96,179003
41527,0.002507,74.125.24.0-255,1484,89097,96,179003
41528,0.002523,74.125.24.0-255,2902,91999,96,179003
41529,0.002525,172.31.47.0-255,66,92065,96,179003
41530,0.002532,74.125.24.0-255,5738,97803,96,179003
41531,0.002534,172.31.47.0-255,66,97869,96,179003
41532,0.002556,74.125.24.0-255,5738,103607,96,179003
41533,0.002558,172.31.47.0-255,66,103673,96,179003
41534,0.002585,74.125.24.0-255,7156,110829,96,179003
41535,0.002587,172.31.47.0-255,66,110895,96,179003
41536,0.002599,172.31.47.0-255,66,110961,96,179003
41537,0.002637,172.31.47.0-255,66,111027,96,179003
41538,0.002655,74.125.24.0-255,2902,113929,96,179003
41539,0.002657,172.31.47.0-255,66,113995,96,179003
41540,0.00266,74.125.24.0-255,1484,115479,96,179003
41541,0.002675,74.125.24.0-255,4320,119799,96,179003
41542,0.002678,172.31.47.0-255,66,119865,96,179003
41543,0.00272,172.31.47.0-255,66,119931,96,179003
41544,0.002735,172.31.47.0-255,66,119997,96,179003
41545,0.002742,74.125.24.0-255,7156,127153,96,179003
41546,0.002745,172.31.47.0-255,66,127219,96,179003
41547,0.002782,172.31.47.0-255,66,127285,96,179003
41548,0.002788,74.125.24.0-255,5738,133023,96,179003
41549,0.00279,172.31.47.0-255,66,133089,96,179003
41550,0.002808,172.31.47.0-255,66,133155,96,179003
41551,0.002833,74.125.24.0-255,2902,136057,96,179003
41552,0.002835,172.31.47.0-255,66,136123,96,179003
41553,0.002841,74.125.24.0-255,4320,140443,96,179003
41554,0.002843,172.31.47.0-255,66,140509,96,179003
41555,0.002846,74.125.24.0-255,1484,141993,96,179003
41556,0.002857,172.31.47.0-255,66,142059,96,179003
41557,0.002888,172.31.47.0-255,66,142125,96,179003
41558,0.002903,74.125.24.0-255,2184,144309,96,179003
41559,0.002906,172.31.47.0-255,66,144375,96,179003
41560,0.002917,172.31.47.0-255,66,144441,96,179003
41561,0.002996,172.31.47.0-255,66,144507,96,179003
41562,0.003016,74.125.24.0-255,2184,146691,96,179003
41563,0.003018,172.31.47.0-255,66,146757,96,179003
41564,0.003033,172.31.47.0-255,66,146823,96,179003
41565,0.003049,172.31.47.0-255,66,146889,96,179003
41566,0.003061,172.31.47.0-255,66,146955,96,179003
41567,0.003092,74.125.24.0-255,7156,154111,96,179003
41568,0.003094,172.31.47.0-255,66,154177,96,179003
41569,0.003098,74.125.24.0-255,1484,155661,96,179003
41570,0.003117,172.31.47.0-255,66,155727,96,179003
41571,0.003123,74.125.24.0-255,5738,161465,96,179003
41572,0.003126,172.31.47.0-255,66,161531,96,179003
41573,0.00314,74.125.24.0-255,4320,165851,96,179003
41574,0.003143,172.31.47.0-255,66,165917,96,179003
41575,0.003147,74.125.24.0-255,1484,167401,96,179003
41576,0.003149,74.125.24.0-255,1484,168885,96,179003
41577,0.003151,172.31.47.0-255,66,168951,96,179003
41578,0.003155,74.125.24.0-255,1484,170435,96,179003
41579,0.003171,172.31.47.0-255,66,170501,96,179003
41580,0.00322,172.31.47.0-255,66,170567,96,179003
41581,0.003223,74.125.24.0-255,1484,172051,96,179003
41582,0.003237,74.125.24.0-255,2184,174235,96,179003
41583,0.00324,172.31.47.0-255,66,174301,96,179003
41584,0.003251,172.31.47.0-255,66,174367,96,179003
41585,0.003275,74.125.24.0-255,105,174472,96,179003
41586,0.008169,172.31.47.0-255,66,174538,96,179003
41587,0.008207,172.31.47.0-255,105,174643,96,179003
41588,0.010782,74.125.24.0-255,66,174709,96,179003
41589,0.030771,172.31.47.0-255,171,174880,96,179003
41590,0.030805,172.31.47.0-255,1133,176013,96,179003
41591,0.030866,172.31.47.0-255,1514,177527,96,179003
41592,0.030868,172.31.47.0-255,1278,178805,96,179003
41593,0.032351,104.244.42.0-255,66,178871,96,179003
41594,0.03236,104.244.42.0-255,66,178937,96,179003
41595,0.032442,104.244.42.0-255,66,179003,96,179003
41596,0.0,74.125.200.0-255,306,306,96,318671
41597,2.5e-05,172.31.47.0-255,66,372,96,318671
41598,3.3e-05,74.125.200.0-255,1484,1856,96,318671
41599,3.7e-05,172.31.47.0-255,66,1922,96,318671
41600,4.4e-05,74.125.200.0-255,4320,6242,96,318671
41601,4.6e-05,172.31.47.0-255,66,6308,96,318671
41602,5.2e-05,74.125.200.0-255,5738,12046,96,318671
41603,5.5e-05,172.31.47.0-255,66,12112,96,318671
41604,7.8e-05,74.125.200.0-255,1484,13596,96,318671
41605,8.1e-05,172.31.47.0-255,66,13662,96,318671
41606,0.000104,74.125.200.0-255,4787,18449,96,318671
41607,0.000107,172.31.47.0-255,66,18515,96,318671
41608,0.000114,74.125.200.0-255,5738,24253,96,318671
41609,0.000116,172.31.47.0-255,66,24319,96,318671
41610,0.000138,74.125.200.0-255,1484,25803,96,318671
41611,0.00014,172.31.47.0-255,66,25869,96,318671
41612,0.000146,74.125.200.0-255,4320,30189,96,318671
41613,0.000148,172.31.47.0-255,66,30255,96,318671
41614,0.000183,74.125.200.0-255,1125,31380,96,318671
41615,0.000186,172.31.47.0-255,66,31446,96,318671
41616,0.000304,74.125.200.0-255,1484,32930,96,318671
41617,0.000308,172.31.47.0-255,66,32996,96,318671
41618,0.000322,74.125.200.0-255,2902,35898,96,318671
41619,0.000325,172.31.47.0-255,66,35964,96,318671
41620,0.000331,74.125.200.0-255,4320,40284,96,318671
41621,0.000333,172.31.47.0-255,66,40350,96,318671
41622,0.000356,74.125.200.0-255,1484,41834,96,318671
41623,0.000358,172.31.47.0-255,66,41900,96,318671
41624,0.000363,74.125.200.0-255,2902,44802,96,318671
41625,0.000366,172.31.47.0-255,66,44868,96,318671
41626,0.000371,74.125.200.0-255,4320,49188,96,318671
41627,0.000373,172.31.47.0-255,66,49254,96,318671
41628,0.0004,74.125.200.0-255,4320,53574,96,318671
41629,0.000403,172.31.47.0-255,66,53640,96,318671
41630,0.000432,74.125.200.0-255,4320,57960,96,318671
41631,0.000435,172.31.47.0-255,66,58026,96,318671
41632,0.000442,74.125.200.0-255,7156,65182,96,318671
41633,0.000445,172.31.47.0-255,66,65248,96,318671
41634,0.000447,74.125.200.0-255,1060,66308,96,318671
41635,0.000775,74.125.200.0-255,1484,67792,96,318671
41636,0.00078,172.31.47.0-255,66,67858,96,318671
41637,0.000785,74.125.200.0-255,1484,69342,96,318671
41638,0.0008,74.125.200.0-255,1484,70826,96,318671
41639,0.000802,172.31.47.0-255,66,70892,96,318671
41640,0.000809,74.125.200.0-255,4320,75212,96,318671
41641,0.000811,172.31.47.0-255,66,75278,96,318671
41642,0.000835,74.125.200.0-255,7156,82434,96,318671
41643,0.000838,172.31.47.0-255,66,82500,96,318671
41644,0.000855,74.125.200.0-255,1484,83984,96,318671
41645,0.00086,74.125.200.0-255,2902,86886,96,318671
41646,0.000862,172.31.47.0-255,66,86952,96,318671
41647,0.000865,74.125.200.0-255,1484,88436,96,318671
41648,0.000887,74.125.200.0-255,2902,91338,96,318671
41649,0.00089,172.31.47.0-255,66,91404,96,318671
41650,0.000912,172.31.47.0-255,66,91470,96,318671
41651,0.00094,74.125.200.0-255,5738,97208,96,318671
41652,0.000943,172.31.47.0-255,66,97274,96,318671
41653,0.000957,74.125.200.0-255,3339,100613,96,318671
41654,0.000959,172.31.47.0-255,66,100679,96,318671
41655,0.000962,74.125.200.0-255,1484,102163,96,318671
41656,0.001007,74.125.200.0-255,2902,105065,96,318671
41657,0.001011,172.31.47.0-255,66,105131,96,318671
41658,0.001024,74.125.200.0-255,7156,112287,96,318671
41659,0.001027,172.31.47.0-255,66,112353,96,318671
41660,0.00103,74.125.200.0-255,1484,113837,96,318671
41661,0.001065,172.31.47.0-255,66,113903,96,318671
41662,0.001071,74.125.200.0-255,2184,116087,96,318671
41663,0.001073,172.31.47.0-255,66,116153,96,318671
41664,0.00122,74.125.200.0-255,1484,117637,96,318671
41665,0.001237,74.125.200.0-255,2902,120539,96,318671
41666,0.00124,172.31.47.0-255,66,120605,96,318671
41667,0.001269,74.125.200.0-255,4320,124925,96,318671
41668,0.001272,172.31.47.0-255,66,124991,96,318671
41669,0.001288,74.125.200.0-255,1484,126475,96,318671
41670,0.001301,74.125.200.0-255,4320,130795,96,318671
41671,0.001303,172.31.47.0-255,66,130861,96,318671
41672,0.001326,74.125.200.0-255,5738,136599,96,318671
41673,0.001328,172.31.47.0-255,66,136665,96,318671
41674,0.001353,74.125.200.0-255,7156,143821,96,318671
41675,0.001356,172.31.47.0-255,66,143887,96,318671
41676,0.001374,74.125.200.0-255,4320,148207,96,318671
41677,0.001377,172.31.47.0-255,66,148273,96,318671
41678,0.00138,74.125.200.0-255,1484,149757,96,318671
41679,0.001395,74.125.200.0-255,766,150523,96,318671
41680,0.001398,172.31.47.0-255,66,150589,96,318671
41681,0.001525,74.125.200.0-255,1484,152073,96,318671
41682,0.001531,74.125.200.0-255,2902,154975,96,318671
41683,0.001534,172.31.47.0-255,66,155041,96,318671
41684,0.001541,74.125.200.0-255,5738,160779,96,318671
41685,0.001543,172.31.47.0-255,66,160845,96,318671
41686,0.001557,74.125.200.0-255,1484,162329,96,318671
41687,0.001584,74.125.200.0-255,1484,163813,96,318671
41688,0.001587,172.31.47.0-255,66,163879,96,318671
41689,0.001604,74.125.200.0-255,1484,165363,96,318671
41690,0.001611,74.125.200.0-255,5738,171101,96,318671
41691,0.001613,172.31.47.0-255,66,171167,96,318671
41692,0.001628,74.125.200.0-255,2902,174069,96,318671
41693,0.00163,172.31.47.0-255,66,174135,96,318671
41694,0.001646,74.125.200.0-255,4320,178455,96,318671
41695,0.00165,172.31.47.0-255,66,178521,96,318671
41696,0.00168,74.125.200.0-255,4320,182841,96,318671
41697,0.001684,172.31.47.0-255,66,182907,96,318671
41698,0.001692,172.31.47.0-255,66,182973,96,318671
41699,0.001697,74.125.200.0-255,4320,187293,96,318671
41700,0.0017,172.31.47.0-255,66,187359,96,318671
41701,0.001734,172.31.47.0-255,66,187425,96,318671
41702,0.001764,74.125.200.0-255,2902,190327,96,318671
41703,0.001767,172.31.47.0-255,66,190393,96,318671
41704,0.00179,74.125.200.0-255,6438,196831,96,318671
41705,0.001793,172.31.47.0-255,66,196897,96,318671
41706,0.001831,74.125.200.0-255,2902,199799,96,318671
41707,0.001834,172.31.47.0-255,66,199865,96,318671
41708,0.001862,74.125.200.0-255,7156,207021,96,318671
41709,0.001865,172.31.47.0-255,66,207087,96,318671
41710,0.001876,74.125.200.0-255,4320,211407,96,318671
41711,0.001878,172.31.47.0-255,66,211473,96,318671
41712,0.001894,172.31.47.0-255,66,211539,96,318671
41713,0.001899,74.125.200.0-255,3602,215141,96,318671
41714,0.001901,172.31.47.0-255,66,215207,96,318671
41715,0.001924,74.125.200.0-255,1484,216691,96,318671
41716,0.001955,172.31.47.0-255,66,216757,96,318671
41717,0.001985,172.31.47.0-255,66,216823,96,318671
41718,0.001989,74.125.200.0-255,2902,219725,96,318671
41719,0.001992,172.31.47.0-255,66,219791,96,318671
41720,0.002034,74.125.200.0-255,4320,224111,96,318671
41721,0.002038,172.31.47.0-255,66,224177,96,318671
41722,0.002071,74.125.200.0-255,1484,225661,96,318671
41723,0.002077,172.31.47.0-255,66,225727,96,318671
41724,0.002098,172.31.47.0-255,66,225793,96,318671
41725,0.00212,74.125.200.0-255,1484,227277,96,318671
41726,0.004131,74.125.200.0-255,4320,231597,96,318671
41727,0.004147,172.31.47.0-255,66,231663,96,318671
41728,0.006244,74.125.200.0-255,5738,237401,96,318671
41729,0.006265,172.31.47.0-255,66,237467,96,318671
41730,0.008304,74.125.200.0-255,2902,240369,96,318671
41731,0.008312,172.31.47.0-255,66,240435,96,318671
41732,0.008332,74.125.200.0-255,2902,243337,96,318671
41733,0.008334,172.31.47.0-255,66,243403,96,318671
41734,0.010331,74.125.200.0-255,2902,246305,96,318671
41735,0.010339,172.31.47.0-255,66,246371,96,318671
41736,0.01036,74.125.200.0-255,2902,249273,96,318671
41737,0.010363,172.31.47.0-255,66,249339,96,318671
41738,0.012357,74.125.200.0-255,2902,252241,96,318671
41739,0.012361,172.31.47.0-255,66,252307,96,318671
41740,0.012377,74.125.200.0-255,2902,255209,96,318671
41741,0.01238,172.31.47.0-255,66,255275,96,318671
41742,0.014383,74.125.200.0-255,2902,258177,96,318671
41743,0.01439,172.31.47.0-255,66,258243,96,318671
41744,0.014411,74.125.200.0-255,2902,261145,96,318671
41745,0.014413,172.31.47.0-255,66,261211,96,318671
41746,0.016428,74.125.200.0-255,2902,264113,96,318671
41747,0.016444,172.31.47.0-255,66,264179,96,318671
41748,0.016473,74.125.200.0-255,2902,267081,96,318671
41749,0.016476,172.31.47.0-255,66,267147,96,318671
41750,0.018475,74.125.200.0-255,2902,270049,96,318671
41751,0.01849,172.31.47.0-255,66,270115,96,318671
41752,0.018512,74.125.200.0-255,2902,273017,96,318671
41753,0.018515,172.31.47.0-255,66,273083,96,318671
41754,0.020529,74.125.200.0-255,5738,278821,96,318671
41755,0.020537,172.31.47.0-255,66,278887,96,318671
41756,0.022577,74.125.200.0-255,5738,284625,96,318671
41757,0.022585,172.31.47.0-255,66,284691,96,318671
41758,0.024626,74.125.200.0-255,5738,290429,96,318671
41759,0.024633,172.31.47.0-255,66,290495,96,318671
41760,0.026648,74.125.200.0-255,4320,294815,96,318671
41761,0.026655,172.31.47.0-255,66,294881,96,318671
41762,0.026674,74.125.200.0-255,1484,296365,96,318671
41763,0.028684,74.125.200.0-255,4320,300685,96,318671
41764,0.02869,172.31.47.0-255,66,300751,96,318671
41765,0.030714,74.125.200.0-255,5738,306489,96,318671
41766,0.030726,172.31.47.0-255,66,306555,96,318671
41767,0.032756,74.125.200.0-255,5738,312293,96,318671
41768,0.032762,172.31.47.0-255,66,312359,96,318671
41769,0.034832,74.125.200.0-255,1780,314139,96,318671
41770,0.034843,172.31.47.0-255,66,314205,96,318671
41771,0.035032,172.31.47.0-255,105,314310,96,318671
41772,0.037049,74.125.200.0-255,66,314376,96,318671
41773,0.039214,172.31.47.0-255,172,314548,96,318671
41774,0.039244,172.31.47.0-255,1104,315652,96,318671
41775,0.039303,172.31.47.0-255,1514,317166,96,318671
41776,0.039304,172.31.47.0-255,1307,318473,96,318671
41777,0.040749,104.244.42.0-255,66,318539,96,318671
41778,0.040796,104.244.42.0-255,66,318605,96,318671
41779,0.040889,104.244.42.0-255,66,318671,96,318671
41780,0.0,172.217.27.0-255,153,153,96,324564
41781,3.5e-05,172.31.47.0-255,66,219,96,324564
41782,4.1e-05,172.217.27.0-255,1484,1703,96,324564
41783,4.5e-05,172.31.47.0-255,66,1769,96,324564
41784,4.8e-05,172.217.27.0-255,1484,3253,96,324564
41785,5.1e-05,172.31.47.0-255,66,3319,96,324564
41786,5.5e-05,172.217.27.0-255,2902,6221,96,324564
41787,5.8e-05,172.31.47.0-255,66,6287,96,324564
41788,6.4e-05,172.217.27.0-255,5738,12025,96,324564
41789,6.8e-05,172.31.47.0-255,66,12091,96,324564
41790,7.1e-05,172.217.27.0-255,2046,14137,96,324564
41791,7.4e-05,172.31.47.0-255,66,14203,96,324564
41792,0.000131,172.217.27.0-255,1484,15687,96,324564
41793,0.000135,172.31.47.0-255,66,15753,96,324564
41794,0.000141,172.217.27.0-255,2902,18655,96,324564
41795,0.000145,172.31.47.0-255,66,18721,96,324564
41796,0.00015,172.217.27.0-255,5738,24459,96,324564
41797,0.000154,172.31.47.0-255,66,24525,96,324564
41798,0.000188,172.217.27.0-255,6797,31322,96,324564
41799,0.000192,172.31.47.0-255,66,31388,96,324564
41800,0.000195,172.217.27.0-255,1484,32872,96,324564
41801,0.000196,172.31.47.0-255,66,32938,96,324564
41802,0.000216,172.217.27.0-255,5738,38676,96,324564
41803,0.00022,172.31.47.0-255,66,38742,96,324564
41804,0.000231,172.31.47.0-255,66,38808,96,324564
41805,0.000251,172.217.27.0-255,1125,39933,96,324564
41806,0.000253,172.31.47.0-255,66,39999,96,324564
41807,0.000817,172.217.27.0-255,1484,41483,96,324564
41808,0.000822,172.31.47.0-255,66,41549,96,324564
41809,0.00083,172.217.27.0-255,2902,44451,96,324564
41810,0.000832,172.31.47.0-255,66,44517,96,324564
41811,0.000837,172.217.27.0-255,2902,47419,96,324564
41812,0.000839,172.31.47.0-255,66,47485,96,324564
41813,0.00087,172.217.27.0-255,1484,48969,96,324564
41814,0.000882,172.31.47.0-255,66,49035,96,324564
41815,0.00097,172.217.27.0-255,350,49385,96,324564
41816,0.001068,172.31.47.0-255,66,49451,96,324564
41817,0.001082,172.217.27.0-255,1484,50935,96,324564
41818,0.001087,172.217.27.0-255,2902,53837,96,324564
41819,0.001089,172.31.47.0-255,66,53903,96,324564
41820,0.001092,172.217.27.0-255,1484,55387,96,324564
41821,0.001113,172.217.27.0-255,4320,59707,96,324564
41822,0.001115,172.31.47.0-255,66,59773,96,324564
41823,0.001126,172.217.27.0-255,1484,61257,96,324564
41824,0.001146,172.217.27.0-255,5379,66636,96,324564
41825,0.00115,172.31.47.0-255,66,66702,96,324564
41826,0.001182,172.217.27.0-255,4320,71022,96,324564
41827,0.001185,172.31.47.0-255,66,71088,96,324564
41828,0.001203,172.217.27.0-255,2902,73990,96,324564
41829,0.001205,172.31.47.0-255,66,74056,96,324564
41830,0.00121,172.217.27.0-255,4320,78376,96,324564
41831,0.001211,172.31.47.0-255,66,78442,96,324564
41832,0.001235,172.217.27.0-255,5379,83821,96,324564
41833,0.001238,172.31.47.0-255,66,83887,96,324564
41834,0.002879,172.217.27.0-255,5738,89625,96,324564
41835,0.002892,172.31.47.0-255,66,89691,96,324564
41836,0.004528,172.217.27.0-255,5738,95429,96,324564
41837,0.004535,172.31.47.0-255,66,95495,96,324564
41838,0.006173,172.217.27.0-255,5738,101233,96,324564
41839,0.006179,172.31.47.0-255,66,101299,96,324564
41840,0.007806,172.217.27.0-255,5738,107037,96,324564
41841,0.007811,172.31.47.0-255,66,107103,96,324564
41842,0.009439,172.217.27.0-255,5738,112841,96,324564
41843,0.009446,172.31.47.0-255,66,112907,96,324564
41844,0.011102,172.217.27.0-255,5738,118645,96,324564
41845,0.011108,172.31.47.0-255,66,118711,96,324564
41846,0.012748,172.217.27.0-255,5738,124449,96,324564
41847,0.012757,172.31.47.0-255,66,124515,96,324564
41848,0.014411,172.217.27.0-255,5738,130253,96,324564
41849,0.01442,172.31.47.0-255,66,130319,96,324564
41850,0.01606,172.217.27.0-255,5738,136057,96,324564
41851,0.016067,172.31.47.0-255,66,136123,96,324564
41852,0.017697,172.217.27.0-255,5738,141861,96,324564
41853,0.017703,172.31.47.0-255,66,141927,96,324564
41854,0.019329,172.217.27.0-255,5738,147665,96,324564
41855,0.019333,172.31.47.0-255,66,147731,96,324564
41856,0.020954,172.217.27.0-255,5738,153469,96,324564
41857,0.020959,172.31.47.0-255,66,153535,96,324564
41858,0.022446,172.31.47.0-255,172,153707,96,324564
41859,0.022474,172.31.47.0-255,1110,154817,96,324564
41860,0.022526,172.31.47.0-255,1514,156331,96,324564
41861,0.022527,172.31.47.0-255,1301,157632,96,324564
41862,0.022593,172.217.27.0-255,5738,163370,96,324564
41863,0.022597,172.31.47.0-255,66,163436,96,324564
41864,0.024048,104.244.42.0-255,66,163502,96,324564
41865,0.024066,104.244.42.0-255,66,163568,96,324564
41866,0.024084,104.244.42.0-255,66,163634,96,324564
41867,0.024239,172.217.27.0-255,5738,169372,96,324564
41868,0.024244,172.31.47.0-255,66,169438,96,324564
41869,0.025872,172.217.27.0-255,5738,175176,96,324564
41870,0.025881,172.31.47.0-255,66,175242,96,324564
41871,0.027504,172.217.27.0-255,5738,180980,96,324564
41872,0.027509,172.31.47.0-255,66,181046,96,324564
41873,0.029126,172.217.27.0-255,2902,183948,96,324564
41874,0.029131,172.31.47.0-255,66,184014,96,324564
41875,0.029155,172.217.27.0-255,2902,186916,96,324564
41876,0.029157,172.31.47.0-255,66,186982,96,324564
41877,0.030757,172.217.27.0-255,2902,189884,96,324564
41878,0.030761,172.31.47.0-255,66,189950,96,324564
41879,0.030787,172.217.27.0-255,2902,192852,96,324564
41880,0.03079,172.31.47.0-255,66,192918,96,324564
41881,0.03238,172.217.27.0-255,2902,195820,96,324564
41882,0.032384,172.31.47.0-255,66,195886,96,324564
41883,0.032411,172.217.27.0-255,2902,198788,96,324564
41884,0.032414,172.31.47.0-255,66,198854,96,324564
41885,0.03401,172.217.27.0-255,2902,201756,96,324564
41886,0.034016,172.31.47.0-255,66,201822,96,324564
41887,0.034044,172.217.27.0-255,2902,204724,96,324564
41888,0.034046,172.31.47.0-255,66,204790,96,324564
41889,0.035646,172.217.27.0-255,2902,207692,96,324564
41890,0.035651,172.31.47.0-255,66,207758,96,324564
41891,0.035679,172.217.27.0-255,2902,210660,96,324564
41892,0.035682,172.31.47.0-255,66,210726,96,324564
41893,0.037273,172.217.27.0-255,2902,213628,96,324564
41894,0.037279,172.31.47.0-255,66,213694,96,324564
41895,0.037308,172.217.27.0-255,2902,216596,96,324564
41896,0.037311,172.31.47.0-255,66,216662,96,324564
41897,0.038904,172.217.27.0-255,2902,219564,96,324564
41898,0.038909,172.31.47.0-255,66,219630,96,324564
41899,0.038934,172.217.27.0-255,2902,222532,96,324564
41900,0.038936,172.31.47.0-255,66,222598,96,324564
41901,0.040553,172.217.27.0-255,5738,228336,96,324564
41902,0.040561,172.31.47.0-255,66,228402,96,324564
41903,0.042197,172.217.27.0-255,5738,234140,96,324564
41904,0.042202,172.31.47.0-255,66,234206,96,324564
41905,0.043831,172.217.27.0-255,5738,239944,96,324564
41906,0.043837,172.31.47.0-255,66,240010,96,324564
41907,0.045472,172.217.27.0-255,5738,245748,96,324564
41908,0.045477,172.31.47.0-255,66,245814,96,324564
41909,0.04711,172.217.27.0-255,5738,251552,96,324564
41910,0.047116,172.31.47.0-255,66,251618,96,324564
41911,0.048738,172.217.27.0-255,4320,255938,96,324564
41912,0.048743,172.31.47.0-255,66,256004,96,324564
41913,0.048769,172.217.27.0-255,1484,257488,96,324564
41914,0.050371,172.217.27.0-255,4320,261808,96,324564
41915,0.050375,172.31.47.0-255,66,261874,96,324564
41916,0.051997,172.217.27.0-255,5738,267612,96,324564
41917,0.052002,172.31.47.0-255,66,267678,96,324564
41918,0.053633,172.217.27.0-255,5738,273416,96,324564
41919,0.053638,172.31.47.0-255,66,273482,96,324564
41920,0.055289,172.217.27.0-255,5738,279220,96,324564
41921,0.055294,172.31.47.0-255,66,279286,96,324564
41922,0.056921,172.217.27.0-255,2902,282188,96,324564
41923,0.056927,172.31.47.0-255,66,282254,96,324564
41924,0.056952,172.217.27.0-255,2902,285156,96,324564
41925,0.056955,172.31.47.0-255,66,285222,96,324564
41926,0.058546,172.217.27.0-255,1484,286706,96,324564
41927,0.058584,172.217.27.0-255,4320,291026,96,324564
41928,0.058589,172.31.47.0-255,66,291092,96,324564
41929,0.060233,172.217.27.0-255,5738,296830,96,324564
41930,0.060239,172.31.47.0-255,66,296896,96,324564
41931,0.061871,172.217.27.0-255,5738,302634,96,324564
41932,0.061876,172.31.47.0-255,66,302700,96,324564
41933,0.063538,172.217.27.0-255,4320,307020,96,324564
41934,0.063555,172.31.47.0-255,66,307086,96,324564
41935,0.063574,172.217.27.0-255,1484,308570,96,324564
41936,0.06518,172.217.27.0-255,4320,312890,96,324564
41937,0.065186,172.31.47.0-255,66,312956,96,324564
41938,0.066817,172.217.27.0-255,5738,318694,96,324564
41939,0.066823,172.31.47.0-255,66,318760,96,324564
41940,0.068455,172.217.27.0-255,5738,324498,96,324564
41941,0.068464,172.31.47.0-255,66,324564,96,324564
41942,0.0,74.125.68.0-255,153,153,96,397639
41943,2.9e-05,172.31.47.0-255,66,219,96,397639
41944,6e-05,74.125.68.0-255,1484,1703,96,397639
41945,6.5e-05,172.31.47.0-255,66,1769,96,397639
41946,7e-05,74.125.68.0-255,2902,4671,96,397639
41947,7.3e-05,172.31.47.0-255,66,4737,96,397639
41948,8.3e-05,74.125.68.0-255,5738,10475,96,397639
41949,8.6e-05,172.31.47.0-255,66,10541,96,397639
41950,9.2e-05,74.125.68.0-255,4919,15460,96,397639
41951,9.5e-05,172.31.47.0-255,66,15526,96,397639
41952,9.8e-05,74.125.68.0-255,2902,18428,96,397639
41953,0.000101,172.31.47.0-255,66,18494,96,397639
41954,0.000125,74.125.68.0-255,2902,21396,96,397639
41955,0.000133,172.31.47.0-255,66,21462,96,397639
41956,0.000138,74.125.68.0-255,2902,24364,96,397639
41957,0.00014,172.31.47.0-255,66,24430,96,397639
41958,0.000175,74.125.68.0-255,6797,31227,96,397639
41959,0.000178,172.31.47.0-255,66,31293,96,397639
41960,0.000201,74.125.68.0-255,1484,32777,96,397639
41961,0.000204,172.31.47.0-255,66,32843,96,397639
41962,0.000209,74.125.68.0-255,2902,35745,96,397639
41963,0.000211,172.31.47.0-255,66,35811,96,397639
41964,0.000214,74.125.68.0-255,1484,37295,96,397639
41965,0.00022,172.31.47.0-255,66,37361,96,397639
41966,0.00025,74.125.68.0-255,4320,41681,96,397639
41967,0.000253,172.31.47.0-255,66,41747,96,397639
41968,0.000259,74.125.68.0-255,4320,46067,96,397639
41969,0.000261,172.31.47.0-255,66,46133,96,397639
41970,0.000296,74.125.68.0-255,2543,48676,96,397639
41971,0.000299,172.31.47.0-255,66,48742,96,397639
41972,0.000334,74.125.68.0-255,1484,50226,96,397639
41973,0.000337,172.31.47.0-255,66,50292,96,397639
41974,0.000363,74.125.68.0-255,2902,53194,96,397639
41975,0.000368,172.31.47.0-255,66,53260,96,397639
41976,0.000396,74.125.68.0-255,5738,58998,96,397639
41977,0.0004,74.125.68.0-255,2902,61900,96,397639
41978,0.000402,172.31.47.0-255,66,61966,96,397639
41979,0.000406,172.31.47.0-255,66,62032,96,397639
41980,0.000431,74.125.68.0-255,1484,63516,96,397639
41981,0.000459,74.125.68.0-255,2543,66059,96,397639
41982,0.000464,172.31.47.0-255,66,66125,96,397639
41983,0.000467,74.125.68.0-255,359,66484,96,397639
41984,0.000499,74.125.68.0-255,1484,67968,96,397639
41985,0.000502,172.31.47.0-255,66,68034,96,397639
41986,0.00052,74.125.68.0-255,2902,70936,96,397639
41987,0.000523,172.31.47.0-255,66,71002,96,397639
41988,0.000553,74.125.68.0-255,5738,76740,96,397639
41989,0.000557,172.31.47.0-255,66,76806,96,397639
41990,0.000561,74.125.68.0-255,2902,79708,96,397639
41991,0.000563,172.31.47.0-255,66,79774,96,397639
41992,0.000599,74.125.68.0-255,1484,81258,96,397639
41993,0.000601,172.31.47.0-255,66,81324,96,397639
41994,0.000629,74.125.68.0-255,5738,87062,96,397639
41995,0.000633,172.31.47.0-255,66,87128,96,397639
41996,0.000661,74.125.68.0-255,2543,89671,96,397639
41997,0.000664,172.31.47.0-255,66,89737,96,397639
41998,0.000744,74.125.68.0-255,1484,91221,96,397639
41999,0.000764,74.125.68.0-255,2902,94123,96,397639
42000,0.000768,172.31.47.0-255,66,94189,96,397639
42001,0.000773,74.125.68.0-255,4320,98509,96,397639
42002,0.000775,172.31.47.0-255,66,98575,96,397639
42003,0.000794,74.125.68.0-255,1484,100059,96,397639
42004,0.000819,74.125.68.0-255,5738,105797,96,397639
42005,0.000822,172.31.47.0-255,66,105863,96,397639
42006,0.000849,74.125.68.0-255,2902,108765,96,397639
42007,0.000852,172.31.47.0-255,66,108831,96,397639
42008,0.000878,74.125.68.0-255,2529,111360,96,397639
42009,0.000882,172.31.47.0-255,66,111426,96,397639
42010,0.000888,74.125.68.0-255,5738,117164,96,397639
42011,0.00089,172.31.47.0-255,66,117230,96,397639
42012,0.000923,74.125.68.0-255,5787,123017,96,397639
42013,0.000927,172.31.47.0-255,66,123083,96,397639
42014,0.001221,74.125.68.0-255,1484,124567,96,397639
42015,0.001224,74.125.68.0-255,1484,126051,96,397639
42016,0.001227,172.31.47.0-255,66,126117,96,397639
42017,0.001252,74.125.68.0-255,1484,127601,96,397639
42018,0.001254,74.125.68.0-255,1484,129085,96,397639
42019,0.001256,172.31.47.0-255,66,129151,96,397639
42020,0.00126,74.125.68.0-255,2902,132053,96,397639
42021,0.001262,172.31.47.0-255,66,132119,96,397639
42022,0.001267,74.125.68.0-255,5738,137857,96,397639
42023,0.001274,172.31.47.0-255,66,137923,96,397639
42024,0.001277,74.125.68.0-255,1484,139407,96,397639
42025,0.00131,74.125.68.0-255,2543,141950,96,397639
42026,0.001313,172.31.47.0-255,66,142016,96,397639
42027,0.001318,74.125.68.0-255,4320,146336,96,397639
42028,0.001319,172.31.47.0-255,66,146402,96,397639
42029,0.001323,74.125.68.0-255,2902,149304,96,397639
42030,0.001325,172.31.47.0-255,66,149370,96,397639
42031,0.001361,74.125.68.0-255,7156,156526,96,397639
42032,0.001365,74.125.68.0-255,4320,160846,96,397639
42033,0.001365,172.31.47.0-255,66,160912,96,397639
42034,0.001368,172.31.47.0-255,66,160978,96,397639
42035,0.0014,172.31.47.0-255,66,161044,96,397639
42036,0.001425,74.125.68.0-255,5020,166064,96,397639
42037,0.001427,172.31.47.0-255,66,166130,96,397639
42038,0.001513,74.125.68.0-255,1484,167614,96,397639
42039,0.00153,74.125.68.0-255,2902,170516,96,397639
42040,0.001533,172.31.47.0-255,66,170582,96,397639
42041,0.001548,74.125.68.0-255,1484,172066,96,397639
42042,0.00156,74.125.68.0-255,2902,174968,96,397639
42043,0.001562,172.31.47.0-255,66,175034,96,397639
42044,0.001583,74.125.68.0-255,2902,177936,96,397639
42045,0.001586,172.31.47.0-255,66,178002,96,397639
42046,0.001609,74.125.68.0-255,2902,180904,96,397639
42047,0.001612,172.31.47.0-255,66,180970,96,397639
42048,0.001617,74.125.68.0-255,5738,186708,96,397639
42049,0.001619,172.31.47.0-255,66,186774,96,397639
42050,0.00164,74.125.68.0-255,1484,188258,96,397639
42051,0.001643,74.125.68.0-255,2902,191160,96,397639
42052,0.001645,172.31.47.0-255,66,191226,96,397639
42053,0.001669,74.125.68.0-255,4320,195546,96,397639
42054,0.001671,172.31.47.0-255,66,195612,96,397639
42055,0.001707,74.125.68.0-255,1484,197096,96,397639
42056,0.001725,74.125.68.0-255,3602,200698,96,397639
42057,0.001727,172.31.47.0-255,66,200764,96,397639
42058,0.001821,74.125.68.0-255,1484,202248,96,397639
42059,0.001834,74.125.68.0-255,1484,203732,96,397639
42060,0.001837,172.31.47.0-255,66,203798,96,397639
42061,0.001842,74.125.68.0-255,2902,206700,96,397639
42062,0.001843,172.31.47.0-255,66,206766,96,397639
42063,0.001846,74.125.68.0-255,1484,208250,96,397639
42064,0.001874,74.125.68.0-255,4320,212570,96,397639
42065,0.001876,172.31.47.0-255,66,212636,96,397639
42066,0.0019,74.125.68.0-255,5379,218015,96,397639
42067,0.001903,172.31.47.0-255,66,218081,96,397639
42068,0.001929,74.125.68.0-255,5738,223819,96,397639
42069,0.001932,172.31.47.0-255,66,223885,96,397639
42070,0.001935,74.125.68.0-255,1484,225369,96,397639
42071,0.001955,74.125.68.0-255,4320,229689,96,397639
42072,0.001957,172.31.47.0-255,66,229755,96,397639
42073,0.002006,74.125.68.0-255,5738,235493,96,397639
42074,0.002009,172.31.47.0-255,66,235559,96,397639
42075,0.002034,74.125.68.0-255,1484,237043,96,397639
42076,0.002047,172.31.47.0-255,66,237109,96,397639
42077,0.002052,74.125.68.0-255,3602,240711,96,397639
42078,0.002053,172.31.47.0-255,66,240777,96,397639
42079,0.002233,74.125.68.0-255,1484,242261,96,397639
42080,0.002248,74.125.68.0-255,2902,245163,96,397639
42081,0.002251,172.31.47.0-255,66,245229,96,397639
42082,0.002279,74.125.68.0-255,5738,250967,96,397639
42083,0.002282,172.31.47.0-255,66,251033,96,397639
42084,0.002288,74.125.68.0-255,4320,255353,96,397639
42085,0.00229,172.31.47.0-255,66,255419,96,397639
42086,0.002311,74.125.68.0-255,2902,258321,96,397639
42087,0.002312,172.31.47.0-255,66,258387,96,397639
42088,0.002334,74.125.68.0-255,2902,261289,96,397639
42089,0.002336,172.31.47.0-255,66,261355,96,397639
42090,0.002342,74.125.68.0-255,5738,267093,96,397639
42091,0.002343,172.31.47.0-255,66,267159,96,397639
42092,0.002378,74.125.68.0-255,7156,274315,96,397639
42093,0.002381,172.31.47.0-255,66,274381,96,397639
42094,0.002383,74.125.68.0-255,766,275147,96,397639
42095,0.002408,74.125.68.0-255,1484,276631,96,397639
42096,0.00241,172.31.47.0-255,66,276697,96,397639
42097,0.002452,74.125.68.0-255,4320,281017,96,397639
42098,0.002455,172.31.47.0-255,66,281083,96,397639
42099,0.002457,74.125.68.0-255,1484,282567,96,397639
42100,0.002461,74.125.68.0-255,2902,285469,96,397639
42101,0.002462,172.31.47.0-255,66,285535,96,397639
42102,0.002466,74.125.68.0-255,2902,288437,96,397639
42103,0.002472,172.31.47.0-255,66,288503,96,397639
42104,0.002488,74.125.68.0-255,2902,291405,96,397639
42105,0.002489,172.31.47.0-255,66,291471,96,397639
42106,0.002495,74.125.68.0-255,5738,297209,96,397639
42107,0.002501,172.31.47.0-255,66,297275,96,397639
42108,0.002522,74.125.68.0-255,5738,303013,96,397639
42109,0.002525,172.31.47.0-255,66,303079,96,397639
42110,0.002545,74.125.68.0-255,1484,304563,96,397639
42111,0.00255,74.125.68.0-255,5020,309583,96,397639
42112,0.002553,172.31.47.0-255,66,309649,96,397639
42113,0.002595,74.125.68.0-255,1484,311133,96,397639
42114,0.002606,74.125.68.0-255,2902,314035,96,397639
42115,0.002608,172.31.47.0-255,66,314101,96,397639
42116,0.002616,74.125.68.0-255,1484,315585,96,397639
42117,0.005149,74.125.68.0-255,4320,319905,96,397639
42118,0.005154,172.31.47.0-255,66,319971,96,397639
42119,0.007702,74.125.68.0-255,5738,325709,96,397639
42120,0.007708,172.31.47.0-255,66,325775,96,397639
42121,0.010252,74.125.68.0-255,5738,331513,96,397639
42122,0.010259,172.31.47.0-255,66,331579,96,397639
42123,0.012818,74.125.68.0-255,5738,337317,96,397639
42124,0.012824,172.31.47.0-255,66,337383,96,397639
42125,0.01537,74.125.68.0-255,5738,343121,96,397639
42126,0.015375,172.31.47.0-255,66,343187,96,397639
42127,0.017926,74.125.68.0-255,5738,348925,96,397639
42128,0.017934,172.31.47.0-255,66,348991,96,397639
42129,0.020503,74.125.68.0-255,5738,354729,96,397639
42130,0.020512,172.31.47.0-255,66,354795,96,397639
42131,0.023075,74.125.68.0-255,5738,360533,96,397639
42132,0.023082,172.31.47.0-255,66,360599,96,397639
42133,0.025645,74.125.68.0-255,4320,364919,96,397639
42134,0.025651,172.31.47.0-255,66,364985,96,397639
42135,0.025685,74.125.68.0-255,1484,366469,96,397639
42136,0.028233,74.125.68.0-255,4320,370789,96,397639
42137,0.028241,172.31.47.0-255,66,370855,96,397639
42138,0.030792,74.125.68.0-255,5738,376593,96,397639
42139,0.030797,172.31.47.0-255,66,376659,96,397639
42140,0.032015,172.31.47.0-255,172,376831,96,397639
42141,0.032043,172.31.47.0-255,1110,377941,96,397639
42142,0.032072,172.31.47.0-255,1514,379455,96,397639
42143,0.032074,172.31.47.0-255,1301,380756,96,397639
42144,0.033343,74.125.68.0-255,5738,386494,96,397639
42145,0.033351,172.31.47.0-255,66,386560,96,397639
42146,0.033547,104.244.42.0-255,66,386626,96,397639
42147,0.033593,104.244.42.0-255,66,386692,96,397639
42148,0.033635,104.244.42.0-255,66,386758,96,397639
42149,0.0359,74.125.68.0-255,5738,392496,96,397639
42150,0.035905,172.31.47.0-255,66,392562,96,397639
42151,0.03847,74.125.68.0-255,4840,397402,96,397639
42152,0.038476,172.31.47.0-255,66,397468,96,397639
42153,0.03865,172.31.47.0-255,105,397573,96,397639
42154,0.041173,74.125.68.0-255,66,397639,96,397639
42155,0.0,172.217.194.0-255,153,153,96,248605
42156,2.2e-05,172.31.47.0-255,66,219,96,248605
42157,2.9e-05,172.217.194.0-255,1484,1703,96,248605
42158,3.3e-05,172.31.47.0-255,66,1769,96,248605
42159,3.9e-05,172.217.194.0-255,2902,4671,96,248605
42160,4.9e-05,172.31.47.0-255,66,4737,96,248605
42161,5.6e-05,172.217.194.0-255,7156,11893,96,248605
42162,5.9e-05,172.31.47.0-255,66,11959,96,248605
42163,9.5e-05,172.31.47.0-255,66,12025,96,248605
42164,0.000107,172.31.47.0-255,66,12091,96,248605
42165,0.000272,172.217.194.0-255,1484,13575,96,248605
42166,0.000277,172.31.47.0-255,66,13641,96,248605
42167,0.000282,172.217.194.0-255,2902,16543,96,248605
42168,0.000284,172.31.47.0-255,66,16609,96,248605
42169,0.000314,172.217.194.0-255,5738,22347,96,248605
42170,0.000317,172.31.47.0-255,66,22413,96,248605
42171,0.000323,172.217.194.0-255,4320,26733,96,248605
42172,0.000325,172.31.47.0-255,66,26799,96,248605
42173,0.000347,172.217.194.0-255,2543,29342,96,248605
42174,0.000349,172.31.47.0-255,66,29408,96,248605
42175,0.000356,172.217.194.0-255,7156,36564,96,248605
42176,0.000359,172.31.47.0-255,66,36630,96,248605
42177,0.000393,172.31.47.0-255,66,36696,96,248605
42178,0.000396,172.217.194.0-255,364,37060,96,248605
42179,0.000398,172.31.47.0-255,66,37126,96,248605
42180,0.000499,172.217.194.0-255,1484,38610,96,248605
42181,0.000503,172.31.47.0-255,66,38676,96,248605
42182,0.000521,172.217.194.0-255,2902,41578,96,248605
42183,0.000523,172.31.47.0-255,66,41644,96,248605
42184,0.000548,172.217.194.0-255,5738,47382,96,248605
42185,0.000551,172.31.47.0-255,66,47448,96,248605
42186,0.000586,172.31.47.0-255,66,47514,96,248605
42187,0.000613,172.217.194.0-255,2543,50057,96,248605
42188,0.000615,172.31.47.0-255,66,50123,96,248605
42189,0.000628,172.31.47.0-255,66,50189,96,248605
42190,0.00063,172.217.194.0-255,1484,51673,96,248605
42191,0.000633,172.31.47.0-255,66,51739,96,248605
42192,0.000638,172.217.194.0-255,2902,54641,96,248605
42193,0.00064,172.31.47.0-255,66,54707,96,248605
42194,0.000676,172.217.194.0-255,5738,60445,96,248605
42195,0.000679,172.31.47.0-255,66,60511,96,248605
42196,0.000715,172.217.194.0-255,1484,61995,96,248605
42197,0.000738,172.217.194.0-255,2902,64897,96,248605
42198,0.000756,172.217.194.0-255,5020,69917,96,248605
42199,0.000778,172.217.194.0-255,4320,74237,96,248605
42200,0.00081,172.217.194.0-255,2902,77139,96,248605
42201,0.000831,172.217.194.0-255,2902,80041,96,248605
42202,0.000834,172.217.194.0-255,766,80807,96,248605
42203,0.000843,172.31.47.0-255,66,80873,96,248605
42204,0.000869,172.31.47.0-255,66,80939,96,248605
42205,0.000893,172.217.194.0-255,1484,82423,96,248605
42206,0.000895,172.217.194.0-255,1484,83907,96,248605
42207,0.000991,172.31.47.0-255,66,83973,96,248605
42208,0.00102,172.31.47.0-255,66,84039,96,248605
42209,0.001563,172.217.194.0-255,1484,85523,96,248605
42210,0.001569,172.217.194.0-255,2902,88425,96,248605
42211,0.001597,172.217.194.0-255,5738,94163,96,248605
42212,0.001603,172.217.194.0-255,5738,99901,96,248605
42213,0.00162,172.217.194.0-255,4320,104221,96,248605
42214,0.001624,172.31.47.0-255,66,104287,96,248605
42215,0.001648,172.217.194.0-255,7156,111443,96,248605
42216,0.001659,172.217.194.0-255,1484,112927,96,248605
42217,0.001665,172.217.194.0-255,5020,117947,96,248605
42218,0.001668,172.31.47.0-255,66,118013,96,248605
42219,0.001694,172.31.47.0-255,66,118079,96,248605
42220,0.00183,172.217.194.0-255,1484,119563,96,248605
42221,0.001836,172.217.194.0-255,2902,122465,96,248605
42222,0.001848,172.31.47.0-255,66,122531,96,248605
42223,0.00186,172.217.194.0-255,5738,128269,96,248605
42224,0.001869,172.217.194.0-255,4320,132589,96,248605
42225,0.001911,172.217.194.0-255,2902,135491,96,248605
42226,0.001925,172.217.194.0-255,4320,139811,96,248605
42227,0.001938,172.217.194.0-255,3602,143413,96,248605
42228,0.001999,172.217.194.0-255,1484,144897,96,248605
42229,0.002004,172.217.194.0-255,2902,147799,96,248605
42230,0.002019,172.217.194.0-255,2902,150701,96,248605
42231,0.002031,172.217.194.0-255,2902,153603,96,248605
42232,0.002044,172.217.194.0-255,5738,159341,96,248605
42233,0.002069,172.217.194.0-255,7156,166497,96,248605
42234,0.002076,172.217.194.0-255,7156,173653,96,248605
42235,0.00209,172.217.194.0-255,3602,177255,96,248605
42236,0.002251,172.217.194.0-255,1484,178739,96,248605
42237,0.002257,172.217.194.0-255,2902,181641,96,248605
42238,0.002276,172.217.194.0-255,4320,185961,96,248605
42239,0.002287,172.217.194.0-255,1484,187445,96,248605
42240,0.002324,172.217.194.0-255,5738,193183,96,248605
42241,0.00234,172.217.194.0-255,5020,198203,96,248605
42242,0.005664,172.31.47.0-255,66,198269,96,248605
42243,0.008008,172.217.194.0-255,5738,204007,96,248605
42244,0.008017,172.31.47.0-255,66,204073,96,248605
42245,0.010368,172.217.194.0-255,5738,209811,96,248605
42246,0.010374,172.31.47.0-255,66,209877,96,248605
42247,0.012704,172.217.194.0-255,5738,215615,96,248605
42248,0.012712,172.31.47.0-255,66,215681,96,248605
42249,0.015025,172.217.194.0-255,5738,221419,96,248605
42250,0.015034,172.31.47.0-255,66,221485,96,248605
42251,0.017421,172.217.194.0-255,4320,225805,96,248605
42252,0.01743,172.31.47.0-255,66,225871,96,248605
42253,0.017461,172.217.194.0-255,1484,227355,96,248605
42254,0.017465,172.31.47.0-255,66,227421,96,248605
42255,0.019814,172.217.194.0-255,5738,233159,96,248605
42256,0.019826,172.31.47.0-255,66,233225,96,248605
42257,0.02218,172.217.194.0-255,5738,238963,96,248605
42258,0.022188,172.31.47.0-255,66,239029,96,248605
42259,0.024528,172.217.194.0-255,5044,244073,96,248605
42260,0.024535,172.31.47.0-255,66,244139,96,248605
42261,0.02473,172.31.47.0-255,105,244244,96,248605
42262,0.027009,172.217.194.0-255,66,244310,96,248605
42263,0.033124,172.31.47.0-255,172,244482,96,248605
42264,0.033157,172.31.47.0-255,1105,245587,96,248605
42265,0.033269,172.31.47.0-255,1514,247101,96,248605
42266,0.033272,172.31.47.0-255,1306,248407,96,248605
42267,0.034683,104.244.42.0-255,66,248473,96,248605
42268,0.034718,104.244.42.0-255,66,248539,96,248605
42269,0.034821,104.244.42.0-255,66,248605,96,248605
42270,0.0,74.125.24.0-255,153,153,96,298541
42271,2.3e-05,172.31.47.0-255,66,219,96,298541
42272,2.9e-05,74.125.24.0-255,1484,1703,96,298541
42273,3.3e-05,172.31.47.0-255,66,1769,96,298541
42274,3.8e-05,74.125.24.0-255,2902,4671,96,298541
42275,4.1e-05,172.31.47.0-255,66,4737,96,298541
42276,4.8e-05,74.125.24.0-255,7156,11893,96,298541
42277,5e-05,172.31.47.0-255,66,11959,96,298541
42278,6.7e-05,74.125.24.0-255,2175,14134,96,298541
42279,6.9e-05,172.31.47.0-255,66,14200,96,298541
42280,0.000109,74.125.24.0-255,2902,17102,96,298541
42281,0.000112,172.31.47.0-255,66,17168,96,298541
42282,0.000116,74.125.24.0-255,2902,20070,96,298541
42283,0.000118,172.31.47.0-255,66,20136,96,298541
42284,0.000128,74.125.24.0-255,1484,21620,96,298541
42285,0.000131,172.31.47.0-255,66,21686,96,298541
42286,0.000154,74.125.24.0-255,5738,27424,96,298541
42287,0.000157,172.31.47.0-255,66,27490,96,298541
42288,0.000202,74.125.24.0-255,3961,31451,96,298541
42289,0.000204,172.31.47.0-255,66,31517,96,298541
42290,0.000237,74.125.24.0-255,4320,35837,96,298541
42291,0.00024,172.31.47.0-255,66,35903,96,298541
42292,0.000242,74.125.24.0-255,1484,37387,96,298541
42293,0.000244,172.31.47.0-255,66,37453,96,298541
42294,0.000262,74.125.24.0-255,4320,41773,96,298541
42295,0.000264,172.31.47.0-255,66,41839,96,298541
42296,0.000281,74.125.24.0-255,4320,46159,96,298541
42297,0.000284,172.31.47.0-255,66,46225,96,298541
42298,0.000312,172.31.47.0-255,66,46291,96,298541
42299,0.000321,172.31.47.0-255,66,46357,96,298541
42300,0.000345,74.125.24.0-255,2839,49196,96,298541
42301,0.000348,172.31.47.0-255,66,49262,96,298541
42302,0.000364,74.125.24.0-255,127,49389,96,298541
42303,0.000627,172.31.47.0-255,66,49455,96,298541
42304,0.000805,74.125.24.0-255,352,49807,96,298541
42305,0.000834,172.31.47.0-255,66,49873,96,298541
42306,0.001145,74.125.24.0-255,1484,51357,96,298541
42307,0.001154,74.125.24.0-255,2902,54259,96,298541
42308,0.001157,172.31.47.0-255,66,54325,96,298541
42309,0.001163,74.125.24.0-255,2902,57227,96,298541
42310,0.001164,172.31.47.0-255,66,57293,96,298541
42311,0.001177,74.125.24.0-255,2902,60195,96,298541
42312,0.001179,172.31.47.0-255,66,60261,96,298541
42313,0.001182,74.125.24.0-255,2902,63163,96,298541
42314,0.001184,172.31.47.0-255,66,63229,96,298541
42315,0.001196,74.125.24.0-255,4320,67549,96,298541
42316,0.001198,172.31.47.0-255,66,67615,96,298541
42317,0.00123,74.125.24.0-255,5738,73353,96,298541
42318,0.001232,172.31.47.0-255,66,73419,96,298541
42319,0.001242,172.31.47.0-255,66,73485,96,298541
42320,0.001244,74.125.24.0-255,1484,74969,96,298541
42321,0.001268,74.125.24.0-255,2902,77871,96,298541
42322,0.00127,172.31.47.0-255,66,77937,96,298541
42323,0.001275,74.125.24.0-255,4320,82257,96,298541
42324,0.001276,172.31.47.0-255,66,82323,96,298541
42325,0.001288,74.125.24.0-255,1484,83807,96,298541
42326,0.001292,74.125.24.0-255,2902,86709,96,298541
42327,0.001293,172.31.47.0-255,66,86775,96,298541
42328,0.001321,172.31.47.0-255,66,86841,96,298541
42329,0.00133,172.31.47.0-255,66,86907,96,298541
42330,0.001374,74.125.24.0-255,766,87673,96,298541
42331,0.001454,74.125.24.0-255,1484,89157,96,298541
42332,0.001457,172.31.47.0-255,66,89223,96,298541
42333,0.001462,74.125.24.0-255,2902,92125,96,298541
42334,0.001464,172.31.47.0-255,66,92191,96,298541
42335,0.001466,74.125.24.0-255,1484,93675,96,298541
42336,0.001485,74.125.24.0-255,4320,97995,96,298541
42337,0.001487,172.31.47.0-255,66,98061,96,298541
42338,0.001491,74.125.24.0-255,2902,100963,96,298541
42339,0.001492,172.31.47.0-255,66,101029,96,298541
42340,0.001524,172.31.47.0-255,66,101095,96,298541
42341,0.001529,74.125.24.0-255,7156,108251,96,298541
42342,0.001531,172.31.47.0-255,66,108317,96,298541
42343,0.001551,74.125.24.0-255,1484,109801,96,298541
42344,0.001573,172.31.47.0-255,66,109867,96,298541
42345,0.001607,172.31.47.0-255,66,109933,96,298541
42346,0.001613,172.31.47.0-255,66,109999,96,298541
42347,0.001618,74.125.24.0-255,5020,115019,96,298541
42348,0.00162,172.31.47.0-255,66,115085,96,298541
42349,0.001673,74.125.24.0-255,1484,116569,96,298541
42350,0.001677,74.125.24.0-255,2902,119471,96,298541
42351,0.00168,172.31.47.0-255,66,119537,96,298541
42352,0.001701,74.125.24.0-255,5738,125275,96,298541
42353,0.001704,172.31.47.0-255,66,125341,96,298541
42354,0.001719,74.125.24.0-255,5738,131079,96,298541
42355,0.001721,172.31.47.0-255,66,131145,96,298541
42356,0.001745,74.125.24.0-255,7156,138301,96,298541
42357,0.001748,172.31.47.0-255,66,138367,96,298541
42358,0.001752,74.125.24.0-255,4320,142687,96,298541
42359,0.001754,172.31.47.0-255,66,142753,96,298541
42360,0.001779,74.125.24.0-255,4320,147073,96,298541
42361,0.001781,172.31.47.0-255,66,147139,96,298541
42362,0.001793,74.125.24.0-255,2184,149323,96,298541
42363,0.001795,172.31.47.0-255,66,149389,96,298541
42364,0.001826,74.125.24.0-255,2902,152291,96,298541
42365,0.00183,172.31.47.0-255,66,152357,96,298541
42366,0.001848,74.125.24.0-255,2902,155259,96,298541
42367,0.00185,172.31.47.0-255,66,155325,96,298541
42368,0.001856,74.125.24.0-255,7156,162481,96,298541
42369,0.001857,172.31.47.0-255,66,162547,96,298541
42370,0.001904,172.31.47.0-255,66,162613,96,298541
42371,0.001919,74.125.24.0-255,4320,166933,96,298541
42372,0.001921,172.31.47.0-255,66,166999,96,298541
42373,0.001924,74.125.24.0-255,2902,169901,96,298541
42374,0.001926,172.31.47.0-255,66,169967,96,298541
42375,0.00195,74.125.24.0-255,3602,173569,96,298541
42376,0.001953,172.31.47.0-255,66,173635,96,298541
42377,0.001976,74.125.24.0-255,1484,175119,96,298541
42378,0.00199,74.125.24.0-255,2902,178021,96,298541
42379,0.001992,172.31.47.0-255,66,178087,96,298541
42380,0.002011,74.125.24.0-255,5738,183825,96,298541
42381,0.002014,172.31.47.0-255,66,183891,96,298541
42382,0.002037,172.31.47.0-255,66,183957,96,298541
42383,0.002054,74.125.24.0-255,1484,185441,96,298541
42384,0.002077,74.125.24.0-255,1484,186925,96,298541
42385,0.002079,172.31.47.0-255,66,186991,96,298541
42386,0.002093,74.125.24.0-255,5738,192729,96,298541
42387,0.002096,172.31.47.0-255,66,192795,96,298541
42388,0.002113,74.125.24.0-255,6438,199233,96,298541
42389,0.002115,172.31.47.0-255,66,199299,96,298541
42390,0.002221,74.125.24.0-255,1484,200783,96,298541
42391,0.002225,74.125.24.0-255,1484,202267,96,298541
42392,0.002227,172.31.47.0-255,66,202333,96,298541
42393,0.002245,74.125.24.0-255,1484,203817,96,298541
42394,0.002262,74.125.24.0-255,5738,209555,96,298541
42395,0.002264,172.31.47.0-255,66,209621,96,298541
42396,0.002309,74.125.24.0-255,2902,212523,96,298541
42397,0.002312,172.31.47.0-255,66,212589,96,298541
42398,0.002333,172.31.47.0-255,66,212655,96,298541
42399,0.002335,74.125.24.0-255,1484,214139,96,298541
42400,0.00234,74.125.24.0-255,4320,218459,96,298541
42401,0.002341,172.31.47.0-255,66,218525,96,298541
42402,0.002358,74.125.24.0-255,6438,224963,96,298541
42403,0.00236,172.31.47.0-255,66,225029,96,298541
42404,0.002428,74.125.24.0-255,1484,226513,96,298541
42405,0.002441,74.125.24.0-255,1484,227997,96,298541
42406,0.002443,172.31.47.0-255,66,228063,96,298541
42407,0.002462,74.125.24.0-255,4320,232383,96,298541
42408,0.002464,172.31.47.0-255,66,232449,96,298541
42409,0.002484,74.125.24.0-255,5738,238187,96,298541
42410,0.002486,172.31.47.0-255,66,238253,96,298541
42411,0.002506,74.125.24.0-255,4320,242573,96,298541
42412,0.002508,172.31.47.0-255,66,242639,96,298541
42413,0.002514,74.125.24.0-255,7156,249795,96,298541
42414,0.002515,172.31.47.0-255,66,249861,96,298541
42415,0.002525,172.31.47.0-255,66,249927,96,298541
42416,0.002527,74.125.24.0-255,1484,251411,96,298541
42417,0.002542,74.125.24.0-255,7156,258567,96,298541
42418,0.002546,172.31.47.0-255,66,258633,96,298541
42419,0.002558,74.125.24.0-255,2902,261535,96,298541
42420,0.00256,172.31.47.0-255,66,261601,96,298541
42421,0.002562,74.125.24.0-255,1484,263085,96,298541
42422,0.002564,74.125.24.0-255,1484,264569,96,298541
42423,0.002566,172.31.47.0-255,66,264635,96,298541
42424,0.002568,74.125.24.0-255,1484,266119,96,298541
42425,0.002592,74.125.24.0-255,2902,269021,96,298541
42426,0.002594,172.31.47.0-255,66,269087,96,298541
42427,0.002606,74.125.24.0-255,4320,273407,96,298541
42428,0.002608,172.31.47.0-255,66,273473,96,298541
42429,0.002626,74.125.24.0-255,5738,279211,96,298541
42430,0.002633,172.31.47.0-255,66,279277,96,298541
42431,0.002636,74.125.24.0-255,1484,280761,96,298541
42432,0.002653,74.125.24.0-255,3602,284363,96,298541
42433,0.002655,172.31.47.0-255,66,284429,96,298541
42434,0.002659,74.125.24.0-255,4320,288749,96,298541
42435,0.002661,172.31.47.0-255,66,288815,96,298541
42436,0.002676,74.125.24.0-255,1484,290299,96,298541
42437,0.00268,74.125.24.0-255,3539,293838,96,298541
42438,0.002682,172.31.47.0-255,66,293904,96,298541
42439,0.002684,74.125.24.0-255,105,294009,96,298541
42440,0.00463,172.31.47.0-255,66,294075,96,298541
42441,0.004685,172.31.47.0-255,105,294180,96,298541
42442,0.006879,74.125.24.0-255,66,294246,96,298541
42443,0.037863,172.31.47.0-255,172,294418,96,298541
42444,0.037896,172.31.47.0-255,1101,295519,96,298541
42445,0.037947,172.31.47.0-255,1514,297033,96,298541
42446,0.037949,172.31.47.0-255,1310,298343,96,298541
42447,0.039386,104.244.42.0-255,66,298409,96,298541
42448,0.039431,104.244.42.0-255,66,298475,96,298541
42449,0.039525,104.244.42.0-255,66,298541,96,298541
42450,0.0,172.217.194.0-255,146,146,96,268408
42451,2.9e-05,172.31.47.0-255,66,212,96,268408
42452,3.5e-05,172.217.194.0-255,1484,1696,96,268408
42453,3.8e-05,172.31.47.0-255,66,1762,96,268408
42454,4.2e-05,172.217.194.0-255,2902,4664,96,268408
42455,4.5e-05,172.31.47.0-255,66,4730,96,268408
42456,5.7e-05,172.217.194.0-255,1484,6214,96,268408
42457,5.9e-05,172.31.47.0-255,66,6280,96,268408
42458,7.3e-05,172.217.194.0-255,1484,7764,96,268408
42459,7.5e-05,172.31.47.0-255,66,7830,96,268408
42460,8.8e-05,172.217.194.0-255,1484,9314,96,268408
42461,9e-05,172.31.47.0-255,66,9380,96,268408
42462,0.000108,172.217.194.0-255,2902,12282,96,268408
42463,0.000111,172.31.47.0-255,66,12348,96,268408
42464,0.000127,172.217.194.0-255,2103,14451,96,268408
42465,0.000129,172.31.47.0-255,66,14517,96,268408
42466,0.000133,172.217.194.0-255,2902,17419,96,268408
42467,0.000135,172.31.47.0-255,66,17485,96,268408
42468,0.000155,172.217.194.0-255,2902,20387,96,268408
42469,0.000158,172.31.47.0-255,66,20453,96,268408
42470,0.000186,172.217.194.0-255,4320,24773,96,268408
42471,0.000188,172.31.47.0-255,66,24839,96,268408
42472,0.00021,172.217.194.0-255,6797,31636,96,268408
42473,0.000212,172.31.47.0-255,66,31702,96,268408
42474,0.000362,172.217.194.0-255,1484,33186,96,268408
42475,0.000366,172.31.47.0-255,66,33252,96,268408
42476,0.00037,172.217.194.0-255,2902,36154,96,268408
42477,0.000378,172.31.47.0-255,66,36220,96,268408
42478,0.000386,172.217.194.0-255,5738,41958,96,268408
42479,0.000389,172.31.47.0-255,66,42024,96,268408
42480,0.000417,172.217.194.0-255,4320,46344,96,268408
42481,0.00042,172.31.47.0-255,66,46410,96,268408
42482,0.000447,172.31.47.0-255,66,46476,96,268408
42483,0.000464,172.217.194.0-255,2902,49378,96,268408
42484,0.000466,172.31.47.0-255,66,49444,96,268408
42485,0.000494,172.217.194.0-255,7102,56546,96,268408
42486,0.000497,172.31.47.0-255,66,56612,96,268408
42487,0.0005,172.217.194.0-255,382,56994,96,268408
42488,0.000502,172.31.47.0-255,66,57060,96,268408
42489,0.00075,172.217.194.0-255,1484,58544,96,268408
42490,0.000754,172.31.47.0-255,66,58610,96,268408
42491,0.000761,172.217.194.0-255,2902,61512,96,268408
42492,0.000763,172.31.47.0-255,66,61578,96,268408
42493,0.000766,172.217.194.0-255,1484,63062,96,268408
42494,0.000767,172.31.47.0-255,66,63128,96,268408
42495,0.000793,172.217.194.0-255,4320,67448,96,268408
42496,0.000797,172.31.47.0-255,66,67514,96,268408
42497,0.000805,172.31.47.0-255,66,67580,96,268408
42498,0.000824,172.217.194.0-255,4320,71900,96,268408
42499,0.000827,172.31.47.0-255,66,71966,96,268408
42500,0.000837,172.31.47.0-255,66,72032,96,268408
42501,0.001135,172.217.194.0-255,1484,73516,96,268408
42502,0.00114,172.31.47.0-255,66,73582,96,268408
42503,0.001147,172.217.194.0-255,2902,76484,96,268408
42504,0.001149,172.31.47.0-255,66,76550,96,268408
42505,0.001153,172.217.194.0-255,4320,80870,96,268408
42506,0.001171,172.217.194.0-255,1484,82354,96,268408
42507,0.001175,172.217.194.0-255,4320,86674,96,268408
42508,0.001186,172.31.47.0-255,66,86740,96,268408
42509,0.001204,172.217.194.0-255,1484,88224,96,268408
42510,0.00121,172.217.194.0-255,7156,95380,96,268408
42511,0.001226,172.217.194.0-255,2902,98282,96,268408
42512,0.001263,172.217.194.0-255,2902,101184,96,268408
42513,0.001266,172.31.47.0-255,66,101250,96,268408
42514,0.00127,172.31.47.0-255,66,101316,96,268408
42515,0.001336,172.31.47.0-255,66,101382,96,268408
42516,0.001352,172.217.194.0-255,4320,105702,96,268408
42517,0.001368,172.31.47.0-255,66,105768,96,268408
42518,0.001398,172.217.194.0-255,7156,112924,96,268408
42519,0.001416,172.217.194.0-255,7156,120080,96,268408
42520,0.00142,172.31.47.0-255,66,120146,96,268408
42521,0.001439,172.217.194.0-255,4320,124466,96,268408
42522,0.001445,172.31.47.0-255,66,124532,96,268408
42523,0.001454,172.217.194.0-255,5738,130270,96,268408
42524,0.001457,172.31.47.0-255,66,130336,96,268408
42525,0.001463,172.217.194.0-255,766,131102,96,268408
42526,0.001559,172.217.194.0-255,1484,132586,96,268408
42527,0.001563,172.217.194.0-255,2902,135488,96,268408
42528,0.001596,172.31.47.0-255,66,135554,96,268408
42529,0.001618,172.217.194.0-255,5738,141292,96,268408
42530,0.001624,172.217.194.0-255,7156,148448,96,268408
42531,0.001634,172.31.47.0-255,66,148514,96,268408
42532,0.001644,172.217.194.0-255,5738,154252,96,268408
42533,0.001647,172.31.47.0-255,66,154318,96,268408
42534,0.00167,172.217.194.0-255,2184,156502,96,268408
42535,0.001684,172.31.47.0-255,66,156568,96,268408
42536,0.001718,172.217.194.0-255,1484,158052,96,268408
42537,0.00172,172.217.194.0-255,1484,159536,96,268408
42538,0.001725,172.31.47.0-255,66,159602,96,268408
42539,0.001739,172.217.194.0-255,1484,161086,96,268408
42540,0.001754,172.217.194.0-255,5738,166824,96,268408
42541,0.001757,172.217.194.0-255,2902,169726,96,268408
42542,0.001767,172.31.47.0-255,66,169792,96,268408
42543,0.001787,172.217.194.0-255,4320,174112,96,268408
42544,0.001792,172.217.194.0-255,4320,178432,96,268408
42545,0.001804,172.31.47.0-255,66,178498,96,268408
42546,0.001815,172.31.47.0-255,66,178564,96,268408
42547,0.001822,172.217.194.0-255,2184,180748,96,268408
42548,0.001848,172.31.47.0-255,66,180814,96,268408
42549,0.001877,172.31.47.0-255,66,180880,96,268408
42550,0.001885,172.217.194.0-255,2902,183782,96,268408
42551,0.001887,172.217.194.0-255,1484,185266,96,268408
42552,0.00191,172.31.47.0-255,66,185332,96,268408
42553,0.001914,172.31.47.0-255,66,185398,96,268408
42554,0.001939,172.31.47.0-255,66,185464,96,268408
42555,0.001957,172.217.194.0-255,5738,191202,96,268408
42556,0.001969,172.217.194.0-255,1484,192686,96,268408
42557,0.001976,172.217.194.0-255,7156,199842,96,268408
42558,0.001979,172.31.47.0-255,66,199908,96,268408
42559,0.001985,172.217.194.0-255,1484,201392,96,268408
42560,0.001995,172.217.194.0-255,2902,204294,96,268408
42561,0.002019,172.31.47.0-255,66,204360,96,268408
42562,0.002039,172.217.194.0-255,5738,210098,96,268408
42563,0.002053,172.217.194.0-255,2902,213000,96,268408
42564,0.002055,172.31.47.0-255,66,213066,96,268408
42565,0.002058,172.31.47.0-255,66,213132,96,268408
42566,0.002077,172.217.194.0-255,5020,218152,96,268408
42567,0.002079,172.217.194.0-255,1484,219636,96,268408
42568,0.002082,172.31.47.0-255,66,219702,96,268408
42569,0.002128,172.217.194.0-255,4320,224022,96,268408
42570,0.002132,172.31.47.0-255,66,224088,96,268408
42571,0.002145,172.217.194.0-255,3602,227690,96,268408
42572,0.002161,172.31.47.0-255,66,227756,96,268408
42573,0.002186,172.217.194.0-255,1484,229240,96,268408
42574,0.002191,172.217.194.0-255,2902,232142,96,268408
42575,0.002194,172.31.47.0-255,66,232208,96,268408
42576,0.002215,172.217.194.0-255,5738,237946,96,268408
42577,0.002218,172.217.194.0-255,2902,240848,96,268408
42578,0.002222,172.31.47.0-255,66,240914,96,268408
42579,0.002241,172.217.194.0-255,5738,246652,96,268408
42580,0.00228,172.31.47.0-255,66,246718,96,268408
42581,0.002287,172.217.194.0-255,2902,249620,96,268408
42582,0.002291,172.31.47.0-255,66,249686,96,268408
42583,0.002321,172.217.194.0-255,3602,253288,96,268408
42584,0.002325,172.31.47.0-255,66,253354,96,268408
42585,0.002411,172.217.194.0-255,1484,254838,96,268408
42586,0.002434,172.217.194.0-255,2902,257740,96,268408
42587,0.002438,172.217.194.0-255,4320,262060,96,268408
42588,0.002442,172.31.47.0-255,66,262126,96,268408
42589,0.002457,172.217.194.0-255,1482,263608,96,268408
42590,0.00246,172.217.194.0-255,97,263705,96,268408
42591,0.002478,172.31.47.0-255,66,263771,96,268408
42592,0.002509,172.217.194.0-255,105,263876,96,268408
42593,0.003863,172.31.47.0-255,66,263942,96,268408
42594,0.003894,172.31.47.0-255,105,264047,96,268408
42595,0.006365,172.217.194.0-255,66,264113,96,268408
42596,0.023942,172.31.47.0-255,172,264285,96,268408
42597,0.023977,172.31.47.0-255,1105,265390,96,268408
42598,0.024032,172.31.47.0-255,1514,266904,96,268408
42599,0.024034,172.31.47.0-255,1306,268210,96,268408
42600,0.02549,104.244.42.0-255,66,268276,96,268408
42601,0.025525,104.244.42.0-255,66,268342,96,268408
42602,0.025588,104.244.42.0-255,66,268408,96,268408
42603,0.0,74.125.24.0-255,298,298,96,313691
42604,1.7e-05,172.31.47.0-255,66,364,96,313691
42605,2.3e-05,74.125.24.0-255,1484,1848,96,313691
42606,2.7e-05,172.31.47.0-255,66,1914,96,313691
42607,3.3e-05,74.125.24.0-255,4320,6234,96,313691
42608,3.6e-05,172.31.47.0-255,66,6300,96,313691
42609,4.4e-05,74.125.24.0-255,7156,13456,96,313691
42610,4.7e-05,172.31.47.0-255,66,13522,96,313691
42611,6.9e-05,74.125.24.0-255,1846,15368,96,313691
42612,7.1e-05,172.31.47.0-255,66,15434,96,313691
42613,8.2e-05,172.31.47.0-255,66,15500,96,313691
42614,8.5e-05,74.125.24.0-255,2902,18402,96,313691
42615,8.7e-05,172.31.47.0-255,66,18468,96,313691
42616,0.00011,74.125.24.0-255,2543,21011,96,313691
42617,0.000113,172.31.47.0-255,66,21077,96,313691
42618,0.000152,74.125.24.0-255,1484,22561,96,313691
42619,0.000155,172.31.47.0-255,66,22627,96,313691
42620,0.000159,74.125.24.0-255,2902,25529,96,313691
42621,0.000161,172.31.47.0-255,66,25595,96,313691
42622,0.000178,74.125.24.0-255,5738,31333,96,313691
42623,0.00018,172.31.47.0-255,66,31399,96,313691
42624,0.000182,74.125.24.0-255,1484,32883,96,313691
42625,0.000184,172.31.47.0-255,66,32949,96,313691
42626,0.000207,74.125.24.0-255,4320,37269,96,313691
42627,0.000209,172.31.47.0-255,66,37335,96,313691
42628,0.000212,74.125.24.0-255,1484,38819,96,313691
42629,0.000213,172.31.47.0-255,66,38885,96,313691
42630,0.000232,74.125.24.0-255,7156,46041,96,313691
42631,0.000234,172.31.47.0-255,66,46107,96,313691
42632,0.000264,74.125.24.0-255,5379,51486,96,313691
42633,0.000267,172.31.47.0-255,66,51552,96,313691
42634,0.000271,74.125.24.0-255,3961,55513,96,313691
42635,0.000273,172.31.47.0-255,66,55579,96,313691
42636,0.000305,74.125.24.0-255,646,56225,96,313691
42637,0.000445,74.125.24.0-255,1484,57709,96,313691
42638,0.000449,172.31.47.0-255,66,57775,96,313691
42639,0.000455,74.125.24.0-255,2902,60677,96,313691
42640,0.000458,172.31.47.0-255,66,60743,96,313691
42641,0.000463,74.125.24.0-255,4320,65063,96,313691
42642,0.000465,172.31.47.0-255,66,65129,96,313691
42643,0.00048,74.125.24.0-255,1484,66613,96,313691
42644,0.000491,172.31.47.0-255,66,66679,96,313691
42645,0.000506,74.125.24.0-255,1484,68163,96,313691
42646,0.000533,172.31.47.0-255,66,68229,96,313691
42647,0.001004,74.125.24.0-255,1484,69713,96,313691
42648,0.001011,74.125.24.0-255,2902,72615,96,313691
42649,0.001015,172.31.47.0-255,66,72681,96,313691
42650,0.001021,74.125.24.0-255,2902,75583,96,313691
42651,0.001023,172.31.47.0-255,66,75649,96,313691
42652,0.001041,74.125.24.0-255,2902,78551,96,313691
42653,0.001044,172.31.47.0-255,66,78617,96,313691
42654,0.00105,74.125.24.0-255,5738,84355,96,313691
42655,0.001052,172.31.47.0-255,66,84421,96,313691
42656,0.001057,74.125.24.0-255,2902,87323,96,313691
42657,0.001059,172.31.47.0-255,66,87389,96,313691
42658,0.001096,74.125.24.0-255,4471,91860,96,313691
42659,0.001106,172.31.47.0-255,66,91926,96,313691
42660,0.001109,172.31.47.0-255,66,91992,96,313691
42661,0.001361,74.125.24.0-255,1484,93476,96,313691
42662,0.001367,74.125.24.0-255,2902,96378,96,313691
42663,0.001371,172.31.47.0-255,66,96444,96,313691
42664,0.001378,74.125.24.0-255,5738,102182,96,313691
42665,0.001381,172.31.47.0-255,66,102248,96,313691
42666,0.001413,74.125.24.0-255,7156,109404,96,313691
42667,0.001433,172.31.47.0-255,66,109470,96,313691
42668,0.001439,74.125.24.0-255,4320,113790,96,313691
42669,0.001443,74.125.24.0-255,2184,115974,96,313691
42670,0.001636,74.125.24.0-255,1484,117458,96,313691
42671,0.001641,74.125.24.0-255,2902,120360,96,313691
42672,0.001653,74.125.24.0-255,1484,121844,96,313691
42673,0.001666,74.125.24.0-255,4320,126164,96,313691
42674,0.001693,74.125.24.0-255,1484,127648,96,313691
42675,0.002196,74.125.24.0-255,1484,129132,96,313691
42676,0.002203,74.125.24.0-255,2902,132034,96,313691
42677,0.002207,74.125.24.0-255,4320,136354,96,313691
42678,0.002219,74.125.24.0-255,1484,137838,96,313691
42679,0.002225,74.125.24.0-255,4320,142158,96,313691
42680,0.002251,74.125.24.0-255,1484,143642,96,313691
42681,0.002305,74.125.24.0-255,1484,145126,96,313691
42682,0.002322,74.125.24.0-255,2902,148028,96,313691
42683,0.002324,74.125.24.0-255,1484,149512,96,313691
42684,0.002342,74.125.24.0-255,4320,153832,96,313691
42685,0.00238,74.125.24.0-255,4320,158152,96,313691
42686,0.002409,74.125.24.0-255,5738,163890,96,313691
42687,0.002428,74.125.24.0-255,5020,168910,96,313691
42688,0.006161,172.31.47.0-255,66,168976,96,313691
42689,0.006167,172.31.47.0-255,66,169042,96,313691
42690,0.00617,172.31.47.0-255,66,169108,96,313691
42691,0.006184,172.31.47.0-255,66,169174,96,313691
42692,0.006188,172.31.47.0-255,66,169240,96,313691
42693,0.006193,172.31.47.0-255,66,169306,96,313691
42694,0.006197,172.31.47.0-255,66,169372,96,313691
42695,0.0062,172.31.47.0-255,66,169438,96,313691
42696,0.006203,172.31.47.0-255,66,169504,96,313691
42697,0.006206,172.31.47.0-255,66,169570,96,313691
42698,0.006209,172.31.47.0-255,66,169636,96,313691
42699,0.006212,172.31.47.0-255,66,169702,96,313691
42700,0.006215,172.31.47.0-255,66,169768,96,313691
42701,0.006219,172.31.47.0-255,66,169834,96,313691
42702,0.006222,172.31.47.0-255,66,169900,96,313691
42703,0.006224,172.31.47.0-255,66,169966,96,313691
42704,0.006227,172.31.47.0-255,66,170032,96,313691
42705,0.00623,172.31.47.0-255,66,170098,96,313691
42706,0.008806,74.125.24.0-255,5738,175836,96,313691
42707,0.008813,172.31.47.0-255,66,175902,96,313691
42708,0.011386,74.125.24.0-255,5738,181640,96,313691
42709,0.011395,172.31.47.0-255,66,181706,96,313691
42710,0.013955,74.125.24.0-255,5738,187444,96,313691
42711,0.013963,172.31.47.0-255,66,187510,96,313691
42712,0.016527,74.125.24.0-255,5738,193248,96,313691
42713,0.016535,172.31.47.0-255,66,193314,96,313691
42714,0.019101,74.125.24.0-255,5738,199052,96,313691
42715,0.019112,172.31.47.0-255,66,199118,96,313691
42716,0.021702,74.125.24.0-255,5738,204856,96,313691
42717,0.021709,172.31.47.0-255,66,204922,96,313691
42718,0.024249,74.125.24.0-255,5738,210660,96,313691
42719,0.024257,172.31.47.0-255,66,210726,96,313691
42720,0.026451,172.31.47.0-255,172,210898,96,313691
42721,0.026477,172.31.47.0-255,1110,212008,96,313691
42722,0.026526,172.31.47.0-255,1514,213522,96,313691
42723,0.026527,172.31.47.0-255,1303,214825,96,313691
42724,0.026814,74.125.24.0-255,5738,220563,96,313691
42725,0.026822,172.31.47.0-255,66,220629,96,313691
42726,0.027937,104.244.42.0-255,66,220695,96,313691
42727,0.027962,104.244.42.0-255,66,220761,96,313691
42728,0.028028,104.244.42.0-255,66,220827,96,313691
42729,0.029387,74.125.24.0-255,5738,226565,96,313691
42730,0.029392,172.31.47.0-255,66,226631,96,313691
42731,0.03199,74.125.24.0-255,5738,232369,96,313691
42732,0.031997,172.31.47.0-255,66,232435,96,313691
42733,0.034567,74.125.24.0-255,5738,238173,96,313691
42734,0.034573,172.31.47.0-255,66,238239,96,313691
42735,0.037164,74.125.24.0-255,5738,243977,96,313691
42736,0.03717,172.31.47.0-255,66,244043,96,313691
42737,0.039748,74.125.24.0-255,5738,249781,96,313691
42738,0.039754,172.31.47.0-255,66,249847,96,313691
42739,0.042325,74.125.24.0-255,5738,255585,96,313691
42740,0.04233,172.31.47.0-255,66,255651,96,313691
42741,0.044889,74.125.24.0-255,5738,261389,96,313691
42742,0.044895,172.31.47.0-255,66,261455,96,313691
42743,0.047456,74.125.24.0-255,5738,267193,96,313691
42744,0.047464,172.31.47.0-255,66,267259,96,313691
42745,0.050024,74.125.24.0-255,5738,272997,96,313691
42746,0.05003,172.31.47.0-255,66,273063,96,313691
42747,0.052627,74.125.24.0-255,5738,278801,96,313691
42748,0.052634,172.31.47.0-255,66,278867,96,313691
42749,0.055202,74.125.24.0-255,5738,284605,96,313691
42750,0.055208,172.31.47.0-255,66,284671,96,313691
42751,0.057795,74.125.24.0-255,5738,290409,96,313691
42752,0.057802,172.31.47.0-255,66,290475,96,313691
42753,0.060388,74.125.24.0-255,5738,296213,96,313691
42754,0.060395,172.31.47.0-255,66,296279,96,313691
42755,0.062975,74.125.24.0-255,5738,302017,96,313691
42756,0.062982,172.31.47.0-255,66,302083,96,313691
42757,0.065536,74.125.24.0-255,5738,307821,96,313691
42758,0.065542,172.31.47.0-255,66,307887,96,313691
42759,0.06812,74.125.24.0-255,5738,313625,96,313691
42760,0.068126,172.31.47.0-255,66,313691,96,313691
42761,0.0,172.31.47.0-255,105,105,96,276
42762,0.00149,157.240.13.0-255,105,210,96,276
42763,0.0015,172.31.47.0-255,66,276,96,276
42764,0.0,172.253.118.0-255,145,145,96,332768
42765,2.7e-05,172.31.47.0-255,66,211,96,332768
42766,3.4e-05,172.253.118.0-255,1484,1695,96,332768
42767,3.9e-05,172.31.47.0-255,66,1761,96,332768
42768,4.5e-05,172.253.118.0-255,2902,4663,96,332768
42769,4.9e-05,172.31.47.0-255,66,4729,96,332768
42770,5.4e-05,172.253.118.0-255,4320,9049,96,332768
42771,5.8e-05,172.31.47.0-255,66,9115,96,332768
42772,6.3e-05,172.253.118.0-255,4919,14034,96,332768
42773,6.7e-05,172.31.47.0-255,66,14100,96,332768
42774,0.00011,172.253.118.0-255,7156,21256,96,332768
42775,0.000114,172.31.47.0-255,66,21322,96,332768
42776,0.000125,172.31.47.0-255,66,21388,96,332768
42777,0.000128,172.253.118.0-255,1484,22872,96,332768
42778,0.00013,172.31.47.0-255,66,22938,96,332768
42779,0.00016,172.31.47.0-255,66,23004,96,332768
42780,0.000163,172.253.118.0-255,766,23770,96,332768
42781,0.000165,172.31.47.0-255,66,23836,96,332768
42782,0.000191,172.253.118.0-255,1484,25320,96,332768
42783,0.000193,172.31.47.0-255,66,25386,96,332768
42784,0.000198,172.253.118.0-255,2902,28288,96,332768
42785,0.0002,172.31.47.0-255,66,28354,96,332768
42786,0.000218,172.253.118.0-255,2902,31256,96,332768
42787,0.00022,172.31.47.0-255,66,31322,96,332768
42788,0.000242,172.253.118.0-255,2902,34224,96,332768
42789,0.000244,172.31.47.0-255,66,34290,96,332768
42790,0.000263,172.253.118.0-255,4320,38610,96,332768
42791,0.000265,172.31.47.0-255,66,38676,96,332768
42792,0.000282,172.253.118.0-255,2543,41219,96,332768
42793,0.000285,172.31.47.0-255,66,41285,96,332768
42794,0.000287,172.253.118.0-255,363,41648,96,332768
42795,0.000289,172.31.47.0-255,66,41714,96,332768
42796,0.000648,172.253.118.0-255,379,42093,96,332768
42797,0.000657,172.31.47.0-255,66,42159,96,332768
42798,0.0008,172.253.118.0-255,1484,43643,96,332768
42799,0.000805,172.31.47.0-255,66,43709,96,332768
42800,0.000809,172.253.118.0-255,1484,45193,96,332768
42801,0.000811,172.31.47.0-255,66,45259,96,332768
42802,0.000827,172.253.118.0-255,1484,46743,96,332768
42803,0.00083,172.31.47.0-255,66,46809,96,332768
42804,0.000837,172.253.118.0-255,5738,52547,96,332768
42805,0.000839,172.31.47.0-255,66,52613,96,332768
42806,0.000874,172.31.47.0-255,66,52679,96,332768
42807,0.000896,172.253.118.0-255,5379,58058,96,332768
42808,0.000902,172.31.47.0-255,66,58124,96,332768
42809,0.000915,172.253.118.0-255,7156,65280,96,332768
42810,0.00093,172.253.118.0-255,2543,67823,96,332768
42811,0.00094,172.31.47.0-255,66,67889,96,332768
42812,0.001107,172.253.118.0-255,1484,69373,96,332768
42813,0.001123,172.253.118.0-255,2902,72275,96,332768
42814,0.001126,172.31.47.0-255,66,72341,96,332768
42815,0.00113,172.253.118.0-255,1484,73825,96,332768
42816,0.001146,172.253.118.0-255,4320,78145,96,332768
42817,0.001162,172.31.47.0-255,66,78211,96,332768
42818,0.001174,172.253.118.0-255,2902,81113,96,332768
42819,0.001195,172.31.47.0-255,66,81179,96,332768
42820,0.001211,172.253.118.0-255,5738,86917,96,332768
42821,0.001217,172.31.47.0-255,66,86983,96,332768
42822,0.001228,172.253.118.0-255,5020,92003,96,332768
42823,0.001249,172.31.47.0-255,66,92069,96,332768
42824,0.001277,172.253.118.0-255,1484,93553,96,332768
42825,0.001281,172.253.118.0-255,1484,95037,96,332768
42826,0.001294,172.253.118.0-255,1484,96521,96,332768
42827,0.001298,172.31.47.0-255,66,96587,96,332768
42828,0.001307,172.253.118.0-255,2902,99489,96,332768
42829,0.001312,172.31.47.0-255,66,99555,96,332768
42830,0.001321,172.253.118.0-255,2902,102457,96,332768
42831,0.001337,172.253.118.0-255,5738,108195,96,332768
42832,0.001355,172.253.118.0-255,4320,112515,96,332768
42833,0.001358,172.253.118.0-255,1484,113999,96,332768
42834,0.001363,172.31.47.0-255,66,114065,96,332768
42835,0.001399,172.31.47.0-255,66,114131,96,332768
42836,0.00141,172.253.118.0-255,3602,117733,96,332768
42837,0.001428,172.31.47.0-255,66,117799,96,332768
42838,0.001657,172.253.118.0-255,1484,119283,96,332768
42839,0.001676,172.253.118.0-255,2902,122185,96,332768
42840,0.00168,172.31.47.0-255,66,122251,96,332768
42841,0.001685,172.253.118.0-255,2902,125153,96,332768
42842,0.001692,172.31.47.0-255,66,125219,96,332768
42843,0.001703,172.253.118.0-255,2902,128121,96,332768
42844,0.001718,172.253.118.0-255,4320,132441,96,332768
42845,0.001728,172.31.47.0-255,66,132507,96,332768
42846,0.001743,172.253.118.0-255,4320,136827,96,332768
42847,0.001802,172.253.118.0-255,5020,141847,96,332768
42848,0.001811,172.31.47.0-255,66,141913,96,332768
42849,0.002006,172.253.118.0-255,1484,143397,96,332768
42850,0.002021,172.253.118.0-255,2902,146299,96,332768
42851,0.002025,172.31.47.0-255,66,146365,96,332768
42852,0.002045,172.253.118.0-255,5738,152103,96,332768
42853,0.002069,172.253.118.0-255,4320,156423,96,332768
42854,0.002074,172.31.47.0-255,66,156489,96,332768
42855,0.002086,172.253.118.0-255,5738,162227,96,332768
42856,0.002088,172.253.118.0-255,1484,163711,96,332768
42857,0.002104,172.31.47.0-255,66,163777,96,332768
42858,0.002126,172.253.118.0-255,2184,165961,96,332768
42859,0.002146,172.31.47.0-255,66,166027,96,332768
42860,0.002457,172.253.118.0-255,1484,167511,96,332768
42861,0.002464,172.253.118.0-255,2902,170413,96,332768
42862,0.002467,172.31.47.0-255,66,170479,96,332768
42863,0.002492,172.253.118.0-255,5738,176217,96,332768
42864,0.002514,172.253.118.0-255,5738,181955,96,332768
42865,0.00254,172.253.118.0-255,7156,189111,96,332768
42866,0.00848,172.31.47.0-255,66,189177,96,332768
42867,0.011017,172.253.118.0-255,5738,194915,96,332768
42868,0.011024,172.31.47.0-255,66,194981,96,332768
42869,0.013561,172.253.118.0-255,5738,200719,96,332768
42870,0.01357,172.31.47.0-255,66,200785,96,332768
42871,0.016116,172.253.118.0-255,5738,206523,96,332768
42872,0.016128,172.31.47.0-255,66,206589,96,332768
42873,0.018677,172.253.118.0-255,5738,212327,96,332768
42874,0.018687,172.31.47.0-255,66,212393,96,332768
42875,0.021198,172.253.118.0-255,5738,218131,96,332768
42876,0.021207,172.31.47.0-255,66,218197,96,332768
42877,0.023751,172.253.118.0-255,5738,223935,96,332768
42878,0.023759,172.31.47.0-255,66,224001,96,332768
42879,0.026311,172.253.118.0-255,5738,229739,96,332768
42880,0.026324,172.31.47.0-255,66,229805,96,332768
42881,0.028824,172.253.118.0-255,5738,235543,96,332768
42882,0.028834,172.31.47.0-255,66,235609,96,332768
42883,0.029519,172.31.47.0-255,172,235781,96,332768
42884,0.02955,172.31.47.0-255,1110,236891,96,332768
42885,0.029596,172.31.47.0-255,1514,238405,96,332768
42886,0.029598,172.31.47.0-255,1301,239706,96,332768
42887,0.031079,104.244.42.0-255,66,239772,96,332768
42888,0.031111,104.244.42.0-255,66,239838,96,332768
42889,0.031146,104.244.42.0-255,66,239904,96,332768
42890,0.031349,172.253.118.0-255,5738,245642,96,332768
42891,0.031357,172.31.47.0-255,66,245708,96,332768
42892,0.033921,172.253.118.0-255,5738,251446,96,332768
42893,0.033938,172.31.47.0-255,66,251512,96,332768
42894,0.03648,172.253.118.0-255,5738,257250,96,332768
42895,0.036487,172.31.47.0-255,66,257316,96,332768
42896,0.039011,172.253.118.0-255,5738,263054,96,332768
42897,0.039016,172.31.47.0-255,66,263120,96,332768
42898,0.041535,172.253.118.0-255,5738,268858,96,332768
42899,0.041543,172.31.47.0-255,66,268924,96,332768
42900,0.044084,172.253.118.0-255,5738,274662,96,332768
42901,0.044091,172.31.47.0-255,66,274728,96,332768
42902,0.046629,172.253.118.0-255,5738,280466,96,332768
42903,0.046636,172.31.47.0-255,66,280532,96,332768
42904,0.049149,172.253.118.0-255,5738,286270,96,332768
42905,0.049155,172.31.47.0-255,66,286336,96,332768
42906,0.051667,172.253.118.0-255,5738,292074,96,332768
42907,0.051675,172.31.47.0-255,66,292140,96,332768
42908,0.054201,172.253.118.0-255,5738,297878,96,332768
42909,0.054208,172.31.47.0-255,66,297944,96,332768
42910,0.056768,172.253.118.0-255,5738,303682,96,332768
42911,0.056775,172.31.47.0-255,66,303748,96,332768
42912,0.059303,172.253.118.0-255,5738,309486,96,332768
42913,0.059308,172.31.47.0-255,66,309552,96,332768
42914,0.061836,172.253.118.0-255,5738,315290,96,332768
42915,0.061842,172.31.47.0-255,66,315356,96,332768
42916,0.064372,172.253.118.0-255,5738,321094,96,332768
42917,0.064377,172.31.47.0-255,66,321160,96,332768
42918,0.066908,172.253.118.0-255,5738,326898,96,332768
42919,0.066914,172.31.47.0-255,66,326964,96,332768
42920,0.069441,172.253.118.0-255,5738,332702,96,332768
42921,0.069447,172.31.47.0-255,66,332768,96,332768
42922,0.0,172.31.47.0-255,105,105,96,105
42923,0.0,74.125.200.0-255,297,297,96,332537
42924,3.1e-05,172.31.47.0-255,66,363,96,332537
42925,3.7e-05,74.125.200.0-255,1484,1847,96,332537
42926,4.1e-05,172.31.47.0-255,66,1913,96,332537
42927,4.4e-05,74.125.200.0-255,2902,4815,96,332537
42928,5.3e-05,172.31.47.0-255,66,4881,96,332537
42929,5.8e-05,74.125.200.0-255,4320,9201,96,332537
42930,6e-05,172.31.47.0-255,66,9267,96,332537
42931,8.7e-05,74.125.200.0-255,1484,10751,96,332537
42932,8.9e-05,172.31.47.0-255,66,10817,96,332537
42933,0.000101,74.125.200.0-255,2902,13719,96,332537
42934,0.000106,172.31.47.0-255,66,13785,96,332537
42935,0.000126,74.125.200.0-255,604,14389,96,332537
42936,0.000129,172.31.47.0-255,66,14455,96,332537
42937,0.000268,74.125.200.0-255,1484,15939,96,332537
42938,0.000272,172.31.47.0-255,66,16005,96,332537
42939,0.000276,74.125.200.0-255,1484,17489,96,332537
42940,0.000278,172.31.47.0-255,66,17555,96,332537
42941,0.000295,74.125.200.0-255,1484,19039,96,332537
42942,0.000297,172.31.47.0-255,66,19105,96,332537
42943,0.000302,74.125.200.0-255,4320,23425,96,332537
42944,0.000309,172.31.47.0-255,66,23491,96,332537
42945,0.000349,74.125.200.0-255,7156,30647,96,332537
42946,0.000352,172.31.47.0-255,66,30713,96,332537
42947,0.000376,74.125.200.0-255,2543,33256,96,332537
42948,0.000379,172.31.47.0-255,66,33322,96,332537
42949,0.00039,172.31.47.0-255,66,33388,96,332537
42950,0.000429,74.125.200.0-255,5738,39126,96,332537
42951,0.000431,172.31.47.0-255,66,39192,96,332537
42952,0.000459,74.125.200.0-255,4320,43512,96,332537
42953,0.000462,172.31.47.0-255,66,43578,96,332537
42954,0.000478,172.31.47.0-255,66,43644,96,332537
42955,0.000481,74.125.200.0-255,766,44410,96,332537
42956,0.000555,74.125.200.0-255,392,44802,96,332537
42957,0.00059,74.125.200.0-255,116,44918,96,332537
42958,0.000647,74.125.200.0-255,333,45251,96,332537
42959,0.000705,172.31.47.0-255,66,45317,96,332537
42960,0.000857,74.125.200.0-255,1484,46801,96,332537
42961,0.000866,74.125.200.0-255,2902,49703,96,332537
42962,0.000869,172.31.47.0-255,66,49769,96,332537
42963,0.000899,74.125.200.0-255,5738,55507,96,332537
42964,0.000902,172.31.47.0-255,66,55573,96,332537
42965,0.000907,74.125.200.0-255,4320,59893,96,332537
42966,0.000909,172.31.47.0-255,66,59959,96,332537
42967,0.000914,74.125.200.0-255,5738,65697,96,332537
42968,0.000921,172.31.47.0-255,66,65763,96,332537
42969,0.000957,172.31.47.0-255,66,65829,96,332537
42970,0.000961,74.125.200.0-255,2184,68013,96,332537
42971,0.000963,172.31.47.0-255,66,68079,96,332537
42972,0.001191,74.125.200.0-255,1484,69563,96,332537
42973,0.001198,74.125.200.0-255,2902,72465,96,332537
42974,0.001201,172.31.47.0-255,66,72531,96,332537
42975,0.001208,74.125.200.0-255,5738,78269,96,332537
42976,0.001209,172.31.47.0-255,66,78335,96,332537
42977,0.001212,74.125.200.0-255,1484,79819,96,332537
42978,0.001242,74.125.200.0-255,5738,85557,96,332537
42979,0.001248,172.31.47.0-255,66,85623,96,332537
42980,0.001253,74.125.200.0-255,4320,89943,96,332537
42981,0.001255,172.31.47.0-255,66,90009,96,332537
42982,0.001295,172.31.47.0-255,66,90075,96,332537
42983,0.001299,74.125.200.0-255,2184,92259,96,332537
42984,0.001301,172.31.47.0-255,66,92325,96,332537
42985,0.001357,74.125.200.0-255,2902,95227,96,332537
42986,0.001361,172.31.47.0-255,66,95293,96,332537
42987,0.001366,74.125.200.0-255,4320,99613,96,332537
42988,0.001368,172.31.47.0-255,66,99679,96,332537
42989,0.001399,172.31.47.0-255,66,99745,96,332537
42990,0.001405,74.125.200.0-255,5738,105483,96,332537
42991,0.001406,172.31.47.0-255,66,105549,96,332537
42992,0.001439,74.125.200.0-255,7156,112705,96,332537
42993,0.001442,172.31.47.0-255,66,112771,96,332537
42994,0.001446,74.125.200.0-255,1484,114255,96,332537
42995,0.001471,74.125.200.0-255,3602,117857,96,332537
42996,0.001473,172.31.47.0-255,66,117923,96,332537
42997,0.00168,74.125.200.0-255,1484,119407,96,332537
42998,0.001695,74.125.200.0-255,2902,122309,96,332537
42999,0.001698,172.31.47.0-255,66,122375,96,332537
43000,0.001704,74.125.200.0-255,4320,126695,96,332537
43001,0.001706,172.31.47.0-255,66,126761,96,332537
43002,0.001732,74.125.200.0-255,1484,128245,96,332537
43003,0.001744,172.31.47.0-255,66,128311,96,332537
43004,0.001747,74.125.200.0-255,1484,129795,96,332537
43005,0.001776,172.31.47.0-255,66,129861,96,332537
43006,0.001781,74.125.200.0-255,5020,134881,96,332537
43007,0.001782,172.31.47.0-255,66,134947,96,332537
43008,0.001934,74.125.200.0-255,1484,136431,96,332537
43009,0.00195,74.125.200.0-255,2902,139333,96,332537
43010,0.001953,172.31.47.0-255,66,139399,96,332537
43011,0.001974,74.125.200.0-255,5738,145137,96,332537
43012,0.001976,172.31.47.0-255,66,145203,96,332537
43013,0.001981,74.125.200.0-255,5738,150941,96,332537
43014,0.001983,172.31.47.0-255,66,151007,96,332537
43015,0.002014,74.125.200.0-255,7156,158163,96,332537
43016,0.002017,172.31.47.0-255,66,158229,96,332537
43017,0.002048,172.31.47.0-255,66,158295,96,332537
43018,0.002101,74.125.200.0-255,2902,161197,96,332537
43019,0.002104,172.31.47.0-255,66,161263,96,332537
43020,0.002106,172.31.47.0-255,66,161329,96,332537
43021,0.004164,74.125.200.0-255,5738,167067,96,332537
43022,0.004168,172.31.47.0-255,66,167133,96,332537
43023,0.006224,74.125.200.0-255,5738,172871,96,332537
43024,0.006235,172.31.47.0-255,66,172937,96,332537
43025,0.008275,74.125.200.0-255,5738,178675,96,332537
43026,0.008282,172.31.47.0-255,66,178741,96,332537
43027,0.010349,74.125.200.0-255,5738,184479,96,332537
43028,0.010359,172.31.47.0-255,66,184545,96,332537
43029,0.012429,74.125.200.0-255,5738,190283,96,332537
43030,0.012441,172.31.47.0-255,66,190349,96,332537
43031,0.014497,74.125.200.0-255,5738,196087,96,332537
43032,0.014512,172.31.47.0-255,66,196153,96,332537
43033,0.016564,74.125.200.0-255,5738,201891,96,332537
43034,0.016575,172.31.47.0-255,66,201957,96,332537
43035,0.018632,74.125.200.0-255,5738,207695,96,332537
43036,0.018645,172.31.47.0-255,66,207761,96,332537
43037,0.020701,74.125.200.0-255,5738,213499,96,332537
43038,0.020709,172.31.47.0-255,66,213565,96,332537
43039,0.022754,74.125.200.0-255,5738,219303,96,332537
43040,0.022763,172.31.47.0-255,66,219369,96,332537
43041,0.024809,74.125.200.0-255,5738,225107,96,332537
43042,0.024819,172.31.47.0-255,66,225173,96,332537
43043,0.026788,172.31.47.0-255,172,225345,96,332537
43044,0.026835,172.31.47.0-255,1105,226450,96,332537
43045,0.026861,74.125.200.0-255,4320,230770,96,332537
43046,0.026867,172.31.47.0-255,66,230836,96,332537
43047,0.026885,74.125.200.0-255,1484,232320,96,332537
43048,0.02693,172.31.47.0-255,1514,233834,96,332537
43049,0.026931,172.31.47.0-255,1308,235142,96,332537
43050,0.028335,104.244.42.0-255,66,235208,96,332537
43051,0.028377,104.244.42.0-255,66,235274,96,332537
43052,0.028466,104.244.42.0-255,66,235340,96,332537
43053,0.028921,74.125.200.0-255,4320,239660,96,332537
43054,0.028925,172.31.47.0-255,66,239726,96,332537
43055,0.030971,74.125.200.0-255,5738,245464,96,332537
43056,0.030976,172.31.47.0-255,66,245530,96,332537
43057,0.033015,74.125.200.0-255,5738,251268,96,332537
43058,0.033019,172.31.47.0-255,66,251334,96,332537
43059,0.035068,74.125.200.0-255,5738,257072,96,332537
43060,0.035074,172.31.47.0-255,66,257138,96,332537
43061,0.037131,74.125.200.0-255,5738,262876,96,332537
43062,0.037136,172.31.47.0-255,66,262942,96,332537
43063,0.039179,74.125.200.0-255,4320,267262,96,332537
43064,0.039184,172.31.47.0-255,66,267328,96,332537
43065,0.039214,74.125.200.0-255,1484,268812,96,332537
43066,0.041217,74.125.200.0-255,4320,273132,96,332537
43067,0.041222,172.31.47.0-255,66,273198,96,332537
43068,0.043267,74.125.200.0-255,5738,278936,96,332537
43069,0.043273,172.31.47.0-255,66,279002,96,332537
43070,0.045318,74.125.200.0-255,5738,284740,96,332537
43071,0.045325,172.31.47.0-255,66,284806,96,332537
43072,0.047366,74.125.200.0-255,5738,290544,96,332537
43073,0.047371,172.31.47.0-255,66,290610,96,332537
43074,0.049408,74.125.200.0-255,2902,293512,96,332537
43075,0.049413,172.31.47.0-255,66,293578,96,332537
43076,0.049446,74.125.200.0-255,2902,296480,96,332537
43077,0.049449,172.31.47.0-255,66,296546,96,332537
43078,0.051484,74.125.200.0-255,5738,302284,96,332537
43079,0.051489,172.31.47.0-255,66,302350,96,332537
43080,0.053525,74.125.200.0-255,5738,308088,96,332537
43081,0.053529,172.31.47.0-255,66,308154,96,332537
43082,0.055577,74.125.200.0-255,5738,313892,96,332537
43083,0.055588,172.31.47.0-255,66,313958,96,332537
43084,0.057661,74.125.200.0-255,5738,319696,96,332537
43085,0.057668,172.31.47.0-255,66,319762,96,332537
43086,0.059729,74.125.200.0-255,4320,324082,96,332537
43087,0.059735,172.31.47.0-255,66,324148,96,332537
43088,0.05977,74.125.200.0-255,1484,325632,96,332537
43089,0.061768,74.125.200.0-255,4320,329952,96,332537
43090,0.061773,172.31.47.0-255,66,330018,96,332537
43091,0.063821,74.125.200.0-255,2282,332300,96,332537
43092,0.063828,172.31.47.0-255,66,332366,96,332537
43093,0.064023,172.31.47.0-255,105,332471,96,332537
43094,0.066027,74.125.200.0-255,66,332537,96,332537
43095,0.0,172.31.47.0-255,105,105,96,276
43096,0.001767,157.240.13.0-255,105,210,96,276
43097,0.001781,172.31.47.0-255,66,276,96,276
43098,0.0,74.125.24.0-255,153,153,96,284750
43099,1.7e-05,172.31.47.0-255,66,219,96,284750
43100,4.1e-05,74.125.24.0-255,1484,1703,96,284750
43101,4.6e-05,172.31.47.0-255,66,1769,96,284750
43102,5.2e-05,74.125.24.0-255,2902,4671,96,284750
43103,5.4e-05,172.31.47.0-255,66,4737,96,284750
43104,6.3e-05,74.125.24.0-255,5738,10475,96,284750
43105,6.6e-05,172.31.47.0-255,66,10541,96,284750
43106,0.000103,172.31.47.0-255,66,10607,96,284750
43107,0.000111,74.125.24.0-255,6797,17404,96,284750
43108,0.000113,172.31.47.0-255,66,17470,96,284750
43109,0.000211,74.125.24.0-255,1484,18954,96,284750
43110,0.000215,172.31.47.0-255,66,19020,96,284750
43111,0.00022,74.125.24.0-255,2902,21922,96,284750
43112,0.000223,172.31.47.0-255,66,21988,96,284750
43113,0.000228,74.125.24.0-255,2902,24890,96,284750
43114,0.00023,172.31.47.0-255,66,24956,96,284750
43115,0.000254,74.125.24.0-255,2902,27858,96,284750
43116,0.000257,172.31.47.0-255,66,27924,96,284750
43117,0.000264,74.125.24.0-255,6797,34721,96,284750
43118,0.000266,172.31.47.0-255,66,34787,96,284750
43119,0.000271,74.125.24.0-255,2902,37689,96,284750
43120,0.000273,172.31.47.0-255,66,37755,96,284750
43121,0.000305,172.31.47.0-255,66,37821,96,284750
43122,0.000309,74.125.24.0-255,2815,40636,96,284750
43123,0.000311,172.31.47.0-255,66,40702,96,284750
43124,0.000313,74.125.24.0-255,128,40830,96,284750
43125,0.000316,172.31.47.0-255,66,40896,96,284750
43126,0.001245,74.125.24.0-255,1484,42380,96,284750
43127,0.001252,172.31.47.0-255,66,42446,96,284750
43128,0.001261,74.125.24.0-255,2902,45348,96,284750
43129,0.001263,172.31.47.0-255,66,45414,96,284750
43130,0.00127,74.125.24.0-255,5738,51152,96,284750
43131,0.001272,172.31.47.0-255,66,51218,96,284750
43132,0.001295,74.125.24.0-255,7156,58374,96,284750
43133,0.001297,172.31.47.0-255,66,58440,96,284750
43134,0.001321,74.125.24.0-255,3961,62401,96,284750
43135,0.001324,172.31.47.0-255,66,62467,96,284750
43136,0.001338,172.31.47.0-255,66,62533,96,284750
43137,0.001369,74.125.24.0-255,2902,65435,96,284750
43138,0.001371,172.31.47.0-255,66,65501,96,284750
43139,0.001398,172.31.47.0-255,66,65567,96,284750
43140,0.001663,74.125.24.0-255,1484,67051,96,284750
43141,0.001672,74.125.24.0-255,2902,69953,96,284750
43142,0.001677,172.31.47.0-255,66,70019,96,284750
43143,0.001684,74.125.24.0-255,5738,75757,96,284750
43144,0.001686,172.31.47.0-255,66,75823,96,284750
43145,0.00169,74.125.24.0-255,2902,78725,96,284750
43146,0.001692,172.31.47.0-255,66,78791,96,284750
43147,0.001715,172.31.47.0-255,66,78857,96,284750
43148,0.001735,74.125.24.0-255,1484,80341,96,284750
43149,0.001748,172.31.47.0-255,66,80407,96,284750
43150,0.001758,74.125.24.0-255,1484,81891,96,284750
43151,0.001783,172.31.47.0-255,66,81957,96,284750
43152,0.001813,172.31.47.0-255,66,82023,96,284750
43153,0.001831,74.125.24.0-255,2902,84925,96,284750
43154,0.001834,172.31.47.0-255,66,84991,96,284750
43155,0.001852,74.125.24.0-255,4320,89311,96,284750
43156,0.001855,172.31.47.0-255,66,89377,96,284750
43157,0.001873,74.125.24.0-255,2902,92279,96,284750
43158,0.001875,172.31.47.0-255,66,92345,96,284750
43159,0.001893,74.125.24.0-255,2184,94529,96,284750
43160,0.001895,172.31.47.0-255,66,94595,96,284750
43161,0.003922,74.125.24.0-255,2902,97497,96,284750
43162,0.003927,172.31.47.0-255,66,97563,96,284750
43163,0.003964,74.125.24.0-255,2902,100465,96,284750
43164,0.003967,172.31.47.0-255,66,100531,96,284750
43165,0.005996,74.125.24.0-255,5738,106269,96,284750
43166,0.006,172.31.47.0-255,66,106335,96,284750
43167,0.008068,74.125.24.0-255,5738,112073,96,284750
43168,0.008075,172.31.47.0-255,66,112139,96,284750
43169,0.010122,74.125.24.0-255,5738,117877,96,284750
43170,0.010129,172.31.47.0-255,66,117943,96,284750
43171,0.012217,74.125.24.0-255,5738,123681,96,284750
43172,0.012225,172.31.47.0-255,66,123747,96,284750
43173,0.014276,74.125.24.0-255,5738,129485,96,284750
43174,0.014282,172.31.47.0-255,66,129551,96,284750
43175,0.0163,74.125.24.0-255,5738,135289,96,284750
43176,0.016306,172.31.47.0-255,66,135355,96,284750
43177,0.018378,74.125.24.0-255,5738,141093,96,284750
43178,0.018386,172.31.47.0-255,66,141159,96,284750
43179,0.02047,74.125.24.0-255,5738,146897,96,284750
43180,0.020478,172.31.47.0-255,66,146963,96,284750
43181,0.02254,74.125.24.0-255,5738,152701,96,284750
43182,0.022549,172.31.47.0-255,66,152767,96,284750
43183,0.024589,74.125.24.0-255,5738,158505,96,284750
43184,0.024597,172.31.47.0-255,66,158571,96,284750
43185,0.024697,172.31.47.0-255,172,158743,96,284750
43186,0.024725,172.31.47.0-255,1105,159848,96,284750
43187,0.024779,172.31.47.0-255,1514,161362,96,284750
43188,0.024781,172.31.47.0-255,1306,162668,96,284750
43189,0.026243,104.244.42.0-255,66,162734,96,284750
43190,0.02625,104.244.42.0-255,66,162800,96,284750
43191,0.026325,104.244.42.0-255,66,162866,96,284750
43192,0.02667,74.125.24.0-255,5738,168604,96,284750
43193,0.026676,172.31.47.0-255,66,168670,96,284750
43194,0.028763,74.125.24.0-255,5738,174408,96,284750
43195,0.028772,172.31.47.0-255,66,174474,96,284750
43196,0.030856,74.125.24.0-255,5738,180212,96,284750
43197,0.030862,172.31.47.0-255,66,180278,96,284750
43198,0.03297,74.125.24.0-255,5738,186016,96,284750
43199,0.032977,172.31.47.0-255,66,186082,96,284750
43200,0.035049,74.125.24.0-255,5738,191820,96,284750
43201,0.035055,172.31.47.0-255,66,191886,96,284750
43202,0.037158,74.125.24.0-255,5738,197624,96,284750
43203,0.037164,172.31.47.0-255,66,197690,96,284750
43204,0.039229,74.125.24.0-255,5738,203428,96,284750
43205,0.039237,172.31.47.0-255,66,203494,96,284750
43206,0.041309,74.125.24.0-255,5738,209232,96,284750
43207,0.041317,172.31.47.0-255,66,209298,96,284750
43208,0.043395,74.125.24.0-255,5738,215036,96,284750
43209,0.0434,172.31.47.0-255,66,215102,96,284750
43210,0.04549,74.125.24.0-255,5738,220840,96,284750
43211,0.045495,172.31.47.0-255,66,220906,96,284750
43212,0.047546,74.125.24.0-255,5738,226644,96,284750
43213,0.047551,172.31.47.0-255,66,226710,96,284750
43214,0.049651,74.125.24.0-255,5738,232448,96,284750
43215,0.049656,172.31.47.0-255,66,232514,96,284750
43216,0.051691,74.125.24.0-255,5738,238252,96,284750
43217,0.051696,172.31.47.0-255,66,238318,96,284750
43218,0.053773,74.125.24.0-255,5738,244056,96,284750
43219,0.05378,172.31.47.0-255,66,244122,96,284750
43220,0.055838,74.125.24.0-255,5738,249860,96,284750
43221,0.055845,172.31.47.0-255,66,249926,96,284750
43222,0.0579,74.125.24.0-255,5738,255664,96,284750
43223,0.057907,172.31.47.0-255,66,255730,96,284750
43224,0.059957,74.125.24.0-255,5738,261468,96,284750
43225,0.059964,172.31.47.0-255,66,261534,96,284750
43226,0.062044,74.125.24.0-255,5738,267272,96,284750
43227,0.06205,172.31.47.0-255,66,267338,96,284750
43228,0.064074,74.125.24.0-255,5738,273076,96,284750
43229,0.064081,172.31.47.0-255,66,273142,96,284750
43230,0.06612,74.125.24.0-255,5738,278880,96,284750
43231,0.066126,172.31.47.0-255,66,278946,96,284750
43232,0.068178,74.125.24.0-255,5738,284684,96,284750
43233,0.068183,172.31.47.0-255,66,284750,96,284750
43234,0.0,172.31.47.0-255,66,66,96,66
43235,0.0,74.125.24.0-255,297,297,96,245942
43236,2.4e-05,172.31.47.0-255,66,363,96,245942
43237,3e-05,74.125.24.0-255,1484,1847,96,245942
43238,3.4e-05,172.31.47.0-255,66,1913,96,245942
43239,6.2e-05,74.125.24.0-255,1484,3397,96,245942
43240,6.4e-05,172.31.47.0-255,66,3463,96,245942
43241,8.2e-05,74.125.24.0-255,1484,4947,96,245942
43242,8.5e-05,172.31.47.0-255,66,5013,96,245942
43243,9.1e-05,74.125.24.0-255,4320,9333,96,245942
43244,9.4e-05,172.31.47.0-255,66,9399,96,245942
43245,0.00012,74.125.24.0-255,1484,10883,96,245942
43246,0.000122,172.31.47.0-255,66,10949,96,245942
43247,0.00015,74.125.24.0-255,3356,14305,96,245942
43248,0.000152,172.31.47.0-255,66,14371,96,245942
43249,0.000158,74.125.24.0-255,5738,20109,96,245942
43250,0.00016,172.31.47.0-255,66,20175,96,245942
43251,0.000178,74.125.24.0-255,1484,21659,96,245942
43252,0.00018,172.31.47.0-255,66,21725,96,245942
43253,0.000214,172.31.47.0-255,66,21791,96,245942
43254,0.000925,74.125.24.0-255,1484,23275,96,245942
43255,0.000932,172.31.47.0-255,66,23341,96,245942
43256,0.000939,74.125.24.0-255,2902,26243,96,245942
43257,0.000941,172.31.47.0-255,66,26309,96,245942
43258,0.000952,74.125.24.0-255,5738,32047,96,245942
43259,0.000954,172.31.47.0-255,66,32113,96,245942
43260,0.000986,172.31.47.0-255,66,32179,96,245942
43261,0.001018,74.125.24.0-255,7156,39335,96,245942
43262,0.001021,172.31.47.0-255,66,39401,96,245942
43263,0.001044,74.125.24.0-255,2902,42303,96,245942
43264,0.001046,172.31.47.0-255,66,42369,96,245942
43265,0.001051,74.125.24.0-255,5020,47389,96,245942
43266,0.001053,172.31.47.0-255,66,47455,96,245942
43267,0.001078,74.125.24.0-255,399,47854,96,245942
43268,0.001584,74.125.24.0-255,109,47963,96,245942
43269,0.0019,74.125.24.0-255,1484,49447,96,245942
43270,0.001904,172.31.47.0-255,66,49513,96,245942
43271,0.001921,74.125.24.0-255,2902,52415,96,245942
43272,0.001924,172.31.47.0-255,66,52481,96,245942
43273,0.001952,74.125.24.0-255,2902,55383,96,245942
43274,0.001954,172.31.47.0-255,66,55449,96,245942
43275,0.001985,74.125.24.0-255,2902,58351,96,245942
43276,0.001988,172.31.47.0-255,66,58417,96,245942
43277,0.001992,74.125.24.0-255,2902,61319,96,245942
43278,0.001994,172.31.47.0-255,66,61385,96,245942
43279,0.002009,172.31.47.0-255,66,61451,96,245942
43280,0.002019,172.31.47.0-255,66,61517,96,245942
43281,0.002045,74.125.24.0-255,2184,63701,96,245942
43282,0.002048,172.31.47.0-255,66,63767,96,245942
43283,0.004105,74.125.24.0-255,4320,68087,96,245942
43284,0.00411,172.31.47.0-255,66,68153,96,245942
43285,0.00412,74.125.24.0-255,1484,69637,96,245942
43286,0.006215,74.125.24.0-255,4320,73957,96,245942
43287,0.006221,172.31.47.0-255,66,74023,96,245942
43288,0.008304,74.125.24.0-255,5738,79761,96,245942
43289,0.008311,172.31.47.0-255,66,79827,96,245942
43290,0.010375,74.125.24.0-255,5738,85565,96,245942
43291,0.010382,172.31.47.0-255,66,85631,96,245942
43292,0.012443,74.125.24.0-255,5738,91369,96,245942
43293,0.01245,172.31.47.0-255,66,91435,96,245942
43294,0.014552,74.125.24.0-255,5738,97173,96,245942
43295,0.014558,172.31.47.0-255,66,97239,96,245942
43296,0.016617,74.125.24.0-255,4320,101559,96,245942
43297,0.016623,172.31.47.0-255,66,101625,96,245942
43298,0.01665,74.125.24.0-255,1484,103109,96,245942
43299,0.018701,74.125.24.0-255,4320,107429,96,245942
43300,0.018707,172.31.47.0-255,66,107495,96,245942
43301,0.020749,172.31.47.0-255,172,107667,96,245942
43302,0.020778,172.31.47.0-255,1101,108768,96,245942
43303,0.020808,74.125.24.0-255,5738,114506,96,245942
43304,0.02081,172.31.47.0-255,1514,116020,96,245942
43305,0.020812,172.31.47.0-255,1310,117330,96,245942
43306,0.020813,172.31.47.0-255,66,117396,96,245942
43307,0.022293,104.244.42.0-255,66,117462,96,245942
43308,0.022333,104.244.42.0-255,66,117528,96,245942
43309,0.022335,104.244.42.0-255,66,117594,96,245942
43310,0.022899,74.125.24.0-255,2902,120496,96,245942
43311,0.022904,172.31.47.0-255,66,120562,96,245942
43312,0.022938,74.125.24.0-255,2902,123464,96,245942
43313,0.022942,172.31.47.0-255,66,123530,96,245942
43314,0.024963,74.125.24.0-255,2902,126432,96,245942
43315,0.024968,172.31.47.0-255,66,126498,96,245942
43316,0.025001,74.125.24.0-255,2902,129400,96,245942
43317,0.025004,172.31.47.0-255,66,129466,96,245942
43318,0.027067,74.125.24.0-255,4320,133786,96,245942
43319,0.027072,172.31.47.0-255,66,133852,96,245942
43320,0.027103,74.125.24.0-255,1484,135336,96,245942
43321,0.02915,74.125.24.0-255,4320,139656,96,245942
43322,0.029156,172.31.47.0-255,66,139722,96,245942
43323,0.031199,74.125.24.0-255,5738,145460,96,245942
43324,0.031205,172.31.47.0-255,66,145526,96,245942
43325,0.033307,74.125.24.0-255,4320,149846,96,245942
43326,0.033312,172.31.47.0-255,66,149912,96,245942
43327,0.033338,74.125.24.0-255,1484,151396,96,245942
43328,0.035386,74.125.24.0-255,4320,155716,96,245942
43329,0.035391,172.31.47.0-255,66,155782,96,245942
43330,0.037508,74.125.24.0-255,5738,161520,96,245942
43331,0.037513,172.31.47.0-255,66,161586,96,245942
43332,0.039599,74.125.24.0-255,5738,167324,96,245942
43333,0.039604,172.31.47.0-255,66,167390,96,245942
43334,0.041684,74.125.24.0-255,4320,171710,96,245942
43335,0.041688,172.31.47.0-255,66,171776,96,245942
43336,0.041719,74.125.24.0-255,1484,173260,96,245942
43337,0.043762,74.125.24.0-255,4320,177580,96,245942
43338,0.043768,172.31.47.0-255,66,177646,96,245942
43339,0.04585,74.125.24.0-255,5738,183384,96,245942
43340,0.045855,172.31.47.0-255,66,183450,96,245942
43341,0.047945,74.125.24.0-255,5738,189188,96,245942
43342,0.04795,172.31.47.0-255,66,189254,96,245942
43343,0.049994,74.125.24.0-255,4320,193574,96,245942
43344,0.049999,172.31.47.0-255,66,193640,96,245942
43345,0.050028,74.125.24.0-255,1484,195124,96,245942
43346,0.052064,74.125.24.0-255,4320,199444,96,245942
43347,0.052069,172.31.47.0-255,66,199510,96,245942
43348,0.054181,74.125.24.0-255,5738,205248,96,245942
43349,0.054187,172.31.47.0-255,66,205314,96,245942
43350,0.05628,74.125.24.0-255,5738,211052,96,245942
43351,0.056286,172.31.47.0-255,66,211118,96,245942
43352,0.058374,74.125.24.0-255,5738,216856,96,245942
43353,0.058379,172.31.47.0-255,66,216922,96,245942
43354,0.06046,74.125.24.0-255,5738,222660,96,245942
43355,0.06048,172.31.47.0-255,66,222726,96,245942
43356,0.062639,74.125.24.0-255,5738,228464,96,245942
43357,0.062656,172.31.47.0-255,66,228530,96,245942
43358,0.064771,74.125.24.0-255,5738,234268,96,245942
43359,0.064786,172.31.47.0-255,66,234334,96,245942
43360,0.066898,74.125.24.0-255,5738,240072,96,245942
43361,0.066915,172.31.47.0-255,66,240138,96,245942
43362,0.069014,74.125.24.0-255,5738,245876,96,245942
43363,0.06903,172.31.47.0-255,66,245942,96,245942
43364,0.0,172.217.160.0-255,153,153,96,371574
43365,3.3e-05,172.31.47.0-255,66,219,96,371574
43366,3.9e-05,172.217.160.0-255,1484,1703,96,371574
43367,4.2e-05,172.31.47.0-255,66,1769,96,371574
43368,4.6e-05,172.217.160.0-255,2902,4671,96,371574
43369,4.9e-05,172.31.47.0-255,66,4737,96,371574
43370,6.4e-05,172.217.160.0-255,7156,11893,96,371574
43371,6.6e-05,172.31.47.0-255,66,11959,96,371574
43372,7e-05,172.217.160.0-255,2143,14102,96,371574
43373,7.2e-05,172.31.47.0-255,66,14168,96,371574
43374,0.000228,172.217.160.0-255,1484,15652,96,371574
43375,0.000233,172.31.47.0-255,66,15718,96,371574
43376,0.000239,172.217.160.0-255,2902,18620,96,371574
43377,0.000241,172.31.47.0-255,66,18686,96,371574
43378,0.000244,172.217.160.0-255,1484,20170,96,371574
43379,0.000246,172.31.47.0-255,66,20236,96,371574
43380,0.000282,172.217.160.0-255,4320,24556,96,371574
43381,0.000285,172.31.47.0-255,66,24622,96,371574
43382,0.000291,172.217.160.0-255,6797,31419,96,371574
43383,0.000293,172.31.47.0-255,66,31485,96,371574
43384,0.000331,172.217.160.0-255,7156,38641,96,371574
43385,0.000335,172.31.47.0-255,66,38707,96,371574
43386,0.000337,172.217.160.0-255,1484,40191,96,371574
43387,0.000341,172.31.47.0-255,66,40257,96,371574
43388,0.000391,172.217.160.0-255,2902,43159,96,371574
43389,0.000394,172.31.47.0-255,66,43225,96,371574
43390,0.000419,172.217.160.0-255,5379,48604,96,371574
43391,0.000423,172.31.47.0-255,66,48670,96,371574
43392,0.00059,172.217.160.0-255,1484,50154,96,371574
43393,0.000594,172.31.47.0-255,66,50220,96,371574
43394,0.000599,172.217.160.0-255,2902,53122,96,371574
43395,0.000601,172.31.47.0-255,66,53188,96,371574
43396,0.000607,172.217.160.0-255,2902,56090,96,371574
43397,0.000615,172.31.47.0-255,66,56156,96,371574
43398,0.000625,172.217.160.0-255,2902,59058,96,371574
43399,0.000627,172.31.47.0-255,66,59124,96,371574
43400,0.000652,172.217.160.0-255,5738,64862,96,371574
43401,0.000655,172.31.47.0-255,66,64928,96,371574
43402,0.000682,172.217.160.0-255,1399,66327,96,371574
43403,0.000744,172.31.47.0-255,66,66393,96,371574
43404,0.001146,172.217.160.0-255,403,66796,96,371574
43405,0.001176,172.31.47.0-255,66,66862,96,371574
43406,0.00121,172.217.160.0-255,1484,68346,96,371574
43407,0.001246,172.217.160.0-255,2902,71248,96,371574
43408,0.001249,172.31.47.0-255,66,71314,96,371574
43409,0.001255,172.217.160.0-255,5738,77052,96,371574
43410,0.001257,172.31.47.0-255,66,77118,96,371574
43411,0.001284,172.217.160.0-255,6797,83915,96,371574
43412,0.001286,172.31.47.0-255,66,83981,96,371574
43413,0.00129,172.217.160.0-255,2902,86883,96,371574
43414,0.001292,172.31.47.0-255,66,86949,96,371574
43415,0.00132,172.217.160.0-255,4320,91269,96,371574
43416,0.001323,172.31.47.0-255,66,91335,96,371574
43417,0.001332,172.31.47.0-255,66,91401,96,371574
43418,0.001484,172.217.160.0-255,1484,92885,96,371574
43419,0.001488,172.217.160.0-255,1484,94369,96,371574
43420,0.00149,172.31.47.0-255,66,94435,96,371574
43421,0.001512,172.217.160.0-255,1484,95919,96,371574
43422,0.001518,172.217.160.0-255,5738,101657,96,371574
43423,0.00152,172.31.47.0-255,66,101723,96,371574
43424,0.001525,172.217.160.0-255,5738,107461,96,371574
43425,0.001528,172.31.47.0-255,66,107527,96,371574
43426,0.001576,172.31.47.0-255,66,107593,96,371574
43427,0.001581,172.217.160.0-255,5020,112613,96,371574
43428,0.001583,172.31.47.0-255,66,112679,96,371574
43429,0.001635,172.217.160.0-255,1484,114163,96,371574
43430,0.00164,172.217.160.0-255,2902,117065,96,371574
43431,0.001642,172.31.47.0-255,66,117131,96,371574
43432,0.001685,172.217.160.0-255,5738,122869,96,371574
43433,0.001687,172.31.47.0-255,66,122935,96,371574
43434,0.001692,172.217.160.0-255,5738,128673,96,371574
43435,0.001693,172.31.47.0-255,66,128739,96,371574
43436,0.001699,172.217.160.0-255,7156,135895,96,371574
43437,0.001701,172.31.47.0-255,66,135961,96,371574
43438,0.001734,172.217.160.0-255,5738,141699,96,371574
43439,0.001736,172.31.47.0-255,66,141765,96,371574
43440,0.001741,172.217.160.0-255,5020,146785,96,371574
43441,0.001743,172.31.47.0-255,66,146851,96,371574
43442,0.001873,172.217.160.0-255,1484,148335,96,371574
43443,0.001877,172.217.160.0-255,1484,149819,96,371574
43444,0.001879,172.31.47.0-255,66,149885,96,371574
43445,0.001889,172.217.160.0-255,1484,151369,96,371574
43446,0.001893,172.217.160.0-255,2902,154271,96,371574
43447,0.001894,172.31.47.0-255,66,154337,96,371574
43448,0.001913,172.217.160.0-255,2902,157239,96,371574
43449,0.001915,172.31.47.0-255,66,157305,96,371574
43450,0.001921,172.217.160.0-255,7156,164461,96,371574
43451,0.001923,172.31.47.0-255,66,164527,96,371574
43452,0.00196,172.217.160.0-255,5738,170265,96,371574
43453,0.001963,172.31.47.0-255,66,170331,96,371574
43454,0.001973,172.31.47.0-255,66,170397,96,371574
43455,0.001976,172.217.160.0-255,2184,172581,96,371574
43456,0.001978,172.31.47.0-255,66,172647,96,371574
43457,0.0039,172.217.160.0-255,5738,178385,96,371574
43458,0.003907,172.31.47.0-255,66,178451,96,371574
43459,0.005852,172.217.160.0-255,5738,184189,96,371574
43460,0.00586,172.31.47.0-255,66,184255,96,371574
43461,0.007798,172.217.160.0-255,5738,189993,96,371574
43462,0.007806,172.31.47.0-255,66,190059,96,371574
43463,0.009757,172.217.160.0-255,5738,195797,96,371574
43464,0.009775,172.31.47.0-255,66,195863,96,371574
43465,0.01172,172.217.160.0-255,5738,201601,96,371574
43466,0.011729,172.31.47.0-255,66,201667,96,371574
43467,0.013679,172.217.160.0-255,5738,207405,96,371574
43468,0.013692,172.31.47.0-255,66,207471,96,371574
43469,0.015635,172.217.160.0-255,5738,213209,96,371574
43470,0.015647,172.31.47.0-255,66,213275,96,371574
43471,0.017606,172.217.160.0-255,5738,219013,96,371574
43472,0.017623,172.31.47.0-255,66,219079,96,371574
43473,0.019569,172.217.160.0-255,5738,224817,96,371574
43474,0.019576,172.31.47.0-255,66,224883,96,371574
43475,0.021514,172.217.160.0-255,5738,230621,96,371574
43476,0.021528,172.31.47.0-255,66,230687,96,371574
43477,0.023474,172.217.160.0-255,5738,236425,96,371574
43478,0.023483,172.31.47.0-255,66,236491,96,371574
43479,0.025418,172.217.160.0-255,5738,242229,96,371574
43480,0.025427,172.31.47.0-255,66,242295,96,371574
43481,0.027379,172.217.160.0-255,5738,248033,96,371574
43482,0.027393,172.31.47.0-255,66,248099,96,371574
43483,0.029337,172.217.160.0-255,5738,253837,96,371574
43484,0.029348,172.31.47.0-255,66,253903,96,371574
43485,0.031277,172.217.160.0-255,4320,258223,96,371574
43486,0.031282,172.31.47.0-255,66,258289,96,371574
43487,0.031304,172.217.160.0-255,1484,259773,96,371574
43488,0.033233,172.217.160.0-255,4320,264093,96,371574
43489,0.033247,172.31.47.0-255,66,264159,96,371574
43490,0.03518,172.217.160.0-255,5738,269897,96,371574
43491,0.035187,172.31.47.0-255,66,269963,96,371574
43492,0.037133,172.217.160.0-255,5738,275701,96,371574
43493,0.037143,172.31.47.0-255,66,275767,96,371574
43494,0.039082,172.217.160.0-255,5738,281505,96,371574
43495,0.039089,172.31.47.0-255,66,281571,96,371574
43496,0.041035,172.217.160.0-255,5738,287309,96,371574
43497,0.041048,172.31.47.0-255,66,287375,96,371574
43498,0.043017,172.217.160.0-255,5738,293113,96,371574
43499,0.043031,172.31.47.0-255,66,293179,96,371574
43500,0.045015,172.217.160.0-255,5738,298917,96,371574
43501,0.045023,172.31.47.0-255,66,298983,96,371574
43502,0.046953,172.217.160.0-255,4320,303303,96,371574
43503,0.046958,172.31.47.0-255,66,303369,96,371574
43504,0.046962,172.31.47.0-255,172,303541,96,371574
43505,0.046971,172.217.160.0-255,1484,305025,96,371574
43506,0.046999,172.31.47.0-255,1101,306126,96,371574
43507,0.047049,172.31.47.0-255,1514,307640,96,371574
43508,0.047051,172.31.47.0-255,1310,308950,96,371574
43509,0.048558,104.244.42.0-255,66,309016,96,371574
43510,0.048566,104.244.42.0-255,66,309082,96,371574
43511,0.048592,104.244.42.0-255,66,309148,96,371574
43512,0.048887,172.217.160.0-255,4320,313468,96,371574
43513,0.048895,172.31.47.0-255,66,313534,96,371574
43514,0.05085,172.217.160.0-255,5738,319272,96,371574
43515,0.050865,172.31.47.0-255,66,319338,96,371574
43516,0.052827,172.217.160.0-255,5738,325076,96,371574
43517,0.052841,172.31.47.0-255,66,325142,96,371574
43518,0.054791,172.217.160.0-255,5738,330880,96,371574
43519,0.054807,172.31.47.0-255,66,330946,96,371574
43520,0.056751,172.217.160.0-255,5738,336684,96,371574
43521,0.056765,172.31.47.0-255,66,336750,96,371574
43522,0.05872,172.217.160.0-255,5738,342488,96,371574
43523,0.058738,172.31.47.0-255,66,342554,96,371574
43524,0.060686,172.217.160.0-255,5738,348292,96,371574
43525,0.060701,172.31.47.0-255,66,348358,96,371574
43526,0.062664,172.217.160.0-255,5738,354096,96,371574
43527,0.062682,172.31.47.0-255,66,354162,96,371574
43528,0.064621,172.217.160.0-255,5738,359900,96,371574
43529,0.064631,172.31.47.0-255,66,359966,96,371574
43530,0.066581,172.217.160.0-255,5738,365704,96,371574
43531,0.066596,172.31.47.0-255,66,365770,96,371574
43532,0.068547,172.217.160.0-255,5738,371508,96,371574
43533,0.068563,172.31.47.0-255,66,371574,96,371574
43534,0.0,172.31.47.0-255,105,105,96,105
43535,0.0,74.125.130.0-255,153,153,96,350122
43536,2.9e-05,172.31.47.0-255,66,219,96,350122
43537,3.5e-05,74.125.130.0-255,1484,1703,96,350122
43538,3.8e-05,172.31.47.0-255,66,1769,96,350122
43539,4.3e-05,74.125.130.0-255,2902,4671,96,350122
43540,4.5e-05,172.31.47.0-255,66,4737,96,350122
43541,7.6e-05,74.125.130.0-255,5738,10475,96,350122
43542,7.9e-05,172.31.47.0-255,66,10541,96,350122
43543,8.1e-05,74.125.130.0-255,1484,12025,96,350122
43544,8.4e-05,172.31.47.0-255,66,12091,96,350122
43545,9.9e-05,74.125.130.0-255,2054,14145,96,350122
43546,0.000101,172.31.47.0-255,66,14211,96,350122
43547,0.000141,74.125.130.0-255,1484,15695,96,350122
43548,0.000144,172.31.47.0-255,66,15761,96,350122
43549,0.000169,74.125.130.0-255,2902,18663,96,350122
43550,0.000172,172.31.47.0-255,66,18729,96,350122
43551,0.000175,74.125.130.0-255,1484,20213,96,350122
43552,0.000176,172.31.47.0-255,66,20279,96,350122
43553,0.000195,74.125.130.0-255,2902,23181,96,350122
43554,0.000198,172.31.47.0-255,66,23247,96,350122
43555,0.000201,74.125.130.0-255,2902,26149,96,350122
43556,0.000203,172.31.47.0-255,66,26215,96,350122
43557,0.000221,74.125.130.0-255,2902,29117,96,350122
43558,0.000223,172.31.47.0-255,66,29183,96,350122
43559,0.000227,74.125.130.0-255,2543,31726,96,350122
43560,0.000229,172.31.47.0-255,66,31792,96,350122
43561,0.00036,74.125.130.0-255,1484,33276,96,350122
43562,0.000364,172.31.47.0-255,66,33342,96,350122
43563,0.000377,74.125.130.0-255,2902,36244,96,350122
43564,0.000379,172.31.47.0-255,66,36310,96,350122
43565,0.000382,74.125.130.0-255,1484,37794,96,350122
43566,0.000384,172.31.47.0-255,66,37860,96,350122
43567,0.000403,74.125.130.0-255,2902,40762,96,350122
43568,0.000405,172.31.47.0-255,66,40828,96,350122
43569,0.00041,74.125.130.0-255,4320,45148,96,350122
43570,0.000412,172.31.47.0-255,66,45214,96,350122
43571,0.000428,74.125.130.0-255,1484,46698,96,350122
43572,0.000435,74.125.130.0-255,5379,52077,96,350122
43573,0.000437,172.31.47.0-255,66,52143,96,350122
43574,0.000458,74.125.130.0-255,5738,57881,96,350122
43575,0.000462,172.31.47.0-255,66,57947,96,350122
43576,0.000483,74.125.130.0-255,2902,60849,96,350122
43577,0.000485,172.31.47.0-255,66,60915,96,350122
43578,0.0005,74.125.130.0-255,5669,66584,96,350122
43579,0.000503,172.31.47.0-255,66,66650,96,350122
43580,0.000506,74.125.130.0-255,98,66748,96,350122
43581,0.000658,74.125.130.0-255,363,67111,96,350122
43582,0.000682,172.31.47.0-255,66,67177,96,350122
43583,0.001022,74.125.130.0-255,1484,68661,96,350122
43584,0.00104,74.125.130.0-255,2902,71563,96,350122
43585,0.001044,172.31.47.0-255,66,71629,96,350122
43586,0.001048,74.125.130.0-255,1484,73113,96,350122
43587,0.001068,74.125.130.0-255,4320,77433,96,350122
43588,0.001071,172.31.47.0-255,66,77499,96,350122
43589,0.001075,74.125.130.0-255,4320,81819,96,350122
43590,0.001077,172.31.47.0-255,66,81885,96,350122
43591,0.00108,74.125.130.0-255,2902,84787,96,350122
43592,0.001082,172.31.47.0-255,66,84853,96,350122
43593,0.001102,74.125.130.0-255,2902,87755,96,350122
43594,0.001105,172.31.47.0-255,66,87821,96,350122
43595,0.001115,74.125.130.0-255,1484,89305,96,350122
43596,0.00113,74.125.130.0-255,7156,96461,96,350122
43597,0.001132,172.31.47.0-255,66,96527,96,350122
43598,0.001149,74.125.130.0-255,2902,99429,96,350122
43599,0.001152,172.31.47.0-255,66,99495,96,350122
43600,0.001154,74.125.130.0-255,1484,100979,96,350122
43601,0.001156,74.125.130.0-255,766,101745,96,350122
43602,0.001158,172.31.47.0-255,66,101811,96,350122
43603,0.001512,74.125.130.0-255,1484,103295,96,350122
43604,0.001535,74.125.130.0-255,2902,106197,96,350122
43605,0.00154,172.31.47.0-255,66,106263,96,350122
43606,0.001548,74.125.130.0-255,5738,112001,96,350122
43607,0.00155,172.31.47.0-255,66,112067,96,350122
43608,0.001579,74.125.130.0-255,7156,119223,96,350122
43609,0.001582,172.31.47.0-255,66,119289,96,350122
43610,0.001602,74.125.130.0-255,4320,123609,96,350122
43611,0.001605,172.31.47.0-255,66,123675,96,350122
43612,0.001619,172.31.47.0-255,66,123741,96,350122
43613,0.001685,74.125.130.0-255,1484,125225,96,350122
43614,0.00169,74.125.130.0-255,2902,128127,96,350122
43615,0.001693,172.31.47.0-255,66,128193,96,350122
43616,0.00173,74.125.130.0-255,4320,132513,96,350122
43617,0.001733,172.31.47.0-255,66,132579,96,350122
43618,0.001739,74.125.130.0-255,5738,138317,96,350122
43619,0.001741,172.31.47.0-255,66,138383,96,350122
43620,0.001811,172.31.47.0-255,66,138449,96,350122
43621,0.001816,74.125.130.0-255,4320,142769,96,350122
43622,0.001818,172.31.47.0-255,66,142835,96,350122
43623,0.001834,74.125.130.0-255,3602,146437,96,350122
43624,0.001838,172.31.47.0-255,66,146503,96,350122
43625,0.001894,74.125.130.0-255,1484,147987,96,350122
43626,0.001908,74.125.130.0-255,2902,150889,96,350122
43627,0.001911,172.31.47.0-255,66,150955,96,350122
43628,0.001915,74.125.130.0-255,1484,152439,96,350122
43629,0.001932,74.125.130.0-255,4320,156759,96,350122
43630,0.001934,172.31.47.0-255,66,156825,96,350122
43631,0.001938,74.125.130.0-255,2902,159727,96,350122
43632,0.00194,172.31.47.0-255,66,159793,96,350122
43633,0.001945,74.125.130.0-255,2902,162695,96,350122
43634,0.001948,172.31.47.0-255,66,162761,96,350122
43635,0.001957,74.125.130.0-255,1484,164245,96,350122
43636,0.001983,172.31.47.0-255,66,164311,96,350122
43637,0.001988,74.125.130.0-255,5738,170049,96,350122
43638,0.001991,172.31.47.0-255,66,170115,96,350122
43639,0.002074,74.125.130.0-255,2184,172299,96,350122
43640,0.002078,172.31.47.0-255,66,172365,96,350122
43641,0.004222,74.125.130.0-255,2902,175267,96,350122
43642,0.004228,172.31.47.0-255,66,175333,96,350122
43643,0.004316,74.125.130.0-255,2902,178235,96,350122
43644,0.00432,172.31.47.0-255,66,178301,96,350122
43645,0.006474,74.125.130.0-255,2902,181203,96,350122
43646,0.00648,172.31.47.0-255,66,181269,96,350122
43647,0.006549,74.125.130.0-255,2902,184171,96,350122
43648,0.006552,172.31.47.0-255,66,184237,96,350122
43649,0.008709,74.125.130.0-255,2902,187139,96,350122
43650,0.008717,172.31.47.0-255,66,187205,96,350122
43651,0.008775,74.125.130.0-255,2902,190107,96,350122
43652,0.008779,172.31.47.0-255,66,190173,96,350122
43653,0.010944,74.125.130.0-255,2902,193075,96,350122
43654,0.01095,172.31.47.0-255,66,193141,96,350122
43655,0.010998,74.125.130.0-255,2902,196043,96,350122
43656,0.011003,172.31.47.0-255,66,196109,96,350122
43657,0.013173,74.125.130.0-255,2902,199011,96,350122
43658,0.013179,172.31.47.0-255,66,199077,96,350122
43659,0.013218,74.125.130.0-255,2902,201979,96,350122
43660,0.013221,172.31.47.0-255,66,202045,96,350122
43661,0.015404,74.125.130.0-255,2902,204947,96,350122
43662,0.015411,172.31.47.0-255,66,205013,96,350122
43663,0.015438,74.125.130.0-255,2902,207915,96,350122
43664,0.015441,172.31.47.0-255,66,207981,96,350122
43665,0.017637,74.125.130.0-255,2902,210883,96,350122
43666,0.017645,172.31.47.0-255,66,210949,96,350122
43667,0.017665,74.125.130.0-255,2902,213851,96,350122
43668,0.017668,172.31.47.0-255,66,213917,96,350122
43669,0.019887,74.125.130.0-255,5738,219655,96,350122
43670,0.019893,172.31.47.0-255,66,219721,96,350122
43671,0.022133,74.125.130.0-255,5738,225459,96,350122
43672,0.02214,172.31.47.0-255,66,225525,96,350122
43673,0.024372,74.125.130.0-255,5738,231263,96,350122
43674,0.024383,172.31.47.0-255,66,231329,96,350122
43675,0.026613,74.125.130.0-255,5738,237067,96,350122
43676,0.026621,172.31.47.0-255,66,237133,96,350122
43677,0.028856,74.125.130.0-255,5738,242871,96,350122
43678,0.028864,172.31.47.0-255,66,242937,96,350122
43679,0.031106,74.125.130.0-255,5738,248675,96,350122
43680,0.031115,172.31.47.0-255,66,248741,96,350122
43681,0.032425,172.31.47.0-255,172,248913,96,350122
43682,0.032454,172.31.47.0-255,1110,250023,96,350122
43683,0.032492,172.31.47.0-255,1514,251537,96,350122
43684,0.032494,172.31.47.0-255,1301,252838,96,350122
43685,0.033351,74.125.130.0-255,5738,258576,96,350122
43686,0.033356,172.31.47.0-255,66,258642,96,350122
43687,0.033962,104.244.42.0-255,66,258708,96,350122
43688,0.033995,104.244.42.0-255,66,258774,96,350122
43689,0.034065,104.244.42.0-255,66,258840,96,350122
43690,0.035584,74.125.130.0-255,5738,264578,96,350122
43691,0.035589,172.31.47.0-255,66,264644,96,350122
43692,0.037816,74.125.130.0-255,4320,268964,96,350122
43693,0.03782,172.31.47.0-255,66,269030,96,350122
43694,0.037849,74.125.130.0-255,1484,270514,96,350122
43695,0.040054,74.125.130.0-255,4320,274834,96,350122
43696,0.040058,172.31.47.0-255,66,274900,96,350122
43697,0.042285,74.125.130.0-255,5738,280638,96,350122
43698,0.042291,172.31.47.0-255,66,280704,96,350122
43699,0.044516,74.125.130.0-255,4320,285024,96,350122
43700,0.04452,172.31.47.0-255,66,285090,96,350122
43701,0.044549,74.125.130.0-255,1484,286574,96,350122
43702,0.046738,74.125.130.0-255,4320,290894,96,350122
43703,0.046742,172.31.47.0-255,66,290960,96,350122
43704,0.048966,74.125.130.0-255,5738,296698,96,350122
43705,0.048972,172.31.47.0-255,66,296764,96,350122
43706,0.051195,74.125.130.0-255,5738,302502,96,350122
43707,0.0512,172.31.47.0-255,66,302568,96,350122
43708,0.053413,74.125.130.0-255,2902,305470,96,350122
43709,0.053417,172.31.47.0-255,66,305536,96,350122
43710,0.053472,74.125.130.0-255,2902,308438,96,350122
43711,0.053477,172.31.47.0-255,66,308504,96,350122
43712,0.055647,74.125.130.0-255,2902,311406,96,350122
43713,0.055651,172.31.47.0-255,66,311472,96,350122
43714,0.055697,74.125.130.0-255,2902,314374,96,350122
43715,0.0557,172.31.47.0-255,66,314440,96,350122
43716,0.057877,74.125.130.0-255,2902,317342,96,350122
43717,0.057882,172.31.47.0-255,66,317408,96,350122
43718,0.057933,74.125.130.0-255,2902,320310,96,350122
43719,0.057937,172.31.47.0-255,66,320376,96,350122
43720,0.060106,74.125.130.0-255,2902,323278,96,350122
43721,0.06011,172.31.47.0-255,66,323344,96,350122
43722,0.060144,74.125.130.0-255,2902,326246,96,350122
43723,0.060147,172.31.47.0-255,66,326312,96,350122
43724,0.062332,74.125.130.0-255,1484,327796,96,350122
43725,0.062357,74.125.130.0-255,1484,329280,96,350122
43726,0.062362,172.31.47.0-255,66,329346,96,350122
43727,0.062384,74.125.130.0-255,2902,332248,96,350122
43728,0.062388,172.31.47.0-255,66,332314,96,350122
43729,0.064589,74.125.130.0-255,2902,335216,96,350122
43730,0.064594,172.31.47.0-255,66,335282,96,350122
43731,0.064621,74.125.130.0-255,2902,338184,96,350122
43732,0.064623,172.31.47.0-255,66,338250,96,350122
43733,0.066818,74.125.130.0-255,2902,341152,96,350122
43734,0.066823,172.31.47.0-255,66,341218,96,350122
43735,0.066852,74.125.130.0-255,2902,344120,96,350122
43736,0.066855,172.31.47.0-255,66,344186,96,350122
43737,0.069054,74.125.130.0-255,2902,347088,96,350122
43738,0.06906,172.31.47.0-255,66,347154,96,350122
43739,0.069087,74.125.130.0-255,2902,350056,96,350122
43740,0.06909,172.31.47.0-255,66,350122,96,350122
43741,0.0,172.217.194.0-255,159,159,96,204858
43742,2.9e-05,172.31.47.0-255,66,225,96,204858
43743,3.6e-05,172.217.194.0-255,1484,1709,96,204858
43744,4.1e-05,172.31.47.0-255,66,1775,96,204858
43745,5.2e-05,172.217.194.0-255,2902,4677,96,204858
43746,5.4e-05,172.31.47.0-255,66,4743,96,204858
43747,5.9e-05,172.217.194.0-255,4320,9063,96,204858
43748,6.2e-05,172.31.47.0-255,66,9129,96,204858
43749,0.000109,172.217.194.0-255,4964,14093,96,204858
43750,0.000113,172.31.47.0-255,66,14159,96,204858
43751,0.000223,172.217.194.0-255,1484,15643,96,204858
43752,0.000228,172.31.47.0-255,66,15709,96,204858
43753,0.000234,172.217.194.0-255,2902,18611,96,204858
43754,0.000235,172.31.47.0-255,66,18677,96,204858
43755,0.00024,172.217.194.0-255,2902,21579,96,204858
43756,0.000248,172.31.47.0-255,66,21645,96,204858
43757,0.00028,172.217.194.0-255,2902,24547,96,204858
43758,0.000283,172.31.47.0-255,66,24613,96,204858
43759,0.000313,172.217.194.0-255,6797,31410,96,204858
43760,0.000317,172.31.47.0-255,66,31476,96,204858
43761,0.000378,172.217.194.0-255,1484,32960,96,204858
43762,0.000382,172.31.47.0-255,66,33026,96,204858
43763,0.000386,172.217.194.0-255,2902,35928,96,204858
43764,0.000389,172.31.47.0-255,66,35994,96,204858
43765,0.000425,172.217.194.0-255,5738,41732,96,204858
43766,0.00043,172.31.47.0-255,66,41798,96,204858
43767,0.000475,172.31.47.0-255,66,41864,96,204858
43768,0.000499,172.31.47.0-255,66,41930,96,204858
43769,0.000502,172.217.194.0-255,378,42308,96,204858
43770,0.000505,172.31.47.0-255,66,42374,96,204858
43771,0.000533,172.217.194.0-255,396,42770,96,204858
43772,0.000626,172.217.194.0-255,1484,44254,96,204858
43773,0.00063,172.31.47.0-255,66,44320,96,204858
43774,0.000633,172.217.194.0-255,1484,45804,96,204858
43775,0.000648,172.217.194.0-255,1484,47288,96,204858
43776,0.000651,172.31.47.0-255,66,47354,96,204858
43777,0.000658,172.217.194.0-255,5738,53092,96,204858
43778,0.00066,172.31.47.0-255,66,53158,96,204858
43779,0.000709,172.217.194.0-255,5738,58896,96,204858
43780,0.000712,172.31.47.0-255,66,58962,96,204858
43781,0.000737,172.217.194.0-255,576,59538,96,204858
43782,0.000875,172.217.194.0-255,1484,61022,96,204858
43783,0.000879,172.31.47.0-255,66,61088,96,204858
43784,0.000885,172.217.194.0-255,2902,63990,96,204858
43785,0.000887,172.31.47.0-255,66,64056,96,204858
43786,0.000892,172.217.194.0-255,5738,69794,96,204858
43787,0.0009,172.31.47.0-255,66,69860,96,204858
43788,0.000908,172.217.194.0-255,7156,77016,96,204858
43789,0.00091,172.31.47.0-255,66,77082,96,204858
43790,0.000944,172.217.194.0-255,5738,82820,96,204858
43791,0.000949,172.217.194.0-255,4320,87140,96,204858
43792,0.000948,172.31.47.0-255,66,87206,96,204858
43793,0.000953,172.31.47.0-255,66,87272,96,204858
43794,0.000973,172.217.194.0-255,6438,93710,96,204858
43795,0.000977,172.31.47.0-255,66,93776,96,204858
43796,0.001192,172.217.194.0-255,1484,95260,96,204858
43797,0.001206,172.217.194.0-255,2902,98162,96,204858
43798,0.001209,172.31.47.0-255,66,98228,96,204858
43799,0.001215,172.217.194.0-255,5738,103966,96,204858
43800,0.001217,172.31.47.0-255,66,104032,96,204858
43801,0.001221,172.217.194.0-255,2902,106934,96,204858
43802,0.001225,172.31.47.0-255,66,107000,96,204858
43803,0.00125,172.217.194.0-255,2902,109902,96,204858
43804,0.001258,172.31.47.0-255,66,109968,96,204858
43805,0.001271,172.31.47.0-255,66,110034,96,204858
43806,0.001276,172.217.194.0-255,5020,115054,96,204858
43807,0.001278,172.31.47.0-255,66,115120,96,204858
43808,0.001316,172.217.194.0-255,5738,120858,96,204858
43809,0.001319,172.31.47.0-255,66,120924,96,204858
43810,0.001333,172.31.47.0-255,66,120990,96,204858
43811,0.00135,172.31.47.0-255,66,121056,96,204858
43812,0.001375,172.217.194.0-255,1484,122540,96,204858
43813,0.001379,172.217.194.0-255,1484,124024,96,204858
43814,0.001382,172.31.47.0-255,66,124090,96,204858
43815,0.001416,172.31.47.0-255,66,124156,96,204858
43816,0.001422,172.217.194.0-255,5738,129894,96,204858
43817,0.001424,172.31.47.0-255,66,129960,96,204858
43818,0.001454,172.217.194.0-255,5738,135698,96,204858
43819,0.001457,172.31.47.0-255,66,135764,96,204858
43820,0.001471,172.31.47.0-255,66,135830,96,204858
43821,0.001495,172.217.194.0-255,5020,140850,96,204858
43822,0.001507,172.31.47.0-255,66,140916,96,204858
43823,0.001508,172.217.194.0-255,7156,148072,96,204858
43824,0.001511,172.31.47.0-255,66,148138,96,204858
43825,0.001523,172.217.194.0-255,5738,153876,96,204858
43826,0.001527,172.31.47.0-255,66,153942,96,204858
43827,0.001563,172.217.194.0-255,1484,155426,96,204858
43828,0.001579,172.31.47.0-255,66,155492,96,204858
43829,0.001584,172.217.194.0-255,3602,159094,96,204858
43830,0.001588,172.31.47.0-255,66,159160,96,204858
43831,0.001609,172.31.47.0-255,66,159226,96,204858
43832,0.001661,172.31.47.0-255,66,159292,96,204858
43833,0.001668,172.217.194.0-255,1484,160776,96,204858
43834,0.001672,172.217.194.0-255,2902,163678,96,204858
43835,0.001675,172.31.47.0-255,66,163744,96,204858
43836,0.001684,172.217.194.0-255,5738,169482,96,204858
43837,0.001688,172.31.47.0-255,66,169548,96,204858
43838,0.001757,172.31.47.0-255,66,169614,96,204858
43839,0.00177,172.217.194.0-255,1484,171098,96,204858
43840,0.001787,172.217.194.0-255,766,171864,96,204858
43841,0.001801,172.31.47.0-255,66,171930,96,204858
43842,0.002571,172.217.194.0-255,1484,173414,96,204858
43843,0.002578,172.217.194.0-255,2902,176316,96,204858
43844,0.002582,172.31.47.0-255,66,176382,96,204858
43845,0.002586,172.217.194.0-255,1484,177866,96,204858
43846,0.002622,172.217.194.0-255,4320,182186,96,204858
43847,0.002622,172.31.47.0-255,66,182252,96,204858
43848,0.002626,172.31.47.0-255,66,182318,96,204858
43849,0.002662,172.217.194.0-255,7156,189474,96,204858
43850,0.002665,172.31.47.0-255,66,189540,96,204858
43851,0.002681,172.31.47.0-255,66,189606,96,204858
43852,0.002715,172.217.194.0-255,2184,191790,96,204858
43853,0.002718,172.31.47.0-255,66,191856,96,204858
43854,0.002745,172.31.47.0-255,66,191922,96,204858
43855,0.00276,172.217.194.0-255,1484,193406,96,204858
43856,0.002766,172.217.194.0-255,6683,200089,96,204858
43857,0.002767,172.31.47.0-255,66,200155,96,204858
43858,0.002772,172.31.47.0-255,66,200221,96,204858
43859,0.002827,172.217.194.0-255,105,200326,96,204858
43860,0.003629,172.31.47.0-255,66,200392,96,204858
43861,0.003657,172.31.47.0-255,105,200497,96,204858
43862,0.005682,172.217.194.0-255,66,200563,96,204858
43863,0.02763,172.31.47.0-255,172,200735,96,204858
43864,0.027657,172.31.47.0-255,1109,201844,96,204858
43865,0.027686,172.31.47.0-255,1514,203358,96,204858
43866,0.027688,172.31.47.0-255,1302,204660,96,204858
43867,0.029164,104.244.42.0-255,66,204726,96,204858
43868,0.029194,104.244.42.0-255,66,204792,96,204858
43869,0.029242,104.244.42.0-255,66,204858,96,204858
43870,0.0,74.125.24.0-255,153,153,96,327152
43871,2.6e-05,172.31.47.0-255,66,219,96,327152
43872,3.3e-05,74.125.24.0-255,1484,1703,96,327152
43873,3.7e-05,172.31.47.0-255,66,1769,96,327152
43874,4.2e-05,74.125.24.0-255,2902,4671,96,327152
43875,4.4e-05,172.31.47.0-255,66,4737,96,327152
43876,4.8e-05,74.125.24.0-255,2902,7639,96,327152
43877,5e-05,172.31.47.0-255,66,7705,96,327152
43878,6.9e-05,74.125.24.0-255,5738,13443,96,327152
43879,7.2e-05,172.31.47.0-255,66,13509,96,327152
43880,0.000102,74.125.24.0-255,5044,18553,96,327152
43881,0.000105,172.31.47.0-255,66,18619,96,327152
43882,0.00011,74.125.24.0-255,5738,24357,96,327152
43883,0.000112,172.31.47.0-255,66,24423,96,327152
43884,0.000127,74.125.24.0-255,2902,27325,96,327152
43885,0.00013,172.31.47.0-255,66,27391,96,327152
43886,0.000171,172.31.47.0-255,66,27457,96,327152
43887,0.000178,74.125.24.0-255,5020,32477,96,327152
43888,0.000181,172.31.47.0-255,66,32543,96,327152
43889,0.000198,74.125.24.0-255,2902,35445,96,327152
43890,0.0002,172.31.47.0-255,66,35511,96,327152
43891,0.000225,74.125.24.0-255,5738,41249,96,327152
43892,0.000228,172.31.47.0-255,66,41315,96,327152
43893,0.000272,172.31.47.0-255,66,41381,96,327152
43894,0.000301,74.125.24.0-255,1484,42865,96,327152
43895,0.000304,172.31.47.0-255,66,42931,96,327152
43896,0.000309,74.125.24.0-255,1484,44415,96,327152
43897,0.000313,172.31.47.0-255,66,44481,96,327152
43898,0.000323,74.125.24.0-255,1484,45965,96,327152
43899,0.000325,172.31.47.0-255,66,46031,96,327152
43900,0.000331,74.125.24.0-255,4320,50351,96,327152
43901,0.000334,172.31.47.0-255,66,50417,96,327152
43902,0.000356,74.125.24.0-255,1484,51901,96,327152
43903,0.000366,74.125.24.0-255,7156,59057,96,327152
43904,0.000369,172.31.47.0-255,66,59123,96,327152
43905,0.000398,172.31.47.0-255,66,59189,96,327152
43906,0.00042,74.125.24.0-255,4320,63509,96,327152
43907,0.000423,172.31.47.0-255,66,63575,96,327152
43908,0.000426,74.125.24.0-255,2184,65759,96,327152
43909,0.000429,172.31.47.0-255,66,65825,96,327152
43910,0.000731,74.125.24.0-255,1484,67309,96,327152
43911,0.000736,74.125.24.0-255,2902,70211,96,327152
43912,0.000739,172.31.47.0-255,66,70277,96,327152
43913,0.000746,74.125.24.0-255,5738,76015,96,327152
43914,0.000748,172.31.47.0-255,66,76081,96,327152
43915,0.000776,74.125.24.0-255,6497,82578,96,327152
43916,0.00078,172.31.47.0-255,66,82644,96,327152
43917,0.000891,74.125.24.0-255,1484,84128,96,327152
43918,0.000895,74.125.24.0-255,1484,85612,96,327152
43919,0.000898,172.31.47.0-255,66,85678,96,327152
43920,0.00092,74.125.24.0-255,1484,87162,96,327152
43921,0.000926,74.125.24.0-255,5738,92900,96,327152
43922,0.000929,172.31.47.0-255,66,92966,96,327152
43923,0.000935,74.125.24.0-255,5738,98704,96,327152
43924,0.000937,172.31.47.0-255,66,98770,96,327152
43925,0.00096,74.125.24.0-255,1484,100254,96,327152
43926,0.00097,172.31.47.0-255,66,100320,96,327152
43927,0.00099,74.125.24.0-255,4320,104640,96,327152
43928,0.000992,172.31.47.0-255,66,104706,96,327152
43929,0.000995,74.125.24.0-255,2184,106890,96,327152
43930,0.000997,172.31.47.0-255,66,106956,96,327152
43931,0.001174,74.125.24.0-255,1484,108440,96,327152
43932,0.001192,74.125.24.0-255,2902,111342,96,327152
43933,0.001195,172.31.47.0-255,66,111408,96,327152
43934,0.001227,74.125.24.0-255,2902,114310,96,327152
43935,0.001229,172.31.47.0-255,66,114376,96,327152
43936,0.001252,74.125.24.0-255,2902,117278,96,327152
43937,0.001255,172.31.47.0-255,66,117344,96,327152
43938,0.001264,172.31.47.0-255,66,117410,96,327152
43939,0.00127,74.125.24.0-255,5738,123148,96,327152
43940,0.001271,172.31.47.0-255,66,123214,96,327152
43941,0.001296,74.125.24.0-255,5738,128952,96,327152
43942,0.001299,172.31.47.0-255,66,129018,96,327152
43943,0.001302,74.125.24.0-255,2184,131202,96,327152
43944,0.001304,172.31.47.0-255,66,131268,96,327152
43945,0.001731,74.125.24.0-255,1484,132752,96,327152
43946,0.00174,74.125.24.0-255,2902,135654,96,327152
43947,0.001743,172.31.47.0-255,66,135720,96,327152
43948,0.001747,74.125.24.0-255,2902,138622,96,327152
43949,0.001749,172.31.47.0-255,66,138688,96,327152
43950,0.001766,74.125.24.0-255,2902,141590,96,327152
43951,0.001769,172.31.47.0-255,66,141656,96,327152
43952,0.001785,74.125.24.0-255,2902,144558,96,327152
43953,0.001788,172.31.47.0-255,66,144624,96,327152
43954,0.001823,172.31.47.0-255,66,144690,96,327152
43955,0.001827,74.125.24.0-255,2902,147592,96,327152
43956,0.001828,172.31.47.0-255,66,147658,96,327152
43957,0.001865,172.31.47.0-255,66,147724,96,327152
43958,0.002289,74.125.24.0-255,1484,149208,96,327152
43959,0.002297,74.125.24.0-255,2902,152110,96,327152
43960,0.002301,172.31.47.0-255,66,152176,96,327152
43961,0.002308,74.125.24.0-255,5738,157914,96,327152
43962,0.00231,172.31.47.0-255,66,157980,96,327152
43963,0.002314,74.125.24.0-255,1484,159464,96,327152
43964,0.002338,74.125.24.0-255,2902,162366,96,327152
43965,0.00234,172.31.47.0-255,66,162432,96,327152
43966,0.00237,172.31.47.0-255,66,162498,96,327152
43967,0.004688,74.125.24.0-255,5738,168236,96,327152
43968,0.004692,172.31.47.0-255,66,168302,96,327152
43969,0.007008,74.125.24.0-255,5738,174040,96,327152
43970,0.007015,172.31.47.0-255,66,174106,96,327152
43971,0.009374,74.125.24.0-255,5738,179844,96,327152
43972,0.009383,172.31.47.0-255,66,179910,96,327152
43973,0.01169,74.125.24.0-255,5738,185648,96,327152
43974,0.011696,172.31.47.0-255,66,185714,96,327152
43975,0.014041,74.125.24.0-255,5738,191452,96,327152
43976,0.014048,172.31.47.0-255,66,191518,96,327152
43977,0.016424,74.125.24.0-255,5738,197256,96,327152
43978,0.016433,172.31.47.0-255,66,197322,96,327152
43979,0.018745,74.125.24.0-255,5738,203060,96,327152
43980,0.018751,172.31.47.0-255,66,203126,96,327152
43981,0.02122,74.125.24.0-255,5738,208864,96,327152
43982,0.021227,172.31.47.0-255,66,208930,96,327152
43983,0.022278,172.31.47.0-255,172,209102,96,327152
43984,0.022304,172.31.47.0-255,1109,210211,96,327152
43985,0.022337,172.31.47.0-255,1514,211725,96,327152
43986,0.022338,172.31.47.0-255,335,212060,96,327152
43987,0.023561,74.125.24.0-255,5738,217798,96,327152
43988,0.023565,172.31.47.0-255,66,217864,96,327152
43989,0.023802,104.244.42.0-255,66,217930,96,327152
43990,0.023874,104.244.42.0-255,66,217996,96,327152
43991,0.023879,104.244.42.0-255,66,218062,96,327152
43992,0.025901,74.125.24.0-255,4320,222382,96,327152
43993,0.025905,172.31.47.0-255,66,222448,96,327152
43994,0.025933,74.125.24.0-255,1484,223932,96,327152
43995,0.028246,74.125.24.0-255,4320,228252,96,327152
43996,0.02825,172.31.47.0-255,66,228318,96,327152
43997,0.030573,74.125.24.0-255,5738,234056,96,327152
43998,0.030578,172.31.47.0-255,66,234122,96,327152
43999,0.032912,74.125.24.0-255,5738,239860,96,327152
44000,0.032916,172.31.47.0-255,66,239926,96,327152
44001,0.03524,74.125.24.0-255,5738,245664,96,327152
44002,0.035244,172.31.47.0-255,66,245730,96,327152
44003,0.037584,74.125.24.0-255,5738,251468,96,327152
44004,0.037588,172.31.47.0-255,66,251534,96,327152
44005,0.03992,74.125.24.0-255,4320,255854,96,327152
44006,0.039925,172.31.47.0-255,66,255920,96,327152
44007,0.03995,74.125.24.0-255,1484,257404,96,327152
44008,0.042232,74.125.24.0-255,4320,261724,96,327152
44009,0.042237,172.31.47.0-255,66,261790,96,327152
44010,0.044613,74.125.24.0-255,5738,267528,96,327152
44011,0.044618,172.31.47.0-255,66,267594,96,327152
44012,0.046968,74.125.24.0-255,2902,270496,96,327152
44013,0.046972,172.31.47.0-255,66,270562,96,327152
44014,0.046999,74.125.24.0-255,2902,273464,96,327152
44015,0.047002,172.31.47.0-255,66,273530,96,327152
44016,0.049285,74.125.24.0-255,2902,276432,96,327152
44017,0.04929,172.31.47.0-255,66,276498,96,327152
44018,0.049318,74.125.24.0-255,2902,279400,96,327152
44019,0.04932,172.31.47.0-255,66,279466,96,327152
44020,0.051635,74.125.24.0-255,2902,282368,96,327152
44021,0.051639,172.31.47.0-255,66,282434,96,327152
44022,0.051668,74.125.24.0-255,1484,283918,96,327152
44023,0.051679,74.125.24.0-255,1484,285402,96,327152
44024,0.051682,172.31.47.0-255,66,285468,96,327152
44025,0.053966,74.125.24.0-255,2902,288370,96,327152
44026,0.05397,172.31.47.0-255,66,288436,96,327152
44027,0.054027,74.125.24.0-255,2902,291338,96,327152
44028,0.054031,172.31.47.0-255,66,291404,96,327152
44029,0.056283,74.125.24.0-255,2902,294306,96,327152
44030,0.056287,172.31.47.0-255,66,294372,96,327152
44031,0.056345,74.125.24.0-255,1484,295856,96,327152
44032,0.056362,74.125.24.0-255,1484,297340,96,327152
44033,0.056365,172.31.47.0-255,66,297406,96,327152
44034,0.058579,74.125.24.0-255,2902,300308,96,327152
44035,0.058585,172.31.47.0-255,66,300374,96,327152
44036,0.058686,74.125.24.0-255,2902,303276,96,327152
44037,0.058691,172.31.47.0-255,66,303342,96,327152
44038,0.060916,74.125.24.0-255,2902,306244,96,327152
44039,0.060922,172.31.47.0-255,66,306310,96,327152
44040,0.061021,74.125.24.0-255,2902,309212,96,327152
44041,0.061026,172.31.47.0-255,66,309278,96,327152
44042,0.063259,74.125.24.0-255,2902,312180,96,327152
44043,0.063263,172.31.47.0-255,66,312246,96,327152
44044,0.063334,74.125.24.0-255,2902,315148,96,327152
44045,0.063338,172.31.47.0-255,66,315214,96,327152
44046,0.065583,74.125.24.0-255,2902,318116,96,327152
44047,0.065588,172.31.47.0-255,66,318182,96,327152
44048,0.065659,74.125.24.0-255,2902,321084,96,327152
44049,0.065663,172.31.47.0-255,66,321150,96,327152
44050,0.067914,74.125.24.0-255,1484,322634,96,327152
44051,0.06794,74.125.24.0-255,1484,324118,96,327152
44052,0.067943,172.31.47.0-255,66,324184,96,327152
44053,0.067981,74.125.24.0-255,2902,327086,96,327152
44054,0.067984,172.31.47.0-255,66,327152,96,327152
44055,0.0,74.125.24.0-255,153,153,96,305115
44056,3.1e-05,172.31.47.0-255,66,219,96,305115
44057,3.7e-05,74.125.24.0-255,1484,1703,96,305115
44058,4.2e-05,172.31.47.0-255,66,1769,96,305115
44059,4.6e-05,74.125.24.0-255,2902,4671,96,305115
44060,4.9e-05,172.31.47.0-255,66,4737,96,305115
44061,5.3e-05,74.125.24.0-255,2902,7639,96,305115
44062,5.5e-05,172.31.47.0-255,66,7705,96,305115
44063,0.0001,74.125.24.0-255,4320,12025,96,305115
44064,0.000103,172.31.47.0-255,66,12091,96,305115
44065,0.000119,74.125.24.0-255,1974,14065,96,305115
44066,0.000122,172.31.47.0-255,66,14131,96,305115
44067,0.000539,74.125.24.0-255,1484,15615,96,305115
44068,0.000544,172.31.47.0-255,66,15681,96,305115
44069,0.000552,74.125.24.0-255,1484,17165,96,305115
44070,0.000555,172.31.47.0-255,66,17231,96,305115
44071,0.000579,74.125.24.0-255,1484,18715,96,305115
44072,0.000582,172.31.47.0-255,66,18781,96,305115
44073,0.000589,74.125.24.0-255,5738,24519,96,305115
44074,0.000591,172.31.47.0-255,66,24585,96,305115
44075,0.000595,74.125.24.0-255,1484,26069,96,305115
44076,0.000596,172.31.47.0-255,66,26135,96,305115
44077,0.000627,172.31.47.0-255,66,26201,96,305115
44078,0.000691,172.31.47.0-255,66,26267,96,305115
44079,0.000703,172.31.47.0-255,66,26333,96,305115
44080,0.000706,74.125.24.0-255,766,27099,96,305115
44081,0.000708,172.31.47.0-255,66,27165,96,305115
44082,0.000726,74.125.24.0-255,399,27564,96,305115
44083,0.000728,172.31.47.0-255,66,27630,96,305115
44084,0.000929,74.125.24.0-255,109,27739,96,305115
44085,0.001111,74.125.24.0-255,1484,29223,96,305115
44086,0.001117,74.125.24.0-255,2902,32125,96,305115
44087,0.00112,74.125.24.0-255,1484,33609,96,305115
44088,0.001133,74.125.24.0-255,2902,36511,96,305115
44089,0.001155,74.125.24.0-255,1484,37995,96,305115
44090,0.001172,74.125.24.0-255,5738,43733,96,305115
44091,0.001183,74.125.24.0-255,4320,48053,96,305115
44092,0.001195,74.125.24.0-255,766,48819,96,305115
44093,0.001442,74.125.24.0-255,1484,50303,96,305115
44094,0.001455,74.125.24.0-255,1484,51787,96,305115
44095,0.00147,74.125.24.0-255,1484,53271,96,305115
44096,0.001473,74.125.24.0-255,1484,54755,96,305115
44097,0.001492,74.125.24.0-255,4320,59075,96,305115
44098,0.001502,74.125.24.0-255,2902,61977,96,305115
44099,0.00152,74.125.24.0-255,5738,67715,96,305115
44100,0.001532,74.125.24.0-255,4320,72035,96,305115
44101,0.001535,74.125.24.0-255,1484,73519,96,305115
44102,0.001537,74.125.24.0-255,1484,75003,96,305115
44103,0.00155,74.125.24.0-255,1484,76487,96,305115
44104,0.001563,74.125.24.0-255,5738,82225,96,305115
44105,0.001565,74.125.24.0-255,766,82991,96,305115
44106,0.001673,74.125.24.0-255,1484,84475,96,305115
44107,0.001686,74.125.24.0-255,1484,85959,96,305115
44108,0.001697,74.125.24.0-255,1484,87443,96,305115
44109,0.001699,74.125.24.0-255,1484,88927,96,305115
44110,0.001713,74.125.24.0-255,4320,93247,96,305115
44111,0.001732,74.125.24.0-255,2902,96149,96,305115
44112,0.001749,74.125.24.0-255,7156,103305,96,305115
44113,0.001759,74.125.24.0-255,1484,104789,96,305115
44114,0.001777,74.125.24.0-255,1484,106273,96,305115
44115,0.001801,74.125.24.0-255,2902,109175,96,305115
44116,0.002238,74.125.24.0-255,1484,110659,96,305115
44117,0.002242,74.125.24.0-255,2902,113561,96,305115
44118,0.002252,74.125.24.0-255,1484,115045,96,305115
44119,0.002276,74.125.24.0-255,4320,119365,96,305115
44120,0.002281,74.125.24.0-255,4320,123685,96,305115
44121,0.002297,74.125.24.0-255,4320,128005,96,305115
44122,0.002311,74.125.24.0-255,4320,132325,96,305115
44123,0.002314,74.125.24.0-255,1484,133809,96,305115
44124,0.00236,74.125.24.0-255,4320,138129,96,305115
44125,0.002378,74.125.24.0-255,2902,141031,96,305115
44126,0.002388,74.125.24.0-255,2184,143215,96,305115
44127,0.002573,172.31.47.0-255,66,143281,96,305115
44128,0.004986,74.125.24.0-255,5738,149019,96,305115
44129,0.004991,172.31.47.0-255,66,149085,96,305115
44130,0.00734,74.125.24.0-255,5738,154823,96,305115
44131,0.007348,172.31.47.0-255,66,154889,96,305115
44132,0.009747,74.125.24.0-255,5738,160627,96,305115
44133,0.009754,172.31.47.0-255,66,160693,96,305115
44134,0.012109,74.125.24.0-255,5738,166431,96,305115
44135,0.012116,172.31.47.0-255,66,166497,96,305115
44136,0.014485,74.125.24.0-255,5738,172235,96,305115
44137,0.014496,172.31.47.0-255,66,172301,96,305115
44138,0.016847,74.125.24.0-255,5738,178039,96,305115
44139,0.016854,172.31.47.0-255,66,178105,96,305115
44140,0.019208,74.125.24.0-255,5738,183843,96,305115
44141,0.019216,172.31.47.0-255,66,183909,96,305115
44142,0.020594,172.31.47.0-255,172,184081,96,305115
44143,0.020625,172.31.47.0-255,1111,185192,96,305115
44144,0.020658,172.31.47.0-255,1514,186706,96,305115
44145,0.02066,172.31.47.0-255,1514,188220,96,305115
44146,0.020664,172.31.47.0-255,1514,189734,96,305115
44147,0.020665,172.31.47.0-255,1081,190815,96,305115
44148,0.021597,74.125.24.0-255,5738,196553,96,305115
44149,0.021604,172.31.47.0-255,66,196619,96,305115
44150,0.022168,104.244.42.0-255,66,196685,96,305115
44151,0.022226,104.244.42.0-255,66,196751,96,305115
44152,0.022267,104.244.42.0-255,66,196817,96,305115
44153,0.022272,104.244.42.0-255,66,196883,96,305115
44154,0.023972,74.125.24.0-255,4320,201203,96,305115
44155,0.023979,172.31.47.0-255,66,201269,96,305115
44156,0.024013,74.125.24.0-255,1484,202753,96,305115
44157,0.026356,74.125.24.0-255,4320,207073,96,305115
44158,0.026362,172.31.47.0-255,66,207139,96,305115
44159,0.02871,74.125.24.0-255,5738,212877,96,305115
44160,0.028751,172.31.47.0-255,66,212943,96,305115
44161,0.03112,74.125.24.0-255,5738,218681,96,305115
44162,0.031129,172.31.47.0-255,66,218747,96,305115
44163,0.033487,74.125.24.0-255,5738,224485,96,305115
44164,0.033492,172.31.47.0-255,66,224551,96,305115
44165,0.035862,74.125.24.0-255,5738,230289,96,305115
44166,0.035867,172.31.47.0-255,66,230355,96,305115
44167,0.038228,74.125.24.0-255,4320,234675,96,305115
44168,0.038233,172.31.47.0-255,66,234741,96,305115
44169,0.038247,74.125.24.0-255,1484,236225,96,305115
44170,0.04059,74.125.24.0-255,2902,239127,96,305115
44171,0.040595,172.31.47.0-255,66,239193,96,305115
44172,0.040614,74.125.24.0-255,1484,240677,96,305115
44173,0.042953,74.125.24.0-255,2902,243579,96,305115
44174,0.042958,172.31.47.0-255,66,243645,96,305115
44175,0.042976,74.125.24.0-255,1484,245129,96,305115
44176,0.045294,74.125.24.0-255,4320,249449,96,305115
44177,0.045358,172.31.47.0-255,66,249515,96,305115
44178,0.04774,74.125.24.0-255,5738,255253,96,305115
44179,0.047808,172.31.47.0-255,66,255319,96,305115
44180,0.050152,74.125.24.0-255,5738,261057,96,305115
44181,0.050159,172.31.47.0-255,66,261123,96,305115
44182,0.052519,74.125.24.0-255,5738,266861,96,305115
44183,0.052525,172.31.47.0-255,66,266927,96,305115
44184,0.054883,74.125.24.0-255,5738,272665,96,305115
44185,0.054888,172.31.47.0-255,66,272731,96,305115
44186,0.057256,74.125.24.0-255,5738,278469,96,305115
44187,0.057262,172.31.47.0-255,66,278535,96,305115
44188,0.059589,74.125.24.0-255,4320,282855,96,305115
44189,0.059595,172.31.47.0-255,66,282921,96,305115
44190,0.059625,74.125.24.0-255,1484,284405,96,305115
44191,0.061945,74.125.24.0-255,4320,288725,96,305115
44192,0.06195,172.31.47.0-255,66,288791,96,305115
44193,0.064306,74.125.24.0-255,2902,291693,96,305115
44194,0.064311,172.31.47.0-255,66,291759,96,305115
44195,0.064337,74.125.24.0-255,2902,294661,96,305115
44196,0.064347,172.31.47.0-255,66,294727,96,305115
44197,0.066693,74.125.24.0-255,4320,299047,96,305115
44198,0.066699,172.31.47.0-255,66,299113,96,305115
44199,0.066729,74.125.24.0-255,1484,300597,96,305115
44200,0.069059,74.125.24.0-255,1484,302081,96,305115
44201,0.069063,172.31.47.0-255,66,302147,96,305115
44202,0.06909,74.125.24.0-255,2902,305049,96,305115
44203,0.069097,172.31.47.0-255,66,305115,96,305115
44204,0.0,74.125.24.0-255,153,153,96,303667
44205,2.1e-05,172.31.47.0-255,66,219,96,303667
44206,2.8e-05,74.125.24.0-255,1484,1703,96,303667
44207,3.2e-05,172.31.47.0-255,66,1769,96,303667
44208,3.7e-05,74.125.24.0-255,2902,4671,96,303667
44209,4e-05,172.31.47.0-255,66,4737,96,303667
44210,4.5e-05,74.125.24.0-255,4320,9057,96,303667
44211,4.8e-05,172.31.47.0-255,66,9123,96,303667
44212,7.6e-05,74.125.24.0-255,2902,12025,96,303667
44213,8.1e-05,172.31.47.0-255,66,12091,96,303667
44214,8.7e-05,74.125.24.0-255,4320,16411,96,303667
44215,9e-05,172.31.47.0-255,66,16477,96,303667
44216,0.000122,172.31.47.0-255,66,16543,96,303667
44217,0.000162,172.31.47.0-255,66,16609,96,303667
44218,0.00021,74.125.24.0-255,4320,20929,96,303667
44219,0.000213,172.31.47.0-255,66,20995,96,303667
44220,0.000234,74.125.24.0-255,3602,24597,96,303667
44221,0.000238,172.31.47.0-255,66,24663,96,303667
44222,0.003702,74.125.24.0-255,1484,26147,96,303667
44223,0.003708,172.31.47.0-255,66,26213,96,303667
44224,0.003717,74.125.24.0-255,2902,29115,96,303667
44225,0.003719,172.31.47.0-255,66,29181,96,303667
44226,0.003726,74.125.24.0-255,5738,34919,96,303667
44227,0.003728,172.31.47.0-255,66,34985,96,303667
44228,0.003733,74.125.24.0-255,4320,39305,96,303667
44229,0.003735,172.31.47.0-255,66,39371,96,303667
44230,0.003753,74.125.24.0-255,1484,40855,96,303667
44231,0.003754,172.31.47.0-255,66,40921,96,303667
44232,0.003779,74.125.24.0-255,1481,42402,96,303667
44233,0.003781,172.31.47.0-255,66,42468,96,303667
44234,0.010311,74.125.24.0-255,1484,43952,96,303667
44235,0.010325,74.125.24.0-255,2902,46854,96,303667
44236,0.010332,172.31.47.0-255,66,46920,96,303667
44237,0.01034,74.125.24.0-255,4320,51240,96,303667
44238,0.010343,74.125.24.0-255,1484,52724,96,303667
44239,0.010364,74.125.24.0-255,7156,59880,96,303667
44240,0.010384,74.125.24.0-255,4320,64200,96,303667
44241,0.0104,74.125.24.0-255,1484,65684,96,303667
44242,0.010423,172.31.47.0-255,66,65750,96,303667
44243,0.010434,74.125.24.0-255,2902,68652,96,303667
44244,0.010441,172.31.47.0-255,66,68718,96,303667
44245,0.010511,172.31.47.0-255,66,68784,96,303667
44246,0.015668,74.125.24.0-255,1484,70268,96,303667
44247,0.015682,74.125.24.0-255,2902,73170,96,303667
44248,0.015691,172.31.47.0-255,66,73236,96,303667
44249,0.0157,74.125.24.0-255,5738,78974,96,303667
44250,0.015707,74.125.24.0-255,7156,86130,96,303667
44251,0.015725,74.125.24.0-255,2902,89032,96,303667
44252,0.015753,74.125.24.0-255,7156,96188,96,303667
44253,0.015772,74.125.24.0-255,6438,102626,96,303667
44254,0.0158,172.31.47.0-255,66,102692,96,303667
44255,0.015821,74.125.24.0-255,4320,107012,96,303667
44256,0.015897,74.125.24.0-255,7156,114168,96,303667
44257,0.015901,172.31.47.0-255,66,114234,96,303667
44258,0.015914,74.125.24.0-255,7156,121390,96,303667
44259,0.01593,74.125.24.0-255,5020,126410,96,303667
44260,0.015974,172.31.47.0-255,66,126476,96,303667
44261,0.017944,74.125.24.0-255,1484,127960,96,303667
44262,0.017951,74.125.24.0-255,2902,130862,96,303667
44263,0.017955,172.31.47.0-255,66,130928,96,303667
44264,0.017961,74.125.24.0-255,4320,135248,96,303667
44265,0.017977,74.125.24.0-255,1484,136732,96,303667
44266,0.017979,74.125.24.0-255,1484,138216,96,303667
44267,0.018003,74.125.24.0-255,5738,143954,96,303667
44268,0.018009,172.31.47.0-255,66,144020,96,303667
44269,0.018062,172.31.47.0-255,66,144086,96,303667
44270,0.01809,74.125.24.0-255,2184,146270,96,303667
44271,0.018096,172.31.47.0-255,66,146336,96,303667
44272,0.020491,172.31.47.0-255,171,146507,96,303667
44273,0.020522,172.31.47.0-255,1134,147641,96,303667
44274,0.020554,172.31.47.0-255,1514,149155,96,303667
44275,0.020556,172.31.47.0-255,1277,150432,96,303667
44276,0.020913,74.125.24.0-255,1484,151916,96,303667
44277,0.020937,74.125.24.0-255,2902,154818,96,303667
44278,0.020942,172.31.47.0-255,66,154884,96,303667
44279,0.020949,74.125.24.0-255,5738,160622,96,303667
44280,0.020952,74.125.24.0-255,1484,162106,96,303667
44281,0.020959,172.31.47.0-255,66,162172,96,303667
44282,0.020992,172.31.47.0-255,66,162238,96,303667
44283,0.02103,74.125.24.0-255,4320,166558,96,303667
44284,0.021035,172.31.47.0-255,66,166624,96,303667
44285,0.021043,74.125.24.0-255,4320,170944,96,303667
44286,0.021049,172.31.47.0-255,66,171010,96,303667
44287,0.021064,74.125.24.0-255,1484,172494,96,303667
44288,0.021091,172.31.47.0-255,66,172560,96,303667
44289,0.02118,74.125.24.0-255,5738,178298,96,303667
44290,0.021495,172.31.47.0-255,66,178364,96,303667
44291,0.022048,104.244.42.0-255,66,178430,96,303667
44292,0.022071,74.125.24.0-255,1484,179914,96,303667
44293,0.02209,74.125.24.0-255,2902,182816,96,303667
44294,0.022095,172.31.47.0-255,66,182882,96,303667
44295,0.022098,104.244.42.0-255,66,182948,96,303667
44296,0.022106,74.125.24.0-255,5738,188686,96,303667
44297,0.022111,172.31.47.0-255,66,188752,96,303667
44298,0.022129,104.244.42.0-255,66,188818,96,303667
44299,0.022138,74.125.24.0-255,7156,195974,96,303667
44300,0.022148,172.31.47.0-255,66,196040,96,303667
44301,0.022159,74.125.24.0-255,5738,201778,96,303667
44302,0.022163,172.31.47.0-255,66,201844,96,303667
44303,0.022178,74.125.24.0-255,7156,209000,96,303667
44304,0.022187,172.31.47.0-255,66,209066,96,303667
44305,0.02222,74.125.24.0-255,3602,212668,96,303667
44306,0.022225,172.31.47.0-255,66,212734,96,303667
44307,0.023137,74.125.24.0-255,1484,214218,96,303667
44308,0.023154,74.125.24.0-255,2902,217120,96,303667
44309,0.023158,172.31.47.0-255,66,217186,96,303667
44310,0.023165,74.125.24.0-255,5738,222924,96,303667
44311,0.023177,74.125.24.0-255,2902,225826,96,303667
44312,0.023188,74.125.24.0-255,5738,231564,96,303667
44313,0.023201,74.125.24.0-255,4320,235884,96,303667
44314,0.023204,172.31.47.0-255,66,235950,96,303667
44315,0.023209,172.31.47.0-255,66,236016,96,303667
44316,0.023242,74.125.24.0-255,4320,240336,96,303667
44317,0.023248,172.31.47.0-255,66,240402,96,303667
44318,0.023269,74.125.24.0-255,5738,246140,96,303667
44319,0.023278,172.31.47.0-255,66,246206,96,303667
44320,0.023308,74.125.24.0-255,2902,249108,96,303667
44321,0.023313,172.31.47.0-255,66,249174,96,303667
44322,0.023367,172.31.47.0-255,66,249240,96,303667
44323,0.023369,74.125.24.0-255,766,250006,96,303667
44324,0.02338,74.125.24.0-255,4320,254326,96,303667
44325,0.023382,172.31.47.0-255,66,254392,96,303667
44326,0.023402,74.125.24.0-255,7156,261548,96,303667
44327,0.023412,172.31.47.0-255,66,261614,96,303667
44328,0.023427,74.125.24.0-255,6438,268052,96,303667
44329,0.023432,172.31.47.0-255,66,268118,96,303667
44330,0.023933,74.125.24.0-255,1484,269602,96,303667
44331,0.023941,74.125.24.0-255,2902,272504,96,303667
44332,0.023944,172.31.47.0-255,66,272570,96,303667
44333,0.023961,74.125.24.0-255,2902,275472,96,303667
44334,0.023975,74.125.24.0-255,2902,278374,96,303667
44335,0.023978,74.125.24.0-255,1484,279858,96,303667
44336,0.023982,74.125.24.0-255,4320,284178,96,303667
44337,0.023999,74.125.24.0-255,4320,288498,96,303667
44338,0.024022,74.125.24.0-255,2902,291400,96,303667
44339,0.024027,172.31.47.0-255,66,291466,96,303667
44340,0.024061,172.31.47.0-255,66,291532,96,303667
44341,0.024186,74.125.24.0-255,1484,293016,96,303667
44342,0.024204,74.125.24.0-255,2902,295918,96,303667
44343,0.024207,172.31.47.0-255,66,295984,96,303667
44344,0.024213,74.125.24.0-255,4320,300304,96,303667
44345,0.024221,172.31.47.0-255,66,300370,96,303667
44346,0.024226,74.125.24.0-255,1484,301854,96,303667
44347,0.024257,74.125.24.0-255,1405,303259,96,303667
44348,0.024261,172.31.47.0-255,66,303325,96,303667
44349,0.024276,74.125.24.0-255,105,303430,96,303667
44350,0.024352,172.31.47.0-255,66,303496,96,303667
44351,0.024372,172.31.47.0-255,105,303601,96,303667
44352,0.026932,74.125.24.0-255,66,303667,96,303667
44353,0.0,74.125.130.0-255,302,302,96,319818
44354,1.7e-05,172.31.47.0-255,66,368,96,319818
44355,2.3e-05,74.125.130.0-255,1484,1852,96,319818
44356,2.7e-05,172.31.47.0-255,66,1918,96,319818
44357,3.4e-05,74.125.130.0-255,4320,6238,96,319818
44358,3.7e-05,172.31.47.0-255,66,6304,96,319818
44359,4e-05,74.125.130.0-255,1484,7788,96,319818
44360,4.2e-05,172.31.47.0-255,66,7854,96,319818
44361,7.1e-05,74.125.130.0-255,1484,9338,96,319818
44362,7.3e-05,172.31.47.0-255,66,9404,96,319818
44363,7.8e-05,74.125.130.0-255,4320,13724,96,319818
44364,8.1e-05,172.31.47.0-255,66,13790,96,319818
44365,8.3e-05,74.125.130.0-255,359,14149,96,319818
44366,8.5e-05,172.31.47.0-255,66,14215,96,319818
44367,0.000231,74.125.130.0-255,1484,15699,96,319818
44368,0.000236,172.31.47.0-255,66,15765,96,319818
44369,0.000257,74.125.130.0-255,2902,18667,96,319818
44370,0.00026,172.31.47.0-255,66,18733,96,319818
44371,0.000287,74.125.130.0-255,5738,24471,96,319818
44372,0.00029,172.31.47.0-255,66,24537,96,319818
44373,0.000304,74.125.130.0-255,2902,27439,96,319818
44374,0.000305,172.31.47.0-255,66,27505,96,319818
44375,0.000318,74.125.130.0-255,1484,28989,96,319818
44376,0.00032,172.31.47.0-255,66,29055,96,319818
44377,0.00037,74.125.130.0-255,2543,31598,96,319818
44378,0.000373,172.31.47.0-255,66,31664,96,319818
44379,0.000435,74.125.130.0-255,1484,33148,96,319818
44380,0.000439,172.31.47.0-255,66,33214,96,319818
44381,0.000444,74.125.130.0-255,2902,36116,96,319818
44382,0.000446,172.31.47.0-255,66,36182,96,319818
44383,0.000458,74.125.130.0-255,1484,37666,96,319818
44384,0.00046,172.31.47.0-255,66,37732,96,319818
44385,0.000482,74.125.130.0-255,1484,39216,96,319818
44386,0.000488,74.125.130.0-255,4320,43536,96,319818
44387,0.000491,172.31.47.0-255,66,43602,96,319818
44388,0.00051,74.125.130.0-255,1484,45086,96,319818
44389,0.000519,74.125.130.0-255,1484,46570,96,319818
44390,0.000521,172.31.47.0-255,66,46636,96,319818
44391,0.000536,74.125.130.0-255,2543,49179,96,319818
44392,0.000539,172.31.47.0-255,66,49245,96,319818
44393,0.000594,74.125.130.0-255,1484,50729,96,319818
44394,0.000599,74.125.130.0-255,2902,53631,96,319818
44395,0.000601,172.31.47.0-255,66,53697,96,319818
44396,0.000604,74.125.130.0-255,1484,55181,96,319818
44397,0.000627,74.125.130.0-255,2902,58083,96,319818
44398,0.00063,172.31.47.0-255,66,58149,96,319818
44399,0.000633,74.125.130.0-255,1484,59633,96,319818
44400,0.000655,74.125.130.0-255,4320,63953,96,319818
44401,0.000659,172.31.47.0-255,66,64019,96,319818
44402,0.000662,74.125.130.0-255,2543,66562,96,319818
44403,0.000665,172.31.47.0-255,66,66628,96,319818
44404,0.000686,74.125.130.0-255,377,67005,96,319818
44405,0.000797,74.125.130.0-255,367,67372,96,319818
44406,0.001036,74.125.130.0-255,1484,68856,96,319818
44407,0.001042,172.31.47.0-255,66,68922,96,319818
44408,0.00106,74.125.130.0-255,2902,71824,96,319818
44409,0.001062,172.31.47.0-255,66,71890,96,319818
44410,0.001065,74.125.130.0-255,1484,73374,96,319818
44411,0.001081,74.125.130.0-255,2902,76276,96,319818
44412,0.001083,74.125.130.0-255,1484,77760,96,319818
44413,0.00109,172.31.47.0-255,66,77826,96,319818
44414,0.001096,74.125.130.0-255,4320,82146,96,319818
44415,0.001098,172.31.47.0-255,66,82212,96,319818
44416,0.001111,74.125.130.0-255,2902,85114,96,319818
44417,0.001113,172.31.47.0-255,66,85180,96,319818
44418,0.001135,74.125.130.0-255,1125,86305,96,319818
44419,0.00114,74.125.130.0-255,4320,90625,96,319818
44420,0.001142,172.31.47.0-255,66,90691,96,319818
44421,0.001184,172.31.47.0-255,66,90757,96,319818
44422,0.001201,74.125.130.0-255,1125,91882,96,319818
44423,0.001492,172.31.47.0-255,66,91948,96,319818
44424,0.001749,74.125.130.0-255,1484,93432,96,319818
44425,0.001768,74.125.130.0-255,2902,96334,96,319818
44426,0.001771,172.31.47.0-255,66,96400,96,319818
44427,0.001777,74.125.130.0-255,2902,99302,96,319818
44428,0.001779,172.31.47.0-255,66,99368,96,319818
44429,0.001791,74.125.130.0-255,1484,100852,96,319818
44430,0.001803,74.125.130.0-255,2902,103754,96,319818
44431,0.001805,172.31.47.0-255,66,103820,96,319818
44432,0.001828,74.125.130.0-255,5738,109558,96,319818
44433,0.00183,172.31.47.0-255,66,109624,96,319818
44434,0.001834,74.125.130.0-255,2902,112526,96,319818
44435,0.001835,172.31.47.0-255,66,112592,96,319818
44436,0.001867,74.125.130.0-255,2902,115494,96,319818
44437,0.001869,172.31.47.0-255,66,115560,96,319818
44438,0.001898,172.31.47.0-255,66,115626,96,319818
44439,0.001901,74.125.130.0-255,766,116392,96,319818
44440,0.002042,74.125.130.0-255,1484,117876,96,319818
44441,0.002045,172.31.47.0-255,66,117942,96,319818
44442,0.002058,74.125.130.0-255,2902,120844,96,319818
44443,0.00206,172.31.47.0-255,66,120910,96,319818
44444,0.002076,74.125.130.0-255,1484,122394,96,319818
44445,0.002088,74.125.130.0-255,2902,125296,96,319818
44446,0.00209,172.31.47.0-255,66,125362,96,319818
44447,0.002123,74.125.130.0-255,2902,128264,96,319818
44448,0.002125,172.31.47.0-255,66,128330,96,319818
44449,0.002145,74.125.130.0-255,4320,132650,96,319818
44450,0.002147,172.31.47.0-255,66,132716,96,319818
44451,0.002181,172.31.47.0-255,66,132782,96,319818
44452,0.002185,74.125.130.0-255,2902,135684,96,319818
44453,0.002187,172.31.47.0-255,66,135750,96,319818
44454,0.002192,74.125.130.0-255,4320,140070,96,319818
44455,0.002193,172.31.47.0-255,66,140136,96,319818
44456,0.002223,74.125.130.0-255,2184,142320,96,319818
44457,0.002226,172.31.47.0-255,66,142386,96,319818
44458,0.002418,74.125.130.0-255,1484,143870,96,319818
44459,0.002435,74.125.130.0-255,2902,146772,96,319818
44460,0.002438,172.31.47.0-255,66,146838,96,319818
44461,0.002467,74.125.130.0-255,4320,151158,96,319818
44462,0.00247,172.31.47.0-255,66,151224,96,319818
44463,0.002487,74.125.130.0-255,1484,152708,96,319818
44464,0.00249,74.125.130.0-255,1484,154192,96,319818
44465,0.002492,172.31.47.0-255,66,154258,96,319818
44466,0.002496,74.125.130.0-255,2902,157160,96,319818
44467,0.002498,172.31.47.0-255,66,157226,96,319818
44468,0.002532,74.125.130.0-255,1484,158710,96,319818
44469,0.00255,74.125.130.0-255,2902,161612,96,319818
44470,0.002552,172.31.47.0-255,66,161678,96,319818
44471,0.005013,74.125.130.0-255,1484,163162,96,319818
44472,0.00507,74.125.130.0-255,4320,167482,96,319818
44473,0.005079,172.31.47.0-255,66,167548,96,319818
44474,0.007586,74.125.130.0-255,5738,173286,96,319818
44475,0.007596,172.31.47.0-255,66,173352,96,319818
44476,0.010114,74.125.130.0-255,5738,179090,96,319818
44477,0.010131,172.31.47.0-255,66,179156,96,319818
44478,0.012688,74.125.130.0-255,5738,184894,96,319818
44479,0.012705,172.31.47.0-255,66,184960,96,319818
44480,0.015222,74.125.130.0-255,5738,190698,96,319818
44481,0.015239,172.31.47.0-255,66,190764,96,319818
44482,0.017768,74.125.130.0-255,5738,196502,96,319818
44483,0.017785,172.31.47.0-255,66,196568,96,319818
44484,0.020299,74.125.130.0-255,5738,202306,96,319818
44485,0.020313,172.31.47.0-255,66,202372,96,319818
44486,0.022829,74.125.130.0-255,5738,208110,96,319818
44487,0.022844,172.31.47.0-255,66,208176,96,319818
44488,0.024276,172.31.47.0-255,172,208348,96,319818
44489,0.024326,172.31.47.0-255,1111,209459,96,319818
44490,0.02439,172.31.47.0-255,1514,210973,96,319818
44491,0.024392,172.31.47.0-255,1514,212487,96,319818
44492,0.024396,172.31.47.0-255,1514,214001,96,319818
44493,0.024397,172.31.47.0-255,1081,215082,96,319818
44494,0.025356,74.125.130.0-255,5738,220820,96,319818
44495,0.025364,172.31.47.0-255,66,220886,96,319818
44496,0.025831,104.244.42.0-255,66,220952,96,319818
44497,0.025933,104.244.42.0-255,66,221018,96,319818
44498,0.026007,104.244.42.0-255,66,221084,96,319818
44499,0.026012,104.244.42.0-255,66,221150,96,319818
44500,0.02788,74.125.130.0-255,5738,226888,96,319818
44501,0.027886,172.31.47.0-255,66,226954,96,319818
44502,0.030404,74.125.130.0-255,5738,232692,96,319818
44503,0.03041,172.31.47.0-255,66,232758,96,319818
44504,0.032924,74.125.130.0-255,5738,238496,96,319818
44505,0.032936,172.31.47.0-255,66,238562,96,319818
44506,0.035452,74.125.130.0-255,5738,244300,96,319818
44507,0.035461,172.31.47.0-255,66,244366,96,319818
44508,0.037984,74.125.130.0-255,5738,250104,96,319818
44509,0.037998,172.31.47.0-255,66,250170,96,319818
44510,0.040526,74.125.130.0-255,5738,255908,96,319818
44511,0.040543,172.31.47.0-255,66,255974,96,319818
44512,0.043072,74.125.130.0-255,5738,261712,96,319818
44513,0.043085,172.31.47.0-255,66,261778,96,319818
44514,0.045616,74.125.130.0-255,5738,267516,96,319818
44515,0.04563,172.31.47.0-255,66,267582,96,319818
44516,0.048151,74.125.130.0-255,5738,273320,96,319818
44517,0.048163,172.31.47.0-255,66,273386,96,319818
44518,0.050677,74.125.130.0-255,5738,279124,96,319818
44519,0.050686,172.31.47.0-255,66,279190,96,319818
44520,0.053212,74.125.130.0-255,5738,284928,96,319818
44521,0.053223,172.31.47.0-255,66,284994,96,319818
44522,0.055747,74.125.130.0-255,5738,290732,96,319818
44523,0.055758,172.31.47.0-255,66,290798,96,319818
44524,0.05827,74.125.130.0-255,5738,296536,96,319818
44525,0.058282,172.31.47.0-255,66,296602,96,319818
44526,0.060806,74.125.130.0-255,5738,302340,96,319818
44527,0.060815,172.31.47.0-255,66,302406,96,319818
44528,0.063347,74.125.130.0-255,5738,308144,96,319818
44529,0.063359,172.31.47.0-255,66,308210,96,319818
44530,0.06588,74.125.130.0-255,5738,313948,96,319818
44531,0.065892,172.31.47.0-255,66,314014,96,319818
44532,0.068417,74.125.130.0-255,5738,319752,96,319818
44533,0.068427,172.31.47.0-255,66,319818,96,319818
44534,0.0,172.31.47.0-255,105,105,96,276
44535,0.001501,157.240.13.0-255,105,210,96,276
44536,0.001514,172.31.47.0-255,66,276,96,276
44537,0.0,74.125.24.0-255,153,153,96,253499
44538,1.9e-05,172.31.47.0-255,66,219,96,253499
44539,2.5e-05,74.125.24.0-255,1484,1703,96,253499
44540,3e-05,172.31.47.0-255,66,1769,96,253499
44541,4.5e-05,74.125.24.0-255,2902,4671,96,253499
44542,4.8e-05,172.31.47.0-255,66,4737,96,253499
44543,5.6e-05,74.125.24.0-255,7156,11893,96,253499
44544,6e-05,172.31.47.0-255,66,11959,96,253499
44545,0.000101,172.31.47.0-255,66,12025,96,253499
44546,0.000149,172.31.47.0-255,66,12091,96,253499
44547,0.000598,74.125.24.0-255,1484,13575,96,253499
44548,0.000604,172.31.47.0-255,66,13641,96,253499
44549,0.00061,74.125.24.0-255,2902,16543,96,253499
44550,0.000612,172.31.47.0-255,66,16609,96,253499
44551,0.000652,74.125.24.0-255,5738,22347,96,253499
44552,0.000657,172.31.47.0-255,66,22413,96,253499
44553,0.000663,74.125.24.0-255,5738,28151,96,253499
44554,0.000665,172.31.47.0-255,66,28217,96,253499
44555,0.000681,172.31.47.0-255,66,28283,96,253499
44556,0.000709,74.125.24.0-255,5379,33662,96,253499
44557,0.000716,172.31.47.0-255,66,33728,96,253499
44558,0.000723,74.125.24.0-255,4276,38004,96,253499
44559,0.000726,172.31.47.0-255,66,38070,96,253499
44560,0.000835,74.125.24.0-255,108,38178,96,253499
44561,0.000839,172.31.47.0-255,66,38244,96,253499
44562,0.001012,74.125.24.0-255,1484,39728,96,253499
44563,0.001016,172.31.47.0-255,66,39794,96,253499
44564,0.001021,74.125.24.0-255,2902,42696,96,253499
44565,0.001024,172.31.47.0-255,66,42762,96,253499
44566,0.00104,74.125.24.0-255,2902,45664,96,253499
44567,0.001043,172.31.47.0-255,66,45730,96,253499
44568,0.001063,74.125.24.0-255,1484,47214,96,253499
44569,0.001069,74.125.24.0-255,4320,51534,96,253499
44570,0.001072,172.31.47.0-255,66,51600,96,253499
44571,0.001104,74.125.24.0-255,5379,56979,96,253499
44572,0.001108,172.31.47.0-255,66,57045,96,253499
44573,0.001125,172.31.47.0-255,66,57111,96,253499
44574,0.001157,74.125.24.0-255,3961,61072,96,253499
44575,0.00116,172.31.47.0-255,66,61138,96,253499
44576,0.00153,74.125.24.0-255,1484,62622,96,253499
44577,0.001537,74.125.24.0-255,2902,65524,96,253499
44578,0.001541,172.31.47.0-255,66,65590,96,253499
44579,0.001544,74.125.24.0-255,1484,67074,96,253499
44580,0.001566,74.125.24.0-255,2902,69976,96,253499
44581,0.001568,172.31.47.0-255,66,70042,96,253499
44582,0.001573,74.125.24.0-255,4320,74362,96,253499
44583,0.001575,172.31.47.0-255,66,74428,96,253499
44584,0.0016,74.125.24.0-255,1484,75912,96,253499
44585,0.001611,172.31.47.0-255,66,75978,96,253499
44586,0.001617,74.125.24.0-255,5738,81716,96,253499
44587,0.001619,172.31.47.0-255,66,81782,96,253499
44588,0.001651,74.125.24.0-255,4320,86102,96,253499
44589,0.001654,172.31.47.0-255,66,86168,96,253499
44590,0.001658,74.125.24.0-255,766,86934,96,253499
44591,0.001828,74.125.24.0-255,1484,88418,96,253499
44592,0.001833,172.31.47.0-255,66,88484,96,253499
44593,0.001837,74.125.24.0-255,2902,91386,96,253499
44594,0.00184,172.31.47.0-255,66,91452,96,253499
44595,0.001845,74.125.24.0-255,5738,97190,96,253499
44596,0.001847,172.31.47.0-255,66,97256,96,253499
44597,0.00189,172.31.47.0-255,66,97322,96,253499
44598,0.001893,74.125.24.0-255,1484,98806,96,253499
44599,0.001934,172.31.47.0-255,66,98872,96,253499
44600,0.001946,172.31.47.0-255,66,98938,96,253499
44601,0.001979,74.125.24.0-255,4320,103258,96,253499
44602,0.001981,172.31.47.0-255,66,103324,96,253499
44603,0.001997,172.31.47.0-255,66,103390,96,253499
44604,0.002099,74.125.24.0-255,1484,104874,96,253499
44605,0.002104,74.125.24.0-255,2902,107776,96,253499
44606,0.002108,172.31.47.0-255,66,107842,96,253499
44607,0.002111,74.125.24.0-255,1484,109326,96,253499
44608,0.002136,74.125.24.0-255,4320,113646,96,253499
44609,0.002139,172.31.47.0-255,66,113712,96,253499
44610,0.002145,74.125.24.0-255,7156,120868,96,253499
44611,0.002147,172.31.47.0-255,66,120934,96,253499
44612,0.002177,74.125.24.0-255,5738,126672,96,253499
44613,0.00218,172.31.47.0-255,66,126738,96,253499
44614,0.002211,172.31.47.0-255,66,126804,96,253499
44615,0.002244,74.125.24.0-255,1484,128288,96,253499
44616,0.002248,74.125.24.0-255,2902,131190,96,253499
44617,0.002251,172.31.47.0-255,66,131256,96,253499
44618,0.002285,74.125.24.0-255,5738,136994,96,253499
44619,0.002288,172.31.47.0-255,66,137060,96,253499
44620,0.002328,74.125.24.0-255,5738,142798,96,253499
44621,0.002331,172.31.47.0-255,66,142864,96,253499
44622,0.002354,74.125.24.0-255,7156,150020,96,253499
44623,0.002357,172.31.47.0-255,66,150086,96,253499
44624,0.002363,74.125.24.0-255,7156,157242,96,253499
44625,0.002365,172.31.47.0-255,66,157308,96,253499
44626,0.002379,172.31.47.0-255,66,157374,96,253499
44627,0.002418,74.125.24.0-255,5020,162394,96,253499
44628,0.002421,172.31.47.0-255,66,162460,96,253499
44629,0.002435,172.31.47.0-255,66,162526,96,253499
44630,0.002444,74.125.24.0-255,3602,166128,96,253499
44631,0.002446,172.31.47.0-255,66,166194,96,253499
44632,0.00245,74.125.24.0-255,4320,170514,96,253499
44633,0.002452,172.31.47.0-255,66,170580,96,253499
44634,0.002465,74.125.24.0-255,2902,173482,96,253499
44635,0.002509,74.125.24.0-255,3602,177084,96,253499
44636,0.002511,172.31.47.0-255,66,177150,96,253499
44637,0.002514,74.125.24.0-255,7156,184306,96,253499
44638,0.002516,172.31.47.0-255,66,184372,96,253499
44639,0.002539,172.31.47.0-255,66,184438,96,253499
44640,0.002552,172.31.47.0-255,66,184504,96,253499
44641,0.005047,74.125.24.0-255,5738,190242,96,253499
44642,0.005053,172.31.47.0-255,66,190308,96,253499
44643,0.007563,74.125.24.0-255,5738,196046,96,253499
44644,0.007571,172.31.47.0-255,66,196112,96,253499
44645,0.010082,74.125.24.0-255,4320,200432,96,253499
44646,0.010084,172.31.47.0-255,66,200498,96,253499
44647,0.010106,74.125.24.0-255,1484,201982,96,253499
44648,0.012631,74.125.24.0-255,4320,206302,96,253499
44649,0.012649,172.31.47.0-255,66,206368,96,253499
44650,0.015142,74.125.24.0-255,5738,212106,96,253499
44651,0.015149,172.31.47.0-255,66,212172,96,253499
44652,0.017645,74.125.24.0-255,5738,217910,96,253499
44653,0.017659,172.31.47.0-255,66,217976,96,253499
44654,0.020213,74.125.24.0-255,5738,223714,96,253499
44655,0.020219,172.31.47.0-255,66,223780,96,253499
44656,0.0227,74.125.24.0-255,5738,229518,96,253499
44657,0.022707,172.31.47.0-255,66,229584,96,253499
44658,0.025227,74.125.24.0-255,5738,235322,96,253499
44659,0.025234,172.31.47.0-255,66,235388,96,253499
44660,0.027757,74.125.24.0-255,5738,241126,96,253499
44661,0.027768,172.31.47.0-255,66,241192,96,253499
44662,0.030257,74.125.24.0-255,4320,245512,96,253499
44663,0.030263,172.31.47.0-255,66,245578,96,253499
44664,0.030289,74.125.24.0-255,1484,247062,96,253499
44665,0.03275,74.125.24.0-255,1905,248967,96,253499
44666,0.03277,172.31.47.0-255,66,249033,96,253499
44667,0.033047,172.31.47.0-255,105,249138,96,253499
44668,0.035548,74.125.24.0-255,66,249204,96,253499
44669,0.043145,172.31.47.0-255,172,249376,96,253499
44670,0.043176,172.31.47.0-255,1101,250477,96,253499
44671,0.043227,172.31.47.0-255,1514,251991,96,253499
44672,0.043248,172.31.47.0-255,1310,253301,96,253499
44673,0.044762,104.244.42.0-255,66,253367,96,253499
44674,0.044777,104.244.42.0-255,66,253433,96,253499
44675,0.044797,104.244.42.0-255,66,253499,96,253499
44676,0.0,172.31.47.0-255,66,66,96,66
44677,0.0,172.31.47.0-255,105,105,96,276
44678,0.067933,31.13.82.0-255,105,210,96,276
44679,0.067947,172.31.47.0-255,66,276,96,276
44680,0.0,74.125.130.0-255,153,153,96,272930
44681,2.9e-05,172.31.47.0-255,66,219,96,272930
44682,3.6e-05,74.125.130.0-255,1484,1703,96,272930
44683,4.1e-05,172.31.47.0-255,66,1769,96,272930
44684,4.5e-05,74.125.130.0-255,2902,4671,96,272930
44685,4.8e-05,172.31.47.0-255,66,4737,96,272930
44686,7.2e-05,74.125.130.0-255,4320,9057,96,272930
44687,7.5e-05,172.31.47.0-255,66,9123,96,272930
44688,0.000106,74.125.130.0-255,4814,13937,96,272930
44689,0.00011,172.31.47.0-255,66,14003,96,272930
44690,0.000123,74.125.130.0-255,2902,16905,96,272930
44691,0.000125,172.31.47.0-255,66,16971,96,272930
44692,0.000143,74.125.130.0-255,1484,18455,96,272930
44693,0.000145,172.31.47.0-255,66,18521,96,272930
44694,0.000166,74.125.130.0-255,2902,21423,96,272930
44695,0.000169,172.31.47.0-255,66,21489,96,272930
44696,0.000171,74.125.130.0-255,1484,22973,96,272930
44697,0.000173,172.31.47.0-255,66,23039,96,272930
44698,0.000194,74.125.130.0-255,4320,27359,96,272930
44699,0.000197,172.31.47.0-255,66,27425,96,272930
44700,0.000219,74.125.130.0-255,3961,31386,96,272930
44701,0.000223,172.31.47.0-255,66,31452,96,272930
44702,0.000569,74.125.130.0-255,1484,32936,96,272930
44703,0.000573,172.31.47.0-255,66,33002,96,272930
44704,0.000581,74.125.130.0-255,1484,34486,96,272930
44705,0.000583,172.31.47.0-255,66,34552,96,272930
44706,0.000605,74.125.130.0-255,2902,37454,96,272930
44707,0.000608,172.31.47.0-255,66,37520,96,272930
44708,0.000652,74.125.130.0-255,2902,40422,96,272930
44709,0.000655,172.31.47.0-255,66,40488,96,272930
44710,0.000675,74.125.130.0-255,2902,43390,96,272930
44711,0.000678,172.31.47.0-255,66,43456,96,272930
44712,0.000683,74.125.130.0-255,5379,48835,96,272930
44713,0.000685,172.31.47.0-255,66,48901,96,272930
44714,0.000708,74.125.130.0-255,1484,50385,96,272930
44715,0.000727,74.125.130.0-255,4320,54705,96,272930
44716,0.00073,172.31.47.0-255,66,54771,96,272930
44717,0.000735,74.125.130.0-255,4320,59091,96,272930
44718,0.000737,172.31.47.0-255,66,59157,96,272930
44719,0.000739,74.125.130.0-255,1484,60641,96,272930
44720,0.000766,74.125.130.0-255,4320,64961,96,272930
44721,0.000769,172.31.47.0-255,66,65027,96,272930
44722,0.000787,74.125.130.0-255,1414,66441,96,272930
44723,0.000801,74.125.130.0-255,98,66539,96,272930
44724,0.000895,74.125.130.0-255,1484,68023,96,272930
44725,0.0009,172.31.47.0-255,66,68089,96,272930
44726,0.000914,74.125.130.0-255,2902,70991,96,272930
44727,0.000917,172.31.47.0-255,66,71057,96,272930
44728,0.000932,74.125.130.0-255,2902,73959,96,272930
44729,0.000935,172.31.47.0-255,66,74025,96,272930
44730,0.000959,74.125.130.0-255,4320,78345,96,272930
44731,0.000963,172.31.47.0-255,66,78411,96,272930
44732,0.000968,74.125.130.0-255,4320,82731,96,272930
44733,0.00097,172.31.47.0-255,66,82797,96,272930
44734,0.000985,74.125.130.0-255,4320,87117,96,272930
44735,0.000988,172.31.47.0-255,66,87183,96,272930
44736,0.000993,74.125.130.0-255,4320,91503,96,272930
44737,0.000995,172.31.47.0-255,66,91569,96,272930
44738,0.000999,74.125.130.0-255,5738,97307,96,272930
44739,0.001001,172.31.47.0-255,66,97373,96,272930
44740,0.001044,74.125.130.0-255,3902,101275,96,272930
44741,0.001049,172.31.47.0-255,66,101341,96,272930
44742,0.004436,74.125.130.0-255,1484,102825,96,272930
44743,0.004453,74.125.130.0-255,2902,105727,96,272930
44744,0.004457,172.31.47.0-255,66,105793,96,272930
44745,0.004469,74.125.130.0-255,1484,107277,96,272930
44746,0.006793,74.125.130.0-255,4320,111597,96,272930
44747,0.006799,172.31.47.0-255,66,111663,96,272930
44748,0.009113,74.125.130.0-255,5738,117401,96,272930
44749,0.00912,172.31.47.0-255,66,117467,96,272930
44750,0.01142,74.125.130.0-255,5738,123205,96,272930
44751,0.011427,172.31.47.0-255,66,123271,96,272930
44752,0.013731,74.125.130.0-255,5738,129009,96,272930
44753,0.013739,172.31.47.0-255,66,129075,96,272930
44754,0.01604,74.125.130.0-255,5738,134813,96,272930
44755,0.016048,172.31.47.0-255,66,134879,96,272930
44756,0.018366,74.125.130.0-255,2902,137781,96,272930
44757,0.018374,172.31.47.0-255,66,137847,96,272930
44758,0.018395,74.125.130.0-255,2902,140749,96,272930
44759,0.018398,172.31.47.0-255,66,140815,96,272930
44760,0.01871,172.31.47.0-255,172,140987,96,272930
44761,0.018742,172.31.47.0-255,1110,142097,96,272930
44762,0.018781,172.31.47.0-255,1514,143611,96,272930
44763,0.018783,172.31.47.0-255,1301,144912,96,272930
44764,0.020275,104.244.42.0-255,66,144978,96,272930
44765,0.02032,104.244.42.0-255,66,145044,96,272930
44766,0.020372,104.244.42.0-255,66,145110,96,272930
44767,0.020671,74.125.130.0-255,2902,148012,96,272930
44768,0.020677,172.31.47.0-255,66,148078,96,272930
44769,0.020701,74.125.130.0-255,2902,150980,96,272930
44770,0.020704,172.31.47.0-255,66,151046,96,272930
44771,0.022987,74.125.130.0-255,5738,156784,96,272930
44772,0.022992,172.31.47.0-255,66,156850,96,272930
44773,0.025296,74.125.130.0-255,5738,162588,96,272930
44774,0.025303,172.31.47.0-255,66,162654,96,272930
44775,0.027616,74.125.130.0-255,5738,168392,96,272930
44776,0.027623,172.31.47.0-255,66,168458,96,272930
44777,0.029943,74.125.130.0-255,5738,174196,96,272930
44778,0.029951,172.31.47.0-255,66,174262,96,272930
44779,0.032255,74.125.130.0-255,5738,180000,96,272930
44780,0.032261,172.31.47.0-255,66,180066,96,272930
44781,0.03458,74.125.130.0-255,5738,185804,96,272930
44782,0.034587,172.31.47.0-255,66,185870,96,272930
44783,0.036895,74.125.130.0-255,5738,191608,96,272930
44784,0.036902,172.31.47.0-255,66,191674,96,272930
44785,0.039212,74.125.130.0-255,5738,197412,96,272930
44786,0.039217,172.31.47.0-255,66,197478,96,272930
44787,0.041527,74.125.130.0-255,5738,203216,96,272930
44788,0.041532,172.31.47.0-255,66,203282,96,272930
44789,0.043851,74.125.130.0-255,5738,209020,96,272930
44790,0.043857,172.31.47.0-255,66,209086,96,272930
44791,0.046178,74.125.130.0-255,5738,214824,96,272930
44792,0.046187,172.31.47.0-255,66,214890,96,272930
44793,0.048501,74.125.130.0-255,5738,220628,96,272930
44794,0.048509,172.31.47.0-255,66,220694,96,272930
44795,0.050822,74.125.130.0-255,5738,226432,96,272930
44796,0.050829,172.31.47.0-255,66,226498,96,272930
44797,0.053128,74.125.130.0-255,5738,232236,96,272930
44798,0.053134,172.31.47.0-255,66,232302,96,272930
44799,0.055443,74.125.130.0-255,5738,238040,96,272930
44800,0.055448,172.31.47.0-255,66,238106,96,272930
44801,0.057744,74.125.130.0-255,5738,243844,96,272930
44802,0.057749,172.31.47.0-255,66,243910,96,272930
44803,0.060058,74.125.130.0-255,5738,249648,96,272930
44804,0.060065,172.31.47.0-255,66,249714,96,272930
44805,0.062377,74.125.130.0-255,5738,255452,96,272930
44806,0.062383,172.31.47.0-255,66,255518,96,272930
44807,0.064691,74.125.130.0-255,5738,261256,96,272930
44808,0.064697,172.31.47.0-255,66,261322,96,272930
44809,0.067017,74.125.130.0-255,5738,267060,96,272930
44810,0.067023,172.31.47.0-255,66,267126,96,272930
44811,0.069327,74.125.130.0-255,5738,272864,96,272930
44812,0.069332,172.31.47.0-255,66,272930,96,272930
44813,0.0,74.125.200.0-255,153,153,96,324986
44814,3.3e-05,172.31.47.0-255,66,219,96,324986
44815,3.9e-05,74.125.200.0-255,1484,1703,96,324986
44816,4.3e-05,172.31.47.0-255,66,1769,96,324986
44817,4.8e-05,74.125.200.0-255,2902,4671,96,324986
44818,5.1e-05,172.31.47.0-255,66,4737,96,324986
44819,5.7e-05,74.125.200.0-255,5738,10475,96,324986
44820,6e-05,172.31.47.0-255,66,10541,96,324986
44821,8.1e-05,74.125.200.0-255,3584,14125,96,324986
44822,8.4e-05,172.31.47.0-255,66,14191,96,324986
44823,0.000113,74.125.200.0-255,4320,18511,96,324986
44824,0.000117,172.31.47.0-255,66,18577,96,324986
44825,0.000147,74.125.200.0-255,5738,24315,96,324986
44826,0.000151,172.31.47.0-255,66,24381,96,324986
44827,0.000173,74.125.200.0-255,2902,27283,96,324986
44828,0.000175,172.31.47.0-255,66,27349,96,324986
44829,0.000188,172.31.47.0-255,66,27415,96,324986
44830,0.000195,74.125.200.0-255,7156,34571,96,324986
44831,0.000198,172.31.47.0-255,66,34637,96,324986
44832,0.000229,74.125.200.0-255,1484,36121,96,324986
44833,0.000232,172.31.47.0-255,66,36187,96,324986
44834,0.000251,74.125.200.0-255,2184,38371,96,324986
44835,0.000254,172.31.47.0-255,66,38437,96,324986
44836,0.000714,74.125.200.0-255,1484,39921,96,324986
44837,0.00072,172.31.47.0-255,66,39987,96,324986
44838,0.000728,74.125.200.0-255,2902,42889,96,324986
44839,0.00073,172.31.47.0-255,66,42955,96,324986
44840,0.000761,74.125.200.0-255,5738,48693,96,324986
44841,0.000765,172.31.47.0-255,66,48759,96,324986
44842,0.000771,74.125.200.0-255,7070,55829,96,324986
44843,0.000773,172.31.47.0-255,66,55895,96,324986
44844,0.000776,74.125.200.0-255,132,56027,96,324986
44845,0.001157,74.125.200.0-255,1484,57511,96,324986
44846,0.001163,172.31.47.0-255,66,57577,96,324986
44847,0.001168,74.125.200.0-255,2902,60479,96,324986
44848,0.00117,172.31.47.0-255,66,60545,96,324986
44849,0.001199,74.125.200.0-255,5738,66283,96,324986
44850,0.001201,172.31.47.0-255,66,66349,96,324986
44851,0.001205,74.125.200.0-255,4320,70669,96,324986
44852,0.001207,172.31.47.0-255,66,70735,96,324986
44853,0.001212,74.125.200.0-255,4320,75055,96,324986
44854,0.001213,172.31.47.0-255,66,75121,96,324986
44855,0.001235,74.125.200.0-255,1484,76605,96,324986
44856,0.001265,172.31.47.0-255,66,76671,96,324986
44857,0.0013,74.125.200.0-255,2184,78855,96,324986
44858,0.001303,172.31.47.0-255,66,78921,96,324986
44859,0.001406,74.125.200.0-255,1484,80405,96,324986
44860,0.001417,74.125.200.0-255,2902,83307,96,324986
44861,0.001419,172.31.47.0-255,66,83373,96,324986
44862,0.00145,74.125.200.0-255,4320,87693,96,324986
44863,0.001452,172.31.47.0-255,66,87759,96,324986
44864,0.001506,74.125.200.0-255,2902,90661,96,324986
44865,0.001508,172.31.47.0-255,66,90727,96,324986
44866,0.001523,74.125.200.0-255,4320,95047,96,324986
44867,0.001526,172.31.47.0-255,66,95113,96,324986
44868,0.001558,172.31.47.0-255,66,95179,96,324986
44869,0.001561,74.125.200.0-255,2902,98081,96,324986
44870,0.001563,172.31.47.0-255,66,98147,96,324986
44871,0.001599,74.125.200.0-255,4320,102467,96,324986
44872,0.001602,172.31.47.0-255,66,102533,96,324986
44873,0.001632,172.31.47.0-255,66,102599,96,324986
44874,0.001636,74.125.200.0-255,4320,106919,96,324986
44875,0.001638,172.31.47.0-255,66,106985,96,324986
44876,0.001708,172.31.47.0-255,66,107051,96,324986
44877,0.001712,74.125.200.0-255,2184,109235,96,324986
44878,0.001713,172.31.47.0-255,66,109301,96,324986
44879,0.001725,74.125.200.0-255,1484,110785,96,324986
44880,0.001742,74.125.200.0-255,2902,113687,96,324986
44881,0.001744,172.31.47.0-255,66,113753,96,324986
44882,0.001772,74.125.200.0-255,4320,118073,96,324986
44883,0.001774,172.31.47.0-255,66,118139,96,324986
44884,0.001778,74.125.200.0-255,2902,121041,96,324986
44885,0.00178,172.31.47.0-255,66,121107,96,324986
44886,0.001794,74.125.200.0-255,2902,124009,96,324986
44887,0.001796,172.31.47.0-255,66,124075,96,324986
44888,0.001808,74.125.200.0-255,2902,126977,96,324986
44889,0.001809,172.31.47.0-255,66,127043,96,324986
44890,0.001827,172.31.47.0-255,66,127109,96,324986
44891,0.001831,74.125.200.0-255,4320,131429,96,324986
44892,0.001832,172.31.47.0-255,66,131495,96,324986
44893,0.001881,74.125.200.0-255,3602,135097,96,324986
44894,0.001883,172.31.47.0-255,66,135163,96,324986
44895,0.001904,74.125.200.0-255,1484,136647,96,324986
44896,0.001916,74.125.200.0-255,2902,139549,96,324986
44897,0.001918,172.31.47.0-255,66,139615,96,324986
44898,0.00194,74.125.200.0-255,5738,145353,96,324986
44899,0.001942,172.31.47.0-255,66,145419,96,324986
44900,0.001948,74.125.200.0-255,7156,152575,96,324986
44901,0.001949,172.31.47.0-255,66,152641,96,324986
44902,0.001967,74.125.200.0-255,1484,154125,96,324986
44903,0.001983,74.125.200.0-255,7156,161281,96,324986
44904,0.001985,172.31.47.0-255,66,161347,96,324986
44905,0.002005,74.125.200.0-255,5738,167085,96,324986
44906,0.002007,172.31.47.0-255,66,167151,96,324986
44907,0.002037,74.125.200.0-255,5738,172889,96,324986
44908,0.00204,172.31.47.0-255,66,172955,96,324986
44909,0.002067,172.31.47.0-255,66,173021,96,324986
44910,0.002098,74.125.200.0-255,4320,177341,96,324986
44911,0.002103,74.125.200.0-255,4320,181661,96,324986
44912,0.002133,74.125.200.0-255,2184,183845,96,324986
44913,0.002137,74.125.200.0-255,2902,186747,96,324986
44914,0.002164,74.125.200.0-255,7156,193903,96,324986
44915,0.002193,74.125.200.0-255,5738,199641,96,324986
44916,0.002198,74.125.200.0-255,4320,203961,96,324986
44917,0.002214,74.125.200.0-255,2902,206863,96,324986
44918,0.00223,74.125.200.0-255,4320,211183,96,324986
44919,0.002243,74.125.200.0-255,1484,212667,96,324986
44920,0.002256,74.125.200.0-255,3602,216269,96,324986
44921,0.002311,74.125.200.0-255,1484,217753,96,324986
44922,0.002316,74.125.200.0-255,2902,220655,96,324986
44923,0.002319,74.125.200.0-255,1484,222139,96,324986
44924,0.002334,74.125.200.0-255,2902,225041,96,324986
44925,0.002362,74.125.200.0-255,5738,230779,96,324986
44926,0.002381,74.125.200.0-255,5738,236517,96,324986
44927,0.002403,74.125.200.0-255,7156,243673,96,324986
44928,0.002459,74.125.200.0-255,6438,250111,96,324986
44929,0.002465,74.125.200.0-255,5738,255849,96,324986
44930,0.00248,74.125.200.0-255,1484,257333,96,324986
44931,0.002514,74.125.200.0-255,5738,263071,96,324986
44932,0.002526,74.125.200.0-255,4320,267391,96,324986
44933,0.002529,74.125.200.0-255,1484,268875,96,324986
44934,0.002549,74.125.200.0-255,6438,275313,96,324986
44935,0.006302,172.31.47.0-255,66,275379,96,324986
44936,0.008865,74.125.200.0-255,5738,281117,96,324986
44937,0.008871,172.31.47.0-255,66,281183,96,324986
44938,0.011427,74.125.200.0-255,4320,285503,96,324986
44939,0.011435,172.31.47.0-255,66,285569,96,324986
44940,0.011456,74.125.200.0-255,1484,287053,96,324986
44941,0.013975,74.125.200.0-255,4320,291373,96,324986
44942,0.013981,172.31.47.0-255,66,291439,96,324986
44943,0.016526,74.125.200.0-255,5738,297177,96,324986
44944,0.016533,172.31.47.0-255,66,297243,96,324986
44945,0.01907,74.125.200.0-255,4320,301563,96,324986
44946,0.019076,172.31.47.0-255,66,301629,96,324986
44947,0.019093,74.125.200.0-255,1484,303113,96,324986
44948,0.021622,74.125.200.0-255,4320,307433,96,324986
44949,0.021633,172.31.47.0-255,66,307499,96,324986
44950,0.024183,74.125.200.0-255,5738,313237,96,324986
44951,0.024196,172.31.47.0-255,66,313303,96,324986
44952,0.026758,74.125.200.0-255,5738,319041,96,324986
44953,0.026771,172.31.47.0-255,66,319107,96,324986
44954,0.029308,74.125.200.0-255,1347,320454,96,324986
44955,0.029452,172.31.47.0-255,66,320520,96,324986
44956,0.029487,172.31.47.0-255,105,320625,96,324986
44957,0.03199,74.125.200.0-255,66,320691,96,324986
44958,0.03225,172.31.47.0-255,172,320863,96,324986
44959,0.032276,172.31.47.0-255,1109,321972,96,324986
44960,0.032339,172.31.47.0-255,1514,323486,96,324986
44961,0.03234,172.31.47.0-255,1302,324788,96,324986
44962,0.033769,104.244.42.0-255,66,324854,96,324986
44963,0.033794,104.244.42.0-255,66,324920,96,324986
44964,0.033858,104.244.42.0-255,66,324986,96,324986
44965,0.0,172.31.47.0-255,105,105,96,276
44966,0.002077,157.240.13.0-255,105,210,96,276
44967,0.002089,172.31.47.0-255,66,276,96,276
44968,0.0,172.31.47.0-255,105,105,96,276
44969,0.068327,31.13.82.0-255,105,210,96,276
44970,0.068348,172.31.47.0-255,66,276,96,276
44971,0.0,172.31.47.0-255,105,105,96,276
44972,0.001539,157.240.13.0-255,105,210,96,276
44973,0.039061,172.31.47.0-255,66,276,96,276
44974,0.0,74.125.68.0-255,153,153,96,352776
44975,3.4e-05,172.31.47.0-255,66,219,96,352776
44976,4.1e-05,74.125.68.0-255,1484,1703,96,352776
44977,4.5e-05,172.31.47.0-255,66,1769,96,352776
44978,4.9e-05,74.125.68.0-255,2902,4671,96,352776
44979,5.1e-05,172.31.47.0-255,66,4737,96,352776
44980,7.3e-05,74.125.68.0-255,1484,6221,96,352776
44981,7.5e-05,172.31.47.0-255,66,6287,96,352776
44982,0.000111,74.125.68.0-255,4320,10607,96,352776
44983,0.000114,172.31.47.0-255,66,10673,96,352776
44984,0.000119,74.125.68.0-255,4976,15649,96,352776
44985,0.000121,172.31.47.0-255,66,15715,96,352776
44986,0.000149,74.125.68.0-255,5738,21453,96,352776
44987,0.000153,172.31.47.0-255,66,21519,96,352776
44988,0.000163,172.31.47.0-255,66,21585,96,352776
44989,0.000386,74.125.68.0-255,1484,23069,96,352776
44990,0.000391,172.31.47.0-255,66,23135,96,352776
44991,0.000395,74.125.68.0-255,1484,24619,96,352776
44992,0.000396,172.31.47.0-255,66,24685,96,352776
44993,0.000401,74.125.68.0-255,2902,27587,96,352776
44994,0.000411,172.31.47.0-255,66,27653,96,352776
44995,0.000448,74.125.68.0-255,5738,33391,96,352776
44996,0.00045,172.31.47.0-255,66,33457,96,352776
44997,0.000454,74.125.68.0-255,2902,36359,96,352776
44998,0.000456,172.31.47.0-255,66,36425,96,352776
44999,0.000459,74.125.68.0-255,1484,37909,96,352776
45000,0.00046,172.31.47.0-255,66,37975,96,352776
45001,0.000497,74.125.68.0-255,2543,40518,96,352776
45002,0.0005,172.31.47.0-255,66,40584,96,352776
45003,0.000507,74.125.68.0-255,7156,47740,96,352776
45004,0.000509,172.31.47.0-255,66,47806,96,352776
45005,0.000544,172.31.47.0-255,66,47872,96,352776
45006,0.000546,74.125.68.0-255,135,48007,96,352776
45007,0.000548,172.31.47.0-255,66,48073,96,352776
45008,0.000571,74.125.68.0-255,348,48421,96,352776
45009,0.000573,172.31.47.0-255,66,48487,96,352776
45010,0.000736,74.125.68.0-255,1484,49971,96,352776
45011,0.00074,172.31.47.0-255,66,50037,96,352776
45012,0.000762,74.125.68.0-255,2902,52939,96,352776
45013,0.000765,172.31.47.0-255,66,53005,96,352776
45014,0.000768,74.125.68.0-255,1484,54489,96,352776
45015,0.00077,172.31.47.0-255,66,54555,96,352776
45016,0.000791,74.125.68.0-255,2902,57457,96,352776
45017,0.000793,172.31.47.0-255,66,57523,96,352776
45018,0.000795,74.125.68.0-255,1484,59007,96,352776
45019,0.000799,172.31.47.0-255,66,59073,96,352776
45020,0.000828,74.125.68.0-255,7156,66229,96,352776
45021,0.00083,172.31.47.0-255,66,66295,96,352776
45022,0.000838,74.125.68.0-255,2902,69197,96,352776
45023,0.00084,172.31.47.0-255,66,69263,96,352776
45024,0.000859,74.125.68.0-255,4320,73583,96,352776
45025,0.000864,172.31.47.0-255,66,73649,96,352776
45026,0.000891,74.125.68.0-255,5738,79387,96,352776
45027,0.000899,172.31.47.0-255,66,79453,96,352776
45028,0.00091,74.125.68.0-255,3602,83055,96,352776
45029,0.000913,172.31.47.0-255,66,83121,96,352776
45030,0.001723,74.125.68.0-255,1484,84605,96,352776
45031,0.00173,172.31.47.0-255,66,84671,96,352776
45032,0.001758,74.125.68.0-255,1484,86155,96,352776
45033,0.00176,172.31.47.0-255,66,86221,96,352776
45034,0.001766,74.125.68.0-255,2902,89123,96,352776
45035,0.001771,74.125.68.0-255,2902,92025,96,352776
45036,0.001786,74.125.68.0-255,2902,94927,96,352776
45037,0.00179,74.125.68.0-255,2902,97829,96,352776
45038,0.001793,74.125.68.0-255,1484,99313,96,352776
45039,0.001811,74.125.68.0-255,2902,102215,96,352776
45040,0.001836,74.125.68.0-255,4320,106535,96,352776
45041,0.001853,74.125.68.0-255,4320,110855,96,352776
45042,0.00188,74.125.68.0-255,1484,112339,96,352776
45043,0.001897,74.125.68.0-255,5020,117359,96,352776
45044,0.001935,74.125.68.0-255,2902,120261,96,352776
45045,0.001945,74.125.68.0-255,2902,123163,96,352776
45046,0.001982,74.125.68.0-255,1484,124647,96,352776
45047,0.002,74.125.68.0-255,2902,127549,96,352776
45048,0.002021,74.125.68.0-255,5738,133287,96,352776
45049,0.00204,74.125.68.0-255,4320,137607,96,352776
45050,0.00207,74.125.68.0-255,5738,143345,96,352776
45051,0.002086,74.125.68.0-255,1484,144829,96,352776
45052,0.002105,74.125.68.0-255,2902,147731,96,352776
45053,0.002131,74.125.68.0-255,5738,153469,96,352776
45054,0.002141,74.125.68.0-255,766,154235,96,352776
45055,0.002145,74.125.68.0-255,2902,157137,96,352776
45056,0.002149,74.125.68.0-255,4320,161457,96,352776
45057,0.002174,74.125.68.0-255,5738,167195,96,352776
45058,0.00219,74.125.68.0-255,2902,170097,96,352776
45059,0.002196,74.125.68.0-255,5738,175835,96,352776
45060,0.002207,74.125.68.0-255,1484,177319,96,352776
45061,0.002226,74.125.68.0-255,5738,183057,96,352776
45062,0.002237,74.125.68.0-255,2184,185241,96,352776
45063,0.003963,172.31.47.0-255,66,185307,96,352776
45064,0.006304,74.125.68.0-255,2902,188209,96,352776
45065,0.006309,172.31.47.0-255,66,188275,96,352776
45066,0.00634,74.125.68.0-255,2902,191177,96,352776
45067,0.006355,172.31.47.0-255,66,191243,96,352776
45068,0.008622,74.125.68.0-255,1484,192727,96,352776
45069,0.008629,172.31.47.0-255,66,192793,96,352776
45070,0.008697,74.125.68.0-255,4320,197113,96,352776
45071,0.009291,172.31.47.0-255,66,197179,96,352776
45072,0.010955,74.125.68.0-255,1484,198663,96,352776
45073,0.011603,74.125.68.0-255,4320,202983,96,352776
45074,0.011608,172.31.47.0-255,66,203049,96,352776
45075,0.013928,74.125.68.0-255,5738,208787,96,352776
45076,0.014055,172.31.47.0-255,66,208853,96,352776
45077,0.016378,74.125.68.0-255,2902,211755,96,352776
45078,0.016385,172.31.47.0-255,66,211821,96,352776
45079,0.016419,74.125.68.0-255,2902,214723,96,352776
45080,0.016437,172.31.47.0-255,66,214789,96,352776
45081,0.018697,74.125.68.0-255,2902,217691,96,352776
45082,0.018704,172.31.47.0-255,66,217757,96,352776
45083,0.018748,74.125.68.0-255,2902,220659,96,352776
45084,0.018758,172.31.47.0-255,66,220725,96,352776
45085,0.021024,74.125.68.0-255,2902,223627,96,352776
45086,0.021032,172.31.47.0-255,66,223693,96,352776
45087,0.021075,74.125.68.0-255,2902,226595,96,352776
45088,0.02109,172.31.47.0-255,66,226661,96,352776
45089,0.02304,172.31.47.0-255,172,226833,96,352776
45090,0.023069,172.31.47.0-255,1104,227937,96,352776
45091,0.02311,172.31.47.0-255,1514,229451,96,352776
45092,0.023112,172.31.47.0-255,1307,230758,96,352776
45093,0.023345,74.125.68.0-255,2902,233660,96,352776
45094,0.023352,172.31.47.0-255,66,233726,96,352776
45095,0.023382,74.125.68.0-255,1484,235210,96,352776
45096,0.023396,74.125.68.0-255,1484,236694,96,352776
45097,0.024608,104.244.42.0-255,66,236760,96,352776
45098,0.024634,104.244.42.0-255,66,236826,96,352776
45099,0.024687,104.244.42.0-255,66,236892,96,352776
45100,0.025399,172.31.47.0-255,66,236958,96,352776
45101,0.025666,74.125.68.0-255,2902,239860,96,352776
45102,0.025673,172.31.47.0-255,66,239926,96,352776
45103,0.027713,74.125.68.0-255,2902,242828,96,352776
45104,0.027729,172.31.47.0-255,66,242894,96,352776
45105,0.027984,74.125.68.0-255,2902,245796,96,352776
45106,0.02799,172.31.47.0-255,66,245862,96,352776
45107,0.030055,74.125.68.0-255,2902,248764,96,352776
45108,0.030072,172.31.47.0-255,66,248830,96,352776
45109,0.030297,74.125.68.0-255,2902,251732,96,352776
45110,0.030301,172.31.47.0-255,66,251798,96,352776
45111,0.032386,74.125.68.0-255,2902,254700,96,352776
45112,0.032402,172.31.47.0-255,66,254766,96,352776
45113,0.032602,74.125.68.0-255,2902,257668,96,352776
45114,0.032607,172.31.47.0-255,66,257734,96,352776
45115,0.034725,74.125.68.0-255,2902,260636,96,352776
45116,0.034731,172.31.47.0-255,66,260702,96,352776
45117,0.034918,74.125.68.0-255,2902,263604,96,352776
45118,0.034923,172.31.47.0-255,66,263670,96,352776
45119,0.037041,74.125.68.0-255,1484,265154,96,352776
45120,0.037072,74.125.68.0-255,1484,266638,96,352776
45121,0.037076,172.31.47.0-255,66,266704,96,352776
45122,0.037222,74.125.68.0-255,2902,269606,96,352776
45123,0.037228,172.31.47.0-255,66,269672,96,352776
45124,0.039387,74.125.68.0-255,2902,272574,96,352776
45125,0.039393,172.31.47.0-255,66,272640,96,352776
45126,0.039531,74.125.68.0-255,2902,275542,96,352776
45127,0.039536,172.31.47.0-255,66,275608,96,352776
45128,0.041717,74.125.68.0-255,2902,278510,96,352776
45129,0.041722,172.31.47.0-255,66,278576,96,352776
45130,0.041845,74.125.68.0-255,2902,281478,96,352776
45131,0.04185,172.31.47.0-255,66,281544,96,352776
45132,0.04405,74.125.68.0-255,2902,284446,96,352776
45133,0.044064,172.31.47.0-255,66,284512,96,352776
45134,0.044156,74.125.68.0-255,2902,287414,96,352776
45135,0.0442,172.31.47.0-255,66,287480,96,352776
45136,0.046371,74.125.68.0-255,2902,290382,96,352776
45137,0.046377,172.31.47.0-255,66,290448,96,352776
45138,0.046509,74.125.68.0-255,2902,293350,96,352776
45139,0.046513,172.31.47.0-255,66,293416,96,352776
45140,0.048693,74.125.68.0-255,2902,296318,96,352776
45141,0.048704,172.31.47.0-255,66,296384,96,352776
45142,0.048817,74.125.68.0-255,2902,299286,96,352776
45143,0.048851,172.31.47.0-255,66,299352,96,352776
45144,0.051024,74.125.68.0-255,2902,302254,96,352776
45145,0.051034,172.31.47.0-255,66,302320,96,352776
45146,0.051175,74.125.68.0-255,2902,305222,96,352776
45147,0.05118,172.31.47.0-255,66,305288,96,352776
45148,0.053358,74.125.68.0-255,2902,308190,96,352776
45149,0.053364,172.31.47.0-255,66,308256,96,352776
45150,0.053485,74.125.68.0-255,2902,311158,96,352776
45151,0.05349,172.31.47.0-255,66,311224,96,352776
45152,0.055672,74.125.68.0-255,2902,314126,96,352776
45153,0.055677,172.31.47.0-255,66,314192,96,352776
45154,0.055815,74.125.68.0-255,2902,317094,96,352776
45155,0.05582,172.31.47.0-255,66,317160,96,352776
45156,0.057988,74.125.68.0-255,2902,320062,96,352776
45157,0.057993,172.31.47.0-255,66,320128,96,352776
45158,0.058117,74.125.68.0-255,2902,323030,96,352776
45159,0.058121,172.31.47.0-255,66,323096,96,352776
45160,0.060312,74.125.68.0-255,2902,325998,96,352776
45161,0.060321,172.31.47.0-255,66,326064,96,352776
45162,0.060438,74.125.68.0-255,2902,328966,96,352776
45163,0.060447,172.31.47.0-255,66,329032,96,352776
45164,0.062644,74.125.68.0-255,2902,331934,96,352776
45165,0.062654,172.31.47.0-255,66,332000,96,352776
45166,0.062764,74.125.68.0-255,2902,334902,96,352776
45167,0.062774,172.31.47.0-255,66,334968,96,352776
45168,0.064963,74.125.68.0-255,2902,337870,96,352776
45169,0.064969,172.31.47.0-255,66,337936,96,352776
45170,0.065081,74.125.68.0-255,2902,340838,96,352776
45171,0.065086,172.31.47.0-255,66,340904,96,352776
45172,0.067282,74.125.68.0-255,2902,343806,96,352776
45173,0.067288,172.31.47.0-255,66,343872,96,352776
45174,0.067397,74.125.68.0-255,2902,346774,96,352776
45175,0.067402,172.31.47.0-255,66,346840,96,352776
45176,0.069608,74.125.68.0-255,2902,349742,96,352776
45177,0.069616,172.31.47.0-255,66,349808,96,352776
45178,0.069721,74.125.68.0-255,2902,352710,96,352776
45179,0.069729,172.31.47.0-255,66,352776,96,352776
45180,0.0,172.31.47.0-255,66,66,96,66
45181,0.0,172.217.194.0-255,153,153,96,308398
45182,1.4e-05,172.31.47.0-255,66,219,96,308398
45183,2e-05,172.217.194.0-255,1484,1703,96,308398
45184,2.4e-05,172.31.47.0-255,66,1769,96,308398
45185,2.9e-05,172.217.194.0-255,2902,4671,96,308398
45186,3.1e-05,172.31.47.0-255,66,4737,96,308398
45187,3.7e-05,172.217.194.0-255,5738,10475,96,308398
45188,3.9e-05,172.31.47.0-255,66,10541,96,308398
45189,6e-05,172.217.194.0-255,1484,12025,96,308398
45190,6.3e-05,172.31.47.0-255,66,12091,96,308398
45191,6.8e-05,172.217.194.0-255,2097,14188,96,308398
45192,7e-05,172.31.47.0-255,66,14254,96,308398
45193,8.7e-05,172.217.194.0-255,5738,19992,96,308398
45194,9e-05,172.31.47.0-255,66,20058,96,308398
45195,0.000117,172.217.194.0-255,5738,25796,96,308398
45196,0.000119,172.31.47.0-255,66,25862,96,308398
45197,0.000129,172.31.47.0-255,66,25928,96,308398
45198,0.000164,172.217.194.0-255,4320,30248,96,308398
45199,0.000166,172.31.47.0-255,66,30314,96,308398
45200,0.00019,172.31.47.0-255,66,30380,96,308398
45201,0.000247,172.31.47.0-255,66,30446,96,308398
45202,0.000762,172.217.194.0-255,646,31092,96,308398
45203,0.000768,172.31.47.0-255,66,31158,96,308398
45204,0.000809,172.217.194.0-255,1484,32642,96,308398
45205,0.000813,172.31.47.0-255,66,32708,96,308398
45206,0.000818,172.217.194.0-255,2902,35610,96,308398
45207,0.00082,172.31.47.0-255,66,35676,96,308398
45208,0.000839,172.217.194.0-255,5738,41414,96,308398
45209,0.000841,172.31.47.0-255,66,41480,96,308398
45210,0.000873,172.217.194.0-255,2902,44382,96,308398
45211,0.000876,172.31.47.0-255,66,44448,96,308398
45212,0.000879,172.31.47.0-255,66,44514,96,308398
45213,0.000887,172.217.194.0-255,1484,45998,96,308398
45214,0.000917,172.217.194.0-255,4320,50318,96,308398
45215,0.000919,172.31.47.0-255,66,50384,96,308398
45216,0.000938,172.217.194.0-255,2184,52568,96,308398
45217,0.00094,172.31.47.0-255,66,52634,96,308398
45218,0.000943,172.217.194.0-255,1484,54118,96,308398
45219,0.000967,172.217.194.0-255,5738,59856,96,308398
45220,0.00097,172.31.47.0-255,66,59922,96,308398
45221,0.000977,172.217.194.0-255,7156,67078,96,308398
45222,0.00098,172.31.47.0-255,66,67144,96,308398
45223,0.000999,172.217.194.0-255,4320,71464,96,308398
45224,0.001001,172.31.47.0-255,66,71530,96,308398
45225,0.001019,172.217.194.0-255,2902,74432,96,308398
45226,0.001022,172.31.47.0-255,66,74498,96,308398
45227,0.001049,172.31.47.0-255,66,74564,96,308398
45228,0.001055,172.217.194.0-255,4320,78884,96,308398
45229,0.001058,172.31.47.0-255,66,78950,96,308398
45230,0.001083,172.31.47.0-255,66,79016,96,308398
45231,0.001095,172.31.47.0-255,66,79082,96,308398
45232,0.001115,172.217.194.0-255,5738,84820,96,308398
45233,0.001118,172.31.47.0-255,66,84886,96,308398
45234,0.001122,172.217.194.0-255,2184,87070,96,308398
45235,0.001124,172.31.47.0-255,66,87136,96,308398
45236,0.001335,172.217.194.0-255,1484,88620,96,308398
45237,0.001341,172.217.194.0-255,2902,91522,96,308398
45238,0.001345,172.31.47.0-255,66,91588,96,308398
45239,0.001352,172.217.194.0-255,5738,97326,96,308398
45240,0.001354,172.31.47.0-255,66,97392,96,308398
45241,0.001397,172.217.194.0-255,4320,101712,96,308398
45242,0.001408,172.31.47.0-255,66,101778,96,308398
45243,0.001411,172.31.47.0-255,66,101844,96,308398
45244,0.001429,172.217.194.0-255,4320,106164,96,308398
45245,0.001432,172.31.47.0-255,66,106230,96,308398
45246,0.001446,172.217.194.0-255,2184,108414,96,308398
45247,0.001449,172.31.47.0-255,66,108480,96,308398
45248,0.001949,172.217.194.0-255,1484,109964,96,308398
45249,0.001954,172.217.194.0-255,1484,111448,96,308398
45250,0.001957,172.31.47.0-255,66,111514,96,308398
45251,0.001979,172.217.194.0-255,1484,112998,96,308398
45252,0.001986,172.217.194.0-255,5738,118736,96,308398
45253,0.001988,172.31.47.0-255,66,118802,96,308398
45254,0.001991,172.217.194.0-255,1484,120286,96,308398
45255,0.00202,172.31.47.0-255,66,120352,96,308398
45256,0.002074,172.31.47.0-255,66,120418,96,308398
45257,0.004141,172.217.194.0-255,5738,126156,96,308398
45258,0.004149,172.31.47.0-255,66,126222,96,308398
45259,0.006193,172.217.194.0-255,5738,131960,96,308398
45260,0.006199,172.31.47.0-255,66,132026,96,308398
45261,0.00825,172.217.194.0-255,5738,137764,96,308398
45262,0.008257,172.31.47.0-255,66,137830,96,308398
45263,0.010361,172.217.194.0-255,5738,143568,96,308398
45264,0.010368,172.31.47.0-255,66,143634,96,308398
45265,0.012454,172.217.194.0-255,5738,149372,96,308398
45266,0.012471,172.31.47.0-255,66,149438,96,308398
45267,0.014541,172.217.194.0-255,5738,155176,96,308398
45268,0.014555,172.31.47.0-255,66,155242,96,308398
45269,0.016626,172.217.194.0-255,5738,160980,96,308398
45270,0.016641,172.31.47.0-255,66,161046,96,308398
45271,0.018724,172.217.194.0-255,5738,166784,96,308398
45272,0.018738,172.31.47.0-255,66,166850,96,308398
45273,0.020791,172.217.194.0-255,5738,172588,96,308398
45274,0.0208,172.31.47.0-255,66,172654,96,308398
45275,0.022859,172.217.194.0-255,5738,178392,96,308398
45276,0.022866,172.31.47.0-255,66,178458,96,308398
45277,0.024963,172.217.194.0-255,5738,184196,96,308398
45278,0.024973,172.31.47.0-255,66,184262,96,308398
45279,0.027033,172.217.194.0-255,5738,190000,96,308398
45280,0.027042,172.31.47.0-255,66,190066,96,308398
45281,0.029112,172.217.194.0-255,5738,195804,96,308398
45282,0.029119,172.31.47.0-255,66,195870,96,308398
45283,0.031224,172.217.194.0-255,5738,201608,96,308398
45284,0.031234,172.31.47.0-255,66,201674,96,308398
45285,0.033301,172.217.194.0-255,5738,207412,96,308398
45286,0.033309,172.31.47.0-255,66,207478,96,308398
45287,0.035381,172.217.194.0-255,5738,213216,96,308398
45288,0.035396,172.31.47.0-255,66,213282,96,308398
45289,0.037454,172.217.194.0-255,5738,219020,96,308398
45290,0.037462,172.31.47.0-255,66,219086,96,308398
45291,0.039521,172.217.194.0-255,5738,224824,96,308398
45292,0.039531,172.31.47.0-255,66,224890,96,308398
45293,0.041611,172.217.194.0-255,5738,230628,96,308398
45294,0.041628,172.31.47.0-255,66,230694,96,308398
45295,0.043685,172.217.194.0-255,5738,236432,96,308398
45296,0.043692,172.31.47.0-255,66,236498,96,308398
45297,0.045754,172.217.194.0-255,5738,242236,96,308398
45298,0.045761,172.31.47.0-255,66,242302,96,308398
45299,0.04785,172.217.194.0-255,5738,248040,96,308398
45300,0.047867,172.31.47.0-255,66,248106,96,308398
45301,0.049954,172.217.194.0-255,5738,253844,96,308398
45302,0.049969,172.31.47.0-255,66,253910,96,308398
45303,0.052031,172.217.194.0-255,5738,259648,96,308398
45304,0.052038,172.31.47.0-255,66,259714,96,308398
45305,0.054079,172.217.194.0-255,5738,265452,96,308398
45306,0.054086,172.31.47.0-255,66,265518,96,308398
45307,0.055945,172.31.47.0-255,171,265689,96,308398
45308,0.055974,172.31.47.0-255,1125,266814,96,308398
45309,0.056034,172.31.47.0-255,1514,268328,96,308398
45310,0.056036,172.31.47.0-255,1286,269614,96,308398
45311,0.056141,172.217.194.0-255,5738,275352,96,308398
45312,0.056146,172.31.47.0-255,66,275418,96,308398
45313,0.05751,104.244.42.0-255,66,275484,96,308398
45314,0.057518,104.244.42.0-255,66,275550,96,308398
45315,0.057621,104.244.42.0-255,66,275616,96,308398
45316,0.058241,172.217.194.0-255,5738,281354,96,308398
45317,0.058247,172.31.47.0-255,66,281420,96,308398
45318,0.060304,172.217.194.0-255,5738,287158,96,308398
45319,0.060312,172.31.47.0-255,66,287224,96,308398
45320,0.062381,172.217.194.0-255,5738,292962,96,308398
45321,0.062388,172.31.47.0-255,66,293028,96,308398
45322,0.064479,172.217.194.0-255,5738,298766,96,308398
45323,0.064486,172.31.47.0-255,66,298832,96,308398
45324,0.066566,172.217.194.0-255,5738,304570,96,308398
45325,0.066573,172.31.47.0-255,66,304636,96,308398
45326,0.068632,172.217.194.0-255,3591,308227,96,308398
45327,0.068638,172.31.47.0-255,66,308293,96,308398
45328,0.068837,172.31.47.0-255,105,308398,96,308398
45329,0.0,74.125.24.0-255,153,153,96,219165
45330,2.8e-05,172.31.47.0-255,66,219,96,219165
45331,3.4e-05,74.125.24.0-255,1484,1703,96,219165
45332,3.8e-05,172.31.47.0-255,66,1769,96,219165
45333,4.2e-05,74.125.24.0-255,2902,4671,96,219165
45334,4.4e-05,172.31.47.0-255,66,4737,96,219165
45335,7.1e-05,74.125.24.0-255,5738,10475,96,219165
45336,7.3e-05,172.31.47.0-255,66,10541,96,219165
45337,8.8e-05,74.125.24.0-255,5738,16279,96,219165
45338,9.1e-05,172.31.47.0-255,66,16345,96,219165
45339,0.000109,172.31.47.0-255,66,16411,96,219165
45340,0.000143,74.125.24.0-255,2902,19313,96,219165
45341,0.000145,172.31.47.0-255,66,19379,96,219165
45342,0.000164,74.125.24.0-255,3961,23340,96,219165
45343,0.000166,172.31.47.0-255,66,23406,96,219165
45344,0.000206,74.125.24.0-255,1484,24890,96,219165
45345,0.000209,172.31.47.0-255,66,24956,96,219165
45346,0.000224,74.125.24.0-255,2902,27858,96,219165
45347,0.000226,172.31.47.0-255,66,27924,96,219165
45348,0.000229,74.125.24.0-255,1484,29408,96,219165
45349,0.00023,172.31.47.0-255,66,29474,96,219165
45350,0.000249,74.125.24.0-255,2902,32376,96,219165
45351,0.000251,172.31.47.0-255,66,32442,96,219165
45352,0.000269,74.125.24.0-255,2902,35344,96,219165
45353,0.000272,172.31.47.0-255,66,35410,96,219165
45354,0.000293,74.125.24.0-255,5738,41148,96,219165
45355,0.000295,172.31.47.0-255,66,41214,96,219165
45356,0.000304,172.31.47.0-255,66,41280,96,219165
45357,0.000343,74.125.24.0-255,5738,47018,96,219165
45358,0.000347,172.31.47.0-255,66,47084,96,219165
45359,0.000361,74.125.24.0-255,2561,49645,96,219165
45360,0.000363,172.31.47.0-255,66,49711,96,219165
45361,0.000478,74.125.24.0-255,1484,51195,96,219165
45362,0.000483,74.125.24.0-255,1484,52679,96,219165
45363,0.000485,172.31.47.0-255,66,52745,96,219165
45364,0.000505,74.125.24.0-255,1484,54229,96,219165
45365,0.000511,74.125.24.0-255,5738,59967,96,219165
45366,0.000513,172.31.47.0-255,66,60033,96,219165
45367,0.000532,172.31.47.0-255,66,60099,96,219165
45368,0.000544,74.125.24.0-255,2902,63001,96,219165
45369,0.000546,172.31.47.0-255,66,63067,96,219165
45370,0.000553,74.125.24.0-255,7156,70223,96,219165
45371,0.000555,172.31.47.0-255,66,70289,96,219165
45372,0.000567,74.125.24.0-255,3602,73891,96,219165
45373,0.000569,172.31.47.0-255,66,73957,96,219165
45374,0.000571,74.125.24.0-255,332,74289,96,219165
45375,0.000617,74.125.24.0-255,1484,75773,96,219165
45376,0.000619,172.31.47.0-255,66,75839,96,219165
45377,0.000636,74.125.24.0-255,4320,80159,96,219165
45378,0.000639,172.31.47.0-255,66,80225,96,219165
45379,0.000643,74.125.24.0-255,5738,85963,96,219165
45380,0.000645,172.31.47.0-255,66,86029,96,219165
45381,0.000665,74.125.24.0-255,1484,87513,96,219165
45382,0.000703,74.125.24.0-255,7156,94669,96,219165
45383,0.000708,172.31.47.0-255,66,94735,96,219165
45384,0.000725,74.125.24.0-255,2902,97637,96,219165
45385,0.000727,172.31.47.0-255,66,97703,96,219165
45386,0.000738,172.31.47.0-255,66,97769,96,219165
45387,0.000743,74.125.24.0-255,2902,100671,96,219165
45388,0.000745,172.31.47.0-255,66,100737,96,219165
45389,0.000768,74.125.24.0-255,4320,105057,96,219165
45390,0.00077,172.31.47.0-255,66,105123,96,219165
45391,0.000779,172.31.47.0-255,66,105189,96,219165
45392,0.000783,74.125.24.0-255,2902,108091,96,219165
45393,0.000784,172.31.47.0-255,66,108157,96,219165
45394,0.000819,172.31.47.0-255,66,108223,96,219165
45395,0.000822,74.125.24.0-255,766,108989,96,219165
45396,0.001025,74.125.24.0-255,1484,110473,96,219165
45397,0.001029,172.31.47.0-255,66,110539,96,219165
45398,0.001033,74.125.24.0-255,2902,113441,96,219165
45399,0.001035,172.31.47.0-255,66,113507,96,219165
45400,0.001038,74.125.24.0-255,1484,114991,96,219165
45401,0.001057,74.125.24.0-255,4320,119311,96,219165
45402,0.00106,172.31.47.0-255,66,119377,96,219165
45403,0.001062,74.125.24.0-255,5738,125115,96,219165
45404,0.001064,172.31.47.0-255,66,125181,96,219165
45405,0.001082,74.125.24.0-255,1484,126665,96,219165
45406,0.001087,74.125.24.0-255,4320,130985,96,219165
45407,0.001089,172.31.47.0-255,66,131051,96,219165
45408,0.001117,172.31.47.0-255,66,131117,96,219165
45409,0.001121,74.125.24.0-255,2184,133301,96,219165
45410,0.001123,172.31.47.0-255,66,133367,96,219165
45411,0.001166,74.125.24.0-255,1484,134851,96,219165
45412,0.001182,74.125.24.0-255,2902,137753,96,219165
45413,0.001185,172.31.47.0-255,66,137819,96,219165
45414,0.001196,74.125.24.0-255,2902,140721,96,219165
45415,0.001198,172.31.47.0-255,66,140787,96,219165
45416,0.001221,74.125.24.0-255,2902,143689,96,219165
45417,0.001223,172.31.47.0-255,66,143755,96,219165
45418,0.001229,74.125.24.0-255,7156,150911,96,219165
45419,0.001231,172.31.47.0-255,66,150977,96,219165
45420,0.001233,74.125.24.0-255,1484,152461,96,219165
45421,0.001271,172.31.47.0-255,66,152527,96,219165
45422,0.001275,74.125.24.0-255,2184,154711,96,219165
45423,0.001277,172.31.47.0-255,66,154777,96,219165
45424,0.001353,74.125.24.0-255,1484,156261,96,219165
45425,0.001371,74.125.24.0-255,2902,159163,96,219165
45426,0.001374,172.31.47.0-255,66,159229,96,219165
45427,0.00138,74.125.24.0-255,5738,164967,96,219165
45428,0.001382,172.31.47.0-255,66,165033,96,219165
45429,0.001427,172.31.47.0-255,66,165099,96,219165
45430,0.001434,74.125.24.0-255,7156,172255,96,219165
45431,0.001435,172.31.47.0-255,66,172321,96,219165
45432,0.001459,74.125.24.0-255,3602,175923,96,219165
45433,0.001462,172.31.47.0-255,66,175989,96,219165
45434,0.001587,74.125.24.0-255,1484,177473,96,219165
45435,0.001592,74.125.24.0-255,2902,180375,96,219165
45436,0.001595,172.31.47.0-255,66,180441,96,219165
45437,0.0016,74.125.24.0-255,5738,186179,96,219165
45438,0.001602,172.31.47.0-255,66,186245,96,219165
45439,0.001612,74.125.24.0-255,1484,187729,96,219165
45440,0.001644,172.31.47.0-255,66,187795,96,219165
45441,0.001655,172.31.47.0-255,66,187861,96,219165
45442,0.001717,172.31.47.0-255,66,187927,96,219165
45443,0.001749,172.31.47.0-255,66,187993,96,219165
45444,0.001751,74.125.24.0-255,7156,195149,96,219165
45445,0.001752,172.31.47.0-255,66,195215,96,219165
45446,0.001771,74.125.24.0-255,3602,198817,96,219165
45447,0.001774,172.31.47.0-255,66,198883,96,219165
45448,0.001785,172.31.47.0-255,66,198949,96,219165
45449,0.001795,172.31.47.0-255,66,199015,96,219165
45450,0.001821,74.125.24.0-255,3602,202617,96,219165
45451,0.001825,172.31.47.0-255,66,202683,96,219165
45452,0.001839,172.31.47.0-255,66,202749,96,219165
45453,0.001844,74.125.24.0-255,5738,208487,96,219165
45454,0.001846,172.31.47.0-255,66,208553,96,219165
45455,0.001876,172.31.47.0-255,66,208619,96,219165
45456,0.00188,74.125.24.0-255,2902,211521,96,219165
45457,0.001881,172.31.47.0-255,66,211587,96,219165
45458,0.001904,172.31.47.0-255,66,211653,96,219165
45459,0.001906,74.125.24.0-255,105,211758,96,219165
45460,0.002961,172.31.47.0-255,66,211824,96,219165
45461,0.002984,172.31.47.0-255,105,211929,96,219165
45462,0.005448,74.125.24.0-255,66,211995,96,219165
45463,0.026045,172.31.47.0-255,172,212167,96,219165
45464,0.026075,172.31.47.0-255,1105,213272,96,219165
45465,0.026108,172.31.47.0-255,1514,214786,96,219165
45466,0.02611,172.31.47.0-255,1514,216300,96,219165
45467,0.026111,172.31.47.0-255,1514,217814,96,219165
45468,0.026112,172.31.47.0-255,1087,218901,96,219165
45469,0.027525,104.244.42.0-255,66,218967,96,219165
45470,0.027555,104.244.42.0-255,66,219033,96,219165
45471,0.027612,104.244.42.0-255,66,219099,96,219165
45472,0.027615,104.244.42.0-255,66,219165,96,219165
45473,0.0,74.125.68.0-255,146,146,96,329953
45474,2.7e-05,172.31.47.0-255,66,212,96,329953
45475,3.3e-05,74.125.68.0-255,1484,1696,96,329953
45476,3.7e-05,172.31.47.0-255,66,1762,96,329953
45477,3.9e-05,74.125.68.0-255,1484,3246,96,329953
45478,4.1e-05,172.31.47.0-255,66,3312,96,329953
45479,5.8e-05,74.125.68.0-255,1484,4796,96,329953
45480,6.1e-05,172.31.47.0-255,66,4862,96,329953
45481,6.5e-05,74.125.68.0-255,2902,7764,96,329953
45482,6.7e-05,172.31.47.0-255,66,7830,96,329953
45483,8.8e-05,74.125.68.0-255,4320,12150,96,329953
45484,9e-05,172.31.47.0-255,66,12216,96,329953
45485,9.2e-05,74.125.68.0-255,1484,13700,96,329953
45486,9.4e-05,172.31.47.0-255,66,13766,96,329953
45487,0.000116,74.125.68.0-255,6396,20162,96,329953
45488,0.000119,172.31.47.0-255,66,20228,96,329953
45489,0.000124,74.125.68.0-255,5738,25966,96,329953
45490,0.000125,172.31.47.0-255,66,26032,96,329953
45491,0.000143,74.125.68.0-255,4320,30352,96,329953
45492,0.000145,172.31.47.0-255,66,30418,96,329953
45493,0.000167,74.125.68.0-255,2902,33320,96,329953
45494,0.000169,172.31.47.0-255,66,33386,96,329953
45495,0.000196,172.31.47.0-255,66,33452,96,329953
45496,0.00022,74.125.68.0-255,5020,38472,96,329953
45497,0.000222,172.31.47.0-255,66,38538,96,329953
45498,0.000238,74.125.68.0-255,5738,44276,96,329953
45499,0.00024,172.31.47.0-255,66,44342,96,329953
45500,0.00027,74.125.68.0-255,4320,48662,96,329953
45501,0.000273,172.31.47.0-255,66,48728,96,329953
45502,0.000292,74.125.68.0-255,4304,53032,96,329953
45503,0.000295,172.31.47.0-255,66,53098,96,329953
45504,0.000334,74.125.68.0-255,1484,54582,96,329953
45505,0.000337,172.31.47.0-255,66,54648,96,329953
45506,0.000348,74.125.68.0-255,2902,57550,96,329953
45507,0.00035,172.31.47.0-255,66,57616,96,329953
45508,0.000366,74.125.68.0-255,2902,60518,96,329953
45509,0.000369,172.31.47.0-255,66,60584,96,329953
45510,0.000389,74.125.68.0-255,2902,63486,96,329953
45511,0.000392,172.31.47.0-255,66,63552,96,329953
45512,0.000394,74.125.68.0-255,1484,65036,96,329953
45513,0.000396,172.31.47.0-255,66,65102,96,329953
45514,0.000413,74.125.68.0-255,5738,70840,96,329953
45515,0.000416,172.31.47.0-255,66,70906,96,329953
45516,0.000419,74.125.68.0-255,2902,73808,96,329953
45517,0.000421,172.31.47.0-255,66,73874,96,329953
45518,0.000454,172.31.47.0-255,66,73940,96,329953
45519,0.000477,74.125.68.0-255,2902,76842,96,329953
45520,0.00048,172.31.47.0-255,66,76908,96,329953
45521,0.000491,74.125.68.0-255,1043,77951,96,329953
45522,0.000494,172.31.47.0-255,66,78017,96,329953
45523,0.000769,74.125.68.0-255,1484,79501,96,329953
45524,0.000823,74.125.68.0-255,2902,82403,96,329953
45525,0.000827,74.125.68.0-255,2902,85305,96,329953
45526,0.00083,74.125.68.0-255,4320,89625,96,329953
45527,0.000835,74.125.68.0-255,4320,93945,96,329953
45528,0.000853,74.125.68.0-255,4320,98265,96,329953
45529,0.000857,74.125.68.0-255,4320,102585,96,329953
45530,0.00086,74.125.68.0-255,1484,104069,96,329953
45531,0.000874,74.125.68.0-255,4320,108389,96,329953
45532,0.000895,74.125.68.0-255,3602,111991,96,329953
45533,0.001894,74.125.68.0-255,1484,113475,96,329953
45534,0.00191,74.125.68.0-255,2902,116377,96,329953
45535,0.001927,74.125.68.0-255,5738,122115,96,329953
45536,0.001963,74.125.68.0-255,4320,126435,96,329953
45537,0.002033,74.125.68.0-255,1484,127919,96,329953
45538,0.002055,74.125.68.0-255,2902,130821,96,329953
45539,0.002058,74.125.68.0-255,1484,132305,96,329953
45540,0.002077,74.125.68.0-255,1484,133789,96,329953
45541,0.00208,74.125.68.0-255,1484,135273,96,329953
45542,0.002102,74.125.68.0-255,2184,137457,96,329953
45543,0.002181,74.125.68.0-255,1484,138941,96,329953
45544,0.002196,74.125.68.0-255,2902,141843,96,329953
45545,0.002208,74.125.68.0-255,2902,144745,96,329953
45546,0.002228,74.125.68.0-255,4320,149065,96,329953
45547,0.002265,74.125.68.0-255,1484,150549,96,329953
45548,0.002268,74.125.68.0-255,1484,152033,96,329953
45549,0.002282,74.125.68.0-255,1484,153517,96,329953
45550,0.002285,74.125.68.0-255,1484,155001,96,329953
45551,0.002313,74.125.68.0-255,2902,157903,96,329953
45552,0.002315,74.125.68.0-255,1484,159387,96,329953
45553,0.002334,74.125.68.0-255,2902,162289,96,329953
45554,0.002336,74.125.68.0-255,1484,163773,96,329953
45555,0.002338,74.125.68.0-255,1484,165257,96,329953
45556,0.002359,74.125.68.0-255,2902,168159,96,329953
45557,0.002371,74.125.68.0-255,3602,171761,96,329953
45558,0.002513,74.125.68.0-255,1484,173245,96,329953
45559,0.002532,74.125.68.0-255,2902,176147,96,329953
45560,0.002584,74.125.68.0-255,1484,177631,96,329953
45561,0.002616,74.125.68.0-255,1484,179115,96,329953
45562,0.002663,74.125.68.0-255,1484,180599,96,329953
45563,0.002686,74.125.68.0-255,2902,183501,96,329953
45564,0.002714,74.125.68.0-255,1484,184985,96,329953
45565,0.002727,74.125.68.0-255,2902,187887,96,329953
45566,0.002755,74.125.68.0-255,2902,190789,96,329953
45567,0.002769,74.125.68.0-255,2902,193691,96,329953
45568,0.002786,74.125.68.0-255,1484,195175,96,329953
45569,0.002813,74.125.68.0-255,2902,198077,96,329953
45570,0.002835,74.125.68.0-255,2902,200979,96,329953
45571,0.00285,74.125.68.0-255,1484,202463,96,329953
45572,0.002869,74.125.68.0-255,3602,206065,96,329953
45573,0.003385,74.125.68.0-255,1484,207549,96,329953
45574,0.003403,74.125.68.0-255,2902,210451,96,329953
45575,0.003412,74.125.68.0-255,2902,213353,96,329953
45576,0.003425,74.125.68.0-255,2902,216255,96,329953
45577,0.003427,74.125.68.0-255,1484,217739,96,329953
45578,0.003431,74.125.68.0-255,2902,220641,96,329953
45579,0.003463,74.125.68.0-255,4320,224961,96,329953
45580,0.003478,74.125.68.0-255,1484,226445,96,329953
45581,0.003481,74.125.68.0-255,2902,229347,96,329953
45582,0.003483,74.125.68.0-255,1484,230831,96,329953
45583,0.003497,74.125.68.0-255,2902,233733,96,329953
45584,0.00353,74.125.68.0-255,2902,236635,96,329953
45585,0.003548,74.125.68.0-255,3602,240237,96,329953
45586,0.003569,74.125.68.0-255,1484,241721,96,329953
45587,0.003591,74.125.68.0-255,5738,247459,96,329953
45588,0.003677,74.125.68.0-255,2902,250361,96,329953
45589,0.00369,74.125.68.0-255,4320,254681,96,329953
45590,0.003705,74.125.68.0-255,766,255447,96,329953
45591,0.00374,74.125.68.0-255,1484,256931,96,329953
45592,0.003755,74.125.68.0-255,4320,261251,96,329953
45593,0.003783,74.125.68.0-255,4320,265571,96,329953
45594,0.003796,74.125.68.0-255,4320,269891,96,329953
45595,0.003824,74.125.68.0-255,1484,271375,96,329953
45596,0.003827,74.125.68.0-255,2902,274277,96,329953
45597,0.003841,74.125.68.0-255,6438,280715,96,329953
45598,0.004219,74.125.68.0-255,1484,282199,96,329953
45599,0.004233,74.125.68.0-255,2902,285101,96,329953
45600,0.004236,74.125.68.0-255,1484,286585,96,329953
45601,0.004252,74.125.68.0-255,2902,289487,96,329953
45602,0.004332,74.125.68.0-255,1484,290971,96,329953
45603,0.004356,74.125.68.0-255,5020,295991,96,329953
45604,0.004395,74.125.68.0-255,5738,301729,96,329953
45605,0.004416,74.125.68.0-255,7156,308885,96,329953
45606,0.004443,74.125.68.0-255,5738,314623,96,329953
45607,0.004467,74.125.68.0-255,5738,320361,96,329953
45608,0.004539,74.125.68.0-255,2902,323263,96,329953
45609,0.004555,74.125.68.0-255,2053,325316,96,329953
45610,0.004614,74.125.68.0-255,105,325421,96,329953
45611,0.007623,172.31.47.0-255,66,325487,96,329953
45612,0.01021,172.31.47.0-255,105,325592,96,329953
45613,0.012133,74.125.68.0-255,66,325658,96,329953
45614,0.046544,172.31.47.0-255,172,325830,96,329953
45615,0.046573,172.31.47.0-255,1101,326931,96,329953
45616,0.046606,172.31.47.0-255,1514,328445,96,329953
45617,0.046608,172.31.47.0-255,1310,329755,96,329953
45618,0.048107,104.244.42.0-255,66,329821,96,329953
45619,0.048141,104.244.42.0-255,66,329887,96,329953
45620,0.048144,104.244.42.0-255,66,329953,96,329953
45621,0.0,172.217.194.0-255,153,153,96,301614
45622,2.2e-05,172.31.47.0-255,66,219,96,301614
45623,2.8e-05,172.217.194.0-255,1484,1703,96,301614
45624,3.2e-05,172.31.47.0-255,66,1769,96,301614
45625,3.6e-05,172.217.194.0-255,2902,4671,96,301614
45626,4e-05,172.31.47.0-255,66,4737,96,301614
45627,4.4e-05,172.217.194.0-255,4320,9057,96,301614
45628,4.7e-05,172.31.47.0-255,66,9123,96,301614
45629,8e-05,172.217.194.0-255,2902,12025,96,301614
45630,8.2e-05,172.31.47.0-255,66,12091,96,301614
45631,8.6e-05,172.217.194.0-255,2044,14135,96,301614
45632,8.8e-05,172.31.47.0-255,66,14201,96,301614
45633,0.000483,172.217.194.0-255,1484,15685,96,301614
45634,0.000488,172.31.47.0-255,66,15751,96,301614
45635,0.000497,172.217.194.0-255,2902,18653,96,301614
45636,0.000499,172.31.47.0-255,66,18719,96,301614
45637,0.000511,172.217.194.0-255,5738,24457,96,301614
45638,0.000513,172.31.47.0-255,66,24523,96,301614
45639,0.000535,172.217.194.0-255,1484,26007,96,301614
45640,0.000542,172.31.47.0-255,66,26073,96,301614
45641,0.000583,172.31.47.0-255,66,26139,96,301614
45642,0.000612,172.217.194.0-255,5738,31877,96,301614
45643,0.000614,172.31.47.0-255,66,31943,96,301614
45644,0.00064,172.217.194.0-255,5379,37322,96,301614
45645,0.000643,172.31.47.0-255,66,37388,96,301614
45646,0.000646,172.217.194.0-255,1484,38872,96,301614
45647,0.000648,172.31.47.0-255,66,38938,96,301614
45648,0.000651,172.217.194.0-255,2902,41840,96,301614
45649,0.000653,172.31.47.0-255,66,41906,96,301614
45650,0.000661,172.217.194.0-255,2902,44808,96,301614
45651,0.000665,172.31.47.0-255,66,44874,96,301614
45652,0.000689,172.217.194.0-255,2902,47776,96,301614
45653,0.000693,172.31.47.0-255,66,47842,96,301614
45654,0.000703,172.217.194.0-255,6797,54639,96,301614
45655,0.000705,172.31.47.0-255,66,54705,96,301614
45656,0.000723,172.217.194.0-255,378,55083,96,301614
45657,0.001056,172.31.47.0-255,66,55149,96,301614
45658,0.001189,172.217.194.0-255,364,55513,96,301614
45659,0.00121,172.31.47.0-255,66,55579,96,301614
45660,0.001318,172.217.194.0-255,1484,57063,96,301614
45661,0.001322,172.217.194.0-255,1484,58547,96,301614
45662,0.001325,172.31.47.0-255,66,58613,96,301614
45663,0.001339,172.217.194.0-255,1484,60097,96,301614
45664,0.001348,172.217.194.0-255,5738,65835,96,301614
45665,0.00135,172.31.47.0-255,66,65901,96,301614
45666,0.001355,172.217.194.0-255,5738,71639,96,301614
45667,0.001357,172.31.47.0-255,66,71705,96,301614
45668,0.001375,172.217.194.0-255,1125,72830,96,301614
45669,0.001377,172.217.194.0-255,1484,74314,96,301614
45670,0.001379,172.31.47.0-255,66,74380,96,301614
45671,0.001408,172.31.47.0-255,66,74446,96,301614
45672,0.001412,172.217.194.0-255,2543,76989,96,301614
45673,0.001413,172.31.47.0-255,66,77055,96,301614
45674,0.001912,172.217.194.0-255,1484,78539,96,301614
45675,0.001929,172.217.194.0-255,1484,80023,96,301614
45676,0.001933,172.31.47.0-255,66,80089,96,301614
45677,0.001962,172.217.194.0-255,1484,81573,96,301614
45678,0.001968,172.217.194.0-255,5738,87311,96,301614
45679,0.001969,172.31.47.0-255,66,87377,96,301614
45680,0.001976,172.217.194.0-255,7156,94533,96,301614
45681,0.001977,172.31.47.0-255,66,94599,96,301614
45682,0.001997,172.217.194.0-255,5738,100337,96,301614
45683,0.002003,172.31.47.0-255,66,100403,96,301614
45684,0.002015,172.217.194.0-255,2902,103305,96,301614
45685,0.002021,172.31.47.0-255,66,103371,96,301614
45686,0.002056,172.31.47.0-255,66,103437,96,301614
45687,0.002131,172.217.194.0-255,1484,104921,96,301614
45688,0.002136,172.217.194.0-255,2902,107823,96,301614
45689,0.002139,172.31.47.0-255,66,107889,96,301614
45690,0.002159,172.217.194.0-255,5738,113627,96,301614
45691,0.002161,172.31.47.0-255,66,113693,96,301614
45692,0.002191,172.31.47.0-255,66,113759,96,301614
45693,0.002239,172.31.47.0-255,66,113825,96,301614
45694,0.002271,172.217.194.0-255,5020,118845,96,301614
45695,0.002273,172.31.47.0-255,66,118911,96,301614
45696,0.002283,172.31.47.0-255,66,118977,96,301614
45697,0.002309,172.217.194.0-255,7156,126133,96,301614
45698,0.002312,172.31.47.0-255,66,126199,96,301614
45699,0.002316,172.217.194.0-255,4320,130519,96,301614
45700,0.002318,172.31.47.0-255,66,130585,96,301614
45701,0.002358,172.31.47.0-255,66,130651,96,301614
45702,0.004645,172.217.194.0-255,5738,136389,96,301614
45703,0.004653,172.31.47.0-255,66,136455,96,301614
45704,0.006934,172.217.194.0-255,5738,142193,96,301614
45705,0.006941,172.31.47.0-255,66,142259,96,301614
45706,0.009241,172.217.194.0-255,5738,147997,96,301614
45707,0.009249,172.31.47.0-255,66,148063,96,301614
45708,0.011586,172.217.194.0-255,5738,153801,96,301614
45709,0.011592,172.31.47.0-255,66,153867,96,301614
45710,0.013904,172.217.194.0-255,5738,159605,96,301614
45711,0.013913,172.31.47.0-255,66,159671,96,301614
45712,0.016198,172.217.194.0-255,5738,165409,96,301614
45713,0.016205,172.31.47.0-255,66,165475,96,301614
45714,0.017535,172.31.47.0-255,172,165647,96,301614
45715,0.017572,172.31.47.0-255,1110,166757,96,301614
45716,0.017625,172.31.47.0-255,1514,168271,96,301614
45717,0.017627,172.31.47.0-255,1301,169572,96,301614
45718,0.018486,172.217.194.0-255,5738,175310,96,301614
45719,0.018491,172.31.47.0-255,66,175376,96,301614
45720,0.019118,104.244.42.0-255,66,175442,96,301614
45721,0.019125,104.244.42.0-255,66,175508,96,301614
45722,0.019204,104.244.42.0-255,66,175574,96,301614
45723,0.020743,172.217.194.0-255,4320,179894,96,301614
45724,0.020754,172.31.47.0-255,66,179960,96,301614
45725,0.020785,172.217.194.0-255,1484,181444,96,301614
45726,0.023016,172.217.194.0-255,4320,185764,96,301614
45727,0.023023,172.31.47.0-255,66,185830,96,301614
45728,0.025303,172.217.194.0-255,5738,191568,96,301614
45729,0.025308,172.31.47.0-255,66,191634,96,301614
45730,0.027569,172.217.194.0-255,5738,197372,96,301614
45731,0.027574,172.31.47.0-255,66,197438,96,301614
45732,0.029832,172.217.194.0-255,4320,201758,96,301614
45733,0.029837,172.31.47.0-255,66,201824,96,301614
45734,0.029866,172.217.194.0-255,1484,203308,96,301614
45735,0.032097,172.217.194.0-255,4320,207628,96,301614
45736,0.032103,172.31.47.0-255,66,207694,96,301614
45737,0.034358,172.217.194.0-255,5738,213432,96,301614
45738,0.034363,172.31.47.0-255,66,213498,96,301614
45739,0.036621,172.217.194.0-255,5738,219236,96,301614
45740,0.036628,172.31.47.0-255,66,219302,96,301614
45741,0.038906,172.217.194.0-255,5738,225040,96,301614
45742,0.038911,172.31.47.0-255,66,225106,96,301614
45743,0.041205,172.217.194.0-255,5738,230844,96,301614
45744,0.041211,172.31.47.0-255,66,230910,96,301614
45745,0.04349,172.217.194.0-255,5738,236648,96,301614
45746,0.043495,172.31.47.0-255,66,236714,96,301614
45747,0.045791,172.217.194.0-255,5738,242452,96,301614
45748,0.045796,172.31.47.0-255,66,242518,96,301614
45749,0.048057,172.217.194.0-255,5738,248256,96,301614
45750,0.048063,172.31.47.0-255,66,248322,96,301614
45751,0.050324,172.217.194.0-255,5738,254060,96,301614
45752,0.050329,172.31.47.0-255,66,254126,96,301614
45753,0.05261,172.217.194.0-255,2902,257028,96,301614
45754,0.052614,172.31.47.0-255,66,257094,96,301614
45755,0.052644,172.217.194.0-255,2902,259996,96,301614
45756,0.052646,172.31.47.0-255,66,260062,96,301614
45757,0.054884,172.217.194.0-255,2902,262964,96,301614
45758,0.05489,172.31.47.0-255,66,263030,96,301614
45759,0.054926,172.217.194.0-255,2902,265932,96,301614
45760,0.054929,172.31.47.0-255,66,265998,96,301614
45761,0.05714,172.217.194.0-255,2902,268900,96,301614
45762,0.057145,172.31.47.0-255,66,268966,96,301614
45763,0.057174,172.217.194.0-255,2902,271868,96,301614
45764,0.057177,172.31.47.0-255,66,271934,96,301614
45765,0.059426,172.217.194.0-255,2902,274836,96,301614
45766,0.059431,172.31.47.0-255,66,274902,96,301614
45767,0.059467,172.217.194.0-255,2902,277804,96,301614
45768,0.05947,172.31.47.0-255,66,277870,96,301614
45769,0.061713,172.217.194.0-255,2902,280772,96,301614
45770,0.061717,172.31.47.0-255,66,280838,96,301614
45771,0.061748,172.217.194.0-255,2902,283740,96,301614
45772,0.061751,172.31.47.0-255,66,283806,96,301614
45773,0.063973,172.217.194.0-255,2902,286708,96,301614
45774,0.063979,172.31.47.0-255,66,286774,96,301614
45775,0.064023,172.217.194.0-255,2902,289676,96,301614
45776,0.064027,172.31.47.0-255,66,289742,96,301614
45777,0.066233,172.217.194.0-255,2902,292644,96,301614
45778,0.066238,172.31.47.0-255,66,292710,96,301614
45779,0.066293,172.217.194.0-255,2902,295612,96,301614
45780,0.066297,172.31.47.0-255,66,295678,96,301614
45781,0.068492,172.217.194.0-255,2902,298580,96,301614
45782,0.06851,172.31.47.0-255,66,298646,96,301614
45783,0.068559,172.217.194.0-255,2902,301548,96,301614
45784,0.068564,172.31.47.0-255,66,301614,96,301614
45785,0.0,172.31.47.0-255,66,66,96,66
