,TIME,SRC,PACKET_SIZE,CUMULATIVE_PACKET_SIZE,PAGE_NUMBER,TOTAL_PACKET_SIZE
0,0.0,74.125.130.0-255,160,160,6,153144
1,2.4e-05,172.31.36.0-255,66,226,6,153144
2,3.1e-05,74.125.130.0-255,1484,1710,6,153144
3,3.5e-05,172.31.36.0-255,66,1776,6,153144
4,5.1e-05,74.125.130.0-255,2902,4678,6,153144
5,5.4e-05,172.31.36.0-255,66,4744,6,153144
6,5.8e-05,74.125.130.0-255,1484,6228,6,153144
7,6e-05,172.31.36.0-255,66,6294,6,153144
8,6.5e-05,74.125.130.0-255,2902,9196,6,153144
9,6.8e-05,172.31.36.0-255,66,9262,6,153144
10,9.6e-05,74.125.130.0-255,4903,14165,6,153144
11,0.0001,172.31.36.0-255,66,14231,6,153144
12,0.000185,74.125.130.0-255,1484,15715,6,153144
13,0.000188,172.31.36.0-255,66,15781,6,153144
14,0.000194,74.125.130.0-255,2902,18683,6,153144
15,0.000196,172.31.36.0-255,66,18749,6,153144
16,0.000226,74.125.130.0-255,5738,24487,6,153144
17,0.000231,172.31.36.0-255,66,24553,6,153144
18,0.000259,74.125.130.0-255,6797,31350,6,153144
19,0.000262,172.31.36.0-255,66,31416,6,153144
20,0.000313,74.125.130.0-255,4320,35736,6,153144
21,0.000316,172.31.36.0-255,66,35802,6,153144
22,0.000328,74.125.130.0-255,1484,37286,6,153144
23,0.00033,172.31.36.0-255,66,37352,6,153144
24,0.000343,74.125.130.0-255,7156,44508,6,153144
25,0.000346,172.31.36.0-255,66,44574,6,153144
26,0.000351,74.125.130.0-255,3961,48535,6,153144
27,0.000353,172.31.36.0-255,66,48601,6,153144
28,0.000417,74.125.130.0-255,1484,50085,6,153144
29,0.000421,172.31.36.0-255,66,50151,6,153144
30,0.000427,74.125.130.0-255,2902,53053,6,153144
31,0.000429,172.31.36.0-255,66,53119,6,153144
32,0.000432,74.125.130.0-255,1484,54603,6,153144
33,0.000459,74.125.130.0-255,2902,57505,6,153144
34,0.000462,172.31.36.0-255,66,57571,6,153144
35,0.000496,74.125.130.0-255,4320,61891,6,153144
36,0.000499,172.31.36.0-255,66,61957,6,153144
37,0.000524,74.125.130.0-255,1484,63441,6,153144
38,0.000558,74.125.130.0-255,2543,65984,6,153144
39,0.00056,172.31.36.0-255,66,66050,6,153144
40,0.000563,74.125.130.0-255,339,66389,6,153144
41,0.000584,74.125.130.0-255,405,66794,6,153144
42,0.000822,74.125.130.0-255,1484,68278,6,153144
43,0.000829,172.31.36.0-255,66,68344,6,153144
44,0.00084,74.125.130.0-255,2902,71246,6,153144
45,0.000843,172.31.36.0-255,66,71312,6,153144
46,0.000871,74.125.130.0-255,4320,75632,6,153144
47,0.000874,172.31.36.0-255,66,75698,6,153144
48,0.000906,74.125.130.0-255,9633,85331,6,153144
49,0.000909,172.31.36.0-255,66,85397,6,153144
50,0.000944,74.125.130.0-255,9992,95389,6,153144
51,0.000947,172.31.36.0-255,66,95455,6,153144
52,0.000953,74.125.130.0-255,5379,100834,6,153144
53,0.000955,172.31.36.0-255,66,100900,6,153144
54,0.001659,74.125.130.0-255,1484,102384,6,153144
55,0.001669,74.125.130.0-255,2902,105286,6,153144
56,0.001674,172.31.36.0-255,66,105352,6,153144
57,0.001679,74.125.130.0-255,1484,106836,6,153144
58,0.001713,74.125.130.0-255,4320,111156,6,153144
59,0.001715,172.31.36.0-255,66,111222,6,153144
60,0.001721,74.125.130.0-255,2902,114124,6,153144
61,0.001723,172.31.36.0-255,66,114190,6,153144
62,0.001733,74.125.130.0-255,4320,118510,6,153144
63,0.001735,172.31.36.0-255,66,118576,6,153144
64,0.001763,74.125.130.0-255,7156,125732,6,153144
65,0.001765,172.31.36.0-255,66,125798,6,153144
66,0.001795,74.125.130.0-255,7156,132954,6,153144
67,0.001798,172.31.36.0-255,66,133020,6,153144
68,0.001808,74.125.130.0-255,1484,134504,6,153144
69,0.001811,74.125.130.0-255,766,135270,6,153144
70,0.001813,172.31.36.0-255,66,135336,6,153144
71,0.003943,74.125.130.0-255,2902,138238,6,153144
72,0.003953,172.31.36.0-255,66,138304,6,153144
73,0.003984,74.125.130.0-255,2902,141206,6,153144
74,0.003988,172.31.36.0-255,66,141272,6,153144
75,0.006121,74.125.130.0-255,2902,144174,6,153144
76,0.006127,172.31.36.0-255,66,144240,6,153144
77,0.006157,74.125.130.0-255,2902,147142,6,153144
78,0.00616,172.31.36.0-255,66,147208,6,153144
79,0.00824,74.125.130.0-255,2902,150110,6,153144
80,0.008247,172.31.36.0-255,66,150176,6,153144
81,0.008275,74.125.130.0-255,2902,153078,6,153144
82,0.008278,172.31.36.0-255,66,153144,6,153144
83,0.0,74.125.24.0-255,152,152,6,271217
84,2.6e-05,172.31.36.0-255,66,218,6,271217
85,3.3e-05,74.125.24.0-255,1484,1702,6,271217
86,3.7e-05,172.31.36.0-255,66,1768,6,271217
87,4.3e-05,74.125.24.0-255,2902,4670,6,271217
88,4.6e-05,172.31.36.0-255,66,4736,6,271217
89,4.9e-05,74.125.24.0-255,1484,6220,6,271217
90,5.1e-05,172.31.36.0-255,66,6286,6,271217
91,8.2e-05,74.125.24.0-255,5738,12024,6,271217
92,8.6e-05,172.31.36.0-255,66,12090,6,271217
93,9.1e-05,74.125.24.0-255,3511,15601,6,271217
94,9.3e-05,172.31.36.0-255,66,15667,6,271217
95,9.8e-05,74.125.24.0-255,4320,19987,6,271217
96,0.0001,172.31.36.0-255,66,20053,6,271217
97,0.000123,74.125.24.0-255,8574,28627,6,271217
98,0.000126,172.31.36.0-255,66,28693,6,271217
99,0.00013,74.125.24.0-255,2543,31236,6,271217
100,0.000133,172.31.36.0-255,66,31302,6,271217
101,0.000197,74.125.24.0-255,1484,32786,6,271217
102,0.0002,172.31.36.0-255,66,32852,6,271217
103,0.000205,74.125.24.0-255,2902,35754,6,271217
104,0.000207,172.31.36.0-255,66,35820,6,271217
105,0.000214,74.125.24.0-255,5738,41558,6,271217
106,0.000216,172.31.36.0-255,66,41624,6,271217
107,0.000228,172.31.36.0-255,66,41690,6,271217
108,0.000246,74.125.24.0-255,1484,43174,6,271217
109,0.000249,172.31.36.0-255,66,43240,6,271217
110,0.000258,74.125.24.0-255,8574,51814,6,271217
111,0.000261,172.31.36.0-255,66,51880,6,271217
112,0.000277,74.125.24.0-255,2477,54357,6,271217
113,0.00028,172.31.36.0-255,66,54423,6,271217
114,0.000284,74.125.24.0-255,136,54559,6,271217
115,0.000437,74.125.24.0-255,1484,56043,6,271217
116,0.000444,172.31.36.0-255,66,56109,6,271217
117,0.000455,74.125.24.0-255,2902,59011,6,271217
118,0.000461,74.125.24.0-255,5738,64749,6,271217
119,0.00046,172.31.36.0-255,66,64815,6,271217
120,0.000466,172.31.36.0-255,66,64881,6,271217
121,0.000488,74.125.24.0-255,4320,69201,6,271217
122,0.000493,172.31.36.0-255,66,69267,6,271217
123,0.000505,74.125.24.0-255,8574,77841,6,271217
124,0.000509,74.125.24.0-255,2902,80743,6,271217
125,0.00051,172.31.36.0-255,66,80809,6,271217
126,0.000525,172.31.36.0-255,66,80875,6,271217
127,0.000526,74.125.24.0-255,7856,88731,6,271217
128,0.000529,172.31.36.0-255,66,88797,6,271217
129,0.000705,74.125.24.0-255,1484,90281,6,271217
130,0.000725,74.125.24.0-255,2902,93183,6,271217
131,0.000729,172.31.36.0-255,66,93249,6,271217
132,0.000737,74.125.24.0-255,5738,98987,6,271217
133,0.000749,172.31.36.0-255,66,99053,6,271217
134,0.000763,74.125.24.0-255,4320,103373,6,271217
135,0.000775,172.31.36.0-255,66,103439,6,271217
136,0.000783,74.125.24.0-255,8574,112013,6,271217
137,0.000788,172.31.36.0-255,66,112079,6,271217
138,0.000809,74.125.24.0-255,5738,117817,6,271217
139,0.000814,172.31.36.0-255,66,117883,6,271217
140,0.000824,74.125.24.0-255,5020,122903,6,271217
141,0.000827,172.31.36.0-255,66,122969,6,271217
142,0.000888,74.125.24.0-255,9992,132961,6,271217
143,0.000892,172.31.36.0-255,66,133027,6,271217
144,0.000915,74.125.24.0-255,1484,134511,6,271217
145,0.000933,74.125.24.0-255,7856,142367,6,271217
146,0.000935,172.31.36.0-255,66,142433,6,271217
147,0.00094,172.31.36.0-255,66,142499,6,271217
148,0.001498,74.125.24.0-255,1484,143983,6,271217
149,0.001504,74.125.24.0-255,1484,145467,6,271217
150,0.001507,172.31.36.0-255,66,145533,6,271217
151,0.001524,74.125.24.0-255,1484,147017,6,271217
152,0.00153,74.125.24.0-255,5738,152755,6,271217
153,0.001536,172.31.36.0-255,66,152821,6,271217
154,0.001545,74.125.24.0-255,2902,155723,6,271217
155,0.001551,172.31.36.0-255,66,155789,6,271217
156,0.00156,74.125.24.0-255,4320,160109,6,271217
157,0.001564,172.31.36.0-255,66,160175,6,271217
158,0.001594,74.125.24.0-255,9992,170167,6,271217
159,0.001598,172.31.36.0-255,66,170233,6,271217
160,0.001636,74.125.24.0-255,6438,176671,6,271217
161,0.001639,172.31.36.0-255,66,176737,6,271217
162,0.001781,74.125.24.0-255,1484,178221,6,271217
163,0.001784,74.125.24.0-255,1484,179705,6,271217
164,0.001787,172.31.36.0-255,66,179771,6,271217
165,0.00181,74.125.24.0-255,1484,181255,6,271217
166,0.001816,74.125.24.0-255,5738,186993,6,271217
167,0.001823,172.31.36.0-255,66,187059,6,271217
168,0.001829,74.125.24.0-255,4320,191379,6,271217
169,0.001835,172.31.36.0-255,66,191445,6,271217
170,0.001845,74.125.24.0-255,4320,195765,6,271217
171,0.001853,172.31.36.0-255,66,195831,6,271217
172,0.001883,74.125.24.0-255,2902,198733,6,271217
173,0.001887,172.31.36.0-255,66,198799,6,271217
174,0.001914,172.31.36.0-255,66,198865,6,271217
175,0.001948,74.125.24.0-255,7156,206021,6,271217
176,0.001951,172.31.36.0-255,66,206087,6,271217
177,0.001984,74.125.24.0-255,9992,216079,6,271217
178,0.001989,172.31.36.0-255,66,216145,6,271217
179,0.00199,74.125.24.0-255,5738,221883,6,271217
180,0.001993,172.31.36.0-255,66,221949,6,271217
181,0.002029,172.31.36.0-255,66,222015,6,271217
182,0.002031,74.125.24.0-255,9992,232007,6,271217
183,0.002043,172.31.36.0-255,66,232073,6,271217
184,0.002054,74.125.24.0-255,8574,240647,6,271217
185,0.002065,172.31.36.0-255,66,240713,6,271217
186,0.002069,74.125.24.0-255,2902,243615,6,271217
187,0.00207,172.31.36.0-255,66,243681,6,271217
188,0.002083,172.31.36.0-255,66,243747,6,271217
189,0.002101,74.125.24.0-255,9992,253739,6,271217
190,0.002111,172.31.36.0-255,66,253805,6,271217
191,0.004167,74.125.24.0-255,5738,259543,6,271217
192,0.004175,172.31.36.0-255,66,259609,6,271217
193,0.006254,74.125.24.0-255,5738,265347,6,271217
194,0.00626,172.31.36.0-255,66,265413,6,271217
195,0.008302,74.125.24.0-255,5738,271151,6,271217
196,0.008307,172.31.36.0-255,66,271217,6,271217
197,0.0,74.125.68.0-255,152,152,6,263974
198,2.7e-05,172.31.36.0-255,66,218,6,263974
199,3.4e-05,74.125.68.0-255,1484,1702,6,263974
200,3.8e-05,172.31.36.0-255,66,1768,6,263974
201,5.7e-05,74.125.68.0-255,2902,4670,6,263974
202,6e-05,172.31.36.0-255,66,4736,6,263974
203,8.4e-05,74.125.68.0-255,2902,7638,6,263974
204,8.7e-05,172.31.36.0-255,66,7704,6,263974
205,9.3e-05,74.125.68.0-255,4320,12024,6,263974
206,9.5e-05,172.31.36.0-255,66,12090,6,263974
207,0.000112,74.125.68.0-255,1484,13574,6,263974
208,0.000128,172.31.36.0-255,66,13640,6,263974
209,0.000153,74.125.68.0-255,7658,21298,6,263974
210,0.000158,172.31.36.0-255,66,21364,6,263974
211,0.000166,74.125.68.0-255,9633,30997,6,263974
212,0.000168,172.31.36.0-255,66,31063,6,263974
213,0.000242,74.125.68.0-255,1484,32547,6,263974
214,0.000245,172.31.36.0-255,66,32613,6,263974
215,0.00026,74.125.68.0-255,2902,35515,6,263974
216,0.000262,172.31.36.0-255,66,35581,6,263974
217,0.000286,74.125.68.0-255,4320,39901,6,263974
218,0.000289,172.31.36.0-255,66,39967,6,263974
219,0.000311,74.125.68.0-255,4320,44287,6,263974
220,0.000314,172.31.36.0-255,66,44353,6,263974
221,0.000331,74.125.68.0-255,5379,49732,6,263974
222,0.000334,172.31.36.0-255,66,49798,6,263974
223,0.000338,74.125.68.0-255,2902,52700,6,263974
224,0.00034,172.31.36.0-255,66,52766,6,263974
225,0.000384,74.125.68.0-255,4320,57086,6,263974
226,0.000388,172.31.36.0-255,66,57152,6,263974
227,0.000422,74.125.68.0-255,5738,62890,6,263974
228,0.000428,172.31.36.0-255,66,62956,6,263974
229,0.000438,74.125.68.0-255,2820,65776,6,263974
230,0.00044,172.31.36.0-255,66,65842,6,263974
231,0.000443,74.125.68.0-255,130,65972,6,263974
232,0.000446,74.125.68.0-255,1484,67456,6,263974
233,0.000449,74.125.68.0-255,1484,68940,6,263974
234,0.000452,172.31.36.0-255,66,69006,6,263974
235,0.000469,74.125.68.0-255,1484,70490,6,263974
236,0.000475,74.125.68.0-255,4320,74810,6,263974
237,0.000483,172.31.36.0-255,66,74876,6,263974
238,0.000507,74.125.68.0-255,5738,80614,6,263974
239,0.000511,172.31.36.0-255,66,80680,6,263974
240,0.000526,74.125.68.0-255,2801,83481,6,263974
241,0.000537,172.31.36.0-255,66,83547,6,263974
242,0.000572,74.125.68.0-255,2902,86449,6,263974
243,0.000577,172.31.36.0-255,66,86515,6,263974
244,0.000589,74.125.68.0-255,4320,90835,6,263974
245,0.000598,172.31.36.0-255,66,90901,6,263974
246,0.000602,74.125.68.0-255,2902,93803,6,263974
247,0.000604,172.31.36.0-255,66,93869,6,263974
248,0.000618,74.125.68.0-255,5738,99607,6,263974
249,0.000621,74.125.68.0-255,1125,100732,6,263974
250,0.000626,172.31.36.0-255,66,100798,6,263974
251,0.00132,74.125.68.0-255,1484,102282,6,263974
252,0.00133,74.125.68.0-255,2902,105184,6,263974
253,0.001334,172.31.36.0-255,66,105250,6,263974
254,0.001339,74.125.68.0-255,1484,106734,6,263974
255,0.001353,74.125.68.0-255,2902,109636,6,263974
256,0.001355,172.31.36.0-255,66,109702,6,263974
257,0.001358,74.125.68.0-255,1484,111186,6,263974
258,0.001384,74.125.68.0-255,7156,118342,6,263974
259,0.001387,172.31.36.0-255,66,118408,6,263974
260,0.001395,74.125.68.0-255,7156,125564,6,263974
261,0.001397,172.31.36.0-255,66,125630,6,263974
262,0.00143,74.125.68.0-255,8574,134204,6,263974
263,0.001433,172.31.36.0-255,66,134270,6,263974
264,0.001436,74.125.68.0-255,766,135036,6,263974
265,0.001824,74.125.68.0-255,1484,136520,6,263974
266,0.001828,172.31.36.0-255,66,136586,6,263974
267,0.001834,74.125.68.0-255,2902,139488,6,263974
268,0.001835,172.31.36.0-255,66,139554,6,263974
269,0.001854,74.125.68.0-255,4320,143874,6,263974
270,0.001856,172.31.36.0-255,66,143940,6,263974
271,0.001879,74.125.68.0-255,8574,152514,6,263974
272,0.001902,74.125.68.0-255,7156,159670,6,263974
273,0.001905,74.125.68.0-255,1484,161154,6,263974
274,0.001927,74.125.68.0-255,7156,168310,6,263974
275,0.00193,74.125.68.0-255,766,169076,6,263974
276,0.002046,74.125.68.0-255,1484,170560,6,263974
277,0.002059,74.125.68.0-255,2902,173462,6,263974
278,0.00208,74.125.68.0-255,2902,176364,6,263974
279,0.002094,74.125.68.0-255,2902,179266,6,263974
280,0.002098,74.125.68.0-255,2902,182168,6,263974
281,0.002102,74.125.68.0-255,2902,185070,6,263974
282,0.002113,74.125.68.0-255,1484,186554,6,263974
283,0.002129,74.125.68.0-255,4320,190874,6,263974
284,0.002147,74.125.68.0-255,4320,195194,6,263974
285,0.002152,74.125.68.0-255,5738,200932,6,263974
286,0.002197,74.125.68.0-255,2184,203116,6,263974
287,0.002237,74.125.68.0-255,1484,204600,6,263974
288,0.00224,74.125.68.0-255,1484,206084,6,263974
289,0.002255,74.125.68.0-255,1484,207568,6,263974
290,0.002281,74.125.68.0-255,5738,213306,6,263974
291,0.002299,74.125.68.0-255,4320,217626,6,263974
292,0.002318,74.125.68.0-255,4320,221946,6,263974
293,0.002326,74.125.68.0-255,8574,230520,6,263974
294,0.002338,74.125.68.0-255,1484,232004,6,263974
295,0.00234,74.125.68.0-255,1484,233488,6,263974
296,0.002359,74.125.68.0-255,3602,237090,6,263974
297,0.00243,74.125.68.0-255,1484,238574,6,263974
298,0.002446,74.125.68.0-255,1484,240058,6,263974
299,0.002458,74.125.68.0-255,1484,241542,6,263974
300,0.002499,74.125.68.0-255,4320,245862,6,263974
301,0.002517,74.125.68.0-255,1484,247346,6,263974
302,0.002553,74.125.68.0-255,2902,250248,6,263974
303,0.002572,74.125.68.0-255,7856,258104,6,263974
304,0.004967,172.31.36.0-255,66,258170,6,263974
305,0.007532,74.125.68.0-255,5738,263908,6,263974
306,0.007539,172.31.36.0-255,66,263974,6,263974
307,0.0,74.125.24.0-255,150,150,6,88426
308,2.3e-05,172.31.36.0-255,66,216,6,88426
309,3e-05,74.125.24.0-255,1484,1700,6,88426
310,3.5e-05,172.31.36.0-255,66,1766,6,88426
311,4.1e-05,74.125.24.0-255,2902,4668,6,88426
312,4.4e-05,172.31.36.0-255,66,4734,6,88426
313,5.3e-05,74.125.24.0-255,7156,11890,6,88426
314,5.6e-05,172.31.36.0-255,66,11956,6,88426
315,0.00011,172.31.36.0-255,66,12022,6,88426
316,0.000117,74.125.24.0-255,6797,18819,6,88426
317,0.000119,172.31.36.0-255,66,18885,6,88426
318,0.000331,74.125.24.0-255,1484,20369,6,88426
319,0.000337,172.31.36.0-255,66,20435,6,88426
320,0.000343,74.125.24.0-255,2902,23337,6,88426
321,0.000345,172.31.36.0-255,66,23403,6,88426
322,0.000351,74.125.24.0-255,5738,29141,6,88426
323,0.000354,172.31.36.0-255,66,29207,6,88426
324,0.000357,74.125.24.0-255,1484,30691,6,88426
325,0.000359,172.31.36.0-255,66,30757,6,88426
326,0.000382,74.125.24.0-255,5738,36495,6,88426
327,0.000384,172.31.36.0-255,66,36561,6,88426
328,0.000417,74.125.24.0-255,8215,44776,6,88426
329,0.00042,172.31.36.0-255,66,44842,6,88426
330,0.000428,74.125.24.0-255,8215,53057,6,88426
331,0.000431,172.31.36.0-255,66,53123,6,88426
332,0.000434,74.125.24.0-255,396,53519,6,88426
333,0.000435,172.31.36.0-255,66,53585,6,88426
334,0.001864,74.125.24.0-255,112,53697,6,88426
335,0.001871,172.31.36.0-255,66,53763,6,88426
336,0.001892,74.125.24.0-255,1484,55247,6,88426
337,0.001895,172.31.36.0-255,66,55313,6,88426
338,0.001899,74.125.24.0-255,1484,56797,6,88426
339,0.001913,74.125.24.0-255,1484,58281,6,88426
340,0.001915,172.31.36.0-255,66,58347,6,88426
341,0.001923,74.125.24.0-255,7156,65503,6,88426
342,0.001926,172.31.36.0-255,66,65569,6,88426
343,0.001933,74.125.24.0-255,5379,70948,6,88426
344,0.001935,172.31.36.0-255,66,71014,6,88426
345,0.00429,74.125.24.0-255,5738,76752,6,88426
346,0.004296,172.31.36.0-255,66,76818,6,88426
347,0.006651,74.125.24.0-255,5738,82556,6,88426
348,0.006658,172.31.36.0-255,66,82622,6,88426
349,0.009023,74.125.24.0-255,5738,88360,6,88426
350,0.00903,172.31.36.0-255,66,88426,6,88426
351,0.0,74.125.24.0-255,153,153,6,236569
352,2.3e-05,172.31.36.0-255,66,219,6,236569
353,3e-05,74.125.24.0-255,1484,1703,6,236569
354,3.5e-05,172.31.36.0-255,66,1769,6,236569
355,4.2e-05,74.125.24.0-255,2902,4671,6,236569
356,4.5e-05,172.31.36.0-255,66,4737,6,236569
357,5.4e-05,74.125.24.0-255,7156,11893,6,236569
358,5.7e-05,172.31.36.0-255,66,11959,6,236569
359,7.5e-05,74.125.24.0-255,2070,14029,6,236569
360,7.7e-05,172.31.36.0-255,66,14095,6,236569
361,0.000124,74.125.24.0-255,1484,15579,6,236569
362,0.000142,172.31.36.0-255,66,15645,6,236569
363,0.000148,74.125.24.0-255,2902,18547,6,236569
364,0.000152,172.31.36.0-255,66,18613,6,236569
365,0.000163,74.125.24.0-255,5738,24351,6,236569
366,0.000167,172.31.36.0-255,66,24417,6,236569
367,0.000196,74.125.24.0-255,6797,31214,6,236569
368,0.000199,172.31.36.0-255,66,31280,6,236569
369,0.00027,74.125.24.0-255,1484,32764,6,236569
370,0.000273,74.125.24.0-255,1484,34248,6,236569
371,0.000277,172.31.36.0-255,66,34314,6,236569
372,0.000284,172.31.36.0-255,66,34380,6,236569
373,0.000288,74.125.24.0-255,1484,35864,6,236569
374,0.000291,172.31.36.0-255,66,35930,6,236569
375,0.000294,74.125.24.0-255,1484,37414,6,236569
376,0.000297,172.31.36.0-255,66,37480,6,236569
377,0.000328,74.125.24.0-255,4320,41800,6,236569
378,0.000331,172.31.36.0-255,66,41866,6,236569
379,0.000346,172.31.36.0-255,66,41932,6,236569
380,0.000355,74.125.24.0-255,9633,51565,6,236569
381,0.000358,172.31.36.0-255,66,51631,6,236569
382,0.000575,74.125.24.0-255,645,52276,6,236569
383,0.001059,172.31.36.0-255,66,52342,6,236569
384,0.001389,74.125.24.0-255,1484,53826,6,236569
385,0.0014,74.125.24.0-255,2902,56728,6,236569
386,0.001405,172.31.36.0-255,66,56794,6,236569
387,0.001412,74.125.24.0-255,5738,62532,6,236569
388,0.001414,172.31.36.0-255,66,62598,6,236569
389,0.001418,74.125.24.0-255,1484,64082,6,236569
390,0.001442,172.31.36.0-255,66,64148,6,236569
391,0.001471,74.125.24.0-255,5738,69886,6,236569
392,0.001473,172.31.36.0-255,66,69952,6,236569
393,0.001498,74.125.24.0-255,4320,74272,6,236569
394,0.0015,172.31.36.0-255,66,74338,6,236569
395,0.001503,74.125.24.0-255,766,75104,6,236569
396,0.001824,74.125.24.0-255,1484,76588,6,236569
397,0.001832,172.31.36.0-255,66,76654,6,236569
398,0.001839,74.125.24.0-255,2902,79556,6,236569
399,0.001841,172.31.36.0-255,66,79622,6,236569
400,0.001847,74.125.24.0-255,5738,85360,6,236569
401,0.001849,172.31.36.0-255,66,85426,6,236569
402,0.001854,74.125.24.0-255,2902,88328,6,236569
403,0.001856,172.31.36.0-255,66,88394,6,236569
404,0.001882,74.125.24.0-255,4320,92714,6,236569
405,0.001885,172.31.36.0-255,66,92780,6,236569
406,0.001901,172.31.36.0-255,66,92846,6,236569
407,0.001905,74.125.24.0-255,2184,95030,6,236569
408,0.001906,172.31.36.0-255,66,95096,6,236569
409,0.001928,74.125.24.0-255,4320,99416,6,236569
410,0.001931,172.31.36.0-255,66,99482,6,236569
411,0.001954,172.31.36.0-255,66,99548,6,236569
412,0.001967,172.31.36.0-255,66,99614,6,236569
413,0.001984,74.125.24.0-255,1484,101098,6,236569
414,0.002003,74.125.24.0-255,2184,103282,6,236569
415,0.002005,172.31.36.0-255,66,103348,6,236569
416,0.002029,74.125.24.0-255,1484,104832,6,236569
417,0.00204,74.125.24.0-255,1484,106316,6,236569
418,0.002043,172.31.36.0-255,66,106382,6,236569
419,0.002051,74.125.24.0-255,7156,113538,6,236569
420,0.002053,172.31.36.0-255,66,113604,6,236569
421,0.002068,74.125.24.0-255,1484,115088,6,236569
422,0.002094,74.125.24.0-255,9992,125080,6,236569
423,0.002097,172.31.36.0-255,66,125146,6,236569
424,0.002101,74.125.24.0-255,2902,128048,6,236569
425,0.002103,172.31.36.0-255,66,128114,6,236569
426,0.002123,74.125.24.0-255,9274,137388,6,236569
427,0.002126,172.31.36.0-255,66,137454,6,236569
428,0.002135,74.125.24.0-255,9992,147446,6,236569
429,0.002137,172.31.36.0-255,66,147512,6,236569
430,0.002158,74.125.24.0-255,2902,150414,6,236569
431,0.00216,172.31.36.0-255,66,150480,6,236569
432,0.002165,74.125.24.0-255,2902,153382,6,236569
433,0.002167,172.31.36.0-255,66,153448,6,236569
434,0.002203,172.31.36.0-255,66,153514,6,236569
435,0.002217,172.31.36.0-255,66,153580,6,236569
436,0.002252,74.125.24.0-255,7156,160736,6,236569
437,0.002255,172.31.36.0-255,66,160802,6,236569
438,0.002268,172.31.36.0-255,66,160868,6,236569
439,0.002273,74.125.24.0-255,4320,165188,6,236569
440,0.002276,172.31.36.0-255,66,165254,6,236569
441,0.00231,172.31.36.0-255,66,165320,6,236569
442,0.002313,74.125.24.0-255,1484,166804,6,236569
443,0.002315,172.31.36.0-255,78,166882,6,236569
444,0.00233,172.31.36.0-255,66,166948,6,236569
445,0.002334,74.125.24.0-255,2184,169132,6,236569
446,0.002337,172.31.36.0-255,66,169198,6,236569
447,0.002346,74.125.24.0-255,9992,179190,6,236569
448,0.002348,172.31.36.0-255,66,179256,6,236569
449,0.002351,74.125.24.0-255,1484,180740,6,236569
450,0.002403,74.125.24.0-255,5738,186478,6,236569
451,0.002407,172.31.36.0-255,66,186544,6,236569
452,0.002432,74.125.24.0-255,1484,188028,6,236569
453,0.002439,74.125.24.0-255,4320,192348,6,236569
454,0.002442,172.31.36.0-255,66,192414,6,236569
455,0.002458,172.31.36.0-255,66,192480,6,236569
456,0.002462,74.125.24.0-255,2902,195382,6,236569
457,0.002464,172.31.36.0-255,66,195448,6,236569
458,0.002467,74.125.24.0-255,1484,196932,6,236569
459,0.00247,74.125.24.0-255,1484,198416,6,236569
460,0.002472,172.31.36.0-255,66,198482,6,236569
461,0.002481,74.125.24.0-255,8574,207056,6,236569
462,0.002484,172.31.36.0-255,66,207122,6,236569
463,0.002489,74.125.24.0-255,4320,211442,6,236569
464,0.002491,172.31.36.0-255,66,211508,6,236569
465,0.002494,74.125.24.0-255,1484,212992,6,236569
466,0.002538,74.125.24.0-255,8574,221566,6,236569
467,0.002542,172.31.36.0-255,66,221632,6,236569
468,0.002563,74.125.24.0-255,2184,223816,6,236569
469,0.002565,172.31.36.0-255,66,223882,6,236569
470,0.002581,172.31.36.0-255,66,223948,6,236569
471,0.002589,74.125.24.0-255,8574,232522,6,236569
472,0.002592,172.31.36.0-255,66,232588,6,236569
473,0.002595,74.125.24.0-255,1484,234072,6,236569
474,0.002599,74.125.24.0-255,2326,236398,6,236569
475,0.002601,172.31.36.0-255,66,236464,6,236569
476,0.002625,74.125.24.0-255,105,236569,6,236569
477,0.0,74.125.24.0-255,153,153,6,138692
478,3.1e-05,172.31.36.0-255,66,219,6,138692
479,3.8e-05,74.125.24.0-255,1484,1703,6,138692
480,4.2e-05,172.31.36.0-255,66,1769,6,138692
481,4.6e-05,74.125.24.0-255,2902,4671,6,138692
482,5.7e-05,172.31.36.0-255,66,4737,6,138692
483,6.4e-05,74.125.24.0-255,5738,10475,6,138692
484,6.7e-05,172.31.36.0-255,66,10541,6,138692
485,7e-05,74.125.24.0-255,2902,13443,6,138692
486,7.2e-05,172.31.36.0-255,66,13509,6,138692
487,0.000108,74.125.24.0-255,7742,21251,6,138692
488,0.000111,172.31.36.0-255,66,21317,6,138692
489,0.000129,74.125.24.0-255,4320,25637,6,138692
490,0.000136,172.31.36.0-255,66,25703,6,138692
491,0.000157,74.125.24.0-255,5379,31082,6,138692
492,0.00016,172.31.36.0-255,66,31148,6,138692
493,0.000206,74.125.24.0-255,1484,32632,6,138692
494,0.000209,172.31.36.0-255,66,32698,6,138692
495,0.000237,74.125.24.0-255,1484,34182,6,138692
496,0.00024,172.31.36.0-255,66,34248,6,138692
497,0.000273,74.125.24.0-255,1484,35732,6,138692
498,0.000276,172.31.36.0-255,66,35798,6,138692
499,0.000282,74.125.24.0-255,5738,41536,6,138692
500,0.000285,172.31.36.0-255,66,41602,6,138692
501,0.000304,172.31.36.0-255,66,41668,6,138692
502,0.000317,172.31.36.0-255,66,41734,6,138692
503,0.00032,74.125.24.0-255,1125,42859,6,138692
504,0.000322,172.31.36.0-255,66,42925,6,138692
505,0.000561,74.125.24.0-255,645,43570,6,138692
506,0.000566,172.31.36.0-255,66,43636,6,138692
507,0.000982,74.125.24.0-255,1484,45120,6,138692
508,0.000994,74.125.24.0-255,2902,48022,6,138692
509,0.000998,172.31.36.0-255,66,48088,6,138692
510,0.001005,74.125.24.0-255,4320,52408,6,138692
511,0.001007,172.31.36.0-255,66,52474,6,138692
512,0.001035,74.125.24.0-255,1484,53958,6,138692
513,0.001051,74.125.24.0-255,9992,63950,6,138692
514,0.001054,172.31.36.0-255,66,64016,6,138692
515,0.001058,74.125.24.0-255,1484,65500,6,138692
516,0.0011,172.31.36.0-255,66,65566,6,138692
517,0.001426,74.125.24.0-255,1484,67050,6,138692
518,0.001433,74.125.24.0-255,2902,69952,6,138692
519,0.001437,172.31.36.0-255,66,70018,6,138692
520,0.001443,74.125.24.0-255,2902,72920,6,138692
521,0.001444,172.31.36.0-255,66,72986,6,138692
522,0.001469,74.125.24.0-255,2902,75888,6,138692
523,0.001476,172.31.36.0-255,66,75954,6,138692
524,0.001481,74.125.24.0-255,4320,80274,6,138692
525,0.001498,172.31.36.0-255,66,80340,6,138692
526,0.00151,172.31.36.0-255,66,80406,6,138692
527,0.001517,74.125.24.0-255,7856,88262,6,138692
528,0.001519,172.31.36.0-255,66,88328,6,138692
529,0.00178,74.125.24.0-255,1484,89812,6,138692
530,0.001785,74.125.24.0-255,1484,91296,6,138692
531,0.001788,172.31.36.0-255,66,91362,6,138692
532,0.0018,74.125.24.0-255,1484,92846,6,138692
533,0.00183,74.125.24.0-255,4320,97166,6,138692
534,0.001833,172.31.36.0-255,66,97232,6,138692
535,0.00186,74.125.24.0-255,1484,98716,6,138692
536,0.001863,74.125.24.0-255,1484,100200,6,138692
537,0.001865,172.31.36.0-255,66,100266,6,138692
538,0.001873,74.125.24.0-255,8574,108840,6,138692
539,0.001875,172.31.36.0-255,66,108906,6,138692
540,0.001902,74.125.24.0-255,4320,113226,6,138692
541,0.001904,172.31.36.0-255,66,113292,6,138692
542,0.001938,74.125.24.0-255,9274,122566,6,138692
543,0.001941,172.31.36.0-255,66,122632,6,138692
544,0.003943,74.125.24.0-255,5738,128370,6,138692
545,0.003948,172.31.36.0-255,66,128436,6,138692
546,0.005948,74.125.24.0-255,4320,132756,6,138692
547,0.005953,172.31.36.0-255,66,132822,6,138692
548,0.005981,74.125.24.0-255,1484,134306,6,138692
549,0.007971,74.125.24.0-255,4320,138626,6,138692
550,0.007978,172.31.36.0-255,66,138692,6,138692
551,0.0,172.217.194.0-255,153,153,6,217470
552,2e-05,172.31.36.0-255,66,219,6,217470
553,2.8e-05,172.217.194.0-255,1484,1703,6,217470
554,3.2e-05,172.31.36.0-255,66,1769,6,217470
555,3.8e-05,172.217.194.0-255,2902,4671,6,217470
556,5.1e-05,172.31.36.0-255,66,4737,6,217470
557,5.9e-05,172.217.194.0-255,7156,11893,6,217470
558,6.2e-05,172.31.36.0-255,66,11959,6,217470
559,6.7e-05,172.217.194.0-255,1977,13936,6,217470
560,7e-05,172.31.36.0-255,66,14002,6,217470
561,0.00035,172.217.194.0-255,1484,15486,6,217470
562,0.000357,172.31.36.0-255,66,15552,6,217470
563,0.000363,172.217.194.0-255,2902,18454,6,217470
564,0.000366,172.31.36.0-255,66,18520,6,217470
565,0.000379,172.217.194.0-255,5738,24258,6,217470
566,0.000382,172.31.36.0-255,66,24324,6,217470
567,0.00044,172.31.36.0-255,66,24390,6,217470
568,0.000449,172.217.194.0-255,9633,34023,6,217470
569,0.000452,172.31.36.0-255,66,34089,6,217470
570,0.000492,172.31.36.0-255,66,34155,6,217470
571,0.000531,172.217.194.0-255,4252,38407,6,217470
572,0.000534,172.31.36.0-255,66,38473,6,217470
573,0.000537,172.217.194.0-255,366,38839,6,217470
574,0.000539,172.31.36.0-255,66,38905,6,217470
575,0.000733,172.217.194.0-255,1484,40389,6,217470
576,0.000738,172.31.36.0-255,66,40455,6,217470
577,0.000745,172.217.194.0-255,2902,43357,6,217470
578,0.000748,172.31.36.0-255,66,43423,6,217470
579,0.00076,172.217.194.0-255,5738,49161,6,217470
580,0.000763,172.31.36.0-255,66,49227,6,217470
581,0.000768,172.217.194.0-255,2902,52129,6,217470
582,0.000771,172.31.36.0-255,66,52195,6,217470
583,0.000788,172.217.194.0-255,9992,62187,6,217470
584,0.00079,172.217.194.0-255,1484,63671,6,217470
585,0.000799,172.31.36.0-255,66,63737,6,217470
586,0.000844,172.217.194.0-255,9274,73011,6,217470
587,0.000848,172.31.36.0-255,66,73077,6,217470
588,0.001152,172.217.194.0-255,1484,74561,6,217470
589,0.001158,172.217.194.0-255,2902,77463,6,217470
590,0.001162,172.31.36.0-255,66,77529,6,217470
591,0.001166,172.217.194.0-255,1484,79013,6,217470
592,0.001191,172.217.194.0-255,4320,83333,6,217470
593,0.001193,172.31.36.0-255,66,83399,6,217470
594,0.001196,172.217.194.0-255,1484,84883,6,217470
595,0.001205,172.217.194.0-255,8574,93457,6,217470
596,0.001212,172.31.36.0-255,66,93523,6,217470
597,0.001244,172.217.194.0-255,9992,103515,6,217470
598,0.001246,172.31.36.0-255,66,103581,6,217470
599,0.001265,172.217.194.0-255,3602,107183,6,217470
600,0.001268,172.31.36.0-255,66,107249,6,217470
601,0.001408,172.217.194.0-255,1484,108733,6,217470
602,0.001414,172.217.194.0-255,2902,111635,6,217470
603,0.001418,172.31.36.0-255,66,111701,6,217470
604,0.00145,172.217.194.0-255,5738,117439,6,217470
605,0.001452,172.31.36.0-255,66,117505,6,217470
606,0.001459,172.217.194.0-255,7156,124661,6,217470
607,0.001462,172.31.36.0-255,66,124727,6,217470
608,0.00151,172.31.36.0-255,66,124793,6,217470
609,0.001514,172.217.194.0-255,2184,126977,6,217470
610,0.001516,172.31.36.0-255,66,127043,6,217470
611,0.001533,172.217.194.0-255,1484,128527,6,217470
612,0.001567,172.217.194.0-255,8574,137101,6,217470
613,0.00157,172.31.36.0-255,66,137167,6,217470
614,0.001588,172.31.36.0-255,66,137233,6,217470
615,0.001611,172.217.194.0-255,1484,138717,6,217470
616,0.001638,172.217.194.0-255,10692,149409,6,217470
617,0.001642,172.31.36.0-255,66,149475,6,217470
618,0.001757,172.217.194.0-255,1484,150959,6,217470
619,0.001771,172.217.194.0-255,2902,153861,6,217470
620,0.001774,172.31.36.0-255,66,153927,6,217470
621,0.001811,172.217.194.0-255,1484,155411,6,217470
622,0.001827,172.217.194.0-255,4320,159731,6,217470
623,0.001829,172.31.36.0-255,66,159797,6,217470
624,0.001843,172.31.36.0-255,66,159863,6,217470
625,0.001859,172.217.194.0-255,10692,170555,6,217470
626,0.001862,172.31.36.0-255,66,170621,6,217470
627,0.001951,172.217.194.0-255,1484,172105,6,217470
628,0.001956,172.217.194.0-255,2902,175007,6,217470
629,0.001959,172.31.36.0-255,66,175073,6,217470
630,0.00199,172.217.194.0-255,5738,180811,6,217470
631,0.001994,172.31.36.0-255,66,180877,6,217470
632,0.002027,172.31.36.0-255,66,180943,6,217470
633,0.002035,172.217.194.0-255,8574,189517,6,217470
634,0.002039,172.31.36.0-255,66,189583,6,217470
635,0.00207,172.217.194.0-255,10692,200275,6,217470
636,0.002074,172.31.36.0-255,66,200341,6,217470
637,0.002095,172.31.36.0-255,66,200407,6,217470
638,0.002104,172.217.194.0-255,9992,210399,6,217470
639,0.002107,172.31.36.0-255,66,210465,6,217470
640,0.002158,172.31.36.0-255,66,210531,6,217470
641,0.002185,172.31.36.0-255,66,210597,6,217470
642,0.002189,172.217.194.0-255,3602,214199,6,217470
643,0.002191,172.31.36.0-255,66,214265,6,217470
644,0.002251,172.31.36.0-255,66,214331,6,217470
645,0.002261,172.217.194.0-255,2902,217233,6,217470
646,0.002268,172.31.36.0-255,66,217299,6,217470
647,0.002319,172.217.194.0-255,105,217404,6,217470
648,0.007761,172.31.36.0-255,66,217470,6,217470
649,0.0,172.217.194.0-255,147,147,6,212786
650,2.5e-05,172.31.36.0-255,66,213,6,212786
651,3.2e-05,172.217.194.0-255,1484,1697,6,212786
652,3.6e-05,172.31.36.0-255,66,1763,6,212786
653,4.1e-05,172.217.194.0-255,2902,4665,6,212786
654,4.5e-05,172.31.36.0-255,66,4731,6,212786
655,5.1e-05,172.217.194.0-255,4320,9051,6,212786
656,5.3e-05,172.31.36.0-255,66,9117,6,212786
657,7e-05,172.217.194.0-255,2902,12019,6,212786
658,7.2e-05,172.31.36.0-255,66,12085,6,212786
659,7.6e-05,172.217.194.0-255,1484,13569,6,212786
660,7.8e-05,172.31.36.0-255,66,13635,6,212786
661,8e-05,172.217.194.0-255,548,14183,6,212786
662,8.4e-05,172.31.36.0-255,66,14249,6,212786
663,0.00019,172.217.194.0-255,1484,15733,6,212786
664,0.000194,172.31.36.0-255,66,15799,6,212786
665,0.000214,172.217.194.0-255,2902,18701,6,212786
666,0.000217,172.31.36.0-255,66,18767,6,212786
667,0.000238,172.217.194.0-255,5738,24505,6,212786
668,0.000241,172.31.36.0-255,66,24571,6,212786
669,0.000257,172.217.194.0-255,5738,30309,6,212786
670,0.00026,172.31.36.0-255,66,30375,6,212786
671,0.000288,172.217.194.0-255,2543,32918,6,212786
672,0.000291,172.31.36.0-255,66,32984,6,212786
673,0.0003,172.217.194.0-255,8574,41558,6,212786
674,0.000303,172.31.36.0-255,66,41624,6,212786
675,0.000311,172.217.194.0-255,7156,48780,6,212786
676,0.000314,172.31.36.0-255,66,48846,6,212786
677,0.000345,172.31.36.0-255,66,48912,6,212786
678,0.000353,172.217.194.0-255,5020,53932,6,212786
679,0.000355,172.31.36.0-255,66,53998,6,212786
680,0.000358,172.217.194.0-255,382,54380,6,212786
681,0.000471,172.217.194.0-255,1484,55864,6,212786
682,0.000475,172.31.36.0-255,66,55930,6,212786
683,0.000481,172.217.194.0-255,2902,58832,6,212786
684,0.000483,172.217.194.0-255,1484,60316,6,212786
685,0.000484,172.31.36.0-255,66,60382,6,212786
686,0.000499,172.217.194.0-255,4320,64702,6,212786
687,0.000501,172.31.36.0-255,66,64768,6,212786
688,0.000519,172.217.194.0-255,8574,73342,6,212786
689,0.000522,172.31.36.0-255,66,73408,6,212786
690,0.000554,172.217.194.0-255,4320,77728,6,212786
691,0.000557,172.31.36.0-255,66,77794,6,212786
692,0.000567,172.217.194.0-255,9992,87786,6,212786
693,0.00057,172.31.36.0-255,66,87852,6,212786
694,0.000584,172.217.194.0-255,766,88618,6,212786
695,0.000888,172.217.194.0-255,1484,90102,6,212786
696,0.000893,172.217.194.0-255,2902,93004,6,212786
697,0.000894,172.31.36.0-255,66,93070,6,212786
698,0.000898,172.31.36.0-255,66,93136,6,212786
699,0.000916,172.217.194.0-255,5738,98874,6,212786
700,0.000919,172.31.36.0-255,66,98940,6,212786
701,0.000923,172.217.194.0-255,1484,100424,6,212786
702,0.000951,172.31.36.0-255,66,100490,6,212786
703,0.000991,172.217.194.0-255,8574,109064,6,212786
704,0.000995,172.31.36.0-255,66,109130,6,212786
705,0.001011,172.217.194.0-255,2184,111314,6,212786
706,0.001015,172.31.36.0-255,66,111380,6,212786
707,0.001079,172.217.194.0-255,1484,112864,6,212786
708,0.001084,172.217.194.0-255,2902,115766,6,212786
709,0.001088,172.31.36.0-255,66,115832,6,212786
710,0.001102,172.217.194.0-255,5738,121570,6,212786
711,0.001105,172.31.36.0-255,66,121636,6,212786
712,0.001141,172.31.36.0-255,66,121702,6,212786
713,0.001149,172.217.194.0-255,8574,130276,6,212786
714,0.001152,172.31.36.0-255,66,130342,6,212786
715,0.001172,172.217.194.0-255,1484,131826,6,212786
716,0.001176,172.217.194.0-255,766,132592,6,212786
717,0.001179,172.31.36.0-255,66,132658,6,212786
718,0.001265,172.217.194.0-255,1484,134142,6,212786
719,0.001268,172.217.194.0-255,1484,135626,6,212786
720,0.001271,172.31.36.0-255,66,135692,6,212786
721,0.001287,172.217.194.0-255,1484,137176,6,212786
722,0.001294,172.217.194.0-255,5738,142914,6,212786
723,0.001296,172.31.36.0-255,66,142980,6,212786
724,0.001357,172.31.36.0-255,66,143046,6,212786
725,0.001367,172.217.194.0-255,10692,153738,6,212786
726,0.00137,172.31.36.0-255,66,153804,6,212786
727,0.001398,172.217.194.0-255,1484,155288,6,212786
728,0.001402,172.217.194.0-255,2902,158190,6,212786
729,0.001406,172.31.36.0-255,66,158256,6,212786
730,0.00141,172.217.194.0-255,1484,159740,6,212786
731,0.001427,172.217.194.0-255,4320,164060,6,212786
732,0.001429,172.31.36.0-255,66,164126,6,212786
733,0.001435,172.217.194.0-255,4320,168446,6,212786
734,0.001437,172.31.36.0-255,66,168512,6,212786
735,0.001459,172.217.194.0-255,8574,177086,6,212786
736,0.001462,172.31.36.0-255,66,177152,6,212786
737,0.001489,172.217.194.0-255,7156,184308,6,212786
738,0.001492,172.31.36.0-255,66,184374,6,212786
739,0.001526,172.31.36.0-255,66,184440,6,212786
740,0.001544,172.31.36.0-255,66,184506,6,212786
741,0.001564,172.217.194.0-255,4320,188826,6,212786
742,0.001567,172.31.36.0-255,66,188892,6,212786
743,0.001593,172.31.36.0-255,66,188958,6,212786
744,0.001626,172.217.194.0-255,6438,195396,6,212786
745,0.001631,172.31.36.0-255,66,195462,6,212786
746,0.001648,172.31.36.0-255,66,195528,6,212786
747,0.001663,172.31.36.0-255,66,195594,6,212786
748,0.001706,172.31.36.0-255,66,195660,6,212786
749,0.001713,172.217.194.0-255,6438,202098,6,212786
750,0.001716,172.31.36.0-255,66,202164,6,212786
751,0.001744,172.31.36.0-255,66,202230,6,212786
752,0.001778,172.31.36.0-255,66,202296,6,212786
753,0.001795,172.31.36.0-255,66,202362,6,212786
754,0.001851,172.217.194.0-255,10016,212378,6,212786
755,0.001855,172.31.36.0-255,66,212444,6,212786
756,0.001858,172.217.194.0-255,105,212549,6,212786
757,0.003359,172.31.36.0-255,66,212615,6,212786
758,0.003385,172.31.36.0-255,105,212720,6,212786
759,0.00594,172.217.194.0-255,66,212786,6,212786
760,0.0,172.217.194.0-255,153,153,6,201947
761,2.8e-05,172.31.36.0-255,66,219,6,201947
762,3.5e-05,172.217.194.0-255,1484,1703,6,201947
763,3.9e-05,172.31.36.0-255,66,1769,6,201947
764,4.2e-05,172.217.194.0-255,1484,3253,6,201947
765,4.4e-05,172.31.36.0-255,66,3319,6,201947
766,5.8e-05,172.217.194.0-255,4320,7639,6,201947
767,6.1e-05,172.31.36.0-255,66,7705,6,201947
768,9.2e-05,172.217.194.0-255,6334,14039,6,201947
769,9.6e-05,172.31.36.0-255,66,14105,6,201947
770,0.000302,172.217.194.0-255,1484,15589,6,201947
771,0.000308,172.31.36.0-255,66,15655,6,201947
772,0.000314,172.217.194.0-255,2902,18557,6,201947
773,0.000316,172.31.36.0-255,66,18623,6,201947
774,0.000321,172.217.194.0-255,2902,21525,6,201947
775,0.000329,172.31.36.0-255,66,21591,6,201947
776,0.000363,172.217.194.0-255,2902,24493,6,201947
777,0.000366,172.31.36.0-255,66,24559,6,201947
778,0.000374,172.217.194.0-255,6797,31356,6,201947
779,0.000379,172.31.36.0-255,66,31422,6,201947
780,0.000486,172.217.194.0-255,1484,32906,6,201947
781,0.00049,172.31.36.0-255,66,32972,6,201947
782,0.000495,172.217.194.0-255,2902,35874,6,201947
783,0.000499,172.31.36.0-255,66,35940,6,201947
784,0.000515,172.217.194.0-255,4320,40260,6,201947
785,0.000518,172.31.36.0-255,66,40326,6,201947
786,0.000551,172.217.194.0-255,1484,41810,6,201947
787,0.000556,172.31.36.0-255,66,41876,6,201947
788,0.000564,172.217.194.0-255,6797,48673,6,201947
789,0.000566,172.31.36.0-255,66,48739,6,201947
790,0.000601,172.217.194.0-255,4320,53059,6,201947
791,0.000605,172.31.36.0-255,66,53125,6,201947
792,0.000634,172.217.194.0-255,9992,63117,6,201947
793,0.000639,172.31.36.0-255,66,63183,6,201947
794,0.000643,172.217.194.0-255,2794,65977,6,201947
795,0.000646,172.31.36.0-255,66,66043,6,201947
796,0.000689,172.217.194.0-255,120,66163,6,201947
797,0.000858,172.31.36.0-255,66,66229,6,201947
798,0.001272,172.217.194.0-255,382,66611,6,201947
799,0.00131,172.31.36.0-255,66,66677,6,201947
800,0.001322,172.217.194.0-255,1484,68161,6,201947
801,0.001327,172.217.194.0-255,2902,71063,6,201947
802,0.001331,172.31.36.0-255,66,71129,6,201947
803,0.001352,172.217.194.0-255,1484,72613,6,201947
804,0.001364,172.217.194.0-255,5738,78351,6,201947
805,0.001367,172.31.36.0-255,66,78417,6,201947
806,0.001392,172.217.194.0-255,1484,79901,6,201947
807,0.001425,172.217.194.0-255,9992,89893,6,201947
808,0.00143,172.31.36.0-255,66,89959,6,201947
809,0.001438,172.217.194.0-255,5738,95697,6,201947
810,0.00144,172.31.36.0-255,66,95763,6,201947
811,0.001476,172.217.194.0-255,5020,100783,6,201947
812,0.001479,172.31.36.0-255,66,100849,6,201947
813,0.001634,172.217.194.0-255,1484,102333,6,201947
814,0.001641,172.217.194.0-255,2902,105235,6,201947
815,0.001644,172.31.36.0-255,66,105301,6,201947
816,0.001648,172.217.194.0-255,1484,106785,6,201947
817,0.001696,172.217.194.0-255,5738,112523,6,201947
818,0.001699,172.31.36.0-255,66,112589,6,201947
819,0.001727,172.217.194.0-255,4320,116909,6,201947
820,0.00173,172.31.36.0-255,66,116975,6,201947
821,0.001767,172.217.194.0-255,1484,118459,6,201947
822,0.001782,172.217.194.0-255,4320,122779,6,201947
823,0.001785,172.31.36.0-255,66,122845,6,201947
824,0.001816,172.217.194.0-255,2902,125747,6,201947
825,0.001819,172.31.36.0-255,66,125813,6,201947
826,0.001828,172.217.194.0-255,9274,135087,6,201947
827,0.001835,172.31.36.0-255,66,135153,6,201947
828,0.001924,172.217.194.0-255,1484,136637,6,201947
829,0.001943,172.217.194.0-255,2902,139539,6,201947
830,0.001947,172.31.36.0-255,66,139605,6,201947
831,0.001954,172.217.194.0-255,5738,145343,6,201947
832,0.001956,172.31.36.0-255,66,145409,6,201947
833,0.001987,172.217.194.0-255,8574,153983,6,201947
834,0.00199,172.31.36.0-255,66,154049,6,201947
835,0.002033,172.217.194.0-255,4320,158369,6,201947
836,0.002037,172.31.36.0-255,66,158435,6,201947
837,0.002081,172.217.194.0-255,10692,169127,6,201947
838,0.002084,172.31.36.0-255,66,169193,6,201947
839,0.002254,172.217.194.0-255,1484,170677,6,201947
840,0.002274,172.217.194.0-255,2902,173579,6,201947
841,0.002278,172.31.36.0-255,66,173645,6,201947
842,0.002281,172.217.194.0-255,1484,175129,6,201947
843,0.002303,172.217.194.0-255,4320,179449,6,201947
844,0.002306,172.31.36.0-255,66,179515,6,201947
845,0.002344,172.31.36.0-255,66,179581,6,201947
846,0.002353,172.217.194.0-255,10692,190273,6,201947
847,0.00236,172.31.36.0-255,66,190339,6,201947
848,0.004901,172.217.194.0-255,5738,196077,6,201947
849,0.004907,172.31.36.0-255,66,196143,6,201947
850,0.007434,172.217.194.0-255,5738,201881,6,201947
851,0.007441,172.31.36.0-255,66,201947,6,201947
852,0.0,172.217.160.0-255,153,153,6,206858
853,2.8e-05,172.31.36.0-255,66,219,6,206858
854,3.5e-05,172.217.160.0-255,1484,1703,6,206858
855,4e-05,172.31.36.0-255,66,1769,6,206858
856,4.4e-05,172.217.160.0-255,2902,4671,6,206858
857,6.7e-05,172.31.36.0-255,66,4737,6,206858
858,7.5e-05,172.217.160.0-255,7156,11893,6,206858
859,7.9e-05,172.31.36.0-255,66,11959,6,206858
860,9.1e-05,172.31.36.0-255,66,12025,6,206858
861,9.5e-05,172.217.160.0-255,2902,14927,6,206858
862,9.8e-05,172.31.36.0-255,66,14993,6,206858
863,0.000102,172.217.160.0-255,3961,18954,6,206858
864,0.000105,172.31.36.0-255,66,19020,6,206858
865,0.000166,172.217.160.0-255,1484,20504,6,206858
866,0.000171,172.31.36.0-255,66,20570,6,206858
867,0.000176,172.217.160.0-255,2902,23472,6,206858
868,0.000179,172.31.36.0-255,66,23538,6,206858
869,0.000182,172.217.160.0-255,1484,25022,6,206858
870,0.000191,172.31.36.0-255,66,25088,6,206858
871,0.000223,172.217.160.0-255,4320,29408,6,206858
872,0.000227,172.31.36.0-255,66,29474,6,206858
873,0.000232,172.217.160.0-255,4320,33794,6,206858
874,0.000234,172.31.36.0-255,66,33860,6,206858
875,0.000257,172.217.160.0-255,2543,36403,6,206858
876,0.00026,172.31.36.0-255,66,36469,6,206858
877,0.000651,172.217.160.0-255,1484,37953,6,206858
878,0.000655,172.31.36.0-255,66,38019,6,206858
879,0.000662,172.217.160.0-255,2902,40921,6,206858
880,0.000665,172.31.36.0-255,66,40987,6,206858
881,0.000679,172.217.160.0-255,5738,46725,6,206858
882,0.000681,172.31.36.0-255,66,46791,6,206858
883,0.000687,172.217.160.0-255,4320,51111,6,206858
884,0.000689,172.31.36.0-255,66,51177,6,206858
885,0.000723,172.217.160.0-255,2543,53720,6,206858
886,0.000726,172.31.36.0-255,66,53786,6,206858
887,0.000729,172.217.160.0-255,336,54122,6,206858
888,0.000771,172.217.160.0-255,1484,55606,6,206858
889,0.000774,172.31.36.0-255,66,55672,6,206858
890,0.00078,172.217.160.0-255,4320,59992,6,206858
891,0.000782,172.31.36.0-255,66,60058,6,206858
892,0.000796,172.217.160.0-255,8574,68632,6,206858
893,0.000798,172.31.36.0-255,66,68698,6,206858
894,0.000802,172.217.160.0-255,2304,71002,6,206858
895,0.000804,172.31.36.0-255,66,71068,6,206858
896,0.001161,172.217.160.0-255,1484,72552,6,206858
897,0.001173,172.217.160.0-255,2902,75454,6,206858
898,0.001178,172.31.36.0-255,66,75520,6,206858
899,0.001185,172.217.160.0-255,5738,81258,6,206858
900,0.001187,172.31.36.0-255,66,81324,6,206858
901,0.001242,172.31.36.0-255,66,81390,6,206858
902,0.001249,172.217.160.0-255,5738,87128,6,206858
903,0.001251,172.31.36.0-255,66,87194,6,206858
904,0.001301,172.31.36.0-255,66,87260,6,206858
905,0.00131,172.217.160.0-255,8574,95834,6,206858
906,0.001313,172.31.36.0-255,66,95900,6,206858
907,0.00134,172.217.160.0-255,8574,104474,6,206858
908,0.001343,172.31.36.0-255,66,104540,6,206858
909,0.001348,172.217.160.0-255,5020,109560,6,206858
910,0.00135,172.31.36.0-255,66,109626,6,206858
911,0.001384,172.217.160.0-255,5738,115364,6,206858
912,0.001388,172.31.36.0-255,66,115430,6,206858
913,0.001394,172.217.160.0-255,7156,122586,6,206858
914,0.001397,172.31.36.0-255,66,122652,6,206858
915,0.001451,172.217.160.0-255,9992,132644,6,206858
916,0.001456,172.31.36.0-255,66,132710,6,206858
917,0.001482,172.217.160.0-255,1484,134194,6,206858
918,0.001493,172.217.160.0-255,9274,143468,6,206858
919,0.001502,172.31.36.0-255,66,143534,6,206858
920,0.001511,172.217.160.0-255,9992,153526,6,206858
921,0.001516,172.31.36.0-255,66,153592,6,206858
922,0.001542,172.217.160.0-255,2902,156494,6,206858
923,0.001545,172.31.36.0-255,66,156560,6,206858
924,0.001554,172.217.160.0-255,4320,160880,6,206858
925,0.001556,172.31.36.0-255,66,160946,6,206858
926,0.001585,172.217.160.0-255,1484,162430,6,206858
927,0.001589,172.217.160.0-255,2902,165332,6,206858
928,0.001591,172.31.36.0-255,66,165398,6,206858
929,0.001595,172.217.160.0-255,2902,168300,6,206858
930,0.001597,172.31.36.0-255,66,168366,6,206858
931,0.001621,172.217.160.0-255,2902,171268,6,206858
932,0.001624,172.31.36.0-255,66,171334,6,206858
933,0.001631,172.217.160.0-255,6438,177772,6,206858
934,0.001634,172.31.36.0-255,66,177838,6,206858
935,0.003248,172.217.160.0-255,5738,183576,6,206858
936,0.003251,172.31.36.0-255,66,183642,6,206858
937,0.004877,172.217.160.0-255,5738,189380,6,206858
938,0.00488,172.31.36.0-255,66,189446,6,206858
939,0.00651,172.217.160.0-255,5738,195184,6,206858
940,0.006518,172.31.36.0-255,66,195250,6,206858
941,0.008167,172.217.160.0-255,5738,200988,6,206858
942,0.008173,172.31.36.0-255,66,201054,6,206858
943,0.009803,172.217.160.0-255,5738,206792,6,206858
944,0.009811,172.31.36.0-255,66,206858,6,206858
945,0.0,172.217.194.0-255,153,153,6,281323
946,2.8e-05,172.31.36.0-255,66,219,6,281323
947,5.1e-05,172.217.194.0-255,1484,1703,6,281323
948,5.5e-05,172.31.36.0-255,66,1769,6,281323
949,6e-05,172.217.194.0-255,2902,4671,6,281323
950,6.3e-05,172.31.36.0-255,66,4737,6,281323
951,0.0001,172.217.194.0-255,2902,7639,6,281323
952,0.000103,172.31.36.0-255,66,7705,6,281323
953,0.000108,172.217.194.0-255,4320,12025,6,281323
954,0.00011,172.31.36.0-255,66,12091,6,281323
955,0.000141,172.217.194.0-255,2099,14190,6,281323
956,0.000144,172.31.36.0-255,66,14256,6,281323
957,0.000171,172.217.194.0-255,2902,17158,6,281323
958,0.000175,172.31.36.0-255,66,17224,6,281323
959,0.000205,172.217.194.0-255,7156,24380,6,281323
960,0.000208,172.31.36.0-255,66,24446,6,281323
961,0.000216,172.217.194.0-255,8574,33020,6,281323
962,0.000219,172.31.36.0-255,66,33086,6,281323
963,0.000244,172.217.194.0-255,8574,41660,6,281323
964,0.000247,172.31.36.0-255,66,41726,6,281323
965,0.000275,172.217.194.0-255,5738,47464,6,281323
966,0.000281,172.31.36.0-255,66,47530,6,281323
967,0.000284,172.217.194.0-255,766,48296,6,281323
968,0.000286,172.31.36.0-255,66,48362,6,281323
969,0.000343,172.217.194.0-255,1484,49846,6,281323
970,0.000347,172.31.36.0-255,66,49912,6,281323
971,0.000353,172.217.194.0-255,2902,52814,6,281323
972,0.000357,172.31.36.0-255,66,52880,6,281323
973,0.000387,172.217.194.0-255,5738,58618,6,281323
974,0.00039,172.31.36.0-255,66,58684,6,281323
975,0.000394,172.217.194.0-255,1484,60168,6,281323
976,0.000396,172.31.36.0-255,66,60234,6,281323
977,0.000418,172.217.194.0-255,2902,63136,6,281323
978,0.000422,172.31.36.0-255,66,63202,6,281323
979,0.000439,172.217.194.0-255,2543,65745,6,281323
980,0.000443,172.31.36.0-255,66,65811,6,281323
981,0.001216,172.217.194.0-255,646,66457,6,281323
982,0.001256,172.31.36.0-255,66,66523,6,281323
983,0.001313,172.217.194.0-255,1484,68007,6,281323
984,0.001319,172.217.194.0-255,2902,70909,6,281323
985,0.001323,172.31.36.0-255,66,70975,6,281323
986,0.001356,172.217.194.0-255,4320,75295,6,281323
987,0.001359,172.31.36.0-255,66,75361,6,281323
988,0.001385,172.217.194.0-255,1484,76845,6,281323
989,0.001393,172.217.194.0-255,6248,83093,6,281323
990,0.001395,172.31.36.0-255,66,83159,6,281323
991,0.001637,172.217.194.0-255,1484,84643,6,281323
992,0.001645,172.217.194.0-255,1484,86127,6,281323
993,0.001649,172.31.36.0-255,66,86193,6,281323
994,0.001684,172.217.194.0-255,1484,87677,6,281323
995,0.001691,172.217.194.0-255,5738,93415,6,281323
996,0.001694,172.31.36.0-255,66,93481,6,281323
997,0.001727,172.217.194.0-255,6797,100278,6,281323
998,0.001731,172.31.36.0-255,66,100344,6,281323
999,0.001863,172.217.194.0-255,1484,101828,6,281323
1000,0.001871,172.217.194.0-255,2902,104730,6,281323
1001,0.001874,172.31.36.0-255,66,104796,6,281323
1002,0.001881,172.217.194.0-255,5738,110534,6,281323
1003,0.001883,172.31.36.0-255,66,110600,6,281323
1004,0.001926,172.217.194.0-255,9992,120592,6,281323
1005,0.00193,172.31.36.0-255,66,120658,6,281323
1006,0.001949,172.217.194.0-255,2902,123560,6,281323
1007,0.001953,172.31.36.0-255,66,123626,6,281323
1008,0.002004,172.217.194.0-255,8574,132200,6,281323
1009,0.002009,172.31.36.0-255,66,132266,6,281323
1010,0.002041,172.217.194.0-255,2184,134450,6,281323
1011,0.002045,172.31.36.0-255,66,134516,6,281323
1012,0.002063,172.217.194.0-255,1484,136000,6,281323
1013,0.002067,172.217.194.0-255,1484,137484,6,281323
1014,0.002069,172.31.36.0-255,66,137550,6,281323
1015,0.002097,172.217.194.0-255,1484,139034,6,281323
1016,0.002106,172.217.194.0-255,5738,144772,6,281323
1017,0.002109,172.31.36.0-255,66,144838,6,281323
1018,0.002116,172.217.194.0-255,7156,151994,6,281323
1019,0.002119,172.31.36.0-255,66,152060,6,281323
1020,0.002156,172.217.194.0-255,5738,157798,6,281323
1021,0.002162,172.31.36.0-255,66,157864,6,281323
1022,0.002172,172.217.194.0-255,10692,168556,6,281323
1023,0.002174,172.31.36.0-255,66,168622,6,281323
1024,0.002198,172.217.194.0-255,1484,170106,6,281323
1025,0.002202,172.217.194.0-255,2902,173008,6,281323
1026,0.002205,172.31.36.0-255,66,173074,6,281323
1027,0.002233,172.217.194.0-255,5738,178812,6,281323
1028,0.002237,172.31.36.0-255,66,178878,6,281323
1029,0.002262,172.217.194.0-255,5738,184616,6,281323
1030,0.002265,172.31.36.0-255,66,184682,6,281323
1031,0.002295,172.217.194.0-255,7156,191838,6,281323
1032,0.002298,172.31.36.0-255,66,191904,6,281323
1033,0.002326,172.217.194.0-255,7156,199060,6,281323
1034,0.002331,172.31.36.0-255,66,199126,6,281323
1035,0.00235,172.217.194.0-255,3602,202728,6,281323
1036,0.002352,172.31.36.0-255,66,202794,6,281323
1037,0.002363,172.217.194.0-255,1484,204278,6,281323
1038,0.002371,172.217.194.0-255,2902,207180,6,281323
1039,0.002374,172.31.36.0-255,66,207246,6,281323
1040,0.00238,172.217.194.0-255,5738,212984,6,281323
1041,0.002382,172.31.36.0-255,66,213050,6,281323
1042,0.002394,172.31.36.0-255,66,213116,6,281323
1043,0.002401,172.217.194.0-255,8574,221690,6,281323
1044,0.002405,172.31.36.0-255,66,221756,6,281323
1045,0.002433,172.217.194.0-255,2184,223940,6,281323
1046,0.002438,172.31.36.0-255,66,224006,6,281323
1047,0.002456,172.217.194.0-255,2902,226908,6,281323
1048,0.002459,172.31.36.0-255,66,226974,6,281323
1049,0.002464,172.217.194.0-255,4320,231294,6,281323
1050,0.002466,172.31.36.0-255,66,231360,6,281323
1051,0.002486,172.217.194.0-255,2902,234262,6,281323
1052,0.002489,172.31.36.0-255,66,234328,6,281323
1053,0.002499,172.217.194.0-255,5738,240066,6,281323
1054,0.002501,172.31.36.0-255,66,240132,6,281323
1055,0.002518,172.217.194.0-255,9992,250124,6,281323
1056,0.002524,172.31.36.0-255,66,250190,6,281323
1057,0.002603,172.31.36.0-255,66,250256,6,281323
1058,0.002612,172.217.194.0-255,9992,260248,6,281323
1059,0.002614,172.31.36.0-255,66,260314,6,281323
1060,0.002617,172.217.194.0-255,1484,261798,6,281323
1061,0.002667,172.31.36.0-255,66,261864,6,281323
1062,0.00267,172.217.194.0-255,1484,263348,6,281323
1063,0.002673,172.217.194.0-255,2902,266250,6,281323
1064,0.002675,172.31.36.0-255,66,266316,6,281323
1065,0.002679,172.217.194.0-255,2902,269218,6,281323
1066,0.002681,172.31.36.0-255,66,269284,6,281323
1067,0.004056,172.31.36.0-255,101,269385,6,281323
1068,0.005332,172.217.194.0-255,2902,272287,6,281323
1069,0.005339,172.31.36.0-255,66,272353,6,281323
1070,0.005363,172.217.194.0-255,2902,275255,6,281323
1071,0.005366,172.31.36.0-255,66,275321,6,281323
1072,0.00666,172.217.194.0-255,66,275387,6,281323
1073,0.007971,172.217.194.0-255,2902,278289,6,281323
1074,0.007977,172.31.36.0-255,66,278355,6,281323
1075,0.008027,172.217.194.0-255,2902,281257,6,281323
1076,0.008032,172.31.36.0-255,66,281323,6,281323
1077,0.0,172.217.194.0-255,153,153,6,223475
1078,2.4e-05,172.31.36.0-255,66,219,6,223475
1079,3.2e-05,172.217.194.0-255,1484,1703,6,223475
1080,3.6e-05,172.31.36.0-255,66,1769,6,223475
1081,4.2e-05,172.217.194.0-255,2902,4671,6,223475
1082,4.5e-05,172.31.36.0-255,66,4737,6,223475
1083,5.3e-05,172.217.194.0-255,7156,11893,6,223475
1084,5.7e-05,172.31.36.0-255,66,11959,6,223475
1085,6.1e-05,172.217.194.0-255,1976,13935,6,223475
1086,6.3e-05,172.31.36.0-255,66,14001,6,223475
1087,0.000222,172.217.194.0-255,1484,15485,6,223475
1088,0.000226,172.31.36.0-255,66,15551,6,223475
1089,0.000232,172.217.194.0-255,2902,18453,6,223475
1090,0.000235,172.31.36.0-255,66,18519,6,223475
1091,0.000238,172.217.194.0-255,1484,20003,6,223475
1092,0.000241,172.31.36.0-255,66,20069,6,223475
1093,0.000269,172.217.194.0-255,4320,24389,6,223475
1094,0.000272,172.31.36.0-255,66,24455,6,223475
1095,0.000291,172.217.194.0-255,2902,27357,6,223475
1096,0.000293,172.31.36.0-255,66,27423,6,223475
1097,0.000306,172.217.194.0-255,3961,31384,6,223475
1098,0.000309,172.31.36.0-255,66,31450,6,223475
1099,0.000415,172.217.194.0-255,1484,32934,6,223475
1100,0.000419,172.31.36.0-255,66,33000,6,223475
1101,0.000425,172.217.194.0-255,2902,35902,6,223475
1102,0.000426,172.31.36.0-255,66,35968,6,223475
1103,0.000452,172.217.194.0-255,4320,40288,6,223475
1104,0.000455,172.31.36.0-255,66,40354,6,223475
1105,0.000462,172.217.194.0-255,5738,46092,6,223475
1106,0.000464,172.31.36.0-255,66,46158,6,223475
1107,0.000489,172.217.194.0-255,5738,51896,6,223475
1108,0.000492,172.31.36.0-255,66,51962,6,223475
1109,0.00052,172.217.194.0-255,6797,58759,6,223475
1110,0.000528,172.217.194.0-255,6797,65556,6,223475
1111,0.000536,172.31.36.0-255,66,65622,6,223475
1112,0.000565,172.217.194.0-255,379,66001,6,223475
1113,0.000598,172.217.194.0-255,366,66367,6,223475
1114,0.000785,172.217.194.0-255,1484,67851,6,223475
1115,0.000791,172.217.194.0-255,2902,70753,6,223475
1116,0.000826,172.31.36.0-255,66,70819,6,223475
1117,0.000832,172.217.194.0-255,5738,76557,6,223475
1118,0.000837,172.217.194.0-255,2902,79459,6,223475
1119,0.000842,172.31.36.0-255,66,79525,6,223475
1120,0.000857,172.217.194.0-255,8574,88099,6,223475
1121,0.000868,172.217.194.0-255,1484,89583,6,223475
1122,0.000875,172.217.194.0-255,5738,95321,6,223475
1123,0.000896,172.217.194.0-255,5020,100341,6,223475
1124,0.000906,172.31.36.0-255,66,100407,6,223475
1125,0.00142,172.217.194.0-255,1484,101891,6,223475
1126,0.001427,172.217.194.0-255,2902,104793,6,223475
1127,0.001431,172.31.36.0-255,66,104859,6,223475
1128,0.001435,172.217.194.0-255,1484,106343,6,223475
1129,0.001455,172.217.194.0-255,4320,110663,6,223475
1130,0.001461,172.217.194.0-255,5738,116401,6,223475
1131,0.001466,172.31.36.0-255,66,116467,6,223475
1132,0.001488,172.217.194.0-255,7156,123623,6,223475
1133,0.001499,172.217.194.0-255,9992,133615,6,223475
1134,0.001501,172.217.194.0-255,766,134381,6,223475
1135,0.001508,172.31.36.0-255,66,134447,6,223475
1136,0.001842,172.217.194.0-255,1484,135931,6,223475
1137,0.001863,172.217.194.0-255,2902,138833,6,223475
1138,0.001867,172.31.36.0-255,66,138899,6,223475
1139,0.001874,172.217.194.0-255,5738,144637,6,223475
1140,0.001887,172.217.194.0-255,1484,146121,6,223475
1141,0.001904,172.31.36.0-255,66,146187,6,223475
1142,0.001932,172.217.194.0-255,8574,154761,6,223475
1143,0.001948,172.217.194.0-255,766,155527,6,223475
1144,0.001959,172.31.36.0-255,66,155593,6,223475
1145,0.00198,172.217.194.0-255,5738,161331,6,223475
1146,0.001987,172.31.36.0-255,66,161397,6,223475
1147,0.001998,172.217.194.0-255,4320,165717,6,223475
1148,0.002046,172.217.194.0-255,9992,175709,6,223475
1149,0.002061,172.217.194.0-255,2184,177893,6,223475
1150,0.00209,172.217.194.0-255,1484,179377,6,223475
1151,0.002095,172.217.194.0-255,2902,182279,6,223475
1152,0.002106,172.217.194.0-255,1484,183763,6,223475
1153,0.00212,172.217.194.0-255,4320,188083,6,223475
1154,0.002124,172.217.194.0-255,2902,190985,6,223475
1155,0.002149,172.217.194.0-255,4320,195305,6,223475
1156,0.002164,172.217.194.0-255,5738,201043,6,223475
1157,0.002201,172.217.194.0-255,9992,211035,6,223475
1158,0.002213,172.217.194.0-255,766,211801,6,223475
1159,0.002254,172.31.36.0-255,66,211867,6,223475
1160,0.004523,172.217.194.0-255,5738,217605,6,223475
1161,0.004531,172.31.36.0-255,66,217671,6,223475
1162,0.006791,172.217.194.0-255,5738,223409,6,223475
1163,0.009161,172.31.36.0-255,66,223475,6,223475
1164,0.0,172.217.194.0-255,188,188,6,141638
1165,2.1e-05,172.31.36.0-255,66,254,6,141638
1166,2.8e-05,172.217.194.0-255,1484,1738,6,141638
1167,3.3e-05,172.31.36.0-255,66,1804,6,141638
1168,4.6e-05,172.217.194.0-255,2902,4706,6,141638
1169,4.8e-05,172.31.36.0-255,66,4772,6,141638
1170,5.6e-05,172.217.194.0-255,5738,10510,6,141638
1171,5.9e-05,172.31.36.0-255,66,10576,6,141638
1172,6.4e-05,172.217.194.0-255,3482,14058,6,141638
1173,6.7e-05,172.31.36.0-255,66,14124,6,141638
1174,0.00012,172.217.194.0-255,1484,15608,6,141638
1175,0.000123,172.31.36.0-255,66,15674,6,141638
1176,0.000129,172.217.194.0-255,2902,18576,6,141638
1177,0.000131,172.31.36.0-255,66,18642,6,141638
1178,0.000137,172.217.194.0-255,4320,22962,6,141638
1179,0.000145,172.31.36.0-255,66,23028,6,141638
1180,0.000175,172.217.194.0-255,1484,24512,6,141638
1181,0.000177,172.31.36.0-255,66,24578,6,141638
1182,0.000192,172.31.36.0-255,66,24644,6,141638
1183,0.000196,172.217.194.0-255,1484,26128,6,141638
1184,0.000198,172.31.36.0-255,66,26194,6,141638
1185,0.000212,172.31.36.0-255,66,26260,6,141638
1186,0.000242,172.217.194.0-255,4320,30580,6,141638
1187,0.000244,172.31.36.0-255,66,30646,6,141638
1188,0.000253,172.217.194.0-255,7856,38502,6,141638
1189,0.000255,172.31.36.0-255,66,38568,6,141638
1190,0.000258,172.217.194.0-255,678,39246,6,141638
1191,0.00026,172.31.36.0-255,66,39312,6,141638
1192,0.000447,172.217.194.0-255,1484,40796,6,141638
1193,0.000452,172.31.36.0-255,66,40862,6,141638
1194,0.000458,172.217.194.0-255,2902,43764,6,141638
1195,0.000461,172.31.36.0-255,66,43830,6,141638
1196,0.000473,172.217.194.0-255,5738,49568,6,141638
1197,0.000475,172.31.36.0-255,66,49634,6,141638
1198,0.000482,172.217.194.0-255,5738,55372,6,141638
1199,0.000484,172.31.36.0-255,66,55438,6,141638
1200,0.000525,172.31.36.0-255,66,55504,6,141638
1201,0.000532,172.217.194.0-255,5020,60524,6,141638
1202,0.000534,172.31.36.0-255,66,60590,6,141638
1203,0.000813,172.217.194.0-255,1484,62074,6,141638
1204,0.00082,172.217.194.0-255,2902,64976,6,141638
1205,0.000823,172.31.36.0-255,66,65042,6,141638
1206,0.000831,172.217.194.0-255,5738,70780,6,141638
1207,0.000833,172.31.36.0-255,66,70846,6,141638
1208,0.000869,172.31.36.0-255,66,70912,6,141638
1209,0.000903,172.217.194.0-255,10692,81604,6,141638
1210,0.000907,172.31.36.0-255,66,81670,6,141638
1211,0.001412,172.217.194.0-255,1484,83154,6,141638
1212,0.001419,172.217.194.0-255,2902,86056,6,141638
1213,0.001423,172.31.36.0-255,66,86122,6,141638
1214,0.001429,172.217.194.0-255,4320,90442,6,141638
1215,0.001431,172.31.36.0-255,66,90508,6,141638
1216,0.001464,172.217.194.0-255,1484,91992,6,141638
1217,0.001472,172.217.194.0-255,7156,99148,6,141638
1218,0.001474,172.31.36.0-255,66,99214,6,141638
1219,0.001489,172.31.36.0-255,66,99280,6,141638
1220,0.001493,172.217.194.0-255,2184,101464,6,141638
1221,0.001496,172.31.36.0-255,66,101530,6,141638
1222,0.001652,172.217.194.0-255,1484,103014,6,141638
1223,0.001658,172.217.194.0-255,2902,105916,6,141638
1224,0.001661,172.31.36.0-255,66,105982,6,141638
1225,0.001692,172.217.194.0-255,5738,111720,6,141638
1226,0.001695,172.31.36.0-255,66,111786,6,141638
1227,0.001709,172.31.36.0-255,66,111852,6,141638
1228,0.001713,172.217.194.0-255,2902,114754,6,141638
1229,0.001715,172.31.36.0-255,66,114820,6,141638
1230,0.001754,172.217.194.0-255,9274,124094,6,141638
1231,0.001757,172.31.36.0-255,66,124160,6,141638
1232,0.00405,172.217.194.0-255,5738,129898,6,141638
1233,0.004059,172.31.36.0-255,66,129964,6,141638
1234,0.006356,172.217.194.0-255,1484,131448,6,141638
1235,0.006381,172.217.194.0-255,4320,135768,6,141638
1236,0.006384,172.31.36.0-255,66,135834,6,141638
1237,0.008705,172.217.194.0-255,5738,141572,6,141638
1238,0.008713,172.31.36.0-255,66,141638,6,141638
1239,0.0,74.125.24.0-255,154,154,6,106177
1240,2.3e-05,172.31.36.0-255,66,220,6,106177
1241,3e-05,74.125.24.0-255,1484,1704,6,106177
1242,3.6e-05,172.31.36.0-255,66,1770,6,106177
1243,4.2e-05,74.125.24.0-255,2902,4672,6,106177
1244,4.5e-05,172.31.36.0-255,66,4738,6,106177
1245,5.1e-05,74.125.24.0-255,4320,9058,6,106177
1246,5.4e-05,172.31.36.0-255,66,9124,6,106177
1247,6.1e-05,74.125.24.0-255,4984,14108,6,106177
1248,6.4e-05,172.31.36.0-255,66,14174,6,106177
1249,7.7e-05,172.31.36.0-255,66,14240,6,106177
1250,8.3e-05,74.125.24.0-255,5379,19619,6,106177
1251,8.7e-05,172.31.36.0-255,66,19685,6,106177
1252,0.000158,74.125.24.0-255,1484,21169,6,106177
1253,0.000161,172.31.36.0-255,66,21235,6,106177
1254,0.000167,74.125.24.0-255,2902,24137,6,106177
1255,0.00017,172.31.36.0-255,66,24203,6,106177
1256,0.000198,74.125.24.0-255,5738,29941,6,106177
1257,0.000201,172.31.36.0-255,66,30007,6,106177
1258,0.000216,74.125.24.0-255,5738,35745,6,106177
1259,0.000219,172.31.36.0-255,66,35811,6,106177
1260,0.000239,74.125.24.0-255,1125,36936,6,106177
1261,0.000241,172.31.36.0-255,66,37002,6,106177
1262,0.00025,74.125.24.0-255,7156,44158,6,106177
1263,0.000252,172.31.36.0-255,66,44224,6,106177
1264,0.000282,74.125.24.0-255,9908,54132,6,106177
1265,0.000285,172.31.36.0-255,66,54198,6,106177
1266,0.000937,74.125.24.0-255,131,54329,6,106177
1267,0.000945,172.31.36.0-255,66,54395,6,106177
1268,0.001077,74.125.24.0-255,1484,55879,6,106177
1269,0.001082,172.31.36.0-255,66,55945,6,106177
1270,0.001102,74.125.24.0-255,2902,58847,6,106177
1271,0.001105,172.31.36.0-255,66,58913,6,106177
1272,0.001112,74.125.24.0-255,5738,64651,6,106177
1273,0.001114,172.31.36.0-255,66,64717,6,106177
1274,0.001119,74.125.24.0-255,2902,67619,6,106177
1275,0.001121,172.31.36.0-255,66,67685,6,106177
1276,0.001161,74.125.24.0-255,4320,72005,6,106177
1277,0.001164,172.31.36.0-255,66,72071,6,106177
1278,0.001189,74.125.24.0-255,6797,78868,6,106177
1279,0.001191,172.31.36.0-255,66,78934,6,106177
1280,0.001197,74.125.24.0-255,4320,83254,6,106177
1281,0.001199,172.31.36.0-255,66,83320,6,106177
1282,0.001228,74.125.24.0-255,5379,88699,6,106177
1283,0.001231,172.31.36.0-255,66,88765,6,106177
1284,0.003514,74.125.24.0-255,5738,94503,6,106177
1285,0.003522,172.31.36.0-255,66,94569,6,106177
1286,0.005797,74.125.24.0-255,5738,100307,6,106177
1287,0.005801,172.31.36.0-255,66,100373,6,106177
1288,0.008106,74.125.24.0-255,5738,106111,6,106177
1289,0.008113,172.31.36.0-255,66,106177,6,106177
1290,0.0,172.217.194.0-255,153,153,6,228670
1291,3.5e-05,172.31.36.0-255,66,219,6,228670
1292,4.2e-05,172.217.194.0-255,1484,1703,6,228670
1293,4.6e-05,172.31.36.0-255,66,1769,6,228670
1294,5.1e-05,172.217.194.0-255,2902,4671,6,228670
1295,5.4e-05,172.31.36.0-255,66,4737,6,228670
1296,6.1e-05,172.217.194.0-255,7156,11893,6,228670
1297,6.4e-05,172.31.36.0-255,66,11959,6,228670
1298,6.8e-05,172.217.194.0-255,2074,14033,6,228670
1299,7.1e-05,172.31.36.0-255,66,14099,6,228670
1300,9.4e-05,172.217.194.0-255,4320,18419,6,228670
1301,9.6e-05,172.31.36.0-255,66,18485,6,228670
1302,0.000123,172.217.194.0-255,7156,25641,6,228670
1303,0.000125,172.31.36.0-255,66,25707,6,228670
1304,0.000133,172.217.194.0-255,8574,34281,6,228670
1305,0.000135,172.31.36.0-255,66,34347,6,228670
1306,0.000182,172.31.36.0-255,66,34413,6,228670
1307,0.000199,172.217.194.0-255,2184,36597,6,228670
1308,0.000201,172.31.36.0-255,66,36663,6,228670
1309,0.000243,172.217.194.0-255,1484,38147,6,228670
1310,0.000246,172.31.36.0-255,66,38213,6,228670
1311,0.000267,172.217.194.0-255,2902,41115,6,228670
1312,0.000269,172.31.36.0-255,66,41181,6,228670
1313,0.000306,172.217.194.0-255,2902,44083,6,228670
1314,0.000309,172.31.36.0-255,66,44149,6,228670
1315,0.000322,172.217.194.0-255,2902,47051,6,228670
1316,0.000324,172.31.36.0-255,66,47117,6,228670
1317,0.000331,172.217.194.0-255,7070,54187,6,228670
1318,0.000335,172.31.36.0-255,66,54253,6,228670
1319,0.000379,172.217.194.0-255,1484,55737,6,228670
1320,0.000382,172.31.36.0-255,66,55803,6,228670
1321,0.000394,172.217.194.0-255,2902,58705,6,228670
1322,0.000405,172.217.194.0-255,1484,60189,6,228670
1323,0.000422,172.217.194.0-255,4320,64509,6,228670
1324,0.000424,172.217.194.0-255,1484,65993,6,228670
1325,0.000464,172.217.194.0-255,7156,73149,6,228670
1326,0.000483,172.217.194.0-255,2543,75692,6,228670
1327,0.00049,172.217.194.0-255,8574,84266,6,228670
1328,0.000515,172.217.194.0-255,2902,87168,6,228670
1329,0.000528,172.217.194.0-255,1418,88586,6,228670
1330,0.000961,172.217.194.0-255,1484,90070,6,228670
1331,0.000967,172.217.194.0-255,2902,92972,6,228670
1332,0.000987,172.217.194.0-255,2902,95874,6,228670
1333,0.001,172.217.194.0-255,1484,97358,6,228670
1334,0.001016,172.217.194.0-255,5738,103096,6,228670
1335,0.001031,172.217.194.0-255,2902,105998,6,228670
1336,0.001038,172.217.194.0-255,7156,113154,6,228670
1337,0.001061,172.217.194.0-255,9274,122428,6,228670
1338,0.001072,172.217.194.0-255,1484,123912,6,228670
1339,0.001083,172.217.194.0-255,2902,126814,6,228670
1340,0.001111,172.217.194.0-255,5738,132552,6,228670
1341,0.001119,172.217.194.0-255,7156,139708,6,228670
1342,0.00114,172.217.194.0-255,5738,145446,6,228670
1343,0.001143,172.217.194.0-255,1484,146930,6,228670
1344,0.001195,172.217.194.0-255,2902,149832,6,228670
1345,0.001221,172.217.194.0-255,6438,156270,6,228670
1346,0.001886,172.217.194.0-255,1484,157754,6,228670
1347,0.001904,172.217.194.0-255,2902,160656,6,228670
1348,0.001911,172.217.194.0-255,5738,166394,6,228670
1349,0.001947,172.217.194.0-255,4320,170714,6,228670
1350,0.001975,172.217.194.0-255,8574,179288,6,228670
1351,0.001979,172.217.194.0-255,2902,182190,6,228670
1352,0.002008,172.217.194.0-255,1484,183674,6,228670
1353,0.002044,172.217.194.0-255,6438,190112,6,228670
1354,0.002179,172.217.194.0-255,1484,191596,6,228670
1355,0.002183,172.217.194.0-255,1484,193080,6,228670
1356,0.002198,172.217.194.0-255,1484,194564,6,228670
1357,0.002202,172.217.194.0-255,2902,197466,6,228670
1358,0.002223,172.217.194.0-255,2902,200368,6,228670
1359,0.002229,172.217.194.0-255,7156,207524,6,228670
1360,0.002239,172.217.194.0-255,1484,209008,6,228670
1361,0.002266,172.217.194.0-255,2184,211192,6,228670
1362,0.002447,172.31.36.0-255,66,211258,6,228670
1363,0.00481,172.217.194.0-255,5738,216996,6,228670
1364,0.004819,172.31.36.0-255,66,217062,6,228670
1365,0.007111,172.217.194.0-255,5738,222800,6,228670
1366,0.007117,172.31.36.0-255,66,222866,6,228670
1367,0.009436,172.217.194.0-255,5738,228604,6,228670
1368,0.009443,172.31.36.0-255,66,228670,6,228670
1369,0.0,172.217.194.0-255,153,153,6,229925
1370,2.3e-05,172.31.36.0-255,66,219,6,229925
1371,3e-05,172.217.194.0-255,1484,1703,6,229925
1372,3.5e-05,172.31.36.0-255,66,1769,6,229925
1373,4e-05,172.217.194.0-255,2902,4671,6,229925
1374,5.3e-05,172.31.36.0-255,66,4737,6,229925
1375,6.1e-05,172.217.194.0-255,7156,11893,6,229925
1376,6.4e-05,172.31.36.0-255,66,11959,6,229925
1377,7.6e-05,172.217.194.0-255,10543,22502,6,229925
1378,7.9e-05,172.31.36.0-255,66,22568,6,229925
1379,0.000134,172.31.36.0-255,66,22634,6,229925
1380,0.00016,172.217.194.0-255,4320,26954,6,229925
1381,0.000163,172.31.36.0-255,66,27020,6,229925
1382,0.000193,172.217.194.0-255,8215,35235,6,229925
1383,0.000196,172.31.36.0-255,66,35301,6,229925
1384,0.000199,172.217.194.0-255,1484,36785,6,229925
1385,0.000201,172.31.36.0-255,66,36851,6,229925
1386,0.00024,172.31.36.0-255,66,36917,6,229925
1387,0.000245,172.217.194.0-255,4275,41192,6,229925
1388,0.000247,172.31.36.0-255,66,41258,6,229925
1389,0.000291,172.217.194.0-255,1484,42742,6,229925
1390,0.000294,172.31.36.0-255,66,42808,6,229925
1391,0.000299,172.217.194.0-255,2902,45710,6,229925
1392,0.000301,172.31.36.0-255,66,45776,6,229925
1393,0.000307,172.217.194.0-255,5738,51514,6,229925
1394,0.000314,172.31.36.0-255,66,51580,6,229925
1395,0.000322,172.217.194.0-255,6797,58377,6,229925
1396,0.000324,172.31.36.0-255,66,58443,6,229925
1397,0.000331,172.217.194.0-255,7156,65599,6,229925
1398,0.000334,172.31.36.0-255,66,65665,6,229925
1399,0.000382,172.217.194.0-255,9908,75573,6,229925
1400,0.000385,172.31.36.0-255,66,75639,6,229925
1401,0.000665,172.217.194.0-255,1484,77123,6,229925
1402,0.000684,172.217.194.0-255,2902,80025,6,229925
1403,0.000689,172.31.36.0-255,66,80091,6,229925
1404,0.000697,172.217.194.0-255,5738,85829,6,229925
1405,0.0007,172.31.36.0-255,66,85895,6,229925
1406,0.000709,172.217.194.0-255,2902,88797,6,229925
1407,0.000711,172.31.36.0-255,66,88863,6,229925
1408,0.000744,172.217.194.0-255,5738,94601,6,229925
1409,0.000748,172.31.36.0-255,66,94667,6,229925
1410,0.000757,172.217.194.0-255,9992,104659,6,229925
1411,0.00076,172.31.36.0-255,66,104725,6,229925
1412,0.000765,172.217.194.0-255,3425,108150,6,229925
1413,0.000767,172.31.36.0-255,66,108216,6,229925
1414,0.000794,172.217.194.0-255,4320,112536,6,229925
1415,0.000801,172.31.36.0-255,66,112602,6,229925
1416,0.000811,172.217.194.0-255,9992,122594,6,229925
1417,0.000814,172.31.36.0-255,66,122660,6,229925
1418,0.00082,172.217.194.0-255,2902,125562,6,229925
1419,0.000822,172.31.36.0-255,66,125628,6,229925
1420,0.000862,172.217.194.0-255,9992,135620,6,229925
1421,0.00087,172.217.194.0-255,6438,142058,6,229925
1422,0.000875,172.31.36.0-255,66,142124,6,229925
1423,0.000878,172.31.36.0-255,66,142190,6,229925
1424,0.00089,172.217.194.0-255,7156,149346,6,229925
1425,0.000897,172.31.36.0-255,66,149412,6,229925
1426,0.000946,172.31.36.0-255,66,149478,6,229925
1427,0.00097,172.217.194.0-255,10692,160170,6,229925
1428,0.000974,172.31.36.0-255,66,160236,6,229925
1429,0.00108,172.217.194.0-255,1484,161720,6,229925
1430,0.001087,172.217.194.0-255,2902,164622,6,229925
1431,0.00109,172.31.36.0-255,66,164688,6,229925
1432,0.001111,172.217.194.0-255,5738,170426,6,229925
1433,0.001114,172.31.36.0-255,66,170492,6,229925
1434,0.001117,172.217.194.0-255,1484,171976,6,229925
1435,0.001145,172.217.194.0-255,5738,177714,6,229925
1436,0.001148,172.31.36.0-255,66,177780,6,229925
1437,0.001162,172.31.36.0-255,66,177846,6,229925
1438,0.001194,172.217.194.0-255,2902,180748,6,229925
1439,0.001197,172.31.36.0-255,66,180814,6,229925
1440,0.001201,172.217.194.0-255,2184,182998,6,229925
1441,0.001204,172.31.36.0-255,66,183064,6,229925
1442,0.001339,172.217.194.0-255,1484,184548,6,229925
1443,0.001344,172.217.194.0-255,2902,187450,6,229925
1444,0.001348,172.31.36.0-255,66,187516,6,229925
1445,0.001353,172.217.194.0-255,2902,190418,6,229925
1446,0.001355,172.31.36.0-255,66,190484,6,229925
1447,0.001386,172.217.194.0-255,2902,193386,6,229925
1448,0.001389,172.31.36.0-255,66,193452,6,229925
1449,0.001395,172.217.194.0-255,5738,199190,6,229925
1450,0.001397,172.31.36.0-255,66,199256,6,229925
1451,0.001421,172.31.36.0-255,66,199322,6,229925
1452,0.001427,172.217.194.0-255,4320,203642,6,229925
1453,0.001429,172.31.36.0-255,66,203708,6,229925
1454,0.001471,172.31.36.0-255,66,203774,6,229925
1455,0.001523,172.217.194.0-255,8574,212348,6,229925
1456,0.001527,172.31.36.0-255,66,212414,6,229925
1457,0.001561,172.217.194.0-255,8574,220988,6,229925
1458,0.001564,172.31.36.0-255,66,221054,6,229925
1459,0.001586,172.31.36.0-255,66,221120,6,229925
1460,0.001609,172.31.36.0-255,66,221186,6,229925
1461,0.00163,172.31.36.0-255,66,221252,6,229925
1462,0.001651,172.31.36.0-255,66,221318,6,229925
1463,0.001656,172.217.194.0-255,766,222084,6,229925
1464,0.001672,172.31.36.0-255,66,222150,6,229925
1465,0.001683,172.217.194.0-255,5738,227888,6,229925
1466,0.001686,172.31.36.0-255,66,227954,6,229925
1467,0.001718,172.217.194.0-255,1800,229754,6,229925
1468,0.001721,172.31.36.0-255,66,229820,6,229925
1469,0.001725,172.217.194.0-255,105,229925,6,229925
1470,0.0,172.31.36.0-255,105,105,6,459
1471,0.000208,172.31.36.0-255,90,195,6,459
1472,0.000218,172.31.36.0-255,66,261,6,459
1473,0.002804,74.125.24.0-255,66,327,6,459
1474,0.002835,74.125.24.0-255,66,393,6,459
1475,0.002869,172.31.36.0-255,66,459,6,459
1476,0.0,172.31.36.0-255,176,176,6,242
1477,0.006255,74.125.200.0-255,66,242,6,242
1478,0.0,172.217.194.0-255,155,155,6,185697
1479,1.2e-05,172.31.36.0-255,66,221,6,185697
1480,4.2e-05,172.217.194.0-255,1484,1705,6,185697
1481,4.7e-05,172.31.36.0-255,66,1771,6,185697
1482,5.3e-05,172.217.194.0-255,2902,4673,6,185697
1483,5.6e-05,172.31.36.0-255,66,4739,6,185697
1484,6.2e-05,172.217.194.0-255,4320,9059,6,185697
1485,6.5e-05,172.31.36.0-255,66,9125,6,185697
1486,0.000101,172.217.194.0-255,4873,13998,6,185697
1487,0.000104,172.31.36.0-255,66,14064,6,185697
1488,0.00013,172.217.194.0-255,5738,19802,6,185697
1489,0.000133,172.31.36.0-255,66,19868,6,185697
1490,0.000169,172.31.36.0-255,66,19934,6,185697
1491,0.000194,172.217.194.0-255,1484,21418,6,185697
1492,0.000196,172.31.36.0-255,66,21484,6,185697
1493,0.000233,172.31.36.0-255,66,21550,6,185697
1494,0.00027,172.31.36.0-255,66,21616,6,185697
1495,0.000314,172.217.194.0-255,2855,24471,6,185697
1496,0.000317,172.31.36.0-255,66,24537,6,185697
1497,0.000344,172.217.194.0-255,365,24902,6,185697
1498,0.000346,172.31.36.0-255,66,24968,6,185697
1499,0.000598,172.217.194.0-255,1484,26452,6,185697
1500,0.000603,172.31.36.0-255,66,26518,6,185697
1501,0.000609,172.217.194.0-255,2902,29420,6,185697
1502,0.000611,172.31.36.0-255,66,29486,6,185697
1503,0.000623,172.217.194.0-255,5738,35224,6,185697
1504,0.000626,172.31.36.0-255,66,35290,6,185697
1505,0.000632,172.217.194.0-255,5738,41028,6,185697
1506,0.000634,172.31.36.0-255,66,41094,6,185697
1507,0.000682,172.31.36.0-255,66,41160,6,185697
1508,0.000688,172.217.194.0-255,5020,46180,6,185697
1509,0.00069,172.31.36.0-255,66,46246,6,185697
1510,0.000939,172.217.194.0-255,1484,47730,6,185697
1511,0.000947,172.217.194.0-255,2902,50632,6,185697
1512,0.00095,172.31.36.0-255,66,50698,6,185697
1513,0.000957,172.217.194.0-255,5738,56436,6,185697
1514,0.000959,172.31.36.0-255,66,56502,6,185697
1515,0.000998,172.31.36.0-255,66,56568,6,185697
1516,0.001007,172.217.194.0-255,10692,67260,6,185697
1517,0.00101,172.31.36.0-255,66,67326,6,185697
1518,0.001333,172.217.194.0-255,1484,68810,6,185697
1519,0.001339,172.217.194.0-255,2902,71712,6,185697
1520,0.001342,172.31.36.0-255,66,71778,6,185697
1521,0.001348,172.217.194.0-255,2902,74680,6,185697
1522,0.00135,172.31.36.0-255,66,74746,6,185697
1523,0.001374,172.217.194.0-255,2902,77648,6,185697
1524,0.001376,172.31.36.0-255,66,77714,6,185697
1525,0.001393,172.31.36.0-255,66,77780,6,185697
1526,0.0014,172.217.194.0-255,8574,86354,6,185697
1527,0.001402,172.31.36.0-255,66,86420,6,185697
1528,0.00143,172.217.194.0-255,2184,88604,6,185697
1529,0.001433,172.31.36.0-255,66,88670,6,185697
1530,0.001495,172.217.194.0-255,1484,90154,6,185697
1531,0.001509,172.217.194.0-255,2902,93056,6,185697
1532,0.001512,172.31.36.0-255,66,93122,6,185697
1533,0.001519,172.217.194.0-255,5738,98860,6,185697
1534,0.00152,172.31.36.0-255,66,98926,6,185697
1535,0.001551,172.217.194.0-255,7156,106082,6,185697
1536,0.001554,172.31.36.0-255,66,106148,6,185697
1537,0.001583,172.217.194.0-255,5738,111886,6,185697
1538,0.001586,172.31.36.0-255,66,111952,6,185697
1539,0.001591,172.217.194.0-255,4320,116272,6,185697
1540,0.001594,172.31.36.0-255,66,116338,6,185697
1541,0.001598,172.217.194.0-255,2902,119240,6,185697
1542,0.001601,172.31.36.0-255,66,119306,6,185697
1543,0.001636,172.217.194.0-255,3602,122908,6,185697
1544,0.00164,172.31.36.0-255,66,122974,6,185697
1545,0.001713,172.217.194.0-255,1484,124458,6,185697
1546,0.001728,172.217.194.0-255,2902,127360,6,185697
1547,0.001732,172.31.36.0-255,66,127426,6,185697
1548,0.001737,172.217.194.0-255,4320,131746,6,185697
1549,0.00174,172.31.36.0-255,66,131812,6,185697
1550,0.001768,172.217.194.0-255,1484,133296,6,185697
1551,0.001782,172.31.36.0-255,66,133362,6,185697
1552,0.001813,172.217.194.0-255,8574,141936,6,185697
1553,0.001817,172.31.36.0-255,66,142002,6,185697
1554,0.001841,172.217.194.0-255,2184,144186,6,185697
1555,0.001845,172.31.36.0-255,66,144252,6,185697
1556,0.001857,172.217.194.0-255,4320,148572,6,185697
1557,0.001863,172.31.36.0-255,66,148638,6,185697
1558,0.001892,172.217.194.0-255,7156,155794,6,185697
1559,0.001894,172.31.36.0-255,66,155860,6,185697
1560,0.001898,172.217.194.0-255,1484,157344,6,185697
1561,0.001949,172.217.194.0-255,5738,163082,6,185697
1562,0.001952,172.31.36.0-255,66,163148,6,185697
1563,0.001982,172.217.194.0-255,8574,171722,6,185697
1564,0.002028,172.31.36.0-255,66,171788,6,185697
1565,0.002031,172.31.36.0-255,66,171854,6,185697
1566,0.002034,172.31.36.0-255,66,171920,6,185697
1567,0.002037,172.31.36.0-255,66,171986,6,185697
1568,0.002055,172.31.36.0-255,66,172052,6,185697
1569,0.002078,172.31.36.0-255,66,172118,6,185697
1570,0.0021,172.217.194.0-255,3602,175720,6,185697
1571,0.002103,172.31.36.0-255,66,175786,6,185697
1572,0.002122,172.31.36.0-255,66,175852,6,185697
1573,0.002161,172.217.194.0-255,9274,185126,6,185697
1574,0.002165,172.31.36.0-255,66,185192,6,185697
1575,0.002187,172.31.36.0-255,66,185258,6,185697
1576,0.00219,172.217.194.0-255,97,185355,6,185697
1577,0.002193,172.217.194.0-255,105,185460,6,185697
1578,0.004397,172.31.36.0-255,66,185526,6,185697
1579,0.004432,172.31.36.0-255,105,185631,6,185697
1580,0.006655,172.217.194.0-255,66,185697,6,185697
1581,0.0,74.125.24.0-255,156,156,6,293770
1582,2.1e-05,172.31.36.0-255,66,222,6,293770
1583,2.8e-05,74.125.24.0-255,1484,1706,6,293770
1584,3.3e-05,172.31.36.0-255,66,1772,6,293770
1585,4.6e-05,74.125.24.0-255,2902,4674,6,293770
1586,4.9e-05,172.31.36.0-255,66,4740,6,293770
1587,5.4e-05,74.125.24.0-255,2902,7642,6,293770
1588,5.7e-05,172.31.36.0-255,66,7708,6,293770
1589,8.5e-05,74.125.24.0-255,4320,12028,6,293770
1590,8.7e-05,172.31.36.0-255,66,12094,6,293770
1591,9.1e-05,74.125.24.0-255,2030,14124,6,293770
1592,9.3e-05,172.31.36.0-255,66,14190,6,293770
1593,0.000135,172.31.36.0-255,66,14256,6,293770
1594,0.000155,74.125.24.0-255,5738,19994,6,293770
1595,0.000158,172.31.36.0-255,66,20060,6,293770
1596,0.000183,74.125.24.0-255,5738,25798,6,293770
1597,0.000185,172.31.36.0-255,66,25864,6,293770
1598,0.000218,74.125.24.0-255,10692,36556,6,293770
1599,0.00022,172.31.36.0-255,66,36622,6,293770
1600,0.000358,74.125.24.0-255,1484,38106,6,293770
1601,0.000362,172.31.36.0-255,66,38172,6,293770
1602,0.000368,74.125.24.0-255,2902,41074,6,293770
1603,0.00037,172.31.36.0-255,66,41140,6,293770
1604,0.000376,74.125.24.0-255,4320,45460,6,293770
1605,0.000382,172.31.36.0-255,66,45526,6,293770
1606,0.000409,74.125.24.0-255,1484,47010,6,293770
1607,0.000412,172.31.36.0-255,66,47076,6,293770
1608,0.000419,74.125.24.0-255,5738,52814,6,293770
1609,0.000422,172.31.36.0-255,66,52880,6,293770
1610,0.00045,74.125.24.0-255,1439,54319,6,293770
1611,0.000453,172.31.36.0-255,66,54385,6,293770
1612,0.000508,74.125.24.0-255,110,54495,6,293770
1613,0.000546,74.125.24.0-255,1484,55979,6,293770
1614,0.00055,172.31.36.0-255,66,56045,6,293770
1615,0.000554,74.125.24.0-255,1484,57529,6,293770
1616,0.000575,74.125.24.0-255,1484,59013,6,293770
1617,0.000578,172.31.36.0-255,66,59079,6,293770
1618,0.0006,74.125.24.0-255,5738,64817,6,293770
1619,0.000603,172.31.36.0-255,66,64883,6,293770
1620,0.000644,172.31.36.0-255,66,64949,6,293770
1621,0.000673,74.125.24.0-255,1484,66433,6,293770
1622,0.000702,74.125.24.0-255,5738,72171,6,293770
1623,0.000705,172.31.36.0-255,66,72237,6,293770
1624,0.000735,74.125.24.0-255,3602,75839,6,293770
1625,0.000738,172.31.36.0-255,66,75905,6,293770
1626,0.000973,74.125.24.0-255,1484,77389,6,293770
1627,0.000994,74.125.24.0-255,2902,80291,6,293770
1628,0.000999,172.31.36.0-255,66,80357,6,293770
1629,0.001006,74.125.24.0-255,5738,86095,6,293770
1630,0.001008,172.31.36.0-255,66,86161,6,293770
1631,0.001026,74.125.24.0-255,2902,89063,6,293770
1632,0.001032,172.31.36.0-255,66,89129,6,293770
1633,0.001064,74.125.24.0-255,7156,96285,6,293770
1634,0.001067,172.31.36.0-255,66,96351,6,293770
1635,0.001083,74.125.24.0-255,2902,99253,6,293770
1636,0.001085,172.31.36.0-255,66,99319,6,293770
1637,0.001088,74.125.24.0-255,1484,100803,6,293770
1638,0.001111,74.125.24.0-255,4320,105123,6,293770
1639,0.001128,74.125.24.0-255,5020,110143,6,293770
1640,0.001229,172.31.36.0-255,66,110209,6,293770
1641,0.001295,74.125.24.0-255,1484,111693,6,293770
1642,0.001301,74.125.24.0-255,2902,114595,6,293770
1643,0.001324,74.125.24.0-255,5738,120333,6,293770
1644,0.001336,74.125.24.0-255,1484,121817,6,293770
1645,0.001352,74.125.24.0-255,4320,126137,6,293770
1646,0.001366,74.125.24.0-255,4320,130457,6,293770
1647,0.001382,74.125.24.0-255,8574,139031,6,293770
1648,0.001436,74.125.24.0-255,4320,143351,6,293770
1649,0.001463,74.125.24.0-255,7856,151207,6,293770
1650,0.00155,74.125.24.0-255,9274,160481,6,293770
1651,0.001604,172.31.36.0-255,66,160547,6,293770
1652,0.001659,74.125.24.0-255,5738,166285,6,293770
1653,0.001665,172.31.36.0-255,66,166351,6,293770
1654,0.001693,74.125.24.0-255,8574,174925,6,293770
1655,0.001722,172.31.36.0-255,66,174991,6,293770
1656,0.001751,74.125.24.0-255,4320,179311,6,293770
1657,0.001761,172.31.36.0-255,66,179377,6,293770
1658,0.001813,172.31.36.0-255,66,179443,6,293770
1659,0.00185,74.125.24.0-255,8574,188017,6,293770
1660,0.001856,172.31.36.0-255,66,188083,6,293770
1661,0.001888,74.125.24.0-255,8574,196657,6,293770
1662,0.001896,172.31.36.0-255,66,196723,6,293770
1663,0.001946,74.125.24.0-255,8574,205297,6,293770
1664,0.001951,172.31.36.0-255,66,205363,6,293770
1665,0.00201,172.31.36.0-255,66,205429,6,293770
1666,0.00212,74.125.24.0-255,5738,211167,6,293770
1667,0.00215,74.125.24.0-255,10692,221859,6,293770
1668,0.002158,172.31.36.0-255,66,221925,6,293770
1669,0.002224,172.31.36.0-255,66,221991,6,293770
1670,0.002239,74.125.24.0-255,5738,227729,6,293770
1671,0.002245,172.31.36.0-255,66,227795,6,293770
1672,0.002312,74.125.24.0-255,5738,233533,6,293770
1673,0.002321,172.31.36.0-255,66,233599,6,293770
1674,0.002335,74.125.24.0-255,9992,243591,6,293770
1675,0.002344,172.31.36.0-255,66,243657,6,293770
1676,0.002376,74.125.24.0-255,766,244423,6,293770
1677,0.002458,74.125.24.0-255,1484,245907,6,293770
1678,0.002473,74.125.24.0-255,2902,248809,6,293770
1679,0.002476,74.125.24.0-255,1484,250293,6,293770
1680,0.002494,74.125.24.0-255,4320,254613,6,293770
1681,0.002497,172.31.36.0-255,66,254679,6,293770
1682,0.002503,172.31.36.0-255,66,254745,6,293770
1683,0.002578,74.125.24.0-255,1484,256229,6,293770
1684,0.002585,74.125.24.0-255,5738,261967,6,293770
1685,0.002602,172.31.36.0-255,66,262033,6,293770
1686,0.002616,74.125.24.0-255,5020,267053,6,293770
1687,0.002637,74.125.24.0-255,4320,271373,6,293770
1688,0.002647,74.125.24.0-255,1484,272857,6,293770
1689,0.002655,172.31.36.0-255,66,272923,6,293770
1690,0.002665,74.125.24.0-255,1484,274407,6,293770
1691,0.002685,74.125.24.0-255,8574,282981,6,293770
1692,0.002716,74.125.24.0-255,10218,293199,6,293770
1693,0.00272,172.31.36.0-255,66,293265,6,293770
1694,0.002725,172.31.36.0-255,66,293331,6,293770
1695,0.002763,74.125.24.0-255,97,293428,6,293770
1696,0.002765,74.125.24.0-255,105,293533,6,293770
1697,0.005351,172.31.36.0-255,66,293599,6,293770
1698,0.005386,172.31.36.0-255,105,293704,6,293770
1699,0.007409,74.125.24.0-255,66,293770,6,293770
1700,0.0,74.125.24.0-255,297,297,6,254813
1701,2.6e-05,172.31.36.0-255,66,363,6,254813
1702,3.2e-05,74.125.24.0-255,1484,1847,6,254813
1703,3.6e-05,172.31.36.0-255,66,1913,6,254813
1704,4.3e-05,74.125.24.0-255,4320,6233,6,254813
1705,4.6e-05,172.31.36.0-255,66,6299,6,254813
1706,8.3e-05,74.125.24.0-255,9041,15340,6,254813
1707,8.8e-05,172.31.36.0-255,66,15406,6,254813
1708,9.2e-05,74.125.24.0-255,2902,18308,6,254813
1709,9.4e-05,172.31.36.0-255,66,18374,6,254813
1710,0.000143,172.31.36.0-255,66,18440,6,254813
1711,0.000174,74.125.24.0-255,1484,19924,6,254813
1712,0.000177,172.31.36.0-255,66,19990,6,254813
1713,0.000182,74.125.24.0-255,2902,22892,6,254813
1714,0.000185,172.31.36.0-255,66,22958,6,254813
1715,0.000191,74.125.24.0-255,4320,27278,6,254813
1716,0.000193,172.31.36.0-255,66,27344,6,254813
1717,0.000214,74.125.24.0-255,1484,28828,6,254813
1718,0.000217,172.31.36.0-255,66,28894,6,254813
1719,0.00023,172.31.36.0-255,66,28960,6,254813
1720,0.00025,74.125.24.0-255,1125,30085,6,254813
1721,0.000252,172.31.36.0-255,66,30151,6,254813
1722,0.00026,74.125.24.0-255,7156,37307,6,254813
1723,0.000262,172.31.36.0-255,66,37373,6,254813
1724,0.000281,74.125.24.0-255,2886,40259,6,254813
1725,0.000285,172.31.36.0-255,66,40325,6,254813
1726,0.000306,74.125.24.0-255,346,40671,6,254813
1727,0.000309,172.31.36.0-255,66,40737,6,254813
1728,0.00054,74.125.24.0-255,1484,42221,6,254813
1729,0.000545,172.31.36.0-255,66,42287,6,254813
1730,0.000552,74.125.24.0-255,2902,45189,6,254813
1731,0.000555,172.31.36.0-255,66,45255,6,254813
1732,0.000561,74.125.24.0-255,5738,50993,6,254813
1733,0.000564,172.31.36.0-255,66,51059,6,254813
1734,0.000568,74.125.24.0-255,2902,53961,6,254813
1735,0.000571,172.31.36.0-255,66,54027,6,254813
1736,0.000601,74.125.24.0-255,9992,64019,6,254813
1737,0.000605,172.31.36.0-255,66,64085,6,254813
1738,0.000609,74.125.24.0-255,2902,66987,6,254813
1739,0.000611,172.31.36.0-255,66,67053,6,254813
1740,0.000637,74.125.24.0-255,7156,74209,6,254813
1741,0.00064,172.31.36.0-255,66,74275,6,254813
1742,0.000652,74.125.24.0-255,766,75041,6,254813
1743,0.000657,74.125.24.0-255,2902,77943,6,254813
1744,0.00066,172.31.36.0-255,66,78009,6,254813
1745,0.000685,74.125.24.0-255,5738,83747,6,254813
1746,0.000688,172.31.36.0-255,66,83813,6,254813
1747,0.000703,172.31.36.0-255,66,83879,6,254813
1748,0.000726,74.125.24.0-255,4320,88199,6,254813
1749,0.000729,172.31.36.0-255,66,88265,6,254813
1750,0.000758,172.31.36.0-255,66,88331,6,254813
1751,0.000787,172.31.36.0-255,66,88397,6,254813
1752,0.000792,74.125.24.0-255,4320,92717,6,254813
1753,0.000794,172.31.36.0-255,66,92783,6,254813
1754,0.000817,74.125.24.0-255,2184,94967,6,254813
1755,0.000822,172.31.36.0-255,66,95033,6,254813
1756,0.001402,74.125.24.0-255,1484,96517,6,254813
1757,0.00141,74.125.24.0-255,2902,99419,6,254813
1758,0.001414,172.31.36.0-255,66,99485,6,254813
1759,0.00142,74.125.24.0-255,5738,105223,6,254813
1760,0.001424,172.31.36.0-255,66,105289,6,254813
1761,0.001432,74.125.24.0-255,1484,106773,6,254813
1762,0.001454,172.31.36.0-255,66,106839,6,254813
1763,0.001461,74.125.24.0-255,7156,113995,6,254813
1764,0.001464,172.31.36.0-255,66,114061,6,254813
1765,0.001503,74.125.24.0-255,3602,117663,6,254813
1766,0.001506,172.31.36.0-255,66,117729,6,254813
1767,0.001587,74.125.24.0-255,1484,119213,6,254813
1768,0.001604,74.125.24.0-255,2902,122115,6,254813
1769,0.001607,172.31.36.0-255,66,122181,6,254813
1770,0.001613,74.125.24.0-255,4320,126501,6,254813
1771,0.001615,172.31.36.0-255,66,126567,6,254813
1772,0.00164,74.125.24.0-255,1484,128051,6,254813
1773,0.001654,172.31.36.0-255,66,128117,6,254813
1774,0.001697,74.125.24.0-255,2902,131019,6,254813
1775,0.0017,172.31.36.0-255,66,131085,6,254813
1776,0.001719,74.125.24.0-255,7856,138941,6,254813
1777,0.001722,172.31.36.0-255,66,139007,6,254813
1778,0.001873,74.125.24.0-255,1484,140491,6,254813
1779,0.001879,74.125.24.0-255,2902,143393,6,254813
1780,0.001882,172.31.36.0-255,66,143459,6,254813
1781,0.001888,74.125.24.0-255,5738,149197,6,254813
1782,0.001891,172.31.36.0-255,66,149263,6,254813
1783,0.001928,172.31.36.0-255,66,149329,6,254813
1784,0.001936,74.125.24.0-255,7156,156485,6,254813
1785,0.001938,172.31.36.0-255,66,156551,6,254813
1786,0.001962,74.125.24.0-255,3602,160153,6,254813
1787,0.001967,172.31.36.0-255,66,160219,6,254813
1788,0.002017,74.125.24.0-255,1484,161703,6,254813
1789,0.002032,74.125.24.0-255,2902,164605,6,254813
1790,0.002035,172.31.36.0-255,66,164671,6,254813
1791,0.002041,74.125.24.0-255,5738,170409,6,254813
1792,0.002044,172.31.36.0-255,66,170475,6,254813
1793,0.002065,74.125.24.0-255,7156,177631,6,254813
1794,0.002069,172.31.36.0-255,66,177697,6,254813
1795,0.002083,74.125.24.0-255,5738,183435,6,254813
1796,0.002086,172.31.36.0-255,66,183501,6,254813
1797,0.002093,74.125.24.0-255,7156,190657,6,254813
1798,0.002096,172.31.36.0-255,66,190723,6,254813
1799,0.002115,74.125.24.0-255,1484,192207,6,254813
1800,0.002128,74.125.24.0-255,2184,194391,6,254813
1801,0.002131,172.31.36.0-255,66,194457,6,254813
1802,0.002135,74.125.24.0-255,2902,197359,6,254813
1803,0.002137,172.31.36.0-255,66,197425,6,254813
1804,0.002152,74.125.24.0-255,1484,198909,6,254813
1805,0.002161,74.125.24.0-255,9992,208901,6,254813
1806,0.002163,172.31.36.0-255,66,208967,6,254813
1807,0.002194,172.31.36.0-255,66,209033,6,254813
1808,0.002216,74.125.24.0-255,2902,211935,6,254813
1809,0.002225,172.31.36.0-255,66,212001,6,254813
1810,0.002244,74.125.24.0-255,3602,215603,6,254813
1811,0.002248,172.31.36.0-255,66,215669,6,254813
1812,0.002254,74.125.24.0-255,7156,222825,6,254813
1813,0.002257,172.31.36.0-255,66,222891,6,254813
1814,0.002281,74.125.24.0-255,8574,231465,6,254813
1815,0.002285,172.31.36.0-255,66,231531,6,254813
1816,0.002307,74.125.24.0-255,5738,237269,6,254813
1817,0.00231,172.31.36.0-255,66,237335,6,254813
1818,0.002323,172.31.36.0-255,66,237401,6,254813
1819,0.004603,74.125.24.0-255,5738,243139,6,254813
1820,0.004611,172.31.36.0-255,66,243205,6,254813
1821,0.00689,74.125.24.0-255,5738,248943,6,254813
1822,0.006893,172.31.36.0-255,66,249009,6,254813
1823,0.009194,74.125.24.0-255,5738,254747,6,254813
1824,0.0092,172.31.36.0-255,66,254813,6,254813
1825,0.0,172.217.194.0-255,152,152,6,333354
1826,2.5e-05,172.31.36.0-255,66,218,6,333354
1827,3.1e-05,172.217.194.0-255,1484,1702,6,333354
1828,3.5e-05,172.31.36.0-255,66,1768,6,333354
1829,3.9e-05,172.217.194.0-255,2902,4670,6,333354
1830,4.1e-05,172.31.36.0-255,66,4736,6,333354
1831,4.4e-05,172.217.194.0-255,1484,6220,6,333354
1832,4.6e-05,172.31.36.0-255,66,6286,6,333354
1833,7.1e-05,172.217.194.0-255,5738,12024,6,333354
1834,7.3e-05,172.31.36.0-255,66,12090,6,333354
1835,7.9e-05,172.217.194.0-255,5738,17828,6,333354
1836,8.3e-05,172.31.36.0-255,66,17894,6,333354
1837,9.7e-05,172.217.194.0-255,1986,19880,6,333354
1838,9.9e-05,172.31.36.0-255,66,19946,6,333354
1839,0.000102,172.217.194.0-255,1484,21430,6,333354
1840,0.000103,172.31.36.0-255,66,21496,6,333354
1841,0.000134,172.217.194.0-255,9633,31129,6,333354
1842,0.000136,172.31.36.0-255,66,31195,6,333354
1843,0.000198,172.217.194.0-255,1484,32679,6,333354
1844,0.000201,172.31.36.0-255,66,32745,6,333354
1845,0.000221,172.217.194.0-255,2902,35647,6,333354
1846,0.000224,172.31.36.0-255,66,35713,6,333354
1847,0.000231,172.217.194.0-255,5738,41451,6,333354
1848,0.000232,172.31.36.0-255,66,41517,6,333354
1849,0.00026,172.217.194.0-255,6797,48314,6,333354
1850,0.000262,172.31.36.0-255,66,48380,6,333354
1851,0.000266,172.217.194.0-255,2902,51282,6,333354
1852,0.000269,172.31.36.0-255,66,51348,6,333354
1853,0.000286,172.217.194.0-255,4320,55668,6,333354
1854,0.00029,172.31.36.0-255,66,55734,6,333354
1855,0.000303,172.217.194.0-255,4320,60054,6,333354
1856,0.000305,172.31.36.0-255,66,60120,6,333354
1857,0.000327,172.217.194.0-255,5668,65788,6,333354
1858,0.00033,172.31.36.0-255,66,65854,6,333354
1859,0.000367,172.217.194.0-255,102,65956,6,333354
1860,0.000463,172.217.194.0-255,1484,67440,6,333354
1861,0.000467,172.31.36.0-255,66,67506,6,333354
1862,0.00047,172.217.194.0-255,1484,68990,6,333354
1863,0.000485,172.217.194.0-255,1484,70474,6,333354
1864,0.000488,172.31.36.0-255,66,70540,6,333354
1865,0.000493,172.217.194.0-255,5738,76278,6,333354
1866,0.000496,172.31.36.0-255,66,76344,6,333354
1867,0.000536,172.217.194.0-255,6797,83141,6,333354
1868,0.000539,172.31.36.0-255,66,83207,6,333354
1869,0.000543,172.217.194.0-255,7156,90363,6,333354
1870,0.000545,172.31.36.0-255,66,90429,6,333354
1871,0.000559,172.217.194.0-255,2902,93331,6,333354
1872,0.000561,172.31.36.0-255,66,93397,6,333354
1873,0.000575,172.217.194.0-255,6797,100194,6,333354
1874,0.000577,172.31.36.0-255,66,100260,6,333354
1875,0.000613,172.217.194.0-255,4320,104580,6,333354
1876,0.000615,172.31.36.0-255,66,104646,6,333354
1877,0.000636,172.217.194.0-255,5738,110384,6,333354
1878,0.000639,172.31.36.0-255,66,110450,6,333354
1879,0.000641,172.217.194.0-255,1484,111934,6,333354
1880,0.000678,172.217.194.0-255,5094,117028,6,333354
1881,0.000682,172.31.36.0-255,66,117094,6,333354
1882,0.000714,172.217.194.0-255,1484,118578,6,333354
1883,0.000718,172.217.194.0-255,1484,120062,6,333354
1884,0.00072,172.31.36.0-255,66,120128,6,333354
1885,0.000739,172.217.194.0-255,1484,121612,6,333354
1886,0.000745,172.217.194.0-255,5738,127350,6,333354
1887,0.000748,172.31.36.0-255,66,127416,6,333354
1888,0.000767,172.217.194.0-255,4320,131736,6,333354
1889,0.000769,172.31.36.0-255,66,131802,6,333354
1890,0.000791,172.217.194.0-255,8574,140376,6,333354
1891,0.000794,172.31.36.0-255,66,140442,6,333354
1892,0.000814,172.217.194.0-255,1484,141926,6,333354
1893,0.00083,172.217.194.0-255,9274,151200,6,333354
1894,0.000833,172.31.36.0-255,66,151266,6,333354
1895,0.001038,172.217.194.0-255,1484,152750,6,333354
1896,0.001043,172.217.194.0-255,2902,155652,6,333354
1897,0.001045,172.31.36.0-255,66,155718,6,333354
1898,0.001051,172.217.194.0-255,4320,160038,6,333354
1899,0.001053,172.31.36.0-255,66,160104,6,333354
1900,0.001064,172.217.194.0-255,1484,161588,6,333354
1901,0.001071,172.217.194.0-255,7156,168744,6,333354
1902,0.001073,172.31.36.0-255,66,168810,6,333354
1903,0.001137,172.217.194.0-255,7156,175966,6,333354
1904,0.00114,172.31.36.0-255,66,176032,6,333354
1905,0.001158,172.217.194.0-255,7156,183188,6,333354
1906,0.001161,172.31.36.0-255,66,183254,6,333354
1907,0.001165,172.217.194.0-255,2184,185438,6,333354
1908,0.001166,172.31.36.0-255,66,185504,6,333354
1909,0.001287,172.217.194.0-255,1484,186988,6,333354
1910,0.001305,172.217.194.0-255,2902,189890,6,333354
1911,0.001307,172.217.194.0-255,1484,191374,6,333354
1912,0.001313,172.31.36.0-255,66,191440,6,333354
1913,0.001331,172.217.194.0-255,4320,195760,6,333354
1914,0.001334,172.31.36.0-255,66,195826,6,333354
1915,0.001337,172.217.194.0-255,1484,197310,6,333354
1916,0.001367,172.217.194.0-255,8574,205884,6,333354
1917,0.00137,172.31.36.0-255,66,205950,6,333354
1918,0.001385,172.217.194.0-255,5738,211688,6,333354
1919,0.001388,172.31.36.0-255,66,211754,6,333354
1920,0.001414,172.217.194.0-255,7856,219610,6,333354
1921,0.001417,172.31.36.0-255,66,219676,6,333354
1922,0.001442,172.31.36.0-255,101,219777,6,333354
1923,0.001467,172.217.194.0-255,1484,221261,6,333354
1924,0.001472,172.217.194.0-255,2902,224163,6,333354
1925,0.001474,172.31.36.0-255,66,224229,6,333354
1926,0.001493,172.217.194.0-255,5738,229967,6,333354
1927,0.001495,172.31.36.0-255,66,230033,6,333354
1928,0.00152,172.217.194.0-255,5738,235771,6,333354
1929,0.001523,172.31.36.0-255,66,235837,6,333354
1930,0.001549,172.217.194.0-255,7156,242993,6,333354
1931,0.001552,172.31.36.0-255,66,243059,6,333354
1932,0.001567,172.217.194.0-255,10692,253751,6,333354
1933,0.00157,172.31.36.0-255,66,253817,6,333354
1934,0.001665,172.217.194.0-255,1484,255301,6,333354
1935,0.001681,172.217.194.0-255,2902,258203,6,333354
1936,0.001684,172.31.36.0-255,66,258269,6,333354
1937,0.001705,172.217.194.0-255,5738,264007,6,333354
1938,0.001708,172.31.36.0-255,66,264073,6,333354
1939,0.001723,172.217.194.0-255,2902,266975,6,333354
1940,0.001726,172.31.36.0-255,66,267041,6,333354
1941,0.001751,172.217.194.0-255,9992,277033,6,333354
1942,0.001754,172.31.36.0-255,66,277099,6,333354
1943,0.001762,172.217.194.0-255,8574,285673,6,333354
1944,0.001764,172.31.36.0-255,66,285739,6,333354
1945,0.001786,172.217.194.0-255,2184,287923,6,333354
1946,0.001789,172.31.36.0-255,66,287989,6,333354
1947,0.001834,172.217.194.0-255,1484,289473,6,333354
1948,0.00184,172.217.194.0-255,2902,292375,6,333354
1949,0.001843,172.31.36.0-255,66,292441,6,333354
1950,0.001846,172.217.194.0-255,1484,293925,6,333354
1951,0.001865,172.217.194.0-255,4320,298245,6,333354
1952,0.001867,172.217.194.0-255,1484,299729,6,333354
1953,0.001869,172.31.36.0-255,66,299795,6,333354
1954,0.001898,172.31.36.0-255,66,299861,6,333354
1955,0.001905,172.217.194.0-255,7156,307017,6,333354
1956,0.001907,172.31.36.0-255,66,307083,6,333354
1957,0.001921,172.217.194.0-255,3602,310685,6,333354
1958,0.001925,172.31.36.0-255,66,310751,6,333354
1959,0.001957,172.217.194.0-255,7156,317907,6,333354
1960,0.001962,172.31.36.0-255,66,317973,6,333354
1961,0.002001,172.31.36.0-255,66,318039,6,333354
1962,0.002017,172.31.36.0-255,66,318105,6,333354
1963,0.002053,172.217.194.0-255,1484,319589,6,333354
1964,0.002088,172.31.36.0-255,66,319655,6,333354
1965,0.003431,172.217.194.0-255,66,319721,6,333354
1966,0.004097,172.217.194.0-255,4320,324041,6,333354
1967,0.004102,172.31.36.0-255,66,324107,6,333354
1968,0.004117,172.217.194.0-255,1484,325591,6,333354
1969,0.006105,172.217.194.0-255,4320,329911,6,333354
1970,0.006111,172.31.36.0-255,66,329977,6,333354
1971,0.008136,172.217.194.0-255,3206,333183,6,333354
1972,0.008141,172.31.36.0-255,66,333249,6,333354
1973,0.008294,172.31.36.0-255,105,333354,6,333354
1974,0.0,172.217.194.0-255,298,298,6,264149
1975,3.4e-05,172.31.36.0-255,66,364,6,264149
1976,4.3e-05,172.217.194.0-255,1484,1848,6,264149
1977,4.8e-05,172.31.36.0-255,66,1914,6,264149
1978,6.2e-05,172.217.194.0-255,4320,6234,6,264149
1979,6.6e-05,172.31.36.0-255,66,6300,6,264149
1980,7.4e-05,172.217.194.0-255,7532,13832,6,264149
1981,7.6e-05,172.31.36.0-255,66,13898,6,264149
1982,0.000146,172.217.194.0-255,1484,15382,6,264149
1983,0.000151,172.31.36.0-255,66,15448,6,264149
1984,0.000156,172.217.194.0-255,2902,18350,6,264149
1985,0.000158,172.31.36.0-255,66,18416,6,264149
1986,0.000163,172.217.194.0-255,2902,21318,6,264149
1987,0.000166,172.31.36.0-255,66,21384,6,264149
1988,0.000198,172.217.194.0-255,2902,24286,6,264149
1989,0.000202,172.31.36.0-255,66,24352,6,264149
1990,0.000213,172.217.194.0-255,6797,31149,6,264149
1991,0.000216,172.31.36.0-255,66,31215,6,264149
1992,0.000221,172.217.194.0-255,4320,35535,6,264149
1993,0.000224,172.31.36.0-255,66,35601,6,264149
1994,0.000267,172.217.194.0-255,2902,38503,6,264149
1995,0.000271,172.31.36.0-255,66,38569,6,264149
1996,0.00028,172.217.194.0-255,9633,48202,6,264149
1997,0.000282,172.31.36.0-255,66,48268,6,264149
1998,0.000296,172.217.194.0-255,9992,58260,6,264149
1999,0.000299,172.31.36.0-255,66,58326,6,264149
2000,0.000306,172.217.194.0-255,7052,65378,6,264149
2001,0.000309,172.31.36.0-255,66,65444,6,264149
2002,0.000312,172.217.194.0-255,121,65565,6,264149
2003,0.000315,172.31.36.0-255,66,65631,6,264149
2004,0.000453,172.217.194.0-255,378,66009,6,264149
2005,0.000457,172.31.36.0-255,66,66075,6,264149
2006,0.00074,172.217.194.0-255,1484,67559,6,264149
2007,0.000746,172.217.194.0-255,2902,70461,6,264149
2008,0.000749,172.31.36.0-255,66,70527,6,264149
2009,0.000753,172.217.194.0-255,1484,72011,6,264149
2010,0.00077,172.217.194.0-255,4320,76331,6,264149
2011,0.000774,172.31.36.0-255,66,76397,6,264149
2012,0.000777,172.217.194.0-255,1484,77881,6,264149
2013,0.000818,172.31.36.0-255,66,77947,6,264149
2014,0.000828,172.217.194.0-255,10692,88639,6,264149
2015,0.000837,172.31.36.0-255,66,88705,6,264149
2016,0.000861,172.217.194.0-255,1484,90189,6,264149
2017,0.000866,172.217.194.0-255,2902,93091,6,264149
2018,0.000868,172.31.36.0-255,66,93157,6,264149
2019,0.000875,172.217.194.0-255,5738,98895,6,264149
2020,0.000877,172.31.36.0-255,66,98961,6,264149
2021,0.000898,172.217.194.0-255,1484,100445,6,264149
2022,0.000951,172.217.194.0-255,9992,110437,6,264149
2023,0.000954,172.31.36.0-255,66,110503,6,264149
2024,0.00098,172.217.194.0-255,1484,111987,6,264149
2025,0.000987,172.217.194.0-255,7156,119143,6,264149
2026,0.00099,172.31.36.0-255,66,119209,6,264149
2027,0.000997,172.217.194.0-255,6438,125647,6,264149
2028,0.001002,172.31.36.0-255,66,125713,6,264149
2029,0.001003,172.217.194.0-255,7156,132869,6,264149
2030,0.001006,172.31.36.0-255,66,132935,6,264149
2031,0.001009,172.217.194.0-255,5738,138673,6,264149
2032,0.001011,172.31.36.0-255,66,138739,6,264149
2033,0.00105,172.217.194.0-255,9992,148731,6,264149
2034,0.001054,172.31.36.0-255,66,148797,6,264149
2035,0.001062,172.217.194.0-255,7856,156653,6,264149
2036,0.001064,172.31.36.0-255,66,156719,6,264149
2037,0.001342,172.217.194.0-255,1484,158203,6,264149
2038,0.001348,172.217.194.0-255,2902,161105,6,264149
2039,0.001351,172.31.36.0-255,66,161171,6,264149
2040,0.001382,172.217.194.0-255,5738,166909,6,264149
2041,0.001386,172.31.36.0-255,66,166975,6,264149
2042,0.001392,172.217.194.0-255,5738,172713,6,264149
2043,0.001394,172.31.36.0-255,66,172779,6,264149
2044,0.001402,172.217.194.0-255,8574,181353,6,264149
2045,0.001404,172.31.36.0-255,66,181419,6,264149
2046,0.001444,172.217.194.0-255,4320,185739,6,264149
2047,0.001447,172.31.36.0-255,66,185805,6,264149
2048,0.001453,172.217.194.0-255,5020,190825,6,264149
2049,0.001455,172.31.36.0-255,66,190891,6,264149
2050,0.001698,172.217.194.0-255,1484,192375,6,264149
2051,0.001701,172.217.194.0-255,1484,193859,6,264149
2052,0.001704,172.31.36.0-255,66,193925,6,264149
2053,0.00173,172.217.194.0-255,1484,195409,6,264149
2054,0.001737,172.217.194.0-255,5738,201147,6,264149
2055,0.001739,172.31.36.0-255,66,201213,6,264149
2056,0.001766,172.217.194.0-255,2902,204115,6,264149
2057,0.00177,172.31.36.0-255,66,204181,6,264149
2058,0.001795,172.217.194.0-255,8574,212755,6,264149
2059,0.001798,172.31.36.0-255,66,212821,6,264149
2060,0.001828,172.217.194.0-255,8574,221395,6,264149
2061,0.001832,172.31.36.0-255,66,221461,6,264149
2062,0.001861,172.217.194.0-255,3602,225063,6,264149
2063,0.001865,172.31.36.0-255,66,225129,6,264149
2064,0.001876,172.217.194.0-255,1484,226613,6,264149
2065,0.001898,172.217.194.0-255,2902,229515,6,264149
2066,0.0019,172.31.36.0-255,66,229581,6,264149
2067,0.001907,172.217.194.0-255,5738,235319,6,264149
2068,0.001909,172.31.36.0-255,66,235385,6,264149
2069,0.001959,172.31.36.0-255,66,235451,6,264149
2070,0.001968,172.217.194.0-255,8574,244025,6,264149
2071,0.00197,172.31.36.0-255,66,244091,6,264149
2072,0.002003,172.217.194.0-255,2184,246275,6,264149
2073,0.002006,172.31.36.0-255,66,246341,6,264149
2074,0.004032,172.217.194.0-255,2902,249243,6,264149
2075,0.004039,172.31.36.0-255,66,249309,6,264149
2076,0.00408,172.217.194.0-255,2902,252211,6,264149
2077,0.004083,172.31.36.0-255,66,252277,6,264149
2078,0.006086,172.217.194.0-255,2902,255179,6,264149
2079,0.006088,172.31.36.0-255,66,255245,6,264149
2080,0.00614,172.217.194.0-255,2902,258147,6,264149
2081,0.006142,172.31.36.0-255,66,258213,6,264149
2082,0.008146,172.217.194.0-255,2902,261115,6,264149
2083,0.008153,172.31.36.0-255,66,261181,6,264149
2084,0.008211,172.217.194.0-255,2902,264083,6,264149
2085,0.008214,172.31.36.0-255,66,264149,6,264149
2086,0.0,172.217.194.0-255,150,150,6,242853
2087,3.4e-05,172.31.36.0-255,66,216,6,242853
2088,4.2e-05,172.217.194.0-255,1484,1700,6,242853
2089,6.5e-05,172.31.36.0-255,66,1766,6,242853
2090,7.1e-05,172.217.194.0-255,2902,4668,6,242853
2091,7.6e-05,172.31.36.0-255,66,4734,6,242853
2092,8.2e-05,172.217.194.0-255,7156,11890,6,242853
2093,8.5e-05,172.31.36.0-255,66,11956,6,242853
2094,0.000112,172.217.194.0-255,2091,14047,6,242853
2095,0.000114,172.31.36.0-255,66,14113,6,242853
2096,0.000139,172.217.194.0-255,2902,17015,6,242853
2097,0.000142,172.31.36.0-255,66,17081,6,242853
2098,0.000149,172.217.194.0-255,7156,24237,6,242853
2099,0.000151,172.31.36.0-255,66,24303,6,242853
2100,0.000158,172.217.194.0-255,6797,31100,6,242853
2101,0.00016,172.31.36.0-255,66,31166,6,242853
2102,0.000197,172.217.194.0-255,5738,36904,6,242853
2103,0.000201,172.31.36.0-255,66,36970,6,242853
2104,0.000225,172.217.194.0-255,9992,46962,6,242853
2105,0.000228,172.31.36.0-255,66,47028,6,242853
2106,0.000231,172.217.194.0-255,1125,48153,6,242853
2107,0.000233,172.31.36.0-255,66,48219,6,242853
2108,0.000262,172.217.194.0-255,9992,58211,6,242853
2109,0.000265,172.31.36.0-255,66,58277,6,242853
2110,0.000313,172.217.194.0-255,7099,65376,6,242853
2111,0.000318,172.31.36.0-255,66,65442,6,242853
2112,0.000366,172.217.194.0-255,377,65819,6,242853
2113,0.00037,172.31.36.0-255,66,65885,6,242853
2114,0.000765,172.217.194.0-255,1484,67369,6,242853
2115,0.000769,172.31.36.0-255,66,67435,6,242853
2116,0.000775,172.217.194.0-255,2902,70337,6,242853
2117,0.000777,172.31.36.0-255,66,70403,6,242853
2118,0.000782,172.217.194.0-255,4320,74723,6,242853
2119,0.00079,172.31.36.0-255,66,74789,6,242853
2120,0.000825,172.217.194.0-255,1484,76273,6,242853
2121,0.000842,172.31.36.0-255,66,76339,6,242853
2122,0.000851,172.217.194.0-255,9992,86331,6,242853
2123,0.000859,172.31.36.0-255,66,86397,6,242853
2124,0.000863,172.217.194.0-255,215,86612,6,242853
2125,0.000926,172.217.194.0-255,1484,88096,6,242853
2126,0.00093,172.31.36.0-255,66,88162,6,242853
2127,0.000936,172.217.194.0-255,2902,91064,6,242853
2128,0.000937,172.31.36.0-255,66,91130,6,242853
2129,0.00094,172.217.194.0-255,1484,92614,6,242853
2130,0.000974,172.217.194.0-255,4320,96934,6,242853
2131,0.000977,172.31.36.0-255,66,97000,6,242853
2132,0.00099,172.31.36.0-255,66,97066,6,242853
2133,0.001029,172.217.194.0-255,9992,107058,6,242853
2134,0.001032,172.31.36.0-255,66,107124,6,242853
2135,0.001048,172.217.194.0-255,766,107890,6,242853
2136,0.001185,172.217.194.0-255,1484,109374,6,242853
2137,0.001188,172.31.36.0-255,66,109440,6,242853
2138,0.001192,172.217.194.0-255,1484,110924,6,242853
2139,0.001215,172.217.194.0-255,1484,112408,6,242853
2140,0.001218,172.31.36.0-255,66,112474,6,242853
2141,0.001224,172.217.194.0-255,5738,118212,6,242853
2142,0.001227,172.31.36.0-255,66,118278,6,242853
2143,0.001241,172.217.194.0-255,9992,128270,6,242853
2144,0.001244,172.31.36.0-255,66,128336,6,242853
2145,0.001278,172.217.194.0-255,5738,134074,6,242853
2146,0.001281,172.31.36.0-255,66,134140,6,242853
2147,0.001313,172.217.194.0-255,7856,141996,6,242853
2148,0.001316,172.31.36.0-255,66,142062,6,242853
2149,0.00137,172.217.194.0-255,1484,143546,6,242853
2150,0.001376,172.217.194.0-255,2902,146448,6,242853
2151,0.001378,172.31.36.0-255,66,146514,6,242853
2152,0.001385,172.217.194.0-255,5738,152252,6,242853
2153,0.001387,172.31.36.0-255,66,152318,6,242853
2154,0.001426,172.31.36.0-255,66,152384,6,242853
2155,0.001435,172.217.194.0-255,9992,162376,6,242853
2156,0.001437,172.31.36.0-255,66,162442,6,242853
2157,0.001463,172.217.194.0-255,766,163208,6,242853
2158,0.001478,172.217.194.0-255,5738,168946,6,242853
2159,0.001482,172.31.36.0-255,66,169012,6,242853
2160,0.001524,172.217.194.0-255,7156,176168,6,242853
2161,0.001527,172.31.36.0-255,66,176234,6,242853
2162,0.001549,172.31.36.0-255,66,176300,6,242853
2163,0.001556,172.217.194.0-255,6438,182738,6,242853
2164,0.001559,172.31.36.0-255,66,182804,6,242853
2165,0.00159,172.217.194.0-255,7156,189960,6,242853
2166,0.001594,172.31.36.0-255,66,190026,6,242853
2167,0.001602,172.217.194.0-255,8574,198600,6,242853
2168,0.001604,172.31.36.0-255,66,198666,6,242853
2169,0.00165,172.217.194.0-255,766,199432,6,242853
2170,0.001653,172.31.36.0-255,66,199498,6,242853
2171,0.001689,172.217.194.0-255,5738,205236,6,242853
2172,0.001693,172.31.36.0-255,66,205302,6,242853
2173,0.001746,172.31.36.0-255,66,205368,6,242853
2174,0.001758,172.31.36.0-255,66,205434,6,242853
2175,0.001777,172.31.36.0-255,66,205500,6,242853
2176,0.001863,172.31.36.0-255,66,205566,6,242853
2177,0.001882,172.31.36.0-255,66,205632,6,242853
2178,0.001892,172.217.194.0-255,9992,215624,6,242853
2179,0.001895,172.31.36.0-255,66,215690,6,242853
2180,0.0019,172.217.194.0-255,4320,220010,6,242853
2181,0.001903,172.31.36.0-255,66,220076,6,242853
2182,0.001935,172.217.194.0-255,7856,227932,6,242853
2183,0.001939,172.31.36.0-255,66,227998,6,242853
2184,0.001958,172.31.36.0-255,66,228064,6,242853
2185,0.001967,172.217.194.0-255,9992,238056,6,242853
2186,0.001969,172.31.36.0-255,66,238122,6,242853
2187,0.002003,172.217.194.0-255,4323,242445,6,242853
2188,0.002006,172.31.36.0-255,66,242511,6,242853
2189,0.00201,172.217.194.0-255,105,242616,6,242853
2190,0.003474,172.31.36.0-255,66,242682,6,242853
2191,0.003501,172.31.36.0-255,105,242787,6,242853
2192,0.0058,172.217.194.0-255,66,242853,6,242853
2193,0.0,172.217.194.0-255,146,146,6,207306
2194,2.7e-05,172.31.36.0-255,66,212,6,207306
2195,3.4e-05,172.217.194.0-255,1484,1696,6,207306
2196,3.9e-05,172.31.36.0-255,66,1762,6,207306
2197,4.5e-05,172.217.194.0-255,2902,4664,6,207306
2198,5.6e-05,172.31.36.0-255,66,4730,6,207306
2199,6.3e-05,172.217.194.0-255,7156,11886,6,207306
2200,6.6e-05,172.31.36.0-255,66,11952,6,207306
2201,7e-05,172.217.194.0-255,2038,13990,6,207306
2202,7.4e-05,172.31.36.0-255,66,14056,6,207306
2203,0.000108,172.217.194.0-255,2902,16958,6,207306
2204,0.000111,172.31.36.0-255,66,17024,6,207306
2205,0.000115,172.217.194.0-255,2902,19926,6,207306
2206,0.000117,172.31.36.0-255,66,19992,6,207306
2207,0.00014,172.217.194.0-255,4320,24312,6,207306
2208,0.000148,172.31.36.0-255,66,24378,6,207306
2209,0.000154,172.217.194.0-255,5738,30116,6,207306
2210,0.000156,172.31.36.0-255,66,30182,6,207306
2211,0.00016,172.217.194.0-255,1125,31307,6,207306
2212,0.000162,172.31.36.0-255,66,31373,6,207306
2213,0.000196,172.217.194.0-255,1484,32857,6,207306
2214,0.000199,172.31.36.0-255,66,32923,6,207306
2215,0.000205,172.217.194.0-255,4320,37243,6,207306
2216,0.000207,172.31.36.0-255,66,37309,6,207306
2217,0.000222,172.217.194.0-255,8574,45883,6,207306
2218,0.000225,172.31.36.0-255,66,45949,6,207306
2219,0.000245,172.217.194.0-255,1484,47433,6,207306
2220,0.000247,172.217.194.0-255,1125,48558,6,207306
2221,0.000249,172.31.36.0-255,66,48624,6,207306
2222,0.000253,172.31.36.0-255,66,48690,6,207306
2223,0.000262,172.217.194.0-255,1484,50174,6,207306
2224,0.000269,172.31.36.0-255,66,50240,6,207306
2225,0.000274,172.217.194.0-255,4320,54560,6,207306
2226,0.000276,172.31.36.0-255,66,54626,6,207306
2227,0.000309,172.217.194.0-255,9992,64618,6,207306
2228,0.000313,172.31.36.0-255,66,64684,6,207306
2229,0.000316,172.217.194.0-255,1125,65809,6,207306
2230,0.000319,172.217.194.0-255,390,66199,6,207306
2231,0.000401,172.217.194.0-255,386,66585,6,207306
2232,0.000405,172.31.36.0-255,66,66651,6,207306
2233,0.000838,172.217.194.0-255,1484,68135,6,207306
2234,0.000844,172.217.194.0-255,2902,71037,6,207306
2235,0.000847,172.31.36.0-255,66,71103,6,207306
2236,0.000853,172.217.194.0-255,4320,75423,6,207306
2237,0.000855,172.31.36.0-255,66,75489,6,207306
2238,0.000881,172.217.194.0-255,1484,76973,6,207306
2239,0.000888,172.217.194.0-255,7156,84129,6,207306
2240,0.000891,172.31.36.0-255,66,84195,6,207306
2241,0.000925,172.217.194.0-255,5738,89933,6,207306
2242,0.000928,172.31.36.0-255,66,89999,6,207306
2243,0.000934,172.217.194.0-255,5738,95737,6,207306
2244,0.000936,172.31.36.0-255,66,95803,6,207306
2245,0.00096,172.217.194.0-255,5020,100823,6,207306
2246,0.000963,172.31.36.0-255,66,100889,6,207306
2247,0.001222,172.217.194.0-255,1484,102373,6,207306
2248,0.001231,172.217.194.0-255,2902,105275,6,207306
2249,0.001234,172.31.36.0-255,66,105341,6,207306
2250,0.001241,172.217.194.0-255,5738,111079,6,207306
2251,0.001243,172.31.36.0-255,66,111145,6,207306
2252,0.001247,172.217.194.0-255,2902,114047,6,207306
2253,0.001256,172.31.36.0-255,66,114113,6,207306
2254,0.001288,172.217.194.0-255,9992,124105,6,207306
2255,0.001291,172.31.36.0-255,66,124171,6,207306
2256,0.001325,172.217.194.0-255,5738,129909,6,207306
2257,0.001329,172.31.36.0-255,66,129975,6,207306
2258,0.001359,172.217.194.0-255,4469,134444,6,207306
2259,0.001363,172.31.36.0-255,66,134510,6,207306
2260,0.001368,172.217.194.0-255,1484,135994,6,207306
2261,0.001389,172.217.194.0-255,2902,138896,6,207306
2262,0.001392,172.31.36.0-255,66,138962,6,207306
2263,0.001399,172.217.194.0-255,5738,144700,6,207306
2264,0.001401,172.31.36.0-255,66,144766,6,207306
2265,0.001411,172.217.194.0-255,2902,147668,6,207306
2266,0.001413,172.31.36.0-255,66,147734,6,207306
2267,0.00142,172.217.194.0-255,5738,153472,6,207306
2268,0.001422,172.31.36.0-255,66,153538,6,207306
2269,0.001455,172.217.194.0-255,4320,157858,6,207306
2270,0.001459,172.31.36.0-255,66,157924,6,207306
2271,0.001467,172.217.194.0-255,7156,165080,6,207306
2272,0.001469,172.31.36.0-255,66,165146,6,207306
2273,0.001496,172.217.194.0-255,3602,168748,6,207306
2274,0.001503,172.31.36.0-255,66,168814,6,207306
2275,0.001554,172.217.194.0-255,1484,170298,6,207306
2276,0.001559,172.217.194.0-255,2902,173200,6,207306
2277,0.001562,172.31.36.0-255,66,173266,6,207306
2278,0.00157,172.217.194.0-255,5738,179004,6,207306
2279,0.001573,172.31.36.0-255,66,179070,6,207306
2280,0.001654,172.31.36.0-255,66,179136,6,207306
2281,0.001664,172.217.194.0-255,10692,189828,6,207306
2282,0.001673,172.31.36.0-255,66,189894,6,207306
2283,0.004245,172.217.194.0-255,5738,195632,6,207306
2284,0.00425,172.31.36.0-255,66,195698,6,207306
2285,0.00683,172.217.194.0-255,5738,201436,6,207306
2286,0.006835,172.31.36.0-255,66,201502,6,207306
2287,0.009429,172.217.194.0-255,5738,207240,6,207306
2288,0.009436,172.31.36.0-255,66,207306,6,207306
2289,0.0,172.217.194.0-255,159,159,6,218968
2290,1.3e-05,172.31.36.0-255,66,225,6,218968
2291,4.4e-05,172.217.194.0-255,1484,1709,6,218968
2292,4.9e-05,172.31.36.0-255,66,1775,6,218968
2293,5.4e-05,172.217.194.0-255,2902,4677,6,218968
2294,5.7e-05,172.31.36.0-255,66,4743,6,218968
2295,6.4e-05,172.217.194.0-255,4320,9063,6,218968
2296,7.2e-05,172.31.36.0-255,66,9129,6,218968
2297,8.8e-05,172.217.194.0-255,2902,12031,6,218968
2298,9.5e-05,172.31.36.0-255,66,12097,6,218968
2299,0.0001,172.217.194.0-255,2078,14175,6,218968
2300,0.000102,172.31.36.0-255,66,14241,6,218968
2301,0.00011,172.217.194.0-255,7156,21397,6,218968
2302,0.000113,172.31.36.0-255,66,21463,6,218968
2303,0.00015,172.217.194.0-255,4320,25783,6,218968
2304,0.000152,172.31.36.0-255,66,25849,6,218968
2305,0.000159,172.217.194.0-255,5379,31228,6,218968
2306,0.000161,172.31.36.0-255,66,31294,6,218968
2307,0.000197,172.217.194.0-255,1484,32778,6,218968
2308,0.000199,172.31.36.0-255,66,32844,6,218968
2309,0.000204,172.217.194.0-255,2902,35746,6,218968
2310,0.000206,172.31.36.0-255,66,35812,6,218968
2311,0.000211,172.217.194.0-255,2902,38714,6,218968
2312,0.000213,172.31.36.0-255,66,38780,6,218968
2313,0.000254,172.217.194.0-255,2902,41682,6,218968
2314,0.000256,172.31.36.0-255,66,41748,6,218968
2315,0.000264,172.217.194.0-255,6797,48545,6,218968
2316,0.000266,172.31.36.0-255,66,48611,6,218968
2317,0.000286,172.31.36.0-255,66,48677,6,218968
2318,0.00029,172.217.194.0-255,2848,51525,6,218968
2319,0.000293,172.31.36.0-255,66,51591,6,218968
2320,0.000445,172.217.194.0-255,381,51972,6,218968
2321,0.000711,172.217.194.0-255,1484,53456,6,218968
2322,0.000716,172.217.194.0-255,2902,56358,6,218968
2323,0.000723,172.31.36.0-255,66,56424,6,218968
2324,0.000732,172.31.36.0-255,66,56490,6,218968
2325,0.000738,172.217.194.0-255,5738,62228,6,218968
2326,0.00074,172.31.36.0-255,66,62294,6,218968
2327,0.000754,172.217.194.0-255,8574,70868,6,218968
2328,0.000757,172.31.36.0-255,66,70934,6,218968
2329,0.000781,172.217.194.0-255,4320,75254,6,218968
2330,0.000787,172.31.36.0-255,66,75320,6,218968
2331,0.000797,172.217.194.0-255,8574,83894,6,218968
2332,0.000799,172.31.36.0-255,66,83960,6,218968
2333,0.000828,172.217.194.0-255,2184,86144,6,218968
2334,0.00083,172.31.36.0-255,66,86210,6,218968
2335,0.000968,172.217.194.0-255,1484,87694,6,218968
2336,0.000974,172.217.194.0-255,2902,90596,6,218968
2337,0.000977,172.31.36.0-255,66,90662,6,218968
2338,0.001011,172.217.194.0-255,5738,96400,6,218968
2339,0.001014,172.31.36.0-255,66,96466,6,218968
2340,0.001034,172.31.36.0-255,66,96532,6,218968
2341,0.001091,172.217.194.0-255,10692,107224,6,218968
2342,0.001094,172.31.36.0-255,66,107290,6,218968
2343,0.00147,172.217.194.0-255,1484,108774,6,218968
2344,0.001476,172.217.194.0-255,2902,111676,6,218968
2345,0.001479,172.31.36.0-255,66,111742,6,218968
2346,0.001488,172.217.194.0-255,5738,117480,6,218968
2347,0.00149,172.31.36.0-255,66,117546,6,218968
2348,0.001508,172.217.194.0-255,1484,119030,6,218968
2349,0.001541,172.217.194.0-255,8574,127604,6,218968
2350,0.001543,172.31.36.0-255,66,127670,6,218968
2351,0.001581,172.31.36.0-255,66,127736,6,218968
2352,0.00168,172.217.194.0-255,1484,129220,6,218968
2353,0.001702,172.217.194.0-255,2902,132122,6,218968
2354,0.001705,172.31.36.0-255,66,132188,6,218968
2355,0.001712,172.217.194.0-255,5738,137926,6,218968
2356,0.001714,172.31.36.0-255,66,137992,6,218968
2357,0.001737,172.217.194.0-255,5738,143730,6,218968
2358,0.001743,172.31.36.0-255,66,143796,6,218968
2359,0.001777,172.217.194.0-255,7156,150952,6,218968
2360,0.001779,172.31.36.0-255,66,151018,6,218968
2361,0.00179,172.217.194.0-255,10692,161710,6,218968
2362,0.001801,172.31.36.0-255,66,161776,6,218968
2363,0.00191,172.217.194.0-255,1484,163260,6,218968
2364,0.001914,172.217.194.0-255,1484,164744,6,218968
2365,0.001917,172.31.36.0-255,66,164810,6,218968
2366,0.001944,172.217.194.0-255,1484,166294,6,218968
2367,0.001951,172.217.194.0-255,5738,172032,6,218968
2368,0.001954,172.31.36.0-255,66,172098,6,218968
2369,0.001973,172.31.36.0-255,66,172164,6,218968
2370,0.001984,172.217.194.0-255,10692,182856,6,218968
2371,0.001987,172.31.36.0-255,66,182922,6,218968
2372,0.002042,172.217.194.0-255,7156,190078,6,218968
2373,0.002046,172.31.36.0-255,66,190144,6,218968
2374,0.002054,172.217.194.0-255,8574,198718,6,218968
2375,0.002061,172.31.36.0-255,66,198784,6,218968
2376,0.002083,172.217.194.0-255,2902,201686,6,218968
2377,0.002089,172.31.36.0-255,66,201752,6,218968
2378,0.00213,172.31.36.0-255,66,201818,6,218968
2379,0.002138,172.217.194.0-255,7856,209674,6,218968
2380,0.002141,172.31.36.0-255,66,209740,6,218968
2381,0.00217,172.31.36.0-255,66,209806,6,218968
2382,0.002193,172.217.194.0-255,766,210572,6,218968
2383,0.002213,172.31.36.0-255,66,210638,6,218968
2384,0.002282,172.31.36.0-255,66,210704,6,218968
2385,0.00233,172.217.194.0-255,7856,218560,6,218968
2386,0.002333,172.31.36.0-255,66,218626,6,218968
2387,0.002381,172.217.194.0-255,105,218731,6,218968
2388,0.002404,172.31.36.0-255,66,218797,6,218968
2389,0.004609,172.31.36.0-255,105,218902,6,218968
2390,0.00721,172.217.194.0-255,66,218968,6,218968
2391,0.0,74.125.130.0-255,373,373,6,63605
2392,2.6e-05,172.31.36.0-255,66,439,6,63605
2393,3.3e-05,74.125.130.0-255,1484,1923,6,63605
2394,3.7e-05,172.31.36.0-255,66,1989,6,63605
2395,4.5e-05,74.125.130.0-255,4320,6309,6,63605
2396,4.7e-05,172.31.36.0-255,66,6375,6,63605
2397,0.000215,74.125.130.0-255,5738,12113,6,63605
2398,0.00022,172.31.36.0-255,66,12179,6,63605
2399,0.000435,74.125.130.0-255,7156,19335,6,63605
2400,0.000441,172.31.36.0-255,66,19401,6,63605
2401,0.000458,74.125.130.0-255,1923,21324,6,63605
2402,0.00046,172.31.36.0-255,66,21390,6,63605
2403,0.000792,74.125.130.0-255,9633,31023,6,63605
2404,0.000798,172.31.36.0-255,66,31089,6,63605
2405,0.001163,74.125.130.0-255,5738,36827,6,63605
2406,0.00117,172.31.36.0-255,66,36893,6,63605
2407,0.001989,74.125.130.0-255,2902,39795,6,63605
2408,0.001996,172.31.36.0-255,66,39861,6,63605
2409,0.003099,74.125.130.0-255,2902,42763,6,63605
2410,0.003101,172.31.36.0-255,66,42829,6,63605
2411,0.003922,74.125.130.0-255,2902,45731,6,63605
2412,0.003924,172.31.36.0-255,66,45797,6,63605
2413,0.005037,74.125.130.0-255,2902,48699,6,63605
2414,0.005045,172.31.36.0-255,66,48765,6,63605
2415,0.005903,74.125.130.0-255,2902,51667,6,63605
2416,0.00591,172.31.36.0-255,66,51733,6,63605
2417,0.007006,74.125.130.0-255,2902,54635,6,63605
2418,0.007015,172.31.36.0-255,66,54701,6,63605
2419,0.00785,74.125.130.0-255,2902,57603,6,63605
2420,0.007859,172.31.36.0-255,66,57669,6,63605
2421,0.008964,74.125.130.0-255,2902,60571,6,63605
2422,0.008971,172.31.36.0-255,66,60637,6,63605
2423,0.009797,74.125.130.0-255,2902,63539,6,63605
2424,0.009804,172.31.36.0-255,66,63605,6,63605
2425,0.0,172.217.160.0-255,143,143,6,204218
2426,2.3e-05,172.31.36.0-255,66,209,6,204218
2427,3.1e-05,172.217.160.0-255,1484,1693,6,204218
2428,3.6e-05,172.31.36.0-255,66,1759,6,204218
2429,7.3e-05,172.217.160.0-255,2902,4661,6,204218
2430,7.7e-05,172.31.36.0-255,66,4727,6,204218
2431,8.5e-05,172.217.160.0-255,7156,11883,6,204218
2432,8.8e-05,172.31.36.0-255,66,11949,6,204218
2433,9.6e-05,172.217.160.0-255,7613,19562,6,204218
2434,9.9e-05,172.31.36.0-255,66,19628,6,204218
2435,0.000161,172.31.36.0-255,66,19694,6,204218
2436,0.000211,172.217.160.0-255,1484,21178,6,204218
2437,0.000214,172.31.36.0-255,66,21244,6,204218
2438,0.000217,172.217.160.0-255,1484,22728,6,204218
2439,0.000219,172.31.36.0-255,66,22794,6,204218
2440,0.000251,172.217.160.0-255,2902,25696,6,204218
2441,0.000254,172.31.36.0-255,66,25762,6,204218
2442,0.000258,172.217.160.0-255,2902,28664,6,204218
2443,0.000262,172.31.36.0-255,66,28730,6,204218
2444,0.000283,172.217.160.0-255,2902,31632,6,204218
2445,0.000286,172.31.36.0-255,66,31698,6,204218
2446,0.000292,172.217.160.0-255,5379,37077,6,204218
2447,0.000294,172.31.36.0-255,66,37143,6,204218
2448,0.000514,172.217.160.0-255,1484,38627,6,204218
2449,0.000521,172.31.36.0-255,66,38693,6,204218
2450,0.000527,172.217.160.0-255,2902,41595,6,204218
2451,0.00053,172.31.36.0-255,66,41661,6,204218
2452,0.000542,172.217.160.0-255,5738,47399,6,204218
2453,0.000545,172.31.36.0-255,66,47465,6,204218
2454,0.000585,172.217.160.0-255,2902,50367,6,204218
2455,0.000588,172.31.36.0-255,66,50433,6,204218
2456,0.000617,172.217.160.0-255,4265,54698,6,204218
2457,0.000621,172.31.36.0-255,66,54764,6,204218
2458,0.001062,172.217.160.0-255,102,54866,6,204218
2459,0.001139,172.217.160.0-255,1484,56350,6,204218
2460,0.001143,172.31.36.0-255,66,56416,6,204218
2461,0.001175,172.217.160.0-255,2902,59318,6,204218
2462,0.001179,172.31.36.0-255,66,59384,6,204218
2463,0.001184,172.217.160.0-255,2902,62286,6,204218
2464,0.001186,172.31.36.0-255,66,62352,6,204218
2465,0.001191,172.217.160.0-255,2902,65254,6,204218
2466,0.001197,172.31.36.0-255,66,65320,6,204218
2467,0.001243,172.217.160.0-255,8215,73535,6,204218
2468,0.001269,172.217.160.0-255,4320,77855,6,204218
2469,0.001275,172.31.36.0-255,66,77921,6,204218
2470,0.001284,172.31.36.0-255,66,77987,6,204218
2471,0.00129,172.217.160.0-255,4320,82307,6,204218
2472,0.001297,172.31.36.0-255,66,82373,6,204218
2473,0.001304,172.217.160.0-255,6797,89170,6,204218
2474,0.001307,172.31.36.0-255,66,89236,6,204218
2475,0.00143,172.217.160.0-255,1484,90720,6,204218
2476,0.001435,172.217.160.0-255,1484,92204,6,204218
2477,0.001438,172.31.36.0-255,66,92270,6,204218
2478,0.00147,172.217.160.0-255,1484,93754,6,204218
2479,0.001477,172.217.160.0-255,5738,99492,6,204218
2480,0.001479,172.31.36.0-255,66,99558,6,204218
2481,0.001485,172.217.160.0-255,4320,103878,6,204218
2482,0.001487,172.31.36.0-255,66,103944,6,204218
2483,0.001504,172.31.36.0-255,66,104010,6,204218
2484,0.001563,172.217.160.0-255,4320,108330,6,204218
2485,0.001566,172.31.36.0-255,66,108396,6,204218
2486,0.001594,172.217.160.0-255,3602,111998,6,204218
2487,0.001598,172.31.36.0-255,66,112064,6,204218
2488,0.001621,172.217.160.0-255,1484,113548,6,204218
2489,0.001627,172.217.160.0-255,2902,116450,6,204218
2490,0.001629,172.31.36.0-255,66,116516,6,204218
2491,0.001661,172.217.160.0-255,5738,122254,6,204218
2492,0.001664,172.31.36.0-255,66,122320,6,204218
2493,0.001669,172.217.160.0-255,2902,125222,6,204218
2494,0.001671,172.31.36.0-255,66,125288,6,204218
2495,0.001707,172.217.160.0-255,9992,135280,6,204218
2496,0.00171,172.31.36.0-255,66,135346,6,204218
2497,0.001719,172.217.160.0-255,8574,143920,6,204218
2498,0.001721,172.31.36.0-255,66,143986,6,204218
2499,0.001756,172.217.160.0-255,2184,146170,6,204218
2500,0.001759,172.31.36.0-255,66,146236,6,204218
2501,0.001869,172.217.160.0-255,1484,147720,6,204218
2502,0.001875,172.217.160.0-255,2902,150622,6,204218
2503,0.001878,172.31.36.0-255,66,150688,6,204218
2504,0.001883,172.217.160.0-255,2902,153590,6,204218
2505,0.001886,172.31.36.0-255,66,153656,6,204218
2506,0.001905,172.217.160.0-255,2902,156558,6,204218
2507,0.001912,172.31.36.0-255,66,156624,6,204218
2508,0.001923,172.217.160.0-255,9992,166616,6,204218
2509,0.001925,172.31.36.0-255,66,166682,6,204218
2510,0.001957,172.217.160.0-255,2902,169584,6,204218
2511,0.00196,172.31.36.0-255,66,169650,6,204218
2512,0.001968,172.217.160.0-255,7156,176806,6,204218
2513,0.001971,172.31.36.0-255,66,176872,6,204218
2514,0.002003,172.217.160.0-255,3602,180474,6,204218
2515,0.002006,172.31.36.0-255,66,180540,6,204218
2516,0.003918,172.217.160.0-255,1484,182024,6,204218
2517,0.003946,172.217.160.0-255,4320,186344,6,204218
2518,0.00395,172.31.36.0-255,66,186410,6,204218
2519,0.005897,172.217.160.0-255,2902,189312,6,204218
2520,0.005901,172.31.36.0-255,66,189378,6,204218
2521,0.005926,172.217.160.0-255,2902,192280,6,204218
2522,0.005929,172.31.36.0-255,66,192346,6,204218
2523,0.007845,172.217.160.0-255,2902,195248,6,204218
2524,0.007852,172.31.36.0-255,66,195314,6,204218
2525,0.007882,172.217.160.0-255,2902,198216,6,204218
2526,0.007885,172.31.36.0-255,66,198282,6,204218
2527,0.009828,172.217.160.0-255,2902,201184,6,204218
2528,0.009836,172.31.36.0-255,66,201250,6,204218
2529,0.009868,172.217.160.0-255,2902,204152,6,204218
2530,0.00987,172.31.36.0-255,66,204218,6,204218
2531,0.0,74.125.24.0-255,153,153,6,139333
2532,2.2e-05,172.31.36.0-255,66,219,6,139333
2533,2.9e-05,74.125.24.0-255,1484,1703,6,139333
2534,3.4e-05,172.31.36.0-255,66,1769,6,139333
2535,4e-05,74.125.24.0-255,2902,4671,6,139333
2536,4.4e-05,172.31.36.0-255,66,4737,6,139333
2537,5.2e-05,74.125.24.0-255,7156,11893,6,139333
2538,5.5e-05,172.31.36.0-255,66,11959,6,139333
2539,5.9e-05,74.125.24.0-255,1950,13909,6,139333
2540,6.3e-05,172.31.36.0-255,66,13975,6,139333
2541,0.000126,74.125.24.0-255,1484,15459,6,139333
2542,0.000128,172.31.36.0-255,66,15525,6,139333
2543,0.000134,74.125.24.0-255,2902,18427,6,139333
2544,0.000137,172.31.36.0-255,66,18493,6,139333
2545,0.000165,74.125.24.0-255,5738,24231,6,139333
2546,0.000168,172.31.36.0-255,66,24297,6,139333
2547,0.000212,74.125.24.0-255,6797,31094,6,139333
2548,0.000215,172.31.36.0-255,66,31160,6,139333
2549,0.000287,74.125.24.0-255,1484,32644,6,139333
2550,0.00029,172.31.36.0-255,66,32710,6,139333
2551,0.000296,74.125.24.0-255,2902,35612,6,139333
2552,0.000298,172.31.36.0-255,66,35678,6,139333
2553,0.000301,74.125.24.0-255,1484,37162,6,139333
2554,0.000304,172.31.36.0-255,66,37228,6,139333
2555,0.00033,74.125.24.0-255,4320,41548,6,139333
2556,0.000332,172.31.36.0-255,66,41614,6,139333
2557,0.000339,74.125.24.0-255,5738,47352,6,139333
2558,0.000342,172.31.36.0-255,66,47418,6,139333
2559,0.00036,74.125.24.0-255,8215,55633,6,139333
2560,0.000363,172.31.36.0-255,66,55699,6,139333
2561,0.000365,74.125.24.0-255,1484,57183,6,139333
2562,0.000367,172.31.36.0-255,66,57249,6,139333
2563,0.000398,74.125.24.0-255,8215,65464,6,139333
2564,0.000401,172.31.36.0-255,66,65530,6,139333
2565,0.000519,74.125.24.0-255,410,65940,6,139333
2566,0.000953,74.125.24.0-255,333,66273,6,139333
2567,0.001016,172.31.36.0-255,66,66339,6,139333
2568,0.00128,74.125.24.0-255,1484,67823,6,139333
2569,0.00129,74.125.24.0-255,2902,70725,6,139333
2570,0.001294,172.31.36.0-255,66,70791,6,139333
2571,0.001302,74.125.24.0-255,5738,76529,6,139333
2572,0.001304,172.31.36.0-255,66,76595,6,139333
2573,0.001314,74.125.24.0-255,9992,86587,6,139333
2574,0.001316,172.31.36.0-255,66,86653,6,139333
2575,0.001325,74.125.24.0-255,8574,95227,6,139333
2576,0.001327,172.31.36.0-255,66,95293,6,139333
2577,0.001353,74.125.24.0-255,5020,100313,6,139333
2578,0.001356,172.31.36.0-255,66,100379,6,139333
2579,0.001834,74.125.24.0-255,1484,101863,6,139333
2580,0.001843,74.125.24.0-255,2902,104765,6,139333
2581,0.001847,172.31.36.0-255,66,104831,6,139333
2582,0.001854,74.125.24.0-255,4320,109151,6,139333
2583,0.001857,172.31.36.0-255,66,109217,6,139333
2584,0.001873,74.125.24.0-255,1484,110701,6,139333
2585,0.00188,74.125.24.0-255,7156,117857,6,139333
2586,0.001882,172.31.36.0-255,66,117923,6,139333
2587,0.001897,74.125.24.0-255,2902,120825,6,139333
2588,0.001899,172.31.36.0-255,66,120891,6,139333
2589,0.001935,172.31.36.0-255,66,120957,6,139333
2590,0.001939,74.125.24.0-255,2184,123141,6,139333
2591,0.001942,172.31.36.0-255,66,123207,6,139333
2592,0.004765,74.125.24.0-255,1484,124691,6,139333
2593,0.004774,74.125.24.0-255,2902,127593,6,139333
2594,0.004778,172.31.36.0-255,66,127659,6,139333
2595,0.004783,74.125.24.0-255,1484,129143,6,139333
2596,0.00713,74.125.24.0-255,4320,133463,6,139333
2597,0.007137,172.31.36.0-255,66,133529,6,139333
2598,0.009528,74.125.24.0-255,5738,139267,6,139333
2599,0.009536,172.31.36.0-255,66,139333,6,139333
2600,0.0,172.217.194.0-255,153,153,6,273597
2601,1.5e-05,172.31.36.0-255,66,219,6,273597
2602,2.1e-05,172.217.194.0-255,1484,1703,6,273597
2603,2.5e-05,172.31.36.0-255,66,1769,6,273597
2604,3e-05,172.217.194.0-255,2902,4671,6,273597
2605,3.3e-05,172.31.36.0-255,66,4737,6,273597
2606,4.6e-05,172.217.194.0-255,7156,11893,6,273597
2607,4.9e-05,172.31.36.0-255,66,11959,6,273597
2608,5.3e-05,172.217.194.0-255,2039,13998,6,273597
2609,5.6e-05,172.31.36.0-255,66,14064,6,273597
2610,0.000153,172.217.194.0-255,1484,15548,6,273597
2611,0.000157,172.31.36.0-255,66,15614,6,273597
2612,0.000161,172.217.194.0-255,2902,18516,6,273597
2613,0.000163,172.31.36.0-255,66,18582,6,273597
2614,0.000193,172.217.194.0-255,5738,24320,6,273597
2615,0.000196,172.31.36.0-255,66,24386,6,273597
2616,0.000217,172.217.194.0-255,8215,32601,6,273597
2617,0.000219,172.31.36.0-255,66,32667,6,273597
2618,0.000223,172.217.194.0-255,2902,35569,6,273597
2619,0.000225,172.31.36.0-255,66,35635,6,273597
2620,0.000252,172.217.194.0-255,5738,41373,6,273597
2621,0.000254,172.31.36.0-255,66,41439,6,273597
2622,0.00026,172.217.194.0-255,5738,47177,6,273597
2623,0.000262,172.31.36.0-255,66,47243,6,273597
2624,0.000297,172.31.36.0-255,66,47309,6,273597
2625,0.000302,172.217.194.0-255,5020,52329,6,273597
2626,0.000304,172.31.36.0-255,66,52395,6,273597
2627,0.000306,172.217.194.0-255,650,53045,6,273597
2628,0.000312,172.31.36.0-255,66,53111,6,273597
2629,0.000366,172.217.194.0-255,1484,54595,6,273597
2630,0.000369,172.31.36.0-255,66,54661,6,273597
2631,0.000373,172.217.194.0-255,2902,57563,6,273597
2632,0.000375,172.31.36.0-255,66,57629,6,273597
2633,0.000397,172.217.194.0-255,5738,63367,6,273597
2634,0.000399,172.31.36.0-255,66,63433,6,273597
2635,0.000403,172.217.194.0-255,2902,66335,6,273597
2636,0.000405,172.31.36.0-255,66,66401,6,273597
2637,0.000437,172.217.194.0-255,9992,76393,6,273597
2638,0.00044,172.31.36.0-255,66,76459,6,273597
2639,0.000449,172.217.194.0-255,10692,87151,6,273597
2640,0.000451,172.31.36.0-255,66,87217,6,273597
2641,0.000514,172.217.194.0-255,1484,88701,6,273597
2642,0.000527,172.217.194.0-255,2902,91603,6,273597
2643,0.00053,172.31.36.0-255,66,91669,6,273597
2644,0.000534,172.217.194.0-255,2902,94571,6,273597
2645,0.000536,172.31.36.0-255,66,94637,6,273597
2646,0.000567,172.217.194.0-255,2902,97539,6,273597
2647,0.000569,172.31.36.0-255,66,97605,6,273597
2648,0.000582,172.31.36.0-255,66,97671,6,273597
2649,0.000594,172.217.194.0-255,10692,108363,6,273597
2650,0.000596,172.31.36.0-255,66,108429,6,273597
2651,0.00065,172.217.194.0-255,1484,109913,6,273597
2652,0.000655,172.217.194.0-255,2902,112815,6,273597
2653,0.000658,172.31.36.0-255,66,112881,6,273597
2654,0.000686,172.217.194.0-255,5738,118619,6,273597
2655,0.000689,172.31.36.0-255,66,118685,6,273597
2656,0.000714,172.31.36.0-255,66,118751,6,273597
2657,0.000778,172.217.194.0-255,10692,129443,6,273597
2658,0.000781,172.31.36.0-255,66,129509,6,273597
2659,0.000893,172.217.194.0-255,1484,130993,6,273597
2660,0.0009,172.217.194.0-255,2902,133895,6,273597
2661,0.000903,172.31.36.0-255,66,133961,6,273597
2662,0.00091,172.217.194.0-255,5738,139699,6,273597
2663,0.000912,172.31.36.0-255,66,139765,6,273597
2664,0.000916,172.217.194.0-255,1484,141249,6,273597
2665,0.000957,172.31.36.0-255,66,141315,6,273597
2666,0.000987,172.217.194.0-255,4320,145635,6,273597
2667,0.000993,172.31.36.0-255,66,145701,6,273597
2668,0.001022,172.217.194.0-255,6438,152139,6,273597
2669,0.001025,172.31.36.0-255,66,152205,6,273597
2670,0.001052,172.217.194.0-255,1484,153689,6,273597
2671,0.001057,172.217.194.0-255,2902,156591,6,273597
2672,0.001059,172.31.36.0-255,66,156657,6,273597
2673,0.001063,172.217.194.0-255,1484,158141,6,273597
2674,0.001079,172.217.194.0-255,4320,162461,6,273597
2675,0.001082,172.31.36.0-255,66,162527,6,273597
2676,0.001105,172.217.194.0-255,8574,171101,6,273597
2677,0.001107,172.31.36.0-255,66,171167,6,273597
2678,0.001135,172.217.194.0-255,4320,175487,6,273597
2679,0.001138,172.31.36.0-255,66,175553,6,273597
2680,0.001149,172.217.194.0-255,10692,186245,6,273597
2681,0.001152,172.31.36.0-255,66,186311,6,273597
2682,0.001201,172.31.36.0-255,66,186377,6,273597
2683,0.001215,172.217.194.0-255,9992,196369,6,273597
2684,0.001218,172.31.36.0-255,66,196435,6,273597
2685,0.001253,172.31.36.0-255,66,196501,6,273597
2686,0.0013,172.31.36.0-255,66,196567,6,273597
2687,0.001313,172.31.36.0-255,66,196633,6,273597
2688,0.001343,172.217.194.0-255,9274,205907,6,273597
2689,0.001346,172.31.36.0-255,66,205973,6,273597
2690,0.001385,172.217.194.0-255,2902,208875,6,273597
2691,0.001388,172.31.36.0-255,66,208941,6,273597
2692,0.001418,172.217.194.0-255,7156,216097,6,273597
2693,0.00142,172.31.36.0-255,66,216163,6,273597
2694,0.001433,172.31.36.0-255,66,216229,6,273597
2695,0.001439,172.217.194.0-255,2902,219131,6,273597
2696,0.001441,172.31.36.0-255,66,219197,6,273597
2697,0.001475,172.217.194.0-255,9274,228471,6,273597
2698,0.001478,172.31.36.0-255,66,228537,6,273597
2699,0.001519,172.217.194.0-255,5738,234275,6,273597
2700,0.001522,172.31.36.0-255,66,234341,6,273597
2701,0.001544,172.217.194.0-255,2902,237243,6,273597
2702,0.001547,172.31.36.0-255,66,237309,6,273597
2703,0.001556,172.217.194.0-255,9992,247301,6,273597
2704,0.001558,172.31.36.0-255,66,247367,6,273597
2705,0.001575,172.31.36.0-255,66,247433,6,273597
2706,0.001582,172.217.194.0-255,7156,254589,6,273597
2707,0.001584,172.31.36.0-255,66,254655,6,273597
2708,0.001624,172.217.194.0-255,8574,263229,6,273597
2709,0.001627,172.31.36.0-255,66,263295,6,273597
2710,0.001638,172.217.194.0-255,10034,273329,6,273597
2711,0.001641,172.31.36.0-255,66,273395,6,273597
2712,0.001643,172.217.194.0-255,97,273492,6,273597
2713,0.001646,172.217.194.0-255,105,273597,6,273597
2714,0.0,74.125.24.0-255,147,147,6,312638
2715,2.8e-05,172.31.36.0-255,66,213,6,312638
2716,3.5e-05,74.125.24.0-255,1484,1697,6,312638
2717,4e-05,172.31.36.0-255,66,1763,6,312638
2718,4.5e-05,74.125.24.0-255,2902,4665,6,312638
2719,4.7e-05,172.31.36.0-255,66,4731,6,312638
2720,5.5e-05,74.125.24.0-255,7156,11887,6,312638
2721,5.8e-05,172.31.36.0-255,66,11953,6,312638
2722,8.1e-05,74.125.24.0-255,1994,13947,6,312638
2723,8.4e-05,172.31.36.0-255,66,14013,6,312638
2724,0.000111,74.125.24.0-255,2902,16915,6,312638
2725,0.000115,172.31.36.0-255,66,16981,6,312638
2726,0.000138,74.125.24.0-255,8574,25555,6,312638
2727,0.000142,172.31.36.0-255,66,25621,6,312638
2728,0.000147,74.125.24.0-255,4320,29941,6,312638
2729,0.000149,172.31.36.0-255,66,30007,6,312638
2730,0.000152,74.125.24.0-255,1125,31132,6,312638
2731,0.000154,172.31.36.0-255,66,31198,6,312638
2732,0.000277,74.125.24.0-255,1484,32682,6,312638
2733,0.000282,172.31.36.0-255,66,32748,6,312638
2734,0.000287,74.125.24.0-255,2902,35650,6,312638
2735,0.00029,172.31.36.0-255,66,35716,6,312638
2736,0.000316,74.125.24.0-255,5738,41454,6,312638
2737,0.00032,172.31.36.0-255,66,41520,6,312638
2738,0.000327,74.125.24.0-255,6797,48317,6,312638
2739,0.00033,172.31.36.0-255,66,48383,6,312638
2740,0.000367,74.125.24.0-255,5738,54121,6,312638
2741,0.000371,172.31.36.0-255,66,54187,6,312638
2742,0.000397,74.125.24.0-255,8574,62761,6,312638
2743,0.0004,172.31.36.0-255,66,62827,6,312638
2744,0.000405,74.125.24.0-255,2855,65682,6,312638
2745,0.000407,172.31.36.0-255,66,65748,6,312638
2746,0.000409,74.125.24.0-255,112,65860,6,312638
2747,0.000517,74.125.24.0-255,1484,67344,6,312638
2748,0.000522,172.31.36.0-255,66,67410,6,312638
2749,0.000528,74.125.24.0-255,2902,70312,6,312638
2750,0.00053,172.31.36.0-255,66,70378,6,312638
2751,0.000536,74.125.24.0-255,5738,76116,6,312638
2752,0.000538,172.31.36.0-255,66,76182,6,312638
2753,0.000564,74.125.24.0-255,7156,83338,6,312638
2754,0.000568,172.31.36.0-255,66,83404,6,312638
2755,0.000579,74.125.24.0-255,6797,90201,6,312638
2756,0.000582,172.31.36.0-255,66,90267,6,312638
2757,0.000586,74.125.24.0-255,2902,93169,6,312638
2758,0.00059,172.31.36.0-255,66,93235,6,312638
2759,0.000617,74.125.24.0-255,6797,100032,6,312638
2760,0.000622,172.31.36.0-255,66,100098,6,312638
2761,0.000677,74.125.24.0-255,1484,101582,6,312638
2762,0.000706,74.125.24.0-255,2902,104484,6,312638
2763,0.00071,172.31.36.0-255,66,104550,6,312638
2764,0.000717,74.125.24.0-255,5738,110288,6,312638
2765,0.000719,172.31.36.0-255,66,110354,6,312638
2766,0.000726,74.125.24.0-255,5738,116092,6,312638
2767,0.000728,172.31.36.0-255,66,116158,6,312638
2768,0.000753,74.125.24.0-255,7156,123314,6,312638
2769,0.000756,172.31.36.0-255,66,123380,6,312638
2770,0.000763,74.125.24.0-255,7156,130536,6,312638
2771,0.000766,172.31.36.0-255,66,130602,6,312638
2772,0.000792,74.125.24.0-255,3602,134204,6,312638
2773,0.000795,172.31.36.0-255,66,134270,6,312638
2774,0.000819,74.125.24.0-255,4320,138590,6,312638
2775,0.000838,74.125.24.0-255,7156,145746,6,312638
2776,0.000856,74.125.24.0-255,2902,148648,6,312638
2777,0.000863,74.125.24.0-255,5738,154386,6,312638
2778,0.000894,74.125.24.0-255,2902,157288,6,312638
2779,0.000924,74.125.24.0-255,10692,167980,6,312638
2780,0.001385,74.125.24.0-255,1484,169464,6,312638
2781,0.001392,74.125.24.0-255,2902,172366,6,312638
2782,0.001419,74.125.24.0-255,5738,178104,6,312638
2783,0.001424,74.125.24.0-255,4320,182424,6,312638
2784,0.001485,74.125.24.0-255,7856,190280,6,312638
2785,0.001561,74.125.24.0-255,1484,191764,6,312638
2786,0.001567,74.125.24.0-255,2902,194666,6,312638
2787,0.001592,74.125.24.0-255,4320,198986,6,312638
2788,0.001608,74.125.24.0-255,1484,200470,6,312638
2789,0.001705,74.125.24.0-255,7156,207626,6,312638
2790,0.001727,74.125.24.0-255,7156,214782,6,312638
2791,0.001807,74.125.24.0-255,1484,216266,6,312638
2792,0.001811,74.125.24.0-255,1484,217750,6,312638
2793,0.001821,74.125.24.0-255,1484,219234,6,312638
2794,0.001825,74.125.24.0-255,2902,222136,6,312638
2795,0.001844,74.125.24.0-255,2902,225038,6,312638
2796,0.001849,74.125.24.0-255,4320,229358,6,312638
2797,0.001865,74.125.24.0-255,5738,235096,6,312638
2798,0.001882,74.125.24.0-255,2902,237998,6,312638
2799,0.001887,74.125.24.0-255,4320,242318,6,312638
2800,0.001902,74.125.24.0-255,6438,248756,6,312638
2801,0.001927,74.125.24.0-255,1484,250240,6,312638
2802,0.001942,74.125.24.0-255,2902,253142,6,312638
2803,0.001944,74.125.24.0-255,1484,254626,6,312638
2804,0.001961,74.125.24.0-255,4320,258946,6,312638
2805,0.001974,74.125.24.0-255,1484,260430,6,312638
2806,0.001988,74.125.24.0-255,4320,264750,6,312638
2807,0.001994,74.125.24.0-255,7156,271906,6,312638
2808,0.002028,74.125.24.0-255,2902,274808,6,312638
2809,0.002049,74.125.24.0-255,9274,284082,6,312638
2810,0.002055,74.125.24.0-255,5738,289820,6,312638
2811,0.002074,74.125.24.0-255,7156,296976,6,312638
2812,0.002104,74.125.24.0-255,6438,303414,6,312638
2813,0.002107,74.125.24.0-255,1484,304898,6,312638
2814,0.002142,74.125.24.0-255,7367,312265,6,312638
2815,0.002144,74.125.24.0-255,97,312362,6,312638
2816,0.002203,74.125.24.0-255,105,312467,6,312638
2817,0.005221,172.31.36.0-255,66,312533,6,312638
2818,0.007969,172.31.36.0-255,105,312638,6,312638
2819,0.0,74.125.24.0-255,143,143,6,139249
2820,2.2e-05,172.31.36.0-255,66,209,6,139249
2821,2.9e-05,74.125.24.0-255,1484,1693,6,139249
2822,3.3e-05,172.31.36.0-255,66,1759,6,139249
2823,3.8e-05,74.125.24.0-255,2902,4661,6,139249
2824,4.7e-05,172.31.36.0-255,66,4727,6,139249
2825,5.2e-05,74.125.24.0-255,2902,7629,6,139249
2826,5.5e-05,172.31.36.0-255,66,7695,6,139249
2827,0.000103,74.125.24.0-255,6319,14014,6,139249
2828,0.000106,172.31.36.0-255,66,14080,6,139249
2829,0.000111,74.125.24.0-255,4320,18400,6,139249
2830,0.000113,172.31.36.0-255,66,18466,6,139249
2831,0.000141,74.125.24.0-255,2902,21368,6,139249
2832,0.000143,172.31.36.0-255,66,21434,6,139249
2833,0.000151,74.125.24.0-255,9633,31067,6,139249
2834,0.000152,172.31.36.0-255,66,31133,6,139249
2835,0.000305,74.125.24.0-255,1484,32617,6,139249
2836,0.000309,172.31.36.0-255,66,32683,6,139249
2837,0.000315,74.125.24.0-255,2902,35585,6,139249
2838,0.000317,172.31.36.0-255,66,35651,6,139249
2839,0.000337,74.125.24.0-255,5738,41389,6,139249
2840,0.00034,172.31.36.0-255,66,41455,6,139249
2841,0.000344,74.125.24.0-255,2902,44357,6,139249
2842,0.000346,172.31.36.0-255,66,44423,6,139249
2843,0.000371,74.125.24.0-255,2902,47325,6,139249
2844,0.000373,172.31.36.0-255,66,47391,6,139249
2845,0.000381,74.125.24.0-255,8574,55965,6,139249
2846,0.000382,172.31.36.0-255,66,56031,6,139249
2847,0.000415,74.125.24.0-255,5379,61410,6,139249
2848,0.000417,172.31.36.0-255,66,61476,6,139249
2849,0.000422,74.125.24.0-255,4234,65710,6,139249
2850,0.000424,172.31.36.0-255,66,65776,6,139249
2851,0.000427,74.125.24.0-255,128,65904,6,139249
2852,0.000525,74.125.24.0-255,1484,67388,6,139249
2853,0.000529,172.31.36.0-255,66,67454,6,139249
2854,0.000534,74.125.24.0-255,2902,70356,6,139249
2855,0.000535,172.31.36.0-255,66,70422,6,139249
2856,0.000541,74.125.24.0-255,4320,74742,6,139249
2857,0.000542,172.31.36.0-255,66,74808,6,139249
2858,0.000568,74.125.24.0-255,1484,76292,6,139249
2859,0.000574,74.125.24.0-255,6797,83089,6,139249
2860,0.000576,172.31.36.0-255,66,83155,6,139249
2861,0.000597,74.125.24.0-255,1484,84639,6,139249
2862,0.000629,172.31.36.0-255,66,84705,6,139249
2863,0.000633,74.125.24.0-255,2828,87533,6,139249
2864,0.000635,172.31.36.0-255,66,87599,6,139249
2865,0.002215,74.125.24.0-255,1484,89083,6,139249
2866,0.002227,74.125.24.0-255,2902,91985,6,139249
2867,0.002232,172.31.36.0-255,66,92051,6,139249
2868,0.002241,74.125.24.0-255,5738,97789,6,139249
2869,0.002243,172.31.36.0-255,66,97855,6,139249
2870,0.002258,74.125.24.0-255,9992,107847,6,139249
2871,0.002261,172.31.36.0-255,66,107913,6,139249
2872,0.002295,74.125.24.0-255,2902,110815,6,139249
2873,0.002297,172.31.36.0-255,66,110881,6,139249
2874,0.002304,74.125.24.0-255,7156,118037,6,139249
2875,0.002306,172.31.36.0-255,66,118103,6,139249
2876,0.002311,74.125.24.0-255,3602,121705,6,139249
2877,0.002314,172.31.36.0-255,66,121771,6,139249
2878,0.004621,74.125.24.0-255,1484,123255,6,139249
2879,0.00464,74.125.24.0-255,4320,127575,6,139249
2880,0.004643,172.31.36.0-255,66,127641,6,139249
2881,0.006947,74.125.24.0-255,5738,133379,6,139249
2882,0.006953,172.31.36.0-255,66,133445,6,139249
2883,0.009313,74.125.24.0-255,5738,139183,6,139249
2884,0.00932,172.31.36.0-255,66,139249,6,139249
2885,0.0,74.125.24.0-255,153,153,6,194818
2886,2.6e-05,172.31.36.0-255,66,219,6,194818
2887,3.3e-05,74.125.24.0-255,1484,1703,6,194818
2888,3.6e-05,172.31.36.0-255,66,1769,6,194818
2889,4.1e-05,74.125.24.0-255,2902,4671,6,194818
2890,4.3e-05,172.31.36.0-255,66,4737,6,194818
2891,5.1e-05,74.125.24.0-255,7156,11893,6,194818
2892,5.4e-05,172.31.36.0-255,66,11959,6,194818
2893,6e-05,74.125.24.0-255,7717,19676,6,194818
2894,6.4e-05,172.31.36.0-255,66,19742,6,194818
2895,9.4e-05,74.125.24.0-255,4320,24062,6,194818
2896,9.6e-05,172.31.36.0-255,66,24128,6,194818
2897,0.000118,74.125.24.0-255,6797,30925,6,194818
2898,0.000121,172.31.36.0-255,66,30991,6,194818
2899,0.000129,74.125.24.0-255,8574,39565,6,194818
2900,0.000132,172.31.36.0-255,66,39631,6,194818
2901,0.000146,74.125.24.0-255,2902,42533,6,194818
2902,0.000148,172.31.36.0-255,66,42599,6,194818
2903,0.000167,74.125.24.0-255,1484,44083,6,194818
2904,0.000169,172.31.36.0-255,66,44149,6,194818
2905,0.000182,74.125.24.0-255,1484,45633,6,194818
2906,0.000185,172.31.36.0-255,66,45699,6,194818
2907,0.000202,74.125.24.0-255,2543,48242,6,194818
2908,0.000205,172.31.36.0-255,66,48308,6,194818
2909,0.000266,74.125.24.0-255,1484,49792,6,194818
2910,0.00027,172.31.36.0-255,66,49858,6,194818
2911,0.000275,74.125.24.0-255,2902,52760,6,194818
2912,0.000279,74.125.24.0-255,4320,57080,6,194818
2913,0.000279,172.31.36.0-255,66,57146,6,194818
2914,0.000283,172.31.36.0-255,66,57212,6,194818
2915,0.000291,74.125.24.0-255,1484,58696,6,194818
2916,0.000293,172.31.36.0-255,66,58762,6,194818
2917,0.000299,74.125.24.0-255,4320,63082,6,194818
2918,0.000301,172.31.36.0-255,66,63148,6,194818
2919,0.000325,74.125.24.0-255,2543,65691,6,194818
2920,0.000329,172.31.36.0-255,66,65757,6,194818
2921,0.000344,74.125.24.0-255,647,66404,6,194818
2922,0.000509,74.125.24.0-255,1484,67888,6,194818
2923,0.000514,172.31.36.0-255,66,67954,6,194818
2924,0.000519,74.125.24.0-255,2902,70856,6,194818
2925,0.000521,172.31.36.0-255,66,70922,6,194818
2926,0.000528,74.125.24.0-255,5738,76660,6,194818
2927,0.000531,172.31.36.0-255,66,76726,6,194818
2928,0.000559,74.125.24.0-255,9992,86718,6,194818
2929,0.000562,172.31.36.0-255,66,86784,6,194818
2930,0.00059,172.31.36.0-255,66,86850,6,194818
2931,0.000595,74.125.24.0-255,1634,88484,6,194818
2932,0.000597,172.31.36.0-255,66,88550,6,194818
2933,0.000691,74.125.24.0-255,1484,90034,6,194818
2934,0.000706,74.125.24.0-255,2902,92936,6,194818
2935,0.000711,74.125.24.0-255,5738,98674,6,194818
2936,0.000711,172.31.36.0-255,66,98740,6,194818
2937,0.000715,172.31.36.0-255,66,98806,6,194818
2938,0.000741,74.125.24.0-255,7156,105962,6,194818
2939,0.000744,172.31.36.0-255,66,106028,6,194818
2940,0.000769,74.125.24.0-255,5738,111766,6,194818
2941,0.000773,172.31.36.0-255,66,111832,6,194818
2942,0.000781,74.125.24.0-255,9992,121824,6,194818
2943,0.000784,172.31.36.0-255,66,121890,6,194818
2944,0.000786,74.125.24.0-255,766,122656,6,194818
2945,0.001142,74.125.24.0-255,1484,124140,6,194818
2946,0.001145,74.125.24.0-255,1484,125624,6,194818
2947,0.001147,172.31.36.0-255,66,125690,6,194818
2948,0.001171,74.125.24.0-255,1484,127174,6,194818
2949,0.001175,172.31.36.0-255,66,127240,6,194818
2950,0.001181,74.125.24.0-255,5738,132978,6,194818
2951,0.001183,172.31.36.0-255,66,133044,6,194818
2952,0.001188,74.125.24.0-255,4320,137364,6,194818
2953,0.00119,172.31.36.0-255,66,137430,6,194818
2954,0.001219,74.125.24.0-255,8574,146004,6,194818
2955,0.001221,172.31.36.0-255,66,146070,6,194818
2956,0.001232,74.125.24.0-255,10692,156762,6,194818
2957,0.001234,172.31.36.0-255,66,156828,6,194818
2958,0.001718,74.125.24.0-255,1484,158312,6,194818
2959,0.001727,74.125.24.0-255,2902,161214,6,194818
2960,0.001732,172.31.36.0-255,66,161280,6,194818
2961,0.001736,74.125.24.0-255,1484,162764,6,194818
2962,0.001754,74.125.24.0-255,4320,167084,6,194818
2963,0.001758,172.31.36.0-255,66,167150,6,194818
2964,0.001774,74.125.24.0-255,7156,174306,6,194818
2965,0.001777,172.31.36.0-255,66,174372,6,194818
2966,0.001791,74.125.24.0-255,2902,177274,6,194818
2967,0.001793,172.31.36.0-255,66,177340,6,194818
2968,0.001835,172.31.36.0-255,66,177406,6,194818
2969,0.003883,74.125.24.0-255,5738,183144,6,194818
2970,0.003888,172.31.36.0-255,66,183210,6,194818
2971,0.005955,74.125.24.0-255,5738,188948,6,194818
2972,0.005962,172.31.36.0-255,66,189014,6,194818
2973,0.007999,74.125.24.0-255,5738,194752,6,194818
2974,0.008005,172.31.36.0-255,66,194818,6,194818
2975,0.0,172.217.194.0-255,297,297,6,316435
2976,3.1e-05,172.31.36.0-255,66,363,6,316435
2977,3.7e-05,172.217.194.0-255,1484,1847,6,316435
2978,4.2e-05,172.31.36.0-255,66,1913,6,316435
2979,4.8e-05,172.217.194.0-255,4320,6233,6,316435
2980,5.7e-05,172.31.36.0-255,66,6299,6,316435
2981,6.3e-05,172.217.194.0-255,5738,12037,6,316435
2982,6.6e-05,172.31.36.0-255,66,12103,6,316435
2983,0.00011,172.31.36.0-255,66,12169,6,316435
2984,0.000116,172.217.194.0-255,6797,18966,6,316435
2985,0.000119,172.31.36.0-255,66,19032,6,316435
2986,0.000173,172.217.194.0-255,1484,20516,6,316435
2987,0.000176,172.31.36.0-255,66,20582,6,316435
2988,0.000182,172.217.194.0-255,2902,23484,6,316435
2989,0.000186,172.31.36.0-255,66,23550,6,316435
2990,0.000191,172.217.194.0-255,5738,29288,6,316435
2991,0.000194,172.31.36.0-255,66,29354,6,316435
2992,0.000197,172.217.194.0-255,1484,30838,6,316435
2993,0.000199,172.31.36.0-255,66,30904,6,316435
2994,0.000231,172.217.194.0-255,5379,36283,6,316435
2995,0.000235,172.31.36.0-255,66,36349,6,316435
2996,0.000602,172.217.194.0-255,1484,37833,6,316435
2997,0.000607,172.31.36.0-255,66,37899,6,316435
2998,0.000613,172.217.194.0-255,2902,40801,6,316435
2999,0.000615,172.31.36.0-255,66,40867,6,316435
3000,0.00062,172.217.194.0-255,2902,43769,6,316435
3001,0.000629,172.31.36.0-255,66,43835,6,316435
3002,0.000659,172.217.194.0-255,2902,46737,6,316435
3003,0.000662,172.31.36.0-255,66,46803,6,316435
3004,0.000669,172.217.194.0-255,6797,53600,6,316435
3005,0.000671,172.31.36.0-255,66,53666,6,316435
3006,0.000741,172.217.194.0-255,1484,55150,6,316435
3007,0.000746,172.217.194.0-255,2902,58052,6,316435
3008,0.000752,172.217.194.0-255,4320,62372,6,316435
3009,0.000752,172.31.36.0-255,66,62438,6,316435
3010,0.000756,172.31.36.0-255,66,62504,6,316435
3011,0.000777,172.217.194.0-255,1484,63988,6,316435
3012,0.000807,172.217.194.0-255,2902,66890,6,316435
3013,0.00081,172.31.36.0-255,66,66956,6,316435
3014,0.000836,172.217.194.0-255,4541,71497,6,316435
3015,0.00084,172.31.36.0-255,66,71563,6,316435
3016,0.000962,172.217.194.0-255,1484,73047,6,316435
3017,0.000968,172.217.194.0-255,2902,75949,6,316435
3018,0.000971,172.31.36.0-255,66,76015,6,316435
3019,0.000976,172.217.194.0-255,1484,77499,6,316435
3020,0.001004,172.217.194.0-255,4320,81819,6,316435
3021,0.001006,172.31.36.0-255,66,81885,6,316435
3022,0.001028,172.217.194.0-255,6797,88682,6,316435
3023,0.001031,172.31.36.0-255,66,88748,6,316435
3024,0.001688,172.217.194.0-255,1484,90232,6,316435
3025,0.001699,172.217.194.0-255,2902,93134,6,316435
3026,0.001704,172.31.36.0-255,66,93200,6,316435
3027,0.001712,172.217.194.0-255,5738,98938,6,316435
3028,0.001714,172.31.36.0-255,66,99004,6,316435
3029,0.001772,172.31.36.0-255,66,99070,6,316435
3030,0.001779,172.217.194.0-255,5738,104808,6,316435
3031,0.001782,172.31.36.0-255,66,104874,6,316435
3032,0.001815,172.217.194.0-255,5020,109894,6,316435
3033,0.001819,172.31.36.0-255,66,109960,6,316435
3034,0.002106,172.217.194.0-255,1484,111444,6,316435
3035,0.002116,172.217.194.0-255,2902,114346,6,316435
3036,0.002123,172.31.36.0-255,66,114412,6,316435
3037,0.002129,172.217.194.0-255,4320,118732,6,316435
3038,0.00213,172.31.36.0-255,66,118798,6,316435
3039,0.002165,172.217.194.0-255,1484,120282,6,316435
3040,0.002175,172.217.194.0-255,9992,130274,6,316435
3041,0.002177,172.31.36.0-255,66,130340,6,316435
3042,0.002207,172.217.194.0-255,5738,136078,6,316435
3043,0.00221,172.31.36.0-255,66,136144,6,316435
3044,0.002241,172.217.194.0-255,7856,144000,6,316435
3045,0.002244,172.31.36.0-255,66,144066,6,316435
3046,0.0025,172.217.194.0-255,1484,145550,6,316435
3047,0.002506,172.217.194.0-255,2902,148452,6,316435
3048,0.00251,172.31.36.0-255,66,148518,6,316435
3049,0.002515,172.217.194.0-255,4320,152838,6,316435
3050,0.002517,172.31.36.0-255,66,152904,6,316435
3051,0.002534,172.217.194.0-255,1484,154388,6,316435
3052,0.002539,172.217.194.0-255,4320,158708,6,316435
3053,0.002541,172.31.36.0-255,66,158774,6,316435
3054,0.00257,172.217.194.0-255,8574,167348,6,316435
3055,0.002573,172.31.36.0-255,66,167414,6,316435
3056,0.002581,172.217.194.0-255,8574,175988,6,316435
3057,0.002583,172.31.36.0-255,66,176054,6,316435
3058,0.002609,172.217.194.0-255,2184,178238,6,316435
3059,0.002611,172.31.36.0-255,66,178304,6,316435
3060,0.002622,172.217.194.0-255,1484,179788,6,316435
3061,0.00263,172.217.194.0-255,2902,182690,6,316435
3062,0.002632,172.31.36.0-255,66,182756,6,316435
3063,0.002638,172.217.194.0-255,5738,188494,6,316435
3064,0.00264,172.31.36.0-255,66,188560,6,316435
3065,0.002699,172.217.194.0-255,8574,197134,6,316435
3066,0.002701,172.31.36.0-255,66,197200,6,316435
3067,0.002713,172.217.194.0-255,4320,201520,6,316435
3068,0.002715,172.31.36.0-255,66,201586,6,316435
3069,0.002725,172.217.194.0-255,10692,212278,6,316435
3070,0.002738,172.31.36.0-255,66,212344,6,316435
3071,0.00278,172.31.36.0-255,66,212410,6,316435
3072,0.002782,172.217.194.0-255,1484,213894,6,316435
3073,0.002796,172.31.36.0-255,66,213960,6,316435
3074,0.002822,172.217.194.0-255,2902,216862,6,316435
3075,0.002824,172.31.36.0-255,66,216928,6,316435
3076,0.00283,172.217.194.0-255,6438,223366,6,316435
3077,0.002832,172.31.36.0-255,66,223432,6,316435
3078,0.002837,172.217.194.0-255,7156,230588,6,316435
3079,0.002839,172.31.36.0-255,66,230654,6,316435
3080,0.002872,172.31.36.0-255,66,230720,6,316435
3081,0.002875,172.217.194.0-255,2902,233622,6,316435
3082,0.002877,172.31.36.0-255,66,233688,6,316435
3083,0.002905,172.217.194.0-255,7156,240844,6,316435
3084,0.002908,172.31.36.0-255,66,240910,6,316435
3085,0.00291,172.217.194.0-255,1484,242394,6,316435
3086,0.002914,172.217.194.0-255,3602,245996,6,316435
3087,0.002916,172.31.36.0-255,66,246062,6,316435
3088,0.003041,172.217.194.0-255,1484,247546,6,316435
3089,0.003058,172.217.194.0-255,2902,250448,6,316435
3090,0.00306,172.31.36.0-255,66,250514,6,316435
3091,0.003081,172.217.194.0-255,1484,251998,6,316435
3092,0.003088,172.217.194.0-255,8574,260572,6,316435
3093,0.00309,172.31.36.0-255,66,260638,6,316435
3094,0.003111,172.217.194.0-255,1484,262122,6,316435
3095,0.003125,172.217.194.0-255,4320,266442,6,316435
3096,0.003127,172.31.36.0-255,66,266508,6,316435
3097,0.003153,172.217.194.0-255,7156,273664,6,316435
3098,0.003155,172.31.36.0-255,66,273730,6,316435
3099,0.003157,172.217.194.0-255,1484,275214,6,316435
3100,0.003181,172.217.194.0-255,5020,280234,6,316435
3101,0.003183,172.31.36.0-255,66,280300,6,316435
3102,0.003286,172.217.194.0-255,1484,281784,6,316435
3103,0.003306,172.217.194.0-255,2902,284686,6,316435
3104,0.003308,172.31.36.0-255,66,284752,6,316435
3105,0.003311,172.217.194.0-255,1484,286236,6,316435
3106,0.003331,172.217.194.0-255,4320,290556,6,316435
3107,0.003333,172.31.36.0-255,66,290622,6,316435
3108,0.003366,172.31.36.0-255,66,290688,6,316435
3109,0.00339,172.217.194.0-255,7156,297844,6,316435
3110,0.003392,172.31.36.0-255,66,297910,6,316435
3111,0.003414,172.217.194.0-255,5020,302930,6,316435
3112,0.003416,172.31.36.0-255,66,302996,6,316435
3113,0.00342,172.217.194.0-255,2902,305898,6,316435
3114,0.003422,172.31.36.0-255,66,305964,6,316435
3115,0.003438,172.217.194.0-255,2902,308866,6,316435
3116,0.00344,172.31.36.0-255,66,308932,6,316435
3117,0.003459,172.217.194.0-255,1484,310416,6,316435
3118,0.00349,172.31.36.0-255,66,310482,6,316435
3119,0.003512,172.217.194.0-255,4320,314802,6,316435
3120,0.003514,172.31.36.0-255,66,314868,6,316435
3121,0.003526,172.217.194.0-255,1291,316159,6,316435
3122,0.003562,172.217.194.0-255,105,316264,6,316435
3123,0.008752,172.31.36.0-255,66,316330,6,316435
3124,0.008781,172.31.36.0-255,105,316435,6,316435
3125,0.0,74.125.24.0-255,66,66,6,66
3126,0.0,172.217.194.0-255,161,161,6,285304
3127,2.6e-05,172.31.36.0-255,66,227,6,285304
3128,3.4e-05,172.217.194.0-255,1484,1711,6,285304
3129,3.9e-05,172.31.36.0-255,66,1777,6,285304
3130,4.5e-05,172.217.194.0-255,2902,4679,6,285304
3131,4.8e-05,172.31.36.0-255,66,4745,6,285304
3132,5.6e-05,172.217.194.0-255,7156,11901,6,285304
3133,5.8e-05,172.31.36.0-255,66,11967,6,285304
3134,6.3e-05,172.217.194.0-255,2081,14048,6,285304
3135,6.6e-05,172.31.36.0-255,66,14114,6,285304
3136,8.1e-05,172.31.36.0-255,66,14180,6,285304
3137,8.5e-05,172.217.194.0-255,1484,15664,6,285304
3138,8.8e-05,172.31.36.0-255,66,15730,6,285304
3139,0.000117,172.217.194.0-255,3961,19691,6,285304
3140,0.000121,172.31.36.0-255,66,19757,6,285304
3141,0.000161,172.217.194.0-255,1484,21241,6,285304
3142,0.000164,172.31.36.0-255,66,21307,6,285304
3143,0.000168,172.217.194.0-255,2902,24209,6,285304
3144,0.00017,172.31.36.0-255,66,24275,6,285304
3145,0.000182,172.217.194.0-255,1484,25759,6,285304
3146,0.000184,172.31.36.0-255,66,25825,6,285304
3147,0.0002,172.217.194.0-255,4320,30145,6,285304
3148,0.000202,172.31.36.0-255,66,30211,6,285304
3149,0.000239,172.217.194.0-255,6797,37008,6,285304
3150,0.000241,172.31.36.0-255,66,37074,6,285304
3151,0.000244,172.217.194.0-255,1484,38558,6,285304
3152,0.000246,172.31.36.0-255,66,38624,6,285304
3153,0.000273,172.31.36.0-255,66,38690,6,285304
3154,0.000298,172.217.194.0-255,3162,41852,6,285304
3155,0.0003,172.31.36.0-255,66,41918,6,285304
3156,0.000403,172.217.194.0-255,1484,43402,6,285304
3157,0.000425,172.217.194.0-255,2902,46304,6,285304
3158,0.000428,172.31.36.0-255,66,46370,6,285304
3159,0.000435,172.217.194.0-255,5738,52108,6,285304
3160,0.000437,172.31.36.0-255,66,52174,6,285304
3161,0.000442,172.217.194.0-255,2902,55076,6,285304
3162,0.000445,172.31.36.0-255,66,55142,6,285304
3163,0.000477,172.217.194.0-255,9992,65134,6,285304
3164,0.00048,172.31.36.0-255,66,65200,6,285304
3165,0.000502,172.217.194.0-255,7156,72356,6,285304
3166,0.000505,172.31.36.0-255,66,72422,6,285304
3167,0.000528,172.217.194.0-255,3602,76024,6,285304
3168,0.00053,172.31.36.0-255,66,76090,6,285304
3169,0.000956,172.217.194.0-255,1484,77574,6,285304
3170,0.000963,172.217.194.0-255,2902,80476,6,285304
3171,0.000966,172.31.36.0-255,66,80542,6,285304
3172,0.000973,172.217.194.0-255,5738,86280,6,285304
3173,0.000975,172.31.36.0-255,66,86346,6,285304
3174,0.001006,172.31.36.0-255,66,86412,6,285304
3175,0.001012,172.217.194.0-255,4320,90732,6,285304
3176,0.001014,172.31.36.0-255,66,90798,6,285304
3177,0.001033,172.217.194.0-255,5738,96536,6,285304
3178,0.001035,172.31.36.0-255,66,96602,6,285304
3179,0.001038,172.217.194.0-255,766,97368,6,285304
3180,0.001411,172.217.194.0-255,1484,98852,6,285304
3181,0.001415,172.31.36.0-255,66,98918,6,285304
3182,0.001421,172.217.194.0-255,2902,101820,6,285304
3183,0.001423,172.31.36.0-255,66,101886,6,285304
3184,0.001429,172.217.194.0-255,4320,106206,6,285304
3185,0.001431,172.31.36.0-255,66,106272,6,285304
3186,0.001456,172.217.194.0-255,1484,107756,6,285304
3187,0.001469,172.31.36.0-255,66,107822,6,285304
3188,0.001489,172.217.194.0-255,1484,109306,6,285304
3189,0.001499,172.217.194.0-255,10692,119998,6,285304
3190,0.001502,172.31.36.0-255,66,120064,6,285304
3191,0.001544,172.217.194.0-255,1484,121548,6,285304
3192,0.001549,172.217.194.0-255,2902,124450,6,285304
3193,0.001551,172.31.36.0-255,66,124516,6,285304
3194,0.001572,172.217.194.0-255,5738,130254,6,285304
3195,0.001575,172.31.36.0-255,66,130320,6,285304
3196,0.001602,172.217.194.0-255,9992,140312,6,285304
3197,0.001604,172.31.36.0-255,66,140378,6,285304
3198,0.001622,172.217.194.0-255,1484,141862,6,285304
3199,0.001638,172.217.194.0-255,7156,149018,6,285304
3200,0.001641,172.31.36.0-255,66,149084,6,285304
3201,0.001664,172.217.194.0-255,5020,154104,6,285304
3202,0.001667,172.31.36.0-255,66,154170,6,285304
3203,0.001673,172.217.194.0-255,4320,158490,6,285304
3204,0.001675,172.31.36.0-255,66,158556,6,285304
3205,0.00169,172.217.194.0-255,2902,161458,6,285304
3206,0.001693,172.31.36.0-255,66,161524,6,285304
3207,0.001702,172.217.194.0-255,8574,170098,6,285304
3208,0.001704,172.31.36.0-255,66,170164,6,285304
3209,0.001776,172.31.36.0-255,66,170230,6,285304
3210,0.001793,172.217.194.0-255,2902,173132,6,285304
3211,0.001796,172.217.194.0-255,766,173898,6,285304
3212,0.001799,172.217.194.0-255,1484,175382,6,285304
3213,0.001803,172.217.194.0-255,2902,178284,6,285304
3214,0.001817,172.31.36.0-255,66,178350,6,285304
3215,0.001833,172.217.194.0-255,5738,184088,6,285304
3216,0.001839,172.217.194.0-255,5738,189826,6,285304
3217,0.00185,172.31.36.0-255,66,189892,6,285304
3218,0.00187,172.217.194.0-255,5738,195630,6,285304
3219,0.001874,172.31.36.0-255,66,195696,6,285304
3220,0.001905,172.217.194.0-255,7156,202852,6,285304
3221,0.001912,172.217.194.0-255,5020,207872,6,285304
3222,0.001924,172.31.36.0-255,66,207938,6,285304
3223,0.001955,172.217.194.0-255,1484,209422,6,285304
3224,0.001976,172.217.194.0-255,2902,212324,6,285304
3225,0.001989,172.31.36.0-255,66,212390,6,285304
3226,0.001992,172.217.194.0-255,1484,213874,6,285304
3227,0.002013,172.217.194.0-255,4320,218194,6,285304
3228,0.002032,172.31.36.0-255,66,218260,6,285304
3229,0.002039,172.217.194.0-255,1484,219744,6,285304
3230,0.002072,172.31.36.0-255,66,219810,6,285304
3231,0.002096,172.217.194.0-255,2902,222712,6,285304
3232,0.002107,172.31.36.0-255,66,222778,6,285304
3233,0.002119,172.217.194.0-255,7856,230634,6,285304
3234,0.002126,172.31.36.0-255,66,230700,6,285304
3235,0.002135,172.217.194.0-255,2902,233602,6,285304
3236,0.002157,172.217.194.0-255,8574,242176,6,285304
3237,0.002162,172.217.194.0-255,2902,245078,6,285304
3238,0.002167,172.31.36.0-255,66,245144,6,285304
3239,0.002218,172.31.36.0-255,66,245210,6,285304
3240,0.002268,172.217.194.0-255,2902,248112,6,285304
3241,0.002277,172.31.36.0-255,66,248178,6,285304
3242,0.002288,172.217.194.0-255,4320,252498,6,285304
3243,0.002293,172.31.36.0-255,66,252564,6,285304
3244,0.002302,172.217.194.0-255,4320,256884,6,285304
3245,0.00234,172.31.36.0-255,66,256950,6,285304
3246,0.002345,172.217.194.0-255,3602,260552,6,285304
3247,0.00235,172.217.194.0-255,4320,264872,6,285304
3248,0.002356,172.31.36.0-255,66,264938,6,285304
3249,0.002374,172.217.194.0-255,7156,272094,6,285304
3250,0.002392,172.31.36.0-255,66,272160,6,285304
3251,0.002414,172.31.36.0-255,66,272226,6,285304
3252,0.002433,172.217.194.0-255,766,272992,6,285304
3253,0.002436,172.217.194.0-255,1484,274476,6,285304
3254,0.002444,172.217.194.0-255,8574,283050,6,285304
3255,0.00245,172.31.36.0-255,66,283116,6,285304
3256,0.002465,172.217.194.0-255,1846,284962,6,285304
3257,0.002468,172.217.194.0-255,105,285067,6,285304
3258,0.002486,172.31.36.0-255,66,285133,6,285304
3259,0.004451,172.31.36.0-255,105,285238,6,285304
3260,0.00675,172.217.194.0-255,66,285304,6,285304
3261,0.0,74.125.24.0-255,152,152,6,320176
3262,2.4e-05,172.31.36.0-255,66,218,6,320176
3263,3.2e-05,74.125.24.0-255,1484,1702,6,320176
3264,3.5e-05,172.31.36.0-255,66,1768,6,320176
3265,4.1e-05,74.125.24.0-255,2902,4670,6,320176
3266,4.4e-05,172.31.36.0-255,66,4736,6,320176
3267,5.2e-05,74.125.24.0-255,7156,11892,6,320176
3268,5.6e-05,172.31.36.0-255,66,11958,6,320176
3269,6e-05,74.125.24.0-255,1947,13905,6,320176
3270,6.2e-05,172.31.36.0-255,66,13971,6,320176
3271,0.000241,74.125.24.0-255,1484,15455,6,320176
3272,0.000246,172.31.36.0-255,66,15521,6,320176
3273,0.000252,74.125.24.0-255,2902,18423,6,320176
3274,0.000255,172.31.36.0-255,66,18489,6,320176
3275,0.00026,74.125.24.0-255,2902,21391,6,320176
3276,0.000263,172.31.36.0-255,66,21457,6,320176
3277,0.000284,74.125.24.0-255,2902,24359,6,320176
3278,0.000286,172.31.36.0-255,66,24425,6,320176
3279,0.000346,74.125.24.0-255,1484,25909,6,320176
3280,0.00035,172.31.36.0-255,66,25975,6,320176
3281,0.000365,74.125.24.0-255,5379,31354,6,320176
3282,0.000368,172.31.36.0-255,66,31420,6,320176
3283,0.001018,74.125.24.0-255,1484,32904,6,320176
3284,0.001024,172.31.36.0-255,66,32970,6,320176
3285,0.001034,74.125.24.0-255,2902,35872,6,320176
3286,0.001037,172.31.36.0-255,66,35938,6,320176
3287,0.001044,74.125.24.0-255,5738,41676,6,320176
3288,0.001046,172.31.36.0-255,66,41742,6,320176
3289,0.001085,172.31.36.0-255,66,41808,6,320176
3290,0.001093,74.125.24.0-255,7156,48964,6,320176
3291,0.001095,172.31.36.0-255,66,49030,6,320176
3292,0.00114,74.125.24.0-255,2852,51882,6,320176
3293,0.001143,172.31.36.0-255,66,51948,6,320176
3294,0.001397,74.125.24.0-255,346,52294,6,320176
3295,0.001492,74.125.24.0-255,1484,53778,6,320176
3296,0.001498,172.31.36.0-255,66,53844,6,320176
3297,0.001504,74.125.24.0-255,2902,56746,6,320176
3298,0.001506,172.31.36.0-255,66,56812,6,320176
3299,0.001536,74.125.24.0-255,5738,62550,6,320176
3300,0.001538,172.31.36.0-255,66,62616,6,320176
3301,0.001545,74.125.24.0-255,6797,69413,6,320176
3302,0.001547,172.31.36.0-255,66,69479,6,320176
3303,0.001583,74.125.24.0-255,4320,73799,6,320176
3304,0.001585,172.31.36.0-255,66,73865,6,320176
3305,0.001604,74.125.24.0-255,5738,79603,6,320176
3306,0.001606,172.31.36.0-255,66,79669,6,320176
3307,0.001639,74.125.24.0-255,2902,82571,6,320176
3308,0.001643,172.31.36.0-255,66,82637,6,320176
3309,0.001662,74.125.24.0-255,3961,86598,6,320176
3310,0.001664,172.31.36.0-255,66,86664,6,320176
3311,0.002091,74.125.24.0-255,1484,88148,6,320176
3312,0.002112,74.125.24.0-255,2902,91050,6,320176
3313,0.002115,172.31.36.0-255,66,91116,6,320176
3314,0.002139,74.125.24.0-255,5738,96854,6,320176
3315,0.002142,172.31.36.0-255,66,96920,6,320176
3316,0.002148,74.125.24.0-255,5738,102658,6,320176
3317,0.002151,172.31.36.0-255,66,102724,6,320176
3318,0.002156,74.125.24.0-255,4320,107044,6,320176
3319,0.002159,172.31.36.0-255,66,107110,6,320176
3320,0.002177,74.125.24.0-255,2902,110012,6,320176
3321,0.002179,172.31.36.0-255,66,110078,6,320176
3322,0.002183,74.125.24.0-255,1484,111562,6,320176
3323,0.002206,74.125.24.0-255,9274,120836,6,320176
3324,0.002209,172.31.36.0-255,66,120902,6,320176
3325,0.002234,74.125.24.0-255,1484,122386,6,320176
3326,0.002239,74.125.24.0-255,2902,125288,6,320176
3327,0.002242,172.31.36.0-255,66,125354,6,320176
3328,0.002245,74.125.24.0-255,1484,126838,6,320176
3329,0.002264,74.125.24.0-255,4320,131158,6,320176
3330,0.002267,172.31.36.0-255,66,131224,6,320176
3331,0.002308,74.125.24.0-255,8574,139798,6,320176
3332,0.00231,172.31.36.0-255,66,139864,6,320176
3333,0.002318,74.125.24.0-255,7156,147020,6,320176
3334,0.002321,172.31.36.0-255,66,147086,6,320176
3335,0.002345,74.125.24.0-255,7856,154942,6,320176
3336,0.002347,172.31.36.0-255,66,155008,6,320176
3337,0.002472,74.125.24.0-255,1484,156492,6,320176
3338,0.00249,74.125.24.0-255,2902,159394,6,320176
3339,0.002493,172.31.36.0-255,66,159460,6,320176
3340,0.002511,74.125.24.0-255,1484,160944,6,320176
3341,0.002527,74.125.24.0-255,2902,163846,6,320176
3342,0.00253,172.31.36.0-255,66,163912,6,320176
3343,0.002535,74.125.24.0-255,2902,166814,6,320176
3344,0.002537,172.31.36.0-255,66,166880,6,320176
3345,0.002552,74.125.24.0-255,2902,169782,6,320176
3346,0.002555,172.31.36.0-255,66,169848,6,320176
3347,0.00256,74.125.24.0-255,2902,172750,6,320176
3348,0.002562,172.31.36.0-255,66,172816,6,320176
3349,0.002591,74.125.24.0-255,8574,181390,6,320176
3350,0.002594,172.31.36.0-255,66,181456,6,320176
3351,0.0026,74.125.24.0-255,5738,187194,6,320176
3352,0.002603,172.31.36.0-255,66,187260,6,320176
3353,0.002617,74.125.24.0-255,2184,189444,6,320176
3354,0.00262,172.31.36.0-255,66,189510,6,320176
3355,0.002813,74.125.24.0-255,1484,190994,6,320176
3356,0.002838,74.125.24.0-255,2902,193896,6,320176
3357,0.002841,172.31.36.0-255,66,193962,6,320176
3358,0.002847,74.125.24.0-255,5738,199700,6,320176
3359,0.00285,172.31.36.0-255,66,199766,6,320176
3360,0.002854,74.125.24.0-255,2902,202668,6,320176
3361,0.002856,172.31.36.0-255,66,202734,6,320176
3362,0.002896,74.125.24.0-255,1484,204218,6,320176
3363,0.002911,74.125.24.0-255,2902,207120,6,320176
3364,0.002913,172.31.36.0-255,66,207186,6,320176
3365,0.002922,74.125.24.0-255,8574,215760,6,320176
3366,0.002924,172.31.36.0-255,66,215826,6,320176
3367,0.00293,74.125.24.0-255,4320,220146,6,320176
3368,0.002932,172.31.36.0-255,66,220212,6,320176
3369,0.002951,74.125.24.0-255,3602,223814,6,320176
3370,0.002953,172.31.36.0-255,66,223880,6,320176
3371,0.003078,74.125.24.0-255,1484,225364,6,320176
3372,0.003087,74.125.24.0-255,2902,228266,6,320176
3373,0.003091,172.31.36.0-255,66,228332,6,320176
3374,0.003095,74.125.24.0-255,1484,229816,6,320176
3375,0.003116,74.125.24.0-255,4320,234136,6,320176
3376,0.003118,172.31.36.0-255,66,234202,6,320176
3377,0.003128,74.125.24.0-255,4320,238522,6,320176
3378,0.00313,172.31.36.0-255,66,238588,6,320176
3379,0.003165,74.125.24.0-255,2902,241490,6,320176
3380,0.003167,172.31.36.0-255,66,241556,6,320176
3381,0.003184,172.31.36.0-255,66,241622,6,320176
3382,0.003188,74.125.24.0-255,2184,243806,6,320176
3383,0.003191,172.31.36.0-255,66,243872,6,320176
3384,0.003207,172.31.36.0-255,66,243938,6,320176
3385,0.003229,74.125.24.0-255,2902,246840,6,320176
3386,0.003231,172.31.36.0-255,66,246906,6,320176
3387,0.003248,172.31.36.0-255,66,246972,6,320176
3388,0.003255,74.125.24.0-255,5738,252710,6,320176
3389,0.003257,172.31.36.0-255,66,252776,6,320176
3390,0.003287,74.125.24.0-255,9992,262768,6,320176
3391,0.00329,172.31.36.0-255,66,262834,6,320176
3392,0.003303,172.31.36.0-255,66,262900,6,320176
3393,0.003321,74.125.24.0-255,5738,268638,6,320176
3394,0.003325,172.31.36.0-255,66,268704,6,320176
3395,0.003332,74.125.24.0-255,5020,273724,6,320176
3396,0.003335,172.31.36.0-255,66,273790,6,320176
3397,0.003341,74.125.24.0-255,5738,279528,6,320176
3398,0.003344,172.31.36.0-255,66,279594,6,320176
3399,0.003347,74.125.24.0-255,1484,281078,6,320176
3400,0.003352,74.125.24.0-255,4320,285398,6,320176
3401,0.003355,172.31.36.0-255,66,285464,6,320176
3402,0.003374,74.125.24.0-255,7156,292620,6,320176
3403,0.003377,172.31.36.0-255,66,292686,6,320176
3404,0.00338,74.125.24.0-255,1484,294170,6,320176
3405,0.003403,74.125.24.0-255,7156,301326,6,320176
3406,0.003405,172.31.36.0-255,66,301392,6,320176
3407,0.003427,74.125.24.0-255,7856,309248,6,320176
3408,0.00343,172.31.36.0-255,66,309314,6,320176
3409,0.003433,74.125.24.0-255,1484,310798,6,320176
3410,0.003437,74.125.24.0-255,1484,312282,6,320176
3411,0.003438,172.31.36.0-255,66,312348,6,320176
3412,0.003463,74.125.24.0-255,7156,319504,6,320176
3413,0.003465,172.31.36.0-255,66,319570,6,320176
3414,0.003498,172.31.36.0-255,66,319636,6,320176
3415,0.003501,74.125.24.0-255,97,319733,6,320176
3416,0.003504,74.125.24.0-255,105,319838,6,320176
3417,0.005544,172.31.36.0-255,101,319939,6,320176
3418,0.007242,172.31.36.0-255,105,320044,6,320176
3419,0.007801,74.125.24.0-255,66,320110,6,320176
3420,0.009467,74.125.24.0-255,66,320176,6,320176
3421,0.0,74.125.24.0-255,153,153,6,65001
3422,2.6e-05,172.31.36.0-255,66,219,6,65001
3423,3.3e-05,74.125.24.0-255,1484,1703,6,65001
3424,3.7e-05,172.31.36.0-255,66,1769,6,65001
3425,4.2e-05,74.125.24.0-255,2902,4671,6,65001
3426,4.5e-05,172.31.36.0-255,66,4737,6,65001
3427,4.9e-05,74.125.24.0-255,2902,7639,6,65001
3428,5.1e-05,172.31.36.0-255,66,7705,6,65001
3429,8.7e-05,74.125.24.0-255,4320,12025,6,65001
3430,9.2e-05,172.31.36.0-255,66,12091,6,65001
3431,0.000105,74.125.24.0-255,2018,14109,6,65001
3432,0.000107,172.31.36.0-255,66,14175,6,65001
3433,0.000285,74.125.24.0-255,1484,15659,6,65001
3434,0.000289,172.31.36.0-255,66,15725,6,65001
3435,0.000296,74.125.24.0-255,2902,18627,6,65001
3436,0.0003,172.31.36.0-255,66,18693,6,65001
3437,0.000304,74.125.24.0-255,2902,21595,6,65001
3438,0.000306,172.31.36.0-255,66,21661,6,65001
3439,0.000327,74.125.24.0-255,2902,24563,6,65001
3440,0.000331,172.31.36.0-255,66,24629,6,65001
3441,0.000335,74.125.24.0-255,2902,27531,6,65001
3442,0.000337,172.31.36.0-255,66,27597,6,65001
3443,0.000353,74.125.24.0-255,3961,31558,6,65001
3444,0.000356,172.31.36.0-255,66,31624,6,65001
3445,0.000646,74.125.24.0-255,1484,33108,6,65001
3446,0.000666,172.31.36.0-255,66,33174,6,65001
3447,0.000673,74.125.24.0-255,2902,36076,6,65001
3448,0.000676,172.31.36.0-255,66,36142,6,65001
3449,0.000684,74.125.24.0-255,5738,41880,6,65001
3450,0.000686,172.31.36.0-255,66,41946,6,65001
3451,0.000727,172.31.36.0-255,66,42012,6,65001
3452,0.000741,172.31.36.0-255,66,42078,6,65001
3453,0.000744,74.125.24.0-255,1125,43203,6,65001
3454,0.002833,74.125.24.0-255,4320,47523,6,65001
3455,0.002841,172.31.36.0-255,66,47589,6,65001
3456,0.004904,74.125.24.0-255,5738,53327,6,65001
3457,0.004912,172.31.36.0-255,66,53393,6,65001
3458,0.007,74.125.24.0-255,5738,59131,6,65001
3459,0.007006,172.31.36.0-255,66,59197,6,65001
3460,0.009099,74.125.24.0-255,5738,64935,6,65001
3461,0.009106,172.31.36.0-255,66,65001,6,65001
3462,0.0,172.217.194.0-255,150,150,6,134988
3463,2.2e-05,172.31.36.0-255,66,216,6,134988
3464,3e-05,172.217.194.0-255,1484,1700,6,134988
3465,3.5e-05,172.31.36.0-255,66,1766,6,134988
3466,4.1e-05,172.217.194.0-255,2902,4668,6,134988
3467,4.3e-05,172.31.36.0-255,66,4734,6,134988
3468,5.2e-05,172.217.194.0-255,7156,11890,6,134988
3469,5.7e-05,172.31.36.0-255,66,11956,6,134988
3470,6.1e-05,172.217.194.0-255,2036,13992,6,134988
3471,7.3e-05,172.31.36.0-255,66,14058,6,134988
3472,0.000123,172.217.194.0-255,1484,15542,6,134988
3473,0.000126,172.31.36.0-255,66,15608,6,134988
3474,0.000132,172.217.194.0-255,2902,18510,6,134988
3475,0.000135,172.31.36.0-255,66,18576,6,134988
3476,0.00017,172.217.194.0-255,5738,24314,6,134988
3477,0.000173,172.31.36.0-255,66,24380,6,134988
3478,0.000202,172.217.194.0-255,5738,30118,6,134988
3479,0.000204,172.31.36.0-255,66,30184,6,134988
3480,0.000233,172.217.194.0-255,5379,35563,6,134988
3481,0.000236,172.31.36.0-255,66,35629,6,134988
3482,0.000245,172.217.194.0-255,9992,45621,6,134988
3483,0.000248,172.31.36.0-255,66,45687,6,134988
3484,0.000252,172.217.194.0-255,2902,48589,6,134988
3485,0.000254,172.31.36.0-255,66,48655,6,134988
3486,0.000294,172.31.36.0-255,66,48721,6,134988
3487,0.000642,172.217.194.0-255,379,49100,6,134988
3488,0.000647,172.31.36.0-255,66,49166,6,134988
3489,0.00099,172.217.194.0-255,1484,50650,6,134988
3490,0.000995,172.31.36.0-255,66,50716,6,134988
3491,0.000999,172.217.194.0-255,1484,52200,6,134988
3492,0.001001,172.31.36.0-255,66,52266,6,134988
3493,0.001021,172.217.194.0-255,1484,53750,6,134988
3494,0.001033,172.217.194.0-255,5738,59488,6,134988
3495,0.001036,172.31.36.0-255,66,59554,6,134988
3496,0.001069,172.217.194.0-255,7156,66710,6,134988
3497,0.001071,172.31.36.0-255,66,66776,6,134988
3498,0.001118,172.217.194.0-255,5738,72514,6,134988
3499,0.001122,172.31.36.0-255,66,72580,6,134988
3500,0.001132,172.217.194.0-255,10692,83272,6,134988
3501,0.001134,172.31.36.0-255,66,83338,6,134988
3502,0.001732,172.217.194.0-255,1484,84822,6,134988
3503,0.00174,172.217.194.0-255,1484,86306,6,134988
3504,0.001744,172.31.36.0-255,66,86372,6,134988
3505,0.001778,172.217.194.0-255,1484,87856,6,134988
3506,0.001784,172.217.194.0-255,5738,93594,6,134988
3507,0.001787,172.31.36.0-255,66,93660,6,134988
3508,0.001794,172.217.194.0-255,7156,100816,6,134988
3509,0.001796,172.31.36.0-255,66,100882,6,134988
3510,0.001827,172.217.194.0-255,9992,110874,6,134988
3511,0.001831,172.31.36.0-255,66,110940,6,134988
3512,0.001855,172.217.194.0-255,4320,115260,6,134988
3513,0.001858,172.31.36.0-255,66,115326,6,134988
3514,0.001862,172.217.194.0-255,2184,117510,6,134988
3515,0.001865,172.31.36.0-255,66,117576,6,134988
3516,0.003924,172.217.194.0-255,5738,123314,6,134988
3517,0.003927,172.31.36.0-255,66,123380,6,134988
3518,0.006033,172.217.194.0-255,5738,129118,6,134988
3519,0.006038,172.31.36.0-255,66,129184,6,134988
3520,0.008112,172.217.194.0-255,5738,134922,6,134988
3521,0.00812,172.31.36.0-255,66,134988,6,134988
3522,0.0,172.217.194.0-255,297,297,6,157108
3523,1.7e-05,172.31.36.0-255,66,363,6,157108
3524,2.4e-05,172.217.194.0-255,1484,1847,6,157108
3525,3e-05,172.31.36.0-255,66,1913,6,157108
3526,4.4e-05,172.217.194.0-255,4320,6233,6,157108
3527,4.8e-05,172.31.36.0-255,66,6299,6,157108
3528,5.8e-05,172.217.194.0-255,8995,15294,6,157108
3529,6.2e-05,172.31.36.0-255,66,15360,6,157108
3530,0.000127,172.217.194.0-255,4320,19680,6,157108
3531,0.000131,172.31.36.0-255,66,19746,6,157108
3532,0.000173,172.217.194.0-255,1484,21230,6,157108
3533,0.000176,172.31.36.0-255,66,21296,6,157108
3534,0.000211,172.217.194.0-255,9633,30929,6,157108
3535,0.000214,172.31.36.0-255,66,30995,6,157108
3536,0.000289,172.217.194.0-255,2902,33897,6,157108
3537,0.000294,172.31.36.0-255,66,33963,6,157108
3538,0.000324,172.217.194.0-255,8574,42537,6,157108
3539,0.000327,172.31.36.0-255,66,42603,6,157108
3540,0.000405,172.217.194.0-255,6797,49400,6,157108
3541,0.000409,172.31.36.0-255,66,49466,6,157108
3542,0.000472,172.217.194.0-255,8574,58040,6,157108
3543,0.000476,172.31.36.0-255,66,58106,6,157108
3544,0.000498,172.217.194.0-255,7050,65156,6,157108
3545,0.000501,172.31.36.0-255,66,65222,6,157108
3546,0.000604,172.217.194.0-255,432,65654,6,157108
3547,0.000609,172.31.36.0-255,66,65720,6,157108
3548,0.000634,172.217.194.0-255,1484,67204,6,157108
3549,0.000636,172.31.36.0-255,66,67270,6,157108
3550,0.000642,172.217.194.0-255,4320,71590,6,157108
3551,0.000645,172.31.36.0-255,66,71656,6,157108
3552,0.000705,172.217.194.0-255,9992,81648,6,157108
3553,0.000714,172.31.36.0-255,66,81714,6,157108
3554,0.000779,172.217.194.0-255,2902,84616,6,157108
3555,0.000782,172.31.36.0-255,66,84682,6,157108
3556,0.000825,172.31.36.0-255,66,84748,6,157108
3557,0.001322,172.217.194.0-255,1484,86232,6,157108
3558,0.001343,172.217.194.0-255,2902,89134,6,157108
3559,0.001347,172.31.36.0-255,66,89200,6,157108
3560,0.001353,172.217.194.0-255,4320,93520,6,157108
3561,0.001355,172.31.36.0-255,66,93586,6,157108
3562,0.001374,172.217.194.0-255,1484,95070,6,157108
3563,0.001412,172.217.194.0-255,4320,99390,6,157108
3564,0.001415,172.31.36.0-255,66,99456,6,157108
3565,0.001448,172.217.194.0-255,8574,108030,6,157108
3566,0.001452,172.31.36.0-255,66,108096,6,157108
3567,0.00153,172.217.194.0-255,5738,113834,6,157108
3568,0.001534,172.31.36.0-255,66,113900,6,157108
3569,0.001552,172.217.194.0-255,4320,118220,6,157108
3570,0.001554,172.31.36.0-255,66,118286,6,157108
3571,0.001611,172.217.194.0-255,766,119052,6,157108
3572,0.001955,172.31.36.0-255,66,119118,6,157108
3573,0.00225,172.217.194.0-255,1484,120602,6,157108
3574,0.00226,172.217.194.0-255,2902,123504,6,157108
3575,0.002264,172.31.36.0-255,66,123570,6,157108
3576,0.002269,172.217.194.0-255,1484,125054,6,157108
3577,0.002302,172.217.194.0-255,4320,129374,6,157108
3578,0.002305,172.31.36.0-255,66,129440,6,157108
3579,0.002332,172.217.194.0-255,5738,135178,6,157108
3580,0.002334,172.31.36.0-255,66,135244,6,157108
3581,0.002363,172.217.194.0-255,4320,139564,6,157108
3582,0.002365,172.31.36.0-255,66,139630,6,157108
3583,0.004618,172.217.194.0-255,1484,141114,6,157108
3584,0.00465,172.217.194.0-255,4320,145434,6,157108
3585,0.004656,172.31.36.0-255,66,145500,6,157108
3586,0.006954,172.217.194.0-255,5738,151238,6,157108
3587,0.006961,172.31.36.0-255,66,151304,6,157108
3588,0.009249,172.217.194.0-255,5738,157042,6,157108
3589,0.009254,172.31.36.0-255,66,157108,6,157108
3590,0.0,74.125.24.0-255,153,153,6,211885
3591,2.7e-05,172.31.36.0-255,66,219,6,211885
3592,5.7e-05,74.125.24.0-255,1484,1703,6,211885
3593,6.2e-05,172.31.36.0-255,66,1769,6,211885
3594,6.7e-05,74.125.24.0-255,2902,4671,6,211885
3595,7e-05,172.31.36.0-255,66,4737,6,211885
3596,7.7e-05,74.125.24.0-255,5738,10475,6,211885
3597,7.9e-05,172.31.36.0-255,66,10541,6,211885
3598,0.000127,172.31.36.0-255,66,10607,6,211885
3599,0.000135,74.125.24.0-255,6797,17404,6,211885
3600,0.000137,172.31.36.0-255,66,17470,6,211885
3601,0.000192,74.125.24.0-255,1484,18954,6,211885
3602,0.000198,172.31.36.0-255,66,19020,6,211885
3603,0.000225,74.125.24.0-255,2902,21922,6,211885
3604,0.000227,172.31.36.0-255,66,21988,6,211885
3605,0.000234,74.125.24.0-255,5738,27726,6,211885
3606,0.000236,172.31.36.0-255,66,27792,6,211885
3607,0.000245,74.125.24.0-255,1484,29276,6,211885
3608,0.000247,172.31.36.0-255,66,29342,6,211885
3609,0.000289,172.31.36.0-255,66,29408,6,211885
3610,0.000298,74.125.24.0-255,8574,37982,6,211885
3611,0.0003,172.31.36.0-255,66,38048,6,211885
3612,0.000303,74.125.24.0-255,1401,39449,6,211885
3613,0.000305,172.31.36.0-255,66,39515,6,211885
3614,0.000356,74.125.24.0-255,382,39897,6,211885
3615,0.00036,172.31.36.0-255,66,39963,6,211885
3616,0.000435,74.125.24.0-255,1484,41447,6,211885
3617,0.000438,172.31.36.0-255,66,41513,6,211885
3618,0.000442,74.125.24.0-255,2902,44415,6,211885
3619,0.000445,172.31.36.0-255,66,44481,6,211885
3620,0.000479,74.125.24.0-255,5738,50219,6,211885
3621,0.000486,74.125.24.0-255,6797,57016,6,211885
3622,0.000498,172.31.36.0-255,66,57082,6,211885
3623,0.000526,74.125.24.0-255,4320,61402,6,211885
3624,0.000533,74.125.24.0-255,5738,67140,6,211885
3625,0.000537,172.31.36.0-255,66,67206,6,211885
3626,0.000565,74.125.24.0-255,4320,71526,6,211885
3627,0.000578,172.31.36.0-255,66,71592,6,211885
3628,0.000578,74.125.24.0-255,2543,74135,6,211885
3629,0.000583,172.31.36.0-255,66,74201,6,211885
3630,0.000647,74.125.24.0-255,1484,75685,6,211885
3631,0.000665,74.125.24.0-255,2902,78587,6,211885
3632,0.000668,172.31.36.0-255,66,78653,6,211885
3633,0.000704,74.125.24.0-255,5738,84391,6,211885
3634,0.000717,172.31.36.0-255,66,84457,6,211885
3635,0.000722,74.125.24.0-255,8574,93031,6,211885
3636,0.000723,172.31.36.0-255,66,93097,6,211885
3637,0.000742,172.31.36.0-255,66,93163,6,211885
3638,0.00075,74.125.24.0-255,1484,94647,6,211885
3639,0.000757,74.125.24.0-255,766,95413,6,211885
3640,0.000769,172.31.36.0-255,66,95479,6,211885
3641,0.000792,74.125.24.0-255,1484,96963,6,211885
3642,0.000813,74.125.24.0-255,4320,101283,6,211885
3643,0.000817,74.125.24.0-255,2902,104185,6,211885
3644,0.000822,172.31.36.0-255,66,104251,6,211885
3645,0.000834,74.125.24.0-255,8574,112825,6,211885
3646,0.00084,172.31.36.0-255,66,112891,6,211885
3647,0.000897,172.31.36.0-255,66,112957,6,211885
3648,0.000902,74.125.24.0-255,3602,116559,6,211885
3649,0.000912,172.31.36.0-255,66,116625,6,211885
3650,0.000947,74.125.24.0-255,1484,118109,6,211885
3651,0.000962,74.125.24.0-255,2902,121011,6,211885
3652,0.000974,74.125.24.0-255,5738,126749,6,211885
3653,0.000975,172.31.36.0-255,66,126815,6,211885
3654,0.00098,172.31.36.0-255,66,126881,6,211885
3655,0.001015,74.125.24.0-255,1484,128365,6,211885
3656,0.001015,172.31.36.0-255,66,128431,6,211885
3657,0.001046,74.125.24.0-255,9274,137705,6,211885
3658,0.001054,172.31.36.0-255,66,137771,6,211885
3659,0.001131,74.125.24.0-255,1484,139255,6,211885
3660,0.001135,74.125.24.0-255,1484,140739,6,211885
3661,0.001138,172.31.36.0-255,66,140805,6,211885
3662,0.001159,74.125.24.0-255,1484,142289,6,211885
3663,0.001166,74.125.24.0-255,5738,148027,6,211885
3664,0.001172,74.125.24.0-255,5738,153765,6,211885
3665,0.001173,172.31.36.0-255,66,153831,6,211885
3666,0.001177,172.31.36.0-255,66,153897,6,211885
3667,0.001198,74.125.24.0-255,5738,159635,6,211885
3668,0.001204,172.31.36.0-255,66,159701,6,211885
3669,0.001248,172.31.36.0-255,66,159767,6,211885
3670,0.00131,74.125.24.0-255,1484,161251,6,211885
3671,0.001313,74.125.24.0-255,1484,162735,6,211885
3672,0.001316,172.31.36.0-255,66,162801,6,211885
3673,0.001337,74.125.24.0-255,1484,164285,6,211885
3674,0.001342,74.125.24.0-255,5738,170023,6,211885
3675,0.001353,172.31.36.0-255,66,170089,6,211885
3676,0.001396,74.125.24.0-255,2902,172991,6,211885
3677,0.001406,172.31.36.0-255,66,173057,6,211885
3678,0.001418,74.125.24.0-255,9992,183049,6,211885
3679,0.001433,172.31.36.0-255,66,183115,6,211885
3680,0.001435,74.125.24.0-255,10692,193807,6,211885
3681,0.001448,172.31.36.0-255,66,193873,6,211885
3682,0.001461,74.125.24.0-255,7856,201729,6,211885
3683,0.001462,172.31.36.0-255,66,201795,6,211885
3684,0.001467,172.31.36.0-255,66,201861,6,211885
3685,0.001528,172.31.36.0-255,66,201927,6,211885
3686,0.001553,172.31.36.0-255,66,201993,6,211885
3687,0.001579,172.31.36.0-255,66,202059,6,211885
3688,0.001596,74.125.24.0-255,2184,204243,6,211885
3689,0.001607,172.31.36.0-255,66,204309,6,211885
3690,0.001613,172.31.36.0-255,66,204375,6,211885
3691,0.001648,172.31.36.0-255,66,204441,6,211885
3692,0.001649,74.125.24.0-255,7036,211477,6,211885
3693,0.001654,172.31.36.0-255,66,211543,6,211885
3694,0.00167,74.125.24.0-255,105,211648,6,211885
3695,0.004653,172.31.36.0-255,66,211714,6,211885
3696,0.004682,172.31.36.0-255,105,211819,6,211885
3697,0.006996,74.125.24.0-255,66,211885,6,211885
3698,0.0,172.217.194.0-255,153,153,6,206179
3699,3.6e-05,172.31.36.0-255,66,219,6,206179
3700,4.4e-05,172.217.194.0-255,1484,1703,6,206179
3701,4.8e-05,172.31.36.0-255,66,1769,6,206179
3702,5.3e-05,172.217.194.0-255,2902,4671,6,206179
3703,5.6e-05,172.31.36.0-255,66,4737,6,206179
3704,6.3e-05,172.217.194.0-255,7156,11893,6,206179
3705,6.5e-05,172.31.36.0-255,66,11959,6,206179
3706,6.9e-05,172.217.194.0-255,1484,13443,6,206179
3707,7.1e-05,172.31.36.0-255,66,13509,6,206179
3708,9.8e-05,172.217.194.0-255,10521,24030,6,206179
3709,0.000101,172.31.36.0-255,66,24096,6,206179
3710,0.000107,172.217.194.0-255,6797,30893,6,206179
3711,0.000109,172.31.36.0-255,66,30959,6,206179
3712,0.00017,172.217.194.0-255,1484,32443,6,206179
3713,0.000174,172.31.36.0-255,66,32509,6,206179
3714,0.00018,172.217.194.0-255,2902,35411,6,206179
3715,0.000182,172.31.36.0-255,66,35477,6,206179
3716,0.000196,172.217.194.0-255,1484,36961,6,206179
3717,0.000199,172.31.36.0-255,66,37027,6,206179
3718,0.000216,172.217.194.0-255,4320,41347,6,206179
3719,0.000218,172.31.36.0-255,66,41413,6,206179
3720,0.000238,172.217.194.0-255,8574,49987,6,206179
3721,0.000241,172.31.36.0-255,66,50053,6,206179
3722,0.000266,172.217.194.0-255,5379,55432,6,206179
3723,0.000269,172.31.36.0-255,66,55498,6,206179
3724,0.000297,172.217.194.0-255,2902,58400,6,206179
3725,0.000299,172.31.36.0-255,66,58466,6,206179
3726,0.000322,172.217.194.0-255,7051,65517,6,206179
3727,0.000325,172.31.36.0-255,66,65583,6,206179
3728,0.000391,172.217.194.0-255,5738,71321,6,206179
3729,0.000395,172.31.36.0-255,66,71387,6,206179
3730,0.000421,172.217.194.0-255,4657,76044,6,206179
3731,0.000426,172.31.36.0-255,66,76110,6,206179
3732,0.000433,172.217.194.0-255,6797,82907,6,206179
3733,0.000435,172.31.36.0-255,66,82973,6,206179
3734,0.000438,172.217.194.0-255,1484,84457,6,206179
3735,0.000444,172.217.194.0-255,2902,87359,6,206179
3736,0.000447,172.31.36.0-255,66,87425,6,206179
3737,0.000453,172.217.194.0-255,5738,93163,6,206179
3738,0.000456,172.31.36.0-255,66,93229,6,206179
3739,0.000481,172.217.194.0-255,2902,96131,6,206179
3740,0.000484,172.31.36.0-255,66,96197,6,206179
3741,0.000509,172.217.194.0-255,5379,101576,6,206179
3742,0.000512,172.31.36.0-255,66,101642,6,206179
3743,0.00052,172.217.194.0-255,8574,110216,6,206179
3744,0.000527,172.217.194.0-255,7156,117372,6,206179
3745,0.000527,172.31.36.0-255,66,117438,6,206179
3746,0.00053,172.31.36.0-255,66,117504,6,206179
3747,0.000543,172.217.194.0-255,7156,124660,6,206179
3748,0.000545,172.31.36.0-255,66,124726,6,206179
3749,0.000582,172.217.194.0-255,8723,133449,6,206179
3750,0.000587,172.31.36.0-255,66,133515,6,206179
3751,0.000725,172.217.194.0-255,1484,134999,6,206179
3752,0.00073,172.217.194.0-255,2902,137901,6,206179
3753,0.000734,172.31.36.0-255,66,137967,6,206179
3754,0.000741,172.217.194.0-255,5738,143705,6,206179
3755,0.000743,172.31.36.0-255,66,143771,6,206179
3756,0.000763,172.217.194.0-255,7156,150927,6,206179
3757,0.000766,172.31.36.0-255,66,150993,6,206179
3758,0.000791,172.217.194.0-255,4320,155313,6,206179
3759,0.000794,172.31.36.0-255,66,155379,6,206179
3760,0.000823,172.217.194.0-255,4320,159699,6,206179
3761,0.000827,172.31.36.0-255,66,159765,6,206179
3762,0.000852,172.217.194.0-255,7856,167621,6,206179
3763,0.000855,172.31.36.0-255,66,167687,6,206179
3764,0.00203,172.217.194.0-255,1484,169171,6,206179
3765,0.002042,172.217.194.0-255,2902,172073,6,206179
3766,0.002047,172.31.36.0-255,66,172139,6,206179
3767,0.002055,172.217.194.0-255,5738,177877,6,206179
3768,0.002057,172.31.36.0-255,66,177943,6,206179
3769,0.002126,172.31.36.0-255,66,178009,6,206179
3770,0.002136,172.217.194.0-255,10692,188701,6,206179
3771,0.002138,172.31.36.0-255,66,188767,6,206179
3772,0.004357,172.217.194.0-255,5738,194505,6,206179
3773,0.004367,172.31.36.0-255,66,194571,6,206179
3774,0.006591,172.217.194.0-255,5738,200309,6,206179
3775,0.006601,172.31.36.0-255,66,200375,6,206179
3776,0.008839,172.217.194.0-255,5738,206113,6,206179
3777,0.008848,172.31.36.0-255,66,206179,6,206179
3778,0.0,172.217.160.0-255,156,156,6,96982
3779,3e-05,172.31.36.0-255,66,222,6,96982
3780,3.7e-05,172.217.160.0-255,1484,1706,6,96982
3781,4.1e-05,172.31.36.0-255,66,1772,6,96982
3782,4.4e-05,172.217.160.0-255,1484,3256,6,96982
3783,4.6e-05,172.31.36.0-255,66,3322,6,96982
3784,6.6e-05,172.217.160.0-255,2902,6224,6,96982
3785,6.9e-05,172.31.36.0-255,66,6290,6,96982
3786,0.000102,172.217.160.0-255,2902,9192,6,96982
3787,0.000105,172.31.36.0-255,66,9258,6,96982
3788,0.000122,172.217.160.0-255,2902,12160,6,96982
3789,0.000124,172.31.36.0-255,66,12226,6,96982
3790,0.000218,172.217.160.0-255,2006,14232,6,96982
3791,0.000222,172.31.36.0-255,66,14298,6,96982
3792,0.000265,172.217.160.0-255,2902,17200,6,96982
3793,0.000269,172.31.36.0-255,66,17266,6,96982
3794,0.000296,172.217.160.0-255,8574,25840,6,96982
3795,0.0003,172.31.36.0-255,66,25906,6,96982
3796,0.000316,172.217.160.0-255,2902,28808,6,96982
3797,0.000319,172.31.36.0-255,66,28874,6,96982
3798,0.000523,172.217.160.0-255,2543,31417,6,96982
3799,0.000527,172.31.36.0-255,66,31483,6,96982
3800,0.000573,172.217.160.0-255,5738,37221,6,96982
3801,0.000576,172.31.36.0-255,66,37287,6,96982
3802,0.000613,172.31.36.0-255,66,37353,6,96982
3803,0.001015,172.31.36.0-255,66,37419,6,96982
3804,0.00119,172.217.160.0-255,123,37542,6,96982
3805,0.001196,172.31.36.0-255,66,37608,6,96982
3806,0.001213,172.217.160.0-255,1484,39092,6,96982
3807,0.001216,172.31.36.0-255,66,39158,6,96982
3808,0.00124,172.217.160.0-255,2902,42060,6,96982
3809,0.001293,172.217.160.0-255,2902,44962,6,96982
3810,0.001313,172.217.160.0-255,4320,49282,6,96982
3811,0.001439,172.217.160.0-255,9992,59274,6,96982
3812,0.001461,172.217.160.0-255,6797,66071,6,96982
3813,0.001756,172.217.160.0-255,5379,71450,6,96982
3814,0.001848,172.217.160.0-255,4320,75770,6,96982
3815,0.001891,172.217.160.0-255,1484,77254,6,96982
3816,0.002309,172.217.160.0-255,5738,82992,6,96982
3817,0.002322,172.217.160.0-255,3602,86594,6,96982
3818,0.002487,172.217.160.0-255,1484,88078,6,96982
3819,0.002535,172.217.160.0-255,2902,90980,6,96982
3820,0.007085,172.31.36.0-255,66,91046,6,96982
3821,0.008729,172.217.160.0-255,2902,93948,6,96982
3822,0.008737,172.31.36.0-255,66,94014,6,96982
3823,0.008756,172.217.160.0-255,2902,96916,6,96982
3824,0.008767,172.31.36.0-255,66,96982,6,96982
3825,0.0,172.217.194.0-255,152,152,6,316178
3826,2.3e-05,172.31.36.0-255,66,218,6,316178
3827,3e-05,172.217.194.0-255,1484,1702,6,316178
3828,3.4e-05,172.31.36.0-255,66,1768,6,316178
3829,3.7e-05,172.217.194.0-255,1484,3252,6,316178
3830,4e-05,172.31.36.0-255,66,3318,6,316178
3831,5.8e-05,172.217.194.0-255,1484,4802,6,316178
3832,6.1e-05,172.31.36.0-255,66,4868,6,316178
3833,6.9e-05,172.217.194.0-255,7156,12024,6,316178
3834,7.1e-05,172.31.36.0-255,66,12090,6,316178
3835,7.5e-05,172.217.194.0-255,2002,14092,6,316178
3836,7.8e-05,172.31.36.0-255,66,14158,6,316178
3837,0.000105,172.217.194.0-255,4320,18478,6,316178
3838,0.000108,172.31.36.0-255,66,18544,6,316178
3839,0.000123,172.217.194.0-255,7156,25700,6,316178
3840,0.000125,172.31.36.0-255,66,25766,6,316178
3841,0.000132,172.217.194.0-255,5379,31145,6,316178
3842,0.000135,172.31.36.0-255,66,31211,6,316178
3843,0.000204,172.217.194.0-255,1484,32695,6,316178
3844,0.000207,172.31.36.0-255,66,32761,6,316178
3845,0.000212,172.217.194.0-255,2902,35663,6,316178
3846,0.000214,172.31.36.0-255,66,35729,6,316178
3847,0.00022,172.217.194.0-255,2902,38631,6,316178
3848,0.000222,172.31.36.0-255,66,38697,6,316178
3849,0.000227,172.217.194.0-255,2902,41599,6,316178
3850,0.00023,172.31.36.0-255,66,41665,6,316178
3851,0.000252,172.217.194.0-255,1484,43149,6,316178
3852,0.000254,172.31.36.0-255,66,43215,6,316178
3853,0.000262,172.217.194.0-255,5738,48953,6,316178
3854,0.000264,172.31.36.0-255,66,49019,6,316178
3855,0.000278,172.217.194.0-255,3961,52980,6,316178
3856,0.00028,172.31.36.0-255,66,53046,6,316178
3857,0.000287,172.217.194.0-255,5738,58784,6,316178
3858,0.000353,172.217.194.0-255,5738,64522,6,316178
3859,0.000369,172.217.194.0-255,1446,65968,6,316178
3860,0.000487,172.217.194.0-255,366,66334,6,316178
3861,0.000496,172.31.36.0-255,66,66400,6,316178
3862,0.000806,172.217.194.0-255,1484,67884,6,316178
3863,0.000813,172.217.194.0-255,2902,70786,6,316178
3864,0.000817,172.31.36.0-255,66,70852,6,316178
3865,0.000841,172.217.194.0-255,5738,76590,6,316178
3866,0.000855,172.31.36.0-255,66,76656,6,316178
3867,0.000887,172.217.194.0-255,5738,82394,6,316178
3868,0.000897,172.31.36.0-255,66,82460,6,316178
3869,0.000908,172.217.194.0-255,5020,87480,6,316178
3870,0.000937,172.31.36.0-255,66,87546,6,316178
3871,0.001147,172.217.194.0-255,1484,89030,6,316178
3872,0.001153,172.217.194.0-255,2902,91932,6,316178
3873,0.001157,172.31.36.0-255,66,91998,6,316178
3874,0.001163,172.217.194.0-255,4320,96318,6,316178
3875,0.001176,172.217.194.0-255,1484,97802,6,316178
3876,0.00118,172.217.194.0-255,2902,100704,6,316178
3877,0.001184,172.31.36.0-255,66,100770,6,316178
3878,0.001189,172.31.36.0-255,66,100836,6,316178
3879,0.001216,172.217.194.0-255,9992,110828,6,316178
3880,0.001227,172.217.194.0-255,10692,121520,6,316178
3881,0.001246,172.31.36.0-255,66,121586,6,316178
3882,0.001313,172.217.194.0-255,1484,123070,6,316178
3883,0.001344,172.217.194.0-255,2902,125972,6,316178
3884,0.001347,172.31.36.0-255,66,126038,6,316178
3885,0.001353,172.217.194.0-255,4320,130358,6,316178
3886,0.001366,172.217.194.0-255,1484,131842,6,316178
3887,0.001369,172.217.194.0-255,1484,133326,6,316178
3888,0.001372,172.31.36.0-255,66,133392,6,316178
3889,0.00138,172.31.36.0-255,66,133458,6,316178
3890,0.001385,172.217.194.0-255,2902,136360,6,316178
3891,0.001413,172.217.194.0-255,9992,146352,6,316178
3892,0.00142,172.217.194.0-255,4320,150672,6,316178
3893,0.001425,172.31.36.0-255,66,150738,6,316178
3894,0.001444,172.217.194.0-255,5020,155758,6,316178
3895,0.001453,172.31.36.0-255,66,155824,6,316178
3896,0.001684,172.217.194.0-255,1484,157308,6,316178
3897,0.00169,172.217.194.0-255,2902,160210,6,316178
3898,0.001694,172.31.36.0-255,66,160276,6,316178
3899,0.001718,172.217.194.0-255,5738,166014,6,316178
3900,0.001721,172.217.194.0-255,1484,167498,6,316178
3901,0.001755,172.31.36.0-255,66,167564,6,316178
3902,0.001767,172.217.194.0-255,5738,173302,6,316178
3903,0.001773,172.31.36.0-255,66,173368,6,316178
3904,0.001792,172.217.194.0-255,5020,178388,6,316178
3905,0.001805,172.31.36.0-255,66,178454,6,316178
3906,0.001826,172.31.36.0-255,66,178520,6,316178
3907,0.001844,172.217.194.0-255,9992,188512,6,316178
3908,0.001858,172.217.194.0-255,2902,191414,6,316178
3909,0.001868,172.31.36.0-255,66,191480,6,316178
3910,0.001882,172.217.194.0-255,9274,200754,6,316178
3911,0.001893,172.31.36.0-255,66,200820,6,316178
3912,0.001904,172.217.194.0-255,1484,202304,6,316178
3913,0.001917,172.217.194.0-255,2902,205206,6,316178
3914,0.001938,172.31.36.0-255,66,205272,6,316178
3915,0.001944,172.217.194.0-255,4320,209592,6,316178
3916,0.001949,172.31.36.0-255,66,209658,6,316178
3917,0.001958,172.217.194.0-255,1484,211142,6,316178
3918,0.002005,172.31.36.0-255,66,211208,6,316178
3919,0.00202,172.217.194.0-255,8574,219782,6,316178
3920,0.002038,172.217.194.0-255,10692,230474,6,316178
3921,0.002086,172.31.36.0-255,66,230540,6,316178
3922,0.002104,172.217.194.0-255,1484,232024,6,316178
3923,0.002107,172.217.194.0-255,1484,233508,6,316178
3924,0.002137,172.31.36.0-255,66,233574,6,316178
3925,0.002416,172.217.194.0-255,1484,235058,6,316178
3926,0.002436,172.217.194.0-255,2902,237960,6,316178
3927,0.002441,172.217.194.0-255,2902,240862,6,316178
3928,0.002456,172.217.194.0-255,2902,243764,6,316178
3929,0.002469,172.217.194.0-255,4320,248084,6,316178
3930,0.002477,172.31.36.0-255,66,248150,6,316178
3931,0.002505,172.217.194.0-255,8574,256724,6,316178
3932,0.002515,172.217.194.0-255,10692,267416,6,316178
3933,0.002524,172.31.36.0-255,66,267482,6,316178
3934,0.002657,172.217.194.0-255,1484,268966,6,316178
3935,0.002662,172.217.194.0-255,2902,271868,6,316178
3936,0.002666,172.217.194.0-255,2902,274770,6,316178
3937,0.002671,172.31.36.0-255,66,274836,6,316178
3938,0.002683,172.217.194.0-255,2902,277738,6,316178
3939,0.002686,172.217.194.0-255,1484,279222,6,316178
3940,0.002699,172.31.36.0-255,66,279288,6,316178
3941,0.00274,172.217.194.0-255,10692,289980,6,316178
3942,0.002762,172.31.36.0-255,66,290046,6,316178
3943,0.002861,172.217.194.0-255,1484,291530,6,316178
3944,0.002865,172.217.194.0-255,1484,293014,6,316178
3945,0.002868,172.31.36.0-255,66,293080,6,316178
3946,0.002892,172.217.194.0-255,4320,297400,6,316178
3947,0.002896,172.217.194.0-255,1484,298884,6,316178
3948,0.002914,172.217.194.0-255,5738,304622,6,316178
3949,0.002918,172.217.194.0-255,2902,307524,6,316178
3950,0.002937,172.217.194.0-255,7156,314680,6,316178
3951,0.002941,172.217.194.0-255,1090,315770,6,316178
3952,0.002953,172.31.36.0-255,66,315836,6,316178
3953,0.002988,172.217.194.0-255,105,315941,6,316178
3954,0.004543,172.31.36.0-255,66,316007,6,316178
3955,0.00458,172.31.36.0-255,105,316112,6,316178
3956,0.006578,172.217.194.0-255,66,316178,6,316178
3957,0.0,172.217.194.0-255,153,153,6,182119
3958,3.6e-05,172.31.36.0-255,66,219,6,182119
3959,4.4e-05,172.217.194.0-255,1484,1703,6,182119
3960,5e-05,172.31.36.0-255,66,1769,6,182119
3961,5.4e-05,172.217.194.0-255,2902,4671,6,182119
3962,5.7e-05,172.31.36.0-255,66,4737,6,182119
3963,6.3e-05,172.217.194.0-255,7156,11893,6,182119
3964,6.6e-05,172.31.36.0-255,66,11959,6,182119
3965,8.8e-05,172.217.194.0-255,2052,14011,6,182119
3966,9.1e-05,172.31.36.0-255,66,14077,6,182119
3967,0.000126,172.217.194.0-255,1484,15561,6,182119
3968,0.000128,172.31.36.0-255,66,15627,6,182119
3969,0.000133,172.217.194.0-255,2902,18529,6,182119
3970,0.000135,172.31.36.0-255,66,18595,6,182119
3971,0.000154,172.217.194.0-255,5738,24333,6,182119
3972,0.000157,172.31.36.0-255,66,24399,6,182119
3973,0.000163,172.217.194.0-255,4320,28719,6,182119
3974,0.000165,172.31.36.0-255,66,28785,6,182119
3975,0.000179,172.217.194.0-255,1484,30269,6,182119
3976,0.000181,172.31.36.0-255,66,30335,6,182119
3977,0.000194,172.217.194.0-255,1125,31460,6,182119
3978,0.000197,172.31.36.0-255,66,31526,6,182119
3979,0.000478,172.217.194.0-255,1484,33010,6,182119
3980,0.000482,172.31.36.0-255,66,33076,6,182119
3981,0.000488,172.217.194.0-255,2902,35978,6,182119
3982,0.00049,172.31.36.0-255,66,36044,6,182119
3983,0.00052,172.217.194.0-255,5738,41782,6,182119
3984,0.000523,172.31.36.0-255,66,41848,6,182119
3985,0.000529,172.217.194.0-255,6797,48645,6,182119
3986,0.000531,172.31.36.0-255,66,48711,6,182119
3987,0.000554,172.217.194.0-255,7156,55867,6,182119
3988,0.000565,172.31.36.0-255,66,55933,6,182119
3989,0.000579,172.217.194.0-255,4320,60253,6,182119
3990,0.0006,172.217.194.0-255,5379,65632,6,182119
3991,0.000602,172.31.36.0-255,66,65698,6,182119
3992,0.000608,172.31.36.0-255,66,65764,6,182119
3993,0.000649,172.217.194.0-255,394,66158,6,182119
3994,0.000663,172.217.194.0-255,379,66537,6,182119
3995,0.000805,172.217.194.0-255,1484,68021,6,182119
3996,0.00081,172.31.36.0-255,66,68087,6,182119
3997,0.000816,172.217.194.0-255,2902,70989,6,182119
3998,0.000826,172.31.36.0-255,66,71055,6,182119
3999,0.00083,172.217.194.0-255,4320,75375,6,182119
4000,0.000843,172.217.194.0-255,1484,76859,6,182119
4001,0.000843,172.31.36.0-255,66,76925,6,182119
4002,0.000876,172.217.194.0-255,1484,78409,6,182119
4003,0.000882,172.31.36.0-255,66,78475,6,182119
4004,0.000899,172.217.194.0-255,1484,79959,6,182119
4005,0.000926,172.217.194.0-255,7856,87815,6,182119
4006,0.00093,172.31.36.0-255,66,87881,6,182119
4007,0.001266,172.217.194.0-255,1484,89365,6,182119
4008,0.001291,172.217.194.0-255,2902,92267,6,182119
4009,0.001296,172.31.36.0-255,66,92333,6,182119
4010,0.001303,172.217.194.0-255,5738,98071,6,182119
4011,0.001367,172.217.194.0-255,4320,102391,6,182119
4012,0.001387,172.217.194.0-255,6438,108829,6,182119
4013,0.00175,172.217.194.0-255,1484,110313,6,182119
4014,0.001758,172.217.194.0-255,2902,113215,6,182119
4015,0.001763,172.217.194.0-255,5738,118953,6,182119
4016,0.00179,172.217.194.0-255,7156,126109,6,182119
4017,0.001809,172.217.194.0-255,5738,131847,6,182119
4018,0.00183,172.217.194.0-255,2902,134749,6,182119
4019,0.001846,172.217.194.0-255,7156,141905,6,182119
4020,0.001865,172.217.194.0-255,10692,152597,6,182119
4021,0.001868,172.217.194.0-255,1484,154081,6,182119
4022,0.00189,172.217.194.0-255,9992,164073,6,182119
4023,0.001919,172.217.194.0-255,9992,174065,6,182119
4024,0.001922,172.217.194.0-255,2184,176249,6,182119
4025,0.006845,172.31.36.0-255,66,176315,6,182119
4026,0.008882,172.217.194.0-255,5738,182053,6,182119
4027,0.008889,172.31.36.0-255,66,182119,6,182119
4028,0.0,74.125.24.0-255,147,147,6,222492
4029,1.7e-05,172.31.36.0-255,66,213,6,222492
4030,2.3e-05,74.125.24.0-255,1484,1697,6,222492
4031,2.8e-05,172.31.36.0-255,66,1763,6,222492
4032,4.3e-05,74.125.24.0-255,2902,4665,6,222492
4033,4.7e-05,172.31.36.0-255,66,4731,6,222492
4034,5.1e-05,74.125.24.0-255,1484,6215,6,222492
4035,5.4e-05,172.31.36.0-255,66,6281,6,222492
4036,6.1e-05,74.125.24.0-255,5738,12019,6,222492
4037,6.4e-05,172.31.36.0-255,66,12085,6,222492
4038,9.5e-05,74.125.24.0-255,2059,14144,6,222492
4039,9.8e-05,172.31.36.0-255,66,14210,6,222492
4040,0.00013,74.125.24.0-255,2902,17112,6,222492
4041,0.000135,172.31.36.0-255,66,17178,6,222492
4042,0.00014,74.125.24.0-255,4320,21498,6,222492
4043,0.000143,172.31.36.0-255,66,21564,6,222492
4044,0.000163,74.125.24.0-255,8574,30138,6,222492
4045,0.000166,172.31.36.0-255,66,30204,6,222492
4046,0.00017,74.125.24.0-255,1484,31688,6,222492
4047,0.000172,172.31.36.0-255,66,31754,6,222492
4048,0.000207,74.125.24.0-255,8574,40328,6,222492
4049,0.000211,172.31.36.0-255,66,40394,6,222492
4050,0.000238,74.125.24.0-255,7856,48250,6,222492
4051,0.00024,172.31.36.0-255,66,48316,6,222492
4052,0.000559,74.125.24.0-255,1484,49800,6,222492
4053,0.000565,172.31.36.0-255,66,49866,6,222492
4054,0.000571,74.125.24.0-255,2902,52768,6,222492
4055,0.000574,172.31.36.0-255,66,52834,6,222492
4056,0.000605,74.125.24.0-255,5738,58572,6,222492
4057,0.000608,172.31.36.0-255,66,58638,6,222492
4058,0.00064,74.125.24.0-255,4320,62958,6,222492
4059,0.000643,172.31.36.0-255,66,63024,6,222492
4060,0.000666,74.125.24.0-255,2845,65869,6,222492
4061,0.000669,172.31.36.0-255,66,65935,6,222492
4062,0.000813,74.125.24.0-255,1484,67419,6,222492
4063,0.000819,74.125.24.0-255,2902,70321,6,222492
4064,0.000822,172.31.36.0-255,66,70387,6,222492
4065,0.000849,74.125.24.0-255,4320,74707,6,222492
4066,0.000852,172.31.36.0-255,66,74773,6,222492
4067,0.000881,74.125.24.0-255,8574,83347,6,222492
4068,0.000884,172.31.36.0-255,66,83413,6,222492
4069,0.000914,74.125.24.0-255,1125,84538,6,222492
4070,0.000921,74.125.24.0-255,5738,90276,6,222492
4071,0.000924,172.31.36.0-255,66,90342,6,222492
4072,0.000931,74.125.24.0-255,5738,96080,6,222492
4073,0.000933,172.31.36.0-255,66,96146,6,222492
4074,0.000972,172.31.36.0-255,66,96212,6,222492
4075,0.000978,74.125.24.0-255,4320,100532,6,222492
4076,0.000981,172.31.36.0-255,66,100598,6,222492
4077,0.001013,74.125.24.0-255,5020,105618,6,222492
4078,0.001016,172.31.36.0-255,66,105684,6,222492
4079,0.001029,172.31.36.0-255,66,105750,6,222492
4080,0.001056,74.125.24.0-255,5644,111394,6,222492
4081,0.001059,172.31.36.0-255,66,111460,6,222492
4082,0.001345,74.125.24.0-255,1484,112944,6,222492
4083,0.001391,74.125.24.0-255,2902,115846,6,222492
4084,0.001395,172.31.36.0-255,66,115912,6,222492
4085,0.001403,74.125.24.0-255,5738,121650,6,222492
4086,0.001405,172.31.36.0-255,66,121716,6,222492
4087,0.001424,172.31.36.0-255,66,121782,6,222492
4088,0.001467,74.125.24.0-255,7156,128938,6,222492
4089,0.001473,172.31.36.0-255,66,129004,6,222492
4090,0.001483,74.125.24.0-255,3602,132606,6,222492
4091,0.001485,172.31.36.0-255,66,132672,6,222492
4092,0.001733,74.125.24.0-255,1484,134156,6,222492
4093,0.001739,74.125.24.0-255,2902,137058,6,222492
4094,0.001742,172.31.36.0-255,66,137124,6,222492
4095,0.001771,74.125.24.0-255,5738,142862,6,222492
4096,0.001774,172.31.36.0-255,66,142928,6,222492
4097,0.00178,74.125.24.0-255,4320,147248,6,222492
4098,0.001782,172.31.36.0-255,66,147314,6,222492
4099,0.001823,172.31.36.0-255,66,147380,6,222492
4100,0.00183,74.125.24.0-255,7156,154536,6,222492
4101,0.001833,172.31.36.0-255,66,154602,6,222492
4102,0.001862,74.125.24.0-255,766,155368,6,222492
4103,0.002027,74.125.24.0-255,1484,156852,6,222492
4104,0.002032,74.125.24.0-255,2902,159754,6,222492
4105,0.002038,172.31.36.0-255,66,159820,6,222492
4106,0.002046,172.31.36.0-255,66,159886,6,222492
4107,0.002058,74.125.24.0-255,5738,165624,6,222492
4108,0.00206,172.31.36.0-255,66,165690,6,222492
4109,0.002108,172.31.36.0-255,66,165756,6,222492
4110,0.002115,74.125.24.0-255,5738,171494,6,222492
4111,0.002118,172.31.36.0-255,66,171560,6,222492
4112,0.002139,74.125.24.0-255,5020,176580,6,222492
4113,0.002142,172.31.36.0-255,66,176646,6,222492
4114,0.002357,74.125.24.0-255,1484,178130,6,222492
4115,0.002364,74.125.24.0-255,2902,181032,6,222492
4116,0.002367,172.31.36.0-255,66,181098,6,222492
4117,0.002373,74.125.24.0-255,2902,184000,6,222492
4118,0.002375,172.31.36.0-255,66,184066,6,222492
4119,0.002404,74.125.24.0-255,2902,186968,6,222492
4120,0.002414,74.125.24.0-255,4320,191288,6,222492
4121,0.002416,74.125.24.0-255,1484,192772,6,222492
4122,0.002421,172.31.36.0-255,66,192838,6,222492
4123,0.002428,172.31.36.0-255,66,192904,6,222492
4124,0.002489,74.125.24.0-255,9992,202896,6,222492
4125,0.002492,172.31.36.0-255,66,202962,6,222492
4126,0.002501,74.125.24.0-255,7856,210818,6,222492
4127,0.002504,172.31.36.0-255,66,210884,6,222492
4128,0.005127,74.125.24.0-255,5738,216622,6,222492
4129,0.005148,172.31.36.0-255,66,216688,6,222492
4130,0.007747,74.125.24.0-255,5738,222426,6,222492
4131,0.007755,172.31.36.0-255,66,222492,6,222492
4132,0.0,74.125.24.0-255,153,153,6,129396
4133,2.3e-05,172.31.36.0-255,66,219,6,129396
4134,3e-05,74.125.24.0-255,1484,1703,6,129396
4135,3.4e-05,172.31.36.0-255,66,1769,6,129396
4136,3.7e-05,74.125.24.0-255,1484,3253,6,129396
4137,4.8e-05,172.31.36.0-255,66,3319,6,129396
4138,5.5e-05,74.125.24.0-255,4320,7639,6,129396
4139,5.8e-05,172.31.36.0-255,66,7705,6,129396
4140,6.2e-05,74.125.24.0-255,1484,9189,6,129396
4141,6.4e-05,172.31.36.0-255,66,9255,6,129396
4142,8.7e-05,74.125.24.0-255,4874,14129,6,129396
4143,9e-05,172.31.36.0-255,66,14195,6,129396
4144,9.7e-05,74.125.24.0-255,7156,21351,6,129396
4145,0.000106,172.31.36.0-255,66,21417,6,129396
4146,0.000156,74.125.24.0-255,9633,31050,6,129396
4147,0.000159,172.31.36.0-255,66,31116,6,129396
4148,0.000266,74.125.24.0-255,1484,32600,6,129396
4149,0.00027,172.31.36.0-255,66,32666,6,129396
4150,0.000277,74.125.24.0-255,2902,35568,6,129396
4151,0.000279,172.31.36.0-255,66,35634,6,129396
4152,0.000282,74.125.24.0-255,1484,37118,6,129396
4153,0.000284,172.31.36.0-255,66,37184,6,129396
4154,0.000313,74.125.24.0-255,4320,41504,6,129396
4155,0.000316,172.31.36.0-255,66,41570,6,129396
4156,0.00033,172.31.36.0-255,66,41636,6,129396
4157,0.000351,74.125.24.0-255,1484,43120,6,129396
4158,0.000354,172.31.36.0-255,66,43186,6,129396
4159,0.000377,74.125.24.0-255,8574,51760,6,129396
4160,0.00038,172.31.36.0-255,66,51826,6,129396
4161,0.000409,74.125.24.0-255,2184,54010,6,129396
4162,0.000411,172.31.36.0-255,66,54076,6,129396
4163,0.000414,74.125.24.0-255,445,54521,6,129396
4164,0.000438,74.125.24.0-255,331,54852,6,129396
4165,0.000841,74.125.24.0-255,1484,56336,6,129396
4166,0.000846,172.31.36.0-255,66,56402,6,129396
4167,0.000852,74.125.24.0-255,2902,59304,6,129396
4168,0.000854,172.31.36.0-255,66,59370,6,129396
4169,0.000865,74.125.24.0-255,5738,65108,6,129396
4170,0.000867,172.31.36.0-255,66,65174,6,129396
4171,0.000871,74.125.24.0-255,1484,66658,6,129396
4172,0.000914,172.31.36.0-255,66,66724,6,129396
4173,0.000924,74.125.24.0-255,4320,71044,6,129396
4174,0.000927,172.31.36.0-255,66,71110,6,129396
4175,0.000957,74.125.24.0-255,6438,77548,6,129396
4176,0.00096,172.31.36.0-255,66,77614,6,129396
4177,0.001454,74.125.24.0-255,1484,79098,6,129396
4178,0.001461,74.125.24.0-255,2902,82000,6,129396
4179,0.001464,172.31.36.0-255,66,82066,6,129396
4180,0.001468,74.125.24.0-255,1484,83550,6,129396
4181,0.001492,74.125.24.0-255,2902,86452,6,129396
4182,0.001495,172.31.36.0-255,66,86518,6,129396
4183,0.001502,74.125.24.0-255,5738,92256,6,129396
4184,0.001504,172.31.36.0-255,66,92322,6,129396
4185,0.00153,74.125.24.0-255,2902,95224,6,129396
4186,0.001532,172.31.36.0-255,66,95290,6,129396
4187,0.001537,74.125.24.0-255,2902,98192,6,129396
4188,0.001539,172.31.36.0-255,66,98258,6,129396
4189,0.001554,74.125.24.0-255,5738,103996,6,129396
4190,0.001556,172.31.36.0-255,66,104062,6,129396
4191,0.001586,74.125.24.0-255,7856,111918,6,129396
4192,0.001589,172.31.36.0-255,66,111984,6,129396
4193,0.003904,74.125.24.0-255,5738,117722,6,129396
4194,0.003911,172.31.36.0-255,66,117788,6,129396
4195,0.006206,74.125.24.0-255,5738,123526,6,129396
4196,0.00621,172.31.36.0-255,66,123592,6,129396
4197,0.008535,74.125.24.0-255,5738,129330,6,129396
4198,0.008543,172.31.36.0-255,66,129396,6,129396
4199,0.0,74.125.200.0-255,153,153,6,350144
4200,1.5e-05,172.31.36.0-255,66,219,6,350144
4201,2.1e-05,74.125.200.0-255,1484,1703,6,350144
4202,2.6e-05,172.31.36.0-255,66,1769,6,350144
4203,3.2e-05,74.125.200.0-255,2902,4671,6,350144
4204,3.6e-05,172.31.36.0-255,66,4737,6,350144
4205,7e-05,74.125.200.0-255,7156,11893,6,350144
4206,7.3e-05,172.31.36.0-255,66,11959,6,350144
4207,7.7e-05,74.125.200.0-255,2092,14051,6,350144
4208,8e-05,172.31.36.0-255,66,14117,6,350144
4209,0.0001,74.125.200.0-255,5738,19855,6,350144
4210,0.000102,172.31.36.0-255,66,19921,6,350144
4211,0.000123,74.125.200.0-255,5738,25659,6,350144
4212,0.000125,172.31.36.0-255,66,25725,6,350144
4213,0.000131,74.125.200.0-255,5738,31463,6,350144
4214,0.000134,172.31.36.0-255,66,31529,6,350144
4215,0.000184,172.31.36.0-255,66,31595,6,350144
4216,0.000205,74.125.200.0-255,2902,34497,6,350144
4217,0.000208,172.31.36.0-255,66,34563,6,350144
4218,0.000235,74.125.200.0-255,9992,44555,6,350144
4219,0.000237,172.31.36.0-255,66,44621,6,350144
4220,0.00026,74.125.200.0-255,4297,48918,6,350144
4221,0.000262,172.31.36.0-255,66,48984,6,350144
4222,0.000301,74.125.200.0-255,4320,53304,6,350144
4223,0.000304,172.31.36.0-255,66,53370,6,350144
4224,0.000328,74.125.200.0-255,5738,59108,6,350144
4225,0.000331,172.31.36.0-255,66,59174,6,350144
4226,0.000356,74.125.200.0-255,2902,62076,6,350144
4227,0.000358,172.31.36.0-255,66,62142,6,350144
4228,0.000379,74.125.200.0-255,8574,70716,6,350144
4229,0.000382,172.31.36.0-255,66,70782,6,350144
4230,0.000387,74.125.200.0-255,4320,75102,6,350144
4231,0.00039,172.31.36.0-255,66,75168,6,350144
4232,0.000407,74.125.200.0-255,1484,76652,6,350144
4233,0.000434,74.125.200.0-255,6438,83090,6,350144
4234,0.000437,172.31.36.0-255,66,83156,6,350144
4235,0.000455,74.125.200.0-255,1484,84640,6,350144
4236,0.000477,74.125.200.0-255,2902,87542,6,350144
4237,0.000479,172.31.36.0-255,66,87608,6,350144
4238,0.000499,74.125.200.0-255,5738,93346,6,350144
4239,0.000502,172.31.36.0-255,66,93412,6,350144
4240,0.000529,74.125.200.0-255,4320,97732,6,350144
4241,0.000532,172.31.36.0-255,66,97798,6,350144
4242,0.000564,74.125.200.0-255,5738,103536,6,350144
4243,0.000566,172.31.36.0-255,66,103602,6,350144
4244,0.00058,172.31.36.0-255,66,103668,6,350144
4245,0.000584,74.125.200.0-255,2184,105852,6,350144
4246,0.000586,172.31.36.0-255,66,105918,6,350144
4247,0.000672,74.125.200.0-255,1484,107402,6,350144
4248,0.000676,74.125.200.0-255,1484,108886,6,350144
4249,0.000678,172.31.36.0-255,66,108952,6,350144
4250,0.000699,74.125.200.0-255,1484,110436,6,350144
4251,0.000707,74.125.200.0-255,5738,116174,6,350144
4252,0.00071,172.31.36.0-255,66,116240,6,350144
4253,0.000713,74.125.200.0-255,1484,117724,6,350144
4254,0.000735,74.125.200.0-255,1484,119208,6,350144
4255,0.000738,172.31.36.0-255,66,119274,6,350144
4256,0.000744,74.125.200.0-255,4320,123594,6,350144
4257,0.000746,172.31.36.0-255,66,123660,6,350144
4258,0.000783,74.125.200.0-255,5738,129398,6,350144
4259,0.000787,172.31.36.0-255,66,129464,6,350144
4260,0.000827,74.125.200.0-255,7156,136620,6,350144
4261,0.000831,172.31.36.0-255,66,136686,6,350144
4262,0.000836,74.125.200.0-255,3602,140288,6,350144
4263,0.000838,172.31.36.0-255,66,140354,6,350144
4264,0.001012,74.125.200.0-255,1484,141838,6,350144
4265,0.001026,74.125.200.0-255,2902,144740,6,350144
4266,0.001029,172.31.36.0-255,66,144806,6,350144
4267,0.001044,74.125.200.0-255,2902,147708,6,350144
4268,0.001046,172.31.36.0-255,66,147774,6,350144
4269,0.001068,74.125.200.0-255,1484,149258,6,350144
4270,0.001077,74.125.200.0-255,8574,157832,6,350144
4271,0.00108,172.31.36.0-255,66,157898,6,350144
4272,0.001085,74.125.200.0-255,2902,160800,6,350144
4273,0.001087,172.31.36.0-255,66,160866,6,350144
4274,0.001135,74.125.200.0-255,4320,165186,6,350144
4275,0.001139,172.31.36.0-255,66,165252,6,350144
4276,0.001165,74.125.200.0-255,8574,173826,6,350144
4277,0.001168,172.31.36.0-255,66,173892,6,350144
4278,0.00117,74.125.200.0-255,766,174658,6,350144
4279,0.001236,74.125.200.0-255,1484,176142,6,350144
4280,0.001239,74.125.200.0-255,1484,177626,6,350144
4281,0.001244,172.31.36.0-255,66,177692,6,350144
4282,0.001252,74.125.200.0-255,1484,179176,6,350144
4283,0.001254,172.31.36.0-255,66,179242,6,350144
4284,0.00126,74.125.200.0-255,2902,182144,6,350144
4285,0.001262,172.31.36.0-255,66,182210,6,350144
4286,0.001285,74.125.200.0-255,2902,185112,6,350144
4287,0.001288,172.31.36.0-255,66,185178,6,350144
4288,0.001297,74.125.200.0-255,8574,193752,6,350144
4289,0.001301,74.125.200.0-255,2902,196654,6,350144
4290,0.001326,74.125.200.0-255,7156,203810,6,350144
4291,0.001332,74.125.200.0-255,5020,208830,6,350144
4292,0.001354,74.125.200.0-255,5738,214568,6,350144
4293,0.001365,172.31.36.0-255,66,214634,6,350144
4294,0.001368,74.125.200.0-255,1484,216118,6,350144
4295,0.001385,74.125.200.0-255,7156,223274,6,350144
4296,0.001405,74.125.200.0-255,4320,227594,6,350144
4297,0.00141,74.125.200.0-255,4320,231914,6,350144
4298,0.001428,172.31.36.0-255,66,231980,6,350144
4299,0.001444,74.125.200.0-255,5738,237718,6,350144
4300,0.001463,74.125.200.0-255,5020,242738,6,350144
4301,0.001466,74.125.200.0-255,1484,244222,6,350144
4302,0.001469,172.31.36.0-255,66,244288,6,350144
4303,0.001475,172.31.36.0-255,66,244354,6,350144
4304,0.0015,74.125.200.0-255,9992,254346,6,350144
4305,0.001507,74.125.200.0-255,5738,260084,6,350144
4306,0.001514,74.125.200.0-255,7156,267240,6,350144
4307,0.001527,172.31.36.0-255,66,267306,6,350144
4308,0.001546,74.125.200.0-255,4320,271626,6,350144
4309,0.001559,74.125.200.0-255,5020,276646,6,350144
4310,0.001566,172.31.36.0-255,66,276712,6,350144
4311,0.001581,74.125.200.0-255,7156,283868,6,350144
4312,0.001596,74.125.200.0-255,2902,286770,6,350144
4313,0.001602,74.125.200.0-255,5738,292508,6,350144
4314,0.00161,74.125.200.0-255,7156,299664,6,350144
4315,0.001668,74.125.200.0-255,10692,310356,6,350144
4316,0.001687,172.31.36.0-255,66,310422,6,350144
4317,0.001702,74.125.200.0-255,9992,320414,6,350144
4318,0.001708,172.31.36.0-255,66,320480,6,350144
4319,0.001734,74.125.200.0-255,766,321246,6,350144
4320,0.001754,172.31.36.0-255,66,321312,6,350144
4321,0.001763,74.125.200.0-255,1484,322796,6,350144
4322,0.001777,74.125.200.0-255,4320,327116,6,350144
4323,0.001792,74.125.200.0-255,1484,328600,6,350144
4324,0.001796,74.125.200.0-255,2902,331502,6,350144
4325,0.0018,172.31.36.0-255,66,331568,6,350144
4326,0.001809,172.31.36.0-255,66,331634,6,350144
4327,0.001816,74.125.200.0-255,5738,337372,6,350144
4328,0.001848,74.125.200.0-255,5738,343110,6,350144
4329,0.001867,74.125.200.0-255,6595,349705,6,350144
4330,0.00187,74.125.200.0-255,97,349802,6,350144
4331,0.001875,172.31.36.0-255,66,349868,6,350144
4332,0.001907,74.125.200.0-255,105,349973,6,350144
4333,0.008632,172.31.36.0-255,66,350039,6,350144
4334,0.008672,172.31.36.0-255,105,350144,6,350144
4335,0.0,74.125.24.0-255,147,147,6,290223
4336,1.3e-05,172.31.36.0-255,66,213,6,290223
4337,1.8e-05,74.125.24.0-255,1484,1697,6,290223
4338,2.2e-05,172.31.36.0-255,66,1763,6,290223
4339,4.3e-05,74.125.24.0-255,2902,4665,6,290223
4340,4.5e-05,172.31.36.0-255,66,4731,6,290223
4341,5e-05,74.125.24.0-255,2902,7633,6,290223
4342,5.2e-05,172.31.36.0-255,66,7699,6,290223
4343,9.9e-05,74.125.24.0-255,5738,13437,6,290223
4344,0.000104,172.31.36.0-255,66,13503,6,290223
4345,0.000121,74.125.24.0-255,693,14196,6,290223
4346,0.000123,172.31.36.0-255,66,14262,6,290223
4347,0.00014,74.125.24.0-255,1484,15746,6,290223
4348,0.000142,172.31.36.0-255,66,15812,6,290223
4349,0.000146,74.125.24.0-255,2902,18714,6,290223
4350,0.000148,172.31.36.0-255,66,18780,6,290223
4351,0.000151,74.125.24.0-255,1484,20264,6,290223
4352,0.000153,172.31.36.0-255,66,20330,6,290223
4353,0.000175,74.125.24.0-255,4320,24650,6,290223
4354,0.000177,172.31.36.0-255,66,24716,6,290223
4355,0.000194,74.125.24.0-255,4320,29036,6,290223
4356,0.000196,172.31.36.0-255,66,29102,6,290223
4357,0.000217,74.125.24.0-255,2543,31645,6,290223
4358,0.000219,172.31.36.0-255,66,31711,6,290223
4359,0.000242,74.125.24.0-255,1484,33195,6,290223
4360,0.000244,172.31.36.0-255,66,33261,6,290223
4361,0.000248,74.125.24.0-255,1484,34745,6,290223
4362,0.000249,172.31.36.0-255,66,34811,6,290223
4363,0.000262,74.125.24.0-255,1484,36295,6,290223
4364,0.000264,172.31.36.0-255,66,36361,6,290223
4365,0.000268,74.125.24.0-255,2902,39263,6,290223
4366,0.00027,172.31.36.0-255,66,39329,6,290223
4367,0.000291,74.125.24.0-255,2902,42231,6,290223
4368,0.000315,74.125.24.0-255,6797,49028,6,290223
4369,0.00034,172.31.36.0-255,66,49094,6,290223
4370,0.000658,74.125.24.0-255,1484,50578,6,290223
4371,0.000662,74.125.24.0-255,1484,52062,6,290223
4372,0.000666,172.31.36.0-255,66,52128,6,290223
4373,0.000697,74.125.24.0-255,1484,53612,6,290223
4374,0.000704,74.125.24.0-255,5738,59350,6,290223
4375,0.000741,74.125.24.0-255,2902,62252,6,290223
4376,0.000762,74.125.24.0-255,4542,66794,6,290223
4377,0.000789,74.125.24.0-255,1484,68278,6,290223
4378,0.000807,74.125.24.0-255,2902,71180,6,290223
4379,0.000824,74.125.24.0-255,4320,75500,6,290223
4380,0.000833,74.125.24.0-255,1484,76984,6,290223
4381,0.000849,74.125.24.0-255,4320,81304,6,290223
4382,0.000863,74.125.24.0-255,2543,83847,6,290223
4383,0.000882,74.125.24.0-255,2902,86749,6,290223
4384,0.000896,74.125.24.0-255,2902,89651,6,290223
4385,0.000905,74.125.24.0-255,1484,91135,6,290223
4386,0.00094,74.125.24.0-255,1484,92619,6,290223
4387,0.000959,74.125.24.0-255,5738,98357,6,290223
4388,0.000974,74.125.24.0-255,1484,99841,6,290223
4389,0.000996,74.125.24.0-255,1125,100966,6,290223
4390,0.001283,74.125.24.0-255,1484,102450,6,290223
4391,0.001289,74.125.24.0-255,2902,105352,6,290223
4392,0.00131,74.125.24.0-255,1484,106836,6,290223
4393,0.001323,74.125.24.0-255,4320,111156,6,290223
4394,0.001339,74.125.24.0-255,4320,115476,6,290223
4395,0.001351,74.125.24.0-255,5738,121214,6,290223
4396,0.001361,74.125.24.0-255,2902,124116,6,290223
4397,0.001419,74.125.24.0-255,2902,127018,6,290223
4398,0.001438,74.125.24.0-255,5738,132756,6,290223
4399,0.001472,74.125.24.0-255,2184,134940,6,290223
4400,0.002054,74.125.24.0-255,1484,136424,6,290223
4401,0.002056,74.125.24.0-255,1484,137908,6,290223
4402,0.00207,74.125.24.0-255,1484,139392,6,290223
4403,0.002072,74.125.24.0-255,1484,140876,6,290223
4404,0.002084,74.125.24.0-255,4320,145196,6,290223
4405,0.00211,74.125.24.0-255,5738,150934,6,290223
4406,0.002127,74.125.24.0-255,7156,158090,6,290223
4407,0.002185,74.125.24.0-255,1484,159574,6,290223
4408,0.002204,74.125.24.0-255,9274,168848,6,290223
4409,0.002907,74.125.24.0-255,1484,170332,6,290223
4410,0.002913,74.125.24.0-255,1484,171816,6,290223
4411,0.002929,74.125.24.0-255,1484,173300,6,290223
4412,0.002936,74.125.24.0-255,5738,179038,6,290223
4413,0.002965,74.125.24.0-255,5738,184776,6,290223
4414,0.002984,74.125.24.0-255,7156,191932,6,290223
4415,0.003015,172.31.36.0-255,66,191998,6,290223
4416,0.003057,74.125.24.0-255,4320,196318,6,290223
4417,0.003075,172.31.36.0-255,66,196384,6,290223
4418,0.003076,74.125.24.0-255,6438,202822,6,290223
4419,0.00308,172.31.36.0-255,66,202888,6,290223
4420,0.003143,74.125.24.0-255,1484,204372,6,290223
4421,0.003161,74.125.24.0-255,2902,207274,6,290223
4422,0.003166,74.125.24.0-255,2902,210176,6,290223
4423,0.003166,172.31.36.0-255,66,210242,6,290223
4424,0.003182,172.31.36.0-255,66,210308,6,290223
4425,0.003185,74.125.24.0-255,2902,213210,6,290223
4426,0.003197,172.31.36.0-255,66,213276,6,290223
4427,0.003205,74.125.24.0-255,2902,216178,6,290223
4428,0.003215,172.31.36.0-255,66,216244,6,290223
4429,0.003241,74.125.24.0-255,9992,226236,6,290223
4430,0.003251,172.31.36.0-255,66,226302,6,290223
4431,0.003286,74.125.24.0-255,2902,229204,6,290223
4432,0.003296,172.31.36.0-255,66,229270,6,290223
4433,0.003307,74.125.24.0-255,7856,237126,6,290223
4434,0.003312,172.31.36.0-255,66,237192,6,290223
4435,0.003398,74.125.24.0-255,4320,241512,6,290223
4436,0.003404,172.31.36.0-255,66,241578,6,290223
4437,0.003443,172.31.36.0-255,66,241644,6,290223
4438,0.003514,74.125.24.0-255,7156,248800,6,290223
4439,0.003524,172.31.36.0-255,66,248866,6,290223
4440,0.00353,74.125.24.0-255,3602,252468,6,290223
4441,0.003541,172.31.36.0-255,66,252534,6,290223
4442,0.003612,74.125.24.0-255,4320,256854,6,290223
4443,0.003624,172.31.36.0-255,66,256920,6,290223
4444,0.003635,74.125.24.0-255,9992,266912,6,290223
4445,0.003639,172.31.36.0-255,66,266978,6,290223
4446,0.003679,172.31.36.0-255,66,267044,6,290223
4447,0.003683,74.125.24.0-255,3602,270646,6,290223
4448,0.003694,172.31.36.0-255,66,270712,6,290223
4449,0.003842,172.31.36.0-255,66,270778,6,290223
4450,0.003871,172.31.36.0-255,66,270844,6,290223
4451,0.00388,74.125.24.0-255,2184,273028,6,290223
4452,0.003886,172.31.36.0-255,66,273094,6,290223
4453,0.004137,172.31.36.0-255,66,273160,6,290223
4454,0.004144,74.125.24.0-255,2184,275344,6,290223
4455,0.004147,172.31.36.0-255,66,275410,6,290223
4456,0.004248,74.125.24.0-255,7156,282566,6,290223
4457,0.004263,172.31.36.0-255,66,282632,6,290223
4458,0.004266,74.125.24.0-255,4320,286952,6,290223
4459,0.004278,172.31.36.0-255,66,287018,6,290223
4460,0.00432,74.125.24.0-255,2902,289920,6,290223
4461,0.004324,172.31.36.0-255,66,289986,6,290223
4462,0.004358,172.31.36.0-255,66,290052,6,290223
4463,0.00626,172.31.36.0-255,105,290157,6,290223
4464,0.008522,74.125.24.0-255,66,290223,6,290223
4465,0.0,74.125.24.0-255,291,291,6,82996
4466,3.2e-05,172.31.36.0-255,66,357,6,82996
4467,3.9e-05,74.125.24.0-255,1484,1841,6,82996
4468,4.4e-05,172.31.36.0-255,66,1907,6,82996
4469,4.9e-05,74.125.24.0-255,2902,4809,6,82996
4470,5.2e-05,172.31.36.0-255,66,4875,6,82996
4471,7.7e-05,74.125.24.0-255,5738,10613,6,82996
4472,8e-05,172.31.36.0-255,66,10679,6,82996
4473,0.000141,74.125.24.0-255,3251,13930,6,82996
4474,0.000144,172.31.36.0-255,66,13996,6,82996
4475,0.000176,74.125.24.0-255,2902,16898,6,82996
4476,0.000178,172.31.36.0-255,66,16964,6,82996
4477,0.000198,74.125.24.0-255,1484,18448,6,82996
4478,0.0002,172.31.36.0-255,66,18514,6,82996
4479,0.000235,74.125.24.0-255,4320,22834,6,82996
4480,0.000238,172.31.36.0-255,66,22900,6,82996
4481,0.000261,74.125.24.0-255,5738,28638,6,82996
4482,0.000263,172.31.36.0-255,66,28704,6,82996
4483,0.000363,74.125.24.0-255,2543,31247,6,82996
4484,0.000367,172.31.36.0-255,66,31313,6,82996
4485,0.00039,74.125.24.0-255,8574,39887,6,82996
4486,0.000393,172.31.36.0-255,66,39953,6,82996
4487,0.000491,74.125.24.0-255,5738,45691,6,82996
4488,0.000496,172.31.36.0-255,66,45757,6,82996
4489,0.000514,74.125.24.0-255,6797,52554,6,82996
4490,0.000517,172.31.36.0-255,66,52620,6,82996
4491,0.000674,74.125.24.0-255,5738,58358,6,82996
4492,0.000678,172.31.36.0-255,66,58424,6,82996
4493,0.0007,74.125.24.0-255,7094,65518,6,82996
4494,0.000703,172.31.36.0-255,66,65584,6,82996
4495,0.003293,74.125.24.0-255,5738,71322,6,82996
4496,0.0033,172.31.36.0-255,66,71388,6,82996
4497,0.005865,74.125.24.0-255,5738,77126,6,82996
4498,0.005871,172.31.36.0-255,66,77192,6,82996
4499,0.008464,74.125.24.0-255,5738,82930,6,82996
4500,0.008472,172.31.36.0-255,66,82996,6,82996
4501,0.0,74.125.130.0-255,150,150,6,187466
4502,2.5e-05,172.31.36.0-255,66,216,6,187466
4503,3.2e-05,74.125.130.0-255,1484,1700,6,187466
4504,3.6e-05,172.31.36.0-255,66,1766,6,187466
4505,5.1e-05,74.125.130.0-255,2902,4668,6,187466
4506,5.4e-05,172.31.36.0-255,66,4734,6,187466
4507,6e-05,74.125.130.0-255,4320,9054,6,187466
4508,6.2e-05,172.31.36.0-255,66,9120,6,187466
4509,6.9e-05,74.125.130.0-255,4922,14042,6,187466
4510,7.2e-05,172.31.36.0-255,66,14108,6,187466
4511,0.000183,74.125.130.0-255,1484,15592,6,187466
4512,0.000187,172.31.36.0-255,66,15658,6,187466
4513,0.000214,74.125.130.0-255,2902,18560,6,187466
4514,0.000217,172.31.36.0-255,66,18626,6,187466
4515,0.000222,74.125.130.0-255,4320,22946,6,187466
4516,0.000224,172.31.36.0-255,66,23012,6,187466
4517,0.000236,74.125.130.0-255,4320,27332,6,187466
4518,0.000238,172.31.36.0-255,66,27398,6,187466
4519,0.000269,74.125.130.0-255,1484,28882,6,187466
4520,0.000272,172.31.36.0-255,66,28948,6,187466
4521,0.000277,74.125.130.0-255,2543,31491,6,187466
4522,0.000278,172.31.36.0-255,66,31557,6,187466
4523,0.000288,74.125.130.0-255,2902,34459,6,187466
4524,0.000291,172.31.36.0-255,66,34525,6,187466
4525,0.000294,74.125.130.0-255,1484,36009,6,187466
4526,0.000295,172.31.36.0-255,66,36075,6,187466
4527,0.000311,74.125.130.0-255,5738,41813,6,187466
4528,0.000314,172.31.36.0-255,66,41879,6,187466
4529,0.000324,74.125.130.0-255,4320,46199,6,187466
4530,0.000326,172.31.36.0-255,66,46265,6,187466
4531,0.000367,74.125.130.0-255,2543,48808,6,187466
4532,0.00037,172.31.36.0-255,66,48874,6,187466
4533,0.000406,74.125.130.0-255,2902,51776,6,187466
4534,0.000409,172.31.36.0-255,66,51842,6,187466
4535,0.000412,74.125.130.0-255,1484,53326,6,187466
4536,0.000437,74.125.130.0-255,2902,56228,6,187466
4537,0.00044,172.31.36.0-255,66,56294,6,187466
4538,0.000447,74.125.130.0-255,5738,62032,6,187466
4539,0.000449,172.31.36.0-255,66,62098,6,187466
4540,0.000475,74.125.130.0-255,4212,66310,6,187466
4541,0.000478,172.31.36.0-255,66,66376,6,187466
4542,0.000502,74.125.130.0-255,436,66812,6,187466
4543,0.000872,74.125.130.0-255,1484,68296,6,187466
4544,0.000878,172.31.36.0-255,66,68362,6,187466
4545,0.000884,74.125.130.0-255,2902,71264,6,187466
4546,0.000886,172.31.36.0-255,66,71330,6,187466
4547,0.000919,74.125.130.0-255,5738,77068,6,187466
4548,0.000921,172.31.36.0-255,66,77134,6,187466
4549,0.000927,74.125.130.0-255,5738,82872,6,187466
4550,0.000929,172.31.36.0-255,66,82938,6,187466
4551,0.000976,74.125.130.0-255,7156,90094,6,187466
4552,0.000979,172.31.36.0-255,66,90160,6,187466
4553,0.000983,74.125.130.0-255,2902,93062,6,187466
4554,0.000986,172.31.36.0-255,66,93128,6,187466
4555,0.000991,74.125.130.0-255,4320,97448,6,187466
4556,0.000999,172.31.36.0-255,66,97514,6,187466
4557,0.001026,74.125.130.0-255,3602,101116,6,187466
4558,0.001029,172.31.36.0-255,66,101182,6,187466
4559,0.001276,74.125.130.0-255,1484,102666,6,187466
4560,0.001294,74.125.130.0-255,2902,105568,6,187466
4561,0.001298,172.31.36.0-255,66,105634,6,187466
4562,0.001306,74.125.130.0-255,5738,111372,6,187466
4563,0.001308,172.31.36.0-255,66,111438,6,187466
4564,0.001318,74.125.130.0-255,4320,115758,6,187466
4565,0.00132,172.31.36.0-255,66,115824,6,187466
4566,0.001323,74.125.130.0-255,1484,117308,6,187466
4567,0.001351,74.125.130.0-255,4320,121628,6,187466
4568,0.001354,172.31.36.0-255,66,121694,6,187466
4569,0.001358,74.125.130.0-255,1484,123178,6,187466
4570,0.001388,74.125.130.0-255,9992,133170,6,187466
4571,0.001391,172.31.36.0-255,66,133236,6,187466
4572,0.001396,74.125.130.0-255,2184,135420,6,187466
4573,0.001398,172.31.36.0-255,66,135486,6,187466
4574,0.001843,74.125.130.0-255,1484,136970,6,187466
4575,0.001847,74.125.130.0-255,1484,138454,6,187466
4576,0.001851,172.31.36.0-255,66,138520,6,187466
4577,0.001868,74.125.130.0-255,1484,140004,6,187466
4578,0.001888,74.125.130.0-255,5738,145742,6,187466
4579,0.001891,172.31.36.0-255,66,145808,6,187466
4580,0.001896,74.125.130.0-255,2902,148710,6,187466
4581,0.001898,172.31.36.0-255,66,148776,6,187466
4582,0.001908,74.125.130.0-255,4320,153096,6,187466
4583,0.00191,172.31.36.0-255,66,153162,6,187466
4584,0.001915,74.125.130.0-255,2902,156064,6,187466
4585,0.001917,172.31.36.0-255,66,156130,6,187466
4586,0.001957,74.125.130.0-255,5738,161868,6,187466
4587,0.001961,172.31.36.0-255,66,161934,6,187466
4588,0.001967,74.125.130.0-255,4320,166254,6,187466
4589,0.001969,172.31.36.0-255,66,166320,6,187466
4590,0.001994,74.125.130.0-255,3602,169922,6,187466
4591,0.001997,172.31.36.0-255,66,169988,6,187466
4592,0.004206,74.125.130.0-255,1484,171472,6,187466
4593,0.004278,74.125.130.0-255,4320,175792,6,187466
4594,0.004284,172.31.36.0-255,66,175858,6,187466
4595,0.00652,74.125.130.0-255,5738,181596,6,187466
4596,0.006525,172.31.36.0-255,66,181662,6,187466
4597,0.008766,74.125.130.0-255,5738,187400,6,187466
4598,0.008773,172.31.36.0-255,66,187466,6,187466
4599,0.0,74.125.24.0-255,146,146,6,210255
4600,2e-05,172.31.36.0-255,66,212,6,210255
4601,2.7e-05,74.125.24.0-255,1484,1696,6,210255
4602,3.1e-05,172.31.36.0-255,66,1762,6,210255
4603,3.7e-05,74.125.24.0-255,2902,4664,6,210255
4604,4.9e-05,172.31.36.0-255,66,4730,6,210255
4605,5.4e-05,74.125.24.0-255,2902,7632,6,210255
4606,5.6e-05,172.31.36.0-255,66,7698,6,210255
4607,6.5e-05,74.125.24.0-255,7699,15397,6,210255
4608,6.8e-05,172.31.36.0-255,66,15463,6,210255
4609,8.9e-05,74.125.24.0-255,2902,18365,6,210255
4610,9.3e-05,172.31.36.0-255,66,18431,6,210255
4611,0.000139,172.31.36.0-255,66,18497,6,210255
4612,0.000154,172.31.36.0-255,66,18563,6,210255
4613,0.000159,74.125.24.0-255,2184,20747,6,210255
4614,0.000161,172.31.36.0-255,66,20813,6,210255
4615,0.000515,74.125.24.0-255,1484,22297,6,210255
4616,0.00052,172.31.36.0-255,66,22363,6,210255
4617,0.000527,74.125.24.0-255,2902,25265,6,210255
4618,0.000529,172.31.36.0-255,66,25331,6,210255
4619,0.00054,74.125.24.0-255,5738,31069,6,210255
4620,0.000543,172.31.36.0-255,66,31135,6,210255
4621,0.000577,74.125.24.0-255,7132,38267,6,210255
4622,0.00058,172.31.36.0-255,66,38333,6,210255
4623,0.000919,74.125.24.0-255,1484,39817,6,210255
4624,0.000924,172.31.36.0-255,66,39883,6,210255
4625,0.000929,74.125.24.0-255,2902,42785,6,210255
4626,0.000931,172.31.36.0-255,66,42851,6,210255
4627,0.000935,74.125.24.0-255,1484,44335,6,210255
4628,0.000936,172.31.36.0-255,66,44401,6,210255
4629,0.000973,74.125.24.0-255,4320,48721,6,210255
4630,0.000992,74.125.24.0-255,5738,54459,6,210255
4631,0.001002,172.31.36.0-255,66,54525,6,210255
4632,0.001007,74.125.24.0-255,2902,57427,6,210255
4633,0.001012,172.31.36.0-255,66,57493,6,210255
4634,0.001044,74.125.24.0-255,2184,59677,6,210255
4635,0.001071,172.31.36.0-255,66,59743,6,210255
4636,0.0016,74.125.24.0-255,1484,61227,6,210255
4637,0.001609,74.125.24.0-255,2902,64129,6,210255
4638,0.001614,172.31.36.0-255,66,64195,6,210255
4639,0.001622,74.125.24.0-255,5738,69933,6,210255
4640,0.001624,172.31.36.0-255,66,69999,6,210255
4641,0.001663,74.125.24.0-255,4320,74319,6,210255
4642,0.001687,74.125.24.0-255,7856,82175,6,210255
4643,0.001708,74.125.24.0-255,7156,89331,6,210255
4644,0.001718,74.125.24.0-255,1484,90815,6,210255
4645,0.001733,74.125.24.0-255,8574,99389,6,210255
4646,0.001744,74.125.24.0-255,1484,100873,6,210255
4647,0.001749,74.125.24.0-255,4320,105193,6,210255
4648,0.001807,74.125.24.0-255,10692,115885,6,210255
4649,0.00189,74.125.24.0-255,1484,117369,6,210255
4650,0.001896,74.125.24.0-255,2902,120271,6,210255
4651,0.001913,74.125.24.0-255,4320,124591,6,210255
4652,0.001923,74.125.24.0-255,1484,126075,6,210255
4653,0.001951,74.125.24.0-255,5738,131813,6,210255
4654,0.001974,74.125.24.0-255,5738,137551,6,210255
4655,0.001982,74.125.24.0-255,8574,146125,6,210255
4656,0.001996,74.125.24.0-255,3602,149727,6,210255
4657,0.00211,74.125.24.0-255,1484,151211,6,210255
4658,0.00213,74.125.24.0-255,2902,154113,6,210255
4659,0.002147,74.125.24.0-255,1484,155597,6,210255
4660,0.002172,74.125.24.0-255,5738,161335,6,210255
4661,0.002193,74.125.24.0-255,5738,167073,6,210255
4662,0.002212,74.125.24.0-255,7156,174229,6,210255
4663,0.002253,74.125.24.0-255,5738,179967,6,210255
4664,0.002279,74.125.24.0-255,7856,187823,6,210255
4665,0.002282,74.125.24.0-255,1484,189307,6,210255
4666,0.002336,74.125.24.0-255,5738,195045,6,210255
4667,0.00234,74.125.24.0-255,2902,197947,6,210255
4668,0.00236,74.125.24.0-255,6438,204385,6,210255
4669,0.007593,172.31.36.0-255,66,204451,6,210255
4670,0.009958,74.125.24.0-255,5738,210189,6,210255
4671,0.009967,172.31.36.0-255,66,210255,6,210255
4672,0.0,74.125.24.0-255,153,153,6,163006
4673,2.3e-05,172.31.36.0-255,66,219,6,163006
4674,3.1e-05,74.125.24.0-255,1484,1703,6,163006
4675,3.7e-05,172.31.36.0-255,66,1769,6,163006
4676,5e-05,74.125.24.0-255,2902,4671,6,163006
4677,5.5e-05,172.31.36.0-255,66,4737,6,163006
4678,6.2e-05,74.125.24.0-255,5738,10475,6,163006
4679,6.6e-05,172.31.36.0-255,66,10541,6,163006
4680,7.5e-05,74.125.24.0-255,8574,19115,6,163006
4681,7.9e-05,172.31.36.0-255,66,19181,6,163006
4682,0.00011,74.125.24.0-255,4814,23995,6,163006
4683,0.000113,172.31.36.0-255,66,24061,6,163006
4684,0.000121,74.125.24.0-255,6797,30858,6,163006
4685,0.000123,172.31.36.0-255,66,30924,6,163006
4686,0.000197,74.125.24.0-255,1484,32408,6,163006
4687,0.000201,172.31.36.0-255,66,32474,6,163006
4688,0.000219,74.125.24.0-255,2902,35376,6,163006
4689,0.000222,172.31.36.0-255,66,35442,6,163006
4690,0.000227,74.125.24.0-255,4320,39762,6,163006
4691,0.00023,172.31.36.0-255,66,39828,6,163006
4692,0.000263,74.125.24.0-255,1484,41312,6,163006
4693,0.000266,172.31.36.0-255,66,41378,6,163006
4694,0.000272,74.125.24.0-255,4320,45698,6,163006
4695,0.000274,172.31.36.0-255,66,45764,6,163006
4696,0.000286,74.125.24.0-255,8574,54338,6,163006
4697,0.000289,172.31.36.0-255,66,54404,6,163006
4698,0.00032,74.125.24.0-255,8215,62619,6,163006
4699,0.000323,172.31.36.0-255,66,62685,6,163006
4700,0.000327,74.125.24.0-255,2543,65228,6,163006
4701,0.000329,172.31.36.0-255,66,65294,6,163006
4702,0.000332,74.125.24.0-255,443,65737,6,163006
4703,0.000334,172.31.36.0-255,66,65803,6,163006
4704,0.000373,74.125.24.0-255,333,66136,6,163006
4705,0.000791,74.125.24.0-255,1484,67620,6,163006
4706,0.000797,172.31.36.0-255,66,67686,6,163006
4707,0.000803,74.125.24.0-255,2902,70588,6,163006
4708,0.000806,172.31.36.0-255,66,70654,6,163006
4709,0.000826,74.125.24.0-255,5738,76392,6,163006
4710,0.000829,172.31.36.0-255,66,76458,6,163006
4711,0.000842,74.125.24.0-255,8574,85032,6,163006
4712,0.000845,172.31.36.0-255,66,85098,6,163006
4713,0.000885,74.125.24.0-255,4320,89418,6,163006
4714,0.000889,172.31.36.0-255,66,89484,6,163006
4715,0.000896,74.125.24.0-255,7156,96640,6,163006
4716,0.000899,172.31.36.0-255,66,96706,6,163006
4717,0.000908,74.125.24.0-255,3602,100308,6,163006
4718,0.000911,172.31.36.0-255,66,100374,6,163006
4719,0.001661,74.125.24.0-255,1484,101858,6,163006
4720,0.00167,74.125.24.0-255,2902,104760,6,163006
4721,0.001674,172.31.36.0-255,66,104826,6,163006
4722,0.001679,74.125.24.0-255,2902,107728,6,163006
4723,0.001681,172.31.36.0-255,66,107794,6,163006
4724,0.001716,74.125.24.0-255,2902,110696,6,163006
4725,0.001718,172.31.36.0-255,66,110762,6,163006
4726,0.001731,172.31.36.0-255,66,110828,6,163006
4727,0.00175,172.31.36.0-255,66,110894,6,163006
4728,0.002061,74.125.24.0-255,1484,112378,6,163006
4729,0.002076,74.125.24.0-255,2902,115280,6,163006
4730,0.002078,172.31.36.0-255,66,115346,6,163006
4731,0.002103,74.125.24.0-255,5738,121084,6,163006
4732,0.002105,172.31.36.0-255,66,121150,6,163006
4733,0.00211,74.125.24.0-255,2902,124052,6,163006
4734,0.002112,172.31.36.0-255,66,124118,6,163006
4735,0.002144,74.125.24.0-255,7156,131274,6,163006
4736,0.002146,172.31.36.0-255,66,131340,6,163006
4737,0.002174,74.125.24.0-255,2902,134242,6,163006
4738,0.002176,172.31.36.0-255,66,134308,6,163006
4739,0.002185,74.125.24.0-255,8574,142882,6,163006
4740,0.002191,172.31.36.0-255,66,142948,6,163006
4741,0.002209,74.125.24.0-255,2184,145132,6,163006
4742,0.002211,172.31.36.0-255,66,145198,6,163006
4743,0.004499,74.125.24.0-255,2902,148100,6,163006
4744,0.004505,172.31.36.0-255,66,148166,6,163006
4745,0.004532,74.125.24.0-255,2902,151068,6,163006
4746,0.004535,172.31.36.0-255,66,151134,6,163006
4747,0.0068,74.125.24.0-255,2902,154036,6,163006
4748,0.006807,172.31.36.0-255,66,154102,6,163006
4749,0.006867,74.125.24.0-255,2902,157004,6,163006
4750,0.00687,172.31.36.0-255,66,157070,6,163006
4751,0.00908,74.125.24.0-255,2902,159972,6,163006
4752,0.009088,172.31.36.0-255,66,160038,6,163006
4753,0.009164,74.125.24.0-255,2902,162940,6,163006
4754,0.009167,172.31.36.0-255,66,163006,6,163006
4755,0.0,74.125.24.0-255,146,146,6,170783
4756,2.7e-05,172.31.36.0-255,66,212,6,170783
4757,3.5e-05,74.125.24.0-255,1484,1696,6,170783
4758,4e-05,172.31.36.0-255,66,1762,6,170783
4759,4.5e-05,74.125.24.0-255,2902,4664,6,170783
4760,5.8e-05,172.31.36.0-255,66,4730,6,170783
4761,6.5e-05,74.125.24.0-255,7156,11886,6,170783
4762,6.8e-05,172.31.36.0-255,66,11952,6,170783
4763,7.2e-05,74.125.24.0-255,2051,14003,6,170783
4764,7.5e-05,172.31.36.0-255,66,14069,6,170783
4765,0.000306,74.125.24.0-255,1484,15553,6,170783
4766,0.000312,172.31.36.0-255,66,15619,6,170783
4767,0.000317,74.125.24.0-255,2902,18521,6,170783
4768,0.000321,172.31.36.0-255,66,18587,6,170783
4769,0.000341,74.125.24.0-255,5738,24325,6,170783
4770,0.000346,172.31.36.0-255,66,24391,6,170783
4771,0.000383,74.125.24.0-255,1484,25875,6,170783
4772,0.000387,172.31.36.0-255,66,25941,6,170783
4773,0.00042,74.125.24.0-255,5379,31320,6,170783
4774,0.000424,172.31.36.0-255,66,31386,6,170783
4775,0.000664,74.125.24.0-255,1484,32870,6,170783
4776,0.000669,172.31.36.0-255,66,32936,6,170783
4777,0.000678,74.125.24.0-255,2902,35838,6,170783
4778,0.00068,172.31.36.0-255,66,35904,6,170783
4779,0.000694,74.125.24.0-255,5738,41642,6,170783
4780,0.000696,172.31.36.0-255,66,41708,6,170783
4781,0.000703,74.125.24.0-255,6797,48505,6,170783
4782,0.000706,172.31.36.0-255,66,48571,6,170783
4783,0.000752,172.31.36.0-255,66,48637,6,170783
4784,0.000757,74.125.24.0-255,2815,51452,6,170783
4785,0.000759,172.31.36.0-255,66,51518,6,170783
4786,0.001001,74.125.24.0-255,129,51647,6,170783
4787,0.001294,74.125.24.0-255,1484,53131,6,170783
4788,0.001302,74.125.24.0-255,2902,56033,6,170783
4789,0.001323,74.125.24.0-255,5738,61771,6,170783
4790,0.001349,74.125.24.0-255,4320,66091,6,170783
4791,0.001363,74.125.24.0-255,6797,72888,6,170783
4792,0.001369,74.125.24.0-255,7156,80044,6,170783
4793,0.001391,74.125.24.0-255,4320,84364,6,170783
4794,0.001393,74.125.24.0-255,1125,85489,6,170783
4795,0.001476,74.125.24.0-255,1484,86973,6,170783
4796,0.001495,74.125.24.0-255,2902,89875,6,170783
4797,0.001498,74.125.24.0-255,1484,91359,6,170783
4798,0.001525,74.125.24.0-255,5738,97097,6,170783
4799,0.001546,74.125.24.0-255,1484,98581,6,170783
4800,0.001569,74.125.24.0-255,7156,105737,6,170783
4801,0.001592,74.125.24.0-255,4320,110057,6,170783
4802,0.001597,74.125.24.0-255,4320,114377,6,170783
4803,0.0016,74.125.24.0-255,2902,117279,6,170783
4804,0.001611,74.125.24.0-255,2184,119463,6,170783
4805,0.00168,74.125.24.0-255,1484,120947,6,170783
4806,0.001684,74.125.24.0-255,2902,123849,6,170783
4807,0.001705,74.125.24.0-255,2902,126751,6,170783
4808,0.001722,74.125.24.0-255,1484,128235,6,170783
4809,0.001736,74.125.24.0-255,5738,133973,6,170783
4810,0.001762,74.125.24.0-255,4320,138293,6,170783
4811,0.001782,74.125.24.0-255,9992,148285,6,170783
4812,0.00181,74.125.24.0-255,5020,153305,6,170783
4813,0.002708,172.31.36.0-255,66,153371,6,170783
4814,0.005023,74.125.24.0-255,5738,159109,6,170783
4815,0.005031,172.31.36.0-255,66,159175,6,170783
4816,0.007337,74.125.24.0-255,5738,164913,6,170783
4817,0.007344,172.31.36.0-255,66,164979,6,170783
4818,0.009644,74.125.24.0-255,5738,170717,6,170783
4819,0.009652,172.31.36.0-255,66,170783,6,170783
4820,0.0,74.125.24.0-255,147,147,6,263467
4821,1.6e-05,172.31.36.0-255,66,213,6,263467
4822,2.3e-05,74.125.24.0-255,1484,1697,6,263467
4823,2.7e-05,172.31.36.0-255,66,1763,6,263467
4824,3.2e-05,74.125.24.0-255,2902,4665,6,263467
4825,3.5e-05,172.31.36.0-255,66,4731,6,263467
4826,4.3e-05,74.125.24.0-255,7156,11887,6,263467
4827,4.5e-05,172.31.36.0-255,66,11953,6,263467
4828,4.9e-05,74.125.24.0-255,2031,13984,6,263467
4829,5.2e-05,172.31.36.0-255,66,14050,6,263467
4830,9.6e-05,74.125.24.0-255,1484,15534,6,263467
4831,9.8e-05,172.31.36.0-255,66,15600,6,263467
4832,0.000103,74.125.24.0-255,2902,18502,6,263467
4833,0.000106,172.31.36.0-255,66,18568,6,263467
4834,0.000135,74.125.24.0-255,5738,24306,6,263467
4835,0.000138,172.31.36.0-255,66,24372,6,263467
4836,0.000145,74.125.24.0-255,6797,31169,6,263467
4837,0.000147,172.31.36.0-255,66,31235,6,263467
4838,0.000195,74.125.24.0-255,1484,32719,6,263467
4839,0.000197,172.31.36.0-255,66,32785,6,263467
4840,0.000202,74.125.24.0-255,2902,35687,6,263467
4841,0.000204,172.31.36.0-255,66,35753,6,263467
4842,0.00022,74.125.24.0-255,5738,41491,6,263467
4843,0.000222,172.31.36.0-255,66,41557,6,263467
4844,0.000263,74.125.24.0-255,6797,48354,6,263467
4845,0.000267,172.31.36.0-255,66,48420,6,263467
4846,0.000408,74.125.24.0-255,1484,49904,6,263467
4847,0.000413,172.31.36.0-255,66,49970,6,263467
4848,0.000418,74.125.24.0-255,2902,52872,6,263467
4849,0.000421,172.31.36.0-255,66,52938,6,263467
4850,0.000444,74.125.24.0-255,5738,58676,6,263467
4851,0.000447,172.31.36.0-255,66,58742,6,263467
4852,0.000493,74.125.24.0-255,7092,65834,6,263467
4853,0.000496,172.31.36.0-255,66,65900,6,263467
4854,0.000735,74.125.24.0-255,383,66283,6,263467
4855,0.00077,74.125.24.0-255,1484,67767,6,263467
4856,0.000774,172.31.36.0-255,66,67833,6,263467
4857,0.000777,74.125.24.0-255,1484,69317,6,263467
4858,0.000793,74.125.24.0-255,2902,72219,6,263467
4859,0.000796,172.31.36.0-255,66,72285,6,263467
4860,0.000803,74.125.24.0-255,4320,76605,6,263467
4861,0.000805,172.31.36.0-255,66,76671,6,263467
4862,0.000849,74.125.24.0-255,4320,80991,6,263467
4863,0.000852,172.31.36.0-255,66,81057,6,263467
4864,0.000871,74.125.24.0-255,2543,83600,6,263467
4865,0.000875,172.31.36.0-255,66,83666,6,263467
4866,0.000912,74.125.24.0-255,7156,90822,6,263467
4867,0.000915,172.31.36.0-255,66,90888,6,263467
4868,0.000922,74.125.24.0-255,4320,95208,6,263467
4869,0.000924,172.31.36.0-255,66,95274,6,263467
4870,0.000939,74.125.24.0-255,4320,99594,6,263467
4871,0.000943,172.31.36.0-255,66,99660,6,263467
4872,0.000946,74.125.24.0-255,1125,100785,6,263467
4873,0.001191,74.125.24.0-255,1484,102269,6,263467
4874,0.001196,172.31.36.0-255,66,102335,6,263467
4875,0.001201,74.125.24.0-255,2902,105237,6,263467
4876,0.001203,172.31.36.0-255,66,105303,6,263467
4877,0.001217,74.125.24.0-255,4320,109623,6,263467
4878,0.001219,172.31.36.0-255,66,109689,6,263467
4879,0.001245,74.125.24.0-255,1484,111173,6,263467
4880,0.001259,172.31.36.0-255,66,111239,6,263467
4881,0.001286,74.125.24.0-255,10692,121931,6,263467
4882,0.001289,172.31.36.0-255,66,121997,6,263467
4883,0.001734,74.125.24.0-255,1484,123481,6,263467
4884,0.001741,74.125.24.0-255,2902,126383,6,263467
4885,0.001744,172.31.36.0-255,66,126449,6,263467
4886,0.001748,74.125.24.0-255,1484,127933,6,263467
4887,0.001768,74.125.24.0-255,4320,132253,6,263467
4888,0.00177,172.31.36.0-255,66,132319,6,263467
4889,0.001776,74.125.24.0-255,5738,138057,6,263467
4890,0.001777,172.31.36.0-255,66,138123,6,263467
4891,0.001795,74.125.24.0-255,7156,145279,6,263467
4892,0.001797,172.31.36.0-255,66,145345,6,263467
4893,0.001803,74.125.24.0-255,7156,152501,6,263467
4894,0.001805,172.31.36.0-255,66,152567,6,263467
4895,0.001827,74.125.24.0-255,3602,156169,6,263467
4896,0.001829,172.31.36.0-255,66,156235,6,263467
4897,0.001872,74.125.24.0-255,4320,160555,6,263467
4898,0.001875,172.31.36.0-255,66,160621,6,263467
4899,0.001895,74.125.24.0-255,2902,163523,6,263467
4900,0.001897,172.31.36.0-255,66,163589,6,263467
4901,0.001905,74.125.24.0-255,8574,172163,6,263467
4902,0.001907,172.31.36.0-255,66,172229,6,263467
4903,0.001953,74.125.24.0-255,5738,177967,6,263467
4904,0.001956,172.31.36.0-255,66,178033,6,263467
4905,0.001985,172.31.36.0-255,66,178099,6,263467
4906,0.002238,74.125.24.0-255,1484,179583,6,263467
4907,0.002245,74.125.24.0-255,2902,182485,6,263467
4908,0.002248,172.31.36.0-255,66,182551,6,263467
4909,0.002254,74.125.24.0-255,2902,185453,6,263467
4910,0.002255,172.31.36.0-255,66,185519,6,263467
4911,0.002269,74.125.24.0-255,2902,188421,6,263467
4912,0.002271,172.31.36.0-255,66,188487,6,263467
4913,0.002312,172.31.36.0-255,66,188553,6,263467
4914,0.002331,74.125.24.0-255,1484,190037,6,263467
4915,0.00234,74.125.24.0-255,10692,200729,6,263467
4916,0.002343,172.31.36.0-255,66,200795,6,263467
4917,0.002389,74.125.24.0-255,1484,202279,6,263467
4918,0.002392,74.125.24.0-255,1484,203763,6,263467
4919,0.002395,172.31.36.0-255,66,203829,6,263467
4920,0.002411,74.125.24.0-255,1484,205313,6,263467
4921,0.002417,74.125.24.0-255,5738,211051,6,263467
4922,0.002419,172.31.36.0-255,66,211117,6,263467
4923,0.002435,74.125.24.0-255,2902,214019,6,263467
4924,0.002437,172.31.36.0-255,66,214085,6,263467
4925,0.002461,74.125.24.0-255,9992,224077,6,263467
4926,0.002464,172.31.36.0-255,66,224143,6,263467
4927,0.002469,74.125.24.0-255,5738,229881,6,263467
4928,0.002472,172.31.36.0-255,66,229947,6,263467
4929,0.00249,74.125.24.0-255,5020,234967,6,263467
4930,0.002492,172.31.36.0-255,66,235033,6,263467
4931,0.002505,74.125.24.0-255,2902,237935,6,263467
4932,0.002507,172.31.36.0-255,66,238001,6,263467
4933,0.002539,172.31.36.0-255,66,238067,6,263467
4934,0.002566,74.125.24.0-255,5738,243805,6,263467
4935,0.002568,172.31.36.0-255,66,243871,6,263467
4936,0.002571,74.125.24.0-255,1484,245355,6,263467
4937,0.002577,74.125.24.0-255,6438,251793,6,263467
4938,0.002579,172.31.36.0-255,66,251859,6,263467
4939,0.005137,74.125.24.0-255,5738,257597,6,263467
4940,0.005144,172.31.36.0-255,66,257663,6,263467
4941,0.007691,74.125.24.0-255,5738,263401,6,263467
4942,0.007698,172.31.36.0-255,66,263467,6,263467
4943,0.0,74.125.68.0-255,143,143,6,118497
4944,1.6e-05,172.31.36.0-255,66,209,6,118497
4945,2.3e-05,74.125.68.0-255,1484,1693,6,118497
4946,2.8e-05,172.31.36.0-255,66,1759,6,118497
4947,3.1e-05,74.125.68.0-255,1484,3243,6,118497
4948,3.3e-05,172.31.36.0-255,66,3309,6,118497
4949,4.7e-05,74.125.68.0-255,2902,6211,6,118497
4950,4.9e-05,172.31.36.0-255,66,6277,6,118497
4951,5.5e-05,74.125.68.0-255,5738,12015,6,118497
4952,5.8e-05,172.31.36.0-255,66,12081,6,118497
4953,9.4e-05,74.125.68.0-255,2029,14110,6,118497
4954,9.7e-05,172.31.36.0-255,66,14176,6,118497
4955,0.000285,74.125.68.0-255,1484,15660,6,118497
4956,0.00029,172.31.36.0-255,66,15726,6,118497
4957,0.000296,74.125.68.0-255,2902,18628,6,118497
4958,0.000298,172.31.36.0-255,66,18694,6,118497
4959,0.000328,74.125.68.0-255,5738,24432,6,118497
4960,0.000331,172.31.36.0-255,66,24498,6,118497
4961,0.000401,74.125.68.0-255,6797,31295,6,118497
4962,0.000405,172.31.36.0-255,66,31361,6,118497
4963,0.001042,74.125.68.0-255,1484,32845,6,118497
4964,0.001048,172.31.36.0-255,66,32911,6,118497
4965,0.001056,74.125.68.0-255,2902,35813,6,118497
4966,0.001058,172.31.36.0-255,66,35879,6,118497
4967,0.00107,74.125.68.0-255,5738,41617,6,118497
4968,0.001071,172.31.36.0-255,66,41683,6,118497
4969,0.001075,74.125.68.0-255,1484,43167,6,118497
4970,0.001076,172.31.36.0-255,66,43233,6,118497
4971,0.00111,74.125.68.0-255,1484,44717,6,118497
4972,0.001112,172.31.36.0-255,66,44783,6,118497
4973,0.001118,74.125.68.0-255,3961,48744,6,118497
4974,0.001119,172.31.36.0-255,66,48810,6,118497
4975,0.001628,74.125.68.0-255,1484,50294,6,118497
4976,0.001636,74.125.68.0-255,2902,53196,6,118497
4977,0.00164,172.31.36.0-255,66,53262,6,118497
4978,0.00168,74.125.68.0-255,5738,59000,6,118497
4979,0.001682,172.31.36.0-255,66,59066,6,118497
4980,0.001685,74.125.68.0-255,1484,60550,6,118497
4981,0.001719,74.125.68.0-255,6797,67347,6,118497
4982,0.001721,172.31.36.0-255,66,67413,6,118497
4983,0.001729,74.125.68.0-255,8574,75987,6,118497
4984,0.001736,172.31.36.0-255,66,76053,6,118497
4985,0.001741,74.125.68.0-255,2902,78955,6,118497
4986,0.001743,172.31.36.0-255,66,79021,6,118497
4987,0.001766,74.125.68.0-255,4285,83306,6,118497
4988,0.001768,172.31.36.0-255,66,83372,6,118497
4989,0.001849,74.125.68.0-255,1484,84856,6,118497
4990,0.001863,74.125.68.0-255,2902,87758,6,118497
4991,0.001865,172.31.36.0-255,66,87824,6,118497
4992,0.001887,74.125.68.0-255,5738,93562,6,118497
4993,0.001889,172.31.36.0-255,66,93628,6,118497
4994,0.001893,74.125.68.0-255,1484,95112,6,118497
4995,0.00191,74.125.68.0-255,2902,98014,6,118497
4996,0.001912,172.31.36.0-255,66,98080,6,118497
4997,0.001937,74.125.68.0-255,2543,100623,6,118497
4998,0.001939,172.31.36.0-255,66,100689,6,118497
4999,0.004181,74.125.68.0-255,2902,103591,6,118497
5000,0.004185,172.31.36.0-255,66,103657,6,118497
5001,0.004219,74.125.68.0-255,2902,106559,6,118497
5002,0.004221,172.31.36.0-255,66,106625,6,118497
5003,0.006464,74.125.68.0-255,2902,109527,6,118497
5004,0.006471,172.31.36.0-255,66,109593,6,118497
5005,0.006499,74.125.68.0-255,2902,112495,6,118497
5006,0.006502,172.31.36.0-255,66,112561,6,118497
5007,0.008754,74.125.68.0-255,2902,115463,6,118497
5008,0.008761,172.31.36.0-255,66,115529,6,118497
5009,0.008786,74.125.68.0-255,2902,118431,6,118497
5010,0.008789,172.31.36.0-255,66,118497,6,118497
5011,0.0,172.217.194.0-255,153,153,6,252930
5012,4.4e-05,172.31.36.0-255,66,219,6,252930
5013,5e-05,172.217.194.0-255,1484,1703,6,252930
5014,5.6e-05,172.31.36.0-255,66,1769,6,252930
5015,6.2e-05,172.217.194.0-255,2902,4671,6,252930
5016,6.5e-05,172.31.36.0-255,66,4737,6,252930
5017,8e-05,172.217.194.0-255,7156,11893,6,252930
5018,8.3e-05,172.31.36.0-255,66,11959,6,252930
5019,8.7e-05,172.217.194.0-255,2099,14058,6,252930
5020,9e-05,172.31.36.0-255,66,14124,6,252930
5021,0.000117,172.217.194.0-255,5738,19862,6,252930
5022,0.00012,172.31.36.0-255,66,19928,6,252930
5023,0.000144,172.217.194.0-255,5738,25666,6,252930
5024,0.000148,172.31.36.0-255,66,25732,6,252930
5025,0.000161,172.31.36.0-255,66,25798,6,252930
5026,0.000215,172.217.194.0-255,9274,35072,6,252930
5027,0.000219,172.31.36.0-255,66,35138,6,252930
5028,0.000254,172.217.194.0-255,1484,36622,6,252930
5029,0.000257,172.31.36.0-255,66,36688,6,252930
5030,0.000262,172.217.194.0-255,2902,39590,6,252930
5031,0.000264,172.31.36.0-255,66,39656,6,252930
5032,0.00029,172.217.194.0-255,5738,45394,6,252930
5033,0.000298,172.31.36.0-255,66,45460,6,252930
5034,0.000353,172.217.194.0-255,7103,52563,6,252930
5035,0.000358,172.31.36.0-255,66,52629,6,252930
5036,0.000411,172.217.194.0-255,1484,54113,6,252930
5037,0.000415,172.31.36.0-255,66,54179,6,252930
5038,0.000421,172.217.194.0-255,2902,57081,6,252930
5039,0.000423,172.31.36.0-255,66,57147,6,252930
5040,0.000456,172.217.194.0-255,5738,62885,6,252930
5041,0.00046,172.31.36.0-255,66,62951,6,252930
5042,0.000463,172.217.194.0-255,1484,64435,6,252930
5043,0.000472,172.217.194.0-255,8574,73009,6,252930
5044,0.00048,172.31.36.0-255,66,73075,6,252930
5045,0.000506,172.217.194.0-255,4320,77395,6,252930
5046,0.000511,172.31.36.0-255,66,77461,6,252930
5047,0.000512,172.217.194.0-255,7156,84617,6,252930
5048,0.000516,172.31.36.0-255,66,84683,6,252930
5049,0.000537,172.217.194.0-255,2184,86867,6,252930
5050,0.000542,172.31.36.0-255,66,86933,6,252930
5051,0.000611,172.217.194.0-255,1484,88417,6,252930
5052,0.000617,172.217.194.0-255,2902,91319,6,252930
5053,0.00062,172.31.36.0-255,66,91385,6,252930
5054,0.000623,172.217.194.0-255,1484,92869,6,252930
5055,0.000647,172.217.194.0-255,2902,95771,6,252930
5056,0.00065,172.31.36.0-255,66,95837,6,252930
5057,0.000672,172.217.194.0-255,1484,97321,6,252930
5058,0.000689,172.31.36.0-255,66,97387,6,252930
5059,0.000695,172.217.194.0-255,4320,101707,6,252930
5060,0.000697,172.31.36.0-255,66,101773,6,252930
5061,0.000727,172.217.194.0-255,6438,108211,6,252930
5062,0.000731,172.31.36.0-255,66,108277,6,252930
5063,0.000919,172.217.194.0-255,1484,109761,6,252930
5064,0.000922,172.217.194.0-255,1484,111245,6,252930
5065,0.000926,172.31.36.0-255,66,111311,6,252930
5066,0.000933,172.217.194.0-255,1484,112795,6,252930
5067,0.000953,172.217.194.0-255,5738,118533,6,252930
5068,0.000956,172.31.36.0-255,66,118599,6,252930
5069,0.000961,172.217.194.0-255,2902,121501,6,252930
5070,0.000963,172.31.36.0-255,66,121567,6,252930
5071,0.000996,172.217.194.0-255,9992,131559,6,252930
5072,0.000999,172.31.36.0-255,66,131625,6,252930
5073,0.001003,172.217.194.0-255,1484,133109,6,252930
5074,0.001041,172.31.36.0-255,66,133175,6,252930
5075,0.001046,172.217.194.0-255,2902,136077,6,252930
5076,0.001048,172.31.36.0-255,66,136143,6,252930
5077,0.001075,172.31.36.0-255,66,136209,6,252930
5078,0.001078,172.217.194.0-255,1484,137693,6,252930
5079,0.001116,172.217.194.0-255,9992,147685,6,252930
5080,0.00112,172.31.36.0-255,66,147751,6,252930
5081,0.00114,172.217.194.0-255,5020,152771,6,252930
5082,0.001143,172.31.36.0-255,66,152837,6,252930
5083,0.001146,172.217.194.0-255,1484,154321,6,252930
5084,0.00115,172.217.194.0-255,1484,155805,6,252930
5085,0.001153,172.31.36.0-255,66,155871,6,252930
5086,0.001179,172.217.194.0-255,1484,157355,6,252930
5087,0.001192,172.217.194.0-255,5738,163093,6,252930
5088,0.001195,172.31.36.0-255,66,163159,6,252930
5089,0.001232,172.217.194.0-255,8574,171733,6,252930
5090,0.001236,172.31.36.0-255,66,171799,6,252930
5091,0.001245,172.217.194.0-255,4320,176119,6,252930
5092,0.001248,172.31.36.0-255,66,176185,6,252930
5093,0.001259,172.217.194.0-255,4320,180505,6,252930
5094,0.001261,172.31.36.0-255,66,180571,6,252930
5095,0.001284,172.217.194.0-255,6438,187009,6,252930
5096,0.001292,172.31.36.0-255,66,187075,6,252930
5097,0.001296,172.217.194.0-255,1484,188559,6,252930
5098,0.001301,172.217.194.0-255,2902,191461,6,252930
5099,0.001303,172.31.36.0-255,66,191527,6,252930
5100,0.001309,172.217.194.0-255,5738,197265,6,252930
5101,0.001311,172.31.36.0-255,66,197331,6,252930
5102,0.001392,172.31.36.0-255,66,197397,6,252930
5103,0.001406,172.31.36.0-255,66,197463,6,252930
5104,0.001408,172.217.194.0-255,5738,203201,6,252930
5105,0.00142,172.31.36.0-255,66,203267,6,252930
5106,0.001459,172.217.194.0-255,7156,210423,6,252930
5107,0.001464,172.31.36.0-255,66,210489,6,252930
5108,0.001478,172.31.36.0-255,66,210555,6,252930
5109,0.001491,172.217.194.0-255,6438,216993,6,252930
5110,0.001494,172.31.36.0-255,66,217059,6,252930
5111,0.001541,172.217.194.0-255,7156,224215,6,252930
5112,0.001551,172.31.36.0-255,66,224281,6,252930
5113,0.001568,172.31.36.0-255,66,224347,6,252930
5114,0.001599,172.217.194.0-255,9992,234339,6,252930
5115,0.001605,172.31.36.0-255,66,234405,6,252930
5116,0.001622,172.217.194.0-255,5020,239425,6,252930
5117,0.00163,172.31.36.0-255,66,239491,6,252930
5118,0.001644,172.31.36.0-255,66,239557,6,252930
5119,0.001651,172.217.194.0-255,8574,248131,6,252930
5120,0.001654,172.31.36.0-255,66,248197,6,252930
5121,0.001715,172.31.36.0-255,66,248263,6,252930
5122,0.00173,172.31.36.0-255,66,248329,6,252930
5123,0.001759,172.217.194.0-255,4193,252522,6,252930
5124,0.001763,172.31.36.0-255,66,252588,6,252930
5125,0.001771,172.217.194.0-255,105,252693,6,252930
5126,0.003585,172.31.36.0-255,66,252759,6,252930
5127,0.003611,172.31.36.0-255,105,252864,6,252930
5128,0.005569,172.217.194.0-255,66,252930,6,252930
5129,0.0,216.58.221.0-255,153,153,6,162762
5130,3.1e-05,172.31.36.0-255,66,219,6,162762
5131,3.7e-05,216.58.221.0-255,1484,1703,6,162762
5132,4.1e-05,172.31.36.0-255,66,1769,6,162762
5133,4.8e-05,216.58.221.0-255,2902,4671,6,162762
5134,5.6e-05,172.31.36.0-255,66,4737,6,162762
5135,6.1e-05,216.58.221.0-255,2902,7639,6,162762
5136,6.4e-05,172.31.36.0-255,66,7705,6,162762
5137,9.8e-05,216.58.221.0-255,4320,12025,6,162762
5138,0.000101,172.31.36.0-255,66,12091,6,162762
5139,0.000105,216.58.221.0-255,2105,14196,6,162762
5140,0.000107,172.31.36.0-255,66,14262,6,162762
5141,0.000126,172.31.36.0-255,66,14328,6,162762
5142,0.000132,216.58.221.0-255,5379,19707,6,162762
5143,0.000135,172.31.36.0-255,66,19773,6,162762
5144,0.000164,216.58.221.0-255,1484,21257,6,162762
5145,0.000167,172.31.36.0-255,66,21323,6,162762
5146,0.000194,216.58.221.0-255,2902,24225,6,162762
5147,0.000197,172.31.36.0-255,66,24291,6,162762
5148,0.000204,216.58.221.0-255,5738,30029,6,162762
5149,0.000206,172.31.36.0-255,66,30095,6,162762
5150,0.000237,216.58.221.0-255,6797,36892,6,162762
5151,0.00024,172.31.36.0-255,66,36958,6,162762
5152,0.000548,216.58.221.0-255,1484,38442,6,162762
5153,0.000553,172.31.36.0-255,66,38508,6,162762
5154,0.000558,216.58.221.0-255,2902,41410,6,162762
5155,0.00056,172.31.36.0-255,66,41476,6,162762
5156,0.000574,216.58.221.0-255,5738,47214,6,162762
5157,0.000577,172.31.36.0-255,66,47280,6,162762
5158,0.000584,216.58.221.0-255,5738,53018,6,162762
5159,0.000586,172.31.36.0-255,66,53084,6,162762
5160,0.000616,216.58.221.0-255,1125,54209,6,162762
5161,0.000619,216.58.221.0-255,355,54564,6,162762
5162,0.00078,172.31.36.0-255,66,54630,6,162762
5163,0.000889,216.58.221.0-255,387,55017,6,162762
5164,0.001046,216.58.221.0-255,1484,56501,6,162762
5165,0.001051,172.31.36.0-255,66,56567,6,162762
5166,0.001057,216.58.221.0-255,2902,59469,6,162762
5167,0.001059,172.31.36.0-255,66,59535,6,162762
5168,0.001072,216.58.221.0-255,5738,65273,6,162762
5169,0.001074,172.31.36.0-255,66,65339,6,162762
5170,0.001081,216.58.221.0-255,4320,69659,6,162762
5171,0.001083,172.31.36.0-255,66,69725,6,162762
5172,0.001108,216.58.221.0-255,2543,72268,6,162762
5173,0.001115,172.31.36.0-255,66,72334,6,162762
5174,0.00112,216.58.221.0-255,2902,75236,6,162762
5175,0.001122,172.31.36.0-255,66,75302,6,162762
5176,0.001157,216.58.221.0-255,4320,79622,6,162762
5177,0.00116,172.31.36.0-255,66,79688,6,162762
5178,0.001165,216.58.221.0-255,4320,84008,6,162762
5179,0.001167,172.31.36.0-255,66,84074,6,162762
5180,0.0012,216.58.221.0-255,4831,88905,6,162762
5181,0.001203,172.31.36.0-255,66,88971,6,162762
5182,0.001334,216.58.221.0-255,1484,90455,6,162762
5183,0.001354,216.58.221.0-255,2902,93357,6,162762
5184,0.001357,172.31.36.0-255,66,93423,6,162762
5185,0.001395,216.58.221.0-255,2902,96325,6,162762
5186,0.001398,172.31.36.0-255,66,96391,6,162762
5187,0.001428,216.58.221.0-255,2902,99293,6,162762
5188,0.001431,172.31.36.0-255,66,99359,6,162762
5189,0.001438,216.58.221.0-255,6783,106142,6,162762
5190,0.001441,172.31.36.0-255,66,106208,6,162762
5191,0.001901,216.58.221.0-255,1484,107692,6,162762
5192,0.001911,216.58.221.0-255,2902,110594,6,162762
5193,0.001915,172.31.36.0-255,66,110660,6,162762
5194,0.001919,216.58.221.0-255,1484,112144,6,162762
5195,0.001944,216.58.221.0-255,4320,116464,6,162762
5196,0.001946,172.31.36.0-255,66,116530,6,162762
5197,0.001951,216.58.221.0-255,2902,119432,6,162762
5198,0.001953,172.31.36.0-255,66,119498,6,162762
5199,0.001989,216.58.221.0-255,9992,129490,6,162762
5200,0.001991,172.31.36.0-255,66,129556,6,162762
5201,0.001998,216.58.221.0-255,7156,136712,6,162762
5202,0.002,172.31.36.0-255,66,136778,6,162762
5203,0.002008,216.58.221.0-255,2570,139348,6,162762
5204,0.002011,172.31.36.0-255,66,139414,6,162762
5205,0.003934,216.58.221.0-255,2902,142316,6,162762
5206,0.003937,172.31.36.0-255,66,142382,6,162762
5207,0.003941,216.58.221.0-255,2902,145284,6,162762
5208,0.003943,172.31.36.0-255,66,145350,6,162762
5209,0.005872,216.58.221.0-255,5738,151088,6,162762
5210,0.005874,172.31.36.0-255,66,151154,6,162762
5211,0.007813,216.58.221.0-255,5738,156892,6,162762
5212,0.00782,172.31.36.0-255,66,156958,6,162762
5213,0.009771,216.58.221.0-255,5738,162696,6,162762
5214,0.009777,172.31.36.0-255,66,162762,6,162762
5215,0.0,74.125.200.0-255,150,150,6,266869
5216,2.4e-05,172.31.36.0-255,66,216,6,266869
5217,5.1e-05,74.125.200.0-255,1484,1700,6,266869
5218,5.6e-05,172.31.36.0-255,66,1766,6,266869
5219,9.6e-05,74.125.200.0-255,2902,4668,6,266869
5220,0.0001,172.31.36.0-255,66,4734,6,266869
5221,0.000104,74.125.200.0-255,2902,7636,6,266869
5222,0.000107,172.31.36.0-255,66,7702,6,266869
5223,0.000128,74.125.200.0-255,1484,9186,6,266869
5224,0.000131,172.31.36.0-255,66,9252,6,266869
5225,0.000134,74.125.200.0-255,1484,10736,6,266869
5226,0.000136,172.31.36.0-255,66,10802,6,266869
5227,0.000161,74.125.200.0-255,7747,18549,6,266869
5228,0.000164,172.31.36.0-255,66,18615,6,266869
5229,0.000176,74.125.200.0-255,9992,28607,6,266869
5230,0.000179,172.31.36.0-255,66,28673,6,266869
5231,0.000204,74.125.200.0-255,2543,31216,6,266869
5232,0.000207,172.31.36.0-255,66,31282,6,266869
5233,0.00026,74.125.200.0-255,1484,32766,6,266869
5234,0.000266,172.31.36.0-255,66,32832,6,266869
5235,0.000293,74.125.200.0-255,2902,35734,6,266869
5236,0.000297,172.31.36.0-255,66,35800,6,266869
5237,0.000305,74.125.200.0-255,5738,41538,6,266869
5238,0.000308,172.31.36.0-255,66,41604,6,266869
5239,0.000338,74.125.200.0-255,6797,48401,6,266869
5240,0.000341,172.31.36.0-255,66,48467,6,266869
5241,0.000425,74.125.200.0-255,1484,49951,6,266869
5242,0.000428,172.31.36.0-255,66,50017,6,266869
5243,0.000457,74.125.200.0-255,2902,52919,6,266869
5244,0.00046,172.31.36.0-255,66,52985,6,266869
5245,0.000466,74.125.200.0-255,4320,57305,6,266869
5246,0.000468,172.31.36.0-255,66,57371,6,266869
5247,0.000506,74.125.200.0-255,8545,65916,6,266869
5248,0.00051,172.31.36.0-255,66,65982,6,266869
5249,0.000514,74.125.200.0-255,347,66329,6,266869
5250,0.000695,74.125.200.0-255,1484,67813,6,266869
5251,0.000701,74.125.200.0-255,2902,70715,6,266869
5252,0.000701,172.31.36.0-255,66,70781,6,266869
5253,0.000705,172.31.36.0-255,66,70847,6,266869
5254,0.000736,74.125.200.0-255,5738,76585,6,266869
5255,0.000739,172.31.36.0-255,66,76651,6,266869
5256,0.000744,74.125.200.0-255,2902,79553,6,266869
5257,0.000749,172.31.36.0-255,66,79619,6,266869
5258,0.000778,74.125.200.0-255,2902,82521,6,266869
5259,0.000782,172.31.36.0-255,66,82587,6,266869
5260,0.00079,74.125.200.0-255,6797,89384,6,266869
5261,0.000794,74.125.200.0-255,1484,90868,6,266869
5262,0.000797,172.31.36.0-255,66,90934,6,266869
5263,0.000833,74.125.200.0-255,9633,100567,6,266869
5264,0.000837,172.31.36.0-255,66,100633,6,266869
5265,0.000928,74.125.200.0-255,1484,102117,6,266869
5266,0.000943,74.125.200.0-255,2902,105019,6,266869
5267,0.000948,172.31.36.0-255,66,105085,6,266869
5268,0.000972,74.125.200.0-255,4320,109405,6,266869
5269,0.000975,172.31.36.0-255,66,109471,6,266869
5270,0.001011,74.125.200.0-255,8574,118045,6,266869
5271,0.001016,172.31.36.0-255,66,118111,6,266869
5272,0.001017,74.125.200.0-255,7156,125267,6,266869
5273,0.00102,172.31.36.0-255,66,125333,6,266869
5274,0.001056,74.125.200.0-255,4320,129653,6,266869
5275,0.001059,172.31.36.0-255,66,129719,6,266869
5276,0.001089,74.125.200.0-255,4320,134039,6,266869
5277,0.001094,172.31.36.0-255,66,134105,6,266869
5278,0.001097,74.125.200.0-255,766,134871,6,266869
5279,0.00117,74.125.200.0-255,1484,136355,6,266869
5280,0.001174,172.31.36.0-255,66,136421,6,266869
5281,0.001179,74.125.200.0-255,2902,139323,6,266869
5282,0.001181,172.31.36.0-255,66,139389,6,266869
5283,0.001213,74.125.200.0-255,5738,145127,6,266869
5284,0.001216,172.31.36.0-255,66,145193,6,266869
5285,0.001252,74.125.200.0-255,5738,150931,6,266869
5286,0.001256,172.31.36.0-255,66,150997,6,266869
5287,0.00126,74.125.200.0-255,1484,152481,6,266869
5288,0.001288,74.125.200.0-255,5738,158219,6,266869
5289,0.001291,172.31.36.0-255,66,158285,6,266869
5290,0.001325,74.125.200.0-255,10692,168977,6,266869
5291,0.001329,172.31.36.0-255,66,169043,6,266869
5292,0.001352,74.125.200.0-255,1484,170527,6,266869
5293,0.001358,74.125.200.0-255,2902,173429,6,266869
5294,0.00136,172.31.36.0-255,66,173495,6,266869
5295,0.001389,74.125.200.0-255,5738,179233,6,266869
5296,0.001392,172.31.36.0-255,66,179299,6,266869
5297,0.001396,74.125.200.0-255,1484,180783,6,266869
5298,0.001428,74.125.200.0-255,8574,189357,6,266869
5299,0.001432,172.31.36.0-255,66,189423,6,266869
5300,0.001454,74.125.200.0-255,1484,190907,6,266869
5301,0.001476,74.125.200.0-255,7156,198063,6,266869
5302,0.001479,172.31.36.0-255,66,198129,6,266869
5303,0.00151,74.125.200.0-255,5020,203149,6,266869
5304,0.001515,172.31.36.0-255,66,203215,6,266869
5305,0.00175,74.125.200.0-255,1484,204699,6,266869
5306,0.001765,74.125.200.0-255,2902,207601,6,266869
5307,0.00177,172.31.36.0-255,66,207667,6,266869
5308,0.001776,74.125.200.0-255,4320,211987,6,266869
5309,0.001779,172.31.36.0-255,66,212053,6,266869
5310,0.001807,74.125.200.0-255,1484,213537,6,266869
5311,0.001821,74.125.200.0-255,1484,215021,6,266869
5312,0.001823,172.31.36.0-255,66,215087,6,266869
5313,0.001872,74.125.200.0-255,5738,220825,6,266869
5314,0.001875,172.31.36.0-255,66,220891,6,266869
5315,0.001894,74.125.200.0-255,3602,224493,6,266869
5316,0.001897,172.31.36.0-255,66,224559,6,266869
5317,0.001978,74.125.200.0-255,1484,226043,6,266869
5318,0.001999,74.125.200.0-255,2902,228945,6,266869
5319,0.002003,172.31.36.0-255,66,229011,6,266869
5320,0.002033,74.125.200.0-255,5738,234749,6,266869
5321,0.002036,172.31.36.0-255,66,234815,6,266869
5322,0.00204,74.125.200.0-255,2902,237717,6,266869
5323,0.002042,172.31.36.0-255,66,237783,6,266869
5324,0.002054,74.125.200.0-255,4320,242103,6,266869
5325,0.002057,172.31.36.0-255,66,242169,6,266869
5326,0.002064,74.125.200.0-255,8574,250743,6,266869
5327,0.002067,172.31.36.0-255,66,250809,6,266869
5328,0.004087,74.125.200.0-255,5738,256547,6,266869
5329,0.004094,172.31.36.0-255,66,256613,6,266869
5330,0.006107,74.125.200.0-255,4320,260933,6,266869
5331,0.00611,172.31.36.0-255,66,260999,6,266869
5332,0.006126,74.125.200.0-255,1484,262483,6,266869
5333,0.008125,74.125.200.0-255,4320,266803,6,266869
5334,0.00813,172.31.36.0-255,66,266869,6,266869
5335,0.0,74.125.24.0-255,153,153,6,223346
5336,2.2e-05,172.31.36.0-255,66,219,6,223346
5337,2.9e-05,74.125.24.0-255,1484,1703,6,223346
5338,3.3e-05,172.31.36.0-255,66,1769,6,223346
5339,3.9e-05,74.125.24.0-255,2902,4671,6,223346
5340,4.2e-05,172.31.36.0-255,66,4737,6,223346
5341,4.9e-05,74.125.24.0-255,4320,9057,6,223346
5342,5.1e-05,172.31.36.0-255,66,9123,6,223346
5343,9e-05,74.125.24.0-255,4885,14008,6,223346
5344,9.4e-05,172.31.36.0-255,66,14074,6,223346
5345,0.000101,74.125.24.0-255,5738,19812,6,223346
5346,0.000103,172.31.36.0-255,66,19878,6,223346
5347,0.000137,172.31.36.0-255,66,19944,6,223346
5348,0.000311,74.125.24.0-255,1484,21428,6,223346
5349,0.000316,172.31.36.0-255,66,21494,6,223346
5350,0.000322,74.125.24.0-255,2902,24396,6,223346
5351,0.000325,172.31.36.0-255,66,24462,6,223346
5352,0.000331,74.125.24.0-255,4320,28782,6,223346
5353,0.000333,172.31.36.0-255,66,28848,6,223346
5354,0.000349,74.125.24.0-255,1484,30332,6,223346
5355,0.000352,172.31.36.0-255,66,30398,6,223346
5356,0.000367,74.125.24.0-255,1484,31882,6,223346
5357,0.000369,172.31.36.0-255,66,31948,6,223346
5358,0.000389,74.125.24.0-255,5379,37327,6,223346
5359,0.000392,172.31.36.0-255,66,37393,6,223346
5360,0.000408,74.125.24.0-255,5738,43131,6,223346
5361,0.000411,172.31.36.0-255,66,43197,6,223346
5362,0.000434,74.125.24.0-255,1484,44681,6,223346
5363,0.000437,172.31.36.0-255,66,44747,6,223346
5364,0.000446,74.125.24.0-255,8574,53321,6,223346
5365,0.000449,172.31.36.0-255,66,53387,6,223346
5366,0.000452,74.125.24.0-255,1125,54512,6,223346
5367,0.00096,172.31.36.0-255,66,54578,6,223346
5368,0.001186,74.125.24.0-255,646,55224,6,223346
5369,0.001212,74.125.24.0-255,1484,56708,6,223346
5370,0.001219,74.125.24.0-255,2902,59610,6,223346
5371,0.001233,74.125.24.0-255,1484,61094,6,223346
5372,0.00124,74.125.24.0-255,5738,66832,6,223346
5373,0.001262,74.125.24.0-255,7156,73988,6,223346
5374,0.001268,74.125.24.0-255,4320,78308,6,223346
5375,0.001292,74.125.24.0-255,7156,85464,6,223346
5376,0.001308,74.125.24.0-255,2902,88366,6,223346
5377,0.00131,74.125.24.0-255,766,89132,6,223346
5378,0.001689,74.125.24.0-255,1484,90616,6,223346
5379,0.001695,74.125.24.0-255,2902,93518,6,223346
5380,0.001699,74.125.24.0-255,2902,96420,6,223346
5381,0.001711,74.125.24.0-255,2902,99322,6,223346
5382,0.001755,74.125.24.0-255,1484,100806,6,223346
5383,0.001776,74.125.24.0-255,9274,110080,6,223346
5384,0.001864,74.125.24.0-255,1484,111564,6,223346
5385,0.001876,74.125.24.0-255,2902,114466,6,223346
5386,0.001888,74.125.24.0-255,2902,117368,6,223346
5387,0.001906,74.125.24.0-255,4320,121688,6,223346
5388,0.00192,74.125.24.0-255,2902,124590,6,223346
5389,0.001944,74.125.24.0-255,4320,128910,6,223346
5390,0.001968,74.125.24.0-255,7156,136066,6,223346
5391,0.001985,74.125.24.0-255,2902,138968,6,223346
5392,0.002032,74.125.24.0-255,5020,143988,6,223346
5393,0.002037,74.125.24.0-255,5738,149726,6,223346
5394,0.002044,74.125.24.0-255,8574,158300,6,223346
5395,0.002063,74.125.24.0-255,4320,162620,6,223346
5396,0.00207,74.125.24.0-255,8574,171194,6,223346
5397,0.002083,74.125.24.0-255,1484,172678,6,223346
5398,0.002096,74.125.24.0-255,5020,177698,6,223346
5399,0.002138,74.125.24.0-255,2902,180600,6,223346
5400,0.00215,74.125.24.0-255,1484,182084,6,223346
5401,0.002156,74.125.24.0-255,5738,187822,6,223346
5402,0.002195,74.125.24.0-255,7156,194978,6,223346
5403,0.002241,74.125.24.0-255,5020,199998,6,223346
5404,0.002326,74.125.24.0-255,1484,201482,6,223346
5405,0.00234,74.125.24.0-255,2902,204384,6,223346
5406,0.002353,74.125.24.0-255,1484,205868,6,223346
5407,0.002603,172.31.36.0-255,66,205934,6,223346
5408,0.004983,74.125.24.0-255,5738,211672,6,223346
5409,0.004988,172.31.36.0-255,66,211738,6,223346
5410,0.00733,74.125.24.0-255,5738,217476,6,223346
5411,0.007335,172.31.36.0-255,66,217542,6,223346
5412,0.0097,74.125.24.0-255,5738,223280,6,223346
5413,0.009708,172.31.36.0-255,66,223346,6,223346
5414,0.0,74.125.24.0-255,152,152,6,178533
5415,3.5e-05,172.31.36.0-255,66,218,6,178533
5416,4.2e-05,74.125.24.0-255,1484,1702,6,178533
5417,4.6e-05,172.31.36.0-255,66,1768,6,178533
5418,5.1e-05,74.125.24.0-255,2902,4670,6,178533
5419,5.4e-05,172.31.36.0-255,66,4736,6,178533
5420,6.2e-05,74.125.24.0-255,7156,11892,6,178533
5421,6.5e-05,172.31.36.0-255,66,11958,6,178533
5422,9.8e-05,172.31.36.0-255,66,12024,6,178533
5423,0.000101,74.125.24.0-255,1484,13508,6,178533
5424,0.000103,172.31.36.0-255,66,13574,6,178533
5425,0.000143,172.31.36.0-255,66,13640,6,178533
5426,0.000153,74.125.24.0-255,10692,24332,6,178533
5427,0.000155,172.31.36.0-255,66,24398,6,178533
5428,0.000197,74.125.24.0-255,9992,34390,6,178533
5429,0.000201,172.31.36.0-255,66,34456,6,178533
5430,0.000225,74.125.24.0-255,5738,40194,6,178533
5431,0.000227,172.31.36.0-255,66,40260,6,178533
5432,0.000231,74.125.24.0-255,1398,41658,6,178533
5433,0.000234,172.31.36.0-255,66,41724,6,178533
5434,0.000261,74.125.24.0-255,132,41856,6,178533
5435,0.000265,172.31.36.0-255,66,41922,6,178533
5436,0.000391,74.125.24.0-255,1484,43406,6,178533
5437,0.000396,172.31.36.0-255,66,43472,6,178533
5438,0.000402,74.125.24.0-255,2902,46374,6,178533
5439,0.000405,172.31.36.0-255,66,46440,6,178533
5440,0.00041,74.125.24.0-255,2902,49342,6,178533
5441,0.000412,172.31.36.0-255,66,49408,6,178533
5442,0.000436,74.125.24.0-255,2902,52310,6,178533
5443,0.000439,172.31.36.0-255,66,52376,6,178533
5444,0.000446,74.125.24.0-255,5738,58114,6,178533
5445,0.000449,172.31.36.0-255,66,58180,6,178533
5446,0.000456,74.125.24.0-255,6797,64977,6,178533
5447,0.000459,172.31.36.0-255,66,65043,6,178533
5448,0.000509,172.31.36.0-255,66,65109,6,178533
5449,0.000781,74.125.24.0-255,1484,66593,6,178533
5450,0.000786,74.125.24.0-255,2902,69495,6,178533
5451,0.000791,172.31.36.0-255,66,69561,6,178533
5452,0.000809,74.125.24.0-255,4320,73881,6,178533
5453,0.000813,172.31.36.0-255,66,73947,6,178533
5454,0.000827,74.125.24.0-255,1484,75431,6,178533
5455,0.000837,74.125.24.0-255,9992,85423,6,178533
5456,0.000839,172.31.36.0-255,66,85489,6,178533
5457,0.000883,74.125.24.0-255,1484,86973,6,178533
5458,0.000911,172.31.36.0-255,66,87039,6,178533
5459,0.001118,74.125.24.0-255,1484,88523,6,178533
5460,0.001124,74.125.24.0-255,2902,91425,6,178533
5461,0.001127,172.31.36.0-255,66,91491,6,178533
5462,0.001153,74.125.24.0-255,5738,97229,6,178533
5463,0.001158,74.125.24.0-255,4320,101549,6,178533
5464,0.001158,172.31.36.0-255,66,101615,6,178533
5465,0.001161,172.31.36.0-255,66,101681,6,178533
5466,0.001184,74.125.24.0-255,8574,110255,6,178533
5467,0.001187,172.31.36.0-255,66,110321,6,178533
5468,0.001227,74.125.24.0-255,2902,113223,6,178533
5469,0.00123,172.31.36.0-255,66,113289,6,178533
5470,0.001253,74.125.24.0-255,7856,121145,6,178533
5471,0.001256,172.31.36.0-255,66,121211,6,178533
5472,0.001852,74.125.24.0-255,1484,122695,6,178533
5473,0.001861,74.125.24.0-255,2902,125597,6,178533
5474,0.001866,172.31.36.0-255,66,125663,6,178533
5475,0.001873,74.125.24.0-255,5738,131401,6,178533
5476,0.001875,172.31.36.0-255,66,131467,6,178533
5477,0.001893,74.125.24.0-255,7156,138623,6,178533
5478,0.001896,172.31.36.0-255,66,138689,6,178533
5479,0.001929,74.125.24.0-255,5738,144427,6,178533
5480,0.001932,172.31.36.0-255,66,144493,6,178533
5481,0.001941,74.125.24.0-255,10692,155185,6,178533
5482,0.001943,172.31.36.0-255,66,155251,6,178533
5483,0.003873,74.125.24.0-255,5738,160989,6,178533
5484,0.00388,172.31.36.0-255,66,161055,6,178533
5485,0.005781,74.125.24.0-255,1484,162539,6,178533
5486,0.005799,74.125.24.0-255,4320,166859,6,178533
5487,0.005801,172.31.36.0-255,66,166925,6,178533
5488,0.007731,74.125.24.0-255,5738,172663,6,178533
5489,0.007738,172.31.36.0-255,66,172729,6,178533
5490,0.009675,74.125.24.0-255,5738,178467,6,178533
5491,0.009687,172.31.36.0-255,66,178533,6,178533
5492,0.0,74.125.68.0-255,152,152,6,168559
5493,2.6e-05,172.31.36.0-255,66,218,6,168559
5494,3.3e-05,74.125.68.0-255,1484,1702,6,168559
5495,3.8e-05,172.31.36.0-255,66,1768,6,168559
5496,5e-05,74.125.68.0-255,2902,4670,6,168559
5497,5.2e-05,172.31.36.0-255,66,4736,6,168559
5498,9.8e-05,74.125.68.0-255,7156,11892,6,168559
5499,0.000109,172.31.36.0-255,66,11958,6,168559
5500,0.000153,74.125.68.0-255,2014,13972,6,168559
5501,0.000157,172.31.36.0-255,66,14038,6,168559
5502,0.000186,74.125.68.0-255,2902,16940,6,168559
5503,0.00019,172.31.36.0-255,66,17006,6,168559
5504,0.000223,74.125.68.0-255,7156,24162,6,168559
5505,0.000226,172.31.36.0-255,66,24228,6,168559
5506,0.000305,74.125.68.0-255,6797,31025,6,168559
5507,0.00031,172.31.36.0-255,66,31091,6,168559
5508,0.000391,74.125.68.0-255,7156,38247,6,168559
5509,0.000396,172.31.36.0-255,66,38313,6,168559
5510,0.000472,74.125.68.0-255,2902,41215,6,168559
5511,0.000476,172.31.36.0-255,66,41281,6,168559
5512,0.000503,74.125.68.0-255,4320,45601,6,168559
5513,0.000506,172.31.36.0-255,66,45667,6,168559
5514,0.000558,74.125.68.0-255,4320,49987,6,168559
5515,0.000561,172.31.36.0-255,66,50053,6,168559
5516,0.000596,172.31.36.0-255,66,50119,6,168559
5517,0.000767,74.125.68.0-255,2888,53007,6,168559
5518,0.000771,172.31.36.0-255,66,53073,6,168559
5519,0.000775,74.125.68.0-255,332,53405,6,168559
5520,0.000777,172.31.36.0-255,66,53471,6,168559
5521,0.0008,74.125.68.0-255,5738,59209,6,168559
5522,0.000806,172.31.36.0-255,66,59275,6,168559
5523,0.000878,74.125.68.0-255,1484,60759,6,168559
5524,0.000897,74.125.68.0-255,9992,70751,6,168559
5525,0.000905,172.31.36.0-255,66,70817,6,168559
5526,0.001016,74.125.68.0-255,5738,76555,6,168559
5527,0.00102,172.31.36.0-255,66,76621,6,168559
5528,0.001097,74.125.68.0-255,10692,87313,6,168559
5529,0.001118,172.31.36.0-255,66,87379,6,168559
5530,0.001224,74.125.68.0-255,7156,94535,6,168559
5531,0.001249,74.125.68.0-255,4320,98855,6,168559
5532,0.001257,172.31.36.0-255,66,98921,6,168559
5533,0.001423,172.31.36.0-255,66,98987,6,168559
5534,0.001612,74.125.68.0-255,766,99753,6,168559
5535,0.001697,172.31.36.0-255,66,99819,6,168559
5536,0.001764,74.125.68.0-255,1484,101303,6,168559
5537,0.001785,74.125.68.0-255,2902,104205,6,168559
5538,0.001798,74.125.68.0-255,1484,105689,6,168559
5539,0.001804,172.31.36.0-255,66,105755,6,168559
5540,0.001822,74.125.68.0-255,2902,108657,6,168559
5541,0.001847,74.125.68.0-255,1484,110141,6,168559
5542,0.001859,74.125.68.0-255,2902,113043,6,168559
5543,0.001864,172.31.36.0-255,66,113109,6,168559
5544,0.001887,74.125.68.0-255,1484,114593,6,168559
5545,0.001935,74.125.68.0-255,9992,124585,6,168559
5546,0.001959,172.31.36.0-255,66,124651,6,168559
5547,0.002049,74.125.68.0-255,2902,127553,6,168559
5548,0.00206,172.31.36.0-255,66,127619,6,168559
5549,0.002068,74.125.68.0-255,6438,134057,6,168559
5550,0.002078,172.31.36.0-255,66,134123,6,168559
5551,0.002166,74.125.68.0-255,7156,141279,6,168559
5552,0.00217,172.31.36.0-255,66,141345,6,168559
5553,0.002197,74.125.68.0-255,2902,144247,6,168559
5554,0.00221,172.31.36.0-255,66,144313,6,168559
5555,0.002291,74.125.68.0-255,4320,148633,6,168559
5556,0.0023,172.31.36.0-255,66,148699,6,168559
5557,0.00233,172.31.36.0-255,66,148765,6,168559
5558,0.002549,74.125.68.0-255,2184,150949,6,168559
5559,0.002553,172.31.36.0-255,66,151015,6,168559
5560,0.002606,172.31.36.0-255,66,151081,6,168559
5561,0.002648,172.31.36.0-255,66,151147,6,168559
5562,0.004897,74.125.68.0-255,5738,156885,6,168559
5563,0.004902,172.31.36.0-255,66,156951,6,168559
5564,0.007164,74.125.68.0-255,5738,162689,6,168559
5565,0.007171,172.31.36.0-255,66,162755,6,168559
5566,0.009424,74.125.68.0-255,5738,168493,6,168559
5567,0.009431,172.31.36.0-255,66,168559,6,168559
5568,0.0,172.217.160.0-255,152,152,6,161255
5569,2.9e-05,172.31.36.0-255,66,218,6,161255
5570,3.7e-05,172.217.160.0-255,1484,1702,6,161255
5571,4.1e-05,172.31.36.0-255,66,1768,6,161255
5572,4.5e-05,172.217.160.0-255,2902,4670,6,161255
5573,4.8e-05,172.31.36.0-255,66,4736,6,161255
5574,5.5e-05,172.217.160.0-255,5738,10474,6,161255
5575,5.8e-05,172.31.36.0-255,66,10540,6,161255
5576,8.7e-05,172.31.36.0-255,66,10606,6,161255
5577,9.4e-05,172.217.160.0-255,6797,17403,6,161255
5578,9.7e-05,172.31.36.0-255,66,17469,6,161255
5579,0.000128,172.217.160.0-255,4320,21789,6,161255
5580,0.000131,172.31.36.0-255,66,21855,6,161255
5581,0.000153,172.217.160.0-255,4320,26175,6,161255
5582,0.000156,172.31.36.0-255,66,26241,6,161255
5583,0.000195,172.217.160.0-255,8215,34456,6,161255
5584,0.000198,172.31.36.0-255,66,34522,6,161255
5585,0.000452,172.217.160.0-255,1484,36006,6,161255
5586,0.000457,172.31.36.0-255,66,36072,6,161255
5587,0.000462,172.217.160.0-255,2902,38974,6,161255
5588,0.000466,172.217.160.0-255,2902,41876,6,161255
5589,0.000469,172.31.36.0-255,66,41942,6,161255
5590,0.000473,172.31.36.0-255,66,42008,6,161255
5591,0.000482,172.217.160.0-255,2902,44910,6,161255
5592,0.000485,172.31.36.0-255,66,44976,6,161255
5593,0.000493,172.217.160.0-255,6797,51773,6,161255
5594,0.000495,172.31.36.0-255,66,51839,6,161255
5595,0.000518,172.217.160.0-255,336,52175,6,161255
5596,0.000522,172.31.36.0-255,66,52241,6,161255
5597,0.001256,172.217.160.0-255,1484,53725,6,161255
5598,0.001263,172.31.36.0-255,66,53791,6,161255
5599,0.001272,172.217.160.0-255,2902,56693,6,161255
5600,0.001274,172.31.36.0-255,66,56759,6,161255
5601,0.001278,172.217.160.0-255,1484,58243,6,161255
5602,0.001296,172.217.160.0-255,4320,62563,6,161255
5603,0.001299,172.31.36.0-255,66,62629,6,161255
5604,0.001304,172.217.160.0-255,4320,66949,6,161255
5605,0.001306,172.31.36.0-255,66,67015,6,161255
5606,0.00133,172.217.160.0-255,8574,75589,6,161255
5607,0.001333,172.31.36.0-255,66,75655,6,161255
5608,0.00136,172.217.160.0-255,3961,79616,6,161255
5609,0.001363,172.31.36.0-255,66,79682,6,161255
5610,0.001369,172.217.160.0-255,5738,85420,6,161255
5611,0.001371,172.31.36.0-255,66,85486,6,161255
5612,0.001374,172.217.160.0-255,886,86372,6,161255
5613,0.001422,172.217.160.0-255,1484,87856,6,161255
5614,0.001425,172.31.36.0-255,66,87922,6,161255
5615,0.001441,172.217.160.0-255,1484,89406,6,161255
5616,0.001456,172.217.160.0-255,1484,90890,6,161255
5617,0.001458,172.31.36.0-255,66,90956,6,161255
5618,0.001464,172.217.160.0-255,4320,95276,6,161255
5619,0.001466,172.31.36.0-255,66,95342,6,161255
5620,0.001483,172.217.160.0-255,1484,96826,6,161255
5621,0.001506,172.217.160.0-255,6683,103509,6,161255
5622,0.001508,172.31.36.0-255,66,103575,6,161255
5623,0.001737,172.217.160.0-255,1484,105059,6,161255
5624,0.001747,172.217.160.0-255,1484,106543,6,161255
5625,0.001749,172.31.36.0-255,66,106609,6,161255
5626,0.00176,172.217.160.0-255,1484,108093,6,161255
5627,0.001766,172.217.160.0-255,5738,113831,6,161255
5628,0.001768,172.31.36.0-255,66,113897,6,161255
5629,0.001799,172.217.160.0-255,4320,118217,6,161255
5630,0.001802,172.31.36.0-255,66,118283,6,161255
5631,0.001817,172.217.160.0-255,2666,120949,6,161255
5632,0.001819,172.31.36.0-255,66,121015,6,161255
5633,0.001856,172.217.160.0-255,2902,123917,6,161255
5634,0.001859,172.31.36.0-255,66,123983,6,161255
5635,0.001878,172.217.160.0-255,4320,128303,6,161255
5636,0.001881,172.31.36.0-255,66,128369,6,161255
5637,0.001886,172.217.160.0-255,4320,132689,6,161255
5638,0.001888,172.31.36.0-255,66,132755,6,161255
5639,0.001906,172.217.160.0-255,4320,137075,6,161255
5640,0.001908,172.31.36.0-255,66,137141,6,161255
5641,0.001911,172.217.160.0-255,1484,138625,6,161255
5642,0.001949,172.31.36.0-255,66,138691,6,161255
5643,0.001952,172.217.160.0-255,766,139457,6,161255
5644,0.003847,172.217.160.0-255,4320,143777,6,161255
5645,0.00385,172.31.36.0-255,66,143843,6,161255
5646,0.005739,172.217.160.0-255,5738,149581,6,161255
5647,0.005745,172.31.36.0-255,66,149647,6,161255
5648,0.007632,172.217.160.0-255,5738,155385,6,161255
5649,0.007636,172.31.36.0-255,66,155451,6,161255
5650,0.009516,172.217.160.0-255,5738,161189,6,161255
5651,0.009522,172.31.36.0-255,66,161255,6,161255
5652,0.0,172.217.194.0-255,296,296,6,316480
5653,2.4e-05,172.31.36.0-255,66,362,6,316480
5654,3e-05,172.217.194.0-255,1484,1846,6,316480
5655,3.5e-05,172.31.36.0-255,66,1912,6,316480
5656,4.1e-05,172.217.194.0-255,4320,6232,6,316480
5657,4.5e-05,172.31.36.0-255,66,6298,6,316480
5658,5.4e-05,172.217.194.0-255,8984,15282,6,316480
5659,5.7e-05,172.31.36.0-255,66,15348,6,316480
5660,6.4e-05,172.217.194.0-255,7156,22504,6,316480
5661,6.8e-05,172.31.36.0-255,66,22570,6,316480
5662,9.5e-05,172.217.194.0-255,2902,25472,6,316480
5663,9.8e-05,172.31.36.0-255,66,25538,6,316480
5664,0.000108,172.217.194.0-255,9992,35530,6,316480
5665,0.00011,172.31.36.0-255,66,35596,6,316480
5666,0.000149,172.31.36.0-255,66,35662,6,316480
5667,0.000152,172.217.194.0-255,766,36428,6,316480
5668,0.000154,172.31.36.0-255,66,36494,6,316480
5669,0.000283,172.217.194.0-255,1484,37978,6,316480
5670,0.000286,172.31.36.0-255,66,38044,6,316480
5671,0.000291,172.217.194.0-255,2902,40946,6,316480
5672,0.000294,172.31.36.0-255,66,41012,6,316480
5673,0.000297,172.217.194.0-255,1484,42496,6,316480
5674,0.0003,172.31.36.0-255,66,42562,6,316480
5675,0.000332,172.217.194.0-255,2902,45464,6,316480
5676,0.000334,172.31.36.0-255,66,45530,6,316480
5677,0.000341,172.217.194.0-255,5738,51268,6,316480
5678,0.000343,172.31.36.0-255,66,51334,6,316480
5679,0.00036,172.217.194.0-255,3122,54456,6,316480
5680,0.000362,172.31.36.0-255,66,54522,6,316480
5681,0.000547,172.217.194.0-255,1484,56006,6,316480
5682,0.000551,172.31.36.0-255,66,56072,6,316480
5683,0.000555,172.217.194.0-255,2902,58974,6,316480
5684,0.000558,172.31.36.0-255,66,59040,6,316480
5685,0.000574,172.217.194.0-255,4320,63360,6,316480
5686,0.000576,172.31.36.0-255,66,63426,6,316480
5687,0.000591,172.217.194.0-255,1484,64910,6,316480
5688,0.000602,172.217.194.0-255,9992,74902,6,316480
5689,0.000605,172.31.36.0-255,66,74968,6,316480
5690,0.000624,172.217.194.0-255,2902,77870,6,316480
5691,0.000626,172.31.36.0-255,66,77936,6,316480
5692,0.000635,172.217.194.0-255,8574,86510,6,316480
5693,0.000638,172.31.36.0-255,66,86576,6,316480
5694,0.000653,172.217.194.0-255,2184,88760,6,316480
5695,0.000656,172.31.36.0-255,66,88826,6,316480
5696,0.000669,172.217.194.0-255,1484,90310,6,316480
5697,0.000703,172.31.36.0-255,66,90376,6,316480
5698,0.000706,172.217.194.0-255,577,90953,6,316480
5699,0.000784,172.217.194.0-255,1484,92437,6,316480
5700,0.000788,172.31.36.0-255,66,92503,6,316480
5701,0.000793,172.217.194.0-255,2902,95405,6,316480
5702,0.000796,172.31.36.0-255,66,95471,6,316480
5703,0.000802,172.217.194.0-255,4320,99791,6,316480
5704,0.000804,172.31.36.0-255,66,99857,6,316480
5705,0.000823,172.217.194.0-255,1484,101341,6,316480
5706,0.000827,172.217.194.0-255,2902,104243,6,316480
5707,0.00083,172.31.36.0-255,66,104309,6,316480
5708,0.000834,172.217.194.0-255,4320,108629,6,316480
5709,0.000837,172.31.36.0-255,66,108695,6,316480
5710,0.00084,172.217.194.0-255,1484,110179,6,316480
5711,0.000865,172.217.194.0-255,7156,117335,6,316480
5712,0.000868,172.31.36.0-255,66,117401,6,316480
5713,0.000875,172.217.194.0-255,7856,125257,6,316480
5714,0.000877,172.31.36.0-255,66,125323,6,316480
5715,0.001101,172.217.194.0-255,1484,126807,6,316480
5716,0.001108,172.217.194.0-255,2902,129709,6,316480
5717,0.001111,172.31.36.0-255,66,129775,6,316480
5718,0.001116,172.217.194.0-255,2902,132677,6,316480
5719,0.001119,172.31.36.0-255,66,132743,6,316480
5720,0.001131,172.217.194.0-255,2902,135645,6,316480
5721,0.001134,172.31.36.0-255,66,135711,6,316480
5722,0.001139,172.217.194.0-255,5738,141449,6,316480
5723,0.001141,172.31.36.0-255,66,141515,6,316480
5724,0.001168,172.217.194.0-255,7156,148671,6,316480
5725,0.001171,172.31.36.0-255,66,148737,6,316480
5726,0.001178,172.217.194.0-255,7156,155893,6,316480
5727,0.001181,172.31.36.0-255,66,155959,6,316480
5728,0.001205,172.217.194.0-255,3602,159561,6,316480
5729,0.001208,172.31.36.0-255,66,159627,6,316480
5730,0.001279,172.217.194.0-255,1484,161111,6,316480
5731,0.001284,172.217.194.0-255,2902,164013,6,316480
5732,0.001287,172.31.36.0-255,66,164079,6,316480
5733,0.001317,172.217.194.0-255,5738,169817,6,316480
5734,0.00132,172.31.36.0-255,66,169883,6,316480
5735,0.001326,172.217.194.0-255,5738,175621,6,316480
5736,0.001329,172.31.36.0-255,66,175687,6,316480
5737,0.001332,172.217.194.0-255,1484,177171,6,316480
5738,0.001355,172.217.194.0-255,5738,182909,6,316480
5739,0.001358,172.31.36.0-255,66,182975,6,316480
5740,0.00138,172.217.194.0-255,1484,184459,6,316480
5741,0.001395,172.217.194.0-255,5738,190197,6,316480
5742,0.001398,172.31.36.0-255,66,190263,6,316480
5743,0.001419,172.217.194.0-255,3602,193865,6,316480
5744,0.001422,172.31.36.0-255,66,193931,6,316480
5745,0.001456,172.217.194.0-255,1484,195415,6,316480
5746,0.001471,172.217.194.0-255,2902,198317,6,316480
5747,0.001474,172.31.36.0-255,66,198383,6,316480
5748,0.001498,172.217.194.0-255,5738,204121,6,316480
5749,0.001512,172.31.36.0-255,66,204187,6,316480
5750,0.001515,172.31.36.0-255,66,204253,6,316480
5751,0.001529,172.217.194.0-255,1484,205737,6,316480
5752,0.001544,172.217.194.0-255,10692,216429,6,316480
5753,0.001547,172.31.36.0-255,66,216495,6,316480
5754,0.001978,172.217.194.0-255,1484,217979,6,316480
5755,0.001984,172.217.194.0-255,2902,220881,6,316480
5756,0.001999,172.31.36.0-255,66,220947,6,316480
5757,0.002007,172.217.194.0-255,5738,226685,6,316480
5758,0.002009,172.31.36.0-255,66,226751,6,316480
5759,0.002015,172.217.194.0-255,4320,231071,6,316480
5760,0.002017,172.31.36.0-255,66,231137,6,316480
5761,0.002061,172.217.194.0-255,8574,239711,6,316480
5762,0.002065,172.31.36.0-255,66,239777,6,316480
5763,0.002075,172.217.194.0-255,10692,250469,6,316480
5764,0.002077,172.31.36.0-255,66,250535,6,316480
5765,0.002413,172.217.194.0-255,1484,252019,6,316480
5766,0.002418,172.217.194.0-255,1484,253503,6,316480
5767,0.002421,172.31.36.0-255,66,253569,6,316480
5768,0.002442,172.217.194.0-255,4320,257889,6,316480
5769,0.002445,172.31.36.0-255,66,257955,6,316480
5770,0.002469,172.217.194.0-255,8574,266529,6,316480
5771,0.002472,172.31.36.0-255,66,266595,6,316480
5772,0.002475,172.217.194.0-255,766,267361,6,316480
5773,0.002478,172.31.36.0-255,78,267439,6,316480
5774,0.002495,172.217.194.0-255,5738,273177,6,316480
5775,0.002498,172.31.36.0-255,78,273255,6,316480
5776,0.002537,172.31.36.0-255,66,273321,6,316480
5777,0.00255,172.31.36.0-255,66,273387,6,316480
5778,0.002562,172.31.36.0-255,66,273453,6,316480
5779,0.002566,172.217.194.0-255,2902,276355,6,316480
5780,0.002568,172.31.36.0-255,66,276421,6,316480
5781,0.002576,172.217.194.0-255,7156,283577,6,316480
5782,0.002578,172.31.36.0-255,66,283643,6,316480
5783,0.002632,172.217.194.0-255,9274,292917,6,316480
5784,0.002635,172.31.36.0-255,66,292983,6,316480
5785,0.002644,172.217.194.0-255,9992,302975,6,316480
5786,0.002647,172.31.36.0-255,66,303041,6,316480
5787,0.002655,172.217.194.0-255,7156,310197,6,316480
5788,0.002657,172.31.36.0-255,66,310263,6,316480
5789,0.002705,172.31.36.0-255,66,310329,6,316480
5790,0.002711,172.217.194.0-255,5980,316309,6,316480
5791,0.002713,172.31.36.0-255,66,316375,6,316480
5792,0.002717,172.217.194.0-255,105,316480,6,316480
5793,0.0,74.125.24.0-255,297,297,6,164568
5794,3.5e-05,172.31.36.0-255,66,363,6,164568
5795,4.1e-05,74.125.24.0-255,1484,1847,6,164568
5796,4.7e-05,172.31.36.0-255,66,1913,6,164568
5797,5.3e-05,74.125.24.0-255,4320,6233,6,164568
5798,6.4e-05,172.31.36.0-255,66,6299,6,164568
5799,9.4e-05,74.125.24.0-255,7558,13857,6,164568
5800,0.000102,172.31.36.0-255,66,13923,6,164568
5801,0.000259,74.125.24.0-255,1484,15407,6,164568
5802,0.000264,172.31.36.0-255,66,15473,6,164568
5803,0.00027,74.125.24.0-255,2902,18375,6,164568
5804,0.000272,172.31.36.0-255,66,18441,6,164568
5805,0.000284,74.125.24.0-255,5738,24179,6,164568
5806,0.000288,172.31.36.0-255,66,24245,6,164568
5807,0.000338,172.31.36.0-255,66,24311,6,164568
5808,0.000355,172.31.36.0-255,66,24377,6,164568
5809,0.000361,74.125.24.0-255,5738,30115,6,164568
5810,0.000365,172.31.36.0-255,66,30181,6,164568
5811,0.000401,74.125.24.0-255,9274,39455,6,164568
5812,0.000411,172.31.36.0-255,66,39521,6,164568
5813,0.000414,74.125.24.0-255,363,39884,6,164568
5814,0.000416,172.31.36.0-255,66,39950,6,164568
5815,0.000419,74.125.24.0-255,130,40080,6,164568
5816,0.000422,172.31.36.0-255,66,40146,6,164568
5817,0.000572,74.125.24.0-255,1484,41630,6,164568
5818,0.000576,172.31.36.0-255,66,41696,6,164568
5819,0.000581,74.125.24.0-255,2902,44598,6,164568
5820,0.000583,172.31.36.0-255,66,44664,6,164568
5821,0.00062,74.125.24.0-255,5738,50402,6,164568
5822,0.000623,172.31.36.0-255,66,50468,6,164568
5823,0.00063,74.125.24.0-255,4320,54788,6,164568
5824,0.000632,172.31.36.0-255,66,54854,6,164568
5825,0.000667,74.125.24.0-255,8574,63428,6,164568
5826,0.000671,172.31.36.0-255,66,63494,6,164568
5827,0.000678,74.125.24.0-255,8574,72068,6,164568
5828,0.000681,172.31.36.0-255,66,72134,6,164568
5829,0.000691,74.125.24.0-255,2184,74318,6,164568
5830,0.000694,172.31.36.0-255,66,74384,6,164568
5831,0.000745,74.125.24.0-255,346,74730,6,164568
5832,0.000772,74.125.24.0-255,1484,76214,6,164568
5833,0.000775,172.31.36.0-255,66,76280,6,164568
5834,0.000807,74.125.24.0-255,4320,80600,6,164568
5835,0.000811,172.31.36.0-255,66,80666,6,164568
5836,0.000817,74.125.24.0-255,4320,84986,6,164568
5837,0.000819,172.31.36.0-255,66,85052,6,164568
5838,0.000834,74.125.24.0-255,9992,95044,6,164568
5839,0.000837,172.31.36.0-255,66,95110,6,164568
5840,0.000886,172.31.36.0-255,66,95176,6,164568
5841,0.001296,74.125.24.0-255,1484,96660,6,164568
5842,0.001302,74.125.24.0-255,2902,99562,6,164568
5843,0.001305,172.31.36.0-255,66,99628,6,164568
5844,0.001309,74.125.24.0-255,1484,101112,6,164568
5845,0.001335,74.125.24.0-255,4320,105432,6,164568
5846,0.001341,172.31.36.0-255,66,105498,6,164568
5847,0.001344,74.125.24.0-255,9992,115490,6,164568
5848,0.001346,172.31.36.0-255,66,115556,6,164568
5849,0.001395,74.125.24.0-255,2902,118458,6,164568
5850,0.001399,172.31.36.0-255,66,118524,6,164568
5851,0.001409,74.125.24.0-255,8574,127098,6,164568
5852,0.001417,172.31.36.0-255,66,127164,6,164568
5853,0.001422,74.125.24.0-255,2184,129348,6,164568
5854,0.001424,172.31.36.0-255,66,129414,6,164568
5855,0.001457,74.125.24.0-255,2902,132316,6,164568
5856,0.001461,172.31.36.0-255,66,132382,6,164568
5857,0.001466,74.125.24.0-255,4320,136702,6,164568
5858,0.001468,172.31.36.0-255,66,136768,6,164568
5859,0.001499,74.125.24.0-255,8574,145342,6,164568
5860,0.001503,172.31.36.0-255,66,145408,6,164568
5861,0.001516,74.125.24.0-255,2902,148310,6,164568
5862,0.001519,172.31.36.0-255,66,148376,6,164568
5863,0.001566,172.31.36.0-255,66,148442,6,164568
5864,0.004072,74.125.24.0-255,1484,149926,6,164568
5865,0.004084,74.125.24.0-255,2902,152828,6,164568
5866,0.004088,172.31.36.0-255,66,152894,6,164568
5867,0.004093,74.125.24.0-255,1484,154378,6,164568
5868,0.006146,74.125.24.0-255,4320,158698,6,164568
5869,0.006151,172.31.36.0-255,66,158764,6,164568
5870,0.008233,74.125.24.0-255,5738,164502,6,164568
5871,0.008239,172.31.36.0-255,66,164568,6,164568
5872,0.0,172.217.194.0-255,153,153,6,146669
5873,1.9e-05,172.31.36.0-255,66,219,6,146669
5874,2.5e-05,172.217.194.0-255,1484,1703,6,146669
5875,3e-05,172.31.36.0-255,66,1769,6,146669
5876,3.5e-05,172.217.194.0-255,2902,4671,6,146669
5877,3.8e-05,172.31.36.0-255,66,4737,6,146669
5878,4.5e-05,172.217.194.0-255,7156,11893,6,146669
5879,4.8e-05,172.31.36.0-255,66,11959,6,146669
5880,9.7e-05,172.217.194.0-255,5738,17697,6,146669
5881,0.000101,172.31.36.0-255,66,17763,6,146669
5882,0.000124,172.217.194.0-255,9156,26919,6,146669
5883,0.000127,172.31.36.0-255,66,26985,6,146669
5884,0.000132,172.217.194.0-255,3961,30946,6,146669
5885,0.000134,172.31.36.0-255,66,31012,6,146669
5886,0.00016,172.217.194.0-255,4320,35332,6,146669
5887,0.000162,172.31.36.0-255,66,35398,6,146669
5888,0.000166,172.217.194.0-255,2902,38300,6,146669
5889,0.000168,172.31.36.0-255,66,38366,6,146669
5890,0.000184,172.217.194.0-255,4320,42686,6,146669
5891,0.000186,172.31.36.0-255,66,42752,6,146669
5892,0.000199,172.217.194.0-255,2902,45654,6,146669
5893,0.000201,172.31.36.0-255,66,45720,6,146669
5894,0.000233,172.31.36.0-255,66,45786,6,146669
5895,0.000241,172.217.194.0-255,8215,54001,6,146669
5896,0.000244,172.31.36.0-255,66,54067,6,146669
5897,0.000924,172.217.194.0-255,646,54713,6,146669
5898,0.000931,172.31.36.0-255,66,54779,6,146669
5899,0.001091,172.217.194.0-255,1484,56263,6,146669
5900,0.001097,172.31.36.0-255,66,56329,6,146669
5901,0.001105,172.217.194.0-255,2902,59231,6,146669
5902,0.001108,172.31.36.0-255,66,59297,6,146669
5903,0.001116,172.217.194.0-255,5738,65035,6,146669
5904,0.001118,172.31.36.0-255,66,65101,6,146669
5905,0.001162,172.31.36.0-255,66,65167,6,146669
5906,0.001171,172.217.194.0-255,8574,73741,6,146669
5907,0.001174,172.31.36.0-255,66,73807,6,146669
5908,0.001194,172.217.194.0-255,2184,75991,6,146669
5909,0.001196,172.31.36.0-255,66,76057,6,146669
5910,0.002423,172.217.194.0-255,1484,77541,6,146669
5911,0.002433,172.217.194.0-255,2902,80443,6,146669
5912,0.002437,172.31.36.0-255,66,80509,6,146669
5913,0.002458,172.217.194.0-255,2902,83411,6,146669
5914,0.002461,172.31.36.0-255,66,83477,6,146669
5915,0.002464,172.217.194.0-255,1484,84961,6,146669
5916,0.002482,172.217.194.0-255,2902,87863,6,146669
5917,0.002485,172.31.36.0-255,66,87929,6,146669
5918,0.002491,172.217.194.0-255,4320,92249,6,146669
5919,0.002493,172.31.36.0-255,66,92315,6,146669
5920,0.002519,172.217.194.0-255,4320,96635,6,146669
5921,0.002521,172.31.36.0-255,66,96701,6,146669
5922,0.00253,172.217.194.0-255,9992,106693,6,146669
5923,0.002533,172.31.36.0-255,66,106759,6,146669
5924,0.002563,172.217.194.0-255,3602,110361,6,146669
5925,0.002566,172.31.36.0-255,66,110427,6,146669
5926,0.002588,172.217.194.0-255,4320,114747,6,146669
5927,0.002591,172.31.36.0-255,66,114813,6,146669
5928,0.002598,172.217.194.0-255,5738,120551,6,146669
5929,0.002601,172.31.36.0-255,66,120617,6,146669
5930,0.002616,172.217.194.0-255,4320,124937,6,146669
5931,0.002619,172.31.36.0-255,66,125003,6,146669
5932,0.002628,172.217.194.0-255,9992,134995,6,146669
5933,0.00263,172.31.36.0-255,66,135061,6,146669
5934,0.005227,172.217.194.0-255,5738,140799,6,146669
5935,0.005231,172.31.36.0-255,66,140865,6,146669
5936,0.007826,172.217.194.0-255,5738,146603,6,146669
5937,0.007833,172.31.36.0-255,66,146669,6,146669
5938,0.0,74.125.24.0-255,158,158,6,363380
5939,3.4e-05,172.31.36.0-255,66,224,6,363380
5940,4.1e-05,74.125.24.0-255,1484,1708,6,363380
5941,4.5e-05,172.31.36.0-255,66,1774,6,363380
5942,5e-05,74.125.24.0-255,2902,4676,6,363380
5943,5.4e-05,172.31.36.0-255,66,4742,6,363380
5944,6.2e-05,74.125.24.0-255,7156,11898,6,363380
5945,6.4e-05,172.31.36.0-255,66,11964,6,363380
5946,6.8e-05,74.125.24.0-255,1976,13940,6,363380
5947,7e-05,172.31.36.0-255,66,14006,6,363380
5948,0.00017,74.125.24.0-255,1484,15490,6,363380
5949,0.000176,172.31.36.0-255,66,15556,6,363380
5950,0.000181,74.125.24.0-255,2902,18458,6,363380
5951,0.000184,172.31.36.0-255,66,18524,6,363380
5952,0.00019,74.125.24.0-255,4320,22844,6,363380
5953,0.000192,172.31.36.0-255,66,22910,6,363380
5954,0.000212,74.125.24.0-255,1484,24394,6,363380
5955,0.000214,172.31.36.0-255,66,24460,6,363380
5956,0.000219,74.125.24.0-255,2902,27362,6,363380
5957,0.000221,172.31.36.0-255,66,27428,6,363380
5958,0.000227,74.125.24.0-255,4320,31748,6,363380
5959,0.000229,172.31.36.0-255,66,31814,6,363380
5960,0.000256,74.125.24.0-255,6797,38611,6,363380
5961,0.000258,172.31.36.0-255,66,38677,6,363380
5962,0.000268,74.125.24.0-255,9992,48669,6,363380
5963,0.00027,172.31.36.0-255,66,48735,6,363380
5964,0.000294,74.125.24.0-255,9992,58727,6,363380
5965,0.000297,172.31.36.0-255,66,58793,6,363380
5966,0.000314,74.125.24.0-255,1484,60277,6,363380
5967,0.000317,172.31.36.0-255,66,60343,6,363380
5968,0.000332,74.125.24.0-255,5354,65697,6,363380
5969,0.000337,172.31.36.0-255,66,65763,6,363380
5970,0.000472,74.125.24.0-255,109,65872,6,363380
5971,0.000477,74.125.24.0-255,332,66204,6,363380
5972,0.000715,74.125.24.0-255,1484,67688,6,363380
5973,0.00072,172.31.36.0-255,66,67754,6,363380
5974,0.000726,74.125.24.0-255,2902,70656,6,363380
5975,0.000728,172.31.36.0-255,66,70722,6,363380
5976,0.000732,74.125.24.0-255,2902,73624,6,363380
5977,0.000734,172.31.36.0-255,66,73690,6,363380
5978,0.000758,74.125.24.0-255,2902,76592,6,363380
5979,0.000761,172.31.36.0-255,66,76658,6,363380
5980,0.000768,74.125.24.0-255,4320,80978,6,363380
5981,0.00077,172.31.36.0-255,66,81044,6,363380
5982,0.000774,74.125.24.0-255,2902,83946,6,363380
5983,0.000776,172.31.36.0-255,66,84012,6,363380
5984,0.000802,74.125.24.0-255,8574,92586,6,363380
5985,0.000805,172.31.36.0-255,66,92652,6,363380
5986,0.000813,74.125.24.0-255,7856,100508,6,363380
5987,0.000815,172.31.36.0-255,66,100574,6,363380
5988,0.001192,74.125.24.0-255,1484,102058,6,363380
5989,0.001202,74.125.24.0-255,2902,104960,6,363380
5990,0.001207,172.31.36.0-255,66,105026,6,363380
5991,0.001214,74.125.24.0-255,5738,110764,6,363380
5992,0.001216,172.31.36.0-255,66,110830,6,363380
5993,0.001219,74.125.24.0-255,1484,112314,6,363380
5994,0.001253,172.31.36.0-255,66,112380,6,363380
5995,0.001259,74.125.24.0-255,2902,115282,6,363380
5996,0.001261,172.31.36.0-255,66,115348,6,363380
5997,0.001287,74.125.24.0-255,7856,123204,6,363380
5998,0.00129,172.31.36.0-255,66,123270,6,363380
5999,0.001295,74.125.24.0-255,2902,126172,6,363380
6000,0.001297,172.31.36.0-255,66,126238,6,363380
6001,0.001324,74.125.24.0-255,8574,134812,6,363380
6002,0.001327,172.31.36.0-255,66,134878,6,363380
6003,0.001332,74.125.24.0-255,4320,139198,6,363380
6004,0.001334,172.31.36.0-255,66,139264,6,363380
6005,0.001365,172.31.36.0-255,66,139330,6,363380
6006,0.001382,74.125.24.0-255,5738,145068,6,363380
6007,0.001384,172.31.36.0-255,66,145134,6,363380
6008,0.001387,74.125.24.0-255,766,145900,6,363380
6009,0.001511,74.125.24.0-255,1484,147384,6,363380
6010,0.001516,172.31.36.0-255,66,147450,6,363380
6011,0.00152,74.125.24.0-255,1484,148934,6,363380
6012,0.001537,74.125.24.0-255,1484,150418,6,363380
6013,0.00154,172.31.36.0-255,66,150484,6,363380
6014,0.001547,74.125.24.0-255,5738,156222,6,363380
6015,0.00155,172.31.36.0-255,66,156288,6,363380
6016,0.001554,74.125.24.0-255,2902,159190,6,363380
6017,0.001557,172.31.36.0-255,66,159256,6,363380
6018,0.001579,74.125.24.0-255,9992,169248,6,363380
6019,0.001582,172.31.36.0-255,66,169314,6,363380
6020,0.001586,74.125.24.0-255,1484,170798,6,363380
6021,0.001652,74.125.24.0-255,5738,176536,6,363380
6022,0.001656,172.31.36.0-255,66,176602,6,363380
6023,0.001676,74.125.24.0-255,3602,180204,6,363380
6024,0.00168,172.31.36.0-255,66,180270,6,363380
6025,0.001703,74.125.24.0-255,1484,181754,6,363380
6026,0.001707,74.125.24.0-255,2902,184656,6,363380
6027,0.00171,172.31.36.0-255,66,184722,6,363380
6028,0.001716,74.125.24.0-255,5738,190460,6,363380
6029,0.001718,172.31.36.0-255,66,190526,6,363380
6030,0.001749,74.125.24.0-255,5738,196264,6,363380
6031,0.001753,172.31.36.0-255,66,196330,6,363380
6032,0.001776,74.125.24.0-255,7156,203486,6,363380
6033,0.001781,172.31.36.0-255,66,203552,6,363380
6034,0.00179,74.125.24.0-255,10692,214244,6,363380
6035,0.001792,172.31.36.0-255,66,214310,6,363380
6036,0.002709,74.125.24.0-255,1484,215794,6,363380
6037,0.002715,74.125.24.0-255,2902,218696,6,363380
6038,0.00272,172.31.36.0-255,66,218762,6,363380
6039,0.00275,74.125.24.0-255,5738,224500,6,363380
6040,0.002753,172.31.36.0-255,66,224566,6,363380
6041,0.002759,74.125.24.0-255,4320,228886,6,363380
6042,0.002781,74.125.24.0-255,8574,237460,6,363380
6043,0.002786,74.125.24.0-255,4320,241780,6,363380
6044,0.002804,74.125.24.0-255,6438,248218,6,363380
6045,0.003196,74.125.24.0-255,1484,249702,6,363380
6046,0.003208,74.125.24.0-255,2902,252604,6,363380
6047,0.003224,74.125.24.0-255,5738,258342,6,363380
6048,0.003227,74.125.24.0-255,1484,259826,6,363380
6049,0.003244,74.125.24.0-255,4320,264146,6,363380
6050,0.003256,74.125.24.0-255,2902,267048,6,363380
6051,0.003277,74.125.24.0-255,9992,277040,6,363380
6052,0.0033,74.125.24.0-255,6438,283478,6,363380
6053,0.003306,74.125.24.0-255,7156,290634,6,363380
6054,0.003341,74.125.24.0-255,2902,293536,6,363380
6055,0.003369,74.125.24.0-255,7156,300692,6,363380
6056,0.003383,74.125.24.0-255,2184,302876,6,363380
6057,0.003425,74.125.24.0-255,1484,304360,6,363380
6058,0.003428,74.125.24.0-255,2902,307262,6,363380
6059,0.003446,74.125.24.0-255,4320,311582,6,363380
6060,0.003455,74.125.24.0-255,1484,313066,6,363380
6061,0.003461,74.125.24.0-255,5738,318804,6,363380
6062,0.003465,74.125.24.0-255,2902,321706,6,363380
6063,0.003489,74.125.24.0-255,9992,331698,6,363380
6064,0.003493,74.125.24.0-255,2902,334600,6,363380
6065,0.003506,74.125.24.0-255,2184,336784,6,363380
6066,0.003528,74.125.24.0-255,5738,342522,6,363380
6067,0.00353,74.125.24.0-255,1484,344006,6,363380
6068,0.003578,74.125.24.0-255,7156,351162,6,363380
6069,0.003596,74.125.24.0-255,4320,355482,6,363380
6070,0.003602,74.125.24.0-255,5738,361220,6,363380
6071,0.003605,74.125.24.0-255,1884,363104,6,363380
6072,0.003629,74.125.24.0-255,105,363209,6,363380
6073,0.007129,172.31.36.0-255,66,363275,6,363380
6074,0.009311,172.31.36.0-255,105,363380,6,363380
6075,0.0,74.125.130.0-255,146,146,6,289847
6076,1.6e-05,172.31.36.0-255,66,212,6,289847
6077,2.3e-05,74.125.130.0-255,1484,1696,6,289847
6078,2.8e-05,172.31.36.0-255,66,1762,6,289847
6079,4.1e-05,74.125.130.0-255,2902,4664,6,289847
6080,4.5e-05,172.31.36.0-255,66,4730,6,289847
6081,5e-05,74.125.130.0-255,2902,7632,6,289847
6082,5.3e-05,172.31.36.0-255,66,7698,6,289847
6083,6e-05,74.125.130.0-255,4320,12018,6,289847
6084,6.4e-05,172.31.36.0-255,66,12084,6,289847
6085,8.9e-05,74.125.130.0-255,4320,16404,6,289847
6086,9.6e-05,172.31.36.0-255,66,16470,6,289847
6087,0.000124,74.125.130.0-255,4889,21359,6,289847
6088,0.000127,172.31.36.0-255,66,21425,6,289847
6089,0.000138,74.125.130.0-255,9633,31058,6,289847
6090,0.000144,172.31.36.0-255,66,31124,6,289847
6091,0.000217,74.125.130.0-255,1484,32608,6,289847
6092,0.00022,172.31.36.0-255,66,32674,6,289847
6093,0.000223,74.125.130.0-255,1484,34158,6,289847
6094,0.000225,172.31.36.0-255,66,34224,6,289847
6095,0.000228,74.125.130.0-255,1484,35708,6,289847
6096,0.00023,172.31.36.0-255,66,35774,6,289847
6097,0.000259,74.125.130.0-255,1484,37258,6,289847
6098,0.000261,172.31.36.0-255,66,37324,6,289847
6099,0.000268,74.125.130.0-255,5738,43062,6,289847
6100,0.000271,172.31.36.0-255,66,43128,6,289847
6101,0.000301,74.125.130.0-255,8215,51343,6,289847
6102,0.000303,172.31.36.0-255,66,51409,6,289847
6103,0.000312,74.125.130.0-255,8574,59983,6,289847
6104,0.000315,172.31.36.0-255,66,60049,6,289847
6105,0.000362,74.125.130.0-255,5669,65718,6,289847
6106,0.000365,172.31.36.0-255,66,65784,6,289847
6107,0.000368,74.125.130.0-255,365,66149,6,289847
6108,0.000507,74.125.130.0-255,1484,67633,6,289847
6109,0.000511,172.31.36.0-255,66,67699,6,289847
6110,0.000517,74.125.130.0-255,2902,70601,6,289847
6111,0.00052,172.31.36.0-255,66,70667,6,289847
6112,0.000531,74.125.130.0-255,5738,76405,6,289847
6113,0.000534,172.31.36.0-255,66,76471,6,289847
6114,0.00057,74.125.130.0-255,6797,83268,6,289847
6115,0.000574,172.31.36.0-255,66,83334,6,289847
6116,0.000582,74.125.130.0-255,7156,90490,6,289847
6117,0.000584,172.31.36.0-255,66,90556,6,289847
6118,0.00062,74.125.130.0-255,7156,97712,6,289847
6119,0.000622,172.31.36.0-255,66,97778,6,289847
6120,0.000626,74.125.130.0-255,1484,99262,6,289847
6121,0.000629,74.125.130.0-255,1125,100387,6,289847
6122,0.000632,172.31.36.0-255,66,100453,6,289847
6123,0.000714,74.125.130.0-255,1484,101937,6,289847
6124,0.000762,74.125.130.0-255,2902,104839,6,289847
6125,0.000767,172.31.36.0-255,66,104905,6,289847
6126,0.00077,74.125.130.0-255,1484,106389,6,289847
6127,0.000799,74.125.130.0-255,2902,109291,6,289847
6128,0.000802,172.31.36.0-255,66,109357,6,289847
6129,0.000809,74.125.130.0-255,5738,115095,6,289847
6130,0.000812,172.31.36.0-255,66,115161,6,289847
6131,0.000815,74.125.130.0-255,1484,116645,6,289847
6132,0.000826,74.125.130.0-255,2902,119547,6,289847
6133,0.000828,172.31.36.0-255,66,119613,6,289847
6134,0.000835,74.125.130.0-255,5738,125351,6,289847
6135,0.000837,172.31.36.0-255,66,125417,6,289847
6136,0.000841,74.125.130.0-255,1484,126901,6,289847
6137,0.000877,74.125.130.0-255,7856,134757,6,289847
6138,0.00088,172.31.36.0-255,66,134823,6,289847
6139,0.000918,74.125.130.0-255,1484,136307,6,289847
6140,0.000935,74.125.130.0-255,2902,139209,6,289847
6141,0.000938,172.31.36.0-255,66,139275,6,289847
6142,0.000942,74.125.130.0-255,1484,140759,6,289847
6143,0.000967,74.125.130.0-255,2902,143661,6,289847
6144,0.00097,172.31.36.0-255,66,143727,6,289847
6145,0.000976,74.125.130.0-255,5738,149465,6,289847
6146,0.000979,172.31.36.0-255,66,149531,6,289847
6147,0.001016,172.31.36.0-255,66,149597,6,289847
6148,0.00102,74.125.130.0-255,1484,151081,6,289847
6149,0.001025,74.125.130.0-255,2902,153983,6,289847
6150,0.001026,172.31.36.0-255,66,154049,6,289847
6151,0.001055,74.125.130.0-255,3602,157651,6,289847
6152,0.001058,172.31.36.0-255,66,157717,6,289847
6153,0.0012,74.125.130.0-255,1484,159201,6,289847
6154,0.001205,74.125.130.0-255,1484,160685,6,289847
6155,0.001209,172.31.36.0-255,66,160751,6,289847
6156,0.001241,74.125.130.0-255,1484,162235,6,289847
6157,0.001248,74.125.130.0-255,5738,167973,6,289847
6158,0.001251,172.31.36.0-255,66,168039,6,289847
6159,0.001271,172.31.36.0-255,66,168105,6,289847
6160,0.001274,74.125.130.0-255,1484,169589,6,289847
6161,0.001322,74.125.130.0-255,5738,175327,6,289847
6162,0.001325,172.31.36.0-255,66,175393,6,289847
6163,0.001342,74.125.130.0-255,3602,178995,6,289847
6164,0.001345,172.31.36.0-255,66,179061,6,289847
6165,0.001573,74.125.130.0-255,1484,180545,6,289847
6166,0.001595,74.125.130.0-255,2902,183447,6,289847
6167,0.001598,172.31.36.0-255,66,183513,6,289847
6168,0.001606,74.125.130.0-255,5738,189251,6,289847
6169,0.001608,172.31.36.0-255,66,189317,6,289847
6170,0.001618,74.125.130.0-255,5738,195055,6,289847
6171,0.001621,172.31.36.0-255,66,195121,6,289847
6172,0.001647,74.125.130.0-255,1484,196605,6,289847
6173,0.00166,74.125.130.0-255,8574,205179,6,289847
6174,0.001663,172.31.36.0-255,66,205245,6,289847
6175,0.00167,74.125.130.0-255,5738,210983,6,289847
6176,0.001672,172.31.36.0-255,66,211049,6,289847
6177,0.001693,74.125.130.0-255,2184,213233,6,289847
6178,0.001696,172.31.36.0-255,66,213299,6,289847
6179,0.001819,74.125.130.0-255,1484,214783,6,289847
6180,0.001825,74.125.130.0-255,2902,217685,6,289847
6181,0.001828,172.31.36.0-255,66,217751,6,289847
6182,0.001833,74.125.130.0-255,2902,220653,6,289847
6183,0.001835,172.31.36.0-255,66,220719,6,289847
6184,0.001856,74.125.130.0-255,2902,223621,6,289847
6185,0.001859,172.31.36.0-255,66,223687,6,289847
6186,0.001871,74.125.130.0-255,7156,230843,6,289847
6187,0.001878,172.31.36.0-255,66,230909,6,289847
6188,0.001911,74.125.130.0-255,5738,236647,6,289847
6189,0.001914,172.31.36.0-255,66,236713,6,289847
6190,0.001922,74.125.130.0-255,8574,245287,6,289847
6191,0.001925,172.31.36.0-255,66,245353,6,289847
6192,0.001929,74.125.130.0-255,2184,247537,6,289847
6193,0.001931,172.31.36.0-255,66,247603,6,289847
6194,0.001956,74.125.130.0-255,2902,250505,6,289847
6195,0.001958,172.31.36.0-255,66,250571,6,289847
6196,0.001968,74.125.130.0-255,5738,256309,6,289847
6197,0.001971,172.31.36.0-255,66,256375,6,289847
6198,0.001998,74.125.130.0-255,1484,257859,6,289847
6199,0.002005,74.125.130.0-255,5738,263597,6,289847
6200,0.002008,172.31.36.0-255,66,263663,6,289847
6201,0.002012,74.125.130.0-255,2902,266565,6,289847
6202,0.002014,172.31.36.0-255,66,266631,6,289847
6203,0.003975,74.125.130.0-255,5738,272369,6,289847
6204,0.003983,172.31.36.0-255,66,272435,6,289847
6205,0.005957,74.125.130.0-255,5738,278173,6,289847
6206,0.005962,172.31.36.0-255,66,278239,6,289847
6207,0.007937,74.125.130.0-255,5738,283977,6,289847
6208,0.007944,172.31.36.0-255,66,284043,6,289847
6209,0.009921,74.125.130.0-255,5738,289781,6,289847
6210,0.009928,172.31.36.0-255,66,289847,6,289847
6211,0.0,74.125.24.0-255,153,153,6,139875
6212,2.5e-05,172.31.36.0-255,66,219,6,139875
6213,3.2e-05,74.125.24.0-255,1484,1703,6,139875
6214,3.7e-05,172.31.36.0-255,66,1769,6,139875
6215,4.2e-05,74.125.24.0-255,2902,4671,6,139875
6216,4.5e-05,172.31.36.0-255,66,4737,6,139875
6217,5.1e-05,74.125.24.0-255,7156,11893,6,139875
6218,5.3e-05,172.31.36.0-255,66,11959,6,139875
6219,0.000108,74.125.24.0-255,2066,14025,6,139875
6220,0.000111,172.31.36.0-255,66,14091,6,139875
6221,0.000151,74.125.24.0-255,4320,18411,6,139875
6222,0.000155,172.31.36.0-255,66,18477,6,139875
6223,0.00018,74.125.24.0-255,7156,25633,6,139875
6224,0.000183,172.31.36.0-255,66,25699,6,139875
6225,0.000243,74.125.24.0-255,5379,31078,6,139875
6226,0.000247,172.31.36.0-255,66,31144,6,139875
6227,0.000286,74.125.24.0-255,4320,35464,6,139875
6228,0.000289,172.31.36.0-255,66,35530,6,139875
6229,0.000308,74.125.24.0-255,1484,37014,6,139875
6230,0.00031,172.31.36.0-255,66,37080,6,139875
6231,0.000353,74.125.24.0-255,9992,47072,6,139875
6232,0.000358,172.31.36.0-255,66,47138,6,139875
6233,0.000375,74.125.24.0-255,2543,49681,6,139875
6234,0.000378,172.31.36.0-255,66,49747,6,139875
6235,0.000454,74.125.24.0-255,1484,51231,6,139875
6236,0.000457,172.31.36.0-255,66,51297,6,139875
6237,0.000493,172.31.36.0-255,66,51363,6,139875
6238,0.00058,74.125.24.0-255,361,51724,6,139875
6239,0.000584,172.31.36.0-255,66,51790,6,139875
6240,0.000587,74.125.24.0-255,383,52173,6,139875
6241,0.000589,172.31.36.0-255,66,52239,6,139875
6242,0.000614,74.125.24.0-255,2902,55141,6,139875
6243,0.000623,172.31.36.0-255,66,55207,6,139875
6244,0.000637,74.125.24.0-255,4320,59527,6,139875
6245,0.000655,172.31.36.0-255,66,59593,6,139875
6246,0.000702,172.31.36.0-255,66,59659,6,139875
6247,0.000788,74.125.24.0-255,4320,63979,6,139875
6248,0.000792,172.31.36.0-255,66,64045,6,139875
6249,0.000821,172.31.36.0-255,66,64111,6,139875
6250,0.000932,74.125.24.0-255,8574,72685,6,139875
6251,0.000936,172.31.36.0-255,66,72751,6,139875
6252,0.000958,74.125.24.0-255,7156,79907,6,139875
6253,0.000968,172.31.36.0-255,66,79973,6,139875
6254,0.001085,74.125.24.0-255,8574,88547,6,139875
6255,0.001089,172.31.36.0-255,66,88613,6,139875
6256,0.001133,172.31.36.0-255,66,88679,6,139875
6257,0.001419,74.125.24.0-255,5738,94417,6,139875
6258,0.001423,172.31.36.0-255,66,94483,6,139875
6259,0.001459,172.31.36.0-255,66,94549,6,139875
6260,0.001552,74.125.24.0-255,766,95315,6,139875
6261,0.001616,172.31.36.0-255,66,95381,6,139875
6262,0.001891,74.125.24.0-255,7156,102537,6,139875
6263,0.001895,172.31.36.0-255,66,102603,6,139875
6264,0.001943,172.31.36.0-255,66,102669,6,139875
6265,0.001972,172.31.36.0-255,66,102735,6,139875
6266,0.002437,74.125.24.0-255,8574,111309,6,139875
6267,0.002443,172.31.36.0-255,66,111375,6,139875
6268,0.002465,74.125.24.0-255,3602,114977,6,139875
6269,0.002487,172.31.36.0-255,66,115043,6,139875
6270,0.002528,74.125.24.0-255,7156,122199,6,139875
6271,0.002559,172.31.36.0-255,66,122265,6,139875
6272,0.002608,172.31.36.0-255,66,122331,6,139875
6273,0.002918,172.31.36.0-255,66,122397,6,139875
6274,0.003002,172.31.36.0-255,66,122463,6,139875
6275,0.005256,74.125.24.0-255,5738,128201,6,139875
6276,0.005263,172.31.36.0-255,66,128267,6,139875
6277,0.007538,74.125.24.0-255,5738,134005,6,139875
6278,0.007544,172.31.36.0-255,66,134071,6,139875
6279,0.009812,74.125.24.0-255,5738,139809,6,139875
6280,0.009819,172.31.36.0-255,66,139875,6,139875
6281,0.0,172.217.194.0-255,146,146,6,282031
6282,2.6e-05,172.31.36.0-255,66,212,6,282031
6283,3.3e-05,172.217.194.0-255,1484,1696,6,282031
6284,3.7e-05,172.31.36.0-255,66,1762,6,282031
6285,4.2e-05,172.217.194.0-255,2902,4664,6,282031
6286,5.2e-05,172.31.36.0-255,66,4730,6,282031
6287,6e-05,172.217.194.0-255,7156,11886,6,282031
6288,6.3e-05,172.31.36.0-255,66,11952,6,282031
6289,9.4e-05,172.217.194.0-255,2048,14000,6,282031
6290,9.7e-05,172.31.36.0-255,66,14066,6,282031
6291,0.000102,172.217.194.0-255,2902,16968,6,282031
6292,0.000104,172.31.36.0-255,66,17034,6,282031
6293,0.000142,172.217.194.0-255,7156,24190,6,282031
6294,0.000145,172.31.36.0-255,66,24256,6,282031
6295,0.000148,172.217.194.0-255,1484,25740,6,282031
6296,0.00015,172.31.36.0-255,66,25806,6,282031
6297,0.000179,172.217.194.0-255,5379,31185,6,282031
6298,0.000183,172.31.36.0-255,66,31251,6,282031
6299,0.000235,172.217.194.0-255,1484,32735,6,282031
6300,0.000237,172.31.36.0-255,66,32801,6,282031
6301,0.00026,172.217.194.0-255,2902,35703,6,282031
6302,0.000263,172.31.36.0-255,66,35769,6,282031
6303,0.000269,172.217.194.0-255,5738,41507,6,282031
6304,0.000271,172.31.36.0-255,66,41573,6,282031
6305,0.000278,172.217.194.0-255,6797,48370,6,282031
6306,0.000281,172.31.36.0-255,66,48436,6,282031
6307,0.000314,172.217.194.0-255,9992,58428,6,282031
6308,0.000323,172.31.36.0-255,66,58494,6,282031
6309,0.00035,172.217.194.0-255,4320,62814,6,282031
6310,0.000354,172.31.36.0-255,66,62880,6,282031
6311,0.000358,172.217.194.0-255,2859,65739,6,282031
6312,0.000361,172.31.36.0-255,66,65805,6,282031
6313,0.00039,172.217.194.0-255,362,66167,6,282031
6314,0.000752,172.217.194.0-255,1484,67651,6,282031
6315,0.000756,172.217.194.0-255,2902,70553,6,282031
6316,0.000758,172.31.36.0-255,66,70619,6,282031
6317,0.000762,172.31.36.0-255,66,70685,6,282031
6318,0.000795,172.217.194.0-255,5738,76423,6,282031
6319,0.000799,172.31.36.0-255,66,76489,6,282031
6320,0.000806,172.217.194.0-255,8574,85063,6,282031
6321,0.000809,172.31.36.0-255,66,85129,6,282031
6322,0.000841,172.217.194.0-255,7156,92285,6,282031
6323,0.000845,172.31.36.0-255,66,92351,6,282031
6324,0.000872,172.217.194.0-255,7856,100207,6,282031
6325,0.000875,172.31.36.0-255,66,100273,6,282031
6326,0.001376,172.217.194.0-255,1484,101757,6,282031
6327,0.001383,172.217.194.0-255,2902,104659,6,282031
6328,0.001387,172.31.36.0-255,66,104725,6,282031
6329,0.001394,172.217.194.0-255,5738,110463,6,282031
6330,0.001395,172.31.36.0-255,66,110529,6,282031
6331,0.001432,172.217.194.0-255,9992,120521,6,282031
6332,0.001435,172.31.36.0-255,66,120587,6,282031
6333,0.001469,172.217.194.0-255,8574,129161,6,282031
6334,0.001472,172.31.36.0-255,66,129227,6,282031
6335,0.001498,172.217.194.0-255,5020,134247,6,282031
6336,0.001501,172.31.36.0-255,66,134313,6,282031
6337,0.001674,172.217.194.0-255,1484,135797,6,282031
6338,0.001681,172.217.194.0-255,2902,138699,6,282031
6339,0.001684,172.31.36.0-255,66,138765,6,282031
6340,0.001692,172.217.194.0-255,5738,144503,6,282031
6341,0.001694,172.31.36.0-255,66,144569,6,282031
6342,0.001743,172.31.36.0-255,66,144635,6,282031
6343,0.001764,172.217.194.0-255,7156,151791,6,282031
6344,0.001766,172.31.36.0-255,66,151857,6,282031
6345,0.001791,172.217.194.0-255,5020,156877,6,282031
6346,0.001794,172.31.36.0-255,66,156943,6,282031
6347,0.001832,172.217.194.0-255,1484,158427,6,282031
6348,0.001836,172.217.194.0-255,2902,161329,6,282031
6349,0.001838,172.31.36.0-255,66,161395,6,282031
6350,0.001862,172.217.194.0-255,5738,167133,6,282031
6351,0.001864,172.31.36.0-255,66,167199,6,282031
6352,0.001893,172.217.194.0-255,7156,174355,6,282031
6353,0.001895,172.31.36.0-255,66,174421,6,282031
6354,0.001903,172.217.194.0-255,8574,182995,6,282031
6355,0.001904,172.31.36.0-255,66,183061,6,282031
6356,0.001933,172.217.194.0-255,5738,188799,6,282031
6357,0.001935,172.31.36.0-255,66,188865,6,282031
6358,0.001939,172.217.194.0-255,2184,191049,6,282031
6359,0.001941,172.31.36.0-255,66,191115,6,282031
6360,0.001958,172.217.194.0-255,7156,198271,6,282031
6361,0.001961,172.31.36.0-255,66,198337,6,282031
6362,0.00199,172.31.36.0-255,66,198403,6,282031
6363,0.002002,172.31.36.0-255,66,198469,6,282031
6364,0.002029,172.217.194.0-255,7856,206325,6,282031
6365,0.002031,172.31.36.0-255,66,206391,6,282031
6366,0.002036,172.217.194.0-255,4320,210711,6,282031
6367,0.002037,172.31.36.0-255,66,210777,6,282031
6368,0.002067,172.217.194.0-255,4320,215097,6,282031
6369,0.002069,172.31.36.0-255,66,215163,6,282031
6370,0.002086,172.31.36.0-255,66,215229,6,282031
6371,0.00211,172.217.194.0-255,5738,220967,6,282031
6372,0.002113,172.31.36.0-255,66,221033,6,282031
6373,0.002117,172.217.194.0-255,2184,223217,6,282031
6374,0.002118,172.31.36.0-255,66,223283,6,282031
6375,0.002142,172.217.194.0-255,1484,224767,6,282031
6376,0.002158,172.217.194.0-255,2902,227669,6,282031
6377,0.00216,172.31.36.0-255,66,227735,6,282031
6378,0.002166,172.217.194.0-255,5738,233473,6,282031
6379,0.002169,172.31.36.0-255,66,233539,6,282031
6380,0.002211,172.217.194.0-255,2902,236441,6,282031
6381,0.002213,172.31.36.0-255,66,236507,6,282031
6382,0.002238,172.217.194.0-255,1484,237991,6,282031
6383,0.002254,172.31.36.0-255,66,238057,6,282031
6384,0.002262,172.217.194.0-255,7856,245913,6,282031
6385,0.002264,172.31.36.0-255,66,245979,6,282031
6386,0.002471,172.217.194.0-255,1484,247463,6,282031
6387,0.002475,172.217.194.0-255,2902,250365,6,282031
6388,0.002478,172.31.36.0-255,66,250431,6,282031
6389,0.002482,172.217.194.0-255,2902,253333,6,282031
6390,0.002484,172.31.36.0-255,66,253399,6,282031
6391,0.002503,172.217.194.0-255,2902,256301,6,282031
6392,0.002506,172.31.36.0-255,66,256367,6,282031
6393,0.002522,172.31.36.0-255,66,256433,6,282031
6394,0.002555,172.217.194.0-255,10692,267125,6,282031
6395,0.002558,172.31.36.0-255,66,267191,6,282031
6396,0.002583,172.217.194.0-255,2902,270093,6,282031
6397,0.002585,172.31.36.0-255,66,270159,6,282031
6398,0.005058,172.217.194.0-255,2902,273061,6,282031
6399,0.005061,172.31.36.0-255,66,273127,6,282031
6400,0.005102,172.217.194.0-255,2902,276029,6,282031
6401,0.005106,172.31.36.0-255,66,276095,6,282031
6402,0.007579,172.217.194.0-255,2902,278997,6,282031
6403,0.007585,172.31.36.0-255,66,279063,6,282031
6404,0.007614,172.217.194.0-255,2902,281965,6,282031
6405,0.007618,172.31.36.0-255,66,282031,6,282031
6406,0.0,172.217.194.0-255,143,143,6,172901
6407,2.6e-05,172.31.36.0-255,66,209,6,172901
6408,3.3e-05,172.217.194.0-255,1484,1693,6,172901
6409,3.8e-05,172.31.36.0-255,66,1759,6,172901
6410,4.4e-05,172.217.194.0-255,2902,4661,6,172901
6411,5.6e-05,172.31.36.0-255,66,4727,6,172901
6412,6.5e-05,172.217.194.0-255,7156,11883,6,172901
6413,6.7e-05,172.31.36.0-255,66,11949,6,172901
6414,7.2e-05,172.217.194.0-255,2045,13994,6,172901
6415,7.4e-05,172.31.36.0-255,66,14060,6,172901
6416,7.7e-05,172.217.194.0-255,1484,15544,6,172901
6417,7.9e-05,172.31.36.0-255,66,15610,6,172901
6418,8.4e-05,172.217.194.0-255,2902,18512,6,172901
6419,8.7e-05,172.31.36.0-255,66,18578,6,172901
6420,9e-05,172.217.194.0-255,1484,20062,6,172901
6421,9.2e-05,172.31.36.0-255,66,20128,6,172901
6422,0.000132,172.217.194.0-255,4320,24448,6,172901
6423,0.000136,172.31.36.0-255,66,24514,6,172901
6424,0.000141,172.217.194.0-255,2902,27416,6,172901
6425,0.000143,172.31.36.0-255,66,27482,6,172901
6426,0.000163,172.217.194.0-255,3961,31443,6,172901
6427,0.000166,172.31.36.0-255,66,31509,6,172901
6428,0.000178,172.217.194.0-255,7156,38665,6,172901
6429,0.000181,172.31.36.0-255,66,38731,6,172901
6430,0.000187,172.217.194.0-255,4320,43051,6,172901
6431,0.000189,172.31.36.0-255,66,43117,6,172901
6432,0.00022,172.217.194.0-255,4320,47437,6,172901
6433,0.000223,172.31.36.0-255,66,47503,6,172901
6434,0.000251,172.217.194.0-255,1125,48628,6,172901
6435,0.000253,172.31.36.0-255,66,48694,6,172901
6436,0.000667,172.217.194.0-255,1484,50178,6,172901
6437,0.000673,172.31.36.0-255,66,50244,6,172901
6438,0.000679,172.217.194.0-255,2902,53146,6,172901
6439,0.000683,172.31.36.0-255,66,53212,6,172901
6440,0.000718,172.217.194.0-255,5738,58950,6,172901
6441,0.000721,172.31.36.0-255,66,59016,6,172901
6442,0.000729,172.217.194.0-255,6797,65813,6,172901
6443,0.000744,172.217.194.0-255,365,66178,6,172901
6444,0.000756,172.31.36.0-255,66,66244,6,172901
6445,0.001057,172.217.194.0-255,378,66622,6,172901
6446,0.001123,172.31.36.0-255,66,66688,6,172901
6447,0.001286,172.217.194.0-255,1484,68172,6,172901
6448,0.001295,172.217.194.0-255,2902,71074,6,172901
6449,0.001299,172.31.36.0-255,66,71140,6,172901
6450,0.001307,172.217.194.0-255,5738,76878,6,172901
6451,0.00131,172.31.36.0-255,66,76944,6,172901
6452,0.001365,172.31.36.0-255,66,77010,6,172901
6453,0.0014,172.217.194.0-255,9633,86643,6,172901
6454,0.001403,172.31.36.0-255,66,86709,6,172901
6455,0.00185,172.217.194.0-255,1484,88193,6,172901
6456,0.001859,172.217.194.0-255,2902,91095,6,172901
6457,0.001863,172.31.36.0-255,66,91161,6,172901
6458,0.001871,172.217.194.0-255,5738,96899,6,172901
6459,0.001873,172.31.36.0-255,66,96965,6,172901
6460,0.001893,172.31.36.0-255,66,97031,6,172901
6461,0.00193,172.217.194.0-255,8574,105605,6,172901
6462,0.001947,172.217.194.0-255,2184,107789,6,172901
6463,0.002137,172.217.194.0-255,1484,109273,6,172901
6464,0.002144,172.217.194.0-255,2902,112175,6,172901
6465,0.002152,172.217.194.0-255,5738,117913,6,172901
6466,0.002173,172.217.194.0-255,5738,123651,6,172901
6467,0.002199,172.217.194.0-255,7156,130807,6,172901
6468,0.002208,172.217.194.0-255,8574,139381,6,172901
6469,0.002223,172.217.194.0-255,1484,140865,6,172901
6470,0.002227,172.217.194.0-255,2184,143049,6,172901
6471,0.002243,172.217.194.0-255,2902,145951,6,172901
6472,0.002249,172.217.194.0-255,4320,150271,6,172901
6473,0.002264,172.217.194.0-255,2902,153173,6,172901
6474,0.002281,172.217.194.0-255,2902,156075,6,172901
6475,0.002307,172.217.194.0-255,4320,160395,6,172901
6476,0.002321,172.217.194.0-255,2184,162579,6,172901
6477,0.004675,172.31.36.0-255,66,162645,6,172901
6478,0.006957,172.217.194.0-255,4320,166965,6,172901
6479,0.006963,172.31.36.0-255,66,167031,6,172901
6480,0.006991,172.217.194.0-255,1484,168515,6,172901
6481,0.009248,172.217.194.0-255,4320,172835,6,172901
6482,0.009255,172.31.36.0-255,66,172901,6,172901
6483,0.0,172.217.194.0-255,293,293,6,183396
6484,1.7e-05,172.31.36.0-255,66,359,6,183396
6485,2.5e-05,172.217.194.0-255,1484,1843,6,183396
6486,2.9e-05,172.31.36.0-255,66,1909,6,183396
6487,3.5e-05,172.217.194.0-255,2902,4811,6,183396
6488,4.7e-05,172.31.36.0-255,66,4877,6,183396
6489,7.5e-05,172.217.194.0-255,1484,6361,6,183396
6490,7.8e-05,172.31.36.0-255,66,6427,6,183396
6491,9.1e-05,172.217.194.0-255,7156,13583,6,183396
6492,9.4e-05,172.31.36.0-255,66,13649,6,183396
6493,0.000127,172.217.194.0-255,1484,15133,6,183396
6494,0.00013,172.31.36.0-255,66,15199,6,183396
6495,0.000162,172.217.194.0-255,6122,21321,6,183396
6496,0.000166,172.31.36.0-255,66,21387,6,183396
6497,0.000174,172.217.194.0-255,8574,29961,6,183396
6498,0.000176,172.31.36.0-255,66,30027,6,183396
6499,0.000179,172.217.194.0-255,1125,31152,6,183396
6500,0.000181,172.31.36.0-255,66,31218,6,183396
6501,0.000361,172.217.194.0-255,1484,32702,6,183396
6502,0.000367,172.31.36.0-255,66,32768,6,183396
6503,0.000371,172.217.194.0-255,1484,34252,6,183396
6504,0.000373,172.31.36.0-255,66,34318,6,183396
6505,0.000409,172.217.194.0-255,1484,35802,6,183396
6506,0.000412,172.31.36.0-255,66,35868,6,183396
6507,0.000419,172.217.194.0-255,5738,41606,6,183396
6508,0.000421,172.31.36.0-255,66,41672,6,183396
6509,0.000446,172.217.194.0-255,2902,44574,6,183396
6510,0.000448,172.31.36.0-255,66,44640,6,183396
6511,0.000466,172.217.194.0-255,3961,48601,6,183396
6512,0.000468,172.31.36.0-255,66,48667,6,183396
6513,0.000696,172.217.194.0-255,1484,50151,6,183396
6514,0.000701,172.31.36.0-255,66,50217,6,183396
6515,0.00073,172.217.194.0-255,2902,53119,6,183396
6516,0.000733,172.31.36.0-255,66,53185,6,183396
6517,0.000739,172.217.194.0-255,5738,58923,6,183396
6518,0.000742,172.31.36.0-255,66,58989,6,183396
6519,0.000747,172.217.194.0-255,4320,63309,6,183396
6520,0.000749,172.31.36.0-255,66,63375,6,183396
6521,0.000782,172.217.194.0-255,2543,65918,6,183396
6522,0.000785,172.31.36.0-255,66,65984,6,183396
6523,0.000788,172.217.194.0-255,647,66631,6,183396
6524,0.000951,172.217.194.0-255,1484,68115,6,183396
6525,0.000955,172.31.36.0-255,66,68181,6,183396
6526,0.00096,172.217.194.0-255,2902,71083,6,183396
6527,0.000962,172.31.36.0-255,66,71149,6,183396
6528,0.000968,172.217.194.0-255,4320,75469,6,183396
6529,0.000978,172.31.36.0-255,66,75535,6,183396
6530,0.001008,172.217.194.0-255,1484,77019,6,183396
6531,0.001016,172.217.194.0-255,6797,83816,6,183396
6532,0.001018,172.31.36.0-255,66,83882,6,183396
6533,0.001052,172.217.194.0-255,7156,91038,6,183396
6534,0.001055,172.31.36.0-255,66,91104,6,183396
6535,0.00106,172.217.194.0-255,2902,94006,6,183396
6536,0.001061,172.31.36.0-255,66,94072,6,183396
6537,0.001086,172.217.194.0-255,5738,99810,6,183396
6538,0.001089,172.31.36.0-255,66,99876,6,183396
6539,0.001091,172.217.194.0-255,1125,101001,6,183396
6540,0.00127,172.217.194.0-255,1484,102485,6,183396
6541,0.001275,172.31.36.0-255,66,102551,6,183396
6542,0.001281,172.217.194.0-255,2902,105453,6,183396
6543,0.001283,172.31.36.0-255,66,105519,6,183396
6544,0.001314,172.217.194.0-255,5738,111257,6,183396
6545,0.001316,172.31.36.0-255,66,111323,6,183396
6546,0.001321,172.217.194.0-255,4320,115643,6,183396
6547,0.001324,172.31.36.0-255,66,115709,6,183396
6548,0.001357,172.217.194.0-255,5738,121447,6,183396
6549,0.001359,172.31.36.0-255,66,121513,6,183396
6550,0.001401,172.31.36.0-255,66,121579,6,183396
6551,0.001482,172.217.194.0-255,1484,123063,6,183396
6552,0.001499,172.217.194.0-255,2902,125965,6,183396
6553,0.001501,172.31.36.0-255,66,126031,6,183396
6554,0.001508,172.217.194.0-255,4320,130351,6,183396
6555,0.001511,172.31.36.0-255,66,130417,6,183396
6556,0.001537,172.217.194.0-255,1484,131901,6,183396
6557,0.001545,172.217.194.0-255,7156,139057,6,183396
6558,0.001548,172.31.36.0-255,66,139123,6,183396
6559,0.001583,172.31.36.0-255,66,139189,6,183396
6560,0.001594,172.217.194.0-255,1484,140673,6,183396
6561,0.001609,172.217.194.0-255,2184,142857,6,183396
6562,0.001615,172.31.36.0-255,66,142923,6,183396
6563,0.001663,172.31.36.0-255,101,143024,6,183396
6564,0.002067,172.217.194.0-255,1484,144508,6,183396
6565,0.002072,172.217.194.0-255,1484,145992,6,183396
6566,0.002075,172.31.36.0-255,66,146058,6,183396
6567,0.002103,172.217.194.0-255,1484,147542,6,183396
6568,0.002109,172.217.194.0-255,2902,150444,6,183396
6569,0.002111,172.31.36.0-255,66,150510,6,183396
6570,0.002142,172.217.194.0-255,7156,157666,6,183396
6571,0.002145,172.31.36.0-255,66,157732,6,183396
6572,0.002158,172.31.36.0-255,66,157798,6,183396
6573,0.002187,172.217.194.0-255,4320,162118,6,183396
6574,0.002189,172.31.36.0-255,66,162184,6,183396
6575,0.002193,172.217.194.0-255,1484,163668,6,183396
6576,0.002219,172.217.194.0-255,2184,165852,6,183396
6577,0.002222,172.31.36.0-255,66,165918,6,183396
6578,0.003896,172.217.194.0-255,66,165984,6,183396
6579,0.004496,172.217.194.0-255,5738,171722,6,183396
6580,0.004502,172.31.36.0-255,66,171788,6,183396
6581,0.006788,172.217.194.0-255,5738,177526,6,183396
6582,0.006795,172.31.36.0-255,66,177592,6,183396
6583,0.009053,172.217.194.0-255,5738,183330,6,183396
6584,0.00906,172.31.36.0-255,66,183396,6,183396
6585,0.0,74.125.24.0-255,150,150,6,280233
6586,2.6e-05,172.31.36.0-255,66,216,6,280233
6587,3.3e-05,74.125.24.0-255,1484,1700,6,280233
6588,3.8e-05,172.31.36.0-255,66,1766,6,280233
6589,5e-05,74.125.24.0-255,2902,4668,6,280233
6590,5.4e-05,172.31.36.0-255,66,4734,6,280233
6591,8.8e-05,74.125.24.0-255,5738,10472,6,280233
6592,9.1e-05,172.31.36.0-255,66,10538,6,280233
6593,0.000116,74.125.24.0-255,3420,13958,6,280233
6594,0.000119,172.31.36.0-255,66,14024,6,280233
6595,0.000241,74.125.24.0-255,1484,15508,6,280233
6596,0.000246,172.31.36.0-255,66,15574,6,280233
6597,0.000251,74.125.24.0-255,2902,18476,6,280233
6598,0.000253,172.31.36.0-255,66,18542,6,280233
6599,0.000265,74.125.24.0-255,5738,24280,6,280233
6600,0.000268,172.31.36.0-255,66,24346,6,280233
6601,0.000271,74.125.24.0-255,1484,25830,6,280233
6602,0.000274,172.31.36.0-255,66,25896,6,280233
6603,0.000301,74.125.24.0-255,5379,31275,6,280233
6604,0.000305,172.31.36.0-255,66,31341,6,280233
6605,0.000312,74.125.24.0-255,5738,37079,6,280233
6606,0.000314,172.31.36.0-255,66,37145,6,280233
6607,0.000359,74.125.24.0-255,8574,45719,6,280233
6608,0.000363,172.31.36.0-255,66,45785,6,280233
6609,0.000379,172.31.36.0-255,66,45851,6,280233
6610,0.000385,74.125.24.0-255,3602,49453,6,280233
6611,0.000388,172.31.36.0-255,66,49519,6,280233
6612,0.000391,74.125.24.0-255,398,49917,6,280233
6613,0.000393,172.31.36.0-255,66,49983,6,280233
6614,0.000432,74.125.24.0-255,114,50097,6,280233
6615,0.000436,172.31.36.0-255,66,50163,6,280233
6616,0.000586,74.125.24.0-255,1484,51647,6,280233
6617,0.000591,74.125.24.0-255,1484,53131,6,280233
6618,0.000595,172.31.36.0-255,66,53197,6,280233
6619,0.000627,74.125.24.0-255,1484,54681,6,280233
6620,0.000634,74.125.24.0-255,5738,60419,6,280233
6621,0.000637,172.31.36.0-255,66,60485,6,280233
6622,0.000645,74.125.24.0-255,7156,67641,6,280233
6623,0.000647,172.31.36.0-255,66,67707,6,280233
6624,0.000675,74.125.24.0-255,2902,70609,6,280233
6625,0.00068,172.31.36.0-255,66,70675,6,280233
6626,0.000683,74.125.24.0-255,8574,79249,6,280233
6627,0.000685,172.31.36.0-255,66,79315,6,280233
6628,0.000717,74.125.24.0-255,5020,84335,6,280233
6629,0.00072,172.31.36.0-255,66,84401,6,280233
6630,0.000769,74.125.24.0-255,1484,85885,6,280233
6631,0.000773,74.125.24.0-255,2902,88787,6,280233
6632,0.000776,172.31.36.0-255,66,88853,6,280233
6633,0.000805,74.125.24.0-255,5738,94591,6,280233
6634,0.000808,172.31.36.0-255,66,94657,6,280233
6635,0.000814,74.125.24.0-255,4320,98977,6,280233
6636,0.000826,172.31.36.0-255,66,99043,6,280233
6637,0.000849,74.125.24.0-255,8574,107617,6,280233
6638,0.000854,172.31.36.0-255,66,107683,6,280233
6639,0.000856,74.125.24.0-255,5738,113421,6,280233
6640,0.000868,172.31.36.0-255,66,113487,6,280233
6641,0.000882,74.125.24.0-255,5020,118507,6,280233
6642,0.000886,172.31.36.0-255,66,118573,6,280233
6643,0.001,74.125.24.0-255,1484,120057,6,280233
6644,0.001003,74.125.24.0-255,1484,121541,6,280233
6645,0.001007,172.31.36.0-255,66,121607,6,280233
6646,0.001024,74.125.24.0-255,1484,123091,6,280233
6647,0.001029,74.125.24.0-255,2902,125993,6,280233
6648,0.001042,74.125.24.0-255,2902,128895,6,280233
6649,0.001042,172.31.36.0-255,66,128961,6,280233
6650,0.001047,172.31.36.0-255,66,129027,6,280233
6651,0.001095,74.125.24.0-255,4320,133347,6,280233
6652,0.001099,172.31.36.0-255,66,133413,6,280233
6653,0.001126,74.125.24.0-255,2902,136315,6,280233
6654,0.001129,172.31.36.0-255,66,136381,6,280233
6655,0.001145,74.125.24.0-255,2184,138565,6,280233
6656,0.001145,172.31.36.0-255,66,138631,6,280233
6657,0.00115,172.31.36.0-255,66,138697,6,280233
6658,0.001222,74.125.24.0-255,1484,140181,6,280233
6659,0.001243,74.125.24.0-255,2902,143083,6,280233
6660,0.001254,172.31.36.0-255,66,143149,6,280233
6661,0.001257,74.125.24.0-255,1484,144633,6,280233
6662,0.001283,74.125.24.0-255,4320,148953,6,280233
6663,0.001287,172.31.36.0-255,66,149019,6,280233
6664,0.001293,74.125.24.0-255,7156,156175,6,280233
6665,0.001301,172.31.36.0-255,66,156241,6,280233
6666,0.00132,74.125.24.0-255,8574,164815,6,280233
6667,0.001334,172.31.36.0-255,66,164881,6,280233
6668,0.001349,74.125.24.0-255,5738,170619,6,280233
6669,0.001353,74.125.24.0-255,2184,172803,6,280233
6670,0.00136,172.31.36.0-255,66,172869,6,280233
6671,0.001431,74.125.24.0-255,1484,174353,6,280233
6672,0.001435,74.125.24.0-255,1484,175837,6,280233
6673,0.001441,172.31.36.0-255,66,175903,6,280233
6674,0.001463,74.125.24.0-255,1484,177387,6,280233
6675,0.00147,74.125.24.0-255,5738,183125,6,280233
6676,0.001472,172.31.36.0-255,66,183191,6,280233
6677,0.00148,74.125.24.0-255,8574,191765,6,280233
6678,0.00149,172.31.36.0-255,66,191831,6,280233
6679,0.001513,74.125.24.0-255,4320,196151,6,280233
6680,0.001518,172.31.36.0-255,66,196217,6,280233
6681,0.00152,74.125.24.0-255,7156,203373,6,280233
6682,0.001534,172.31.36.0-255,66,203439,6,280233
6683,0.001552,74.125.24.0-255,3602,207041,6,280233
6684,0.001559,172.31.36.0-255,66,207107,6,280233
6685,0.001585,74.125.24.0-255,4320,211427,6,280233
6686,0.001595,172.31.36.0-255,66,211493,6,280233
6687,0.001606,74.125.24.0-255,5738,217231,6,280233
6688,0.001622,172.31.36.0-255,66,217297,6,280233
6689,0.001661,74.125.24.0-255,2902,220199,6,280233
6690,0.001669,172.31.36.0-255,66,220265,6,280233
6691,0.001693,74.125.24.0-255,1484,221749,6,280233
6692,0.001721,74.125.24.0-255,7856,229605,6,280233
6693,0.001732,172.31.36.0-255,66,229671,6,280233
6694,0.001786,74.125.24.0-255,1484,231155,6,280233
6695,0.0018,74.125.24.0-255,2902,234057,6,280233
6696,0.001814,172.31.36.0-255,66,234123,6,280233
6697,0.001822,74.125.24.0-255,5738,239861,6,280233
6698,0.001825,172.31.36.0-255,66,239927,6,280233
6699,0.00185,74.125.24.0-255,1484,241411,6,280233
6700,0.001875,74.125.24.0-255,9992,251403,6,280233
6701,0.001879,172.31.36.0-255,66,251469,6,280233
6702,0.00188,74.125.24.0-255,4320,255789,6,280233
6703,0.001895,172.31.36.0-255,66,255855,6,280233
6704,0.001918,74.125.24.0-255,7856,263711,6,280233
6705,0.001922,74.125.24.0-255,330,264041,6,280233
6706,0.001923,172.31.36.0-255,66,264107,6,280233
6707,0.002812,172.31.36.0-255,66,264173,6,280233
6708,0.00447,74.125.24.0-255,4320,268493,6,280233
6709,0.004478,172.31.36.0-255,66,268559,6,280233
6710,0.005375,74.125.24.0-255,1484,270043,6,280233
6711,0.007051,74.125.24.0-255,4320,274363,6,280233
6712,0.007055,172.31.36.0-255,66,274429,6,280233
6713,0.00964,74.125.24.0-255,5738,280167,6,280233
6714,0.009647,172.31.36.0-255,66,280233,6,280233
6715,0.0,74.125.24.0-255,150,150,6,187206
6716,2.7e-05,172.31.36.0-255,66,216,6,187206
6717,3.4e-05,74.125.24.0-255,1484,1700,6,187206
6718,3.8e-05,172.31.36.0-255,66,1766,6,187206
6719,4.3e-05,74.125.24.0-255,2902,4668,6,187206
6720,4.6e-05,172.31.36.0-255,66,4734,6,187206
6721,5.4e-05,74.125.24.0-255,7156,11890,6,187206
6722,5.6e-05,172.31.36.0-255,66,11956,6,187206
6723,5.9e-05,74.125.24.0-255,1484,13440,6,187206
6724,6.1e-05,172.31.36.0-255,66,13506,6,187206
6725,7.9e-05,74.125.24.0-255,1974,15480,6,187206
6726,8.2e-05,172.31.36.0-255,66,15546,6,187206
6727,9.9e-05,74.125.24.0-255,7156,22702,6,187206
6728,0.000101,172.31.36.0-255,66,22768,6,187206
6729,0.000118,74.125.24.0-255,5738,28506,6,187206
6730,0.000122,172.31.36.0-255,66,28572,6,187206
6731,0.000204,74.125.24.0-255,2543,31115,6,187206
6732,0.000208,172.31.36.0-255,66,31181,6,187206
6733,0.000229,74.125.24.0-255,2902,34083,6,187206
6734,0.000231,172.31.36.0-255,66,34149,6,187206
6735,0.000236,74.125.24.0-255,2902,37051,6,187206
6736,0.000238,172.31.36.0-255,66,37117,6,187206
6737,0.000256,74.125.24.0-255,4320,41437,6,187206
6738,0.000259,172.31.36.0-255,66,41503,6,187206
6739,0.000299,74.125.24.0-255,4320,45823,6,187206
6740,0.000303,172.31.36.0-255,66,45889,6,187206
6741,0.000314,74.125.24.0-255,2543,48432,6,187206
6742,0.000317,172.31.36.0-255,66,48498,6,187206
6743,0.000347,74.125.24.0-255,4320,52818,6,187206
6744,0.00035,172.31.36.0-255,66,52884,6,187206
6745,0.000385,172.31.36.0-255,66,52950,6,187206
6746,0.000446,74.125.24.0-255,113,53063,6,187206
6747,0.000471,74.125.24.0-255,2902,55965,6,187206
6748,0.000475,172.31.36.0-255,66,56031,6,187206
6749,0.000505,74.125.24.0-255,4320,60351,6,187206
6750,0.000508,172.31.36.0-255,66,60417,6,187206
6751,0.00054,74.125.24.0-255,4320,64737,6,187206
6752,0.000545,172.31.36.0-255,66,64803,6,187206
6753,0.000569,74.125.24.0-255,6797,71600,6,187206
6754,0.000573,172.31.36.0-255,66,71666,6,187206
6755,0.000618,74.125.24.0-255,2902,74568,6,187206
6756,0.000621,172.31.36.0-255,66,74634,6,187206
6757,0.000651,172.31.36.0-255,66,74700,6,187206
6758,0.000754,74.125.24.0-255,2902,77602,6,187206
6759,0.000758,172.31.36.0-255,66,77668,6,187206
6760,0.00079,172.31.36.0-255,66,77734,6,187206
6761,0.000869,74.125.24.0-255,2902,80636,6,187206
6762,0.000873,172.31.36.0-255,66,80702,6,187206
6763,0.000894,74.125.24.0-255,7156,87858,6,187206
6764,0.000897,172.31.36.0-255,66,87924,6,187206
6765,0.000928,74.125.24.0-255,7856,95780,6,187206
6766,0.000932,172.31.36.0-255,66,95846,6,187206
6767,0.001009,74.125.24.0-255,5738,101584,6,187206
6768,0.001013,172.31.36.0-255,66,101650,6,187206
6769,0.00105,172.31.36.0-255,66,101716,6,187206
6770,0.001071,74.125.24.0-255,5020,106736,6,187206
6771,0.001074,172.31.36.0-255,66,106802,6,187206
6772,0.001262,74.125.24.0-255,8574,115376,6,187206
6773,0.001266,172.31.36.0-255,66,115442,6,187206
6774,0.001284,74.125.24.0-255,2902,118344,6,187206
6775,0.001286,172.31.36.0-255,66,118410,6,187206
6776,0.001337,74.125.24.0-255,4320,122730,6,187206
6777,0.001341,172.31.36.0-255,66,122796,6,187206
6778,0.001379,172.31.36.0-255,66,122862,6,187206
6779,0.001402,172.31.36.0-255,66,122928,6,187206
6780,0.001645,74.125.24.0-255,4320,127248,6,187206
6781,0.00165,172.31.36.0-255,66,127314,6,187206
6782,0.001666,74.125.24.0-255,7156,134470,6,187206
6783,0.001669,172.31.36.0-255,66,134536,6,187206
6784,0.001696,74.125.24.0-255,5020,139556,6,187206
6785,0.001702,172.31.36.0-255,66,139622,6,187206
6786,0.00178,74.125.24.0-255,2902,142524,6,187206
6787,0.001785,172.31.36.0-255,66,142590,6,187206
6788,0.001805,74.125.24.0-255,4320,146910,6,187206
6789,0.001808,172.31.36.0-255,66,146976,6,187206
6790,0.001864,74.125.24.0-255,4320,151296,6,187206
6791,0.001869,172.31.36.0-255,66,151362,6,187206
6792,0.001896,172.31.36.0-255,66,151428,6,187206
6793,0.001923,74.125.24.0-255,7156,158584,6,187206
6794,0.001926,172.31.36.0-255,66,158650,6,187206
6795,0.002086,74.125.24.0-255,2902,161552,6,187206
6796,0.00209,172.31.36.0-255,66,161618,6,187206
6797,0.002131,172.31.36.0-255,66,161684,6,187206
6798,0.00217,172.31.36.0-255,66,161750,6,187206
6799,0.002402,74.125.24.0-255,1484,163234,6,187206
6800,0.002423,74.125.24.0-255,4320,167554,6,187206
6801,0.002426,172.31.36.0-255,66,167620,6,187206
6802,0.002459,172.31.36.0-255,66,167686,6,187206
6803,0.002502,172.31.36.0-255,66,167752,6,187206
6804,0.002522,74.125.24.0-255,8556,176308,6,187206
6805,0.002525,172.31.36.0-255,66,176374,6,187206
6806,0.00286,74.125.24.0-255,7156,183530,6,187206
6807,0.002866,172.31.36.0-255,66,183596,6,187206
6808,0.002897,172.31.36.0-255,66,183662,6,187206
6809,0.00292,74.125.24.0-255,3171,186833,6,187206
6810,0.002924,172.31.36.0-255,66,186899,6,187206
6811,0.003013,74.125.24.0-255,136,187035,6,187206
6812,0.00743,172.31.36.0-255,66,187101,6,187206
6813,0.007458,172.31.36.0-255,105,187206,6,187206
6814,0.0,74.125.24.0-255,152,152,6,141556
6815,2.7e-05,172.31.36.0-255,66,218,6,141556
6816,3.3e-05,74.125.24.0-255,1484,1702,6,141556
6817,3.7e-05,172.31.36.0-255,66,1768,6,141556
6818,5e-05,74.125.24.0-255,2902,4670,6,141556
6819,5.4e-05,172.31.36.0-255,66,4736,6,141556
6820,6.1e-05,74.125.24.0-255,5738,10474,6,141556
6821,6.3e-05,172.31.36.0-255,66,10540,6,141556
6822,0.000133,74.125.24.0-255,9992,20532,6,141556
6823,0.000138,172.31.36.0-255,66,20598,6,141556
6824,0.000164,74.125.24.0-255,3473,24071,6,141556
6825,0.000168,172.31.36.0-255,66,24137,6,141556
6826,0.000301,74.125.24.0-255,4320,28457,6,141556
6827,0.000306,172.31.36.0-255,66,28523,6,141556
6828,0.000335,74.125.24.0-255,2543,31066,6,141556
6829,0.000338,172.31.36.0-255,66,31132,6,141556
6830,0.000392,74.125.24.0-255,9992,41124,6,141556
6831,0.000396,172.31.36.0-255,66,41190,6,141556
6832,0.000425,74.125.24.0-255,6797,47987,6,141556
6833,0.00043,172.31.36.0-255,66,48053,6,141556
6834,0.000615,172.31.36.0-255,66,48119,6,141556
6835,0.000643,74.125.24.0-255,2902,51021,6,141556
6836,0.000647,172.31.36.0-255,66,51087,6,141556
6837,0.000802,74.125.24.0-255,350,51437,6,141556
6838,0.000805,172.31.36.0-255,66,51503,6,141556
6839,0.000838,74.125.24.0-255,1484,52987,6,141556
6840,0.00084,172.31.36.0-255,66,53053,6,141556
6841,0.000869,74.125.24.0-255,4320,57373,6,141556
6842,0.000872,172.31.36.0-255,66,57439,6,141556
6843,0.000912,74.125.24.0-255,9992,67431,6,141556
6844,0.000916,172.31.36.0-255,66,67497,6,141556
6845,0.001037,74.125.24.0-255,8574,76071,6,141556
6846,0.001041,172.31.36.0-255,66,76137,6,141556
6847,0.001071,74.125.24.0-255,9274,85411,6,141556
6848,0.001074,172.31.36.0-255,66,85477,6,141556
6849,0.001252,74.125.24.0-255,1484,86961,6,141556
6850,0.001279,74.125.24.0-255,2902,89863,6,141556
6851,0.001283,172.31.36.0-255,66,89929,6,141556
6852,0.001315,74.125.24.0-255,5738,95667,6,141556
6853,0.001318,172.31.36.0-255,66,95733,6,141556
6854,0.0014,172.31.36.0-255,66,95799,6,141556
6855,0.001423,74.125.24.0-255,1484,97283,6,141556
6856,0.001552,74.125.24.0-255,2902,100185,6,141556
6857,0.001557,172.31.36.0-255,66,100251,6,141556
6858,0.001586,74.125.24.0-255,7856,108107,6,141556
6859,0.00159,172.31.36.0-255,66,108173,6,141556
6860,0.00169,74.125.24.0-255,2902,111075,6,141556
6861,0.001692,172.31.36.0-255,66,111141,6,141556
6862,0.001743,172.31.36.0-255,66,111207,6,141556
6863,0.00211,74.125.24.0-255,766,111973,6,141556
6864,0.00213,74.125.24.0-255,2902,114875,6,141556
6865,0.002132,172.31.36.0-255,66,114941,6,141556
6866,0.00217,172.31.36.0-255,66,115007,6,141556
6867,0.002349,74.125.24.0-255,4320,119327,6,141556
6868,0.002352,172.31.36.0-255,66,119393,6,141556
6869,0.002377,172.31.36.0-255,66,119459,6,141556
6870,0.002558,74.125.24.0-255,4320,123779,6,141556
6871,0.00256,172.31.36.0-255,66,123845,6,141556
6872,0.002596,172.31.36.0-255,66,123911,6,141556
6873,0.002803,172.31.36.0-255,66,123977,6,141556
6874,0.003366,172.31.36.0-255,101,124078,6,141556
6875,0.005063,74.125.24.0-255,5738,129816,6,141556
6876,0.005068,172.31.36.0-255,66,129882,6,141556
6877,0.005579,74.125.24.0-255,66,129948,6,141556
6878,0.007327,74.125.24.0-255,5738,135686,6,141556
6879,0.007333,172.31.36.0-255,66,135752,6,141556
6880,0.009619,74.125.24.0-255,5738,141490,6,141556
6881,0.009625,172.31.36.0-255,66,141556,6,141556
6882,0.0,74.125.24.0-255,154,154,6,274825
6883,1.6e-05,172.31.36.0-255,66,220,6,274825
6884,2.3e-05,74.125.24.0-255,1484,1704,6,274825
6885,2.6e-05,172.31.36.0-255,66,1770,6,274825
6886,3.2e-05,74.125.24.0-255,2902,4672,6,274825
6887,3.5e-05,172.31.36.0-255,66,4738,6,274825
6888,4.2e-05,74.125.24.0-255,7156,11894,6,274825
6889,4.5e-05,172.31.36.0-255,66,11960,6,274825
6890,7e-05,74.125.24.0-255,2055,14015,6,274825
6891,7.4e-05,172.31.36.0-255,66,14081,6,274825
6892,0.00022,74.125.24.0-255,1484,15565,6,274825
6893,0.000225,172.31.36.0-255,66,15631,6,274825
6894,0.000231,74.125.24.0-255,2902,18533,6,274825
6895,0.000234,172.31.36.0-255,66,18599,6,274825
6896,0.000262,74.125.24.0-255,2902,21501,6,274825
6897,0.000265,172.31.36.0-255,66,21567,6,274825
6898,0.00027,74.125.24.0-255,4320,25887,6,274825
6899,0.000272,172.31.36.0-255,66,25953,6,274825
6900,0.000315,74.125.24.0-255,5379,31332,6,274825
6901,0.000318,172.31.36.0-255,66,31398,6,274825
6902,0.000372,74.125.24.0-255,2902,34300,6,274825
6903,0.000376,172.31.36.0-255,66,34366,6,274825
6904,0.000396,74.125.24.0-255,2902,37268,6,274825
6905,0.000399,172.31.36.0-255,66,37334,6,274825
6906,0.000407,74.125.24.0-255,7156,44490,6,274825
6907,0.00041,172.31.36.0-255,66,44556,6,274825
6908,0.000425,172.31.36.0-255,66,44622,6,274825
6909,0.000446,74.125.24.0-255,5686,50308,6,274825
6910,0.00045,172.31.36.0-255,66,50374,6,274825
6911,0.000453,74.125.24.0-255,113,50487,6,274825
6912,0.000455,172.31.36.0-255,66,50553,6,274825
6913,0.000467,74.125.24.0-255,331,50884,6,274825
6914,0.000871,172.31.36.0-255,66,50950,6,274825
6915,0.001396,74.125.24.0-255,1484,52434,6,274825
6916,0.001406,74.125.24.0-255,2902,55336,6,274825
6917,0.00141,172.31.36.0-255,66,55402,6,274825
6918,0.001419,74.125.24.0-255,5738,61140,6,274825
6919,0.001421,172.31.36.0-255,66,61206,6,274825
6920,0.001444,74.125.24.0-255,8574,69780,6,274825
6921,0.001446,172.31.36.0-255,66,69846,6,274825
6922,0.001476,74.125.24.0-255,4320,74166,6,274825
6923,0.001478,172.31.36.0-255,66,74232,6,274825
6924,0.001487,74.125.24.0-255,9992,84224,6,274825
6925,0.001489,172.31.36.0-255,66,84290,6,274825
6926,0.001492,74.125.24.0-255,766,85056,6,274825
6927,0.00158,74.125.24.0-255,1484,86540,6,274825
6928,0.001584,172.31.36.0-255,66,86606,6,274825
6929,0.001603,74.125.24.0-255,2902,89508,6,274825
6930,0.001605,172.31.36.0-255,66,89574,6,274825
6931,0.001644,74.125.24.0-255,5738,95312,6,274825
6932,0.001648,172.31.36.0-255,66,95378,6,274825
6933,0.001656,74.125.24.0-255,8574,103952,6,274825
6934,0.001658,172.31.36.0-255,66,104018,6,274825
6935,0.001685,74.125.24.0-255,4320,108338,6,274825
6936,0.001687,172.31.36.0-255,66,108404,6,274825
6937,0.00169,74.125.24.0-255,1484,109888,6,274825
6938,0.001694,74.125.24.0-255,2902,112790,6,274825
6939,0.001697,172.31.36.0-255,66,112856,6,274825
6940,0.001702,74.125.24.0-255,5738,118594,6,274825
6941,0.001704,172.31.36.0-255,66,118660,6,274825
6942,0.001707,74.125.24.0-255,766,119426,6,274825
6943,0.001752,74.125.24.0-255,8574,128000,6,274825
6944,0.001757,172.31.36.0-255,66,128066,6,274825
6945,0.001821,172.31.36.0-255,66,128132,6,274825
6946,0.001834,172.31.36.0-255,66,128198,6,274825
6947,0.001894,74.125.24.0-255,1484,129682,6,274825
6948,0.001897,74.125.24.0-255,1484,131166,6,274825
6949,0.001899,172.31.36.0-255,66,131232,6,274825
6950,0.001919,74.125.24.0-255,1484,132716,6,274825
6951,0.001924,74.125.24.0-255,5738,138454,6,274825
6952,0.001926,172.31.36.0-255,66,138520,6,274825
6953,0.001931,74.125.24.0-255,2902,141422,6,274825
6954,0.001933,172.31.36.0-255,66,141488,6,274825
6955,0.001952,74.125.24.0-255,9992,151480,6,274825
6956,0.001954,172.31.36.0-255,66,151546,6,274825
6957,0.001967,74.125.24.0-255,4320,155866,6,274825
6958,0.001969,172.31.36.0-255,66,155932,6,274825
6959,0.001986,74.125.24.0-255,6438,162370,6,274825
6960,0.001989,172.31.36.0-255,66,162436,6,274825
6961,0.00203,74.125.24.0-255,1484,163920,6,274825
6962,0.002045,74.125.24.0-255,2902,166822,6,274825
6963,0.002048,172.31.36.0-255,66,166888,6,274825
6964,0.002053,74.125.24.0-255,5738,172626,6,274825
6965,0.002056,172.31.36.0-255,66,172692,6,274825
6966,0.002059,74.125.24.0-255,2902,175594,6,274825
6967,0.002075,74.125.24.0-255,2902,178496,6,274825
6968,0.002092,74.125.24.0-255,4320,182816,6,274825
6969,0.002111,74.125.24.0-255,8574,191390,6,274825
6970,0.002127,74.125.24.0-255,4320,195710,6,274825
6971,0.002153,74.125.24.0-255,10692,206402,6,274825
6972,0.002164,74.125.24.0-255,1484,207886,6,274825
6973,0.002185,74.125.24.0-255,5738,213624,6,274825
6974,0.002212,74.125.24.0-255,8574,222198,6,274825
6975,0.00222,74.125.24.0-255,7856,230054,6,274825
6976,0.002226,74.125.24.0-255,5738,235792,6,274825
6977,0.002236,74.125.24.0-255,1484,237276,6,274825
6978,0.002254,74.125.24.0-255,5738,243014,6,274825
6979,0.002258,74.125.24.0-255,2902,245916,6,274825
6980,0.002287,74.125.24.0-255,6438,252354,6,274825
6981,0.00233,74.125.24.0-255,4320,256674,6,274825
6982,0.002367,74.125.24.0-255,1484,258158,6,274825
6983,0.002452,74.125.24.0-255,4320,262478,6,274825
6984,0.002454,74.125.24.0-255,1484,263962,6,274825
6985,0.002543,74.125.24.0-255,5738,269700,6,274825
6986,0.00256,74.125.24.0-255,4954,274654,6,274825
6987,0.00552,172.31.36.0-255,66,274720,6,274825
6988,0.008093,172.31.36.0-255,105,274825,6,274825
6989,0.0,74.125.200.0-255,153,153,6,115903
6990,3.2e-05,172.31.36.0-255,66,219,6,115903
6991,4e-05,74.125.200.0-255,1484,1703,6,115903
6992,4.4e-05,172.31.36.0-255,66,1769,6,115903
6993,4.8e-05,74.125.200.0-255,2902,4671,6,115903
6994,5e-05,172.31.36.0-255,66,4737,6,115903
6995,5.5e-05,74.125.200.0-255,4320,9057,6,115903
6996,5.7e-05,172.31.36.0-255,66,9123,6,115903
6997,8.8e-05,74.125.200.0-255,4908,14031,6,115903
6998,9.1e-05,172.31.36.0-255,66,14097,6,115903
6999,0.00034,74.125.200.0-255,1484,15581,6,115903
7000,0.000345,172.31.36.0-255,66,15647,6,115903
7001,0.000351,74.125.200.0-255,2902,18549,6,115903
7002,0.000353,172.31.36.0-255,66,18615,6,115903
7003,0.000369,74.125.200.0-255,4320,22935,6,115903
7004,0.000372,172.31.36.0-255,66,23001,6,115903
7005,0.000396,74.125.200.0-255,1484,24485,6,115903
7006,0.000401,74.125.200.0-255,5738,30223,6,115903
7007,0.000401,172.31.36.0-255,66,30289,6,115903
7008,0.000406,172.31.36.0-255,66,30355,6,115903
7009,0.000428,74.125.200.0-255,1125,31480,6,115903
7010,0.000433,172.31.36.0-255,66,31546,6,115903
7011,0.00046,74.125.200.0-255,1484,33030,6,115903
7012,0.000464,172.31.36.0-255,66,33096,6,115903
7013,0.000474,74.125.200.0-255,4320,37416,6,115903
7014,0.000476,172.31.36.0-255,66,37482,6,115903
7015,0.000502,74.125.200.0-255,4320,41802,6,115903
7016,0.000505,172.31.36.0-255,66,41868,6,115903
7017,0.000527,74.125.200.0-255,5738,47606,6,115903
7018,0.00053,172.31.36.0-255,66,47672,6,115903
7019,0.000545,74.125.200.0-255,1125,48797,6,115903
7020,0.000547,172.31.36.0-255,66,48863,6,115903
7021,0.001658,74.125.200.0-255,1484,50347,6,115903
7022,0.001668,74.125.200.0-255,2902,53249,6,115903
7023,0.001672,172.31.36.0-255,66,53315,6,115903
7024,0.001677,74.125.200.0-255,1484,54799,6,115903
7025,0.00168,74.125.200.0-255,1484,56283,6,115903
7026,0.001682,172.31.36.0-255,66,56349,6,115903
7027,0.001694,74.125.200.0-255,1484,57833,6,115903
7028,0.001709,74.125.200.0-255,5738,63571,6,115903
7029,0.001711,172.31.36.0-255,66,63637,6,115903
7030,0.001732,74.125.200.0-255,2543,66180,6,115903
7031,0.001734,172.31.36.0-255,66,66246,6,115903
7032,0.001773,74.125.200.0-255,645,66891,6,115903
7033,0.001805,74.125.200.0-255,1484,68375,6,115903
7034,0.001807,172.31.36.0-255,66,68441,6,115903
7035,0.001821,74.125.200.0-255,4320,72761,6,115903
7036,0.001823,172.31.36.0-255,66,72827,6,115903
7037,0.001845,74.125.200.0-255,5738,78565,6,115903
7038,0.001847,172.31.36.0-255,66,78631,6,115903
7039,0.001868,74.125.200.0-255,4320,82951,6,115903
7040,0.001871,172.31.36.0-255,66,83017,6,115903
7041,0.001887,74.125.200.0-255,7156,90173,6,115903
7042,0.00189,172.31.36.0-255,66,90239,6,115903
7043,0.001893,74.125.200.0-255,2902,93141,6,115903
7044,0.001895,172.31.36.0-255,66,93207,6,115903
7045,0.001938,74.125.200.0-255,1484,94691,6,115903
7046,0.001962,74.125.200.0-255,6438,101129,6,115903
7047,0.001964,172.31.36.0-255,66,101195,6,115903
7048,0.004497,74.125.200.0-255,4320,105515,6,115903
7049,0.004502,172.31.36.0-255,66,105581,6,115903
7050,0.004518,74.125.200.0-255,1484,107065,6,115903
7051,0.00704,74.125.200.0-255,2902,109967,6,115903
7052,0.007046,172.31.36.0-255,66,110033,6,115903
7053,0.007065,74.125.200.0-255,1484,111517,6,115903
7054,0.009684,74.125.200.0-255,4320,115837,6,115903
7055,0.009692,172.31.36.0-255,66,115903,6,115903
7056,0.0,172.217.27.0-255,146,146,6,94356
7057,3.1e-05,172.31.36.0-255,66,212,6,94356
7058,3.8e-05,172.217.27.0-255,1484,1696,6,94356
7059,4.3e-05,172.31.36.0-255,66,1762,6,94356
7060,4.9e-05,172.217.27.0-255,2902,4664,6,94356
7061,5.9e-05,172.31.36.0-255,66,4730,6,94356
7062,6.3e-05,172.217.27.0-255,2902,7632,6,94356
7063,6.5e-05,172.31.36.0-255,66,7698,6,94356
7064,0.000102,172.217.27.0-255,4320,12018,6,94356
7065,0.000105,172.31.36.0-255,66,12084,6,94356
7066,0.00011,172.217.27.0-255,1965,14049,6,94356
7067,0.000112,172.31.36.0-255,66,14115,6,94356
7068,0.000116,172.217.27.0-255,2902,17017,6,94356
7069,0.000118,172.31.36.0-255,66,17083,6,94356
7070,0.000128,172.217.27.0-255,2902,19985,6,94356
7071,0.000131,172.31.36.0-255,66,20051,6,94356
7072,0.000137,172.217.27.0-255,4320,24371,6,94356
7073,0.000139,172.31.36.0-255,66,24437,6,94356
7074,0.000176,172.217.27.0-255,6797,31234,6,94356
7075,0.000179,172.31.36.0-255,66,31300,6,94356
7076,0.000254,172.217.27.0-255,1484,32784,6,94356
7077,0.000258,172.31.36.0-255,66,32850,6,94356
7078,0.000275,172.217.27.0-255,2902,35752,6,94356
7079,0.000278,172.31.36.0-255,66,35818,6,94356
7080,0.000284,172.217.27.0-255,5738,41556,6,94356
7081,0.000288,172.31.36.0-255,66,41622,6,94356
7082,0.000323,172.217.27.0-255,2902,44524,6,94356
7083,0.000327,172.31.36.0-255,66,44590,6,94356
7084,0.000347,172.217.27.0-255,3961,48551,6,94356
7085,0.00035,172.31.36.0-255,66,48617,6,94356
7086,0.000358,172.217.27.0-255,8574,57191,6,94356
7087,0.000361,172.31.36.0-255,66,57257,6,94356
7088,0.000365,172.217.27.0-255,2902,60159,6,94356
7089,0.000377,172.31.36.0-255,66,60225,6,94356
7090,0.000405,172.217.27.0-255,5689,65914,6,94356
7091,0.00041,172.31.36.0-255,66,65980,6,94356
7092,0.001719,172.217.27.0-255,114,66094,6,94356
7093,0.001758,172.217.27.0-255,1484,67578,6,94356
7094,0.001763,172.31.36.0-255,66,67644,6,94356
7095,0.002107,172.217.27.0-255,2902,70546,6,94356
7096,0.002135,172.31.36.0-255,66,70612,6,94356
7097,0.00344,172.217.27.0-255,2902,73514,6,94356
7098,0.003445,172.31.36.0-255,66,73580,6,94356
7099,0.003826,172.217.27.0-255,2902,76482,6,94356
7100,0.003831,172.31.36.0-255,66,76548,6,94356
7101,0.00511,172.217.27.0-255,2902,79450,6,94356
7102,0.005115,172.31.36.0-255,66,79516,6,94356
7103,0.005496,172.217.27.0-255,2902,82418,6,94356
7104,0.005501,172.31.36.0-255,66,82484,6,94356
7105,0.006817,172.217.27.0-255,2902,85386,6,94356
7106,0.006824,172.31.36.0-255,66,85452,6,94356
7107,0.007202,172.217.27.0-255,2902,88354,6,94356
7108,0.007208,172.31.36.0-255,66,88420,6,94356
7109,0.008513,172.217.27.0-255,2902,91322,6,94356
7110,0.00852,172.31.36.0-255,66,91388,6,94356
7111,0.008879,172.217.27.0-255,2902,94290,6,94356
7112,0.008885,172.31.36.0-255,66,94356,6,94356
7113,0.0,172.217.24.0-255,153,153,6,124693
7114,2.9e-05,172.31.36.0-255,66,219,6,124693
7115,3.6e-05,172.217.24.0-255,1484,1703,6,124693
7116,4.1e-05,172.31.36.0-255,66,1769,6,124693
7117,5.6e-05,172.217.24.0-255,1484,3253,6,124693
7118,5.9e-05,172.31.36.0-255,66,3319,6,124693
7119,6.5e-05,172.217.24.0-255,2902,6221,6,124693
7120,6.8e-05,172.31.36.0-255,66,6287,6,124693
7121,7.1e-05,172.217.24.0-255,1484,7771,6,124693
7122,7.3e-05,172.31.36.0-255,66,7837,6,124693
7123,8.6e-05,172.217.24.0-255,1484,9321,6,124693
7124,8.8e-05,172.31.36.0-255,66,9387,6,124693
7125,9.4e-05,172.217.24.0-255,4320,13707,6,124693
7126,9.7e-05,172.31.36.0-255,66,13773,6,124693
7127,0.000135,172.217.24.0-255,9155,22928,6,124693
7128,0.000139,172.31.36.0-255,66,22994,6,124693
7129,0.000184,172.217.24.0-255,5738,28732,6,124693
7130,0.000187,172.31.36.0-255,66,28798,6,124693
7131,0.000206,172.217.24.0-255,2543,31341,6,124693
7132,0.000208,172.31.36.0-255,66,31407,6,124693
7133,0.000327,172.217.24.0-255,1484,32891,6,124693
7134,0.000332,172.31.36.0-255,66,32957,6,124693
7135,0.000337,172.217.24.0-255,2902,35859,6,124693
7136,0.000343,172.31.36.0-255,66,35925,6,124693
7137,0.00035,172.217.24.0-255,1484,37409,6,124693
7138,0.000352,172.31.36.0-255,66,37475,6,124693
7139,0.000378,172.217.24.0-255,4320,41795,6,124693
7140,0.000381,172.31.36.0-255,66,41861,6,124693
7141,0.000387,172.217.24.0-255,4320,46181,6,124693
7142,0.00039,172.31.36.0-255,66,46247,6,124693
7143,0.000404,172.217.24.0-255,2543,48790,6,124693
7144,0.000407,172.31.36.0-255,66,48856,6,124693
7145,0.000414,172.217.24.0-255,7156,56012,6,124693
7146,0.000417,172.31.36.0-255,66,56078,6,124693
7147,0.000437,172.217.24.0-255,4320,60398,6,124693
7148,0.00044,172.31.36.0-255,66,60464,6,124693
7149,0.000462,172.217.24.0-255,4320,64784,6,124693
7150,0.000465,172.31.36.0-255,66,64850,6,124693
7151,0.000479,172.217.24.0-255,1390,66240,6,124693
7152,0.000795,172.31.36.0-255,66,66306,6,124693
7153,0.001701,172.217.24.0-255,141,66447,6,124693
7154,0.001752,172.31.36.0-255,66,66513,6,124693
7155,0.001815,172.217.24.0-255,1484,67997,6,124693
7156,0.001833,172.217.24.0-255,2902,70899,6,124693
7157,0.001837,172.31.36.0-255,66,70965,6,124693
7158,0.001843,172.217.24.0-255,5738,76703,6,124693
7159,0.001845,172.31.36.0-255,66,76769,6,124693
7160,0.001851,172.217.24.0-255,5738,82507,6,124693
7161,0.001853,172.31.36.0-255,66,82573,6,124693
7162,0.0019,172.217.24.0-255,1125,83698,6,124693
7163,0.001904,172.217.24.0-255,1484,85182,6,124693
7164,0.001906,172.31.36.0-255,66,85248,6,124693
7165,0.001912,172.217.24.0-255,4320,89568,6,124693
7166,0.001914,172.31.36.0-255,66,89634,6,124693
7167,0.001949,172.217.24.0-255,9992,99626,6,124693
7168,0.001952,172.31.36.0-255,66,99692,6,124693
7169,0.001955,172.217.24.0-255,1125,100817,6,124693
7170,0.002117,172.31.36.0-255,66,100883,6,124693
7171,0.003882,172.217.24.0-255,2902,103785,6,124693
7172,0.003887,172.31.36.0-255,66,103851,6,124693
7173,0.003913,172.217.24.0-255,1484,105335,6,124693
7174,0.004049,172.217.24.0-255,1484,106819,6,124693
7175,0.004053,172.31.36.0-255,66,106885,6,124693
7176,0.005821,172.217.24.0-255,2902,109787,6,124693
7177,0.005825,172.31.36.0-255,66,109853,6,124693
7178,0.005985,172.217.24.0-255,2902,112755,6,124693
7179,0.005989,172.31.36.0-255,66,112821,6,124693
7180,0.007776,172.217.24.0-255,2902,115723,6,124693
7181,0.007782,172.31.36.0-255,66,115789,6,124693
7182,0.007924,172.217.24.0-255,2902,118691,6,124693
7183,0.007929,172.31.36.0-255,66,118757,6,124693
7184,0.009719,172.217.24.0-255,2902,121659,6,124693
7185,0.009727,172.31.36.0-255,66,121725,6,124693
7186,0.00985,172.217.24.0-255,2902,124627,6,124693
7187,0.009855,172.31.36.0-255,66,124693,6,124693
7188,0.0,172.217.194.0-255,172,172,6,222239
7189,2.7e-05,172.31.36.0-255,66,238,6,222239
7190,3.3e-05,172.217.194.0-255,1484,1722,6,222239
7191,3.8e-05,172.31.36.0-255,66,1788,6,222239
7192,4.3e-05,172.217.194.0-255,2902,4690,6,222239
7193,4.6e-05,172.31.36.0-255,66,4756,6,222239
7194,6.1e-05,172.217.194.0-255,7156,11912,6,222239
7195,6.4e-05,172.31.36.0-255,66,11978,6,222239
7196,0.000107,172.31.36.0-255,66,12044,6,222239
7197,0.000112,172.217.194.0-255,2543,14587,6,222239
7198,0.000114,172.31.36.0-255,66,14653,6,222239
7199,0.000265,172.217.194.0-255,1484,16137,6,222239
7200,0.000271,172.31.36.0-255,66,16203,6,222239
7201,0.000276,172.217.194.0-255,2902,19105,6,222239
7202,0.000279,172.31.36.0-255,66,19171,6,222239
7203,0.000285,172.217.194.0-255,4320,23491,6,222239
7204,0.000294,172.31.36.0-255,66,23557,6,222239
7205,0.000322,172.217.194.0-255,1484,25041,6,222239
7206,0.000325,172.31.36.0-255,66,25107,6,222239
7207,0.000341,172.31.36.0-255,66,25173,6,222239
7208,0.00035,172.217.194.0-255,9633,34806,6,222239
7209,0.000352,172.31.36.0-255,66,34872,6,222239
7210,0.000709,172.217.194.0-255,364,35236,6,222239
7211,0.000714,172.31.36.0-255,66,35302,6,222239
7212,0.000736,172.217.194.0-255,379,35681,6,222239
7213,0.000738,172.31.36.0-255,66,35747,6,222239
7214,0.001154,172.217.194.0-255,1484,37231,6,222239
7215,0.001161,172.31.36.0-255,66,37297,6,222239
7216,0.001169,172.217.194.0-255,1484,38781,6,222239
7217,0.00117,172.31.36.0-255,66,38847,6,222239
7218,0.001205,172.217.194.0-255,1484,40331,6,222239
7219,0.001213,172.217.194.0-255,5738,46069,6,222239
7220,0.001216,172.31.36.0-255,66,46135,6,222239
7221,0.001228,172.31.36.0-255,66,46201,6,222239
7222,0.00124,172.217.194.0-255,1484,47685,6,222239
7223,0.001274,172.217.194.0-255,10692,58377,6,222239
7224,0.001277,172.31.36.0-255,66,58443,6,222239
7225,0.001789,172.217.194.0-255,1484,59927,6,222239
7226,0.001797,172.217.194.0-255,2902,62829,6,222239
7227,0.001801,172.31.36.0-255,66,62895,6,222239
7228,0.001808,172.217.194.0-255,5738,68633,6,222239
7229,0.001809,172.31.36.0-255,66,68699,6,222239
7230,0.001844,172.31.36.0-255,66,68765,6,222239
7231,0.001893,172.31.36.0-255,66,68831,6,222239
7232,0.001922,172.217.194.0-255,1484,70315,6,222239
7233,0.001935,172.217.194.0-255,2902,73217,6,222239
7234,0.001938,172.31.36.0-255,66,73283,6,222239
7235,0.001943,172.217.194.0-255,4320,77603,6,222239
7236,0.001945,172.31.36.0-255,66,77669,6,222239
7237,0.001966,172.217.194.0-255,1484,79153,6,222239
7238,0.001971,172.217.194.0-255,4320,83473,6,222239
7239,0.001973,172.31.36.0-255,66,83539,6,222239
7240,0.002,172.217.194.0-255,8574,92113,6,222239
7241,0.002003,172.31.36.0-255,66,92179,6,222239
7242,0.002011,172.217.194.0-255,9992,102171,6,222239
7243,0.002013,172.31.36.0-255,66,102237,6,222239
7244,0.002016,172.217.194.0-255,766,103003,6,222239
7245,0.002088,172.217.194.0-255,1484,104487,6,222239
7246,0.002091,172.31.36.0-255,66,104553,6,222239
7247,0.002096,172.217.194.0-255,2902,107455,6,222239
7248,0.002097,172.31.36.0-255,66,107521,6,222239
7249,0.002101,172.217.194.0-255,1484,109005,6,222239
7250,0.002125,172.217.194.0-255,4320,113325,6,222239
7251,0.002128,172.31.36.0-255,66,113391,6,222239
7252,0.002133,172.217.194.0-255,5738,119129,6,222239
7253,0.002135,172.31.36.0-255,66,119195,6,222239
7254,0.002171,172.217.194.0-255,7156,126351,6,222239
7255,0.002174,172.31.36.0-255,66,126417,6,222239
7256,0.002182,172.217.194.0-255,10692,137109,6,222239
7257,0.002185,172.31.36.0-255,66,137175,6,222239
7258,0.002235,172.217.194.0-255,1484,138659,6,222239
7259,0.002237,172.217.194.0-255,1484,140143,6,222239
7260,0.002239,172.31.36.0-255,66,140209,6,222239
7261,0.002268,172.217.194.0-255,1484,141693,6,222239
7262,0.002273,172.217.194.0-255,5738,147431,6,222239
7263,0.002275,172.31.36.0-255,66,147497,6,222239
7264,0.002292,172.31.36.0-255,66,147563,6,222239
7265,0.002317,172.217.194.0-255,5738,153301,6,222239
7266,0.002319,172.31.36.0-255,66,153367,6,222239
7267,0.002349,172.217.194.0-255,5020,158387,6,222239
7268,0.002352,172.31.36.0-255,66,158453,6,222239
7269,0.002379,172.217.194.0-255,1484,159937,6,222239
7270,0.002392,172.217.194.0-255,2902,162839,6,222239
7271,0.002395,172.31.36.0-255,66,162905,6,222239
7272,0.002422,172.217.194.0-255,5738,168643,6,222239
7273,0.002426,172.31.36.0-255,66,168709,6,222239
7274,0.002432,172.217.194.0-255,7156,175865,6,222239
7275,0.002439,172.31.36.0-255,66,175931,6,222239
7276,0.002459,172.217.194.0-255,2902,178833,6,222239
7277,0.002461,172.31.36.0-255,66,178899,6,222239
7278,0.002467,172.217.194.0-255,5738,184637,6,222239
7279,0.002469,172.31.36.0-255,66,184703,6,222239
7280,0.002483,172.217.194.0-255,5738,190441,6,222239
7281,0.002486,172.31.36.0-255,66,190507,6,222239
7282,0.002512,172.217.194.0-255,2184,192691,6,222239
7283,0.002515,172.31.36.0-255,66,192757,6,222239
7284,0.002574,172.217.194.0-255,1484,194241,6,222239
7285,0.002578,172.217.194.0-255,2902,197143,6,222239
7286,0.00258,172.31.36.0-255,66,197209,6,222239
7287,0.002608,172.217.194.0-255,5738,202947,6,222239
7288,0.00261,172.31.36.0-255,66,203013,6,222239
7289,0.002615,172.217.194.0-255,4320,207333,6,222239
7290,0.002616,172.31.36.0-255,66,207399,6,222239
7291,0.002621,172.217.194.0-255,2902,210301,6,222239
7292,0.002627,172.31.36.0-255,66,210367,6,222239
7293,0.005179,172.217.194.0-255,2902,213269,6,222239
7294,0.005185,172.31.36.0-255,66,213335,6,222239
7295,0.005213,172.217.194.0-255,2902,216237,6,222239
7296,0.005216,172.31.36.0-255,66,216303,6,222239
7297,0.007776,172.217.194.0-255,2902,219205,6,222239
7298,0.007783,172.31.36.0-255,66,219271,6,222239
7299,0.007807,172.217.194.0-255,2902,222173,6,222239
7300,0.007809,172.31.36.0-255,66,222239,6,222239
7301,0.0,172.217.194.0-255,153,153,6,254394
7302,3.1e-05,172.31.36.0-255,66,219,6,254394
7303,3.7e-05,172.217.194.0-255,1484,1703,6,254394
7304,4.1e-05,172.31.36.0-255,66,1769,6,254394
7305,4.4e-05,172.217.194.0-255,1484,3253,6,254394
7306,4.7e-05,172.31.36.0-255,66,3319,6,254394
7307,6e-05,172.217.194.0-255,4320,7639,6,254394
7308,6.3e-05,172.31.36.0-255,66,7705,6,254394
7309,0.000101,172.217.194.0-255,10554,18259,6,254394
7310,0.000114,172.31.36.0-255,66,18325,6,254394
7311,0.000122,172.217.194.0-255,8574,26899,6,254394
7312,0.00013,172.31.36.0-255,66,26965,6,254394
7313,0.000135,172.217.194.0-255,3961,30926,6,254394
7314,0.000137,172.31.36.0-255,66,30992,6,254394
7315,0.000427,172.217.194.0-255,1484,32476,6,254394
7316,0.000431,172.31.36.0-255,66,32542,6,254394
7317,0.000437,172.217.194.0-255,2902,35444,6,254394
7318,0.00044,172.31.36.0-255,66,35510,6,254394
7319,0.000471,172.217.194.0-255,5738,41248,6,254394
7320,0.000474,172.31.36.0-255,66,41314,6,254394
7321,0.000498,172.217.194.0-255,4320,45634,6,254394
7322,0.000501,172.31.36.0-255,66,45700,6,254394
7323,0.000531,172.217.194.0-255,9633,55333,6,254394
7324,0.000534,172.31.36.0-255,66,55399,6,254394
7325,0.000573,172.217.194.0-255,9923,65322,6,254394
7326,0.000576,172.31.36.0-255,66,65388,6,254394
7327,0.000579,172.217.194.0-255,99,65487,6,254394
7328,0.000581,172.31.36.0-255,66,65553,6,254394
7329,0.000623,172.217.194.0-255,1484,67037,6,254394
7330,0.000626,172.31.36.0-255,66,67103,6,254394
7331,0.000631,172.217.194.0-255,2902,70005,6,254394
7332,0.000633,172.31.36.0-255,66,70071,6,254394
7333,0.000636,172.217.194.0-255,1484,71555,6,254394
7334,0.00066,172.217.194.0-255,5738,77293,6,254394
7335,0.000665,172.31.36.0-255,66,77359,6,254394
7336,0.000705,172.31.36.0-255,66,77425,6,254394
7337,0.000709,172.217.194.0-255,2902,80327,6,254394
7338,0.000712,172.31.36.0-255,66,80393,6,254394
7339,0.00074,172.217.194.0-255,5317,85710,6,254394
7340,0.000744,172.31.36.0-255,66,85776,6,254394
7341,0.001341,172.217.194.0-255,1484,87260,6,254394
7342,0.00135,172.217.194.0-255,2902,90162,6,254394
7343,0.001354,172.31.36.0-255,66,90228,6,254394
7344,0.001361,172.217.194.0-255,5738,95966,6,254394
7345,0.001364,172.31.36.0-255,66,96032,6,254394
7346,0.001428,172.31.36.0-255,66,96098,6,254394
7347,0.001438,172.217.194.0-255,10692,106790,6,254394
7348,0.001447,172.31.36.0-255,66,106856,6,254394
7349,0.001536,172.217.194.0-255,1484,108340,6,254394
7350,0.001551,172.217.194.0-255,2902,111242,6,254394
7351,0.001555,172.31.36.0-255,66,111308,6,254394
7352,0.00156,172.217.194.0-255,2902,114210,6,254394
7353,0.001562,172.31.36.0-255,66,114276,6,254394
7354,0.0016,172.217.194.0-255,7156,121432,6,254394
7355,0.001605,172.31.36.0-255,66,121498,6,254394
7356,0.001646,172.31.36.0-255,66,121564,6,254394
7357,0.001669,172.217.194.0-255,3602,125166,6,254394
7358,0.001671,172.31.36.0-255,66,125232,6,254394
7359,0.001674,172.217.194.0-255,1484,126716,6,254394
7360,0.001695,172.217.194.0-255,2902,129618,6,254394
7361,0.001697,172.31.36.0-255,66,129684,6,254394
7362,0.001703,172.217.194.0-255,4320,134004,6,254394
7363,0.001705,172.31.36.0-255,66,134070,6,254394
7364,0.001738,172.217.194.0-255,5738,139808,6,254394
7365,0.00174,172.31.36.0-255,66,139874,6,254394
7366,0.001745,172.217.194.0-255,4320,144194,6,254394
7367,0.001747,172.31.36.0-255,66,144260,6,254394
7368,0.001769,172.217.194.0-255,1484,145744,6,254394
7369,0.001792,172.31.36.0-255,66,145810,6,254394
7370,0.001813,172.217.194.0-255,2184,147994,6,254394
7371,0.001815,172.31.36.0-255,66,148060,6,254394
7372,0.001818,172.217.194.0-255,1484,149544,6,254394
7373,0.001822,172.217.194.0-255,2902,152446,6,254394
7374,0.001824,172.31.36.0-255,66,152512,6,254394
7375,0.00185,172.217.194.0-255,5738,158250,6,254394
7376,0.001853,172.31.36.0-255,66,158316,6,254394
7377,0.001881,172.217.194.0-255,9992,168308,6,254394
7378,0.001884,172.31.36.0-255,66,168374,6,254394
7379,0.00191,172.217.194.0-255,2902,171276,6,254394
7380,0.001912,172.31.36.0-255,66,171342,6,254394
7381,0.001929,172.217.194.0-255,2902,174244,6,254394
7382,0.001931,172.31.36.0-255,66,174310,6,254394
7383,0.001958,172.217.194.0-255,7856,182166,6,254394
7384,0.001961,172.31.36.0-255,66,182232,6,254394
7385,0.001965,172.217.194.0-255,2902,185134,6,254394
7386,0.001967,172.31.36.0-255,66,185200,6,254394
7387,0.001997,172.217.194.0-255,4320,189520,6,254394
7388,0.002,172.31.36.0-255,66,189586,6,254394
7389,0.002004,172.217.194.0-255,2902,192488,6,254394
7390,0.002006,172.31.36.0-255,66,192554,6,254394
7391,0.002041,172.217.194.0-255,5738,198292,6,254394
7392,0.002043,172.31.36.0-255,66,198358,6,254394
7393,0.002053,172.217.194.0-255,4320,202678,6,254394
7394,0.002062,172.31.36.0-255,66,202744,6,254394
7395,0.002077,172.217.194.0-255,2902,205646,6,254394
7396,0.002079,172.31.36.0-255,66,205712,6,254394
7397,0.002114,172.217.194.0-255,10692,216404,6,254394
7398,0.002117,172.31.36.0-255,66,216470,6,254394
7399,0.002262,172.217.194.0-255,1484,217954,6,254394
7400,0.002291,172.217.194.0-255,2902,220856,6,254394
7401,0.002295,172.31.36.0-255,66,220922,6,254394
7402,0.00233,172.217.194.0-255,5738,226660,6,254394
7403,0.002333,172.31.36.0-255,66,226726,6,254394
7404,0.002335,172.217.194.0-255,1484,228210,6,254394
7405,0.002343,172.217.194.0-255,8574,236784,6,254394
7406,0.002345,172.31.36.0-255,66,236850,6,254394
7407,0.002353,172.217.194.0-255,1484,238334,6,254394
7408,0.004685,172.217.194.0-255,4320,242654,6,254394
7409,0.004691,172.31.36.0-255,66,242720,6,254394
7410,0.007022,172.217.194.0-255,5738,248458,6,254394
7411,0.007031,172.31.36.0-255,66,248524,6,254394
7412,0.009336,172.217.194.0-255,4320,252844,6,254394
7413,0.009343,172.31.36.0-255,66,252910,6,254394
7414,0.009367,172.217.194.0-255,1484,254394,6,254394
7415,0.0,74.125.24.0-255,153,153,6,257543
7416,3.8e-05,172.31.36.0-255,66,219,6,257543
7417,4.4e-05,74.125.24.0-255,1484,1703,6,257543
7418,4.9e-05,172.31.36.0-255,66,1769,6,257543
7419,6.2e-05,74.125.24.0-255,2902,4671,6,257543
7420,6.6e-05,172.31.36.0-255,66,4737,6,257543
7421,7.3e-05,74.125.24.0-255,5738,10475,6,257543
7422,7.5e-05,172.31.36.0-255,66,10541,6,257543
7423,8.3e-05,74.125.24.0-255,7639,18180,6,257543
7424,8.6e-05,172.31.36.0-255,66,18246,6,257543
7425,0.000124,74.125.24.0-255,8574,26820,6,257543
7426,0.000127,172.31.36.0-255,66,26886,6,257543
7427,0.000132,74.125.24.0-255,3961,30847,6,257543
7428,0.000135,172.31.36.0-255,66,30913,6,257543
7429,0.000201,74.125.24.0-255,1484,32397,6,257543
7430,0.000204,172.31.36.0-255,66,32463,6,257543
7431,0.000209,74.125.24.0-255,2902,35365,6,257543
7432,0.000211,172.31.36.0-255,66,35431,6,257543
7433,0.000255,74.125.24.0-255,5738,41169,6,257543
7434,0.000258,172.31.36.0-255,66,41235,6,257543
7435,0.000265,74.125.24.0-255,6797,48032,6,257543
7436,0.000267,172.31.36.0-255,66,48098,6,257543
7437,0.000288,172.31.36.0-255,66,48164,6,257543
7438,0.000292,74.125.24.0-255,2853,51017,6,257543
7439,0.000295,172.31.36.0-255,66,51083,6,257543
7440,0.000298,74.125.24.0-255,378,51461,6,257543
7441,0.0003,172.31.36.0-255,66,51527,6,257543
7442,0.000567,74.125.24.0-255,1484,53011,6,257543
7443,0.000572,172.31.36.0-255,66,53077,6,257543
7444,0.000578,74.125.24.0-255,2902,55979,6,257543
7445,0.000581,172.31.36.0-255,66,56045,6,257543
7446,0.000594,74.125.24.0-255,5738,61783,6,257543
7447,0.000599,172.31.36.0-255,66,61849,6,257543
7448,0.000647,172.31.36.0-255,66,61915,6,257543
7449,0.000659,74.125.24.0-255,10692,72607,6,257543
7450,0.000661,172.31.36.0-255,66,72673,6,257543
7451,0.000954,74.125.24.0-255,1484,74157,6,257543
7452,0.000962,74.125.24.0-255,2902,77059,6,257543
7453,0.000966,172.31.36.0-255,66,77125,6,257543
7454,0.000971,74.125.24.0-255,2902,80027,6,257543
7455,0.000973,172.31.36.0-255,66,80093,6,257543
7456,0.001003,74.125.24.0-255,2902,82995,6,257543
7457,0.001007,74.125.24.0-255,4320,87315,6,257543
7458,0.001007,172.31.36.0-255,66,87381,6,257543
7459,0.001011,172.31.36.0-255,66,87447,6,257543
7460,0.001018,172.31.36.0-255,66,87513,6,257543
7461,0.001062,74.125.24.0-255,7856,95369,6,257543
7462,0.001066,172.31.36.0-255,66,95435,6,257543
7463,0.001093,74.125.24.0-255,5738,101173,6,257543
7464,0.001096,172.31.36.0-255,66,101239,6,257543
7465,0.001104,74.125.24.0-255,7156,108395,6,257543
7466,0.001106,172.31.36.0-255,66,108461,6,257543
7467,0.001159,172.31.36.0-255,66,108527,6,257543
7468,0.001166,74.125.24.0-255,6438,114965,6,257543
7469,0.001168,172.31.36.0-255,66,115031,6,257543
7470,0.001282,74.125.24.0-255,1484,116515,6,257543
7471,0.001296,74.125.24.0-255,2902,119417,6,257543
7472,0.001301,172.31.36.0-255,66,119483,6,257543
7473,0.001325,74.125.24.0-255,5738,125221,6,257543
7474,0.001328,172.31.36.0-255,66,125287,6,257543
7475,0.001332,74.125.24.0-255,2902,128189,6,257543
7476,0.001334,172.31.36.0-255,66,128255,6,257543
7477,0.001377,74.125.24.0-255,9992,138247,6,257543
7478,0.00138,172.31.36.0-255,66,138313,6,257543
7479,0.001387,74.125.24.0-255,7156,145469,6,257543
7480,0.00139,172.31.36.0-255,66,145535,6,257543
7481,0.001401,74.125.24.0-255,3602,149137,6,257543
7482,0.001404,172.31.36.0-255,66,149203,6,257543
7483,0.001409,74.125.24.0-255,4320,153523,6,257543
7484,0.001415,172.31.36.0-255,66,153589,6,257543
7485,0.001449,74.125.24.0-255,9992,163581,6,257543
7486,0.001452,172.31.36.0-255,66,163647,6,257543
7487,0.001472,172.31.36.0-255,66,163713,6,257543
7488,0.001511,74.125.24.0-255,7856,171569,6,257543
7489,0.001515,172.31.36.0-255,66,171635,6,257543
7490,0.001753,74.125.24.0-255,1484,173119,6,257543
7491,0.001758,74.125.24.0-255,1484,174603,6,257543
7492,0.001761,172.31.36.0-255,66,174669,6,257543
7493,0.001771,74.125.24.0-255,1484,176153,6,257543
7494,0.001773,74.125.24.0-255,1484,177637,6,257543
7495,0.001783,172.31.36.0-255,66,177703,6,257543
7496,0.001814,74.125.24.0-255,4320,182023,6,257543
7497,0.001819,172.31.36.0-255,66,182089,6,257543
7498,0.00184,172.31.36.0-255,66,182155,6,257543
7499,0.001853,172.31.36.0-255,66,182221,6,257543
7500,0.001934,74.125.24.0-255,1484,183705,6,257543
7501,0.001955,74.125.24.0-255,2902,186607,6,257543
7502,0.001958,172.31.36.0-255,66,186673,6,257543
7503,0.001964,74.125.24.0-255,5738,192411,6,257543
7504,0.001966,172.31.36.0-255,66,192477,6,257543
7505,0.001983,74.125.24.0-255,1484,193961,6,257543
7506,0.002021,172.31.36.0-255,66,194027,6,257543
7507,0.002025,74.125.24.0-255,10692,204719,6,257543
7508,0.002027,172.31.36.0-255,66,204785,6,257543
7509,0.002078,74.125.24.0-255,1484,206269,6,257543
7510,0.002092,74.125.24.0-255,2902,209171,6,257543
7511,0.002095,172.31.36.0-255,66,209237,6,257543
7512,0.0021,74.125.24.0-255,2902,212139,6,257543
7513,0.002102,172.31.36.0-255,66,212205,6,257543
7514,0.002122,74.125.24.0-255,2902,215107,6,257543
7515,0.002125,172.31.36.0-255,66,215173,6,257543
7516,0.002144,172.31.36.0-255,66,215239,6,257543
7517,0.002178,74.125.24.0-255,10692,225931,6,257543
7518,0.002182,172.31.36.0-255,66,225997,6,257543
7519,0.002194,74.125.24.0-255,2902,228899,6,257543
7520,0.0022,172.31.36.0-255,66,228965,6,257543
7521,0.002215,74.125.24.0-255,8574,237539,6,257543
7522,0.002223,172.31.36.0-255,66,237605,6,257543
7523,0.002229,74.125.24.0-255,5738,243343,6,257543
7524,0.002231,172.31.36.0-255,66,243409,6,257543
7525,0.002273,172.31.36.0-255,66,243475,6,257543
7526,0.002308,74.125.24.0-255,5020,248495,6,257543
7527,0.002312,172.31.36.0-255,66,248561,6,257543
7528,0.002321,74.125.24.0-255,8574,257135,6,257543
7529,0.002324,172.31.36.0-255,66,257201,6,257543
7530,0.002345,172.31.36.0-255,66,257267,6,257543
7531,0.002349,74.125.24.0-255,105,257372,6,257543
7532,0.009766,172.31.36.0-255,66,257438,6,257543
7533,0.009797,172.31.36.0-255,105,257543,6,257543
7534,0.0,172.217.27.0-255,153,153,6,185241
7535,2.2e-05,172.31.36.0-255,66,219,6,185241
7536,2.8e-05,172.217.27.0-255,1484,1703,6,185241
7537,3.2e-05,172.31.36.0-255,66,1769,6,185241
7538,3.8e-05,172.217.27.0-255,2902,4671,6,185241
7539,4.1e-05,172.31.36.0-255,66,4737,6,185241
7540,4.7e-05,172.217.27.0-255,5738,10475,6,185241
7541,5e-05,172.31.36.0-255,66,10541,6,185241
7542,5.6e-05,172.217.27.0-255,5738,16279,6,185241
7543,5.9e-05,172.31.36.0-255,66,16345,6,185241
7544,9e-05,172.217.27.0-255,6222,22567,6,185241
7545,9.3e-05,172.31.36.0-255,66,22633,6,185241
7546,0.000116,172.217.27.0-255,2902,25535,6,185241
7547,0.000118,172.31.36.0-255,66,25601,6,185241
7548,0.000137,172.217.27.0-255,5379,30980,6,185241
7549,0.00014,172.31.36.0-255,66,31046,6,185241
7550,0.000276,172.217.27.0-255,1484,32530,6,185241
7551,0.00028,172.31.36.0-255,66,32596,6,185241
7552,0.000285,172.217.27.0-255,2902,35498,6,185241
7553,0.000287,172.31.36.0-255,66,35564,6,185241
7554,0.000293,172.217.27.0-255,4320,39884,6,185241
7555,0.000295,172.31.36.0-255,66,39950,6,185241
7556,0.000322,172.217.27.0-255,1484,41434,6,185241
7557,0.000324,172.31.36.0-255,66,41500,6,185241
7558,0.00033,172.217.27.0-255,6797,48297,6,185241
7559,0.000332,172.31.36.0-255,66,48363,6,185241
7560,0.000335,172.217.27.0-255,1484,49847,6,185241
7561,0.000336,172.31.36.0-255,66,49913,6,185241
7562,0.000375,172.31.36.0-255,66,49979,6,185241
7563,0.000379,172.217.27.0-255,2810,52789,6,185241
7564,0.000381,172.31.36.0-255,66,52855,6,185241
7565,0.000715,172.217.27.0-255,388,53243,6,185241
7566,0.000913,172.31.36.0-255,66,53309,6,185241
7567,0.001107,172.217.27.0-255,1484,54793,6,185241
7568,0.001117,172.217.27.0-255,2902,57695,6,185241
7569,0.00112,172.31.36.0-255,66,57761,6,185241
7570,0.001127,172.217.27.0-255,5738,63499,6,185241
7571,0.001129,172.31.36.0-255,66,63565,6,185241
7572,0.001168,172.217.27.0-255,8574,72139,6,185241
7573,0.001171,172.31.36.0-255,66,72205,6,185241
7574,0.001192,172.217.27.0-255,5379,77584,6,185241
7575,0.001195,172.31.36.0-255,66,77650,6,185241
7576,0.001198,172.217.27.0-255,1484,79134,6,185241
7577,0.001214,172.217.27.0-255,2902,82036,6,185241
7578,0.001216,172.31.36.0-255,66,82102,6,185241
7579,0.001221,172.217.27.0-255,2902,85004,6,185241
7580,0.001222,172.31.36.0-255,66,85070,6,185241
7581,0.001237,172.217.27.0-255,2902,87972,6,185241
7582,0.001239,172.31.36.0-255,66,88038,6,185241
7583,0.001245,172.217.27.0-255,7156,95194,6,185241
7584,0.001247,172.31.36.0-255,66,95260,6,185241
7585,0.001286,172.217.27.0-255,4320,99580,6,185241
7586,0.00129,172.31.36.0-255,66,99646,6,185241
7587,0.001309,172.217.27.0-255,5020,104666,6,185241
7588,0.001311,172.31.36.0-255,66,104732,6,185241
7589,0.00146,172.217.27.0-255,1484,106216,6,185241
7590,0.001467,172.217.27.0-255,2902,109118,6,185241
7591,0.00147,172.31.36.0-255,66,109184,6,185241
7592,0.001492,172.217.27.0-255,4320,113504,6,185241
7593,0.001494,172.31.36.0-255,66,113570,6,185241
7594,0.001498,172.217.27.0-255,1484,115054,6,185241
7595,0.001515,172.217.27.0-255,4320,119374,6,185241
7596,0.001517,172.31.36.0-255,66,119440,6,185241
7597,0.001532,172.217.27.0-255,5738,125178,6,185241
7598,0.001535,172.31.36.0-255,66,125244,6,185241
7599,0.001553,172.217.27.0-255,3961,129205,6,185241
7600,0.001556,172.31.36.0-255,66,129271,6,185241
7601,0.001558,172.217.27.0-255,1484,130755,6,185241
7602,0.001572,172.217.27.0-255,1484,132239,6,185241
7603,0.001575,172.31.36.0-255,66,132305,6,185241
7604,0.001594,172.217.27.0-255,2902,135207,6,185241
7605,0.001597,172.31.36.0-255,66,135273,6,185241
7606,0.001616,172.217.27.0-255,5738,141011,6,185241
7607,0.001619,172.31.36.0-255,66,141077,6,185241
7608,0.00165,172.217.27.0-255,9992,151069,6,185241
7609,0.001653,172.31.36.0-255,66,151135,6,185241
7610,0.001672,172.217.27.0-255,5020,156155,6,185241
7611,0.001675,172.31.36.0-255,66,156221,6,185241
7612,0.003317,172.217.27.0-255,5738,161959,6,185241
7613,0.003324,172.31.36.0-255,66,162025,6,185241
7614,0.00496,172.217.27.0-255,5738,167763,6,185241
7615,0.004964,172.31.36.0-255,66,167829,6,185241
7616,0.006607,172.217.27.0-255,5738,173567,6,185241
7617,0.006614,172.31.36.0-255,66,173633,6,185241
7618,0.008255,172.217.27.0-255,5738,179371,6,185241
7619,0.008263,172.31.36.0-255,66,179437,6,185241
7620,0.009914,172.217.27.0-255,5738,185175,6,185241
7621,0.009921,172.31.36.0-255,66,185241,6,185241
7622,0.0,172.31.36.0-255,66,66,6,66
7623,0.0,172.217.194.0-255,153,153,6,260796
7624,3.6e-05,172.31.36.0-255,66,219,6,260796
7625,4.4e-05,172.217.194.0-255,1484,1703,6,260796
7626,4.9e-05,172.31.36.0-255,66,1769,6,260796
7627,5.3e-05,172.217.194.0-255,2902,4671,6,260796
7628,5.7e-05,172.31.36.0-255,66,4737,6,260796
7629,6.4e-05,172.217.194.0-255,7156,11893,6,260796
7630,6.7e-05,172.31.36.0-255,66,11959,6,260796
7631,7.5e-05,172.217.194.0-255,8574,20533,6,260796
7632,7.7e-05,172.31.36.0-255,66,20599,6,260796
7633,0.0001,172.217.194.0-255,4884,25483,6,260796
7634,0.000103,172.31.36.0-255,66,25549,6,260796
7635,0.00013,172.217.194.0-255,5379,30928,6,260796
7636,0.000133,172.31.36.0-255,66,30994,6,260796
7637,0.000138,172.217.194.0-255,2902,33896,6,260796
7638,0.00014,172.31.36.0-255,66,33962,6,260796
7639,0.000155,172.217.194.0-255,2902,36864,6,260796
7640,0.000157,172.31.36.0-255,66,36930,6,260796
7641,0.000162,172.217.194.0-255,2902,39832,6,260796
7642,0.000165,172.31.36.0-255,66,39898,6,260796
7643,0.000181,172.217.194.0-255,7156,47054,6,260796
7644,0.000183,172.31.36.0-255,66,47120,6,260796
7645,0.000205,172.217.194.0-255,5738,52858,6,260796
7646,0.000207,172.31.36.0-255,66,52924,6,260796
7647,0.000246,172.31.36.0-255,66,52990,6,260796
7648,0.000249,172.217.194.0-255,364,53354,6,260796
7649,0.000252,172.31.36.0-255,66,53420,6,260796
7650,0.000501,172.217.194.0-255,1484,54904,6,260796
7651,0.000505,172.31.36.0-255,66,54970,6,260796
7652,0.000511,172.217.194.0-255,2902,57872,6,260796
7653,0.000514,172.31.36.0-255,66,57938,6,260796
7654,0.000543,172.217.194.0-255,5738,63676,6,260796
7655,0.000546,172.31.36.0-255,66,63742,6,260796
7656,0.000558,172.217.194.0-255,1484,65226,6,260796
7657,0.000581,172.217.194.0-255,9992,75218,6,260796
7658,0.000585,172.31.36.0-255,66,75284,6,260796
7659,0.000602,172.217.194.0-255,1484,76768,6,260796
7660,0.000612,172.217.194.0-255,9992,86760,6,260796
7661,0.000616,172.31.36.0-255,66,86826,6,260796
7662,0.000619,172.217.194.0-255,766,87592,6,260796
7663,0.000745,172.217.194.0-255,1484,89076,6,260796
7664,0.00075,172.31.36.0-255,66,89142,6,260796
7665,0.000755,172.217.194.0-255,2902,92044,6,260796
7666,0.000757,172.31.36.0-255,66,92110,6,260796
7667,0.00076,172.217.194.0-255,1484,93594,6,260796
7668,0.000783,172.217.194.0-255,4320,97914,6,260796
7669,0.000786,172.31.36.0-255,66,97980,6,260796
7670,0.0008,172.31.36.0-255,66,98046,6,260796
7671,0.000835,172.217.194.0-255,7156,105202,6,260796
7672,0.000838,172.31.36.0-255,66,105268,6,260796
7673,0.000861,172.217.194.0-255,5020,110288,6,260796
7674,0.000865,172.31.36.0-255,66,110354,6,260796
7675,0.000883,172.217.194.0-255,1484,111838,6,260796
7676,0.000888,172.217.194.0-255,2902,114740,6,260796
7677,0.00089,172.31.36.0-255,66,114806,6,260796
7678,0.000912,172.217.194.0-255,5738,120544,6,260796
7679,0.000916,172.31.36.0-255,66,120610,6,260796
7680,0.000938,172.217.194.0-255,4320,124930,6,260796
7681,0.000943,172.31.36.0-255,66,124996,6,260796
7682,0.000958,172.217.194.0-255,5738,130734,6,260796
7683,0.000962,172.31.36.0-255,66,130800,6,260796
7684,0.000987,172.217.194.0-255,1484,132284,6,260796
7685,0.001002,172.31.36.0-255,66,132350,6,260796
7686,0.001186,172.217.194.0-255,1484,133834,6,260796
7687,0.0012,172.217.194.0-255,2902,136736,6,260796
7688,0.001204,172.31.36.0-255,66,136802,6,260796
7689,0.001237,172.217.194.0-255,1484,138286,6,260796
7690,0.001257,172.217.194.0-255,4320,142606,6,260796
7691,0.001261,172.31.36.0-255,66,142672,6,260796
7692,0.001276,172.31.36.0-255,66,142738,6,260796
7693,0.001284,172.217.194.0-255,8574,151312,6,260796
7694,0.001288,172.31.36.0-255,66,151378,6,260796
7695,0.001294,172.217.194.0-255,5020,156398,6,260796
7696,0.001299,172.31.36.0-255,66,156464,6,260796
7697,0.001325,172.217.194.0-255,5738,162202,6,260796
7698,0.001328,172.31.36.0-255,66,162268,6,260796
7699,0.001336,172.217.194.0-255,7156,169424,6,260796
7700,0.001338,172.31.36.0-255,66,169490,6,260796
7701,0.001355,172.217.194.0-255,5738,175228,6,260796
7702,0.001358,172.31.36.0-255,66,175294,6,260796
7703,0.001373,172.31.36.0-255,66,175360,6,260796
7704,0.001392,172.217.194.0-255,2902,178262,6,260796
7705,0.001395,172.31.36.0-255,66,178328,6,260796
7706,0.001425,172.217.194.0-255,9992,188320,6,260796
7707,0.00143,172.31.36.0-255,66,188386,6,260796
7708,0.001451,172.31.36.0-255,66,188452,6,260796
7709,0.001458,172.217.194.0-255,6438,194890,6,260796
7710,0.001461,172.31.36.0-255,66,194956,6,260796
7711,0.001548,172.217.194.0-255,1484,196440,6,260796
7712,0.001554,172.217.194.0-255,2902,199342,6,260796
7713,0.001558,172.31.36.0-255,66,199408,6,260796
7714,0.001561,172.217.194.0-255,1484,200892,6,260796
7715,0.001581,172.217.194.0-255,4320,205212,6,260796
7716,0.001585,172.217.194.0-255,2902,208114,6,260796
7717,0.001585,172.31.36.0-255,66,208180,6,260796
7718,0.001589,172.31.36.0-255,66,208246,6,260796
7719,0.001604,172.217.194.0-255,5738,213984,6,260796
7720,0.001608,172.31.36.0-255,66,214050,6,260796
7721,0.001639,172.217.194.0-255,4320,218370,6,260796
7722,0.001644,172.31.36.0-255,66,218436,6,260796
7723,0.001652,172.217.194.0-255,9992,228428,6,260796
7724,0.001655,172.31.36.0-255,66,228494,6,260796
7725,0.001658,172.217.194.0-255,766,229260,6,260796
7726,0.001661,172.217.194.0-255,1484,230744,6,260796
7727,0.001663,172.31.36.0-255,66,230810,6,260796
7728,0.001668,172.217.194.0-255,4320,235130,6,260796
7729,0.00167,172.31.36.0-255,66,235196,6,260796
7730,0.001695,172.217.194.0-255,9992,245188,6,260796
7731,0.0017,172.31.36.0-255,66,245254,6,260796
7732,0.001718,172.217.194.0-255,9992,255246,6,260796
7733,0.001721,172.31.36.0-255,66,255312,6,260796
7734,0.001801,172.31.36.0-255,66,255378,6,260796
7735,0.001818,172.31.36.0-255,66,255444,6,260796
7736,0.00186,172.217.194.0-255,4320,259764,6,260796
7737,0.001866,172.31.36.0-255,66,259830,6,260796
7738,0.00189,172.31.36.0-255,66,259896,6,260796
7739,0.001893,172.217.194.0-255,558,260454,6,260796
7740,0.001897,172.217.194.0-255,105,260559,6,260796
7741,0.003435,172.31.36.0-255,66,260625,6,260796
7742,0.003462,172.31.36.0-255,105,260730,6,260796
7743,0.005795,172.217.194.0-255,66,260796,6,260796
7744,0.0,74.125.24.0-255,153,153,6,192417
7745,2.2e-05,172.31.36.0-255,66,219,6,192417
7746,3e-05,74.125.24.0-255,1484,1703,6,192417
7747,3.4e-05,172.31.36.0-255,66,1769,6,192417
7748,4.8e-05,74.125.24.0-255,2902,4671,6,192417
7749,5.1e-05,172.31.36.0-255,66,4737,6,192417
7750,5.9e-05,74.125.24.0-255,7156,11893,6,192417
7751,6.2e-05,172.31.36.0-255,66,11959,6,192417
7752,6.7e-05,74.125.24.0-255,2053,14012,6,192417
7753,7e-05,172.31.36.0-255,66,14078,6,192417
7754,9.3e-05,74.125.24.0-255,2902,16980,6,192417
7755,0.000101,172.31.36.0-255,66,17046,6,192417
7756,0.000134,74.125.24.0-255,7156,24202,6,192417
7757,0.000137,172.31.36.0-255,66,24268,6,192417
7758,0.000143,74.125.24.0-255,4320,28588,6,192417
7759,0.000145,172.31.36.0-255,66,28654,6,192417
7760,0.000174,74.125.24.0-255,2543,31197,6,192417
7761,0.000177,172.31.36.0-255,66,31263,6,192417
7762,0.000545,74.125.24.0-255,1484,32747,6,192417
7763,0.000551,172.31.36.0-255,66,32813,6,192417
7764,0.000557,74.125.24.0-255,2902,35715,6,192417
7765,0.00056,172.31.36.0-255,66,35781,6,192417
7766,0.000565,74.125.24.0-255,2902,38683,6,192417
7767,0.000573,172.31.36.0-255,66,38749,6,192417
7768,0.000607,74.125.24.0-255,2902,41651,6,192417
7769,0.000609,172.31.36.0-255,66,41717,6,192417
7770,0.000629,172.31.36.0-255,66,41783,6,192417
7771,0.000635,74.125.24.0-255,4320,46103,6,192417
7772,0.000637,172.31.36.0-255,66,46169,6,192417
7773,0.000676,74.125.24.0-255,7376,53545,6,192417
7774,0.000678,172.31.36.0-255,66,53611,6,192417
7775,0.001046,74.125.24.0-255,1484,55095,6,192417
7776,0.00105,74.125.24.0-255,1484,56579,6,192417
7777,0.001054,172.31.36.0-255,66,56645,6,192417
7778,0.001081,74.125.24.0-255,1484,58129,6,192417
7779,0.00109,74.125.24.0-255,5738,63867,6,192417
7780,0.001104,74.125.24.0-255,1484,65351,6,192417
7781,0.001111,172.31.36.0-255,66,65417,6,192417
7782,0.001144,74.125.24.0-255,8574,73991,6,192417
7783,0.001147,74.125.24.0-255,766,74757,6,192417
7784,0.001155,172.31.36.0-255,66,74823,6,192417
7785,0.001294,74.125.24.0-255,1484,76307,6,192417
7786,0.001298,74.125.24.0-255,1484,77791,6,192417
7787,0.001304,172.31.36.0-255,66,77857,6,192417
7788,0.001323,74.125.24.0-255,1484,79341,6,192417
7789,0.00133,74.125.24.0-255,5738,85079,6,192417
7790,0.001338,74.125.24.0-255,7156,92235,6,192417
7791,0.001347,172.31.36.0-255,66,92301,6,192417
7792,0.001377,74.125.24.0-255,5738,98039,6,192417
7793,0.001386,74.125.24.0-255,7156,105195,6,192417
7794,0.001391,172.31.36.0-255,66,105261,6,192417
7795,0.001421,74.125.24.0-255,3602,108863,6,192417
7796,0.001423,74.125.24.0-255,1484,110347,6,192417
7797,0.001429,172.31.36.0-255,66,110413,6,192417
7798,0.001505,172.31.36.0-255,66,110479,6,192417
7799,0.001522,74.125.24.0-255,7856,118335,6,192417
7800,0.00153,172.31.36.0-255,66,118401,6,192417
7801,0.001694,74.125.24.0-255,1484,119885,6,192417
7802,0.001699,74.125.24.0-255,1484,121369,6,192417
7803,0.001704,172.31.36.0-255,66,121435,6,192417
7804,0.001732,74.125.24.0-255,1484,122919,6,192417
7805,0.001739,74.125.24.0-255,5738,128657,6,192417
7806,0.001748,74.125.24.0-255,8574,137231,6,192417
7807,0.001768,172.31.36.0-255,66,137297,6,192417
7808,0.001801,74.125.24.0-255,8574,145871,6,192417
7809,0.001817,74.125.24.0-255,6438,152309,6,192417
7810,0.001831,172.31.36.0-255,66,152375,6,192417
7811,0.001943,74.125.24.0-255,1484,153859,6,192417
7812,0.001948,74.125.24.0-255,2902,156761,6,192417
7813,0.001959,172.31.36.0-255,66,156827,6,192417
7814,0.001971,74.125.24.0-255,5738,162565,6,192417
7815,0.001982,172.31.36.0-255,66,162631,6,192417
7816,0.001994,74.125.24.0-255,2902,165533,6,192417
7817,0.002017,74.125.24.0-255,9992,175525,6,192417
7818,0.00202,74.125.24.0-255,1484,177009,6,192417
7819,0.002049,74.125.24.0-255,8574,185583,6,192417
7820,0.002052,172.31.36.0-255,66,185649,6,192417
7821,0.002058,172.31.36.0-255,66,185715,6,192417
7822,0.00207,74.125.24.0-255,766,186481,6,192417
7823,0.002774,172.31.36.0-255,66,186547,6,192417
7824,0.004067,74.125.24.0-255,4320,190867,6,192417
7825,0.004789,74.125.24.0-255,1484,192351,6,192417
7826,0.008326,172.31.36.0-255,66,192417,6,192417
7827,0.0,74.125.24.0-255,153,153,6,190379
7828,2.7e-05,172.31.36.0-255,66,219,6,190379
7829,3.3e-05,74.125.24.0-255,1484,1703,6,190379
7830,3.7e-05,172.31.36.0-255,66,1769,6,190379
7831,4.1e-05,74.125.24.0-255,2902,4671,6,190379
7832,5.2e-05,172.31.36.0-255,66,4737,6,190379
7833,5.9e-05,74.125.24.0-255,7156,11893,6,190379
7834,6.2e-05,172.31.36.0-255,66,11959,6,190379
7835,6.5e-05,74.125.24.0-255,1484,13443,6,190379
7836,6.7e-05,172.31.36.0-255,66,13509,6,190379
7837,0.000109,74.125.24.0-255,10564,24073,6,190379
7838,0.000112,172.31.36.0-255,66,24139,6,190379
7839,0.00012,74.125.24.0-255,6797,30936,6,190379
7840,0.000122,172.31.36.0-255,66,31002,6,190379
7841,0.000171,74.125.24.0-255,1484,32486,6,190379
7842,0.000174,172.31.36.0-255,66,32552,6,190379
7843,0.000209,74.125.24.0-255,2902,35454,6,190379
7844,0.000213,172.31.36.0-255,66,35520,6,190379
7845,0.000221,74.125.24.0-255,5738,41258,6,190379
7846,0.000223,172.31.36.0-255,66,41324,6,190379
7847,0.000277,74.125.24.0-255,6797,48121,6,190379
7848,0.000282,172.31.36.0-255,66,48187,6,190379
7849,0.000303,172.31.36.0-255,66,48253,6,190379
7850,0.000307,74.125.24.0-255,2543,50796,6,190379
7851,0.000309,172.31.36.0-255,66,50862,6,190379
7852,0.000335,74.125.24.0-255,397,51259,6,190379
7853,0.000343,172.31.36.0-255,66,51325,6,190379
7854,0.000347,74.125.24.0-255,346,51671,6,190379
7855,0.00035,172.31.36.0-255,66,51737,6,190379
7856,0.000585,74.125.24.0-255,1484,53221,6,190379
7857,0.000589,172.31.36.0-255,66,53287,6,190379
7858,0.000593,74.125.24.0-255,1484,54771,6,190379
7859,0.000624,74.125.24.0-255,1484,56255,6,190379
7860,0.000628,172.31.36.0-255,66,56321,6,190379
7861,0.000635,74.125.24.0-255,5738,62059,6,190379
7862,0.000637,172.31.36.0-255,66,62125,6,190379
7863,0.000657,172.31.36.0-255,66,62191,6,190379
7864,0.000668,74.125.24.0-255,9992,72183,6,190379
7865,0.000671,172.31.36.0-255,66,72249,6,190379
7866,0.000701,74.125.24.0-255,766,73015,6,190379
7867,0.000779,74.125.24.0-255,1484,74499,6,190379
7868,0.000783,172.31.36.0-255,66,74565,6,190379
7869,0.000789,74.125.24.0-255,2902,77467,6,190379
7870,0.000791,172.31.36.0-255,66,77533,6,190379
7871,0.000796,74.125.24.0-255,2902,80435,6,190379
7872,0.000798,172.31.36.0-255,66,80501,6,190379
7873,0.000814,74.125.24.0-255,2902,83403,6,190379
7874,0.000818,172.31.36.0-255,66,83469,6,190379
7875,0.000827,74.125.24.0-255,2902,86371,6,190379
7876,0.00083,172.31.36.0-255,66,86437,6,190379
7877,0.000839,74.125.24.0-255,9992,96429,6,190379
7878,0.000841,172.31.36.0-255,66,96495,6,190379
7879,0.000867,74.125.24.0-255,2902,99397,6,190379
7880,0.000871,172.31.36.0-255,66,99463,6,190379
7881,0.000901,74.125.24.0-255,7856,107319,6,190379
7882,0.000906,172.31.36.0-255,66,107385,6,190379
7883,0.000998,74.125.24.0-255,1484,108869,6,190379
7884,0.001002,74.125.24.0-255,1484,110353,6,190379
7885,0.001005,172.31.36.0-255,66,110419,6,190379
7886,0.001034,74.125.24.0-255,1484,111903,6,190379
7887,0.00104,74.125.24.0-255,5738,117641,6,190379
7888,0.001046,172.31.36.0-255,66,117707,6,190379
7889,0.001075,172.31.36.0-255,66,117773,6,190379
7890,0.001081,74.125.24.0-255,4320,122093,6,190379
7891,0.001084,172.31.36.0-255,66,122159,6,190379
7892,0.001118,74.125.24.0-255,6438,128597,6,190379
7893,0.001121,172.31.36.0-255,66,128663,6,190379
7894,0.001548,74.125.24.0-255,1484,130147,6,190379
7895,0.001569,74.125.24.0-255,1484,131631,6,190379
7896,0.001573,172.31.36.0-255,66,131697,6,190379
7897,0.001578,74.125.24.0-255,2902,134599,6,190379
7898,0.00158,172.31.36.0-255,66,134665,6,190379
7899,0.001615,74.125.24.0-255,5738,140403,6,190379
7900,0.001618,172.31.36.0-255,66,140469,6,190379
7901,0.001624,74.125.24.0-255,5738,146207,6,190379
7902,0.001627,172.31.36.0-255,66,146273,6,190379
7903,0.00163,74.125.24.0-255,1484,147757,6,190379
7904,0.001668,172.31.36.0-255,66,147823,6,190379
7905,0.001673,74.125.24.0-255,3602,151425,6,190379
7906,0.001675,172.31.36.0-255,66,151491,6,190379
7907,0.002175,74.125.24.0-255,1484,152975,6,190379
7908,0.002187,74.125.24.0-255,2902,155877,6,190379
7909,0.002191,172.31.36.0-255,66,155943,6,190379
7910,0.002197,74.125.24.0-255,2902,158845,6,190379
7911,0.002198,172.31.36.0-255,66,158911,6,190379
7912,0.002221,74.125.24.0-255,2902,161813,6,190379
7913,0.002224,172.31.36.0-255,66,161879,6,190379
7914,0.002243,172.31.36.0-255,66,161945,6,190379
7915,0.002311,74.125.24.0-255,10692,172637,6,190379
7916,0.002316,172.31.36.0-255,66,172703,6,190379
7917,0.004591,74.125.24.0-255,5738,178441,6,190379
7918,0.004597,172.31.36.0-255,66,178507,6,190379
7919,0.006904,74.125.24.0-255,2902,181409,6,190379
7920,0.006909,172.31.36.0-255,66,181475,6,190379
7921,0.006949,74.125.24.0-255,2902,184377,6,190379
7922,0.006952,172.31.36.0-255,66,184443,6,190379
7923,0.009222,74.125.24.0-255,2902,187345,6,190379
7924,0.009229,172.31.36.0-255,66,187411,6,190379
7925,0.009263,74.125.24.0-255,2902,190313,6,190379
7926,0.009266,172.31.36.0-255,66,190379,6,190379
7927,0.0,172.217.194.0-255,153,153,6,291684
7928,1.5e-05,172.31.36.0-255,66,219,6,291684
7929,2.2e-05,172.217.194.0-255,1484,1703,6,291684
7930,2.6e-05,172.31.36.0-255,66,1769,6,291684
7931,3.1e-05,172.217.194.0-255,2902,4671,6,291684
7932,3.4e-05,172.31.36.0-255,66,4737,6,291684
7933,5.2e-05,172.217.194.0-255,7156,11893,6,291684
7934,5.5e-05,172.31.36.0-255,66,11959,6,291684
7935,8.5e-05,172.217.194.0-255,8574,20533,6,291684
7936,8.9e-05,172.31.36.0-255,66,20599,6,291684
7937,0.000113,172.217.194.0-255,4903,25502,6,291684
7938,0.000116,172.31.36.0-255,66,25568,6,291684
7939,0.000128,172.217.194.0-255,5379,30947,6,291684
7940,0.000131,172.31.36.0-255,66,31013,6,291684
7941,0.000491,172.217.194.0-255,1484,32497,6,291684
7942,0.000496,172.31.36.0-255,66,32563,6,291684
7943,0.000501,172.217.194.0-255,1484,34047,6,291684
7944,0.000504,172.31.36.0-255,66,34113,6,291684
7945,0.000537,172.217.194.0-255,1484,35597,6,291684
7946,0.000541,172.31.36.0-255,66,35663,6,291684
7947,0.000546,172.217.194.0-255,2902,38565,6,291684
7948,0.000548,172.31.36.0-255,66,38631,6,291684
7949,0.000561,172.217.194.0-255,7156,45787,6,291684
7950,0.000564,172.31.36.0-255,66,45853,6,291684
7951,0.000616,172.31.36.0-255,66,45919,6,291684
7952,0.000648,172.217.194.0-255,2902,48821,6,291684
7953,0.000651,172.31.36.0-255,66,48887,6,291684
7954,0.00067,172.217.194.0-255,1413,50300,6,291684
7955,0.000673,172.31.36.0-255,66,50366,6,291684
7956,0.000676,172.217.194.0-255,366,50732,6,291684
7957,0.000678,172.31.36.0-255,66,50798,6,291684
7958,0.000755,172.217.194.0-255,1484,52282,6,291684
7959,0.000759,172.217.194.0-255,2902,55184,6,291684
7960,0.000762,172.31.36.0-255,66,55250,6,291684
7961,0.000794,172.217.194.0-255,5738,60988,6,291684
7962,0.000799,172.217.194.0-255,2902,63890,6,291684
7963,0.0008,172.31.36.0-255,66,63956,6,291684
7964,0.000805,172.31.36.0-255,66,64022,6,291684
7965,0.00084,172.217.194.0-255,9992,74014,6,291684
7966,0.000844,172.31.36.0-255,66,74080,6,291684
7967,0.000853,172.217.194.0-255,10692,84772,6,291684
7968,0.000857,172.31.36.0-255,66,84838,6,291684
7969,0.001295,172.217.194.0-255,1484,86322,6,291684
7970,0.001301,172.217.194.0-255,1484,87806,6,291684
7971,0.001305,172.31.36.0-255,66,87872,6,291684
7972,0.001333,172.217.194.0-255,1484,89356,6,291684
7973,0.00134,172.217.194.0-255,5738,95094,6,291684
7974,0.001342,172.31.36.0-255,66,95160,6,291684
7975,0.001345,172.217.194.0-255,1484,96644,6,291684
7976,0.001354,172.217.194.0-255,8574,105218,6,291684
7977,0.001356,172.31.36.0-255,66,105284,6,291684
7978,0.001389,172.217.194.0-255,2902,108186,6,291684
7979,0.001393,172.31.36.0-255,66,108252,6,291684
7980,0.001428,172.217.194.0-255,10692,118944,6,291684
7981,0.001433,172.31.36.0-255,66,119010,6,291684
7982,0.001508,172.217.194.0-255,1484,120494,6,291684
7983,0.001514,172.217.194.0-255,2902,123396,6,291684
7984,0.001517,172.31.36.0-255,66,123462,6,291684
7985,0.00152,172.217.194.0-255,1484,124946,6,291684
7986,0.001553,172.217.194.0-255,4320,129266,6,291684
7987,0.001558,172.31.36.0-255,66,129332,6,291684
7988,0.001562,172.217.194.0-255,1484,130816,6,291684
7989,0.001576,172.217.194.0-255,8574,139390,6,291684
7990,0.001578,172.31.36.0-255,66,139456,6,291684
7991,0.001625,172.31.36.0-255,66,139522,6,291684
7992,0.001793,172.217.194.0-255,1484,141006,6,291684
7993,0.0018,172.217.194.0-255,2902,143908,6,291684
7994,0.001803,172.31.36.0-255,66,143974,6,291684
7995,0.001844,172.217.194.0-255,5738,149712,6,291684
7996,0.001847,172.31.36.0-255,66,149778,6,291684
7997,0.001855,172.217.194.0-255,7156,156934,6,291684
7998,0.001858,172.31.36.0-255,66,157000,6,291684
7999,0.001887,172.217.194.0-255,5738,162738,6,291684
8000,0.00189,172.31.36.0-255,66,162804,6,291684
8001,0.001893,172.217.194.0-255,1484,164288,6,291684
8002,0.001904,172.217.194.0-255,2902,167190,6,291684
8003,0.00191,172.31.36.0-255,66,167256,6,291684
8004,0.001929,172.217.194.0-255,6438,173694,6,291684
8005,0.001931,172.31.36.0-255,66,173760,6,291684
8006,0.002049,172.217.194.0-255,1484,175244,6,291684
8007,0.002062,172.217.194.0-255,2902,178146,6,291684
8008,0.002065,172.31.36.0-255,66,178212,6,291684
8009,0.002086,172.217.194.0-255,5738,183950,6,291684
8010,0.002088,172.31.36.0-255,66,184016,6,291684
8011,0.002094,172.217.194.0-255,4320,188336,6,291684
8012,0.002096,172.31.36.0-255,66,188402,6,291684
8013,0.002126,172.217.194.0-255,1484,189886,6,291684
8014,0.002138,172.31.36.0-255,66,189952,6,291684
8015,0.002166,172.217.194.0-255,1484,191436,6,291684
8016,0.002172,172.217.194.0-255,5020,196456,6,291684
8017,0.002174,172.31.36.0-255,66,196522,6,291684
8018,0.002201,172.217.194.0-255,4320,200842,6,291684
8019,0.002203,172.31.36.0-255,66,200908,6,291684
8020,0.002229,172.217.194.0-255,1484,202392,6,291684
8021,0.002236,172.217.194.0-255,7156,209548,6,291684
8022,0.002239,172.31.36.0-255,66,209614,6,291684
8023,0.002295,172.217.194.0-255,8574,218188,6,291684
8024,0.002298,172.31.36.0-255,66,218254,6,291684
8025,0.00233,172.217.194.0-255,5738,223992,6,291684
8026,0.002333,172.31.36.0-255,66,224058,6,291684
8027,0.002339,172.217.194.0-255,6438,230496,6,291684
8028,0.002341,172.31.36.0-255,66,230562,6,291684
8029,0.002365,172.31.36.0-255,66,230628,6,291684
8030,0.002374,172.217.194.0-255,10692,241320,6,291684
8031,0.002376,172.31.36.0-255,66,241386,6,291684
8032,0.002379,172.217.194.0-255,1484,242870,6,291684
8033,0.00243,172.31.36.0-255,66,242936,6,291684
8034,0.002438,172.217.194.0-255,7856,250792,6,291684
8035,0.002439,172.31.36.0-255,66,250858,6,291684
8036,0.002603,172.217.194.0-255,1484,252342,6,291684
8037,0.002614,172.217.194.0-255,2902,255244,6,291684
8038,0.002617,172.31.36.0-255,66,255310,6,291684
8039,0.002641,172.217.194.0-255,4320,259630,6,291684
8040,0.002644,172.31.36.0-255,66,259696,6,291684
8041,0.002656,172.217.194.0-255,1484,261180,6,291684
8042,0.002664,172.217.194.0-255,2902,264082,6,291684
8043,0.002666,172.31.36.0-255,66,264148,6,291684
8044,0.002701,172.217.194.0-255,9992,274140,6,291684
8045,0.002703,172.31.36.0-255,66,274206,6,291684
8046,0.002709,172.217.194.0-255,5738,279944,6,291684
8047,0.002711,172.31.36.0-255,66,280010,6,291684
8048,0.002714,172.217.194.0-255,1484,281494,6,291684
8049,0.005403,172.217.194.0-255,4320,285814,6,291684
8050,0.00541,172.31.36.0-255,66,285880,6,291684
8051,0.008122,172.217.194.0-255,5738,291618,6,291684
8052,0.008129,172.31.36.0-255,66,291684,6,291684
8053,0.0,172.217.194.0-255,146,146,6,140696
8054,2.3e-05,172.31.36.0-255,66,212,6,140696
8055,3.1e-05,172.217.194.0-255,1484,1696,6,140696
8056,3.6e-05,172.31.36.0-255,66,1762,6,140696
8057,4.2e-05,172.217.194.0-255,2902,4664,6,140696
8058,4.5e-05,172.31.36.0-255,66,4730,6,140696
8059,5.2e-05,172.217.194.0-255,7156,11886,6,140696
8060,5.6e-05,172.31.36.0-255,66,11952,6,140696
8061,6e-05,172.217.194.0-255,1933,13885,6,140696
8062,6.4e-05,172.31.36.0-255,66,13951,6,140696
8063,0.000154,172.217.194.0-255,1484,15435,6,140696
8064,0.000158,172.31.36.0-255,66,15501,6,140696
8065,0.000163,172.217.194.0-255,2902,18403,6,140696
8066,0.000166,172.31.36.0-255,66,18469,6,140696
8067,0.000183,172.217.194.0-255,2902,21371,6,140696
8068,0.000186,172.31.36.0-255,66,21437,6,140696
8069,0.000211,172.217.194.0-255,2902,24339,6,140696
8070,0.000214,172.31.36.0-255,66,24405,6,140696
8071,0.000222,172.217.194.0-255,6797,31202,6,140696
8072,0.000224,172.31.36.0-255,66,31268,6,140696
8073,0.000324,172.217.194.0-255,1484,32752,6,140696
8074,0.000328,172.31.36.0-255,66,32818,6,140696
8075,0.000333,172.217.194.0-255,2902,35720,6,140696
8076,0.000335,172.31.36.0-255,66,35786,6,140696
8077,0.000364,172.217.194.0-255,5738,41524,6,140696
8078,0.000367,172.31.36.0-255,66,41590,6,140696
8079,0.000373,172.217.194.0-255,5738,47328,6,140696
8080,0.000376,172.31.36.0-255,66,47394,6,140696
8081,0.000416,172.217.194.0-255,7156,54550,6,140696
8082,0.000419,172.31.36.0-255,66,54616,6,140696
8083,0.000436,172.217.194.0-255,6797,61413,6,140696
8084,0.000439,172.31.36.0-255,66,61479,6,140696
8085,0.000455,172.217.194.0-255,1484,62963,6,140696
8086,0.000458,172.31.36.0-255,66,63029,6,140696
8087,0.000473,172.217.194.0-255,2543,65572,6,140696
8088,0.000475,172.31.36.0-255,66,65638,6,140696
8089,0.001482,172.217.194.0-255,646,66284,6,140696
8090,0.001489,172.31.36.0-255,66,66350,6,140696
8091,0.001628,172.217.194.0-255,1484,67834,6,140696
8092,0.001632,172.31.36.0-255,66,67900,6,140696
8093,0.001638,172.217.194.0-255,2902,70802,6,140696
8094,0.00164,172.31.36.0-255,66,70868,6,140696
8095,0.001648,172.217.194.0-255,5738,76606,6,140696
8096,0.00165,172.31.36.0-255,66,76672,6,140696
8097,0.001657,172.217.194.0-255,5738,82410,6,140696
8098,0.001659,172.31.36.0-255,66,82476,6,140696
8099,0.00168,172.217.194.0-255,4320,86796,6,140696
8100,0.001682,172.31.36.0-255,66,86862,6,140696
8101,0.001713,172.217.194.0-255,8574,95436,6,140696
8102,0.001715,172.31.36.0-255,66,95502,6,140696
8103,0.001739,172.217.194.0-255,5020,100522,6,140696
8104,0.001741,172.31.36.0-255,66,100588,6,140696
8105,0.002199,172.217.194.0-255,1484,102072,6,140696
8106,0.002208,172.217.194.0-255,2902,104974,6,140696
8107,0.002212,172.31.36.0-255,66,105040,6,140696
8108,0.002219,172.217.194.0-255,5738,110778,6,140696
8109,0.002221,172.31.36.0-255,66,110844,6,140696
8110,0.002224,172.217.194.0-255,1484,112328,6,140696
8111,0.002258,172.31.36.0-255,66,112394,6,140696
8112,0.002278,172.217.194.0-255,4320,116714,6,140696
8113,0.00228,172.31.36.0-255,66,116780,6,140696
8114,0.002296,172.217.194.0-255,6438,123218,6,140696
8115,0.002299,172.31.36.0-255,66,123284,6,140696
8116,0.004589,172.217.194.0-255,5738,129022,6,140696
8117,0.004592,172.31.36.0-255,66,129088,6,140696
8118,0.006904,172.217.194.0-255,5738,134826,6,140696
8119,0.006908,172.31.36.0-255,66,134892,6,140696
8120,0.009186,172.217.194.0-255,5738,140630,6,140696
8121,0.009195,172.31.36.0-255,66,140696,6,140696
8122,0.0,74.125.24.0-255,143,143,6,105177
8123,1.9e-05,172.31.36.0-255,66,209,6,105177
8124,2.5e-05,74.125.24.0-255,1484,1693,6,105177
8125,2.9e-05,172.31.36.0-255,66,1759,6,105177
8126,3.4e-05,74.125.24.0-255,2902,4661,6,105177
8127,3.6e-05,172.31.36.0-255,66,4727,6,105177
8128,3.9e-05,74.125.24.0-255,1484,6211,6,105177
8129,4.1e-05,172.31.36.0-255,66,6277,6,105177
8130,6.9e-05,74.125.24.0-255,5738,12015,6,105177
8131,7.2e-05,172.31.36.0-255,66,12081,6,105177
8132,7.6e-05,74.125.24.0-255,2064,14145,6,105177
8133,7.8e-05,172.31.36.0-255,66,14211,6,105177
8134,0.000162,74.125.24.0-255,1484,15695,6,105177
8135,0.000167,172.31.36.0-255,66,15761,6,105177
8136,0.000172,74.125.24.0-255,2902,18663,6,105177
8137,0.000174,172.31.36.0-255,66,18729,6,105177
8138,0.000178,74.125.24.0-255,2902,21631,6,105177
8139,0.000179,172.31.36.0-255,66,21697,6,105177
8140,0.000207,74.125.24.0-255,2902,24599,6,105177
8141,0.000211,172.31.36.0-255,66,24665,6,105177
8142,0.000217,74.125.24.0-255,6797,31462,6,105177
8143,0.000219,172.31.36.0-255,66,31528,6,105177
8144,0.001583,74.125.24.0-255,1484,33012,6,105177
8145,0.001594,172.31.36.0-255,66,33078,6,105177
8146,0.001605,74.125.24.0-255,2902,35980,6,105177
8147,0.001608,172.31.36.0-255,66,36046,6,105177
8148,0.001615,74.125.24.0-255,5738,41784,6,105177
8149,0.001618,172.31.36.0-255,66,41850,6,105177
8150,0.001633,172.31.36.0-255,66,41916,6,105177
8151,0.001654,74.125.24.0-255,1125,43041,6,105177
8152,0.001657,172.31.36.0-255,66,43107,6,105177
8153,0.001673,74.125.24.0-255,2902,46009,6,105177
8154,0.001675,172.31.36.0-255,66,46075,6,105177
8155,0.001702,74.125.24.0-255,7109,53184,6,105177
8156,0.001705,172.31.36.0-255,66,53250,6,105177
8157,0.001946,74.125.24.0-255,343,53593,6,105177
8158,0.002092,74.125.24.0-255,1484,55077,6,105177
8159,0.002094,172.31.36.0-255,66,55143,6,105177
8160,0.002113,74.125.24.0-255,2902,58045,6,105177
8161,0.002115,172.31.36.0-255,66,58111,6,105177
8162,0.002119,74.125.24.0-255,1484,59595,6,105177
8163,0.002144,74.125.24.0-255,2902,62497,6,105177
8164,0.002147,172.31.36.0-255,66,62563,6,105177
8165,0.002184,74.125.24.0-255,9633,72196,6,105177
8166,0.002187,172.31.36.0-255,66,72262,6,105177
8167,0.002196,74.125.24.0-255,9992,82254,6,105177
8168,0.002199,172.31.36.0-255,66,82320,6,105177
8169,0.002241,74.125.24.0-255,5379,87699,6,105177
8170,0.002244,172.31.36.0-255,66,87765,6,105177
8171,0.004485,74.125.24.0-255,5738,93503,6,105177
8172,0.004489,172.31.36.0-255,66,93569,6,105177
8173,0.006699,74.125.24.0-255,5738,99307,6,105177
8174,0.006707,172.31.36.0-255,66,99373,6,105177
8175,0.008942,74.125.24.0-255,5738,105111,6,105177
8176,0.00895,172.31.36.0-255,66,105177,6,105177
8177,0.0,172.31.36.0-255,105,105,6,459
8178,0.000221,172.31.36.0-255,90,195,6,459
8179,0.000233,172.31.36.0-255,66,261,6,459
8180,0.00249,74.125.68.0-255,66,327,6,459
8181,0.002522,74.125.68.0-255,66,393,6,459
8182,0.002544,172.31.36.0-255,66,459,6,459
8183,0.0,172.217.194.0-255,153,153,6,236596
8184,2.2e-05,172.31.36.0-255,66,219,6,236596
8185,2.9e-05,172.217.194.0-255,1484,1703,6,236596
8186,3.3e-05,172.31.36.0-255,66,1769,6,236596
8187,3.9e-05,172.217.194.0-255,2902,4671,6,236596
8188,4.9e-05,172.31.36.0-255,66,4737,6,236596
8189,5.6e-05,172.217.194.0-255,7156,11893,6,236596
8190,5.9e-05,172.31.36.0-255,66,11959,6,236596
8191,6.5e-05,172.217.194.0-255,4811,16770,6,236596
8192,6.9e-05,172.31.36.0-255,66,16836,6,236596
8193,8.8e-05,172.217.194.0-255,4320,21156,6,236596
8194,9.1e-05,172.31.36.0-255,66,21222,6,236596
8195,0.00012,172.217.194.0-255,9633,30855,6,236596
8196,0.000122,172.31.36.0-255,66,30921,6,236596
8197,0.000159,172.31.36.0-255,66,30987,6,236596
8198,0.000182,172.217.194.0-255,2902,33889,6,236596
8199,0.000184,172.31.36.0-255,66,33955,6,236596
8200,0.000189,172.217.194.0-255,2543,36498,6,236596
8201,0.000191,172.31.36.0-255,66,36564,6,236596
8202,0.000613,172.217.194.0-255,1484,38048,6,236596
8203,0.000619,172.31.36.0-255,66,38114,6,236596
8204,0.000625,172.217.194.0-255,2902,41016,6,236596
8205,0.000627,172.31.36.0-255,66,41082,6,236596
8206,0.000639,172.217.194.0-255,5738,46820,6,236596
8207,0.000641,172.31.36.0-255,66,46886,6,236596
8208,0.000675,172.217.194.0-255,6797,53683,6,236596
8209,0.000678,172.31.36.0-255,66,53749,6,236596
8210,0.000702,172.217.194.0-255,1484,55233,6,236596
8211,0.000705,172.31.36.0-255,66,55299,6,236596
8212,0.000708,172.217.194.0-255,1484,56783,6,236596
8213,0.00071,172.31.36.0-255,66,56849,6,236596
8214,0.000745,172.217.194.0-255,1484,58333,6,236596
8215,0.000753,172.217.194.0-255,5738,64071,6,236596
8216,0.000756,172.31.36.0-255,66,64137,6,236596
8217,0.000788,172.217.194.0-255,9992,74129,6,236596
8218,0.00079,172.31.36.0-255,66,74195,6,236596
8219,0.000814,172.217.194.0-255,2543,76738,6,236596
8220,0.000817,172.31.36.0-255,66,76804,6,236596
8221,0.00083,172.31.36.0-255,66,76870,6,236596
8222,0.000868,172.217.194.0-255,1484,78354,6,236596
8223,0.000872,172.217.194.0-255,1484,79838,6,236596
8224,0.000874,172.31.36.0-255,66,79904,6,236596
8225,0.000898,172.217.194.0-255,1484,81388,6,236596
8226,0.000905,172.217.194.0-255,5738,87126,6,236596
8227,0.000908,172.31.36.0-255,66,87192,6,236596
8228,0.000911,172.217.194.0-255,1484,88676,6,236596
8229,0.000943,172.217.194.0-255,8574,97250,6,236596
8230,0.000945,172.31.36.0-255,66,97316,6,236596
8231,0.000953,172.217.194.0-255,7156,104472,6,236596
8232,0.000956,172.31.36.0-255,66,104538,6,236596
8233,0.000985,172.217.194.0-255,4320,108858,6,236596
8234,0.000987,172.31.36.0-255,66,108924,6,236596
8235,0.000991,172.217.194.0-255,2184,111108,6,236596
8236,0.000994,172.31.36.0-255,66,111174,6,236596
8237,0.001048,172.217.194.0-255,646,111820,6,236596
8238,0.001078,172.217.194.0-255,1484,113304,6,236596
8239,0.001082,172.31.36.0-255,66,113370,6,236596
8240,0.001104,172.217.194.0-255,4320,117690,6,236596
8241,0.001107,172.31.36.0-255,66,117756,6,236596
8242,0.001113,172.217.194.0-255,5738,123494,6,236596
8243,0.001116,172.31.36.0-255,66,123560,6,236596
8244,0.001154,172.217.194.0-255,4320,127880,6,236596
8245,0.001157,172.31.36.0-255,66,127946,6,236596
8246,0.001171,172.31.36.0-255,66,128012,6,236596
8247,0.001178,172.217.194.0-255,6438,134450,6,236596
8248,0.001181,172.31.36.0-255,66,134516,6,236596
8249,0.00123,172.217.194.0-255,1484,136000,6,236596
8250,0.001244,172.217.194.0-255,2902,138902,6,236596
8251,0.001247,172.31.36.0-255,66,138968,6,236596
8252,0.001254,172.217.194.0-255,5738,144706,6,236596
8253,0.001256,172.31.36.0-255,66,144772,6,236596
8254,0.001285,172.217.194.0-255,7156,151928,6,236596
8255,0.001289,172.31.36.0-255,66,151994,6,236596
8256,0.001294,172.217.194.0-255,4320,156314,6,236596
8257,0.001296,172.31.36.0-255,66,156380,6,236596
8258,0.001332,172.217.194.0-255,9992,166372,6,236596
8259,0.001335,172.31.36.0-255,66,166438,6,236596
8260,0.001339,172.217.194.0-255,2184,168622,6,236596
8261,0.001341,172.31.36.0-255,66,168688,6,236596
8262,0.001543,172.217.194.0-255,1484,170172,6,236596
8263,0.001569,172.217.194.0-255,2902,173074,6,236596
8264,0.001573,172.31.36.0-255,66,173140,6,236596
8265,0.001578,172.217.194.0-255,2902,176042,6,236596
8266,0.00158,172.31.36.0-255,66,176108,6,236596
8267,0.001592,172.217.194.0-255,7156,183264,6,236596
8268,0.001595,172.31.36.0-255,66,183330,6,236596
8269,0.001648,172.31.36.0-255,66,183396,6,236596
8270,0.001653,172.217.194.0-255,3602,186998,6,236596
8271,0.001655,172.31.36.0-255,66,187064,6,236596
8272,0.001689,172.31.36.0-255,66,187130,6,236596
8273,0.001723,172.217.194.0-255,8574,195704,6,236596
8274,0.001727,172.31.36.0-255,66,195770,6,236596
8275,0.001741,172.31.36.0-255,66,195836,6,236596
8276,0.001824,172.31.36.0-255,66,195902,6,236596
8277,0.001833,172.217.194.0-255,9992,205894,6,236596
8278,0.001836,172.31.36.0-255,66,205960,6,236596
8279,0.001848,172.31.36.0-255,66,206026,6,236596
8280,0.001862,172.31.36.0-255,66,206092,6,236596
8281,0.001868,172.217.194.0-255,5738,211830,6,236596
8282,0.001871,172.31.36.0-255,66,211896,6,236596
8283,0.001905,172.217.194.0-255,7156,219052,6,236596
8284,0.001908,172.31.36.0-255,66,219118,6,236596
8285,0.001929,172.31.36.0-255,66,219184,6,236596
8286,0.003982,172.217.194.0-255,5738,224922,6,236596
8287,0.003988,172.31.36.0-255,66,224988,6,236596
8288,0.006073,172.217.194.0-255,5738,230726,6,236596
8289,0.00608,172.31.36.0-255,66,230792,6,236596
8290,0.008151,172.217.194.0-255,5738,236530,6,236596
8291,0.008154,172.31.36.0-255,66,236596,6,236596
8292,0.0,172.31.36.0-255,188,188,6,11695
8293,3.3e-05,172.31.36.0-255,981,1169,6,11695
8294,0.000125,172.31.36.0-255,1514,2683,6,11695
8295,0.000127,172.31.36.0-255,1514,4197,6,11695
8296,0.000128,172.31.36.0-255,1514,5711,6,11695
8297,0.000129,172.31.36.0-255,1514,7225,6,11695
8298,0.000159,172.31.36.0-255,1514,8739,6,11695
8299,0.00016,172.31.36.0-255,1514,10253,6,11695
8300,0.000166,172.31.36.0-255,1112,11365,6,11695
8301,0.001556,104.244.42.0-255,66,11431,6,11695
8302,0.001606,104.244.42.0-255,66,11497,6,11695
8303,0.00174,104.244.42.0-255,66,11563,6,11695
8304,0.001747,104.244.42.0-255,66,11629,6,11695
8305,0.001793,104.244.42.0-255,66,11695,6,11695
8306,0.0,172.217.24.0-255,153,153,6,107764
8307,2.4e-05,172.31.36.0-255,66,219,6,107764
8308,3.2e-05,172.217.24.0-255,1484,1703,6,107764
8309,3.7e-05,172.31.36.0-255,66,1769,6,107764
8310,4.3e-05,172.217.24.0-255,2902,4671,6,107764
8311,5.4e-05,172.31.36.0-255,66,4737,6,107764
8312,6.2e-05,172.217.24.0-255,7156,11893,6,107764
8313,6.6e-05,172.31.36.0-255,66,11959,6,107764
8314,7.4e-05,172.217.24.0-255,7670,19629,6,107764
8315,7.8e-05,172.31.36.0-255,66,19695,6,107764
8316,8.6e-05,172.217.24.0-255,8574,28269,6,107764
8317,8.9e-05,172.31.36.0-255,66,28335,6,107764
8318,9.3e-05,172.217.24.0-255,2543,30878,6,107764
8319,9.5e-05,172.31.36.0-255,66,30944,6,107764
8320,0.000216,172.217.24.0-255,1484,32428,6,107764
8321,0.00022,172.31.36.0-255,66,32494,6,107764
8322,0.000226,172.217.24.0-255,2902,35396,6,107764
8323,0.000228,172.31.36.0-255,66,35462,6,107764
8324,0.000242,172.217.24.0-255,5738,41200,6,107764
8325,0.000245,172.31.36.0-255,66,41266,6,107764
8326,0.000252,172.217.24.0-255,6797,48063,6,107764
8327,0.000254,172.31.36.0-255,66,48129,6,107764
8328,0.000262,172.217.24.0-255,7156,55285,6,107764
8329,0.000265,172.31.36.0-255,66,55351,6,107764
8330,0.000294,172.217.24.0-255,1484,56835,6,107764
8331,0.000297,172.31.36.0-255,66,56901,6,107764
8332,0.000334,172.217.24.0-255,8215,65116,6,107764
8333,0.000337,172.31.36.0-255,66,65182,6,107764
8334,0.000339,172.217.24.0-255,365,65547,6,107764
8335,0.000341,172.31.36.0-255,66,65613,6,107764
8336,0.001141,172.217.24.0-255,134,65747,6,107764
8337,0.001149,172.31.36.0-255,66,65813,6,107764
8338,0.001349,172.217.24.0-255,1484,67297,6,107764
8339,0.001358,172.217.24.0-255,2902,70199,6,107764
8340,0.001361,172.31.36.0-255,66,70265,6,107764
8341,0.001367,172.217.24.0-255,4320,74585,6,107764
8342,0.001369,172.31.36.0-255,66,74651,6,107764
8343,0.001396,172.217.24.0-255,1484,76135,6,107764
8344,0.001409,172.31.36.0-255,66,76201,6,107764
8345,0.001417,172.217.24.0-255,8574,84775,6,107764
8346,0.001419,172.31.36.0-255,66,84841,6,107764
8347,0.001466,172.217.24.0-255,1125,85966,6,107764
8348,0.003343,172.217.24.0-255,4320,90286,6,107764
8349,0.003346,172.31.36.0-255,66,90352,6,107764
8350,0.005274,172.217.24.0-255,5738,96090,6,107764
8351,0.005277,172.31.36.0-255,66,96156,6,107764
8352,0.007226,172.217.24.0-255,5738,101894,6,107764
8353,0.007239,172.31.36.0-255,66,101960,6,107764
8354,0.009192,172.217.24.0-255,5738,107698,6,107764
8355,0.009204,172.31.36.0-255,66,107764,6,107764
8356,0.0,172.217.160.0-255,150,150,6,123582
8357,2.6e-05,172.31.36.0-255,66,216,6,123582
8358,3.3e-05,172.217.160.0-255,1484,1700,6,123582
8359,3.8e-05,172.31.36.0-255,66,1766,6,123582
8360,4.3e-05,172.217.160.0-255,2902,4668,6,123582
8361,4.7e-05,172.31.36.0-255,66,4734,6,123582
8362,5.5e-05,172.217.160.0-255,7156,11890,6,123582
8363,5.7e-05,172.31.36.0-255,66,11956,6,123582
8364,6.6e-05,172.217.160.0-255,7703,19659,6,123582
8365,7.1e-05,172.31.36.0-255,66,19725,6,123582
8366,8.1e-05,172.217.160.0-255,9992,29717,6,123582
8367,8.5e-05,172.31.36.0-255,66,29783,6,123582
8368,0.000112,172.217.160.0-255,1125,30908,6,123582
8369,0.000115,172.31.36.0-255,66,30974,6,123582
8370,0.000121,172.217.160.0-255,4320,35294,6,123582
8371,0.000124,172.31.36.0-255,66,35360,6,123582
8372,0.00014,172.217.160.0-255,2902,38262,6,123582
8373,0.000143,172.31.36.0-255,66,38328,6,123582
8374,0.000152,172.217.160.0-255,8574,46902,6,123582
8375,0.000155,172.31.36.0-255,66,46968,6,123582
8376,0.000175,172.217.160.0-255,1125,48093,6,123582
8377,0.000178,172.31.36.0-255,66,48159,6,123582
8378,0.000329,172.217.160.0-255,1484,49643,6,123582
8379,0.000333,172.31.36.0-255,66,49709,6,123582
8380,0.000339,172.217.160.0-255,2902,52611,6,123582
8381,0.000342,172.31.36.0-255,66,52677,6,123582
8382,0.00037,172.217.160.0-255,5738,58415,6,123582
8383,0.000373,172.31.36.0-255,66,58481,6,123582
8384,0.000376,172.217.160.0-255,1484,59965,6,123582
8385,0.000378,172.31.36.0-255,66,60031,6,123582
8386,0.000383,172.217.160.0-255,2902,62933,6,123582
8387,0.000385,172.31.36.0-255,66,62999,6,123582
8388,0.000421,172.217.160.0-255,2813,65812,6,123582
8389,0.000424,172.31.36.0-255,66,65878,6,123582
8390,0.001138,172.217.160.0-255,118,65996,6,123582
8391,0.001191,172.31.36.0-255,66,66062,6,123582
8392,0.001296,172.217.160.0-255,1484,67546,6,123582
8393,0.001306,172.217.160.0-255,2902,70448,6,123582
8394,0.00131,172.31.36.0-255,66,70514,6,123582
8395,0.001318,172.217.160.0-255,5738,76252,6,123582
8396,0.00132,172.31.36.0-255,66,76318,6,123582
8397,0.001325,172.217.160.0-255,2902,79220,6,123582
8398,0.001327,172.31.36.0-255,66,79286,6,123582
8399,0.001343,172.217.160.0-255,2902,82188,6,123582
8400,0.001345,172.31.36.0-255,66,82254,6,123582
8401,0.001351,172.217.160.0-255,4320,86574,6,123582
8402,0.001353,172.31.36.0-255,66,86640,6,123582
8403,0.001384,172.217.160.0-255,9633,96273,6,123582
8404,0.001386,172.31.36.0-255,66,96339,6,123582
8405,0.001392,172.217.160.0-255,3961,100300,6,123582
8406,0.001394,172.31.36.0-255,66,100366,6,123582
8407,0.003303,172.217.160.0-255,5738,106104,6,123582
8408,0.003311,172.31.36.0-255,66,106170,6,123582
8409,0.005227,172.217.160.0-255,5738,111908,6,123582
8410,0.005232,172.31.36.0-255,66,111974,6,123582
8411,0.007151,172.217.160.0-255,5738,117712,6,123582
8412,0.00716,172.31.36.0-255,66,117778,6,123582
8413,0.0091,172.217.160.0-255,5738,123516,6,123582
8414,0.009115,172.31.36.0-255,66,123582,6,123582
8415,0.0,172.217.160.0-255,150,150,6,180406
8416,1.5e-05,172.31.36.0-255,66,216,6,180406
8417,2.2e-05,172.217.160.0-255,1484,1700,6,180406
8418,2.6e-05,172.31.36.0-255,66,1766,6,180406
8419,3.2e-05,172.217.160.0-255,2902,4668,6,180406
8420,3.5e-05,172.31.36.0-255,66,4734,6,180406
8421,3.8e-05,172.217.160.0-255,1484,6218,6,180406
8422,4.1e-05,172.31.36.0-255,66,6284,6,180406
8423,4.9e-05,172.217.160.0-255,5738,12022,6,180406
8424,5.2e-05,172.31.36.0-255,66,12088,6,180406
8425,8.9e-05,172.31.36.0-255,66,12154,6,180406
8426,0.000111,172.217.160.0-255,1949,14103,6,180406
8427,0.000114,172.31.36.0-255,66,14169,6,180406
8428,0.00018,172.217.160.0-255,2902,17071,6,180406
8429,0.000184,172.31.36.0-255,66,17137,6,180406
8430,0.000196,172.217.160.0-255,2543,19680,6,180406
8431,0.000198,172.31.36.0-255,66,19746,6,180406
8432,0.000229,172.217.160.0-255,5738,25484,6,180406
8433,0.000232,172.31.36.0-255,66,25550,6,180406
8434,0.000274,172.217.160.0-255,4320,29870,6,180406
8435,0.000278,172.31.36.0-255,66,29936,6,180406
8436,0.000301,172.217.160.0-255,8215,38151,6,180406
8437,0.000304,172.31.36.0-255,66,38217,6,180406
8438,0.000387,172.217.160.0-255,4320,42537,6,180406
8439,0.000391,172.31.36.0-255,66,42603,6,180406
8440,0.000423,172.31.36.0-255,66,42669,6,180406
8441,0.000519,172.217.160.0-255,104,42773,6,180406
8442,0.000524,172.31.36.0-255,66,42839,6,180406
8443,0.00063,172.217.160.0-255,1484,44323,6,180406
8444,0.000635,172.31.36.0-255,66,44389,6,180406
8445,0.00064,172.217.160.0-255,2902,47291,6,180406
8446,0.000643,172.31.36.0-255,66,47357,6,180406
8447,0.00065,172.217.160.0-255,5738,53095,6,180406
8448,0.000653,172.31.36.0-255,66,53161,6,180406
8449,0.000696,172.217.160.0-255,5738,58899,6,180406
8450,0.0007,172.31.36.0-255,66,58965,6,180406
8451,0.000719,172.217.160.0-255,2543,61508,6,180406
8452,0.000721,172.31.36.0-255,66,61574,6,180406
8453,0.000771,172.217.160.0-255,2902,64476,6,180406
8454,0.000775,172.31.36.0-255,66,64542,6,180406
8455,0.000808,172.31.36.0-255,66,64608,6,180406
8456,0.000898,172.217.160.0-255,5738,70346,6,180406
8457,0.000902,172.31.36.0-255,66,70412,6,180406
8458,0.000932,172.217.160.0-255,9992,80404,6,180406
8459,0.000935,172.31.36.0-255,66,80470,6,180406
8460,0.001017,172.217.160.0-255,5738,86208,6,180406
8461,0.001021,172.31.36.0-255,66,86274,6,180406
8462,0.001053,172.31.36.0-255,66,86340,6,180406
8463,0.001163,172.217.160.0-255,1484,87824,6,180406
8464,0.001169,172.217.160.0-255,2902,90726,6,180406
8465,0.001173,172.31.36.0-255,66,90792,6,180406
8466,0.001192,172.217.160.0-255,2902,93694,6,180406
8467,0.001211,172.217.160.0-255,2902,96596,6,180406
8468,0.001215,172.31.36.0-255,66,96662,6,180406
8469,0.00122,172.31.36.0-255,66,96728,6,180406
8470,0.001249,172.217.160.0-255,5738,102466,6,180406
8471,0.001254,172.31.36.0-255,66,102532,6,180406
8472,0.001271,172.217.160.0-255,7156,109688,6,180406
8473,0.001287,172.31.36.0-255,66,109754,6,180406
8474,0.00136,172.217.160.0-255,5738,115492,6,180406
8475,0.001363,172.31.36.0-255,66,115558,6,180406
8476,0.001385,172.217.160.0-255,5020,120578,6,180406
8477,0.001416,172.31.36.0-255,66,120644,6,180406
8478,0.001438,172.217.160.0-255,5738,126382,6,180406
8479,0.001472,172.217.160.0-255,5738,132120,6,180406
8480,0.00151,172.31.36.0-255,66,132186,6,180406
8481,0.001536,172.217.160.0-255,5738,137924,6,180406
8482,0.001716,172.217.160.0-255,5738,143662,6,180406
8483,0.001754,172.217.160.0-255,5738,149400,6,180406
8484,0.001803,172.217.160.0-255,9274,158674,6,180406
8485,0.001993,172.217.160.0-255,9992,168666,6,180406
8486,0.006117,172.31.36.0-255,66,168732,6,180406
8487,0.007748,172.217.160.0-255,5738,174470,6,180406
8488,0.007755,172.31.36.0-255,66,174536,6,180406
8489,0.00937,172.217.160.0-255,4320,178856,6,180406
8490,0.009373,172.31.36.0-255,66,178922,6,180406
8491,0.009389,172.217.160.0-255,1484,180406,6,180406
8492,0.0,74.125.24.0-255,153,153,6,324889
8493,2.2e-05,172.31.36.0-255,66,219,6,324889
8494,2.9e-05,74.125.24.0-255,1484,1703,6,324889
8495,3.4e-05,172.31.36.0-255,66,1769,6,324889
8496,4.8e-05,74.125.24.0-255,2902,4671,6,324889
8497,5e-05,172.31.36.0-255,66,4737,6,324889
8498,5.9e-05,74.125.24.0-255,7156,11893,6,324889
8499,6.2e-05,172.31.36.0-255,66,11959,6,324889
8500,7.2e-05,74.125.24.0-255,10529,22488,6,324889
8501,7.5e-05,172.31.36.0-255,66,22554,6,324889
8502,0.000123,74.125.24.0-255,8215,30769,6,324889
8503,0.000126,172.31.36.0-255,66,30835,6,324889
8504,0.000157,74.125.24.0-255,8574,39409,6,324889
8505,0.00016,172.31.36.0-255,66,39475,6,324889
8506,0.000167,74.125.24.0-255,7156,46631,6,324889
8507,0.00017,172.31.36.0-255,66,46697,6,324889
8508,0.000199,74.125.24.0-255,1125,47822,6,324889
8509,0.000201,172.31.36.0-255,66,47888,6,324889
8510,0.000204,74.125.24.0-255,1484,49372,6,324889
8511,0.000207,172.31.36.0-255,66,49438,6,324889
8512,0.000212,74.125.24.0-255,4320,53758,6,324889
8513,0.000215,172.31.36.0-255,66,53824,6,324889
8514,0.000254,74.125.24.0-255,9992,63816,6,324889
8515,0.000257,172.31.36.0-255,66,63882,6,324889
8516,0.00026,74.125.24.0-255,1453,65335,6,324889
8517,0.000262,172.31.36.0-255,66,65401,6,324889
8518,0.000299,74.125.24.0-255,114,65515,6,324889
8519,0.000301,172.31.36.0-255,66,65581,6,324889
8520,0.000335,74.125.24.0-255,332,65913,6,324889
8521,0.000338,172.31.36.0-255,66,65979,6,324889
8522,0.000713,74.125.24.0-255,1484,67463,6,324889
8523,0.00072,172.31.36.0-255,66,67529,6,324889
8524,0.000725,74.125.24.0-255,2902,70431,6,324889
8525,0.000728,172.31.36.0-255,66,70497,6,324889
8526,0.000761,74.125.24.0-255,5738,76235,6,324889
8527,0.000764,172.31.36.0-255,66,76301,6,324889
8528,0.000769,74.125.24.0-255,4320,80621,6,324889
8529,0.000771,172.31.36.0-255,66,80687,6,324889
8530,0.000803,74.125.24.0-255,8574,89261,6,324889
8531,0.000806,172.31.36.0-255,66,89327,6,324889
8532,0.000814,74.125.24.0-255,7156,96483,6,324889
8533,0.000816,172.31.36.0-255,66,96549,6,324889
8534,0.000821,74.125.24.0-255,3602,100151,6,324889
8535,0.000824,172.31.36.0-255,66,100217,6,324889
8536,0.000892,74.125.24.0-255,1484,101701,6,324889
8537,0.000907,74.125.24.0-255,2902,104603,6,324889
8538,0.000911,172.31.36.0-255,66,104669,6,324889
8539,0.000914,74.125.24.0-255,1484,106153,6,324889
8540,0.000939,74.125.24.0-255,4320,110473,6,324889
8541,0.000942,172.31.36.0-255,66,110539,6,324889
8542,0.000947,74.125.24.0-255,2902,113441,6,324889
8543,0.000949,172.31.36.0-255,66,113507,6,324889
8544,0.000982,74.125.24.0-255,9992,123499,6,324889
8545,0.000984,172.31.36.0-255,66,123565,6,324889
8546,0.000993,74.125.24.0-255,9097,132662,6,324889
8547,0.000995,172.31.36.0-255,66,132728,6,324889
8548,0.001039,74.125.24.0-255,1484,134212,6,324889
8549,0.001079,74.125.24.0-255,1484,135696,6,324889
8550,0.001082,172.31.36.0-255,66,135762,6,324889
8551,0.001086,74.125.24.0-255,2902,138664,6,324889
8552,0.001088,172.31.36.0-255,66,138730,6,324889
8553,0.001091,74.125.24.0-255,1484,140214,6,324889
8554,0.001119,74.125.24.0-255,4320,144534,6,324889
8555,0.001122,172.31.36.0-255,66,144600,6,324889
8556,0.001127,74.125.24.0-255,4320,148920,6,324889
8557,0.001129,172.31.36.0-255,66,148986,6,324889
8558,0.001134,74.125.24.0-255,5738,154724,6,324889
8559,0.001136,172.31.36.0-255,66,154790,6,324889
8560,0.001178,172.31.36.0-255,66,154856,6,324889
8561,0.001181,74.125.24.0-255,766,155622,6,324889
8562,0.001239,74.125.24.0-255,1484,157106,6,324889
8563,0.001242,172.31.36.0-255,66,157172,6,324889
8564,0.001247,74.125.24.0-255,2902,160074,6,324889
8565,0.001249,172.31.36.0-255,66,160140,6,324889
8566,0.001278,74.125.24.0-255,2902,163042,6,324889
8567,0.001281,172.31.36.0-255,66,163108,6,324889
8568,0.001286,74.125.24.0-255,4320,167428,6,324889
8569,0.001288,172.31.36.0-255,66,167494,6,324889
8570,0.001294,74.125.24.0-255,5738,173232,6,324889
8571,0.001296,172.31.36.0-255,66,173298,6,324889
8572,0.001322,74.125.24.0-255,2902,176200,6,324889
8573,0.001324,172.31.36.0-255,66,176266,6,324889
8574,0.001336,172.31.36.0-255,66,176332,6,324889
8575,0.001357,74.125.24.0-255,2184,178516,6,324889
8576,0.001359,172.31.36.0-255,66,178582,6,324889
8577,0.001451,74.125.24.0-255,1484,180066,6,324889
8578,0.001455,74.125.24.0-255,1484,181550,6,324889
8579,0.001458,172.31.36.0-255,66,181616,6,324889
8580,0.001484,74.125.24.0-255,1484,183100,6,324889
8581,0.00149,74.125.24.0-255,5738,188838,6,324889
8582,0.001492,172.31.36.0-255,66,188904,6,324889
8583,0.0015,74.125.24.0-255,8574,197478,6,324889
8584,0.001502,172.31.36.0-255,66,197544,6,324889
8585,0.001518,74.125.24.0-255,4320,201864,6,324889
8586,0.00152,172.31.36.0-255,66,201930,6,324889
8587,0.001528,74.125.24.0-255,8574,210504,6,324889
8588,0.00153,172.31.36.0-255,66,210570,6,324889
8589,0.001559,74.125.24.0-255,1484,212054,6,324889
8590,0.001562,74.125.24.0-255,766,212820,6,324889
8591,0.001564,172.31.36.0-255,66,212886,6,324889
8592,0.001602,74.125.24.0-255,1484,214370,6,324889
8593,0.001607,74.125.24.0-255,4320,218690,6,324889
8594,0.00161,172.31.36.0-255,66,218756,6,324889
8595,0.001642,74.125.24.0-255,8574,227330,6,324889
8596,0.001645,172.31.36.0-255,66,227396,6,324889
8597,0.001663,172.31.36.0-255,66,227462,6,324889
8598,0.001695,74.125.24.0-255,5020,232482,6,324889
8599,0.001697,172.31.36.0-255,66,232548,6,324889
8600,0.001724,74.125.24.0-255,5738,238286,6,324889
8601,0.001727,172.31.36.0-255,66,238352,6,324889
8602,0.001734,74.125.24.0-255,7156,245508,6,324889
8603,0.001738,172.31.36.0-255,66,245574,6,324889
8604,0.001784,172.31.36.0-255,66,245640,6,324889
8605,0.001792,74.125.24.0-255,6438,252078,6,324889
8606,0.001795,172.31.36.0-255,66,252144,6,324889
8607,0.001891,74.125.24.0-255,1484,253628,6,324889
8608,0.001897,74.125.24.0-255,2902,256530,6,324889
8609,0.0019,172.31.36.0-255,66,256596,6,324889
8610,0.001929,74.125.24.0-255,5738,262334,6,324889
8611,0.001932,172.31.36.0-255,66,262400,6,324889
8612,0.001938,74.125.24.0-255,4320,266720,6,324889
8613,0.00194,172.31.36.0-255,66,266786,6,324889
8614,0.001977,74.125.24.0-255,4320,271106,6,324889
8615,0.00198,172.31.36.0-255,66,271172,6,324889
8616,0.002002,74.125.24.0-255,1484,272656,6,324889
8617,0.002015,172.31.36.0-255,66,272722,6,324889
8618,0.002019,74.125.24.0-255,2184,274906,6,324889
8619,0.002021,172.31.36.0-255,66,274972,6,324889
8620,0.002085,74.125.24.0-255,1484,276456,6,324889
8621,0.002089,74.125.24.0-255,1484,277940,6,324889
8622,0.002091,172.31.36.0-255,66,278006,6,324889
8623,0.002119,74.125.24.0-255,1484,279490,6,324889
8624,0.002125,74.125.24.0-255,5738,285228,6,324889
8625,0.002128,172.31.36.0-255,66,285294,6,324889
8626,0.002138,74.125.24.0-255,9992,295286,6,324889
8627,0.00214,172.31.36.0-255,66,295352,6,324889
8628,0.002186,74.125.24.0-255,5738,301090,6,324889
8629,0.002191,172.31.36.0-255,66,301156,6,324889
8630,0.002209,74.125.24.0-255,7856,309012,6,324889
8631,0.002212,172.31.36.0-255,66,309078,6,324889
8632,0.002214,74.125.24.0-255,1484,310562,6,324889
8633,0.002248,172.31.36.0-255,66,310628,6,324889
8634,0.002256,74.125.24.0-255,7156,317784,6,324889
8635,0.002258,172.31.36.0-255,66,317850,6,324889
8636,0.002308,74.125.24.0-255,6631,324481,6,324889
8637,0.002311,172.31.36.0-255,66,324547,6,324889
8638,0.00233,74.125.24.0-255,105,324652,6,324889
8639,0.004381,172.31.36.0-255,66,324718,6,324889
8640,0.004412,172.31.36.0-255,105,324823,6,324889
8641,0.006982,74.125.24.0-255,66,324889,6,324889
8642,0.0,172.217.194.0-255,153,153,6,82002
8643,2.3e-05,172.31.36.0-255,66,219,6,82002
8644,2.9e-05,172.217.194.0-255,1484,1703,6,82002
8645,3.3e-05,172.31.36.0-255,66,1769,6,82002
8646,3.8e-05,172.217.194.0-255,2902,4671,6,82002
8647,4.1e-05,172.31.36.0-255,66,4737,6,82002
8648,9.9e-05,172.217.194.0-255,7156,11893,6,82002
8649,0.000102,172.31.36.0-255,66,11959,6,82002
8650,0.000143,172.217.194.0-255,7727,19686,6,82002
8651,0.000146,172.31.36.0-255,66,19752,6,82002
8652,0.000151,172.217.194.0-255,4320,24072,6,82002
8653,0.000153,172.31.36.0-255,66,24138,6,82002
8654,0.000203,172.217.194.0-255,2902,27040,6,82002
8655,0.000207,172.31.36.0-255,66,27106,6,82002
8656,0.000228,172.217.194.0-255,9992,37098,6,82002
8657,0.000231,172.31.36.0-255,66,37164,6,82002
8658,0.000243,172.217.194.0-255,1484,38648,6,82002
8659,0.000245,172.31.36.0-255,66,38714,6,82002
8660,0.000278,172.217.194.0-255,9274,47988,6,82002
8661,0.000281,172.31.36.0-255,66,48054,6,82002
8662,0.001906,172.217.194.0-255,1484,49538,6,82002
8663,0.001912,172.31.36.0-255,66,49604,6,82002
8664,0.001932,172.217.194.0-255,2902,52506,6,82002
8665,0.001934,172.31.36.0-255,66,52572,6,82002
8666,0.00194,172.217.194.0-255,5738,58310,6,82002
8667,0.001942,172.31.36.0-255,66,58376,6,82002
8668,0.001964,172.217.194.0-255,5738,64114,6,82002
8669,0.001966,172.31.36.0-255,66,64180,6,82002
8670,0.002005,172.217.194.0-255,1432,65612,6,82002
8671,0.00201,172.31.36.0-255,66,65678,6,82002
8672,0.004648,172.217.194.0-255,1484,67162,6,82002
8673,0.004654,172.31.36.0-255,66,67228,6,82002
8674,0.004663,172.217.194.0-255,2902,70130,6,82002
8675,0.004666,172.31.36.0-255,66,70196,6,82002
8676,0.00467,172.217.194.0-255,1484,71680,6,82002
8677,0.00698,172.217.194.0-255,1484,73164,6,82002
8678,0.006989,172.31.36.0-255,66,73230,6,82002
8679,0.007014,172.217.194.0-255,2902,76132,6,82002
8680,0.007018,172.31.36.0-255,66,76198,6,82002
8681,0.00936,172.217.194.0-255,5738,81936,6,82002
8682,0.009368,172.31.36.0-255,66,82002,6,82002
8683,0.0,172.217.194.0-255,161,161,6,242173
8684,2e-05,172.31.36.0-255,66,227,6,242173
8685,2.7e-05,172.217.194.0-255,1484,1711,6,242173
8686,3.1e-05,172.31.36.0-255,66,1777,6,242173
8687,3.6e-05,172.217.194.0-255,2902,4679,6,242173
8688,4.9e-05,172.31.36.0-255,66,4745,6,242173
8689,5.6e-05,172.217.194.0-255,7156,11901,6,242173
8690,5.9e-05,172.31.36.0-255,66,11967,6,242173
8691,6.4e-05,172.217.194.0-255,4320,16287,6,242173
8692,6.9e-05,172.31.36.0-255,66,16353,6,242173
8693,0.000105,172.217.194.0-255,9084,25437,6,242173
8694,0.000108,172.31.36.0-255,66,25503,6,242173
8695,0.000114,172.217.194.0-255,5379,30882,6,242173
8696,0.000117,172.31.36.0-255,66,30948,6,242173
8697,0.000266,172.217.194.0-255,1484,32432,6,242173
8698,0.000271,172.31.36.0-255,66,32498,6,242173
8699,0.000276,172.217.194.0-255,2902,35400,6,242173
8700,0.000279,172.31.36.0-255,66,35466,6,242173
8701,0.000308,172.217.194.0-255,5738,41204,6,242173
8702,0.000311,172.31.36.0-255,66,41270,6,242173
8703,0.000351,172.31.36.0-255,66,41336,6,242173
8704,0.000361,172.217.194.0-255,9925,51261,6,242173
8705,0.000369,172.31.36.0-255,66,51327,6,242173
8706,0.000461,172.217.194.0-255,1484,52811,6,242173
8707,0.000465,172.31.36.0-255,66,52877,6,242173
8708,0.00047,172.217.194.0-255,2902,55779,6,242173
8709,0.000472,172.31.36.0-255,66,55845,6,242173
8710,0.000477,172.217.194.0-255,2902,58747,6,242173
8711,0.000485,172.31.36.0-255,66,58813,6,242173
8712,0.000512,172.217.194.0-255,2902,61715,6,242173
8713,0.000515,172.31.36.0-255,66,61781,6,242173
8714,0.000543,172.217.194.0-255,2902,64683,6,242173
8715,0.000546,172.31.36.0-255,66,64749,6,242173
8716,0.000579,172.217.194.0-255,4237,68986,6,242173
8717,0.000582,172.31.36.0-255,66,69052,6,242173
8718,0.00059,172.217.194.0-255,7156,76208,6,242173
8719,0.000592,172.31.36.0-255,66,76274,6,242173
8720,0.000606,172.217.194.0-255,8574,84848,6,242173
8721,0.000609,172.31.36.0-255,66,84914,6,242173
8722,0.000658,172.31.36.0-255,66,84980,6,242173
8723,0.000662,172.217.194.0-255,766,85746,6,242173
8724,0.000711,172.217.194.0-255,8574,94320,6,242173
8725,0.000714,172.31.36.0-255,66,94386,6,242173
8726,0.000753,172.217.194.0-255,8574,102960,6,242173
8727,0.000756,172.31.36.0-255,66,103026,6,242173
8728,0.00078,172.31.36.0-255,66,103092,6,242173
8729,0.000789,172.217.194.0-255,9992,113084,6,242173
8730,0.000792,172.31.36.0-255,66,113150,6,242173
8731,0.000795,172.217.194.0-255,1484,114634,6,242173
8732,0.000827,172.217.194.0-255,3961,118595,6,242173
8733,0.000831,172.31.36.0-255,66,118661,6,242173
8734,0.000837,172.217.194.0-255,5738,124399,6,242173
8735,0.000839,172.31.36.0-255,66,124465,6,242173
8736,0.000884,172.217.194.0-255,8574,133039,6,242173
8737,0.000888,172.31.36.0-255,66,133105,6,242173
8738,0.000928,172.217.194.0-255,4320,137425,6,242173
8739,0.000932,172.31.36.0-255,66,137491,6,242173
8740,0.000941,172.217.194.0-255,9992,147483,6,242173
8741,0.000943,172.31.36.0-255,66,147549,6,242173
8742,0.000965,172.31.36.0-255,66,147615,6,242173
8743,0.000986,172.217.194.0-255,9992,157607,6,242173
8744,0.000991,172.31.36.0-255,66,157673,6,242173
8745,0.001039,172.31.36.0-255,66,157739,6,242173
8746,0.001057,172.31.36.0-255,66,157805,6,242173
8747,0.001065,172.217.194.0-255,8574,166379,6,242173
8748,0.001072,172.31.36.0-255,66,166445,6,242173
8749,0.001086,172.217.194.0-255,1484,167929,6,242173
8750,0.0011,172.217.194.0-255,1484,169413,6,242173
8751,0.001107,172.31.36.0-255,66,169479,6,242173
8752,0.00113,172.217.194.0-255,10692,180171,6,242173
8753,0.001137,172.31.36.0-255,66,180237,6,242173
8754,0.001225,172.217.194.0-255,1484,181721,6,242173
8755,0.001243,172.217.194.0-255,2902,184623,6,242173
8756,0.001251,172.31.36.0-255,66,184689,6,242173
8757,0.001263,172.217.194.0-255,5738,190427,6,242173
8758,0.001268,172.31.36.0-255,66,190493,6,242173
8759,0.001273,172.217.194.0-255,4320,194813,6,242173
8760,0.001285,172.31.36.0-255,66,194879,6,242173
8761,0.001301,172.217.194.0-255,2543,197422,6,242173
8762,0.001305,172.31.36.0-255,66,197488,6,242173
8763,0.001338,172.217.194.0-255,1484,198972,6,242173
8764,0.001353,172.217.194.0-255,2902,201874,6,242173
8765,0.001361,172.31.36.0-255,66,201940,6,242173
8766,0.001381,172.217.194.0-255,5738,207678,6,242173
8767,0.001388,172.31.36.0-255,66,207744,6,242173
8768,0.001396,172.217.194.0-255,1484,209228,6,242173
8769,0.001401,172.31.36.0-255,66,209294,6,242173
8770,0.00144,172.217.194.0-255,9274,218568,6,242173
8771,0.001448,172.31.36.0-255,66,218634,6,242173
8772,0.001459,172.217.194.0-255,2902,221536,6,242173
8773,0.001467,172.31.36.0-255,66,221602,6,242173
8774,0.001502,172.217.194.0-255,5738,227340,6,242173
8775,0.00151,172.217.194.0-255,9992,237332,6,242173
8776,0.001511,172.31.36.0-255,66,237398,6,242173
8777,0.001516,172.31.36.0-255,66,237464,6,242173
8778,0.001598,172.31.36.0-255,66,237530,6,242173
8779,0.001599,172.217.194.0-255,4235,241765,6,242173
8780,0.001601,172.217.194.0-255,105,241870,6,242173
8781,0.001602,172.31.36.0-255,66,241936,6,242173
8782,0.003457,172.31.36.0-255,66,242002,6,242173
8783,0.003485,172.31.36.0-255,105,242107,6,242173
8784,0.005951,172.217.194.0-255,66,242173,6,242173
8785,0.0,74.125.130.0-255,153,153,6,278148
8786,2.7e-05,172.31.36.0-255,66,219,6,278148
8787,3.3e-05,74.125.130.0-255,1484,1703,6,278148
8788,3.8e-05,172.31.36.0-255,66,1769,6,278148
8789,4.2e-05,74.125.130.0-255,2902,4671,6,278148
8790,4.5e-05,172.31.36.0-255,66,4737,6,278148
8791,5.1e-05,74.125.130.0-255,4320,9057,6,278148
8792,5.4e-05,172.31.36.0-255,66,9123,6,278148
8793,6e-05,74.125.130.0-255,4868,13991,6,278148
8794,6.3e-05,172.31.36.0-255,66,14057,6,278148
8795,0.000138,74.125.130.0-255,1484,15541,6,278148
8796,0.000142,172.31.36.0-255,66,15607,6,278148
8797,0.000148,74.125.130.0-255,2902,18509,6,278148
8798,0.000151,172.31.36.0-255,66,18575,6,278148
8799,0.000178,74.125.130.0-255,5738,24313,6,278148
8800,0.000182,172.31.36.0-255,66,24379,6,278148
8801,0.000195,74.125.130.0-255,4320,28699,6,278148
8802,0.000198,172.31.36.0-255,66,28765,6,278148
8803,0.000214,74.125.130.0-255,2543,31308,6,278148
8804,0.000217,172.31.36.0-255,66,31374,6,278148
8805,0.00043,74.125.130.0-255,1484,32858,6,278148
8806,0.000434,172.31.36.0-255,66,32924,6,278148
8807,0.000438,74.125.130.0-255,1484,34408,6,278148
8808,0.000442,172.31.36.0-255,66,34474,6,278148
8809,0.000458,74.125.130.0-255,2902,37376,6,278148
8810,0.000461,172.31.36.0-255,66,37442,6,278148
8811,0.000466,74.125.130.0-255,1484,38926,6,278148
8812,0.00047,172.31.36.0-255,66,38992,6,278148
8813,0.00049,74.125.130.0-255,4320,43312,6,278148
8814,0.000493,172.31.36.0-255,66,43378,6,278148
8815,0.000497,74.125.130.0-255,1484,44862,6,278148
8816,0.000499,172.31.36.0-255,66,44928,6,278148
8817,0.000524,74.125.130.0-255,3961,48889,6,278148
8818,0.000531,74.125.130.0-255,5738,54627,6,278148
8819,0.000538,172.31.36.0-255,66,54693,6,278148
8820,0.000545,74.125.130.0-255,1484,56177,6,278148
8821,0.000566,74.125.130.0-255,9633,65810,6,278148
8822,0.000585,172.31.36.0-255,66,65876,6,278148
8823,0.001344,74.125.130.0-255,646,66522,6,278148
8824,0.001468,74.125.130.0-255,1484,68006,6,278148
8825,0.001473,172.31.36.0-255,66,68072,6,278148
8826,0.001479,74.125.130.0-255,2902,70974,6,278148
8827,0.001497,74.125.130.0-255,5738,76712,6,278148
8828,0.001526,74.125.130.0-255,8574,85286,6,278148
8829,0.001534,74.125.130.0-255,9992,95278,6,278148
8830,0.001577,74.125.130.0-255,5020,100298,6,278148
8831,0.001673,74.125.130.0-255,1484,101782,6,278148
8832,0.001691,74.125.130.0-255,2902,104684,6,278148
8833,0.001694,74.125.130.0-255,1484,106168,6,278148
8834,0.001721,74.125.130.0-255,4320,110488,6,278148
8835,0.001726,74.125.130.0-255,4320,114808,6,278148
8836,0.001732,74.125.130.0-255,5738,120546,6,278148
8837,0.001739,74.125.130.0-255,8574,129120,6,278148
8838,0.00175,74.125.130.0-255,2902,132022,6,278148
8839,0.001753,74.125.130.0-255,2184,134206,6,278148
8840,0.001847,74.125.130.0-255,1484,135690,6,278148
8841,0.001864,74.125.130.0-255,2902,138592,6,278148
8842,0.00187,74.125.130.0-255,5738,144330,6,278148
8843,0.001897,74.125.130.0-255,7156,151486,6,278148
8844,0.001911,74.125.130.0-255,5738,157224,6,278148
8845,0.001918,74.125.130.0-255,7156,164380,6,278148
8846,0.001935,74.125.130.0-255,3602,167982,6,278148
8847,0.002113,74.125.130.0-255,1484,169466,6,278148
8848,0.002116,74.125.130.0-255,1484,170950,6,278148
8849,0.002133,74.125.130.0-255,1484,172434,6,278148
8850,0.00214,74.125.130.0-255,5738,178172,6,278148
8851,0.002161,74.125.130.0-255,7156,185328,6,278148
8852,0.002178,74.125.130.0-255,5738,191066,6,278148
8853,0.002185,74.125.130.0-255,7156,198222,6,278148
8854,0.00222,74.125.130.0-255,3602,201824,6,278148
8855,0.002356,74.125.130.0-255,1484,203308,6,278148
8856,0.002367,74.125.130.0-255,2902,206210,6,278148
8857,0.002387,74.125.130.0-255,5738,211948,6,278148
8858,0.002419,74.125.130.0-255,2902,214850,6,278148
8859,0.002438,74.125.130.0-255,7856,222706,6,278148
8860,0.002441,74.125.130.0-255,1484,224190,6,278148
8861,0.002459,74.125.130.0-255,9992,234182,6,278148
8862,0.002476,74.125.130.0-255,4320,238502,6,278148
8863,0.002505,74.125.130.0-255,7156,245658,6,278148
8864,0.002509,74.125.130.0-255,2902,248560,6,278148
8865,0.002538,74.125.130.0-255,9274,257834,6,278148
8866,0.002544,74.125.130.0-255,7156,264990,6,278148
8867,0.002617,74.125.130.0-255,1484,266474,6,278148
8868,0.003491,172.31.36.0-255,66,266540,6,278148
8869,0.006082,74.125.130.0-255,5738,272278,6,278148
8870,0.006089,172.31.36.0-255,66,272344,6,278148
8871,0.008645,74.125.130.0-255,5738,278082,6,278148
8872,0.00865,172.31.36.0-255,66,278148,6,278148
8873,0.0,172.217.194.0-255,153,153,6,269274
8874,3.5e-05,172.31.36.0-255,66,219,6,269274
8875,4.2e-05,172.217.194.0-255,1484,1703,6,269274
8876,4.7e-05,172.31.36.0-255,66,1769,6,269274
8877,5e-05,172.217.194.0-255,1484,3253,6,269274
8878,5.9e-05,172.31.36.0-255,66,3319,6,269274
8879,6.5e-05,172.217.194.0-255,2902,6221,6,269274
8880,6.8e-05,172.31.36.0-255,66,6287,6,269274
8881,7.4e-05,172.217.194.0-255,5738,12025,6,269274
8882,7.7e-05,172.31.36.0-255,66,12091,6,269274
8883,0.000101,172.217.194.0-255,2047,14138,6,269274
8884,0.000104,172.31.36.0-255,66,14204,6,269274
8885,0.00011,172.217.194.0-255,2902,17106,6,269274
8886,0.000112,172.31.36.0-255,66,17172,6,269274
8887,0.000119,172.217.194.0-255,7156,24328,6,269274
8888,0.000121,172.31.36.0-255,66,24394,6,269274
8889,0.000149,172.217.194.0-255,6797,31191,6,269274
8890,0.000152,172.31.36.0-255,66,31257,6,269274
8891,0.000197,172.217.194.0-255,1484,32741,6,269274
8892,0.0002,172.31.36.0-255,66,32807,6,269274
8893,0.000207,172.217.194.0-255,2902,35709,6,269274
8894,0.000209,172.31.36.0-255,66,35775,6,269274
8895,0.000243,172.217.194.0-255,5738,41513,6,269274
8896,0.000247,172.31.36.0-255,66,41579,6,269274
8897,0.000255,172.217.194.0-255,8215,49794,6,269274
8898,0.000258,172.31.36.0-255,66,49860,6,269274
8899,0.000272,172.217.194.0-255,8574,58434,6,269274
8900,0.000275,172.31.36.0-255,66,58500,6,269274
8901,0.000303,172.217.194.0-255,7086,65586,6,269274
8902,0.000307,172.31.36.0-255,66,65652,6,269274
8903,0.00031,172.217.194.0-255,98,65750,6,269274
8904,0.000312,172.31.36.0-255,66,65816,6,269274
8905,0.000387,172.217.194.0-255,1484,67300,6,269274
8906,0.000394,172.217.194.0-255,2902,70202,6,269274
8907,0.000407,172.31.36.0-255,66,70268,6,269274
8908,0.000408,172.217.194.0-255,2902,73170,6,269274
8909,0.000414,172.31.36.0-255,66,73236,6,269274
8910,0.000426,172.217.194.0-255,2902,76138,6,269274
8911,0.000431,172.31.36.0-255,66,76204,6,269274
8912,0.000443,172.217.194.0-255,4320,80524,6,269274
8913,0.000448,172.31.36.0-255,66,80590,6,269274
8914,0.000473,172.217.194.0-255,2543,83133,6,269274
8915,0.000477,172.31.36.0-255,66,83199,6,269274
8916,0.00048,172.217.194.0-255,7156,90355,6,269274
8917,0.000494,172.31.36.0-255,66,90421,6,269274
8918,0.000508,172.217.194.0-255,9633,100054,6,269274
8919,0.000512,172.31.36.0-255,66,100120,6,269274
8920,0.000663,172.217.194.0-255,1484,101604,6,269274
8921,0.000669,172.217.194.0-255,2902,104506,6,269274
8922,0.000672,172.217.194.0-255,1484,105990,6,269274
8923,0.000676,172.31.36.0-255,66,106056,6,269274
8924,0.000682,172.217.194.0-255,1484,107540,6,269274
8925,0.000685,172.31.36.0-255,66,107606,6,269274
8926,0.000714,172.217.194.0-255,2902,110508,6,269274
8927,0.000721,172.217.194.0-255,7156,117664,6,269274
8928,0.000727,172.31.36.0-255,66,117730,6,269274
8929,0.000785,172.217.194.0-255,2184,119914,6,269274
8930,0.000788,172.31.36.0-255,66,119980,6,269274
8931,0.000793,172.31.36.0-255,66,120046,6,269274
8932,0.000834,172.217.194.0-255,5738,125784,6,269274
8933,0.000837,172.31.36.0-255,66,125850,6,269274
8934,0.000842,172.31.36.0-255,66,125916,6,269274
8935,0.000882,172.217.194.0-255,9992,135908,6,269274
8936,0.000887,172.31.36.0-255,66,135974,6,269274
8937,0.000891,172.217.194.0-255,7856,143830,6,269274
8938,0.000917,172.217.194.0-255,7156,150986,6,269274
8939,0.000919,172.31.36.0-255,66,151052,6,269274
8940,0.000923,172.31.36.0-255,66,151118,6,269274
8941,0.000971,172.217.194.0-255,9274,160392,6,269274
8942,0.00098,172.31.36.0-255,66,160458,6,269274
8943,0.001004,172.217.194.0-255,10290,170748,6,269274
8944,0.001012,172.217.194.0-255,5738,176486,6,269274
8945,0.001017,172.31.36.0-255,66,176552,6,269274
8946,0.001061,172.217.194.0-255,9992,186544,6,269274
8947,0.001074,172.31.36.0-255,66,186610,6,269274
8948,0.001084,172.217.194.0-255,7856,194466,6,269274
8949,0.001092,172.31.36.0-255,66,194532,6,269274
8950,0.001556,172.217.194.0-255,1484,196016,6,269274
8951,0.001575,172.217.194.0-255,2902,198918,6,269274
8952,0.001579,172.31.36.0-255,66,198984,6,269274
8953,0.001586,172.217.194.0-255,5738,204722,6,269274
8954,0.001596,172.31.36.0-255,66,204788,6,269274
8955,0.001609,172.217.194.0-255,5738,210526,6,269274
8956,0.001625,172.31.36.0-255,66,210592,6,269274
8957,0.00165,172.217.194.0-255,7156,217748,6,269274
8958,0.001654,172.31.36.0-255,66,217814,6,269274
8959,0.001664,172.217.194.0-255,10692,228506,6,269274
8960,0.001669,172.31.36.0-255,66,228572,6,269274
8961,0.001919,172.217.194.0-255,1484,230056,6,269274
8962,0.001934,172.217.194.0-255,2902,232958,6,269274
8963,0.001939,172.31.36.0-255,66,233024,6,269274
8964,0.001948,172.217.194.0-255,4320,237344,6,269274
8965,0.001953,172.31.36.0-255,66,237410,6,269274
8966,0.001968,172.217.194.0-255,1484,238894,6,269274
8967,0.001971,172.217.194.0-255,1484,240378,6,269274
8968,0.001983,172.31.36.0-255,66,240444,6,269274
8969,0.002007,172.217.194.0-255,8574,249018,6,269274
8970,0.002007,172.31.36.0-255,66,249084,6,269274
8971,0.002011,172.31.36.0-255,66,249150,6,269274
8972,0.00206,172.217.194.0-255,2184,251334,6,269274
8973,0.002077,172.31.36.0-255,66,251400,6,269274
8974,0.00403,172.217.194.0-255,2902,254302,6,269274
8975,0.004041,172.31.36.0-255,66,254368,6,269274
8976,0.004122,172.217.194.0-255,2902,257270,6,269274
8977,0.004153,172.31.36.0-255,66,257336,6,269274
8978,0.006047,172.217.194.0-255,2902,260238,6,269274
8979,0.006052,172.31.36.0-255,66,260304,6,269274
8980,0.006151,172.217.194.0-255,2902,263206,6,269274
8981,0.006155,172.31.36.0-255,66,263272,6,269274
8982,0.008051,172.217.194.0-255,1484,264756,6,269274
8983,0.008073,172.217.194.0-255,1484,266240,6,269274
8984,0.008076,172.31.36.0-255,66,266306,6,269274
8985,0.00816,172.217.194.0-255,2902,269208,6,269274
8986,0.008163,172.31.36.0-255,66,269274,6,269274
8987,0.0,74.125.24.0-255,297,297,6,216583
8988,2.6e-05,172.31.36.0-255,66,363,6,216583
8989,3.3e-05,74.125.24.0-255,1484,1847,6,216583
8990,3.7e-05,172.31.36.0-255,66,1913,6,216583
8991,4.5e-05,74.125.24.0-255,4320,6233,6,216583
8992,5.5e-05,172.31.36.0-255,66,6299,6,216583
8993,6.8e-05,74.125.24.0-255,8981,15280,6,216583
8994,7.1e-05,172.31.36.0-255,66,15346,6,216583
8995,8e-05,74.125.24.0-255,9992,25338,6,216583
8996,8.3e-05,172.31.36.0-255,66,25404,6,216583
8997,8.9e-05,74.125.24.0-255,5379,30783,6,216583
8998,9.5e-05,172.31.36.0-255,66,30849,6,216583
8999,0.000263,74.125.24.0-255,1484,32333,6,216583
9000,0.000269,172.31.36.0-255,66,32399,6,216583
9001,0.000274,74.125.24.0-255,2902,35301,6,216583
9002,0.000277,172.31.36.0-255,66,35367,6,216583
9003,0.000282,74.125.24.0-255,2902,38269,6,216583
9004,0.000289,172.31.36.0-255,66,38335,6,216583
9005,0.000319,74.125.24.0-255,2902,41237,6,216583
9006,0.000322,172.31.36.0-255,66,41303,6,216583
9007,0.000344,172.31.36.0-255,66,41369,6,216583
9008,0.000354,74.125.24.0-255,9633,51002,6,216583
9009,0.000356,172.31.36.0-255,66,51068,6,216583
9010,0.000469,74.125.24.0-255,367,51435,6,216583
9011,0.000473,172.31.36.0-255,66,51501,6,216583
9012,0.000563,74.125.24.0-255,1484,52985,6,216583
9013,0.000566,172.31.36.0-255,66,53051,6,216583
9014,0.00057,74.125.24.0-255,1484,54535,6,216583
9015,0.000573,172.31.36.0-255,66,54601,6,216583
9016,0.000593,74.125.24.0-255,1484,56085,6,216583
9017,0.000595,172.31.36.0-255,66,56151,6,216583
9018,0.000602,74.125.24.0-255,5738,61889,6,216583
9019,0.000605,172.31.36.0-255,66,61955,6,216583
9020,0.00061,74.125.24.0-255,2902,64857,6,216583
9021,0.000612,172.31.36.0-255,66,64923,6,216583
9022,0.000658,74.125.24.0-255,9992,74915,6,216583
9023,0.000661,172.31.36.0-255,66,74981,6,216583
9024,0.000674,172.31.36.0-255,66,75047,6,216583
9025,0.000956,74.125.24.0-255,1484,76531,6,216583
9026,0.000965,74.125.24.0-255,2902,79433,6,216583
9027,0.000968,172.31.36.0-255,66,79499,6,216583
9028,0.000976,74.125.24.0-255,5738,85237,6,216583
9029,0.000979,172.31.36.0-255,66,85303,6,216583
9030,0.000989,74.125.24.0-255,4320,89623,6,216583
9031,0.000991,172.31.36.0-255,66,89689,6,216583
9032,0.001017,74.125.24.0-255,4320,94009,6,216583
9033,0.001019,172.31.36.0-255,66,94075,6,216583
9034,0.001046,74.125.24.0-255,7156,101231,6,216583
9035,0.001049,172.31.36.0-255,66,101297,6,216583
9036,0.001062,74.125.24.0-255,7856,109153,6,216583
9037,0.001064,172.31.36.0-255,66,109219,6,216583
9038,0.001122,74.125.24.0-255,1484,110703,6,216583
9039,0.001128,74.125.24.0-255,2902,113605,6,216583
9040,0.001131,172.31.36.0-255,66,113671,6,216583
9041,0.001157,74.125.24.0-255,5738,119409,6,216583
9042,0.00116,172.31.36.0-255,66,119475,6,216583
9043,0.001198,172.31.36.0-255,66,119541,6,216583
9044,0.001205,74.125.24.0-255,5738,125279,6,216583
9045,0.001207,172.31.36.0-255,66,125345,6,216583
9046,0.001274,74.125.24.0-255,5020,130365,6,216583
9047,0.001277,172.31.36.0-255,66,130431,6,216583
9048,0.00139,74.125.24.0-255,1484,131915,6,216583
9049,0.001403,74.125.24.0-255,2902,134817,6,216583
9050,0.001406,172.31.36.0-255,66,134883,6,216583
9051,0.001432,74.125.24.0-255,1484,136367,6,216583
9052,0.001452,74.125.24.0-255,4320,140687,6,216583
9053,0.001455,172.31.36.0-255,66,140753,6,216583
9054,0.001461,74.125.24.0-255,5738,146491,6,216583
9055,0.001464,172.31.36.0-255,66,146557,6,216583
9056,0.001495,74.125.24.0-255,5738,152295,6,216583
9057,0.001498,172.31.36.0-255,66,152361,6,216583
9058,0.001523,74.125.24.0-255,7156,159517,6,216583
9059,0.001526,172.31.36.0-255,66,159583,6,216583
9060,0.001532,74.125.24.0-255,5020,164603,6,216583
9061,0.001534,172.31.36.0-255,66,164669,6,216583
9062,0.001807,74.125.24.0-255,1484,166153,6,216583
9063,0.001821,74.125.24.0-255,2902,169055,6,216583
9064,0.001825,172.31.36.0-255,66,169121,6,216583
9065,0.00185,74.125.24.0-255,5738,174859,6,216583
9066,0.001853,172.31.36.0-255,66,174925,6,216583
9067,0.00189,74.125.24.0-255,9992,184917,6,216583
9068,0.001894,172.31.36.0-255,66,184983,6,216583
9069,0.001902,74.125.24.0-255,7156,192139,6,216583
9070,0.001904,172.31.36.0-255,66,192205,6,216583
9071,0.001934,74.125.24.0-255,4320,196525,6,216583
9072,0.001936,172.31.36.0-255,66,196591,6,216583
9073,0.001941,74.125.24.0-255,2184,198775,6,216583
9074,0.001943,172.31.36.0-255,66,198841,6,216583
9075,0.00448,74.125.24.0-255,2902,201743,6,216583
9076,0.004488,172.31.36.0-255,66,201809,6,216583
9077,0.004516,74.125.24.0-255,2902,204711,6,216583
9078,0.004519,172.31.36.0-255,66,204777,6,216583
9079,0.007036,74.125.24.0-255,2902,207679,6,216583
9080,0.007044,172.31.36.0-255,66,207745,6,216583
9081,0.007065,74.125.24.0-255,2902,210647,6,216583
9082,0.007068,172.31.36.0-255,66,210713,6,216583
9083,0.009624,74.125.24.0-255,4320,215033,6,216583
9084,0.009631,172.31.36.0-255,66,215099,6,216583
9085,0.009664,74.125.24.0-255,1484,216583,6,216583
9086,0.0,74.125.24.0-255,153,153,6,278381
9087,2.4e-05,172.31.36.0-255,66,219,6,278381
9088,3e-05,74.125.24.0-255,1484,1703,6,278381
9089,3.6e-05,172.31.36.0-255,66,1769,6,278381
9090,4.1e-05,74.125.24.0-255,2902,4671,6,278381
9091,4.4e-05,172.31.36.0-255,66,4737,6,278381
9092,5.1e-05,74.125.24.0-255,4320,9057,6,278381
9093,5.4e-05,172.31.36.0-255,66,9123,6,278381
9094,9.3e-05,74.125.24.0-255,4776,13899,6,278381
9095,9.7e-05,172.31.36.0-255,66,13965,6,278381
9096,0.000217,74.125.24.0-255,1484,15449,6,278381
9097,0.00022,172.31.36.0-255,66,15515,6,278381
9098,0.000225,74.125.24.0-255,1484,16999,6,278381
9099,0.000227,172.31.36.0-255,66,17065,6,278381
9100,0.00024,74.125.24.0-255,1484,18549,6,278381
9101,0.000242,172.31.36.0-255,66,18615,6,278381
9102,0.000249,74.125.24.0-255,5738,24353,6,278381
9103,0.000252,172.31.36.0-255,66,24419,6,278381
9104,0.000289,74.125.24.0-255,5738,30157,6,278381
9105,0.000292,172.31.36.0-255,66,30223,6,278381
9106,0.000314,74.125.24.0-255,2543,32766,6,278381
9107,0.000316,172.31.36.0-255,66,32832,6,278381
9108,0.000325,74.125.24.0-255,8574,41406,6,278381
9109,0.000328,172.31.36.0-255,66,41472,6,278381
9110,0.000369,172.31.36.0-255,66,41538,6,278381
9111,0.00039,74.125.24.0-255,7156,48694,6,278381
9112,0.000393,172.31.36.0-255,66,48760,6,278381
9113,0.000415,74.125.24.0-255,3931,52691,6,278381
9114,0.000417,172.31.36.0-255,66,52757,6,278381
9115,0.000446,74.125.24.0-255,112,52869,6,278381
9116,0.000449,172.31.36.0-255,66,52935,6,278381
9117,0.000559,74.125.24.0-255,1484,54419,6,278381
9118,0.000574,74.125.24.0-255,1484,55903,6,278381
9119,0.000576,172.31.36.0-255,66,55969,6,278381
9120,0.000595,74.125.24.0-255,1484,57453,6,278381
9121,0.000603,74.125.24.0-255,5738,63191,6,278381
9122,0.000605,172.31.36.0-255,66,63257,6,278381
9123,0.000654,172.31.36.0-255,66,63323,6,278381
9124,0.000661,74.125.24.0-255,5738,69061,6,278381
9125,0.000664,172.31.36.0-255,66,69127,6,278381
9126,0.000685,74.125.24.0-255,1484,70611,6,278381
9127,0.000707,74.125.24.0-255,3602,74213,6,278381
9128,0.000709,172.31.36.0-255,66,74279,6,278381
9129,0.000914,74.125.24.0-255,1484,75763,6,278381
9130,0.000922,74.125.24.0-255,2902,78665,6,278381
9131,0.000925,172.31.36.0-255,66,78731,6,278381
9132,0.000954,74.125.24.0-255,4320,83051,6,278381
9133,0.000957,172.31.36.0-255,66,83117,6,278381
9134,0.000982,74.125.24.0-255,4320,87437,6,278381
9135,0.000985,172.31.36.0-255,66,87503,6,278381
9136,0.001005,74.125.24.0-255,4320,91823,6,278381
9137,0.001008,172.31.36.0-255,66,91889,6,278381
9138,0.001012,74.125.24.0-255,2902,94791,6,278381
9139,0.001014,172.31.36.0-255,66,94857,6,278381
9140,0.001018,74.125.24.0-255,1484,96341,6,278381
9141,0.001035,74.125.24.0-255,2902,99243,6,278381
9142,0.001037,172.31.36.0-255,66,99309,6,278381
9143,0.001042,74.125.24.0-255,4320,103629,6,278381
9144,0.001045,172.31.36.0-255,66,103695,6,278381
9145,0.001059,74.125.24.0-255,1484,105179,6,278381
9146,0.001104,74.125.24.0-255,3602,108781,6,278381
9147,0.001106,172.31.36.0-255,66,108847,6,278381
9148,0.001462,74.125.24.0-255,1484,110331,6,278381
9149,0.001488,74.125.24.0-255,1484,111815,6,278381
9150,0.001492,172.31.36.0-255,66,111881,6,278381
9151,0.001506,74.125.24.0-255,1484,113365,6,278381
9152,0.001513,74.125.24.0-255,5738,119103,6,278381
9153,0.001516,172.31.36.0-255,66,119169,6,278381
9154,0.00153,74.125.24.0-255,2902,122071,6,278381
9155,0.001533,172.31.36.0-255,66,122137,6,278381
9156,0.00156,74.125.24.0-255,1484,123621,6,278381
9157,0.001573,172.31.36.0-255,66,123687,6,278381
9158,0.001581,74.125.24.0-255,7856,131543,6,278381
9159,0.001584,172.31.36.0-255,66,131609,6,278381
9160,0.001826,74.125.24.0-255,1484,133093,6,278381
9161,0.001833,74.125.24.0-255,2902,135995,6,278381
9162,0.001836,172.31.36.0-255,66,136061,6,278381
9163,0.00184,74.125.24.0-255,1484,137545,6,278381
9164,0.001857,74.125.24.0-255,2902,140447,6,278381
9165,0.001859,172.31.36.0-255,66,140513,6,278381
9166,0.001882,74.125.24.0-255,7156,147669,6,278381
9167,0.001885,172.31.36.0-255,66,147735,6,278381
9168,0.001902,74.125.24.0-255,1484,149219,6,278381
9169,0.001918,74.125.24.0-255,2902,152121,6,278381
9170,0.00192,172.31.36.0-255,66,152187,6,278381
9171,0.001954,172.31.36.0-255,66,152253,6,278381
9172,0.001985,172.31.36.0-255,66,152319,6,278381
9173,0.00199,74.125.24.0-255,4320,156639,6,278381
9174,0.001993,172.31.36.0-255,66,156705,6,278381
9175,0.002028,172.31.36.0-255,66,156771,6,278381
9176,0.002035,74.125.24.0-255,5020,161791,6,278381
9177,0.002037,172.31.36.0-255,66,161857,6,278381
9178,0.002071,74.125.24.0-255,5738,167595,6,278381
9179,0.002074,172.31.36.0-255,66,167661,6,278381
9180,0.002099,74.125.24.0-255,7156,174817,6,278381
9181,0.002102,172.31.36.0-255,66,174883,6,278381
9182,0.002115,74.125.24.0-255,7156,182039,6,278381
9183,0.002117,172.31.36.0-255,66,182105,6,278381
9184,0.002142,74.125.24.0-255,7156,189261,6,278381
9185,0.002145,172.31.36.0-255,66,189327,6,278381
9186,0.002169,74.125.24.0-255,5738,195065,6,278381
9187,0.002171,172.31.36.0-255,66,195131,6,278381
9188,0.002174,74.125.24.0-255,766,195897,6,278381
9189,0.002177,74.125.24.0-255,1484,197381,6,278381
9190,0.002179,172.31.36.0-255,66,197447,6,278381
9191,0.002185,74.125.24.0-255,4320,201767,6,278381
9192,0.002188,172.31.36.0-255,66,201833,6,278381
9193,0.002229,74.125.24.0-255,2902,204735,6,278381
9194,0.002232,172.31.36.0-255,66,204801,6,278381
9195,0.002249,74.125.24.0-255,7156,211957,6,278381
9196,0.002252,172.31.36.0-255,66,212023,6,278381
9197,0.002258,74.125.24.0-255,5738,217761,6,278381
9198,0.00226,172.31.36.0-255,66,217827,6,278381
9199,0.002263,74.125.24.0-255,1484,219311,6,278381
9200,0.002294,172.31.36.0-255,66,219377,6,278381
9201,0.002299,74.125.24.0-255,2902,222279,6,278381
9202,0.002301,172.31.36.0-255,66,222345,6,278381
9203,0.00232,74.125.24.0-255,9992,232337,6,278381
9204,0.002322,172.31.36.0-255,66,232403,6,278381
9205,0.002337,74.125.24.0-255,5738,238141,6,278381
9206,0.00234,172.31.36.0-255,66,238207,6,278381
9207,0.002345,74.125.24.0-255,4320,242527,6,278381
9208,0.002347,172.31.36.0-255,66,242593,6,278381
9209,0.002365,74.125.24.0-255,1484,244077,6,278381
9210,0.002371,74.125.24.0-255,3602,247679,6,278381
9211,0.002373,172.31.36.0-255,66,247745,6,278381
9212,0.002393,74.125.24.0-255,1484,249229,6,278381
9213,0.002414,74.125.24.0-255,2902,252131,6,278381
9214,0.002417,172.31.36.0-255,66,252197,6,278381
9215,0.002424,74.125.24.0-255,5738,257935,6,278381
9216,0.002426,172.31.36.0-255,66,258001,6,278381
9217,0.002431,74.125.24.0-255,2902,260903,6,278381
9218,0.002433,172.31.36.0-255,66,260969,6,278381
9219,0.004831,74.125.24.0-255,5738,266707,6,278381
9220,0.004838,172.31.36.0-255,66,266773,6,278381
9221,0.007259,74.125.24.0-255,5738,272511,6,278381
9222,0.007263,172.31.36.0-255,66,272577,6,278381
9223,0.009658,74.125.24.0-255,5738,278315,6,278381
9224,0.009677,172.31.36.0-255,66,278381,6,278381
9225,0.0,172.217.194.0-255,153,153,6,331396
9226,1.3e-05,172.31.36.0-255,66,219,6,331396
9227,3.6e-05,172.217.194.0-255,1484,1703,6,331396
9228,4e-05,172.31.36.0-255,66,1769,6,331396
9229,6.5e-05,172.217.194.0-255,2902,4671,6,331396
9230,6.9e-05,172.31.36.0-255,66,4737,6,331396
9231,0.000113,172.217.194.0-255,5738,10475,6,331396
9232,0.000116,172.31.36.0-255,66,10541,6,331396
9233,0.000173,172.217.194.0-255,4876,15417,6,331396
9234,0.000177,172.31.36.0-255,66,15483,6,331396
9235,0.000213,172.217.194.0-255,4320,19803,6,331396
9236,0.000216,172.31.36.0-255,66,19869,6,331396
9237,0.000236,172.217.194.0-255,5738,25607,6,331396
9238,0.000239,172.31.36.0-255,66,25673,6,331396
9239,0.000274,172.217.194.0-255,5738,31411,6,331396
9240,0.000277,172.31.36.0-255,66,31477,6,331396
9241,0.00028,172.217.194.0-255,1484,32961,6,331396
9242,0.000282,172.31.36.0-255,66,33027,6,331396
9243,0.000302,172.217.194.0-255,5738,38765,6,331396
9244,0.000305,172.31.36.0-255,66,38831,6,331396
9245,0.000319,172.217.194.0-255,4320,43151,6,331396
9246,0.000321,172.31.36.0-255,66,43217,6,331396
9247,0.000339,172.217.194.0-255,5020,48237,6,331396
9248,0.000342,172.31.36.0-255,66,48303,6,331396
9249,0.00187,172.217.194.0-255,1484,49787,6,331396
9250,0.001879,172.31.36.0-255,66,49853,6,331396
9251,0.001889,172.217.194.0-255,2902,52755,6,331396
9252,0.001891,172.31.36.0-255,66,52821,6,331396
9253,0.001899,172.217.194.0-255,4320,57141,6,331396
9254,0.001901,172.31.36.0-255,66,57207,6,331396
9255,0.001929,172.217.194.0-255,8505,65712,6,331396
9256,0.001932,172.31.36.0-255,66,65778,6,331396
9257,0.001936,172.217.194.0-255,99,65877,6,331396
9258,0.003387,172.31.36.0-255,66,65943,6,331396
9259,0.003751,172.217.194.0-255,1484,67427,6,331396
9260,0.003761,172.217.194.0-255,2902,70329,6,331396
9261,0.003767,172.217.194.0-255,2902,73231,6,331396
9262,0.003792,172.217.194.0-255,4320,77551,6,331396
9263,0.0038,172.217.194.0-255,7156,84707,6,331396
9264,0.003811,172.217.194.0-255,1484,86191,6,331396
9265,0.003835,172.217.194.0-255,7156,93347,6,331396
9266,0.003854,172.217.194.0-255,5738,99085,6,331396
9267,0.003873,172.217.194.0-255,766,99851,6,331396
9268,0.003942,172.31.36.0-255,66,99917,6,331396
9269,0.00403,172.217.194.0-255,1484,101401,6,331396
9270,0.004052,172.217.194.0-255,2902,104303,6,331396
9271,0.004058,172.217.194.0-255,5738,110041,6,331396
9272,0.004082,172.31.36.0-255,66,110107,6,331396
9273,0.004105,172.217.194.0-255,9992,120099,6,331396
9274,0.004119,172.31.36.0-255,66,120165,6,331396
9275,0.004137,172.217.194.0-255,4320,124485,6,331396
9276,0.004151,172.31.36.0-255,66,124551,6,331396
9277,0.004161,172.217.194.0-255,9274,133825,6,331396
9278,0.004166,172.31.36.0-255,66,133891,6,331396
9279,0.004179,172.217.194.0-255,2902,136793,6,331396
9280,0.004208,172.217.194.0-255,1484,138277,6,331396
9281,0.004216,172.217.194.0-255,8574,146851,6,331396
9282,0.004223,172.31.36.0-255,66,146917,6,331396
9283,0.004235,172.217.194.0-255,4320,151237,6,331396
9284,0.004252,172.217.194.0-255,4320,155557,6,331396
9285,0.004262,172.31.36.0-255,66,155623,6,331396
9286,0.004285,172.217.194.0-255,5738,161361,6,331396
9287,0.004295,172.31.36.0-255,66,161427,6,331396
9288,0.004305,172.217.194.0-255,3602,165029,6,331396
9289,0.004311,172.217.194.0-255,5738,170767,6,331396
9290,0.004317,172.31.36.0-255,66,170833,6,331396
9291,0.004336,172.217.194.0-255,4320,175153,6,331396
9292,0.004342,172.217.194.0-255,5738,180891,6,331396
9293,0.004361,172.217.194.0-255,5738,186629,6,331396
9294,0.004367,172.31.36.0-255,66,186695,6,331396
9295,0.004387,172.217.194.0-255,2902,189597,6,331396
9296,0.004394,172.31.36.0-255,66,189663,6,331396
9297,0.004419,172.217.194.0-255,5020,194683,6,331396
9298,0.004427,172.217.194.0-255,8574,203257,6,331396
9299,0.004438,172.217.194.0-255,1484,204741,6,331396
9300,0.004451,172.217.194.0-255,5738,210479,6,331396
9301,0.004466,172.31.36.0-255,66,210545,6,331396
9302,0.00448,172.217.194.0-255,8574,219119,6,331396
9303,0.004486,172.31.36.0-255,66,219185,6,331396
9304,0.004505,172.217.194.0-255,2902,222087,6,331396
9305,0.004536,172.31.36.0-255,66,222153,6,331396
9306,0.004547,172.31.36.0-255,66,222219,6,331396
9307,0.00458,172.217.194.0-255,7856,230075,6,331396
9308,0.004597,172.217.194.0-255,7156,237231,6,331396
9309,0.004607,172.31.36.0-255,66,237297,6,331396
9310,0.004621,172.217.194.0-255,7156,244453,6,331396
9311,0.004663,172.217.194.0-255,5738,250191,6,331396
9312,0.004683,172.217.194.0-255,9274,259465,6,331396
9313,0.004687,172.217.194.0-255,1484,260949,6,331396
9314,0.004705,172.217.194.0-255,2902,263851,6,331396
9315,0.004713,172.31.36.0-255,66,263917,6,331396
9316,0.004727,172.217.194.0-255,5738,269655,6,331396
9317,0.004739,172.217.194.0-255,1484,271139,6,331396
9318,0.00476,172.217.194.0-255,7156,278295,6,331396
9319,0.004765,172.31.36.0-255,66,278361,6,331396
9320,0.004794,172.217.194.0-255,5738,284099,6,331396
9321,0.004799,172.31.36.0-255,66,284165,6,331396
9322,0.004813,172.217.194.0-255,10692,294857,6,331396
9323,0.004835,172.217.194.0-255,5738,300595,6,331396
9324,0.00487,172.31.36.0-255,66,300661,6,331396
9325,0.004882,172.31.36.0-255,66,300727,6,331396
9326,0.004894,172.217.194.0-255,2902,303629,6,331396
9327,0.004907,172.31.36.0-255,66,303695,6,331396
9328,0.004919,172.217.194.0-255,6438,310133,6,331396
9329,0.004928,172.217.194.0-255,9992,320125,6,331396
9330,0.00494,172.31.36.0-255,66,320191,6,331396
9331,0.004961,172.217.194.0-255,5738,325929,6,331396
9332,0.004976,172.217.194.0-255,4993,330922,6,331396
9333,0.00498,172.31.36.0-255,66,330988,6,331396
9334,0.004984,172.31.36.0-255,66,331054,6,331396
9335,0.004998,172.217.194.0-255,105,331159,6,331396
9336,0.007185,172.31.36.0-255,66,331225,6,331396
9337,0.007223,172.31.36.0-255,105,331330,6,331396
9338,0.009477,172.217.194.0-255,66,331396,6,331396
9339,0.0,172.217.194.0-255,146,146,6,282295
9340,3.5e-05,172.31.36.0-255,66,212,6,282295
9341,4.3e-05,172.217.194.0-255,1484,1696,6,282295
9342,4.8e-05,172.31.36.0-255,66,1762,6,282295
9343,5.3e-05,172.217.194.0-255,2902,4664,6,282295
9344,5.5e-05,172.31.36.0-255,66,4730,6,282295
9345,6.2e-05,172.217.194.0-255,7156,11886,6,282295
9346,6.4e-05,172.31.36.0-255,66,11952,6,282295
9347,6.8e-05,172.217.194.0-255,2049,14001,6,282295
9348,7.1e-05,172.31.36.0-255,66,14067,6,282295
9349,0.000223,172.217.194.0-255,1484,15551,6,282295
9350,0.000228,172.31.36.0-255,66,15617,6,282295
9351,0.000234,172.217.194.0-255,2902,18519,6,282295
9352,0.000236,172.31.36.0-255,66,18585,6,282295
9353,0.000241,172.217.194.0-255,1484,20069,6,282295
9354,0.000243,172.31.36.0-255,66,20135,6,282295
9355,0.000268,172.217.194.0-255,4320,24455,6,282295
9356,0.000271,172.31.36.0-255,66,24521,6,282295
9357,0.000279,172.217.194.0-255,6797,31318,6,282295
9358,0.000282,172.31.36.0-255,66,31384,6,282295
9359,0.000316,172.217.194.0-255,5738,37122,6,282295
9360,0.000319,172.31.36.0-255,66,37188,6,282295
9361,0.00034,172.217.194.0-255,8574,45762,6,282295
9362,0.000343,172.31.36.0-255,66,45828,6,282295
9363,0.00037,172.217.194.0-255,2543,48371,6,282295
9364,0.000373,172.31.36.0-255,66,48437,6,282295
9365,0.000668,172.217.194.0-255,1484,49921,6,282295
9366,0.000672,172.31.36.0-255,66,49987,6,282295
9367,0.000691,172.217.194.0-255,2902,52889,6,282295
9368,0.000694,172.31.36.0-255,66,52955,6,282295
9369,0.0007,172.217.194.0-255,4320,57275,6,282295
9370,0.000702,172.31.36.0-255,66,57341,6,282295
9371,0.000715,172.217.194.0-255,1484,58825,6,282295
9372,0.000741,172.217.194.0-255,7378,66203,6,282295
9373,0.000744,172.31.36.0-255,66,66269,6,282295
9374,0.000823,172.217.194.0-255,1484,67753,6,282295
9375,0.000829,172.217.194.0-255,2902,70655,6,282295
9376,0.000832,172.31.36.0-255,66,70721,6,282295
9377,0.000853,172.217.194.0-255,5738,76459,6,282295
9378,0.000871,172.217.194.0-255,5738,82197,6,282295
9379,0.000871,172.31.36.0-255,66,82263,6,282295
9380,0.000877,172.31.36.0-255,66,82329,6,282295
9381,0.000888,172.217.194.0-255,7156,89485,6,282295
9382,0.000897,172.217.194.0-255,8574,98059,6,282295
9383,0.000896,172.31.36.0-255,66,98125,6,282295
9384,0.000901,172.31.36.0-255,66,98191,6,282295
9385,0.000911,172.217.194.0-255,2184,100375,6,282295
9386,0.000917,172.31.36.0-255,66,100441,6,282295
9387,0.000936,172.217.194.0-255,4320,104761,6,282295
9388,0.000942,172.31.36.0-255,66,104827,6,282295
9389,0.000982,172.31.36.0-255,66,104893,6,282295
9390,0.000995,172.31.36.0-255,66,104959,6,282295
9391,0.00101,172.217.194.0-255,1484,106443,6,282295
9392,0.001042,172.31.36.0-255,66,106509,6,282295
9393,0.00107,172.217.194.0-255,1484,107993,6,282295
9394,0.001074,172.217.194.0-255,2902,110895,6,282295
9395,0.001076,172.31.36.0-255,66,110961,6,282295
9396,0.00108,172.217.194.0-255,5738,116699,6,282295
9397,0.001081,172.31.36.0-255,66,116765,6,282295
9398,0.001094,172.31.36.0-255,66,116831,6,282295
9399,0.00114,172.217.194.0-255,1484,118315,6,282295
9400,0.001141,172.31.36.0-255,66,118381,6,282295
9401,0.001154,172.217.194.0-255,5738,124119,6,282295
9402,0.001158,172.31.36.0-255,66,124185,6,282295
9403,0.001178,172.217.194.0-255,3602,127787,6,282295
9404,0.001184,172.31.36.0-255,66,127853,6,282295
9405,0.001199,172.217.194.0-255,2902,130755,6,282295
9406,0.00121,172.31.36.0-255,66,130821,6,282295
9407,0.001223,172.217.194.0-255,7156,137977,6,282295
9408,0.001227,172.31.36.0-255,66,138043,6,282295
9409,0.001234,172.217.194.0-255,9992,148035,6,282295
9410,0.001241,172.31.36.0-255,66,148101,6,282295
9411,0.001251,172.217.194.0-255,1484,149585,6,282295
9412,0.00127,172.217.194.0-255,4320,153905,6,282295
9413,0.001279,172.31.36.0-255,66,153971,6,282295
9414,0.001303,172.217.194.0-255,7856,161827,6,282295
9415,0.001317,172.31.36.0-255,66,161893,6,282295
9416,0.001325,172.217.194.0-255,1484,163377,6,282295
9417,0.00135,172.217.194.0-255,2902,166279,6,282295
9418,0.001354,172.31.36.0-255,66,166345,6,282295
9419,0.001356,172.217.194.0-255,4320,170665,6,282295
9420,0.001358,172.31.36.0-255,66,170731,6,282295
9421,0.00138,172.217.194.0-255,1484,172215,6,282295
9422,0.001395,172.217.194.0-255,7156,179371,6,282295
9423,0.001402,172.31.36.0-255,66,179437,6,282295
9424,0.00143,172.217.194.0-255,7156,186593,6,282295
9425,0.001449,172.217.194.0-255,9274,195867,6,282295
9426,0.001451,172.31.36.0-255,66,195933,6,282295
9427,0.001452,172.217.194.0-255,1484,197417,6,282295
9428,0.001456,172.31.36.0-255,66,197483,6,282295
9429,0.001474,172.217.194.0-255,2902,200385,6,282295
9430,0.001484,172.31.36.0-255,66,200451,6,282295
9431,0.001505,172.217.194.0-255,5738,206189,6,282295
9432,0.001511,172.217.194.0-255,4320,210509,6,282295
9433,0.001518,172.31.36.0-255,66,210575,6,282295
9434,0.001546,172.217.194.0-255,8574,219149,6,282295
9435,0.001556,172.31.36.0-255,66,219215,6,282295
9436,0.001562,172.217.194.0-255,4320,223535,6,282295
9437,0.001578,172.217.194.0-255,6438,229973,6,282295
9438,0.001588,172.31.36.0-255,66,230039,6,282295
9439,0.001733,172.217.194.0-255,1484,231523,6,282295
9440,0.001739,172.217.194.0-255,2902,234425,6,282295
9441,0.001743,172.31.36.0-255,66,234491,6,282295
9442,0.001749,172.217.194.0-255,5738,240229,6,282295
9443,0.001761,172.31.36.0-255,66,240295,6,282295
9444,0.001766,172.217.194.0-255,5738,246033,6,282295
9445,0.001781,172.217.194.0-255,1484,247517,6,282295
9446,0.001782,172.31.36.0-255,66,247583,6,282295
9447,0.001822,172.217.194.0-255,2184,249767,6,282295
9448,0.001822,172.31.36.0-255,66,249833,6,282295
9449,0.001827,172.31.36.0-255,66,249899,6,282295
9450,0.001941,172.217.194.0-255,1484,251383,6,282295
9451,0.001946,172.217.194.0-255,1484,252867,6,282295
9452,0.001957,172.31.36.0-255,66,252933,6,282295
9453,0.001968,172.217.194.0-255,1484,254417,6,282295
9454,0.001975,172.217.194.0-255,5738,260155,6,282295
9455,0.001984,172.31.36.0-255,66,260221,6,282295
9456,0.002,172.217.194.0-255,8574,268795,6,282295
9457,0.002003,172.31.36.0-255,66,268861,6,282295
9458,0.002027,172.217.194.0-255,4320,273181,6,282295
9459,0.002039,172.31.36.0-255,66,273247,6,282295
9460,0.002067,172.217.194.0-255,8574,281821,6,282295
9461,0.002071,172.31.36.0-255,66,281887,6,282295
9462,0.002117,172.31.36.0-255,66,281953,6,282295
9463,0.002123,172.217.194.0-255,105,282058,6,282295
9464,0.002131,172.31.36.0-255,66,282124,6,282295
9465,0.003794,172.31.36.0-255,105,282229,6,282295
9466,0.006034,172.217.194.0-255,66,282295,6,282295
9467,0.0,172.217.194.0-255,153,153,6,141308
9468,2.3e-05,172.31.36.0-255,66,219,6,141308
9469,3e-05,172.217.194.0-255,1484,1703,6,141308
9470,3.5e-05,172.31.36.0-255,66,1769,6,141308
9471,4e-05,172.217.194.0-255,2902,4671,6,141308
9472,4.5e-05,172.31.36.0-255,66,4737,6,141308
9473,5.2e-05,172.217.194.0-255,5738,10475,6,141308
9474,5.6e-05,172.31.36.0-255,66,10541,6,141308
9475,7.2e-05,172.31.36.0-255,66,10607,6,141308
9476,7.9e-05,172.217.194.0-255,6797,17404,6,141308
9477,8.3e-05,172.31.36.0-255,66,17470,6,141308
9478,0.000135,172.217.194.0-255,1484,18954,6,141308
9479,0.000138,172.31.36.0-255,66,19020,6,141308
9480,0.000145,172.217.194.0-255,2902,21922,6,141308
9481,0.000147,172.31.36.0-255,66,21988,6,141308
9482,0.000163,172.217.194.0-255,2902,24890,6,141308
9483,0.000165,172.31.36.0-255,66,24956,6,141308
9484,0.000171,172.217.194.0-255,4320,29276,6,141308
9485,0.000173,172.31.36.0-255,66,29342,6,141308
9486,0.000208,172.217.194.0-255,9633,38975,6,141308
9487,0.000211,172.31.36.0-255,66,39041,6,141308
9488,0.000234,172.217.194.0-255,8574,47615,6,141308
9489,0.000237,172.31.36.0-255,66,47681,6,141308
9490,0.000251,172.217.194.0-255,3961,51642,6,141308
9491,0.000253,172.31.36.0-255,66,51708,6,141308
9492,0.000372,172.217.194.0-255,378,52086,6,141308
9493,0.000377,172.31.36.0-255,66,52152,6,141308
9494,0.000895,172.217.194.0-255,366,52518,6,141308
9495,0.0009,172.31.36.0-255,66,52584,6,141308
9496,0.000932,172.217.194.0-255,1484,54068,6,141308
9497,0.000935,172.31.36.0-255,66,54134,6,141308
9498,0.00095,172.217.194.0-255,4320,58454,6,141308
9499,0.000953,172.31.36.0-255,66,58520,6,141308
9500,0.000989,172.217.194.0-255,9992,68512,6,141308
9501,0.000993,172.31.36.0-255,66,68578,6,141308
9502,0.000996,172.217.194.0-255,1484,70062,6,141308
9503,0.001023,172.217.194.0-255,9992,80054,6,141308
9504,0.001025,172.31.36.0-255,66,80120,6,141308
9505,0.001033,172.217.194.0-255,6438,86558,6,141308
9506,0.001036,172.31.36.0-255,66,86624,6,141308
9507,0.001751,172.217.194.0-255,1484,88108,6,141308
9508,0.001762,172.217.194.0-255,2902,91010,6,141308
9509,0.001767,172.31.36.0-255,66,91076,6,141308
9510,0.001793,172.217.194.0-255,5738,96814,6,141308
9511,0.001796,172.31.36.0-255,66,96880,6,141308
9512,0.00183,172.217.194.0-255,9992,106872,6,141308
9513,0.001833,172.31.36.0-255,66,106938,6,141308
9514,0.001865,172.31.36.0-255,66,107004,6,141308
9515,0.002253,172.217.194.0-255,1484,108488,6,141308
9516,0.002262,172.217.194.0-255,2902,111390,6,141308
9517,0.002266,172.31.36.0-255,66,111456,6,141308
9518,0.002275,172.217.194.0-255,5738,117194,6,141308
9519,0.002277,172.31.36.0-255,66,117260,6,141308
9520,0.00228,172.217.194.0-255,1484,118744,6,141308
9521,0.00231,172.31.36.0-255,66,118810,6,141308
9522,0.002318,172.217.194.0-255,8574,127384,6,141308
9523,0.002321,172.31.36.0-255,66,127450,6,141308
9524,0.002355,172.217.194.0-255,2184,129634,6,141308
9525,0.002358,172.31.36.0-255,66,129700,6,141308
9526,0.004948,172.217.194.0-255,5738,135438,6,141308
9527,0.004955,172.31.36.0-255,66,135504,6,141308
9528,0.007593,172.217.194.0-255,5738,141242,6,141308
9529,0.007603,172.31.36.0-255,66,141308,6,141308
9530,0.0,74.125.68.0-255,153,153,6,393529
9531,2.2e-05,172.31.36.0-255,66,219,6,393529
9532,2.9e-05,74.125.68.0-255,1484,1703,6,393529
9533,3.4e-05,172.31.36.0-255,66,1769,6,393529
9534,4e-05,74.125.68.0-255,2902,4671,6,393529
9535,4.3e-05,172.31.36.0-255,66,4737,6,393529
9536,8e-05,74.125.68.0-255,7156,11893,6,393529
9537,8.3e-05,172.31.36.0-255,66,11959,6,393529
9538,8.7e-05,74.125.68.0-255,1965,13924,6,393529
9539,8.9e-05,172.31.36.0-255,66,13990,6,393529
9540,0.000815,74.125.68.0-255,1484,15474,6,393529
9541,0.000822,172.31.36.0-255,66,15540,6,393529
9542,0.000832,74.125.68.0-255,2902,18442,6,393529
9543,0.000834,172.31.36.0-255,66,18508,6,393529
9544,0.000841,74.125.68.0-255,5738,24246,6,393529
9545,0.000843,172.31.36.0-255,66,24312,6,393529
9546,0.000872,74.125.68.0-255,4320,28632,6,393529
9547,0.000874,172.31.36.0-255,66,28698,6,393529
9548,0.000894,74.125.68.0-255,2543,31241,6,393529
9549,0.000898,172.31.36.0-255,66,31307,6,393529
9550,0.000905,74.125.68.0-255,7156,38463,6,393529
9551,0.000908,172.31.36.0-255,66,38529,6,393529
9552,0.000913,74.125.68.0-255,4320,42849,6,393529
9553,0.000916,172.31.36.0-255,66,42915,6,393529
9554,0.000919,74.125.68.0-255,1484,44399,6,393529
9555,0.000922,172.31.36.0-255,66,44465,6,393529
9556,0.00095,74.125.68.0-255,3961,48426,6,393529
9557,0.000953,172.31.36.0-255,66,48492,6,393529
9558,0.001229,74.125.68.0-255,1484,49976,6,393529
9559,0.001235,172.31.36.0-255,66,50042,6,393529
9560,0.001242,74.125.68.0-255,2902,52944,6,393529
9561,0.001245,172.31.36.0-255,66,53010,6,393529
9562,0.001252,74.125.68.0-255,5738,58748,6,393529
9563,0.001254,172.31.36.0-255,66,58814,6,393529
9564,0.00127,74.125.68.0-255,4320,63134,6,393529
9565,0.001272,172.31.36.0-255,66,63200,6,393529
9566,0.001289,74.125.68.0-255,2543,65743,6,393529
9567,0.001292,172.31.36.0-255,66,65809,6,393529
9568,0.001307,74.125.68.0-255,647,66456,6,393529
9569,0.00169,74.125.68.0-255,1484,67940,6,393529
9570,0.001695,172.31.36.0-255,66,68006,6,393529
9571,0.001699,74.125.68.0-255,1484,69490,6,393529
9572,0.001715,74.125.68.0-255,1484,70974,6,393529
9573,0.001718,172.31.36.0-255,66,71040,6,393529
9574,0.001724,74.125.68.0-255,4320,75360,6,393529
9575,0.001726,172.31.36.0-255,66,75426,6,393529
9576,0.001756,74.125.68.0-255,5738,81164,6,393529
9577,0.00176,172.31.36.0-255,66,81230,6,393529
9578,0.001781,74.125.68.0-255,2543,83773,6,393529
9579,0.001783,172.31.36.0-255,66,83839,6,393529
9580,0.002222,74.125.68.0-255,1484,85323,6,393529
9581,0.002229,74.125.68.0-255,2902,88225,6,393529
9582,0.002233,172.31.36.0-255,66,88291,6,393529
9583,0.002262,74.125.68.0-255,1484,89775,6,393529
9584,0.002281,74.125.68.0-255,4320,94095,6,393529
9585,0.002284,172.31.36.0-255,66,94161,6,393529
9586,0.002297,172.31.36.0-255,66,94227,6,393529
9587,0.0023,74.125.68.0-255,1484,95711,6,393529
9588,0.002342,74.125.68.0-255,2902,98613,6,393529
9589,0.002344,172.31.36.0-255,66,98679,6,393529
9590,0.002369,74.125.68.0-255,7856,106535,6,393529
9591,0.002372,172.31.36.0-255,66,106601,6,393529
9592,0.00311,74.125.68.0-255,1484,108085,6,393529
9593,0.003115,74.125.68.0-255,1484,109569,6,393529
9594,0.003118,172.31.36.0-255,66,109635,6,393529
9595,0.003139,74.125.68.0-255,1484,111119,6,393529
9596,0.003144,74.125.68.0-255,2902,114021,6,393529
9597,0.003147,172.31.36.0-255,66,114087,6,393529
9598,0.00316,74.125.68.0-255,1484,115571,6,393529
9599,0.003172,74.125.68.0-255,1484,117055,6,393529
9600,0.003175,172.31.36.0-255,66,117121,6,393529
9601,0.003195,74.125.68.0-255,2902,120023,6,393529
9602,0.003197,172.31.36.0-255,66,120089,6,393529
9603,0.003202,74.125.68.0-255,3961,124050,6,393529
9604,0.003205,172.31.36.0-255,66,124116,6,393529
9605,0.003265,74.125.68.0-255,1484,125600,6,393529
9606,0.003279,74.125.68.0-255,2902,128502,6,393529
9607,0.003282,172.31.36.0-255,66,128568,6,393529
9608,0.003287,74.125.68.0-255,2902,131470,6,393529
9609,0.003289,172.31.36.0-255,66,131536,6,393529
9610,0.003306,74.125.68.0-255,4320,135856,6,393529
9611,0.003309,172.31.36.0-255,66,135922,6,393529
9612,0.003336,74.125.68.0-255,8574,144496,6,393529
9613,0.003339,172.31.36.0-255,66,144562,6,393529
9614,0.003346,74.125.68.0-255,5738,150300,6,393529
9615,0.003349,172.31.36.0-255,66,150366,6,393529
9616,0.003375,74.125.68.0-255,2902,153268,6,393529
9617,0.003378,172.31.36.0-255,66,153334,6,393529
9618,0.003394,74.125.68.0-255,4320,157654,6,393529
9619,0.003397,172.31.36.0-255,66,157720,6,393529
9620,0.0034,74.125.68.0-255,766,158486,6,393529
9621,0.004313,74.125.68.0-255,1484,159970,6,393529
9622,0.00432,172.31.36.0-255,66,160036,6,393529
9623,0.004353,74.125.68.0-255,2902,162938,6,393529
9624,0.004358,172.31.36.0-255,66,163004,6,393529
9625,0.004363,74.125.68.0-255,2902,165906,6,393529
9626,0.004365,172.31.36.0-255,66,165972,6,393529
9627,0.004377,74.125.68.0-255,1484,167456,6,393529
9628,0.004394,74.125.68.0-255,8574,176030,6,393529
9629,0.004397,172.31.36.0-255,66,176096,6,393529
9630,0.004419,74.125.68.0-255,4320,180416,6,393529
9631,0.004422,172.31.36.0-255,66,180482,6,393529
9632,0.004468,74.125.68.0-255,4320,184802,6,393529
9633,0.004472,172.31.36.0-255,66,184868,6,393529
9634,0.004497,74.125.68.0-255,7856,192724,6,393529
9635,0.004501,172.31.36.0-255,66,192790,6,393529
9636,0.004504,74.125.68.0-255,1484,194274,6,393529
9637,0.004523,74.125.68.0-255,2902,197176,6,393529
9638,0.004526,172.31.36.0-255,66,197242,6,393529
9639,0.004529,74.125.68.0-255,1484,198726,6,393529
9640,0.004542,74.125.68.0-255,1484,200210,6,393529
9641,0.004545,172.31.36.0-255,66,200276,6,393529
9642,0.004548,74.125.68.0-255,1484,201760,6,393529
9643,0.004551,74.125.68.0-255,1484,203244,6,393529
9644,0.004553,172.31.36.0-255,66,203310,6,393529
9645,0.004568,74.125.68.0-255,1484,204794,6,393529
9646,0.004593,74.125.68.0-255,9992,214786,6,393529
9647,0.004597,172.31.36.0-255,66,214852,6,393529
9648,0.004603,74.125.68.0-255,4320,219172,6,393529
9649,0.004605,172.31.36.0-255,66,219238,6,393529
9650,0.00462,74.125.68.0-255,1484,220722,6,393529
9651,0.004623,74.125.68.0-255,1484,222206,6,393529
9652,0.004625,172.31.36.0-255,66,222272,6,393529
9653,0.004628,74.125.68.0-255,1484,223756,6,393529
9654,0.004631,74.125.68.0-255,1484,225240,6,393529
9655,0.004633,172.31.36.0-255,66,225306,6,393529
9656,0.004648,74.125.68.0-255,2184,227490,6,393529
9657,0.004654,172.31.36.0-255,66,227556,6,393529
9658,0.005049,74.125.68.0-255,1484,229040,6,393529
9659,0.00509,74.125.68.0-255,1484,230524,6,393529
9660,0.005094,74.125.68.0-255,2902,233426,6,393529
9661,0.005109,172.31.36.0-255,66,233492,6,393529
9662,0.005114,172.31.36.0-255,66,233558,6,393529
9663,0.005118,74.125.68.0-255,2902,236460,6,393529
9664,0.005121,172.31.36.0-255,66,236526,6,393529
9665,0.005156,74.125.68.0-255,2902,239428,6,393529
9666,0.005159,172.31.36.0-255,66,239494,6,393529
9667,0.005168,74.125.68.0-255,7156,246650,6,393529
9668,0.00517,172.31.36.0-255,66,246716,6,393529
9669,0.005177,74.125.68.0-255,5738,252454,6,393529
9670,0.005178,172.31.36.0-255,66,252520,6,393529
9671,0.005206,74.125.68.0-255,7156,259676,6,393529
9672,0.005209,172.31.36.0-255,66,259742,6,393529
9673,0.005231,74.125.68.0-255,2184,261926,6,393529
9674,0.005234,172.31.36.0-255,66,261992,6,393529
9675,0.00531,74.125.68.0-255,1484,263476,6,393529
9676,0.005363,74.125.68.0-255,2902,266378,6,393529
9677,0.005367,172.31.36.0-255,66,266444,6,393529
9678,0.005374,74.125.68.0-255,4320,270764,6,393529
9679,0.005377,172.31.36.0-255,66,270830,6,393529
9680,0.005387,74.125.68.0-255,8574,279404,6,393529
9681,0.00539,172.31.36.0-255,66,279470,6,393529
9682,0.005394,74.125.68.0-255,2902,282372,6,393529
9683,0.005396,172.31.36.0-255,66,282438,6,393529
9684,0.005402,74.125.68.0-255,5738,288176,6,393529
9685,0.005405,172.31.36.0-255,66,288242,6,393529
9686,0.00543,74.125.68.0-255,5738,293980,6,393529
9687,0.005434,172.31.36.0-255,66,294046,6,393529
9688,0.005438,74.125.68.0-255,2184,296230,6,393529
9689,0.005441,172.31.36.0-255,66,296296,6,393529
9690,0.005494,74.125.68.0-255,1484,297780,6,393529
9691,0.005541,74.125.68.0-255,1484,299264,6,393529
9692,0.005548,172.31.36.0-255,66,299330,6,393529
9693,0.005553,74.125.68.0-255,2902,302232,6,393529
9694,0.005555,172.31.36.0-255,66,302298,6,393529
9695,0.005558,74.125.68.0-255,1484,303782,6,393529
9696,0.005582,74.125.68.0-255,2902,306684,6,393529
9697,0.005585,172.31.36.0-255,66,306750,6,393529
9698,0.005588,74.125.68.0-255,1484,308234,6,393529
9699,0.005605,74.125.68.0-255,1484,309718,6,393529
9700,0.005607,172.31.36.0-255,66,309784,6,393529
9701,0.00564,74.125.68.0-255,4320,314104,6,393529
9702,0.005647,172.31.36.0-255,66,314170,6,393529
9703,0.005651,74.125.68.0-255,1484,315654,6,393529
9704,0.005654,172.31.36.0-255,78,315732,6,393529
9705,0.005662,74.125.68.0-255,8574,324306,6,393529
9706,0.005665,172.31.36.0-255,66,324372,6,393529
9707,0.005669,74.125.68.0-255,1484,325856,6,393529
9708,0.005696,74.125.68.0-255,5020,330876,6,393529
9709,0.0057,172.31.36.0-255,66,330942,6,393529
9710,0.005772,74.125.68.0-255,1484,332426,6,393529
9711,0.005777,74.125.68.0-255,2902,335328,6,393529
9712,0.005784,172.31.36.0-255,66,335394,6,393529
9713,0.005805,74.125.68.0-255,5738,341132,6,393529
9714,0.005809,172.31.36.0-255,66,341198,6,393529
9715,0.005813,74.125.68.0-255,1484,342682,6,393529
9716,0.005835,74.125.68.0-255,2902,345584,6,393529
9717,0.005839,172.31.36.0-255,66,345650,6,393529
9718,0.005845,74.125.68.0-255,5738,351388,6,393529
9719,0.005848,172.31.36.0-255,66,351454,6,393529
9720,0.00588,74.125.68.0-255,8574,360028,6,393529
9721,0.005884,172.31.36.0-255,66,360094,6,393529
9722,0.005896,74.125.68.0-255,1484,361578,6,393529
9723,0.005934,74.125.68.0-255,3602,365180,6,393529
9724,0.005937,74.125.68.0-255,1484,366664,6,393529
9725,0.005943,172.31.36.0-255,66,366730,6,393529
9726,0.005954,74.125.68.0-255,2902,369632,6,393529
9727,0.005957,172.31.36.0-255,66,369698,6,393529
9728,0.005981,74.125.68.0-255,7156,376854,6,393529
9729,0.005984,172.31.36.0-255,66,376920,6,393529
9730,0.005989,74.125.68.0-255,2902,379822,6,393529
9731,0.005991,172.31.36.0-255,66,379888,6,393529
9732,0.006021,74.125.68.0-255,5738,385626,6,393529
9733,0.006025,172.31.36.0-255,66,385692,6,393529
9734,0.006045,74.125.68.0-255,7569,393261,6,393529
9735,0.006049,172.31.36.0-255,66,393327,6,393529
9736,0.006053,74.125.68.0-255,97,393424,6,393529
9737,0.006127,74.125.68.0-255,105,393529,6,393529
9738,0.0,74.125.200.0-255,153,153,6,119465
9739,2.7e-05,172.31.36.0-255,66,219,6,119465
9740,4.7e-05,74.125.200.0-255,1484,1703,6,119465
9741,5.1e-05,172.31.36.0-255,66,1769,6,119465
9742,7.5e-05,74.125.200.0-255,2902,4671,6,119465
9743,7.8e-05,172.31.36.0-255,66,4737,6,119465
9744,9.1e-05,74.125.200.0-255,1484,6221,6,119465
9745,9.4e-05,172.31.36.0-255,66,6287,6,119465
9746,0.000124,74.125.200.0-255,1484,7771,6,119465
9747,0.000128,172.31.36.0-255,66,7837,6,119465
9748,0.000139,74.125.200.0-255,1484,9321,6,119465
9749,0.000141,172.31.36.0-255,66,9387,6,119465
9750,0.000144,74.125.200.0-255,1484,10871,6,119465
9751,0.000146,172.31.36.0-255,66,10937,6,119465
9752,0.000177,74.125.200.0-255,1484,12421,6,119465
9753,0.00018,172.31.36.0-255,66,12487,6,119465
9754,0.000192,74.125.200.0-255,1484,13971,6,119465
9755,0.000194,172.31.36.0-255,66,14037,6,119465
9756,0.000197,74.125.200.0-255,719,14756,6,119465
9757,0.000199,172.31.36.0-255,66,14822,6,119465
9758,0.000384,74.125.200.0-255,1484,16306,6,119465
9759,0.000388,172.31.36.0-255,66,16372,6,119465
9760,0.000416,74.125.200.0-255,2902,19274,6,119465
9761,0.000418,172.31.36.0-255,66,19340,6,119465
9762,0.000422,74.125.200.0-255,1484,20824,6,119465
9763,0.000424,172.31.36.0-255,66,20890,6,119465
9764,0.000441,74.125.200.0-255,4320,25210,6,119465
9765,0.000444,172.31.36.0-255,66,25276,6,119465
9766,0.000447,74.125.200.0-255,1484,26760,6,119465
9767,0.000449,172.31.36.0-255,66,26826,6,119465
9768,0.000467,74.125.200.0-255,1484,28310,6,119465
9769,0.00047,172.31.36.0-255,66,28376,6,119465
9770,0.000488,74.125.200.0-255,1484,29860,6,119465
9771,0.000505,74.125.200.0-255,2543,32403,6,119465
9772,0.00051,172.31.36.0-255,66,32469,6,119465
9773,0.000514,74.125.200.0-255,2902,35371,6,119465
9774,0.000516,172.31.36.0-255,66,35437,6,119465
9775,0.000549,74.125.200.0-255,5738,41175,6,119465
9776,0.000553,172.31.36.0-255,66,41241,6,119465
9777,0.000571,74.125.200.0-255,1484,42725,6,119465
9778,0.000576,74.125.200.0-255,2902,45627,6,119465
9779,0.000578,172.31.36.0-255,66,45693,6,119465
9780,0.000596,74.125.200.0-255,1484,47177,6,119465
9781,0.000608,74.125.200.0-255,2543,49720,6,119465
9782,0.000611,172.31.36.0-255,66,49786,6,119465
9783,0.000777,74.125.200.0-255,1484,51270,6,119465
9784,0.000785,74.125.200.0-255,1484,52754,6,119465
9785,0.000788,172.31.36.0-255,66,52820,6,119465
9786,0.000804,74.125.200.0-255,1484,54304,6,119465
9787,0.000807,74.125.200.0-255,1484,55788,6,119465
9788,0.000809,172.31.36.0-255,66,55854,6,119465
9789,0.000829,74.125.200.0-255,4320,60174,6,119465
9790,0.000831,172.31.36.0-255,66,60240,6,119465
9791,0.000861,74.125.200.0-255,6797,67037,6,119465
9792,0.000865,172.31.36.0-255,66,67103,6,119465
9793,0.001978,74.125.200.0-255,1484,68587,6,119465
9794,0.001998,74.125.200.0-255,2902,71489,6,119465
9795,0.002003,172.31.36.0-255,66,71555,6,119465
9796,0.00201,74.125.200.0-255,5738,77293,6,119465
9797,0.002012,172.31.36.0-255,66,77359,6,119465
9798,0.002019,74.125.200.0-255,7156,84515,6,119465
9799,0.002021,172.31.36.0-255,66,84581,6,119465
9800,0.002047,74.125.200.0-255,7377,91958,6,119465
9801,0.00205,172.31.36.0-255,66,92024,6,119465
9802,0.002072,74.125.200.0-255,5738,97762,6,119465
9803,0.002075,172.31.36.0-255,66,97828,6,119465
9804,0.002089,74.125.200.0-255,3961,101789,6,119465
9805,0.002092,172.31.36.0-255,66,101855,6,119465
9806,0.004671,74.125.200.0-255,1484,103339,6,119465
9807,0.004705,74.125.200.0-255,4320,107659,6,119465
9808,0.004709,172.31.36.0-255,66,107725,6,119465
9809,0.007293,74.125.200.0-255,5738,113463,6,119465
9810,0.0073,172.31.36.0-255,66,113529,6,119465
9811,0.009892,74.125.200.0-255,2902,116431,6,119465
9812,0.0099,172.31.36.0-255,66,116497,6,119465
9813,0.009934,74.125.200.0-255,2902,119399,6,119465
9814,0.009937,172.31.36.0-255,66,119465,6,119465
9815,0.0,74.125.68.0-255,226,226,6,53734
9816,2.7e-05,172.31.36.0-255,66,292,6,53734
9817,3.3e-05,74.125.68.0-255,1484,1776,6,53734
9818,3.8e-05,172.31.36.0-255,66,1842,6,53734
9819,4.1e-05,74.125.68.0-255,1484,3326,6,53734
9820,4.3e-05,172.31.36.0-255,66,3392,6,53734
9821,6.5e-05,74.125.68.0-255,2902,6294,6,53734
9822,7.3e-05,172.31.36.0-255,66,6360,6,53734
9823,0.000213,74.125.68.0-255,5738,12098,6,53734
9824,0.000218,172.31.36.0-255,66,12164,6,53734
9825,0.000435,74.125.68.0-255,1993,14157,6,53734
9826,0.00044,172.31.36.0-255,66,14223,6,53734
9827,0.000507,74.125.68.0-255,5738,19961,6,53734
9828,0.000511,172.31.36.0-255,66,20027,6,53734
9829,0.000538,74.125.68.0-255,4320,24347,6,53734
9830,0.000541,172.31.36.0-255,66,24413,6,53734
9831,0.000903,74.125.68.0-255,6797,31210,6,53734
9832,0.000908,172.31.36.0-255,66,31276,6,53734
9833,0.00224,74.125.68.0-255,1498,32774,6,53734
9834,0.002246,172.31.36.0-255,66,32840,6,53734
9835,0.0031,74.125.68.0-255,2902,35742,6,53734
9836,0.003104,172.31.36.0-255,66,35808,6,53734
9837,0.004443,74.125.68.0-255,2902,38710,6,53734
9838,0.004448,172.31.36.0-255,66,38776,6,53734
9839,0.005319,74.125.68.0-255,2902,41678,6,53734
9840,0.005324,172.31.36.0-255,66,41744,6,53734
9841,0.006665,74.125.68.0-255,2902,44646,6,53734
9842,0.006671,172.31.36.0-255,66,44712,6,53734
9843,0.007526,74.125.68.0-255,1470,46182,6,53734
9844,0.007533,172.31.36.0-255,66,46248,6,53734
9845,0.007559,74.125.68.0-255,1484,47732,6,53734
9846,0.007562,172.31.36.0-255,66,47798,6,53734
9847,0.008889,74.125.68.0-255,2902,50700,6,53734
9848,0.008895,172.31.36.0-255,66,50766,6,53734
9849,0.00976,74.125.68.0-255,2902,53668,6,53734
9850,0.009766,172.31.36.0-255,66,53734,6,53734
9851,0.0,74.125.68.0-255,153,153,6,119700
9852,2.1e-05,172.31.36.0-255,66,219,6,119700
9853,2.8e-05,74.125.68.0-255,1484,1703,6,119700
9854,3.3e-05,172.31.36.0-255,66,1769,6,119700
9855,3.6e-05,74.125.68.0-255,1484,3253,6,119700
9856,3.8e-05,172.31.36.0-255,66,3319,6,119700
9857,4.4e-05,74.125.68.0-255,2902,6221,6,119700
9858,4.6e-05,172.31.36.0-255,66,6287,6,119700
9859,7.4e-05,74.125.68.0-255,5738,12025,6,119700
9860,7.6e-05,172.31.36.0-255,66,12091,6,119700
9861,8.2e-05,74.125.68.0-255,2048,14139,6,119700
9862,8.4e-05,172.31.36.0-255,66,14205,6,119700
9863,0.000217,74.125.68.0-255,1484,15689,6,119700
9864,0.000222,172.31.36.0-255,66,15755,6,119700
9865,0.000225,74.125.68.0-255,1484,17239,6,119700
9866,0.000227,172.31.36.0-255,66,17305,6,119700
9867,0.000242,74.125.68.0-255,2902,20207,6,119700
9868,0.000245,172.31.36.0-255,66,20273,6,119700
9869,0.000268,74.125.68.0-255,2902,23175,6,119700
9870,0.000271,172.31.36.0-255,66,23241,6,119700
9871,0.000292,74.125.68.0-255,2902,26143,6,119700
9872,0.000294,172.31.36.0-255,66,26209,6,119700
9873,0.000296,74.125.68.0-255,1484,27693,6,119700
9874,0.000299,172.31.36.0-255,66,27759,6,119700
9875,0.00033,74.125.68.0-255,3961,31720,6,119700
9876,0.000332,172.31.36.0-255,66,31786,6,119700
9877,0.000505,74.125.68.0-255,1484,33270,6,119700
9878,0.000509,172.31.36.0-255,66,33336,6,119700
9879,0.000531,74.125.68.0-255,2902,36238,6,119700
9880,0.000534,172.31.36.0-255,66,36304,6,119700
9881,0.000537,74.125.68.0-255,1484,37788,6,119700
9882,0.000539,172.31.36.0-255,66,37854,6,119700
9883,0.000571,74.125.68.0-255,2902,40756,6,119700
9884,0.000573,172.31.36.0-255,66,40822,6,119700
9885,0.00058,74.125.68.0-255,5738,46560,6,119700
9886,0.000583,172.31.36.0-255,66,46626,6,119700
9887,0.000585,74.125.68.0-255,1484,48110,6,119700
9888,0.000608,74.125.68.0-255,2543,50653,6,119700
9889,0.000611,172.31.36.0-255,66,50719,6,119700
9890,0.000637,74.125.68.0-255,4320,55039,6,119700
9891,0.00064,172.31.36.0-255,66,55105,6,119700
9892,0.000677,74.125.68.0-255,5738,60843,6,119700
9893,0.00068,172.31.36.0-255,66,60909,6,119700
9894,0.000684,74.125.68.0-255,1484,62393,6,119700
9895,0.000709,74.125.68.0-255,2902,65295,6,119700
9896,0.000713,172.31.36.0-255,66,65361,6,119700
9897,0.000727,74.125.68.0-255,1125,66486,6,119700
9898,0.000765,74.125.68.0-255,398,66884,6,119700
9899,0.001088,172.31.36.0-255,66,66950,6,119700
9900,0.001315,74.125.68.0-255,110,67060,6,119700
9901,0.001506,74.125.68.0-255,1484,68544,6,119700
9902,0.001512,172.31.36.0-255,66,68610,6,119700
9903,0.001517,74.125.68.0-255,1484,70094,6,119700
9904,0.001538,74.125.68.0-255,2902,72996,6,119700
9905,0.00154,172.31.36.0-255,66,73062,6,119700
9906,0.001577,74.125.68.0-255,4320,77382,6,119700
9907,0.00158,172.31.36.0-255,66,77448,6,119700
9908,0.001586,74.125.68.0-255,5738,83186,6,119700
9909,0.001588,172.31.36.0-255,66,83252,6,119700
9910,0.001601,74.125.68.0-255,1125,84377,6,119700
9911,0.001667,74.125.68.0-255,1484,85861,6,119700
9912,0.001671,172.31.36.0-255,66,85927,6,119700
9913,0.001676,74.125.68.0-255,2902,88829,6,119700
9914,0.001678,172.31.36.0-255,66,88895,6,119700
9915,0.001692,74.125.68.0-255,1484,90379,6,119700
9916,0.001714,74.125.68.0-255,4320,94699,6,119700
9917,0.001717,172.31.36.0-255,66,94765,6,119700
9918,0.001722,74.125.68.0-255,4320,99085,6,119700
9919,0.001724,172.31.36.0-255,66,99151,6,119700
9920,0.001771,74.125.68.0-255,2543,101694,6,119700
9921,0.001774,172.31.36.0-255,66,101760,6,119700
9922,0.003976,74.125.68.0-255,2902,104662,6,119700
9923,0.003981,172.31.36.0-255,66,104728,6,119700
9924,0.004016,74.125.68.0-255,1484,106212,6,119700
9925,0.00403,74.125.68.0-255,1484,107696,6,119700
9926,0.004032,172.31.36.0-255,66,107762,6,119700
9927,0.006289,74.125.68.0-255,2902,110664,6,119700
9928,0.006293,172.31.36.0-255,66,110730,6,119700
9929,0.00631,74.125.68.0-255,1484,112214,6,119700
9930,0.006324,74.125.68.0-255,1484,113698,6,119700
9931,0.006326,172.31.36.0-255,66,113764,6,119700
9932,0.008556,74.125.68.0-255,2902,116666,6,119700
9933,0.008565,172.31.36.0-255,66,116732,6,119700
9934,0.008589,74.125.68.0-255,2902,119634,6,119700
9935,0.008592,172.31.36.0-255,66,119700,6,119700
9936,0.0,172.217.194.0-255,150,150,6,284847
9937,2.3e-05,172.31.36.0-255,66,216,6,284847
9938,3e-05,172.217.194.0-255,1484,1700,6,284847
9939,3.5e-05,172.31.36.0-255,66,1766,6,284847
9940,4.1e-05,172.217.194.0-255,2902,4668,6,284847
9941,4.5e-05,172.31.36.0-255,66,4734,6,284847
9942,5.1e-05,172.217.194.0-255,4320,9054,6,284847
9943,5.5e-05,172.31.36.0-255,66,9120,6,284847
9944,9e-05,172.217.194.0-255,9093,18213,6,284847
9945,9.3e-05,172.31.36.0-255,66,18279,6,284847
9946,9.8e-05,172.217.194.0-255,2902,21181,6,284847
9947,0.000101,172.31.36.0-255,66,21247,6,284847
9948,0.000136,172.217.194.0-255,4320,25567,6,284847
9949,0.000139,172.31.36.0-255,66,25633,6,284847
9950,0.000159,172.217.194.0-255,5379,31012,6,284847
9951,0.000162,172.31.36.0-255,66,31078,6,284847
9952,0.000191,172.217.194.0-255,1484,32562,6,284847
9953,0.000193,172.31.36.0-255,66,32628,6,284847
9954,0.000198,172.217.194.0-255,2902,35530,6,284847
9955,0.0002,172.31.36.0-255,66,35596,6,284847
9956,0.000223,172.217.194.0-255,5738,41334,6,284847
9957,0.000226,172.31.36.0-255,66,41400,6,284847
9958,0.000234,172.217.194.0-255,6797,48197,6,284847
9959,0.000237,172.31.36.0-255,66,48263,6,284847
9960,0.000258,172.217.194.0-255,2902,51165,6,284847
9961,0.00026,172.31.36.0-255,66,51231,6,284847
9962,0.000296,172.31.36.0-255,66,51297,6,284847
9963,0.0003,172.217.194.0-255,2836,54133,6,284847
9964,0.000302,172.31.36.0-255,66,54199,6,284847
9965,0.000331,172.217.194.0-255,365,54564,6,284847
9966,0.000334,172.31.36.0-255,66,54630,6,284847
9967,0.000455,172.217.194.0-255,1484,56114,6,284847
9968,0.000461,172.217.194.0-255,1484,57598,6,284847
9969,0.000464,172.31.36.0-255,66,57664,6,284847
9970,0.000482,172.217.194.0-255,1484,59148,6,284847
9971,0.000488,172.217.194.0-255,4320,63468,6,284847
9972,0.000491,172.31.36.0-255,66,63534,6,284847
9973,0.000504,172.217.194.0-255,1484,65018,6,284847
9974,0.000543,172.217.194.0-255,9992,75010,6,284847
9975,0.00056,172.217.194.0-255,2543,77553,6,284847
9976,0.000583,172.217.194.0-255,9992,87545,6,284847
9977,0.00059,172.31.36.0-255,66,87611,6,284847
9978,0.000597,172.217.194.0-255,1125,88736,6,284847
9979,0.000613,172.217.194.0-255,7156,95892,6,284847
9980,0.000633,172.217.194.0-255,4320,100212,6,284847
9981,0.00064,172.217.194.0-255,5738,105950,6,284847
9982,0.000657,172.31.36.0-255,66,106016,6,284847
9983,0.000679,172.217.194.0-255,5738,111754,6,284847
9984,0.000688,172.31.36.0-255,66,111820,6,284847
9985,0.000703,172.217.194.0-255,10692,122512,6,284847
9986,0.000709,172.31.36.0-255,66,122578,6,284847
9987,0.000745,172.217.194.0-255,9992,132570,6,284847
9988,0.000772,172.31.36.0-255,66,132636,6,284847
9989,0.00078,172.217.194.0-255,6438,139074,6,284847
9990,0.000791,172.31.36.0-255,66,139140,6,284847
9991,0.000831,172.217.194.0-255,1484,140624,6,284847
9992,0.000847,172.217.194.0-255,2902,143526,6,284847
9993,0.000851,172.217.194.0-255,1484,145010,6,284847
9994,0.000868,172.217.194.0-255,4320,149330,6,284847
9995,0.000908,172.31.36.0-255,66,149396,6,284847
9996,0.000913,172.31.36.0-255,66,149462,6,284847
9997,0.000944,172.217.194.0-255,10692,160154,6,284847
9998,0.000964,172.31.36.0-255,66,160220,6,284847
9999,0.001002,172.217.194.0-255,1484,161704,6,284847
10000,0.001006,172.217.194.0-255,1484,163188,6,284847
10001,0.001013,172.31.36.0-255,66,163254,6,284847
10002,0.00103,172.217.194.0-255,1484,164738,6,284847
10003,0.001037,172.217.194.0-255,5738,170476,6,284847
10004,0.001043,172.217.194.0-255,5738,176214,6,284847
10005,0.00106,172.31.36.0-255,66,176280,6,284847
10006,0.001078,172.31.36.0-255,66,176346,6,284847
10007,0.001098,172.217.194.0-255,5020,181366,6,284847
10008,0.001113,172.217.194.0-255,5738,187104,6,284847
10009,0.001122,172.31.36.0-255,66,187170,6,284847
10010,0.001165,172.31.36.0-255,66,187236,6,284847
10011,0.001205,172.217.194.0-255,5738,192974,6,284847
10012,0.001226,172.217.194.0-255,10692,203666,6,284847
10013,0.001238,172.31.36.0-255,66,203732,6,284847
10014,0.001256,172.217.194.0-255,1484,205216,6,284847
10015,0.001268,172.217.194.0-255,2902,208118,6,284847
10016,0.001275,172.31.36.0-255,66,208184,6,284847
10017,0.001298,172.217.194.0-255,5738,213922,6,284847
10018,0.001303,172.217.194.0-255,5738,219660,6,284847
10019,0.001306,172.217.194.0-255,1484,221144,6,284847
10020,0.001315,172.31.36.0-255,66,221210,6,284847
10021,0.001345,172.217.194.0-255,5020,226230,6,284847
10022,0.00136,172.31.36.0-255,66,226296,6,284847
10023,0.00141,172.217.194.0-255,1484,227780,6,284847
10024,0.001415,172.217.194.0-255,2902,230682,6,284847
10025,0.001422,172.31.36.0-255,66,230748,6,284847
10026,0.00144,172.217.194.0-255,5738,236486,6,284847
10027,0.001446,172.217.194.0-255,2902,239388,6,284847
10028,0.001455,172.31.36.0-255,66,239454,6,284847
10029,0.001466,172.217.194.0-255,5738,245192,6,284847
10030,0.001472,172.31.36.0-255,66,245258,6,284847
10031,0.001514,172.217.194.0-255,8574,253832,6,284847
10032,0.001536,172.217.194.0-255,6438,260270,6,284847
10033,0.00154,172.217.194.0-255,1484,261754,6,284847
10034,0.001552,172.31.36.0-255,66,261820,6,284847
10035,0.001561,172.217.194.0-255,1484,263304,6,284847
10036,0.001565,172.217.194.0-255,4320,267624,6,284847
10037,0.001586,172.217.194.0-255,7156,274780,6,284847
10038,0.001598,172.31.36.0-255,66,274846,6,284847
10039,0.001616,172.217.194.0-255,1484,276330,6,284847
10040,0.001705,172.217.194.0-255,8175,284505,6,284847
10041,0.001708,172.217.194.0-255,105,284610,6,284847
10042,0.001732,172.31.36.0-255,66,284676,6,284847
10043,0.004421,172.31.36.0-255,105,284781,6,284847
10044,0.006667,172.217.194.0-255,66,284847,6,284847
10045,0.0,172.217.194.0-255,153,153,6,327252
10046,2.7e-05,172.31.36.0-255,66,219,6,327252
10047,3.4e-05,172.217.194.0-255,1484,1703,6,327252
10048,3.8e-05,172.31.36.0-255,66,1769,6,327252
10049,4.3e-05,172.217.194.0-255,2902,4671,6,327252
10050,4.6e-05,172.31.36.0-255,66,4737,6,327252
10051,5.4e-05,172.217.194.0-255,7156,11893,6,327252
10052,5.7e-05,172.31.36.0-255,66,11959,6,327252
10053,7.3e-05,172.217.194.0-255,1484,13443,6,327252
10054,7.6e-05,172.31.36.0-255,66,13509,6,327252
10055,0.000115,172.217.194.0-255,6269,19778,6,327252
10056,0.00013,172.31.36.0-255,66,19844,6,327252
10057,0.000144,172.31.36.0-255,66,19910,6,327252
10058,0.000152,172.217.194.0-255,9992,29902,6,327252
10059,0.000155,172.31.36.0-255,66,29968,6,327252
10060,0.000178,172.217.194.0-255,1484,31452,6,327252
10061,0.000183,172.31.36.0-255,66,31518,6,327252
10062,0.000198,172.217.194.0-255,5379,36897,6,327252
10063,0.0002,172.31.36.0-255,66,36963,6,327252
10064,0.000251,172.217.194.0-255,1484,38447,6,327252
10065,0.000254,172.31.36.0-255,66,38513,6,327252
10066,0.000259,172.217.194.0-255,2902,41415,6,327252
10067,0.000261,172.31.36.0-255,66,41481,6,327252
10068,0.000293,172.217.194.0-255,5738,47219,6,327252
10069,0.000297,172.31.36.0-255,66,47285,6,327252
10070,0.000305,172.217.194.0-255,7069,54354,6,327252
10071,0.000308,172.31.36.0-255,66,54420,6,327252
10072,0.000336,172.217.194.0-255,405,54825,6,327252
10073,0.000339,172.31.36.0-255,66,54891,6,327252
10074,0.000393,172.217.194.0-255,1484,56375,6,327252
10075,0.000396,172.31.36.0-255,66,56441,6,327252
10076,0.000402,172.217.194.0-255,2902,59343,6,327252
10077,0.000406,172.31.36.0-255,66,59409,6,327252
10078,0.000411,172.217.194.0-255,4320,63729,6,327252
10079,0.000415,172.31.36.0-255,66,63795,6,327252
10080,0.00043,172.217.194.0-255,1484,65279,6,327252
10081,0.000464,172.217.194.0-255,9992,75271,6,327252
10082,0.000469,172.31.36.0-255,66,75337,6,327252
10083,0.000488,172.217.194.0-255,3961,79298,6,327252
10084,0.00049,172.31.36.0-255,66,79364,6,327252
10085,0.000493,172.217.194.0-255,1484,80848,6,327252
10086,0.000542,172.217.194.0-255,8215,89063,6,327252
10087,0.000546,172.31.36.0-255,66,89129,6,327252
10088,0.00081,172.217.194.0-255,1484,90613,6,327252
10089,0.000817,172.217.194.0-255,2902,93515,6,327252
10090,0.00082,172.31.36.0-255,66,93581,6,327252
10091,0.000826,172.217.194.0-255,5738,99319,6,327252
10092,0.000829,172.31.36.0-255,66,99385,6,327252
10093,0.000851,172.217.194.0-255,1484,100869,6,327252
10094,0.000869,172.217.194.0-255,8574,109443,6,327252
10095,0.000872,172.31.36.0-255,66,109509,6,327252
10096,0.00089,172.217.194.0-255,2902,112411,6,327252
10097,0.000893,172.31.36.0-255,66,112477,6,327252
10098,0.000903,172.217.194.0-255,10692,123169,6,327252
10099,0.000906,172.31.36.0-255,66,123235,6,327252
10100,0.000941,172.217.194.0-255,1484,124719,6,327252
10101,0.000946,172.217.194.0-255,2902,127621,6,327252
10102,0.000948,172.31.36.0-255,66,127687,6,327252
10103,0.000955,172.217.194.0-255,5738,133425,6,327252
10104,0.000957,172.31.36.0-255,66,133491,6,327252
10105,0.000975,172.217.194.0-255,1484,134975,6,327252
10106,0.000998,172.217.194.0-255,7156,142131,6,327252
10107,0.001001,172.31.36.0-255,66,142197,6,327252
10108,0.001021,172.217.194.0-255,4320,146517,6,327252
10109,0.001023,172.31.36.0-255,66,146583,6,327252
10110,0.001048,172.217.194.0-255,4320,150903,6,327252
10111,0.001051,172.31.36.0-255,66,150969,6,327252
10112,0.001073,172.217.194.0-255,6438,157407,6,327252
10113,0.001075,172.31.36.0-255,66,157473,6,327252
10114,0.001083,172.217.194.0-255,9992,167465,6,327252
10115,0.001086,172.31.36.0-255,66,167531,6,327252
10116,0.001099,172.217.194.0-255,1484,169015,6,327252
10117,0.001114,172.31.36.0-255,66,169081,6,327252
10118,0.001127,172.217.194.0-255,5738,174819,6,327252
10119,0.00113,172.31.36.0-255,66,174885,6,327252
10120,0.001155,172.217.194.0-255,3602,178487,6,327252
10121,0.001158,172.31.36.0-255,66,178553,6,327252
10122,0.001214,172.217.194.0-255,1484,180037,6,327252
10123,0.001218,172.217.194.0-255,2902,182939,6,327252
10124,0.001221,172.31.36.0-255,66,183005,6,327252
10125,0.001225,172.217.194.0-255,2902,185907,6,327252
10126,0.001227,172.31.36.0-255,66,185973,6,327252
10127,0.001241,172.217.194.0-255,2902,188875,6,327252
10128,0.001243,172.31.36.0-255,66,188941,6,327252
10129,0.001261,172.217.194.0-255,4320,193261,6,327252
10130,0.001264,172.31.36.0-255,66,193327,6,327252
10131,0.001282,172.217.194.0-255,7156,200483,6,327252
10132,0.001285,172.31.36.0-255,66,200549,6,327252
10133,0.001305,172.217.194.0-255,1484,202033,6,327252
10134,0.00131,172.217.194.0-255,4320,206353,6,327252
10135,0.001313,172.31.36.0-255,66,206419,6,327252
10136,0.001341,172.217.194.0-255,6438,212857,6,327252
10137,0.001344,172.31.36.0-255,66,212923,6,327252
10138,0.001418,172.217.194.0-255,1484,214407,6,327252
10139,0.001422,172.217.194.0-255,1484,215891,6,327252
10140,0.001425,172.31.36.0-255,66,215957,6,327252
10141,0.001447,172.217.194.0-255,1484,217441,6,327252
10142,0.001453,172.217.194.0-255,5738,223179,6,327252
10143,0.001456,172.31.36.0-255,66,223245,6,327252
10144,0.001461,172.217.194.0-255,4320,227565,6,327252
10145,0.001463,172.31.36.0-255,66,227631,6,327252
10146,0.00149,172.217.194.0-255,8574,236205,6,327252
10147,0.001495,172.31.36.0-255,66,236271,6,327252
10148,0.001499,172.217.194.0-255,10692,246963,6,327252
10149,0.001501,172.31.36.0-255,66,247029,6,327252
10150,0.001535,172.217.194.0-255,1484,248513,6,327252
10151,0.001539,172.217.194.0-255,1484,249997,6,327252
10152,0.001542,172.31.36.0-255,66,250063,6,327252
10153,0.001562,172.217.194.0-255,1484,251547,6,327252
10154,0.001569,172.217.194.0-255,5738,257285,6,327252
10155,0.001571,172.31.36.0-255,66,257351,6,327252
10156,0.001611,172.217.194.0-255,1484,258835,6,327252
10157,0.001634,172.31.36.0-255,66,258901,6,327252
10158,0.001639,172.217.194.0-255,2902,261803,6,327252
10159,0.001641,172.31.36.0-255,66,261869,6,327252
10160,0.001658,172.217.194.0-255,8574,270443,6,327252
10161,0.001662,172.31.36.0-255,66,270509,6,327252
10162,0.001672,172.217.194.0-255,2184,272693,6,327252
10163,0.001676,172.31.36.0-255,66,272759,6,327252
10164,0.001691,172.31.36.0-255,66,272825,6,327252
10165,0.001699,172.217.194.0-255,8574,281399,6,327252
10166,0.001702,172.31.36.0-255,66,281465,6,327252
10167,0.001726,172.217.194.0-255,7856,289321,6,327252
10168,0.00173,172.31.36.0-255,66,289387,6,327252
10169,0.001736,172.217.194.0-255,5738,295125,6,327252
10170,0.001739,172.31.36.0-255,66,295191,6,327252
10171,0.001777,172.31.36.0-255,66,295257,6,327252
10172,0.001785,172.31.36.0-255,66,295323,6,327252
10173,0.001833,172.217.194.0-255,5020,300343,6,327252
10174,0.001838,172.31.36.0-255,66,300409,6,327252
10175,0.001888,172.217.194.0-255,5738,306147,6,327252
10176,0.001893,172.31.36.0-255,66,306213,6,327252
10177,0.001917,172.217.194.0-255,7156,313369,6,327252
10178,0.001921,172.31.36.0-255,66,313435,6,327252
10179,0.001958,172.217.194.0-255,4320,317755,6,327252
10180,0.001962,172.31.36.0-255,66,317821,6,327252
10181,0.001989,172.217.194.0-255,9089,326910,6,327252
10182,0.001992,172.31.36.0-255,66,326976,6,327252
10183,0.001995,172.217.194.0-255,105,327081,6,327252
10184,0.007555,172.31.36.0-255,66,327147,6,327252
10185,0.007582,172.31.36.0-255,105,327252,6,327252
10186,0.0,172.217.194.0-255,153,153,6,251600
10187,1.8e-05,172.31.36.0-255,66,219,6,251600
10188,5.4e-05,172.217.194.0-255,1484,1703,6,251600
10189,6e-05,172.31.36.0-255,66,1769,6,251600
10190,6.6e-05,172.217.194.0-255,2902,4671,6,251600
10191,7e-05,172.31.36.0-255,66,4737,6,251600
10192,8.2e-05,172.217.194.0-255,5738,10475,6,251600
10193,8.5e-05,172.31.36.0-255,66,10541,6,251600
10194,8.9e-05,172.217.194.0-255,1484,12025,6,251600
10195,9.1e-05,172.31.36.0-255,66,12091,6,251600
10196,9.6e-05,172.217.194.0-255,2029,14120,6,251600
10197,9.9e-05,172.31.36.0-255,66,14186,6,251600
10198,0.000215,172.217.194.0-255,1484,15670,6,251600
10199,0.000222,172.31.36.0-255,66,15736,6,251600
10200,0.000227,172.217.194.0-255,2902,18638,6,251600
10201,0.000229,172.31.36.0-255,66,18704,6,251600
10202,0.000255,172.217.194.0-255,5738,24442,6,251600
10203,0.000257,172.31.36.0-255,66,24508,6,251600
10204,0.000261,172.217.194.0-255,4320,28828,6,251600
10205,0.000263,172.31.36.0-255,66,28894,6,251600
10206,0.000291,172.217.194.0-255,1484,30378,6,251600
10207,0.000294,172.31.36.0-255,66,30444,6,251600
10208,0.000299,172.217.194.0-255,2902,33346,6,251600
10209,0.000301,172.31.36.0-255,66,33412,6,251600
10210,0.000343,172.31.36.0-255,66,33478,6,251600
10211,0.000351,172.217.194.0-255,8574,42052,6,251600
10212,0.000354,172.31.36.0-255,66,42118,6,251600
10213,0.000357,172.217.194.0-255,1484,43602,6,251600
10214,0.000359,172.31.36.0-255,66,43668,6,251600
10215,0.000395,172.217.194.0-255,6747,50415,6,251600
10216,0.000399,172.31.36.0-255,66,50481,6,251600
10217,0.000403,172.217.194.0-255,101,50582,6,251600
10218,0.000457,172.217.194.0-255,1484,52066,6,251600
10219,0.000461,172.31.36.0-255,66,52132,6,251600
10220,0.000464,172.217.194.0-255,1484,53616,6,251600
10221,0.000466,172.217.194.0-255,1484,55100,6,251600
10222,0.000468,172.31.36.0-255,66,55166,6,251600
10223,0.000494,172.217.194.0-255,2902,58068,6,251600
10224,0.000496,172.31.36.0-255,66,58134,6,251600
10225,0.000522,172.217.194.0-255,9992,68126,6,251600
10226,0.000524,172.31.36.0-255,66,68192,6,251600
10227,0.000555,172.31.36.0-255,66,68258,6,251600
10228,0.000607,172.217.194.0-255,4738,72996,6,251600
10229,0.000611,172.31.36.0-255,66,73062,6,251600
10230,0.000697,172.217.194.0-255,1484,74546,6,251600
10231,0.000723,172.217.194.0-255,2902,77448,6,251600
10232,0.000728,172.31.36.0-255,66,77514,6,251600
10233,0.000734,172.217.194.0-255,4320,81834,6,251600
10234,0.000737,172.31.36.0-255,66,81900,6,251600
10235,0.000751,172.217.194.0-255,8574,90474,6,251600
10236,0.000754,172.31.36.0-255,66,90540,6,251600
10237,0.000798,172.31.36.0-255,66,90606,6,251600
10238,0.000833,172.217.194.0-255,3602,94208,6,251600
10239,0.000836,172.31.36.0-255,66,94274,6,251600
10240,0.000856,172.31.36.0-255,66,94340,6,251600
10241,0.000868,172.31.36.0-255,66,94406,6,251600
10242,0.000873,172.217.194.0-255,5020,99426,6,251600
10243,0.000875,172.31.36.0-255,66,99492,6,251600
10244,0.000878,172.217.194.0-255,1484,100976,6,251600
10245,0.000908,172.217.194.0-255,4320,105296,6,251600
10246,0.000911,172.31.36.0-255,66,105362,6,251600
10247,0.000917,172.217.194.0-255,7156,112518,6,251600
10248,0.000919,172.31.36.0-255,66,112584,6,251600
10249,0.000946,172.217.194.0-255,5738,118322,6,251600
10250,0.000948,172.31.36.0-255,66,118388,6,251600
10251,0.000956,172.217.194.0-255,8574,126962,6,251600
10252,0.000958,172.31.36.0-255,66,127028,6,251600
10253,0.000997,172.217.194.0-255,6438,133466,6,251600
10254,0.001001,172.31.36.0-255,66,133532,6,251600
10255,0.001349,172.217.194.0-255,1484,135016,6,251600
10256,0.001376,172.217.194.0-255,2902,137918,6,251600
10257,0.001381,172.31.36.0-255,66,137984,6,251600
10258,0.001386,172.217.194.0-255,1484,139468,6,251600
10259,0.001392,172.217.194.0-255,5738,145206,6,251600
10260,0.001399,172.31.36.0-255,66,145272,6,251600
10261,0.001427,172.217.194.0-255,8574,153846,6,251600
10262,0.00143,172.31.36.0-255,66,153912,6,251600
10263,0.001466,172.217.194.0-255,4320,158232,6,251600
10264,0.001469,172.31.36.0-255,66,158298,6,251600
10265,0.001478,172.217.194.0-255,9274,167572,6,251600
10266,0.001487,172.31.36.0-255,66,167638,6,251600
10267,0.001576,172.217.194.0-255,1484,169122,6,251600
10268,0.001583,172.217.194.0-255,2902,172024,6,251600
10269,0.001586,172.31.36.0-255,66,172090,6,251600
10270,0.001592,172.217.194.0-255,4320,176410,6,251600
10271,0.001595,172.31.36.0-255,66,176476,6,251600
10272,0.001615,172.217.194.0-255,1484,177960,6,251600
10273,0.001622,172.217.194.0-255,7156,185116,6,251600
10274,0.001625,172.31.36.0-255,66,185182,6,251600
10275,0.001662,172.217.194.0-255,5738,190920,6,251600
10276,0.001665,172.31.36.0-255,66,190986,6,251600
10277,0.001675,172.217.194.0-255,10692,201678,6,251600
10278,0.001677,172.31.36.0-255,66,201744,6,251600
10279,0.001707,172.217.194.0-255,1484,203228,6,251600
10280,0.001711,172.217.194.0-255,2902,206130,6,251600
10281,0.001714,172.31.36.0-255,66,206196,6,251600
10282,0.001725,172.217.194.0-255,5738,211934,6,251600
10283,0.001727,172.31.36.0-255,66,212000,6,251600
10284,0.001789,172.31.36.0-255,66,212066,6,251600
10285,0.001798,172.217.194.0-255,8574,220640,6,251600
10286,0.001801,172.31.36.0-255,66,220706,6,251600
10287,0.001837,172.217.194.0-255,10692,231398,6,251600
10288,0.001839,172.31.36.0-255,66,231464,6,251600
10289,0.001857,172.31.36.0-255,66,231530,6,251600
10290,0.001883,172.217.194.0-255,8574,240104,6,251600
10291,0.001886,172.31.36.0-255,66,240170,6,251600
10292,0.001931,172.31.36.0-255,66,240236,6,251600
10293,0.001935,172.217.194.0-255,2902,243138,6,251600
10294,0.001937,172.31.36.0-255,66,243204,6,251600
10295,0.001976,172.31.36.0-255,66,243270,6,251600
10296,0.002017,172.217.194.0-255,7856,251126,6,251600
10297,0.00202,172.31.36.0-255,66,251192,6,251600
10298,0.002043,172.31.36.0-255,66,251258,6,251600
10299,0.002046,172.217.194.0-255,105,251363,6,251600
10300,0.004655,172.31.36.0-255,66,251429,6,251600
10301,0.004693,172.31.36.0-255,105,251534,6,251600
10302,0.006793,172.217.194.0-255,66,251600,6,251600
10303,0.0,74.125.24.0-255,152,152,6,126085
10304,3.5e-05,172.31.36.0-255,66,218,6,126085
10305,4.2e-05,74.125.24.0-255,1484,1702,6,126085
10306,4.6e-05,172.31.36.0-255,66,1768,6,126085
10307,5.1e-05,74.125.24.0-255,2902,4670,6,126085
10308,6.2e-05,172.31.36.0-255,66,4736,6,126085
10309,7.1e-05,74.125.24.0-255,7156,11892,6,126085
10310,7.4e-05,172.31.36.0-255,66,11958,6,126085
10311,7.8e-05,74.125.24.0-255,2076,14034,6,126085
10312,8.1e-05,172.31.36.0-255,66,14100,6,126085
10313,9.5e-05,172.31.36.0-255,66,14166,6,126085
10314,9.7e-05,74.125.24.0-255,1484,15650,6,126085
10315,0.0001,172.31.36.0-255,66,15716,6,126085
10316,0.000138,74.125.24.0-255,3961,19677,6,126085
10317,0.000141,172.31.36.0-255,66,19743,6,126085
10318,0.000145,74.125.24.0-255,1484,21227,6,126085
10319,0.000146,172.31.36.0-255,66,21293,6,126085
10320,0.000165,74.125.24.0-255,2902,24195,6,126085
10321,0.000167,172.31.36.0-255,66,24261,6,126085
10322,0.000173,74.125.24.0-255,4320,28581,6,126085
10323,0.000176,172.31.36.0-255,66,28647,6,126085
10324,0.0002,74.125.24.0-255,1484,30131,6,126085
10325,0.000203,172.31.36.0-255,66,30197,6,126085
10326,0.000216,74.125.24.0-255,6797,36994,6,126085
10327,0.000219,172.31.36.0-255,66,37060,6,126085
10328,0.000526,74.125.24.0-255,1484,38544,6,126085
10329,0.000532,172.31.36.0-255,66,38610,6,126085
10330,0.000537,74.125.24.0-255,1484,40094,6,126085
10331,0.000541,172.31.36.0-255,66,40160,6,126085
10332,0.000572,74.125.24.0-255,1484,41644,6,126085
10333,0.000577,172.31.36.0-255,66,41710,6,126085
10334,0.000579,74.125.24.0-255,5738,47448,6,126085
10335,0.000582,172.31.36.0-255,66,47514,6,126085
10336,0.000601,74.125.24.0-255,1484,48998,6,126085
10337,0.000636,172.31.36.0-255,66,49064,6,126085
10338,0.000672,74.125.24.0-255,9633,58697,6,126085
10339,0.000676,172.31.36.0-255,66,58763,6,126085
10340,0.001666,74.125.24.0-255,1484,60247,6,126085
10341,0.001678,74.125.24.0-255,2902,63149,6,126085
10342,0.001682,172.31.36.0-255,66,63215,6,126085
10343,0.001689,74.125.24.0-255,4320,67535,6,126085
10344,0.001707,172.31.36.0-255,66,67601,6,126085
10345,0.001741,74.125.24.0-255,1484,69085,6,126085
10346,0.001754,172.31.36.0-255,66,69151,6,126085
10347,0.001763,74.125.24.0-255,9992,79143,6,126085
10348,0.001765,172.31.36.0-255,66,79209,6,126085
10349,0.001772,74.125.24.0-255,766,79975,6,126085
10350,0.002467,74.125.24.0-255,1484,81459,6,126085
10351,0.00247,172.31.36.0-255,66,81525,6,126085
10352,0.002475,74.125.24.0-255,2902,84427,6,126085
10353,0.002476,172.31.36.0-255,66,84493,6,126085
10354,0.00248,74.125.24.0-255,1484,85977,6,126085
10355,0.002511,74.125.24.0-255,4320,90297,6,126085
10356,0.002513,172.31.36.0-255,66,90363,6,126085
10357,0.002519,74.125.24.0-255,4320,94683,6,126085
10358,0.002521,172.31.36.0-255,66,94749,6,126085
10359,0.00254,74.125.24.0-255,2902,97651,6,126085
10360,0.002546,172.31.36.0-255,66,97717,6,126085
10361,0.002554,74.125.24.0-255,8574,106291,6,126085
10362,0.002557,172.31.36.0-255,66,106357,6,126085
10363,0.002562,74.125.24.0-255,4320,110677,6,126085
10364,0.002564,172.31.36.0-255,66,110743,6,126085
10365,0.002596,74.125.24.0-255,3602,114345,6,126085
10366,0.002598,172.31.36.0-255,66,114411,6,126085
10367,0.005201,74.125.24.0-255,1484,115895,6,126085
10368,0.005231,74.125.24.0-255,4320,120215,6,126085
10369,0.005236,172.31.36.0-255,66,120281,6,126085
10370,0.007851,74.125.24.0-255,5738,126019,6,126085
10371,0.007857,172.31.36.0-255,66,126085,6,126085
10372,0.0,74.125.24.0-255,298,298,6,190833
10373,2.8e-05,172.31.36.0-255,66,364,6,190833
10374,3.4e-05,74.125.24.0-255,1484,1848,6,190833
10375,3.7e-05,172.31.36.0-255,66,1914,6,190833
10376,4.3e-05,74.125.24.0-255,4320,6234,6,190833
10377,5.5e-05,172.31.36.0-255,66,6300,6,190833
10378,6.1e-05,74.125.24.0-255,7156,13456,6,190833
10379,6.4e-05,172.31.36.0-255,66,13522,6,190833
10380,0.000113,172.31.36.0-255,66,13588,6,190833
10381,0.000115,74.125.24.0-255,1125,14713,6,190833
10382,0.000117,172.31.36.0-255,66,14779,6,190833
10383,0.000162,74.125.24.0-255,1484,16263,6,190833
10384,0.000166,172.31.36.0-255,66,16329,6,190833
10385,0.000193,74.125.24.0-255,1484,17813,6,190833
10386,0.000196,172.31.36.0-255,66,17879,6,190833
10387,0.000202,74.125.24.0-255,4320,22199,6,190833
10388,0.000204,172.31.36.0-255,66,22265,6,190833
10389,0.000244,172.31.36.0-255,66,22331,6,190833
10390,0.000254,74.125.24.0-255,9992,32323,6,190833
10391,0.000264,172.31.36.0-255,66,32389,6,190833
10392,0.000298,74.125.24.0-255,5657,38046,6,190833
10393,0.000302,172.31.36.0-255,66,38112,6,190833
10394,0.000305,74.125.24.0-255,130,38242,6,190833
10395,0.000308,172.31.36.0-255,66,38308,6,190833
10396,0.000642,74.125.24.0-255,1484,39792,6,190833
10397,0.000647,172.31.36.0-255,66,39858,6,190833
10398,0.000651,74.125.24.0-255,1484,41342,6,190833
10399,0.000653,172.31.36.0-255,66,41408,6,190833
10400,0.000671,74.125.24.0-255,1484,42892,6,190833
10401,0.000673,172.31.36.0-255,66,42958,6,190833
10402,0.000686,74.125.24.0-255,5738,48696,6,190833
10403,0.000689,172.31.36.0-255,66,48762,6,190833
10404,0.000721,74.125.24.0-255,6797,55559,6,190833
10405,0.000725,172.31.36.0-255,66,55625,6,190833
10406,0.00073,74.125.24.0-255,4320,59945,6,190833
10407,0.000732,172.31.36.0-255,66,60011,6,190833
10408,0.000754,74.125.24.0-255,2902,62913,6,190833
10409,0.000757,172.31.36.0-255,66,62979,6,190833
10410,0.00076,74.125.24.0-255,1484,64463,6,190833
10411,0.000789,74.125.24.0-255,8215,72678,6,190833
10412,0.000793,172.31.36.0-255,66,72744,6,190833
10413,0.001039,74.125.24.0-255,1484,74228,6,190833
10414,0.001054,74.125.24.0-255,2902,77130,6,190833
10415,0.001057,172.31.36.0-255,66,77196,6,190833
10416,0.001061,74.125.24.0-255,1484,78680,6,190833
10417,0.001088,74.125.24.0-255,5738,84418,6,190833
10418,0.001091,172.31.36.0-255,66,84484,6,190833
10419,0.00113,172.31.36.0-255,66,84550,6,190833
10420,0.001136,74.125.24.0-255,5738,90288,6,190833
10421,0.001138,172.31.36.0-255,66,90354,6,190833
10422,0.001172,74.125.24.0-255,3602,93956,6,190833
10423,0.001176,172.31.36.0-255,66,94022,6,190833
10424,0.001357,74.125.24.0-255,1484,95506,6,190833
10425,0.001365,74.125.24.0-255,2902,98408,6,190833
10426,0.001368,172.31.36.0-255,66,98474,6,190833
10427,0.001373,74.125.24.0-255,2902,101376,6,190833
10428,0.001375,172.31.36.0-255,66,101442,6,190833
10429,0.0014,74.125.24.0-255,2902,104344,6,190833
10430,0.001404,172.31.36.0-255,66,104410,6,190833
10431,0.001417,172.31.36.0-255,66,104476,6,190833
10432,0.001432,74.125.24.0-255,9992,114468,6,190833
10433,0.001435,172.31.36.0-255,66,114534,6,190833
10434,0.001455,74.125.24.0-255,766,115300,6,190833
10435,0.001562,74.125.24.0-255,1484,116784,6,190833
10436,0.001566,172.31.36.0-255,66,116850,6,190833
10437,0.001572,74.125.24.0-255,2902,119752,6,190833
10438,0.001574,172.31.36.0-255,66,119818,6,190833
10439,0.001598,74.125.24.0-255,5738,125556,6,190833
10440,0.001602,172.31.36.0-255,66,125622,6,190833
10441,0.001606,74.125.24.0-255,2902,128524,6,190833
10442,0.001608,172.31.36.0-255,66,128590,6,190833
10443,0.001652,74.125.24.0-255,9992,138582,6,190833
10444,0.001657,172.31.36.0-255,66,138648,6,190833
10445,0.001666,74.125.24.0-255,10692,149340,6,190833
10446,0.001669,172.31.36.0-255,66,149406,6,190833
10447,0.001679,74.125.24.0-255,2902,152308,6,190833
10448,0.001681,172.31.36.0-255,66,152374,6,190833
10449,0.001724,172.31.36.0-255,66,152440,6,190833
10450,0.001753,74.125.24.0-255,5738,158178,6,190833
10451,0.001757,172.31.36.0-255,66,158244,6,190833
10452,0.001765,74.125.24.0-255,7856,166100,6,190833
10453,0.001767,172.31.36.0-255,66,166166,6,190833
10454,0.001802,172.31.36.0-255,66,166232,6,190833
10455,0.001862,74.125.24.0-255,6438,172670,6,190833
10456,0.001867,172.31.36.0-255,66,172736,6,190833
10457,0.001874,172.31.36.0-255,66,172802,6,190833
10458,0.001896,172.31.36.0-255,66,172868,6,190833
10459,0.001933,74.125.24.0-255,2184,175052,6,190833
10460,0.001938,172.31.36.0-255,66,175118,6,190833
10461,0.002022,172.31.36.0-255,66,175184,6,190833
10462,0.002057,74.125.24.0-255,5020,180204,6,190833
10463,0.002061,172.31.36.0-255,66,180270,6,190833
10464,0.002087,172.31.36.0-255,66,180336,6,190833
10465,0.002096,74.125.24.0-255,9992,190328,6,190833
10466,0.002099,172.31.36.0-255,66,190394,6,190833
10467,0.002124,172.31.36.0-255,66,190460,6,190833
10468,0.002127,74.125.24.0-255,97,190557,6,190833
10469,0.002131,74.125.24.0-255,105,190662,6,190833
10470,0.008334,172.31.36.0-255,66,190728,6,190833
10471,0.008362,172.31.36.0-255,105,190833,6,190833
10472,0.0,172.31.36.0-255,66,66,6,66
10473,0.0,74.125.24.0-255,153,153,6,135134
10474,2.4e-05,172.31.36.0-255,66,219,6,135134
10475,3.2e-05,74.125.24.0-255,1484,1703,6,135134
10476,3.7e-05,172.31.36.0-255,66,1769,6,135134
10477,5.6e-05,74.125.24.0-255,2902,4671,6,135134
10478,6e-05,172.31.36.0-255,66,4737,6,135134
10479,6.7e-05,74.125.24.0-255,7156,11893,6,135134
10480,7.1e-05,172.31.36.0-255,66,11959,6,135134
10481,9e-05,74.125.24.0-255,2071,14030,6,135134
10482,9.7e-05,172.31.36.0-255,66,14096,6,135134
10483,0.000174,74.125.24.0-255,1484,15580,6,135134
10484,0.000176,172.31.36.0-255,66,15646,6,135134
10485,0.000183,74.125.24.0-255,2902,18548,6,135134
10486,0.000185,172.31.36.0-255,66,18614,6,135134
10487,0.000211,74.125.24.0-255,5738,24352,6,135134
10488,0.000213,172.31.36.0-255,66,24418,6,135134
10489,0.000216,74.125.24.0-255,1484,25902,6,135134
10490,0.000218,172.31.36.0-255,66,25968,6,135134
10491,0.000255,74.125.24.0-255,9633,35601,6,135134
10492,0.000261,74.125.24.0-255,5738,41339,6,135134
10493,0.000267,172.31.36.0-255,66,41405,6,135134
10494,0.000274,172.31.36.0-255,66,41471,6,135134
10495,0.000283,74.125.24.0-255,2902,44373,6,135134
10496,0.000285,172.31.36.0-255,66,44439,6,135134
10497,0.00031,74.125.24.0-255,3961,48400,6,135134
10498,0.000313,172.31.36.0-255,66,48466,6,135134
10499,0.000432,74.125.24.0-255,1484,49950,6,135134
10500,0.000436,172.31.36.0-255,66,50016,6,135134
10501,0.000441,74.125.24.0-255,2902,52918,6,135134
10502,0.000444,172.31.36.0-255,66,52984,6,135134
10503,0.000448,74.125.24.0-255,1484,54468,6,135134
10504,0.000454,172.31.36.0-255,66,54534,6,135134
10505,0.000484,74.125.24.0-255,4320,58854,6,135134
10506,0.000493,172.31.36.0-255,66,58920,6,135134
10507,0.000537,74.125.24.0-255,7408,66328,6,135134
10508,0.00054,172.31.36.0-255,66,66394,6,135134
10509,0.000572,74.125.24.0-255,1484,67878,6,135134
10510,0.000593,74.125.24.0-255,2902,70780,6,135134
10511,0.000612,172.31.36.0-255,66,70846,6,135134
10512,0.00062,74.125.24.0-255,5738,76584,6,135134
10513,0.000623,172.31.36.0-255,66,76650,6,135134
10514,0.000633,74.125.24.0-255,4320,80970,6,135134
10515,0.000636,172.31.36.0-255,66,81036,6,135134
10516,0.000665,74.125.24.0-255,2543,83579,6,135134
10517,0.000668,172.31.36.0-255,66,83645,6,135134
10518,0.000696,74.125.24.0-255,2902,86547,6,135134
10519,0.000698,172.31.36.0-255,66,86613,6,135134
10520,0.000703,74.125.24.0-255,2902,89515,6,135134
10521,0.000705,172.31.36.0-255,66,89581,6,135134
10522,0.000736,74.125.24.0-255,4320,93901,6,135134
10523,0.000739,172.31.36.0-255,66,93967,6,135134
10524,0.000745,74.125.24.0-255,5738,99705,6,135134
10525,0.000748,172.31.36.0-255,66,99771,6,135134
10526,0.000756,74.125.24.0-255,1125,100896,6,135134
10527,0.001625,172.31.36.0-255,66,100962,6,135134
10528,0.002489,74.125.24.0-255,1484,102446,6,135134
10529,0.002504,74.125.24.0-255,2902,105348,6,135134
10530,0.00251,172.31.36.0-255,66,105414,6,135134
10531,0.002518,74.125.24.0-255,5738,111152,6,135134
10532,0.00252,172.31.36.0-255,66,111218,6,135134
10533,0.002542,172.31.36.0-255,66,111284,6,135134
10534,0.00257,74.125.24.0-255,1484,112768,6,135134
10535,0.002585,74.125.24.0-255,10692,123460,6,135134
10536,0.002588,172.31.36.0-255,66,123526,6,135134
10537,0.005173,74.125.24.0-255,5738,129264,6,135134
10538,0.00518,172.31.36.0-255,66,129330,6,135134
10539,0.007783,74.125.24.0-255,5738,135068,6,135134
10540,0.007791,172.31.36.0-255,66,135134,6,135134
10541,0.0,74.125.68.0-255,144,144,6,392504
10542,2.1e-05,172.31.36.0-255,66,210,6,392504
10543,2.9e-05,74.125.68.0-255,1484,1694,6,392504
10544,3.4e-05,172.31.36.0-255,66,1760,6,392504
10545,4e-05,74.125.68.0-255,2902,4662,6,392504
10546,4.4e-05,172.31.36.0-255,66,4728,6,392504
10547,4.7e-05,74.125.68.0-255,1484,6212,6,392504
10548,5e-05,172.31.36.0-255,66,6278,6,392504
10549,5.4e-05,74.125.68.0-255,1484,7762,6,392504
10550,5.6e-05,172.31.36.0-255,66,7828,6,392504
10551,8.4e-05,74.125.68.0-255,1484,9312,6,392504
10552,8.8e-05,172.31.36.0-255,66,9378,6,392504
10553,9.5e-05,74.125.68.0-255,6296,15674,6,392504
10554,9.8e-05,172.31.36.0-255,66,15740,6,392504
10555,0.000104,74.125.68.0-255,5738,21478,6,392504
10556,0.000107,172.31.36.0-255,66,21544,6,392504
10557,0.000114,74.125.68.0-255,7156,28700,6,392504
10558,0.000116,172.31.36.0-255,66,28766,6,392504
10559,0.000141,74.125.68.0-255,2543,31309,6,392504
10560,0.000143,172.31.36.0-255,66,31375,6,392504
10561,0.000288,74.125.68.0-255,1484,32859,6,392504
10562,0.000292,172.31.36.0-255,66,32925,6,392504
10563,0.000297,74.125.68.0-255,2902,35827,6,392504
10564,0.0003,172.31.36.0-255,66,35893,6,392504
10565,0.000332,74.125.68.0-255,5738,41631,6,392504
10566,0.000335,172.31.36.0-255,66,41697,6,392504
10567,0.000339,74.125.68.0-255,2902,44599,6,392504
10568,0.000341,172.31.36.0-255,66,44665,6,392504
10569,0.000362,74.125.68.0-255,3961,48626,6,392504
10570,0.000365,172.31.36.0-255,66,48692,6,392504
10571,0.000371,74.125.68.0-255,7156,55848,6,392504
10572,0.000374,172.31.36.0-255,66,55914,6,392504
10573,0.000412,74.125.68.0-255,9905,65819,6,392504
10574,0.000415,172.31.36.0-255,66,65885,6,392504
10575,0.000418,74.125.68.0-255,134,66019,6,392504
10576,0.000711,74.125.68.0-255,348,66367,6,392504
10577,0.001015,74.125.68.0-255,1484,67851,6,392504
10578,0.001021,172.31.36.0-255,66,67917,6,392504
10579,0.001044,74.125.68.0-255,2902,70819,6,392504
10580,0.001047,172.31.36.0-255,66,70885,6,392504
10581,0.001065,74.125.68.0-255,2902,73787,6,392504
10582,0.001067,172.31.36.0-255,66,73853,6,392504
10583,0.001091,74.125.68.0-255,2902,76755,6,392504
10584,0.001094,172.31.36.0-255,66,76821,6,392504
10585,0.001111,74.125.68.0-255,1484,78305,6,392504
10586,0.001117,74.125.68.0-255,5379,83684,6,392504
10587,0.00112,172.31.36.0-255,66,83750,6,392504
10588,0.00115,74.125.68.0-255,5738,89488,6,392504
10589,0.001153,172.31.36.0-255,66,89554,6,392504
10590,0.001159,74.125.68.0-255,4320,93874,6,392504
10591,0.001161,172.31.36.0-255,66,93940,6,392504
10592,0.001186,74.125.68.0-255,5738,99678,6,392504
10593,0.001189,172.31.36.0-255,66,99744,6,392504
10594,0.001208,74.125.68.0-255,1125,100869,6,392504
10595,0.00158,172.31.36.0-255,66,100935,6,392504
10596,0.001748,74.125.68.0-255,1484,102419,6,392504
10597,0.001756,74.125.68.0-255,1484,103903,6,392504
10598,0.001759,172.31.36.0-255,66,103969,6,392504
10599,0.001781,74.125.68.0-255,2902,106871,6,392504
10600,0.001784,172.31.36.0-255,66,106937,6,392504
10601,0.001803,74.125.68.0-255,5738,112675,6,392504
10602,0.001806,172.31.36.0-255,66,112741,6,392504
10603,0.001809,74.125.68.0-255,1484,114225,6,392504
10604,0.001824,74.125.68.0-255,2902,117127,6,392504
10605,0.001827,172.31.36.0-255,66,117193,6,392504
10606,0.001845,74.125.68.0-255,1484,118677,6,392504
10607,0.001868,74.125.68.0-255,4320,122997,6,392504
10608,0.00187,172.31.36.0-255,66,123063,6,392504
10609,0.001874,74.125.68.0-255,1484,124547,6,392504
10610,0.001878,74.125.68.0-255,2902,127449,6,392504
10611,0.00188,172.31.36.0-255,66,127515,6,392504
10612,0.001923,74.125.68.0-255,5738,133253,6,392504
10613,0.001927,172.31.36.0-255,66,133319,6,392504
10614,0.00193,74.125.68.0-255,1484,134803,6,392504
10615,0.001958,74.125.68.0-255,766,135569,6,392504
10616,0.00196,172.31.36.0-255,66,135635,6,392504
10617,0.00203,74.125.68.0-255,1484,137119,6,392504
10618,0.002048,74.125.68.0-255,2902,140021,6,392504
10619,0.002051,172.31.36.0-255,66,140087,6,392504
10620,0.002103,74.125.68.0-255,1484,141571,6,392504
10621,0.002117,74.125.68.0-255,1484,143055,6,392504
10622,0.00212,172.31.36.0-255,66,143121,6,392504
10623,0.002154,74.125.68.0-255,2902,146023,6,392504
10624,0.002156,172.31.36.0-255,66,146089,6,392504
10625,0.002161,74.125.68.0-255,2902,148991,6,392504
10626,0.002163,172.31.36.0-255,66,149057,6,392504
10627,0.002177,74.125.68.0-255,2902,151959,6,392504
10628,0.002179,172.31.36.0-255,66,152025,6,392504
10629,0.002182,74.125.68.0-255,1484,153509,6,392504
10630,0.002214,74.125.68.0-255,7156,160665,6,392504
10631,0.002217,172.31.36.0-255,66,160731,6,392504
10632,0.002234,74.125.68.0-255,1484,162215,6,392504
10633,0.002239,74.125.68.0-255,4320,166535,6,392504
10634,0.002241,172.31.36.0-255,66,166601,6,392504
10635,0.002276,74.125.68.0-255,5020,171621,6,392504
10636,0.002278,172.31.36.0-255,66,171687,6,392504
10637,0.002291,74.125.68.0-255,2902,174589,6,392504
10638,0.002295,172.31.36.0-255,66,174655,6,392504
10639,0.002318,74.125.68.0-255,2902,177557,6,392504
10640,0.002321,172.31.36.0-255,66,177623,6,392504
10641,0.002325,74.125.68.0-255,1484,179107,6,392504
10642,0.002339,74.125.68.0-255,4320,183427,6,392504
10643,0.002342,172.31.36.0-255,66,183493,6,392504
10644,0.002384,74.125.68.0-255,4320,187813,6,392504
10645,0.002388,172.31.36.0-255,66,187879,6,392504
10646,0.002392,74.125.68.0-255,1484,189363,6,392504
10647,0.002423,74.125.68.0-255,1484,190847,6,392504
10648,0.002425,172.31.36.0-255,66,190913,6,392504
10649,0.002431,74.125.68.0-255,2902,193815,6,392504
10650,0.002434,172.31.36.0-255,66,193881,6,392504
10651,0.00245,74.125.68.0-255,1484,195365,6,392504
10652,0.002478,74.125.68.0-255,2902,198267,6,392504
10653,0.002481,172.31.36.0-255,66,198333,6,392504
10654,0.002504,74.125.68.0-255,5738,204071,6,392504
10655,0.002507,172.31.36.0-255,66,204137,6,392504
10656,0.00251,74.125.68.0-255,766,204903,6,392504
10657,0.002719,74.125.68.0-255,1484,206387,6,392504
10658,0.002725,172.31.36.0-255,66,206453,6,392504
10659,0.00273,74.125.68.0-255,1484,207937,6,392504
10660,0.002745,74.125.68.0-255,2902,210839,6,392504
10661,0.002748,172.31.36.0-255,66,210905,6,392504
10662,0.002768,74.125.68.0-255,4320,215225,6,392504
10663,0.00277,172.31.36.0-255,66,215291,6,392504
10664,0.002793,74.125.68.0-255,1484,216775,6,392504
10665,0.002796,74.125.68.0-255,1484,218259,6,392504
10666,0.002798,172.31.36.0-255,66,218325,6,392504
10667,0.002802,74.125.68.0-255,2902,221227,6,392504
10668,0.002805,172.31.36.0-255,66,221293,6,392504
10669,0.002827,74.125.68.0-255,5738,227031,6,392504
10670,0.00283,172.31.36.0-255,66,227097,6,392504
10671,0.002833,74.125.68.0-255,1484,228581,6,392504
10672,0.002856,74.125.68.0-255,2902,231483,6,392504
10673,0.002859,172.31.36.0-255,66,231549,6,392504
10674,0.002866,74.125.68.0-255,5738,237287,6,392504
10675,0.002868,172.31.36.0-255,66,237353,6,392504
10676,0.00289,74.125.68.0-255,2184,239537,6,392504
10677,0.002893,172.31.36.0-255,66,239603,6,392504
10678,0.003082,74.125.68.0-255,1484,241087,6,392504
10679,0.003098,74.125.68.0-255,1484,242571,6,392504
10680,0.003101,172.31.36.0-255,66,242637,6,392504
10681,0.003114,74.125.68.0-255,1484,244121,6,392504
10682,0.003126,74.125.68.0-255,5738,249859,6,392504
10683,0.003129,172.31.36.0-255,66,249925,6,392504
10684,0.003133,74.125.68.0-255,1484,251409,6,392504
10685,0.003155,74.125.68.0-255,2902,254311,6,392504
10686,0.003158,172.31.36.0-255,66,254377,6,392504
10687,0.003165,74.125.68.0-255,5738,260115,6,392504
10688,0.003167,172.31.36.0-255,66,260181,6,392504
10689,0.003208,172.31.36.0-255,66,260247,6,392504
10690,0.003212,74.125.68.0-255,2184,262431,6,392504
10691,0.003214,172.31.36.0-255,66,262497,6,392504
10692,0.00327,74.125.68.0-255,1484,263981,6,392504
10693,0.003275,74.125.68.0-255,2902,266883,6,392504
10694,0.003278,172.31.36.0-255,66,266949,6,392504
10695,0.003293,74.125.68.0-255,1484,268433,6,392504
10696,0.00331,74.125.68.0-255,4320,272753,6,392504
10697,0.003313,172.31.36.0-255,66,272819,6,392504
10698,0.003318,74.125.68.0-255,4320,277139,6,392504
10699,0.003321,172.31.36.0-255,66,277205,6,392504
10700,0.003337,74.125.68.0-255,2902,280107,6,392504
10701,0.00334,172.31.36.0-255,66,280173,6,392504
10702,0.003344,74.125.68.0-255,2902,283075,6,392504
10703,0.003347,172.31.36.0-255,66,283141,6,392504
10704,0.00335,74.125.68.0-255,1484,284625,6,392504
10705,0.003354,74.125.68.0-255,1484,286109,6,392504
10706,0.003356,172.31.36.0-255,66,286175,6,392504
10707,0.003371,74.125.68.0-255,1484,287659,6,392504
10708,0.003374,74.125.68.0-255,1484,289143,6,392504
10709,0.003376,172.31.36.0-255,66,289209,6,392504
10710,0.003398,74.125.68.0-255,1484,290693,6,392504
10711,0.003415,74.125.68.0-255,6438,297131,6,392504
10712,0.003418,172.31.36.0-255,66,297197,6,392504
10713,0.003455,74.125.68.0-255,8574,305771,6,392504
10714,0.003459,172.31.36.0-255,66,305837,6,392504
10715,0.003462,74.125.68.0-255,1484,307321,6,392504
10716,0.003494,74.125.68.0-255,7156,314477,6,392504
10717,0.003497,172.31.36.0-255,66,314543,6,392504
10718,0.003521,74.125.68.0-255,4320,318863,6,392504
10719,0.003525,172.31.36.0-255,66,318929,6,392504
10720,0.003528,74.125.68.0-255,1484,320413,6,392504
10721,0.003559,74.125.68.0-255,10692,331105,6,392504
10722,0.003562,172.31.36.0-255,66,331171,6,392504
10723,0.003586,74.125.68.0-255,1484,332655,6,392504
10724,0.003603,74.125.68.0-255,1484,334139,6,392504
10725,0.003606,172.31.36.0-255,66,334205,6,392504
10726,0.00361,74.125.68.0-255,2902,337107,6,392504
10727,0.003613,172.31.36.0-255,66,337173,6,392504
10728,0.003633,74.125.68.0-255,5738,342911,6,392504
10729,0.003636,172.31.36.0-255,66,342977,6,392504
10730,0.003662,74.125.68.0-255,2902,345879,6,392504
10731,0.003665,172.31.36.0-255,66,345945,6,392504
10732,0.003685,74.125.68.0-255,4320,350265,6,392504
10733,0.003687,172.31.36.0-255,66,350331,6,392504
10734,0.003694,74.125.68.0-255,5738,356069,6,392504
10735,0.003696,172.31.36.0-255,66,356135,6,392504
10736,0.003715,74.125.68.0-255,2902,359037,6,392504
10737,0.003719,172.31.36.0-255,66,359103,6,392504
10738,0.003726,74.125.68.0-255,6438,365541,6,392504
10739,0.003728,172.31.36.0-255,66,365607,6,392504
10740,0.003742,74.125.68.0-255,2902,368509,6,392504
10741,0.003745,172.31.36.0-255,66,368575,6,392504
10742,0.003774,74.125.68.0-255,4320,372895,6,392504
10743,0.003776,172.31.36.0-255,66,372961,6,392504
10744,0.003783,74.125.68.0-255,5738,378699,6,392504
10745,0.003785,172.31.36.0-255,66,378765,6,392504
10746,0.00379,74.125.68.0-255,2902,381667,6,392504
10747,0.003792,172.31.36.0-255,66,381733,6,392504
10748,0.00381,74.125.68.0-255,4320,386053,6,392504
10749,0.003812,172.31.36.0-255,66,386119,6,392504
10750,0.00382,74.125.68.0-255,5946,392065,6,392504
10751,0.003822,172.31.36.0-255,66,392131,6,392504
10752,0.003825,74.125.68.0-255,97,392228,6,392504
10753,0.003905,74.125.68.0-255,105,392333,6,392504
10754,0.008951,172.31.36.0-255,66,392399,6,392504
10755,0.00899,172.31.36.0-255,105,392504,6,392504
10756,0.0,172.217.194.0-255,153,153,6,292031
10757,1.7e-05,172.31.36.0-255,66,219,6,292031
10758,2.5e-05,172.217.194.0-255,1484,1703,6,292031
10759,3e-05,172.31.36.0-255,66,1769,6,292031
10760,3.6e-05,172.217.194.0-255,2902,4671,6,292031
10761,3.9e-05,172.31.36.0-255,66,4737,6,292031
10762,4.7e-05,172.217.194.0-255,7156,11893,6,292031
10763,5e-05,172.31.36.0-255,66,11959,6,292031
10764,5.8e-05,172.217.194.0-255,7739,19698,6,292031
10765,6.1e-05,172.31.36.0-255,66,19764,6,292031
10766,8.9e-05,172.31.36.0-255,66,19830,6,292031
10767,0.000298,172.217.194.0-255,1484,21314,6,292031
10768,0.000303,172.31.36.0-255,66,21380,6,292031
10769,0.00031,172.217.194.0-255,2902,24282,6,292031
10770,0.000312,172.31.36.0-255,66,24348,6,292031
10771,0.000319,172.217.194.0-255,5738,30086,6,292031
10772,0.000322,172.31.36.0-255,66,30152,6,292031
10773,0.00033,172.217.194.0-255,6797,36949,6,292031
10774,0.000332,172.31.36.0-255,66,37015,6,292031
10775,0.000366,172.217.194.0-255,7156,44171,6,292031
10776,0.000369,172.31.36.0-255,66,44237,6,292031
10777,0.00039,172.217.194.0-255,8574,52811,6,292031
10778,0.000392,172.31.36.0-255,66,52877,6,292031
10779,0.000413,172.217.194.0-255,1418,54295,6,292031
10780,0.000415,172.31.36.0-255,66,54361,6,292031
10781,0.000434,172.217.194.0-255,1517,55878,6,292031
10782,0.000437,172.31.36.0-255,66,55944,6,292031
10783,0.000441,172.217.194.0-255,2902,58846,6,292031
10784,0.000443,172.31.36.0-255,66,58912,6,292031
10785,0.00045,172.217.194.0-255,5738,64650,6,292031
10786,0.000453,172.31.36.0-255,66,64716,6,292031
10787,0.000494,172.217.194.0-255,6797,71513,6,292031
10788,0.000497,172.31.36.0-255,66,71579,6,292031
10789,0.000533,172.217.194.0-255,5738,77317,6,292031
10790,0.000537,172.31.36.0-255,66,77383,6,292031
10791,0.000542,172.217.194.0-255,2902,80285,6,292031
10792,0.000544,172.31.36.0-255,66,80351,6,292031
10793,0.000561,172.217.194.0-255,4320,84671,6,292031
10794,0.000563,172.31.36.0-255,66,84737,6,292031
10795,0.000579,172.217.194.0-255,1484,86221,6,292031
10796,0.000614,172.31.36.0-255,66,86287,6,292031
10797,0.000621,172.217.194.0-255,5093,91380,6,292031
10798,0.000624,172.31.36.0-255,66,91446,6,292031
10799,0.000643,172.217.194.0-255,1484,92930,6,292031
10800,0.000648,172.217.194.0-255,2902,95832,6,292031
10801,0.00065,172.31.36.0-255,66,95898,6,292031
10802,0.000656,172.217.194.0-255,4320,100218,6,292031
10803,0.000658,172.31.36.0-255,66,100284,6,292031
10804,0.000684,172.217.194.0-255,1484,101768,6,292031
10805,0.000698,172.31.36.0-255,66,101834,6,292031
10806,0.00072,172.217.194.0-255,1484,103318,6,292031
10807,0.00073,172.217.194.0-255,9992,113310,6,292031
10808,0.000733,172.31.36.0-255,66,113376,6,292031
10809,0.000735,172.217.194.0-255,766,114142,6,292031
10810,0.001144,172.217.194.0-255,1484,115626,6,292031
10811,0.00115,172.31.36.0-255,66,115692,6,292031
10812,0.001155,172.217.194.0-255,2902,118594,6,292031
10813,0.001158,172.31.36.0-255,66,118660,6,292031
10814,0.001165,172.217.194.0-255,5738,124398,6,292031
10815,0.001167,172.31.36.0-255,66,124464,6,292031
10816,0.001187,172.217.194.0-255,2902,127366,6,292031
10817,0.001189,172.31.36.0-255,66,127432,6,292031
10818,0.001232,172.217.194.0-255,9992,137424,6,292031
10819,0.001235,172.31.36.0-255,66,137490,6,292031
10820,0.001245,172.217.194.0-255,10692,148182,6,292031
10821,0.001248,172.31.36.0-255,66,148248,6,292031
10822,0.001367,172.217.194.0-255,1484,149732,6,292031
10823,0.001388,172.217.194.0-255,2902,152634,6,292031
10824,0.001392,172.31.36.0-255,66,152700,6,292031
10825,0.001399,172.217.194.0-255,5738,158438,6,292031
10826,0.001401,172.31.36.0-255,66,158504,6,292031
10827,0.001429,172.217.194.0-255,5738,164242,6,292031
10828,0.001432,172.31.36.0-255,66,164308,6,292031
10829,0.001446,172.31.36.0-255,66,164374,6,292031
10830,0.001494,172.217.194.0-255,5020,169394,6,292031
10831,0.001497,172.31.36.0-255,66,169460,6,292031
10832,0.001658,172.217.194.0-255,1484,170944,6,292031
10833,0.001664,172.217.194.0-255,2902,173846,6,292031
10834,0.001667,172.31.36.0-255,66,173912,6,292031
10835,0.001671,172.217.194.0-255,1484,175396,6,292031
10836,0.001689,172.217.194.0-255,4320,179716,6,292031
10837,0.001691,172.31.36.0-255,66,179782,6,292031
10838,0.001696,172.217.194.0-255,2902,182684,6,292031
10839,0.001698,172.31.36.0-255,66,182750,6,292031
10840,0.001723,172.217.194.0-255,9992,192742,6,292031
10841,0.001726,172.31.36.0-255,66,192808,6,292031
10842,0.001735,172.217.194.0-255,8574,201382,6,292031
10843,0.001737,172.31.36.0-255,66,201448,6,292031
10844,0.001771,172.217.194.0-255,2184,203632,6,292031
10845,0.001773,172.31.36.0-255,66,203698,6,292031
10846,0.001847,172.217.194.0-255,1484,205182,6,292031
10847,0.001854,172.217.194.0-255,2902,208084,6,292031
10848,0.001858,172.31.36.0-255,66,208150,6,292031
10849,0.001864,172.217.194.0-255,4320,212470,6,292031
10850,0.001866,172.31.36.0-255,66,212536,6,292031
10851,0.001882,172.217.194.0-255,1484,214020,6,292031
10852,0.001887,172.217.194.0-255,4320,218340,6,292031
10853,0.00189,172.31.36.0-255,66,218406,6,292031
10854,0.001899,172.217.194.0-255,8574,226980,6,292031
10855,0.001902,172.31.36.0-255,66,227046,6,292031
10856,0.001919,172.217.194.0-255,2902,229948,6,292031
10857,0.001921,172.31.36.0-255,66,230014,6,292031
10858,0.001926,172.217.194.0-255,2902,232916,6,292031
10859,0.001928,172.31.36.0-255,66,232982,6,292031
10860,0.001965,172.31.36.0-255,66,233048,6,292031
10861,0.001983,172.31.36.0-255,66,233114,6,292031
10862,0.001991,172.217.194.0-255,7856,240970,6,292031
10863,0.001993,172.31.36.0-255,66,241036,6,292031
10864,0.002044,172.31.36.0-255,66,241102,6,292031
10865,0.002054,172.217.194.0-255,9992,251094,6,292031
10866,0.002056,172.31.36.0-255,66,251160,6,292031
10867,0.002084,172.217.194.0-255,2902,254062,6,292031
10868,0.002087,172.31.36.0-255,66,254128,6,292031
10869,0.002096,172.217.194.0-255,9274,263402,6,292031
10870,0.002099,172.31.36.0-255,66,263468,6,292031
10871,0.002108,172.217.194.0-255,9992,273460,6,292031
10872,0.002111,172.31.36.0-255,66,273526,6,292031
10873,0.002156,172.31.36.0-255,66,273592,6,292031
10874,0.002176,172.217.194.0-255,9992,283584,6,292031
10875,0.002179,172.31.36.0-255,66,283650,6,292031
10876,0.002196,172.217.194.0-255,6438,290088,6,292031
10877,0.002201,172.217.194.0-255,1601,291689,6,292031
10878,0.002252,172.217.194.0-255,105,291794,6,292031
10879,0.0023,172.31.36.0-255,66,291860,6,292031
10880,0.005176,172.31.36.0-255,105,291965,6,292031
10881,0.007731,172.217.194.0-255,66,292031,6,292031
10882,0.0,74.125.200.0-255,145,145,6,203017
10883,2.5e-05,172.31.36.0-255,66,211,6,203017
10884,3.2e-05,74.125.200.0-255,1484,1695,6,203017
10885,3.6e-05,172.31.36.0-255,66,1761,6,203017
10886,4.1e-05,74.125.200.0-255,2902,4663,6,203017
10887,4.4e-05,172.31.36.0-255,66,4729,6,203017
10888,6.8e-05,74.125.200.0-255,4320,9049,6,203017
10889,7.1e-05,172.31.36.0-255,66,9115,6,203017
10890,9e-05,74.125.200.0-255,1484,10599,6,203017
10891,9.2e-05,172.31.36.0-255,66,10665,6,203017
10892,0.000114,74.125.200.0-255,3465,14130,6,203017
10893,0.000117,172.31.36.0-255,66,14196,6,203017
10894,0.000211,74.125.200.0-255,1484,15680,6,203017
10895,0.000215,172.31.36.0-255,66,15746,6,203017
10896,0.00022,74.125.200.0-255,2902,18648,6,203017
10897,0.000222,172.31.36.0-255,66,18714,6,203017
10898,0.000253,74.125.200.0-255,5738,24452,6,203017
10899,0.000256,172.31.36.0-255,66,24518,6,203017
10900,0.000264,74.125.200.0-255,6797,31315,6,203017
10901,0.000266,172.31.36.0-255,66,31381,6,203017
10902,0.000287,74.125.200.0-255,1484,32865,6,203017
10903,0.000289,172.31.36.0-255,66,32931,6,203017
10904,0.000313,74.125.200.0-255,5738,38669,6,203017
10905,0.000316,172.31.36.0-255,66,38735,6,203017
10906,0.000323,74.125.200.0-255,5738,44473,6,203017
10907,0.000325,172.31.36.0-255,66,44539,6,203017
10908,0.00034,74.125.200.0-255,2902,47441,6,203017
10909,0.000342,172.31.36.0-255,66,47507,6,203017
10910,0.000347,74.125.200.0-255,4320,51827,6,203017
10911,0.00035,172.31.36.0-255,66,51893,6,203017
10912,0.000376,74.125.200.0-255,7156,59049,6,203017
10913,0.000379,172.31.36.0-255,66,59115,6,203017
10914,0.000397,74.125.200.0-255,2902,62017,6,203017
10915,0.000399,172.31.36.0-255,66,62083,6,203017
10916,0.000413,74.125.200.0-255,3602,65685,6,203017
10917,0.000415,172.31.36.0-255,66,65751,6,203017
10918,0.000437,74.125.200.0-255,409,66160,6,203017
10919,0.000596,74.125.200.0-255,333,66493,6,203017
10920,0.000941,74.125.200.0-255,1484,67977,6,203017
10921,0.000946,172.31.36.0-255,66,68043,6,203017
10922,0.000952,74.125.200.0-255,2902,70945,6,203017
10923,0.000954,172.31.36.0-255,66,71011,6,203017
10924,0.000957,74.125.200.0-255,1484,72495,6,203017
10925,0.000984,74.125.200.0-255,1484,73979,6,203017
10926,0.000987,172.31.36.0-255,66,74045,6,203017
10927,0.000993,74.125.200.0-255,4320,78365,6,203017
10928,0.000995,172.31.36.0-255,66,78431,6,203017
10929,0.001001,74.125.200.0-255,4320,82751,6,203017
10930,0.001002,172.31.36.0-255,66,82817,6,203017
10931,0.001023,74.125.200.0-255,4320,87137,6,203017
10932,0.001025,172.31.36.0-255,66,87203,6,203017
10933,0.001032,74.125.200.0-255,7156,94359,6,203017
10934,0.001034,172.31.36.0-255,66,94425,6,203017
10935,0.001084,74.125.200.0-255,5738,100163,6,203017
10936,0.001087,172.31.36.0-255,66,100229,6,203017
10937,0.001105,74.125.200.0-255,766,100995,6,203017
10938,0.001168,74.125.200.0-255,1484,102479,6,203017
10939,0.001172,172.31.36.0-255,66,102545,6,203017
10940,0.001192,74.125.200.0-255,2902,105447,6,203017
10941,0.001194,172.31.36.0-255,66,105513,6,203017
10942,0.001211,74.125.200.0-255,5738,111251,6,203017
10943,0.001213,172.31.36.0-255,66,111317,6,203017
10944,0.001217,74.125.200.0-255,2902,114219,6,203017
10945,0.00122,172.31.36.0-255,66,114285,6,203017
10946,0.001237,74.125.200.0-255,2902,117187,6,203017
10947,0.001241,172.31.36.0-255,66,117253,6,203017
10948,0.00127,74.125.200.0-255,7156,124409,6,203017
10949,0.001274,172.31.36.0-255,66,124475,6,203017
10950,0.001283,74.125.200.0-255,10692,135167,6,203017
10951,0.001285,172.31.36.0-255,66,135233,6,203017
10952,0.002162,74.125.200.0-255,1484,136717,6,203017
10953,0.002176,74.125.200.0-255,2902,139619,6,203017
10954,0.002184,172.31.36.0-255,66,139685,6,203017
10955,0.002189,74.125.200.0-255,1484,141169,6,203017
10956,0.002195,74.125.200.0-255,2902,144071,6,203017
10957,0.002197,172.31.36.0-255,66,144137,6,203017
10958,0.002232,74.125.200.0-255,5738,149875,6,203017
10959,0.002235,172.31.36.0-255,66,149941,6,203017
10960,0.002254,74.125.200.0-255,1484,151425,6,203017
10961,0.002258,74.125.200.0-255,1484,152909,6,203017
10962,0.00226,172.31.36.0-255,66,152975,6,203017
10963,0.00228,74.125.200.0-255,1484,154459,6,203017
10964,0.002283,74.125.200.0-255,1484,155943,6,203017
10965,0.002285,172.31.36.0-255,66,156009,6,203017
10966,0.002291,74.125.200.0-255,2902,158911,6,203017
10967,0.002292,172.31.36.0-255,66,158977,6,203017
10968,0.002319,74.125.200.0-255,5738,164715,6,203017
10969,0.002322,172.31.36.0-255,66,164781,6,203017
10970,0.002325,74.125.200.0-255,1484,166265,6,203017
10971,0.002374,74.125.200.0-255,2902,169167,6,203017
10972,0.002378,172.31.36.0-255,66,169233,6,203017
10973,0.002381,74.125.200.0-255,766,169999,6,203017
10974,0.002472,74.125.200.0-255,1484,171483,6,203017
10975,0.002476,172.31.36.0-255,66,171549,6,203017
10976,0.002482,74.125.200.0-255,2902,174451,6,203017
10977,0.002484,172.31.36.0-255,66,174517,6,203017
10978,0.002514,74.125.200.0-255,5738,180255,6,203017
10979,0.002516,172.31.36.0-255,66,180321,6,203017
10980,0.00255,172.31.36.0-255,66,180387,6,203017
10981,0.002589,74.125.200.0-255,8574,188961,6,203017
10982,0.002592,172.31.36.0-255,66,189027,6,203017
10983,0.00261,74.125.200.0-255,2184,191211,6,203017
10984,0.002612,172.31.36.0-255,66,191277,6,203017
10985,0.005148,74.125.200.0-255,2902,194179,6,203017
10986,0.005155,172.31.36.0-255,66,194245,6,203017
10987,0.00517,74.125.200.0-255,2902,197147,6,203017
10988,0.005173,172.31.36.0-255,66,197213,6,203017
10989,0.007978,74.125.200.0-255,5738,202951,6,203017
10990,0.007992,172.31.36.0-255,66,203017,6,203017
10991,0.0,74.125.24.0-255,152,152,6,282686
10992,2.4e-05,172.31.36.0-255,66,218,6,282686
10993,3.1e-05,74.125.24.0-255,1484,1702,6,282686
10994,3.6e-05,172.31.36.0-255,66,1768,6,282686
10995,4.1e-05,74.125.24.0-255,2902,4670,6,282686
10996,4.4e-05,172.31.36.0-255,66,4736,6,282686
10997,5.2e-05,74.125.24.0-255,7156,11892,6,282686
10998,5.4e-05,172.31.36.0-255,66,11958,6,282686
10999,5.8e-05,74.125.24.0-255,2066,14024,6,282686
11000,6e-05,172.31.36.0-255,66,14090,6,282686
11001,0.000111,74.125.24.0-255,1484,15574,6,282686
11002,0.000115,172.31.36.0-255,66,15640,6,282686
11003,0.00012,74.125.24.0-255,2902,18542,6,282686
11004,0.000123,172.31.36.0-255,66,18608,6,282686
11005,0.000129,74.125.24.0-255,4320,22928,6,282686
11006,0.000131,172.31.36.0-255,66,22994,6,282686
11007,0.000145,74.125.24.0-255,1484,24478,6,282686
11008,0.000148,172.31.36.0-255,66,24544,6,282686
11009,0.00016,74.125.24.0-255,1484,26028,6,282686
11010,0.000162,172.31.36.0-255,66,26094,6,282686
11011,0.000179,74.125.24.0-255,5379,31473,6,282686
11012,0.000181,172.31.36.0-255,66,31539,6,282686
11013,0.000225,74.125.24.0-255,1484,33023,6,282686
11014,0.000227,172.31.36.0-255,66,33089,6,282686
11015,0.000274,74.125.24.0-255,2902,35991,6,282686
11016,0.000278,172.31.36.0-255,66,36057,6,282686
11017,0.000284,74.125.24.0-255,5738,41795,6,282686
11018,0.000286,172.31.36.0-255,66,41861,6,282686
11019,0.000293,74.125.24.0-255,6797,48658,6,282686
11020,0.000296,172.31.36.0-255,66,48724,6,282686
11021,0.00031,172.31.36.0-255,66,48790,6,282686
11022,0.000314,74.125.24.0-255,2543,51333,6,282686
11023,0.000518,172.31.36.0-255,66,51399,6,282686
11024,0.000611,74.125.24.0-255,647,52046,6,282686
11025,0.000981,74.125.24.0-255,1484,53530,6,282686
11026,0.000988,74.125.24.0-255,2902,56432,6,282686
11027,0.000994,74.125.24.0-255,4320,60752,6,282686
11028,0.001015,74.125.24.0-255,5738,66490,6,282686
11029,0.001018,74.125.24.0-255,1484,67974,6,282686
11030,0.00103,172.31.36.0-255,66,68040,6,282686
11031,0.001057,74.125.24.0-255,9992,78032,6,282686
11032,0.001065,74.125.24.0-255,7856,85888,6,282686
11033,0.001089,172.31.36.0-255,66,85954,6,282686
11034,0.001141,74.125.24.0-255,1484,87438,6,282686
11035,0.001146,74.125.24.0-255,1484,88922,6,282686
11036,0.00115,172.31.36.0-255,66,88988,6,282686
11037,0.001174,74.125.24.0-255,1484,90472,6,282686
11038,0.001182,74.125.24.0-255,5738,96210,6,282686
11039,0.001188,74.125.24.0-255,4320,100530,6,282686
11040,0.001207,74.125.24.0-255,8574,109104,6,282686
11041,0.00121,74.125.24.0-255,1484,110588,6,282686
11042,0.001216,172.31.36.0-255,66,110654,6,282686
11043,0.00124,74.125.24.0-255,9274,119928,6,282686
11044,0.00126,172.31.36.0-255,66,119994,6,282686
11045,0.001362,74.125.24.0-255,1484,121478,6,282686
11046,0.001365,74.125.24.0-255,1484,122962,6,282686
11047,0.001381,172.31.36.0-255,66,123028,6,282686
11048,0.001385,74.125.24.0-255,1484,124512,6,282686
11049,0.00139,74.125.24.0-255,5738,130250,6,282686
11050,0.001396,172.31.36.0-255,66,130316,6,282686
11051,0.001414,74.125.24.0-255,8574,138890,6,282686
11052,0.001432,172.31.36.0-255,66,138956,6,282686
11053,0.001451,74.125.24.0-255,2902,141858,6,282686
11054,0.00148,172.31.36.0-255,66,141924,6,282686
11055,0.001503,74.125.24.0-255,5738,147662,6,282686
11056,0.00151,172.31.36.0-255,66,147728,6,282686
11057,0.001542,74.125.24.0-255,9992,157720,6,282686
11058,0.001561,172.31.36.0-255,66,157786,6,282686
11059,0.001568,74.125.24.0-255,1484,159270,6,282686
11060,0.00157,74.125.24.0-255,766,160036,6,282686
11061,0.001591,172.31.36.0-255,66,160102,6,282686
11062,0.001599,74.125.24.0-255,1484,161586,6,282686
11063,0.001621,74.125.24.0-255,2902,164488,6,282686
11064,0.001627,74.125.24.0-255,5738,170226,6,282686
11065,0.00165,74.125.24.0-255,4320,174546,6,282686
11066,0.001654,172.31.36.0-255,66,174612,6,282686
11067,0.001659,172.31.36.0-255,66,174678,6,282686
11068,0.001689,74.125.24.0-255,8574,183252,6,282686
11069,0.001698,74.125.24.0-255,9992,193244,6,282686
11070,0.001703,172.31.36.0-255,66,193310,6,282686
11071,0.001711,74.125.24.0-255,1484,194794,6,282686
11072,0.001728,74.125.24.0-255,7156,201950,6,282686
11073,0.00174,74.125.24.0-255,2184,204134,6,282686
11074,0.001776,74.125.24.0-255,4320,208454,6,282686
11075,0.001785,172.31.36.0-255,66,208520,6,282686
11076,0.001802,74.125.24.0-255,7156,215676,6,282686
11077,0.001819,74.125.24.0-255,9992,225668,6,282686
11078,0.001825,172.31.36.0-255,66,225734,6,282686
11079,0.001872,172.31.36.0-255,66,225800,6,282686
11080,0.001917,172.31.36.0-255,66,225866,6,282686
11081,0.001959,74.125.24.0-255,1484,227350,6,282686
11082,0.00198,74.125.24.0-255,2902,230252,6,282686
11083,0.001984,74.125.24.0-255,2902,233154,6,282686
11084,0.001994,172.31.36.0-255,66,233220,6,282686
11085,0.002004,74.125.24.0-255,2902,236122,6,282686
11086,0.002006,74.125.24.0-255,1484,237606,6,282686
11087,0.002011,172.31.36.0-255,66,237672,6,282686
11088,0.002023,74.125.24.0-255,7156,244828,6,282686
11089,0.00204,74.125.24.0-255,4320,249148,6,282686
11090,0.002048,74.125.24.0-255,8574,257722,6,282686
11091,0.002056,172.31.36.0-255,66,257788,6,282686
11092,0.002065,74.125.24.0-255,2184,259972,6,282686
11093,0.00207,172.31.36.0-255,66,260038,6,282686
11094,0.002092,74.125.24.0-255,2902,262940,6,282686
11095,0.002098,74.125.24.0-255,5738,268678,6,282686
11096,0.002113,74.125.24.0-255,1484,270162,6,282686
11097,0.002116,172.31.36.0-255,66,270228,6,282686
11098,0.002129,74.125.24.0-255,4320,274548,6,282686
11099,0.00215,74.125.24.0-255,1484,276032,6,282686
11100,0.002183,172.31.36.0-255,66,276098,6,282686
11101,0.002186,74.125.24.0-255,766,276864,6,282686
11102,0.002201,172.31.36.0-255,66,276930,6,282686
11103,0.002223,74.125.24.0-255,5348,282278,6,282686
11104,0.002233,172.31.36.0-255,66,282344,6,282686
11105,0.002246,74.125.24.0-255,105,282449,6,282686
11106,0.004384,172.31.36.0-255,66,282515,6,282686
11107,0.00442,172.31.36.0-255,105,282620,6,282686
11108,0.00676,74.125.24.0-255,66,282686,6,282686
11109,0.0,172.31.36.0-255,105,105,6,459
11110,0.000219,172.31.36.0-255,90,195,6,459
11111,0.000227,172.31.36.0-255,66,261,6,459
11112,0.002509,74.125.24.0-255,66,327,6,459
11113,0.002523,74.125.24.0-255,66,393,6,459
11114,0.002536,172.31.36.0-255,66,459,6,459
11115,0.0,74.125.24.0-255,153,153,6,153973
11116,3.8e-05,172.31.36.0-255,66,219,6,153973
11117,4.6e-05,74.125.24.0-255,1484,1703,6,153973
11118,5.2e-05,172.31.36.0-255,66,1769,6,153973
11119,6.5e-05,74.125.24.0-255,2902,4671,6,153973
11120,6.8e-05,172.31.36.0-255,66,4737,6,153973
11121,7.5e-05,74.125.24.0-255,7156,11893,6,153973
11122,7.8e-05,172.31.36.0-255,66,11959,6,153973
11123,8.2e-05,74.125.24.0-255,2036,13995,6,153973
11124,8.5e-05,172.31.36.0-255,66,14061,6,153973
11125,0.000229,74.125.24.0-255,1484,15545,6,153973
11126,0.000234,172.31.36.0-255,66,15611,6,153973
11127,0.00024,74.125.24.0-255,2902,18513,6,153973
11128,0.000243,172.31.36.0-255,66,18579,6,153973
11129,0.000279,74.125.24.0-255,5738,24317,6,153973
11130,0.000282,172.31.36.0-255,66,24383,6,153973
11131,0.000287,74.125.24.0-255,4320,28703,6,153973
11132,0.00029,172.31.36.0-255,66,28769,6,153973
11133,0.000321,74.125.24.0-255,2543,31312,6,153973
11134,0.000327,172.31.36.0-255,66,31378,6,153973
11135,0.000373,74.125.24.0-255,1484,32862,6,153973
11136,0.000377,172.31.36.0-255,66,32928,6,153973
11137,0.000382,74.125.24.0-255,2902,35830,6,153973
11138,0.000385,172.31.36.0-255,66,35896,6,153973
11139,0.000408,74.125.24.0-255,5738,41634,6,153973
11140,0.000412,172.31.36.0-255,66,41700,6,153973
11141,0.00042,74.125.24.0-255,6797,48497,6,153973
11142,0.000423,172.31.36.0-255,66,48563,6,153973
11143,0.000628,74.125.24.0-255,1484,50047,6,153973
11144,0.000632,172.31.36.0-255,66,50113,6,153973
11145,0.000638,74.125.24.0-255,2902,53015,6,153973
11146,0.00064,172.31.36.0-255,66,53081,6,153973
11147,0.000645,74.125.24.0-255,2902,55983,6,153973
11148,0.000657,172.31.36.0-255,66,56049,6,153973
11149,0.00068,74.125.24.0-255,2902,58951,6,153973
11150,0.000688,74.125.24.0-255,6797,65748,6,153973
11151,0.000695,172.31.36.0-255,66,65814,6,153973
11152,0.000709,74.125.24.0-255,647,66461,6,153973
11153,0.000734,74.125.24.0-255,1484,67945,6,153973
11154,0.000737,172.31.36.0-255,66,68011,6,153973
11155,0.000748,74.125.24.0-255,1484,69495,6,153973
11156,0.000769,74.125.24.0-255,2902,72397,6,153973
11157,0.000774,172.31.36.0-255,66,72463,6,153973
11158,0.000776,74.125.24.0-255,7156,79619,6,153973
11159,0.00079,172.31.36.0-255,66,79685,6,153973
11160,0.000805,74.125.24.0-255,2902,82587,6,153973
11161,0.000815,74.125.24.0-255,2543,85130,6,153973
11162,0.000815,172.31.36.0-255,66,85196,6,153973
11163,0.00082,172.31.36.0-255,66,85262,6,153973
11164,0.00083,74.125.24.0-255,1125,86387,6,153973
11165,0.000833,172.31.36.0-255,66,86453,6,153973
11166,0.001603,74.125.24.0-255,1484,87937,6,153973
11167,0.001614,74.125.24.0-255,2902,90839,6,153973
11168,0.001619,172.31.36.0-255,66,90905,6,153973
11169,0.001626,74.125.24.0-255,5738,96643,6,153973
11170,0.001686,74.125.24.0-255,2902,99545,6,153973
11171,0.001716,74.125.24.0-255,9274,108819,6,153973
11172,0.001721,172.31.36.0-255,66,108885,6,153973
11173,0.001728,172.31.36.0-255,66,108951,6,153973
11174,0.001862,74.125.24.0-255,1484,110435,6,153973
11175,0.001868,74.125.24.0-255,1484,111919,6,153973
11176,0.001876,172.31.36.0-255,66,111985,6,153973
11177,0.001884,74.125.24.0-255,1484,113469,6,153973
11178,0.001886,74.125.24.0-255,1484,114953,6,153973
11179,0.001891,172.31.36.0-255,66,115019,6,153973
11180,0.001921,74.125.24.0-255,4320,119339,6,153973
11181,0.001928,74.125.24.0-255,5738,125077,6,153973
11182,0.001936,172.31.36.0-255,66,125143,6,153973
11183,0.001964,74.125.24.0-255,5020,130163,6,153973
11184,0.002026,172.31.36.0-255,66,130229,6,153973
11185,0.002082,74.125.24.0-255,1484,131713,6,153973
11186,0.002086,74.125.24.0-255,1484,133197,6,153973
11187,0.002093,172.31.36.0-255,66,133263,6,153973
11188,0.002112,74.125.24.0-255,1484,134747,6,153973
11189,0.002115,74.125.24.0-255,1484,136231,6,153973
11190,0.002126,172.31.36.0-255,66,136297,6,153973
11191,0.00416,74.125.24.0-255,2902,139199,6,153973
11192,0.004165,172.31.36.0-255,66,139265,6,153973
11193,0.004196,74.125.24.0-255,2902,142167,6,153973
11194,0.004217,172.31.36.0-255,66,142233,6,153973
11195,0.006255,74.125.24.0-255,2902,145135,6,153973
11196,0.006259,172.31.36.0-255,66,145201,6,153973
11197,0.0063,74.125.24.0-255,2902,148103,6,153973
11198,0.006315,172.31.36.0-255,66,148169,6,153973
11199,0.008364,74.125.24.0-255,5738,153907,6,153973
11200,0.008406,172.31.36.0-255,66,153973,6,153973
11201,0.0,172.217.194.0-255,153,153,6,170221
11202,3.5e-05,172.31.36.0-255,66,219,6,170221
11203,4.2e-05,172.217.194.0-255,1484,1703,6,170221
11204,4.6e-05,172.31.36.0-255,66,1769,6,170221
11205,5.2e-05,172.217.194.0-255,2902,4671,6,170221
11206,6.2e-05,172.31.36.0-255,66,4737,6,170221
11207,7e-05,172.217.194.0-255,7156,11893,6,170221
11208,7.3e-05,172.31.36.0-255,66,11959,6,170221
11209,0.000125,172.217.194.0-255,2040,13999,6,170221
11210,0.000128,172.31.36.0-255,66,14065,6,170221
11211,0.000168,172.217.194.0-255,2902,16967,6,170221
11212,0.000172,172.31.36.0-255,66,17033,6,170221
11213,0.000193,172.217.194.0-255,7156,24189,6,170221
11214,0.000197,172.31.36.0-255,66,24255,6,170221
11215,0.000252,172.217.194.0-255,6797,31052,6,170221
11216,0.000257,172.31.36.0-255,66,31118,6,170221
11217,0.000329,172.217.194.0-255,4320,35438,6,170221
11218,0.000333,172.31.36.0-255,66,35504,6,170221
11219,0.000358,172.217.194.0-255,2902,38406,6,170221
11220,0.000362,172.31.36.0-255,66,38472,6,170221
11221,0.000399,172.217.194.0-255,4320,42792,6,170221
11222,0.000403,172.31.36.0-255,66,42858,6,170221
11223,0.000426,172.217.194.0-255,2902,45760,6,170221
11224,0.000429,172.31.36.0-255,66,45826,6,170221
11225,0.000483,172.217.194.0-255,2902,48728,6,170221
11226,0.000487,172.31.36.0-255,66,48794,6,170221
11227,0.000521,172.31.36.0-255,66,48860,6,170221
11228,0.000661,172.217.194.0-255,2818,51678,6,170221
11229,0.000665,172.31.36.0-255,66,51744,6,170221
11230,0.000669,172.217.194.0-255,434,52178,6,170221
11231,0.000671,172.31.36.0-255,66,52244,6,170221
11232,0.000873,172.217.194.0-255,1484,53728,6,170221
11233,0.000884,172.217.194.0-255,2902,56630,6,170221
11234,0.000888,172.31.36.0-255,66,56696,6,170221
11235,0.000892,172.217.194.0-255,1484,58180,6,170221
11236,0.000921,172.217.194.0-255,4320,62500,6,170221
11237,0.000924,172.31.36.0-255,66,62566,6,170221
11238,0.000976,172.217.194.0-255,9992,72558,6,170221
11239,0.000981,172.31.36.0-255,66,72624,6,170221
11240,0.001009,172.217.194.0-255,2902,75526,6,170221
11241,0.001013,172.31.36.0-255,66,75592,6,170221
11242,0.001108,172.217.194.0-255,9992,85584,6,170221
11243,0.001114,172.31.36.0-255,66,85650,6,170221
11244,0.0012,172.217.194.0-255,766,86416,6,170221
11245,0.001312,172.217.194.0-255,1484,87900,6,170221
11246,0.001318,172.31.36.0-255,66,87966,6,170221
11247,0.001325,172.217.194.0-255,2902,90868,6,170221
11248,0.001327,172.31.36.0-255,66,90934,6,170221
11249,0.001365,172.217.194.0-255,5738,96672,6,170221
11250,0.001369,172.31.36.0-255,66,96738,6,170221
11251,0.001408,172.217.194.0-255,8574,105312,6,170221
11252,0.001412,172.31.36.0-255,66,105378,6,170221
11253,0.001438,172.217.194.0-255,1484,106862,6,170221
11254,0.001519,172.31.36.0-255,66,106928,6,170221
11255,0.001669,172.217.194.0-255,5738,112666,6,170221
11256,0.001676,172.31.36.0-255,66,112732,6,170221
11257,0.001766,172.217.194.0-255,7156,119888,6,170221
11258,0.00177,172.31.36.0-255,66,119954,6,170221
11259,0.001816,172.31.36.0-255,66,120020,6,170221
11260,0.001949,172.217.194.0-255,8574,128594,6,170221
11261,0.001955,172.31.36.0-255,66,128660,6,170221
11262,0.002018,172.31.36.0-255,66,128726,6,170221
11263,0.002375,172.217.194.0-255,5738,134464,6,170221
11264,0.00238,172.31.36.0-255,66,134530,6,170221
11265,0.002436,172.31.36.0-255,66,134596,6,170221
11266,0.002662,172.31.36.0-255,101,134697,6,170221
11267,0.002735,172.217.194.0-255,8574,143271,6,170221
11268,0.002739,172.31.36.0-255,66,143337,6,170221
11269,0.002828,172.217.194.0-255,9274,152611,6,170221
11270,0.002832,172.31.36.0-255,66,152677,6,170221
11271,0.002837,172.31.36.0-255,66,152743,6,170221
11272,0.004869,172.217.194.0-255,66,152809,6,170221
11273,0.005071,172.217.194.0-255,5738,158547,6,170221
11274,0.005075,172.31.36.0-255,66,158613,6,170221
11275,0.007315,172.217.194.0-255,5738,164351,6,170221
11276,0.007322,172.31.36.0-255,66,164417,6,170221
11277,0.00987,172.217.194.0-255,5738,170155,6,170221
11278,0.00993,172.31.36.0-255,66,170221,6,170221
11279,0.0,74.125.200.0-255,302,302,6,301546
11280,1.6e-05,172.31.36.0-255,66,368,6,301546
11281,2.3e-05,74.125.200.0-255,1484,1852,6,301546
11282,2.7e-05,172.31.36.0-255,66,1918,6,301546
11283,3.3e-05,74.125.200.0-255,4320,6238,6,301546
11284,3.6e-05,172.31.36.0-255,66,6304,6,301546
11285,4e-05,74.125.200.0-255,1484,7788,6,301546
11286,4.2e-05,172.31.36.0-255,66,7854,6,301546
11287,7.7e-05,74.125.200.0-255,6113,13967,6,301546
11288,8e-05,172.31.36.0-255,66,14033,6,301546
11289,0.000234,74.125.200.0-255,1484,15517,6,301546
11290,0.000239,172.31.36.0-255,66,15583,6,301546
11291,0.000245,74.125.200.0-255,2902,18485,6,301546
11292,0.000248,172.31.36.0-255,66,18551,6,301546
11293,0.000284,74.125.200.0-255,5738,24289,6,301546
11294,0.000287,172.31.36.0-255,66,24355,6,301546
11295,0.000314,74.125.200.0-255,6797,31152,6,301546
11296,0.000317,172.31.36.0-255,66,31218,6,301546
11297,0.000331,74.125.200.0-255,4320,35538,6,301546
11298,0.000333,172.31.36.0-255,66,35604,6,301546
11299,0.000357,74.125.200.0-255,2902,38506,6,301546
11300,0.00036,172.31.36.0-255,66,38572,6,301546
11301,0.000363,74.125.200.0-255,1484,40056,6,301546
11302,0.000364,172.31.36.0-255,66,40122,6,301546
11303,0.00037,74.125.200.0-255,2902,43024,6,301546
11304,0.000372,172.31.36.0-255,66,43090,6,301546
11305,0.000396,74.125.200.0-255,5379,48469,6,301546
11306,0.000399,172.31.36.0-255,66,48535,6,301546
11307,0.000602,74.125.200.0-255,1484,50019,6,301546
11308,0.000607,172.31.36.0-255,66,50085,6,301546
11309,0.000611,74.125.200.0-255,1484,51569,6,301546
11310,0.000613,172.31.36.0-255,66,51635,6,301546
11311,0.000627,74.125.200.0-255,1484,53119,6,301546
11312,0.000635,74.125.200.0-255,5738,58857,6,301546
11313,0.000637,172.31.36.0-255,66,58923,6,301546
11314,0.000642,74.125.200.0-255,2902,61825,6,301546
11315,0.000645,172.31.36.0-255,66,61891,6,301546
11316,0.000672,74.125.200.0-255,3961,65852,6,301546
11317,0.000676,172.31.36.0-255,66,65918,6,301546
11318,0.000678,74.125.200.0-255,363,66281,6,301546
11319,0.000719,74.125.200.0-255,381,66662,6,301546
11320,0.000811,74.125.200.0-255,1484,68146,6,301546
11321,0.000817,172.31.36.0-255,66,68212,6,301546
11322,0.000822,74.125.200.0-255,2902,71114,6,301546
11323,0.000824,172.31.36.0-255,66,71180,6,301546
11324,0.000855,74.125.200.0-255,5738,76918,6,301546
11325,0.000858,172.31.36.0-255,66,76984,6,301546
11326,0.000862,74.125.200.0-255,2902,79886,6,301546
11327,0.000864,172.31.36.0-255,66,79952,6,301546
11328,0.000878,74.125.200.0-255,1484,81436,6,301546
11329,0.000906,74.125.200.0-255,9633,91069,6,301546
11330,0.000909,172.31.36.0-255,66,91135,6,301546
11331,0.000918,74.125.200.0-255,9633,100768,6,301546
11332,0.000921,172.31.36.0-255,66,100834,6,301546
11333,0.001102,74.125.200.0-255,1484,102318,6,301546
11334,0.001119,74.125.200.0-255,2902,105220,6,301546
11335,0.001122,172.31.36.0-255,66,105286,6,301546
11336,0.001136,74.125.200.0-255,1484,106770,6,301546
11337,0.001152,74.125.200.0-255,4320,111090,6,301546
11338,0.001156,74.125.200.0-255,4320,115410,6,301546
11339,0.00116,172.31.36.0-255,66,115476,6,301546
11340,0.001163,172.31.36.0-255,66,115542,6,301546
11341,0.001176,74.125.200.0-255,5738,121280,6,301546
11342,0.001178,172.31.36.0-255,66,121346,6,301546
11343,0.001203,74.125.200.0-255,5738,127084,6,301546
11344,0.001206,172.31.36.0-255,66,127150,6,301546
11345,0.001228,74.125.200.0-255,5738,132888,6,301546
11346,0.001231,172.31.36.0-255,66,132954,6,301546
11347,0.00125,74.125.200.0-255,2184,135138,6,301546
11348,0.001253,172.31.36.0-255,66,135204,6,301546
11349,0.001388,74.125.200.0-255,1484,136688,6,301546
11350,0.001403,74.125.200.0-255,2902,139590,6,301546
11351,0.001406,172.31.36.0-255,66,139656,6,301546
11352,0.001409,74.125.200.0-255,1484,141140,6,301546
11353,0.001427,74.125.200.0-255,4320,145460,6,301546
11354,0.00143,172.31.36.0-255,66,145526,6,301546
11355,0.001454,74.125.200.0-255,8574,154100,6,301546
11356,0.001457,172.31.36.0-255,66,154166,6,301546
11357,0.001481,74.125.200.0-255,4320,158486,6,301546
11358,0.001486,74.125.200.0-255,4320,162806,6,301546
11359,0.00149,172.31.36.0-255,66,162872,6,301546
11360,0.001493,172.31.36.0-255,66,162938,6,301546
11361,0.001508,74.125.200.0-255,1484,164422,6,301546
11362,0.001524,74.125.200.0-255,5020,169442,6,301546
11363,0.001527,172.31.36.0-255,66,169508,6,301546
11364,0.001736,74.125.200.0-255,1484,170992,6,301546
11365,0.00174,74.125.200.0-255,2902,173894,6,301546
11366,0.001745,172.31.36.0-255,66,173960,6,301546
11367,0.001758,74.125.200.0-255,5738,179698,6,301546
11368,0.00176,172.31.36.0-255,66,179764,6,301546
11369,0.001765,74.125.200.0-255,2902,182666,6,301546
11370,0.001767,172.31.36.0-255,66,182732,6,301546
11371,0.00179,74.125.200.0-255,5738,188470,6,301546
11372,0.001793,172.31.36.0-255,66,188536,6,301546
11373,0.001815,74.125.200.0-255,4320,192856,6,301546
11374,0.001817,172.31.36.0-255,66,192922,6,301546
11375,0.001823,74.125.200.0-255,5738,198660,6,301546
11376,0.001825,172.31.36.0-255,66,198726,6,301546
11377,0.001846,74.125.200.0-255,5020,203746,6,301546
11378,0.001848,172.31.36.0-255,66,203812,6,301546
11379,0.001901,74.125.200.0-255,1484,205296,6,301546
11380,0.001905,74.125.200.0-255,2902,208198,6,301546
11381,0.001909,172.31.36.0-255,66,208264,6,301546
11382,0.001921,74.125.200.0-255,5738,214002,6,301546
11383,0.001924,172.31.36.0-255,66,214068,6,301546
11384,0.001955,74.125.200.0-255,7156,221224,6,301546
11385,0.001958,172.31.36.0-255,66,221290,6,301546
11386,0.002004,172.31.36.0-255,66,221356,6,301546
11387,0.002017,74.125.200.0-255,5738,227094,6,301546
11388,0.002031,172.31.36.0-255,66,227160,6,301546
11389,0.002051,74.125.200.0-255,9274,236434,6,301546
11390,0.002063,74.125.200.0-255,5738,242172,6,301546
11391,0.002085,74.125.200.0-255,4320,246492,6,301546
11392,0.002091,172.31.36.0-255,66,246558,6,301546
11393,0.002105,74.125.200.0-255,10692,257250,6,301546
11394,0.002108,74.125.200.0-255,1484,258734,6,301546
11395,0.002112,172.31.36.0-255,66,258800,6,301546
11396,0.002151,74.125.200.0-255,5738,264538,6,301546
11397,0.002155,172.31.36.0-255,66,264604,6,301546
11398,0.002188,74.125.200.0-255,4320,268924,6,301546
11399,0.002194,172.31.36.0-255,66,268990,6,301546
11400,0.002238,74.125.200.0-255,7856,276846,6,301546
11401,0.002242,74.125.200.0-255,1484,278330,6,301546
11402,0.002246,74.125.200.0-255,2902,281232,6,301546
11403,0.002251,74.125.200.0-255,4320,285552,6,301546
11404,0.002265,74.125.200.0-255,1484,287036,6,301546
11405,0.002299,74.125.200.0-255,5738,292774,6,301546
11406,0.002313,74.125.200.0-255,2902,295676,6,301546
11407,0.005542,172.31.36.0-255,66,295742,6,301546
11408,0.007854,74.125.200.0-255,5738,301480,6,301546
11409,0.007861,172.31.36.0-255,66,301546,6,301546
11410,0.0,74.125.24.0-255,153,153,6,270064
11411,2.4e-05,172.31.36.0-255,66,219,6,270064
11412,3.2e-05,74.125.24.0-255,1484,1703,6,270064
11413,3.7e-05,172.31.36.0-255,66,1769,6,270064
11414,4.3e-05,74.125.24.0-255,2902,4671,6,270064
11415,5.4e-05,172.31.36.0-255,66,4737,6,270064
11416,5.9e-05,74.125.24.0-255,2902,7639,6,270064
11417,6.2e-05,172.31.36.0-255,66,7705,6,270064
11418,7.1e-05,74.125.24.0-255,7652,15357,6,270064
11419,7.5e-05,172.31.36.0-255,66,15423,6,270064
11420,8.4e-05,74.125.24.0-255,8574,23997,6,270064
11421,8.7e-05,172.31.36.0-255,66,24063,6,270064
11422,0.000119,74.125.24.0-255,6797,30860,6,270064
11423,0.000122,172.31.36.0-255,66,30926,6,270064
11424,0.00017,74.125.24.0-255,1484,32410,6,270064
11425,0.000172,172.31.36.0-255,66,32476,6,270064
11426,0.000178,74.125.24.0-255,2902,35378,6,270064
11427,0.00018,172.31.36.0-255,66,35444,6,270064
11428,0.000202,74.125.24.0-255,5738,41182,6,270064
11429,0.000209,172.31.36.0-255,66,41248,6,270064
11430,0.000213,74.125.24.0-255,2902,44150,6,270064
11431,0.000216,172.31.36.0-255,66,44216,6,270064
11432,0.000253,74.125.24.0-255,5379,49595,6,270064
11433,0.000256,172.31.36.0-255,66,49661,6,270064
11434,0.000264,74.125.24.0-255,8574,58235,6,270064
11435,0.000267,172.31.36.0-255,66,58301,6,270064
11436,0.000298,74.125.24.0-255,6797,65098,6,270064
11437,0.000301,172.31.36.0-255,66,65164,6,270064
11438,0.00059,74.125.24.0-255,358,65522,6,270064
11439,0.000596,172.31.36.0-255,66,65588,6,270064
11440,0.00062,74.125.24.0-255,1484,67072,6,270064
11441,0.000624,172.31.36.0-255,66,67138,6,270064
11442,0.000634,74.125.24.0-255,4320,71458,6,270064
11443,0.00064,172.31.36.0-255,66,71524,6,270064
11444,0.000646,74.125.24.0-255,2902,74426,6,270064
11445,0.000649,172.31.36.0-255,66,74492,6,270064
11446,0.000672,74.125.24.0-255,2902,77394,6,270064
11447,0.000675,172.31.36.0-255,66,77460,6,270064
11448,0.000708,74.125.24.0-255,5418,82878,6,270064
11449,0.000711,172.31.36.0-255,66,82944,6,270064
11450,0.000767,74.125.24.0-255,1484,84428,6,270064
11451,0.000774,74.125.24.0-255,2902,87330,6,270064
11452,0.000777,172.31.36.0-255,66,87396,6,270064
11453,0.000782,74.125.24.0-255,2902,90298,6,270064
11454,0.000784,172.31.36.0-255,66,90364,6,270064
11455,0.000816,74.125.24.0-255,2902,93266,6,270064
11456,0.000819,172.31.36.0-255,66,93332,6,270064
11457,0.000825,74.125.24.0-255,4320,97652,6,270064
11458,0.000827,172.31.36.0-255,66,97718,6,270064
11459,0.000842,74.125.24.0-255,9992,107710,6,270064
11460,0.000845,172.31.36.0-255,66,107776,6,270064
11461,0.000872,74.125.24.0-255,1484,109260,6,270064
11462,0.000882,74.125.24.0-255,7856,117116,6,270064
11463,0.000885,172.31.36.0-255,66,117182,6,270064
11464,0.00091,74.125.24.0-255,8574,125756,6,270064
11465,0.000913,172.31.36.0-255,66,125822,6,270064
11466,0.000953,172.31.36.0-255,66,125888,6,270064
11467,0.000959,74.125.24.0-255,4320,130208,6,270064
11468,0.000961,172.31.36.0-255,66,130274,6,270064
11469,0.000992,74.125.24.0-255,7565,137839,6,270064
11470,0.000995,172.31.36.0-255,66,137905,6,270064
11471,0.001466,74.125.24.0-255,1484,139389,6,270064
11472,0.001473,74.125.24.0-255,2902,142291,6,270064
11473,0.001476,172.31.36.0-255,66,142357,6,270064
11474,0.001481,74.125.24.0-255,2902,145259,6,270064
11475,0.001483,172.31.36.0-255,66,145325,6,270064
11476,0.001528,74.125.24.0-255,2902,148227,6,270064
11477,0.001532,172.31.36.0-255,66,148293,6,270064
11478,0.001552,74.125.24.0-255,6797,155090,6,270064
11479,0.001555,172.31.36.0-255,66,155156,6,270064
11480,0.001637,74.125.24.0-255,1484,156640,6,270064
11481,0.001643,74.125.24.0-255,2902,159542,6,270064
11482,0.001646,172.31.36.0-255,66,159608,6,270064
11483,0.00165,74.125.24.0-255,1484,161092,6,270064
11484,0.001674,74.125.24.0-255,4320,165412,6,270064
11485,0.001677,172.31.36.0-255,66,165478,6,270064
11486,0.001681,74.125.24.0-255,2902,168380,6,270064
11487,0.001683,172.31.36.0-255,66,168446,6,270064
11488,0.001721,74.125.24.0-255,9992,178438,6,270064
11489,0.001724,172.31.36.0-255,66,178504,6,270064
11490,0.001731,74.125.24.0-255,7156,185660,6,270064
11491,0.001733,172.31.36.0-255,66,185726,6,270064
11492,0.001744,74.125.24.0-255,3602,189328,6,270064
11493,0.001746,172.31.36.0-255,66,189394,6,270064
11494,0.001778,74.125.24.0-255,4320,193714,6,270064
11495,0.001781,172.31.36.0-255,66,193780,6,270064
11496,0.001804,74.125.24.0-255,8574,202354,6,270064
11497,0.001807,172.31.36.0-255,66,202420,6,270064
11498,0.001814,74.125.24.0-255,5738,208158,6,270064
11499,0.001816,172.31.36.0-255,66,208224,6,270064
11500,0.001846,74.125.24.0-255,4320,212544,6,270064
11501,0.001849,172.31.36.0-255,66,212610,6,270064
11502,0.00186,74.125.24.0-255,10692,223302,6,270064
11503,0.001862,172.31.36.0-255,66,223368,6,270064
11504,0.001929,74.125.24.0-255,1484,224852,6,270064
11505,0.001949,74.125.24.0-255,2902,227754,6,270064
11506,0.001953,172.31.36.0-255,66,227820,6,270064
11507,0.001959,74.125.24.0-255,4320,232140,6,270064
11508,0.001961,172.31.36.0-255,66,232206,6,270064
11509,0.001985,74.125.24.0-255,1484,233690,6,270064
11510,0.00199,74.125.24.0-255,2902,236592,6,270064
11511,0.001992,172.31.36.0-255,66,236658,6,270064
11512,0.001997,74.125.24.0-255,2902,239560,6,270064
11513,0.001999,172.31.36.0-255,66,239626,6,270064
11514,0.00203,74.125.24.0-255,7156,246782,6,270064
11515,0.002034,172.31.36.0-255,66,246848,6,270064
11516,0.00204,74.125.24.0-255,5738,252586,6,270064
11517,0.002043,172.31.36.0-255,66,252652,6,270064
11518,0.004081,74.125.24.0-255,5738,258390,6,270064
11519,0.004093,172.31.36.0-255,66,258456,6,270064
11520,0.006122,74.125.24.0-255,5738,264194,6,270064
11521,0.006141,172.31.36.0-255,66,264260,6,270064
11522,0.008163,74.125.24.0-255,5738,269998,6,270064
11523,0.008179,172.31.36.0-255,66,270064,6,270064
11524,0.0,74.125.68.0-255,153,153,6,160322
11525,3.3e-05,172.31.36.0-255,66,219,6,160322
11526,4e-05,74.125.68.0-255,1484,1703,6,160322
11527,4.5e-05,172.31.36.0-255,66,1769,6,160322
11528,4.9e-05,74.125.68.0-255,2902,4671,6,160322
11529,5.2e-05,172.31.36.0-255,66,4737,6,160322
11530,5.6e-05,74.125.68.0-255,2902,7639,6,160322
11531,5.8e-05,172.31.36.0-255,66,7705,6,160322
11532,6.4e-05,74.125.68.0-255,4320,12025,6,160322
11533,6.7e-05,172.31.36.0-255,66,12091,6,160322
11534,0.000119,74.125.68.0-255,2039,14130,6,160322
11535,0.000123,172.31.36.0-255,66,14196,6,160322
11536,0.00038,74.125.68.0-255,1484,15680,6,160322
11537,0.000386,172.31.36.0-255,66,15746,6,160322
11538,0.000391,74.125.68.0-255,2902,18648,6,160322
11539,0.000394,172.31.36.0-255,66,18714,6,160322
11540,0.000397,74.125.68.0-255,1484,20198,6,160322
11541,0.000399,172.31.36.0-255,66,20264,6,160322
11542,0.000425,74.125.68.0-255,2902,23166,6,160322
11543,0.000427,172.31.36.0-255,66,23232,6,160322
11544,0.000432,74.125.68.0-255,2902,26134,6,160322
11545,0.000436,172.31.36.0-255,66,26200,6,160322
11546,0.000449,74.125.68.0-255,2902,29102,6,160322
11547,0.000452,172.31.36.0-255,66,29168,6,160322
11548,0.000456,74.125.68.0-255,2543,31711,6,160322
11549,0.000459,172.31.36.0-255,66,31777,6,160322
11550,0.000486,74.125.68.0-255,2902,34679,6,160322
11551,0.00049,172.31.36.0-255,66,34745,6,160322
11552,0.000509,74.125.68.0-255,4320,39065,6,160322
11553,0.000512,172.31.36.0-255,66,39131,6,160322
11554,0.000555,74.125.68.0-255,2902,42033,6,160322
11555,0.000558,172.31.36.0-255,66,42099,6,160322
11556,0.000579,74.125.68.0-255,2902,45001,6,160322
11557,0.000583,172.31.36.0-255,66,45067,6,160322
11558,0.000589,74.125.68.0-255,3961,49028,6,160322
11559,0.000591,172.31.36.0-255,66,49094,6,160322
11560,0.00085,74.125.68.0-255,1484,50578,6,160322
11561,0.000861,74.125.68.0-255,1484,52062,6,160322
11562,0.000865,172.31.36.0-255,66,52128,6,160322
11563,0.000871,74.125.68.0-255,2902,55030,6,160322
11564,0.000873,172.31.36.0-255,66,55096,6,160322
11565,0.00088,74.125.68.0-255,4320,59416,6,160322
11566,0.000882,172.31.36.0-255,66,59482,6,160322
11567,0.000904,74.125.68.0-255,1484,60966,6,160322
11568,0.000911,74.125.68.0-255,4320,65286,6,160322
11569,0.000914,172.31.36.0-255,66,65352,6,160322
11570,0.000932,74.125.68.0-255,1125,66477,6,160322
11571,0.001009,74.125.68.0-255,1484,67961,6,160322
11572,0.001014,172.31.36.0-255,66,68027,6,160322
11573,0.001019,74.125.68.0-255,2902,70929,6,160322
11574,0.001021,172.31.36.0-255,66,70995,6,160322
11575,0.001035,74.125.68.0-255,1484,72479,6,160322
11576,0.001049,74.125.68.0-255,4320,76799,6,160322
11577,0.001052,172.31.36.0-255,66,76865,6,160322
11578,0.001056,74.125.68.0-255,2902,79767,6,160322
11579,0.001058,172.31.36.0-255,66,79833,6,160322
11580,0.001076,74.125.68.0-255,3961,83794,6,160322
11581,0.001079,172.31.36.0-255,66,83860,6,160322
11582,0.001085,74.125.68.0-255,5738,89598,6,160322
11583,0.001088,172.31.36.0-255,66,89664,6,160322
11584,0.001104,74.125.68.0-255,1484,91148,6,160322
11585,0.001133,74.125.68.0-255,9633,100781,6,160322
11586,0.001137,172.31.36.0-255,66,100847,6,160322
11587,0.001162,74.125.68.0-255,1484,102331,6,160322
11588,0.001166,74.125.68.0-255,1484,103815,6,160322
11589,0.001169,172.31.36.0-255,66,103881,6,160322
11590,0.001183,74.125.68.0-255,1484,105365,6,160322
11591,0.001189,74.125.68.0-255,4320,109685,6,160322
11592,0.001192,172.31.36.0-255,66,109751,6,160322
11593,0.001207,74.125.68.0-255,1484,111235,6,160322
11594,0.001212,74.125.68.0-255,4320,115555,6,160322
11595,0.001215,172.31.36.0-255,66,115621,6,160322
11596,0.001234,74.125.68.0-255,2429,118050,6,160322
11597,0.001237,172.31.36.0-255,66,118116,6,160322
11598,0.001923,74.125.68.0-255,1484,119600,6,160322
11599,0.001931,74.125.68.0-255,2902,122502,6,160322
11600,0.001936,172.31.36.0-255,66,122568,6,160322
11601,0.001951,74.125.68.0-255,2902,125470,6,160322
11602,0.001953,172.31.36.0-255,66,125536,6,160322
11603,0.001968,74.125.68.0-255,2902,128438,6,160322
11604,0.001971,172.31.36.0-255,66,128504,6,160322
11605,0.001978,74.125.68.0-255,6920,135424,6,160322
11606,0.00198,172.31.36.0-255,66,135490,6,160322
11607,0.002012,74.125.68.0-255,2902,138392,6,160322
11608,0.002015,172.31.36.0-255,66,138458,6,160322
11609,0.002028,74.125.68.0-255,4320,142778,6,160322
11610,0.00203,172.31.36.0-255,66,142844,6,160322
11611,0.002033,74.125.68.0-255,1484,144328,6,160322
11612,0.003995,74.125.68.0-255,4320,148648,6,160322
11613,0.003998,172.31.36.0-255,66,148714,6,160322
11614,0.005997,74.125.68.0-255,5738,154452,6,160322
11615,0.006004,172.31.36.0-255,66,154518,6,160322
11616,0.008018,74.125.68.0-255,5738,160256,6,160322
11617,0.008024,172.31.36.0-255,66,160322,6,160322
11618,0.0,74.125.24.0-255,153,153,6,183560
11619,2.6e-05,172.31.36.0-255,66,219,6,183560
11620,3.3e-05,74.125.24.0-255,1484,1703,6,183560
11621,3.8e-05,172.31.36.0-255,66,1769,6,183560
11622,4.2e-05,74.125.24.0-255,2902,4671,6,183560
11623,5.5e-05,172.31.36.0-255,66,4737,6,183560
11624,6.2e-05,74.125.24.0-255,7156,11893,6,183560
11625,6.5e-05,172.31.36.0-255,66,11959,6,183560
11626,9.2e-05,74.125.24.0-255,2048,14007,6,183560
11627,9.5e-05,172.31.36.0-255,66,14073,6,183560
11628,0.000178,74.125.24.0-255,1484,15557,6,183560
11629,0.000183,172.31.36.0-255,66,15623,6,183560
11630,0.000212,74.125.24.0-255,2902,18525,6,183560
11631,0.000215,172.31.36.0-255,66,18591,6,183560
11632,0.000243,74.125.24.0-255,5738,24329,6,183560
11633,0.000246,74.125.24.0-255,1484,25813,6,183560
11634,0.000248,172.31.36.0-255,66,25879,6,183560
11635,0.000252,172.31.36.0-255,66,25945,6,183560
11636,0.000258,74.125.24.0-255,1484,27429,6,183560
11637,0.00026,172.31.36.0-255,66,27495,6,183560
11638,0.000304,74.125.24.0-255,3961,31456,6,183560
11639,0.000308,172.31.36.0-255,66,31522,6,183560
11640,0.000397,74.125.24.0-255,1484,33006,6,183560
11641,0.000402,172.31.36.0-255,66,33072,6,183560
11642,0.000427,74.125.24.0-255,1484,34556,6,183560
11643,0.00043,172.31.36.0-255,66,34622,6,183560
11644,0.000456,74.125.24.0-255,1484,36106,6,183560
11645,0.000459,172.31.36.0-255,66,36172,6,183560
11646,0.000466,74.125.24.0-255,5738,41910,6,183560
11647,0.000469,172.31.36.0-255,66,41976,6,183560
11648,0.000477,74.125.24.0-255,1484,43460,6,183560
11649,0.000479,172.31.36.0-255,66,43526,6,183560
11650,0.000523,74.125.24.0-255,9633,53159,6,183560
11651,0.000532,74.125.24.0-255,8574,61733,6,183560
11652,0.000536,172.31.36.0-255,66,61799,6,183560
11653,0.000542,172.31.36.0-255,66,61865,6,183560
11654,0.000585,74.125.24.0-255,4292,66157,6,183560
11655,0.000592,172.31.36.0-255,66,66223,6,183560
11656,0.000627,74.125.24.0-255,113,66336,6,183560
11657,0.000778,74.125.24.0-255,1484,67820,6,183560
11658,0.000782,172.31.36.0-255,66,67886,6,183560
11659,0.000796,74.125.24.0-255,2902,70788,6,183560
11660,0.000805,74.125.24.0-255,2902,73690,6,183560
11661,0.000805,172.31.36.0-255,66,73756,6,183560
11662,0.00082,172.31.36.0-255,66,73822,6,183560
11663,0.000852,74.125.24.0-255,7156,80978,6,183560
11664,0.000857,74.125.24.0-255,2902,83880,6,183560
11665,0.000862,172.31.36.0-255,66,83946,6,183560
11666,0.000873,74.125.24.0-255,3961,87907,6,183560
11667,0.000881,172.31.36.0-255,66,87973,6,183560
11668,0.000883,74.125.24.0-255,4320,92293,6,183560
11669,0.000896,172.31.36.0-255,66,92359,6,183560
11670,0.00091,74.125.24.0-255,2902,95261,6,183560
11671,0.00092,74.125.24.0-255,5379,100640,6,183560
11672,0.000924,172.31.36.0-255,66,100706,6,183560
11673,0.002373,74.125.24.0-255,1484,102190,6,183560
11674,0.0024,74.125.24.0-255,2902,105092,6,183560
11675,0.002403,172.31.36.0-255,66,105158,6,183560
11676,0.00241,74.125.24.0-255,5738,110896,6,183560
11677,0.002434,74.125.24.0-255,2902,113798,6,183560
11678,0.002452,74.125.24.0-255,2902,116700,6,183560
11679,0.002464,74.125.24.0-255,4320,121020,6,183560
11680,0.002479,74.125.24.0-255,7156,128176,6,183560
11681,0.002489,74.125.24.0-255,1484,129660,6,183560
11682,0.002494,74.125.24.0-255,5020,134680,6,183560
11683,0.002501,172.31.36.0-255,66,134746,6,183560
11684,0.002577,74.125.24.0-255,1484,136230,6,183560
11685,0.002583,74.125.24.0-255,2902,139132,6,183560
11686,0.00259,172.31.36.0-255,66,139198,6,183560
11687,0.002599,74.125.24.0-255,1484,140682,6,183560
11688,0.002621,74.125.24.0-255,4320,145002,6,183560
11689,0.002628,74.125.24.0-255,5738,150740,6,183560
11690,0.002628,172.31.36.0-255,66,150806,6,183560
11691,0.002633,172.31.36.0-255,66,150872,6,183560
11692,0.002655,74.125.24.0-255,4320,155192,6,183560
11693,0.002676,172.31.36.0-255,66,155258,6,183560
11694,0.002684,74.125.24.0-255,8574,163832,6,183560
11695,0.002693,172.31.36.0-255,66,163898,6,183560
11696,0.002701,74.125.24.0-255,7856,171754,6,183560
11697,0.002713,172.31.36.0-255,66,171820,6,183560
11698,0.005333,74.125.24.0-255,5738,177558,6,183560
11699,0.005337,172.31.36.0-255,66,177624,6,183560
11700,0.007927,74.125.24.0-255,2902,180526,6,183560
11701,0.007935,172.31.36.0-255,66,180592,6,183560
11702,0.00797,74.125.24.0-255,2902,183494,6,183560
11703,0.008001,172.31.36.0-255,66,183560,6,183560
11704,0.0,172.217.26.0-255,146,146,6,112172
11705,2.3e-05,172.31.36.0-255,66,212,6,112172
11706,3.1e-05,172.217.26.0-255,1484,1696,6,112172
11707,3.5e-05,172.31.36.0-255,66,1762,6,112172
11708,4e-05,172.217.26.0-255,2902,4664,6,112172
11709,4.3e-05,172.31.36.0-255,66,4730,6,112172
11710,7.4e-05,172.217.26.0-255,7156,11886,6,112172
11711,7.7e-05,172.31.36.0-255,66,11952,6,112172
11712,8.7e-05,172.217.26.0-255,9165,21117,6,112172
11713,9e-05,172.31.36.0-255,66,21183,6,112172
11714,0.0001,172.217.26.0-255,9633,30816,6,112172
11715,0.000102,172.31.36.0-255,66,30882,6,112172
11716,0.000242,172.217.26.0-255,1484,32366,6,112172
11717,0.000247,172.31.36.0-255,66,32432,6,112172
11718,0.000251,172.217.26.0-255,1484,33916,6,112172
11719,0.000253,172.31.36.0-255,66,33982,6,112172
11720,0.000272,172.217.26.0-255,1484,35466,6,112172
11721,0.000274,172.31.36.0-255,66,35532,6,112172
11722,0.000281,172.217.26.0-255,4320,39852,6,112172
11723,0.000284,172.31.36.0-255,66,39918,6,112172
11724,0.000289,172.217.26.0-255,4320,44238,6,112172
11725,0.000291,172.31.36.0-255,66,44304,6,112172
11726,0.000319,172.217.26.0-255,5379,49683,6,112172
11727,0.000321,172.31.36.0-255,66,49749,6,112172
11728,0.000324,172.217.26.0-255,1484,51233,6,112172
11729,0.000326,172.31.36.0-255,66,51299,6,112172
11730,0.000355,172.31.36.0-255,66,51365,6,112172
11731,0.00036,172.217.26.0-255,2835,54200,6,112172
11732,0.000363,172.31.36.0-255,66,54266,6,112172
11733,0.001448,172.217.26.0-255,386,54652,6,112172
11734,0.001455,172.31.36.0-255,66,54718,6,112172
11735,0.001631,172.217.26.0-255,1484,56202,6,112172
11736,0.001639,172.217.26.0-255,2902,59104,6,112172
11737,0.001643,172.31.36.0-255,66,59170,6,112172
11738,0.00165,172.217.26.0-255,4320,63490,6,112172
11739,0.001652,172.31.36.0-255,66,63556,6,112172
11740,0.001659,172.217.26.0-255,4320,67876,6,112172
11741,0.001661,172.31.36.0-255,66,67942,6,112172
11742,0.001678,172.217.26.0-255,1484,69426,6,112172
11743,0.001703,172.217.26.0-255,9992,79418,6,112172
11744,0.001705,172.31.36.0-255,66,79484,6,112172
11745,0.001722,172.217.26.0-255,2543,82027,6,112172
11746,0.001725,172.31.36.0-255,66,82093,6,112172
11747,0.001733,172.217.26.0-255,6797,88890,6,112172
11748,0.001735,172.31.36.0-255,66,88956,6,112172
11749,0.003698,172.217.26.0-255,5738,94694,6,112172
11750,0.0037,172.31.36.0-255,66,94760,6,112172
11751,0.005707,172.217.26.0-255,5738,100498,6,112172
11752,0.005711,172.31.36.0-255,66,100564,6,112172
11753,0.00771,172.217.26.0-255,5738,106302,6,112172
11754,0.007717,172.31.36.0-255,66,106368,6,112172
11755,0.009691,172.217.26.0-255,5738,112106,6,112172
11756,0.009697,172.31.36.0-255,66,112172,6,112172
11757,0.0,172.217.194.0-255,153,153,6,101481
11758,3.5e-05,172.31.36.0-255,66,219,6,101481
11759,4.3e-05,172.217.194.0-255,1484,1703,6,101481
11760,4.7e-05,172.31.36.0-255,66,1769,6,101481
11761,5.2e-05,172.217.194.0-255,2902,4671,6,101481
11762,5.4e-05,172.31.36.0-255,66,4737,6,101481
11763,0.000115,172.217.194.0-255,2902,7639,6,101481
11764,0.000119,172.31.36.0-255,66,7705,6,101481
11765,0.000135,172.217.194.0-255,4320,12025,6,101481
11766,0.000139,172.31.36.0-255,66,12091,6,101481
11767,0.000326,172.217.194.0-255,2055,14146,6,101481
11768,0.000331,172.31.36.0-255,66,14212,6,101481
11769,0.000388,172.217.194.0-255,4320,18532,6,101481
11770,0.000392,172.31.36.0-255,66,18598,6,101481
11771,0.000414,172.217.194.0-255,7156,25754,6,101481
11772,0.000418,172.31.36.0-255,66,25820,6,101481
11773,0.00073,172.217.194.0-255,5379,31199,6,101481
11774,0.000736,172.31.36.0-255,66,31265,6,101481
11775,0.000908,172.217.194.0-255,5738,37003,6,101481
11776,0.000913,172.31.36.0-255,66,37069,6,101481
11777,0.001052,172.217.194.0-255,5738,42807,6,101481
11778,0.001057,172.31.36.0-255,66,42873,6,101481
11779,0.00108,172.217.194.0-255,6797,49670,6,101481
11780,0.001083,172.31.36.0-255,66,49736,6,101481
11781,0.00144,172.217.194.0-255,8574,58310,6,101481
11782,0.001448,172.31.36.0-255,66,58376,6,101481
11783,0.00147,172.217.194.0-255,6797,65173,6,101481
11784,0.001474,172.31.36.0-255,66,65239,6,101481
11785,0.001877,172.217.194.0-255,2902,68141,6,101481
11786,0.00188,172.31.36.0-255,66,68207,6,101481
11787,0.001907,172.31.36.0-255,66,68273,6,101481
11788,0.002363,172.217.194.0-255,4320,72593,6,101481
11789,0.002902,172.217.194.0-255,7156,79749,6,101481
11790,0.002965,172.217.194.0-255,2902,82651,6,101481
11791,0.003868,172.217.194.0-255,4320,86971,6,101481
11792,0.003889,172.217.194.0-255,8574,95545,6,101481
11793,0.005365,172.31.36.0-255,66,95611,6,101481
11794,0.007646,172.217.194.0-255,1484,97095,6,101481
11795,0.007672,172.217.194.0-255,4320,101415,6,101481
11796,0.007677,172.31.36.0-255,66,101481,6,101481
11797,0.0,172.217.194.0-255,153,153,6,120266
11798,3.4e-05,172.31.36.0-255,66,219,6,120266
11799,4.1e-05,172.217.194.0-255,1484,1703,6,120266
11800,4.6e-05,172.31.36.0-255,66,1769,6,120266
11801,5.1e-05,172.217.194.0-255,2902,4671,6,120266
11802,5.5e-05,172.31.36.0-255,66,4737,6,120266
11803,5.8e-05,172.217.194.0-255,1484,6221,6,120266
11804,6.1e-05,172.31.36.0-255,66,6287,6,120266
11805,8.1e-05,172.217.194.0-255,4320,10607,6,120266
11806,8.4e-05,172.31.36.0-255,66,10673,6,120266
11807,9e-05,172.217.194.0-255,6329,17002,6,120266
11808,9.2e-05,172.31.36.0-255,66,17068,6,120266
11809,0.000118,172.217.194.0-255,5738,22806,6,120266
11810,0.000121,172.31.36.0-255,66,22872,6,120266
11811,0.000143,172.217.194.0-255,7156,30028,6,120266
11812,0.000145,172.31.36.0-255,66,30094,6,120266
11813,0.000148,172.217.194.0-255,1125,31219,6,120266
11814,0.00015,172.31.36.0-255,66,31285,6,120266
11815,0.000271,172.217.194.0-255,1484,32769,6,120266
11816,0.000276,172.31.36.0-255,66,32835,6,120266
11817,0.000281,172.217.194.0-255,2902,35737,6,120266
11818,0.000284,172.31.36.0-255,66,35803,6,120266
11819,0.000287,172.217.194.0-255,1484,37287,6,120266
11820,0.000289,172.31.36.0-255,66,37353,6,120266
11821,0.000312,172.217.194.0-255,4320,41673,6,120266
11822,0.000316,172.31.36.0-255,66,41739,6,120266
11823,0.000321,172.217.194.0-255,4320,46059,6,120266
11824,0.000324,172.31.36.0-255,66,46125,6,120266
11825,0.000354,172.217.194.0-255,8215,54340,6,120266
11826,0.000358,172.31.36.0-255,66,54406,6,120266
11827,0.000375,172.217.194.0-255,2902,57308,6,120266
11828,0.000378,172.31.36.0-255,66,57374,6,120266
11829,0.000405,172.217.194.0-255,8215,65589,6,120266
11830,0.000409,172.31.36.0-255,66,65655,6,120266
11831,0.000577,172.217.194.0-255,645,66300,6,120266
11832,0.000719,172.217.194.0-255,1484,67784,6,120266
11833,0.000723,172.31.36.0-255,66,67850,6,120266
11834,0.000729,172.217.194.0-255,2902,70752,6,120266
11835,0.000731,172.31.36.0-255,66,70818,6,120266
11836,0.000748,172.217.194.0-255,5738,76556,6,120266
11837,0.00075,172.31.36.0-255,66,76622,6,120266
11838,0.000774,172.31.36.0-255,66,76688,6,120266
11839,0.000801,172.217.194.0-255,10692,87380,6,120266
11840,0.000804,172.31.36.0-255,66,87446,6,120266
11841,0.00226,172.217.194.0-255,1484,88930,6,120266
11842,0.00227,172.217.194.0-255,2902,91832,6,120266
11843,0.002275,172.31.36.0-255,66,91898,6,120266
11844,0.002284,172.217.194.0-255,5738,97636,6,120266
11845,0.002286,172.31.36.0-255,66,97702,6,120266
11846,0.002313,172.217.194.0-255,1484,99186,6,120266
11847,0.002338,172.31.36.0-255,66,99252,6,120266
11848,0.002347,172.217.194.0-255,9992,109244,6,120266
11849,0.002349,172.31.36.0-255,66,109310,6,120266
11850,0.002351,172.217.194.0-255,766,110076,6,120266
11851,0.004988,172.217.194.0-255,4320,114396,6,120266
11852,0.004991,172.31.36.0-255,66,114462,6,120266
11853,0.007623,172.217.194.0-255,5738,120200,6,120266
11854,0.00763,172.31.36.0-255,66,120266,6,120266
11855,0.0,74.125.24.0-255,298,298,6,140930
11856,2.4e-05,172.31.36.0-255,66,364,6,140930
11857,3.1e-05,74.125.24.0-255,1484,1848,6,140930
11858,3.5e-05,172.31.36.0-255,66,1914,6,140930
11859,4.1e-05,74.125.24.0-255,2902,4816,6,140930
11860,4.3e-05,172.31.36.0-255,66,4882,6,140930
11861,6.1e-05,74.125.24.0-255,1484,6366,6,140930
11862,6.4e-05,172.31.36.0-255,66,6432,6,140930
11863,7.3e-05,74.125.24.0-255,7526,13958,6,140930
11864,7.6e-05,172.31.36.0-255,66,14024,6,140930
11865,9.1e-05,74.125.24.0-255,1484,15508,6,140930
11866,9.3e-05,172.31.36.0-255,66,15574,6,140930
11867,0.00016,74.125.24.0-255,2902,18476,6,140930
11868,0.000165,172.31.36.0-255,66,18542,6,140930
11869,0.000172,74.125.24.0-255,5738,24280,6,140930
11870,0.000174,172.31.36.0-255,66,24346,6,140930
11871,0.000181,74.125.24.0-255,6797,31143,6,140930
11872,0.000183,172.31.36.0-255,66,31209,6,140930
11873,0.00026,74.125.24.0-255,1484,32693,6,140930
11874,0.000263,172.31.36.0-255,66,32759,6,140930
11875,0.000268,74.125.24.0-255,2902,35661,6,140930
11876,0.00027,172.31.36.0-255,66,35727,6,140930
11877,0.000276,74.125.24.0-255,4320,40047,6,140930
11878,0.000279,172.31.36.0-255,66,40113,6,140930
11879,0.00029,74.125.24.0-255,1484,41597,6,140930
11880,0.000292,172.31.36.0-255,66,41663,6,140930
11881,0.000298,74.125.24.0-255,4320,45983,6,140930
11882,0.0003,172.31.36.0-255,66,46049,6,140930
11883,0.000321,74.125.24.0-255,1484,47533,6,140930
11884,0.000323,172.31.36.0-255,66,47599,6,140930
11885,0.000354,172.31.36.0-255,66,47665,6,140930
11886,0.000362,74.125.24.0-255,6797,54462,6,140930
11887,0.000364,172.31.36.0-255,66,54528,6,140930
11888,0.001113,74.125.24.0-255,646,55174,6,140930
11889,0.001135,172.31.36.0-255,66,55240,6,140930
11890,0.001322,74.125.24.0-255,1484,56724,6,140930
11891,0.001333,74.125.24.0-255,2902,59626,6,140930
11892,0.001337,172.31.36.0-255,66,59692,6,140930
11893,0.001342,74.125.24.0-255,1484,61176,6,140930
11894,0.001363,74.125.24.0-255,4320,65496,6,140930
11895,0.001366,172.31.36.0-255,66,65562,6,140930
11896,0.001396,74.125.24.0-255,8574,74136,6,140930
11897,0.001399,172.31.36.0-255,66,74202,6,140930
11898,0.00142,74.125.24.0-255,4320,78522,6,140930
11899,0.001422,172.31.36.0-255,66,78588,6,140930
11900,0.001429,74.125.24.0-255,5738,84326,6,140930
11901,0.001431,172.31.36.0-255,66,84392,6,140930
11902,0.001454,74.125.24.0-255,5020,89412,6,140930
11903,0.001456,172.31.36.0-255,66,89478,6,140930
11904,0.002172,74.125.24.0-255,1484,90962,6,140930
11905,0.002182,74.125.24.0-255,2902,93864,6,140930
11906,0.002186,172.31.36.0-255,66,93930,6,140930
11907,0.002194,74.125.24.0-255,5738,99668,6,140930
11908,0.002196,172.31.36.0-255,66,99734,6,140930
11909,0.002241,74.125.24.0-255,8574,108308,6,140930
11910,0.002243,172.31.36.0-255,66,108374,6,140930
11911,0.00228,74.125.24.0-255,4320,112694,6,140930
11912,0.002283,172.31.36.0-255,66,112760,6,140930
11913,0.00233,74.125.24.0-255,10692,123452,6,140930
11914,0.002332,172.31.36.0-255,66,123518,6,140930
11915,0.004561,74.125.24.0-255,5738,129256,6,140930
11916,0.004574,172.31.36.0-255,66,129322,6,140930
11917,0.006834,74.125.24.0-255,5738,135060,6,140930
11918,0.006848,172.31.36.0-255,66,135126,6,140930
11919,0.009091,74.125.24.0-255,5738,140864,6,140930
11920,0.009103,172.31.36.0-255,66,140930,6,140930
11921,0.0,74.125.68.0-255,152,152,6,163337
11922,3.5e-05,172.31.36.0-255,66,218,6,163337
11923,4.2e-05,74.125.68.0-255,1484,1702,6,163337
11924,4.6e-05,172.31.36.0-255,66,1768,6,163337
11925,5.9e-05,74.125.68.0-255,2902,4670,6,163337
11926,6.2e-05,172.31.36.0-255,66,4736,6,163337
11927,6.9e-05,74.125.68.0-255,7156,11892,6,163337
11928,7.1e-05,172.31.36.0-255,66,11958,6,163337
11929,7.5e-05,74.125.68.0-255,1978,13936,6,163337
11930,7.8e-05,172.31.36.0-255,66,14002,6,163337
11931,0.000226,74.125.68.0-255,1484,15486,6,163337
11932,0.000231,172.31.36.0-255,66,15552,6,163337
11933,0.000236,74.125.68.0-255,2902,18454,6,163337
11934,0.000239,172.31.36.0-255,66,18520,6,163337
11935,0.000272,74.125.68.0-255,5738,24258,6,163337
11936,0.000275,172.31.36.0-255,66,24324,6,163337
11937,0.000279,74.125.68.0-255,2902,27226,6,163337
11938,0.000281,172.31.36.0-255,66,27292,6,163337
11939,0.000284,74.125.68.0-255,1484,28776,6,163337
11940,0.000288,172.31.36.0-255,66,28842,6,163337
11941,0.000302,74.125.68.0-255,2543,31385,6,163337
11942,0.000305,172.31.36.0-255,66,31451,6,163337
11943,0.000681,74.125.68.0-255,1484,32935,6,163337
11944,0.000687,172.31.36.0-255,66,33001,6,163337
11945,0.000696,74.125.68.0-255,2902,35903,6,163337
11946,0.000698,172.31.36.0-255,66,35969,6,163337
11947,0.000711,74.125.68.0-255,5738,41707,6,163337
11948,0.000715,172.31.36.0-255,66,41773,6,163337
11949,0.00072,74.125.68.0-255,2902,44675,6,163337
11950,0.000722,172.31.36.0-255,66,44741,6,163337
11951,0.000757,74.125.68.0-255,1484,46225,6,163337
11952,0.00076,172.31.36.0-255,66,46291,6,163337
11953,0.000768,74.125.68.0-255,5379,51670,6,163337
11954,0.00077,172.31.36.0-255,66,51736,6,163337
11955,0.000785,74.125.68.0-255,9992,61728,6,163337
11956,0.000787,172.31.36.0-255,66,61794,6,163337
11957,0.000818,74.125.68.0-255,1484,63278,6,163337
11958,0.000838,74.125.68.0-255,2543,65821,6,163337
11959,0.000841,172.31.36.0-255,66,65887,6,163337
11960,0.001197,74.125.68.0-255,646,66533,6,163337
11961,0.001329,74.125.68.0-255,1484,68017,6,163337
11962,0.001334,172.31.36.0-255,66,68083,6,163337
11963,0.001361,74.125.68.0-255,2902,70985,6,163337
11964,0.001363,172.31.36.0-255,66,71051,6,163337
11965,0.001366,74.125.68.0-255,1484,72535,6,163337
11966,0.001389,74.125.68.0-255,4320,76855,6,163337
11967,0.001392,172.31.36.0-255,66,76921,6,163337
11968,0.001395,74.125.68.0-255,2902,79823,6,163337
11969,0.001397,172.31.36.0-255,66,79889,6,163337
11970,0.001415,74.125.68.0-255,2902,82791,6,163337
11971,0.001417,172.31.36.0-255,66,82857,6,163337
11972,0.001434,74.125.68.0-255,1484,84341,6,163337
11973,0.001446,74.125.68.0-255,8574,92915,6,163337
11974,0.001448,172.31.36.0-255,66,92981,6,163337
11975,0.001455,74.125.68.0-255,7156,100137,6,163337
11976,0.001456,172.31.36.0-255,66,100203,6,163337
11977,0.001483,74.125.68.0-255,766,100969,6,163337
11978,0.001584,74.125.68.0-255,1484,102453,6,163337
11979,0.001586,172.31.36.0-255,66,102519,6,163337
11980,0.001606,74.125.68.0-255,2902,105421,6,163337
11981,0.001608,172.31.36.0-255,66,105487,6,163337
11982,0.001613,74.125.68.0-255,2902,108389,6,163337
11983,0.001615,172.31.36.0-255,66,108455,6,163337
11984,0.001635,74.125.68.0-255,4320,112775,6,163337
11985,0.001637,172.31.36.0-255,66,112841,6,163337
11986,0.001659,74.125.68.0-255,8574,121415,6,163337
11987,0.001662,172.31.36.0-255,66,121481,6,163337
11988,0.001671,74.125.68.0-255,4320,125801,6,163337
11989,0.001673,172.31.36.0-255,66,125867,6,163337
11990,0.001678,74.125.68.0-255,4320,130187,6,163337
11991,0.00168,172.31.36.0-255,66,130253,6,163337
11992,0.001707,74.125.68.0-255,1484,131737,6,163337
11993,0.001711,74.125.68.0-255,1484,133221,6,163337
11994,0.001712,172.31.36.0-255,66,133287,6,163337
11995,0.001737,74.125.68.0-255,2184,135471,6,163337
11996,0.001739,172.31.36.0-255,66,135537,6,163337
11997,0.001979,74.125.68.0-255,1484,137021,6,163337
11998,0.001994,74.125.68.0-255,2902,139923,6,163337
11999,0.001997,172.31.36.0-255,66,139989,6,163337
12000,0.002,74.125.68.0-255,1484,141473,6,163337
12001,0.002022,74.125.68.0-255,4320,145793,6,163337
12002,0.002024,172.31.36.0-255,66,145859,6,163337
12003,0.002027,74.125.68.0-255,1484,147343,6,163337
12004,0.00402,74.125.68.0-255,4320,151663,6,163337
12005,0.004024,172.31.36.0-255,66,151729,6,163337
12006,0.006021,74.125.68.0-255,5738,157467,6,163337
12007,0.006028,172.31.36.0-255,66,157533,6,163337
12008,0.008036,74.125.68.0-255,5738,163271,6,163337
12009,0.008044,172.31.36.0-255,66,163337,6,163337
12010,0.0,172.217.194.0-255,153,153,6,220585
12011,1.6e-05,172.31.36.0-255,66,219,6,220585
12012,2.2e-05,172.217.194.0-255,1484,1703,6,220585
12013,2.7e-05,172.31.36.0-255,66,1769,6,220585
12014,3.3e-05,172.217.194.0-255,2902,4671,6,220585
12015,3.6e-05,172.31.36.0-255,66,4737,6,220585
12016,5.1e-05,172.217.194.0-255,7156,11893,6,220585
12017,5.4e-05,172.31.36.0-255,66,11959,6,220585
12018,6.1e-05,172.217.194.0-255,3432,15391,6,220585
12019,6.4e-05,172.31.36.0-255,66,15457,6,220585
12020,7e-05,172.217.194.0-255,4320,19777,6,220585
12021,7.4e-05,172.31.36.0-255,66,19843,6,220585
12022,0.000118,172.217.194.0-255,9992,29835,6,220585
12023,0.000122,172.31.36.0-255,66,29901,6,220585
12024,0.000125,172.217.194.0-255,1484,31385,6,220585
12025,0.000127,172.31.36.0-255,66,31451,6,220585
12026,0.000177,172.31.36.0-255,66,31517,6,220585
12027,0.000182,172.217.194.0-255,2184,33701,6,220585
12028,0.000184,172.31.36.0-255,66,33767,6,220585
12029,0.000189,172.217.194.0-255,2902,36669,6,220585
12030,0.000191,172.31.36.0-255,66,36735,6,220585
12031,0.000198,172.217.194.0-255,7156,43891,6,220585
12032,0.0002,172.31.36.0-255,66,43957,6,220585
12033,0.000206,172.217.194.0-255,4320,48277,6,220585
12034,0.00021,172.31.36.0-255,66,48343,6,220585
12035,0.000238,172.217.194.0-255,3133,51476,6,220585
12036,0.000245,172.31.36.0-255,66,51542,6,220585
12037,0.000268,172.217.194.0-255,8574,60116,6,220585
12038,0.000271,172.31.36.0-255,66,60182,6,220585
12039,0.000278,172.217.194.0-255,7156,67338,6,220585
12040,0.000281,172.31.36.0-255,66,67404,6,220585
12041,0.000315,172.217.194.0-255,9992,77396,6,220585
12042,0.000338,172.217.194.0-255,7156,84552,6,220585
12043,0.00034,172.217.194.0-255,766,85318,6,220585
12044,0.000354,172.31.36.0-255,66,85384,6,220585
12045,0.000361,172.217.194.0-255,4320,89704,6,220585
12046,0.000366,172.31.36.0-255,66,89770,6,220585
12047,0.000433,172.217.194.0-255,7156,96926,6,220585
12048,0.000466,172.217.194.0-255,1484,98410,6,220585
12049,0.000536,172.217.194.0-255,2902,101312,6,220585
12050,0.000587,172.217.194.0-255,2184,103496,6,220585
12051,0.00059,172.217.194.0-255,2902,106398,6,220585
12052,0.000597,172.217.194.0-255,7156,113554,6,220585
12053,0.000644,172.217.194.0-255,1484,115038,6,220585
12054,0.000651,172.217.194.0-255,6438,121476,6,220585
12055,0.000685,172.217.194.0-255,5738,127214,6,220585
12056,0.000716,172.217.194.0-255,5738,132952,6,220585
12057,0.00074,172.217.194.0-255,9274,142226,6,220585
12058,0.00076,172.217.194.0-255,4320,146546,6,220585
12059,0.000777,172.217.194.0-255,5738,152284,6,220585
12060,0.000783,172.217.194.0-255,4320,156604,6,220585
12061,0.000801,172.217.194.0-255,7156,163760,6,220585
12062,0.00083,172.217.194.0-255,5738,169498,6,220585
12063,0.000855,172.217.194.0-255,6438,175936,6,220585
12064,0.000874,172.217.194.0-255,8574,184510,6,220585
12065,0.0009,172.217.194.0-255,4320,188830,6,220585
12066,0.000907,172.217.194.0-255,7156,195986,6,220585
12067,0.000931,172.31.36.0-255,66,196052,6,220585
12068,0.000996,172.217.194.0-255,8574,204626,6,220585
12069,0.001004,172.31.36.0-255,66,204692,6,220585
12070,0.001036,172.217.194.0-255,5738,210430,6,220585
12071,0.001068,172.217.194.0-255,9984,220414,6,220585
12072,0.001071,172.217.194.0-255,105,220519,6,220585
12073,0.001096,172.31.36.0-255,66,220585,6,220585
12074,0.0,74.125.24.0-255,153,153,6,340203
12075,2.4e-05,172.31.36.0-255,66,219,6,340203
12076,4.3e-05,74.125.24.0-255,1484,1703,6,340203
12077,5.5e-05,172.31.36.0-255,66,1769,6,340203
12078,6.1e-05,74.125.24.0-255,2902,4671,6,340203
12079,6.5e-05,172.31.36.0-255,66,4737,6,340203
12080,6.9e-05,74.125.24.0-255,2902,7639,6,340203
12081,7.2e-05,172.31.36.0-255,66,7705,6,340203
12082,0.000101,74.125.24.0-255,2902,10607,6,340203
12083,0.000104,172.31.36.0-255,66,10673,6,340203
12084,0.000145,74.125.24.0-255,7686,18359,6,340203
12085,0.000149,172.31.36.0-255,66,18425,6,340203
12086,0.000159,74.125.24.0-255,7156,25581,6,340203
12087,0.000161,172.31.36.0-255,66,25647,6,340203
12088,0.000169,74.125.24.0-255,5379,31026,6,340203
12089,0.000172,172.31.36.0-255,66,31092,6,340203
12090,0.000998,74.125.24.0-255,1484,32576,6,340203
12091,0.001006,172.31.36.0-255,66,32642,6,340203
12092,0.001016,74.125.24.0-255,2902,35544,6,340203
12093,0.001018,172.31.36.0-255,66,35610,6,340203
12094,0.00103,74.125.24.0-255,4320,39930,6,340203
12095,0.001033,172.31.36.0-255,66,39996,6,340203
12096,0.001039,74.125.24.0-255,5738,45734,6,340203
12097,0.001041,172.31.36.0-255,66,45800,6,340203
12098,0.001088,172.31.36.0-255,66,45866,6,340203
12099,0.001096,74.125.24.0-255,7856,53722,6,340203
12100,0.001098,172.31.36.0-255,66,53788,6,340203
12101,0.001782,74.125.24.0-255,394,54182,6,340203
12102,0.001786,172.31.36.0-255,66,54248,6,340203
12103,0.001809,74.125.24.0-255,1484,55732,6,340203
12104,0.001811,172.31.36.0-255,66,55798,6,340203
12105,0.001838,74.125.24.0-255,4320,60118,6,340203
12106,0.001841,172.31.36.0-255,66,60184,6,340203
12107,0.001849,74.125.24.0-255,7156,67340,6,340203
12108,0.001851,172.31.36.0-255,66,67406,6,340203
12109,0.001888,74.125.24.0-255,5738,73144,6,340203
12110,0.001891,172.31.36.0-255,66,73210,6,340203
12111,0.001923,74.125.24.0-255,9992,83202,6,340203
12112,0.001926,172.31.36.0-255,66,83268,6,340203
12113,0.001929,74.125.24.0-255,1484,84752,6,340203
12114,0.001946,74.125.24.0-255,3602,88354,6,340203
12115,0.001948,172.31.36.0-255,66,88420,6,340203
12116,0.002359,74.125.24.0-255,1484,89904,6,340203
12117,0.002378,74.125.24.0-255,2902,92806,6,340203
12118,0.00238,172.31.36.0-255,66,92872,6,340203
12119,0.0024,74.125.24.0-255,5738,98610,6,340203
12120,0.002403,172.31.36.0-255,66,98676,6,340203
12121,0.00244,172.31.36.0-255,66,98742,6,340203
12122,0.002446,74.125.24.0-255,4320,103062,6,340203
12123,0.002448,172.31.36.0-255,66,103128,6,340203
12124,0.002509,74.125.24.0-255,6438,109566,6,340203
12125,0.002512,172.31.36.0-255,66,109632,6,340203
12126,0.00254,74.125.24.0-255,2902,112534,6,340203
12127,0.002543,172.31.36.0-255,66,112600,6,340203
12128,0.002559,74.125.24.0-255,4320,116920,6,340203
12129,0.002562,172.31.36.0-255,66,116986,6,340203
12130,0.002585,74.125.24.0-255,8574,125560,6,340203
12131,0.002587,172.31.36.0-255,66,125626,6,340203
12132,0.002594,74.125.24.0-255,7156,132782,6,340203
12133,0.002596,172.31.36.0-255,66,132848,6,340203
12134,0.002599,74.125.24.0-255,1484,134332,6,340203
12135,0.002625,74.125.24.0-255,7156,141488,6,340203
12136,0.002634,172.31.36.0-255,66,141554,6,340203
12137,0.002638,74.125.24.0-255,2184,143738,6,340203
12138,0.002639,172.31.36.0-255,66,143804,6,340203
12139,0.002677,74.125.24.0-255,2902,146706,6,340203
12140,0.002679,172.31.36.0-255,66,146772,6,340203
12141,0.002686,74.125.24.0-255,7156,153928,6,340203
12142,0.002688,172.31.36.0-255,66,153994,6,340203
12143,0.002715,74.125.24.0-255,8574,162568,6,340203
12144,0.002717,172.31.36.0-255,66,162634,6,340203
12145,0.002752,74.125.24.0-255,1484,164118,6,340203
12146,0.002767,74.125.24.0-255,7156,171274,6,340203
12147,0.002769,172.31.36.0-255,66,171340,6,340203
12148,0.002799,74.125.24.0-255,6438,177778,6,340203
12149,0.002802,172.31.36.0-255,66,177844,6,340203
12150,0.002808,74.125.24.0-255,5738,183582,6,340203
12151,0.002811,172.31.36.0-255,66,183648,6,340203
12152,0.002818,74.125.24.0-255,7156,190804,6,340203
12153,0.002821,172.31.36.0-255,66,190870,6,340203
12154,0.002857,74.125.24.0-255,7156,198026,6,340203
12155,0.002861,172.31.36.0-255,66,198092,6,340203
12156,0.002893,74.125.24.0-255,7156,205248,6,340203
12157,0.002897,172.31.36.0-255,66,205314,6,340203
12158,0.002902,74.125.24.0-255,4320,209634,6,340203
12159,0.002904,172.31.36.0-255,66,209700,6,340203
12160,0.002928,74.125.24.0-255,2184,211884,6,340203
12161,0.002932,172.31.36.0-255,66,211950,6,340203
12162,0.002939,74.125.24.0-255,7156,219106,6,340203
12163,0.002942,172.31.36.0-255,66,219172,6,340203
12164,0.002946,74.125.24.0-255,2902,222074,6,340203
12165,0.00295,172.31.36.0-255,66,222140,6,340203
12166,0.002976,74.125.24.0-255,2902,225042,6,340203
12167,0.00298,172.31.36.0-255,66,225108,6,340203
12168,0.002992,74.125.24.0-255,7156,232264,6,340203
12169,0.002995,172.31.36.0-255,66,232330,6,340203
12170,0.003032,74.125.24.0-255,7156,239486,6,340203
12171,0.003036,172.31.36.0-255,66,239552,6,340203
12172,0.003042,74.125.24.0-255,5738,245290,6,340203
12173,0.003046,172.31.36.0-255,66,245356,6,340203
12174,0.003067,74.125.24.0-255,4320,249676,6,340203
12175,0.00307,172.31.36.0-255,66,249742,6,340203
12176,0.003122,74.125.24.0-255,6438,256180,6,340203
12177,0.003126,172.31.36.0-255,66,256246,6,340203
12178,0.003155,172.31.36.0-255,66,256312,6,340203
12179,0.003506,172.31.36.0-255,66,256378,6,340203
12180,0.003931,74.125.24.0-255,1484,257862,6,340203
12181,0.003946,74.125.24.0-255,2902,260764,6,340203
12182,0.00395,172.31.36.0-255,66,260830,6,340203
12183,0.003955,74.125.24.0-255,1484,262314,6,340203
12184,0.004017,74.125.24.0-255,5738,268052,6,340203
12185,0.00402,172.31.36.0-255,66,268118,6,340203
12186,0.00403,74.125.24.0-255,9992,278110,6,340203
12187,0.004032,172.31.36.0-255,66,278176,6,340203
12188,0.00405,172.31.36.0-255,66,278242,6,340203
12189,0.004053,74.125.24.0-255,766,279008,6,340203
12190,0.004081,74.125.24.0-255,1484,280492,6,340203
12191,0.004084,172.31.36.0-255,66,280558,6,340203
12192,0.00409,74.125.24.0-255,4320,284878,6,340203
12193,0.004093,172.31.36.0-255,66,284944,6,340203
12194,0.004129,74.125.24.0-255,9992,294936,6,340203
12195,0.004132,172.31.36.0-255,66,295002,6,340203
12196,0.004162,74.125.24.0-255,8574,303576,6,340203
12197,0.004166,172.31.36.0-255,66,303642,6,340203
12198,0.004178,74.125.24.0-255,2902,306544,6,340203
12199,0.004185,172.31.36.0-255,66,306610,6,340203
12200,0.004191,74.125.24.0-255,4320,310930,6,340203
12201,0.004193,172.31.36.0-255,66,310996,6,340203
12202,0.004222,74.125.24.0-255,2184,313180,6,340203
12203,0.004226,172.31.36.0-255,66,313246,6,340203
12204,0.004427,74.125.24.0-255,1484,314730,6,340203
12205,0.004433,74.125.24.0-255,2902,317632,6,340203
12206,0.004436,172.31.36.0-255,66,317698,6,340203
12207,0.004443,74.125.24.0-255,5738,323436,6,340203
12208,0.004445,172.31.36.0-255,66,323502,6,340203
12209,0.004466,74.125.24.0-255,4320,327822,6,340203
12210,0.004469,172.31.36.0-255,66,327888,6,340203
12211,0.0045,74.125.24.0-255,5738,333626,6,340203
12212,0.004504,172.31.36.0-255,66,333692,6,340203
12213,0.004509,74.125.24.0-255,4320,338012,6,340203
12214,0.004512,74.125.24.0-255,1717,339729,6,340203
12215,0.004512,172.31.36.0-255,66,339795,6,340203
12216,0.004516,172.31.36.0-255,66,339861,6,340203
12217,0.00455,74.125.24.0-255,105,339966,6,340203
12218,0.006102,172.31.36.0-255,66,340032,6,340203
12219,0.006129,172.31.36.0-255,105,340137,6,340203
12220,0.008209,74.125.24.0-255,66,340203,6,340203
12221,0.0,172.217.194.0-255,299,299,6,219042
12222,3.5e-05,172.31.36.0-255,66,365,6,219042
12223,4.1e-05,172.217.194.0-255,1484,1849,6,219042
12224,4.5e-05,172.31.36.0-255,66,1915,6,219042
12225,5.1e-05,172.217.194.0-255,4320,6235,6,219042
12226,5.4e-05,172.31.36.0-255,66,6301,6,219042
12227,6.3e-05,172.217.194.0-255,8859,15160,6,219042
12228,6.6e-05,172.31.36.0-255,66,15226,6,219042
12229,7.4e-05,172.217.194.0-255,8574,23800,6,219042
12230,7.7e-05,172.31.36.0-255,66,23866,6,219042
12231,0.000103,172.217.194.0-255,6797,30663,6,219042
12232,0.000107,172.31.36.0-255,66,30729,6,219042
12233,0.000144,172.217.194.0-255,1484,32213,6,219042
12234,0.000147,172.31.36.0-255,66,32279,6,219042
12235,0.000153,172.217.194.0-255,2902,35181,6,219042
12236,0.000155,172.31.36.0-255,66,35247,6,219042
12237,0.000162,172.217.194.0-255,5738,40985,6,219042
12238,0.000165,172.31.36.0-255,66,41051,6,219042
12239,0.000192,172.217.194.0-255,7156,48207,6,219042
12240,0.000195,172.31.36.0-255,66,48273,6,219042
12241,0.00022,172.217.194.0-255,6797,55070,6,219042
12242,0.000223,172.31.36.0-255,66,55136,6,219042
12243,0.000233,172.217.194.0-255,9925,65061,6,219042
12244,0.000235,172.31.36.0-255,66,65127,6,219042
12245,0.000252,172.217.194.0-255,98,65225,6,219042
12246,0.000255,172.31.36.0-255,66,65291,6,219042
12247,0.000399,172.217.194.0-255,366,65657,6,219042
12248,0.000404,172.31.36.0-255,66,65723,6,219042
12249,0.000579,172.217.194.0-255,1484,67207,6,219042
12250,0.000584,172.31.36.0-255,66,67273,6,219042
12251,0.000589,172.217.194.0-255,2902,70175,6,219042
12252,0.000593,172.217.194.0-255,2902,73077,6,219042
12253,0.000593,172.31.36.0-255,66,73143,6,219042
12254,0.000598,172.31.36.0-255,66,73209,6,219042
12255,0.000607,172.217.194.0-255,2902,76111,6,219042
12256,0.000611,172.31.36.0-255,66,76177,6,219042
12257,0.000616,172.217.194.0-255,4320,80497,6,219042
12258,0.000619,172.31.36.0-255,66,80563,6,219042
12259,0.000637,172.217.194.0-255,8574,89137,6,219042
12260,0.00064,172.31.36.0-255,66,89203,6,219042
12261,0.000649,172.217.194.0-255,9992,99195,6,219042
12262,0.000652,172.31.36.0-255,66,99261,6,219042
12263,0.000705,172.217.194.0-255,766,100027,6,219042
12264,0.000835,172.217.194.0-255,1484,101511,6,219042
12265,0.000839,172.31.36.0-255,66,101577,6,219042
12266,0.000861,172.217.194.0-255,2902,104479,6,219042
12267,0.000865,172.31.36.0-255,66,104545,6,219042
12268,0.000869,172.217.194.0-255,2902,107447,6,219042
12269,0.000871,172.31.36.0-255,66,107513,6,219042
12270,0.000898,172.217.194.0-255,2902,110415,6,219042
12271,0.000901,172.31.36.0-255,66,110481,6,219042
12272,0.00091,172.217.194.0-255,9992,120473,6,219042
12273,0.000913,172.31.36.0-255,66,120539,6,219042
12274,0.000926,172.31.36.0-255,66,120605,6,219042
12275,0.000943,172.217.194.0-255,2184,122789,6,219042
12276,0.000945,172.31.36.0-255,66,122855,6,219042
12277,0.001109,172.217.194.0-255,1484,124339,6,219042
12278,0.001115,172.217.194.0-255,2902,127241,6,219042
12279,0.001119,172.31.36.0-255,66,127307,6,219042
12280,0.001123,172.217.194.0-255,2902,130209,6,219042
12281,0.001126,172.31.36.0-255,66,130275,6,219042
12282,0.001143,172.217.194.0-255,2902,133177,6,219042
12283,0.001145,172.31.36.0-255,66,133243,6,219042
12284,0.001154,172.217.194.0-255,9992,143235,6,219042
12285,0.001157,172.31.36.0-255,66,143301,6,219042
12286,0.001207,172.31.36.0-255,66,143367,6,219042
12287,0.001227,172.217.194.0-255,2184,145551,6,219042
12288,0.001231,172.31.36.0-255,66,145617,6,219042
12289,0.001276,172.217.194.0-255,1484,147101,6,219042
12290,0.001281,172.217.194.0-255,1484,148585,6,219042
12291,0.001284,172.31.36.0-255,66,148651,6,219042
12292,0.001306,172.217.194.0-255,1484,150135,6,219042
12293,0.001313,172.217.194.0-255,5738,155873,6,219042
12294,0.001315,172.31.36.0-255,66,155939,6,219042
12295,0.00133,172.31.36.0-255,66,156005,6,219042
12296,0.001369,172.217.194.0-255,10692,166697,6,219042
12297,0.001372,172.31.36.0-255,66,166763,6,219042
12298,0.001653,172.217.194.0-255,1484,168247,6,219042
12299,0.001659,172.217.194.0-255,2902,171149,6,219042
12300,0.001662,172.31.36.0-255,66,171215,6,219042
12301,0.001668,172.217.194.0-255,4320,175535,6,219042
12302,0.001671,172.31.36.0-255,66,175601,6,219042
12303,0.001695,172.217.194.0-255,1484,177085,6,219042
12304,0.00171,172.31.36.0-255,66,177151,6,219042
12305,0.001718,172.217.194.0-255,8574,185725,6,219042
12306,0.00172,172.31.36.0-255,66,185791,6,219042
12307,0.001745,172.217.194.0-255,2184,187975,6,219042
12308,0.001748,172.31.36.0-255,66,188041,6,219042
12309,0.001899,172.217.194.0-255,1484,189525,6,219042
12310,0.001905,172.217.194.0-255,2902,192427,6,219042
12311,0.001908,172.31.36.0-255,66,192493,6,219042
12312,0.001915,172.217.194.0-255,5738,198231,6,219042
12313,0.001917,172.31.36.0-255,66,198297,6,219042
12314,0.001932,172.217.194.0-255,1484,199781,6,219042
12315,0.001961,172.31.36.0-255,66,199847,6,219042
12316,0.001965,172.217.194.0-255,1484,201331,6,219042
12317,0.002012,172.31.36.0-255,66,201397,6,219042
12318,0.002025,172.31.36.0-255,66,201463,6,219042
12319,0.002089,172.31.36.0-255,66,201529,6,219042
12320,0.004073,172.217.194.0-255,5738,207267,6,219042
12321,0.004082,172.31.36.0-255,66,207333,6,219042
12322,0.006077,172.217.194.0-255,5738,213071,6,219042
12323,0.006084,172.31.36.0-255,66,213137,6,219042
12324,0.008101,172.217.194.0-255,5738,218875,6,219042
12325,0.008107,172.31.36.0-255,66,218941,6,219042
12326,0.008246,172.31.36.0-255,101,219042,6,219042
12327,0.0,74.125.24.0-255,146,146,6,278956
12328,2.6e-05,172.31.36.0-255,66,212,6,278956
12329,3.2e-05,74.125.24.0-255,1484,1696,6,278956
12330,3.6e-05,172.31.36.0-255,66,1762,6,278956
12331,4e-05,74.125.24.0-255,2902,4664,6,278956
12332,5.1e-05,172.31.36.0-255,66,4730,6,278956
12333,5.6e-05,74.125.24.0-255,4320,9050,6,278956
12334,5.9e-05,172.31.36.0-255,66,9116,6,278956
12335,8.8e-05,74.125.24.0-255,2902,12018,6,278956
12336,9.1e-05,172.31.36.0-255,66,12084,6,278956
12337,9.7e-05,74.125.24.0-255,4924,17008,6,278956
12338,0.0001,172.31.36.0-255,66,17074,6,278956
12339,0.000105,74.125.24.0-255,4320,21394,6,278956
12340,0.000107,172.31.36.0-255,66,21460,6,278956
12341,0.000146,74.125.24.0-255,9633,31093,6,278956
12342,0.000151,172.31.36.0-255,66,31159,6,278956
12343,0.000181,74.125.24.0-255,1484,32643,6,278956
12344,0.000185,172.31.36.0-255,66,32709,6,278956
12345,0.000191,74.125.24.0-255,2902,35611,6,278956
12346,0.000193,172.31.36.0-255,66,35677,6,278956
12347,0.000206,74.125.24.0-255,4320,39997,6,278956
12348,0.000209,172.31.36.0-255,66,40063,6,278956
12349,0.000237,74.125.24.0-255,1484,41547,6,278956
12350,0.000239,172.31.36.0-255,66,41613,6,278956
12351,0.00025,74.125.24.0-255,9633,51246,6,278956
12352,0.000253,172.31.36.0-255,66,51312,6,278956
12353,0.000261,74.125.24.0-255,9992,61304,6,278956
12354,0.000264,172.31.36.0-255,66,61370,6,278956
12355,0.000269,74.125.24.0-255,3961,65331,6,278956
12356,0.000271,172.31.36.0-255,66,65397,6,278956
12357,0.000714,74.125.24.0-255,645,66042,6,278956
12358,0.000719,172.31.36.0-255,66,66108,6,278956
12359,0.000793,74.125.24.0-255,1484,67592,6,278956
12360,0.0008,74.125.24.0-255,2902,70494,6,278956
12361,0.000804,172.31.36.0-255,66,70560,6,278956
12362,0.000812,74.125.24.0-255,5738,76298,6,278956
12363,0.000814,172.31.36.0-255,66,76364,6,278956
12364,0.000847,74.125.24.0-255,5738,82102,6,278956
12365,0.00085,172.31.36.0-255,66,82168,6,278956
12366,0.000865,74.125.24.0-255,2902,85070,6,278956
12367,0.000868,172.31.36.0-255,66,85136,6,278956
12368,0.00091,172.31.36.0-255,66,85202,6,278956
12369,0.001074,74.125.24.0-255,1484,86686,6,278956
12370,0.001078,74.125.24.0-255,1484,88170,6,278956
12371,0.001081,172.31.36.0-255,66,88236,6,278956
12372,0.00111,74.125.24.0-255,1484,89720,6,278956
12373,0.001117,74.125.24.0-255,5738,95458,6,278956
12374,0.001119,172.31.36.0-255,66,95524,6,278956
12375,0.001124,74.125.24.0-255,4320,99844,6,278956
12376,0.001134,172.31.36.0-255,66,99910,6,278956
12377,0.001155,74.125.24.0-255,8574,108484,6,278956
12378,0.00116,172.31.36.0-255,66,108550,6,278956
12379,0.001163,74.125.24.0-255,8574,117124,6,278956
12380,0.001165,172.31.36.0-255,66,117190,6,278956
12381,0.001195,74.125.24.0-255,2184,119374,6,278956
12382,0.001198,172.31.36.0-255,66,119440,6,278956
12383,0.001414,74.125.24.0-255,1484,120924,6,278956
12384,0.001424,74.125.24.0-255,2902,123826,6,278956
12385,0.001428,172.31.36.0-255,66,123892,6,278956
12386,0.001434,74.125.24.0-255,2902,126794,6,278956
12387,0.001436,172.31.36.0-255,66,126860,6,278956
12388,0.001462,74.125.24.0-255,2902,129762,6,278956
12389,0.001465,172.31.36.0-255,66,129828,6,278956
12390,0.001484,172.31.36.0-255,66,129894,6,278956
12391,0.001492,74.125.24.0-255,7156,137050,6,278956
12392,0.001494,172.31.36.0-255,66,137116,6,278956
12393,0.001538,74.125.24.0-255,3602,140718,6,278956
12394,0.001543,172.31.36.0-255,66,140784,6,278956
12395,0.001595,74.125.24.0-255,1484,142268,6,278956
12396,0.001601,74.125.24.0-255,2902,145170,6,278956
12397,0.001604,172.31.36.0-255,66,145236,6,278956
12398,0.00161,74.125.24.0-255,4320,149556,6,278956
12399,0.001612,172.31.36.0-255,66,149622,6,278956
12400,0.001634,74.125.24.0-255,1484,151106,6,278956
12401,0.001646,74.125.24.0-255,5738,156844,6,278956
12402,0.001649,172.31.36.0-255,66,156910,6,278956
12403,0.001663,172.31.36.0-255,66,156976,6,278956
12404,0.001699,74.125.24.0-255,5020,161996,6,278956
12405,0.001704,172.31.36.0-255,66,162062,6,278956
12406,0.001974,74.125.24.0-255,1484,163546,6,278956
12407,0.001981,74.125.24.0-255,2902,166448,6,278956
12408,0.001986,172.31.36.0-255,66,166514,6,278956
12409,0.001989,74.125.24.0-255,1484,167998,6,278956
12410,0.00202,74.125.24.0-255,4320,172318,6,278956
12411,0.002024,172.31.36.0-255,66,172384,6,278956
12412,0.002033,74.125.24.0-255,9992,182376,6,278956
12413,0.002036,172.31.36.0-255,66,182442,6,278956
12414,0.00207,74.125.24.0-255,2902,185344,6,278956
12415,0.002074,172.31.36.0-255,66,185410,6,278956
12416,0.002081,74.125.24.0-255,7156,192566,6,278956
12417,0.002084,172.31.36.0-255,66,192632,6,278956
12418,0.002087,74.125.24.0-255,1484,194116,6,278956
12419,0.002109,74.125.24.0-255,2184,196300,6,278956
12420,0.002116,172.31.36.0-255,66,196366,6,278956
12421,0.002217,74.125.24.0-255,1484,197850,6,278956
12422,0.002222,74.125.24.0-255,2902,200752,6,278956
12423,0.002226,172.31.36.0-255,66,200818,6,278956
12424,0.00224,74.125.24.0-255,5738,206556,6,278956
12425,0.002248,172.31.36.0-255,66,206622,6,278956
12426,0.002285,74.125.24.0-255,9992,216614,6,278956
12427,0.002288,172.31.36.0-255,66,216680,6,278956
12428,0.00232,74.125.24.0-255,2902,219582,6,278956
12429,0.002323,172.31.36.0-255,66,219648,6,278956
12430,0.002334,74.125.24.0-255,10692,230340,6,278956
12431,0.002337,172.31.36.0-255,66,230406,6,278956
12432,0.002349,172.31.36.0-255,66,230472,6,278956
12433,0.002395,74.125.24.0-255,5738,236210,6,278956
12434,0.002399,172.31.36.0-255,66,236276,6,278956
12435,0.00243,74.125.24.0-255,7156,243432,6,278956
12436,0.002433,74.125.24.0-255,1484,244916,6,278956
12437,0.002434,172.31.36.0-255,66,244982,6,278956
12438,0.002457,74.125.24.0-255,7856,252838,6,278956
12439,0.00246,172.31.36.0-255,66,252904,6,278956
12440,0.002468,74.125.24.0-255,8574,261478,6,278956
12441,0.00247,172.31.36.0-255,66,261544,6,278956
12442,0.004793,74.125.24.0-255,5738,267282,6,278956
12443,0.004799,172.31.36.0-255,66,267348,6,278956
12444,0.007123,74.125.24.0-255,5738,273086,6,278956
12445,0.00713,172.31.36.0-255,66,273152,6,278956
12446,0.009457,74.125.24.0-255,5738,278890,6,278956
12447,0.009465,172.31.36.0-255,66,278956,6,278956
12448,0.0,172.217.194.0-255,153,153,6,70476
12449,3.4e-05,172.31.36.0-255,66,219,6,70476
12450,4.2e-05,172.217.194.0-255,1484,1703,6,70476
12451,4.8e-05,172.31.36.0-255,66,1769,6,70476
12452,5.3e-05,172.217.194.0-255,2902,4671,6,70476
12453,5.5e-05,172.31.36.0-255,66,4737,6,70476
12454,6.1e-05,172.217.194.0-255,5738,10475,6,70476
12455,6.4e-05,172.31.36.0-255,66,10541,6,70476
12456,8.9e-05,172.217.194.0-255,3437,13978,6,70476
12457,9.2e-05,172.31.36.0-255,66,14044,6,70476
12458,0.000111,172.217.194.0-255,4320,18364,6,70476
12459,0.000113,172.31.36.0-255,66,18430,6,70476
12460,0.000137,172.217.194.0-255,5738,24168,6,70476
12461,0.00014,172.31.36.0-255,66,24234,6,70476
12462,0.000159,172.217.194.0-255,2902,27136,6,70476
12463,0.000161,172.31.36.0-255,66,27202,6,70476
12464,0.000189,172.217.194.0-255,2902,30104,6,70476
12465,0.000192,172.31.36.0-255,66,30170,6,70476
12466,0.000217,172.217.194.0-255,9992,40162,6,70476
12467,0.00022,172.31.36.0-255,66,40228,6,70476
12468,0.000237,172.217.194.0-255,5738,45966,6,70476
12469,0.000241,172.31.36.0-255,66,46032,6,70476
12470,0.000263,172.217.194.0-255,2184,48216,6,70476
12471,0.000265,172.31.36.0-255,66,48282,6,70476
12472,0.003802,172.217.194.0-255,1484,49766,6,70476
12473,0.003808,172.31.36.0-255,66,49832,6,70476
12474,0.003817,172.217.194.0-255,2902,52734,6,70476
12475,0.003819,172.31.36.0-255,66,52800,6,70476
12476,0.003823,172.217.194.0-255,1484,54284,6,70476
12477,0.003825,172.31.36.0-255,66,54350,6,70476
12478,0.005856,172.217.194.0-255,4320,58670,6,70476
12479,0.005862,172.31.36.0-255,66,58736,6,70476
12480,0.005882,172.217.194.0-255,1484,60220,6,70476
12481,0.007868,172.217.194.0-255,4320,64540,6,70476
12482,0.007876,172.31.36.0-255,66,64606,6,70476
12483,0.009913,172.217.194.0-255,4320,68926,6,70476
12484,0.00992,172.31.36.0-255,66,68992,6,70476
12485,0.009941,172.217.194.0-255,1484,70476,6,70476
12486,0.0,74.125.200.0-255,289,289,6,179082
12487,1.5e-05,172.31.36.0-255,66,355,6,179082
12488,2.2e-05,74.125.200.0-255,1484,1839,6,179082
12489,2.6e-05,172.31.36.0-255,66,1905,6,179082
12490,3.2e-05,74.125.200.0-255,2902,4807,6,179082
12491,3.6e-05,172.31.36.0-255,66,4873,6,179082
12492,4.3e-05,74.125.200.0-255,5738,10611,6,179082
12493,4.6e-05,172.31.36.0-255,66,10677,6,179082
12494,9.1e-05,74.125.200.0-255,7423,18100,6,179082
12495,9.4e-05,172.31.36.0-255,66,18166,6,179082
12496,0.000102,74.125.200.0-255,8574,26740,6,179082
12497,0.000106,172.31.36.0-255,66,26806,6,179082
12498,0.000109,74.125.200.0-255,1484,28290,6,179082
12499,0.000111,172.31.36.0-255,66,28356,6,179082
12500,0.000135,74.125.200.0-255,2543,30899,6,179082
12501,0.000137,172.31.36.0-255,66,30965,6,179082
12502,0.000255,74.125.200.0-255,1484,32449,6,179082
12503,0.00026,172.31.36.0-255,66,32515,6,179082
12504,0.000264,74.125.200.0-255,1484,33999,6,179082
12505,0.000266,172.31.36.0-255,66,34065,6,179082
12506,0.000284,74.125.200.0-255,2902,36967,6,179082
12507,0.000287,172.31.36.0-255,66,37033,6,179082
12508,0.000303,74.125.200.0-255,4320,41353,6,179082
12509,0.000306,172.31.36.0-255,66,41419,6,179082
12510,0.000331,74.125.200.0-255,1484,42903,6,179082
12511,0.000333,172.31.36.0-255,66,42969,6,179082
12512,0.000339,74.125.200.0-255,5379,48348,6,179082
12513,0.000341,172.31.36.0-255,66,48414,6,179082
12514,0.000346,74.125.200.0-255,2902,51316,6,179082
12515,0.000348,172.31.36.0-255,66,51382,6,179082
12516,0.000369,74.125.200.0-255,2902,54284,6,179082
12517,0.000371,172.31.36.0-255,66,54350,6,179082
12518,0.00039,74.125.200.0-255,7156,61506,6,179082
12519,0.000393,172.31.36.0-255,66,61572,6,179082
12520,0.000418,74.125.200.0-255,4270,65842,6,179082
12521,0.00042,172.31.36.0-255,66,65908,6,179082
12522,0.000561,74.125.200.0-255,112,66020,6,179082
12523,0.000691,74.125.200.0-255,1484,67504,6,179082
12524,0.000695,172.31.36.0-255,66,67570,6,179082
12525,0.000699,74.125.200.0-255,1484,69054,6,179082
12526,0.000714,74.125.200.0-255,1484,70538,6,179082
12527,0.000716,172.31.36.0-255,66,70604,6,179082
12528,0.000723,74.125.200.0-255,5738,76342,6,179082
12529,0.000725,172.31.36.0-255,66,76408,6,179082
12530,0.000752,74.125.200.0-255,6797,83205,6,179082
12531,0.000755,172.31.36.0-255,66,83271,6,179082
12532,0.000774,74.125.200.0-255,2902,86173,6,179082
12533,0.000777,172.31.36.0-255,66,86239,6,179082
12534,0.000788,74.125.200.0-255,5738,91977,6,179082
12535,0.000791,172.31.36.0-255,66,92043,6,179082
12536,0.000809,74.125.200.0-255,4320,96363,6,179082
12537,0.000811,172.31.36.0-255,66,96429,6,179082
12538,0.000824,74.125.200.0-255,3961,100390,6,179082
12539,0.000827,172.31.36.0-255,66,100456,6,179082
12540,0.001664,74.125.200.0-255,1484,101940,6,179082
12541,0.001674,74.125.200.0-255,2902,104842,6,179082
12542,0.001678,172.31.36.0-255,66,104908,6,179082
12543,0.001684,74.125.200.0-255,2902,107810,6,179082
12544,0.001686,172.31.36.0-255,66,107876,6,179082
12545,0.00169,74.125.200.0-255,1484,109360,6,179082
12546,0.001707,74.125.200.0-255,2902,112262,6,179082
12547,0.001709,172.31.36.0-255,66,112328,6,179082
12548,0.001735,74.125.200.0-255,8574,120902,6,179082
12549,0.001738,172.31.36.0-255,66,120968,6,179082
12550,0.001746,74.125.200.0-255,7156,128124,6,179082
12551,0.001748,172.31.36.0-255,66,128190,6,179082
12552,0.001793,74.125.200.0-255,4320,132510,6,179082
12553,0.001796,172.31.36.0-255,66,132576,6,179082
12554,0.001814,74.125.200.0-255,2184,134760,6,179082
12555,0.001817,172.31.36.0-255,66,134826,6,179082
12556,0.001873,74.125.200.0-255,1484,136310,6,179082
12557,0.001898,74.125.200.0-255,2902,139212,6,179082
12558,0.001901,172.31.36.0-255,66,139278,6,179082
12559,0.001905,74.125.200.0-255,1484,140762,6,179082
12560,0.001921,74.125.200.0-255,4320,145082,6,179082
12561,0.001923,172.31.36.0-255,66,145148,6,179082
12562,0.001953,74.125.200.0-255,5738,150886,6,179082
12563,0.001956,172.31.36.0-255,66,150952,6,179082
12564,0.001972,74.125.200.0-255,1484,152436,6,179082
12565,0.002002,74.125.200.0-255,2902,155338,6,179082
12566,0.002005,172.31.36.0-255,66,155404,6,179082
12567,0.003929,74.125.200.0-255,1484,156888,6,179082
12568,0.003976,74.125.200.0-255,1484,158372,6,179082
12569,0.003981,172.31.36.0-255,66,158438,6,179082
12570,0.003997,74.125.200.0-255,2902,161340,6,179082
12571,0.004,172.31.36.0-255,66,161406,6,179082
12572,0.005963,74.125.200.0-255,2902,164308,6,179082
12573,0.005971,172.31.36.0-255,66,164374,6,179082
12574,0.005993,74.125.200.0-255,2902,167276,6,179082
12575,0.005996,172.31.36.0-255,66,167342,6,179082
12576,0.007956,74.125.200.0-255,2902,170244,6,179082
12577,0.007962,172.31.36.0-255,66,170310,6,179082
12578,0.007983,74.125.200.0-255,2902,173212,6,179082
12579,0.007985,172.31.36.0-255,66,173278,6,179082
12580,0.00995,74.125.200.0-255,5738,179016,6,179082
12581,0.009958,172.31.36.0-255,66,179082,6,179082
12582,0.0,172.217.194.0-255,159,159,6,287777
12583,1.9e-05,172.31.36.0-255,66,225,6,287777
12584,2.7e-05,172.217.194.0-255,1484,1709,6,287777
12585,3.2e-05,172.31.36.0-255,66,1775,6,287777
12586,3.8e-05,172.217.194.0-255,2902,4677,6,287777
12587,4e-05,172.31.36.0-255,66,4743,6,287777
12588,4.8e-05,172.217.194.0-255,7156,11899,6,287777
12589,5.1e-05,172.31.36.0-255,66,11965,6,287777
12590,8.1e-05,172.217.194.0-255,2015,13980,6,287777
12591,8.4e-05,172.31.36.0-255,66,14046,6,287777
12592,0.000117,172.217.194.0-255,2902,16948,6,287777
12593,0.00012,172.31.36.0-255,66,17014,6,287777
12594,0.000145,172.217.194.0-255,4320,21334,6,287777
12595,0.000147,172.31.36.0-255,66,21400,6,287777
12596,0.00017,172.217.194.0-255,2902,24302,6,287777
12597,0.000172,172.31.36.0-255,66,24368,6,287777
12598,0.00019,172.217.194.0-255,5738,30106,6,287777
12599,0.000193,172.31.36.0-255,66,30172,6,287777
12600,0.000196,172.217.194.0-255,1125,31297,6,287777
12601,0.000198,172.31.36.0-255,66,31363,6,287777
12602,0.000277,172.217.194.0-255,1484,32847,6,287777
12603,0.000281,172.31.36.0-255,66,32913,6,287777
12604,0.000286,172.217.194.0-255,2902,35815,6,287777
12605,0.000289,172.31.36.0-255,66,35881,6,287777
12606,0.00031,172.217.194.0-255,5738,41619,6,287777
12607,0.000313,172.31.36.0-255,66,41685,6,287777
12608,0.000321,172.217.194.0-255,6797,48482,6,287777
12609,0.000323,172.31.36.0-255,66,48548,6,287777
12610,0.000353,172.217.194.0-255,8574,57122,6,287777
12611,0.000356,172.31.36.0-255,66,57188,6,287777
12612,0.000384,172.217.194.0-255,5738,62926,6,287777
12613,0.000387,172.31.36.0-255,66,62992,6,287777
12614,0.000392,172.217.194.0-255,2543,65535,6,287777
12615,0.000394,172.31.36.0-255,66,65601,6,287777
12616,0.000397,172.217.194.0-255,364,65965,6,287777
12617,0.000619,172.217.194.0-255,382,66347,6,287777
12618,0.001041,172.217.194.0-255,1484,67831,6,287777
12619,0.001046,172.31.36.0-255,66,67897,6,287777
12620,0.00105,172.217.194.0-255,1484,69381,6,287777
12621,0.00107,172.217.194.0-255,1484,70865,6,287777
12622,0.001072,172.31.36.0-255,66,70931,6,287777
12623,0.001079,172.217.194.0-255,5738,76669,6,287777
12624,0.001081,172.31.36.0-255,66,76735,6,287777
12625,0.001087,172.217.194.0-255,4320,81055,6,287777
12626,0.001089,172.31.36.0-255,66,81121,6,287777
12627,0.001118,172.217.194.0-255,1484,82605,6,287777
12628,0.001133,172.31.36.0-255,66,82671,6,287777
12629,0.00114,172.217.194.0-255,5020,87691,6,287777
12630,0.001142,172.31.36.0-255,66,87757,6,287777
12631,0.001493,172.217.194.0-255,1484,89241,6,287777
12632,0.001502,172.217.194.0-255,2902,92143,6,287777
12633,0.001506,172.31.36.0-255,66,92209,6,287777
12634,0.001546,172.217.194.0-255,5738,97947,6,287777
12635,0.001549,172.31.36.0-255,66,98013,6,287777
12636,0.001554,172.217.194.0-255,4320,102333,6,287777
12637,0.001557,172.31.36.0-255,66,102399,6,287777
12638,0.001565,172.217.194.0-255,7156,109555,6,287777
12639,0.001567,172.31.36.0-255,66,109621,6,287777
12640,0.001591,172.217.194.0-255,4320,113941,6,287777
12641,0.001594,172.31.36.0-255,66,114007,6,287777
12642,0.001602,172.217.194.0-255,7856,121863,6,287777
12643,0.001603,172.31.36.0-255,66,121929,6,287777
12644,0.001696,172.217.194.0-255,1484,123413,6,287777
12645,0.001703,172.217.194.0-255,2902,126315,6,287777
12646,0.001706,172.31.36.0-255,66,126381,6,287777
12647,0.00173,172.217.194.0-255,5738,132119,6,287777
12648,0.001733,172.31.36.0-255,66,132185,6,287777
12649,0.001737,172.217.194.0-255,2902,135087,6,287777
12650,0.00174,172.31.36.0-255,66,135153,6,287777
12651,0.001786,172.217.194.0-255,9992,145145,6,287777
12652,0.001789,172.31.36.0-255,66,145211,6,287777
12653,0.001794,172.217.194.0-255,2902,148113,6,287777
12654,0.001797,172.31.36.0-255,66,148179,6,287777
12655,0.001817,172.217.194.0-255,7856,156035,6,287777
12656,0.001819,172.31.36.0-255,66,156101,6,287777
12657,0.001847,172.217.194.0-255,1484,157585,6,287777
12658,0.001861,172.217.194.0-255,2902,160487,6,287777
12659,0.001864,172.31.36.0-255,66,160553,6,287777
12660,0.001868,172.217.194.0-255,1484,162037,6,287777
12661,0.001906,172.217.194.0-255,4320,166357,6,287777
12662,0.00191,172.31.36.0-255,66,166423,6,287777
12663,0.001927,172.31.36.0-255,66,166489,6,287777
12664,0.001971,172.31.36.0-255,66,166555,6,287777
12665,0.002,172.217.194.0-255,1484,168039,6,287777
12666,0.002006,172.217.194.0-255,2902,170941,6,287777
12667,0.002008,172.31.36.0-255,66,171007,6,287777
12668,0.002016,172.217.194.0-255,5738,176745,6,287777
12669,0.002018,172.31.36.0-255,66,176811,6,287777
12670,0.002048,172.31.36.0-255,66,176877,6,287777
12671,0.002069,172.217.194.0-255,1484,178361,6,287777
12672,0.002078,172.217.194.0-255,8574,186935,6,287777
12673,0.002087,172.31.36.0-255,66,187001,6,287777
12674,0.002091,172.217.194.0-255,1484,188485,6,287777
12675,0.002112,172.217.194.0-255,3602,192087,6,287777
12676,0.002116,172.31.36.0-255,66,192153,6,287777
12677,0.002123,172.217.194.0-255,5738,197891,6,287777
12678,0.002126,172.31.36.0-255,66,197957,6,287777
12679,0.002163,172.31.36.0-255,66,198023,6,287777
12680,0.002176,172.31.36.0-255,66,198089,6,287777
12681,0.002218,172.217.194.0-255,1484,199573,6,287777
12682,0.002224,172.217.194.0-255,2902,202475,6,287777
12683,0.002226,172.31.36.0-255,66,202541,6,287777
12684,0.00224,172.217.194.0-255,2902,205443,6,287777
12685,0.002242,172.31.36.0-255,66,205509,6,287777
12686,0.002266,172.217.194.0-255,2902,208411,6,287777
12687,0.002269,172.31.36.0-255,66,208477,6,287777
12688,0.002275,172.217.194.0-255,4320,212797,6,287777
12689,0.002277,172.31.36.0-255,66,212863,6,287777
12690,0.00229,172.31.36.0-255,66,212929,6,287777
12691,0.002349,172.217.194.0-255,7856,220785,6,287777
12692,0.002352,172.31.36.0-255,66,220851,6,287777
12693,0.00237,172.217.194.0-255,1484,222335,6,287777
12694,0.002387,172.217.194.0-255,2902,225237,6,287777
12695,0.00239,172.31.36.0-255,66,225303,6,287777
12696,0.002412,172.217.194.0-255,5738,231041,6,287777
12697,0.002415,172.31.36.0-255,66,231107,6,287777
12698,0.002421,172.217.194.0-255,5738,236845,6,287777
12699,0.002423,172.31.36.0-255,66,236911,6,287777
12700,0.002443,172.217.194.0-255,4320,241231,6,287777
12701,0.002445,172.31.36.0-255,66,241297,6,287777
12702,0.002457,172.217.194.0-255,2902,244199,6,287777
12703,0.00246,172.31.36.0-255,66,244265,6,287777
12704,0.002501,172.217.194.0-255,10692,254957,6,287777
12705,0.002504,172.31.36.0-255,66,255023,6,287777
12706,0.002507,172.217.194.0-255,1484,256507,6,287777
12707,0.002526,172.217.194.0-255,2902,259409,6,287777
12708,0.002529,172.31.36.0-255,66,259475,6,287777
12709,0.002535,172.217.194.0-255,4320,263795,6,287777
12710,0.002537,172.31.36.0-255,66,263861,6,287777
12711,0.002551,172.217.194.0-255,1484,265345,6,287777
12712,0.002588,172.31.36.0-255,66,265411,6,287777
12713,0.002611,172.217.194.0-255,10692,276103,6,287777
12714,0.002615,172.31.36.0-255,66,276169,6,287777
12715,0.005201,172.217.194.0-255,5738,281907,6,287777
12716,0.005208,172.31.36.0-255,66,281973,6,287777
12717,0.007778,172.217.194.0-255,5738,287711,6,287777
12718,0.007786,172.31.36.0-255,66,287777,6,287777
12719,0.0,172.217.194.0-255,153,153,6,258856
12720,2.3e-05,172.31.36.0-255,66,219,6,258856
12721,3.1e-05,172.217.194.0-255,1484,1703,6,258856
12722,3.5e-05,172.31.36.0-255,66,1769,6,258856
12723,4e-05,172.217.194.0-255,2902,4671,6,258856
12724,5.2e-05,172.31.36.0-255,66,4737,6,258856
12725,6e-05,172.217.194.0-255,7156,11893,6,258856
12726,6.4e-05,172.31.36.0-255,66,11959,6,258856
12727,7.1e-05,172.217.194.0-255,7156,19115,6,258856
12728,7.4e-05,172.31.36.0-255,66,19181,6,258856
12729,0.000122,172.217.194.0-255,9155,28336,6,258856
12730,0.000126,172.31.36.0-255,66,28402,6,258856
12731,0.00014,172.31.36.0-255,66,28468,6,258856
12732,0.000149,172.217.194.0-255,9992,38460,6,258856
12733,0.000152,172.31.36.0-255,66,38526,6,258856
12734,0.0002,172.31.36.0-255,66,38592,6,258856
12735,0.000203,172.217.194.0-255,1446,40038,6,258856
12736,0.000205,172.31.36.0-255,66,40104,6,258856
12737,0.000256,172.217.194.0-255,1484,41588,6,258856
12738,0.000259,172.31.36.0-255,66,41654,6,258856
12739,0.000265,172.217.194.0-255,2902,44556,6,258856
12740,0.000267,172.31.36.0-255,66,44622,6,258856
12741,0.000273,172.217.194.0-255,4320,48942,6,258856
12742,0.00028,172.31.36.0-255,66,49008,6,258856
12743,0.000301,172.217.194.0-255,1484,50492,6,258856
12744,0.000304,172.31.36.0-255,66,50558,6,258856
12745,0.00031,172.217.194.0-255,4320,54878,6,258856
12746,0.000313,172.31.36.0-255,66,54944,6,258856
12747,0.000326,172.31.36.0-255,66,55010,6,258856
12748,0.000329,172.217.194.0-255,1484,56494,6,258856
12749,0.000359,172.217.194.0-255,6438,62932,6,258856
12750,0.000361,172.31.36.0-255,66,62998,6,258856
12751,0.000415,172.217.194.0-255,1484,64482,6,258856
12752,0.000433,172.217.194.0-255,2902,67384,6,258856
12753,0.000436,172.31.36.0-255,66,67450,6,258856
12754,0.000442,172.217.194.0-255,5738,73188,6,258856
12755,0.000445,172.31.36.0-255,66,73254,6,258856
12756,0.00052,172.31.36.0-255,66,73320,6,258856
12757,0.000529,172.217.194.0-255,8574,81894,6,258856
12758,0.000531,172.31.36.0-255,66,81960,6,258856
12759,0.000559,172.217.194.0-255,8574,90534,6,258856
12760,0.000562,172.31.36.0-255,66,90600,6,258856
12761,0.0006,172.31.36.0-255,66,90666,6,258856
12762,0.000616,172.31.36.0-255,66,90732,6,258856
12763,0.000643,172.217.194.0-255,4320,95052,6,258856
12764,0.000646,172.31.36.0-255,66,95118,6,258856
12765,0.000671,172.217.194.0-255,4320,99438,6,258856
12766,0.00068,172.217.194.0-255,9992,109430,6,258856
12767,0.000732,172.217.194.0-255,1484,110914,6,258856
12768,0.000756,172.217.194.0-255,1064,111978,6,258856
12769,0.000824,172.31.36.0-255,66,112044,6,258856
12770,0.000976,172.217.194.0-255,1484,113528,6,258856
12771,0.000992,172.217.194.0-255,2902,116430,6,258856
12772,0.000994,172.217.194.0-255,1484,117914,6,258856
12773,0.001013,172.31.36.0-255,66,117980,6,258856
12774,0.00102,172.217.194.0-255,4320,122300,6,258856
12775,0.001022,172.217.194.0-255,1484,123784,6,258856
12776,0.001042,172.217.194.0-255,7156,130940,6,258856
12777,0.001046,172.31.36.0-255,66,131006,6,258856
12778,0.001075,172.217.194.0-255,4320,135326,6,258856
12779,0.001084,172.217.194.0-255,9992,145318,6,258856
12780,0.001086,172.217.194.0-255,766,146084,6,258856
12781,0.001093,172.31.36.0-255,66,146150,6,258856
12782,0.001223,172.217.194.0-255,1484,147634,6,258856
12783,0.001229,172.217.194.0-255,2902,150536,6,258856
12784,0.001234,172.31.36.0-255,66,150602,6,258856
12785,0.001248,172.217.194.0-255,5738,156340,6,258856
12786,0.00127,172.31.36.0-255,66,156406,6,258856
12787,0.001278,172.217.194.0-255,1484,157890,6,258856
12788,0.001316,172.217.194.0-255,8574,166464,6,258856
12789,0.001332,172.217.194.0-255,2184,168648,6,258856
12790,0.001351,172.217.194.0-255,1484,170132,6,258856
12791,0.001357,172.31.36.0-255,66,170198,6,258856
12792,0.001373,172.217.194.0-255,9992,180190,6,258856
12793,0.001395,172.217.194.0-255,8574,188764,6,258856
12794,0.001411,172.31.36.0-255,66,188830,6,258856
12795,0.001421,172.217.194.0-255,2902,191732,6,258856
12796,0.001434,172.217.194.0-255,10692,202424,6,258856
12797,0.001476,172.31.36.0-255,66,202490,6,258856
12798,0.001533,172.217.194.0-255,9274,211764,6,258856
12799,0.00154,172.217.194.0-255,7156,218920,6,258856
12800,0.001548,172.31.36.0-255,66,218986,6,258856
12801,0.001558,172.217.194.0-255,2902,221888,6,258856
12802,0.001562,172.217.194.0-255,2902,224790,6,258856
12803,0.001588,172.217.194.0-255,2902,227692,6,258856
12804,0.001595,172.217.194.0-255,7156,234848,6,258856
12805,0.001611,172.217.194.0-255,2902,237750,6,258856
12806,0.001623,172.31.36.0-255,66,237816,6,258856
12807,0.001632,172.217.194.0-255,8574,246390,6,258856
12808,0.001637,172.31.36.0-255,66,246456,6,258856
12809,0.001666,172.217.194.0-255,2184,248640,6,258856
12810,0.001688,172.217.194.0-255,9948,258588,6,258856
12811,0.001691,172.217.194.0-255,97,258685,6,258856
12812,0.001705,172.31.36.0-255,66,258751,6,258856
12813,0.001714,172.217.194.0-255,105,258856,6,258856
12814,0.0,172.217.194.0-255,146,146,6,334098
12815,1.7e-05,172.31.36.0-255,66,212,6,334098
12816,2.3e-05,172.217.194.0-255,1484,1696,6,334098
12817,2.8e-05,172.31.36.0-255,66,1762,6,334098
12818,3.3e-05,172.217.194.0-255,2902,4664,6,334098
12819,3.6e-05,172.31.36.0-255,66,4730,6,334098
12820,5.8e-05,172.217.194.0-255,7156,11886,6,334098
12821,6.1e-05,172.31.36.0-255,66,11952,6,334098
12822,6.5e-05,172.217.194.0-255,2042,13994,6,334098
12823,6.7e-05,172.31.36.0-255,66,14060,6,334098
12824,0.00015,172.217.194.0-255,1484,15544,6,334098
12825,0.000153,172.217.194.0-255,1484,17028,6,334098
12826,0.000157,172.31.36.0-255,66,17094,6,334098
12827,0.000166,172.31.36.0-255,66,17160,6,334098
12828,0.00017,172.217.194.0-255,1484,18644,6,334098
12829,0.000172,172.31.36.0-255,66,18710,6,334098
12830,0.000179,172.217.194.0-255,5738,24448,6,334098
12831,0.000181,172.31.36.0-255,66,24514,6,334098
12832,0.000219,172.217.194.0-255,5738,30252,6,334098
12833,0.000222,172.31.36.0-255,66,30318,6,334098
12834,0.000244,172.217.194.0-255,2543,32861,6,334098
12835,0.000247,172.31.36.0-255,66,32927,6,334098
12836,0.000255,172.217.194.0-255,8574,41501,6,334098
12837,0.000257,172.31.36.0-255,66,41567,6,334098
12838,0.00026,172.217.194.0-255,1484,43051,6,334098
12839,0.000262,172.31.36.0-255,66,43117,6,334098
12840,0.000279,172.217.194.0-255,5379,48496,6,334098
12841,0.000282,172.31.36.0-255,66,48562,6,334098
12842,0.000364,172.217.194.0-255,1484,50046,6,334098
12843,0.000368,172.31.36.0-255,66,50112,6,334098
12844,0.000373,172.217.194.0-255,2902,53014,6,334098
12845,0.000376,172.31.36.0-255,66,53080,6,334098
12846,0.000381,172.217.194.0-255,4320,57400,6,334098
12847,0.000383,172.31.36.0-255,66,57466,6,334098
12848,0.000398,172.217.194.0-255,1484,58950,6,334098
12849,0.000417,172.217.194.0-255,2902,61852,6,334098
12850,0.00042,172.31.36.0-255,66,61918,6,334098
12851,0.00044,172.217.194.0-255,3961,65879,6,334098
12852,0.000443,172.31.36.0-255,66,65945,6,334098
12853,0.000626,172.217.194.0-255,1484,67429,6,334098
12854,0.000632,172.217.194.0-255,2902,70331,6,334098
12855,0.000636,172.31.36.0-255,66,70397,6,334098
12856,0.000642,172.217.194.0-255,4320,74717,6,334098
12857,0.000645,172.31.36.0-255,66,74783,6,334098
12858,0.000664,172.217.194.0-255,1484,76267,6,334098
12859,0.00067,172.217.194.0-255,4320,80587,6,334098
12860,0.000672,172.31.36.0-255,66,80653,6,334098
12861,0.000699,172.217.194.0-255,8798,89451,6,334098
12862,0.000702,172.31.36.0-255,66,89517,6,334098
12863,0.000712,172.217.194.0-255,9992,99509,6,334098
12864,0.000714,172.31.36.0-255,66,99575,6,334098
12865,0.000717,172.217.194.0-255,573,100148,6,334098
12866,0.000882,172.217.194.0-255,1484,101632,6,334098
12867,0.000886,172.31.36.0-255,66,101698,6,334098
12868,0.000892,172.217.194.0-255,2902,104600,6,334098
12869,0.000895,172.31.36.0-255,66,104666,6,334098
12870,0.000909,172.217.194.0-255,2902,107568,6,334098
12871,0.000911,172.31.36.0-255,66,107634,6,334098
12872,0.000937,172.217.194.0-255,2902,110536,6,334098
12873,0.000941,172.31.36.0-255,66,110602,6,334098
12874,0.000952,172.217.194.0-255,2902,113504,6,334098
12875,0.000954,172.31.36.0-255,66,113570,6,334098
12876,0.000976,172.217.194.0-255,8574,122144,6,334098
12877,0.000978,172.31.36.0-255,66,122210,6,334098
12878,0.001002,172.31.36.0-255,66,122276,6,334098
12879,0.001322,172.217.194.0-255,1484,123760,6,334098
12880,0.001328,172.217.194.0-255,2902,126662,6,334098
12881,0.001332,172.31.36.0-255,66,126728,6,334098
12882,0.001339,172.217.194.0-255,5738,132466,6,334098
12883,0.00134,172.31.36.0-255,66,132532,6,334098
12884,0.001374,172.217.194.0-255,4320,136852,6,334098
12885,0.001377,172.31.36.0-255,66,136918,6,334098
12886,0.001419,172.217.194.0-255,8574,145492,6,334098
12887,0.001423,172.31.36.0-255,66,145558,6,334098
12888,0.001434,172.217.194.0-255,10692,156250,6,334098
12889,0.001436,172.31.36.0-255,66,156316,6,334098
12890,0.001489,172.217.194.0-255,1484,157800,6,334098
12891,0.001515,172.217.194.0-255,2902,160702,6,334098
12892,0.001518,172.31.36.0-255,66,160768,6,334098
12893,0.001525,172.217.194.0-255,5738,166506,6,334098
12894,0.001527,172.31.36.0-255,66,166572,6,334098
12895,0.00153,172.217.194.0-255,1484,168056,6,334098
12896,0.001557,172.31.36.0-255,66,168122,6,334098
12897,0.001577,172.217.194.0-255,2902,171024,6,334098
12898,0.001579,172.31.36.0-255,66,171090,6,334098
12899,0.001603,172.217.194.0-255,2902,173992,6,334098
12900,0.001605,172.31.36.0-255,66,174058,6,334098
12901,0.001623,172.217.194.0-255,6438,180496,6,334098
12902,0.001626,172.31.36.0-255,66,180562,6,334098
12903,0.001633,172.217.194.0-255,5738,186300,6,334098
12904,0.001636,172.31.36.0-255,66,186366,6,334098
12905,0.001656,172.217.194.0-255,4320,190686,6,334098
12906,0.001659,172.31.36.0-255,66,190752,6,334098
12907,0.001673,172.31.36.0-255,66,190818,6,334098
12908,0.001694,172.217.194.0-255,7156,197974,6,334098
12909,0.001697,172.31.36.0-255,66,198040,6,334098
12910,0.001719,172.217.194.0-255,2184,200224,6,334098
12911,0.001721,172.31.36.0-255,66,200290,6,334098
12912,0.001726,172.217.194.0-255,2902,203192,6,334098
12913,0.001729,172.31.36.0-255,66,203258,6,334098
12914,0.001734,172.217.194.0-255,4320,207578,6,334098
12915,0.001736,172.31.36.0-255,66,207644,6,334098
12916,0.001756,172.217.194.0-255,2902,210546,6,334098
12917,0.001759,172.31.36.0-255,66,210612,6,334098
12918,0.001772,172.217.194.0-255,8574,219186,6,334098
12919,0.001775,172.31.36.0-255,66,219252,6,334098
12920,0.001796,172.217.194.0-255,7156,226408,6,334098
12921,0.001798,172.31.36.0-255,66,226474,6,334098
12922,0.001803,172.217.194.0-255,2902,229376,6,334098
12923,0.001805,172.31.36.0-255,66,229442,6,334098
12924,0.001834,172.217.194.0-255,5020,234462,6,334098
12925,0.001837,172.31.36.0-255,66,234528,6,334098
12926,0.001841,172.217.194.0-255,1484,236012,6,334098
12927,0.001865,172.217.194.0-255,9992,246004,6,334098
12928,0.001868,172.31.36.0-255,66,246070,6,334098
12929,0.001876,172.217.194.0-255,7156,253226,6,334098
12930,0.001879,172.31.36.0-255,66,253292,6,334098
12931,0.001913,172.31.36.0-255,66,253358,6,334098
12932,0.001924,172.217.194.0-255,766,254124,6,334098
12933,0.002004,172.217.194.0-255,1484,255608,6,334098
12934,0.002008,172.31.36.0-255,66,255674,6,334098
12935,0.002014,172.217.194.0-255,2902,258576,6,334098
12936,0.002017,172.31.36.0-255,66,258642,6,334098
12937,0.002049,172.217.194.0-255,2902,261544,6,334098
12938,0.002052,172.31.36.0-255,66,261610,6,334098
12939,0.002072,172.217.194.0-255,2902,264512,6,334098
12940,0.002075,172.31.36.0-255,66,264578,6,334098
12941,0.002082,172.217.194.0-255,5738,270316,6,334098
12942,0.002085,172.31.36.0-255,66,270382,6,334098
12943,0.002124,172.217.194.0-255,5738,276120,6,334098
12944,0.002126,172.31.36.0-255,66,276186,6,334098
12945,0.002147,172.217.194.0-255,7156,283342,6,334098
12946,0.00215,172.31.36.0-255,66,283408,6,334098
12947,0.002156,172.217.194.0-255,5020,288428,6,334098
12948,0.002158,172.31.36.0-255,66,288494,6,334098
12949,0.002161,172.217.194.0-255,1484,289978,6,334098
12950,0.002188,172.217.194.0-255,2902,292880,6,334098
12951,0.002191,172.31.36.0-255,66,292946,6,334098
12952,0.002198,172.217.194.0-255,5738,298684,6,334098
12953,0.002201,172.31.36.0-255,66,298750,6,334098
12954,0.002206,172.217.194.0-255,4320,303070,6,334098
12955,0.002208,172.31.36.0-255,66,303136,6,334098
12956,0.002234,172.217.194.0-255,8574,311710,6,334098
12957,0.002237,172.31.36.0-255,66,311776,6,334098
12958,0.002242,172.217.194.0-255,4320,316096,6,334098
12959,0.002245,172.31.36.0-255,66,316162,6,334098
12960,0.002248,172.217.194.0-255,1484,317646,6,334098
12961,0.002285,172.31.36.0-255,66,317712,6,334098
12962,0.002322,172.217.194.0-255,4320,322032,6,334098
12963,0.002325,172.31.36.0-255,66,322098,6,334098
12964,0.002348,172.217.194.0-255,7156,329254,6,334098
12965,0.00235,172.31.36.0-255,66,329320,6,334098
12966,0.002354,172.217.194.0-255,1484,330804,6,334098
12967,0.002375,172.217.194.0-255,1484,332288,6,334098
12968,0.002378,172.31.36.0-255,66,332354,6,334098
12969,0.002382,172.217.194.0-255,1402,333756,6,334098
12970,0.002384,172.217.194.0-255,105,333861,6,334098
12971,0.007155,172.31.36.0-255,66,333927,6,334098
12972,0.007196,172.31.36.0-255,105,334032,6,334098
12973,0.009146,172.217.194.0-255,66,334098,6,334098
12974,0.0,74.125.130.0-255,150,150,6,181509
12975,2.6e-05,172.31.36.0-255,66,216,6,181509
12976,3.2e-05,74.125.130.0-255,1484,1700,6,181509
12977,3.6e-05,172.31.36.0-255,66,1766,6,181509
12978,6.7e-05,74.125.130.0-255,2902,4668,6,181509
12979,7.5e-05,172.31.36.0-255,66,4734,6,181509
12980,8e-05,74.125.130.0-255,4320,9054,6,181509
12981,8.2e-05,172.31.36.0-255,66,9120,6,181509
12982,0.000122,74.125.130.0-255,7778,16898,6,181509
12983,0.000125,172.31.36.0-255,66,16964,6,181509
12984,0.000134,74.125.130.0-255,8574,25538,6,181509
12985,0.000136,172.31.36.0-255,66,25604,6,181509
12986,0.000147,74.125.130.0-255,2902,28506,6,181509
12987,0.000149,172.31.36.0-255,66,28572,6,181509
12988,0.000175,74.125.130.0-255,2543,31115,6,181509
12989,0.000177,172.31.36.0-255,66,31181,6,181509
12990,0.000232,74.125.130.0-255,1484,32665,6,181509
12991,0.000236,172.31.36.0-255,66,32731,6,181509
12992,0.000239,74.125.130.0-255,1484,34215,6,181509
12993,0.000242,172.31.36.0-255,66,34281,6,181509
12994,0.000265,74.125.130.0-255,2902,37183,6,181509
12995,0.000268,172.31.36.0-255,66,37249,6,181509
12996,0.000272,74.125.130.0-255,2902,40151,6,181509
12997,0.000274,172.31.36.0-255,66,40217,6,181509
12998,0.000312,74.125.130.0-255,2902,43119,6,181509
12999,0.000316,172.31.36.0-255,66,43185,6,181509
13000,0.000322,74.125.130.0-255,4320,47505,6,181509
13001,0.000326,172.31.36.0-255,66,47571,6,181509
13002,0.000344,74.125.130.0-255,1125,48696,6,181509
13003,0.000347,172.31.36.0-255,66,48762,6,181509
13004,0.000589,74.125.130.0-255,1484,50246,6,181509
13005,0.000593,172.31.36.0-255,66,50312,6,181509
13006,0.000612,74.125.130.0-255,2902,53214,6,181509
13007,0.000616,172.31.36.0-255,66,53280,6,181509
13008,0.000661,74.125.130.0-255,5738,59018,6,181509
13009,0.000665,172.31.36.0-255,66,59084,6,181509
13010,0.000669,74.125.130.0-255,2902,61986,6,181509
13011,0.000671,172.31.36.0-255,66,62052,6,181509
13012,0.000683,74.125.130.0-255,3961,66013,6,181509
13013,0.000686,172.31.36.0-255,66,66079,6,181509
13014,0.00071,74.125.130.0-255,1484,67563,6,181509
13015,0.000716,74.125.130.0-255,2902,70465,6,181509
13016,0.000724,172.31.36.0-255,66,70531,6,181509
13017,0.00073,74.125.130.0-255,5738,76269,6,181509
13018,0.000732,172.31.36.0-255,66,76335,6,181509
13019,0.000759,74.125.130.0-255,4320,80655,6,181509
13020,0.000763,172.31.36.0-255,66,80721,6,181509
13021,0.000795,74.125.130.0-255,2543,83264,6,181509
13022,0.000798,172.31.36.0-255,66,83330,6,181509
13023,0.00084,74.125.130.0-255,2902,86232,6,181509
13024,0.000843,172.31.36.0-255,66,86298,6,181509
13025,0.000873,74.125.130.0-255,4320,90618,6,181509
13026,0.000877,172.31.36.0-255,66,90684,6,181509
13027,0.000883,74.125.130.0-255,5738,96422,6,181509
13028,0.000885,172.31.36.0-255,66,96488,6,181509
13029,0.000909,74.125.130.0-255,2902,99390,6,181509
13030,0.000916,172.31.36.0-255,66,99456,6,181509
13031,0.000921,74.125.130.0-255,1705,101161,6,181509
13032,0.000923,172.31.36.0-255,66,101227,6,181509
13033,0.001351,74.125.130.0-255,1484,102711,6,181509
13034,0.001359,74.125.130.0-255,1484,104195,6,181509
13035,0.001363,172.31.36.0-255,66,104261,6,181509
13036,0.001388,74.125.130.0-255,1484,105745,6,181509
13037,0.001408,74.125.130.0-255,4320,110065,6,181509
13038,0.001411,172.31.36.0-255,66,110131,6,181509
13039,0.001442,74.125.130.0-255,5738,115869,6,181509
13040,0.001446,172.31.36.0-255,66,115935,6,181509
13041,0.001484,74.125.130.0-255,7156,123091,6,181509
13042,0.001487,172.31.36.0-255,66,123157,6,181509
13043,0.001496,74.125.130.0-255,8574,131731,6,181509
13044,0.001497,172.31.36.0-255,66,131797,6,181509
13045,0.001529,74.125.130.0-255,3602,135399,6,181509
13046,0.001532,172.31.36.0-255,66,135465,6,181509
13047,0.002207,74.125.130.0-255,1484,136949,6,181509
13048,0.002227,74.125.130.0-255,2902,139851,6,181509
13049,0.002231,172.31.36.0-255,66,139917,6,181509
13050,0.002239,74.125.130.0-255,5738,145655,6,181509
13051,0.00224,172.31.36.0-255,66,145721,6,181509
13052,0.002262,74.125.130.0-255,1484,147205,6,181509
13053,0.002282,74.125.130.0-255,8574,155779,6,181509
13054,0.002285,172.31.36.0-255,66,155845,6,181509
13055,0.002296,74.125.130.0-255,1484,157329,6,181509
13056,0.002324,74.125.130.0-255,9992,167321,6,181509
13057,0.002326,172.31.36.0-255,66,167387,6,181509
13058,0.00233,74.125.130.0-255,2184,169571,6,181509
13059,0.002332,172.31.36.0-255,66,169637,6,181509
13060,0.004944,74.125.130.0-255,2902,172539,6,181509
13061,0.00495,172.31.36.0-255,66,172605,6,181509
13062,0.004982,74.125.130.0-255,2902,175507,6,181509
13063,0.004984,172.31.36.0-255,66,175573,6,181509
13064,0.007577,74.125.130.0-255,2902,178475,6,181509
13065,0.007584,172.31.36.0-255,66,178541,6,181509
13066,0.00762,74.125.130.0-255,2902,181443,6,181509
13067,0.007624,172.31.36.0-255,66,181509,6,181509
13068,0.0,74.125.24.0-255,152,152,6,239498
13069,3.4e-05,172.31.36.0-255,66,218,6,239498
13070,4.1e-05,74.125.24.0-255,1484,1702,6,239498
13071,4.7e-05,172.31.36.0-255,66,1768,6,239498
13072,5.2e-05,74.125.24.0-255,2902,4670,6,239498
13073,5.4e-05,172.31.36.0-255,66,4736,6,239498
13074,6.9e-05,74.125.24.0-255,7156,11892,6,239498
13075,7.2e-05,172.31.36.0-255,66,11958,6,239498
13076,7.7e-05,74.125.24.0-255,3428,15386,6,239498
13077,7.9e-05,172.31.36.0-255,66,15452,6,239498
13078,8.3e-05,74.125.24.0-255,1484,16936,6,239498
13079,8.5e-05,172.31.36.0-255,66,17002,6,239498
13080,0.000136,172.31.36.0-255,66,17068,6,239498
13081,0.00014,74.125.24.0-255,2543,19611,6,239498
13082,0.000143,172.31.36.0-255,66,19677,6,239498
13083,0.000295,74.125.24.0-255,1484,21161,6,239498
13084,0.000301,172.31.36.0-255,66,21227,6,239498
13085,0.000306,74.125.24.0-255,2902,24129,6,239498
13086,0.000308,172.31.36.0-255,66,24195,6,239498
13087,0.000381,74.125.24.0-255,5738,29933,6,239498
13088,0.000386,172.31.36.0-255,66,29999,6,239498
13089,0.000399,172.31.36.0-255,66,30065,6,239498
13090,0.000418,172.31.36.0-255,66,30131,6,239498
13091,0.000421,74.125.24.0-255,1436,31567,6,239498
13092,0.000424,172.31.36.0-255,66,31633,6,239498
13093,0.000454,74.125.24.0-255,112,31745,6,239498
13094,0.000457,172.31.36.0-255,66,31811,6,239498
13095,0.000509,74.125.24.0-255,331,32142,6,239498
13096,0.000513,172.31.36.0-255,66,32208,6,239498
13097,0.000709,74.125.24.0-255,1484,33692,6,239498
13098,0.000716,74.125.24.0-255,2902,36594,6,239498
13099,0.000719,172.31.36.0-255,66,36660,6,239498
13100,0.000725,74.125.24.0-255,4320,40980,6,239498
13101,0.000727,172.31.36.0-255,66,41046,6,239498
13102,0.000768,74.125.24.0-255,1484,42530,6,239498
13103,0.000785,172.31.36.0-255,66,42596,6,239498
13104,0.000787,74.125.24.0-255,10692,53288,6,239498
13105,0.00079,172.31.36.0-255,66,53354,6,239498
13106,0.000987,74.125.24.0-255,1484,54838,6,239498
13107,0.000993,74.125.24.0-255,2902,57740,6,239498
13108,0.000997,172.31.36.0-255,66,57806,6,239498
13109,0.001004,74.125.24.0-255,5738,63544,6,239498
13110,0.001006,172.31.36.0-255,66,63610,6,239498
13111,0.001012,74.125.24.0-255,7156,70766,6,239498
13112,0.001014,172.31.36.0-255,66,70832,6,239498
13113,0.001045,74.125.24.0-255,5738,76570,6,239498
13114,0.001049,172.31.36.0-255,66,76636,6,239498
13115,0.001055,74.125.24.0-255,4320,80956,6,239498
13116,0.001057,172.31.36.0-255,66,81022,6,239498
13117,0.001081,74.125.24.0-255,6438,87460,6,239498
13118,0.001084,172.31.36.0-255,66,87526,6,239498
13119,0.001205,74.125.24.0-255,1484,89010,6,239498
13120,0.001209,74.125.24.0-255,1484,90494,6,239498
13121,0.001213,172.31.36.0-255,66,90560,6,239498
13122,0.001238,74.125.24.0-255,1484,92044,6,239498
13123,0.001242,74.125.24.0-255,1484,93528,6,239498
13124,0.001244,172.31.36.0-255,66,93594,6,239498
13125,0.001251,74.125.24.0-255,5738,99332,6,239498
13126,0.001254,172.31.36.0-255,66,99398,6,239498
13127,0.001284,172.31.36.0-255,66,99464,6,239498
13128,0.001293,74.125.24.0-255,9274,108738,6,239498
13129,0.001296,172.31.36.0-255,66,108804,6,239498
13130,0.001369,74.125.24.0-255,1484,110288,6,239498
13131,0.001387,74.125.24.0-255,2902,113190,6,239498
13132,0.001391,172.31.36.0-255,66,113256,6,239498
13133,0.001396,74.125.24.0-255,5738,118994,6,239498
13134,0.001398,172.31.36.0-255,66,119060,6,239498
13135,0.001437,172.31.36.0-255,66,119126,6,239498
13136,0.001446,74.125.24.0-255,8574,127700,6,239498
13137,0.001448,172.31.36.0-255,66,127766,6,239498
13138,0.001471,74.125.24.0-255,2184,129950,6,239498
13139,0.001478,172.31.36.0-255,66,130016,6,239498
13140,0.001777,74.125.24.0-255,1484,131500,6,239498
13141,0.001796,74.125.24.0-255,2902,134402,6,239498
13142,0.0018,172.31.36.0-255,66,134468,6,239498
13143,0.001807,74.125.24.0-255,5738,140206,6,239498
13144,0.001809,172.31.36.0-255,66,140272,6,239498
13145,0.00185,172.31.36.0-255,66,140338,6,239498
13146,0.001859,74.125.24.0-255,8574,148912,6,239498
13147,0.001861,172.31.36.0-255,66,148978,6,239498
13148,0.001927,74.125.24.0-255,2184,151162,6,239498
13149,0.001931,172.31.36.0-255,66,151228,6,239498
13150,0.001965,74.125.24.0-255,1484,152712,6,239498
13151,0.001971,74.125.24.0-255,2902,155614,6,239498
13152,0.001973,172.31.36.0-255,66,155680,6,239498
13153,0.00198,74.125.24.0-255,5738,161418,6,239498
13154,0.001982,172.31.36.0-255,66,161484,6,239498
13155,0.002,74.125.24.0-255,7156,168640,6,239498
13156,0.002003,172.31.36.0-255,66,168706,6,239498
13157,0.002056,172.31.36.0-255,66,168772,6,239498
13158,0.002061,74.125.24.0-255,2184,170956,6,239498
13159,0.002063,172.31.36.0-255,66,171022,6,239498
13160,0.00215,74.125.24.0-255,1484,172506,6,239498
13161,0.002169,74.125.24.0-255,2902,175408,6,239498
13162,0.002172,172.31.36.0-255,66,175474,6,239498
13163,0.002196,74.125.24.0-255,5738,181212,6,239498
13164,0.0022,172.31.36.0-255,66,181278,6,239498
13165,0.002201,74.125.24.0-255,4320,185598,6,239498
13166,0.002219,172.31.36.0-255,66,185664,6,239498
13167,0.002224,74.125.24.0-255,7156,192820,6,239498
13168,0.002226,172.31.36.0-255,66,192886,6,239498
13169,0.002258,74.125.24.0-255,4320,197206,6,239498
13170,0.002268,172.31.36.0-255,66,197272,6,239498
13171,0.002276,74.125.24.0-255,7856,205128,6,239498
13172,0.002279,172.31.36.0-255,66,205194,6,239498
13173,0.002314,74.125.24.0-255,7156,212350,6,239498
13174,0.002318,172.31.36.0-255,66,212416,6,239498
13175,0.002327,74.125.24.0-255,8574,220990,6,239498
13176,0.002329,172.31.36.0-255,66,221056,6,239498
13177,0.002332,74.125.24.0-255,1484,222540,6,239498
13178,0.002386,172.31.36.0-255,66,222606,6,239498
13179,0.002389,74.125.24.0-255,766,223372,6,239498
13180,0.002992,172.31.36.0-255,66,223438,6,239498
13181,0.004706,74.125.24.0-255,4320,227758,6,239498
13182,0.00472,172.31.36.0-255,66,227824,6,239498
13183,0.005272,74.125.24.0-255,1484,229308,6,239498
13184,0.007048,74.125.24.0-255,4320,233628,6,239498
13185,0.00706,172.31.36.0-255,66,233694,6,239498
13186,0.009369,74.125.24.0-255,5738,239432,6,239498
13187,0.009374,172.31.36.0-255,66,239498,6,239498
13188,0.0,74.125.68.0-255,153,153,6,203224
13189,3.3e-05,172.31.36.0-255,66,219,6,203224
13190,4.1e-05,74.125.68.0-255,1484,1703,6,203224
13191,4.5e-05,172.31.36.0-255,66,1769,6,203224
13192,5e-05,74.125.68.0-255,2902,4671,6,203224
13193,5.2e-05,172.31.36.0-255,66,4737,6,203224
13194,6e-05,74.125.68.0-255,7156,11893,6,203224
13195,6.3e-05,172.31.36.0-255,66,11959,6,203224
13196,8.6e-05,74.125.68.0-255,2011,13970,6,203224
13197,8.9e-05,172.31.36.0-255,66,14036,6,203224
13198,9.3e-05,74.125.68.0-255,2902,16938,6,203224
13199,9.5e-05,172.31.36.0-255,66,17004,6,203224
13200,0.000123,74.125.68.0-255,7156,24160,6,203224
13201,0.000127,172.31.36.0-255,66,24226,6,203224
13202,0.000132,74.125.68.0-255,2902,27128,6,203224
13203,0.000134,172.31.36.0-255,66,27194,6,203224
13204,0.000184,74.125.68.0-255,3961,31155,6,203224
13205,0.000188,172.31.36.0-255,66,31221,6,203224
13206,0.000285,74.125.68.0-255,1484,32705,6,203224
13207,0.000289,172.31.36.0-255,66,32771,6,203224
13208,0.000294,74.125.68.0-255,2902,35673,6,203224
13209,0.000297,172.31.36.0-255,66,35739,6,203224
13210,0.000313,74.125.68.0-255,1484,37223,6,203224
13211,0.000315,172.31.36.0-255,66,37289,6,203224
13212,0.000343,74.125.68.0-255,4320,41609,6,203224
13213,0.000347,172.31.36.0-255,66,41675,6,203224
13214,0.000353,74.125.68.0-255,5738,47413,6,203224
13215,0.000356,172.31.36.0-255,66,47479,6,203224
13216,0.000376,74.125.68.0-255,4320,51799,6,203224
13217,0.000381,172.31.36.0-255,66,51865,6,203224
13218,0.000393,74.125.68.0-255,2543,54408,6,203224
13219,0.000396,172.31.36.0-255,66,54474,6,203224
13220,0.0004,74.125.68.0-255,2902,57376,6,203224
13221,0.000402,172.31.36.0-255,66,57442,6,203224
13222,0.000407,74.125.68.0-255,4320,61762,6,203224
13223,0.00041,172.31.36.0-255,66,61828,6,203224
13224,0.000436,74.125.68.0-255,4274,66102,6,203224
13225,0.00044,172.31.36.0-255,66,66168,6,203224
13226,0.000475,74.125.68.0-255,374,66542,6,203224
13227,0.000766,74.125.68.0-255,1484,68026,6,203224
13228,0.00077,172.31.36.0-255,66,68092,6,203224
13229,0.000775,74.125.68.0-255,2902,70994,6,203224
13230,0.000777,172.31.36.0-255,66,71060,6,203224
13231,0.000793,74.125.68.0-255,1484,72544,6,203224
13232,0.000807,74.125.68.0-255,2902,75446,6,203224
13233,0.00081,172.31.36.0-255,66,75512,6,203224
13234,0.000828,74.125.68.0-255,2902,78414,6,203224
13235,0.000831,172.31.36.0-255,66,78480,6,203224
13236,0.000848,74.125.68.0-255,2902,81382,6,203224
13237,0.000851,172.31.36.0-255,66,81448,6,203224
13238,0.000854,74.125.68.0-255,1484,82932,6,203224
13239,0.000866,74.125.68.0-255,1484,84416,6,203224
13240,0.000869,172.31.36.0-255,66,84482,6,203224
13241,0.000892,74.125.68.0-255,1484,85966,6,203224
13242,0.0009,74.125.68.0-255,5738,91704,6,203224
13243,0.000902,172.31.36.0-255,66,91770,6,203224
13244,0.000905,74.125.68.0-255,1484,93254,6,203224
13245,0.000923,74.125.68.0-255,2902,96156,6,203224
13246,0.000925,172.31.36.0-255,66,96222,6,203224
13247,0.000949,74.125.68.0-255,2902,99124,6,203224
13248,0.000952,172.31.36.0-255,66,99190,6,203224
13249,0.00097,74.125.68.0-255,2184,101374,6,203224
13250,0.000973,172.31.36.0-255,66,101440,6,203224
13251,0.00123,74.125.68.0-255,1484,102924,6,203224
13252,0.001239,74.125.68.0-255,2902,105826,6,203224
13253,0.001242,172.31.36.0-255,66,105892,6,203224
13254,0.001246,74.125.68.0-255,1484,107376,6,203224
13255,0.00127,74.125.68.0-255,2902,110278,6,203224
13256,0.001273,172.31.36.0-255,66,110344,6,203224
13257,0.001309,74.125.68.0-255,5738,116082,6,203224
13258,0.001312,172.31.36.0-255,66,116148,6,203224
13259,0.001335,74.125.68.0-255,1484,117632,6,203224
13260,0.001361,74.125.68.0-255,5738,123370,6,203224
13261,0.001364,172.31.36.0-255,66,123436,6,203224
13262,0.00137,74.125.68.0-255,4320,127756,6,203224
13263,0.001372,172.31.36.0-255,66,127822,6,203224
13264,0.001375,74.125.68.0-255,1484,129306,6,203224
13265,0.001398,74.125.68.0-255,4320,133626,6,203224
13266,0.0014,172.31.36.0-255,66,133692,6,203224
13267,0.001405,74.125.68.0-255,2184,135876,6,203224
13268,0.001407,172.31.36.0-255,66,135942,6,203224
13269,0.001505,74.125.68.0-255,1484,137426,6,203224
13270,0.001519,74.125.68.0-255,2902,140328,6,203224
13271,0.001523,172.31.36.0-255,66,140394,6,203224
13272,0.001552,74.125.68.0-255,5738,146132,6,203224
13273,0.001555,172.31.36.0-255,66,146198,6,203224
13274,0.001558,74.125.68.0-255,1484,147682,6,203224
13275,0.001571,74.125.68.0-255,1484,149166,6,203224
13276,0.001574,172.31.36.0-255,66,149232,6,203224
13277,0.001594,74.125.68.0-255,1484,150716,6,203224
13278,0.001598,74.125.68.0-255,1484,152200,6,203224
13279,0.0016,172.31.36.0-255,66,152266,6,203224
13280,0.001619,74.125.68.0-255,4320,156586,6,203224
13281,0.001621,172.31.36.0-255,66,156652,6,203224
13282,0.001635,74.125.68.0-255,2902,159554,6,203224
13283,0.001637,172.31.36.0-255,66,159620,6,203224
13284,0.001655,74.125.68.0-255,4320,163940,6,203224
13285,0.001658,172.31.36.0-255,66,164006,6,203224
13286,0.001664,74.125.68.0-255,4320,168326,6,203224
13287,0.001666,172.31.36.0-255,66,168392,6,203224
13288,0.001718,74.125.68.0-255,2184,170576,6,203224
13289,0.001721,172.31.36.0-255,66,170642,6,203224
13290,0.002184,74.125.68.0-255,1484,172126,6,203224
13291,0.002204,74.125.68.0-255,2902,175028,6,203224
13292,0.002208,172.31.36.0-255,66,175094,6,203224
13293,0.002227,74.125.68.0-255,2902,177996,6,203224
13294,0.002229,172.31.36.0-255,66,178062,6,203224
13295,0.002242,74.125.68.0-255,2902,180964,6,203224
13296,0.002244,172.31.36.0-255,66,181030,6,203224
13297,0.002262,74.125.68.0-255,1484,182514,6,203224
13298,0.002266,74.125.68.0-255,2902,185416,6,203224
13299,0.002268,172.31.36.0-255,66,185482,6,203224
13300,0.004463,74.125.68.0-255,1484,186966,6,203224
13301,0.004488,74.125.68.0-255,4320,191286,6,203224
13302,0.004491,172.31.36.0-255,66,191352,6,203224
13303,0.00671,74.125.68.0-255,2902,194254,6,203224
13304,0.006714,172.31.36.0-255,66,194320,6,203224
13305,0.006735,74.125.68.0-255,2902,197222,6,203224
13306,0.006737,172.31.36.0-255,66,197288,6,203224
13307,0.008941,74.125.68.0-255,2902,200190,6,203224
13308,0.008948,172.31.36.0-255,66,200256,6,203224
13309,0.008969,74.125.68.0-255,2902,203158,6,203224
13310,0.008972,172.31.36.0-255,66,203224,6,203224
13311,0.0,74.125.24.0-255,148,148,6,173493
13312,2e-05,172.31.36.0-255,66,214,6,173493
13313,2.6e-05,74.125.24.0-255,1484,1698,6,173493
13314,3e-05,172.31.36.0-255,66,1764,6,173493
13315,3.5e-05,74.125.24.0-255,2902,4666,6,173493
13316,4.5e-05,172.31.36.0-255,66,4732,6,173493
13317,5.2e-05,74.125.24.0-255,7156,11888,6,173493
13318,5.4e-05,172.31.36.0-255,66,11954,6,173493
13319,9.5e-05,74.125.24.0-255,5738,17692,6,173493
13320,9.9e-05,172.31.36.0-255,66,17758,6,173493
13321,0.000133,74.125.24.0-255,10554,28312,6,173493
13322,0.000136,172.31.36.0-255,66,28378,6,173493
13323,0.00014,74.125.24.0-255,2543,30921,6,173493
13324,0.000142,172.31.36.0-255,66,30987,6,173493
13325,0.000172,74.125.24.0-255,1484,32471,6,173493
13326,0.000175,172.31.36.0-255,66,32537,6,173493
13327,0.000179,74.125.24.0-255,2902,35439,6,173493
13328,0.000181,172.31.36.0-255,66,35505,6,173493
13329,0.000185,74.125.24.0-255,2902,38407,6,173493
13330,0.000188,172.31.36.0-255,66,38473,6,173493
13331,0.000207,74.125.24.0-255,1484,39957,6,173493
13332,0.000209,172.31.36.0-255,66,40023,6,173493
13333,0.000216,74.125.24.0-255,8574,48597,6,173493
13334,0.000219,172.31.36.0-255,66,48663,6,173493
13335,0.000262,74.125.24.0-255,5738,54401,6,173493
13336,0.000265,172.31.36.0-255,66,54467,6,173493
13337,0.000289,172.31.36.0-255,66,54533,6,173493
13338,0.000478,74.125.24.0-255,111,54644,6,173493
13339,0.000481,172.31.36.0-255,66,54710,6,173493
13340,0.000696,74.125.24.0-255,1484,56194,6,173493
13341,0.0007,172.31.36.0-255,66,56260,6,173493
13342,0.000704,74.125.24.0-255,2902,59162,6,173493
13343,0.000707,172.31.36.0-255,66,59228,6,173493
13344,0.000711,74.125.24.0-255,2902,62130,6,173493
13345,0.000719,172.31.36.0-255,66,62196,6,173493
13346,0.000757,74.125.24.0-255,2902,65098,6,173493
13347,0.00076,172.31.36.0-255,66,65164,6,173493
13348,0.000772,172.31.36.0-255,66,65230,6,173493
13349,0.000778,74.125.24.0-255,8574,73804,6,173493
13350,0.000782,172.31.36.0-255,66,73870,6,173493
13351,0.000803,74.125.24.0-255,2184,76054,6,173493
13352,0.000805,172.31.36.0-255,66,76120,6,173493
13353,0.001489,74.125.24.0-255,1484,77604,6,173493
13354,0.0015,74.125.24.0-255,2902,80506,6,173493
13355,0.001505,172.31.36.0-255,66,80572,6,173493
13356,0.001512,74.125.24.0-255,5738,86310,6,173493
13357,0.001515,172.31.36.0-255,66,86376,6,173493
13358,0.001528,74.125.24.0-255,5738,92114,6,173493
13359,0.001531,172.31.36.0-255,66,92180,6,173493
13360,0.001535,74.125.24.0-255,2902,95082,6,173493
13361,0.001537,172.31.36.0-255,66,95148,6,173493
13362,0.001567,74.125.24.0-255,9992,105140,6,173493
13363,0.00157,172.31.36.0-255,66,105206,6,173493
13364,0.001576,74.125.24.0-255,5020,110226,6,173493
13365,0.001579,172.31.36.0-255,66,110292,6,173493
13366,0.001604,74.125.24.0-255,5738,116030,6,173493
13367,0.001607,172.31.36.0-255,66,116096,6,173493
13368,0.001611,74.125.24.0-255,1484,117580,6,173493
13369,0.001642,74.125.24.0-255,4320,121900,6,173493
13370,0.001645,172.31.36.0-255,66,121966,6,173493
13371,0.001658,172.31.36.0-255,66,122032,6,173493
13372,0.001708,74.125.24.0-255,9274,131306,6,173493
13373,0.001711,172.31.36.0-255,66,131372,6,173493
13374,0.001715,74.125.24.0-255,331,131703,6,173493
13375,0.001762,74.125.24.0-255,1484,133187,6,173493
13376,0.001765,172.31.36.0-255,66,133253,6,173493
13377,0.001772,74.125.24.0-255,4320,137573,6,173493
13378,0.001774,172.31.36.0-255,66,137639,6,173493
13379,0.001785,74.125.24.0-255,4320,141959,6,173493
13380,0.001788,172.31.36.0-255,66,142025,6,173493
13381,0.001814,74.125.24.0-255,2902,144927,6,173493
13382,0.001817,172.31.36.0-255,66,144993,6,173493
13383,0.001833,172.31.36.0-255,66,145059,6,173493
13384,0.001839,74.125.24.0-255,5020,150079,6,173493
13385,0.001842,172.31.36.0-255,66,150145,6,173493
13386,0.003807,74.125.24.0-255,2902,153047,6,173493
13387,0.003811,172.31.36.0-255,66,153113,6,173493
13388,0.00383,74.125.24.0-255,2902,156015,6,173493
13389,0.003832,172.31.36.0-255,66,156081,6,173493
13390,0.005785,74.125.24.0-255,5738,161819,6,173493
13391,0.005789,172.31.36.0-255,66,161885,6,173493
13392,0.00776,74.125.24.0-255,5738,167623,6,173493
13393,0.007767,172.31.36.0-255,66,167689,6,173493
13394,0.009736,74.125.24.0-255,5738,173427,6,173493
13395,0.009746,172.31.36.0-255,66,173493,6,173493
13396,0.0,172.217.194.0-255,298,298,6,249466
13397,2.4e-05,172.31.36.0-255,66,364,6,249466
13398,3.1e-05,172.217.194.0-255,1484,1848,6,249466
13399,3.5e-05,172.31.36.0-255,66,1914,6,249466
13400,5e-05,172.217.194.0-255,4320,6234,6,249466
13401,5.4e-05,172.31.36.0-255,66,6300,6,249466
13402,6.1e-05,172.217.194.0-255,5738,12038,6,249466
13403,6.4e-05,172.31.36.0-255,66,12104,6,249466
13404,0.000104,172.217.194.0-255,7468,19572,6,249466
13405,0.000108,172.31.36.0-255,66,19638,6,249466
13406,0.000114,172.217.194.0-255,4320,23958,6,249466
13407,0.000116,172.31.36.0-255,66,24024,6,249466
13408,0.000143,172.217.194.0-255,4320,28344,6,249466
13409,0.000146,172.31.36.0-255,66,28410,6,249466
13410,0.00015,172.217.194.0-255,2543,30953,6,249466
13411,0.000153,172.31.36.0-255,66,31019,6,249466
13412,0.000205,172.217.194.0-255,1484,32503,6,249466
13413,0.000208,172.31.36.0-255,66,32569,6,249466
13414,0.000213,172.217.194.0-255,2902,35471,6,249466
13415,0.000215,172.31.36.0-255,66,35537,6,249466
13416,0.000221,172.217.194.0-255,4320,39857,6,249466
13417,0.000228,172.31.36.0-255,66,39923,6,249466
13418,0.000259,172.217.194.0-255,1484,41407,6,249466
13419,0.000262,172.31.36.0-255,66,41473,6,249466
13420,0.000271,172.217.194.0-255,6797,48270,6,249466
13421,0.000277,172.31.36.0-255,66,48336,6,249466
13422,0.000282,172.217.194.0-255,2902,51238,6,249466
13423,0.000285,172.31.36.0-255,66,51304,6,249466
13424,0.000328,172.31.36.0-255,66,51370,6,249466
13425,0.000333,172.217.194.0-255,2543,53913,6,249466
13426,0.000336,172.31.36.0-255,66,53979,6,249466
13427,0.000339,172.217.194.0-255,362,54341,6,249466
13428,0.000369,172.217.194.0-255,381,54722,6,249466
13429,0.000606,172.217.194.0-255,1484,56206,6,249466
13430,0.000612,172.31.36.0-255,66,56272,6,249466
13431,0.000618,172.217.194.0-255,2902,59174,6,249466
13432,0.000621,172.31.36.0-255,66,59240,6,249466
13433,0.000656,172.217.194.0-255,5738,64978,6,249466
13434,0.000659,172.31.36.0-255,66,65044,6,249466
13435,0.000664,172.217.194.0-255,2902,67946,6,249466
13436,0.000666,172.31.36.0-255,66,68012,6,249466
13437,0.000689,172.217.194.0-255,9992,78004,6,249466
13438,0.000692,172.31.36.0-255,66,78070,6,249466
13439,0.000701,172.217.194.0-255,9992,88062,6,249466
13440,0.000703,172.31.36.0-255,66,88128,6,249466
13441,0.000706,172.217.194.0-255,766,88894,6,249466
13442,0.000759,172.217.194.0-255,1484,90378,6,249466
13443,0.000765,172.217.194.0-255,4320,94698,6,249466
13444,0.000771,172.217.194.0-255,7156,101854,6,249466
13445,0.000776,172.31.36.0-255,66,101920,6,249466
13446,0.000784,172.31.36.0-255,66,101986,6,249466
13447,0.000786,172.31.36.0-255,66,102052,6,249466
13448,0.000795,172.217.194.0-255,2902,104954,6,249466
13449,0.000798,172.31.36.0-255,66,105020,6,249466
13450,0.000801,172.217.194.0-255,576,105596,6,249466
13451,0.000829,172.217.194.0-255,1484,107080,6,249466
13452,0.000832,172.31.36.0-255,66,107146,6,249466
13453,0.000836,172.217.194.0-255,2902,110048,6,249466
13454,0.000839,172.31.36.0-255,66,110114,6,249466
13455,0.000868,172.217.194.0-255,5738,115852,6,249466
13456,0.000871,172.31.36.0-255,66,115918,6,249466
13457,0.000891,172.31.36.0-255,66,115984,6,249466
13458,0.000894,172.217.194.0-255,1484,117468,6,249466
13459,0.000942,172.217.194.0-255,4320,121788,6,249466
13460,0.000946,172.31.36.0-255,66,121854,6,249466
13461,0.000989,172.31.36.0-255,66,121920,6,249466
13462,0.001008,172.31.36.0-255,66,121986,6,249466
13463,0.001028,172.31.36.0-255,66,122052,6,249466
13464,0.001053,172.217.194.0-255,4320,126372,6,249466
13465,0.001055,172.31.36.0-255,66,126438,6,249466
13466,0.001102,172.31.36.0-255,66,126504,6,249466
13467,0.001112,172.217.194.0-255,9633,136137,6,249466
13468,0.001115,172.31.36.0-255,66,136203,6,249466
13469,0.001158,172.217.194.0-255,9633,145836,6,249466
13470,0.001161,172.31.36.0-255,66,145902,6,249466
13471,0.001585,172.217.194.0-255,1484,147386,6,249466
13472,0.001591,172.217.194.0-255,2902,150288,6,249466
13473,0.001595,172.31.36.0-255,66,150354,6,249466
13474,0.001621,172.217.194.0-255,5738,156092,6,249466
13475,0.001623,172.31.36.0-255,66,156158,6,249466
13476,0.001653,172.217.194.0-255,5738,161896,6,249466
13477,0.001655,172.31.36.0-255,66,161962,6,249466
13478,0.001668,172.217.194.0-255,1125,163087,6,249466
13479,0.001767,172.217.194.0-255,1484,164571,6,249466
13480,0.001771,172.31.36.0-255,66,164637,6,249466
13481,0.001782,172.217.194.0-255,2902,167539,6,249466
13482,0.001789,172.31.36.0-255,66,167605,6,249466
13483,0.001796,172.217.194.0-255,5738,173343,6,249466
13484,0.001798,172.31.36.0-255,66,173409,6,249466
13485,0.001802,172.217.194.0-255,2902,176311,6,249466
13486,0.001804,172.31.36.0-255,66,176377,6,249466
13487,0.00184,172.217.194.0-255,9992,186369,6,249466
13488,0.001843,172.31.36.0-255,66,186435,6,249466
13489,0.001856,172.217.194.0-255,9992,196427,6,249466
13490,0.001858,172.31.36.0-255,66,196493,6,249466
13491,0.001895,172.217.194.0-255,2902,199395,6,249466
13492,0.001897,172.31.36.0-255,66,199461,6,249466
13493,0.001934,172.217.194.0-255,9274,208735,6,249466
13494,0.001968,172.217.194.0-255,5379,214114,6,249466
13495,0.001973,172.31.36.0-255,66,214180,6,249466
13496,0.001977,172.31.36.0-255,66,214246,6,249466
13497,0.001984,172.31.36.0-255,66,214312,6,249466
13498,0.001991,172.31.36.0-255,66,214378,6,249466
13499,0.002058,172.217.194.0-255,1484,215862,6,249466
13500,0.002078,172.217.194.0-255,2902,218764,6,249466
13501,0.002081,172.31.36.0-255,66,218830,6,249466
13502,0.002088,172.217.194.0-255,5738,224568,6,249466
13503,0.00209,172.31.36.0-255,66,224634,6,249466
13504,0.002125,172.217.194.0-255,7156,231790,6,249466
13505,0.002127,172.31.36.0-255,66,231856,6,249466
13506,0.002155,172.217.194.0-255,1484,233340,6,249466
13507,0.004206,172.217.194.0-255,4320,237660,6,249466
13508,0.004212,172.31.36.0-255,66,237726,6,249466
13509,0.006305,172.217.194.0-255,5738,243464,6,249466
13510,0.006312,172.31.36.0-255,66,243530,6,249466
13511,0.008411,172.217.194.0-255,2902,246432,6,249466
13512,0.008416,172.31.36.0-255,66,246498,6,249466
13513,0.00844,172.217.194.0-255,2902,249400,6,249466
13514,0.008443,172.31.36.0-255,66,249466,6,249466
13515,0.0,172.217.194.0-255,151,151,6,300670
13516,1.6e-05,172.31.36.0-255,66,217,6,300670
13517,2.2e-05,172.217.194.0-255,1484,1701,6,300670
13518,2.8e-05,172.31.36.0-255,66,1767,6,300670
13519,3.4e-05,172.217.194.0-255,2902,4669,6,300670
13520,3.8e-05,172.31.36.0-255,66,4735,6,300670
13521,4.1e-05,172.217.194.0-255,1484,6219,6,300670
13522,4.4e-05,172.31.36.0-255,66,6285,6,300670
13523,6.7e-05,172.217.194.0-255,4320,10605,6,300670
13524,7e-05,172.31.36.0-255,66,10671,6,300670
13525,8e-05,172.217.194.0-255,10573,21244,6,300670
13526,8.3e-05,172.31.36.0-255,66,21310,6,300670
13527,0.000108,172.217.194.0-255,9633,30943,6,300670
13528,0.000111,172.31.36.0-255,66,31009,6,300670
13529,0.000146,172.217.194.0-255,2902,33911,6,300670
13530,0.000148,172.31.36.0-255,66,33977,6,300670
13531,0.000173,172.217.194.0-255,7156,41133,6,300670
13532,0.000176,172.31.36.0-255,66,41199,6,300670
13533,0.000179,172.217.194.0-255,1484,42683,6,300670
13534,0.000181,172.31.36.0-255,66,42749,6,300670
13535,0.000195,172.31.36.0-255,66,42815,6,300670
13536,0.000225,172.217.194.0-255,5738,48553,6,300670
13537,0.000228,172.31.36.0-255,66,48619,6,300670
13538,0.00025,172.217.194.0-255,3602,52221,6,300670
13539,0.000253,172.31.36.0-255,66,52287,6,300670
13540,0.000255,172.217.194.0-255,343,52630,6,300670
13541,0.000257,172.31.36.0-255,66,52696,6,300670
13542,0.000295,172.217.194.0-255,113,52809,6,300670
13543,0.000297,172.31.36.0-255,66,52875,6,300670
13544,0.000454,172.217.194.0-255,1484,54359,6,300670
13545,0.000459,172.31.36.0-255,66,54425,6,300670
13546,0.000465,172.217.194.0-255,2902,57327,6,300670
13547,0.000478,172.217.194.0-255,1484,58811,6,300670
13548,0.000495,172.217.194.0-255,4320,63131,6,300670
13549,0.000498,172.217.194.0-255,1484,64615,6,300670
13550,0.000514,172.217.194.0-255,5738,70353,6,300670
13551,0.000534,172.217.194.0-255,4320,74673,6,300670
13552,0.000545,172.31.36.0-255,66,74739,6,300670
13553,0.000581,172.217.194.0-255,1484,76223,6,300670
13554,0.000608,172.217.194.0-255,10692,86915,6,300670
13555,0.000614,172.31.36.0-255,66,86981,6,300670
13556,0.000977,172.217.194.0-255,1484,88465,6,300670
13557,0.001008,172.217.194.0-255,2902,91367,6,300670
13558,0.001013,172.31.36.0-255,66,91433,6,300670
13559,0.001019,172.217.194.0-255,4320,95753,6,300670
13560,0.001035,172.217.194.0-255,5738,101491,6,300670
13561,0.00105,172.31.36.0-255,66,101557,6,300670
13562,0.001054,172.217.194.0-255,2902,104459,6,300670
13563,0.001057,172.217.194.0-255,1484,105943,6,300670
13564,0.001062,172.31.36.0-255,66,106009,6,300670
13565,0.001112,172.217.194.0-255,7156,113165,6,300670
13566,0.001128,172.217.194.0-255,5738,118903,6,300670
13567,0.001134,172.217.194.0-255,4320,123223,6,300670
13568,0.001142,172.31.36.0-255,66,123289,6,300670
13569,0.001157,172.217.194.0-255,9992,133281,6,300670
13570,0.001163,172.31.36.0-255,66,133347,6,300670
13571,0.001182,172.217.194.0-255,6438,139785,6,300670
13572,0.001195,172.31.36.0-255,66,139851,6,300670
13573,0.001795,172.217.194.0-255,1484,141335,6,300670
13574,0.0018,172.217.194.0-255,2902,144237,6,300670
13575,0.00181,172.31.36.0-255,66,144303,6,300670
13576,0.001819,172.217.194.0-255,5738,150041,6,300670
13577,0.001843,172.31.36.0-255,66,150107,6,300670
13578,0.001865,172.31.36.0-255,66,150173,6,300670
13579,0.001895,172.217.194.0-255,10692,160865,6,300670
13580,0.001906,172.31.36.0-255,66,160931,6,300670
13581,0.001981,172.217.194.0-255,1484,162415,6,300670
13582,0.001986,172.217.194.0-255,2902,165317,6,300670
13583,0.001994,172.31.36.0-255,66,165383,6,300670
13584,0.002016,172.217.194.0-255,5738,171121,6,300670
13585,0.002022,172.217.194.0-255,4320,175441,6,300670
13586,0.002029,172.31.36.0-255,66,175507,6,300670
13587,0.002038,172.217.194.0-255,4320,179827,6,300670
13588,0.002057,172.31.36.0-255,66,179893,6,300670
13589,0.002074,172.217.194.0-255,4320,184213,6,300670
13590,0.002096,172.217.194.0-255,10692,194905,6,300670
13591,0.002099,172.31.36.0-255,66,194971,6,300670
13592,0.002108,172.31.36.0-255,66,195037,6,300670
13593,0.002236,172.217.194.0-255,1484,196521,6,300670
13594,0.002242,172.217.194.0-255,2902,199423,6,300670
13595,0.002261,172.31.36.0-255,66,199489,6,300670
13596,0.002301,172.217.194.0-255,2902,202391,6,300670
13597,0.002322,172.217.194.0-255,2902,205293,6,300670
13598,0.002325,172.217.194.0-255,1484,206777,6,300670
13599,0.002328,172.217.194.0-255,1484,208261,6,300670
13600,0.00234,172.217.194.0-255,7156,215417,6,300670
13601,0.002363,172.217.194.0-255,7156,222573,6,300670
13602,0.002381,172.217.194.0-255,1484,224057,6,300670
13603,0.002383,172.217.194.0-255,1484,225541,6,300670
13604,0.002388,172.217.194.0-255,3602,229143,6,300670
13605,0.00254,172.217.194.0-255,1484,230627,6,300670
13606,0.002544,172.217.194.0-255,1484,232111,6,300670
13607,0.00257,172.217.194.0-255,4320,236431,6,300670
13608,0.00258,172.217.194.0-255,1484,237915,6,300670
13609,0.002597,172.217.194.0-255,5738,243653,6,300670
13610,0.002605,172.217.194.0-255,7156,250809,6,300670
13611,0.002618,172.217.194.0-255,1484,252293,6,300670
13612,0.002646,172.217.194.0-255,10692,262985,6,300670
13613,0.00269,172.217.194.0-255,4320,267305,6,300670
13614,0.002721,172.217.194.0-255,8574,275879,6,300670
13615,0.002731,172.217.194.0-255,9274,285153,6,300670
13616,0.002767,172.217.194.0-255,1484,286637,6,300670
13617,0.002802,172.217.194.0-255,9274,295911,6,300670
13618,0.002806,172.217.194.0-255,2902,298813,6,300670
13619,0.002854,172.217.194.0-255,1484,300297,6,300670
13620,0.002895,172.217.194.0-255,97,300394,6,300670
13621,0.002907,172.217.194.0-255,105,300499,6,300670
13622,0.007938,172.31.36.0-255,66,300565,6,300670
13623,0.0098,172.31.36.0-255,105,300670,6,300670
13624,0.0,172.217.194.0-255,153,153,6,246789
13625,1.5e-05,172.31.36.0-255,66,219,6,246789
13626,2.3e-05,172.217.194.0-255,1484,1703,6,246789
13627,2.8e-05,172.31.36.0-255,66,1769,6,246789
13628,3.4e-05,172.217.194.0-255,2902,4671,6,246789
13629,3.7e-05,172.31.36.0-255,66,4737,6,246789
13630,4.5e-05,172.217.194.0-255,7156,11893,6,246789
13631,4.8e-05,172.31.36.0-255,66,11959,6,246789
13632,7.4e-05,172.217.194.0-255,1484,13443,6,246789
13633,7.6e-05,172.31.36.0-255,66,13509,6,246789
13634,9.2e-05,172.217.194.0-255,603,14112,6,246789
13635,9.4e-05,172.31.36.0-255,66,14178,6,246789
13636,0.000125,172.217.194.0-255,2902,17080,6,246789
13637,0.000128,172.31.36.0-255,66,17146,6,246789
13638,0.000144,172.217.194.0-255,7156,24302,6,246789
13639,0.000147,172.31.36.0-255,66,24368,6,246789
13640,0.000154,172.217.194.0-255,5738,30106,6,246789
13641,0.000157,172.31.36.0-255,66,30172,6,246789
13642,0.000175,172.217.194.0-255,1125,31297,6,246789
13643,0.000177,172.31.36.0-255,66,31363,6,246789
13644,0.000281,172.217.194.0-255,1484,32847,6,246789
13645,0.000285,172.31.36.0-255,66,32913,6,246789
13646,0.00029,172.217.194.0-255,1484,34397,6,246789
13647,0.000292,172.31.36.0-255,66,34463,6,246789
13648,0.000304,172.217.194.0-255,1484,35947,6,246789
13649,0.000306,172.31.36.0-255,66,36013,6,246789
13650,0.000311,172.217.194.0-255,2902,38915,6,246789
13651,0.000314,172.31.36.0-255,66,38981,6,246789
13652,0.000317,172.217.194.0-255,1484,40465,6,246789
13653,0.000319,172.31.36.0-255,66,40531,6,246789
13654,0.000343,172.217.194.0-255,5738,46269,6,246789
13655,0.000346,172.31.36.0-255,66,46335,6,246789
13656,0.000397,172.31.36.0-255,66,46401,6,246789
13657,0.00042,172.217.194.0-255,3122,49523,6,246789
13658,0.000422,172.31.36.0-255,66,49589,6,246789
13659,0.000716,172.217.194.0-255,1484,51073,6,246789
13660,0.000721,172.217.194.0-255,2902,53975,6,246789
13661,0.000726,172.217.194.0-255,5738,59713,6,246789
13662,0.000742,172.31.36.0-255,66,59779,6,246789
13663,0.000746,172.31.36.0-255,66,59845,6,246789
13664,0.000785,172.31.36.0-255,66,59911,6,246789
13665,0.000802,172.217.194.0-255,1484,61395,6,246789
13666,0.000814,172.217.194.0-255,10692,72087,6,246789
13667,0.000816,172.31.36.0-255,66,72153,6,246789
13668,0.000819,172.217.194.0-255,1484,73637,6,246789
13669,0.000824,172.217.194.0-255,2902,76539,6,246789
13670,0.000826,172.31.36.0-255,66,76605,6,246789
13671,0.000845,172.217.194.0-255,4320,80925,6,246789
13672,0.000848,172.31.36.0-255,66,80991,6,246789
13673,0.000864,172.217.194.0-255,1484,82475,6,246789
13674,0.000869,172.217.194.0-255,2902,85377,6,246789
13675,0.000871,172.31.36.0-255,66,85443,6,246789
13676,0.000909,172.217.194.0-255,5738,91181,6,246789
13677,0.000912,172.31.36.0-255,66,91247,6,246789
13678,0.000921,172.217.194.0-255,9992,101239,6,246789
13679,0.000923,172.31.36.0-255,66,101305,6,246789
13680,0.000929,172.217.194.0-255,5020,106325,6,246789
13681,0.000932,172.31.36.0-255,66,106391,6,246789
13682,0.001009,172.217.194.0-255,1484,107875,6,246789
13683,0.001017,172.217.194.0-255,2902,110777,6,246789
13684,0.00102,172.31.36.0-255,66,110843,6,246789
13685,0.001043,172.217.194.0-255,5738,116581,6,246789
13686,0.001048,172.31.36.0-255,66,116647,6,246789
13687,0.001071,172.217.194.0-255,8574,125221,6,246789
13688,0.001074,172.31.36.0-255,66,125287,6,246789
13689,0.001102,172.217.194.0-255,4320,129607,6,246789
13690,0.001105,172.31.36.0-255,66,129673,6,246789
13691,0.001115,172.217.194.0-255,10692,140365,6,246789
13692,0.001117,172.31.36.0-255,66,140431,6,246789
13693,0.001161,172.217.194.0-255,1484,141915,6,246789
13694,0.001166,172.217.194.0-255,2902,144817,6,246789
13695,0.001169,172.31.36.0-255,66,144883,6,246789
13696,0.001173,172.217.194.0-255,1484,146367,6,246789
13697,0.001195,172.217.194.0-255,4320,150687,6,246789
13698,0.001198,172.31.36.0-255,66,150753,6,246789
13699,0.001205,172.217.194.0-255,7156,157909,6,246789
13700,0.001208,172.31.36.0-255,66,157975,6,246789
13701,0.001223,172.31.36.0-255,66,158041,6,246789
13702,0.001267,172.31.36.0-255,66,158107,6,246789
13703,0.001286,172.217.194.0-255,2902,161009,6,246789
13704,0.001288,172.31.36.0-255,66,161075,6,246789
13705,0.001323,172.31.36.0-255,66,161141,6,246789
13706,0.001326,172.217.194.0-255,1484,162625,6,246789
13707,0.001328,172.217.194.0-255,766,163391,6,246789
13708,0.001331,172.31.36.0-255,66,163457,6,246789
13709,0.001655,172.217.194.0-255,1484,164941,6,246789
13710,0.001659,172.217.194.0-255,1484,166425,6,246789
13711,0.001662,172.31.36.0-255,66,166491,6,246789
13712,0.001682,172.217.194.0-255,1484,167975,6,246789
13713,0.001689,172.217.194.0-255,5738,173713,6,246789
13714,0.001691,172.31.36.0-255,66,173779,6,246789
13715,0.001698,172.217.194.0-255,4320,178099,6,246789
13716,0.0017,172.31.36.0-255,66,178165,6,246789
13717,0.001719,172.217.194.0-255,2902,181067,6,246789
13718,0.001721,172.31.36.0-255,66,181133,6,246789
13719,0.001747,172.217.194.0-255,8574,189707,6,246789
13720,0.00175,172.31.36.0-255,66,189773,6,246789
13721,0.001759,172.217.194.0-255,7856,197629,6,246789
13722,0.001761,172.31.36.0-255,66,197695,6,246789
13723,0.00187,172.217.194.0-255,1484,199179,6,246789
13724,0.001883,172.217.194.0-255,2902,202081,6,246789
13725,0.001888,172.31.36.0-255,66,202147,6,246789
13726,0.001899,172.217.194.0-255,4320,206467,6,246789
13727,0.001901,172.31.36.0-255,66,206533,6,246789
13728,0.001916,172.217.194.0-255,1484,208017,6,246789
13729,0.001922,172.217.194.0-255,5738,213755,6,246789
13730,0.001923,172.31.36.0-255,66,213821,6,246789
13731,0.001955,172.217.194.0-255,7156,220977,6,246789
13732,0.001958,172.31.36.0-255,66,221043,6,246789
13733,0.001983,172.217.194.0-255,1484,222527,6,246789
13734,0.002029,172.31.36.0-255,66,222593,6,246789
13735,0.00204,172.31.36.0-255,66,222659,6,246789
13736,0.002065,172.217.194.0-255,8574,231233,6,246789
13737,0.002067,172.31.36.0-255,66,231299,6,246789
13738,0.00211,172.217.194.0-255,10692,241991,6,246789
13739,0.002112,172.217.194.0-255,1484,243475,6,246789
13740,0.002117,172.31.36.0-255,66,243541,6,246789
13741,0.002158,172.217.194.0-255,2972,246513,6,246789
13742,0.002161,172.217.194.0-255,105,246618,6,246789
13743,0.002178,172.31.36.0-255,66,246684,6,246789
13744,0.008275,172.31.36.0-255,105,246789,6,246789
13745,0.0,74.125.200.0-255,153,153,6,316759
13746,2.9e-05,172.31.36.0-255,66,219,6,316759
13747,3.5e-05,74.125.200.0-255,1484,1703,6,316759
13748,4e-05,172.31.36.0-255,66,1769,6,316759
13749,4.5e-05,74.125.200.0-255,2902,4671,6,316759
13750,5.6e-05,172.31.36.0-255,66,4737,6,316759
13751,6.1e-05,74.125.200.0-255,4320,9057,6,316759
13752,6.4e-05,172.31.36.0-255,66,9123,6,316759
13753,8.9e-05,74.125.200.0-255,1484,10607,6,316759
13754,9.2e-05,172.31.36.0-255,66,10673,6,316759
13755,0.000101,74.125.200.0-255,2902,13575,6,316759
13756,0.000104,172.31.36.0-255,66,13641,6,316759
13757,0.000107,74.125.200.0-255,664,14305,6,316759
13758,0.000109,172.31.36.0-255,66,14371,6,316759
13759,0.000191,74.125.200.0-255,1484,15855,6,316759
13760,0.000195,172.31.36.0-255,66,15921,6,316759
13761,0.000207,74.125.200.0-255,1484,17405,6,316759
13762,0.000214,172.31.36.0-255,66,17471,6,316759
13763,0.000227,74.125.200.0-255,1484,18955,6,316759
13764,0.000233,172.31.36.0-255,66,19021,6,316759
13765,0.00024,74.125.200.0-255,5738,24759,6,316759
13766,0.000243,172.31.36.0-255,66,24825,6,316759
13767,0.000248,74.125.200.0-255,4320,29145,6,316759
13768,0.000252,172.31.36.0-255,66,29211,6,316759
13769,0.000286,74.125.200.0-255,2543,31754,6,316759
13770,0.000289,172.31.36.0-255,66,31820,6,316759
13771,0.000296,74.125.200.0-255,5738,37558,6,316759
13772,0.000299,172.31.36.0-255,66,37624,6,316759
13773,0.000312,74.125.200.0-255,7156,44780,6,316759
13774,0.000315,172.31.36.0-255,66,44846,6,316759
13775,0.000347,74.125.200.0-255,3961,48807,6,316759
13776,0.000351,172.31.36.0-255,66,48873,6,316759
13777,0.000744,74.125.200.0-255,1484,50357,6,316759
13778,0.000772,74.125.200.0-255,2902,53259,6,316759
13779,0.000777,172.31.36.0-255,66,53325,6,316759
13780,0.000782,74.125.200.0-255,1484,54809,6,316759
13781,0.000828,74.125.200.0-255,2902,57711,6,316759
13782,0.000832,172.31.36.0-255,66,57777,6,316759
13783,0.000838,74.125.200.0-255,4320,62097,6,316759
13784,0.00084,172.31.36.0-255,66,62163,6,316759
13785,0.000889,74.125.200.0-255,3961,66124,6,316759
13786,0.000894,172.31.36.0-255,66,66190,6,316759
13787,0.000934,74.125.200.0-255,1484,67674,6,316759
13788,0.000956,74.125.200.0-255,2902,70576,6,316759
13789,0.00096,172.31.36.0-255,66,70642,6,316759
13790,0.000963,74.125.200.0-255,1484,72126,6,316759
13791,0.000987,74.125.200.0-255,4320,76446,6,316759
13792,0.000989,172.31.36.0-255,66,76512,6,316759
13793,0.000995,74.125.200.0-255,4320,80832,6,316759
13794,0.000997,172.31.36.0-255,66,80898,6,316759
13795,0.001021,74.125.200.0-255,5379,86277,6,316759
13796,0.001031,172.31.36.0-255,66,86343,6,316759
13797,0.001037,74.125.200.0-255,4320,90663,6,316759
13798,0.001039,172.31.36.0-255,66,90729,6,316759
13799,0.001074,74.125.200.0-255,7156,97885,6,316759
13800,0.001077,172.31.36.0-255,66,97951,6,316759
13801,0.001109,74.125.200.0-255,3124,101075,6,316759
13802,0.001112,172.31.36.0-255,66,101141,6,316759
13803,0.001241,74.125.200.0-255,1484,102625,6,316759
13804,0.001248,74.125.200.0-255,2902,105527,6,316759
13805,0.001252,172.31.36.0-255,66,105593,6,316759
13806,0.001289,74.125.200.0-255,5738,111331,6,316759
13807,0.001293,172.31.36.0-255,66,111397,6,316759
13808,0.001299,74.125.200.0-255,7156,118553,6,316759
13809,0.001302,172.31.36.0-255,66,118619,6,316759
13810,0.001344,74.125.200.0-255,5738,124357,6,316759
13811,0.001349,172.31.36.0-255,66,124423,6,316759
13812,0.001356,74.125.200.0-255,7156,131579,6,316759
13813,0.001358,172.31.36.0-255,66,131645,6,316759
13814,0.001392,74.125.200.0-255,3602,135247,6,316759
13815,0.001396,172.31.36.0-255,66,135313,6,316759
13816,0.001456,74.125.200.0-255,1484,136797,6,316759
13817,0.001461,74.125.200.0-255,1484,138281,6,316759
13818,0.001464,172.31.36.0-255,66,138347,6,316759
13819,0.001493,74.125.200.0-255,1484,139831,6,316759
13820,0.001501,74.125.200.0-255,5738,145569,6,316759
13821,0.001504,172.31.36.0-255,66,145635,6,316759
13822,0.001532,74.125.200.0-255,7156,152791,6,316759
13823,0.001535,172.31.36.0-255,66,152857,6,316759
13824,0.001563,74.125.200.0-255,5738,158595,6,316759
13825,0.001565,172.31.36.0-255,66,158661,6,316759
13826,0.00157,74.125.200.0-255,4320,162981,6,316759
13827,0.001572,172.31.36.0-255,66,163047,6,316759
13828,0.001606,74.125.200.0-255,2902,165949,6,316759
13829,0.001609,172.31.36.0-255,66,166015,6,316759
13830,0.001614,74.125.200.0-255,3602,169617,6,316759
13831,0.001616,172.31.36.0-255,66,169683,6,316759
13832,0.001677,74.125.200.0-255,1484,171167,6,316759
13833,0.00169,74.125.200.0-255,1484,172651,6,316759
13834,0.001693,172.31.36.0-255,66,172717,6,316759
13835,0.001728,74.125.200.0-255,2902,175619,6,316759
13836,0.001731,172.31.36.0-255,66,175685,6,316759
13837,0.001757,74.125.200.0-255,5738,181423,6,316759
13838,0.001759,172.31.36.0-255,66,181489,6,316759
13839,0.001762,74.125.200.0-255,1484,182973,6,316759
13840,0.001786,74.125.200.0-255,5738,188711,6,316759
13841,0.001789,172.31.36.0-255,66,188777,6,316759
13842,0.001812,74.125.200.0-255,7156,195933,6,316759
13843,0.001815,172.31.36.0-255,66,195999,6,316759
13844,0.001844,74.125.200.0-255,7156,203155,6,316759
13845,0.001847,172.31.36.0-255,66,203221,6,316759
13846,0.001849,74.125.200.0-255,766,203987,6,316759
13847,0.001873,74.125.200.0-255,1484,205471,6,316759
13848,0.001875,172.31.36.0-255,66,205537,6,316759
13849,0.001901,74.125.200.0-255,4320,209857,6,316759
13850,0.001904,172.31.36.0-255,66,209923,6,316759
13851,0.001906,74.125.200.0-255,1484,211407,6,316759
13852,0.001933,74.125.200.0-255,2902,214309,6,316759
13853,0.001936,172.31.36.0-255,66,214375,6,316759
13854,0.00197,74.125.200.0-255,1484,215859,6,316759
13855,0.001984,74.125.200.0-255,1484,217343,6,316759
13856,0.001986,172.31.36.0-255,66,217409,6,316759
13857,0.002012,74.125.200.0-255,1484,218893,6,316759
13858,0.002015,74.125.200.0-255,1484,220377,6,316759
13859,0.002018,172.31.36.0-255,66,220443,6,316759
13860,0.002035,74.125.200.0-255,2902,223345,6,316759
13861,0.002038,172.31.36.0-255,66,223411,6,316759
13862,0.002055,74.125.200.0-255,2902,226313,6,316759
13863,0.002057,172.31.36.0-255,66,226379,6,316759
13864,0.00208,74.125.200.0-255,1484,227863,6,316759
13865,0.002096,74.125.200.0-255,2902,230765,6,316759
13866,0.00211,74.125.200.0-255,2902,233667,6,316759
13867,0.002149,74.125.200.0-255,5020,238687,6,316759
13868,0.002329,74.125.200.0-255,1484,240171,6,316759
13869,0.002341,74.125.200.0-255,1484,241655,6,316759
13870,0.002351,74.125.200.0-255,1484,243139,6,316759
13871,0.002374,74.125.200.0-255,2902,246041,6,316759
13872,0.002379,74.125.200.0-255,4320,250361,6,316759
13873,0.002388,74.125.200.0-255,2902,253263,6,316759
13874,0.002406,74.125.200.0-255,5738,259001,6,316759
13875,0.002409,74.125.200.0-255,1484,260485,6,316759
13876,0.002413,74.125.200.0-255,2902,263387,6,316759
13877,0.00244,74.125.200.0-255,5738,269125,6,316759
13878,0.002459,74.125.200.0-255,3602,272727,6,316759
13879,0.002464,74.125.200.0-255,4320,277047,6,316759
13880,0.002487,74.125.200.0-255,1484,278531,6,316759
13881,0.00251,74.125.200.0-255,8574,287105,6,316759
13882,0.002516,74.125.200.0-255,4320,291425,6,316759
13883,0.002538,74.125.200.0-255,5738,297163,6,316759
13884,0.002569,74.125.200.0-255,9274,306437,6,316759
13885,0.004564,172.31.36.0-255,66,306503,6,316759
13886,0.007108,74.125.200.0-255,4320,310823,6,316759
13887,0.007115,172.31.36.0-255,66,310889,6,316759
13888,0.007145,74.125.200.0-255,1484,312373,6,316759
13889,0.009653,74.125.200.0-255,4320,316693,6,316759
13890,0.00966,172.31.36.0-255,66,316759,6,316759
13891,0.0,74.125.24.0-255,152,152,6,183091
13892,2.9e-05,172.31.36.0-255,66,218,6,183091
13893,3.6e-05,74.125.24.0-255,1484,1702,6,183091
13894,4e-05,172.31.36.0-255,66,1768,6,183091
13895,5.2e-05,74.125.24.0-255,2902,4670,6,183091
13896,5.4e-05,172.31.36.0-255,66,4736,6,183091
13897,6.2e-05,74.125.24.0-255,7156,11892,6,183091
13898,6.4e-05,172.31.36.0-255,66,11958,6,183091
13899,0.000104,74.125.24.0-255,2065,14023,6,183091
13900,0.000107,172.31.36.0-255,66,14089,6,183091
13901,0.000171,74.125.24.0-255,1484,15573,6,183091
13902,0.000174,172.31.36.0-255,66,15639,6,183091
13903,0.000179,74.125.24.0-255,2902,18541,6,183091
13904,0.000182,172.31.36.0-255,66,18607,6,183091
13905,0.000194,74.125.24.0-255,4320,22927,6,183091
13906,0.000196,172.31.36.0-255,66,22993,6,183091
13907,0.000225,74.125.24.0-255,1484,24477,6,183091
13908,0.000228,172.31.36.0-255,66,24543,6,183091
13909,0.000256,74.125.24.0-255,6797,31340,6,183091
13910,0.000259,172.31.36.0-255,66,31406,6,183091
13911,0.000506,74.125.24.0-255,1484,32890,6,183091
13912,0.000512,74.125.24.0-255,2902,35792,6,183091
13913,0.000512,172.31.36.0-255,66,35858,6,183091
13914,0.000516,172.31.36.0-255,66,35924,6,183091
13915,0.000545,74.125.24.0-255,5738,41662,6,183091
13916,0.000549,172.31.36.0-255,66,41728,6,183091
13917,0.000562,74.125.24.0-255,8215,49943,6,183091
13918,0.000564,172.31.36.0-255,66,50009,6,183091
13919,0.000572,74.125.24.0-255,8574,58583,6,183091
13920,0.000574,172.31.36.0-255,66,58649,6,183091
13921,0.000603,74.125.24.0-255,6797,65446,6,183091
13922,0.000607,172.31.36.0-255,66,65512,6,183091
13923,0.000745,74.125.24.0-255,400,65912,6,183091
13924,0.000826,172.31.36.0-255,66,65978,6,183091
13925,0.001044,74.125.24.0-255,1484,67462,6,183091
13926,0.001054,74.125.24.0-255,2902,70364,6,183091
13927,0.001058,172.31.36.0-255,66,70430,6,183091
13928,0.001066,74.125.24.0-255,5738,76168,6,183091
13929,0.001068,172.31.36.0-255,66,76234,6,183091
13930,0.001099,74.125.24.0-255,5738,81972,6,183091
13931,0.001103,172.31.36.0-255,66,82038,6,183091
13932,0.001124,74.125.24.0-255,7156,89194,6,183091
13933,0.001127,172.31.36.0-255,66,89260,6,183091
13934,0.001138,74.125.24.0-255,10692,99952,6,183091
13935,0.001141,172.31.36.0-255,66,100018,6,183091
13936,0.001395,74.125.24.0-255,343,100361,6,183091
13937,0.001725,74.125.24.0-255,1484,101845,6,183091
13938,0.001729,172.31.36.0-255,66,101911,6,183091
13939,0.001734,74.125.24.0-255,2902,104813,6,183091
13940,0.001736,172.31.36.0-255,66,104879,6,183091
13941,0.001751,74.125.24.0-255,1484,106363,6,183091
13942,0.001773,74.125.24.0-255,4320,110683,6,183091
13943,0.001776,172.31.36.0-255,66,110749,6,183091
13944,0.00178,74.125.24.0-255,4320,115069,6,183091
13945,0.001782,172.31.36.0-255,66,115135,6,183091
13946,0.001817,172.31.36.0-255,66,115201,6,183091
13947,0.001823,74.125.24.0-255,5738,120939,6,183091
13948,0.001824,172.31.36.0-255,66,121005,6,183091
13949,0.001846,74.125.24.0-255,2184,123189,6,183091
13950,0.001848,172.31.36.0-255,66,123255,6,183091
13951,0.001854,74.125.24.0-255,7156,130411,6,183091
13952,0.001856,172.31.36.0-255,66,130477,6,183091
13953,0.001875,74.125.24.0-255,1484,131961,6,183091
13954,0.001887,172.31.36.0-255,66,132027,6,183091
13955,0.00192,74.125.24.0-255,4320,136347,6,183091
13956,0.001922,172.31.36.0-255,66,136413,6,183091
13957,0.001939,74.125.24.0-255,7856,144269,6,183091
13958,0.001941,172.31.36.0-255,66,144335,6,183091
13959,0.002149,74.125.24.0-255,1484,145819,6,183091
13960,0.002152,74.125.24.0-255,1484,147303,6,183091
13961,0.002154,172.31.36.0-255,66,147369,6,183091
13962,0.002175,74.125.24.0-255,1484,148853,6,183091
13963,0.002178,74.125.24.0-255,1484,150337,6,183091
13964,0.002179,172.31.36.0-255,66,150403,6,183091
13965,0.002204,74.125.24.0-255,4320,154723,6,183091
13966,0.002206,172.31.36.0-255,66,154789,6,183091
13967,0.002217,172.31.36.0-255,66,154855,6,183091
13968,0.002247,74.125.24.0-255,1484,156339,6,183091
13969,0.002271,74.125.24.0-255,9274,165613,6,183091
13970,0.002273,172.31.36.0-255,66,165679,6,183091
13971,0.004524,74.125.24.0-255,5738,171417,6,183091
13972,0.00453,172.31.36.0-255,66,171483,6,183091
13973,0.006809,74.125.24.0-255,5738,177221,6,183091
13974,0.006814,172.31.36.0-255,66,177287,6,183091
13975,0.009082,74.125.24.0-255,5738,183025,6,183091
13976,0.009091,172.31.36.0-255,66,183091,6,183091
13977,0.0,172.217.194.0-255,153,153,6,228774
13978,1.5e-05,172.31.36.0-255,66,219,6,228774
13979,2.2e-05,172.217.194.0-255,1484,1703,6,228774
13980,2.7e-05,172.31.36.0-255,66,1769,6,228774
13981,3.3e-05,172.217.194.0-255,2902,4671,6,228774
13982,4.5e-05,172.31.36.0-255,66,4737,6,228774
13983,5.1e-05,172.217.194.0-255,4320,9057,6,228774
13984,5.4e-05,172.31.36.0-255,66,9123,6,228774
13985,7.5e-05,172.217.194.0-255,9129,18252,6,228774
13986,7.9e-05,172.31.36.0-255,66,18318,6,228774
13987,8.4e-05,172.217.194.0-255,4320,22638,6,228774
13988,8.7e-05,172.31.36.0-255,66,22704,6,228774
13989,0.000122,172.217.194.0-255,1484,24188,6,228774
13990,0.000125,172.31.36.0-255,66,24254,6,228774
13991,0.000133,172.217.194.0-255,6797,31051,6,228774
13992,0.00014,172.31.36.0-255,66,31117,6,228774
13993,0.000348,172.217.194.0-255,1484,32601,6,228774
13994,0.000352,172.31.36.0-255,66,32667,6,228774
13995,0.000358,172.217.194.0-255,2902,35569,6,228774
13996,0.000361,172.31.36.0-255,66,35635,6,228774
13997,0.000368,172.217.194.0-255,1484,37119,6,228774
13998,0.00037,172.31.36.0-255,66,37185,6,228774
13999,0.000375,172.217.194.0-255,2902,40087,6,228774
14000,0.000377,172.31.36.0-255,66,40153,6,228774
14001,0.000381,172.217.194.0-255,2902,43055,6,228774
14002,0.000384,172.31.36.0-255,66,43121,6,228774
14003,0.000412,172.217.194.0-255,2902,46023,6,228774
14004,0.000415,172.31.36.0-255,66,46089,6,228774
14005,0.000419,172.217.194.0-255,2902,48991,6,228774
14006,0.000421,172.31.36.0-255,66,49057,6,228774
14007,0.000474,172.217.194.0-255,5654,54711,6,228774
14008,0.000478,172.31.36.0-255,66,54777,6,228774
14009,0.000481,172.31.36.0-255,66,54843,6,228774
14010,0.000576,172.217.194.0-255,1484,56327,6,228774
14011,0.000614,172.217.194.0-255,2902,59229,6,228774
14012,0.000617,172.31.36.0-255,66,59295,6,228774
14013,0.000624,172.217.194.0-255,5738,65033,6,228774
14014,0.000626,172.31.36.0-255,66,65099,6,228774
14015,0.000629,172.217.194.0-255,1484,66583,6,228774
14016,0.000655,172.217.194.0-255,5672,72255,6,228774
14017,0.000658,172.31.36.0-255,66,72321,6,228774
14018,0.000665,172.217.194.0-255,7156,79477,6,228774
14019,0.000668,172.31.36.0-255,66,79543,6,228774
14020,0.000697,172.217.194.0-255,9633,89176,6,228774
14021,0.0007,172.31.36.0-255,66,89242,6,228774
14022,0.001117,172.217.194.0-255,1484,90726,6,228774
14023,0.001123,172.217.194.0-255,2902,93628,6,228774
14024,0.001126,172.31.36.0-255,66,93694,6,228774
14025,0.001157,172.217.194.0-255,5738,99432,6,228774
14026,0.00116,172.31.36.0-255,66,99498,6,228774
14027,0.001164,172.217.194.0-255,2902,102400,6,228774
14028,0.001166,172.31.36.0-255,66,102466,6,228774
14029,0.001177,172.217.194.0-255,9992,112458,6,228774
14030,0.001178,172.31.36.0-255,66,112524,6,228774
14031,0.00121,172.217.194.0-255,4320,116844,6,228774
14032,0.001213,172.31.36.0-255,66,116910,6,228774
14033,0.001245,172.217.194.0-255,6438,123348,6,228774
14034,0.001247,172.31.36.0-255,66,123414,6,228774
14035,0.001348,172.217.194.0-255,1484,124898,6,228774
14036,0.001352,172.217.194.0-255,1484,126382,6,228774
14037,0.001355,172.31.36.0-255,66,126448,6,228774
14038,0.001379,172.217.194.0-255,1484,127932,6,228774
14039,0.001382,172.217.194.0-255,1484,129416,6,228774
14040,0.001384,172.31.36.0-255,66,129482,6,228774
14041,0.00141,172.217.194.0-255,4320,133802,6,228774
14042,0.001412,172.31.36.0-255,66,133868,6,228774
14043,0.001441,172.217.194.0-255,2902,136770,6,228774
14044,0.001444,172.31.36.0-255,66,136836,6,228774
14045,0.001472,172.217.194.0-255,8574,145410,6,228774
14046,0.001475,172.31.36.0-255,66,145476,6,228774
14047,0.001481,172.217.194.0-255,5738,151214,6,228774
14048,0.001483,172.31.36.0-255,66,151280,6,228774
14049,0.001541,172.217.194.0-255,6438,157718,6,228774
14050,0.001545,172.31.36.0-255,66,157784,6,228774
14051,0.001836,172.217.194.0-255,1484,159268,6,228774
14052,0.001839,172.217.194.0-255,1484,160752,6,228774
14053,0.001846,172.31.36.0-255,66,160818,6,228774
14054,0.001857,172.217.194.0-255,1484,162302,6,228774
14055,0.001868,172.217.194.0-255,5738,168040,6,228774
14056,0.001871,172.31.36.0-255,66,168106,6,228774
14057,0.001874,172.217.194.0-255,1484,169590,6,228774
14058,0.001906,172.217.194.0-255,5738,175328,6,228774
14059,0.001909,172.31.36.0-255,66,175394,6,228774
14060,0.001936,172.31.36.0-255,66,175460,6,228774
14061,0.001941,172.217.194.0-255,2184,177644,6,228774
14062,0.001943,172.31.36.0-255,66,177710,6,228774
14063,0.002163,172.217.194.0-255,1484,179194,6,228774
14064,0.002167,172.217.194.0-255,1484,180678,6,228774
14065,0.00217,172.31.36.0-255,66,180744,6,228774
14066,0.002195,172.217.194.0-255,1484,182228,6,228774
14067,0.002202,172.217.194.0-255,5738,187966,6,228774
14068,0.002205,172.31.36.0-255,66,188032,6,228774
14069,0.002234,172.31.36.0-255,66,188098,6,228774
14070,0.00224,172.217.194.0-255,5738,193836,6,228774
14071,0.002243,172.31.36.0-255,66,193902,6,228774
14072,0.002278,172.217.194.0-255,5020,198922,6,228774
14073,0.002281,172.31.36.0-255,66,198988,6,228774
14074,0.002286,172.217.194.0-255,4320,203308,6,228774
14075,0.002288,172.31.36.0-255,66,203374,6,228774
14076,0.00237,172.31.36.0-255,66,203440,6,228774
14077,0.002378,172.217.194.0-255,7856,211296,6,228774
14078,0.00238,172.31.36.0-255,66,211362,6,228774
14079,0.004702,172.217.194.0-255,5738,217100,6,228774
14080,0.004709,172.31.36.0-255,66,217166,6,228774
14081,0.006973,172.217.194.0-255,5738,222904,6,228774
14082,0.00698,172.31.36.0-255,66,222970,6,228774
14083,0.009303,172.217.194.0-255,5738,228708,6,228774
14084,0.009307,172.31.36.0-255,66,228774,6,228774
14085,0.0,172.217.194.0-255,152,152,6,132144
14086,1.6e-05,172.31.36.0-255,66,218,6,132144
14087,2.2e-05,172.217.194.0-255,1484,1702,6,132144
14088,2.7e-05,172.31.36.0-255,66,1768,6,132144
14089,3.2e-05,172.217.194.0-255,2902,4670,6,132144
14090,3.6e-05,172.31.36.0-255,66,4736,6,132144
14091,4.4e-05,172.217.194.0-255,7156,11892,6,132144
14092,4.7e-05,172.31.36.0-255,66,11958,6,132144
14093,5.1e-05,172.217.194.0-255,1484,13442,6,132144
14094,5.4e-05,172.31.36.0-255,66,13508,6,132144
14095,9.1e-05,172.217.194.0-255,4320,17828,6,132144
14096,9.4e-05,172.31.36.0-255,66,17894,6,132144
14097,0.000126,172.217.194.0-255,10558,28452,6,132144
14098,0.000129,172.31.36.0-255,66,28518,6,132144
14099,0.000143,172.31.36.0-255,66,28584,6,132144
14100,0.000179,172.31.36.0-255,66,28650,6,132144
14101,0.000216,172.31.36.0-255,66,28716,6,132144
14102,0.000241,172.217.194.0-255,1484,30200,6,132144
14103,0.000243,172.31.36.0-255,66,30266,6,132144
14104,0.000274,172.217.194.0-255,7936,38202,6,132144
14105,0.000276,172.31.36.0-255,66,38268,6,132144
14106,0.000583,172.217.194.0-255,1484,39752,6,132144
14107,0.00059,172.31.36.0-255,66,39818,6,132144
14108,0.000597,172.217.194.0-255,2902,42720,6,132144
14109,0.0006,172.31.36.0-255,66,42786,6,132144
14110,0.000607,172.217.194.0-255,5738,48524,6,132144
14111,0.00061,172.31.36.0-255,66,48590,6,132144
14112,0.000619,172.217.194.0-255,8574,57164,6,132144
14113,0.000621,172.31.36.0-255,66,57230,6,132144
14114,0.000648,172.217.194.0-255,4320,61550,6,132144
14115,0.000651,172.31.36.0-255,66,61616,6,132144
14116,0.000661,172.217.194.0-255,10692,72308,6,132144
14117,0.000663,172.31.36.0-255,66,72374,6,132144
14118,0.000743,172.217.194.0-255,1484,73858,6,132144
14119,0.000776,172.217.194.0-255,1484,75342,6,132144
14120,0.000779,172.31.36.0-255,66,75408,6,132144
14121,0.000801,172.217.194.0-255,1484,76892,6,132144
14122,0.000808,172.217.194.0-255,5738,82630,6,132144
14123,0.000811,172.31.36.0-255,66,82696,6,132144
14124,0.000825,172.31.36.0-255,66,82762,6,132144
14125,0.000835,172.217.194.0-255,10692,93454,6,132144
14126,0.000838,172.31.36.0-255,66,93520,6,132144
14127,0.001098,172.217.194.0-255,1484,95004,6,132144
14128,0.001104,172.217.194.0-255,2902,97906,6,132144
14129,0.001108,172.31.36.0-255,66,97972,6,132144
14130,0.001116,172.217.194.0-255,5738,103710,6,132144
14131,0.001118,172.31.36.0-255,66,103776,6,132144
14132,0.001161,172.31.36.0-255,66,103842,6,132144
14133,0.001169,172.217.194.0-255,5738,109580,6,132144
14134,0.001171,172.31.36.0-255,66,109646,6,132144
14135,0.0012,172.217.194.0-255,5020,114666,6,132144
14136,0.001202,172.31.36.0-255,66,114732,6,132144
14137,0.003523,172.217.194.0-255,5738,120470,6,132144
14138,0.00353,172.31.36.0-255,66,120536,6,132144
14139,0.005855,172.217.194.0-255,5738,126274,6,132144
14140,0.005859,172.31.36.0-255,66,126340,6,132144
14141,0.008231,172.217.194.0-255,5738,132078,6,132144
14142,0.008243,172.31.36.0-255,66,132144,6,132144
14143,0.0,74.125.68.0-255,146,146,6,185755
14144,3.1e-05,172.31.36.0-255,66,212,6,185755
14145,5.6e-05,74.125.68.0-255,1484,1696,6,185755
14146,6.1e-05,172.31.36.0-255,66,1762,6,185755
14147,8e-05,74.125.68.0-255,1484,3246,6,185755
14148,8.3e-05,74.125.68.0-255,1484,4730,6,185755
14149,8.5e-05,172.31.36.0-255,66,4796,6,185755
14150,9e-05,172.31.36.0-255,66,4862,6,185755
14151,0.000103,74.125.68.0-255,1484,6346,6,185755
14152,0.000107,172.31.36.0-255,66,6412,6,185755
14153,0.000115,74.125.68.0-255,5738,12150,6,185755
14154,0.000118,172.31.36.0-255,66,12216,6,185755
14155,0.00015,74.125.68.0-255,1971,14187,6,185755
14156,0.000152,172.31.36.0-255,66,14253,6,185755
14157,0.000285,74.125.68.0-255,1484,15737,6,185755
14158,0.000289,172.31.36.0-255,66,15803,6,185755
14159,0.000309,74.125.68.0-255,2902,18705,6,185755
14160,0.000313,172.31.36.0-255,66,18771,6,185755
14161,0.000318,74.125.68.0-255,2902,21673,6,185755
14162,0.000322,172.31.36.0-255,66,21739,6,185755
14163,0.000346,74.125.68.0-255,2902,24641,6,185755
14164,0.00035,172.31.36.0-255,66,24707,6,185755
14165,0.000354,74.125.68.0-255,2902,27609,6,185755
14166,0.000356,172.31.36.0-255,66,27675,6,185755
14167,0.000361,74.125.68.0-255,3961,31636,6,185755
14168,0.000364,172.31.36.0-255,66,31702,6,185755
14169,0.00039,74.125.68.0-255,8574,40276,6,185755
14170,0.000393,172.31.36.0-255,66,40342,6,185755
14171,0.000418,74.125.68.0-255,8574,48916,6,185755
14172,0.000423,172.31.36.0-255,66,48982,6,185755
14173,0.00043,74.125.68.0-255,1484,50466,6,185755
14174,0.000433,172.31.36.0-255,66,50532,6,185755
14175,0.000439,74.125.68.0-255,5738,56270,6,185755
14176,0.000441,172.31.36.0-255,66,56336,6,185755
14177,0.000447,74.125.68.0-255,4320,60656,6,185755
14178,0.000449,172.31.36.0-255,66,60722,6,185755
14179,0.000473,74.125.68.0-255,2902,63624,6,185755
14180,0.000477,172.31.36.0-255,66,63690,6,185755
14181,0.000481,74.125.68.0-255,2184,65874,6,185755
14182,0.000484,172.31.36.0-255,66,65940,6,185755
14183,0.000511,74.125.68.0-255,444,66384,6,185755
14184,0.000561,74.125.68.0-255,333,66717,6,185755
14185,0.000818,74.125.68.0-255,1484,68201,6,185755
14186,0.000823,172.31.36.0-255,66,68267,6,185755
14187,0.000841,74.125.68.0-255,1484,69751,6,185755
14188,0.000856,74.125.68.0-255,2902,72653,6,185755
14189,0.000859,172.31.36.0-255,66,72719,6,185755
14190,0.000881,74.125.68.0-255,5738,78457,6,185755
14191,0.000884,172.31.36.0-255,66,78523,6,185755
14192,0.000889,74.125.68.0-255,2902,81425,6,185755
14193,0.00089,172.31.36.0-255,66,81491,6,185755
14194,0.000915,74.125.68.0-255,5738,87229,6,185755
14195,0.000918,172.31.36.0-255,66,87295,6,185755
14196,0.00094,74.125.68.0-255,4320,91615,6,185755
14197,0.000942,172.31.36.0-255,66,91681,6,185755
14198,0.000952,74.125.68.0-255,9274,100955,6,185755
14199,0.000954,172.31.36.0-255,66,101021,6,185755
14200,0.001194,74.125.68.0-255,1484,102505,6,185755
14201,0.001201,74.125.68.0-255,2902,105407,6,185755
14202,0.001204,172.31.36.0-255,66,105473,6,185755
14203,0.001228,74.125.68.0-255,5738,111211,6,185755
14204,0.001231,172.31.36.0-255,66,111277,6,185755
14205,0.001235,74.125.68.0-255,2902,114179,6,185755
14206,0.001237,172.31.36.0-255,66,114245,6,185755
14207,0.001251,74.125.68.0-255,2902,117147,6,185755
14208,0.001254,172.31.36.0-255,66,117213,6,185755
14209,0.001271,74.125.68.0-255,7156,124369,6,185755
14210,0.001273,172.31.36.0-255,66,124435,6,185755
14211,0.001295,74.125.68.0-255,5738,130173,6,185755
14212,0.001297,172.31.36.0-255,66,130239,6,185755
14213,0.00132,74.125.68.0-255,2902,133141,6,185755
14214,0.001323,172.31.36.0-255,66,133207,6,185755
14215,0.001339,74.125.68.0-255,2184,135391,6,185755
14216,0.001342,172.31.36.0-255,66,135457,6,185755
14217,0.00158,74.125.68.0-255,1484,136941,6,185755
14218,0.001588,74.125.68.0-255,1484,138425,6,185755
14219,0.001592,172.31.36.0-255,66,138491,6,185755
14220,0.001596,74.125.68.0-255,1484,139975,6,185755
14221,0.001612,74.125.68.0-255,1484,141459,6,185755
14222,0.001615,172.31.36.0-255,66,141525,6,185755
14223,0.001622,74.125.68.0-255,5738,147263,6,185755
14224,0.001624,172.31.36.0-255,66,147329,6,185755
14225,0.001677,74.125.68.0-255,8574,155903,6,185755
14226,0.001681,172.31.36.0-255,66,155969,6,185755
14227,0.001689,74.125.68.0-255,9992,165961,6,185755
14228,0.001691,172.31.36.0-255,66,166027,6,185755
14229,0.001696,74.125.68.0-255,3602,169629,6,185755
14230,0.001698,172.31.36.0-255,66,169695,6,185755
14231,0.004263,74.125.68.0-255,5738,175433,6,185755
14232,0.00427,172.31.36.0-255,66,175499,6,185755
14233,0.006844,74.125.68.0-255,4320,179819,6,185755
14234,0.006847,172.31.36.0-255,66,179885,6,185755
14235,0.00686,74.125.68.0-255,1484,181369,6,185755
14236,0.009418,74.125.68.0-255,4320,185689,6,185755
14237,0.009425,172.31.36.0-255,66,185755,6,185755
14238,0.0,74.125.68.0-255,152,152,6,179429
14239,2.5e-05,172.31.36.0-255,66,218,6,179429
14240,3.2e-05,74.125.68.0-255,1484,1702,6,179429
14241,3.6e-05,172.31.36.0-255,66,1768,6,179429
14242,4.3e-05,74.125.68.0-255,2902,4670,6,179429
14243,5.5e-05,172.31.36.0-255,66,4736,6,179429
14244,6.3e-05,74.125.68.0-255,7156,11892,6,179429
14245,6.6e-05,172.31.36.0-255,66,11958,6,179429
14246,7.1e-05,74.125.68.0-255,2037,13995,6,179429
14247,7.4e-05,172.31.36.0-255,66,14061,6,179429
14248,0.000489,74.125.68.0-255,1484,15545,6,179429
14249,0.000495,172.31.36.0-255,66,15611,6,179429
14250,0.000502,74.125.68.0-255,2902,18513,6,179429
14251,0.000504,172.31.36.0-255,66,18579,6,179429
14252,0.000518,74.125.68.0-255,5738,24317,6,179429
14253,0.00052,172.31.36.0-255,66,24383,6,179429
14254,0.000527,74.125.68.0-255,5738,30121,6,179429
14255,0.000529,172.31.36.0-255,66,30187,6,179429
14256,0.000559,74.125.68.0-255,1125,31312,6,179429
14257,0.000563,172.31.36.0-255,66,31378,6,179429
14258,0.00063,74.125.68.0-255,1484,32862,6,179429
14259,0.000633,172.31.36.0-255,66,32928,6,179429
14260,0.000666,74.125.68.0-255,2902,35830,6,179429
14261,0.00067,172.31.36.0-255,66,35896,6,179429
14262,0.000676,74.125.68.0-255,5738,41634,6,179429
14263,0.000679,172.31.36.0-255,66,41700,6,179429
14264,0.000689,74.125.68.0-255,2902,44602,6,179429
14265,0.000691,172.31.36.0-255,66,44668,6,179429
14266,0.000696,74.125.68.0-255,3961,48629,6,179429
14267,0.000699,172.31.36.0-255,66,48695,6,179429
14268,0.000733,74.125.68.0-255,8574,57269,6,179429
14269,0.000737,172.31.36.0-255,66,57335,6,179429
14270,0.000743,74.125.68.0-255,4320,61655,6,179429
14271,0.000762,172.31.36.0-255,66,61721,6,179429
14272,0.000787,74.125.68.0-255,3961,65682,6,179429
14273,0.000808,172.31.36.0-255,66,65748,6,179429
14274,0.001057,74.125.68.0-255,645,66393,6,179429
14275,0.001166,172.31.36.0-255,66,66459,6,179429
14276,0.001228,74.125.68.0-255,1484,67943,6,179429
14277,0.001232,74.125.68.0-255,1484,69427,6,179429
14278,0.001235,172.31.36.0-255,66,69493,6,179429
14279,0.001258,74.125.68.0-255,1484,70977,6,179429
14280,0.001265,74.125.68.0-255,5738,76715,6,179429
14281,0.001268,172.31.36.0-255,66,76781,6,179429
14282,0.001293,74.125.68.0-255,1484,78265,6,179429
14283,0.00131,74.125.68.0-255,5379,83644,6,179429
14284,0.001313,172.31.36.0-255,66,83710,6,179429
14285,0.001352,74.125.68.0-255,1484,85194,6,179429
14286,0.00137,74.125.68.0-255,2902,88096,6,179429
14287,0.001374,172.31.36.0-255,66,88162,6,179429
14288,0.00138,74.125.68.0-255,5738,93900,6,179429
14289,0.001383,172.31.36.0-255,66,93966,6,179429
14290,0.001387,74.125.68.0-255,2902,96868,6,179429
14291,0.001393,172.31.36.0-255,66,96934,6,179429
14292,0.001397,74.125.68.0-255,1484,98418,6,179429
14293,0.00141,74.125.68.0-255,2543,100961,6,179429
14294,0.001412,172.31.36.0-255,66,101027,6,179429
14295,0.002098,74.125.68.0-255,1484,102511,6,179429
14296,0.002109,74.125.68.0-255,2902,105413,6,179429
14297,0.002114,172.31.36.0-255,66,105479,6,179429
14298,0.002122,74.125.68.0-255,5738,111217,6,179429
14299,0.002124,172.31.36.0-255,66,111283,6,179429
14300,0.002163,74.125.68.0-255,8574,119857,6,179429
14301,0.002166,172.31.36.0-255,66,119923,6,179429
14302,0.002196,74.125.68.0-255,4320,124243,6,179429
14303,0.002198,172.31.36.0-255,66,124309,6,179429
14304,0.002203,74.125.68.0-255,2902,127211,6,179429
14305,0.002205,172.31.36.0-255,66,127277,6,179429
14306,0.002243,74.125.68.0-255,7856,135133,6,179429
14307,0.002246,172.31.36.0-255,66,135199,6,179429
14308,0.002393,74.125.68.0-255,1484,136683,6,179429
14309,0.002399,74.125.68.0-255,1484,138167,6,179429
14310,0.002403,172.31.36.0-255,66,138233,6,179429
14311,0.002408,74.125.68.0-255,2902,141135,6,179429
14312,0.002411,172.31.36.0-255,66,141201,6,179429
14313,0.002436,74.125.68.0-255,5738,146939,6,179429
14314,0.002438,172.31.36.0-255,66,147005,6,179429
14315,0.00247,74.125.68.0-255,8574,155579,6,179429
14316,0.002474,74.125.68.0-255,1484,157063,6,179429
14317,0.002497,74.125.68.0-255,8574,165637,6,179429
14318,0.002504,74.125.68.0-255,3602,169239,6,179429
14319,0.002553,74.125.68.0-255,4320,173559,6,179429
14320,0.004996,172.31.36.0-255,66,173625,6,179429
14321,0.007511,74.125.68.0-255,5738,179363,6,179429
14322,0.007518,172.31.36.0-255,66,179429,6,179429
14323,0.0,172.217.194.0-255,146,146,6,132313
14324,2.7e-05,172.31.36.0-255,66,212,6,132313
14325,3.4e-05,172.217.194.0-255,1484,1696,6,132313
14326,3.9e-05,172.31.36.0-255,66,1762,6,132313
14327,4.3e-05,172.217.194.0-255,2902,4664,6,132313
14328,4.6e-05,172.31.36.0-255,66,4730,6,132313
14329,5.2e-05,172.217.194.0-255,7156,11886,6,132313
14330,5.5e-05,172.31.36.0-255,66,11952,6,132313
14331,5.9e-05,172.217.194.0-255,1975,13927,6,132313
14332,6.1e-05,172.31.36.0-255,66,13993,6,132313
14333,0.000416,172.217.194.0-255,1484,15477,6,132313
14334,0.000422,172.31.36.0-255,66,15543,6,132313
14335,0.000429,172.217.194.0-255,2902,18445,6,132313
14336,0.000432,172.31.36.0-255,66,18511,6,132313
14337,0.000438,172.217.194.0-255,5738,24249,6,132313
14338,0.00044,172.31.36.0-255,66,24315,6,132313
14339,0.000482,172.217.194.0-255,6797,31112,6,132313
14340,0.000486,172.31.36.0-255,66,31178,6,132313
14341,0.000581,172.217.194.0-255,1484,32662,6,132313
14342,0.000586,172.31.36.0-255,66,32728,6,132313
14343,0.000592,172.217.194.0-255,2902,35630,6,132313
14344,0.000594,172.31.36.0-255,66,35696,6,132313
14345,0.000622,172.217.194.0-255,5738,41434,6,132313
14346,0.000627,172.31.36.0-255,66,41500,6,132313
14347,0.000633,172.217.194.0-255,6797,48297,6,132313
14348,0.000636,172.31.36.0-255,66,48363,6,132313
14349,0.000673,172.31.36.0-255,66,48429,6,132313
14350,0.000692,172.217.194.0-255,2902,51331,6,132313
14351,0.000696,172.31.36.0-255,66,51397,6,132313
14352,0.0007,172.217.194.0-255,1484,52881,6,132313
14353,0.000702,172.31.36.0-255,66,52947,6,132313
14354,0.000718,172.217.194.0-255,1417,54364,6,132313
14355,0.000721,172.31.36.0-255,66,54430,6,132313
14356,0.001149,172.217.194.0-255,364,54794,6,132313
14357,0.001156,172.31.36.0-255,66,54860,6,132313
14358,0.001292,172.217.194.0-255,1484,56344,6,132313
14359,0.001297,172.31.36.0-255,66,56410,6,132313
14360,0.001305,172.217.194.0-255,2902,59312,6,132313
14361,0.001308,172.31.36.0-255,66,59378,6,132313
14362,0.001342,172.217.194.0-255,5738,65116,6,132313
14363,0.001345,172.31.36.0-255,66,65182,6,132313
14364,0.001353,172.217.194.0-255,6247,71429,6,132313
14365,0.001355,172.31.36.0-255,66,71495,6,132313
14366,0.001494,172.217.194.0-255,1484,72979,6,132313
14367,0.001498,172.31.36.0-255,66,73045,6,132313
14368,0.001503,172.217.194.0-255,1484,74529,6,132313
14369,0.001505,172.31.36.0-255,66,74595,6,132313
14370,0.00152,172.217.194.0-255,1484,76079,6,132313
14371,0.001522,172.31.36.0-255,66,76145,6,132313
14372,0.001528,172.217.194.0-255,5738,81883,6,132313
14373,0.00153,172.31.36.0-255,66,81949,6,132313
14374,0.001537,172.217.194.0-255,7156,89105,6,132313
14375,0.001539,172.31.36.0-255,66,89171,6,132313
14376,0.001591,172.217.194.0-255,4320,93491,6,132313
14377,0.001594,172.31.36.0-255,66,93557,6,132313
14378,0.001622,172.31.36.0-255,66,93623,6,132313
14379,0.001726,172.217.194.0-255,1484,95107,6,132313
14380,0.00173,172.31.36.0-255,66,95173,6,132313
14381,0.001736,172.217.194.0-255,2902,98075,6,132313
14382,0.001738,172.31.36.0-255,66,98141,6,132313
14383,0.001742,172.217.194.0-255,2902,101043,6,132313
14384,0.001745,172.31.36.0-255,66,101109,6,132313
14385,0.001759,172.217.194.0-255,2902,104011,6,132313
14386,0.001762,172.31.36.0-255,66,104077,6,132313
14387,0.001808,172.217.194.0-255,7156,111233,6,132313
14388,0.001874,172.217.194.0-255,3602,114835,6,132313
14389,0.001888,172.31.36.0-255,66,114901,6,132313
14390,0.003961,172.217.194.0-255,5738,120639,6,132313
14391,0.003966,172.31.36.0-255,66,120705,6,132313
14392,0.006101,172.217.194.0-255,5738,126443,6,132313
14393,0.006107,172.31.36.0-255,66,126509,6,132313
14394,0.008235,172.217.194.0-255,5738,132247,6,132313
14395,0.008242,172.31.36.0-255,66,132313,6,132313
14396,0.0,74.125.24.0-255,155,155,6,248131
14397,2.9e-05,172.31.36.0-255,66,221,6,248131
14398,3.6e-05,74.125.24.0-255,1484,1705,6,248131
14399,3.9e-05,172.31.36.0-255,66,1771,6,248131
14400,4.4e-05,74.125.24.0-255,2902,4673,6,248131
14401,4.6e-05,172.31.36.0-255,66,4739,6,248131
14402,5.4e-05,74.125.24.0-255,7156,11895,6,248131
14403,5.6e-05,172.31.36.0-255,66,11961,6,248131
14404,6e-05,74.125.24.0-255,2058,14019,6,248131
14405,6.2e-05,172.31.36.0-255,66,14085,6,248131
14406,9.5e-05,172.31.36.0-255,66,14151,6,248131
14407,0.000119,74.125.24.0-255,5379,19530,6,248131
14408,0.000122,172.31.36.0-255,66,19596,6,248131
14409,0.000198,74.125.24.0-255,1484,21080,6,248131
14410,0.000202,172.31.36.0-255,66,21146,6,248131
14411,0.000208,74.125.24.0-255,2902,24048,6,248131
14412,0.000212,172.31.36.0-255,66,24114,6,248131
14413,0.000219,74.125.24.0-255,5738,29852,6,248131
14414,0.000222,172.31.36.0-255,66,29918,6,248131
14415,0.000231,74.125.24.0-255,9992,39910,6,248131
14416,0.000233,172.31.36.0-255,66,39976,6,248131
14417,0.000267,172.31.36.0-255,66,40042,6,248131
14418,0.000519,74.125.24.0-255,129,40171,6,248131
14419,0.000523,172.31.36.0-255,66,40237,6,248131
14420,0.000685,74.125.24.0-255,1484,41721,6,248131
14421,0.00069,172.31.36.0-255,66,41787,6,248131
14422,0.000695,74.125.24.0-255,2902,44689,6,248131
14423,0.000699,172.31.36.0-255,66,44755,6,248131
14424,0.00071,74.125.24.0-255,2902,47657,6,248131
14425,0.000713,172.31.36.0-255,66,47723,6,248131
14426,0.000731,74.125.24.0-255,2902,50625,6,248131
14427,0.000734,172.31.36.0-255,66,50691,6,248131
14428,0.000762,172.31.36.0-255,66,50757,6,248131
14429,0.000769,74.125.24.0-255,5738,56495,6,248131
14430,0.000772,172.31.36.0-255,66,56561,6,248131
14431,0.000792,74.125.24.0-255,1484,58045,6,248131
14432,0.000806,74.125.24.0-255,5738,63783,6,248131
14433,0.000809,172.31.36.0-255,66,63849,6,248131
14434,0.000822,74.125.24.0-255,8574,72423,6,248131
14435,0.000825,172.31.36.0-255,66,72489,6,248131
14436,0.00084,74.125.24.0-255,5020,77509,6,248131
14437,0.000843,172.31.36.0-255,66,77575,6,248131
14438,0.001298,74.125.24.0-255,1484,79059,6,248131
14439,0.001307,74.125.24.0-255,2902,81961,6,248131
14440,0.001311,172.31.36.0-255,66,82027,6,248131
14441,0.001333,74.125.24.0-255,5738,87765,6,248131
14442,0.001336,172.31.36.0-255,66,87831,6,248131
14443,0.001377,172.31.36.0-255,66,87897,6,248131
14444,0.001417,74.125.24.0-255,5738,93635,6,248131
14445,0.00142,172.31.36.0-255,66,93701,6,248131
14446,0.00144,74.125.24.0-255,2902,96603,6,248131
14447,0.001444,172.31.36.0-255,66,96669,6,248131
14448,0.001449,74.125.24.0-255,2184,98853,6,248131
14449,0.001451,172.31.36.0-255,66,98919,6,248131
14450,0.001601,74.125.24.0-255,1484,100403,6,248131
14451,0.001607,74.125.24.0-255,2902,103305,6,248131
14452,0.001611,172.31.36.0-255,66,103371,6,248131
14453,0.001617,74.125.24.0-255,4320,107691,6,248131
14454,0.001618,172.31.36.0-255,66,107757,6,248131
14455,0.001631,74.125.24.0-255,1484,109241,6,248131
14456,0.001639,74.125.24.0-255,7156,116397,6,248131
14457,0.001641,172.31.36.0-255,66,116463,6,248131
14458,0.001669,74.125.24.0-255,7156,123619,6,248131
14459,0.001672,172.31.36.0-255,66,123685,6,248131
14460,0.001693,74.125.24.0-255,7156,130841,6,248131
14461,0.001695,172.31.36.0-255,66,130907,6,248131
14462,0.0017,74.125.24.0-255,2184,133091,6,248131
14463,0.001702,172.31.36.0-255,66,133157,6,248131
14464,0.001768,74.125.24.0-255,1484,134641,6,248131
14465,0.001774,74.125.24.0-255,2902,137543,6,248131
14466,0.001778,172.31.36.0-255,66,137609,6,248131
14467,0.001797,74.125.24.0-255,4320,141929,6,248131
14468,0.001801,172.31.36.0-255,66,141995,6,248131
14469,0.00182,74.125.24.0-255,1484,143479,6,248131
14470,0.001829,74.125.24.0-255,8574,152053,6,248131
14471,0.001832,172.31.36.0-255,66,152119,6,248131
14472,0.001852,74.125.24.0-255,4320,156439,6,248131
14473,0.001855,172.31.36.0-255,66,156505,6,248131
14474,0.001859,74.125.24.0-255,4320,160825,6,248131
14475,0.001861,172.31.36.0-255,66,160891,6,248131
14476,0.001898,74.125.24.0-255,6438,167329,6,248131
14477,0.001901,172.31.36.0-255,66,167395,6,248131
14478,0.002122,74.125.24.0-255,1484,168879,6,248131
14479,0.002128,74.125.24.0-255,2902,171781,6,248131
14480,0.002131,172.31.36.0-255,66,171847,6,248131
14481,0.002135,74.125.24.0-255,1484,173331,6,248131
14482,0.002155,74.125.24.0-255,4320,177651,6,248131
14483,0.002158,172.31.36.0-255,66,177717,6,248131
14484,0.002166,74.125.24.0-255,7156,184873,6,248131
14485,0.002168,172.31.36.0-255,66,184939,6,248131
14486,0.002183,74.125.24.0-255,5738,190677,6,248131
14487,0.002186,172.31.36.0-255,66,190743,6,248131
14488,0.002193,74.125.24.0-255,5738,196481,6,248131
14489,0.002195,172.31.36.0-255,66,196547,6,248131
14490,0.002212,74.125.24.0-255,5020,201567,6,248131
14491,0.002214,172.31.36.0-255,66,201633,6,248131
14492,0.002253,74.125.24.0-255,4320,205953,6,248131
14493,0.002256,172.31.36.0-255,66,206019,6,248131
14494,0.002262,74.125.24.0-255,5738,211757,6,248131
14495,0.002265,172.31.36.0-255,66,211823,6,248131
14496,0.002269,74.125.24.0-255,1484,213307,6,248131
14497,0.002295,74.125.24.0-255,9992,223299,6,248131
14498,0.002298,172.31.36.0-255,66,223365,6,248131
14499,0.002305,74.125.24.0-255,7156,230521,6,248131
14500,0.002308,172.31.36.0-255,66,230587,6,248131
14501,0.002311,74.125.24.0-255,1484,232071,6,248131
14502,0.004549,74.125.24.0-255,4320,236391,6,248131
14503,0.004556,172.31.36.0-255,66,236457,6,248131
14504,0.006819,74.125.24.0-255,5738,242195,6,248131
14505,0.006825,172.31.36.0-255,66,242261,6,248131
14506,0.009056,74.125.24.0-255,4320,246581,6,248131
14507,0.009062,172.31.36.0-255,66,246647,6,248131
14508,0.009082,74.125.24.0-255,1484,248131,6,248131
14509,0.0,74.125.24.0-255,143,143,6,129552
14510,3.4e-05,172.31.36.0-255,66,209,6,129552
14511,4.1e-05,74.125.24.0-255,1484,1693,6,129552
14512,4.6e-05,172.31.36.0-255,66,1759,6,129552
14513,5.1e-05,74.125.24.0-255,2902,4661,6,129552
14514,5.3e-05,172.31.36.0-255,66,4727,6,129552
14515,6.8e-05,74.125.24.0-255,7156,11883,6,129552
14516,7.1e-05,172.31.36.0-255,66,11949,6,129552
14517,0.00013,74.125.24.0-255,5738,17687,6,129552
14518,0.000134,172.31.36.0-255,66,17753,6,129552
14519,0.000166,74.125.24.0-255,7728,25481,6,129552
14520,0.00017,172.31.36.0-255,66,25547,6,129552
14521,0.000282,74.125.24.0-255,5379,30926,6,129552
14522,0.000287,172.31.36.0-255,66,30992,6,129552
14523,0.000345,74.125.24.0-255,5738,36730,6,129552
14524,0.000349,172.31.36.0-255,66,36796,6,129552
14525,0.000416,74.125.24.0-255,5738,42534,6,129552
14526,0.000421,172.31.36.0-255,66,42600,6,129552
14527,0.000453,74.125.24.0-255,6797,49397,6,129552
14528,0.000456,172.31.36.0-255,66,49463,6,129552
14529,0.000573,172.31.36.0-255,66,49529,6,129552
14530,0.000602,74.125.24.0-255,4552,54081,6,129552
14531,0.000606,172.31.36.0-255,66,54147,6,129552
14532,0.000749,74.125.24.0-255,7156,61303,6,129552
14533,0.000753,172.31.36.0-255,66,61369,6,129552
14534,0.000794,172.31.36.0-255,66,61435,6,129552
14535,0.001021,74.125.24.0-255,7156,68591,6,129552
14536,0.001025,172.31.36.0-255,66,68657,6,129552
14537,0.001056,74.125.24.0-255,3961,72618,6,129552
14538,0.001059,172.31.36.0-255,66,72684,6,129552
14539,0.001145,74.125.24.0-255,8574,81258,6,129552
14540,0.001149,172.31.36.0-255,66,81324,6,129552
14541,0.001206,172.31.36.0-255,66,81390,6,129552
14542,0.001535,74.125.24.0-255,9992,91382,6,129552
14543,0.001541,172.31.36.0-255,66,91448,6,129552
14544,0.00161,172.31.36.0-255,66,91514,6,129552
14545,0.002073,74.125.24.0-255,3961,95475,6,129552
14546,0.002079,172.31.36.0-255,66,95541,6,129552
14547,0.002118,74.125.24.0-255,4320,99861,6,129552
14548,0.002123,172.31.36.0-255,66,99927,6,129552
14549,0.002176,172.31.36.0-255,66,99993,6,129552
14550,0.00252,74.125.24.0-255,9992,109985,6,129552
14551,0.002524,172.31.36.0-255,66,110051,6,129552
14552,0.002591,172.31.36.0-255,66,110117,6,129552
14553,0.002616,74.125.24.0-255,1825,111942,6,129552
14554,0.002618,172.31.36.0-255,66,112008,6,129552
14555,0.003109,172.31.36.0-255,66,112074,6,129552
14556,0.003179,172.31.36.0-255,66,112140,6,129552
14557,0.005231,74.125.24.0-255,5738,117878,6,129552
14558,0.005248,172.31.36.0-255,66,117944,6,129552
14559,0.007297,74.125.24.0-255,5738,123682,6,129552
14560,0.007315,172.31.36.0-255,66,123748,6,129552
14561,0.009372,74.125.24.0-255,5738,129486,6,129552
14562,0.00939,172.31.36.0-255,66,129552,6,129552
14563,0.0,172.217.194.0-255,153,153,6,269515
14564,1.7e-05,172.31.36.0-255,66,219,6,269515
14565,2.3e-05,172.217.194.0-255,1484,1703,6,269515
14566,2.7e-05,172.31.36.0-255,66,1769,6,269515
14567,3.3e-05,172.217.194.0-255,2902,4671,6,269515
14568,3.5e-05,172.31.36.0-255,66,4737,6,269515
14569,4.1e-05,172.217.194.0-255,4320,9057,6,269515
14570,4.4e-05,172.31.36.0-255,66,9123,6,269515
14571,6.4e-05,172.217.194.0-255,2902,12025,6,269515
14572,6.7e-05,172.31.36.0-255,66,12091,6,269515
14573,7.5e-05,172.217.194.0-255,7719,19810,6,269515
14574,7.8e-05,172.31.36.0-255,66,19876,6,269515
14575,0.000109,172.217.194.0-255,9992,29868,6,269515
14576,0.000112,172.31.36.0-255,66,29934,6,269515
14577,0.000128,172.217.194.0-255,1125,31059,6,269515
14578,0.00013,172.31.36.0-255,66,31125,6,269515
14579,0.000638,172.217.194.0-255,1484,32609,6,269515
14580,0.000644,172.31.36.0-255,66,32675,6,269515
14581,0.000649,172.217.194.0-255,2902,35577,6,269515
14582,0.000652,172.31.36.0-255,66,35643,6,269515
14583,0.000658,172.217.194.0-255,4320,39963,6,269515
14584,0.00066,172.31.36.0-255,66,40029,6,269515
14585,0.000686,172.217.194.0-255,1484,41513,6,269515
14586,0.000688,172.31.36.0-255,66,41579,6,269515
14587,0.000703,172.31.36.0-255,66,41645,6,269515
14588,0.000709,172.217.194.0-255,4320,45965,6,269515
14589,0.000711,172.31.36.0-255,66,46031,6,269515
14590,0.000738,172.217.194.0-255,5668,51699,6,269515
14591,0.000741,172.31.36.0-255,66,51765,6,269515
14592,0.001125,172.217.194.0-255,99,51864,6,269515
14593,0.00113,172.31.36.0-255,66,51930,6,269515
14594,0.001161,172.217.194.0-255,1484,53414,6,269515
14595,0.001167,172.217.194.0-255,2902,56316,6,269515
14596,0.00117,172.31.36.0-255,66,56382,6,269515
14597,0.001184,172.217.194.0-255,2902,59284,6,269515
14598,0.001186,172.31.36.0-255,66,59350,6,269515
14599,0.001202,172.217.194.0-255,4320,63670,6,269515
14600,0.001204,172.31.36.0-255,66,63736,6,269515
14601,0.001211,172.217.194.0-255,5738,69474,6,269515
14602,0.001213,172.31.36.0-255,66,69540,6,269515
14603,0.001244,172.217.194.0-255,9992,79532,6,269515
14604,0.001247,172.31.36.0-255,66,79598,6,269515
14605,0.001254,172.217.194.0-255,6438,86036,6,269515
14606,0.001256,172.31.36.0-255,66,86102,6,269515
14607,0.001277,172.217.194.0-255,1484,87586,6,269515
14608,0.001283,172.217.194.0-255,2902,90488,6,269515
14609,0.001286,172.31.36.0-255,66,90554,6,269515
14610,0.001308,172.217.194.0-255,5738,96292,6,269515
14611,0.001311,172.31.36.0-255,66,96358,6,269515
14612,0.001334,172.217.194.0-255,8574,104932,6,269515
14613,0.001337,172.31.36.0-255,66,104998,6,269515
14614,0.001357,172.217.194.0-255,4320,109318,6,269515
14615,0.00136,172.31.36.0-255,66,109384,6,269515
14616,0.001363,172.217.194.0-255,1484,110868,6,269515
14617,0.00137,172.217.194.0-255,5738,116606,6,269515
14618,0.001374,172.31.36.0-255,66,116672,6,269515
14619,0.001419,172.31.36.0-255,66,116738,6,269515
14620,0.001435,172.31.36.0-255,66,116804,6,269515
14621,0.001457,172.217.194.0-255,4320,121124,6,269515
14622,0.00146,172.31.36.0-255,66,121190,6,269515
14623,0.001487,172.217.194.0-255,6438,127628,6,269515
14624,0.00149,172.31.36.0-255,66,127694,6,269515
14625,0.001503,172.31.36.0-255,66,127760,6,269515
14626,0.001516,172.31.36.0-255,66,127826,6,269515
14627,0.001537,172.217.194.0-255,3602,131428,6,269515
14628,0.00154,172.31.36.0-255,66,131494,6,269515
14629,0.001543,172.217.194.0-255,1484,132978,6,269515
14630,0.001565,172.217.194.0-255,2902,135880,6,269515
14631,0.001568,172.31.36.0-255,66,135946,6,269515
14632,0.001572,172.217.194.0-255,1484,137430,6,269515
14633,0.001587,172.217.194.0-255,4320,141750,6,269515
14634,0.00159,172.31.36.0-255,66,141816,6,269515
14635,0.001598,172.217.194.0-255,8574,150390,6,269515
14636,0.001601,172.31.36.0-255,66,150456,6,269515
14637,0.001604,172.217.194.0-255,1484,151940,6,269515
14638,0.001627,172.217.194.0-255,8574,160514,6,269515
14639,0.00163,172.31.36.0-255,66,160580,6,269515
14640,0.001634,172.217.194.0-255,2902,163482,6,269515
14641,0.001637,172.31.36.0-255,66,163548,6,269515
14642,0.001652,172.217.194.0-255,2184,165732,6,269515
14643,0.001655,172.31.36.0-255,66,165798,6,269515
14644,0.00172,172.217.194.0-255,1484,167282,6,269515
14645,0.001727,172.217.194.0-255,2902,170184,6,269515
14646,0.00173,172.31.36.0-255,66,170250,6,269515
14647,0.001751,172.217.194.0-255,5738,175988,6,269515
14648,0.001754,172.31.36.0-255,66,176054,6,269515
14649,0.001795,172.217.194.0-255,1484,177538,6,269515
14650,0.00183,172.31.36.0-255,66,177604,6,269515
14651,0.00184,172.217.194.0-255,10692,188296,6,269515
14652,0.001843,172.31.36.0-255,66,188362,6,269515
14653,0.001851,172.217.194.0-255,8574,196936,6,269515
14654,0.001855,172.31.36.0-255,66,197002,6,269515
14655,0.001881,172.217.194.0-255,2902,199904,6,269515
14656,0.001889,172.217.194.0-255,8574,208478,6,269515
14657,0.001905,172.217.194.0-255,4320,212798,6,269515
14658,0.001911,172.217.194.0-255,4320,217118,6,269515
14659,0.001928,172.217.194.0-255,5738,222856,6,269515
14660,0.001952,172.217.194.0-255,6438,229294,6,269515
14661,0.001981,172.217.194.0-255,1484,230778,6,269515
14662,0.001991,172.217.194.0-255,9274,240052,6,269515
14663,0.002009,172.217.194.0-255,1484,241536,6,269515
14664,0.002012,172.217.194.0-255,1484,243020,6,269515
14665,0.002025,172.217.194.0-255,1484,244504,6,269515
14666,0.002028,172.217.194.0-255,1484,245988,6,269515
14667,0.002046,172.217.194.0-255,4320,250308,6,269515
14668,0.002053,172.217.194.0-255,5738,256046,6,269515
14669,0.002066,172.217.194.0-255,2902,258948,6,269515
14670,0.002095,172.217.194.0-255,2902,261850,6,269515
14671,0.002134,172.217.194.0-255,7156,269006,6,269515
14672,0.002195,172.217.194.0-255,105,269111,6,269515
14673,0.003886,172.31.36.0-255,66,269177,6,269515
14674,0.005997,172.31.36.0-255,101,269278,6,269515
14675,0.006258,172.31.36.0-255,105,269383,6,269515
14676,0.008283,172.217.194.0-255,66,269449,6,269515
14677,0.008535,172.217.194.0-255,66,269515,6,269515
14678,0.0,104.244.42.0-255,66,66,6,66
14679,0.0,74.125.68.0-255,153,153,6,184227
14680,2.8e-05,172.31.36.0-255,66,219,6,184227
14681,3.6e-05,74.125.68.0-255,1484,1703,6,184227
14682,4e-05,172.31.36.0-255,66,1769,6,184227
14683,4.3e-05,74.125.68.0-255,1484,3253,6,184227
14684,4.5e-05,172.31.36.0-255,66,3319,6,184227
14685,7.2e-05,74.125.68.0-255,2902,6221,6,184227
14686,7.5e-05,172.31.36.0-255,66,6287,6,184227
14687,8e-05,74.125.68.0-255,4320,10607,6,184227
14688,8.2e-05,172.31.36.0-255,66,10673,6,184227
14689,9.8e-05,74.125.68.0-255,1484,12157,6,184227
14690,0.0001,172.31.36.0-255,66,12223,6,184227
14691,0.000104,74.125.68.0-255,2006,14229,6,184227
14692,0.000106,172.31.36.0-255,66,14295,6,184227
14693,0.000281,74.125.68.0-255,1484,15779,6,184227
14694,0.000287,172.31.36.0-255,66,15845,6,184227
14695,0.000292,74.125.68.0-255,2902,18747,6,184227
14696,0.000295,172.31.36.0-255,66,18813,6,184227
14697,0.000319,74.125.68.0-255,5738,24551,6,184227
14698,0.000323,172.31.36.0-255,66,24617,6,184227
14699,0.000344,74.125.68.0-255,2902,27519,6,184227
14700,0.000347,172.31.36.0-255,66,27585,6,184227
14701,0.000367,74.125.68.0-255,3961,31546,6,184227
14702,0.00037,172.31.36.0-255,66,31612,6,184227
14703,0.000387,74.125.68.0-255,4320,35932,6,184227
14704,0.00039,172.31.36.0-255,66,35998,6,184227
14705,0.000419,74.125.68.0-255,2902,38900,6,184227
14706,0.000422,172.31.36.0-255,66,38966,6,184227
14707,0.00043,74.125.68.0-255,8574,47540,6,184227
14708,0.000434,172.31.36.0-255,66,47606,6,184227
14709,0.000436,74.125.68.0-255,1125,48731,6,184227
14710,0.000439,172.31.36.0-255,66,48797,6,184227
14711,0.000487,74.125.68.0-255,1484,50281,6,184227
14712,0.000502,74.125.68.0-255,2902,53183,6,184227
14713,0.000505,172.31.36.0-255,66,53249,6,184227
14714,0.000527,74.125.68.0-255,1484,54733,6,184227
14715,0.000531,74.125.68.0-255,2902,57635,6,184227
14716,0.000534,172.31.36.0-255,66,57701,6,184227
14717,0.000539,74.125.68.0-255,4320,62021,6,184227
14718,0.000542,172.31.36.0-255,66,62087,6,184227
14719,0.000545,74.125.68.0-255,1484,63571,6,184227
14720,0.000562,74.125.68.0-255,2543,66114,6,184227
14721,0.000565,172.31.36.0-255,66,66180,6,184227
14722,0.000588,74.125.68.0-255,646,66826,6,184227
14723,0.000806,172.31.36.0-255,66,66892,6,184227
14724,0.000931,74.125.68.0-255,1484,68376,6,184227
14725,0.000951,74.125.68.0-255,2902,71278,6,184227
14726,0.000955,172.31.36.0-255,66,71344,6,184227
14727,0.000961,74.125.68.0-255,4320,75664,6,184227
14728,0.000963,172.31.36.0-255,66,75730,6,184227
14729,0.001013,74.125.68.0-255,7666,83396,6,184227
14730,0.001017,172.31.36.0-255,66,83462,6,184227
14731,0.001413,74.125.68.0-255,1484,84946,6,184227
14732,0.00143,74.125.68.0-255,2902,87848,6,184227
14733,0.001435,172.31.36.0-255,66,87914,6,184227
14734,0.00144,74.125.68.0-255,1484,89398,6,184227
14735,0.001459,74.125.68.0-255,4320,93718,6,184227
14736,0.001461,172.31.36.0-255,66,93784,6,184227
14737,0.001467,74.125.68.0-255,5738,99522,6,184227
14738,0.00147,172.31.36.0-255,66,99588,6,184227
14739,0.001504,74.125.68.0-255,4320,103908,6,184227
14740,0.001506,172.31.36.0-255,66,103974,6,184227
14741,0.001534,74.125.68.0-255,8574,112548,6,184227
14742,0.001537,172.31.36.0-255,66,112614,6,184227
14743,0.001542,74.125.68.0-255,4320,116934,6,184227
14744,0.001544,172.31.36.0-255,66,117000,6,184227
14745,0.001547,74.125.68.0-255,766,117766,6,184227
14746,0.001891,74.125.68.0-255,1484,119250,6,184227
14747,0.001893,172.31.36.0-255,66,119316,6,184227
14748,0.00191,74.125.68.0-255,2902,122218,6,184227
14749,0.001913,172.31.36.0-255,66,122284,6,184227
14750,0.001915,74.125.68.0-255,1484,123768,6,184227
14751,0.001931,74.125.68.0-255,1484,125252,6,184227
14752,0.001933,172.31.36.0-255,66,125318,6,184227
14753,0.001951,74.125.68.0-255,1484,126802,6,184227
14754,0.001973,74.125.68.0-255,5738,132540,6,184227
14755,0.001976,172.31.36.0-255,66,132606,6,184227
14756,0.001979,74.125.68.0-255,2543,135149,6,184227
14757,0.001982,172.31.36.0-255,66,135215,6,184227
14758,0.002033,74.125.68.0-255,2902,138117,6,184227
14759,0.002035,172.31.36.0-255,66,138183,6,184227
14760,0.002042,74.125.68.0-255,7156,145339,6,184227
14761,0.002044,172.31.36.0-255,66,145405,6,184227
14762,0.002049,74.125.68.0-255,4320,149725,6,184227
14763,0.002052,172.31.36.0-255,66,149791,6,184227
14764,0.002058,74.125.68.0-255,5738,155529,6,184227
14765,0.00206,172.31.36.0-255,66,155595,6,184227
14766,0.002063,74.125.68.0-255,1484,157079,6,184227
14767,0.002084,74.125.68.0-255,7156,164235,6,184227
14768,0.002086,172.31.36.0-255,66,164301,6,184227
14769,0.002101,74.125.68.0-255,2902,167203,6,184227
14770,0.002103,172.31.36.0-255,66,167269,6,184227
14771,0.002107,74.125.68.0-255,2184,169453,6,184227
14772,0.00211,172.31.36.0-255,66,169519,6,184227
14773,0.004459,74.125.68.0-255,4320,173839,6,184227
14774,0.004465,172.31.36.0-255,66,173905,6,184227
14775,0.004493,74.125.68.0-255,1484,175389,6,184227
14776,0.006818,74.125.68.0-255,2902,178291,6,184227
14777,0.006823,172.31.36.0-255,66,178357,6,184227
14778,0.006849,74.125.68.0-255,1484,179841,6,184227
14779,0.009184,74.125.68.0-255,4320,184161,6,184227
14780,0.009192,172.31.36.0-255,66,184227,6,184227
14781,0.0,172.31.36.0-255,66,66,6,66
14782,0.0,74.125.130.0-255,226,226,6,57574
14783,1.5e-05,172.31.36.0-255,66,292,6,57574
14784,2.1e-05,74.125.130.0-255,1484,1776,6,57574
14785,2.6e-05,172.31.36.0-255,66,1842,6,57574
14786,7.7e-05,74.125.130.0-255,4320,6162,6,57574
14787,8e-05,172.31.36.0-255,66,6228,6,57574
14788,0.000215,74.125.130.0-255,2902,9130,6,57574
14789,0.00022,172.31.36.0-255,66,9196,6,57574
14790,0.00033,74.125.130.0-255,4811,14007,6,57574
14791,0.000335,172.31.36.0-255,66,14073,6,57574
14792,0.000532,74.125.130.0-255,9992,24065,6,57574
14793,0.000536,172.31.36.0-255,66,24131,6,57574
14794,0.000918,74.125.130.0-255,6797,30928,6,57574
14795,0.000925,172.31.36.0-255,66,30994,6,57574
14796,0.001176,74.125.130.0-255,5738,36732,6,57574
14797,0.001181,172.31.36.0-255,66,36798,6,57574
14798,0.002484,74.125.130.0-255,2902,39700,6,57574
14799,0.002488,172.31.36.0-255,66,39766,6,57574
14800,0.003671,74.125.130.0-255,2902,42668,6,57574
14801,0.003678,172.31.36.0-255,66,42734,6,57574
14802,0.004965,74.125.130.0-255,2902,45636,6,57574
14803,0.004972,172.31.36.0-255,66,45702,6,57574
14804,0.006156,74.125.130.0-255,2902,48604,6,57574
14805,0.006163,172.31.36.0-255,66,48670,6,57574
14806,0.00745,74.125.130.0-255,2902,51572,6,57574
14807,0.007457,172.31.36.0-255,66,51638,6,57574
14808,0.008632,74.125.130.0-255,2902,54540,6,57574
14809,0.008639,172.31.36.0-255,66,54606,6,57574
14810,0.009946,74.125.130.0-255,2902,57508,6,57574
14811,0.009954,172.31.36.0-255,66,57574,6,57574
14812,0.0,172.31.36.0-255,105,105,6,459
14813,0.000191,172.31.36.0-255,90,195,6,459
14814,0.0002,172.31.36.0-255,66,261,6,459
14815,0.002573,172.217.194.0-255,66,327,6,459
14816,0.0026,172.217.194.0-255,66,393,6,459
14817,0.002609,172.31.36.0-255,66,459,6,459
14818,0.0,74.125.68.0-255,298,298,6,358627
14819,2.3e-05,172.31.36.0-255,66,364,6,358627
14820,3e-05,74.125.68.0-255,1484,1848,6,358627
14821,3.4e-05,172.31.36.0-255,66,1914,6,358627
14822,4.1e-05,74.125.68.0-255,4320,6234,6,358627
14823,4.4e-05,172.31.36.0-255,66,6300,6,358627
14824,5.3e-05,74.125.68.0-255,7559,13859,6,358627
14825,5.6e-05,172.31.36.0-255,66,13925,6,358627
14826,0.000106,74.125.68.0-255,8574,22499,6,358627
14827,0.00011,172.31.36.0-255,66,22565,6,358627
14828,0.000116,74.125.68.0-255,2902,25467,6,358627
14829,0.000118,172.31.36.0-255,66,25533,6,358627
14830,0.000141,74.125.68.0-255,1484,27017,6,358627
14831,0.000143,172.31.36.0-255,66,27083,6,358627
14832,0.000158,74.125.68.0-255,3961,31044,6,358627
14833,0.000161,172.31.36.0-255,66,31110,6,358627
14834,0.000265,74.125.68.0-255,1484,32594,6,358627
14835,0.00027,172.31.36.0-255,66,32660,6,358627
14836,0.000291,74.125.68.0-255,2902,35562,6,358627
14837,0.000294,172.31.36.0-255,66,35628,6,358627
14838,0.000312,74.125.68.0-255,2902,38530,6,358627
14839,0.000314,172.31.36.0-255,66,38596,6,358627
14840,0.000335,74.125.68.0-255,4320,42916,6,358627
14841,0.000338,172.31.36.0-255,66,42982,6,358627
14842,0.000343,74.125.68.0-255,2902,45884,6,358627
14843,0.000345,172.31.36.0-255,66,45950,6,358627
14844,0.000363,74.125.68.0-255,4320,50270,6,358627
14845,0.000365,172.31.36.0-255,66,50336,6,358627
14846,0.000381,74.125.68.0-255,2902,53238,6,358627
14847,0.000384,172.31.36.0-255,66,53304,6,358627
14848,0.000403,74.125.68.0-255,5738,59042,6,358627
14849,0.000406,172.31.36.0-255,66,59108,6,358627
14850,0.000413,74.125.68.0-255,6438,65546,6,358627
14851,0.000416,172.31.36.0-255,66,65612,6,358627
14852,0.000418,74.125.68.0-255,361,65973,6,358627
14853,0.000481,74.125.68.0-255,133,66106,6,358627
14854,0.000596,74.125.68.0-255,1484,67590,6,358627
14855,0.0006,172.31.36.0-255,66,67656,6,358627
14856,0.000606,74.125.68.0-255,2902,70558,6,358627
14857,0.000609,172.31.36.0-255,66,70624,6,358627
14858,0.000615,74.125.68.0-255,4320,74944,6,358627
14859,0.000618,172.31.36.0-255,66,75010,6,358627
14860,0.000624,74.125.68.0-255,5738,80748,6,358627
14861,0.000627,172.31.36.0-255,66,80814,6,358627
14862,0.000651,74.125.68.0-255,5738,86552,6,358627
14863,0.000654,172.31.36.0-255,66,86618,6,358627
14864,0.000676,74.125.68.0-255,5738,92356,6,358627
14865,0.000678,172.31.36.0-255,66,92422,6,358627
14866,0.000685,74.125.68.0-255,7156,99578,6,358627
14867,0.000688,172.31.36.0-255,66,99644,6,358627
14868,0.000736,74.125.68.0-255,2902,102546,6,358627
14869,0.00074,172.31.36.0-255,66,102612,6,358627
14870,0.000763,74.125.68.0-255,6438,109050,6,358627
14871,0.000766,172.31.36.0-255,66,109116,6,358627
14872,0.000776,74.125.68.0-255,9992,119108,6,358627
14873,0.000779,172.31.36.0-255,66,119174,6,358627
14874,0.000784,74.125.68.0-255,4320,123494,6,358627
14875,0.000786,172.31.36.0-255,66,123560,6,358627
14876,0.000793,74.125.68.0-255,5738,129298,6,358627
14877,0.000795,172.31.36.0-255,66,129364,6,358627
14878,0.000825,74.125.68.0-255,5020,134384,6,358627
14879,0.000828,172.31.36.0-255,66,134450,6,358627
14880,0.000846,74.125.68.0-255,347,134797,6,358627
14881,0.000909,74.125.68.0-255,1484,136281,6,358627
14882,0.000912,172.31.36.0-255,66,136347,6,358627
14883,0.000929,74.125.68.0-255,2902,139249,6,358627
14884,0.000931,172.31.36.0-255,66,139315,6,358627
14885,0.000988,74.125.68.0-255,5738,145053,6,358627
14886,0.000992,172.31.36.0-255,66,145119,6,358627
14887,0.000999,74.125.68.0-255,7156,152275,6,358627
14888,0.001001,172.31.36.0-255,66,152341,6,358627
14889,0.001007,74.125.68.0-255,5738,158079,6,358627
14890,0.00101,172.31.36.0-255,66,158145,6,358627
14891,0.001023,74.125.68.0-255,2902,161047,6,358627
14892,0.001025,172.31.36.0-255,66,161113,6,358627
14893,0.001032,74.125.68.0-255,7156,168269,6,358627
14894,0.001035,172.31.36.0-255,66,168335,6,358627
14895,0.001053,74.125.68.0-255,766,169101,6,358627
14896,0.001101,74.125.68.0-255,1484,170585,6,358627
14897,0.001104,172.31.36.0-255,66,170651,6,358627
14898,0.001118,74.125.68.0-255,2902,173553,6,358627
14899,0.001121,172.31.36.0-255,66,173619,6,358627
14900,0.001134,74.125.68.0-255,1484,175103,6,358627
14901,0.001149,74.125.68.0-255,2902,178005,6,358627
14902,0.001152,172.31.36.0-255,66,178071,6,358627
14903,0.001183,74.125.68.0-255,2902,180973,6,358627
14904,0.001186,172.31.36.0-255,66,181039,6,358627
14905,0.001209,74.125.68.0-255,4320,185359,6,358627
14906,0.001212,172.31.36.0-255,66,185425,6,358627
14907,0.00122,74.125.68.0-255,8574,193999,6,358627
14908,0.001222,172.31.36.0-255,66,194065,6,358627
14909,0.001225,74.125.68.0-255,1484,195549,6,358627
14910,0.001248,74.125.68.0-255,2902,198451,6,358627
14911,0.001251,172.31.36.0-255,66,198517,6,358627
14912,0.001257,74.125.68.0-255,4320,202837,6,358627
14913,0.001259,172.31.36.0-255,66,202903,6,358627
14914,0.00128,74.125.68.0-255,766,203669,6,358627
14915,0.00145,74.125.68.0-255,1484,205153,6,358627
14916,0.001454,172.31.36.0-255,66,205219,6,358627
14917,0.00146,74.125.68.0-255,2902,208121,6,358627
14918,0.001463,172.31.36.0-255,66,208187,6,358627
14919,0.001488,74.125.68.0-255,1484,209671,6,358627
14920,0.001494,74.125.68.0-255,2902,212573,6,358627
14921,0.001496,172.31.36.0-255,66,212639,6,358627
14922,0.001507,74.125.68.0-255,1484,214123,6,358627
14923,0.001522,74.125.68.0-255,4320,218443,6,358627
14924,0.001524,172.31.36.0-255,66,218509,6,358627
14925,0.001531,74.125.68.0-255,5738,224247,6,358627
14926,0.001533,172.31.36.0-255,66,224313,6,358627
14927,0.001552,74.125.68.0-255,2902,227215,6,358627
14928,0.001554,172.31.36.0-255,66,227281,6,358627
14929,0.001578,74.125.68.0-255,4320,231601,6,358627
14930,0.001581,172.31.36.0-255,66,231667,6,358627
14931,0.001617,74.125.68.0-255,6438,238105,6,358627
14932,0.001621,172.31.36.0-255,66,238171,6,358627
14933,0.001702,74.125.68.0-255,1484,239655,6,358627
14934,0.001717,74.125.68.0-255,2902,242557,6,358627
14935,0.001721,172.31.36.0-255,66,242623,6,358627
14936,0.00176,74.125.68.0-255,1484,244107,6,358627
14937,0.001765,74.125.68.0-255,2902,247009,6,358627
14938,0.001768,172.31.36.0-255,66,247075,6,358627
14939,0.001779,74.125.68.0-255,5738,252813,6,358627
14940,0.001782,172.31.36.0-255,66,252879,6,358627
14941,0.001796,74.125.68.0-255,1484,254363,6,358627
14942,0.001798,74.125.68.0-255,1484,255847,6,358627
14943,0.001803,172.31.36.0-255,66,255913,6,358627
14944,0.001818,74.125.68.0-255,1484,257397,6,358627
14945,0.001842,74.125.68.0-255,5738,263135,6,358627
14946,0.001845,172.31.36.0-255,66,263201,6,358627
14947,0.001889,74.125.68.0-255,5738,268939,6,358627
14948,0.001893,172.31.36.0-255,66,269005,6,358627
14949,0.00191,74.125.68.0-255,1484,270489,6,358627
14950,0.001916,74.125.68.0-255,2184,272673,6,358627
14951,0.001918,172.31.36.0-255,66,272739,6,358627
14952,0.001947,74.125.68.0-255,1484,274223,6,358627
14953,0.001952,74.125.68.0-255,2902,277125,6,358627
14954,0.001957,172.31.36.0-255,66,277191,6,358627
14955,0.00197,74.125.68.0-255,1484,278675,6,358627
14956,0.001985,74.125.68.0-255,4320,282995,6,358627
14957,0.001988,74.125.68.0-255,1484,284479,6,358627
14958,0.002013,172.31.36.0-255,66,284545,6,358627
14959,0.002032,74.125.68.0-255,2902,287447,6,358627
14960,0.002036,74.125.68.0-255,1484,288931,6,358627
14961,0.002043,172.31.36.0-255,66,288997,6,358627
14962,0.002065,74.125.68.0-255,4320,293317,6,358627
14963,0.00207,74.125.68.0-255,2902,296219,6,358627
14964,0.002075,74.125.68.0-255,4320,300539,6,358627
14965,0.00208,172.31.36.0-255,66,300605,6,358627
14966,0.002114,74.125.68.0-255,6438,307043,6,358627
14967,0.002122,172.31.36.0-255,66,307109,6,358627
14968,0.002143,74.125.68.0-255,1484,308593,6,358627
14969,0.002164,74.125.68.0-255,5738,314331,6,358627
14970,0.002173,172.31.36.0-255,66,314397,6,358627
14971,0.00221,74.125.68.0-255,8574,322971,6,358627
14972,0.002224,74.125.68.0-255,1484,324455,6,358627
14973,0.002228,74.125.68.0-255,2902,327357,6,358627
14974,0.002275,172.31.36.0-255,66,327423,6,358627
14975,0.002281,74.125.68.0-255,5738,333161,6,358627
14976,0.002285,74.125.68.0-255,2902,336063,6,358627
14977,0.002291,74.125.68.0-255,4320,340383,6,358627
14978,0.002293,74.125.68.0-255,766,341149,6,358627
14979,0.002304,172.31.36.0-255,66,341215,6,358627
14980,0.004575,74.125.68.0-255,5738,346953,6,358627
14981,0.004581,172.31.36.0-255,66,347019,6,358627
14982,0.006869,74.125.68.0-255,5738,352757,6,358627
14983,0.00688,172.31.36.0-255,66,352823,6,358627
14984,0.009165,74.125.68.0-255,5738,358561,6,358627
14985,0.009172,172.31.36.0-255,66,358627,6,358627
14986,0.0,172.253.118.0-255,153,153,6,299721
14987,2.3e-05,172.31.36.0-255,66,219,6,299721
14988,3.1e-05,172.253.118.0-255,1484,1703,6,299721
14989,3.5e-05,172.31.36.0-255,66,1769,6,299721
14990,5e-05,172.253.118.0-255,2902,4671,6,299721
14991,5.4e-05,172.31.36.0-255,66,4737,6,299721
14992,6.2e-05,172.253.118.0-255,7156,11893,6,299721
14993,6.5e-05,172.31.36.0-255,66,11959,6,299721
14994,8.4e-05,172.253.118.0-255,7156,19115,6,299721
14995,8.7e-05,172.31.36.0-255,66,19181,6,299721
14996,0.00011,172.253.118.0-255,4912,24093,6,299721
14997,0.000113,172.31.36.0-255,66,24159,6,299721
14998,0.000125,172.253.118.0-255,6797,30956,6,299721
14999,0.000129,172.31.36.0-255,66,31022,6,299721
15000,0.000185,172.253.118.0-255,1484,32506,6,299721
15001,0.000188,172.31.36.0-255,66,32572,6,299721
15002,0.000193,172.253.118.0-255,2902,35474,6,299721
15003,0.000196,172.31.36.0-255,66,35540,6,299721
15004,0.000203,172.253.118.0-255,5738,41278,6,299721
15005,0.00021,172.31.36.0-255,66,41344,6,299721
15006,0.000215,172.253.118.0-255,4320,45664,6,299721
15007,0.000218,172.31.36.0-255,66,45730,6,299721
15008,0.000242,172.253.118.0-255,2902,48632,6,299721
15009,0.000244,172.31.36.0-255,66,48698,6,299721
15010,0.00026,172.31.36.0-255,66,48764,6,299721
15011,0.000304,172.253.118.0-255,2483,51247,6,299721
15012,0.000308,172.31.36.0-255,66,51313,6,299721
15013,0.00053,172.253.118.0-255,127,51440,6,299721
15014,0.000535,172.31.36.0-255,66,51506,6,299721
15015,0.000663,172.253.118.0-255,1484,52990,6,299721
15016,0.000668,172.31.36.0-255,66,53056,6,299721
15017,0.000673,172.253.118.0-255,2902,55958,6,299721
15018,0.000676,172.31.36.0-255,66,56024,6,299721
15019,0.00071,172.253.118.0-255,5738,61762,6,299721
15020,0.000713,172.31.36.0-255,66,61828,6,299721
15021,0.000721,172.253.118.0-255,7156,68984,6,299721
15022,0.000724,172.31.36.0-255,66,69050,6,299721
15023,0.000759,172.253.118.0-255,5738,74788,6,299721
15024,0.000763,172.31.36.0-255,66,74854,6,299721
15025,0.000771,172.253.118.0-255,7156,82010,6,299721
15026,0.000774,172.31.36.0-255,66,82076,6,299721
15027,0.000779,172.253.118.0-255,3304,85380,6,299721
15028,0.000781,172.31.36.0-255,66,85446,6,299721
15029,0.000824,172.253.118.0-255,4320,89766,6,299721
15030,0.000827,172.31.36.0-255,66,89832,6,299721
15031,0.000833,172.253.118.0-255,5738,95570,6,299721
15032,0.000835,172.31.36.0-255,66,95636,6,299721
15033,0.00087,172.31.36.0-255,66,95702,6,299721
15034,0.000876,172.253.118.0-255,4320,100022,6,299721
15035,0.000878,172.31.36.0-255,66,100088,6,299721
15036,0.000908,172.253.118.0-255,7856,107944,6,299721
15037,0.000911,172.31.36.0-255,66,108010,6,299721
15038,0.000957,172.253.118.0-255,1484,109494,6,299721
15039,0.00098,172.253.118.0-255,2902,112396,6,299721
15040,0.000983,172.31.36.0-255,66,112462,6,299721
15041,0.000991,172.253.118.0-255,5738,118200,6,299721
15042,0.000993,172.31.36.0-255,66,118266,6,299721
15043,0.001029,172.31.36.0-255,66,118332,6,299721
15044,0.00104,172.253.118.0-255,10692,129024,6,299721
15045,0.001047,172.31.36.0-255,66,129090,6,299721
15046,0.001228,172.253.118.0-255,1484,130574,6,299721
15047,0.001241,172.253.118.0-255,2902,133476,6,299721
15048,0.001246,172.31.36.0-255,66,133542,6,299721
15049,0.001257,172.253.118.0-255,5738,139280,6,299721
15050,0.001265,172.31.36.0-255,66,139346,6,299721
15051,0.001277,172.253.118.0-255,2902,142248,6,299721
15052,0.00128,172.31.36.0-255,66,142314,6,299721
15053,0.001307,172.253.118.0-255,4320,146634,6,299721
15054,0.00131,172.31.36.0-255,66,146700,6,299721
15055,0.001319,172.253.118.0-255,8574,155274,6,299721
15056,0.001321,172.31.36.0-255,66,155340,6,299721
15057,0.00133,172.253.118.0-255,2902,158242,6,299721
15058,0.001332,172.31.36.0-255,66,158308,6,299721
15059,0.001359,172.253.118.0-255,5020,163328,6,299721
15060,0.001362,172.31.36.0-255,66,163394,6,299721
15061,0.00144,172.253.118.0-255,1484,164878,6,299721
15062,0.001455,172.253.118.0-255,1484,166362,6,299721
15063,0.001457,172.31.36.0-255,66,166428,6,299721
15064,0.001489,172.253.118.0-255,1484,167912,6,299721
15065,0.001496,172.253.118.0-255,5738,173650,6,299721
15066,0.001499,172.31.36.0-255,66,173716,6,299721
15067,0.001502,172.253.118.0-255,1484,175200,6,299721
15068,0.001505,172.253.118.0-255,1484,176684,6,299721
15069,0.001507,172.31.36.0-255,66,176750,6,299721
15070,0.001534,172.253.118.0-255,7156,183906,6,299721
15071,0.001536,172.31.36.0-255,66,183972,6,299721
15072,0.001543,172.253.118.0-255,4320,188292,6,299721
15073,0.001545,172.31.36.0-255,66,188358,6,299721
15074,0.001569,172.253.118.0-255,2902,191260,6,299721
15075,0.001573,172.31.36.0-255,66,191326,6,299721
15076,0.001588,172.253.118.0-255,4320,195646,6,299721
15077,0.001591,172.31.36.0-255,66,195712,6,299721
15078,0.001609,172.253.118.0-255,2184,197896,6,299721
15079,0.001614,172.31.36.0-255,66,197962,6,299721
15080,0.001719,172.253.118.0-255,1484,199446,6,299721
15081,0.001724,172.253.118.0-255,2902,202348,6,299721
15082,0.001728,172.31.36.0-255,66,202414,6,299721
15083,0.001734,172.253.118.0-255,4320,206734,6,299721
15084,0.001737,172.31.36.0-255,66,206800,6,299721
15085,0.001757,172.253.118.0-255,1484,208284,6,299721
15086,0.001774,172.253.118.0-255,7156,215440,6,299721
15087,0.001777,172.31.36.0-255,66,215506,6,299721
15088,0.001791,172.31.36.0-255,66,215572,6,299721
15089,0.001795,172.253.118.0-255,2184,217756,6,299721
15090,0.001797,172.31.36.0-255,66,217822,6,299721
15091,0.002237,172.253.118.0-255,1484,219306,6,299721
15092,0.002243,172.253.118.0-255,2902,222208,6,299721
15093,0.002247,172.31.36.0-255,66,222274,6,299721
15094,0.002277,172.253.118.0-255,5738,228012,6,299721
15095,0.00228,172.31.36.0-255,66,228078,6,299721
15096,0.002287,172.253.118.0-255,5738,233816,6,299721
15097,0.002289,172.31.36.0-255,66,233882,6,299721
15098,0.002292,172.253.118.0-255,1484,235366,6,299721
15099,0.002295,172.253.118.0-255,1484,236850,6,299721
15100,0.002297,172.31.36.0-255,66,236916,6,299721
15101,0.002349,172.253.118.0-255,8574,245490,6,299721
15102,0.002351,172.253.118.0-255,1484,246974,6,299721
15103,0.002356,172.31.36.0-255,66,247040,6,299721
15104,0.002387,172.253.118.0-255,5020,252060,6,299721
15105,0.002389,172.31.36.0-255,66,252126,6,299721
15106,0.002451,172.253.118.0-255,1484,253610,6,299721
15107,0.002457,172.253.118.0-255,2902,256512,6,299721
15108,0.002459,172.31.36.0-255,66,256578,6,299721
15109,0.002495,172.253.118.0-255,5738,262316,6,299721
15110,0.002498,172.31.36.0-255,66,262382,6,299721
15111,0.002516,172.31.36.0-255,66,262448,6,299721
15112,0.002526,172.253.118.0-255,1484,263932,6,299721
15113,0.002581,172.31.36.0-255,66,263998,6,299721
15114,0.002588,172.253.118.0-255,7156,271154,6,299721
15115,0.002591,172.31.36.0-255,66,271220,6,299721
15116,0.002594,172.253.118.0-255,1484,272704,6,299721
15117,0.002649,172.31.36.0-255,66,272770,6,299721
15118,0.002652,172.253.118.0-255,766,273536,6,299721
15119,0.002659,172.253.118.0-255,5738,279274,6,299721
15120,0.002661,172.31.36.0-255,66,279340,6,299721
15121,0.002686,172.253.118.0-255,4320,283660,6,299721
15122,0.002688,172.31.36.0-255,66,283726,6,299721
15123,0.002728,172.253.118.0-255,9992,293718,6,299721
15124,0.00273,172.31.36.0-255,66,293784,6,299721
15125,0.002756,172.253.118.0-255,1484,295268,6,299721
15126,0.002762,172.253.118.0-255,4282,299550,6,299721
15127,0.002764,172.31.36.0-255,66,299616,6,299721
15128,0.002768,172.253.118.0-255,105,299721,6,299721
15129,0.0,74.125.130.0-255,153,153,6,182497
15130,2.4e-05,172.31.36.0-255,66,219,6,182497
15131,3.2e-05,74.125.130.0-255,1484,1703,6,182497
15132,3.7e-05,172.31.36.0-255,66,1769,6,182497
15133,4.4e-05,74.125.130.0-255,2902,4671,6,182497
15134,4.7e-05,172.31.36.0-255,66,4737,6,182497
15135,5.3e-05,74.125.130.0-255,4320,9057,6,182497
15136,5.6e-05,172.31.36.0-255,66,9123,6,182497
15137,7.3e-05,74.125.130.0-255,1484,10607,6,182497
15138,7.6e-05,172.31.36.0-255,66,10673,6,182497
15139,9.8e-05,74.125.130.0-255,3453,14126,6,182497
15140,0.000101,172.31.36.0-255,66,14192,6,182497
15141,0.000885,74.125.130.0-255,1484,15676,6,182497
15142,0.000893,172.31.36.0-255,66,15742,6,182497
15143,0.000902,74.125.130.0-255,1484,17226,6,182497
15144,0.000904,172.31.36.0-255,66,17292,6,182497
15145,0.00091,74.125.130.0-255,2902,20194,6,182497
15146,0.000912,172.31.36.0-255,66,20260,6,182497
15147,0.00093,74.125.130.0-255,2902,23162,6,182497
15148,0.000932,172.31.36.0-255,66,23228,6,182497
15149,0.000959,74.125.130.0-255,2902,26130,6,182497
15150,0.000962,172.31.36.0-255,66,26196,6,182497
15151,0.000967,74.125.130.0-255,2902,29098,6,182497
15152,0.000969,172.31.36.0-255,66,29164,6,182497
15153,0.000996,74.125.130.0-255,2543,31707,6,182497
15154,0.000999,172.31.36.0-255,66,31773,6,182497
15155,0.00118,74.125.130.0-255,1484,33257,6,182497
15156,0.001185,172.31.36.0-255,66,33323,6,182497
15157,0.001191,74.125.130.0-255,1484,34807,6,182497
15158,0.001194,172.31.36.0-255,66,34873,6,182497
15159,0.00122,74.125.130.0-255,2902,37775,6,182497
15160,0.001223,172.31.36.0-255,66,37841,6,182497
15161,0.001238,74.125.130.0-255,5738,43579,6,182497
15162,0.001241,172.31.36.0-255,66,43645,6,182497
15163,0.001262,74.125.130.0-255,2902,46547,6,182497
15164,0.001265,172.31.36.0-255,66,46613,6,182497
15165,0.001299,74.125.130.0-255,2543,49156,6,182497
15166,0.001302,172.31.36.0-255,66,49222,6,182497
15167,0.00151,74.125.130.0-255,1484,50706,6,182497
15168,0.001527,74.125.130.0-255,2902,53608,6,182497
15169,0.001531,172.31.36.0-255,66,53674,6,182497
15170,0.001566,74.125.130.0-255,5738,59412,6,182497
15171,0.001569,172.31.36.0-255,66,59478,6,182497
15172,0.001572,74.125.130.0-255,1484,60962,6,182497
15173,0.001586,74.125.130.0-255,2902,63864,6,182497
15174,0.001588,172.31.36.0-255,66,63930,6,182497
15175,0.001604,74.125.130.0-255,2543,66473,6,182497
15176,0.001607,172.31.36.0-255,66,66539,6,182497
15177,0.001612,74.125.130.0-255,2902,69441,6,182497
15178,0.001614,172.31.36.0-255,66,69507,6,182497
15179,0.001647,74.125.130.0-255,2902,72409,6,182497
15180,0.00165,172.31.36.0-255,66,72475,6,182497
15181,0.001683,74.125.130.0-255,1484,73959,6,182497
15182,0.001691,74.125.130.0-255,7156,81115,6,182497
15183,0.001694,172.31.36.0-255,66,81181,6,182497
15184,0.001709,74.125.130.0-255,2543,83724,6,182497
15185,0.001711,172.31.36.0-255,66,83790,6,182497
15186,0.001827,74.125.130.0-255,1484,85274,6,182497
15187,0.001848,74.125.130.0-255,2902,88176,6,182497
15188,0.00185,172.31.36.0-255,66,88242,6,182497
15189,0.001855,74.125.130.0-255,2902,91144,6,182497
15190,0.001857,172.31.36.0-255,66,91210,6,182497
15191,0.001882,74.125.130.0-255,4320,95530,6,182497
15192,0.001885,172.31.36.0-255,66,95596,6,182497
15193,0.001903,74.125.130.0-255,2902,98498,6,182497
15194,0.001905,172.31.36.0-255,66,98564,6,182497
15195,0.001921,74.125.130.0-255,3123,101687,6,182497
15196,0.001924,172.31.36.0-255,66,101753,6,182497
15197,0.002056,74.125.130.0-255,1484,103237,6,182497
15198,0.002072,74.125.130.0-255,2902,106139,6,182497
15199,0.002074,172.31.36.0-255,66,106205,6,182497
15200,0.002097,74.125.130.0-255,5738,111943,6,182497
15201,0.0021,172.31.36.0-255,66,112009,6,182497
15202,0.002102,74.125.130.0-255,1484,113493,6,182497
15203,0.002135,74.125.130.0-255,4320,117813,6,182497
15204,0.002137,172.31.36.0-255,66,117879,6,182497
15205,0.002156,74.125.130.0-255,4320,122199,6,182497
15206,0.002158,172.31.36.0-255,66,122265,6,182497
15207,0.002161,74.125.130.0-255,1484,123749,6,182497
15208,0.002164,74.125.130.0-255,1484,125233,6,182497
15209,0.002166,172.31.36.0-255,66,125299,6,182497
15210,0.002178,74.125.130.0-255,1484,126783,6,182497
15211,0.002192,74.125.130.0-255,4320,131103,6,182497
15212,0.002195,172.31.36.0-255,66,131169,6,182497
15213,0.002212,74.125.130.0-255,1484,132653,6,182497
15214,0.002215,74.125.130.0-255,1484,134137,6,182497
15215,0.002217,172.31.36.0-255,66,134203,6,182497
15216,0.002222,74.125.130.0-255,2184,136387,6,182497
15217,0.002224,172.31.36.0-255,66,136453,6,182497
15218,0.00233,74.125.130.0-255,1484,137937,6,182497
15219,0.002346,74.125.130.0-255,2902,140839,6,182497
15220,0.002349,172.31.36.0-255,66,140905,6,182497
15221,0.002352,74.125.130.0-255,1484,142389,6,182497
15222,0.002386,74.125.130.0-255,4320,146709,6,182497
15223,0.002388,172.31.36.0-255,66,146775,6,182497
15224,0.002404,74.125.130.0-255,1484,148259,6,182497
15225,0.00241,74.125.130.0-255,5738,153997,6,182497
15226,0.002412,172.31.36.0-255,66,154063,6,182497
15227,0.002442,74.125.130.0-255,5738,159801,6,182497
15228,0.002444,172.31.36.0-255,66,159867,6,182497
15229,0.002462,74.125.130.0-255,1484,161351,6,182497
15230,0.002468,74.125.130.0-255,5738,167089,6,182497
15231,0.002471,172.31.36.0-255,66,167155,6,182497
15232,0.002512,74.125.130.0-255,3602,170757,6,182497
15233,0.002515,172.31.36.0-255,66,170823,6,182497
15234,0.005084,74.125.130.0-255,1484,172307,6,182497
15235,0.005118,74.125.130.0-255,4320,176627,6,182497
15236,0.005123,172.31.36.0-255,66,176693,6,182497
15237,0.007746,74.125.130.0-255,5738,182431,6,182497
15238,0.007755,172.31.36.0-255,66,182497,6,182497
15239,0.0,172.217.194.0-255,297,297,6,298190
15240,2.5e-05,172.31.36.0-255,66,363,6,298190
15241,3.2e-05,172.217.194.0-255,1484,1847,6,298190
15242,3.7e-05,172.31.36.0-255,66,1913,6,298190
15243,4.4e-05,172.217.194.0-255,4320,6233,6,298190
15244,4.7e-05,172.31.36.0-255,66,6299,6,298190
15245,6.9e-05,172.217.194.0-255,8934,15233,6,298190
15246,7.2e-05,172.31.36.0-255,66,15299,6,298190
15247,8.6e-05,172.31.36.0-255,66,15365,6,298190
15248,0.00011,172.217.194.0-255,2543,17908,6,298190
15249,0.00012,172.31.36.0-255,66,17974,6,298190
15250,0.000326,172.217.194.0-255,1484,19458,6,298190
15251,0.000333,172.31.36.0-255,66,19524,6,298190
15252,0.000339,172.217.194.0-255,2902,22426,6,298190
15253,0.000342,172.31.36.0-255,66,22492,6,298190
15254,0.000363,172.217.194.0-255,5738,28230,6,298190
15255,0.000366,172.31.36.0-255,66,28296,6,298190
15256,0.000377,172.217.194.0-255,5738,34034,6,298190
15257,0.00038,172.31.36.0-255,66,34100,6,298190
15258,0.000387,172.217.194.0-255,5738,39838,6,298190
15259,0.000389,172.31.36.0-255,66,39904,6,298190
15260,0.000419,172.217.194.0-255,1484,41388,6,298190
15261,0.000423,172.31.36.0-255,66,41454,6,298190
15262,0.00044,172.217.194.0-255,10692,52146,6,298190
15263,0.000442,172.31.36.0-255,66,52212,6,298190
15264,0.000445,172.217.194.0-255,387,52599,6,298190
15265,0.000447,172.31.36.0-255,66,52665,6,298190
15266,0.000532,172.217.194.0-255,1484,54149,6,298190
15267,0.000538,172.31.36.0-255,66,54215,6,298190
15268,0.000545,172.217.194.0-255,2902,57117,6,298190
15269,0.000548,172.31.36.0-255,66,57183,6,298190
15270,0.00055,172.217.194.0-255,1484,58667,6,298190
15271,0.00056,172.31.36.0-255,66,58733,6,298190
15272,0.000596,172.217.194.0-255,4320,63053,6,298190
15273,0.000599,172.31.36.0-255,66,63119,6,298190
15274,0.000619,172.31.36.0-255,66,63185,6,298190
15275,0.000654,172.217.194.0-255,8574,71759,6,298190
15276,0.000657,172.31.36.0-255,66,71825,6,298190
15277,0.000704,172.217.194.0-255,6438,78263,6,298190
15278,0.000708,172.31.36.0-255,66,78329,6,298190
15279,0.000729,172.31.36.0-255,66,78395,6,298190
15280,0.000739,172.217.194.0-255,9992,88387,6,298190
15281,0.000745,172.217.194.0-255,3343,91730,6,298190
15282,0.000784,172.31.36.0-255,66,91796,6,298190
15283,0.000883,172.217.194.0-255,1484,93280,6,298190
15284,0.000886,172.217.194.0-255,1484,94764,6,298190
15285,0.000899,172.217.194.0-255,1484,96248,6,298190
15286,0.000906,172.217.194.0-255,5738,101986,6,298190
15287,0.00091,172.31.36.0-255,66,102052,6,298190
15288,0.000925,172.217.194.0-255,7156,109208,6,298190
15289,0.000937,172.217.194.0-255,7156,116364,6,298190
15290,0.000956,172.217.194.0-255,1484,117848,6,298190
15291,0.000973,172.217.194.0-255,2902,120750,6,298190
15292,0.000994,172.217.194.0-255,5020,125770,6,298190
15293,0.001007,172.31.36.0-255,66,125836,6,298190
15294,0.001154,172.217.194.0-255,1484,127320,6,298190
15295,0.00116,172.217.194.0-255,2902,130222,6,298190
15296,0.001176,172.217.194.0-255,1484,131706,6,298190
15297,0.001183,172.31.36.0-255,66,131772,6,298190
15298,0.001204,172.217.194.0-255,4320,136092,6,298190
15299,0.001209,172.217.194.0-255,2902,138994,6,298190
15300,0.001242,172.217.194.0-255,9992,148986,6,298190
15301,0.00125,172.217.194.0-255,7156,156142,6,298190
15302,0.001271,172.31.36.0-255,66,156208,6,298190
15303,0.001277,172.217.194.0-255,3602,159810,6,298190
15304,0.001299,172.31.36.0-255,66,159876,6,298190
15305,0.001342,172.217.194.0-255,1484,161360,6,298190
15306,0.001349,172.217.194.0-255,2902,164262,6,298190
15307,0.00137,172.217.194.0-255,5738,170000,6,298190
15308,0.001375,172.217.194.0-255,4320,174320,6,298190
15309,0.001386,172.31.36.0-255,66,174386,6,298190
15310,0.0014,172.217.194.0-255,7156,181542,6,298190
15311,0.001424,172.217.194.0-255,4320,185862,6,298190
15312,0.001428,172.31.36.0-255,66,185928,6,298190
15313,0.001475,172.217.194.0-255,9992,195920,6,298190
15314,0.001497,172.217.194.0-255,4320,200240,6,298190
15315,0.001534,172.31.36.0-255,66,200306,6,298190
15316,0.001567,172.217.194.0-255,1484,201790,6,298190
15317,0.001572,172.217.194.0-255,1484,203274,6,298190
15318,0.001591,172.217.194.0-255,1484,204758,6,298190
15319,0.001596,172.217.194.0-255,2902,207660,6,298190
15320,0.001602,172.31.36.0-255,66,207726,6,298190
15321,0.001611,172.217.194.0-255,1484,209210,6,298190
15322,0.001653,172.217.194.0-255,1484,210694,6,298190
15323,0.00166,172.31.36.0-255,66,210760,6,298190
15324,0.001694,172.217.194.0-255,7156,217916,6,298190
15325,0.001731,172.31.36.0-255,66,217982,6,298190
15326,0.001767,172.217.194.0-255,1484,219466,6,298190
15327,0.001783,172.217.194.0-255,2902,222368,6,298190
15328,0.00179,172.217.194.0-255,4320,226688,6,298190
15329,0.001805,172.217.194.0-255,1484,228172,6,298190
15330,0.001815,172.217.194.0-255,9992,238164,6,298190
15331,0.001828,172.217.194.0-255,2902,241066,6,298190
15332,0.001854,172.217.194.0-255,10692,251758,6,298190
15333,0.001871,172.31.36.0-255,66,251824,6,298190
15334,0.001938,172.217.194.0-255,1484,253308,6,298190
15335,0.001944,172.217.194.0-255,2902,256210,6,298190
15336,0.001949,172.217.194.0-255,2902,259112,6,298190
15337,0.001963,172.217.194.0-255,2902,262014,6,298190
15338,0.001979,172.31.36.0-255,66,262080,6,298190
15339,0.001988,172.217.194.0-255,8574,270654,6,298190
15340,0.002,172.31.36.0-255,66,270720,6,298190
15341,0.002018,172.217.194.0-255,4320,275040,6,298190
15342,0.002028,172.217.194.0-255,9992,285032,6,298190
15343,0.00206,172.217.194.0-255,7156,292188,6,298190
15344,0.002065,172.31.36.0-255,66,292254,6,298190
15345,0.002074,172.31.36.0-255,66,292320,6,298190
15346,0.002135,172.31.36.0-255,66,292386,6,298190
15347,0.004154,172.217.194.0-255,5738,298124,6,298190
15348,0.008249,172.31.36.0-255,66,298190,6,298190
15349,0.0,172.217.26.0-255,298,298,6,57547
15350,1.7e-05,172.31.36.0-255,66,364,6,57547
15351,2.3e-05,172.217.26.0-255,1484,1848,6,57547
15352,2.8e-05,172.31.36.0-255,66,1914,6,57547
15353,4.3e-05,172.217.26.0-255,4320,6234,6,57547
15354,4.6e-05,172.31.36.0-255,66,6300,6,57547
15355,0.000151,172.217.26.0-255,5738,12038,6,57547
15356,0.000156,172.31.36.0-255,66,12104,6,57547
15357,0.000183,172.217.26.0-255,1847,13951,6,57547
15358,0.000185,172.31.36.0-255,66,14017,6,57547
15359,0.00033,172.217.26.0-255,8574,22591,6,57547
15360,0.000335,172.31.36.0-255,66,22657,6,57547
15361,0.000547,172.217.26.0-255,8215,30872,6,57547
15362,0.000553,172.31.36.0-255,66,30938,6,57547
15363,0.000774,172.31.36.0-255,66,31004,6,57547
15364,0.000802,172.217.26.0-255,3961,34965,6,57547
15365,0.000804,172.31.36.0-255,66,35031,6,57547
15366,0.001246,172.31.36.0-255,66,35097,6,57547
15367,0.001656,172.31.36.0-255,66,35163,6,57547
15368,0.001687,172.217.26.0-255,4642,39805,6,57547
15369,0.00169,172.31.36.0-255,66,39871,6,57547
15370,0.002048,172.217.26.0-255,5738,45609,6,57547
15371,0.00205,172.31.36.0-255,66,45675,6,57547
15372,0.002101,172.31.36.0-255,66,45741,6,57547
15373,0.002965,172.31.36.0-255,66,45807,6,57547
15374,0.003008,172.31.36.0-255,66,45873,6,57547
15375,0.004935,172.217.26.0-255,2902,48775,6,57547
15376,0.004952,172.217.26.0-255,2902,51677,6,57547
15377,0.007653,172.31.36.0-255,66,51743,6,57547
15378,0.009584,172.217.26.0-255,5738,57481,6,57547
15379,0.00959,172.31.36.0-255,66,57547,6,57547
15380,0.0,172.217.194.0-255,153,153,6,232020
15381,1.5e-05,172.31.36.0-255,66,219,6,232020
15382,2.2e-05,172.217.194.0-255,1484,1703,6,232020
15383,2.6e-05,172.31.36.0-255,66,1769,6,232020
15384,7.6e-05,172.217.194.0-255,1484,3253,6,232020
15385,8e-05,172.31.36.0-255,66,3319,6,232020
15386,8.6e-05,172.217.194.0-255,2902,6221,6,232020
15387,8.9e-05,172.31.36.0-255,66,6287,6,232020
15388,0.000101,172.217.194.0-255,5738,12025,6,232020
15389,0.000103,172.31.36.0-255,66,12091,6,232020
15390,0.000108,172.217.194.0-255,2104,14195,6,232020
15391,0.00011,172.31.36.0-255,66,14261,6,232020
15392,0.000137,172.217.194.0-255,2902,17163,6,232020
15393,0.00014,172.31.36.0-255,66,17229,6,232020
15394,0.000169,172.217.194.0-255,7156,24385,6,232020
15395,0.000172,172.31.36.0-255,66,24451,6,232020
15396,0.000184,172.217.194.0-255,6797,31248,6,232020
15397,0.000186,172.31.36.0-255,66,31314,6,232020
15398,0.000356,172.217.194.0-255,1484,32798,6,232020
15399,0.000362,172.31.36.0-255,66,32864,6,232020
15400,0.000368,172.217.194.0-255,2902,35766,6,232020
15401,0.00037,172.31.36.0-255,66,35832,6,232020
15402,0.000381,172.217.194.0-255,5738,41570,6,232020
15403,0.000384,172.31.36.0-255,66,41636,6,232020
15404,0.000405,172.217.194.0-255,1484,43120,6,232020
15405,0.000407,172.31.36.0-255,66,43186,6,232020
15406,0.000447,172.31.36.0-255,66,43252,6,232020
15407,0.000497,172.217.194.0-255,9885,53137,6,232020
15408,0.0005,172.31.36.0-255,66,53203,6,232020
15409,0.000503,172.217.194.0-255,121,53324,6,232020
15410,0.000506,172.31.36.0-255,66,53390,6,232020
15411,0.000534,172.217.194.0-255,1484,54874,6,232020
15412,0.00054,172.217.194.0-255,2902,57776,6,232020
15413,0.000543,172.31.36.0-255,66,57842,6,232020
15414,0.000546,172.217.194.0-255,1484,59326,6,232020
15415,0.000574,172.217.194.0-255,5738,65064,6,232020
15416,0.000576,172.31.36.0-255,66,65130,6,232020
15417,0.000582,172.217.194.0-255,4320,69450,6,232020
15418,0.000584,172.31.36.0-255,66,69516,6,232020
15419,0.00062,172.31.36.0-255,66,69582,6,232020
15420,0.000631,172.217.194.0-255,1484,71066,6,232020
15421,0.000653,172.217.194.0-255,2543,73609,6,232020
15422,0.000655,172.31.36.0-255,66,73675,6,232020
15423,0.000658,172.217.194.0-255,379,74054,6,232020
15424,0.000735,172.217.194.0-255,1484,75538,6,232020
15425,0.000741,172.217.194.0-255,2902,78440,6,232020
15426,0.000766,172.217.194.0-255,5738,84178,6,232020
15427,0.000772,172.217.194.0-255,4320,88498,6,232020
15428,0.000786,172.31.36.0-255,66,88564,6,232020
15429,0.000823,172.217.194.0-255,2902,91466,6,232020
15430,0.000832,172.31.36.0-255,66,91532,6,232020
15431,0.000839,172.217.194.0-255,5738,97270,6,232020
15432,0.000845,172.31.36.0-255,66,97336,6,232020
15433,0.000879,172.217.194.0-255,2902,100238,6,232020
15434,0.000886,172.217.194.0-255,7156,107394,6,232020
15435,0.000889,172.217.194.0-255,766,108160,6,232020
15436,0.000909,172.31.36.0-255,66,108226,6,232020
15437,0.001502,172.217.194.0-255,1484,109710,6,232020
15438,0.001508,172.217.194.0-255,2902,112612,6,232020
15439,0.001511,172.31.36.0-255,66,112678,6,232020
15440,0.001519,172.217.194.0-255,5738,118416,6,232020
15441,0.001521,172.31.36.0-255,66,118482,6,232020
15442,0.001533,172.217.194.0-255,4320,122802,6,232020
15443,0.001535,172.31.36.0-255,66,122868,6,232020
15444,0.001564,172.217.194.0-255,4320,127188,6,232020
15445,0.001567,172.31.36.0-255,66,127254,6,232020
15446,0.001592,172.217.194.0-255,7156,134410,6,232020
15447,0.001598,172.31.36.0-255,66,134476,6,232020
15448,0.001607,172.217.194.0-255,7856,142332,6,232020
15449,0.001608,172.31.36.0-255,66,142398,6,232020
15450,0.001716,172.217.194.0-255,1484,143882,6,232020
15451,0.001722,172.217.194.0-255,2902,146784,6,232020
15452,0.001724,172.31.36.0-255,66,146850,6,232020
15453,0.001728,172.217.194.0-255,1484,148334,6,232020
15454,0.001754,172.217.194.0-255,2902,151236,6,232020
15455,0.001756,172.31.36.0-255,66,151302,6,232020
15456,0.001765,172.217.194.0-255,8574,159876,6,232020
15457,0.001791,172.217.194.0-255,4320,164196,6,232020
15458,0.0018,172.31.36.0-255,66,164262,6,232020
15459,0.001819,172.217.194.0-255,7156,171418,6,232020
15460,0.001834,172.217.194.0-255,1484,172902,6,232020
15461,0.001842,172.31.36.0-255,66,172968,6,232020
15462,0.001852,172.217.194.0-255,3602,176570,6,232020
15463,0.001862,172.31.36.0-255,66,176636,6,232020
15464,0.001904,172.217.194.0-255,1484,178120,6,232020
15465,0.001944,172.217.194.0-255,2902,181022,6,232020
15466,0.001948,172.31.36.0-255,66,181088,6,232020
15467,0.001954,172.217.194.0-255,4320,185408,6,232020
15468,0.001979,172.217.194.0-255,8574,193982,6,232020
15469,0.001992,172.31.36.0-255,66,194048,6,232020
15470,0.002019,172.217.194.0-255,2184,196232,6,232020
15471,0.002054,172.31.36.0-255,66,196298,6,232020
15472,0.00216,172.217.194.0-255,1484,197782,6,232020
15473,0.002166,172.217.194.0-255,2902,200684,6,232020
15474,0.002174,172.31.36.0-255,66,200750,6,232020
15475,0.002195,172.217.194.0-255,5738,206488,6,232020
15476,0.002207,172.217.194.0-255,1484,207972,6,232020
15477,0.002244,172.217.194.0-255,9992,217964,6,232020
15478,0.002257,172.217.194.0-255,766,218730,6,232020
15479,0.002391,172.217.194.0-255,1484,220214,6,232020
15480,0.003012,172.31.36.0-255,66,220280,6,232020
15481,0.005399,172.217.194.0-255,5738,226018,6,232020
15482,0.005407,172.31.36.0-255,66,226084,6,232020
15483,0.00776,172.217.194.0-255,2902,228986,6,232020
15484,0.007764,172.31.36.0-255,66,229052,6,232020
15485,0.007817,172.217.194.0-255,2902,231954,6,232020
15486,0.007825,172.31.36.0-255,66,232020,6,232020
15487,0.0,74.125.24.0-255,153,153,6,114991
15488,2.7e-05,172.31.36.0-255,66,219,6,114991
15489,3.4e-05,74.125.24.0-255,1484,1703,6,114991
15490,3.9e-05,172.31.36.0-255,66,1769,6,114991
15491,4.6e-05,74.125.24.0-255,2902,4671,6,114991
15492,4.8e-05,172.31.36.0-255,66,4737,6,114991
15493,5.6e-05,74.125.24.0-255,7156,11893,6,114991
15494,6e-05,172.31.36.0-255,66,11959,6,114991
15495,6.4e-05,74.125.24.0-255,2047,14006,6,114991
15496,6.7e-05,172.31.36.0-255,66,14072,6,114991
15497,0.000176,74.125.24.0-255,1484,15556,6,114991
15498,0.00018,172.31.36.0-255,66,15622,6,114991
15499,0.000185,74.125.24.0-255,2902,18524,6,114991
15500,0.000188,172.31.36.0-255,66,18590,6,114991
15501,0.000204,74.125.24.0-255,5738,24328,6,114991
15502,0.000207,172.31.36.0-255,66,24394,6,114991
15503,0.000211,74.125.24.0-255,2902,27296,6,114991
15504,0.000213,172.31.36.0-255,66,27362,6,114991
15505,0.000237,74.125.24.0-255,2902,30264,6,114991
15506,0.000239,172.31.36.0-255,66,30330,6,114991
15507,0.000257,74.125.24.0-255,1484,31814,6,114991
15508,0.000259,172.31.36.0-255,66,31880,6,114991
15509,0.000299,172.31.36.0-255,66,31946,6,114991
15510,0.000306,74.125.24.0-255,3961,35907,6,114991
15511,0.000308,172.31.36.0-255,66,35973,6,114991
15512,0.000851,74.125.24.0-255,1484,37457,6,114991
15513,0.000858,74.125.24.0-255,2902,40359,6,114991
15514,0.000864,74.125.24.0-255,5738,46097,6,114991
15515,0.000873,172.31.36.0-255,66,46163,6,114991
15516,0.000877,172.31.36.0-255,66,46229,6,114991
15517,0.00088,172.31.36.0-255,66,46295,6,114991
15518,0.000888,74.125.24.0-255,5738,52033,6,114991
15519,0.000894,172.31.36.0-255,66,52099,6,114991
15520,0.000912,74.125.24.0-255,1125,53224,6,114991
15521,0.000915,74.125.24.0-255,645,53869,6,114991
15522,0.000928,172.31.36.0-255,66,53935,6,114991
15523,0.000955,74.125.24.0-255,1484,55419,6,114991
15524,0.000962,74.125.24.0-255,4320,59739,6,114991
15525,0.000964,172.31.36.0-255,66,59805,6,114991
15526,0.000993,74.125.24.0-255,9992,69797,6,114991
15527,0.001018,172.31.36.0-255,66,69863,6,114991
15528,0.001028,74.125.24.0-255,1125,70988,6,114991
15529,0.00104,74.125.24.0-255,1484,72472,6,114991
15530,0.001052,172.31.36.0-255,66,72538,6,114991
15531,0.001065,74.125.24.0-255,4320,76858,6,114991
15532,0.001096,74.125.24.0-255,9992,86850,6,114991
15533,0.001101,172.31.36.0-255,66,86916,6,114991
15534,0.001115,74.125.24.0-255,1125,88041,6,114991
15535,0.001455,172.31.36.0-255,66,88107,6,114991
15536,0.001571,74.125.24.0-255,1484,89591,6,114991
15537,0.001616,74.125.24.0-255,2902,92493,6,114991
15538,0.001622,74.125.24.0-255,2902,95395,6,114991
15539,0.001643,74.125.24.0-255,2902,98297,6,114991
15540,0.001658,74.125.24.0-255,1484,99781,6,114991
15541,0.001697,74.125.24.0-255,1484,101265,6,114991
15542,0.001714,74.125.24.0-255,7856,109121,6,114991
15543,0.007041,172.31.36.0-255,66,109187,6,114991
15544,0.009278,74.125.24.0-255,5738,114925,6,114991
15545,0.009293,172.31.36.0-255,66,114991,6,114991
15546,0.0,172.217.194.0-255,150,150,6,250684
15547,2.8e-05,172.31.36.0-255,66,216,6,250684
15548,3.5e-05,172.217.194.0-255,1484,1700,6,250684
15549,3.9e-05,172.31.36.0-255,66,1766,6,250684
15550,4.3e-05,172.217.194.0-255,2902,4668,6,250684
15551,4.6e-05,172.31.36.0-255,66,4734,6,250684
15552,5.4e-05,172.217.194.0-255,5738,10472,6,250684
15553,5.7e-05,172.31.36.0-255,66,10538,6,250684
15554,7.7e-05,172.217.194.0-255,3510,14048,6,250684
15555,8e-05,172.31.36.0-255,66,14114,6,250684
15556,0.000304,172.217.194.0-255,1484,15598,6,250684
15557,0.00031,172.31.36.0-255,66,15664,6,250684
15558,0.000315,172.217.194.0-255,2902,18566,6,250684
15559,0.000318,172.31.36.0-255,66,18632,6,250684
15560,0.000334,172.217.194.0-255,4320,22952,6,250684
15561,0.000337,172.31.36.0-255,66,23018,6,250684
15562,0.000354,172.217.194.0-255,1484,24502,6,250684
15563,0.000356,172.31.36.0-255,66,24568,6,250684
15564,0.000387,172.217.194.0-255,6797,31365,6,250684
15565,0.000391,172.31.36.0-255,66,31431,6,250684
15566,0.000561,172.217.194.0-255,1484,32915,6,250684
15567,0.000564,172.31.36.0-255,66,32981,6,250684
15568,0.000573,172.217.194.0-255,2902,35883,6,250684
15569,0.000575,172.31.36.0-255,66,35949,6,250684
15570,0.000581,172.217.194.0-255,4320,40269,6,250684
15571,0.000583,172.31.36.0-255,66,40335,6,250684
15572,0.000609,172.217.194.0-255,2902,43237,6,250684
15573,0.000612,172.31.36.0-255,66,43303,6,250684
15574,0.000631,172.217.194.0-255,2902,46205,6,250684
15575,0.000633,172.31.36.0-255,66,46271,6,250684
15576,0.000661,172.217.194.0-255,4320,50591,6,250684
15577,0.000664,172.31.36.0-255,66,50657,6,250684
15578,0.000687,172.217.194.0-255,8215,58872,6,250684
15579,0.000691,172.31.36.0-255,66,58938,6,250684
15580,0.000765,172.217.194.0-255,2902,61840,6,250684
15581,0.000769,172.31.36.0-255,66,61906,6,250684
15582,0.000786,172.217.194.0-255,4213,66119,6,250684
15583,0.000788,172.31.36.0-255,66,66185,6,250684
15584,0.0008,172.217.194.0-255,116,66301,6,250684
15585,0.000816,172.217.194.0-255,383,66684,6,250684
15586,0.000857,172.217.194.0-255,1484,68168,6,250684
15587,0.000861,172.31.36.0-255,66,68234,6,250684
15588,0.000872,172.217.194.0-255,1484,69718,6,250684
15589,0.00088,172.217.194.0-255,7156,76874,6,250684
15590,0.000883,172.31.36.0-255,66,76940,6,250684
15591,0.000922,172.217.194.0-255,9992,86932,6,250684
15592,0.000925,172.31.36.0-255,66,86998,6,250684
15593,0.001007,172.217.194.0-255,4320,91318,6,250684
15594,0.001013,172.31.36.0-255,66,91384,6,250684
15595,0.00104,172.217.194.0-255,9274,100658,6,250684
15596,0.001044,172.31.36.0-255,66,100724,6,250684
15597,0.001299,172.217.194.0-255,1484,102208,6,250684
15598,0.001319,172.217.194.0-255,2902,105110,6,250684
15599,0.001322,172.31.36.0-255,66,105176,6,250684
15600,0.001329,172.217.194.0-255,5738,110914,6,250684
15601,0.001332,172.31.36.0-255,66,110980,6,250684
15602,0.001367,172.217.194.0-255,2902,113882,6,250684
15603,0.001369,172.31.36.0-255,66,113948,6,250684
15604,0.001385,172.217.194.0-255,4320,118268,6,250684
15605,0.001387,172.31.36.0-255,66,118334,6,250684
15606,0.001434,172.217.194.0-255,2902,121236,6,250684
15607,0.001437,172.31.36.0-255,66,121302,6,250684
15608,0.001472,172.31.36.0-255,66,121368,6,250684
15609,0.001552,172.217.194.0-255,2184,123552,6,250684
15610,0.001554,172.31.36.0-255,66,123618,6,250684
15611,0.001588,172.31.36.0-255,66,123684,6,250684
15612,0.001606,172.217.194.0-255,2902,126586,6,250684
15613,0.001609,172.31.36.0-255,66,126652,6,250684
15614,0.001725,172.217.194.0-255,2902,129554,6,250684
15615,0.001728,172.31.36.0-255,66,129620,6,250684
15616,0.001749,172.217.194.0-255,9992,139612,6,250684
15617,0.001752,172.31.36.0-255,66,139678,6,250684
15618,0.001839,172.217.194.0-255,2184,141862,6,250684
15619,0.001842,172.31.36.0-255,66,141928,6,250684
15620,0.001861,172.217.194.0-255,5738,147666,6,250684
15621,0.001863,172.31.36.0-255,66,147732,6,250684
15622,0.001899,172.31.36.0-255,66,147798,6,250684
15623,0.002001,172.217.194.0-255,1484,149282,6,250684
15624,0.002015,172.217.194.0-255,4320,153602,6,250684
15625,0.002017,172.31.36.0-255,66,153668,6,250684
15626,0.002034,172.217.194.0-255,10692,164360,6,250684
15627,0.002037,172.31.36.0-255,66,164426,6,250684
15628,0.002141,172.217.194.0-255,4320,168746,6,250684
15629,0.002143,172.31.36.0-255,66,168812,6,250684
15630,0.002161,172.217.194.0-255,9992,178804,6,250684
15631,0.002163,172.31.36.0-255,66,178870,6,250684
15632,0.00218,172.217.194.0-255,7156,186026,6,250684
15633,0.002182,172.31.36.0-255,66,186092,6,250684
15634,0.002341,172.217.194.0-255,5738,191830,6,250684
15635,0.002344,172.31.36.0-255,66,191896,6,250684
15636,0.002389,172.31.36.0-255,66,191962,6,250684
15637,0.002407,172.217.194.0-255,6438,198400,6,250684
15638,0.002409,172.31.36.0-255,66,198466,6,250684
15639,0.002646,172.217.194.0-255,2902,201368,6,250684
15640,0.002649,172.31.36.0-255,66,201434,6,250684
15641,0.002666,172.217.194.0-255,3602,205036,6,250684
15642,0.002668,172.31.36.0-255,66,205102,6,250684
15643,0.002713,172.217.194.0-255,2902,208004,6,250684
15644,0.002716,172.31.36.0-255,66,208070,6,250684
15645,0.002732,172.217.194.0-255,7156,215226,6,250684
15646,0.002735,172.31.36.0-255,66,215292,6,250684
15647,0.002777,172.217.194.0-255,2184,217476,6,250684
15648,0.002993,172.217.194.0-255,2902,220378,6,250684
15649,0.003009,172.217.194.0-255,8574,228952,6,250684
15650,0.003039,172.217.194.0-255,8574,237526,6,250684
15651,0.003049,172.217.194.0-255,1484,239010,6,250684
15652,0.003505,172.31.36.0-255,66,239076,6,250684
15653,0.005743,172.217.194.0-255,5738,244814,6,250684
15654,0.005749,172.31.36.0-255,66,244880,6,250684
15655,0.008054,172.217.194.0-255,5738,250618,6,250684
15656,0.00806,172.31.36.0-255,66,250684,6,250684
15657,0.0,172.217.194.0-255,153,153,6,337420
15658,1.6e-05,172.31.36.0-255,66,219,6,337420
15659,2.3e-05,172.217.194.0-255,1484,1703,6,337420
15660,2.7e-05,172.31.36.0-255,66,1769,6,337420
15661,3.4e-05,172.217.194.0-255,2902,4671,6,337420
15662,3.8e-05,172.31.36.0-255,66,4737,6,337420
15663,4.5e-05,172.217.194.0-255,7156,11893,6,337420
15664,4.8e-05,172.31.36.0-255,66,11959,6,337420
15665,5.3e-05,172.217.194.0-255,2052,14011,6,337420
15666,5.5e-05,172.31.36.0-255,66,14077,6,337420
15667,0.00011,172.217.194.0-255,1484,15561,6,337420
15668,0.000113,172.31.36.0-255,66,15627,6,337420
15669,0.000137,172.217.194.0-255,2902,18529,6,337420
15670,0.00014,172.31.36.0-255,66,18595,6,337420
15671,0.000147,172.217.194.0-255,5738,24333,6,337420
15672,0.000149,172.31.36.0-255,66,24399,6,337420
15673,0.000155,172.217.194.0-255,5738,30137,6,337420
15674,0.000157,172.31.36.0-255,66,30203,6,337420
15675,0.000179,172.217.194.0-255,1125,31328,6,337420
15676,0.000181,172.31.36.0-255,66,31394,6,337420
15677,0.000203,172.217.194.0-255,7156,38550,6,337420
15678,0.000205,172.31.36.0-255,66,38616,6,337420
15679,0.000231,172.217.194.0-255,7156,45772,6,337420
15680,0.000234,172.31.36.0-255,66,45838,6,337420
15681,0.000238,172.217.194.0-255,2543,48381,6,337420
15682,0.00024,172.31.36.0-255,66,48447,6,337420
15683,0.000713,172.217.194.0-255,1484,49931,6,337420
15684,0.000719,172.31.36.0-255,66,49997,6,337420
15685,0.000745,172.217.194.0-255,2902,52899,6,337420
15686,0.000748,172.31.36.0-255,66,52965,6,337420
15687,0.000754,172.217.194.0-255,5738,58703,6,337420
15688,0.000756,172.31.36.0-255,66,58769,6,337420
15689,0.000773,172.217.194.0-255,5738,64507,6,337420
15690,0.000776,172.31.36.0-255,66,64573,6,337420
15691,0.000797,172.217.194.0-255,1125,65698,6,337420
15692,0.000839,172.217.194.0-255,1484,67182,6,337420
15693,0.000842,172.31.36.0-255,66,67248,6,337420
15694,0.000848,172.217.194.0-255,2902,70150,6,337420
15695,0.00085,172.31.36.0-255,66,70216,6,337420
15696,0.00088,172.217.194.0-255,5738,75954,6,337420
15697,0.000883,172.31.36.0-255,66,76020,6,337420
15698,0.000886,172.217.194.0-255,1484,77504,6,337420
15699,0.000909,172.217.194.0-255,5738,83242,6,337420
15700,0.000911,172.31.36.0-255,66,83308,6,337420
15701,0.000918,172.217.194.0-255,5738,89046,6,337420
15702,0.000919,172.31.36.0-255,66,89112,6,337420
15703,0.000941,172.217.194.0-255,8574,97686,6,337420
15704,0.000943,172.31.36.0-255,66,97752,6,337420
15705,0.000947,172.217.194.0-255,2184,99936,6,337420
15706,0.000949,172.31.36.0-255,66,100002,6,337420
15707,0.000991,172.217.194.0-255,8574,108576,6,337420
15708,0.000994,172.31.36.0-255,66,108642,6,337420
15709,0.001017,172.217.194.0-255,5738,114380,6,337420
15710,0.00102,172.31.36.0-255,66,114446,6,337420
15711,0.001034,172.31.36.0-255,66,114512,6,337420
15712,0.001051,172.217.194.0-255,3842,118354,6,337420
15713,0.001053,172.31.36.0-255,66,118420,6,337420
15714,0.001059,172.217.194.0-255,4089,122509,6,337420
15715,0.001062,172.31.36.0-255,66,122575,6,337420
15716,0.001336,172.217.194.0-255,1484,124059,6,337420
15717,0.001352,172.217.194.0-255,2902,126961,6,337420
15718,0.001355,172.31.36.0-255,66,127027,6,337420
15719,0.001361,172.217.194.0-255,2902,129929,6,337420
15720,0.001363,172.31.36.0-255,66,129995,6,337420
15721,0.001377,172.217.194.0-255,2902,132897,6,337420
15722,0.001383,172.217.194.0-255,5738,138635,6,337420
15723,0.001388,172.31.36.0-255,66,138701,6,337420
15724,0.001396,172.31.36.0-255,66,138767,6,337420
15725,0.001399,172.217.194.0-255,1484,140251,6,337420
15726,0.001405,172.217.194.0-255,4320,144571,6,337420
15727,0.001407,172.31.36.0-255,66,144637,6,337420
15728,0.001426,172.217.194.0-255,9992,154629,6,337420
15729,0.001429,172.31.36.0-255,66,154695,6,337420
15730,0.001433,172.217.194.0-255,2184,156879,6,337420
15731,0.001435,172.31.36.0-255,66,156945,6,337420
15732,0.001455,172.217.194.0-255,2902,159847,6,337420
15733,0.001458,172.31.36.0-255,66,159913,6,337420
15734,0.001518,172.217.194.0-255,7156,167069,6,337420
15735,0.001524,172.217.194.0-255,5738,172807,6,337420
15736,0.00154,172.217.194.0-255,3602,176409,6,337420
15737,0.001545,172.31.36.0-255,66,176475,6,337420
15738,0.001553,172.31.36.0-255,66,176541,6,337420
15739,0.001556,172.31.36.0-255,66,176607,6,337420
15740,0.001559,172.31.36.0-255,66,176673,6,337420
15741,0.001791,172.217.194.0-255,1484,178157,6,337420
15742,0.001809,172.217.194.0-255,1484,179641,6,337420
15743,0.001813,172.31.36.0-255,66,179707,6,337420
15744,0.001827,172.217.194.0-255,1484,181191,6,337420
15745,0.001834,172.217.194.0-255,5738,186929,6,337420
15746,0.001836,172.31.36.0-255,66,186995,6,337420
15747,0.001869,172.31.36.0-255,66,187061,6,337420
15748,0.001884,172.217.194.0-255,1484,188545,6,337420
15749,0.001903,172.217.194.0-255,9274,197819,6,337420
15750,0.001908,172.31.36.0-255,66,197885,6,337420
15751,0.002203,172.217.194.0-255,1484,199369,6,337420
15752,0.002222,172.217.194.0-255,2902,202271,6,337420
15753,0.002226,172.31.36.0-255,66,202337,6,337420
15754,0.002233,172.217.194.0-255,5738,208075,6,337420
15755,0.002235,172.31.36.0-255,66,208141,6,337420
15756,0.002242,172.217.194.0-255,5738,213879,6,337420
15757,0.002244,172.31.36.0-255,66,213945,6,337420
15758,0.002273,172.217.194.0-255,1484,215429,6,337420
15759,0.002287,172.31.36.0-255,66,215495,6,337420
15760,0.002304,172.217.194.0-255,1484,216979,6,337420
15761,0.002309,172.217.194.0-255,2184,219163,6,337420
15762,0.002311,172.31.36.0-255,66,219229,6,337420
15763,0.002327,172.217.194.0-255,2902,222131,6,337420
15764,0.002329,172.31.36.0-255,66,222197,6,337420
15765,0.002332,172.217.194.0-255,1484,223681,6,337420
15766,0.002347,172.217.194.0-255,2902,226583,6,337420
15767,0.002349,172.31.36.0-255,66,226649,6,337420
15768,0.002355,172.217.194.0-255,4320,230969,6,337420
15769,0.002358,172.31.36.0-255,66,231035,6,337420
15770,0.002379,172.217.194.0-255,4320,235355,6,337420
15771,0.002381,172.31.36.0-255,66,235421,6,337420
15772,0.002398,172.217.194.0-255,4320,239741,6,337420
15773,0.002401,172.31.36.0-255,66,239807,6,337420
15774,0.002429,172.217.194.0-255,9992,249799,6,337420
15775,0.002432,172.31.36.0-255,66,249865,6,337420
15776,0.002452,172.217.194.0-255,3602,253467,6,337420
15777,0.002455,172.31.36.0-255,66,253533,6,337420
15778,0.00247,172.217.194.0-255,1484,255017,6,337420
15779,0.002491,172.217.194.0-255,2902,257919,6,337420
15780,0.002494,172.31.36.0-255,66,257985,6,337420
15781,0.002497,172.217.194.0-255,1484,259469,6,337420
15782,0.0025,172.217.194.0-255,1484,260953,6,337420
15783,0.002502,172.31.36.0-255,66,261019,6,337420
15784,0.002522,172.217.194.0-255,4320,265339,6,337420
15785,0.002525,172.31.36.0-255,66,265405,6,337420
15786,0.002549,172.217.194.0-255,5738,271143,6,337420
15787,0.002552,172.31.36.0-255,66,271209,6,337420
15788,0.00256,172.217.194.0-255,7156,278365,6,337420
15789,0.002562,172.31.36.0-255,66,278431,6,337420
15790,0.002571,172.217.194.0-255,8574,287005,6,337420
15791,0.002573,172.31.36.0-255,66,287071,6,337420
15792,0.002576,172.217.194.0-255,766,287837,6,337420
15793,0.002616,172.217.194.0-255,1484,289321,6,337420
15794,0.002619,172.31.36.0-255,66,289387,6,337420
15795,0.002624,172.217.194.0-255,2902,292289,6,337420
15796,0.002626,172.31.36.0-255,66,292355,6,337420
15797,0.002638,172.217.194.0-255,1484,293839,6,337420
15798,0.00266,172.217.194.0-255,5738,299577,6,337420
15799,0.002663,172.31.36.0-255,66,299643,6,337420
15800,0.002689,172.217.194.0-255,1484,301127,6,337420
15801,0.002703,172.31.36.0-255,66,301193,6,337420
15802,0.002711,172.217.194.0-255,7856,309049,6,337420
15803,0.002713,172.31.36.0-255,66,309115,6,337420
15804,0.002769,172.217.194.0-255,8574,317689,6,337420
15805,0.002772,172.31.36.0-255,66,317755,6,337420
15806,0.002781,172.217.194.0-255,9992,327747,6,337420
15807,0.002784,172.31.36.0-255,66,327813,6,337420
15808,0.0028,172.217.194.0-255,1484,329297,6,337420
15809,0.002828,172.217.194.0-255,7855,337152,6,337420
15810,0.002831,172.31.36.0-255,66,337218,6,337420
15811,0.002877,172.217.194.0-255,97,337315,6,337420
15812,0.002959,172.217.194.0-255,105,337420,6,337420
15813,0.0,74.125.24.0-255,291,291,6,225528
15814,3.4e-05,172.31.36.0-255,66,357,6,225528
15815,4.1e-05,74.125.24.0-255,1484,1841,6,225528
15816,4.5e-05,172.31.36.0-255,66,1907,6,225528
15817,5.1e-05,74.125.24.0-255,4320,6227,6,225528
15818,6.1e-05,172.31.36.0-255,66,6293,6,225528
15819,6.7e-05,74.125.24.0-255,4320,10613,6,225528
15820,6.9e-05,172.31.36.0-255,66,10679,6,225528
15821,7.9e-05,74.125.24.0-255,10414,21093,6,225528
15822,8.2e-05,172.31.36.0-255,66,21159,6,225528
15823,0.000119,74.125.24.0-255,9633,30792,6,225528
15824,0.000122,172.31.36.0-255,66,30858,6,225528
15825,0.000149,74.125.24.0-255,1484,32342,6,225528
15826,0.000152,172.31.36.0-255,66,32408,6,225528
15827,0.000182,74.125.24.0-255,2902,35310,6,225528
15828,0.000185,172.31.36.0-255,66,35376,6,225528
15829,0.000192,74.125.24.0-255,5738,41114,6,225528
15830,0.000194,172.31.36.0-255,66,41180,6,225528
15831,0.000202,74.125.24.0-255,6797,47977,6,225528
15832,0.000205,172.31.36.0-255,66,48043,6,225528
15833,0.00058,74.125.24.0-255,1484,49527,6,225528
15834,0.000586,172.31.36.0-255,66,49593,6,225528
15835,0.000591,74.125.24.0-255,2902,52495,6,225528
15836,0.000593,172.31.36.0-255,66,52561,6,225528
15837,0.000623,74.125.24.0-255,5738,58299,6,225528
15838,0.000627,74.125.24.0-255,2902,61201,6,225528
15839,0.000631,172.31.36.0-255,66,61267,6,225528
15840,0.000635,172.31.36.0-255,66,61333,6,225528
15841,0.00067,74.125.24.0-255,8574,69907,6,225528
15842,0.000673,172.31.36.0-255,66,69973,6,225528
15843,0.000696,74.125.24.0-255,2543,72516,6,225528
15844,0.000699,172.31.36.0-255,66,72582,6,225528
15845,0.000727,74.125.24.0-255,1484,74066,6,225528
15846,0.000752,74.125.24.0-255,8215,82281,6,225528
15847,0.000756,172.31.36.0-255,66,82347,6,225528
15848,0.000806,74.125.24.0-255,1484,83831,6,225528
15849,0.000821,74.125.24.0-255,2902,86733,6,225528
15850,0.000825,172.31.36.0-255,66,86799,6,225528
15851,0.000838,74.125.24.0-255,5738,92537,6,225528
15852,0.000846,172.31.36.0-255,66,92603,6,225528
15853,0.00089,74.125.24.0-255,6797,99400,6,225528
15854,0.000894,172.31.36.0-255,66,99466,6,225528
15855,0.000926,74.125.24.0-255,2902,102368,6,225528
15856,0.00093,172.31.36.0-255,66,102434,6,225528
15857,0.000959,74.125.24.0-255,4320,106754,6,225528
15858,0.000962,172.31.36.0-255,66,106820,6,225528
15859,0.000971,74.125.24.0-255,8574,115394,6,225528
15860,0.000973,172.31.36.0-255,66,115460,6,225528
15861,0.000979,74.125.24.0-255,4320,119780,6,225528
15862,0.000981,172.31.36.0-255,66,119846,6,225528
15863,0.001013,74.125.24.0-255,2902,122748,6,225528
15864,0.001016,172.31.36.0-255,66,122814,6,225528
15865,0.001039,74.125.24.0-255,1484,124298,6,225528
15866,0.001064,74.125.24.0-255,9274,133572,6,225528
15867,0.001067,172.31.36.0-255,66,133638,6,225528
15868,0.001135,74.125.24.0-255,1484,135122,6,225528
15869,0.001162,74.125.24.0-255,2902,138024,6,225528
15870,0.001166,172.31.36.0-255,66,138090,6,225528
15871,0.001173,74.125.24.0-255,5738,143828,6,225528
15872,0.001175,172.31.36.0-255,66,143894,6,225528
15873,0.001215,74.125.24.0-255,8574,152468,6,225528
15874,0.001219,172.31.36.0-255,66,152534,6,225528
15875,0.001222,74.125.24.0-255,1484,154018,6,225528
15876,0.00125,74.125.24.0-255,8574,162592,6,225528
15877,0.001254,172.31.36.0-255,66,162658,6,225528
15878,0.001257,74.125.24.0-255,1484,164142,6,225528
15879,0.001293,74.125.24.0-255,3602,167744,6,225528
15880,0.001296,172.31.36.0-255,66,167810,6,225528
15881,0.001526,74.125.24.0-255,1484,169294,6,225528
15882,0.00154,74.125.24.0-255,2902,172196,6,225528
15883,0.001544,172.31.36.0-255,66,172262,6,225528
15884,0.001548,74.125.24.0-255,1484,173746,6,225528
15885,0.001572,74.125.24.0-255,2902,176648,6,225528
15886,0.001575,172.31.36.0-255,66,176714,6,225528
15887,0.001581,74.125.24.0-255,5738,182452,6,225528
15888,0.001585,172.31.36.0-255,66,182518,6,225528
15889,0.001615,74.125.24.0-255,2902,185420,6,225528
15890,0.001619,172.31.36.0-255,66,185486,6,225528
15891,0.001625,74.125.24.0-255,5738,191224,6,225528
15892,0.001627,172.31.36.0-255,66,191290,6,225528
15893,0.001666,74.125.24.0-255,10692,201982,6,225528
15894,0.001674,172.31.36.0-255,66,202048,6,225528
15895,0.003665,74.125.24.0-255,5738,207786,6,225528
15896,0.003672,172.31.36.0-255,66,207852,6,225528
15897,0.005626,74.125.24.0-255,2902,210754,6,225528
15898,0.00563,172.31.36.0-255,66,210820,6,225528
15899,0.005655,74.125.24.0-255,2902,213722,6,225528
15900,0.005658,172.31.36.0-255,66,213788,6,225528
15901,0.007558,74.125.24.0-255,2902,216690,6,225528
15902,0.007566,172.31.36.0-255,66,216756,6,225528
15903,0.007605,74.125.24.0-255,2902,219658,6,225528
15904,0.007608,172.31.36.0-255,66,219724,6,225528
15905,0.009521,74.125.24.0-255,5738,225462,6,225528
15906,0.009526,172.31.36.0-255,66,225528,6,225528
15907,0.0,74.125.24.0-255,146,146,6,308925
15908,2.3e-05,172.31.36.0-255,66,212,6,308925
15909,3e-05,74.125.24.0-255,1484,1696,6,308925
15910,3.4e-05,172.31.36.0-255,66,1762,6,308925
15911,4e-05,74.125.24.0-255,2902,4664,6,308925
15912,4.3e-05,172.31.36.0-255,66,4730,6,308925
15913,4.8e-05,74.125.24.0-255,4320,9050,6,308925
15914,5.1e-05,172.31.36.0-255,66,9116,6,308925
15915,9.5e-05,74.125.24.0-255,4884,14000,6,308925
15916,9.8e-05,172.31.36.0-255,66,14066,6,308925
15917,0.000215,74.125.24.0-255,1484,15550,6,308925
15918,0.000219,172.31.36.0-255,66,15616,6,308925
15919,0.000225,74.125.24.0-255,2902,18518,6,308925
15920,0.000226,172.31.36.0-255,66,18584,6,308925
15921,0.000238,74.125.24.0-255,1484,20068,6,308925
15922,0.000241,172.31.36.0-255,66,20134,6,308925
15923,0.00026,74.125.24.0-255,4320,24454,6,308925
15924,0.000263,172.31.36.0-255,66,24520,6,308925
15925,0.000286,74.125.24.0-255,6797,31317,6,308925
15926,0.000289,172.31.36.0-255,66,31383,6,308925
15927,0.000293,74.125.24.0-255,2902,34285,6,308925
15928,0.000295,172.31.36.0-255,66,34351,6,308925
15929,0.00032,74.125.24.0-255,4320,38671,6,308925
15930,0.000322,172.31.36.0-255,66,38737,6,308925
15931,0.000327,74.125.24.0-255,2902,41639,6,308925
15932,0.000329,172.31.36.0-255,66,41705,6,308925
15933,0.000346,74.125.24.0-255,8574,50279,6,308925
15934,0.000349,172.31.36.0-255,66,50345,6,308925
15935,0.000352,74.125.24.0-255,1484,51829,6,308925
15936,0.000354,172.31.36.0-255,66,51895,6,308925
15937,0.000385,172.31.36.0-255,66,51961,6,308925
15938,0.000389,74.125.24.0-255,2184,54145,6,308925
15939,0.000391,172.31.36.0-255,66,54211,6,308925
15940,0.000501,74.125.24.0-255,360,54571,6,308925
15941,0.000505,172.31.36.0-255,66,54637,6,308925
15942,0.000977,74.125.24.0-255,1484,56121,6,308925
15943,0.000982,172.31.36.0-255,66,56187,6,308925
15944,0.000987,74.125.24.0-255,2902,59089,6,308925
15945,0.000989,172.31.36.0-255,66,59155,6,308925
15946,0.00101,74.125.24.0-255,5738,64893,6,308925
15947,0.001012,172.31.36.0-255,66,64959,6,308925
15948,0.001046,74.125.24.0-255,9992,74951,6,308925
15949,0.001049,172.31.36.0-255,66,75017,6,308925
15950,0.001086,172.31.36.0-255,66,75083,6,308925
15951,0.001091,74.125.24.0-255,2184,77267,6,308925
15952,0.001093,172.31.36.0-255,66,77333,6,308925
15953,0.001692,74.125.24.0-255,1484,78817,6,308925
15954,0.001699,172.31.36.0-255,66,78883,6,308925
15955,0.001709,74.125.24.0-255,2902,81785,6,308925
15956,0.001711,172.31.36.0-255,66,81851,6,308925
15957,0.001717,74.125.24.0-255,5738,87589,6,308925
15958,0.00172,172.31.36.0-255,66,87655,6,308925
15959,0.001745,74.125.24.0-255,9992,97647,6,308925
15960,0.001748,172.31.36.0-255,66,97713,6,308925
15961,0.001758,74.125.24.0-255,8574,106287,6,308925
15962,0.00176,172.31.36.0-255,66,106353,6,308925
15963,0.001784,74.125.24.0-255,2902,109255,6,308925
15964,0.001786,172.31.36.0-255,66,109321,6,308925
15965,0.001793,74.125.24.0-255,5738,115059,6,308925
15966,0.001795,172.31.36.0-255,66,115125,6,308925
15967,0.001812,74.125.24.0-255,6438,121563,6,308925
15968,0.001814,172.31.36.0-255,66,121629,6,308925
15969,0.001821,74.125.24.0-255,7156,128785,6,308925
15970,0.001823,172.31.36.0-255,66,128851,6,308925
15971,0.001855,74.125.24.0-255,5738,134589,6,308925
15972,0.001858,172.31.36.0-255,66,134655,6,308925
15973,0.001867,74.125.24.0-255,10692,145347,6,308925
15974,0.00187,172.31.36.0-255,66,145413,6,308925
15975,0.001914,74.125.24.0-255,1484,146897,6,308925
15976,0.001916,172.31.36.0-255,66,146963,6,308925
15977,0.001922,74.125.24.0-255,2902,149865,6,308925
15978,0.001924,172.31.36.0-255,66,149931,6,308925
15979,0.001952,74.125.24.0-255,5738,155669,6,308925
15980,0.001954,172.31.36.0-255,66,155735,6,308925
15981,0.001959,74.125.24.0-255,2902,158637,6,308925
15982,0.001962,172.31.36.0-255,66,158703,6,308925
15983,0.001971,74.125.24.0-255,9992,168695,6,308925
15984,0.002027,74.125.24.0-255,10692,179387,6,308925
15985,0.002266,74.125.24.0-255,1484,180871,6,308925
15986,0.002274,74.125.24.0-255,2902,183773,6,308925
15987,0.002288,74.125.24.0-255,1484,185257,6,308925
15988,0.002301,74.125.24.0-255,2902,188159,6,308925
15989,0.002307,74.125.24.0-255,4320,192479,6,308925
15990,0.002319,74.125.24.0-255,1484,193963,6,308925
15991,0.002327,74.125.24.0-255,7156,201119,6,308925
15992,0.002349,74.125.24.0-255,4320,205439,6,308925
15993,0.002357,74.125.24.0-255,7856,213295,6,308925
15994,0.002363,74.125.24.0-255,4320,217615,6,308925
15995,0.002381,74.125.24.0-255,4320,221935,6,308925
15996,0.002446,74.125.24.0-255,4320,226255,6,308925
15997,0.002459,74.125.24.0-255,2184,228439,6,308925
15998,0.002495,74.125.24.0-255,1484,229923,6,308925
15999,0.002499,74.125.24.0-255,1484,231407,6,308925
16000,0.002511,74.125.24.0-255,1484,232891,6,308925
16001,0.002525,74.125.24.0-255,5738,238629,6,308925
16002,0.00255,74.125.24.0-255,2902,241531,6,308925
16003,0.002583,74.125.24.0-255,8574,250105,6,308925
16004,0.002586,74.125.24.0-255,1484,251589,6,308925
16005,0.002621,74.125.24.0-255,10692,262281,6,308925
16006,0.002706,74.125.24.0-255,1484,263765,6,308925
16007,0.002725,74.125.24.0-255,2902,266667,6,308925
16008,0.002743,74.125.24.0-255,5738,272405,6,308925
16009,0.002747,74.125.24.0-255,1484,273889,6,308925
16010,0.002782,74.125.24.0-255,7156,281045,6,308925
16011,0.002786,74.125.24.0-255,1484,282529,6,308925
16012,0.002833,74.125.24.0-255,5738,288267,6,308925
16013,0.002852,74.125.24.0-255,5738,294005,6,308925
16014,0.002894,74.125.24.0-255,2184,296189,6,308925
16015,0.002921,74.125.24.0-255,1484,297673,6,308925
16016,0.002981,74.125.24.0-255,2902,300575,6,308925
16017,0.002988,74.125.24.0-255,5738,306313,6,308925
16018,0.003003,74.125.24.0-255,2507,308820,6,308925
16019,0.003017,74.125.24.0-255,105,308925,6,308925
16020,0.0,74.125.68.0-255,153,153,6,221235
16021,2.7e-05,172.31.36.0-255,66,219,6,221235
16022,3.4e-05,74.125.68.0-255,1484,1703,6,221235
16023,3.8e-05,172.31.36.0-255,66,1769,6,221235
16024,6.5e-05,74.125.68.0-255,2902,4671,6,221235
16025,6.7e-05,172.31.36.0-255,66,4737,6,221235
16026,9.2e-05,74.125.68.0-255,4320,9057,6,221235
16027,9.4e-05,172.31.36.0-255,66,9123,6,221235
16028,0.00011,74.125.68.0-255,2902,12025,6,221235
16029,0.000113,172.31.36.0-255,66,12091,6,221235
16030,0.000132,74.125.68.0-255,2083,14174,6,221235
16031,0.000135,172.31.36.0-255,66,14240,6,221235
16032,0.000402,74.125.68.0-255,1484,15724,6,221235
16033,0.000407,172.31.36.0-255,66,15790,6,221235
16034,0.000413,74.125.68.0-255,2902,18692,6,221235
16035,0.000416,172.31.36.0-255,66,18758,6,221235
16036,0.00044,74.125.68.0-255,2902,21660,6,221235
16037,0.000443,172.31.36.0-255,66,21726,6,221235
16038,0.000458,74.125.68.0-255,2902,24628,6,221235
16039,0.000461,172.31.36.0-255,66,24694,6,221235
16040,0.000478,74.125.68.0-255,4320,29014,6,221235
16041,0.000481,172.31.36.0-255,66,29080,6,221235
16042,0.000522,74.125.68.0-255,2543,31623,6,221235
16043,0.000526,172.31.36.0-255,66,31689,6,221235
16044,0.000529,74.125.68.0-255,1484,33173,6,221235
16045,0.000533,172.31.36.0-255,66,33239,6,221235
16046,0.000537,74.125.68.0-255,2902,36141,6,221235
16047,0.00054,172.31.36.0-255,66,36207,6,221235
16048,0.000542,74.125.68.0-255,1484,37691,6,221235
16049,0.000544,172.31.36.0-255,66,37757,6,221235
16050,0.000575,74.125.68.0-255,4320,42077,6,221235
16051,0.000579,172.31.36.0-255,66,42143,6,221235
16052,0.000581,74.125.68.0-255,1484,43627,6,221235
16053,0.000587,74.125.68.0-255,2902,46529,6,221235
16054,0.000589,172.31.36.0-255,66,46595,6,221235
16055,0.000607,74.125.68.0-255,2543,49138,6,221235
16056,0.00061,172.31.36.0-255,66,49204,6,221235
16057,0.000986,74.125.68.0-255,1484,50688,6,221235
16058,0.000996,74.125.68.0-255,2902,53590,6,221235
16059,0.001,172.31.36.0-255,66,53656,6,221235
16060,0.001019,74.125.68.0-255,1484,55140,6,221235
16061,0.001041,74.125.68.0-255,4320,59460,6,221235
16062,0.001044,172.31.36.0-255,66,59526,6,221235
16063,0.001053,74.125.68.0-255,6797,66323,6,221235
16064,0.001055,172.31.36.0-255,66,66389,6,221235
16065,0.001058,74.125.68.0-255,646,67035,6,221235
16066,0.001158,74.125.68.0-255,1484,68519,6,221235
16067,0.001162,172.31.36.0-255,66,68585,6,221235
16068,0.001167,74.125.68.0-255,2902,71487,6,221235
16069,0.001169,172.31.36.0-255,66,71553,6,221235
16070,0.001172,74.125.68.0-255,1484,73037,6,221235
16071,0.001197,74.125.68.0-255,2902,75939,6,221235
16072,0.0012,172.31.36.0-255,66,76005,6,221235
16073,0.001205,74.125.68.0-255,2902,78907,6,221235
16074,0.001207,172.31.36.0-255,66,78973,6,221235
16075,0.001232,74.125.68.0-255,5738,84711,6,221235
16076,0.001236,172.31.36.0-255,66,84777,6,221235
16077,0.001241,74.125.68.0-255,2902,87679,6,221235
16078,0.001242,172.31.36.0-255,66,87745,6,221235
16079,0.001248,74.125.68.0-255,4320,92065,6,221235
16080,0.00125,172.31.36.0-255,66,92131,6,221235
16081,0.001268,74.125.68.0-255,1484,93615,6,221235
16082,0.001293,74.125.68.0-255,5738,99353,6,221235
16083,0.001296,172.31.36.0-255,66,99419,6,221235
16084,0.001337,74.125.68.0-255,2184,101603,6,221235
16085,0.001341,172.31.36.0-255,66,101669,6,221235
16086,0.001621,74.125.68.0-255,1484,103153,6,221235
16087,0.001638,74.125.68.0-255,2902,106055,6,221235
16088,0.001641,172.31.36.0-255,66,106121,6,221235
16089,0.001669,74.125.68.0-255,2902,109023,6,221235
16090,0.001671,172.31.36.0-255,66,109089,6,221235
16091,0.00169,74.125.68.0-255,2902,111991,6,221235
16092,0.001692,172.31.36.0-255,66,112057,6,221235
16093,0.001703,74.125.68.0-255,2902,114959,6,221235
16094,0.001705,172.31.36.0-255,66,115025,6,221235
16095,0.001732,74.125.68.0-255,4320,119345,6,221235
16096,0.001735,172.31.36.0-255,66,119411,6,221235
16097,0.001739,74.125.68.0-255,4320,123731,6,221235
16098,0.001741,172.31.36.0-255,66,123797,6,221235
16099,0.001758,74.125.68.0-255,5738,129535,6,221235
16100,0.00176,172.31.36.0-255,66,129601,6,221235
16101,0.001784,74.125.68.0-255,4320,133921,6,221235
16102,0.001785,172.31.36.0-255,66,133987,6,221235
16103,0.001824,74.125.68.0-255,2184,136171,6,221235
16104,0.001827,172.31.36.0-255,66,136237,6,221235
16105,0.001899,74.125.68.0-255,1484,137721,6,221235
16106,0.001926,74.125.68.0-255,2902,140623,6,221235
16107,0.001928,172.31.36.0-255,66,140689,6,221235
16108,0.001944,74.125.68.0-255,1484,142173,6,221235
16109,0.001963,74.125.68.0-255,2902,145075,6,221235
16110,0.001965,172.31.36.0-255,66,145141,6,221235
16111,0.001968,74.125.68.0-255,1484,146625,6,221235
16112,0.001992,74.125.68.0-255,5738,152363,6,221235
16113,0.001994,172.31.36.0-255,66,152429,6,221235
16114,0.002009,74.125.68.0-255,2902,155331,6,221235
16115,0.002012,172.31.36.0-255,66,155397,6,221235
16116,0.002033,74.125.68.0-255,5738,161135,6,221235
16117,0.002035,172.31.36.0-255,66,161201,6,221235
16118,0.002038,74.125.68.0-255,1484,162685,6,221235
16119,0.0021,74.125.68.0-255,5738,168423,6,221235
16120,0.002102,172.31.36.0-255,66,168489,6,221235
16121,0.002118,74.125.68.0-255,2184,170673,6,221235
16122,0.00212,172.31.36.0-255,66,170739,6,221235
16123,0.002146,74.125.68.0-255,7156,177895,6,221235
16124,0.002149,172.31.36.0-255,66,177961,6,221235
16125,0.002184,74.125.68.0-255,1484,179445,6,221235
16126,0.002201,74.125.68.0-255,7156,186601,6,221235
16127,0.002203,172.31.36.0-255,66,186667,6,221235
16128,0.002206,74.125.68.0-255,1484,188151,6,221235
16129,0.002209,74.125.68.0-255,2902,191053,6,221235
16130,0.002211,172.31.36.0-255,66,191119,6,221235
16131,0.002214,74.125.68.0-255,1484,192603,6,221235
16132,0.00224,74.125.68.0-255,4320,196923,6,221235
16133,0.002242,172.31.36.0-255,66,196989,6,221235
16134,0.002245,74.125.68.0-255,1484,198473,6,221235
16135,0.002249,74.125.68.0-255,2902,201375,6,221235
16136,0.002251,172.31.36.0-255,66,201441,6,221235
16137,0.002292,74.125.68.0-255,3602,205043,6,221235
16138,0.002294,172.31.36.0-255,66,205109,6,221235
16139,0.004523,74.125.68.0-255,1484,206593,6,221235
16140,0.004571,74.125.68.0-255,4320,210913,6,221235
16141,0.004576,172.31.36.0-255,66,210979,6,221235
16142,0.006853,74.125.68.0-255,4320,215299,6,221235
16143,0.006857,172.31.36.0-255,66,215365,6,221235
16144,0.006891,74.125.68.0-255,1484,216849,6,221235
16145,0.009136,74.125.68.0-255,4320,221169,6,221235
16146,0.009144,172.31.36.0-255,66,221235,6,221235
16147,0.0,172.217.194.0-255,153,153,6,237087
16148,2.3e-05,172.31.36.0-255,66,219,6,237087
16149,3.1e-05,172.217.194.0-255,1484,1703,6,237087
16150,3.5e-05,172.31.36.0-255,66,1769,6,237087
16151,4.8e-05,172.217.194.0-255,2902,4671,6,237087
16152,5.2e-05,172.31.36.0-255,66,4737,6,237087
16153,6e-05,172.217.194.0-255,7156,11893,6,237087
16154,6.4e-05,172.31.36.0-255,66,11959,6,237087
16155,7.2e-05,172.217.194.0-255,7156,19115,6,237087
16156,7.5e-05,172.31.36.0-255,66,19181,6,237087
16157,0.000117,172.217.194.0-255,9145,28326,6,237087
16158,0.000121,172.31.36.0-255,66,28392,6,237087
16159,0.000125,172.217.194.0-255,2543,30935,6,237087
16160,0.000127,172.31.36.0-255,66,31001,6,237087
16161,0.000151,172.217.194.0-255,1484,32485,6,237087
16162,0.000153,172.31.36.0-255,66,32551,6,237087
16163,0.000158,172.217.194.0-255,2902,35453,6,237087
16164,0.000178,172.31.36.0-255,66,35519,6,237087
16165,0.000185,172.217.194.0-255,5738,41257,6,237087
16166,0.000188,172.31.36.0-255,66,41323,6,237087
16167,0.000194,172.217.194.0-255,4320,45643,6,237087
16168,0.000196,172.31.36.0-255,66,45709,6,237087
16169,0.000235,172.217.194.0-255,9633,55342,6,237087
16170,0.000239,172.31.36.0-255,66,55408,6,237087
16171,0.000248,172.217.194.0-255,9633,65041,6,237087
16172,0.000255,172.31.36.0-255,66,65107,6,237087
16173,0.000257,172.217.194.0-255,341,65448,6,237087
16174,0.000259,172.31.36.0-255,66,65514,6,237087
16175,0.000448,172.217.194.0-255,119,65633,6,237087
16176,0.000453,172.31.36.0-255,66,65699,6,237087
16177,0.000482,172.217.194.0-255,381,66080,6,237087
16178,0.000484,172.31.36.0-255,66,66146,6,237087
16179,0.000552,172.217.194.0-255,1484,67630,6,237087
16180,0.000558,172.217.194.0-255,1484,69114,6,237087
16181,0.000561,172.31.36.0-255,66,69180,6,237087
16182,0.000596,172.217.194.0-255,1484,70664,6,237087
16183,0.000602,172.217.194.0-255,5738,76402,6,237087
16184,0.000604,172.31.36.0-255,66,76468,6,237087
16185,0.000611,172.217.194.0-255,5738,82206,6,237087
16186,0.000613,172.31.36.0-255,66,82272,6,237087
16187,0.000621,172.217.194.0-255,575,82847,6,237087
16188,0.000895,172.217.194.0-255,1484,84331,6,237087
16189,0.0009,172.217.194.0-255,1484,85815,6,237087
16190,0.000906,172.31.36.0-255,66,85881,6,237087
16191,0.000915,172.217.194.0-255,1484,87365,6,237087
16192,0.000917,172.31.36.0-255,66,87431,6,237087
16193,0.000929,172.217.194.0-255,5738,93169,6,237087
16194,0.000931,172.31.36.0-255,66,93235,6,237087
16195,0.000973,172.31.36.0-255,66,93301,6,237087
16196,0.000983,172.217.194.0-255,8574,101875,6,237087
16197,0.000985,172.31.36.0-255,66,101941,6,237087
16198,0.001001,172.217.194.0-255,3602,105543,6,237087
16199,0.001008,172.31.36.0-255,66,105609,6,237087
16200,0.001674,172.217.194.0-255,1484,107093,6,237087
16201,0.001681,172.217.194.0-255,2902,109995,6,237087
16202,0.001685,172.31.36.0-255,66,110061,6,237087
16203,0.001715,172.217.194.0-255,5738,115799,6,237087
16204,0.001718,172.31.36.0-255,66,115865,6,237087
16205,0.001726,172.217.194.0-255,7156,123021,6,237087
16206,0.001728,172.31.36.0-255,66,123087,6,237087
16207,0.001762,172.217.194.0-255,5738,128825,6,237087
16208,0.001764,172.31.36.0-255,66,128891,6,237087
16209,0.001773,172.217.194.0-255,8574,137465,6,237087
16210,0.001775,172.31.36.0-255,66,137531,6,237087
16211,0.001803,172.217.194.0-255,2184,139715,6,237087
16212,0.001805,172.31.36.0-255,66,139781,6,237087
16213,0.00188,172.217.194.0-255,1484,141265,6,237087
16214,0.001901,172.217.194.0-255,2902,144167,6,237087
16215,0.001904,172.31.36.0-255,66,144233,6,237087
16216,0.001911,172.217.194.0-255,5738,149971,6,237087
16217,0.001913,172.31.36.0-255,66,150037,6,237087
16218,0.001932,172.31.36.0-255,66,150103,6,237087
16219,0.001938,172.217.194.0-255,4320,154423,6,237087
16220,0.00194,172.31.36.0-255,66,154489,6,237087
16221,0.001973,172.217.194.0-255,6438,160927,6,237087
16222,0.001976,172.31.36.0-255,66,160993,6,237087
16223,0.002042,172.217.194.0-255,1484,162477,6,237087
16224,0.002049,172.217.194.0-255,2902,165379,6,237087
16225,0.002051,172.31.36.0-255,66,165445,6,237087
16226,0.002058,172.217.194.0-255,5738,171183,6,237087
16227,0.00206,172.31.36.0-255,66,171249,6,237087
16228,0.002105,172.31.36.0-255,66,171315,6,237087
16229,0.002115,172.217.194.0-255,10692,182007,6,237087
16230,0.002118,172.31.36.0-255,66,182073,6,237087
16231,0.00218,172.217.194.0-255,1484,183557,6,237087
16232,0.00221,172.217.194.0-255,2902,186459,6,237087
16233,0.002213,172.31.36.0-255,66,186525,6,237087
16234,0.002219,172.217.194.0-255,5738,192263,6,237087
16235,0.002222,172.31.36.0-255,66,192329,6,237087
16236,0.002231,172.217.194.0-255,2902,195231,6,237087
16237,0.002233,172.31.36.0-255,66,195297,6,237087
16238,0.002263,172.217.194.0-255,9992,205289,6,237087
16239,0.002265,172.31.36.0-255,66,205355,6,237087
16240,0.002285,172.217.194.0-255,8574,213929,6,237087
16241,0.002287,172.31.36.0-255,66,213995,6,237087
16242,0.002299,172.217.194.0-255,2184,216179,6,237087
16243,0.002313,172.31.36.0-255,66,216245,6,237087
16244,0.002426,172.217.194.0-255,1484,217729,6,237087
16245,0.00243,172.217.194.0-255,1484,219213,6,237087
16246,0.002434,172.31.36.0-255,66,219279,6,237087
16247,0.004669,172.217.194.0-255,2902,222181,6,237087
16248,0.004678,172.31.36.0-255,66,222247,6,237087
16249,0.004781,172.217.194.0-255,2902,225149,6,237087
16250,0.004784,172.31.36.0-255,66,225215,6,237087
16251,0.00703,172.217.194.0-255,2902,228117,6,237087
16252,0.007033,172.31.36.0-255,66,228183,6,237087
16253,0.00717,172.217.194.0-255,2902,231085,6,237087
16254,0.007173,172.31.36.0-255,66,231151,6,237087
16255,0.009392,172.217.194.0-255,2902,234053,6,237087
16256,0.0094,172.31.36.0-255,66,234119,6,237087
16257,0.009558,172.217.194.0-255,2902,237021,6,237087
16258,0.009564,172.31.36.0-255,66,237087,6,237087
16259,0.0,74.125.24.0-255,152,152,6,129561
16260,3.5e-05,172.31.36.0-255,66,218,6,129561
16261,4.2e-05,74.125.24.0-255,1484,1702,6,129561
16262,4.6e-05,172.31.36.0-255,66,1768,6,129561
16263,5e-05,74.125.24.0-255,2902,4670,6,129561
16264,5.3e-05,172.31.36.0-255,66,4736,6,129561
16265,6e-05,74.125.24.0-255,7156,11892,6,129561
16266,6.3e-05,172.31.36.0-255,66,11958,6,129561
16267,7.8e-05,74.125.24.0-255,2039,13997,6,129561
16268,8e-05,172.31.36.0-255,66,14063,6,129561
16269,8.5e-05,74.125.24.0-255,2902,16965,6,129561
16270,8.7e-05,172.31.36.0-255,66,17031,6,129561
16271,0.000109,74.125.24.0-255,7156,24187,6,129561
16272,0.000112,172.31.36.0-255,66,24253,6,129561
16273,0.000137,74.125.24.0-255,2902,27155,6,129561
16274,0.00014,172.31.36.0-255,66,27221,6,129561
16275,0.000159,74.125.24.0-255,3961,31182,6,129561
16276,0.000162,172.31.36.0-255,66,31248,6,129561
16277,0.000333,74.125.24.0-255,1484,32732,6,129561
16278,0.000337,172.31.36.0-255,66,32798,6,129561
16279,0.000355,74.125.24.0-255,1484,34282,6,129561
16280,0.000358,172.31.36.0-255,66,34348,6,129561
16281,0.00038,74.125.24.0-255,1484,35832,6,129561
16282,0.000383,172.31.36.0-255,66,35898,6,129561
16283,0.000391,74.125.24.0-255,5738,41636,6,129561
16284,0.000393,172.31.36.0-255,66,41702,6,129561
16285,0.0004,74.125.24.0-255,6797,48499,6,129561
16286,0.000402,172.31.36.0-255,66,48565,6,129561
16287,0.000427,74.125.24.0-255,1484,50049,6,129561
16288,0.00043,172.31.36.0-255,66,50115,6,129561
16289,0.000459,172.31.36.0-255,66,50181,6,129561
16290,0.000463,74.125.24.0-255,2543,52724,6,129561
16291,0.000465,172.31.36.0-255,66,52790,6,129561
16292,0.000468,74.125.24.0-255,397,53187,6,129561
16293,0.000799,172.31.36.0-255,66,53253,6,129561
16294,0.000862,74.125.24.0-255,346,53599,6,129561
16295,0.001006,74.125.24.0-255,1484,55083,6,129561
16296,0.001011,172.31.36.0-255,66,55149,6,129561
16297,0.001017,74.125.24.0-255,2902,58051,6,129561
16298,0.001019,172.31.36.0-255,66,58117,6,129561
16299,0.001026,74.125.24.0-255,5738,63855,6,129561
16300,0.001028,172.31.36.0-255,66,63921,6,129561
16301,0.001066,172.31.36.0-255,66,63987,6,129561
16302,0.00108,172.31.36.0-255,66,64053,6,129561
16303,0.001453,74.125.24.0-255,1484,65537,6,129561
16304,0.00146,74.125.24.0-255,2902,68439,6,129561
16305,0.001464,172.31.36.0-255,66,68505,6,129561
16306,0.001471,74.125.24.0-255,5738,74243,6,129561
16307,0.001473,172.31.36.0-255,66,74309,6,129561
16308,0.001506,172.31.36.0-255,66,74375,6,129561
16309,0.001513,74.125.24.0-255,8574,82949,6,129561
16310,0.001515,172.31.36.0-255,66,83015,6,129561
16311,0.001545,74.125.24.0-255,2184,85199,6,129561
16312,0.001548,172.31.36.0-255,66,85265,6,129561
16313,0.00193,74.125.24.0-255,1484,86749,6,129561
16314,0.001942,74.125.24.0-255,2902,89651,6,129561
16315,0.001945,172.31.36.0-255,66,89717,6,129561
16316,0.001951,74.125.24.0-255,5738,95455,6,129561
16317,0.001953,172.31.36.0-255,66,95521,6,129561
16318,0.001996,172.31.36.0-255,66,95587,6,129561
16319,0.002024,74.125.24.0-255,10692,106279,6,129561
16320,0.002026,172.31.36.0-255,66,106345,6,129561
16321,0.004001,74.125.24.0-255,5738,112083,6,129561
16322,0.004005,172.31.36.0-255,66,112149,6,129561
16323,0.005961,74.125.24.0-255,5738,117887,6,129561
16324,0.005967,172.31.36.0-255,66,117953,6,129561
16325,0.007919,74.125.24.0-255,5738,123691,6,129561
16326,0.007925,172.31.36.0-255,66,123757,6,129561
16327,0.009903,74.125.24.0-255,5738,129495,6,129561
16328,0.00991,172.31.36.0-255,66,129561,6,129561
16329,0.0,74.125.24.0-255,146,146,6,253441
16330,1.3e-05,172.31.36.0-255,66,212,6,253441
16331,1.9e-05,74.125.24.0-255,1484,1696,6,253441
16332,2.3e-05,172.31.36.0-255,66,1762,6,253441
16333,3.5e-05,74.125.24.0-255,2902,4664,6,253441
16334,3.9e-05,172.31.36.0-255,66,4730,6,253441
16335,4.6e-05,74.125.24.0-255,7156,11886,6,253441
16336,4.9e-05,172.31.36.0-255,66,11952,6,253441
16337,5.2e-05,74.125.24.0-255,1484,13436,6,253441
16338,5.4e-05,172.31.36.0-255,66,13502,6,253441
16339,9.2e-05,74.125.24.0-255,596,14098,6,253441
16340,9.9e-05,172.31.36.0-255,66,14164,6,253441
16341,0.000129,74.125.24.0-255,1484,15648,6,253441
16342,0.000131,172.31.36.0-255,66,15714,6,253441
16343,0.000155,74.125.24.0-255,2902,18616,6,253441
16344,0.000158,172.31.36.0-255,66,18682,6,253441
16345,0.000164,74.125.24.0-255,5738,24420,6,253441
16346,0.000166,172.31.36.0-255,66,24486,6,253441
16347,0.000199,74.125.24.0-255,5738,30224,6,253441
16348,0.000201,172.31.36.0-255,66,30290,6,253441
16349,0.000216,74.125.24.0-255,1125,31415,6,253441
16350,0.000218,172.31.36.0-255,66,31481,6,253441
16351,0.000424,74.125.24.0-255,1484,32965,6,253441
16352,0.000429,172.31.36.0-255,66,33031,6,253441
16353,0.000435,74.125.24.0-255,2902,35933,6,253441
16354,0.000438,172.31.36.0-255,66,35999,6,253441
16355,0.000458,74.125.24.0-255,1484,37483,6,253441
16356,0.00046,172.31.36.0-255,66,37549,6,253441
16357,0.000487,74.125.24.0-255,4320,41869,6,253441
16358,0.00049,172.31.36.0-255,66,41935,6,253441
16359,0.000498,74.125.24.0-255,8215,50150,6,253441
16360,0.0005,172.31.36.0-255,66,50216,6,253441
16361,0.000503,74.125.24.0-255,1484,51700,6,253441
16362,0.000546,74.125.24.0-255,7156,58856,6,253441
16363,0.000549,172.31.36.0-255,66,58922,6,253441
16364,0.000555,74.125.24.0-255,7064,65986,6,253441
16365,0.000558,172.31.36.0-255,66,66052,6,253441
16366,0.00063,74.125.24.0-255,389,66441,6,253441
16367,0.000717,74.125.24.0-255,1484,67925,6,253441
16368,0.000721,172.31.36.0-255,66,67991,6,253441
16369,0.000727,74.125.24.0-255,2902,70893,6,253441
16370,0.000729,172.31.36.0-255,66,70959,6,253441
16371,0.000754,74.125.24.0-255,5738,76697,6,253441
16372,0.000757,172.31.36.0-255,66,76763,6,253441
16373,0.000793,74.125.24.0-255,6797,83560,6,253441
16374,0.000795,172.31.36.0-255,66,83626,6,253441
16375,0.00082,74.125.24.0-255,7156,90782,6,253441
16376,0.000822,172.31.36.0-255,66,90848,6,253441
16377,0.000865,74.125.24.0-255,2902,93750,6,253441
16378,0.000867,172.31.36.0-255,66,93816,6,253441
16379,0.000885,74.125.24.0-255,6797,100613,6,253441
16380,0.000893,172.31.36.0-255,66,100679,6,253441
16381,0.001412,74.125.24.0-255,1484,102163,6,253441
16382,0.001421,74.125.24.0-255,2902,105065,6,253441
16383,0.001424,172.31.36.0-255,66,105131,6,253441
16384,0.001431,74.125.24.0-255,5738,110869,6,253441
16385,0.001433,172.31.36.0-255,66,110935,6,253441
16386,0.001458,74.125.24.0-255,7156,118091,6,253441
16387,0.00146,172.31.36.0-255,66,118157,6,253441
16388,0.001494,74.125.24.0-255,2902,121059,6,253441
16389,0.001496,172.31.36.0-255,66,121125,6,253441
16390,0.001501,74.125.24.0-255,4320,125445,6,253441
16391,0.001503,172.31.36.0-255,66,125511,6,253441
16392,0.001535,74.125.24.0-255,9274,134785,6,253441
16393,0.001537,172.31.36.0-255,66,134851,6,253441
16394,0.001696,74.125.24.0-255,1484,136335,6,253441
16395,0.001701,74.125.24.0-255,1484,137819,6,253441
16396,0.001704,172.31.36.0-255,66,137885,6,253441
16397,0.001733,74.125.24.0-255,1484,139369,6,253441
16398,0.001739,74.125.24.0-255,5738,145107,6,253441
16399,0.001742,172.31.36.0-255,66,145173,6,253441
16400,0.001754,172.31.36.0-255,66,145239,6,253441
16401,0.001767,74.125.24.0-255,9992,155231,6,253441
16402,0.001769,172.31.36.0-255,66,155297,6,253441
16403,0.00181,74.125.24.0-255,8574,163871,6,253441
16404,0.001812,172.31.36.0-255,66,163937,6,253441
16405,0.001858,172.31.36.0-255,66,164003,6,253441
16406,0.001861,74.125.24.0-255,1484,165487,6,253441
16407,0.001869,74.125.24.0-255,9274,174761,6,253441
16408,0.001872,172.31.36.0-255,66,174827,6,253441
16409,0.001884,74.125.24.0-255,9992,184819,6,253441
16410,0.001887,172.31.36.0-255,66,184885,6,253441
16411,0.001958,172.31.36.0-255,66,184951,6,253441
16412,0.00196,74.125.24.0-255,766,185717,6,253441
16413,0.001968,74.125.24.0-255,9992,195709,6,253441
16414,0.00197,172.31.36.0-255,66,195775,6,253441
16415,0.002006,172.31.36.0-255,66,195841,6,253441
16416,0.002014,74.125.24.0-255,9274,205115,6,253441
16417,0.002016,172.31.36.0-255,66,205181,6,253441
16418,0.002048,74.125.24.0-255,8574,213755,6,253441
16419,0.00205,172.31.36.0-255,66,213821,6,253441
16420,0.002095,172.31.36.0-255,66,213887,6,253441
16421,0.002123,172.31.36.0-255,66,213953,6,253441
16422,0.00215,74.125.24.0-255,3602,217555,6,253441
16423,0.002157,172.31.36.0-255,66,217621,6,253441
16424,0.002171,172.31.36.0-255,66,217687,6,253441
16425,0.002181,74.125.24.0-255,9992,227679,6,253441
16426,0.002183,172.31.36.0-255,66,227745,6,253441
16427,0.002214,74.125.24.0-255,4320,232065,6,253441
16428,0.002217,172.31.36.0-255,66,232131,6,253441
16429,0.002224,74.125.24.0-255,6438,238569,6,253441
16430,0.002226,172.31.36.0-255,66,238635,6,253441
16431,0.002237,74.125.24.0-255,9992,248627,6,253441
16432,0.002239,172.31.36.0-255,66,248693,6,253441
16433,0.002265,172.31.36.0-255,66,248759,6,253441
16434,0.002268,74.125.24.0-255,1484,250243,6,253441
16435,0.002272,74.125.24.0-255,2790,253033,6,253441
16436,0.002274,172.31.36.0-255,66,253099,6,253441
16437,0.00233,74.125.24.0-255,105,253204,6,253441
16438,0.004853,172.31.36.0-255,66,253270,6,253441
16439,0.004894,172.31.36.0-255,105,253375,6,253441
16440,0.007174,74.125.24.0-255,66,253441,6,253441
16441,0.0,104.244.42.0-255,66,66,6,66
16442,0.0,172.217.194.0-255,154,154,6,157629
16443,3.4e-05,172.31.36.0-255,66,220,6,157629
16444,4.1e-05,172.217.194.0-255,1484,1704,6,157629
16445,4.5e-05,172.31.36.0-255,66,1770,6,157629
16446,5.1e-05,172.217.194.0-255,2902,4672,6,157629
16447,5.3e-05,172.31.36.0-255,66,4738,6,157629
16448,5.9e-05,172.217.194.0-255,5738,10476,6,157629
16449,6.2e-05,172.31.36.0-255,66,10542,6,157629
16450,6.8e-05,172.217.194.0-255,5738,16280,6,157629
16451,7.1e-05,172.31.36.0-255,66,16346,6,157629
16452,0.000107,172.217.194.0-255,4912,21258,6,157629
16453,0.00011,172.31.36.0-255,66,21324,6,157629
16454,0.000119,172.217.194.0-255,9633,30957,6,157629
16455,0.000121,172.31.36.0-255,66,31023,6,157629
16456,0.000129,172.217.194.0-255,8574,39597,6,157629
16457,0.000132,172.31.36.0-255,66,39663,6,157629
16458,0.000147,172.217.194.0-255,1484,41147,6,157629
16459,0.000149,172.31.36.0-255,66,41213,6,157629
16460,0.000158,172.217.194.0-255,6797,48010,6,157629
16461,0.00016,172.31.36.0-255,66,48076,6,157629
16462,0.000197,172.217.194.0-255,1484,49560,6,157629
16463,0.0002,172.31.36.0-255,66,49626,6,157629
16464,0.000205,172.217.194.0-255,2902,52528,6,157629
16465,0.000207,172.31.36.0-255,66,52594,6,157629
16466,0.000212,172.217.194.0-255,2902,55496,6,157629
16467,0.000214,172.31.36.0-255,66,55562,6,157629
16468,0.000232,172.217.194.0-255,2902,58464,6,157629
16469,0.000235,172.31.36.0-255,66,58530,6,157629
16470,0.000256,172.217.194.0-255,7071,65601,6,157629
16471,0.00026,172.31.36.0-255,66,65667,6,157629
16472,0.00027,172.217.194.0-255,402,66069,6,157629
16473,0.000272,172.31.36.0-255,66,66135,6,157629
16474,0.000603,172.217.194.0-255,1484,67619,6,157629
16475,0.00061,172.217.194.0-255,2902,70521,6,157629
16476,0.000616,172.31.36.0-255,66,70587,6,157629
16477,0.000629,172.217.194.0-255,5738,76325,6,157629
16478,0.000632,172.31.36.0-255,66,76391,6,157629
16479,0.000659,172.217.194.0-255,9992,86383,6,157629
16480,0.000662,172.31.36.0-255,66,86449,6,157629
16481,0.000679,172.217.194.0-255,1484,87933,6,157629
16482,0.000682,172.217.194.0-255,1484,89417,6,157629
16483,0.000684,172.31.36.0-255,66,89483,6,157629
16484,0.000714,172.217.194.0-255,10692,100175,6,157629
16485,0.000717,172.31.36.0-255,66,100241,6,157629
16486,0.001322,172.217.194.0-255,1484,101725,6,157629
16487,0.001332,172.217.194.0-255,2902,104627,6,157629
16488,0.001336,172.31.36.0-255,66,104693,6,157629
16489,0.001343,172.217.194.0-255,5738,110431,6,157629
16490,0.001345,172.31.36.0-255,66,110497,6,157629
16491,0.001371,172.217.194.0-255,5738,116235,6,157629
16492,0.001375,172.31.36.0-255,66,116301,6,157629
16493,0.001396,172.217.194.0-255,7156,123457,6,157629
16494,0.001398,172.31.36.0-255,66,123523,6,157629
16495,0.001432,172.217.194.0-255,5738,129261,6,157629
16496,0.001435,172.31.36.0-255,66,129327,6,157629
16497,0.001456,172.217.194.0-255,5020,134347,6,157629
16498,0.001459,172.31.36.0-255,66,134413,6,157629
16499,0.003444,172.217.194.0-255,5738,140151,6,157629
16500,0.00345,172.31.36.0-255,66,140217,6,157629
16501,0.005426,172.217.194.0-255,5738,145955,6,157629
16502,0.005431,172.31.36.0-255,66,146021,6,157629
16503,0.007449,172.217.194.0-255,5738,151759,6,157629
16504,0.007456,172.31.36.0-255,66,151825,6,157629
16505,0.009445,172.217.194.0-255,5738,157563,6,157629
16506,0.009453,172.31.36.0-255,66,157629,6,157629
16507,0.0,74.125.200.0-255,153,153,6,322641
16508,3.4e-05,172.31.36.0-255,66,219,6,322641
16509,4.1e-05,74.125.200.0-255,1484,1703,6,322641
16510,4.5e-05,172.31.36.0-255,66,1769,6,322641
16511,5e-05,74.125.200.0-255,2902,4671,6,322641
16512,5.4e-05,172.31.36.0-255,66,4737,6,322641
16513,6.1e-05,74.125.200.0-255,5738,10475,6,322641
16514,6.4e-05,172.31.36.0-255,66,10541,6,322641
16515,0.000106,74.125.200.0-255,6307,16848,6,322641
16516,0.000109,172.31.36.0-255,66,16914,6,322641
16517,0.000113,74.125.200.0-255,4320,21234,6,322641
16518,0.000115,172.31.36.0-255,66,21300,6,322641
16519,0.00012,74.125.200.0-255,5738,27038,6,322641
16520,0.000122,172.31.36.0-255,66,27104,6,322641
16521,0.000154,74.125.200.0-255,3961,31065,6,322641
16522,0.000157,172.31.36.0-255,66,31131,6,322641
16523,0.000228,74.125.200.0-255,1484,32615,6,322641
16524,0.00023,172.31.36.0-255,66,32681,6,322641
16525,0.000242,74.125.200.0-255,2902,35583,6,322641
16526,0.000244,172.31.36.0-255,66,35649,6,322641
16527,0.000265,74.125.200.0-255,2902,38551,6,322641
16528,0.000268,172.31.36.0-255,66,38617,6,322641
16529,0.000272,74.125.200.0-255,2902,41519,6,322641
16530,0.000274,172.31.36.0-255,66,41585,6,322641
16531,0.00029,74.125.200.0-255,1484,43069,6,322641
16532,0.000292,172.31.36.0-255,66,43135,6,322641
16533,0.000326,74.125.200.0-255,9633,52768,6,322641
16534,0.000328,172.31.36.0-255,66,52834,6,322641
16535,0.000333,74.125.200.0-255,4320,57154,6,322641
16536,0.000335,172.31.36.0-255,66,57220,6,322641
16537,0.000361,74.125.200.0-255,1484,58704,6,322641
16538,0.000363,172.31.36.0-255,66,58770,6,322641
16539,0.000385,74.125.200.0-255,7078,65848,6,322641
16540,0.000388,172.31.36.0-255,66,65914,6,322641
16541,0.00042,74.125.200.0-255,126,66040,6,322641
16542,0.000536,74.125.200.0-255,1484,67524,6,322641
16543,0.00054,172.31.36.0-255,66,67590,6,322641
16544,0.00056,74.125.200.0-255,2902,70492,6,322641
16545,0.000562,172.31.36.0-255,66,70558,6,322641
16546,0.000567,74.125.200.0-255,2902,73460,6,322641
16547,0.000569,172.31.36.0-255,66,73526,6,322641
16548,0.000585,74.125.200.0-255,4320,77846,6,322641
16549,0.000587,172.31.36.0-255,66,77912,6,322641
16550,0.00062,74.125.200.0-255,5379,83291,6,322641
16551,0.000623,172.31.36.0-255,66,83357,6,322641
16552,0.000659,74.125.200.0-255,5738,89095,6,322641
16553,0.000662,172.31.36.0-255,66,89161,6,322641
16554,0.000666,74.125.200.0-255,1484,90645,6,322641
16555,0.000685,74.125.200.0-255,5738,96383,6,322641
16556,0.000687,172.31.36.0-255,66,96449,6,322641
16557,0.000713,74.125.200.0-255,4242,100691,6,322641
16558,0.000716,172.31.36.0-255,66,100757,6,322641
16559,0.000762,74.125.200.0-255,4320,105077,6,322641
16560,0.000765,172.31.36.0-255,66,105143,6,322641
16561,0.000768,74.125.200.0-255,1484,106627,6,322641
16562,0.000788,74.125.200.0-255,7156,113783,6,322641
16563,0.000791,172.31.36.0-255,66,113849,6,322641
16564,0.000823,74.125.200.0-255,7156,121005,6,322641
16565,0.000826,172.31.36.0-255,66,121071,6,322641
16566,0.000848,74.125.200.0-255,8574,129645,6,322641
16567,0.000851,172.31.36.0-255,66,129711,6,322641
16568,0.000857,74.125.200.0-255,5020,134731,6,322641
16569,0.000859,172.31.36.0-255,66,134797,6,322641
16570,0.000965,74.125.200.0-255,1484,136281,6,322641
16571,0.000984,74.125.200.0-255,2902,139183,6,322641
16572,0.000987,172.31.36.0-255,66,139249,6,322641
16573,0.000991,74.125.200.0-255,1484,140733,6,322641
16574,0.001007,74.125.200.0-255,4320,145053,6,322641
16575,0.00101,172.31.36.0-255,66,145119,6,322641
16576,0.001022,74.125.200.0-255,1484,146603,6,322641
16577,0.001043,74.125.200.0-255,9992,156595,6,322641
16578,0.001047,172.31.36.0-255,66,156661,6,322641
16579,0.001065,74.125.200.0-255,1484,158145,6,322641
16580,0.001071,74.125.200.0-255,4320,162465,6,322641
16581,0.001074,172.31.36.0-255,66,162531,6,322641
16582,0.001093,74.125.200.0-255,5738,168269,6,322641
16583,0.001097,172.31.36.0-255,66,168335,6,322641
16584,0.001116,74.125.200.0-255,766,169101,6,322641
16585,0.001133,74.125.200.0-255,2902,172003,6,322641
16586,0.00114,172.31.36.0-255,66,172069,6,322641
16587,0.001156,74.125.200.0-255,4320,176389,6,322641
16588,0.001159,172.31.36.0-255,66,176455,6,322641
16589,0.001164,74.125.200.0-255,4320,180775,6,322641
16590,0.001166,172.31.36.0-255,66,180841,6,322641
16591,0.001191,74.125.200.0-255,4320,185161,6,322641
16592,0.001194,172.31.36.0-255,66,185227,6,322641
16593,0.001201,74.125.200.0-255,5738,190965,6,322641
16594,0.001203,172.31.36.0-255,66,191031,6,322641
16595,0.001256,74.125.200.0-255,9992,201023,6,322641
16596,0.001261,172.31.36.0-255,66,201089,6,322641
16597,0.001275,74.125.200.0-255,1484,202573,6,322641
16598,0.001278,74.125.200.0-255,766,203339,6,322641
16599,0.001281,172.31.36.0-255,66,203405,6,322641
16600,0.001502,74.125.200.0-255,1484,204889,6,322641
16601,0.001506,74.125.200.0-255,1484,206373,6,322641
16602,0.001509,172.31.36.0-255,66,206439,6,322641
16603,0.001529,74.125.200.0-255,1484,207923,6,322641
16604,0.001536,74.125.200.0-255,5738,213661,6,322641
16605,0.001538,172.31.36.0-255,66,213727,6,322641
16606,0.001543,74.125.200.0-255,4320,218047,6,322641
16607,0.001545,172.31.36.0-255,66,218113,6,322641
16608,0.001549,74.125.200.0-255,2902,221015,6,322641
16609,0.001551,172.31.36.0-255,66,221081,6,322641
16610,0.001565,74.125.200.0-255,2902,223983,6,322641
16611,0.001567,172.31.36.0-255,66,224049,6,322641
16612,0.00159,74.125.200.0-255,8574,232623,6,322641
16613,0.001592,172.31.36.0-255,66,232689,6,322641
16614,0.001608,74.125.200.0-255,2902,235591,6,322641
16615,0.001611,172.31.36.0-255,66,235657,6,322641
16616,0.001615,74.125.200.0-255,2184,237841,6,322641
16617,0.001617,172.31.36.0-255,66,237907,6,322641
16618,0.001736,74.125.200.0-255,1484,239391,6,322641
16619,0.00174,74.125.200.0-255,1484,240875,6,322641
16620,0.001743,172.31.36.0-255,66,240941,6,322641
16621,0.001767,74.125.200.0-255,1484,242425,6,322641
16622,0.001773,74.125.200.0-255,5738,248163,6,322641
16623,0.001774,172.31.36.0-255,66,248229,6,322641
16624,0.001802,74.125.200.0-255,7156,255385,6,322641
16625,0.001805,172.31.36.0-255,66,255451,6,322641
16626,0.001827,74.125.200.0-255,5738,261189,6,322641
16627,0.00183,172.31.36.0-255,66,261255,6,322641
16628,0.001846,74.125.200.0-255,2902,264157,6,322641
16629,0.001849,172.31.36.0-255,66,264223,6,322641
16630,0.001882,74.125.200.0-255,7856,272079,6,322641
16631,0.001886,172.31.36.0-255,66,272145,6,322641
16632,0.001925,74.125.200.0-255,1484,273629,6,322641
16633,0.00194,74.125.200.0-255,1484,275113,6,322641
16634,0.001942,172.31.36.0-255,66,275179,6,322641
16635,0.001961,74.125.200.0-255,2902,278081,6,322641
16636,0.001963,172.31.36.0-255,66,278147,6,322641
16637,0.001995,74.125.200.0-255,5738,283885,6,322641
16638,0.001998,172.31.36.0-255,66,283951,6,322641
16639,0.002003,74.125.200.0-255,2902,286853,6,322641
16640,0.002005,172.31.36.0-255,66,286919,6,322641
16641,0.00201,74.125.200.0-255,4320,291239,6,322641
16642,0.002012,172.31.36.0-255,66,291305,6,322641
16643,0.002015,74.125.200.0-255,1484,292789,6,322641
16644,0.002043,74.125.200.0-255,7156,299945,6,322641
16645,0.002047,172.31.36.0-255,66,300011,6,322641
16646,0.00206,74.125.200.0-255,1484,301495,6,322641
16647,0.002081,74.125.200.0-255,5020,306515,6,322641
16648,0.002084,172.31.36.0-255,66,306581,6,322641
16649,0.004108,74.125.200.0-255,5738,312319,6,322641
16650,0.004115,172.31.36.0-255,66,312385,6,322641
16651,0.006121,74.125.200.0-255,4320,316705,6,322641
16652,0.006124,172.31.36.0-255,66,316771,6,322641
16653,0.006142,74.125.200.0-255,1484,318255,6,322641
16654,0.008131,74.125.200.0-255,4320,322575,6,322641
16655,0.008133,172.31.36.0-255,66,322641,6,322641
16656,0.0,74.125.68.0-255,146,146,6,132846
16657,3.6e-05,172.31.36.0-255,66,212,6,132846
16658,4.4e-05,74.125.68.0-255,1484,1696,6,132846
16659,4.8e-05,172.31.36.0-255,66,1762,6,132846
16660,6.8e-05,74.125.68.0-255,1484,3246,6,132846
16661,7.1e-05,172.31.36.0-255,66,3312,6,132846
16662,8.1e-05,74.125.68.0-255,2902,6214,6,132846
16663,8.4e-05,172.31.36.0-255,66,6280,6,132846
16664,0.000119,74.125.68.0-255,5738,12018,6,132846
16665,0.000122,172.31.36.0-255,66,12084,6,132846
16666,0.000166,74.125.68.0-255,6293,18377,6,132846
16667,0.00017,172.31.36.0-255,66,18443,6,132846
16668,0.000202,74.125.68.0-255,7156,25599,6,132846
16669,0.000205,172.31.36.0-255,66,25665,6,132846
16670,0.000212,74.125.68.0-255,5379,31044,6,132846
16671,0.000215,172.31.36.0-255,66,31110,6,132846
16672,0.000706,74.125.68.0-255,1484,32594,6,132846
16673,0.000711,172.31.36.0-255,66,32660,6,132846
16674,0.00072,74.125.68.0-255,2902,35562,6,132846
16675,0.000723,172.31.36.0-255,66,35628,6,132846
16676,0.000758,74.125.68.0-255,5738,41366,6,132846
16677,0.000763,172.31.36.0-255,66,41432,6,132846
16678,0.000766,74.125.68.0-255,1484,42916,6,132846
16679,0.000768,172.31.36.0-255,66,42982,6,132846
16680,0.000772,74.125.68.0-255,1484,44466,6,132846
16681,0.000774,172.31.36.0-255,66,44532,6,132846
16682,0.000801,74.125.68.0-255,1484,46016,6,132846
16683,0.000805,172.31.36.0-255,66,46082,6,132846
16684,0.000812,74.125.68.0-255,5738,51820,6,132846
16685,0.000815,172.31.36.0-255,66,51886,6,132846
16686,0.000819,74.125.68.0-255,2902,54788,6,132846
16687,0.000822,172.31.36.0-255,66,54854,6,132846
16688,0.000826,74.125.68.0-255,2902,57756,6,132846
16689,0.000828,172.31.36.0-255,66,57822,6,132846
16690,0.000871,74.125.68.0-255,1484,59306,6,132846
16691,0.000885,74.125.68.0-255,6438,65744,6,132846
16692,0.000889,172.31.36.0-255,66,65810,6,132846
16693,0.000892,74.125.68.0-255,397,66207,6,132846
16694,0.000934,74.125.68.0-255,1484,67691,6,132846
16695,0.000937,172.31.36.0-255,66,67757,6,132846
16696,0.000943,74.125.68.0-255,4320,72077,6,132846
16697,0.000946,172.31.36.0-255,66,72143,6,132846
16698,0.000974,74.125.68.0-255,7156,79299,6,132846
16699,0.000978,172.31.36.0-255,66,79365,6,132846
16700,0.001006,74.125.68.0-255,2902,82267,6,132846
16701,0.00101,172.31.36.0-255,66,82333,6,132846
16702,0.001015,74.125.68.0-255,4320,86653,6,132846
16703,0.001018,172.31.36.0-255,66,86719,6,132846
16704,0.001062,172.31.36.0-255,66,86785,6,132846
16705,0.001065,74.125.68.0-255,347,87132,6,132846
16706,0.00132,74.125.68.0-255,1484,88616,6,132846
16707,0.001326,172.31.36.0-255,66,88682,6,132846
16708,0.001332,74.125.68.0-255,2902,91584,6,132846
16709,0.001335,172.31.36.0-255,66,91650,6,132846
16710,0.001367,74.125.68.0-255,5738,97388,6,132846
16711,0.001371,172.31.36.0-255,66,97454,6,132846
16712,0.001399,74.125.68.0-255,4320,101774,6,132846
16713,0.001402,172.31.36.0-255,66,101840,6,132846
16714,0.001431,74.125.68.0-255,8574,110414,6,132846
16715,0.001435,172.31.36.0-255,66,110480,6,132846
16716,0.001447,74.125.68.0-255,10692,121172,6,132846
16717,0.004897,172.31.36.0-255,66,121238,6,132846
16718,0.007151,74.125.68.0-255,5738,126976,6,132846
16719,0.007159,172.31.36.0-255,66,127042,6,132846
16720,0.009444,74.125.68.0-255,5738,132780,6,132846
16721,0.009451,172.31.36.0-255,66,132846,6,132846
16722,0.0,74.125.24.0-255,153,153,6,341438
16723,2.1e-05,172.31.36.0-255,66,219,6,341438
16724,2.8e-05,74.125.24.0-255,1484,1703,6,341438
16725,3.3e-05,172.31.36.0-255,66,1769,6,341438
16726,3.8e-05,74.125.24.0-255,2902,4671,6,341438
16727,4.1e-05,172.31.36.0-255,66,4737,6,341438
16728,4.9e-05,74.125.24.0-255,7156,11893,6,341438
16729,5.3e-05,172.31.36.0-255,66,11959,6,341438
16730,5.7e-05,74.125.24.0-255,2042,14001,6,341438
16731,6e-05,172.31.36.0-255,66,14067,6,341438
16732,0.000217,74.125.24.0-255,1484,15551,6,341438
16733,0.000222,172.31.36.0-255,66,15617,6,341438
16734,0.000228,74.125.24.0-255,2902,18519,6,341438
16735,0.000231,172.31.36.0-255,66,18585,6,341438
16736,0.000238,74.125.24.0-255,5738,24323,6,341438
16737,0.00024,172.31.36.0-255,66,24389,6,341438
16738,0.000246,74.125.24.0-255,4320,28709,6,341438
16739,0.000248,172.31.36.0-255,66,28775,6,341438
16740,0.000279,74.125.24.0-255,2902,31677,6,341438
16741,0.000282,172.31.36.0-255,66,31743,6,341438
16742,0.000305,74.125.24.0-255,9633,41376,6,341438
16743,0.000308,172.31.36.0-255,66,41442,6,341438
16744,0.000315,74.125.24.0-255,6797,48239,6,341438
16745,0.000318,172.31.36.0-255,66,48305,6,341438
16746,0.000369,74.125.24.0-255,1484,49789,6,341438
16747,0.000372,172.31.36.0-255,66,49855,6,341438
16748,0.000395,74.125.24.0-255,2902,52757,6,341438
16749,0.000397,172.31.36.0-255,66,52823,6,341438
16750,0.000403,74.125.24.0-255,5738,58561,6,341438
16751,0.000406,172.31.36.0-255,66,58627,6,341438
16752,0.000412,74.125.24.0-255,7070,65697,6,341438
16753,0.000415,172.31.36.0-255,66,65763,6,341438
16754,0.000553,74.125.24.0-255,125,65888,6,341438
16755,0.000586,74.125.24.0-255,1484,67372,6,341438
16756,0.00059,74.125.24.0-255,1484,68856,6,341438
16757,0.000604,74.125.24.0-255,1484,70340,6,341438
16758,0.00061,172.31.36.0-255,66,70406,6,341438
16759,0.000628,74.125.24.0-255,1484,71890,6,341438
16760,0.000634,74.125.24.0-255,5738,77628,6,341438
16761,0.00065,74.125.24.0-255,5379,83007,6,341438
16762,0.000655,172.31.36.0-255,66,83073,6,341438
16763,0.000678,74.125.24.0-255,1484,84557,6,341438
16764,0.000691,74.125.24.0-255,4320,88877,6,341438
16765,0.000697,74.125.24.0-255,4320,93197,6,341438
16766,0.000713,172.31.36.0-255,66,93263,6,341438
16767,0.000747,74.125.24.0-255,2902,96165,6,341438
16768,0.000755,172.31.36.0-255,66,96231,6,341438
16769,0.00077,74.125.24.0-255,3961,100192,6,341438
16770,0.000791,172.31.36.0-255,66,100258,6,341438
16771,0.000954,74.125.24.0-255,1484,101742,6,341438
16772,0.00096,74.125.24.0-255,2902,104644,6,341438
16773,0.000963,74.125.24.0-255,1484,106128,6,341438
16774,0.000978,74.125.24.0-255,4320,110448,6,341438
16775,0.001001,74.125.24.0-255,9992,120440,6,341438
16776,0.001004,172.31.36.0-255,66,120506,6,341438
16777,0.001013,74.125.24.0-255,2902,123408,6,341438
16778,0.00102,74.125.24.0-255,7156,130564,6,341438
16779,0.001025,172.31.36.0-255,66,130630,6,341438
16780,0.00106,74.125.24.0-255,3602,134232,6,341438
16781,0.001074,74.125.24.0-255,4320,138552,6,341438
16782,0.001094,74.125.24.0-255,7156,145708,6,341438
16783,0.00111,172.31.36.0-255,66,145774,6,341438
16784,0.001119,74.125.24.0-255,2902,148676,6,341438
16785,0.001129,74.125.24.0-255,9992,158668,6,341438
16786,0.001169,172.31.36.0-255,66,158734,6,341438
16787,0.00119,74.125.24.0-255,9274,168008,6,341438
16788,0.001207,172.31.36.0-255,66,168074,6,341438
16789,0.001224,74.125.24.0-255,1484,169558,6,341438
16790,0.001251,74.125.24.0-255,2902,172460,6,341438
16791,0.001258,74.125.24.0-255,5738,178198,6,341438
16792,0.001264,74.125.24.0-255,4320,182518,6,341438
16793,0.001277,172.31.36.0-255,66,182584,6,341438
16794,0.001294,74.125.24.0-255,2902,185486,6,341438
16795,0.001304,172.31.36.0-255,66,185552,6,341438
16796,0.001319,74.125.24.0-255,8574,194126,6,341438
16797,0.001324,172.31.36.0-255,66,194192,6,341438
16798,0.001346,74.125.24.0-255,7856,202048,6,341438
16799,0.001353,172.31.36.0-255,66,202114,6,341438
16800,0.001363,74.125.24.0-255,1484,203598,6,341438
16801,0.001368,74.125.24.0-255,2902,206500,6,341438
16802,0.001386,74.125.24.0-255,4320,210820,6,341438
16803,0.001396,74.125.24.0-255,1484,212304,6,341438
16804,0.001408,172.31.36.0-255,66,212370,6,341438
16805,0.001417,74.125.24.0-255,8574,220944,6,341438
16806,0.001423,172.31.36.0-255,66,221010,6,341438
16807,0.001433,74.125.24.0-255,4320,225330,6,341438
16808,0.001453,172.31.36.0-255,66,225396,6,341438
16809,0.001464,74.125.24.0-255,5738,231134,6,341438
16810,0.001469,172.31.36.0-255,66,231200,6,341438
16811,0.001482,74.125.24.0-255,5020,236220,6,341438
16812,0.001499,172.31.36.0-255,66,236286,6,341438
16813,0.001675,74.125.24.0-255,1484,237770,6,341438
16814,0.00168,74.125.24.0-255,2902,240672,6,341438
16815,0.001701,74.125.24.0-255,5738,246410,6,341438
16816,0.001705,74.125.24.0-255,1484,247894,6,341438
16817,0.001709,172.31.36.0-255,66,247960,6,341438
16818,0.001738,74.125.24.0-255,8574,256534,6,341438
16819,0.001769,74.125.24.0-255,4320,260854,6,341438
16820,0.001774,172.31.36.0-255,66,260920,6,341438
16821,0.001804,74.125.24.0-255,9274,270194,6,341438
16822,0.001811,172.31.36.0-255,66,270260,6,341438
16823,0.001939,74.125.24.0-255,1484,271744,6,341438
16824,0.001944,74.125.24.0-255,1484,273228,6,341438
16825,0.001955,172.31.36.0-255,66,273294,6,341438
16826,0.001959,74.125.24.0-255,1484,274778,6,341438
16827,0.001964,74.125.24.0-255,4320,279098,6,341438
16828,0.001974,74.125.24.0-255,1484,280582,6,341438
16829,0.001977,172.31.36.0-255,66,280648,6,341438
16830,0.002013,172.31.36.0-255,66,280714,6,341438
16831,0.002051,74.125.24.0-255,8574,289288,6,341438
16832,0.002072,172.31.36.0-255,66,289354,6,341438
16833,0.002078,74.125.24.0-255,5738,295092,6,341438
16834,0.002098,172.31.36.0-255,66,295158,6,341438
16835,0.002153,74.125.24.0-255,5738,300896,6,341438
16836,0.002165,172.31.36.0-255,66,300962,6,341438
16837,0.002178,74.125.24.0-255,7856,308818,6,341438
16838,0.002199,74.125.24.0-255,9274,318092,6,341438
16839,0.002209,74.125.24.0-255,9992,328084,6,341438
16840,0.002214,172.31.36.0-255,66,328150,6,341438
16841,0.002228,74.125.24.0-255,7156,335306,6,341438
16842,0.002247,74.125.24.0-255,5856,341162,6,341438
16843,0.002257,74.125.24.0-255,105,341267,6,341438
16844,0.002266,172.31.36.0-255,66,341333,6,341438
16845,0.009737,172.31.36.0-255,105,341438,6,341438
16846,0.0,172.217.194.0-255,146,146,6,174252
16847,2.6e-05,172.31.36.0-255,66,212,6,174252
16848,3.3e-05,172.217.194.0-255,1484,1696,6,174252
16849,3.7e-05,172.31.36.0-255,66,1762,6,174252
16850,4.9e-05,172.217.194.0-255,2902,4664,6,174252
16851,5.2e-05,172.31.36.0-255,66,4730,6,174252
16852,6e-05,172.217.194.0-255,7156,11886,6,174252
16853,6.3e-05,172.31.36.0-255,66,11952,6,174252
16854,6.7e-05,172.217.194.0-255,2078,14030,6,174252
16855,6.9e-05,172.31.36.0-255,66,14096,6,174252
16856,0.000118,172.217.194.0-255,4320,18416,6,174252
16857,0.000123,172.31.36.0-255,66,18482,6,174252
16858,0.00013,172.217.194.0-255,5738,24220,6,174252
16859,0.000133,172.31.36.0-255,66,24286,6,174252
16860,0.000179,172.217.194.0-255,6797,31083,6,174252
16861,0.000183,172.31.36.0-255,66,31149,6,174252
16862,0.000265,172.217.194.0-255,1484,32633,6,174252
16863,0.000269,172.31.36.0-255,66,32699,6,174252
16864,0.000274,172.217.194.0-255,2902,35601,6,174252
16865,0.000276,172.31.36.0-255,66,35667,6,174252
16866,0.000288,172.217.194.0-255,5738,41405,6,174252
16867,0.000291,172.31.36.0-255,66,41471,6,174252
16868,0.000334,172.217.194.0-255,6797,48268,6,174252
16869,0.000339,172.31.36.0-255,66,48334,6,174252
16870,0.000381,172.217.194.0-255,2902,51236,6,174252
16871,0.000387,172.31.36.0-255,66,51302,6,174252
16872,0.000415,172.217.194.0-255,4320,55622,6,174252
16873,0.000419,172.31.36.0-255,66,55688,6,174252
16874,0.000427,172.217.194.0-255,8574,64262,6,174252
16875,0.00043,172.31.36.0-255,66,64328,6,174252
16876,0.000434,172.217.194.0-255,1736,66064,6,174252
16877,0.000436,172.31.36.0-255,66,66130,6,174252
16878,0.000505,172.217.194.0-255,1484,67614,6,174252
16879,0.00051,172.217.194.0-255,2902,70516,6,174252
16880,0.00051,172.31.36.0-255,66,70582,6,174252
16881,0.000516,172.31.36.0-255,66,70648,6,174252
16882,0.000549,172.217.194.0-255,5738,76386,6,174252
16883,0.000553,172.31.36.0-255,66,76452,6,174252
16884,0.000576,172.217.194.0-255,2902,79354,6,174252
16885,0.000578,172.31.36.0-255,66,79420,6,174252
16886,0.000599,172.217.194.0-255,3961,83381,6,174252
16887,0.000601,172.31.36.0-255,66,83447,6,174252
16888,0.000608,172.217.194.0-255,5738,89185,6,174252
16889,0.00061,172.31.36.0-255,66,89251,6,174252
16890,0.000638,172.217.194.0-255,1484,90735,6,174252
16891,0.000642,172.31.36.0-255,66,90801,6,174252
16892,0.000678,172.217.194.0-255,9633,100434,6,174252
16893,0.000682,172.31.36.0-255,66,100500,6,174252
16894,0.001436,172.217.194.0-255,1484,101984,6,174252
16895,0.001442,172.31.36.0-255,66,102050,6,174252
16896,0.001451,172.217.194.0-255,2902,104952,6,174252
16897,0.001453,172.31.36.0-255,66,105018,6,174252
16898,0.001466,172.217.194.0-255,5738,110756,6,174252
16899,0.001468,172.31.36.0-255,66,110822,6,174252
16900,0.001476,172.217.194.0-255,5738,116560,6,174252
16901,0.001479,172.31.36.0-255,66,116626,6,174252
16902,0.001525,172.217.194.0-255,7156,123782,6,174252
16903,0.001528,172.31.36.0-255,66,123848,6,174252
16904,0.001538,172.217.194.0-255,10692,134540,6,174252
16905,0.002175,172.217.194.0-255,1484,136024,6,174252
16906,0.002183,172.217.194.0-255,2902,138926,6,174252
16907,0.002187,172.217.194.0-255,2902,141828,6,174252
16908,0.002201,172.217.194.0-255,2902,144730,6,174252
16909,0.002221,172.217.194.0-255,8574,153304,6,174252
16910,0.002233,172.217.194.0-255,4320,157624,6,174252
16911,0.002279,172.217.194.0-255,1484,159108,6,174252
16912,0.002298,172.217.194.0-255,9274,168382,6,174252
16913,0.005711,172.31.36.0-255,66,168448,6,174252
16914,0.008054,172.217.194.0-255,5738,174186,6,174252
16915,0.008062,172.31.36.0-255,66,174252,6,174252
16916,0.0,172.217.194.0-255,431,431,6,136426
16917,0.000127,172.217.194.0-255,1484,1915,6,136426
16918,0.000137,172.31.36.0-255,66,1981,6,136426
16919,0.000145,172.217.194.0-255,4320,6301,6,136426
16920,0.000149,172.31.36.0-255,66,6367,6,136426
16921,0.000165,172.217.194.0-255,9189,15556,6,136426
16922,0.000168,172.31.36.0-255,66,15622,6,136426
16923,0.000389,172.217.194.0-255,8574,24196,6,136426
16924,0.000395,172.31.36.0-255,66,24262,6,136426
16925,0.000728,172.217.194.0-255,5582,29844,6,136426
16926,0.000734,172.31.36.0-255,66,29910,6,136426
16927,0.002652,172.217.194.0-255,5738,35648,6,136426
16928,0.002664,172.31.36.0-255,66,35714,6,136426
16929,0.002738,172.217.194.0-255,4320,40034,6,136426
16930,0.002753,172.217.194.0-255,4320,44354,6,136426
16931,0.00307,172.217.194.0-255,2902,47256,6,136426
16932,0.003631,172.217.194.0-255,2902,50158,6,136426
16933,0.003654,172.217.194.0-255,8574,58732,6,136426
16934,0.003672,172.217.194.0-255,2902,61634,6,136426
16935,0.004197,172.217.194.0-255,5738,67372,6,136426
16936,0.004222,172.217.194.0-255,8574,75946,6,136426
16937,0.004732,172.217.194.0-255,5738,81684,6,136426
16938,0.005161,172.31.36.0-255,66,81750,6,136426
16939,0.005188,172.217.194.0-255,8574,90324,6,136426
16940,0.005201,172.31.36.0-255,66,90390,6,136426
16941,0.005588,172.31.36.0-255,66,90456,6,136426
16942,0.007693,172.31.36.0-255,66,90522,6,136426
16943,0.007844,172.217.194.0-255,2902,93424,6,136426
16944,0.008177,172.217.194.0-255,5754,99178,6,136426
16945,0.008253,172.217.194.0-255,4320,103498,6,136426
16946,0.008269,172.217.194.0-255,4304,107802,6,136426
16947,0.008365,172.217.194.0-255,4320,112122,6,136426
16948,0.008389,172.217.194.0-255,9992,122114,6,136426
16949,0.008562,172.217.194.0-255,5738,127852,6,136426
16950,0.008582,172.217.194.0-255,8574,136426,6,136426
16951,0.0,74.125.24.0-255,153,153,6,158874
16952,3.4e-05,172.31.36.0-255,66,219,6,158874
16953,4.2e-05,74.125.24.0-255,1484,1703,6,158874
16954,4.6e-05,172.31.36.0-255,66,1769,6,158874
16955,5.1e-05,74.125.24.0-255,2902,4671,6,158874
16956,5.3e-05,172.31.36.0-255,66,4737,6,158874
16957,6.9e-05,74.125.24.0-255,7156,11893,6,158874
16958,7.3e-05,172.31.36.0-255,66,11959,6,158874
16959,8.1e-05,74.125.24.0-255,6318,18277,6,158874
16960,8.4e-05,172.31.36.0-255,66,18343,6,158874
16961,0.000122,74.125.24.0-255,7156,25499,6,158874
16962,0.000125,172.31.36.0-255,66,25565,6,158874
16963,0.000132,74.125.24.0-255,5379,30944,6,158874
16964,0.000135,172.31.36.0-255,66,31010,6,158874
16965,0.000295,74.125.24.0-255,1484,32494,6,158874
16966,0.0003,172.31.36.0-255,66,32560,6,158874
16967,0.000305,74.125.24.0-255,2902,35462,6,158874
16968,0.000308,172.31.36.0-255,66,35528,6,158874
16969,0.000332,74.125.24.0-255,2902,38430,6,158874
16970,0.000336,172.31.36.0-255,66,38496,6,158874
16971,0.000342,74.125.24.0-255,4320,42816,6,158874
16972,0.000344,172.31.36.0-255,66,42882,6,158874
16973,0.000368,74.125.24.0-255,2902,45784,6,158874
16974,0.000371,172.31.36.0-255,66,45850,6,158874
16975,0.000375,74.125.24.0-255,1484,47334,6,158874
16976,0.000377,172.31.36.0-255,66,47400,6,158874
16977,0.000416,172.31.36.0-255,66,47466,6,158874
16978,0.000445,74.125.24.0-255,3937,51403,6,158874
16979,0.00045,172.31.36.0-255,66,51469,6,158874
16980,0.000476,74.125.24.0-255,107,51576,6,158874
16981,0.000479,172.31.36.0-255,66,51642,6,158874
16982,0.00069,74.125.24.0-255,1484,53126,6,158874
16983,0.000694,172.31.36.0-255,66,53192,6,158874
16984,0.000699,74.125.24.0-255,2902,56094,6,158874
16985,0.000701,172.31.36.0-255,66,56160,6,158874
16986,0.000707,74.125.24.0-255,4320,60480,6,158874
16987,0.000709,172.31.36.0-255,66,60546,6,158874
16988,0.000735,74.125.24.0-255,1484,62030,6,158874
16989,0.000739,172.31.36.0-255,66,62096,6,158874
16990,0.000753,172.31.36.0-255,66,62162,6,158874
16991,0.000762,74.125.24.0-255,9992,72154,6,158874
16992,0.000764,172.31.36.0-255,66,72220,6,158874
16993,0.000787,74.125.24.0-255,766,72986,6,158874
16994,0.001115,172.31.36.0-255,66,73052,6,158874
16995,0.001415,74.125.24.0-255,1484,74536,6,158874
16996,0.001426,74.125.24.0-255,2902,77438,6,158874
16997,0.00143,172.31.36.0-255,66,77504,6,158874
16998,0.001463,74.125.24.0-255,5738,83242,6,158874
16999,0.001466,172.31.36.0-255,66,83308,6,158874
17000,0.001471,74.125.24.0-255,2902,86210,6,158874
17001,0.001474,172.31.36.0-255,66,86276,6,158874
17002,0.001525,74.125.24.0-255,4320,90596,6,158874
17003,0.001528,172.31.36.0-255,66,90662,6,158874
17004,0.001559,74.125.24.0-255,5738,96400,6,158874
17005,0.001563,172.31.36.0-255,66,96466,6,158874
17006,0.001573,74.125.24.0-255,10692,107158,6,158874
17007,0.001575,172.31.36.0-255,66,107224,6,158874
17008,0.002,74.125.24.0-255,1484,108708,6,158874
17009,0.00202,74.125.24.0-255,2902,111610,6,158874
17010,0.002025,172.31.36.0-255,66,111676,6,158874
17011,0.002028,74.125.24.0-255,1484,113160,6,158874
17012,0.002056,74.125.24.0-255,2902,116062,6,158874
17013,0.002058,172.31.36.0-255,66,116128,6,158874
17014,0.002065,74.125.24.0-255,5738,121866,6,158874
17015,0.002066,172.31.36.0-255,66,121932,6,158874
17016,0.002098,74.125.24.0-255,2902,124834,6,158874
17017,0.002101,172.31.36.0-255,66,124900,6,158874
17018,0.002109,74.125.24.0-255,9992,134892,6,158874
17019,0.002111,172.31.36.0-255,66,134958,6,158874
17020,0.002136,74.125.24.0-255,6438,141396,6,158874
17021,0.002138,172.31.36.0-255,66,141462,6,158874
17022,0.00442,74.125.24.0-255,5738,147200,6,158874
17023,0.004429,172.31.36.0-255,66,147266,6,158874
17024,0.006678,74.125.24.0-255,5738,153004,6,158874
17025,0.006687,172.31.36.0-255,66,153070,6,158874
17026,0.00897,74.125.24.0-255,5738,158808,6,158874
17027,0.008982,172.31.36.0-255,66,158874,6,158874
17028,0.0,74.125.68.0-255,153,153,6,88581
17029,2.4e-05,172.31.36.0-255,66,219,6,88581
17030,3.1e-05,74.125.68.0-255,1484,1703,6,88581
17031,3.5e-05,172.31.36.0-255,66,1769,6,88581
17032,4.1e-05,74.125.68.0-255,2902,4671,6,88581
17033,4.5e-05,172.31.36.0-255,66,4737,6,88581
17034,5e-05,74.125.68.0-255,4320,9057,6,88581
17035,5.4e-05,172.31.36.0-255,66,9123,6,88581
17036,7.7e-05,74.125.68.0-255,1484,10607,6,88581
17037,8e-05,172.31.36.0-255,66,10673,6,88581
17038,8.6e-05,74.125.68.0-255,3437,14110,6,88581
17039,8.8e-05,172.31.36.0-255,66,14176,6,88581
17040,9.1e-05,74.125.68.0-255,1484,15660,6,88581
17041,9.3e-05,172.31.36.0-255,66,15726,6,88581
17042,0.000115,74.125.68.0-255,2902,18628,6,88581
17043,0.000117,172.31.36.0-255,66,18694,6,88581
17044,0.000122,74.125.68.0-255,2902,21596,6,88581
17045,0.000125,172.31.36.0-255,66,21662,6,88581
17046,0.000146,74.125.68.0-255,5738,27400,6,88581
17047,0.000148,172.31.36.0-255,66,27466,6,88581
17048,0.000165,74.125.68.0-255,2902,30368,6,88581
17049,0.000167,172.31.36.0-255,66,30434,6,88581
17050,0.000192,74.125.68.0-255,7156,37590,6,88581
17051,0.000194,172.31.36.0-255,66,37656,6,88581
17052,0.000197,74.125.68.0-255,1484,39140,6,88581
17053,0.000199,172.31.36.0-255,66,39206,6,88581
17054,0.000236,74.125.68.0-255,5738,44944,6,88581
17055,0.000239,172.31.36.0-255,66,45010,6,88581
17056,0.000256,74.125.68.0-255,1484,46494,6,88581
17057,0.000258,172.31.36.0-255,66,46560,6,88581
17058,0.000297,74.125.68.0-255,2184,48744,6,88581
17059,0.0003,172.31.36.0-255,66,48810,6,88581
17060,0.001695,74.125.68.0-255,1484,50294,6,88581
17061,0.001707,74.125.68.0-255,2902,53196,6,88581
17062,0.001711,172.31.36.0-255,66,53262,6,88581
17063,0.001718,74.125.68.0-255,4320,57582,6,88581
17064,0.00172,172.31.36.0-255,66,57648,6,88581
17065,0.001732,74.125.68.0-255,1484,59132,6,88581
17066,0.001749,74.125.68.0-255,7109,66241,6,88581
17067,0.001751,172.31.36.0-255,66,66307,6,88581
17068,0.001783,74.125.68.0-255,344,66651,6,88581
17069,0.001919,172.31.36.0-255,66,66717,6,88581
17070,0.003785,74.125.68.0-255,4320,71037,6,88581
17071,0.00379,172.31.36.0-255,66,71103,6,88581
17072,0.00395,74.125.68.0-255,1484,72587,6,88581
17073,0.00583,74.125.68.0-255,4320,76907,6,88581
17074,0.005836,172.31.36.0-255,66,76973,6,88581
17075,0.00788,74.125.68.0-255,5738,82711,6,88581
17076,0.007893,172.31.36.0-255,66,82777,6,88581
17077,0.009952,74.125.68.0-255,5738,88515,6,88581
17078,0.009959,172.31.36.0-255,66,88581,6,88581
17079,0.0,74.125.24.0-255,153,153,6,249826
17080,3.5e-05,172.31.36.0-255,66,219,6,249826
17081,4.2e-05,74.125.24.0-255,1484,1703,6,249826
17082,4.7e-05,172.31.36.0-255,66,1769,6,249826
17083,5.2e-05,74.125.24.0-255,2902,4671,6,249826
17084,6.2e-05,172.31.36.0-255,66,4737,6,249826
17085,6.8e-05,74.125.24.0-255,4320,9057,6,249826
17086,7e-05,172.31.36.0-255,66,9123,6,249826
17087,7.5e-05,74.125.24.0-255,4766,13889,6,249826
17088,7.7e-05,172.31.36.0-255,66,13955,6,249826
17089,0.000113,74.125.24.0-255,8574,22529,6,249826
17090,0.000117,172.31.36.0-255,66,22595,6,249826
17091,0.000122,74.125.24.0-255,4320,26915,6,249826
17092,0.000124,172.31.36.0-255,66,26981,6,249826
17093,0.000159,74.125.24.0-255,5738,32719,6,249826
17094,0.000163,172.31.36.0-255,66,32785,6,249826
17095,0.00018,172.31.36.0-255,66,32851,6,249826
17096,0.000236,74.125.24.0-255,3602,36453,6,249826
17097,0.000239,172.31.36.0-255,66,36519,6,249826
17098,0.000265,74.125.24.0-255,1484,38003,6,249826
17099,0.000267,172.31.36.0-255,66,38069,6,249826
17100,0.000288,74.125.24.0-255,2902,40971,6,249826
17101,0.000291,172.31.36.0-255,66,41037,6,249826
17102,0.000295,74.125.24.0-255,2902,43939,6,249826
17103,0.000297,172.31.36.0-255,66,44005,6,249826
17104,0.000339,74.125.24.0-255,7156,51161,6,249826
17105,0.000341,74.125.24.0-255,1484,52645,6,249826
17106,0.000344,172.31.36.0-255,66,52711,6,249826
17107,0.000349,172.31.36.0-255,66,52777,6,249826
17108,0.000373,74.125.24.0-255,1482,54259,6,249826
17109,0.000381,172.31.36.0-255,66,54325,6,249826
17110,0.00056,74.125.24.0-255,1484,55809,6,249826
17111,0.000579,74.125.24.0-255,2902,58711,6,249826
17112,0.000585,74.125.24.0-255,5738,64449,6,249826
17113,0.000596,172.31.36.0-255,66,64515,6,249826
17114,0.000597,74.125.24.0-255,1484,65999,6,249826
17115,0.00062,74.125.24.0-255,5738,71737,6,249826
17116,0.00063,172.31.36.0-255,66,71803,6,249826
17117,0.000637,74.125.24.0-255,7156,78959,6,249826
17118,0.000644,172.31.36.0-255,66,79025,6,249826
17119,0.000664,74.125.24.0-255,7156,86181,6,249826
17120,0.000674,74.125.24.0-255,2184,88365,6,249826
17121,0.000673,172.31.36.0-255,66,88431,6,249826
17122,0.000675,74.125.24.0-255,329,88760,6,249826
17123,0.000679,172.31.36.0-255,66,88826,6,249826
17124,0.000787,74.125.24.0-255,1484,90310,6,249826
17125,0.000799,74.125.24.0-255,2902,93212,6,249826
17126,0.000803,172.31.36.0-255,66,93278,6,249826
17127,0.00083,74.125.24.0-255,5738,99016,6,249826
17128,0.000835,74.125.24.0-255,2902,101918,6,249826
17129,0.000841,172.31.36.0-255,66,101984,6,249826
17130,0.000873,74.125.24.0-255,9992,111976,6,249826
17131,0.000879,74.125.24.0-255,7156,119132,6,249826
17132,0.000884,172.31.36.0-255,66,119198,6,249826
17133,0.000903,74.125.24.0-255,3602,122800,6,249826
17134,0.000906,172.31.36.0-255,66,122866,6,249826
17135,0.001131,74.125.24.0-255,1484,124350,6,249826
17136,0.001143,74.125.24.0-255,1484,125834,6,249826
17137,0.001147,172.31.36.0-255,66,125900,6,249826
17138,0.001165,74.125.24.0-255,1484,127384,6,249826
17139,0.00117,74.125.24.0-255,2902,130286,6,249826
17140,0.001174,172.31.36.0-255,66,130352,6,249826
17141,0.001176,74.125.24.0-255,7156,137508,6,249826
17142,0.00119,172.31.36.0-255,66,137574,6,249826
17143,0.001214,74.125.24.0-255,8574,146148,6,249826
17144,0.001223,172.31.36.0-255,66,146214,6,249826
17145,0.001229,74.125.24.0-255,4320,150534,6,249826
17146,0.001238,172.31.36.0-255,66,150600,6,249826
17147,0.001247,74.125.24.0-255,4320,154920,6,249826
17148,0.001255,172.31.36.0-255,66,154986,6,249826
17149,0.001266,74.125.24.0-255,2184,157170,6,249826
17150,0.001278,172.31.36.0-255,66,157236,6,249826
17151,0.001308,74.125.24.0-255,7156,164392,6,249826
17152,0.001312,172.31.36.0-255,66,164458,6,249826
17153,0.001315,74.125.24.0-255,1484,165942,6,249826
17154,0.001337,74.125.24.0-255,7156,173098,6,249826
17155,0.001344,172.31.36.0-255,66,173164,6,249826
17156,0.001384,172.31.36.0-255,66,173230,6,249826
17157,0.001393,74.125.24.0-255,4320,177550,6,249826
17158,0.001398,172.31.36.0-255,66,177616,6,249826
17159,0.001403,74.125.24.0-255,766,178382,6,249826
17160,0.001827,74.125.24.0-255,1484,179866,6,249826
17161,0.001831,172.31.36.0-255,66,179932,6,249826
17162,0.001837,74.125.24.0-255,2902,182834,6,249826
17163,0.001846,172.31.36.0-255,66,182900,6,249826
17164,0.001861,74.125.24.0-255,5738,188638,6,249826
17165,0.00187,172.31.36.0-255,66,188704,6,249826
17166,0.001871,74.125.24.0-255,5738,194442,6,249826
17167,0.001886,172.31.36.0-255,66,194508,6,249826
17168,0.001915,172.31.36.0-255,66,194574,6,249826
17169,0.001921,74.125.24.0-255,5020,199594,6,249826
17170,0.001935,172.31.36.0-255,66,199660,6,249826
17171,0.001985,74.125.24.0-255,1484,201144,6,249826
17172,0.001997,74.125.24.0-255,2902,204046,6,249826
17173,0.002001,172.31.36.0-255,66,204112,6,249826
17174,0.002012,74.125.24.0-255,5738,209850,6,249826
17175,0.002023,74.125.24.0-255,4320,214170,6,249826
17176,0.002026,172.31.36.0-255,66,214236,6,249826
17177,0.00203,172.31.36.0-255,66,214302,6,249826
17178,0.002098,172.31.36.0-255,66,214368,6,249826
17179,0.002102,74.125.24.0-255,4320,218688,6,249826
17180,0.002109,172.31.36.0-255,66,218754,6,249826
17181,0.002136,172.31.36.0-255,66,218820,6,249826
17182,0.002137,74.125.24.0-255,9992,228812,6,249826
17183,0.002144,74.125.24.0-255,7156,235968,6,249826
17184,0.002147,74.125.24.0-255,2184,238152,6,249826
17185,0.00215,172.31.36.0-255,66,238218,6,249826
17186,0.002154,172.31.36.0-255,66,238284,6,249826
17187,0.004287,74.125.24.0-255,5738,244022,6,249826
17188,0.004307,172.31.36.0-255,66,244088,6,249826
17189,0.006473,74.125.24.0-255,5738,249826,6,249826
17190,0.0,74.125.68.0-255,146,146,6,128147
17191,3.5e-05,172.31.36.0-255,66,212,6,128147
17192,4.2e-05,74.125.68.0-255,1484,1696,6,128147
17193,4.7e-05,172.31.36.0-255,66,1762,6,128147
17194,5.2e-05,74.125.68.0-255,2902,4664,6,128147
17195,5.5e-05,172.31.36.0-255,66,4730,6,128147
17196,5.8e-05,74.125.68.0-255,1484,6214,6,128147
17197,6e-05,172.31.36.0-255,66,6280,6,128147
17198,6.5e-05,74.125.68.0-255,2902,9182,6,128147
17199,6.7e-05,172.31.36.0-255,66,9248,6,128147
17200,8.8e-05,74.125.68.0-255,6283,15531,6,128147
17201,9.1e-05,172.31.36.0-255,66,15597,6,128147
17202,9.3e-05,74.125.68.0-255,1484,17081,6,128147
17203,9.5e-05,172.31.36.0-255,66,17147,6,128147
17204,0.000121,74.125.68.0-255,2902,20049,6,128147
17205,0.000123,172.31.36.0-255,66,20115,6,128147
17206,0.000129,74.125.68.0-255,5738,25853,6,128147
17207,0.000131,172.31.36.0-255,66,25919,6,128147
17208,0.000155,74.125.68.0-255,5379,31298,6,128147
17209,0.000158,172.31.36.0-255,66,31364,6,128147
17210,0.00064,74.125.68.0-255,1484,32848,6,128147
17211,0.000646,172.31.36.0-255,66,32914,6,128147
17212,0.000656,74.125.68.0-255,2902,35816,6,128147
17213,0.000659,172.31.36.0-255,66,35882,6,128147
17214,0.000691,74.125.68.0-255,5738,41620,6,128147
17215,0.000694,172.31.36.0-255,66,41686,6,128147
17216,0.000716,74.125.68.0-255,2902,44588,6,128147
17217,0.00072,172.31.36.0-255,66,44654,6,128147
17218,0.000751,74.125.68.0-255,9992,54646,6,128147
17219,0.000755,172.31.36.0-255,66,54712,6,128147
17220,0.000761,74.125.68.0-255,4320,59032,6,128147
17221,0.000763,172.31.36.0-255,66,59098,6,128147
17222,0.000787,74.125.68.0-255,6438,65536,6,128147
17223,0.00079,172.31.36.0-255,66,65602,6,128147
17224,0.000837,74.125.68.0-255,392,65994,6,128147
17225,0.000945,74.125.68.0-255,115,66109,6,128147
17226,0.001067,74.125.68.0-255,1484,67593,6,128147
17227,0.001072,172.31.36.0-255,66,67659,6,128147
17228,0.001079,74.125.68.0-255,2902,70561,6,128147
17229,0.001081,172.31.36.0-255,66,70627,6,128147
17230,0.001112,74.125.68.0-255,5738,76365,6,128147
17231,0.001116,172.31.36.0-255,66,76431,6,128147
17232,0.001119,74.125.68.0-255,1484,77915,6,128147
17233,0.001146,74.125.68.0-255,8574,86489,6,128147
17234,0.001149,172.31.36.0-255,66,86555,6,128147
17235,0.001157,74.125.68.0-255,7156,93711,6,128147
17236,0.00116,172.31.36.0-255,66,93777,6,128147
17237,0.001176,74.125.68.0-255,4320,98097,6,128147
17238,0.001179,172.31.36.0-255,66,98163,6,128147
17239,0.001183,74.125.68.0-255,2184,100347,6,128147
17240,0.001185,172.31.36.0-255,66,100413,6,128147
17241,0.002051,74.125.68.0-255,1484,101897,6,128147
17242,0.00206,74.125.68.0-255,2902,104799,6,128147
17243,0.002064,172.31.36.0-255,66,104865,6,128147
17244,0.002092,74.125.68.0-255,5738,110603,6,128147
17245,0.002094,172.31.36.0-255,66,110669,6,128147
17246,0.00413,74.125.68.0-255,5738,116407,6,128147
17247,0.004135,172.31.36.0-255,66,116473,6,128147
17248,0.006165,74.125.68.0-255,5738,122211,6,128147
17249,0.006172,172.31.36.0-255,66,122277,6,128147
17250,0.008208,74.125.68.0-255,4320,126597,6,128147
17251,0.008216,172.31.36.0-255,66,126663,6,128147
17252,0.008238,74.125.68.0-255,1484,128147,6,128147
17253,0.0,74.125.68.0-255,153,153,6,65029
17254,2.2e-05,172.31.36.0-255,66,219,6,65029
17255,2.9e-05,74.125.68.0-255,1484,1703,6,65029
17256,3.4e-05,172.31.36.0-255,66,1769,6,65029
17257,7e-05,74.125.68.0-255,2902,4671,6,65029
17258,7.3e-05,172.31.36.0-255,66,4737,6,65029
17259,0.000145,74.125.68.0-255,2902,7639,6,65029
17260,0.000148,172.31.36.0-255,66,7705,6,65029
17261,0.000174,74.125.68.0-255,2902,10607,6,65029
17262,0.000177,172.31.36.0-255,66,10673,6,65029
17263,0.000351,74.125.68.0-255,3435,14108,6,65029
17264,0.000357,172.31.36.0-255,66,14174,6,65029
17265,0.000471,74.125.68.0-255,7156,21330,6,65029
17266,0.000477,172.31.36.0-255,66,21396,6,65029
17267,0.000487,74.125.68.0-255,2902,24298,6,65029
17268,0.000495,172.31.36.0-255,66,24364,6,65029
17269,0.00083,74.125.68.0-255,6797,31161,6,65029
17270,0.000837,172.31.36.0-255,66,31227,6,65029
17271,0.001056,74.125.68.0-255,7156,38383,6,65029
17272,0.001061,172.31.36.0-255,66,38449,6,65029
17273,0.001102,172.31.36.0-255,66,38515,6,65029
17274,0.001699,74.125.68.0-255,2902,41417,6,65029
17275,0.001709,172.31.36.0-255,66,41483,6,65029
17276,0.001794,74.125.68.0-255,5738,47221,6,65029
17277,0.001798,172.31.36.0-255,66,47287,6,65029
17278,0.001841,172.31.36.0-255,66,47353,6,65029
17279,0.002763,172.31.36.0-255,66,47419,6,65029
17280,0.002804,172.31.36.0-255,66,47485,6,65029
17281,0.003701,74.125.68.0-255,5738,53223,6,65029
17282,0.003704,172.31.36.0-255,66,53289,6,65029
17283,0.003748,172.31.36.0-255,66,53355,6,65029
17284,0.005956,74.125.68.0-255,1484,54839,6,65029
17285,0.005982,74.125.68.0-255,4320,59159,6,65029
17286,0.005987,172.31.36.0-255,66,59225,6,65029
17287,0.008211,74.125.68.0-255,5738,64963,6,65029
17288,0.008218,172.31.36.0-255,66,65029,6,65029
17289,0.0,74.125.24.0-255,146,146,6,95466
17290,2.3e-05,172.31.36.0-255,66,212,6,95466
17291,3e-05,74.125.24.0-255,1484,1696,6,95466
17292,3.5e-05,172.31.36.0-255,66,1762,6,95466
17293,4.1e-05,74.125.24.0-255,2902,4664,6,95466
17294,4.4e-05,172.31.36.0-255,66,4730,6,95466
17295,5.3e-05,74.125.24.0-255,7156,11886,6,95466
17296,5.7e-05,172.31.36.0-255,66,11952,6,95466
17297,6.1e-05,74.125.24.0-255,1992,13944,6,95466
17298,6.4e-05,172.31.36.0-255,66,14010,6,95466
17299,8.9e-05,74.125.24.0-255,1484,15494,6,95466
17300,9.1e-05,172.31.36.0-255,66,15560,6,95466
17301,0.000112,74.125.24.0-255,2902,18462,6,95466
17302,0.000115,172.31.36.0-255,66,18528,6,95466
17303,0.000121,74.125.24.0-255,5738,24266,6,95466
17304,0.000123,172.31.36.0-255,66,24332,6,95466
17305,0.000144,74.125.24.0-255,2902,27234,6,95466
17306,0.000146,172.31.36.0-255,66,27300,6,95466
17307,0.000168,74.125.24.0-255,3961,31261,6,95466
17308,0.000171,172.31.36.0-255,66,31327,6,95466
17309,0.000515,74.125.24.0-255,1484,32811,6,95466
17310,0.00052,172.31.36.0-255,66,32877,6,95466
17311,0.000527,74.125.24.0-255,2902,35779,6,95466
17312,0.00053,172.31.36.0-255,66,35845,6,95466
17313,0.000536,74.125.24.0-255,2902,38747,6,95466
17314,0.000538,172.31.36.0-255,66,38813,6,95466
17315,0.000571,74.125.24.0-255,7156,45969,6,95466
17316,0.000575,172.31.36.0-255,66,46035,6,95466
17317,0.000619,74.125.24.0-255,2543,48578,6,95466
17318,0.000649,172.31.36.0-255,66,48644,6,95466
17319,0.000723,172.31.36.0-255,66,48710,6,95466
17320,0.00125,74.125.24.0-255,646,49356,6,95466
17321,0.001437,74.125.24.0-255,1484,50840,6,95466
17322,0.001443,172.31.36.0-255,66,50906,6,95466
17323,0.001449,74.125.24.0-255,2902,53808,6,95466
17324,0.001452,172.31.36.0-255,66,53874,6,95466
17325,0.001479,74.125.24.0-255,5738,59612,6,95466
17326,0.001482,172.31.36.0-255,66,59678,6,95466
17327,0.001511,172.31.36.0-255,66,59744,6,95466
17328,0.001533,74.125.24.0-255,1484,61228,6,95466
17329,0.001541,74.125.24.0-255,7156,68384,6,95466
17330,0.001543,172.31.36.0-255,66,68450,6,95466
17331,0.001593,74.125.24.0-255,1484,69934,6,95466
17332,0.001609,74.125.24.0-255,2184,72118,6,95466
17333,0.001612,172.31.36.0-255,66,72184,6,95466
17334,0.003501,74.125.24.0-255,1484,73668,6,95466
17335,0.003573,74.125.24.0-255,4320,77988,6,95466
17336,0.003579,172.31.36.0-255,66,78054,6,95466
17337,0.00555,74.125.24.0-255,5738,83792,6,95466
17338,0.005555,172.31.36.0-255,66,83858,6,95466
17339,0.00751,74.125.24.0-255,5738,89596,6,95466
17340,0.007517,172.31.36.0-255,66,89662,6,95466
17341,0.009494,74.125.24.0-255,5738,95400,6,95466
17342,0.009503,172.31.36.0-255,66,95466,6,95466
17343,0.0,74.125.24.0-255,297,297,6,230703
17344,2e-05,172.31.36.0-255,66,363,6,230703
17345,2.7e-05,74.125.24.0-255,1484,1847,6,230703
17346,3.2e-05,172.31.36.0-255,66,1913,6,230703
17347,4.6e-05,74.125.24.0-255,4320,6233,6,230703
17348,5e-05,172.31.36.0-255,66,6299,6,230703
17349,5.8e-05,74.125.24.0-255,7156,13455,6,230703
17350,6.1e-05,172.31.36.0-255,66,13521,6,230703
17351,6.3e-05,74.125.24.0-255,394,13915,6,230703
17352,6.6e-05,172.31.36.0-255,66,13981,6,230703
17353,0.000155,74.125.24.0-255,1484,15465,6,230703
17354,0.000158,172.31.36.0-255,66,15531,6,230703
17355,0.000164,74.125.24.0-255,2902,18433,6,230703
17356,0.000167,172.31.36.0-255,66,18499,6,230703
17357,0.000199,74.125.24.0-255,5738,24237,6,230703
17358,0.000202,172.31.36.0-255,66,24303,6,230703
17359,0.000227,74.125.24.0-255,2902,27205,6,230703
17360,0.00023,172.31.36.0-255,66,27271,6,230703
17361,0.000259,74.125.24.0-255,3961,31232,6,230703
17362,0.000262,172.31.36.0-255,66,31298,6,230703
17363,0.00027,74.125.24.0-255,7156,38454,6,230703
17364,0.000273,172.31.36.0-255,66,38520,6,230703
17365,0.000277,74.125.24.0-255,2902,41422,6,230703
17366,0.00028,172.31.36.0-255,66,41488,6,230703
17367,0.000318,74.125.24.0-255,6797,48285,6,230703
17368,0.000322,172.31.36.0-255,66,48351,6,230703
17369,0.000362,74.125.24.0-255,1484,49835,6,230703
17370,0.000365,172.31.36.0-255,66,49901,6,230703
17371,0.00037,74.125.24.0-255,2902,52803,6,230703
17372,0.000372,172.31.36.0-255,66,52869,6,230703
17373,0.000377,74.125.24.0-255,2902,55771,6,230703
17374,0.000383,172.31.36.0-255,66,55837,6,230703
17375,0.000389,74.125.24.0-255,4320,60157,6,230703
17376,0.000391,172.31.36.0-255,66,60223,6,230703
17377,0.000415,74.125.24.0-255,2902,63125,6,230703
17378,0.000418,172.31.36.0-255,66,63191,6,230703
17379,0.000437,74.125.24.0-255,2816,66007,6,230703
17380,0.000439,172.31.36.0-255,66,66073,6,230703
17381,0.000551,74.125.24.0-255,137,66210,6,230703
17382,0.000607,74.125.24.0-255,1484,67694,6,230703
17383,0.000612,172.31.36.0-255,66,67760,6,230703
17384,0.000615,74.125.24.0-255,1484,69244,6,230703
17385,0.000639,74.125.24.0-255,1484,70728,6,230703
17386,0.000642,172.31.36.0-255,66,70794,6,230703
17387,0.000652,74.125.24.0-255,7156,77950,6,230703
17388,0.000654,172.31.36.0-255,66,78016,6,230703
17389,0.000666,74.125.24.0-255,8574,86590,6,230703
17390,0.000669,172.31.36.0-255,66,86656,6,230703
17391,0.000712,172.31.36.0-255,66,86722,6,230703
17392,0.000849,74.125.24.0-255,1484,88206,6,230703
17393,0.000854,74.125.24.0-255,1484,89690,6,230703
17394,0.000857,172.31.36.0-255,66,89756,6,230703
17395,0.000884,74.125.24.0-255,1484,91240,6,230703
17396,0.000892,74.125.24.0-255,5738,96978,6,230703
17397,0.000895,172.31.36.0-255,66,97044,6,230703
17398,0.000924,172.31.36.0-255,66,97110,6,230703
17399,0.001003,172.31.36.0-255,66,97176,6,230703
17400,0.001047,172.31.36.0-255,66,97242,6,230703
17401,0.001055,74.125.24.0-255,7156,104398,6,230703
17402,0.001058,172.31.36.0-255,66,104464,6,230703
17403,0.001077,172.31.36.0-255,66,104530,6,230703
17404,0.00133,74.125.24.0-255,1484,106014,6,230703
17405,0.001334,74.125.24.0-255,1484,107498,6,230703
17406,0.001338,172.31.36.0-255,66,107564,6,230703
17407,0.001362,74.125.24.0-255,1484,109048,6,230703
17408,0.001368,74.125.24.0-255,5738,114786,6,230703
17409,0.001371,172.31.36.0-255,66,114852,6,230703
17410,0.001407,172.31.36.0-255,66,114918,6,230703
17411,0.001412,74.125.24.0-255,4320,119238,6,230703
17412,0.001414,172.31.36.0-255,66,119304,6,230703
17413,0.001456,74.125.24.0-255,1484,120788,6,230703
17414,0.001477,74.125.24.0-255,5020,125808,6,230703
17415,0.00148,172.31.36.0-255,66,125874,6,230703
17416,0.0016,74.125.24.0-255,1484,127358,6,230703
17417,0.001603,74.125.24.0-255,1484,128842,6,230703
17418,0.001607,172.31.36.0-255,66,128908,6,230703
17419,0.001624,74.125.24.0-255,1484,130392,6,230703
17420,0.001629,74.125.24.0-255,4320,134712,6,230703
17421,0.001632,172.31.36.0-255,66,134778,6,230703
17422,0.001661,74.125.24.0-255,1484,136262,6,230703
17423,0.00167,74.125.24.0-255,8574,144836,6,230703
17424,0.001673,172.31.36.0-255,66,144902,6,230703
17425,0.001682,74.125.24.0-255,8574,153476,6,230703
17426,0.001684,172.31.36.0-255,66,153542,6,230703
17427,0.001703,74.125.24.0-255,1484,155026,6,230703
17428,0.001707,74.125.24.0-255,2902,157928,6,230703
17429,0.001709,172.31.36.0-255,66,157994,6,230703
17430,0.001736,74.125.24.0-255,2184,160178,6,230703
17431,0.001739,172.31.36.0-255,66,160244,6,230703
17432,0.001887,74.125.24.0-255,1484,161728,6,230703
17433,0.001893,74.125.24.0-255,2902,164630,6,230703
17434,0.001896,172.31.36.0-255,66,164696,6,230703
17435,0.001902,74.125.24.0-255,2902,167598,6,230703
17436,0.001904,172.31.36.0-255,66,167664,6,230703
17437,0.001927,74.125.24.0-255,2902,170566,6,230703
17438,0.001929,172.31.36.0-255,66,170632,6,230703
17439,0.001939,74.125.24.0-255,4320,174952,6,230703
17440,0.001941,172.31.36.0-255,66,175018,6,230703
17441,0.001953,74.125.24.0-255,5738,180756,6,230703
17442,0.001955,172.31.36.0-255,66,180822,6,230703
17443,0.001969,172.31.36.0-255,66,180888,6,230703
17444,0.001973,74.125.24.0-255,2184,183072,6,230703
17445,0.001974,172.31.36.0-255,66,183138,6,230703
17446,0.002005,74.125.24.0-255,2902,186040,6,230703
17447,0.002008,172.31.36.0-255,66,186106,6,230703
17448,0.002047,172.31.36.0-255,66,186172,6,230703
17449,0.002054,74.125.24.0-255,7156,193328,6,230703
17450,0.002056,172.31.36.0-255,66,193394,6,230703
17451,0.002084,74.125.24.0-255,2902,196296,6,230703
17452,0.002087,172.31.36.0-255,66,196362,6,230703
17453,0.002188,74.125.24.0-255,9992,206354,6,230703
17454,0.002191,172.31.36.0-255,66,206420,6,230703
17455,0.002197,172.31.36.0-255,66,206486,6,230703
17456,0.002232,74.125.24.0-255,8574,215060,6,230703
17457,0.002241,74.125.24.0-255,8574,223634,6,230703
17458,0.002289,74.125.24.0-255,6898,230532,6,230703
17459,0.002304,74.125.24.0-255,105,230637,6,230703
17460,0.002312,172.31.36.0-255,66,230703,6,230703
17461,0.0,74.125.24.0-255,150,150,6,243666
17462,2.2e-05,172.31.36.0-255,66,216,6,243666
17463,2.9e-05,74.125.24.0-255,1484,1700,6,243666
17464,3.4e-05,172.31.36.0-255,66,1766,6,243666
17465,3.9e-05,74.125.24.0-255,2902,4668,6,243666
17466,4.2e-05,172.31.36.0-255,66,4734,6,243666
17467,4.7e-05,74.125.24.0-255,4320,9054,6,243666
17468,4.9e-05,172.31.36.0-255,66,9120,6,243666
17469,5.2e-05,74.125.24.0-255,1484,10604,6,243666
17470,5.5e-05,172.31.36.0-255,66,10670,6,243666
17471,9e-05,74.125.24.0-255,10536,21206,6,243666
17472,9.3e-05,172.31.36.0-255,66,21272,6,243666
17473,9.8e-05,74.125.24.0-255,4320,25592,6,243666
17474,0.0001,172.31.36.0-255,66,25658,6,243666
17475,0.000122,74.125.24.0-255,5379,31037,6,243666
17476,0.000125,172.31.36.0-255,66,31103,6,243666
17477,0.000157,74.125.24.0-255,1484,32587,6,243666
17478,0.000159,172.31.36.0-255,66,32653,6,243666
17479,0.000173,74.125.24.0-255,2902,35555,6,243666
17480,0.000175,172.31.36.0-255,66,35621,6,243666
17481,0.000179,74.125.24.0-255,2902,38523,6,243666
17482,0.000181,172.31.36.0-255,66,38589,6,243666
17483,0.000184,74.125.24.0-255,1484,40073,6,243666
17484,0.000185,172.31.36.0-255,66,40139,6,243666
17485,0.000209,74.125.24.0-255,2902,43041,6,243666
17486,0.000211,172.31.36.0-255,66,43107,6,243666
17487,0.00022,74.125.24.0-255,9633,52740,6,243666
17488,0.000222,172.31.36.0-255,66,52806,6,243666
17489,0.000247,74.125.24.0-255,9992,62798,6,243666
17490,0.00025,172.31.36.0-255,66,62864,6,243666
17491,0.000282,74.125.24.0-255,2854,65718,6,243666
17492,0.000284,172.31.36.0-255,66,65784,6,243666
17493,0.000317,74.125.24.0-255,108,65892,6,243666
17494,0.000405,74.125.24.0-255,1484,67376,6,243666
17495,0.000424,74.125.24.0-255,2902,70278,6,243666
17496,0.00043,74.125.24.0-255,5738,76016,6,243666
17497,0.000465,74.125.24.0-255,1484,77500,6,243666
17498,0.000497,74.125.24.0-255,9633,87133,6,243666
17499,0.000505,74.125.24.0-255,8574,95707,6,243666
17500,0.000535,74.125.24.0-255,4207,99914,6,243666
17501,0.000562,172.31.36.0-255,66,99980,6,243666
17502,0.000702,74.125.24.0-255,1484,101464,6,243666
17503,0.000713,74.125.24.0-255,1484,102948,6,243666
17504,0.000728,74.125.24.0-255,1484,104432,6,243666
17505,0.000734,74.125.24.0-255,5738,110170,6,243666
17506,0.00074,74.125.24.0-255,5738,115908,6,243666
17507,0.000743,74.125.24.0-255,1484,117392,6,243666
17508,0.000758,74.125.24.0-255,5738,123130,6,243666
17509,0.000764,172.31.36.0-255,66,123196,6,243666
17510,0.000793,74.125.24.0-255,5738,128934,6,243666
17511,0.000799,172.31.36.0-255,66,129000,6,243666
17512,0.00081,74.125.24.0-255,5020,134020,6,243666
17513,0.000832,172.31.36.0-255,66,134086,6,243666
17514,0.001502,74.125.24.0-255,1484,135570,6,243666
17515,0.001509,74.125.24.0-255,2902,138472,6,243666
17516,0.001514,172.31.36.0-255,66,138538,6,243666
17517,0.001518,74.125.24.0-255,1484,140022,6,243666
17518,0.00154,74.125.24.0-255,4320,144342,6,243666
17519,0.00158,74.125.24.0-255,9992,154334,6,243666
17520,0.001584,74.125.24.0-255,2902,157236,6,243666
17521,0.001605,74.125.24.0-255,7156,164392,6,243666
17522,0.00162,74.125.24.0-255,1484,165876,6,243666
17523,0.001624,74.125.24.0-255,2184,168060,6,243666
17524,0.001997,74.125.24.0-255,1484,169544,6,243666
17525,0.002003,74.125.24.0-255,2902,172446,6,243666
17526,0.002016,74.125.24.0-255,1484,173930,6,243666
17527,0.002028,74.125.24.0-255,2902,176832,6,243666
17528,0.002035,74.125.24.0-255,8574,185406,6,243666
17529,0.002064,74.125.24.0-255,1484,186890,6,243666
17530,0.002134,74.125.24.0-255,5738,192628,6,243666
17531,0.002143,74.125.24.0-255,9992,202620,6,243666
17532,0.0022,74.125.24.0-255,6438,209058,6,243666
17533,0.002204,74.125.24.0-255,2902,211960,6,243666
17534,0.002243,74.125.24.0-255,2902,214862,6,243666
17535,0.002245,74.125.24.0-255,766,215628,6,243666
17536,0.002257,74.125.24.0-255,4320,219948,6,243666
17537,0.002308,74.125.24.0-255,7156,227104,6,243666
17538,0.002317,74.125.24.0-255,10692,237796,6,243666
17539,0.005708,172.31.36.0-255,66,237862,6,243666
17540,0.00804,74.125.24.0-255,5738,243600,6,243666
17541,0.008046,172.31.36.0-255,66,243666,6,243666
17542,0.0,172.217.194.0-255,155,155,6,218738
17543,2.6e-05,172.31.36.0-255,66,221,6,218738
17544,3.2e-05,172.217.194.0-255,1484,1705,6,218738
17545,3.6e-05,172.31.36.0-255,66,1771,6,218738
17546,4.9e-05,172.217.194.0-255,2902,4673,6,218738
17547,5.2e-05,172.31.36.0-255,66,4739,6,218738
17548,6e-05,172.217.194.0-255,7156,11895,6,218738
17549,6.3e-05,172.31.36.0-255,66,11961,6,218738
17550,9.1e-05,172.217.194.0-255,2054,14015,6,218738
17551,9.3e-05,172.31.36.0-255,66,14081,6,218738
17552,0.000132,172.217.194.0-255,1484,15565,6,218738
17553,0.000136,172.31.36.0-255,66,15631,6,218738
17554,0.00014,172.217.194.0-255,1484,17115,6,218738
17555,0.000142,172.31.36.0-255,66,17181,6,218738
17556,0.000174,172.217.194.0-255,1484,18665,6,218738
17557,0.000177,172.31.36.0-255,66,18731,6,218738
17558,0.000184,172.217.194.0-255,5738,24469,6,218738
17559,0.000186,172.31.36.0-255,66,24535,6,218738
17560,0.000194,172.217.194.0-255,6797,31332,6,218738
17561,0.000196,172.31.36.0-255,66,31398,6,218738
17562,0.000245,172.217.194.0-255,1484,32882,6,218738
17563,0.000248,172.31.36.0-255,66,32948,6,218738
17564,0.000253,172.217.194.0-255,2902,35850,6,218738
17565,0.000256,172.31.36.0-255,66,35916,6,218738
17566,0.000258,172.217.194.0-255,1484,37400,6,218738
17567,0.00026,172.31.36.0-255,66,37466,6,218738
17568,0.000301,172.217.194.0-255,4320,41786,6,218738
17569,0.000305,172.31.36.0-255,66,41852,6,218738
17570,0.000312,172.217.194.0-255,5738,47590,6,218738
17571,0.000314,172.31.36.0-255,66,47656,6,218738
17572,0.00032,172.217.194.0-255,4320,51976,6,218738
17573,0.000323,172.31.36.0-255,66,52042,6,218738
17574,0.000364,172.217.194.0-255,9633,61675,6,218738
17575,0.000369,172.31.36.0-255,66,61741,6,218738
17576,0.000374,172.217.194.0-255,3961,65702,6,218738
17577,0.000377,172.31.36.0-255,66,65768,6,218738
17578,0.00038,172.217.194.0-255,379,66147,6,218738
17579,0.000409,172.217.194.0-255,363,66510,6,218738
17580,0.000619,172.217.194.0-255,1484,67994,6,218738
17581,0.000623,172.31.36.0-255,66,68060,6,218738
17582,0.000629,172.217.194.0-255,2902,70962,6,218738
17583,0.000632,172.31.36.0-255,66,71028,6,218738
17584,0.000661,172.217.194.0-255,4320,75348,6,218738
17585,0.000664,172.31.36.0-255,66,75414,6,218738
17586,0.0007,172.217.194.0-255,1484,76898,6,218738
17587,0.000717,172.31.36.0-255,66,76964,6,218738
17588,0.000721,172.217.194.0-255,10692,87656,6,218738
17589,0.000723,172.31.36.0-255,66,87722,6,218738
17590,0.000996,172.217.194.0-255,1484,89206,6,218738
17591,0.001012,172.217.194.0-255,2902,92108,6,218738
17592,0.001015,172.31.36.0-255,66,92174,6,218738
17593,0.001019,172.217.194.0-255,1484,93658,6,218738
17594,0.001052,172.217.194.0-255,4320,97978,6,218738
17595,0.001055,172.31.36.0-255,66,98044,6,218738
17596,0.001063,172.217.194.0-255,7156,105200,6,218738
17597,0.001066,172.31.36.0-255,66,105266,6,218738
17598,0.001078,172.217.194.0-255,5738,111004,6,218738
17599,0.001081,172.31.36.0-255,66,111070,6,218738
17600,0.001111,172.217.194.0-255,8574,119644,6,218738
17601,0.001115,172.31.36.0-255,66,119710,6,218738
17602,0.001119,172.217.194.0-255,2184,121894,6,218738
17603,0.001122,172.31.36.0-255,66,121960,6,218738
17604,0.001804,172.217.194.0-255,1484,123444,6,218738
17605,0.001816,172.217.194.0-255,2902,126346,6,218738
17606,0.00182,172.31.36.0-255,66,126412,6,218738
17607,0.001825,172.217.194.0-255,1484,127896,6,218738
17608,0.001849,172.217.194.0-255,4320,132216,6,218738
17609,0.001851,172.31.36.0-255,66,132282,6,218738
17610,0.001881,172.217.194.0-255,8574,140856,6,218738
17611,0.001884,172.31.36.0-255,66,140922,6,218738
17612,0.001895,172.217.194.0-255,9992,150914,6,218738
17613,0.001903,172.31.36.0-255,66,150980,6,218738
17614,0.001909,172.217.194.0-255,5020,156000,6,218738
17615,0.001912,172.31.36.0-255,66,156066,6,218738
17616,0.002085,172.217.194.0-255,1484,157550,6,218738
17617,0.002091,172.217.194.0-255,2902,160452,6,218738
17618,0.002094,172.31.36.0-255,66,160518,6,218738
17619,0.002098,172.217.194.0-255,1484,162002,6,218738
17620,0.002118,172.217.194.0-255,4320,166322,6,218738
17621,0.002121,172.31.36.0-255,66,166388,6,218738
17622,0.002153,172.31.36.0-255,66,166454,6,218738
17623,0.002156,172.217.194.0-255,1484,167938,6,218738
17624,0.002187,172.217.194.0-255,10692,178630,6,218738
17625,0.00219,172.31.36.0-255,66,178696,6,218738
17626,0.002206,172.31.36.0-255,66,178762,6,218738
17627,0.002234,172.217.194.0-255,7156,185918,6,218738
17628,0.002236,172.31.36.0-255,66,185984,6,218738
17629,0.002268,172.31.36.0-255,66,186050,6,218738
17630,0.002276,172.217.194.0-255,9992,196042,6,218738
17631,0.002279,172.31.36.0-255,66,196108,6,218738
17632,0.002317,172.217.194.0-255,5738,201846,6,218738
17633,0.002319,172.31.36.0-255,66,201912,6,218738
17634,0.00234,172.31.36.0-255,66,201978,6,218738
17635,0.002343,172.217.194.0-255,766,202744,6,218738
17636,0.004735,172.217.194.0-255,4320,207064,6,218738
17637,0.004742,172.31.36.0-255,66,207130,6,218738
17638,0.007087,172.217.194.0-255,5738,212868,6,218738
17639,0.007092,172.31.36.0-255,66,212934,6,218738
17640,0.00942,172.217.194.0-255,5738,218672,6,218738
17641,0.009428,172.31.36.0-255,66,218738,6,218738
17642,0.0,172.217.194.0-255,152,152,6,297920
17643,2.9e-05,172.31.36.0-255,66,218,6,297920
17644,3.5e-05,172.217.194.0-255,1484,1702,6,297920
17645,3.9e-05,172.31.36.0-255,66,1768,6,297920
17646,4.4e-05,172.217.194.0-255,2902,4670,6,297920
17647,4.6e-05,172.31.36.0-255,66,4736,6,297920
17648,5.4e-05,172.217.194.0-255,7156,11892,6,297920
17649,5.6e-05,172.31.36.0-255,66,11958,6,297920
17650,9.3e-05,172.217.194.0-255,2103,14061,6,297920
17651,9.5e-05,172.31.36.0-255,66,14127,6,297920
17652,0.000197,172.217.194.0-255,1484,15611,6,297920
17653,0.000202,172.31.36.0-255,66,15677,6,297920
17654,0.000208,172.217.194.0-255,2902,18579,6,297920
17655,0.00021,172.31.36.0-255,66,18645,6,297920
17656,0.000213,172.217.194.0-255,1484,20129,6,297920
17657,0.000215,172.31.36.0-255,66,20195,6,297920
17658,0.000237,172.217.194.0-255,4320,24515,6,297920
17659,0.00024,172.31.36.0-255,66,24581,6,297920
17660,0.000269,172.217.194.0-255,8215,32796,6,297920
17661,0.000272,172.31.36.0-255,66,32862,6,297920
17662,0.000281,172.217.194.0-255,8574,41436,6,297920
17663,0.000283,172.31.36.0-255,66,41502,6,297920
17664,0.00035,172.31.36.0-255,66,41568,6,297920
17665,0.000356,172.217.194.0-255,5631,47199,6,297920
17666,0.00036,172.31.36.0-255,66,47265,6,297920
17667,0.000393,172.217.194.0-255,5738,53003,6,297920
17668,0.000397,172.31.36.0-255,66,53069,6,297920
17669,0.000404,172.217.194.0-255,5738,58807,6,297920
17670,0.000406,172.31.36.0-255,66,58873,6,297920
17671,0.000449,172.217.194.0-255,1484,60357,6,297920
17672,0.000452,172.31.36.0-255,66,60423,6,297920
17673,0.000476,172.31.36.0-255,66,60489,6,297920
17674,0.000503,172.217.194.0-255,1125,61614,6,297920
17675,0.000512,172.217.194.0-255,8215,69829,6,297920
17676,0.000515,172.31.36.0-255,66,69895,6,297920
17677,0.000955,172.217.194.0-255,1484,71379,6,297920
17678,0.000962,172.217.194.0-255,2902,74281,6,297920
17679,0.000965,172.31.36.0-255,66,74347,6,297920
17680,0.000972,172.217.194.0-255,4320,78667,6,297920
17681,0.000974,172.31.36.0-255,66,78733,6,297920
17682,0.000987,172.217.194.0-255,1484,80217,6,297920
17683,0.000992,172.217.194.0-255,2902,83119,6,297920
17684,0.000999,172.31.36.0-255,66,83185,6,297920
17685,0.00102,172.217.194.0-255,9992,93177,6,297920
17686,0.001023,172.31.36.0-255,66,93243,6,297920
17687,0.001033,172.217.194.0-255,10143,103386,6,297920
17688,0.001035,172.31.36.0-255,66,103452,6,297920
17689,0.001074,172.217.194.0-255,5738,109190,6,297920
17690,0.001077,172.31.36.0-255,66,109256,6,297920
17691,0.001104,172.217.194.0-255,5738,114994,6,297920
17692,0.001107,172.31.36.0-255,66,115060,6,297920
17693,0.00111,172.217.194.0-255,1484,116544,6,297920
17694,0.001125,172.31.36.0-255,66,116610,6,297920
17695,0.001132,172.217.194.0-255,6438,123048,6,297920
17696,0.001134,172.31.36.0-255,66,123114,6,297920
17697,0.001172,172.217.194.0-255,1484,124598,6,297920
17698,0.001178,172.217.194.0-255,2902,127500,6,297920
17699,0.001181,172.31.36.0-255,66,127566,6,297920
17700,0.001204,172.217.194.0-255,5738,133304,6,297920
17701,0.001207,172.31.36.0-255,66,133370,6,297920
17702,0.001247,172.31.36.0-255,66,133436,6,297920
17703,0.001255,172.217.194.0-255,8574,142010,6,297920
17704,0.001261,172.31.36.0-255,66,142076,6,297920
17705,0.001267,172.217.194.0-255,1484,143560,6,297920
17706,0.001306,172.217.194.0-255,10692,154252,6,297920
17707,0.001316,172.31.36.0-255,66,154318,6,297920
17708,0.001321,172.31.36.0-255,66,154384,6,297920
17709,0.001374,172.217.194.0-255,2902,157286,6,297920
17710,0.001377,172.31.36.0-255,66,157352,6,297920
17711,0.001411,172.217.194.0-255,9274,166626,6,297920
17712,0.001419,172.217.194.0-255,8574,175200,6,297920
17713,0.001419,172.31.36.0-255,66,175266,6,297920
17714,0.001424,172.31.36.0-255,66,175332,6,297920
17715,0.001427,172.217.194.0-255,9992,185324,6,297920
17716,0.001441,172.31.36.0-255,66,185390,6,297920
17717,0.001486,172.31.36.0-255,66,185456,6,297920
17718,0.001589,172.217.194.0-255,1484,186940,6,297920
17719,0.001594,172.217.194.0-255,2902,189842,6,297920
17720,0.001601,172.31.36.0-255,66,189908,6,297920
17721,0.001613,172.217.194.0-255,5738,195646,6,297920
17722,0.001626,172.217.194.0-255,2902,198548,6,297920
17723,0.001626,172.31.36.0-255,66,198614,6,297920
17724,0.001631,172.31.36.0-255,66,198680,6,297920
17725,0.001648,172.217.194.0-255,9992,208672,6,297920
17726,0.001651,172.31.36.0-255,66,208738,6,297920
17727,0.001658,172.217.194.0-255,7156,215894,6,297920
17728,0.001671,172.31.36.0-255,66,215960,6,297920
17729,0.001689,172.217.194.0-255,1484,217444,6,297920
17730,0.001709,172.217.194.0-255,6438,223882,6,297920
17731,0.001716,172.217.194.0-255,8574,232456,6,297920
17732,0.001715,172.31.36.0-255,66,232522,6,297920
17733,0.001729,172.217.194.0-255,1484,234006,6,297920
17734,0.001731,172.31.36.0-255,66,234072,6,297920
17735,0.001768,172.217.194.0-255,2184,236256,6,297920
17736,0.001774,172.31.36.0-255,66,236322,6,297920
17737,0.001791,172.217.194.0-255,2902,239224,6,297920
17738,0.001806,172.31.36.0-255,66,239290,6,297920
17739,0.001807,172.217.194.0-255,4320,243610,6,297920
17740,0.00181,172.217.194.0-255,1484,245094,6,297920
17741,0.001811,172.31.36.0-255,66,245160,6,297920
17742,0.001835,172.217.194.0-255,7156,252316,6,297920
17743,0.001847,172.31.36.0-255,66,252382,6,297920
17744,0.001851,172.217.194.0-255,4320,256702,6,297920
17745,0.001864,172.31.36.0-255,66,256768,6,297920
17746,0.001874,172.217.194.0-255,9992,266760,6,297920
17747,0.001883,172.31.36.0-255,66,266826,6,297920
17748,0.001898,172.217.194.0-255,4320,271146,6,297920
17749,0.001906,172.31.36.0-255,66,271212,6,297920
17750,0.001922,172.217.194.0-255,5020,276232,6,297920
17751,0.00193,172.217.194.0-255,9992,286224,6,297920
17752,0.001931,172.31.36.0-255,66,286290,6,297920
17753,0.001936,172.31.36.0-255,66,286356,6,297920
17754,0.001953,172.217.194.0-255,4320,290676,6,297920
17755,0.00196,172.31.36.0-255,66,290742,6,297920
17756,0.001979,172.217.194.0-255,6836,297578,6,297920
17757,0.001983,172.217.194.0-255,105,297683,6,297920
17758,0.001989,172.31.36.0-255,66,297749,6,297920
17759,0.003483,172.31.36.0-255,105,297854,6,297920
17760,0.005681,172.217.194.0-255,66,297920,6,297920
17761,0.0,172.253.118.0-255,153,153,6,198731
17762,3.8e-05,172.31.36.0-255,66,219,6,198731
17763,4.6e-05,172.253.118.0-255,1484,1703,6,198731
17764,5e-05,172.31.36.0-255,66,1769,6,198731
17765,5.5e-05,172.253.118.0-255,2902,4671,6,198731
17766,5.7e-05,172.31.36.0-255,66,4737,6,198731
17767,6.4e-05,172.253.118.0-255,7156,11893,6,198731
17768,6.8e-05,172.31.36.0-255,66,11959,6,198731
17769,0.000107,172.253.118.0-255,1484,13443,6,198731
17770,0.000109,172.31.36.0-255,66,13509,6,198731
17771,0.000114,172.31.36.0-255,66,13575,6,198731
17772,0.000124,172.253.118.0-255,2543,16118,6,198731
17773,0.000128,172.31.36.0-255,66,16184,6,198731
17774,0.000265,172.253.118.0-255,1484,17668,6,198731
17775,0.000271,172.31.36.0-255,66,17734,6,198731
17776,0.000277,172.253.118.0-255,2902,20636,6,198731
17777,0.00028,172.31.36.0-255,66,20702,6,198731
17778,0.000286,172.253.118.0-255,5738,26440,6,198731
17779,0.000289,172.31.36.0-255,66,26506,6,198731
17780,0.000311,172.253.118.0-255,1484,27990,6,198731
17781,0.000313,172.31.36.0-255,66,28056,6,198731
17782,0.000349,172.31.36.0-255,66,28122,6,198731
17783,0.000357,172.253.118.0-255,8574,36696,6,198731
17784,0.000361,172.31.36.0-255,66,36762,6,198731
17785,0.000383,172.253.118.0-255,1470,38232,6,198731
17786,0.000385,172.31.36.0-255,66,38298,6,198731
17787,0.001105,172.253.118.0-255,331,38629,6,198731
17788,0.001112,172.31.36.0-255,66,38695,6,198731
17789,0.001441,172.253.118.0-255,1484,40179,6,198731
17790,0.001449,172.31.36.0-255,66,40245,6,198731
17791,0.001457,172.253.118.0-255,2902,43147,6,198731
17792,0.00146,172.31.36.0-255,66,43213,6,198731
17793,0.001466,172.253.118.0-255,5738,48951,6,198731
17794,0.001468,172.31.36.0-255,66,49017,6,198731
17795,0.001493,172.253.118.0-255,7156,56173,6,198731
17796,0.001495,172.31.36.0-255,66,56239,6,198731
17797,0.001515,172.253.118.0-255,5738,61977,6,198731
17798,0.001518,172.31.36.0-255,66,62043,6,198731
17799,0.001554,172.253.118.0-255,4320,66363,6,198731
17800,0.001556,172.31.36.0-255,66,66429,6,198731
17801,0.001577,172.253.118.0-255,6438,72867,6,198731
17802,0.001579,172.31.36.0-255,66,72933,6,198731
17803,0.001846,172.253.118.0-255,1484,74417,6,198731
17804,0.001861,172.253.118.0-255,2902,77319,6,198731
17805,0.001864,172.31.36.0-255,66,77385,6,198731
17806,0.001878,172.253.118.0-255,4320,81705,6,198731
17807,0.00188,172.31.36.0-255,66,81771,6,198731
17808,0.001898,172.253.118.0-255,1484,83255,6,198731
17809,0.001902,172.253.118.0-255,2902,86157,6,198731
17810,0.001904,172.31.36.0-255,66,86223,6,198731
17811,0.001919,172.253.118.0-255,2902,89125,6,198731
17812,0.001922,172.31.36.0-255,66,89191,6,198731
17813,0.001946,172.253.118.0-255,7156,96347,6,198731
17814,0.001948,172.31.36.0-255,66,96413,6,198731
17815,0.001958,172.253.118.0-255,10692,107105,6,198731
17816,0.001961,172.31.36.0-255,66,107171,6,198731
17817,0.002015,172.253.118.0-255,1484,108655,6,198731
17818,0.002019,172.253.118.0-255,1484,110139,6,198731
17819,0.00202,172.31.36.0-255,66,110205,6,198731
17820,0.002036,172.253.118.0-255,1484,111689,6,198731
17821,0.002044,172.253.118.0-255,5738,117427,6,198731
17822,0.002046,172.31.36.0-255,66,117493,6,198731
17823,0.00207,172.253.118.0-255,9992,127485,6,198731
17824,0.002073,172.31.36.0-255,66,127551,6,198731
17825,0.002096,172.253.118.0-255,2902,130453,6,198731
17826,0.002098,172.31.36.0-255,66,130519,6,198731
17827,0.002126,172.31.36.0-255,66,130585,6,198731
17828,0.002186,172.31.36.0-255,66,130651,6,198731
17829,0.002192,172.253.118.0-255,5738,136389,6,198731
17830,0.002194,172.31.36.0-255,66,136455,6,198731
17831,0.002209,172.253.118.0-255,4320,140775,6,198731
17832,0.002211,172.31.36.0-255,66,140841,6,198731
17833,0.002227,172.253.118.0-255,3602,144443,6,198731
17834,0.002229,172.31.36.0-255,66,144509,6,198731
17835,0.002255,172.253.118.0-255,8574,153083,6,198731
17836,0.002258,172.31.36.0-255,66,153149,6,198731
17837,0.002265,172.253.118.0-255,8574,161723,6,198731
17838,0.002267,172.31.36.0-255,66,161789,6,198731
17839,0.002314,172.253.118.0-255,5738,167527,6,198731
17840,0.002317,172.31.36.0-255,66,167593,6,198731
17841,0.002335,172.253.118.0-255,10692,178285,6,198731
17842,0.002338,172.31.36.0-255,66,178351,6,198731
17843,0.002356,172.253.118.0-255,2902,181253,6,198731
17844,0.002358,172.31.36.0-255,66,181319,6,198731
17845,0.004666,172.253.118.0-255,5738,187057,6,198731
17846,0.004672,172.31.36.0-255,66,187123,6,198731
17847,0.007012,172.253.118.0-255,5738,192861,6,198731
17848,0.007025,172.31.36.0-255,66,192927,6,198731
17849,0.009376,172.253.118.0-255,5738,198665,6,198731
17850,0.009391,172.31.36.0-255,66,198731,6,198731
17851,0.0,172.217.194.0-255,153,153,6,285265
17852,2.8e-05,172.31.36.0-255,66,219,6,285265
17853,3.5e-05,172.217.194.0-255,1484,1703,6,285265
17854,3.9e-05,172.31.36.0-255,66,1769,6,285265
17855,4.4e-05,172.217.194.0-255,2902,4671,6,285265
17856,4.7e-05,172.31.36.0-255,66,4737,6,285265
17857,6.2e-05,172.217.194.0-255,5738,10475,6,285265
17858,6.4e-05,172.31.36.0-255,66,10541,6,285265
17859,0.000112,172.217.194.0-255,3410,13951,6,285265
17860,0.000116,172.31.36.0-255,66,14017,6,285265
17861,0.000151,172.217.194.0-255,1484,15501,6,285265
17862,0.000154,172.31.36.0-255,66,15567,6,285265
17863,0.000159,172.217.194.0-255,2902,18469,6,285265
17864,0.000161,172.31.36.0-255,66,18535,6,285265
17865,0.000192,172.217.194.0-255,5738,24273,6,285265
17866,0.000195,172.31.36.0-255,66,24339,6,285265
17867,0.000204,172.217.194.0-255,1484,25823,6,285265
17868,0.000206,172.31.36.0-255,66,25889,6,285265
17869,0.000238,172.217.194.0-255,5379,31268,6,285265
17870,0.000242,172.31.36.0-255,66,31334,6,285265
17871,0.000266,172.217.194.0-255,1484,32818,6,285265
17872,0.00027,172.217.194.0-255,2902,35720,6,285265
17873,0.000271,172.31.36.0-255,66,35786,6,285265
17874,0.000276,172.217.194.0-255,5738,41524,6,285265
17875,0.000276,172.31.36.0-255,66,41590,6,285265
17876,0.00028,172.31.36.0-255,66,41656,6,285265
17877,0.0003,172.217.194.0-255,2902,44558,6,285265
17878,0.000308,172.31.36.0-255,66,44624,6,285265
17879,0.000339,172.217.194.0-255,9633,54257,6,285265
17880,0.000343,172.31.36.0-255,66,54323,6,285265
17881,0.000372,172.217.194.0-255,7156,61479,6,285265
17882,0.000376,172.31.36.0-255,66,61545,6,285265
17883,0.000407,172.217.194.0-255,4251,65796,6,285265
17884,0.00041,172.31.36.0-255,66,65862,6,285265
17885,0.000413,172.217.194.0-255,98,65960,6,285265
17886,0.000437,172.217.194.0-255,364,66324,6,285265
17887,0.000525,172.217.194.0-255,1484,67808,6,285265
17888,0.00053,172.31.36.0-255,66,67874,6,285265
17889,0.000535,172.217.194.0-255,2902,70776,6,285265
17890,0.000537,172.31.36.0-255,66,70842,6,285265
17891,0.000542,172.217.194.0-255,2902,73744,6,285265
17892,0.000549,172.31.36.0-255,66,73810,6,285265
17893,0.000582,172.217.194.0-255,2902,76712,6,285265
17894,0.000586,172.31.36.0-255,66,76778,6,285265
17895,0.000595,172.217.194.0-255,7156,83934,6,285265
17896,0.000597,172.31.36.0-255,66,84000,6,285265
17897,0.000619,172.31.36.0-255,66,84066,6,285265
17898,0.000624,172.217.194.0-255,2184,86250,6,285265
17899,0.000627,172.31.36.0-255,66,86316,6,285265
17900,0.000821,172.217.194.0-255,1484,87800,6,285265
17901,0.000827,172.217.194.0-255,2902,90702,6,285265
17902,0.000831,172.31.36.0-255,66,90768,6,285265
17903,0.000859,172.217.194.0-255,5738,96506,6,285265
17904,0.000863,172.31.36.0-255,66,96572,6,285265
17905,0.000869,172.217.194.0-255,4320,100892,6,285265
17906,0.000872,172.31.36.0-255,66,100958,6,285265
17907,0.000878,172.217.194.0-255,5738,106696,6,285265
17908,0.00088,172.31.36.0-255,66,106762,6,285265
17909,0.000912,172.217.194.0-255,5738,112500,6,285265
17910,0.000915,172.31.36.0-255,66,112566,6,285265
17911,0.000923,172.217.194.0-255,7856,120422,6,285265
17912,0.000925,172.31.36.0-255,66,120488,6,285265
17913,0.000991,172.217.194.0-255,1484,121972,6,285265
17914,0.000997,172.217.194.0-255,2902,124874,6,285265
17915,0.001002,172.31.36.0-255,66,124940,6,285265
17916,0.001034,172.217.194.0-255,5738,130678,6,285265
17917,0.001037,172.31.36.0-255,66,130744,6,285265
17918,0.001047,172.31.36.0-255,66,130810,6,285265
17919,0.001066,172.217.194.0-255,4320,135130,6,285265
17920,0.001073,172.31.36.0-255,66,135196,6,285265
17921,0.001098,172.217.194.0-255,6438,141634,6,285265
17922,0.001101,172.31.36.0-255,66,141700,6,285265
17923,0.001105,172.217.194.0-255,2902,144602,6,285265
17924,0.001107,172.31.36.0-255,66,144668,6,285265
17925,0.001128,172.217.194.0-255,5738,150406,6,285265
17926,0.001136,172.31.36.0-255,66,150472,6,285265
17927,0.001162,172.217.194.0-255,2902,153374,6,285265
17928,0.001165,172.31.36.0-255,66,153440,6,285265
17929,0.001174,172.217.194.0-255,9992,163432,6,285265
17930,0.001176,172.31.36.0-255,66,163498,6,285265
17931,0.001196,172.31.36.0-255,66,163564,6,285265
17932,0.001226,172.217.194.0-255,9274,172838,6,285265
17933,0.001234,172.31.36.0-255,66,172904,6,285265
17934,0.001241,172.217.194.0-255,5738,178642,6,285265
17935,0.001243,172.31.36.0-255,66,178708,6,285265
17936,0.001275,172.217.194.0-255,7156,185864,6,285265
17937,0.001278,172.31.36.0-255,66,185930,6,285265
17938,0.001284,172.217.194.0-255,5738,191668,6,285265
17939,0.001286,172.31.36.0-255,66,191734,6,285265
17940,0.001314,172.217.194.0-255,3602,195336,6,285265
17941,0.001318,172.31.36.0-255,66,195402,6,285265
17942,0.001326,172.217.194.0-255,9992,205394,6,285265
17943,0.001329,172.31.36.0-255,66,205460,6,285265
17944,0.001354,172.31.36.0-255,66,205526,6,285265
17945,0.001376,172.217.194.0-255,1484,207010,6,285265
17946,0.001385,172.217.194.0-255,2184,209194,6,285265
17947,0.001388,172.31.36.0-255,66,209260,6,285265
17948,0.001391,172.217.194.0-255,1484,210744,6,285265
17949,0.001396,172.217.194.0-255,2902,213646,6,285265
17950,0.001398,172.31.36.0-255,66,213712,6,285265
17951,0.001404,172.217.194.0-255,5738,219450,6,285265
17952,0.001407,172.31.36.0-255,66,219516,6,285265
17953,0.001444,172.217.194.0-255,2902,222418,6,285265
17954,0.001448,172.31.36.0-255,66,222484,6,285265
17955,0.001487,172.217.194.0-255,9992,232476,6,285265
17956,0.001492,172.31.36.0-255,66,232542,6,285265
17957,0.001501,172.217.194.0-255,10692,243234,6,285265
17958,0.001504,172.31.36.0-255,66,243300,6,285265
17959,0.001536,172.217.194.0-255,1484,244784,6,285265
17960,0.001541,172.217.194.0-255,2902,247686,6,285265
17961,0.001543,172.31.36.0-255,66,247752,6,285265
17962,0.00155,172.217.194.0-255,5738,253490,6,285265
17963,0.001553,172.31.36.0-255,66,253556,6,285265
17964,0.001569,172.31.36.0-255,66,253622,6,285265
17965,0.001572,172.217.194.0-255,1484,255106,6,285265
17966,0.001616,172.217.194.0-255,9274,264380,6,285265
17967,0.001621,172.31.36.0-255,66,264446,6,285265
17968,0.001634,172.31.36.0-255,66,264512,6,285265
17969,0.001647,172.217.194.0-255,9992,274504,6,285265
17970,0.00165,172.31.36.0-255,66,274570,6,285265
17971,0.001683,172.217.194.0-255,1484,276054,6,285265
17972,0.001693,172.217.194.0-255,8574,284628,6,285265
17973,0.001696,172.31.36.0-255,66,284694,6,285265
17974,0.001739,172.31.36.0-255,66,284760,6,285265
17975,0.001754,172.31.36.0-255,66,284826,6,285265
17976,0.001757,172.217.194.0-255,97,284923,6,285265
17977,0.00176,172.217.194.0-255,105,285028,6,285265
17978,0.003506,172.31.36.0-255,66,285094,6,285265
17979,0.003533,172.31.36.0-255,105,285199,6,285265
17980,0.005774,172.217.194.0-255,66,285265,6,285265
17981,0.0,74.125.24.0-255,146,146,6,117973
17982,2.3e-05,172.31.36.0-255,66,212,6,117973
17983,3.1e-05,74.125.24.0-255,1484,1696,6,117973
17984,3.5e-05,172.31.36.0-255,66,1762,6,117973
17985,4e-05,74.125.24.0-255,2902,4664,6,117973
17986,4.3e-05,172.31.36.0-255,66,4730,6,117973
17987,5.1e-05,74.125.24.0-255,7156,11886,6,117973
17988,5.4e-05,172.31.36.0-255,66,11952,6,117973
17989,0.000107,74.125.24.0-255,2066,14018,6,117973
17990,0.00011,172.31.36.0-255,66,14084,6,117973
17991,0.000433,74.125.24.0-255,1484,15568,6,117973
17992,0.00044,172.31.36.0-255,66,15634,6,117973
17993,0.000457,74.125.24.0-255,2902,18536,6,117973
17994,0.000461,172.31.36.0-255,66,18602,6,117973
17995,0.000467,74.125.24.0-255,4320,22922,6,117973
17996,0.000469,172.31.36.0-255,66,22988,6,117973
17997,0.000488,74.125.24.0-255,1484,24472,6,117973
17998,0.00049,172.31.36.0-255,66,24538,6,117973
17999,0.000499,74.125.24.0-255,6797,31335,6,117973
18000,0.000501,172.31.36.0-255,66,31401,6,117973
18001,0.000665,74.125.24.0-255,1484,32885,6,117973
18002,0.000669,172.31.36.0-255,66,32951,6,117973
18003,0.000675,74.125.24.0-255,2902,35853,6,117973
18004,0.000677,172.31.36.0-255,66,35919,6,117973
18005,0.000683,74.125.24.0-255,4320,40239,6,117973
18006,0.000686,172.31.36.0-255,66,40305,6,117973
18007,0.000701,74.125.24.0-255,1484,41789,6,117973
18008,0.000704,172.31.36.0-255,66,41855,6,117973
18009,0.000712,74.125.24.0-255,6797,48652,6,117973
18010,0.000715,172.31.36.0-255,66,48718,6,117973
18011,0.000752,74.125.24.0-255,1484,50202,6,117973
18012,0.000754,172.31.36.0-255,66,50268,6,117973
18013,0.000777,74.125.24.0-255,9992,60260,6,117973
18014,0.00078,172.31.36.0-255,66,60326,6,117973
18015,0.000802,74.125.24.0-255,5691,66017,6,117973
18016,0.000805,172.31.36.0-255,66,66083,6,117973
18017,0.000946,74.125.24.0-255,108,66191,6,117973
18018,0.00095,172.31.36.0-255,66,66257,6,117973
18019,0.001083,74.125.24.0-255,1484,67741,6,117973
18020,0.00109,74.125.24.0-255,2902,70643,6,117973
18021,0.001112,172.31.36.0-255,66,70709,6,117973
18022,0.001119,74.125.24.0-255,5738,76447,6,117973
18023,0.001124,172.31.36.0-255,66,76513,6,117973
18024,0.001165,74.125.24.0-255,6797,83310,6,117973
18025,0.001175,172.31.36.0-255,66,83376,6,117973
18026,0.001195,74.125.24.0-255,1484,84860,6,117973
18027,0.001199,74.125.24.0-255,1484,86344,6,117973
18028,0.001202,172.31.36.0-255,66,86410,6,117973
18029,0.001213,74.125.24.0-255,1484,87894,6,117973
18030,0.00122,74.125.24.0-255,5738,93632,6,117973
18031,0.001239,172.31.36.0-255,66,93698,6,117973
18032,0.001258,74.125.24.0-255,6797,100495,6,117973
18033,0.001262,172.31.36.0-255,66,100561,6,117973
18034,0.003236,74.125.24.0-255,5738,106299,6,117973
18035,0.003244,172.31.36.0-255,66,106365,6,117973
18036,0.005252,74.125.24.0-255,5738,112103,6,117973
18037,0.006234,172.31.36.0-255,66,112169,6,117973
18038,0.008236,74.125.24.0-255,5738,117907,6,117973
18039,0.008243,172.31.36.0-255,66,117973,6,117973
18040,0.0,74.125.200.0-255,146,146,6,354759
18041,3.3e-05,172.31.36.0-255,66,212,6,354759
18042,4.2e-05,74.125.200.0-255,1484,1696,6,354759
18043,4.5e-05,172.31.36.0-255,66,1762,6,354759
18044,5.9e-05,74.125.200.0-255,2902,4664,6,354759
18045,6.2e-05,172.31.36.0-255,66,4730,6,354759
18046,6.7e-05,74.125.200.0-255,4320,9050,6,354759
18047,7e-05,172.31.36.0-255,66,9116,6,354759
18048,0.00011,74.125.200.0-255,4903,14019,6,354759
18049,0.000114,172.31.36.0-255,66,14085,6,354759
18050,0.000214,74.125.200.0-255,1484,15569,6,354759
18051,0.000221,172.31.36.0-255,66,15635,6,354759
18052,0.000247,74.125.200.0-255,1484,17119,6,354759
18053,0.000249,172.31.36.0-255,66,17185,6,354759
18054,0.000254,74.125.200.0-255,2902,20087,6,354759
18055,0.000257,172.31.36.0-255,66,20153,6,354759
18056,0.00028,74.125.200.0-255,4320,24473,6,354759
18057,0.000284,172.31.36.0-255,66,24539,6,354759
18058,0.000302,74.125.200.0-255,1484,26023,6,354759
18059,0.000304,172.31.36.0-255,66,26089,6,354759
18060,0.000308,74.125.200.0-255,1484,27573,6,354759
18061,0.00031,172.31.36.0-255,66,27639,6,354759
18062,0.000315,74.125.200.0-255,2902,30541,6,354759
18063,0.000317,172.31.36.0-255,66,30607,6,354759
18064,0.000379,74.125.200.0-255,1125,31732,6,354759
18065,0.000383,172.31.36.0-255,66,31798,6,354759
18066,0.000386,74.125.200.0-255,1484,33282,6,354759
18067,0.000389,172.31.36.0-255,66,33348,6,354759
18068,0.000394,74.125.200.0-255,4320,37668,6,354759
18069,0.000396,172.31.36.0-255,66,37734,6,354759
18070,0.000405,74.125.200.0-255,9992,47726,6,354759
18071,0.000408,172.31.36.0-255,66,47792,6,354759
18072,0.000428,74.125.200.0-255,1125,48917,6,354759
18073,0.000431,172.31.36.0-255,66,48983,6,354759
18074,0.00046,74.125.200.0-255,1484,50467,6,354759
18075,0.000465,172.31.36.0-255,66,50533,6,354759
18076,0.000491,74.125.200.0-255,4320,54853,6,354759
18077,0.000496,172.31.36.0-255,66,54919,6,354759
18078,0.000501,74.125.200.0-255,2902,57821,6,354759
18079,0.000503,172.31.36.0-255,66,57887,6,354759
18080,0.000508,74.125.200.0-255,4320,62207,6,354759
18081,0.000512,172.31.36.0-255,66,62273,6,354759
18082,0.000556,74.125.200.0-255,4231,66504,6,354759
18083,0.000559,172.31.36.0-255,66,66570,6,354759
18084,0.000587,74.125.200.0-255,131,66701,6,354759
18085,0.00059,172.31.36.0-255,66,66767,6,354759
18086,0.000641,74.125.200.0-255,1484,68251,6,354759
18087,0.000645,172.31.36.0-255,66,68317,6,354759
18088,0.00065,74.125.200.0-255,2902,71219,6,354759
18089,0.000653,172.31.36.0-255,66,71285,6,354759
18090,0.000657,74.125.200.0-255,2902,74187,6,354759
18091,0.000659,172.31.36.0-255,66,74253,6,354759
18092,0.000684,74.125.200.0-255,2902,77155,6,354759
18093,0.000688,172.31.36.0-255,66,77221,6,354759
18094,0.000695,74.125.200.0-255,5738,82959,6,354759
18095,0.000698,172.31.36.0-255,66,83025,6,354759
18096,0.00072,74.125.200.0-255,5738,88763,6,354759
18097,0.000728,172.31.36.0-255,66,88829,6,354759
18098,0.000736,74.125.200.0-255,7156,95985,6,354759
18099,0.000739,172.31.36.0-255,66,96051,6,354759
18100,0.00077,74.125.200.0-255,5020,101071,6,354759
18101,0.000774,172.31.36.0-255,66,101137,6,354759
18102,0.001103,74.125.200.0-255,1484,102621,6,354759
18103,0.001108,172.31.36.0-255,66,102687,6,354759
18104,0.001113,74.125.200.0-255,2902,105589,6,354759
18105,0.001115,172.31.36.0-255,66,105655,6,354759
18106,0.001133,74.125.200.0-255,1484,107139,6,354759
18107,0.001136,172.31.36.0-255,66,107205,6,354759
18108,0.001164,74.125.200.0-255,4320,111525,6,354759
18109,0.001167,172.31.36.0-255,66,111591,6,354759
18110,0.001176,74.125.200.0-255,9992,121583,6,354759
18111,0.001178,172.31.36.0-255,66,121649,6,354759
18112,0.001222,74.125.200.0-255,2184,123833,6,354759
18113,0.001223,172.31.36.0-255,66,123899,6,354759
18114,0.001227,172.31.36.0-255,66,123965,6,354759
18115,0.00125,74.125.200.0-255,1484,125449,6,354759
18116,0.001253,172.31.36.0-255,66,125515,6,354759
18117,0.001281,74.125.200.0-255,1484,126999,6,354759
18118,0.001284,172.31.36.0-255,66,127065,6,354759
18119,0.00129,74.125.200.0-255,4320,131385,6,354759
18120,0.001292,172.31.36.0-255,66,131451,6,354759
18121,0.001297,74.125.200.0-255,4320,135771,6,354759
18122,0.001299,172.31.36.0-255,66,135837,6,354759
18123,0.001323,74.125.200.0-255,4320,140157,6,354759
18124,0.001329,74.125.200.0-255,5738,145895,6,354759
18125,0.00133,172.31.36.0-255,66,145961,6,354759
18126,0.001335,74.125.200.0-255,7156,153117,6,354759
18127,0.001344,172.31.36.0-255,66,153183,6,354759
18128,0.001363,74.125.200.0-255,2902,156085,6,354759
18129,0.001372,172.31.36.0-255,66,156151,6,354759
18130,0.001386,74.125.200.0-255,2184,158335,6,354759
18131,0.001394,172.31.36.0-255,66,158401,6,354759
18132,0.001416,74.125.200.0-255,1484,159885,6,354759
18133,0.001428,74.125.200.0-255,2902,162787,6,354759
18134,0.001442,172.31.36.0-255,66,162853,6,354759
18135,0.001449,74.125.200.0-255,5738,168591,6,354759
18136,0.001451,172.31.36.0-255,66,168657,6,354759
18137,0.001454,74.125.200.0-255,1484,170141,6,354759
18138,0.001482,74.125.200.0-255,4320,174461,6,354759
18139,0.00149,74.125.200.0-255,7156,181617,6,354759
18140,0.001498,172.31.36.0-255,66,181683,6,354759
18141,0.001531,74.125.200.0-255,10692,192375,6,354759
18142,0.001544,172.31.36.0-255,66,192441,6,354759
18143,0.001616,74.125.200.0-255,1484,193925,6,354759
18144,0.00163,74.125.200.0-255,2902,196827,6,354759
18145,0.001633,172.31.36.0-255,66,196893,6,354759
18146,0.001662,74.125.200.0-255,5738,202631,6,354759
18147,0.001668,74.125.200.0-255,5738,208369,6,354759
18148,0.001669,172.31.36.0-255,66,208435,6,354759
18149,0.001674,172.31.36.0-255,66,208501,6,354759
18150,0.001716,74.125.200.0-255,1484,209985,6,354759
18151,0.001746,74.125.200.0-255,5738,215723,6,354759
18152,0.001755,172.31.36.0-255,66,215789,6,354759
18153,0.001756,74.125.200.0-255,10692,226481,6,354759
18154,0.001779,172.31.36.0-255,66,226547,6,354759
18155,0.001831,74.125.200.0-255,1484,228031,6,354759
18156,0.001846,74.125.200.0-255,2902,230933,6,354759
18157,0.001849,172.31.36.0-255,66,230999,6,354759
18158,0.001852,74.125.200.0-255,1484,232483,6,354759
18159,0.001875,74.125.200.0-255,2902,235385,6,354759
18160,0.001896,74.125.200.0-255,5738,241123,6,354759
18161,0.001897,172.31.36.0-255,66,241189,6,354759
18162,0.001939,74.125.200.0-255,1484,242673,6,354759
18163,0.001956,74.125.200.0-255,4320,246993,6,354759
18164,0.001978,74.125.200.0-255,9274,256267,6,354759
18165,0.00199,74.125.200.0-255,4320,260587,6,354759
18166,0.002022,74.125.200.0-255,5738,266325,6,354759
18167,0.002088,74.125.200.0-255,2184,268509,6,354759
18168,0.002336,74.125.200.0-255,1484,269993,6,354759
18169,0.002342,74.125.200.0-255,2902,272895,6,354759
18170,0.002344,74.125.200.0-255,1484,274379,6,354759
18171,0.002365,74.125.200.0-255,4320,278699,6,354759
18172,0.002382,74.125.200.0-255,2902,281601,6,354759
18173,0.002406,74.125.200.0-255,9992,291593,6,354759
18174,0.002427,74.125.200.0-255,9992,301585,6,354759
18175,0.002445,74.125.200.0-255,4320,305905,6,354759
18176,0.002461,74.125.200.0-255,6438,312343,6,354759
18177,0.00249,74.125.200.0-255,5738,318081,6,354759
18178,0.002508,74.125.200.0-255,5738,323819,6,354759
18179,0.002529,74.125.200.0-255,4320,328139,6,354759
18180,0.002545,74.125.200.0-255,7856,335995,6,354759
18181,0.002578,74.125.200.0-255,5738,341733,6,354759
18182,0.00261,74.125.200.0-255,1484,343217,6,354759
18183,0.002654,74.125.200.0-255,5738,348955,6,354759
18184,0.002676,74.125.200.0-255,5738,354693,6,354759
18185,0.00862,172.31.36.0-255,66,354759,6,354759
18186,0.0,74.125.24.0-255,146,146,6,276954
18187,3.3e-05,172.31.36.0-255,66,212,6,276954
18188,4.1e-05,74.125.24.0-255,1484,1696,6,276954
18189,4.5e-05,172.31.36.0-255,66,1762,6,276954
18190,5e-05,74.125.24.0-255,2902,4664,6,276954
18191,5.3e-05,172.31.36.0-255,66,4730,6,276954
18192,5.5e-05,74.125.24.0-255,1484,6214,6,276954
18193,5.8e-05,172.31.36.0-255,66,6280,6,276954
18194,6.5e-05,74.125.24.0-255,5738,12018,6,276954
18195,6.8e-05,172.31.36.0-255,66,12084,6,276954
18196,9.6e-05,74.125.24.0-255,1484,13568,6,276954
18197,9.9e-05,172.31.36.0-255,66,13634,6,276954
18198,0.000123,74.125.24.0-255,7819,21453,6,276954
18199,0.000127,172.31.36.0-255,66,21519,6,276954
18200,0.000136,74.125.24.0-255,9633,31152,6,276954
18201,0.000138,172.31.36.0-255,66,31218,6,276954
18202,0.000289,74.125.24.0-255,1484,32702,6,276954
18203,0.000296,172.31.36.0-255,66,32768,6,276954
18204,0.000312,74.125.24.0-255,2902,35670,6,276954
18205,0.000316,172.31.36.0-255,66,35736,6,276954
18206,0.000328,74.125.24.0-255,4320,40056,6,276954
18207,0.000331,172.31.36.0-255,66,40122,6,276954
18208,0.000354,74.125.24.0-255,1484,41606,6,276954
18209,0.000357,172.31.36.0-255,66,41672,6,276954
18210,0.000362,74.125.24.0-255,2902,44574,6,276954
18211,0.000365,172.31.36.0-255,66,44640,6,276954
18212,0.000387,74.125.24.0-255,2902,47542,6,276954
18213,0.000391,172.31.36.0-255,66,47608,6,276954
18214,0.000418,74.125.24.0-255,8215,55823,6,276954
18215,0.000421,74.125.24.0-255,1484,57307,6,276954
18216,0.000424,172.31.36.0-255,66,57373,6,276954
18217,0.000426,74.125.24.0-255,2902,60275,6,276954
18218,0.000427,172.31.36.0-255,66,60341,6,276954
18219,0.00043,172.31.36.0-255,66,60407,6,276954
18220,0.000456,74.125.24.0-255,5379,65786,6,276954
18221,0.000459,172.31.36.0-255,66,65852,6,276954
18222,0.000478,74.125.24.0-255,647,66499,6,276954
18223,0.00067,74.125.24.0-255,1484,67983,6,276954
18224,0.000679,172.31.36.0-255,66,68049,6,276954
18225,0.000685,74.125.24.0-255,2902,70951,6,276954
18226,0.000688,172.31.36.0-255,66,71017,6,276954
18227,0.000724,74.125.24.0-255,4320,75337,6,276954
18228,0.000727,172.31.36.0-255,66,75403,6,276954
18229,0.000734,74.125.24.0-255,5738,81141,6,276954
18230,0.000736,172.31.36.0-255,66,81207,6,276954
18231,0.000759,74.125.24.0-255,1993,83200,6,276954
18232,0.000761,172.31.36.0-255,66,83266,6,276954
18233,0.000865,74.125.24.0-255,1484,84750,6,276954
18234,0.000888,74.125.24.0-255,2902,87652,6,276954
18235,0.000892,172.31.36.0-255,66,87718,6,276954
18236,0.000914,74.125.24.0-255,1484,89202,6,276954
18237,0.000933,74.125.24.0-255,2902,92104,6,276954
18238,0.000937,172.31.36.0-255,66,92170,6,276954
18239,0.000953,74.125.24.0-255,5738,97908,6,276954
18240,0.000956,172.31.36.0-255,66,97974,6,276954
18241,0.000961,74.125.24.0-255,2902,100876,6,276954
18242,0.000964,172.31.36.0-255,66,100942,6,276954
18243,0.000991,74.125.24.0-255,4320,105262,6,276954
18244,0.000994,172.31.36.0-255,66,105328,6,276954
18245,0.001011,74.125.24.0-255,2902,108230,6,276954
18246,0.001014,172.31.36.0-255,66,108296,6,276954
18247,0.001034,74.125.24.0-255,9274,117570,6,276954
18248,0.001037,172.31.36.0-255,66,117636,6,276954
18249,0.001405,74.125.24.0-255,1484,119120,6,276954
18250,0.001414,74.125.24.0-255,2902,122022,6,276954
18251,0.001418,172.31.36.0-255,66,122088,6,276954
18252,0.001426,74.125.24.0-255,5738,127826,6,276954
18253,0.001429,172.31.36.0-255,66,127892,6,276954
18254,0.001493,172.31.36.0-255,66,127958,6,276954
18255,0.001511,74.125.24.0-255,1484,129442,6,276954
18256,0.001521,74.125.24.0-255,10692,140134,6,276954
18257,0.001524,172.31.36.0-255,66,140200,6,276954
18258,0.00169,74.125.24.0-255,1484,141684,6,276954
18259,0.001697,74.125.24.0-255,2902,144586,6,276954
18260,0.001702,172.31.36.0-255,66,144652,6,276954
18261,0.001708,74.125.24.0-255,4320,148972,6,276954
18262,0.00171,172.31.36.0-255,66,149038,6,276954
18263,0.001725,74.125.24.0-255,1484,150522,6,276954
18264,0.001733,74.125.24.0-255,7156,157678,6,276954
18265,0.001735,172.31.36.0-255,66,157744,6,276954
18266,0.001738,74.125.24.0-255,1484,159228,6,276954
18267,0.001759,74.125.24.0-255,5738,164966,6,276954
18268,0.001762,172.31.36.0-255,66,165032,6,276954
18269,0.001787,74.125.24.0-255,7156,172188,6,276954
18270,0.00179,172.31.36.0-255,66,172254,6,276954
18271,0.001804,74.125.24.0-255,2184,174438,6,276954
18272,0.001808,172.31.36.0-255,66,174504,6,276954
18273,0.001829,74.125.24.0-255,2902,177406,6,276954
18274,0.001832,172.31.36.0-255,66,177472,6,276954
18275,0.001881,74.125.24.0-255,1484,178956,6,276954
18276,0.001887,74.125.24.0-255,2902,181858,6,276954
18277,0.00189,172.31.36.0-255,66,181924,6,276954
18278,0.001895,74.125.24.0-255,2902,184826,6,276954
18279,0.001899,172.31.36.0-255,66,184892,6,276954
18280,0.001916,74.125.24.0-255,2902,187794,6,276954
18281,0.001918,172.31.36.0-255,66,187860,6,276954
18282,0.001925,74.125.24.0-255,5738,193598,6,276954
18283,0.001928,172.31.36.0-255,66,193664,6,276954
18284,0.001959,74.125.24.0-255,7156,200820,6,276954
18285,0.001963,172.31.36.0-255,66,200886,6,276954
18286,0.00197,74.125.24.0-255,7856,208742,6,276954
18287,0.001972,172.31.36.0-255,66,208808,6,276954
18288,0.002065,74.125.24.0-255,1484,210292,6,276954
18289,0.002068,74.125.24.0-255,1484,211776,6,276954
18290,0.00207,172.31.36.0-255,66,211842,6,276954
18291,0.002089,74.125.24.0-255,1484,213326,6,276954
18292,0.002095,74.125.24.0-255,5738,219064,6,276954
18293,0.002108,74.125.24.0-255,1484,220548,6,276954
18294,0.002147,74.125.24.0-255,4320,224868,6,276954
18295,0.002164,74.125.24.0-255,2902,227770,6,276954
18296,0.002178,74.125.24.0-255,1484,229254,6,276954
18297,0.002197,74.125.24.0-255,2184,231438,6,276954
18298,0.002485,74.125.24.0-255,1484,232922,6,276954
18299,0.00249,74.125.24.0-255,1484,234406,6,276954
18300,0.002501,74.125.24.0-255,1484,235890,6,276954
18301,0.002507,74.125.24.0-255,5738,241628,6,276954
18302,0.002526,74.125.24.0-255,5738,247366,6,276954
18303,0.002562,74.125.24.0-255,7156,254522,6,276954
18304,0.002569,74.125.24.0-255,7156,261678,6,276954
18305,0.00259,74.125.24.0-255,3602,265280,6,276954
18306,0.003833,172.31.36.0-255,66,265346,6,276954
18307,0.006366,74.125.24.0-255,5738,271084,6,276954
18308,0.006373,172.31.36.0-255,66,271150,6,276954
18309,0.008946,74.125.24.0-255,5738,276888,6,276954
18310,0.008953,172.31.36.0-255,66,276954,6,276954
18311,0.0,172.217.194.0-255,150,150,6,243328
18312,2e-05,172.31.36.0-255,66,216,6,243328
18313,2.7e-05,172.217.194.0-255,1484,1700,6,243328
18314,3.2e-05,172.31.36.0-255,66,1766,6,243328
18315,3.7e-05,172.217.194.0-255,2902,4668,6,243328
18316,4e-05,172.31.36.0-255,66,4734,6,243328
18317,4.6e-05,172.217.194.0-255,4320,9054,6,243328
18318,5e-05,172.31.36.0-255,66,9120,6,243328
18319,8e-05,172.217.194.0-255,2902,12022,6,243328
18320,8.3e-05,172.31.36.0-255,66,12088,6,243328
18321,0.000103,172.217.194.0-255,2038,14126,6,243328
18322,0.000106,172.31.36.0-255,66,14192,6,243328
18323,0.000124,172.217.194.0-255,1484,15676,6,243328
18324,0.000126,172.31.36.0-255,66,15742,6,243328
18325,0.000148,172.217.194.0-255,4320,20062,6,243328
18326,0.000151,172.31.36.0-255,66,20128,6,243328
18327,0.000163,172.217.194.0-255,1484,21612,6,243328
18328,0.000165,172.31.36.0-255,66,21678,6,243328
18329,0.00019,172.217.194.0-255,9633,31311,6,243328
18330,0.000192,172.31.36.0-255,66,31377,6,243328
18331,0.000212,172.217.194.0-255,1484,32861,6,243328
18332,0.000214,172.31.36.0-255,66,32927,6,243328
18333,0.000219,172.217.194.0-255,2902,35829,6,243328
18334,0.000221,172.31.36.0-255,66,35895,6,243328
18335,0.000233,172.217.194.0-255,1484,37379,6,243328
18336,0.000235,172.31.36.0-255,66,37445,6,243328
18337,0.000249,172.217.194.0-255,4320,41765,6,243328
18338,0.000251,172.31.36.0-255,66,41831,6,243328
18339,0.000275,172.217.194.0-255,6797,48628,6,243328
18340,0.000277,172.31.36.0-255,66,48694,6,243328
18341,0.0009,172.217.194.0-255,1484,50178,6,243328
18342,0.000906,172.31.36.0-255,66,50244,6,243328
18343,0.000915,172.217.194.0-255,2902,53146,6,243328
18344,0.000917,172.31.36.0-255,66,53212,6,243328
18345,0.000924,172.217.194.0-255,5738,58950,6,243328
18346,0.000926,172.31.36.0-255,66,59016,6,243328
18347,0.000949,172.217.194.0-255,4320,63336,6,243328
18348,0.000952,172.31.36.0-255,66,63402,6,243328
18349,0.00097,172.217.194.0-255,2543,65945,6,243328
18350,0.000972,172.31.36.0-255,66,66011,6,243328
18351,0.001039,172.217.194.0-255,1484,67495,6,243328
18352,0.001045,172.217.194.0-255,2902,70397,6,243328
18353,0.001048,172.31.36.0-255,66,70463,6,243328
18354,0.001055,172.217.194.0-255,5738,76201,6,243328
18355,0.001057,172.31.36.0-255,66,76267,6,243328
18356,0.001079,172.217.194.0-255,5738,82005,6,243328
18357,0.001081,172.31.36.0-255,66,82071,6,243328
18358,0.001114,172.217.194.0-255,8215,90286,6,243328
18359,0.001117,172.31.36.0-255,66,90352,6,243328
18360,0.001127,172.217.194.0-255,9633,99985,6,243328
18361,0.00113,172.31.36.0-255,66,100051,6,243328
18362,0.00127,172.217.194.0-255,1484,101535,6,243328
18363,0.001289,172.217.194.0-255,2902,104437,6,243328
18364,0.001294,172.31.36.0-255,66,104503,6,243328
18365,0.001301,172.217.194.0-255,5738,110241,6,243328
18366,0.001303,172.31.36.0-255,66,110307,6,243328
18367,0.001328,172.217.194.0-255,7156,117463,6,243328
18368,0.001331,172.31.36.0-255,66,117529,6,243328
18369,0.001354,172.217.194.0-255,5738,123267,6,243328
18370,0.001357,172.31.36.0-255,66,123333,6,243328
18371,0.001363,172.217.194.0-255,4320,127653,6,243328
18372,0.001365,172.31.36.0-255,66,127719,6,243328
18373,0.001386,172.217.194.0-255,6438,134157,6,243328
18374,0.001389,172.31.36.0-255,66,134223,6,243328
18375,0.001695,172.217.194.0-255,645,134868,6,243328
18376,0.001718,172.217.194.0-255,1484,136352,6,243328
18377,0.001724,172.31.36.0-255,66,136418,6,243328
18378,0.001728,172.217.194.0-255,1484,137902,6,243328
18379,0.001748,172.217.194.0-255,2902,140804,6,243328
18380,0.001751,172.31.36.0-255,66,140870,6,243328
18381,0.001761,172.217.194.0-255,9992,150862,6,243328
18382,0.001763,172.31.36.0-255,66,150928,6,243328
18383,0.001766,172.217.194.0-255,1484,152412,6,243328
18384,0.001812,172.217.194.0-255,2902,155314,6,243328
18385,0.001815,172.31.36.0-255,66,155380,6,243328
18386,0.001845,172.31.36.0-255,66,155446,6,243328
18387,0.001881,172.31.36.0-255,66,155512,6,243328
18388,0.001895,172.217.194.0-255,2902,158414,6,243328
18389,0.001897,172.31.36.0-255,66,158480,6,243328
18390,0.001929,172.31.36.0-255,66,158546,6,243328
18391,0.001934,172.217.194.0-255,3602,162148,6,243328
18392,0.001936,172.31.36.0-255,66,162214,6,243328
18393,0.002151,172.217.194.0-255,1484,163698,6,243328
18394,0.002156,172.217.194.0-255,1484,165182,6,243328
18395,0.002159,172.31.36.0-255,66,165248,6,243328
18396,0.002176,172.217.194.0-255,1484,166732,6,243328
18397,0.00218,172.217.194.0-255,1484,168216,6,243328
18398,0.002183,172.31.36.0-255,66,168282,6,243328
18399,0.002203,172.217.194.0-255,4320,172602,6,243328
18400,0.002206,172.31.36.0-255,66,172668,6,243328
18401,0.002209,172.217.194.0-255,1484,174152,6,243328
18402,0.002225,172.217.194.0-255,5738,179890,6,243328
18403,0.002228,172.31.36.0-255,66,179956,6,243328
18404,0.002249,172.217.194.0-255,2902,182858,6,243328
18405,0.002251,172.31.36.0-255,66,182924,6,243328
18406,0.002281,172.217.194.0-255,7156,190080,6,243328
18407,0.002283,172.31.36.0-255,66,190146,6,243328
18408,0.002311,172.217.194.0-255,10692,200838,6,243328
18409,0.002314,172.31.36.0-255,66,200904,6,243328
18410,0.002338,172.31.36.0-255,66,200970,6,243328
18411,0.002348,172.217.194.0-255,9992,210962,6,243328
18412,0.002351,172.31.36.0-255,66,211028,6,243328
18413,0.002353,172.217.194.0-255,766,211794,6,243328
18414,0.002435,172.217.194.0-255,1484,213278,6,243328
18415,0.002439,172.31.36.0-255,66,213344,6,243328
18416,0.002444,172.217.194.0-255,2902,216246,6,243328
18417,0.002447,172.31.36.0-255,66,216312,6,243328
18418,0.002472,172.217.194.0-255,5738,222050,6,243328
18419,0.002476,172.31.36.0-255,66,222116,6,243328
18420,0.002516,172.217.194.0-255,1484,223600,6,243328
18421,0.002536,172.217.194.0-255,5738,229338,6,243328
18422,0.002539,172.31.36.0-255,66,229404,6,243328
18423,0.002554,172.31.36.0-255,66,229470,6,243328
18424,0.002558,172.217.194.0-255,2184,231654,6,243328
18425,0.00256,172.31.36.0-255,66,231720,6,243328
18426,0.005097,172.217.194.0-255,5738,237458,6,243328
18427,0.005103,172.31.36.0-255,66,237524,6,243328
18428,0.007639,172.217.194.0-255,5738,243262,6,243328
18429,0.007645,172.31.36.0-255,66,243328,6,243328
18430,0.0,172.217.194.0-255,153,153,6,133603
18431,2.3e-05,172.31.36.0-255,66,219,6,133603
18432,3.1e-05,172.217.194.0-255,1484,1703,6,133603
18433,3.6e-05,172.31.36.0-255,66,1769,6,133603
18434,4.2e-05,172.217.194.0-255,2902,4671,6,133603
18435,4.5e-05,172.31.36.0-255,66,4737,6,133603
18436,5.2e-05,172.217.194.0-255,5738,10475,6,133603
18437,5.6e-05,172.31.36.0-255,66,10541,6,133603
18438,7.8e-05,172.217.194.0-255,3474,14015,6,133603
18439,8.2e-05,172.31.36.0-255,66,14081,6,133603
18440,0.000118,172.217.194.0-255,4320,18401,6,133603
18441,0.000121,172.31.36.0-255,66,18467,6,133603
18442,0.000126,172.217.194.0-255,4320,22787,6,133603
18443,0.000129,172.31.36.0-255,66,22853,6,133603
18444,0.000145,172.217.194.0-255,1484,24337,6,133603
18445,0.000147,172.31.36.0-255,66,24403,6,133603
18446,0.00017,172.217.194.0-255,2902,27305,6,133603
18447,0.000172,172.31.36.0-255,66,27371,6,133603
18448,0.000198,172.217.194.0-255,3961,31332,6,133603
18449,0.0002,172.31.36.0-255,66,31398,6,133603
18450,0.000577,172.217.194.0-255,1484,32882,6,133603
18451,0.000582,172.31.36.0-255,66,32948,6,133603
18452,0.000589,172.217.194.0-255,2902,35850,6,133603
18453,0.000591,172.31.36.0-255,66,35916,6,133603
18454,0.000599,172.217.194.0-255,5738,41654,6,133603
18455,0.000601,172.31.36.0-255,66,41720,6,133603
18456,0.000619,172.217.194.0-255,1484,43204,6,133603
18457,0.000622,172.31.36.0-255,66,43270,6,133603
18458,0.00065,172.217.194.0-255,5379,48649,6,133603
18459,0.000655,172.31.36.0-255,66,48715,6,133603
18460,0.000754,172.217.194.0-255,1484,50199,6,133603
18461,0.000758,172.31.36.0-255,66,50265,6,133603
18462,0.000763,172.217.194.0-255,2902,53167,6,133603
18463,0.000771,172.217.194.0-255,5738,58905,6,133603
18464,0.000784,172.31.36.0-255,66,58971,6,133603
18465,0.000797,172.217.194.0-255,5738,64709,6,133603
18466,0.000803,172.31.36.0-255,66,64775,6,133603
18467,0.000834,172.217.194.0-255,5738,70513,6,133603
18468,0.000842,172.31.36.0-255,66,70579,6,133603
18469,0.00086,172.217.194.0-255,286,70865,6,133603
18470,0.000869,172.217.194.0-255,7156,78021,6,133603
18471,0.00088,172.31.36.0-255,66,78087,6,133603
18472,0.000887,172.217.194.0-255,5379,83466,6,133603
18473,0.000898,172.31.36.0-255,66,83532,6,133603
18474,0.001006,172.217.194.0-255,1484,85016,6,133603
18475,0.001012,172.217.194.0-255,2902,87918,6,133603
18476,0.001015,172.31.36.0-255,66,87984,6,133603
18477,0.001021,172.217.194.0-255,4320,92304,6,133603
18478,0.001035,172.217.194.0-255,1484,93788,6,133603
18479,0.001038,172.217.194.0-255,1484,95272,6,133603
18480,0.001053,172.217.194.0-255,5379,100651,6,133603
18481,0.001056,172.31.36.0-255,66,100717,6,133603
18482,0.001061,172.31.36.0-255,66,100783,6,133603
18483,0.001786,172.217.194.0-255,1484,102267,6,133603
18484,0.001809,172.217.194.0-255,2902,105169,6,133603
18485,0.001814,172.31.36.0-255,66,105235,6,133603
18486,0.001819,172.217.194.0-255,1484,106719,6,133603
18487,0.001835,172.217.194.0-255,1484,108203,6,133603
18488,0.001851,172.217.194.0-255,5738,113941,6,133603
18489,0.001866,172.217.194.0-255,1484,115425,6,133603
18490,0.001884,172.217.194.0-255,2902,118327,6,133603
18491,0.00192,172.217.194.0-255,3602,121929,6,133603
18492,0.004158,172.31.36.0-255,66,121995,6,133603
18493,0.006151,172.217.194.0-255,5738,127733,6,133603
18494,0.006156,172.31.36.0-255,66,127799,6,133603
18495,0.008145,172.217.194.0-255,5738,133537,6,133603
18496,0.008152,172.31.36.0-255,66,133603,6,133603
18497,0.0,172.217.194.0-255,146,146,6,340649
18498,2.3e-05,172.31.36.0-255,66,212,6,340649
18499,3e-05,172.217.194.0-255,1484,1696,6,340649
18500,3.5e-05,172.31.36.0-255,66,1762,6,340649
18501,5.5e-05,172.217.194.0-255,2902,4664,6,340649
18502,5.8e-05,172.31.36.0-255,66,4730,6,340649
18503,6.6e-05,172.217.194.0-255,5738,10468,6,340649
18504,6.8e-05,172.31.36.0-255,66,10534,6,340649
18505,7.2e-05,172.217.194.0-255,1484,12018,6,340649
18506,7.4e-05,172.31.36.0-255,66,12084,6,340649
18507,0.0001,172.217.194.0-255,2104,14188,6,340649
18508,0.000103,172.31.36.0-255,66,14254,6,340649
18509,0.000125,172.217.194.0-255,7156,21410,6,340649
18510,0.000128,172.31.36.0-255,66,21476,6,340649
18511,0.000147,172.217.194.0-255,4320,25796,6,340649
18512,0.000151,172.31.36.0-255,66,25862,6,340649
18513,0.000177,172.217.194.0-255,5379,31241,6,340649
18514,0.00018,172.31.36.0-255,66,31307,6,340649
18515,0.000255,172.217.194.0-255,1484,32791,6,340649
18516,0.000259,172.31.36.0-255,66,32857,6,340649
18517,0.000265,172.217.194.0-255,2902,35759,6,340649
18518,0.000268,172.31.36.0-255,66,35825,6,340649
18519,0.000294,172.217.194.0-255,5738,41563,6,340649
18520,0.000298,172.31.36.0-255,66,41629,6,340649
18521,0.000324,172.217.194.0-255,5738,47367,6,340649
18522,0.000327,172.31.36.0-255,66,47433,6,340649
18523,0.000348,172.217.194.0-255,5379,52812,6,340649
18524,0.000351,172.31.36.0-255,66,52878,6,340649
18525,0.000356,172.217.194.0-255,4320,57198,6,340649
18526,0.000358,172.31.36.0-255,66,57264,6,340649
18527,0.000392,172.217.194.0-255,5738,63002,6,340649
18528,0.000395,172.31.36.0-255,66,63068,6,340649
18529,0.000413,172.217.194.0-255,2543,65611,6,340649
18530,0.000433,172.217.194.0-255,646,66257,6,340649
18531,0.000439,172.31.36.0-255,66,66323,6,340649
18532,0.000609,172.217.194.0-255,1484,67807,6,340649
18533,0.000626,172.217.194.0-255,2902,70709,6,340649
18534,0.000629,172.217.194.0-255,1484,72193,6,340649
18535,0.000651,172.217.194.0-255,4320,76513,6,340649
18536,0.000657,172.217.194.0-255,4320,80833,6,340649
18537,0.000668,172.31.36.0-255,66,80899,6,340649
18538,0.000688,172.217.194.0-255,5738,86637,6,340649
18539,0.000707,172.217.194.0-255,5738,92375,6,340649
18540,0.000723,172.31.36.0-255,66,92441,6,340649
18541,0.000748,172.217.194.0-255,7156,99597,6,340649
18542,0.000752,172.217.194.0-255,766,100363,6,340649
18543,0.000765,172.31.36.0-255,66,100429,6,340649
18544,0.00093,172.217.194.0-255,1484,101913,6,340649
18545,0.000947,172.217.194.0-255,2902,104815,6,340649
18546,0.000969,172.217.194.0-255,5738,110553,6,340649
18547,0.000974,172.31.36.0-255,66,110619,6,340649
18548,0.000996,172.217.194.0-255,2902,113521,6,340649
18549,0.001006,172.31.36.0-255,66,113587,6,340649
18550,0.001022,172.217.194.0-255,1484,115071,6,340649
18551,0.001028,172.217.194.0-255,5738,120809,6,340649
18552,0.001056,172.31.36.0-255,66,120875,6,340649
18553,0.001094,172.217.194.0-255,2184,123059,6,340649
18554,0.001128,172.31.36.0-255,66,123125,6,340649
18555,0.001139,172.217.194.0-255,2902,126027,6,340649
18556,0.001146,172.217.194.0-255,7156,133183,6,340649
18557,0.001149,172.217.194.0-255,1484,134667,6,340649
18558,0.001168,172.31.36.0-255,66,134733,6,340649
18559,0.001176,172.217.194.0-255,5738,140471,6,340649
18560,0.001185,172.31.36.0-255,66,140537,6,340649
18561,0.00119,172.217.194.0-255,2902,143439,6,340649
18562,0.001205,172.217.194.0-255,5738,149177,6,340649
18563,0.00123,172.31.36.0-255,66,149243,6,340649
18564,0.001241,172.217.194.0-255,4320,153563,6,340649
18565,0.001257,172.217.194.0-255,3602,157165,6,340649
18566,0.001273,172.31.36.0-255,66,157231,6,340649
18567,0.001311,172.217.194.0-255,1484,158715,6,340649
18568,0.001318,172.217.194.0-255,2902,161617,6,340649
18569,0.001322,172.217.194.0-255,2902,164519,6,340649
18570,0.001338,172.217.194.0-255,2902,167421,6,340649
18571,0.001343,172.217.194.0-255,2902,170323,6,340649
18572,0.001368,172.217.194.0-255,9992,180315,6,340649
18573,0.001373,172.31.36.0-255,66,180381,6,340649
18574,0.001416,172.217.194.0-255,7156,187537,6,340649
18575,0.001431,172.31.36.0-255,66,187603,6,340649
18576,0.001434,172.217.194.0-255,1484,189087,6,340649
18577,0.001463,172.217.194.0-255,2184,191271,6,340649
18578,0.001467,172.217.194.0-255,2902,194173,6,340649
18579,0.001479,172.31.36.0-255,66,194239,6,340649
18580,0.001491,172.217.194.0-255,7156,201395,6,340649
18581,0.001504,172.31.36.0-255,66,201461,6,340649
18582,0.001522,172.217.194.0-255,2902,204363,6,340649
18583,0.001557,172.31.36.0-255,66,204429,6,340649
18584,0.001613,172.217.194.0-255,7856,212285,6,340649
18585,0.00163,172.31.36.0-255,66,212351,6,340649
18586,0.001667,172.217.194.0-255,7156,219507,6,340649
18587,0.00169,172.217.194.0-255,5738,225245,6,340649
18588,0.001694,172.31.36.0-255,66,225311,6,340649
18589,0.001726,172.31.36.0-255,66,225377,6,340649
18590,0.001774,172.217.194.0-255,4320,229697,6,340649
18591,0.001792,172.217.194.0-255,5020,234717,6,340649
18592,0.001799,172.31.36.0-255,66,234783,6,340649
18593,0.001838,172.217.194.0-255,1484,236267,6,340649
18594,0.001842,172.217.194.0-255,1484,237751,6,340649
18595,0.001849,172.31.36.0-255,66,237817,6,340649
18596,0.001869,172.217.194.0-255,1484,239301,6,340649
18597,0.001875,172.217.194.0-255,5738,245039,6,340649
18598,0.001881,172.217.194.0-255,4320,249359,6,340649
18599,0.001887,172.31.36.0-255,66,249425,6,340649
18600,0.001907,172.217.194.0-255,5738,255163,6,340649
18601,0.001914,172.31.36.0-255,66,255229,6,340649
18602,0.001929,172.217.194.0-255,5738,260967,6,340649
18603,0.001952,172.217.194.0-255,7856,268823,6,340649
18604,0.001959,172.31.36.0-255,66,268889,6,340649
18605,0.001996,172.217.194.0-255,1484,270373,6,340649
18606,0.002009,172.217.194.0-255,2902,273275,6,340649
18607,0.002025,172.217.194.0-255,1484,274759,6,340649
18608,0.002039,172.217.194.0-255,4320,279079,6,340649
18609,0.002043,172.31.36.0-255,66,279145,6,340649
18610,0.002048,172.31.36.0-255,66,279211,6,340649
18611,0.002087,172.217.194.0-255,2902,282113,6,340649
18612,0.002105,172.217.194.0-255,1484,283597,6,340649
18613,0.002125,172.31.36.0-255,66,283663,6,340649
18614,0.002141,172.217.194.0-255,5738,289401,6,340649
18615,0.002155,172.217.194.0-255,2184,291585,6,340649
18616,0.002164,172.31.36.0-255,66,291651,6,340649
18617,0.002185,172.217.194.0-255,5738,297389,6,340649
18618,0.002203,172.217.194.0-255,2902,300291,6,340649
18619,0.002213,172.31.36.0-255,66,300357,6,340649
18620,0.002236,172.217.194.0-255,4320,304677,6,340649
18621,0.002241,172.31.36.0-255,66,304743,6,340649
18622,0.002268,172.217.194.0-255,2902,307645,6,340649
18623,0.002286,172.31.36.0-255,66,307711,6,340649
18624,0.002334,172.217.194.0-255,6438,314149,6,340649
18625,0.002343,172.31.36.0-255,66,314215,6,340649
18626,0.002353,172.217.194.0-255,1484,315699,6,340649
18627,0.002371,172.217.194.0-255,9992,325691,6,340649
18628,0.002386,172.217.194.0-255,4320,330011,6,340649
18629,0.002399,172.31.36.0-255,66,330077,6,340649
18630,0.002474,172.217.194.0-255,10401,340478,6,340649
18631,0.005521,172.31.36.0-255,66,340544,6,340649
18632,0.007766,172.217.194.0-255,105,340649,6,340649
18633,0.0,74.125.24.0-255,153,153,6,178289
18634,3.3e-05,172.31.36.0-255,66,219,6,178289
18635,4.1e-05,74.125.24.0-255,1484,1703,6,178289
18636,4.5e-05,172.31.36.0-255,66,1769,6,178289
18637,5e-05,74.125.24.0-255,2902,4671,6,178289
18638,5.2e-05,172.31.36.0-255,66,4737,6,178289
18639,6.8e-05,74.125.24.0-255,7156,11893,6,178289
18640,7.2e-05,172.31.36.0-255,66,11959,6,178289
18641,0.000103,74.125.24.0-255,2053,14012,6,178289
18642,0.000106,172.31.36.0-255,66,14078,6,178289
18643,0.000217,74.125.24.0-255,1484,15562,6,178289
18644,0.000221,172.31.36.0-255,66,15628,6,178289
18645,0.000227,74.125.24.0-255,2902,18530,6,178289
18646,0.000231,172.31.36.0-255,66,18596,6,178289
18647,0.000243,74.125.24.0-255,5738,24334,6,178289
18648,0.000246,172.31.36.0-255,66,24400,6,178289
18649,0.000292,74.125.24.0-255,8215,32615,6,178289
18650,0.000296,172.31.36.0-255,66,32681,6,178289
18651,0.000304,74.125.24.0-255,8574,41255,6,178289
18652,0.000306,172.31.36.0-255,66,41321,6,178289
18653,0.000309,74.125.24.0-255,1484,42805,6,178289
18654,0.000311,172.31.36.0-255,66,42871,6,178289
18655,0.000347,74.125.24.0-255,5379,48250,6,178289
18656,0.00035,172.31.36.0-255,66,48316,6,178289
18657,0.001035,74.125.24.0-255,1484,49800,6,178289
18658,0.001041,172.31.36.0-255,66,49866,6,178289
18659,0.00105,74.125.24.0-255,2902,52768,6,178289
18660,0.001052,172.31.36.0-255,66,52834,6,178289
18661,0.001065,74.125.24.0-255,5738,58572,6,178289
18662,0.001068,172.31.36.0-255,66,58638,6,178289
18663,0.001071,74.125.24.0-255,1484,60122,6,178289
18664,0.001073,172.31.36.0-255,66,60188,6,178289
18665,0.001123,172.31.36.0-255,66,60254,6,178289
18666,0.001126,74.125.24.0-255,1484,61738,6,178289
18667,0.001153,74.125.24.0-255,8215,69953,6,178289
18668,0.001179,74.125.24.0-255,5738,75691,6,178289
18669,0.001196,74.125.24.0-255,4320,80011,6,178289
18670,0.001199,74.125.24.0-255,1484,81495,6,178289
18671,0.001223,74.125.24.0-255,2902,84397,6,178289
18672,0.001241,74.125.24.0-255,3124,87521,6,178289
18673,0.001683,74.125.24.0-255,1484,89005,6,178289
18674,0.001689,74.125.24.0-255,2902,91907,6,178289
18675,0.001707,74.125.24.0-255,1484,93391,6,178289
18676,0.00172,74.125.24.0-255,4320,97711,6,178289
18677,0.001743,74.125.24.0-255,5738,103449,6,178289
18678,0.001756,74.125.24.0-255,7156,110605,6,178289
18679,0.001786,74.125.24.0-255,10692,121297,6,178289
18680,0.001974,74.125.24.0-255,1484,122781,6,178289
18681,0.001976,74.125.24.0-255,1484,124265,6,178289
18682,0.001995,74.125.24.0-255,1484,125749,6,178289
18683,0.002,74.125.24.0-255,5738,131487,6,178289
18684,0.002006,74.125.24.0-255,5738,137225,6,178289
18685,0.002023,74.125.24.0-255,7156,144381,6,178289
18686,0.002044,74.125.24.0-255,8574,152955,6,178289
18687,0.002061,74.125.24.0-255,2184,155139,6,178289
18688,0.002067,74.125.24.0-255,4320,159459,6,178289
18689,0.002081,74.125.24.0-255,4320,163779,6,178289
18690,0.002096,74.125.24.0-255,2902,166681,6,178289
18691,0.002101,74.125.24.0-255,5738,172419,6,178289
18692,0.006205,172.31.36.0-255,66,172485,6,178289
18693,0.008284,74.125.24.0-255,5738,178223,6,178289
18694,0.00829,172.31.36.0-255,66,178289,6,178289
18695,0.0,172.217.194.0-255,153,153,6,236425
18696,1.1e-05,172.31.36.0-255,66,219,6,236425
18697,3.3e-05,172.217.194.0-255,1484,1703,6,236425
18698,3.8e-05,172.31.36.0-255,66,1769,6,236425
18699,4.4e-05,172.217.194.0-255,2902,4671,6,236425
18700,4.6e-05,172.31.36.0-255,66,4737,6,236425
18701,5.4e-05,172.217.194.0-255,7156,11893,6,236425
18702,5.7e-05,172.31.36.0-255,66,11959,6,236425
18703,6.1e-05,172.217.194.0-255,2038,13997,6,236425
18704,6.4e-05,172.31.36.0-255,66,14063,6,236425
18705,0.000131,172.31.36.0-255,66,14129,6,236425
18706,0.000152,172.31.36.0-255,66,14195,6,236425
18707,0.000184,172.217.194.0-255,6438,20633,6,236425
18708,0.000187,172.31.36.0-255,66,20699,6,236425
18709,0.000231,172.217.194.0-255,1484,22183,6,236425
18710,0.000234,172.31.36.0-255,66,22249,6,236425
18711,0.000239,172.217.194.0-255,2902,25151,6,236425
18712,0.00024,172.31.36.0-255,66,25217,6,236425
18713,0.000244,172.217.194.0-255,1484,26701,6,236425
18714,0.000246,172.31.36.0-255,66,26767,6,236425
18715,0.000282,172.217.194.0-255,4320,31087,6,236425
18716,0.000285,172.31.36.0-255,66,31153,6,236425
18717,0.000292,172.217.194.0-255,6797,37950,6,236425
18718,0.000295,172.31.36.0-255,66,38016,6,236425
18719,0.000582,172.217.194.0-255,645,38661,6,236425
18720,0.000587,172.31.36.0-255,66,38727,6,236425
18721,0.000845,172.217.194.0-255,1484,40211,6,236425
18722,0.000851,172.31.36.0-255,66,40277,6,236425
18723,0.000857,172.217.194.0-255,2902,43179,6,236425
18724,0.000859,172.31.36.0-255,66,43245,6,236425
18725,0.000889,172.217.194.0-255,5738,48983,6,236425
18726,0.000891,172.31.36.0-255,66,49049,6,236425
18727,0.000906,172.217.194.0-255,9992,59041,6,236425
18728,0.000908,172.31.36.0-255,66,59107,6,236425
18729,0.000959,172.217.194.0-255,5738,64845,6,236425
18730,0.000961,172.31.36.0-255,66,64911,6,236425
18731,0.000992,172.217.194.0-255,7308,72219,6,236425
18732,0.000995,172.31.36.0-255,66,72285,6,236425
18733,0.00105,172.217.194.0-255,1484,73769,6,236425
18734,0.001056,172.217.194.0-255,2902,76671,6,236425
18735,0.00106,172.31.36.0-255,66,76737,6,236425
18736,0.001066,172.217.194.0-255,5738,82475,6,236425
18737,0.001069,172.31.36.0-255,66,82541,6,236425
18738,0.001072,172.217.194.0-255,1484,84025,6,236425
18739,0.001107,172.31.36.0-255,66,84091,6,236425
18740,0.001116,172.217.194.0-255,8574,92665,6,236425
18741,0.001119,172.31.36.0-255,66,92731,6,236425
18742,0.001151,172.217.194.0-255,2184,94915,6,236425
18743,0.001154,172.31.36.0-255,66,94981,6,236425
18744,0.001159,172.217.194.0-255,2902,97883,6,236425
18745,0.001161,172.31.36.0-255,66,97949,6,236425
18746,0.001174,172.217.194.0-255,7156,105105,6,236425
18747,0.001176,172.31.36.0-255,66,105171,6,236425
18748,0.001215,172.31.36.0-255,66,105237,6,236425
18749,0.001223,172.217.194.0-255,7856,113093,6,236425
18750,0.001225,172.31.36.0-255,66,113159,6,236425
18751,0.001419,172.217.194.0-255,1484,114643,6,236425
18752,0.001434,172.217.194.0-255,2902,117545,6,236425
18753,0.001437,172.31.36.0-255,66,117611,6,236425
18754,0.001444,172.217.194.0-255,4320,121931,6,236425
18755,0.001446,172.31.36.0-255,66,121997,6,236425
18756,0.001467,172.217.194.0-255,1484,123481,6,236425
18757,0.001474,172.217.194.0-255,7156,130637,6,236425
18758,0.001477,172.31.36.0-255,66,130703,6,236425
18759,0.001506,172.217.194.0-255,2902,133605,6,236425
18760,0.001509,172.31.36.0-255,66,133671,6,236425
18761,0.001529,172.31.36.0-255,66,133737,6,236425
18762,0.001554,172.217.194.0-255,1484,135221,6,236425
18763,0.001559,172.217.194.0-255,2902,138123,6,236425
18764,0.001561,172.31.36.0-255,66,138189,6,236425
18765,0.001568,172.217.194.0-255,5738,143927,6,236425
18766,0.00157,172.31.36.0-255,66,143993,6,236425
18767,0.001592,172.217.194.0-255,2902,146895,6,236425
18768,0.001595,172.31.36.0-255,66,146961,6,236425
18769,0.001627,172.217.194.0-255,9992,156953,6,236425
18770,0.001635,172.31.36.0-255,66,157019,6,236425
18771,0.001645,172.217.194.0-255,10692,167711,6,236425
18772,0.001647,172.31.36.0-255,66,167777,6,236425
18773,0.001697,172.31.36.0-255,66,167843,6,236425
18774,0.001738,172.31.36.0-255,66,167909,6,236425
18775,0.001765,172.217.194.0-255,5020,172929,6,236425
18776,0.001768,172.31.36.0-255,66,172995,6,236425
18777,0.001787,172.31.36.0-255,66,173061,6,236425
18778,0.001796,172.217.194.0-255,9274,182335,6,236425
18779,0.001798,172.31.36.0-255,66,182401,6,236425
18780,0.002111,172.217.194.0-255,1484,183885,6,236425
18781,0.002128,172.217.194.0-255,2902,186787,6,236425
18782,0.002132,172.31.36.0-255,66,186853,6,236425
18783,0.002139,172.217.194.0-255,5738,192591,6,236425
18784,0.002141,172.31.36.0-255,66,192657,6,236425
18785,0.002166,172.217.194.0-255,1484,194141,6,236425
18786,0.002169,172.31.36.0-255,78,194219,6,236425
18787,0.002178,172.217.194.0-255,9992,204211,6,236425
18788,0.002186,172.31.36.0-255,66,204277,6,236425
18789,0.002226,172.31.36.0-255,66,204343,6,236425
18790,0.002273,172.31.36.0-255,66,204409,6,236425
18791,0.002279,172.217.194.0-255,4320,208729,6,236425
18792,0.002281,172.31.36.0-255,66,208795,6,236425
18793,0.002292,172.217.194.0-255,4320,213115,6,236425
18794,0.002294,172.31.36.0-255,66,213181,6,236425
18795,0.002297,172.217.194.0-255,1484,214665,6,236425
18796,0.002333,172.217.194.0-255,10692,225357,6,236425
18797,0.002337,172.31.36.0-255,66,225423,6,236425
18798,0.002342,172.217.194.0-255,4320,229743,6,236425
18799,0.002344,172.31.36.0-255,66,229809,6,236425
18800,0.002347,172.217.194.0-255,1484,231293,6,236425
18801,0.002404,172.31.36.0-255,66,231359,6,236425
18802,0.002407,172.217.194.0-255,1484,232843,6,236425
18803,0.002412,172.217.194.0-255,3174,236017,6,236425
18804,0.002415,172.31.36.0-255,66,236083,6,236425
18805,0.002449,172.217.194.0-255,105,236188,6,236425
18806,0.004579,172.31.36.0-255,66,236254,6,236425
18807,0.004627,172.31.36.0-255,105,236359,6,236425
18808,0.006624,172.217.194.0-255,66,236425,6,236425
18809,0.0,74.125.24.0-255,150,150,6,293509
18810,2.2e-05,172.31.36.0-255,66,216,6,293509
18811,3e-05,74.125.24.0-255,1484,1700,6,293509
18812,3.6e-05,172.31.36.0-255,66,1766,6,293509
18813,4.2e-05,74.125.24.0-255,2902,4668,6,293509
18814,4.5e-05,172.31.36.0-255,66,4734,6,293509
18815,5.2e-05,74.125.24.0-255,7156,11890,6,293509
18816,5.5e-05,172.31.36.0-255,66,11956,6,293509
18817,6.1e-05,74.125.24.0-255,3472,15428,6,293509
18818,6.4e-05,172.31.36.0-255,66,15494,6,293509
18819,7e-05,74.125.24.0-255,4320,19814,6,293509
18820,7.3e-05,172.31.36.0-255,66,19880,6,293509
18821,8.2e-05,74.125.24.0-255,9992,29872,6,293509
18822,8.6e-05,172.31.36.0-255,66,29938,6,293509
18823,0.00013,172.31.36.0-255,66,30004,6,293509
18824,0.000151,74.125.24.0-255,3602,33606,6,293509
18825,0.000154,172.31.36.0-255,66,33672,6,293509
18826,0.000157,74.125.24.0-255,1484,35156,6,293509
18827,0.000159,172.31.36.0-255,66,35222,6,293509
18828,0.000181,74.125.24.0-255,2902,38124,6,293509
18829,0.000184,172.31.36.0-255,66,38190,6,293509
18830,0.000191,74.125.24.0-255,5738,43928,6,293509
18831,0.000193,172.31.36.0-255,66,43994,6,293509
18832,0.000261,74.125.24.0-255,5738,49732,6,293509
18833,0.000265,172.31.36.0-255,66,49798,6,293509
18834,0.000281,74.125.24.0-255,1451,51249,6,293509
18835,0.000283,172.31.36.0-255,66,51315,6,293509
18836,0.000291,74.125.24.0-255,7156,58471,6,293509
18837,0.000293,172.31.36.0-255,66,58537,6,293509
18838,0.000301,74.125.24.0-255,7156,65693,6,293509
18839,0.000303,172.31.36.0-255,66,65759,6,293509
18840,0.000333,74.125.24.0-255,8574,74333,6,293509
18841,0.000336,172.31.36.0-255,66,74399,6,293509
18842,0.000341,74.125.24.0-255,2902,77301,6,293509
18843,0.000343,172.31.36.0-255,66,77367,6,293509
18844,0.000371,74.125.24.0-255,7539,84906,6,293509
18845,0.000374,172.31.36.0-255,66,84972,6,293509
18846,0.000389,74.125.24.0-255,5738,90710,6,293509
18847,0.000392,172.31.36.0-255,66,90776,6,293509
18848,0.000412,74.125.24.0-255,5738,96514,6,293509
18849,0.000414,172.31.36.0-255,66,96580,6,293509
18850,0.000434,74.125.24.0-255,5263,101843,6,293509
18851,0.000437,172.31.36.0-255,66,101909,6,293509
18852,0.000463,74.125.24.0-255,7156,109065,6,293509
18853,0.000465,172.31.36.0-255,66,109131,6,293509
18854,0.000489,74.125.24.0-255,9758,118889,6,293509
18855,0.000491,172.31.36.0-255,66,118955,6,293509
18856,0.000781,74.125.24.0-255,1484,120439,6,293509
18857,0.000806,74.125.24.0-255,2902,123341,6,293509
18858,0.000811,172.31.36.0-255,66,123407,6,293509
18859,0.000818,74.125.24.0-255,5738,129145,6,293509
18860,0.000821,172.31.36.0-255,66,129211,6,293509
18861,0.000855,74.125.24.0-255,9992,139203,6,293509
18862,0.00086,172.31.36.0-255,66,139269,6,293509
18863,0.00089,172.31.36.0-255,66,139335,6,293509
18864,0.000902,74.125.24.0-255,2184,141519,6,293509
18865,0.000904,172.31.36.0-255,66,141585,6,293509
18866,0.001026,74.125.24.0-255,1484,143069,6,293509
18867,0.001031,74.125.24.0-255,2902,145971,6,293509
18868,0.001036,172.31.36.0-255,66,146037,6,293509
18869,0.001047,74.125.24.0-255,4320,150357,6,293509
18870,0.001049,172.31.36.0-255,66,150423,6,293509
18871,0.001074,74.125.24.0-255,1484,151907,6,293509
18872,0.001083,74.125.24.0-255,7156,159063,6,293509
18873,0.001085,172.31.36.0-255,66,159129,6,293509
18874,0.001103,74.125.24.0-255,5738,164867,6,293509
18875,0.001105,172.31.36.0-255,66,164933,6,293509
18876,0.001112,74.125.24.0-255,5738,170671,6,293509
18877,0.001114,172.31.36.0-255,66,170737,6,293509
18878,0.001138,74.125.24.0-255,4320,175057,6,293509
18879,0.00114,172.31.36.0-255,66,175123,6,293509
18880,0.001157,74.125.24.0-255,766,175889,6,293509
18881,0.001177,74.125.24.0-255,5738,181627,6,293509
18882,0.00118,172.31.36.0-255,66,181693,6,293509
18883,0.001204,74.125.24.0-255,7156,188849,6,293509
18884,0.001207,172.31.36.0-255,66,188915,6,293509
18885,0.001253,74.125.24.0-255,6438,195353,6,293509
18886,0.001257,172.31.36.0-255,66,195419,6,293509
18887,0.001265,172.31.36.0-255,66,195485,6,293509
18888,0.001407,74.125.24.0-255,1484,196969,6,293509
18889,0.001427,74.125.24.0-255,2902,199871,6,293509
18890,0.00143,172.31.36.0-255,66,199937,6,293509
18891,0.001434,74.125.24.0-255,1484,201421,6,293509
18892,0.001453,74.125.24.0-255,1484,202905,6,293509
18893,0.001455,172.31.36.0-255,66,202971,6,293509
18894,0.001463,74.125.24.0-255,7156,210127,6,293509
18895,0.001465,172.31.36.0-255,66,210193,6,293509
18896,0.001537,172.31.36.0-255,66,210259,6,293509
18897,0.001543,74.125.24.0-255,3602,213861,6,293509
18898,0.001545,172.31.36.0-255,66,213927,6,293509
18899,0.001744,74.125.24.0-255,1484,215411,6,293509
18900,0.001751,74.125.24.0-255,2902,218313,6,293509
18901,0.001754,172.31.36.0-255,66,218379,6,293509
18902,0.00178,74.125.24.0-255,5738,224117,6,293509
18903,0.001782,172.31.36.0-255,66,224183,6,293509
18904,0.001786,74.125.24.0-255,1484,225667,6,293509
18905,0.001827,172.31.36.0-255,66,225733,6,293509
18906,0.001836,74.125.24.0-255,8574,234307,6,293509
18907,0.001839,172.31.36.0-255,66,234373,6,293509
18908,0.001854,74.125.24.0-255,2902,237275,6,293509
18909,0.001857,172.31.36.0-255,66,237341,6,293509
18910,0.001892,172.31.36.0-255,66,237407,6,293509
18911,0.001914,74.125.24.0-255,8574,245981,6,293509
18912,0.001917,172.31.36.0-255,66,246047,6,293509
18913,0.00194,74.125.24.0-255,3602,249649,6,293509
18914,0.001948,74.125.24.0-255,8574,258223,6,293509
18915,0.001952,172.31.36.0-255,66,258289,6,293509
18916,0.001955,172.31.36.0-255,66,258355,6,293509
18917,0.001967,74.125.24.0-255,4320,262675,6,293509
18918,0.001969,74.125.24.0-255,1484,264159,6,293509
18919,0.001971,74.125.24.0-255,1484,265643,6,293509
18920,0.001974,172.31.36.0-255,66,265709,6,293509
18921,0.001978,172.31.36.0-255,66,265775,6,293509
18922,0.002012,74.125.24.0-255,5738,271513,6,293509
18923,0.002017,172.31.36.0-255,66,271579,6,293509
18924,0.002035,172.31.36.0-255,66,271645,6,293509
18925,0.004022,74.125.24.0-255,5738,277383,6,293509
18926,0.004028,172.31.36.0-255,66,277449,6,293509
18927,0.005977,74.125.24.0-255,5738,283187,6,293509
18928,0.005984,172.31.36.0-255,66,283253,6,293509
18929,0.007936,74.125.24.0-255,4320,287573,6,293509
18930,0.007939,172.31.36.0-255,66,287639,6,293509
18931,0.007952,74.125.24.0-255,1484,289123,6,293509
18932,0.009893,74.125.24.0-255,4320,293443,6,293509
18933,0.009898,172.31.36.0-255,66,293509,6,293509
18934,0.0,74.125.130.0-255,153,153,6,200890
18935,2.3e-05,172.31.36.0-255,66,219,6,200890
18936,5e-05,74.125.130.0-255,1484,1703,6,200890
18937,5.5e-05,172.31.36.0-255,66,1769,6,200890
18938,7.6e-05,74.125.130.0-255,1484,3253,6,200890
18939,7.9e-05,172.31.36.0-255,66,3319,6,200890
18940,9.8e-05,74.125.130.0-255,2902,6221,6,200890
18941,0.000101,172.31.36.0-255,66,6287,6,200890
18942,0.000128,74.125.130.0-255,4320,10607,6,200890
18943,0.000131,172.31.36.0-255,66,10673,6,200890
18944,0.000158,74.125.130.0-255,4921,15594,6,200890
18945,0.000162,172.31.36.0-255,66,15660,6,200890
18946,0.000168,74.125.130.0-255,4320,19980,6,200890
18947,0.000171,172.31.36.0-255,66,20046,6,200890
18948,0.000196,74.125.130.0-255,4320,24366,6,200890
18949,0.000199,172.31.36.0-255,66,24432,6,200890
18950,0.000251,74.125.130.0-255,1484,25916,6,200890
18951,0.000254,172.31.36.0-255,66,25982,6,200890
18952,0.00028,74.125.130.0-255,5379,31361,6,200890
18953,0.000283,172.31.36.0-255,66,31427,6,200890
18954,0.000586,74.125.130.0-255,1484,32911,6,200890
18955,0.00059,172.31.36.0-255,66,32977,6,200890
18956,0.000618,74.125.130.0-255,2902,35879,6,200890
18957,0.000622,172.31.36.0-255,66,35945,6,200890
18958,0.000625,74.125.130.0-255,1484,37429,6,200890
18959,0.000627,172.31.36.0-255,66,37495,6,200890
18960,0.000641,74.125.130.0-255,2902,40397,6,200890
18961,0.000644,172.31.36.0-255,66,40463,6,200890
18962,0.000674,74.125.130.0-255,5738,46201,6,200890
18963,0.000676,172.31.36.0-255,66,46267,6,200890
18964,0.000695,74.125.130.0-255,2543,48810,6,200890
18965,0.000698,172.31.36.0-255,66,48876,6,200890
18966,0.000717,74.125.130.0-255,2902,51778,6,200890
18967,0.000738,74.125.130.0-255,5738,57516,6,200890
18968,0.000775,74.125.130.0-255,5738,63254,6,200890
18969,0.000794,74.125.130.0-255,2793,66047,6,200890
18970,0.000797,74.125.130.0-255,405,66452,6,200890
18971,0.000882,74.125.130.0-255,1484,67936,6,200890
18972,0.000904,74.125.130.0-255,2902,70838,6,200890
18973,0.000917,74.125.130.0-255,2902,73740,6,200890
18974,0.000931,74.125.130.0-255,2902,76642,6,200890
18975,0.000934,74.125.130.0-255,1484,78126,6,200890
18976,0.000955,74.125.130.0-255,5738,83864,6,200890
18977,0.000981,74.125.130.0-255,2902,86766,6,200890
18978,0.001046,74.125.130.0-255,2184,88950,6,200890
18979,0.001483,172.31.36.0-255,66,89016,6,200890
18980,0.001518,74.125.130.0-255,1484,90500,6,200890
18981,0.001535,74.125.130.0-255,1484,91984,6,200890
18982,0.00155,74.125.130.0-255,2902,94886,6,200890
18983,0.001578,74.125.130.0-255,1484,96370,6,200890
18984,0.001583,74.125.130.0-255,2902,99272,6,200890
18985,0.001593,74.125.130.0-255,1484,100756,6,200890
18986,0.001608,74.125.130.0-255,4320,105076,6,200890
18987,0.001636,74.125.130.0-255,4320,109396,6,200890
18988,0.001662,74.125.130.0-255,4320,113716,6,200890
18989,0.001674,74.125.130.0-255,1484,115200,6,200890
18990,0.001677,74.125.130.0-255,1484,116684,6,200890
18991,0.001696,74.125.130.0-255,2902,119586,6,200890
18992,0.001725,74.125.130.0-255,1484,121070,6,200890
18993,0.001743,74.125.130.0-255,2184,123254,6,200890
18994,0.0018,172.31.36.0-255,66,123320,6,200890
18995,0.00206,74.125.130.0-255,1484,124804,6,200890
18996,0.002077,74.125.130.0-255,1484,126288,6,200890
18997,0.002092,172.31.36.0-255,66,126354,6,200890
18998,0.002106,74.125.130.0-255,2902,129256,6,200890
18999,0.002119,172.31.36.0-255,66,129322,6,200890
19000,0.00213,74.125.130.0-255,5738,135060,6,200890
19001,0.002135,74.125.130.0-255,2902,137962,6,200890
19002,0.002139,172.31.36.0-255,66,138028,6,200890
19003,0.002164,74.125.130.0-255,4320,142348,6,200890
19004,0.002181,74.125.130.0-255,5738,148086,6,200890
19005,0.002187,172.31.36.0-255,66,148152,6,200890
19006,0.002208,74.125.130.0-255,9274,157426,6,200890
19007,0.002223,74.125.130.0-255,1484,158910,6,200890
19008,0.002232,172.31.36.0-255,66,158976,6,200890
19009,0.002256,74.125.130.0-255,8574,167550,6,200890
19010,0.002261,74.125.130.0-255,4320,171870,6,200890
19011,0.002268,172.31.36.0-255,66,171936,6,200890
19012,0.002304,74.125.130.0-255,7156,179092,6,200890
19013,0.002321,172.31.36.0-255,66,179158,6,200890
19014,0.002329,74.125.130.0-255,7156,186314,6,200890
19015,0.002333,74.125.130.0-255,2902,189216,6,200890
19016,0.002338,172.31.36.0-255,66,189282,6,200890
19017,0.004624,74.125.130.0-255,5738,195020,6,200890
19018,0.004631,172.31.36.0-255,66,195086,6,200890
19019,0.006919,74.125.130.0-255,5738,200824,6,200890
19020,0.008742,172.31.36.0-255,66,200890,6,200890
19021,0.0,74.125.24.0-255,153,153,6,135742
19022,3.5e-05,172.31.36.0-255,66,219,6,135742
19023,4.2e-05,74.125.24.0-255,1484,1703,6,135742
19024,4.6e-05,172.31.36.0-255,66,1769,6,135742
19025,5.1e-05,74.125.24.0-255,2902,4671,6,135742
19026,5.3e-05,172.31.36.0-255,66,4737,6,135742
19027,6e-05,74.125.24.0-255,5738,10475,6,135742
19028,6.2e-05,172.31.36.0-255,66,10541,6,135742
19029,8.3e-05,74.125.24.0-255,1484,12025,6,135742
19030,8.5e-05,172.31.36.0-255,66,12091,6,135742
19031,8.9e-05,74.125.24.0-255,2066,14157,6,135742
19032,9.1e-05,172.31.36.0-255,66,14223,6,135742
19033,9.9e-05,74.125.24.0-255,9992,24215,6,135742
19034,0.000102,172.31.36.0-255,66,24281,6,135742
19035,0.000126,74.125.24.0-255,1484,25765,6,135742
19036,0.000129,172.31.36.0-255,66,25831,6,135742
19037,0.000142,172.31.36.0-255,66,25897,6,135742
19038,0.000178,74.125.24.0-255,4320,30217,6,135742
19039,0.000181,172.31.36.0-255,66,30283,6,135742
19040,0.000204,74.125.24.0-255,7856,38139,6,135742
19041,0.000207,172.31.36.0-255,66,38205,6,135742
19042,0.000213,74.125.24.0-255,5738,43943,6,135742
19043,0.000215,172.31.36.0-255,66,44009,6,135742
19044,0.000244,74.125.24.0-255,7069,51078,6,135742
19045,0.000247,172.31.36.0-255,66,51144,6,135742
19046,0.00025,74.125.24.0-255,384,51528,6,135742
19047,0.000252,172.31.36.0-255,66,51594,6,135742
19048,0.000286,74.125.24.0-255,1484,53078,6,135742
19049,0.000289,172.31.36.0-255,66,53144,6,135742
19050,0.000295,74.125.24.0-255,2902,56046,6,135742
19051,0.000298,172.31.36.0-255,66,56112,6,135742
19052,0.000302,74.125.24.0-255,2902,59014,6,135742
19053,0.000309,172.31.36.0-255,66,59080,6,135742
19054,0.000331,74.125.24.0-255,2902,61982,6,135742
19055,0.000336,172.31.36.0-255,66,62048,6,135742
19056,0.000345,74.125.24.0-255,1484,63532,6,135742
19057,0.000353,172.31.36.0-255,66,63598,6,135742
19058,0.000366,74.125.24.0-255,5738,69336,6,135742
19059,0.000369,74.125.24.0-255,2902,72238,6,135742
19060,0.000371,172.31.36.0-255,66,72304,6,135742
19061,0.000386,74.125.24.0-255,766,73070,6,135742
19062,0.000386,172.31.36.0-255,66,73136,6,135742
19063,0.001029,172.31.36.0-255,66,73202,6,135742
19064,0.001145,74.125.24.0-255,1484,74686,6,135742
19065,0.001153,74.125.24.0-255,1484,76170,6,135742
19066,0.001156,172.31.36.0-255,66,76236,6,135742
19067,0.001175,74.125.24.0-255,1484,77720,6,135742
19068,0.001181,74.125.24.0-255,4320,82040,6,135742
19069,0.001196,74.125.24.0-255,1484,83524,6,135742
19070,0.0012,74.125.24.0-255,1484,85008,6,135742
19071,0.001223,74.125.24.0-255,5738,90746,6,135742
19072,0.001249,74.125.24.0-255,2902,93648,6,135742
19073,0.001253,74.125.24.0-255,2184,95832,6,135742
19074,0.001953,74.125.24.0-255,1484,97316,6,135742
19075,0.001961,74.125.24.0-255,2902,100218,6,135742
19076,0.001972,74.125.24.0-255,1484,101702,6,135742
19077,0.001986,74.125.24.0-255,4320,106022,6,135742
19078,0.001989,74.125.24.0-255,1484,107506,6,135742
19079,0.002004,74.125.24.0-255,1484,108990,6,135742
19080,0.002007,74.125.24.0-255,1484,110474,6,135742
19081,0.002021,74.125.24.0-255,8574,119048,6,135742
19082,0.002044,74.125.24.0-255,2902,121950,6,135742
19083,0.002069,74.125.24.0-255,7156,129106,6,135742
19084,0.002071,74.125.24.0-255,766,129872,6,135742
19085,0.006645,172.31.36.0-255,66,129938,6,135742
19086,0.008684,74.125.24.0-255,5738,135676,6,135742
19087,0.008693,172.31.36.0-255,66,135742,6,135742
19088,0.0,74.125.24.0-255,153,153,6,206003
19089,2.3e-05,172.31.36.0-255,66,219,6,206003
19090,2.9e-05,74.125.24.0-255,1484,1703,6,206003
19091,3.4e-05,172.31.36.0-255,66,1769,6,206003
19092,4e-05,74.125.24.0-255,2902,4671,6,206003
19093,4.3e-05,172.31.36.0-255,66,4737,6,206003
19094,5.1e-05,74.125.24.0-255,7156,11893,6,206003
19095,5.3e-05,172.31.36.0-255,66,11959,6,206003
19096,5.7e-05,74.125.24.0-255,2081,14040,6,206003
19097,6e-05,172.31.36.0-255,66,14106,6,206003
19098,9.6e-05,74.125.24.0-255,5738,19844,6,206003
19099,9.9e-05,172.31.36.0-255,66,19910,6,206003
19100,0.000123,74.125.24.0-255,2902,22812,6,206003
19101,0.000125,172.31.36.0-255,66,22878,6,206003
19102,0.000144,74.125.24.0-255,5738,28616,6,206003
19103,0.000146,172.31.36.0-255,66,28682,6,206003
19104,0.00017,74.125.24.0-255,2543,31225,6,206003
19105,0.000173,172.31.36.0-255,66,31291,6,206003
19106,0.000289,74.125.24.0-255,1484,32775,6,206003
19107,0.000293,172.31.36.0-255,66,32841,6,206003
19108,0.000299,74.125.24.0-255,2902,35743,6,206003
19109,0.000301,172.31.36.0-255,66,35809,6,206003
19110,0.000331,74.125.24.0-255,5738,41547,6,206003
19111,0.000334,172.31.36.0-255,66,41613,6,206003
19112,0.000338,74.125.24.0-255,2902,44515,6,206003
19113,0.00034,172.31.36.0-255,66,44581,6,206003
19114,0.000363,74.125.24.0-255,5379,49960,6,206003
19115,0.000366,172.31.36.0-255,66,50026,6,206003
19116,0.000374,74.125.24.0-255,8574,58600,6,206003
19117,0.000377,172.31.36.0-255,66,58666,6,206003
19118,0.000384,74.125.24.0-255,5738,64404,6,206003
19119,0.000386,172.31.36.0-255,66,64470,6,206003
19120,0.000401,74.125.24.0-255,1433,65903,6,206003
19121,0.000417,74.125.24.0-255,116,66019,6,206003
19122,0.000492,74.125.24.0-255,1484,67503,6,206003
19123,0.000497,74.125.24.0-255,2902,70405,6,206003
19124,0.000517,74.125.24.0-255,5738,76143,6,206003
19125,0.000525,172.31.36.0-255,66,76209,6,206003
19126,0.000542,74.125.24.0-255,6797,83006,6,206003
19127,0.000561,172.31.36.0-255,66,83072,6,206003
19128,0.000592,74.125.24.0-255,5738,88810,6,206003
19129,0.000606,172.31.36.0-255,66,88876,6,206003
19130,0.000614,74.125.24.0-255,1484,90360,6,206003
19131,0.000622,74.125.24.0-255,8574,98934,6,206003
19132,0.000628,172.31.36.0-255,66,99000,6,206003
19133,0.000637,74.125.24.0-255,1387,100387,6,206003
19134,0.000964,74.125.24.0-255,1484,101871,6,206003
19135,0.000968,172.31.36.0-255,66,101937,6,206003
19136,0.000973,74.125.24.0-255,2902,104839,6,206003
19137,0.000976,74.125.24.0-255,1484,106323,6,206003
19138,0.000982,172.31.36.0-255,66,106389,6,206003
19139,0.000993,74.125.24.0-255,4320,110709,6,206003
19140,0.001,74.125.24.0-255,7156,117865,6,206003
19141,0.001005,172.31.36.0-255,66,117931,6,206003
19142,0.001028,74.125.24.0-255,4320,122251,6,206003
19143,0.001046,172.31.36.0-255,66,122317,6,206003
19144,0.0011,74.125.24.0-255,1484,123801,6,206003
19145,0.00112,74.125.24.0-255,2902,126703,6,206003
19146,0.001125,74.125.24.0-255,2902,129605,6,206003
19147,0.001139,74.125.24.0-255,2902,132507,6,206003
19148,0.001155,74.125.24.0-255,7156,139663,6,206003
19149,0.001159,172.31.36.0-255,66,139729,6,206003
19150,0.001169,172.31.36.0-255,66,139795,6,206003
19151,0.00118,74.125.24.0-255,2902,142697,6,206003
19152,0.001219,74.125.24.0-255,2184,144881,6,206003
19153,0.001238,172.31.36.0-255,66,144947,6,206003
19154,0.001557,74.125.24.0-255,1484,146431,6,206003
19155,0.001577,74.125.24.0-255,2902,149333,6,206003
19156,0.00158,172.31.36.0-255,66,149399,6,206003
19157,0.001587,74.125.24.0-255,5738,155137,6,206003
19158,0.001632,172.31.36.0-255,66,155203,6,206003
19159,0.001665,74.125.24.0-255,7156,162359,6,206003
19160,0.00167,74.125.24.0-255,3602,165961,6,206003
19161,0.001687,172.31.36.0-255,66,166027,6,206003
19162,0.001927,74.125.24.0-255,1484,167511,6,206003
19163,0.001944,74.125.24.0-255,2902,170413,6,206003
19164,0.001961,172.31.36.0-255,66,170479,6,206003
19165,0.001968,74.125.24.0-255,5738,176217,6,206003
19166,0.001971,74.125.24.0-255,1484,177701,6,206003
19167,0.001975,172.31.36.0-255,66,177767,6,206003
19168,0.002011,74.125.24.0-255,1484,179251,6,206003
19169,0.002028,74.125.24.0-255,9274,188525,6,206003
19170,0.002036,172.31.36.0-255,66,188591,6,206003
19171,0.004103,74.125.24.0-255,5738,194329,6,206003
19172,0.00411,172.31.36.0-255,66,194395,6,206003
19173,0.006141,74.125.24.0-255,5738,200133,6,206003
19174,0.007531,172.31.36.0-255,66,200199,6,206003
19175,0.009607,74.125.24.0-255,5738,205937,6,206003
19176,0.009614,172.31.36.0-255,66,206003,6,206003
19177,0.0,74.125.24.0-255,153,153,6,220132
19178,2.5e-05,172.31.36.0-255,66,219,6,220132
19179,3.3e-05,74.125.24.0-255,1484,1703,6,220132
19180,3.8e-05,172.31.36.0-255,66,1769,6,220132
19181,5.3e-05,74.125.24.0-255,2902,4671,6,220132
19182,5.6e-05,172.31.36.0-255,66,4737,6,220132
19183,6.3e-05,74.125.24.0-255,5738,10475,6,220132
19184,6.6e-05,172.31.36.0-255,66,10541,6,220132
19185,7.1e-05,74.125.24.0-255,3423,13964,6,220132
19186,7.5e-05,172.31.36.0-255,66,14030,6,220132
19187,0.000305,74.125.24.0-255,1484,15514,6,220132
19188,0.000313,172.31.36.0-255,66,15580,6,220132
19189,0.000319,74.125.24.0-255,2902,18482,6,220132
19190,0.000322,172.31.36.0-255,66,18548,6,220132
19191,0.000333,74.125.24.0-255,4320,22868,6,220132
19192,0.000335,172.31.36.0-255,66,22934,6,220132
19193,0.000364,74.125.24.0-255,1484,24418,6,220132
19194,0.000367,172.31.36.0-255,66,24484,6,220132
19195,0.000375,74.125.24.0-255,6797,31281,6,220132
19196,0.000377,172.31.36.0-255,66,31347,6,220132
19197,0.000405,74.125.24.0-255,2902,34249,6,220132
19198,0.000407,172.31.36.0-255,66,34315,6,220132
19199,0.000438,74.125.24.0-255,4320,38635,6,220132
19200,0.000442,172.31.36.0-255,66,38701,6,220132
19201,0.000458,172.31.36.0-255,66,38767,6,220132
19202,0.000464,74.125.24.0-255,5738,44505,6,220132
19203,0.000467,172.31.36.0-255,66,44571,6,220132
19204,0.000473,74.125.24.0-255,5020,49591,6,220132
19205,0.000476,172.31.36.0-255,66,49657,6,220132
19206,0.000503,74.125.24.0-255,362,50019,6,220132
19207,0.000506,172.31.36.0-255,66,50085,6,220132
19208,0.000576,74.125.24.0-255,381,50466,6,220132
19209,0.000796,74.125.24.0-255,1484,51950,6,220132
19210,0.000801,172.31.36.0-255,66,52016,6,220132
19211,0.000806,74.125.24.0-255,2902,54918,6,220132
19212,0.000809,172.31.36.0-255,66,54984,6,220132
19213,0.000843,74.125.24.0-255,5738,60722,6,220132
19214,0.000846,172.31.36.0-255,66,60788,6,220132
19215,0.000852,74.125.24.0-255,4320,65108,6,220132
19216,0.000854,172.31.36.0-255,66,65174,6,220132
19217,0.000889,74.125.24.0-255,8574,73748,6,220132
19218,0.000892,172.31.36.0-255,66,73814,6,220132
19219,0.000897,74.125.24.0-255,4320,78134,6,220132
19220,0.0009,172.31.36.0-255,66,78200,6,220132
19221,0.000935,74.125.24.0-255,6438,84638,6,220132
19222,0.000938,172.31.36.0-255,66,84704,6,220132
19223,0.001025,74.125.24.0-255,1484,86188,6,220132
19224,0.001044,74.125.24.0-255,2902,89090,6,220132
19225,0.001047,172.31.36.0-255,66,89156,6,220132
19226,0.001052,74.125.24.0-255,2902,92058,6,220132
19227,0.001055,172.31.36.0-255,66,92124,6,220132
19228,0.001088,74.125.24.0-255,2902,95026,6,220132
19229,0.001091,172.31.36.0-255,66,95092,6,220132
19230,0.001096,74.125.24.0-255,2902,97994,6,220132
19231,0.001098,172.31.36.0-255,66,98060,6,220132
19232,0.001114,74.125.24.0-255,5738,103798,6,220132
19233,0.001121,172.31.36.0-255,66,103864,6,220132
19234,0.00115,74.125.24.0-255,4320,108184,6,220132
19235,0.001155,74.125.24.0-255,4320,112504,6,220132
19236,0.001166,172.31.36.0-255,66,112570,6,220132
19237,0.001169,172.31.36.0-255,66,112636,6,220132
19238,0.001172,74.125.24.0-255,1484,114120,6,220132
19239,0.001205,74.125.24.0-255,5020,119140,6,220132
19240,0.001208,172.31.36.0-255,66,119206,6,220132
19241,0.001223,74.125.24.0-255,1484,120690,6,220132
19242,0.001229,74.125.24.0-255,2902,123592,6,220132
19243,0.001231,172.31.36.0-255,66,123658,6,220132
19244,0.001258,74.125.24.0-255,5738,129396,6,220132
19245,0.001261,172.31.36.0-255,66,129462,6,220132
19246,0.001264,74.125.24.0-255,1484,130946,6,220132
19247,0.001289,74.125.24.0-255,7156,138102,6,220132
19248,0.001295,74.125.24.0-255,5738,143840,6,220132
19249,0.001299,172.31.36.0-255,66,143906,6,220132
19250,0.001302,172.31.36.0-255,66,143972,6,220132
19251,0.001321,74.125.24.0-255,4320,148292,6,220132
19252,0.001324,172.31.36.0-255,66,148358,6,220132
19253,0.001331,74.125.24.0-255,5020,153378,6,220132
19254,0.001334,172.31.36.0-255,66,153444,6,220132
19255,0.001498,74.125.24.0-255,1484,154928,6,220132
19256,0.001512,74.125.24.0-255,2902,157830,6,220132
19257,0.001515,172.31.36.0-255,66,157896,6,220132
19258,0.001519,74.125.24.0-255,1484,159380,6,220132
19259,0.001541,74.125.24.0-255,1484,160864,6,220132
19260,0.001544,172.31.36.0-255,66,160930,6,220132
19261,0.001552,74.125.24.0-255,7156,168086,6,220132
19262,0.001554,172.31.36.0-255,66,168152,6,220132
19263,0.001593,74.125.24.0-255,2902,171054,6,220132
19264,0.001596,172.31.36.0-255,66,171120,6,220132
19265,0.001625,74.125.24.0-255,9992,181112,6,220132
19266,0.001628,172.31.36.0-255,66,181178,6,220132
19267,0.001656,74.125.24.0-255,6438,187616,6,220132
19268,0.001659,172.31.36.0-255,66,187682,6,220132
19269,0.002517,74.125.24.0-255,1484,189166,6,220132
19270,0.002524,74.125.24.0-255,2902,192068,6,220132
19271,0.002528,172.31.36.0-255,66,192134,6,220132
19272,0.002565,74.125.24.0-255,5738,197872,6,220132
19273,0.002568,172.31.36.0-255,66,197938,6,220132
19274,0.002598,74.125.24.0-255,2902,200840,6,220132
19275,0.0026,172.31.36.0-255,66,200906,6,220132
19276,0.002632,74.125.24.0-255,4320,205226,6,220132
19277,0.002635,172.31.36.0-255,66,205292,6,220132
19278,0.00264,74.125.24.0-255,2902,208194,6,220132
19279,0.002641,172.31.36.0-255,66,208260,6,220132
19280,0.005195,74.125.24.0-255,2902,211162,6,220132
19281,0.005206,172.31.36.0-255,66,211228,6,220132
19282,0.005234,74.125.24.0-255,2902,214130,6,220132
19283,0.005237,172.31.36.0-255,66,214196,6,220132
19284,0.007786,74.125.24.0-255,2902,217098,6,220132
19285,0.007794,172.31.36.0-255,66,217164,6,220132
19286,0.007821,74.125.24.0-255,2902,220066,6,220132
19287,0.007823,172.31.36.0-255,66,220132,6,220132
19288,0.0,172.217.194.0-255,143,143,6,261660
19289,2.8e-05,172.31.36.0-255,66,209,6,261660
19290,3.4e-05,172.217.194.0-255,1484,1693,6,261660
19291,3.8e-05,172.31.36.0-255,66,1759,6,261660
19292,4.2e-05,172.217.194.0-255,2902,4661,6,261660
19293,4.5e-05,172.31.36.0-255,66,4727,6,261660
19294,5.2e-05,172.217.194.0-255,7156,11883,6,261660
19295,5.5e-05,172.31.36.0-255,66,11949,6,261660
19296,5.9e-05,172.217.194.0-255,2057,14006,6,261660
19297,6.2e-05,172.31.36.0-255,66,14072,6,261660
19298,0.000136,172.217.194.0-255,1484,15556,6,261660
19299,0.000141,172.31.36.0-255,66,15622,6,261660
19300,0.000146,172.217.194.0-255,2902,18524,6,261660
19301,0.000149,172.31.36.0-255,66,18590,6,261660
19302,0.000153,172.217.194.0-255,1484,20074,6,261660
19303,0.000154,172.31.36.0-255,66,20140,6,261660
19304,0.000177,172.217.194.0-255,4320,24460,6,261660
19305,0.000182,172.31.36.0-255,66,24526,6,261660
19306,0.000206,172.217.194.0-255,6797,31323,6,261660
19307,0.000208,172.31.36.0-255,66,31389,6,261660
19308,0.000235,172.217.194.0-255,7156,38545,6,261660
19309,0.000238,172.31.36.0-255,66,38611,6,261660
19310,0.000263,172.217.194.0-255,2902,41513,6,261660
19311,0.000266,172.31.36.0-255,66,41579,6,261660
19312,0.000291,172.217.194.0-255,6797,48376,6,261660
19313,0.000294,172.31.36.0-255,66,48442,6,261660
19314,0.000303,172.217.194.0-255,9992,58434,6,261660
19315,0.000306,172.31.36.0-255,66,58500,6,261660
19316,0.000309,172.217.194.0-255,1484,59984,6,261660
19317,0.000311,172.31.36.0-255,66,60050,6,261660
19318,0.000339,172.217.194.0-255,5379,65429,6,261660
19319,0.000344,172.31.36.0-255,66,65495,6,261660
19320,0.000347,172.217.194.0-255,341,65836,6,261660
19321,0.00035,172.217.194.0-255,403,66239,6,261660
19322,0.000402,172.217.194.0-255,2902,69141,6,261660
19323,0.000408,172.31.36.0-255,66,69207,6,261660
19324,0.000414,172.217.194.0-255,4320,73527,6,261660
19325,0.000416,172.31.36.0-255,66,73593,6,261660
19326,0.000454,172.217.194.0-255,8574,82167,6,261660
19327,0.000458,172.31.36.0-255,66,82233,6,261660
19328,0.000465,172.217.194.0-255,5379,87612,6,261660
19329,0.000467,172.31.36.0-255,66,87678,6,261660
19330,0.000473,172.217.194.0-255,5738,93416,6,261660
19331,0.000475,172.31.36.0-255,66,93482,6,261660
19332,0.000509,172.217.194.0-255,2902,96384,6,261660
19333,0.000513,172.31.36.0-255,66,96450,6,261660
19334,0.000534,172.217.194.0-255,3961,100411,6,261660
19335,0.000538,172.31.36.0-255,66,100477,6,261660
19336,0.000814,172.217.194.0-255,1484,101961,6,261660
19337,0.000821,172.217.194.0-255,2902,104863,6,261660
19338,0.000824,172.31.36.0-255,66,104929,6,261660
19339,0.00083,172.217.194.0-255,5738,110667,6,261660
19340,0.000832,172.31.36.0-255,66,110733,6,261660
19341,0.000847,172.217.194.0-255,1484,112217,6,261660
19342,0.000872,172.31.36.0-255,66,112283,6,261660
19343,0.000878,172.217.194.0-255,5738,118021,6,261660
19344,0.00088,172.31.36.0-255,66,118087,6,261660
19345,0.0009,172.217.194.0-255,5020,123107,6,261660
19346,0.000902,172.31.36.0-255,66,123173,6,261660
19347,0.001029,172.217.194.0-255,1484,124657,6,261660
19348,0.001035,172.217.194.0-255,2902,127559,6,261660
19349,0.001038,172.31.36.0-255,66,127625,6,261660
19350,0.00106,172.217.194.0-255,5738,133363,6,261660
19351,0.001063,172.31.36.0-255,66,133429,6,261660
19352,0.001068,172.217.194.0-255,4320,137749,6,261660
19353,0.001069,172.31.36.0-255,66,137815,6,261660
19354,0.001094,172.217.194.0-255,8574,146389,6,261660
19355,0.001096,172.31.36.0-255,66,146455,6,261660
19356,0.001122,172.217.194.0-255,1484,147939,6,261660
19357,0.001138,172.217.194.0-255,9274,157213,6,261660
19358,0.001141,172.31.36.0-255,66,157279,6,261660
19359,0.001165,172.217.194.0-255,7156,164435,6,261660
19360,0.001167,172.31.36.0-255,66,164501,6,261660
19361,0.001187,172.217.194.0-255,4320,168821,6,261660
19362,0.001189,172.31.36.0-255,66,168887,6,261660
19363,0.001197,172.217.194.0-255,9992,178879,6,261660
19364,0.001199,172.31.36.0-255,66,178945,6,261660
19365,0.001229,172.217.194.0-255,2902,181847,6,261660
19366,0.001232,172.31.36.0-255,66,181913,6,261660
19367,0.001254,172.217.194.0-255,9274,191187,6,261660
19368,0.001257,172.31.36.0-255,66,191253,6,261660
19369,0.001318,172.217.194.0-255,1484,192737,6,261660
19370,0.001323,172.217.194.0-255,2902,195639,6,261660
19371,0.001325,172.31.36.0-255,66,195705,6,261660
19372,0.001343,172.217.194.0-255,5738,201443,6,261660
19373,0.001346,172.31.36.0-255,66,201509,6,261660
19374,0.001368,172.217.194.0-255,1484,202993,6,261660
19375,0.001394,172.31.36.0-255,66,203059,6,261660
19376,0.001401,172.217.194.0-255,8574,211633,6,261660
19377,0.001404,172.31.36.0-255,66,211699,6,261660
19378,0.001433,172.217.194.0-255,2184,213883,6,261660
19379,0.001436,172.31.36.0-255,66,213949,6,261660
19380,0.001451,172.217.194.0-255,1484,215433,6,261660
19381,0.001461,172.217.194.0-255,1484,216917,6,261660
19382,0.001463,172.31.36.0-255,66,216983,6,261660
19383,0.00147,172.217.194.0-255,5738,222721,6,261660
19384,0.001471,172.31.36.0-255,66,222787,6,261660
19385,0.001484,172.217.194.0-255,1484,224271,6,261660
19386,0.001501,172.31.36.0-255,66,224337,6,261660
19387,0.001546,172.217.194.0-255,7156,231493,6,261660
19388,0.001549,172.31.36.0-255,66,231559,6,261660
19389,0.001576,172.217.194.0-255,9274,240833,6,261660
19390,0.001578,172.31.36.0-255,66,240899,6,261660
19391,0.001594,172.31.36.0-255,66,240965,6,261660
19392,0.001605,172.31.36.0-255,66,241031,6,261660
19393,0.001645,172.217.194.0-255,2902,243933,6,261660
19394,0.001647,172.31.36.0-255,66,243999,6,261660
19395,0.001674,172.31.36.0-255,66,244065,6,261660
19396,0.001678,172.217.194.0-255,2902,246967,6,261660
19397,0.00168,172.31.36.0-255,66,247033,6,261660
19398,0.00172,172.31.36.0-255,66,247099,6,261660
19399,0.001724,172.217.194.0-255,3602,250701,6,261660
19400,0.001726,172.31.36.0-255,66,250767,6,261660
19401,0.001751,172.217.194.0-255,7156,257923,6,261660
19402,0.001753,172.31.36.0-255,66,257989,6,261660
19403,0.001777,172.217.194.0-255,2902,260891,6,261660
19404,0.001779,172.31.36.0-255,66,260957,6,261660
19405,0.00179,172.31.36.0-255,66,261023,6,261660
19406,0.00185,172.31.36.0-255,66,261089,6,261660
19407,0.001864,172.31.36.0-255,66,261155,6,261660
19408,0.001877,172.31.36.0-255,66,261221,6,261660
19409,0.00188,172.217.194.0-255,97,261318,6,261660
19410,0.001932,172.217.194.0-255,105,261423,6,261660
19411,0.004259,172.31.36.0-255,66,261489,6,261660
19412,0.004292,172.31.36.0-255,105,261594,6,261660
19413,0.006523,172.217.194.0-255,66,261660,6,261660
19414,0.0,172.217.194.0-255,226,226,6,49332
19415,2.6e-05,172.31.36.0-255,66,292,6,49332
19416,3.3e-05,172.217.194.0-255,1484,1776,6,49332
19417,3.8e-05,172.31.36.0-255,66,1842,6,49332
19418,6.3e-05,172.217.194.0-255,1484,3326,6,49332
19419,6.6e-05,172.31.36.0-255,66,3392,6,49332
19420,8.8e-05,172.217.194.0-255,2902,6294,6,49332
19421,9e-05,172.31.36.0-255,66,6360,6,49332
19422,0.000297,172.217.194.0-255,7156,13516,6,49332
19423,0.000301,172.31.36.0-255,66,13582,6,49332
19424,0.000699,172.217.194.0-255,9992,23574,6,49332
19425,0.000704,172.31.36.0-255,66,23640,6,49332
19426,0.000722,172.217.194.0-255,3387,27027,6,49332
19427,0.000726,172.31.36.0-255,66,27093,6,49332
19428,0.00142,172.217.194.0-255,4233,31326,6,49332
19429,0.001426,172.31.36.0-255,66,31392,6,49332
19430,0.003235,172.217.194.0-255,1484,32876,6,49332
19431,0.003243,172.31.36.0-255,66,32942,6,49332
19432,0.003909,172.217.194.0-255,4320,37262,6,49332
19433,0.003913,172.31.36.0-255,66,37328,6,49332
19434,0.005752,172.217.194.0-255,1484,38812,6,49332
19435,0.005759,172.31.36.0-255,66,38878,6,49332
19436,0.006449,172.217.194.0-255,4320,43198,6,49332
19437,0.006455,172.31.36.0-255,66,43264,6,49332
19438,0.008253,172.217.194.0-255,1484,44748,6,49332
19439,0.008261,172.31.36.0-255,66,44814,6,49332
19440,0.008979,172.217.194.0-255,1484,46298,6,49332
19441,0.008987,172.31.36.0-255,66,46364,6,49332
19442,0.00901,172.217.194.0-255,2902,49266,6,49332
19443,0.009013,172.31.36.0-255,66,49332,6,49332
19444,0.0,172.217.194.0-255,153,153,6,225837
19445,2.7e-05,172.31.36.0-255,66,219,6,225837
19446,3.5e-05,172.217.194.0-255,1484,1703,6,225837
19447,3.9e-05,172.31.36.0-255,66,1769,6,225837
19448,5.3e-05,172.217.194.0-255,2902,4671,6,225837
19449,5.6e-05,172.31.36.0-255,66,4737,6,225837
19450,6.4e-05,172.217.194.0-255,7156,11893,6,225837
19451,6.7e-05,172.31.36.0-255,66,11959,6,225837
19452,7.2e-05,172.217.194.0-255,2902,14861,6,225837
19453,7.5e-05,172.31.36.0-255,66,14927,6,225837
19454,0.000116,172.31.36.0-255,66,14993,6,225837
19455,0.000201,172.217.194.0-255,6797,21790,6,225837
19456,0.000205,172.31.36.0-255,66,21856,6,225837
19457,0.000248,172.217.194.0-255,7156,29012,6,225837
19458,0.000252,172.31.36.0-255,66,29078,6,225837
19459,0.000309,172.217.194.0-255,5379,34457,6,225837
19460,0.000313,172.31.36.0-255,66,34523,6,225837
19461,0.000766,172.217.194.0-255,1484,36007,6,225837
19462,0.000771,172.31.36.0-255,66,36073,6,225837
19463,0.000777,172.217.194.0-255,2902,38975,6,225837
19464,0.00078,172.31.36.0-255,66,39041,6,225837
19465,0.000809,172.217.194.0-255,5738,44779,6,225837
19466,0.000813,172.31.36.0-255,66,44845,6,225837
19467,0.00084,172.217.194.0-255,6797,51642,6,225837
19468,0.000843,172.31.36.0-255,66,51708,6,225837
19469,0.00088,172.217.194.0-255,4320,56028,6,225837
19470,0.000883,172.31.36.0-255,66,56094,6,225837
19471,0.000908,172.217.194.0-255,2902,58996,6,225837
19472,0.000911,172.31.36.0-255,66,59062,6,225837
19473,0.000941,172.217.194.0-255,5738,64800,6,225837
19474,0.000944,172.31.36.0-255,66,64866,6,225837
19475,0.000981,172.217.194.0-255,7156,72022,6,225837
19476,0.000994,172.31.36.0-255,66,72088,6,225837
19477,0.001012,172.217.194.0-255,8215,80303,6,225837
19478,0.001018,172.31.36.0-255,66,80369,6,225837
19479,0.001097,172.217.194.0-255,5962,86331,6,225837
19480,0.0011,172.31.36.0-255,66,86397,6,225837
19481,0.001141,172.217.194.0-255,7156,93553,6,225837
19482,0.001146,172.31.36.0-255,66,93619,6,225837
19483,0.001196,172.217.194.0-255,9992,103611,6,225837
19484,0.001202,172.31.36.0-255,66,103677,6,225837
19485,0.001211,172.217.194.0-255,5738,109415,6,225837
19486,0.001216,172.31.36.0-255,66,109481,6,225837
19487,0.001299,172.217.194.0-255,1484,110965,6,225837
19488,0.001318,172.217.194.0-255,5738,116703,6,225837
19489,0.001321,172.31.36.0-255,66,116769,6,225837
19490,0.001349,172.217.194.0-255,3602,120371,6,225837
19491,0.001358,172.31.36.0-255,66,120437,6,225837
19492,0.001465,172.217.194.0-255,1484,121921,6,225837
19493,0.001469,172.217.194.0-255,1484,123405,6,225837
19494,0.001472,172.31.36.0-255,66,123471,6,225837
19495,0.001498,172.217.194.0-255,1484,124955,6,225837
19496,0.001504,172.217.194.0-255,5738,130693,6,225837
19497,0.001518,172.31.36.0-255,66,130759,6,225837
19498,0.001525,172.217.194.0-255,4320,135079,6,225837
19499,0.001538,172.31.36.0-255,66,135145,6,225837
19500,0.001549,172.217.194.0-255,8574,143719,6,225837
19501,0.001561,172.31.36.0-255,66,143785,6,225837
19502,0.001625,172.217.194.0-255,4320,148105,6,225837
19503,0.001629,172.31.36.0-255,66,148171,6,225837
19504,0.00166,172.217.194.0-255,6438,154609,6,225837
19505,0.001666,172.31.36.0-255,66,154675,6,225837
19506,0.001741,172.31.36.0-255,66,154741,6,225837
19507,0.001791,172.217.194.0-255,4320,159061,6,225837
19508,0.001796,172.31.36.0-255,66,159127,6,225837
19509,0.001841,172.31.36.0-255,66,159193,6,225837
19510,0.001963,172.217.194.0-255,1484,160677,6,225837
19511,0.001968,172.217.194.0-255,2902,163579,6,225837
19512,0.001971,172.31.36.0-255,66,163645,6,225837
19513,0.002003,172.217.194.0-255,5738,169383,6,225837
19514,0.002009,172.31.36.0-255,66,169449,6,225837
19515,0.002037,172.217.194.0-255,8574,178023,6,225837
19516,0.002052,172.217.194.0-255,4320,182343,6,225837
19517,0.002053,172.31.36.0-255,66,182409,6,225837
19518,0.002065,172.31.36.0-255,66,182475,6,225837
19519,0.002127,172.217.194.0-255,1484,183959,6,225837
19520,0.002143,172.217.194.0-255,7156,191115,6,225837
19521,0.002147,172.31.36.0-255,66,191181,6,225837
19522,0.002153,172.217.194.0-255,2184,193365,6,225837
19523,0.002164,172.31.36.0-255,66,193431,6,225837
19524,0.002215,172.217.194.0-255,7156,200587,6,225837
19525,0.00222,172.31.36.0-255,66,200653,6,225837
19526,0.002407,172.217.194.0-255,5738,206391,6,225837
19527,0.002424,172.217.194.0-255,3602,209993,6,225837
19528,0.002474,172.217.194.0-255,5738,215731,6,225837
19529,0.00274,172.217.194.0-255,5738,221469,6,225837
19530,0.002862,172.217.194.0-255,4302,225771,6,225837
19531,0.008218,172.31.36.0-255,66,225837,6,225837
19532,0.0,74.125.24.0-255,296,296,6,309346
19533,1.4e-05,172.31.36.0-255,66,362,6,309346
19534,2e-05,74.125.24.0-255,1484,1846,6,309346
19535,2.4e-05,172.31.36.0-255,66,1912,6,309346
19536,3.1e-05,74.125.24.0-255,4320,6232,6,309346
19537,3.4e-05,172.31.36.0-255,66,6298,6,309346
19538,4.1e-05,74.125.24.0-255,7539,13837,6,309346
19539,4.4e-05,172.31.36.0-255,66,13903,6,309346
19540,6.8e-05,74.125.24.0-255,1484,15387,6,309346
19541,7.1e-05,172.31.36.0-255,66,15453,6,309346
19542,7.5e-05,74.125.24.0-255,2902,18355,6,309346
19543,7.7e-05,172.31.36.0-255,66,18421,6,309346
19544,8.8e-05,74.125.24.0-255,1484,19905,6,309346
19545,9.1e-05,172.31.36.0-255,66,19971,6,309346
19546,0.000109,74.125.24.0-255,4320,24291,6,309346
19547,0.000111,172.31.36.0-255,66,24357,6,309346
19548,0.000147,74.125.24.0-255,6797,31154,6,309346
19549,0.00015,172.31.36.0-255,66,31220,6,309346
19550,0.000236,74.125.24.0-255,1484,32704,6,309346
19551,0.000239,172.31.36.0-255,66,32770,6,309346
19552,0.000244,74.125.24.0-255,2902,35672,6,309346
19553,0.000246,172.31.36.0-255,66,35738,6,309346
19554,0.00025,74.125.24.0-255,2902,38640,6,309346
19555,0.000253,172.31.36.0-255,66,38706,6,309346
19556,0.000277,74.125.24.0-255,2902,41608,6,309346
19557,0.000279,172.31.36.0-255,66,41674,6,309346
19558,0.000285,74.125.24.0-255,4320,45994,6,309346
19559,0.000286,172.31.36.0-255,66,46060,6,309346
19560,0.000301,74.125.24.0-255,2902,48962,6,309346
19561,0.000303,172.31.36.0-255,66,49028,6,309346
19562,0.000329,74.125.24.0-255,9633,58661,6,309346
19563,0.000332,172.31.36.0-255,66,58727,6,309346
19564,0.000334,74.125.24.0-255,1484,60211,6,309346
19565,0.000355,74.125.24.0-255,5654,65865,6,309346
19566,0.000357,172.31.36.0-255,66,65931,6,309346
19567,0.000361,74.125.24.0-255,127,66058,6,309346
19568,0.000373,74.125.24.0-255,351,66409,6,309346
19569,0.000595,74.125.24.0-255,1484,67893,6,309346
19570,0.000599,172.31.36.0-255,66,67959,6,309346
19571,0.000604,74.125.24.0-255,2902,70861,6,309346
19572,0.000606,172.31.36.0-255,66,70927,6,309346
19573,0.000627,74.125.24.0-255,5738,76665,6,309346
19574,0.000629,172.31.36.0-255,66,76731,6,309346
19575,0.000636,74.125.24.0-255,7156,83887,6,309346
19576,0.000638,172.31.36.0-255,66,83953,6,309346
19577,0.000688,74.125.24.0-255,7156,91109,6,309346
19578,0.000691,172.31.36.0-255,66,91175,6,309346
19579,0.000715,74.125.24.0-255,7156,98331,6,309346
19580,0.000718,172.31.36.0-255,66,98397,6,309346
19581,0.000721,74.125.24.0-255,2184,100581,6,309346
19582,0.000723,172.31.36.0-255,66,100647,6,309346
19583,0.000774,74.125.24.0-255,1484,102131,6,309346
19584,0.000777,74.125.24.0-255,1484,103615,6,309346
19585,0.000782,172.31.36.0-255,66,103681,6,309346
19586,0.000803,74.125.24.0-255,1484,105165,6,309346
19587,0.000809,74.125.24.0-255,5738,110903,6,309346
19588,0.000812,172.31.36.0-255,66,110969,6,309346
19589,0.00082,74.125.24.0-255,4320,115289,6,309346
19590,0.000822,172.31.36.0-255,66,115355,6,309346
19591,0.000855,74.125.24.0-255,8574,123929,6,309346
19592,0.000858,172.31.36.0-255,66,123995,6,309346
19593,0.000868,74.125.24.0-255,10692,134687,6,309346
19594,0.000871,172.31.36.0-255,66,134753,6,309346
19595,0.000943,74.125.24.0-255,1484,136237,6,309346
19596,0.000949,74.125.24.0-255,2902,139139,6,309346
19597,0.000952,172.31.36.0-255,66,139205,6,309346
19598,0.000959,74.125.24.0-255,5738,144943,6,309346
19599,0.000961,172.31.36.0-255,66,145009,6,309346
19600,0.000984,74.125.24.0-255,2902,147911,6,309346
19601,0.000988,172.31.36.0-255,66,147977,6,309346
19602,0.001015,74.125.24.0-255,9992,157969,6,309346
19603,0.001025,74.125.24.0-255,10692,168661,6,309346
19604,0.001029,172.31.36.0-255,66,168727,6,309346
19605,0.001037,172.31.36.0-255,66,168793,6,309346
19606,0.001066,172.31.36.0-255,66,168859,6,309346
19607,0.001097,74.125.24.0-255,2902,171761,6,309346
19608,0.0011,172.31.36.0-255,66,171827,6,309346
19609,0.001116,172.31.36.0-255,66,171893,6,309346
19610,0.001121,74.125.24.0-255,3602,175495,6,309346
19611,0.001123,172.31.36.0-255,66,175561,6,309346
19612,0.001128,74.125.24.0-255,4320,179881,6,309346
19613,0.001131,172.31.36.0-255,66,179947,6,309346
19614,0.00116,74.125.24.0-255,5738,185685,6,309346
19615,0.001163,172.31.36.0-255,66,185751,6,309346
19616,0.001181,74.125.24.0-255,1484,187235,6,309346
19617,0.001189,74.125.24.0-255,8574,195809,6,309346
19618,0.001192,172.31.36.0-255,66,195875,6,309346
19619,0.001227,172.31.36.0-255,66,195941,6,309346
19620,0.001361,74.125.24.0-255,1484,197425,6,309346
19621,0.001365,74.125.24.0-255,1484,198909,6,309346
19622,0.001368,172.31.36.0-255,66,198975,6,309346
19623,0.00138,74.125.24.0-255,1484,200459,6,309346
19624,0.001385,74.125.24.0-255,4320,204779,6,309346
19625,0.001388,172.31.36.0-255,66,204845,6,309346
19626,0.001413,74.125.24.0-255,1484,206329,6,309346
19627,0.001427,74.125.24.0-255,8574,214903,6,309346
19628,0.00143,172.31.36.0-255,66,214969,6,309346
19629,0.001456,74.125.24.0-255,2902,217871,6,309346
19630,0.001459,172.31.36.0-255,66,217937,6,309346
19631,0.001487,172.31.36.0-255,66,218003,6,309346
19632,0.001648,74.125.24.0-255,1484,219487,6,309346
19633,0.001653,74.125.24.0-255,2902,222389,6,309346
19634,0.001694,172.31.36.0-255,66,222455,6,309346
19635,0.001709,74.125.24.0-255,5738,228193,6,309346
19636,0.001711,172.31.36.0-255,66,228259,6,309346
19637,0.001724,172.31.36.0-255,66,228325,6,309346
19638,0.001734,74.125.24.0-255,10692,239017,6,309346
19639,0.001737,172.31.36.0-255,66,239083,6,309346
19640,0.001915,74.125.24.0-255,1484,240567,6,309346
19641,0.001921,74.125.24.0-255,2902,243469,6,309346
19642,0.001923,172.31.36.0-255,66,243535,6,309346
19643,0.001929,74.125.24.0-255,2902,246437,6,309346
19644,0.001931,172.31.36.0-255,66,246503,6,309346
19645,0.001946,74.125.24.0-255,2902,249405,6,309346
19646,0.001948,172.31.36.0-255,66,249471,6,309346
19647,0.001955,74.125.24.0-255,7156,256627,6,309346
19648,0.001957,172.31.36.0-255,66,256693,6,309346
19649,0.001984,74.125.24.0-255,5738,262431,6,309346
19650,0.001986,172.31.36.0-255,66,262497,6,309346
19651,0.001993,74.125.24.0-255,7156,269653,6,309346
19652,0.001995,172.31.36.0-255,66,269719,6,309346
19653,0.002008,74.125.24.0-255,1484,271203,6,309346
19654,0.002027,74.125.24.0-255,2184,273387,6,309346
19655,0.00203,172.31.36.0-255,66,273453,6,309346
19656,0.002093,74.125.24.0-255,1484,274937,6,309346
19657,0.002097,74.125.24.0-255,1484,276421,6,309346
19658,0.0021,172.31.36.0-255,66,276487,6,309346
19659,0.00212,74.125.24.0-255,1484,277971,6,309346
19660,0.002126,74.125.24.0-255,5738,283709,6,309346
19661,0.002129,172.31.36.0-255,66,283775,6,309346
19662,0.002136,74.125.24.0-255,7156,290931,6,309346
19663,0.002139,172.31.36.0-255,66,290997,6,309346
19664,0.002164,74.125.24.0-255,5738,296735,6,309346
19665,0.002167,172.31.36.0-255,66,296801,6,309346
19666,0.002177,74.125.24.0-255,9992,306793,6,309346
19667,0.00218,172.31.36.0-255,66,306859,6,309346
19668,0.002195,74.125.24.0-255,766,307625,6,309346
19669,0.002208,172.31.36.0-255,66,307691,6,309346
19670,0.002211,74.125.24.0-255,1484,309175,6,309346
19671,0.002245,172.31.36.0-255,66,309241,6,309346
19672,0.002263,74.125.24.0-255,105,309346,6,309346
19673,0.0,74.125.24.0-255,152,152,6,232308
19674,2.3e-05,172.31.36.0-255,66,218,6,232308
19675,3e-05,74.125.24.0-255,1484,1702,6,232308
19676,3.5e-05,172.31.36.0-255,66,1768,6,232308
19677,4.1e-05,74.125.24.0-255,2902,4670,6,232308
19678,4.4e-05,172.31.36.0-255,66,4736,6,232308
19679,5.3e-05,74.125.24.0-255,7156,11892,6,232308
19680,5.5e-05,172.31.36.0-255,66,11958,6,232308
19681,6e-05,74.125.24.0-255,2006,13964,6,232308
19682,6.3e-05,172.31.36.0-255,66,14030,6,232308
19683,9.9e-05,74.125.24.0-255,1484,15514,6,232308
19684,0.000102,172.31.36.0-255,66,15580,6,232308
19685,0.000107,74.125.24.0-255,2902,18482,6,232308
19686,0.00011,172.31.36.0-255,66,18548,6,232308
19687,0.000117,74.125.24.0-255,5738,24286,6,232308
19688,0.00012,172.31.36.0-255,66,24352,6,232308
19689,0.000123,74.125.24.0-255,1484,25836,6,232308
19690,0.000125,172.31.36.0-255,66,25902,6,232308
19691,0.000153,74.125.24.0-255,5379,31281,6,232308
19692,0.000156,172.31.36.0-255,66,31347,6,232308
19693,0.00026,74.125.24.0-255,1484,32831,6,232308
19694,0.000263,172.31.36.0-255,66,32897,6,232308
19695,0.000269,74.125.24.0-255,2902,35799,6,232308
19696,0.000271,172.31.36.0-255,66,35865,6,232308
19697,0.000288,74.125.24.0-255,4320,40185,6,232308
19698,0.000291,172.31.36.0-255,66,40251,6,232308
19699,0.000316,74.125.24.0-255,1484,41735,6,232308
19700,0.000319,172.31.36.0-255,66,41801,6,232308
19701,0.000334,172.31.36.0-255,66,41867,6,232308
19702,0.000359,74.125.24.0-255,1484,43351,6,232308
19703,0.000361,172.31.36.0-255,66,43417,6,232308
19704,0.000383,74.125.24.0-255,8215,51632,6,232308
19705,0.000386,172.31.36.0-255,66,51698,6,232308
19706,0.000574,74.125.24.0-255,648,52346,6,232308
19707,0.000732,74.125.24.0-255,1484,53830,6,232308
19708,0.000736,172.31.36.0-255,66,53896,6,232308
19709,0.000739,74.125.24.0-255,1484,55380,6,232308
19710,0.000754,74.125.24.0-255,1484,56864,6,232308
19711,0.000756,172.31.36.0-255,66,56930,6,232308
19712,0.000763,74.125.24.0-255,5738,62668,6,232308
19713,0.000764,172.31.36.0-255,66,62734,6,232308
19714,0.000768,74.125.24.0-255,2902,65636,6,232308
19715,0.00077,172.31.36.0-255,66,65702,6,232308
19716,0.000794,74.125.24.0-255,3961,69663,6,232308
19717,0.000796,172.31.36.0-255,66,69729,6,232308
19718,0.000804,74.125.24.0-255,8574,78303,6,232308
19719,0.000806,172.31.36.0-255,66,78369,6,232308
19720,0.000825,74.125.24.0-255,5738,84107,6,232308
19721,0.000828,172.31.36.0-255,66,84173,6,232308
19722,0.000831,74.125.24.0-255,2543,86716,6,232308
19723,0.000833,172.31.36.0-255,66,86782,6,232308
19724,0.001084,74.125.24.0-255,1484,88266,6,232308
19725,0.001102,74.125.24.0-255,2902,91168,6,232308
19726,0.001105,172.31.36.0-255,66,91234,6,232308
19727,0.001111,74.125.24.0-255,4320,95554,6,232308
19728,0.001112,172.31.36.0-255,66,95620,6,232308
19729,0.001124,74.125.24.0-255,1484,97104,6,232308
19730,0.001129,74.125.24.0-255,4320,101424,6,232308
19731,0.001131,172.31.36.0-255,66,101490,6,232308
19732,0.001147,74.125.24.0-255,7156,108646,6,232308
19733,0.00115,172.31.36.0-255,66,108712,6,232308
19734,0.00119,74.125.24.0-255,8574,117286,6,232308
19735,0.001194,172.31.36.0-255,66,117352,6,232308
19736,0.001202,74.125.24.0-255,3602,120954,6,232308
19737,0.001204,172.31.36.0-255,66,121020,6,232308
19738,0.001235,74.125.24.0-255,5738,126758,6,232308
19739,0.001237,172.31.36.0-255,66,126824,6,232308
19740,0.001259,74.125.24.0-255,7156,133980,6,232308
19741,0.001261,172.31.36.0-255,66,134046,6,232308
19742,0.001275,172.31.36.0-255,66,134112,6,232308
19743,0.001282,74.125.24.0-255,6438,140550,6,232308
19744,0.001284,172.31.36.0-255,66,140616,6,232308
19745,0.001678,74.125.24.0-255,1484,142100,6,232308
19746,0.001683,74.125.24.0-255,2902,145002,6,232308
19747,0.001687,172.31.36.0-255,66,145068,6,232308
19748,0.001721,74.125.24.0-255,5738,150806,6,232308
19749,0.001724,172.31.36.0-255,66,150872,6,232308
19750,0.00173,74.125.24.0-255,5738,156610,6,232308
19751,0.001732,172.31.36.0-255,66,156676,6,232308
19752,0.001757,74.125.24.0-255,7156,163832,6,232308
19753,0.001765,74.125.24.0-255,10692,174524,6,232308
19754,0.001768,172.31.36.0-255,66,174590,6,232308
19755,0.001771,172.31.36.0-255,66,174656,6,232308
19756,0.001884,74.125.24.0-255,1484,176140,6,232308
19757,0.001904,74.125.24.0-255,2902,179042,6,232308
19758,0.001906,172.31.36.0-255,66,179108,6,232308
19759,0.00191,74.125.24.0-255,1484,180592,6,232308
19760,0.001926,74.125.24.0-255,4320,184912,6,232308
19761,0.001928,172.31.36.0-255,66,184978,6,232308
19762,0.001932,74.125.24.0-255,2902,187880,6,232308
19763,0.001934,172.31.36.0-255,66,187946,6,232308
19764,0.001966,74.125.24.0-255,9992,197938,6,232308
19765,0.001969,172.31.36.0-255,66,198004,6,232308
19766,0.001977,74.125.24.0-255,9992,207996,6,232308
19767,0.001978,172.31.36.0-255,66,208062,6,232308
19768,0.00201,74.125.24.0-255,9992,218054,6,232308
19769,0.002012,172.31.36.0-255,66,218120,6,232308
19770,0.002035,74.125.24.0-255,766,218886,6,232308
19771,0.002065,74.125.24.0-255,4320,223206,6,232308
19772,0.002078,74.125.24.0-255,2902,226108,6,232308
19773,0.007715,172.31.36.0-255,66,226174,6,232308
19774,0.007721,172.31.36.0-255,66,226240,6,232308
19775,0.007724,172.31.36.0-255,66,226306,6,232308
19776,0.007728,172.31.36.0-255,66,226372,6,232308
19777,0.009718,74.125.24.0-255,2902,229274,6,232308
19778,0.009725,172.31.36.0-255,66,229340,6,232308
19779,0.009745,74.125.24.0-255,2902,232242,6,232308
19780,0.009747,172.31.36.0-255,66,232308,6,232308
19781,0.0,74.125.24.0-255,153,153,6,266096
19782,3.4e-05,172.31.36.0-255,66,219,6,266096
19783,4.1e-05,74.125.24.0-255,1484,1703,6,266096
19784,4.6e-05,172.31.36.0-255,66,1769,6,266096
19785,5e-05,74.125.24.0-255,2902,4671,6,266096
19786,5.3e-05,172.31.36.0-255,66,4737,6,266096
19787,6e-05,74.125.24.0-255,7156,11893,6,266096
19788,6.4e-05,172.31.36.0-255,66,11959,6,266096
19789,8.5e-05,74.125.24.0-255,2014,13973,6,266096
19790,8.8e-05,172.31.36.0-255,66,14039,6,266096
19791,0.000118,74.125.24.0-255,1484,15523,6,266096
19792,0.000121,172.31.36.0-255,66,15589,6,266096
19793,0.000126,74.125.24.0-255,1484,17073,6,266096
19794,0.000128,172.31.36.0-255,66,17139,6,266096
19795,0.000142,74.125.24.0-255,1484,18623,6,266096
19796,0.000145,172.31.36.0-255,66,18689,6,266096
19797,0.000159,74.125.24.0-255,5738,24427,6,266096
19798,0.000163,172.31.36.0-255,66,24493,6,266096
19799,0.000166,74.125.24.0-255,1484,25977,6,266096
19800,0.00017,172.31.36.0-255,66,26043,6,266096
19801,0.000185,74.125.24.0-255,5379,31422,6,266096
19802,0.000188,172.31.36.0-255,66,31488,6,266096
19803,0.00036,74.125.24.0-255,1484,32972,6,266096
19804,0.000364,172.31.36.0-255,66,33038,6,266096
19805,0.000371,74.125.24.0-255,2902,35940,6,266096
19806,0.000374,172.31.36.0-255,66,36006,6,266096
19807,0.000392,74.125.24.0-255,2902,38908,6,266096
19808,0.000395,172.31.36.0-255,66,38974,6,266096
19809,0.000417,74.125.24.0-255,2902,41876,6,266096
19810,0.000419,172.31.36.0-255,66,41942,6,266096
19811,0.000424,74.125.24.0-255,2902,44844,6,266096
19812,0.000427,172.31.36.0-255,66,44910,6,266096
19813,0.000452,172.31.36.0-255,66,44976,6,266096
19814,0.000455,74.125.24.0-255,1484,46460,6,266096
19815,0.000513,74.125.24.0-255,1484,47944,6,266096
19816,0.000516,172.31.36.0-255,66,48010,6,266096
19817,0.000541,74.125.24.0-255,7073,55083,6,266096
19818,0.000544,172.31.36.0-255,66,55149,6,266096
19819,0.000548,74.125.24.0-255,130,55279,6,266096
19820,0.00068,74.125.24.0-255,1484,56763,6,266096
19821,0.000684,172.31.36.0-255,66,56829,6,266096
19822,0.00069,74.125.24.0-255,2902,59731,6,266096
19823,0.000694,172.31.36.0-255,66,59797,6,266096
19824,0.000695,74.125.24.0-255,5738,65535,6,266096
19825,0.000698,172.31.36.0-255,66,65601,6,266096
19826,0.000723,74.125.24.0-255,7156,72757,6,266096
19827,0.000726,172.31.36.0-255,66,72823,6,266096
19828,0.00075,74.125.24.0-255,6797,79620,6,266096
19829,0.000753,172.31.36.0-255,66,79686,6,266096
19830,0.00076,74.125.24.0-255,7156,86842,6,266096
19831,0.000762,172.31.36.0-255,66,86908,6,266096
19832,0.000788,74.125.24.0-255,2803,89711,6,266096
19833,0.000791,172.31.36.0-255,66,89777,6,266096
19834,0.000862,74.125.24.0-255,1484,91261,6,266096
19835,0.000879,74.125.24.0-255,1484,92745,6,266096
19836,0.000882,172.31.36.0-255,66,92811,6,266096
19837,0.000896,74.125.24.0-255,2902,95713,6,266096
19838,0.000899,172.31.36.0-255,66,95779,6,266096
19839,0.000905,74.125.24.0-255,5738,101517,6,266096
19840,0.000909,172.31.36.0-255,66,101583,6,266096
19841,0.000929,74.125.24.0-255,8574,110157,6,266096
19842,0.000931,172.31.36.0-255,66,110223,6,266096
19843,0.000951,74.125.24.0-255,4320,114543,6,266096
19844,0.000953,172.31.36.0-255,66,114609,6,266096
19845,0.000961,74.125.24.0-255,7156,121765,6,266096
19846,0.000964,172.31.36.0-255,66,121831,6,266096
19847,0.000998,74.125.24.0-255,1633,123464,6,266096
19848,0.001002,172.31.36.0-255,66,123530,6,266096
19849,0.001041,74.125.24.0-255,1484,125014,6,266096
19850,0.001045,74.125.24.0-255,1484,126498,6,266096
19851,0.001048,172.31.36.0-255,66,126564,6,266096
19852,0.001065,74.125.24.0-255,1484,128048,6,266096
19853,0.001071,74.125.24.0-255,5738,133786,6,266096
19854,0.001074,172.31.36.0-255,66,133852,6,266096
19855,0.001088,74.125.24.0-255,1484,135336,6,266096
19856,0.001112,172.31.36.0-255,66,135402,6,266096
19857,0.001115,74.125.24.0-255,1484,136886,6,266096
19858,0.001137,74.125.24.0-255,1484,138370,6,266096
19859,0.00114,172.31.36.0-255,66,138436,6,266096
19860,0.001161,74.125.24.0-255,7856,146292,6,266096
19861,0.001165,172.31.36.0-255,66,146358,6,266096
19862,0.001226,74.125.24.0-255,7156,153514,6,266096
19863,0.00123,172.31.36.0-255,66,153580,6,266096
19864,0.001243,74.125.24.0-255,2902,156482,6,266096
19865,0.001247,172.31.36.0-255,66,156548,6,266096
19866,0.001259,172.31.36.0-255,66,156614,6,266096
19867,0.001266,74.125.24.0-255,7156,163770,6,266096
19868,0.00127,172.31.36.0-255,66,163836,6,266096
19869,0.001289,74.125.24.0-255,5020,168856,6,266096
19870,0.001292,172.31.36.0-255,66,168922,6,266096
19871,0.0014,74.125.24.0-255,1484,170406,6,266096
19872,0.001428,74.125.24.0-255,2902,173308,6,266096
19873,0.001431,172.31.36.0-255,66,173374,6,266096
19874,0.001437,74.125.24.0-255,2902,176276,6,266096
19875,0.001439,172.31.36.0-255,66,176342,6,266096
19876,0.001454,74.125.24.0-255,2902,179244,6,266096
19877,0.001458,172.31.36.0-255,66,179310,6,266096
19878,0.001461,74.125.24.0-255,7156,186466,6,266096
19879,0.001463,172.31.36.0-255,66,186532,6,266096
19880,0.001477,74.125.24.0-255,4320,190852,6,266096
19881,0.00148,172.31.36.0-255,66,190918,6,266096
19882,0.001504,74.125.24.0-255,9992,200910,6,266096
19883,0.001507,172.31.36.0-255,66,200976,6,266096
19884,0.001512,74.125.24.0-255,2184,203160,6,266096
19885,0.001514,172.31.36.0-255,66,203226,6,266096
19886,0.002166,74.125.24.0-255,1484,204710,6,266096
19887,0.002174,74.125.24.0-255,2902,207612,6,266096
19888,0.002178,172.31.36.0-255,66,207678,6,266096
19889,0.002186,74.125.24.0-255,5738,213416,6,266096
19890,0.002188,172.31.36.0-255,66,213482,6,266096
19891,0.002192,74.125.24.0-255,1484,214966,6,266096
19892,0.002225,74.125.24.0-255,5738,220704,6,266096
19893,0.002229,172.31.36.0-255,66,220770,6,266096
19894,0.002241,172.31.36.0-255,66,220836,6,266096
19895,0.002255,74.125.24.0-255,2902,223738,6,266096
19896,0.002259,172.31.36.0-255,66,223804,6,266096
19897,0.002264,74.125.24.0-255,2184,225988,6,266096
19898,0.002266,172.31.36.0-255,66,226054,6,266096
19899,0.002288,74.125.24.0-255,2902,228956,6,266096
19900,0.00229,172.31.36.0-255,66,229022,6,266096
19901,0.002298,74.125.24.0-255,5738,234760,6,266096
19902,0.0023,172.31.36.0-255,66,234826,6,266096
19903,0.002319,74.125.24.0-255,1484,236310,6,266096
19904,0.002333,172.31.36.0-255,66,236376,6,266096
19905,0.00236,74.125.24.0-255,7156,243532,6,266096
19906,0.002363,172.31.36.0-255,66,243598,6,266096
19907,0.002382,74.125.24.0-255,5020,248618,6,266096
19908,0.002385,172.31.36.0-255,66,248684,6,266096
19909,0.004726,74.125.24.0-255,5738,254422,6,266096
19910,0.004734,172.31.36.0-255,66,254488,6,266096
19911,0.007088,74.125.24.0-255,5738,260226,6,266096
19912,0.007096,172.31.36.0-255,66,260292,6,266096
19913,0.009471,74.125.24.0-255,5738,266030,6,266096
19914,0.009478,172.31.36.0-255,66,266096,6,266096
19915,0.0,172.217.194.0-255,154,154,6,289917
19916,2.6e-05,172.31.36.0-255,66,220,6,289917
19917,3.4e-05,172.217.194.0-255,1484,1704,6,289917
19918,3.9e-05,172.31.36.0-255,66,1770,6,289917
19919,5.3e-05,172.217.194.0-255,2902,4672,6,289917
19920,5.6e-05,172.31.36.0-255,66,4738,6,289917
19921,6.5e-05,172.217.194.0-255,7156,11894,6,289917
19922,6.8e-05,172.31.36.0-255,66,11960,6,289917
19923,8.5e-05,172.217.194.0-255,2072,14032,6,289917
19924,8.9e-05,172.31.36.0-255,66,14098,6,289917
19925,0.000124,172.217.194.0-255,2902,17000,6,289917
19926,0.000127,172.31.36.0-255,66,17066,6,289917
19927,0.000132,172.217.194.0-255,2902,19968,6,289917
19928,0.000134,172.31.36.0-255,66,20034,6,289917
19929,0.000143,172.217.194.0-255,7156,27190,6,289917
19930,0.000145,172.31.36.0-255,66,27256,6,289917
19931,0.000172,172.217.194.0-255,3961,31217,6,289917
19932,0.000175,172.31.36.0-255,66,31283,6,289917
19933,0.000235,172.217.194.0-255,1484,32767,6,289917
19934,0.000238,172.31.36.0-255,66,32833,6,289917
19935,0.000243,172.217.194.0-255,2902,35735,6,289917
19936,0.000246,172.31.36.0-255,66,35801,6,289917
19937,0.000249,172.217.194.0-255,1484,37285,6,289917
19938,0.000251,172.31.36.0-255,66,37351,6,289917
19939,0.000288,172.217.194.0-255,4320,41671,6,289917
19940,0.000291,172.31.36.0-255,66,41737,6,289917
19941,0.000298,172.217.194.0-255,5738,47475,6,289917
19942,0.000301,172.31.36.0-255,66,47541,6,289917
19943,0.000303,172.217.194.0-255,1125,48666,6,289917
19944,0.000305,172.31.36.0-255,66,48732,6,289917
19945,0.000335,172.217.194.0-255,1484,50216,6,289917
19946,0.000338,172.31.36.0-255,66,50282,6,289917
19947,0.000344,172.217.194.0-255,4320,54602,6,289917
19948,0.000347,172.31.36.0-255,66,54668,6,289917
19949,0.000387,172.217.194.0-255,9992,64660,6,289917
19950,0.00039,172.31.36.0-255,66,64726,6,289917
19951,0.000393,172.217.194.0-255,1404,66130,6,289917
19952,0.000397,172.217.194.0-255,113,66243,6,289917
19953,0.000427,172.217.194.0-255,382,66625,6,289917
19954,0.00043,172.31.36.0-255,66,66691,6,289917
19955,0.000711,172.217.194.0-255,1484,68175,6,289917
19956,0.000718,172.217.194.0-255,2902,71077,6,289917
19957,0.000722,172.31.36.0-255,66,71143,6,289917
19958,0.000729,172.217.194.0-255,4320,75463,6,289917
19959,0.000731,172.31.36.0-255,66,75529,6,289917
19960,0.000762,172.217.194.0-255,1484,77013,6,289917
19961,0.000777,172.31.36.0-255,66,77079,6,289917
19962,0.000788,172.217.194.0-255,10692,87771,6,289917
19963,0.00079,172.31.36.0-255,66,87837,6,289917
19964,0.001094,172.217.194.0-255,1484,89321,6,289917
19965,0.001111,172.217.194.0-255,2902,92223,6,289917
19966,0.001116,172.31.36.0-255,66,92289,6,289917
19967,0.001147,172.217.194.0-255,5738,98027,6,289917
19968,0.00115,172.31.36.0-255,66,98093,6,289917
19969,0.001155,172.217.194.0-255,2902,100995,6,289917
19970,0.001157,172.31.36.0-255,66,101061,6,289917
19971,0.001163,172.217.194.0-255,5738,106799,6,289917
19972,0.001166,172.31.36.0-255,66,106865,6,289917
19973,0.001192,172.217.194.0-255,4320,111185,6,289917
19974,0.001195,172.31.36.0-255,66,111251,6,289917
19975,0.001207,172.217.194.0-255,10143,121394,6,289917
19976,0.001209,172.31.36.0-255,66,121460,6,289917
19977,0.001256,172.217.194.0-255,1484,122944,6,289917
19978,0.001271,172.217.194.0-255,2902,125846,6,289917
19979,0.001274,172.31.36.0-255,66,125912,6,289917
19980,0.001278,172.217.194.0-255,1484,127396,6,289917
19981,0.001309,172.217.194.0-255,2902,130298,6,289917
19982,0.001312,172.31.36.0-255,66,130364,6,289917
19983,0.001318,172.217.194.0-255,4320,134684,6,289917
19984,0.001321,172.31.36.0-255,66,134750,6,289917
19985,0.001355,172.217.194.0-255,4320,139070,6,289917
19986,0.001359,172.31.36.0-255,66,139136,6,289917
19987,0.001367,172.217.194.0-255,7156,146292,6,289917
19988,0.001369,172.31.36.0-255,66,146358,6,289917
19989,0.001398,172.217.194.0-255,9274,155632,6,289917
19990,0.001402,172.31.36.0-255,66,155698,6,289917
19991,0.001429,172.217.194.0-255,7156,162854,6,289917
19992,0.001436,172.31.36.0-255,66,162920,6,289917
19993,0.001458,172.217.194.0-255,2902,165822,6,289917
19994,0.001461,172.31.36.0-255,66,165888,6,289917
19995,0.001467,172.217.194.0-255,4320,170208,6,289917
19996,0.001469,172.31.36.0-255,66,170274,6,289917
19997,0.001498,172.217.194.0-255,2543,172817,6,289917
19998,0.0015,172.31.36.0-255,66,172883,6,289917
19999,0.001526,172.217.194.0-255,2902,175785,6,289917
20000,0.001528,172.31.36.0-255,66,175851,6,289917
20001,0.001532,172.217.194.0-255,1484,177335,6,289917
20002,0.001557,172.217.194.0-255,2902,180237,6,289917
20003,0.001559,172.31.36.0-255,66,180303,6,289917
20004,0.001567,172.217.194.0-255,5738,186041,6,289917
20005,0.00157,172.31.36.0-255,66,186107,6,289917
20006,0.001603,172.217.194.0-255,7156,193263,6,289917
20007,0.001606,172.31.36.0-255,66,193329,6,289917
20008,0.001633,172.217.194.0-255,5738,199067,6,289917
20009,0.001636,172.31.36.0-255,66,199133,6,289917
20010,0.001639,172.217.194.0-255,1484,200617,6,289917
20011,0.001669,172.217.194.0-255,6438,207055,6,289917
20012,0.001672,172.31.36.0-255,66,207121,6,289917
20013,0.00168,172.217.194.0-255,7156,214277,6,289917
20014,0.001682,172.31.36.0-255,66,214343,6,289917
20015,0.001708,172.217.194.0-255,1484,215827,6,289917
20016,0.001721,172.31.36.0-255,66,215893,6,289917
20017,0.001754,172.217.194.0-255,9992,225885,6,289917
20018,0.001757,172.31.36.0-255,66,225951,6,289917
20019,0.001782,172.217.194.0-255,3602,229553,6,289917
20020,0.001785,172.31.36.0-255,66,229619,6,289917
20021,0.001842,172.217.194.0-255,1484,231103,6,289917
20022,0.001857,172.217.194.0-255,2902,234005,6,289917
20023,0.00186,172.31.36.0-255,66,234071,6,289917
20024,0.001868,172.217.194.0-255,5738,239809,6,289917
20025,0.001871,172.31.36.0-255,66,239875,6,289917
20026,0.00192,172.31.36.0-255,66,239941,6,289917
20027,0.001929,172.217.194.0-255,8574,248515,6,289917
20028,0.001936,172.31.36.0-255,66,248581,6,289917
20029,0.001976,172.217.194.0-255,1484,250065,6,289917
20030,0.002005,172.217.194.0-255,766,250831,6,289917
20031,0.002008,172.31.36.0-255,66,250897,6,289917
20032,0.002093,172.217.194.0-255,1484,252381,6,289917
20033,0.002112,172.217.194.0-255,2902,255283,6,289917
20034,0.002115,172.31.36.0-255,66,255349,6,289917
20035,0.002122,172.217.194.0-255,5738,261087,6,289917
20036,0.002124,172.31.36.0-255,66,261153,6,289917
20037,0.002168,172.31.36.0-255,66,261219,6,289917
20038,0.002177,172.217.194.0-255,8574,269793,6,289917
20039,0.002179,172.31.36.0-255,66,269859,6,289917
20040,0.002201,172.217.194.0-255,2184,272043,6,289917
20041,0.002203,172.31.36.0-255,66,272109,6,289917
20042,0.00448,172.217.194.0-255,2902,275011,6,289917
20043,0.00449,172.31.36.0-255,66,275077,6,289917
20044,0.004518,172.217.194.0-255,2902,277979,6,289917
20045,0.004521,172.31.36.0-255,66,278045,6,289917
20046,0.006822,172.217.194.0-255,2902,280947,6,289917
20047,0.006838,172.31.36.0-255,66,281013,6,289917
20048,0.006869,172.217.194.0-255,2902,283915,6,289917
20049,0.006873,172.31.36.0-255,66,283981,6,289917
20050,0.009155,172.217.194.0-255,2902,286883,6,289917
20051,0.009164,172.31.36.0-255,66,286949,6,289917
20052,0.009192,172.217.194.0-255,2902,289851,6,289917
20053,0.009195,172.31.36.0-255,66,289917,6,289917
20054,0.0,74.125.200.0-255,153,153,6,291721
20055,2.2e-05,172.31.36.0-255,66,219,6,291721
20056,2.9e-05,74.125.200.0-255,1484,1703,6,291721
20057,3.3e-05,172.31.36.0-255,66,1769,6,291721
20058,3.9e-05,74.125.200.0-255,2902,4671,6,291721
20059,4.2e-05,172.31.36.0-255,66,4737,6,291721
20060,4.7e-05,74.125.200.0-255,2902,7639,6,291721
20061,4.9e-05,172.31.36.0-255,66,7705,6,291721
20062,5.5e-05,74.125.200.0-255,4320,12025,6,291721
20063,5.7e-05,172.31.36.0-255,66,12091,6,291721
20064,6e-05,74.125.200.0-255,1484,13575,6,291721
20065,6.2e-05,172.31.36.0-255,66,13641,6,291721
20066,9.3e-05,74.125.200.0-255,7729,21370,6,291721
20067,9.6e-05,172.31.36.0-255,66,21436,6,291721
20068,0.000101,74.125.200.0-255,4320,25756,6,291721
20069,0.000104,172.31.36.0-255,66,25822,6,291721
20070,0.000128,74.125.200.0-255,2902,28724,6,291721
20071,0.000131,172.31.36.0-255,66,28790,6,291721
20072,0.000151,74.125.200.0-255,2543,31333,6,291721
20073,0.000154,172.31.36.0-255,66,31399,6,291721
20074,0.00016,74.125.200.0-255,5738,37137,6,291721
20075,0.000162,172.31.36.0-255,66,37203,6,291721
20076,0.00018,74.125.200.0-255,2902,40105,6,291721
20077,0.000182,172.31.36.0-255,66,40171,6,291721
20078,0.000215,74.125.200.0-255,8215,48386,6,291721
20079,0.000218,172.31.36.0-255,66,48452,6,291721
20080,0.000536,74.125.200.0-255,1484,49936,6,291721
20081,0.000541,172.31.36.0-255,66,50002,6,291721
20082,0.000562,74.125.200.0-255,2902,52904,6,291721
20083,0.000566,172.31.36.0-255,66,52970,6,291721
20084,0.000582,74.125.200.0-255,5738,58708,6,291721
20085,0.000585,172.31.36.0-255,66,58774,6,291721
20086,0.000589,74.125.200.0-255,2902,61676,6,291721
20087,0.000591,172.31.36.0-255,66,61742,6,291721
20088,0.000641,74.125.200.0-255,2902,64644,6,291721
20089,0.000645,172.31.36.0-255,66,64710,6,291721
20090,0.000658,74.125.200.0-255,1705,66415,6,291721
20091,0.00066,172.31.36.0-255,66,66481,6,291721
20092,0.000703,74.125.200.0-255,1484,67965,6,291721
20093,0.000722,74.125.200.0-255,2902,70867,6,291721
20094,0.000724,172.31.36.0-255,66,70933,6,291721
20095,0.00073,74.125.200.0-255,2902,73835,6,291721
20096,0.000732,172.31.36.0-255,66,73901,6,291721
20097,0.000747,74.125.200.0-255,2902,76803,6,291721
20098,0.000749,172.31.36.0-255,66,76869,6,291721
20099,0.000753,74.125.200.0-255,2902,79771,6,291721
20100,0.000755,172.31.36.0-255,66,79837,6,291721
20101,0.000793,74.125.200.0-255,1484,81321,6,291721
20102,0.000817,74.125.200.0-255,8215,89536,6,291721
20103,0.000847,74.125.200.0-255,2902,92438,6,291721
20104,0.000851,172.31.36.0-255,66,92504,6,291721
20105,0.000855,172.31.36.0-255,66,92570,6,291721
20106,0.000873,74.125.200.0-255,7156,99726,6,291721
20107,0.000876,172.31.36.0-255,66,99792,6,291721
20108,0.000879,74.125.200.0-255,1125,100917,6,291721
20109,0.001097,74.125.200.0-255,1484,102401,6,291721
20110,0.001102,172.31.36.0-255,66,102467,6,291721
20111,0.001132,74.125.200.0-255,2902,105369,6,291721
20112,0.001135,172.31.36.0-255,66,105435,6,291721
20113,0.001155,74.125.200.0-255,1484,106919,6,291721
20114,0.001181,74.125.200.0-255,2902,109821,6,291721
20115,0.001184,172.31.36.0-255,66,109887,6,291721
20116,0.001192,74.125.200.0-255,5738,115625,6,291721
20117,0.001194,172.31.36.0-255,66,115691,6,291721
20118,0.001198,74.125.200.0-255,2902,118593,6,291721
20119,0.001201,172.31.36.0-255,66,118659,6,291721
20120,0.001226,74.125.200.0-255,4320,122979,6,291721
20121,0.001229,172.31.36.0-255,66,123045,6,291721
20122,0.001236,74.125.200.0-255,5738,128783,6,291721
20123,0.001238,172.31.36.0-255,66,128849,6,291721
20124,0.001251,74.125.200.0-255,2902,131751,6,291721
20125,0.001253,172.31.36.0-255,66,131817,6,291721
20126,0.001259,74.125.200.0-255,3602,135419,6,291721
20127,0.001261,172.31.36.0-255,66,135485,6,291721
20128,0.00145,74.125.200.0-255,1484,136969,6,291721
20129,0.001468,74.125.200.0-255,2902,139871,6,291721
20130,0.001471,172.31.36.0-255,66,139937,6,291721
20131,0.001476,74.125.200.0-255,2902,142839,6,291721
20132,0.001478,172.31.36.0-255,66,142905,6,291721
20133,0.001484,74.125.200.0-255,4320,147225,6,291721
20134,0.001486,172.31.36.0-255,66,147291,6,291721
20135,0.001503,74.125.200.0-255,1484,148775,6,291721
20136,0.001536,74.125.200.0-255,7156,155931,6,291721
20137,0.001539,172.31.36.0-255,66,155997,6,291721
20138,0.001546,74.125.200.0-255,5738,161735,6,291721
20139,0.001549,172.31.36.0-255,66,161801,6,291721
20140,0.001591,74.125.200.0-255,7856,169657,6,291721
20141,0.001594,172.31.36.0-255,66,169723,6,291721
20142,0.001854,74.125.200.0-255,1484,171207,6,291721
20143,0.001861,74.125.200.0-255,2902,174109,6,291721
20144,0.001864,172.31.36.0-255,66,174175,6,291721
20145,0.001881,74.125.200.0-255,4320,178495,6,291721
20146,0.001883,172.31.36.0-255,66,178561,6,291721
20147,0.001907,74.125.200.0-255,1484,180045,6,291721
20148,0.001915,74.125.200.0-255,7156,187201,6,291721
20149,0.001917,172.31.36.0-255,66,187267,6,291721
20150,0.001949,172.31.36.0-255,66,187333,6,291721
20151,0.001964,74.125.200.0-255,2902,190235,6,291721
20152,0.001966,172.31.36.0-255,66,190301,6,291721
20153,0.001985,74.125.200.0-255,2902,193203,6,291721
20154,0.001987,172.31.36.0-255,66,193269,6,291721
20155,0.00203,172.31.36.0-255,66,193335,6,291721
20156,0.002037,74.125.200.0-255,5738,199073,6,291721
20157,0.002039,172.31.36.0-255,66,199139,6,291721
20158,0.002045,74.125.200.0-255,4320,203459,6,291721
20159,0.002048,172.31.36.0-255,66,203525,6,291721
20160,0.002082,74.125.200.0-255,10692,214217,6,291721
20161,0.002085,172.31.36.0-255,66,214283,6,291721
20162,0.002093,74.125.200.0-255,8574,222857,6,291721
20163,0.002096,172.31.36.0-255,66,222923,6,291721
20164,0.002143,74.125.200.0-255,7156,230079,6,291721
20165,0.002147,172.31.36.0-255,66,230145,6,291721
20166,0.002153,74.125.200.0-255,5738,235883,6,291721
20167,0.002156,172.31.36.0-255,66,235949,6,291721
20168,0.002163,74.125.200.0-255,7156,243105,6,291721
20169,0.002165,172.31.36.0-255,66,243171,6,291721
20170,0.00217,74.125.200.0-255,5020,248191,6,291721
20171,0.002172,172.31.36.0-255,66,248257,6,291721
20172,0.002178,74.125.200.0-255,5738,253995,6,291721
20173,0.00218,172.31.36.0-255,66,254061,6,291721
20174,0.00224,74.125.200.0-255,7156,261217,6,291721
20175,0.002245,172.31.36.0-255,66,261283,6,291721
20176,0.002253,74.125.200.0-255,8574,269857,6,291721
20177,0.002256,172.31.36.0-255,66,269923,6,291721
20178,0.002261,74.125.200.0-255,4320,274243,6,291721
20179,0.002263,172.31.36.0-255,66,274309,6,291721
20180,0.004491,74.125.200.0-255,5738,280047,6,291721
20181,0.004502,172.31.36.0-255,66,280113,6,291721
20182,0.006716,74.125.200.0-255,5738,285851,6,291721
20183,0.006722,172.31.36.0-255,66,285917,6,291721
20184,0.008957,74.125.200.0-255,5738,291655,6,291721
20185,0.008969,172.31.36.0-255,66,291721,6,291721
20186,0.0,172.217.194.0-255,153,153,6,309667
20187,2e-05,172.31.36.0-255,66,219,6,309667
20188,2.7e-05,172.217.194.0-255,1484,1703,6,309667
20189,3.2e-05,172.31.36.0-255,66,1769,6,309667
20190,3.8e-05,172.217.194.0-255,2902,4671,6,309667
20191,4.1e-05,172.31.36.0-255,66,4737,6,309667
20192,4.9e-05,172.217.194.0-255,7156,11893,6,309667
20193,5.2e-05,172.31.36.0-255,66,11959,6,309667
20194,5.7e-05,172.217.194.0-255,3367,15326,6,309667
20195,6e-05,172.31.36.0-255,66,15392,6,309667
20196,6.8e-05,172.217.194.0-255,5738,21130,6,309667
20197,7.1e-05,172.31.36.0-255,66,21196,6,309667
20198,0.000103,172.217.194.0-255,7156,28352,6,309667
20199,0.000107,172.31.36.0-255,66,28418,6,309667
20200,0.000111,172.217.194.0-255,2543,30961,6,309667
20201,0.000113,172.31.36.0-255,66,31027,6,309667
20202,0.000149,172.217.194.0-255,2902,33929,6,309667
20203,0.000153,172.31.36.0-255,66,33995,6,309667
20204,0.000157,172.217.194.0-255,2902,36897,6,309667
20205,0.00016,172.31.36.0-255,66,36963,6,309667
20206,0.000173,172.217.194.0-255,1484,38447,6,309667
20207,0.000176,172.31.36.0-255,66,38513,6,309667
20208,0.000185,172.217.194.0-255,8574,47087,6,309667
20209,0.000187,172.31.36.0-255,66,47153,6,309667
20210,0.00019,172.217.194.0-255,1125,48278,6,309667
20211,0.000192,172.31.36.0-255,66,48344,6,309667
20212,0.000394,172.217.194.0-255,1484,49828,6,309667
20213,0.000399,172.31.36.0-255,66,49894,6,309667
20214,0.000405,172.217.194.0-255,2902,52796,6,309667
20215,0.000408,172.31.36.0-255,66,52862,6,309667
20216,0.000412,172.217.194.0-255,2902,55764,6,309667
20217,0.000415,172.31.36.0-255,66,55830,6,309667
20218,0.000439,172.217.194.0-255,2902,58732,6,309667
20219,0.000442,172.31.36.0-255,66,58798,6,309667
20220,0.000446,172.217.194.0-255,1484,60282,6,309667
20221,0.000466,172.217.194.0-255,4320,64602,6,309667
20222,0.000469,172.31.36.0-255,66,64668,6,309667
20223,0.000485,172.217.194.0-255,1125,65793,6,309667
20224,0.000514,172.217.194.0-255,4320,70113,6,309667
20225,0.000518,172.31.36.0-255,66,70179,6,309667
20226,0.000524,172.217.194.0-255,5738,75917,6,309667
20227,0.000527,172.31.36.0-255,66,75983,6,309667
20228,0.000561,172.217.194.0-255,7156,83139,6,309667
20229,0.000566,172.31.36.0-255,66,83205,6,309667
20230,0.000588,172.217.194.0-255,5379,88584,6,309667
20231,0.000591,172.31.36.0-255,66,88650,6,309667
20232,0.000611,172.217.194.0-255,4320,92970,6,309667
20233,0.000614,172.31.36.0-255,66,93036,6,309667
20234,0.000633,172.217.194.0-255,6797,99833,6,309667
20235,0.000636,172.31.36.0-255,66,99899,6,309667
20236,0.000652,172.217.194.0-255,1484,101383,6,309667
20237,0.000675,172.217.194.0-255,9992,111375,6,309667
20238,0.000677,172.31.36.0-255,66,111441,6,309667
20239,0.000692,172.31.36.0-255,66,111507,6,309667
20240,0.000715,172.217.194.0-255,1484,112991,6,309667
20241,0.000725,172.217.194.0-255,9274,122265,6,309667
20242,0.000728,172.31.36.0-255,66,122331,6,309667
20243,0.000869,172.217.194.0-255,1484,123815,6,309667
20244,0.000888,172.217.194.0-255,2902,126717,6,309667
20245,0.000891,172.31.36.0-255,66,126783,6,309667
20246,0.000897,172.217.194.0-255,2902,129685,6,309667
20247,0.000899,172.31.36.0-255,66,129751,6,309667
20248,0.000918,172.217.194.0-255,2902,132653,6,309667
20249,0.00092,172.31.36.0-255,66,132719,6,309667
20250,0.000927,172.217.194.0-255,5738,138457,6,309667
20251,0.000929,172.31.36.0-255,66,138523,6,309667
20252,0.000965,172.217.194.0-255,4320,142843,6,309667
20253,0.000967,172.31.36.0-255,66,142909,6,309667
20254,0.000989,172.217.194.0-255,8574,151483,6,309667
20255,0.000992,172.31.36.0-255,66,151549,6,309667
20256,0.000998,172.217.194.0-255,5020,156569,6,309667
20257,0.001,172.31.36.0-255,66,156635,6,309667
20258,0.001007,172.217.194.0-255,5738,162373,6,309667
20259,0.00101,172.31.36.0-255,66,162439,6,309667
20260,0.001015,172.217.194.0-255,4320,166759,6,309667
20261,0.001017,172.31.36.0-255,66,166825,6,309667
20262,0.001039,172.217.194.0-255,1484,168309,6,309667
20263,0.001069,172.217.194.0-255,9992,178301,6,309667
20264,0.001072,172.31.36.0-255,66,178367,6,309667
20265,0.001085,172.31.36.0-255,66,178433,6,309667
20266,0.001101,172.217.194.0-255,766,179199,6,309667
20267,0.001136,172.217.194.0-255,1484,180683,6,309667
20268,0.001139,172.31.36.0-255,66,180749,6,309667
20269,0.001154,172.217.194.0-255,2902,183651,6,309667
20270,0.001157,172.31.36.0-255,66,183717,6,309667
20271,0.00117,172.217.194.0-255,1484,185201,6,309667
20272,0.001174,172.217.194.0-255,2902,188103,6,309667
20273,0.001177,172.31.36.0-255,66,188169,6,309667
20274,0.001218,172.217.194.0-255,7156,195325,6,309667
20275,0.001221,172.31.36.0-255,66,195391,6,309667
20276,0.001241,172.217.194.0-255,1484,196875,6,309667
20277,0.001251,172.217.194.0-255,9992,206867,6,309667
20278,0.001254,172.31.36.0-255,66,206933,6,309667
20279,0.001261,172.217.194.0-255,6438,213371,6,309667
20280,0.001263,172.31.36.0-255,66,213437,6,309667
20281,0.001362,172.217.194.0-255,1484,214921,6,309667
20282,0.001366,172.217.194.0-255,1484,216405,6,309667
20283,0.00137,172.31.36.0-255,66,216471,6,309667
20284,0.001384,172.217.194.0-255,1484,217955,6,309667
20285,0.001389,172.217.194.0-255,2902,220857,6,309667
20286,0.001391,172.31.36.0-255,66,220923,6,309667
20287,0.001413,172.217.194.0-255,2902,223825,6,309667
20288,0.001416,172.31.36.0-255,66,223891,6,309667
20289,0.00142,172.217.194.0-255,2902,226793,6,309667
20290,0.001422,172.31.36.0-255,66,226859,6,309667
20291,0.001447,172.217.194.0-255,8574,235433,6,309667
20292,0.001449,172.31.36.0-255,66,235499,6,309667
20293,0.001465,172.217.194.0-255,1484,236983,6,309667
20294,0.001475,172.217.194.0-255,9992,246975,6,309667
20295,0.001478,172.31.36.0-255,66,247041,6,309667
20296,0.001481,172.217.194.0-255,766,247807,6,309667
20297,0.001576,172.217.194.0-255,1484,249291,6,309667
20298,0.00158,172.31.36.0-255,66,249357,6,309667
20299,0.001586,172.217.194.0-255,2902,252259,6,309667
20300,0.001589,172.31.36.0-255,66,252325,6,309667
20301,0.001617,172.217.194.0-255,5738,258063,6,309667
20302,0.00162,172.31.36.0-255,66,258129,6,309667
20303,0.001627,172.217.194.0-255,5738,263867,6,309667
20304,0.001629,172.31.36.0-255,66,263933,6,309667
20305,0.001643,172.217.194.0-255,4320,268253,6,309667
20306,0.001646,172.31.36.0-255,66,268319,6,309667
20307,0.001689,172.31.36.0-255,66,268385,6,309667
20308,0.001697,172.217.194.0-255,7156,275541,6,309667
20309,0.001699,172.31.36.0-255,66,275607,6,309667
20310,0.001737,172.217.194.0-255,7156,282763,6,309667
20311,0.001741,172.31.36.0-255,66,282829,6,309667
20312,0.001756,172.31.36.0-255,66,282895,6,309667
20313,0.001782,172.217.194.0-255,3602,286497,6,309667
20314,0.001784,172.31.36.0-255,66,286563,6,309667
20315,0.001788,172.217.194.0-255,1484,288047,6,309667
20316,0.001793,172.217.194.0-255,2902,290949,6,309667
20317,0.001794,172.31.36.0-255,66,291015,6,309667
20318,0.0018,172.217.194.0-255,5738,296753,6,309667
20319,0.001802,172.31.36.0-255,66,296819,6,309667
20320,0.001865,172.31.36.0-255,66,296885,6,309667
20321,0.001873,172.217.194.0-255,8574,305459,6,309667
20322,0.001876,172.31.36.0-255,66,305525,6,309667
20323,0.001891,172.31.36.0-255,66,305591,6,309667
20324,0.001906,172.217.194.0-255,2184,307775,6,309667
20325,0.001909,172.31.36.0-255,66,307841,6,309667
20326,0.001912,172.217.194.0-255,1484,309325,6,309667
20327,0.001946,172.217.194.0-255,105,309430,6,309667
20328,0.00195,172.31.36.0-255,66,309496,6,309667
20329,0.009115,172.31.36.0-255,66,309562,6,309667
20330,0.009155,172.31.36.0-255,105,309667,6,309667
20331,0.0,172.217.194.0-255,153,153,6,100025
20332,2.3e-05,172.31.36.0-255,66,219,6,100025
20333,3.1e-05,172.217.194.0-255,1484,1703,6,100025
20334,3.5e-05,172.31.36.0-255,66,1769,6,100025
20335,5e-05,172.217.194.0-255,2902,4671,6,100025
20336,5.4e-05,172.31.36.0-255,66,4737,6,100025
20337,5.9e-05,172.217.194.0-255,2902,7639,6,100025
20338,6.1e-05,172.31.36.0-255,66,7705,6,100025
20339,9.6e-05,172.217.194.0-255,1484,9189,6,100025
20340,9.9e-05,172.31.36.0-255,66,9255,6,100025
20341,0.00018,172.217.194.0-255,4918,14173,6,100025
20342,0.000183,172.31.36.0-255,66,14239,6,100025
20343,0.000549,172.217.194.0-255,1484,15723,6,100025
20344,0.000556,172.31.36.0-255,66,15789,6,100025
20345,0.000564,172.217.194.0-255,2902,18691,6,100025
20346,0.000566,172.31.36.0-255,66,18757,6,100025
20347,0.000619,172.217.194.0-255,4320,23077,6,100025
20348,0.000621,172.31.36.0-255,66,23143,6,100025
20349,0.000638,172.217.194.0-255,1484,24627,6,100025
20350,0.00064,172.31.36.0-255,66,24693,6,100025
20351,0.000706,172.217.194.0-255,6797,31490,6,100025
20352,0.000709,172.31.36.0-255,66,31556,6,100025
20353,0.000823,172.217.194.0-255,4320,35876,6,100025
20354,0.000829,172.31.36.0-255,66,35942,6,100025
20355,0.000866,172.217.194.0-255,9992,45934,6,100025
20356,0.00087,172.31.36.0-255,66,46000,6,100025
20357,0.001072,172.217.194.0-255,8574,54574,6,100025
20358,0.001079,172.31.36.0-255,66,54640,6,100025
20359,0.001207,172.217.194.0-255,7156,61796,6,100025
20360,0.001212,172.31.36.0-255,66,61862,6,100025
20361,0.001243,172.217.194.0-255,3602,65464,6,100025
20362,0.001245,172.31.36.0-255,66,65530,6,100025
20363,0.001365,172.217.194.0-255,340,65870,6,100025
20364,0.00137,172.217.194.0-255,115,65985,6,100025
20365,0.001386,172.217.194.0-255,2902,68887,6,100025
20366,0.001461,172.217.194.0-255,7156,76043,6,100025
20367,0.001555,172.217.194.0-255,2902,78945,6,100025
20368,0.001788,172.217.194.0-255,1484,80429,6,100025
20369,0.001809,172.217.194.0-255,7856,88285,6,100025
20370,0.003631,172.31.36.0-255,66,88351,6,100025
20371,0.006059,172.217.194.0-255,5738,94089,6,100025
20372,0.006067,172.31.36.0-255,66,94155,6,100025
20373,0.008425,172.217.194.0-255,4320,98475,6,100025
20374,0.008435,172.31.36.0-255,66,98541,6,100025
20375,0.008469,172.217.194.0-255,1484,100025,6,100025
20376,0.0,172.217.194.0-255,153,153,6,318898
20377,3.1e-05,172.31.36.0-255,66,219,6,318898
20378,3.8e-05,172.217.194.0-255,1484,1703,6,318898
20379,4.3e-05,172.31.36.0-255,66,1769,6,318898
20380,4.9e-05,172.217.194.0-255,2902,4671,6,318898
20381,5.2e-05,172.31.36.0-255,66,4737,6,318898
20382,5.8e-05,172.217.194.0-255,7156,11893,6,318898
20383,6.2e-05,172.31.36.0-255,66,11959,6,318898
20384,0.000103,172.217.194.0-255,1484,13443,6,318898
20385,0.000107,172.31.36.0-255,66,13509,6,318898
20386,0.00013,172.217.194.0-255,8574,22083,6,318898
20387,0.000134,172.31.36.0-255,66,22149,6,318898
20388,0.000153,172.217.194.0-255,6264,28413,6,318898
20389,0.000155,172.31.36.0-255,66,28479,6,318898
20390,0.000159,172.217.194.0-255,2543,31022,6,318898
20391,0.000162,172.31.36.0-255,66,31088,6,318898
20392,0.000208,172.217.194.0-255,1484,32572,6,318898
20393,0.000211,172.31.36.0-255,66,32638,6,318898
20394,0.000216,172.217.194.0-255,2902,35540,6,318898
20395,0.000218,172.31.36.0-255,66,35606,6,318898
20396,0.000225,172.217.194.0-255,5738,41344,6,318898
20397,0.000227,172.31.36.0-255,66,41410,6,318898
20398,0.000261,172.217.194.0-255,6797,48207,6,318898
20399,0.000265,172.31.36.0-255,66,48273,6,318898
20400,0.000272,172.217.194.0-255,7156,55429,6,318898
20401,0.000275,172.31.36.0-255,66,55495,6,318898
20402,0.000308,172.217.194.0-255,9928,65423,6,318898
20403,0.000312,172.31.36.0-255,66,65489,6,318898
20404,0.000315,172.217.194.0-255,362,65851,6,318898
20405,0.000317,172.31.36.0-255,66,65917,6,318898
20406,0.000442,172.217.194.0-255,1484,67401,6,318898
20407,0.000446,172.31.36.0-255,66,67467,6,318898
20408,0.000452,172.217.194.0-255,2902,70369,6,318898
20409,0.000455,172.217.194.0-255,2902,73271,6,318898
20410,0.000456,172.31.36.0-255,66,73337,6,318898
20411,0.00046,172.31.36.0-255,66,73403,6,318898
20412,0.000469,172.217.194.0-255,2902,76305,6,318898
20413,0.000472,172.31.36.0-255,66,76371,6,318898
20414,0.000491,172.217.194.0-255,4320,80691,6,318898
20415,0.000494,172.31.36.0-255,66,80757,6,318898
20416,0.000523,172.217.194.0-255,8574,89331,6,318898
20417,0.000527,172.31.36.0-255,66,89397,6,318898
20418,0.00053,172.217.194.0-255,7156,96553,6,318898
20419,0.000532,172.31.36.0-255,66,96619,6,318898
20420,0.000558,172.217.194.0-255,3051,99670,6,318898
20421,0.000561,172.31.36.0-255,66,99736,6,318898
20422,0.000598,172.217.194.0-255,1484,101220,6,318898
20423,0.000602,172.217.194.0-255,1484,102704,6,318898
20424,0.000605,172.31.36.0-255,66,102770,6,318898
20425,0.000624,172.217.194.0-255,1484,104254,6,318898
20426,0.000632,172.217.194.0-255,5738,109992,6,318898
20427,0.000635,172.31.36.0-255,66,110058,6,318898
20428,0.000656,172.217.194.0-255,7156,117214,6,318898
20429,0.00066,172.31.36.0-255,66,117280,6,318898
20430,0.000683,172.217.194.0-255,5738,123018,6,318898
20431,0.000687,172.31.36.0-255,66,123084,6,318898
20432,0.000716,172.217.194.0-255,10692,133776,6,318898
20433,0.000719,172.31.36.0-255,66,133842,6,318898
20434,0.000736,172.217.194.0-255,1484,135326,6,318898
20435,0.000759,172.217.194.0-255,9992,145318,6,318898
20436,0.000762,172.31.36.0-255,66,145384,6,318898
20437,0.00077,172.217.194.0-255,7156,152540,6,318898
20438,0.000773,172.31.36.0-255,66,152606,6,318898
20439,0.000817,172.217.194.0-255,4320,156926,6,318898
20440,0.000821,172.31.36.0-255,66,156992,6,318898
20441,0.000849,172.217.194.0-255,10692,167684,6,318898
20442,0.000853,172.31.36.0-255,66,167750,6,318898
20443,0.000856,172.217.194.0-255,1484,169234,6,318898
20444,0.00086,172.217.194.0-255,2902,172136,6,318898
20445,0.000863,172.31.36.0-255,66,172202,6,318898
20446,0.000866,172.217.194.0-255,1484,173686,6,318898
20447,0.000883,172.217.194.0-255,4320,178006,6,318898
20448,0.000885,172.31.36.0-255,66,178072,6,318898
20449,0.000899,172.217.194.0-255,5738,183810,6,318898
20450,0.000903,172.31.36.0-255,66,183876,6,318898
20451,0.000938,172.217.194.0-255,7156,191032,6,318898
20452,0.000941,172.31.36.0-255,66,191098,6,318898
20453,0.000949,172.217.194.0-255,8574,199672,6,318898
20454,0.000951,172.31.36.0-255,66,199738,6,318898
20455,0.000968,172.217.194.0-255,2184,201922,6,318898
20456,0.000971,172.31.36.0-255,66,201988,6,318898
20457,0.000975,172.217.194.0-255,2902,204890,6,318898
20458,0.000977,172.31.36.0-255,66,204956,6,318898
20459,0.00101,172.217.194.0-255,7156,212112,6,318898
20460,0.001013,172.31.36.0-255,66,212178,6,318898
20461,0.001062,172.31.36.0-255,66,212244,6,318898
20462,0.001089,172.217.194.0-255,2902,215146,6,318898
20463,0.001092,172.31.36.0-255,66,215212,6,318898
20464,0.001109,172.31.36.0-255,66,215278,6,318898
20465,0.001116,172.217.194.0-255,8215,223493,6,318898
20466,0.001119,172.31.36.0-255,66,223559,6,318898
20467,0.001163,172.217.194.0-255,1484,225043,6,318898
20468,0.001168,172.217.194.0-255,2902,227945,6,318898
20469,0.001171,172.31.36.0-255,66,228011,6,318898
20470,0.001198,172.217.194.0-255,5738,233749,6,318898
20471,0.001202,172.31.36.0-255,66,233815,6,318898
20472,0.001216,172.31.36.0-255,66,233881,6,318898
20473,0.00122,172.217.194.0-255,2902,236783,6,318898
20474,0.001223,172.31.36.0-255,66,236849,6,318898
20475,0.001257,172.217.194.0-255,7856,244705,6,318898
20476,0.001261,172.31.36.0-255,66,244771,6,318898
20477,0.001268,172.217.194.0-255,5738,250509,6,318898
20478,0.001272,172.31.36.0-255,66,250575,6,318898
20479,0.001307,172.217.194.0-255,2902,253477,6,318898
20480,0.001311,172.31.36.0-255,66,253543,6,318898
20481,0.00132,172.217.194.0-255,9992,263535,6,318898
20482,0.001322,172.31.36.0-255,66,263601,6,318898
20483,0.001329,172.217.194.0-255,5738,269339,6,318898
20484,0.001331,172.31.36.0-255,66,269405,6,318898
20485,0.001363,172.217.194.0-255,7156,276561,6,318898
20486,0.001367,172.31.36.0-255,66,276627,6,318898
20487,0.001371,172.217.194.0-255,2184,278811,6,318898
20488,0.001374,172.31.36.0-255,66,278877,6,318898
20489,0.001431,172.217.194.0-255,1484,280361,6,318898
20490,0.001436,172.217.194.0-255,1484,281845,6,318898
20491,0.001439,172.31.36.0-255,66,281911,6,318898
20492,0.001458,172.217.194.0-255,1484,283395,6,318898
20493,0.00148,172.217.194.0-255,5738,289133,6,318898
20494,0.001484,172.31.36.0-255,66,289199,6,318898
20495,0.001499,172.31.36.0-255,66,289265,6,318898
20496,0.001534,172.217.194.0-255,4320,293585,6,318898
20497,0.001537,172.31.36.0-255,66,293651,6,318898
20498,0.001561,172.217.194.0-255,6438,300089,6,318898
20499,0.001566,172.31.36.0-255,66,300155,6,318898
20500,0.001579,172.31.36.0-255,66,300221,6,318898
20501,0.001584,172.217.194.0-255,4320,304541,6,318898
20502,0.001587,172.31.36.0-255,66,304607,6,318898
20503,0.001613,172.217.194.0-255,2902,307509,6,318898
20504,0.001616,172.31.36.0-255,66,307575,6,318898
20505,0.001673,172.31.36.0-255,66,307641,6,318898
20506,0.001693,172.217.194.0-255,1484,309125,6,318898
20507,0.00171,172.217.194.0-255,2902,312027,6,318898
20508,0.001714,172.31.36.0-255,66,312093,6,318898
20509,0.001748,172.217.194.0-255,2902,314995,6,318898
20510,0.001753,172.217.194.0-255,3332,318327,6,318898
20511,0.001755,172.31.36.0-255,66,318393,6,318898
20512,0.001755,172.217.194.0-255,97,318490,6,318898
20513,0.001759,172.31.36.0-255,66,318556,6,318898
20514,0.001841,172.217.194.0-255,105,318661,6,318898
20515,0.003526,172.31.36.0-255,66,318727,6,318898
20516,0.003556,172.31.36.0-255,105,318832,6,318898
20517,0.005591,172.217.194.0-255,66,318898,6,318898
20518,0.0,172.217.194.0-255,155,155,6,191677
20519,2.6e-05,172.31.36.0-255,66,221,6,191677
20520,3.3e-05,172.217.194.0-255,1484,1705,6,191677
20521,3.7e-05,172.31.36.0-255,66,1771,6,191677
20522,4.2e-05,172.217.194.0-255,2902,4673,6,191677
20523,5.3e-05,172.31.36.0-255,66,4739,6,191677
20524,9.5e-05,172.217.194.0-255,7156,11895,6,191677
20525,9.8e-05,172.31.36.0-255,66,11961,6,191677
20526,0.000126,172.217.194.0-255,2040,14001,6,191677
20527,0.00013,172.31.36.0-255,66,14067,6,191677
20528,0.000134,172.217.194.0-255,2902,16969,6,191677
20529,0.000137,172.31.36.0-255,66,17035,6,191677
20530,0.000155,172.217.194.0-255,2902,19937,6,191677
20531,0.000157,172.31.36.0-255,66,20003,6,191677
20532,0.000184,172.217.194.0-255,4320,24323,6,191677
20533,0.000187,172.31.36.0-255,66,24389,6,191677
20534,0.000199,172.217.194.0-255,5738,30127,6,191677
20535,0.000201,172.31.36.0-255,66,30193,6,191677
20536,0.000204,172.217.194.0-255,1125,31318,6,191677
20537,0.000206,172.31.36.0-255,66,31384,6,191677
20538,0.000264,172.217.194.0-255,1484,32868,6,191677
20539,0.000269,172.31.36.0-255,66,32934,6,191677
20540,0.000298,172.217.194.0-255,2902,35836,6,191677
20541,0.000302,172.31.36.0-255,66,35902,6,191677
20542,0.000308,172.217.194.0-255,5738,41640,6,191677
20543,0.000311,172.31.36.0-255,66,41706,6,191677
20544,0.000344,172.217.194.0-255,9992,51698,6,191677
20545,0.000353,172.31.36.0-255,66,51764,6,191677
20546,0.000381,172.217.194.0-255,2902,54666,6,191677
20547,0.000384,172.31.36.0-255,66,54732,6,191677
20548,0.000394,172.217.194.0-255,10692,65424,6,191677
20549,0.000397,172.31.36.0-255,66,65490,6,191677
20550,0.000415,172.217.194.0-255,645,66135,6,191677
20551,0.00078,172.31.36.0-255,66,66201,6,191677
20552,0.000807,172.217.194.0-255,1484,67685,6,191677
20553,0.000823,172.217.194.0-255,2902,70587,6,191677
20554,0.000826,172.31.36.0-255,66,70653,6,191677
20555,0.00083,172.217.194.0-255,1484,72137,6,191677
20556,0.000848,172.217.194.0-255,4320,76457,6,191677
20557,0.000851,172.31.36.0-255,66,76523,6,191677
20558,0.000885,172.217.194.0-255,7156,83679,6,191677
20559,0.000888,172.31.36.0-255,66,83745,6,191677
20560,0.000903,172.217.194.0-255,5738,89483,6,191677
20561,0.000914,172.217.194.0-255,5738,95221,6,191677
20562,0.000908,172.31.36.0-255,66,95287,6,191677
20563,0.000916,172.31.36.0-255,66,95353,6,191677
20564,0.00095,172.217.194.0-255,5020,100373,6,191677
20565,0.000954,172.31.36.0-255,66,100439,6,191677
20566,0.001008,172.217.194.0-255,1484,101923,6,191677
20567,0.001013,172.217.194.0-255,2902,104825,6,191677
20568,0.001017,172.31.36.0-255,66,104891,6,191677
20569,0.001054,172.217.194.0-255,5738,110629,6,191677
20570,0.001057,172.31.36.0-255,66,110695,6,191677
20571,0.001086,172.217.194.0-255,8574,119269,6,191677
20572,0.001089,172.31.36.0-255,66,119335,6,191677
20573,0.001109,172.217.194.0-255,4320,123655,6,191677
20574,0.001112,172.31.36.0-255,66,123721,6,191677
20575,0.001117,172.217.194.0-255,4320,128041,6,191677
20576,0.001119,172.31.36.0-255,66,128107,6,191677
20577,0.001176,172.217.194.0-255,6438,134545,6,191677
20578,0.001181,172.31.36.0-255,66,134611,6,191677
20579,0.001518,172.217.194.0-255,1484,136095,6,191677
20580,0.001528,172.217.194.0-255,2902,138997,6,191677
20581,0.001533,172.31.36.0-255,66,139063,6,191677
20582,0.001538,172.217.194.0-255,2902,141965,6,191677
20583,0.00154,172.31.36.0-255,66,142031,6,191677
20584,0.001561,172.217.194.0-255,2902,144933,6,191677
20585,0.001564,172.31.36.0-255,66,144999,6,191677
20586,0.001584,172.31.36.0-255,66,145065,6,191677
20587,0.001616,172.217.194.0-255,1484,146549,6,191677
20588,0.001644,172.217.194.0-255,9274,155823,6,191677
20589,0.001647,172.31.36.0-255,66,155889,6,191677
20590,0.001697,172.217.194.0-255,1484,157373,6,191677
20591,0.001703,172.217.194.0-255,2902,160275,6,191677
20592,0.001706,172.31.36.0-255,66,160341,6,191677
20593,0.001738,172.217.194.0-255,5738,166079,6,191677
20594,0.001741,172.31.36.0-255,66,166145,6,191677
20595,0.00178,172.31.36.0-255,66,166211,6,191677
20596,0.001789,172.217.194.0-255,9992,176203,6,191677
20597,0.001796,172.31.36.0-255,66,176269,6,191677
20598,0.001821,172.217.194.0-255,766,177035,6,191677
20599,0.004118,172.217.194.0-255,4320,181355,6,191677
20600,0.004125,172.31.36.0-255,66,181421,6,191677
20601,0.006478,172.217.194.0-255,4320,185741,6,191677
20602,0.006482,172.31.36.0-255,66,185807,6,191677
20603,0.006504,172.217.194.0-255,1484,187291,6,191677
20604,0.008758,172.217.194.0-255,4320,191611,6,191677
20605,0.008765,172.31.36.0-255,66,191677,6,191677
20606,0.0,172.217.194.0-255,152,152,6,342712
20607,3.5e-05,172.31.36.0-255,66,218,6,342712
20608,4.3e-05,172.217.194.0-255,1484,1702,6,342712
20609,4.8e-05,172.31.36.0-255,66,1768,6,342712
20610,5.3e-05,172.217.194.0-255,2902,4670,6,342712
20611,5.6e-05,172.31.36.0-255,66,4736,6,342712
20612,5.9e-05,172.217.194.0-255,1484,6220,6,342712
20613,6.1e-05,172.31.36.0-255,66,6286,6,342712
20614,8.4e-05,172.217.194.0-255,4320,10606,6,342712
20615,8.7e-05,172.31.36.0-255,66,10672,6,342712
20616,9.3e-05,172.217.194.0-255,6303,16975,6,342712
20617,9.6e-05,172.31.36.0-255,66,17041,6,342712
20618,0.00012,172.217.194.0-255,4320,21361,6,342712
20619,0.000123,172.31.36.0-255,66,21427,6,342712
20620,0.000139,172.217.194.0-255,4320,25747,6,342712
20621,0.000142,172.31.36.0-255,66,25813,6,342712
20622,0.000155,172.217.194.0-255,2902,28715,6,342712
20623,0.000157,172.31.36.0-255,66,28781,6,342712
20624,0.000161,172.217.194.0-255,2543,31324,6,342712
20625,0.000163,172.31.36.0-255,66,31390,6,342712
20626,0.000283,172.217.194.0-255,1484,32874,6,342712
20627,0.000287,172.31.36.0-255,66,32940,6,342712
20628,0.000292,172.217.194.0-255,2902,35842,6,342712
20629,0.000294,172.31.36.0-255,66,35908,6,342712
20630,0.000297,172.217.194.0-255,1484,37392,6,342712
20631,0.000299,172.31.36.0-255,66,37458,6,342712
20632,0.000326,172.217.194.0-255,4320,41778,6,342712
20633,0.00033,172.31.36.0-255,66,41844,6,342712
20634,0.00035,172.217.194.0-255,2902,44746,6,342712
20635,0.000352,172.31.36.0-255,66,44812,6,342712
20636,0.000366,172.217.194.0-255,3961,48773,6,342712
20637,0.000369,172.31.36.0-255,66,48839,6,342712
20638,0.000372,172.217.194.0-255,1484,50323,6,342712
20639,0.000397,172.217.194.0-255,5738,56061,6,342712
20640,0.0004,172.31.36.0-255,66,56127,6,342712
20641,0.000434,172.217.194.0-255,2902,59029,6,342712
20642,0.000438,172.31.36.0-255,66,59095,6,342712
20643,0.000462,172.217.194.0-255,7084,66179,6,342712
20644,0.000465,172.31.36.0-255,66,66245,6,342712
20645,0.000741,172.217.194.0-255,99,66344,6,342712
20646,0.000776,172.31.36.0-255,66,66410,6,342712
20647,0.000953,172.217.194.0-255,1484,67894,6,342712
20648,0.000964,172.217.194.0-255,2902,70796,6,342712
20649,0.000968,172.31.36.0-255,66,70862,6,342712
20650,0.000973,172.217.194.0-255,2902,73764,6,342712
20651,0.000975,172.31.36.0-255,66,73830,6,342712
20652,0.000993,172.217.194.0-255,2902,76732,6,342712
20653,0.000996,172.31.36.0-255,66,76798,6,342712
20654,0.001004,172.217.194.0-255,7156,83954,6,342712
20655,0.001006,172.31.36.0-255,66,84020,6,342712
20656,0.001033,172.217.194.0-255,5738,89758,6,342712
20657,0.001037,172.31.36.0-255,66,89824,6,342712
20658,0.001045,172.217.194.0-255,8574,98398,6,342712
20659,0.001048,172.31.36.0-255,66,98464,6,342712
20660,0.001065,172.217.194.0-255,2184,100648,6,342712
20661,0.001067,172.31.36.0-255,66,100714,6,342712
20662,0.00109,172.217.194.0-255,4320,105034,6,342712
20663,0.001094,172.31.36.0-255,66,105100,6,342712
20664,0.001128,172.31.36.0-255,66,105166,6,342712
20665,0.001154,172.217.194.0-255,1484,106650,6,342712
20666,0.001173,172.31.36.0-255,66,106716,6,342712
20667,0.001186,172.31.36.0-255,66,106782,6,342712
20668,0.001342,172.217.194.0-255,1484,108266,6,342712
20669,0.001348,172.217.194.0-255,1484,109750,6,342712
20670,0.001351,172.31.36.0-255,66,109816,6,342712
20671,0.00137,172.217.194.0-255,1484,111300,6,342712
20672,0.001378,172.217.194.0-255,5738,117038,6,342712
20673,0.00138,172.31.36.0-255,66,117104,6,342712
20674,0.001386,172.217.194.0-255,2902,120006,6,342712
20675,0.001388,172.31.36.0-255,66,120072,6,342712
20676,0.001414,172.217.194.0-255,9992,130064,6,342712
20677,0.001417,172.31.36.0-255,66,130130,6,342712
20678,0.001447,172.217.194.0-255,4320,134450,6,342712
20679,0.00145,172.31.36.0-255,66,134516,6,342712
20680,0.001472,172.217.194.0-255,6438,140954,6,342712
20681,0.001474,172.31.36.0-255,66,141020,6,342712
20682,0.001628,172.217.194.0-255,1484,142504,6,342712
20683,0.001633,172.217.194.0-255,2902,145406,6,342712
20684,0.001637,172.31.36.0-255,66,145472,6,342712
20685,0.001671,172.217.194.0-255,5738,151210,6,342712
20686,0.001673,172.31.36.0-255,66,151276,6,342712
20687,0.001685,172.217.194.0-255,1484,152760,6,342712
20688,0.001706,172.217.194.0-255,9992,162752,6,342712
20689,0.00171,172.31.36.0-255,66,162818,6,342712
20690,0.001723,172.217.194.0-255,1484,164302,6,342712
20691,0.001759,172.217.194.0-255,4320,168622,6,342712
20692,0.001762,172.31.36.0-255,66,168688,6,342712
20693,0.001778,172.217.194.0-255,6438,175126,6,342712
20694,0.001782,172.31.36.0-255,66,175192,6,342712
20695,0.00196,172.217.194.0-255,1484,176676,6,342712
20696,0.001966,172.217.194.0-255,2902,179578,6,342712
20697,0.001968,172.31.36.0-255,66,179644,6,342712
20698,0.001987,172.217.194.0-255,2902,182546,6,342712
20699,0.001989,172.31.36.0-255,66,182612,6,342712
20700,0.002011,172.217.194.0-255,2902,185514,6,342712
20701,0.002013,172.31.36.0-255,66,185580,6,342712
20702,0.002026,172.217.194.0-255,4320,189900,6,342712
20703,0.002028,172.31.36.0-255,66,189966,6,342712
20704,0.002047,172.217.194.0-255,2902,192868,6,342712
20705,0.002049,172.31.36.0-255,66,192934,6,342712
20706,0.002058,172.217.194.0-255,8574,201508,6,342712
20707,0.00206,172.31.36.0-255,66,201574,6,342712
20708,0.002082,172.217.194.0-255,5738,207312,6,342712
20709,0.002084,172.31.36.0-255,66,207378,6,342712
20710,0.002092,172.217.194.0-255,2184,209562,6,342712
20711,0.002095,172.31.36.0-255,66,209628,6,342712
20712,0.002187,172.217.194.0-255,1484,211112,6,342712
20713,0.002191,172.217.194.0-255,2902,214014,6,342712
20714,0.002194,172.31.36.0-255,66,214080,6,342712
20715,0.002216,172.217.194.0-255,5738,219818,6,342712
20716,0.002218,172.217.194.0-255,1484,221302,6,342712
20717,0.002221,172.31.36.0-255,66,221368,6,342712
20718,0.002245,172.217.194.0-255,8574,229942,6,342712
20719,0.002247,172.31.36.0-255,66,230008,6,342712
20720,0.002269,172.217.194.0-255,2902,232910,6,342712
20721,0.002278,172.217.194.0-255,10692,243602,6,342712
20722,0.002282,172.31.36.0-255,66,243668,6,342712
20723,0.002285,172.31.36.0-255,66,243734,6,342712
20724,0.002455,172.217.194.0-255,1484,245218,6,342712
20725,0.002469,172.217.194.0-255,1484,246702,6,342712
20726,0.002472,172.31.36.0-255,66,246768,6,342712
20727,0.002487,172.217.194.0-255,1484,248252,6,342712
20728,0.002492,172.217.194.0-255,4320,252572,6,342712
20729,0.002494,172.31.36.0-255,66,252638,6,342712
20730,0.002511,172.217.194.0-255,1484,254122,6,342712
20731,0.002515,172.217.194.0-255,2902,257024,6,342712
20732,0.002517,172.31.36.0-255,66,257090,6,342712
20733,0.002536,172.217.194.0-255,5738,262828,6,342712
20734,0.002538,172.31.36.0-255,66,262894,6,342712
20735,0.002563,172.217.194.0-255,2902,265796,6,342712
20736,0.002566,172.31.36.0-255,66,265862,6,342712
20737,0.00257,172.217.194.0-255,4320,270182,6,342712
20738,0.002572,172.31.36.0-255,66,270248,6,342712
20739,0.002593,172.217.194.0-255,7856,278104,6,342712
20740,0.002596,172.31.36.0-255,66,278170,6,342712
20741,0.0026,172.217.194.0-255,2902,281072,6,342712
20742,0.002602,172.31.36.0-255,66,281138,6,342712
20743,0.002628,172.217.194.0-255,7156,288294,6,342712
20744,0.002636,172.31.36.0-255,66,288360,6,342712
20745,0.002664,172.217.194.0-255,9992,298352,6,342712
20746,0.002677,172.217.194.0-255,766,299118,6,342712
20747,0.002726,172.31.36.0-255,66,299184,6,342712
20748,0.002743,172.217.194.0-255,1484,300668,6,342712
20749,0.002748,172.217.194.0-255,1484,302152,6,342712
20750,0.002751,172.31.36.0-255,66,302218,6,342712
20751,0.002766,172.217.194.0-255,1484,303702,6,342712
20752,0.00279,172.217.194.0-255,5738,309440,6,342712
20753,0.002796,172.217.194.0-255,4320,313760,6,342712
20754,0.00281,172.31.36.0-255,66,313826,6,342712
20755,0.002821,172.217.194.0-255,7156,320982,6,342712
20756,0.002832,172.31.36.0-255,66,321048,6,342712
20757,0.002837,172.217.194.0-255,4320,325368,6,342712
20758,0.002841,172.217.194.0-255,4320,329688,6,342712
20759,0.002856,172.217.194.0-255,3602,333290,6,342712
20760,0.002859,172.217.194.0-255,1484,334774,6,342712
20761,0.002872,172.217.194.0-255,2902,337676,6,342712
20762,0.00288,172.31.36.0-255,66,337742,6,342712
20763,0.002899,172.217.194.0-255,4465,342207,6,342712
20764,0.002901,172.217.194.0-255,97,342304,6,342712
20765,0.00291,172.31.36.0-255,66,342370,6,342712
20766,0.002935,172.217.194.0-255,105,342475,6,342712
20767,0.004402,172.31.36.0-255,66,342541,6,342712
20768,0.004438,172.31.36.0-255,105,342646,6,342712
20769,0.006954,172.217.194.0-255,66,342712,6,342712
20770,0.0,74.125.24.0-255,146,146,6,226710
20771,1.8e-05,172.31.36.0-255,66,212,6,226710
20772,2.5e-05,74.125.24.0-255,1484,1696,6,226710
20773,3.1e-05,172.31.36.0-255,66,1762,6,226710
20774,4.4e-05,74.125.24.0-255,2902,4664,6,226710
20775,4.7e-05,172.31.36.0-255,66,4730,6,226710
20776,5.5e-05,74.125.24.0-255,7156,11886,6,226710
20777,5.8e-05,172.31.36.0-255,66,11952,6,226710
20778,6.2e-05,74.125.24.0-255,2102,14054,6,226710
20779,6.6e-05,172.31.36.0-255,66,14120,6,226710
20780,0.000547,74.125.24.0-255,1484,15604,6,226710
20781,0.000553,172.31.36.0-255,66,15670,6,226710
20782,0.000562,74.125.24.0-255,2902,18572,6,226710
20783,0.000565,172.31.36.0-255,66,18638,6,226710
20784,0.000577,74.125.24.0-255,5738,24376,6,226710
20785,0.00058,172.31.36.0-255,66,24442,6,226710
20786,0.000634,74.125.24.0-255,8215,32657,6,226710
20787,0.000638,172.31.36.0-255,66,32723,6,226710
20788,0.000647,74.125.24.0-255,8574,41297,6,226710
20789,0.00065,172.31.36.0-255,66,41363,6,226710
20790,0.000704,74.125.24.0-255,6797,48160,6,226710
20791,0.000707,172.31.36.0-255,66,48226,6,226710
20792,0.000769,74.125.24.0-255,1484,49710,6,226710
20793,0.000772,172.31.36.0-255,66,49776,6,226710
20794,0.000802,74.125.24.0-255,2902,52678,6,226710
20795,0.000806,172.31.36.0-255,66,52744,6,226710
20796,0.000814,74.125.24.0-255,5738,58482,6,226710
20797,0.000816,172.31.36.0-255,66,58548,6,226710
20798,0.000868,74.125.24.0-255,7093,65641,6,226710
20799,0.000873,172.31.36.0-255,66,65707,6,226710
20800,0.00091,74.125.24.0-255,381,66088,6,226710
20801,0.000914,172.31.36.0-255,66,66154,6,226710
20802,0.001013,74.125.24.0-255,1484,67638,6,226710
20803,0.00102,74.125.24.0-255,2902,70540,6,226710
20804,0.001024,172.31.36.0-255,66,70606,6,226710
20805,0.001058,74.125.24.0-255,5738,76344,6,226710
20806,0.001061,172.31.36.0-255,66,76410,6,226710
20807,0.001069,74.125.24.0-255,5738,82148,6,226710
20808,0.001071,172.31.36.0-255,66,82214,6,226710
20809,0.001099,74.125.24.0-255,1125,83339,6,226710
20810,0.001413,74.125.24.0-255,1484,84823,6,226710
20811,0.00142,172.31.36.0-255,66,84889,6,226710
20812,0.001429,74.125.24.0-255,2902,87791,6,226710
20813,0.001437,172.31.36.0-255,66,87857,6,226710
20814,0.001467,74.125.24.0-255,4320,92177,6,226710
20815,0.00147,172.31.36.0-255,66,92243,6,226710
20816,0.001488,74.125.24.0-255,1484,93727,6,226710
20817,0.001493,74.125.24.0-255,2902,96629,6,226710
20818,0.001495,172.31.36.0-255,66,96695,6,226710
20819,0.001518,74.125.24.0-255,1484,98179,6,226710
20820,0.001533,74.125.24.0-255,2543,100722,6,226710
20821,0.001535,172.31.36.0-255,66,100788,6,226710
20822,0.00287,74.125.24.0-255,1484,102272,6,226710
20823,0.002878,74.125.24.0-255,2902,105174,6,226710
20824,0.002882,172.31.36.0-255,66,105240,6,226710
20825,0.002886,74.125.24.0-255,1484,106724,6,226710
20826,0.002907,74.125.24.0-255,4320,111044,6,226710
20827,0.00291,172.31.36.0-255,66,111110,6,226710
20828,0.002913,74.125.24.0-255,1484,112594,6,226710
20829,0.002917,74.125.24.0-255,1484,114078,6,226710
20830,0.002919,172.31.36.0-255,66,114144,6,226710
20831,0.002922,74.125.24.0-255,1484,115628,6,226710
20832,0.00296,74.125.24.0-255,4320,119948,6,226710
20833,0.002962,172.31.36.0-255,66,120014,6,226710
20834,0.003,172.31.36.0-255,66,120080,6,226710
20835,0.003005,74.125.24.0-255,3602,123682,6,226710
20836,0.003007,172.31.36.0-255,66,123748,6,226710
20837,0.003413,74.125.24.0-255,1484,125232,6,226710
20838,0.00343,74.125.24.0-255,2902,128134,6,226710
20839,0.003434,172.31.36.0-255,66,128200,6,226710
20840,0.003441,74.125.24.0-255,5738,133938,6,226710
20841,0.003443,172.31.36.0-255,66,134004,6,226710
20842,0.003478,74.125.24.0-255,9992,143996,6,226710
20843,0.003482,172.31.36.0-255,66,144062,6,226710
20844,0.003517,74.125.24.0-255,2902,146964,6,226710
20845,0.003519,172.31.36.0-255,66,147030,6,226710
20846,0.003529,74.125.24.0-255,9992,157022,6,226710
20847,0.003531,172.31.36.0-255,66,157088,6,226710
20848,0.003572,74.125.24.0-255,10692,167780,6,226710
20849,0.003575,172.31.36.0-255,66,167846,6,226710
20850,0.003578,74.125.24.0-255,1484,169330,6,226710
20851,0.003593,172.31.36.0-255,66,169396,6,226710
20852,0.003626,74.125.24.0-255,9274,178670,6,226710
20853,0.003629,172.31.36.0-255,66,178736,6,226710
20854,0.003654,74.125.24.0-255,1484,180220,6,226710
20855,0.003658,74.125.24.0-255,2902,183122,6,226710
20856,0.003663,74.125.24.0-255,5738,188860,6,226710
20857,0.003703,172.31.36.0-255,66,188926,6,226710
20858,0.003711,172.31.36.0-255,66,188992,6,226710
20859,0.00373,172.31.36.0-255,66,189058,6,226710
20860,0.003746,172.31.36.0-255,66,189124,6,226710
20861,0.003787,74.125.24.0-255,2184,191308,6,226710
20862,0.00379,172.31.36.0-255,66,191374,6,226710
20863,0.003813,172.31.36.0-255,66,191440,6,226710
20864,0.003824,74.125.24.0-255,10692,202132,6,226710
20865,0.003826,172.31.36.0-255,66,202198,6,226710
20866,0.003831,74.125.24.0-255,2902,205100,6,226710
20867,0.003833,172.31.36.0-255,66,205166,6,226710
20868,0.003849,172.31.36.0-255,66,205232,6,226710
20869,0.003883,172.31.36.0-255,66,205298,6,226710
20870,0.003886,74.125.24.0-255,1484,206782,6,226710
20871,0.003932,172.31.36.0-255,66,206848,6,226710
20872,0.003945,172.31.36.0-255,66,206914,6,226710
20873,0.003969,74.125.24.0-255,2184,209098,6,226710
20874,0.003975,172.31.36.0-255,66,209164,6,226710
20875,0.004025,172.31.36.0-255,66,209230,6,226710
20876,0.004034,74.125.24.0-255,8574,217804,6,226710
20877,0.004036,172.31.36.0-255,66,217870,6,226710
20878,0.004084,172.31.36.0-255,66,217936,6,226710
20879,0.004093,74.125.24.0-255,8366,226302,6,226710
20880,0.004095,172.31.36.0-255,66,226368,6,226710
20881,0.004098,74.125.24.0-255,105,226473,6,226710
20882,0.006173,172.31.36.0-255,66,226539,6,226710
20883,0.006208,172.31.36.0-255,105,226644,6,226710
20884,0.008529,74.125.24.0-255,66,226710,6,226710
20885,0.0,74.125.24.0-255,152,152,6,153005
20886,3.6e-05,172.31.36.0-255,66,218,6,153005
20887,4.4e-05,74.125.24.0-255,1484,1702,6,153005
20888,4.8e-05,172.31.36.0-255,66,1768,6,153005
20889,5.3e-05,74.125.24.0-255,2902,4670,6,153005
20890,5.5e-05,172.31.36.0-255,66,4736,6,153005
20891,6.4e-05,74.125.24.0-255,7156,11892,6,153005
20892,6.8e-05,172.31.36.0-255,66,11958,6,153005
20893,7.1e-05,74.125.24.0-255,2002,13960,6,153005
20894,7.4e-05,172.31.36.0-255,66,14026,6,153005
20895,7.9e-05,74.125.24.0-255,4320,18346,6,153005
20896,8.1e-05,172.31.36.0-255,66,18412,6,153005
20897,0.000101,74.125.24.0-255,1484,19896,6,153005
20898,0.000103,172.31.36.0-255,66,19962,6,153005
20899,0.000126,74.125.24.0-255,5738,25700,6,153005
20900,0.000129,172.31.36.0-255,66,25766,6,153005
20901,0.000135,74.125.24.0-255,5379,31145,6,153005
20902,0.000137,172.31.36.0-255,66,31211,6,153005
20903,0.000493,74.125.24.0-255,1484,32695,6,153005
20904,0.000498,172.31.36.0-255,66,32761,6,153005
20905,0.000504,74.125.24.0-255,2902,35663,6,153005
20906,0.000507,172.31.36.0-255,66,35729,6,153005
20907,0.000511,74.125.24.0-255,2902,38631,6,153005
20908,0.000514,172.31.36.0-255,66,38697,6,153005
20909,0.000519,74.125.24.0-255,2902,41599,6,153005
20910,0.000521,172.31.36.0-255,66,41665,6,153005
20911,0.000537,74.125.24.0-255,1484,43149,6,153005
20912,0.000541,172.31.36.0-255,66,43215,6,153005
20913,0.000568,74.125.24.0-255,4320,47535,6,153005
20914,0.00057,172.31.36.0-255,66,47601,6,153005
20915,0.000594,74.125.24.0-255,5379,52980,6,153005
20916,0.000597,172.31.36.0-255,66,53046,6,153005
20917,0.000601,74.125.24.0-255,1484,54530,6,153005
20918,0.000622,74.125.24.0-255,5738,60268,6,153005
20919,0.000625,172.31.36.0-255,66,60334,6,153005
20920,0.000647,74.125.24.0-255,5379,65713,6,153005
20921,0.000651,172.31.36.0-255,66,65779,6,153005
20922,0.000696,74.125.24.0-255,412,66191,6,153005
20923,0.000873,172.31.36.0-255,66,66257,6,153005
20924,0.000985,74.125.24.0-255,332,66589,6,153005
20925,0.001612,74.125.24.0-255,1484,68073,6,153005
20926,0.001618,172.31.36.0-255,66,68139,6,153005
20927,0.001624,74.125.24.0-255,2902,71041,6,153005
20928,0.001628,172.31.36.0-255,66,71107,6,153005
20929,0.001636,74.125.24.0-255,4320,75427,6,153005
20930,0.001639,172.31.36.0-255,66,75493,6,153005
20931,0.001657,74.125.24.0-255,1484,76977,6,153005
20932,0.001663,74.125.24.0-255,4320,81297,6,153005
20933,0.001665,172.31.36.0-255,66,81363,6,153005
20934,0.001683,74.125.24.0-255,4320,85683,6,153005
20935,0.001685,172.31.36.0-255,66,85749,6,153005
20936,0.001706,74.125.24.0-255,4320,90069,6,153005
20937,0.001708,172.31.36.0-255,66,90135,6,153005
20938,0.001724,74.125.24.0-255,2902,93037,6,153005
20939,0.001726,172.31.36.0-255,66,93103,6,153005
20940,0.001775,74.125.24.0-255,5738,98841,6,153005
20941,0.001777,172.31.36.0-255,66,98907,6,153005
20942,0.00179,74.125.24.0-255,2184,101091,6,153005
20943,0.001792,172.31.36.0-255,66,101157,6,153005
20944,0.001915,74.125.24.0-255,1484,102641,6,153005
20945,0.001927,74.125.24.0-255,2902,105543,6,153005
20946,0.001929,172.31.36.0-255,66,105609,6,153005
20947,0.00195,74.125.24.0-255,5738,111347,6,153005
20948,0.001952,172.31.36.0-255,66,111413,6,153005
20949,0.00198,74.125.24.0-255,1484,112897,6,153005
20950,0.002001,74.125.24.0-255,7156,120053,6,153005
20951,0.002004,172.31.36.0-255,66,120119,6,153005
20952,0.002022,74.125.24.0-255,4320,124439,6,153005
20953,0.002024,172.31.36.0-255,66,124505,6,153005
20954,0.002028,74.125.24.0-255,2902,127407,6,153005
20955,0.00203,172.31.36.0-255,66,127473,6,153005
20956,0.002049,74.125.24.0-255,7856,135329,6,153005
20957,0.002051,172.31.36.0-255,66,135395,6,153005
20958,0.004235,74.125.24.0-255,1484,136879,6,153005
20959,0.004253,74.125.24.0-255,4320,141199,6,153005
20960,0.004256,172.31.36.0-255,66,141265,6,153005
20961,0.006257,74.125.24.0-255,2902,144167,6,153005
20962,0.00626,172.31.36.0-255,66,144233,6,153005
20963,0.006278,74.125.24.0-255,2902,147135,6,153005
20964,0.006281,172.31.36.0-255,66,147201,6,153005
20965,0.008276,74.125.24.0-255,5738,152939,6,153005
20966,0.008285,172.31.36.0-255,66,153005,6,153005
20967,0.0,172.217.194.0-255,146,146,6,350933
20968,3e-05,172.31.36.0-255,66,212,6,350933
20969,3.6e-05,172.217.194.0-255,1484,1696,6,350933
20970,4.1e-05,172.31.36.0-255,66,1762,6,350933
20971,4.6e-05,172.217.194.0-255,2902,4664,6,350933
20972,4.8e-05,172.31.36.0-255,66,4730,6,350933
20973,5.6e-05,172.217.194.0-255,7156,11886,6,350933
20974,5.8e-05,172.31.36.0-255,66,11952,6,350933
20975,6.2e-05,172.217.194.0-255,2012,13964,6,350933
20976,6.5e-05,172.31.36.0-255,66,14030,6,350933
20977,0.000152,172.217.194.0-255,1484,15514,6,350933
20978,0.000156,172.31.36.0-255,66,15580,6,350933
20979,0.000181,172.217.194.0-255,2902,18482,6,350933
20980,0.000184,172.31.36.0-255,66,18548,6,350933
20981,0.000191,172.217.194.0-255,5738,24286,6,350933
20982,0.000193,172.31.36.0-255,66,24352,6,350933
20983,0.000219,172.217.194.0-255,4320,28672,6,350933
20984,0.000223,172.31.36.0-255,66,28738,6,350933
20985,0.000237,172.217.194.0-255,2543,31281,6,350933
20986,0.000239,172.31.36.0-255,66,31347,6,350933
20987,0.000258,172.217.194.0-255,2902,34249,6,350933
20988,0.000261,172.31.36.0-255,66,34315,6,350933
20989,0.000283,172.217.194.0-255,4320,38635,6,350933
20990,0.000286,172.31.36.0-255,66,38701,6,350933
20991,0.0003,172.217.194.0-255,4320,43021,6,350933
20992,0.000305,172.31.36.0-255,66,43087,6,350933
20993,0.000318,172.217.194.0-255,4320,47407,6,350933
20994,0.000321,172.31.36.0-255,66,47473,6,350933
20995,0.000324,172.217.194.0-255,1125,48598,6,350933
20996,0.000326,172.31.36.0-255,66,48664,6,350933
20997,0.000357,172.217.194.0-255,1484,50148,6,350933
20998,0.00036,172.31.36.0-255,66,50214,6,350933
20999,0.000381,172.217.194.0-255,2902,53116,6,350933
21000,0.000384,172.31.36.0-255,66,53182,6,350933
21001,0.00041,172.217.194.0-255,5738,58920,6,350933
21002,0.000413,172.31.36.0-255,66,58986,6,350933
21003,0.000421,172.217.194.0-255,6797,65783,6,350933
21004,0.000423,172.31.36.0-255,66,65849,6,350933
21005,0.000445,172.217.194.0-255,647,66496,6,350933
21006,0.000447,172.31.36.0-255,66,66562,6,350933
21007,0.000589,172.217.194.0-255,1484,68046,6,350933
21008,0.000594,172.31.36.0-255,66,68112,6,350933
21009,0.000599,172.217.194.0-255,2902,71014,6,350933
21010,0.000601,172.31.36.0-255,66,71080,6,350933
21011,0.000609,172.217.194.0-255,5738,76818,6,350933
21012,0.000611,172.31.36.0-255,66,76884,6,350933
21013,0.000617,172.217.194.0-255,4320,81204,6,350933
21014,0.00062,172.31.36.0-255,66,81270,6,350933
21015,0.000642,172.217.194.0-255,1484,82754,6,350933
21016,0.000645,172.31.36.0-255,66,82820,6,350933
21017,0.000683,172.217.194.0-255,9992,92812,6,350933
21018,0.000685,172.31.36.0-255,66,92878,6,350933
21019,0.000703,172.217.194.0-255,3961,96839,6,350933
21020,0.000706,172.31.36.0-255,66,96905,6,350933
21021,0.000711,172.217.194.0-255,3961,100866,6,350933
21022,0.000714,172.31.36.0-255,66,100932,6,350933
21023,0.000749,172.217.194.0-255,1484,102416,6,350933
21024,0.000753,172.31.36.0-255,66,102482,6,350933
21025,0.000758,172.217.194.0-255,2902,105384,6,350933
21026,0.00076,172.31.36.0-255,66,105450,6,350933
21027,0.000773,172.217.194.0-255,2902,108352,6,350933
21028,0.000775,172.31.36.0-255,66,108418,6,350933
21029,0.000796,172.217.194.0-255,2902,111320,6,350933
21030,0.000802,172.31.36.0-255,66,111386,6,350933
21031,0.000818,172.31.36.0-255,66,111452,6,350933
21032,0.000825,172.217.194.0-255,4320,115772,6,350933
21033,0.000832,172.31.36.0-255,66,115838,6,350933
21034,0.000844,172.217.194.0-255,6438,122276,6,350933
21035,0.00086,172.31.36.0-255,66,122342,6,350933
21036,0.001087,172.217.194.0-255,1484,123826,6,350933
21037,0.001103,172.217.194.0-255,2902,126728,6,350933
21038,0.001106,172.31.36.0-255,66,126794,6,350933
21039,0.001139,172.217.194.0-255,5738,132532,6,350933
21040,0.001146,172.217.194.0-255,5738,138270,6,350933
21041,0.00116,172.217.194.0-255,4320,142590,6,350933
21042,0.001206,172.217.194.0-255,5738,148328,6,350933
21043,0.001221,172.217.194.0-255,2902,151230,6,350933
21044,0.001242,172.217.194.0-255,5020,156250,6,350933
21045,0.001377,172.217.194.0-255,1484,157734,6,350933
21046,0.001408,172.217.194.0-255,2902,160636,6,350933
21047,0.001436,172.217.194.0-255,4320,164956,6,350933
21048,0.001445,172.217.194.0-255,1484,166440,6,350933
21049,0.001462,172.217.194.0-255,4320,170760,6,350933
21050,0.001489,172.217.194.0-255,4320,175080,6,350933
21051,0.001503,172.217.194.0-255,5738,180818,6,350933
21052,0.001525,172.217.194.0-255,1484,182302,6,350933
21053,0.001533,172.217.194.0-255,7856,190158,6,350933
21054,0.001606,172.217.194.0-255,1484,191642,6,350933
21055,0.00161,172.217.194.0-255,1484,193126,6,350933
21056,0.001631,172.217.194.0-255,1484,194610,6,350933
21057,0.001638,172.217.194.0-255,5738,200348,6,350933
21058,0.001655,172.217.194.0-255,4320,204668,6,350933
21059,0.001679,172.217.194.0-255,7156,211824,6,350933
21060,0.0017,172.217.194.0-255,5738,217562,6,350933
21061,0.001718,172.217.194.0-255,6438,224000,6,350933
21062,0.001751,172.217.194.0-255,1484,225484,6,350933
21063,0.001761,172.217.194.0-255,2902,228386,6,350933
21064,0.001774,172.217.194.0-255,2902,231288,6,350933
21065,0.001786,172.217.194.0-255,2902,234190,6,350933
21066,0.001789,172.217.194.0-255,1484,235674,6,350933
21067,0.001819,172.217.194.0-255,8574,244248,6,350933
21068,0.001823,172.217.194.0-255,2902,247150,6,350933
21069,0.001842,172.217.194.0-255,8574,255724,6,350933
21070,0.00186,172.217.194.0-255,2184,257908,6,350933
21071,0.001877,172.217.194.0-255,2902,260810,6,350933
21072,0.001899,172.217.194.0-255,7156,267966,6,350933
21073,0.001987,172.217.194.0-255,2902,270868,6,350933
21074,0.002005,172.217.194.0-255,2902,273770,6,350933
21075,0.002018,172.217.194.0-255,4320,278090,6,350933
21076,0.002033,172.217.194.0-255,7156,285246,6,350933
21077,0.002048,172.217.194.0-255,3602,288848,6,350933
21078,0.002079,172.217.194.0-255,1484,290332,6,350933
21079,0.002098,172.217.194.0-255,7156,297488,6,350933
21080,0.002122,172.217.194.0-255,9274,306762,6,350933
21081,0.002127,172.217.194.0-255,4320,311082,6,350933
21082,0.002149,172.217.194.0-255,9992,321074,6,350933
21083,0.002161,172.217.194.0-255,4320,325394,6,350933
21084,0.002165,172.217.194.0-255,2902,328296,6,350933
21085,0.002186,172.217.194.0-255,7856,336152,6,350933
21086,0.002234,172.217.194.0-255,4320,340472,6,350933
21087,0.002271,172.217.194.0-255,1484,341956,6,350933
21088,0.002294,172.217.194.0-255,5738,347694,6,350933
21089,0.002316,172.217.194.0-255,2963,350657,6,350933
21090,0.002318,172.217.194.0-255,105,350762,6,350933
21091,0.005499,172.31.36.0-255,66,350828,6,350933
21092,0.007849,172.31.36.0-255,105,350933,6,350933
21093,0.0,172.217.194.0-255,153,153,6,168590
21094,3e-05,172.31.36.0-255,66,219,6,168590
21095,3.8e-05,172.217.194.0-255,1484,1703,6,168590
21096,4.2e-05,172.31.36.0-255,66,1769,6,168590
21097,4.7e-05,172.217.194.0-255,2902,4671,6,168590
21098,5e-05,172.31.36.0-255,66,4737,6,168590
21099,5.6e-05,172.217.194.0-255,7156,11893,6,168590
21100,5.9e-05,172.31.36.0-255,66,11959,6,168590
21101,6.3e-05,172.217.194.0-255,2147,14106,6,168590
21102,6.5e-05,172.31.36.0-255,66,14172,6,168590
21103,0.000109,172.217.194.0-255,5738,19910,6,168590
21104,0.000113,172.31.36.0-255,66,19976,6,168590
21105,0.000126,172.217.194.0-255,1484,21460,6,168590
21106,0.000128,172.31.36.0-255,66,21526,6,168590
21107,0.000136,172.217.194.0-255,8574,30100,6,168590
21108,0.000139,172.31.36.0-255,66,30166,6,168590
21109,0.000142,172.217.194.0-255,1125,31291,6,168590
21110,0.000144,172.31.36.0-255,66,31357,6,168590
21111,0.000218,172.217.194.0-255,1484,32841,6,168590
21112,0.000222,172.31.36.0-255,66,32907,6,168590
21113,0.000227,172.217.194.0-255,2902,35809,6,168590
21114,0.00023,172.31.36.0-255,66,35875,6,168590
21115,0.000232,172.217.194.0-255,1484,37359,6,168590
21116,0.000234,172.31.36.0-255,66,37425,6,168590
21117,0.000259,172.217.194.0-255,4320,41745,6,168590
21118,0.000262,172.31.36.0-255,66,41811,6,168590
21119,0.00027,172.217.194.0-255,6797,48608,6,168590
21120,0.000272,172.31.36.0-255,66,48674,6,168590
21121,0.000275,172.217.194.0-255,1484,50158,6,168590
21122,0.000277,172.31.36.0-255,66,50224,6,168590
21123,0.000314,172.31.36.0-255,66,50290,6,168590
21124,0.000318,172.217.194.0-255,2819,53109,6,168590
21125,0.00032,172.31.36.0-255,66,53175,6,168590
21126,0.000323,172.217.194.0-255,120,53295,6,168590
21127,0.000506,172.217.194.0-255,379,53674,6,168590
21128,0.000792,172.217.194.0-255,1484,55158,6,168590
21129,0.000797,172.31.36.0-255,66,55224,6,168590
21130,0.000802,172.217.194.0-255,2902,58126,6,168590
21131,0.000804,172.31.36.0-255,66,58192,6,168590
21132,0.000807,172.217.194.0-255,1484,59676,6,168590
21133,0.000832,172.217.194.0-255,4320,63996,6,168590
21134,0.000835,172.31.36.0-255,66,64062,6,168590
21135,0.000848,172.31.36.0-255,66,64128,6,168590
21136,0.000879,172.217.194.0-255,10692,74820,6,168590
21137,0.000882,172.31.36.0-255,66,74886,6,168590
21138,0.001913,172.217.194.0-255,1484,76370,6,168590
21139,0.001924,172.217.194.0-255,2902,79272,6,168590
21140,0.001929,172.31.36.0-255,66,79338,6,168590
21141,0.001935,172.217.194.0-255,1484,80822,6,168590
21142,0.001954,172.217.194.0-255,4320,85142,6,168590
21143,0.001956,172.31.36.0-255,66,85208,6,168590
21144,0.001959,172.217.194.0-255,1484,86692,6,168590
21145,0.001984,172.31.36.0-255,66,86758,6,168590
21146,0.002024,172.217.194.0-255,1484,88242,6,168590
21147,0.002044,172.217.194.0-255,8574,96816,6,168590
21148,0.002047,172.31.36.0-255,66,96882,6,168590
21149,0.00205,172.217.194.0-255,766,97648,6,168590
21150,0.002108,172.217.194.0-255,1484,99132,6,168590
21151,0.002111,172.31.36.0-255,66,99198,6,168590
21152,0.002115,172.217.194.0-255,2902,102100,6,168590
21153,0.002117,172.31.36.0-255,66,102166,6,168590
21154,0.002138,172.217.194.0-255,1484,103650,6,168590
21155,0.002153,172.217.194.0-255,4320,107970,6,168590
21156,0.002155,172.31.36.0-255,66,108036,6,168590
21157,0.00216,172.217.194.0-255,4320,112356,6,168590
21158,0.002162,172.31.36.0-255,66,112422,6,168590
21159,0.002179,172.217.194.0-255,8574,120996,6,168590
21160,0.002181,172.31.36.0-255,66,121062,6,168590
21161,0.002187,172.217.194.0-255,5738,126800,6,168590
21162,0.002189,172.31.36.0-255,66,126866,6,168590
21163,0.002205,172.217.194.0-255,2902,129768,6,168590
21164,0.002206,172.31.36.0-255,66,129834,6,168590
21165,0.002223,172.217.194.0-255,2184,132018,6,168590
21166,0.002226,172.31.36.0-255,66,132084,6,168590
21167,0.002265,172.217.194.0-255,2902,134986,6,168590
21168,0.002267,172.31.36.0-255,66,135052,6,168590
21169,0.002289,172.217.194.0-255,4320,139372,6,168590
21170,0.002291,172.31.36.0-255,66,139438,6,168590
21171,0.002298,172.217.194.0-255,8574,148012,6,168590
21172,0.0023,172.31.36.0-255,66,148078,6,168590
21173,0.002334,172.217.194.0-255,2902,150980,6,168590
21174,0.002337,172.31.36.0-255,66,151046,6,168590
21175,0.002367,172.31.36.0-255,66,151112,6,168590
21176,0.002396,172.31.36.0-255,66,151178,6,168590
21177,0.004708,172.217.194.0-255,5738,156916,6,168590
21178,0.004711,172.31.36.0-255,66,156982,6,168590
21179,0.007016,172.217.194.0-255,5738,162720,6,168590
21180,0.007024,172.31.36.0-255,66,162786,6,168590
21181,0.009321,172.217.194.0-255,5738,168524,6,168590
21182,0.009329,172.31.36.0-255,66,168590,6,168590
21183,0.0,74.125.24.0-255,153,153,6,241221
21184,2.4e-05,172.31.36.0-255,66,219,6,241221
21185,3.2e-05,74.125.24.0-255,1484,1703,6,241221
21186,3.6e-05,172.31.36.0-255,66,1769,6,241221
21187,4.2e-05,74.125.24.0-255,2902,4671,6,241221
21188,4.5e-05,172.31.36.0-255,66,4737,6,241221
21189,5.2e-05,74.125.24.0-255,4320,9057,6,241221
21190,5.5e-05,172.31.36.0-255,66,9123,6,241221
21191,8.4e-05,74.125.24.0-255,4936,14059,6,241221
21192,8.7e-05,172.31.36.0-255,66,14125,6,241221
21193,0.000249,74.125.24.0-255,1484,15609,6,241221
21194,0.000254,172.31.36.0-255,66,15675,6,241221
21195,0.00026,74.125.24.0-255,2902,18577,6,241221
21196,0.000262,172.31.36.0-255,66,18643,6,241221
21197,0.000266,74.125.24.0-255,1484,20127,6,241221
21198,0.000268,172.31.36.0-255,66,20193,6,241221
21199,0.000284,74.125.24.0-255,4320,24513,6,241221
21200,0.000287,172.31.36.0-255,66,24579,6,241221
21201,0.00033,74.125.24.0-255,6797,31376,6,241221
21202,0.000333,172.31.36.0-255,66,31442,6,241221
21203,0.000354,74.125.24.0-255,2902,34344,6,241221
21204,0.000356,172.31.36.0-255,66,34410,6,241221
21205,0.000379,74.125.24.0-255,4320,38730,6,241221
21206,0.000382,172.31.36.0-255,66,38796,6,241221
21207,0.000401,74.125.24.0-255,1484,40280,6,241221
21208,0.000403,172.31.36.0-255,66,40346,6,241221
21209,0.000428,74.125.24.0-255,8215,48561,6,241221
21210,0.000431,172.31.36.0-255,66,48627,6,241221
21211,0.000446,74.125.24.0-255,1484,50111,6,241221
21212,0.000448,172.31.36.0-255,66,50177,6,241221
21213,0.000452,74.125.24.0-255,1484,51661,6,241221
21214,0.000454,172.31.36.0-255,66,51727,6,241221
21215,0.000479,74.125.24.0-255,1484,53211,6,241221
21216,0.000481,172.31.36.0-255,66,53277,6,241221
21217,0.000488,74.125.24.0-255,5738,59015,6,241221
21218,0.00049,172.31.36.0-255,66,59081,6,241221
21219,0.000498,74.125.24.0-255,6797,65878,6,241221
21220,0.000502,172.31.36.0-255,66,65944,6,241221
21221,0.000504,74.125.24.0-255,645,66589,6,241221
21222,0.000506,172.31.36.0-255,66,66655,6,241221
21223,0.000628,74.125.24.0-255,1484,68139,6,241221
21224,0.000633,172.31.36.0-255,66,68205,6,241221
21225,0.000638,74.125.24.0-255,2902,71107,6,241221
21226,0.000641,172.31.36.0-255,66,71173,6,241221
21227,0.000671,74.125.24.0-255,5738,76911,6,241221
21228,0.000675,172.31.36.0-255,66,76977,6,241221
21229,0.000711,172.31.36.0-255,66,77043,6,241221
21230,0.000719,74.125.24.0-255,7156,84199,6,241221
21231,0.000721,172.31.36.0-255,66,84265,6,241221
21232,0.000769,74.125.24.0-255,4320,88585,6,241221
21233,0.000781,172.31.36.0-255,66,88651,6,241221
21234,0.000797,74.125.24.0-255,1484,90135,6,241221
21235,0.00081,74.125.24.0-255,218,90353,6,241221
21236,0.000826,74.125.24.0-255,4320,94673,6,241221
21237,0.000845,74.125.24.0-255,7156,101829,6,241221
21238,0.00085,74.125.24.0-255,4320,106149,6,241221
21239,0.000856,172.31.36.0-255,66,106215,6,241221
21240,0.000874,74.125.24.0-255,8574,114789,6,241221
21241,0.000899,74.125.24.0-255,9274,124063,6,241221
21242,0.000912,172.31.36.0-255,66,124129,6,241221
21243,0.001115,74.125.24.0-255,1484,125613,6,241221
21244,0.001121,74.125.24.0-255,2902,128515,6,241221
21245,0.001138,74.125.24.0-255,2902,131417,6,241221
21246,0.001141,172.31.36.0-255,66,131483,6,241221
21247,0.001147,172.31.36.0-255,66,131549,6,241221
21248,0.001162,74.125.24.0-255,2902,134451,6,241221
21249,0.00118,74.125.24.0-255,5738,140189,6,241221
21250,0.001197,74.125.24.0-255,7156,147345,6,241221
21251,0.001237,74.125.24.0-255,7156,154501,6,241221
21252,0.001255,74.125.24.0-255,2902,157403,6,241221
21253,0.001258,74.125.24.0-255,766,158169,6,241221
21254,0.001269,172.31.36.0-255,66,158235,6,241221
21255,0.001492,74.125.24.0-255,1484,159719,6,241221
21256,0.001498,74.125.24.0-255,2902,162621,6,241221
21257,0.001522,74.125.24.0-255,4320,166941,6,241221
21258,0.001526,172.31.36.0-255,66,167007,6,241221
21259,0.001532,172.31.36.0-255,66,167073,6,241221
21260,0.001539,74.125.24.0-255,1484,168557,6,241221
21261,0.001542,74.125.24.0-255,1484,170041,6,241221
21262,0.001566,74.125.24.0-255,5738,175779,6,241221
21263,0.001581,74.125.24.0-255,7156,182935,6,241221
21264,0.00159,74.125.24.0-255,9274,192209,6,241221
21265,0.001607,172.31.36.0-255,66,192275,6,241221
21266,0.00171,74.125.24.0-255,1484,193759,6,241221
21267,0.001716,74.125.24.0-255,2902,196661,6,241221
21268,0.001719,172.31.36.0-255,66,196727,6,241221
21269,0.001723,74.125.24.0-255,1484,198211,6,241221
21270,0.00174,74.125.24.0-255,4320,202531,6,241221
21271,0.001753,172.31.36.0-255,66,202597,6,241221
21272,0.00176,74.125.24.0-255,5738,208335,6,241221
21273,0.001764,172.31.36.0-255,66,208401,6,241221
21274,0.001774,74.125.24.0-255,2902,211303,6,241221
21275,0.001782,74.125.24.0-255,5738,217041,6,241221
21276,0.0018,74.125.24.0-255,4320,221361,6,241221
21277,0.001814,74.125.24.0-255,4320,225681,6,241221
21278,0.00182,172.31.36.0-255,66,225747,6,241221
21279,0.001875,74.125.24.0-255,4320,230067,6,241221
21280,0.001884,172.31.36.0-255,66,230133,6,241221
21281,0.001899,74.125.24.0-255,2184,232317,6,241221
21282,0.001916,172.31.36.0-255,66,232383,6,241221
21283,0.003937,74.125.24.0-255,2902,235285,6,241221
21284,0.00395,172.31.36.0-255,66,235351,6,241221
21285,0.003994,74.125.24.0-255,2902,238253,6,241221
21286,0.006017,74.125.24.0-255,2902,241155,6,241221
21287,0.008313,172.31.36.0-255,66,241221,6,241221
21288,0.0,74.125.24.0-255,152,152,6,203134
21289,2.3e-05,172.31.36.0-255,66,218,6,203134
21290,3.1e-05,74.125.24.0-255,1484,1702,6,203134
21291,3.7e-05,172.31.36.0-255,66,1768,6,203134
21292,4.2e-05,74.125.24.0-255,2902,4670,6,203134
21293,4.7e-05,172.31.36.0-255,66,4736,6,203134
21294,5.5e-05,74.125.24.0-255,7156,11892,6,203134
21295,5.8e-05,172.31.36.0-255,66,11958,6,203134
21296,0.000102,172.31.36.0-255,66,12024,6,203134
21297,0.000107,74.125.24.0-255,2543,14567,6,203134
21298,0.000109,172.31.36.0-255,66,14633,6,203134
21299,0.000545,74.125.24.0-255,1484,16117,6,203134
21300,0.00055,172.31.36.0-255,66,16183,6,203134
21301,0.000554,74.125.24.0-255,1484,17667,6,203134
21302,0.000556,172.31.36.0-255,66,17733,6,203134
21303,0.000574,74.125.24.0-255,1484,19217,6,203134
21304,0.000577,172.31.36.0-255,66,19283,6,203134
21305,0.000584,74.125.24.0-255,5738,25021,6,203134
21306,0.000587,172.31.36.0-255,66,25087,6,203134
21307,0.000592,74.125.24.0-255,4320,29407,6,203134
21308,0.000595,172.31.36.0-255,66,29473,6,203134
21309,0.000628,172.31.36.0-255,66,29539,6,203134
21310,0.000636,74.125.24.0-255,6797,36336,6,203134
21311,0.000639,172.31.36.0-255,66,36402,6,203134
21312,0.000678,74.125.24.0-255,647,37049,6,203134
21313,0.00068,172.31.36.0-255,66,37115,6,203134
21314,0.000763,74.125.24.0-255,1484,38599,6,203134
21315,0.000767,172.31.36.0-255,66,38665,6,203134
21316,0.000772,74.125.24.0-255,2902,41567,6,203134
21317,0.000774,172.31.36.0-255,66,41633,6,203134
21318,0.000803,74.125.24.0-255,5738,47371,6,203134
21319,0.000819,74.125.24.0-255,4320,51691,6,203134
21320,0.00084,74.125.24.0-255,4320,56011,6,203134
21321,0.000863,74.125.24.0-255,4320,60331,6,203134
21322,0.000866,74.125.24.0-255,1484,61815,6,203134
21323,0.000872,172.31.36.0-255,66,61881,6,203134
21324,0.000888,74.125.24.0-255,4320,66201,6,203134
21325,0.000912,74.125.24.0-255,4320,70521,6,203134
21326,0.000932,74.125.24.0-255,2902,73423,6,203134
21327,0.000952,74.125.24.0-255,4320,77743,6,203134
21328,0.000969,74.125.24.0-255,2902,80645,6,203134
21329,0.000996,74.125.24.0-255,6947,87592,6,203134
21330,0.001016,74.125.24.0-255,1484,89076,6,203134
21331,0.001021,74.125.24.0-255,2902,91978,6,203134
21332,0.001027,74.125.24.0-255,4320,96298,6,203134
21333,0.001049,74.125.24.0-255,1484,97782,6,203134
21334,0.001063,74.125.24.0-255,1484,99266,6,203134
21335,0.001073,74.125.24.0-255,9274,108540,6,203134
21336,0.001199,172.31.36.0-255,66,108606,6,203134
21337,0.001915,74.125.24.0-255,1484,110090,6,203134
21338,0.001921,74.125.24.0-255,2902,112992,6,203134
21339,0.001925,172.31.36.0-255,66,113058,6,203134
21340,0.001931,74.125.24.0-255,2902,115960,6,203134
21341,0.001945,172.31.36.0-255,66,116026,6,203134
21342,0.00195,74.125.24.0-255,2902,118928,6,203134
21343,0.001957,74.125.24.0-255,7156,126084,6,203134
21344,0.001963,172.31.36.0-255,66,126150,6,203134
21345,0.001973,74.125.24.0-255,2902,129052,6,203134
21346,0.002004,74.125.24.0-255,2184,131236,6,203134
21347,0.002012,172.31.36.0-255,66,131302,6,203134
21348,0.002029,74.125.24.0-255,1484,132786,6,203134
21349,0.002044,74.125.24.0-255,2902,135688,6,203134
21350,0.00205,74.125.24.0-255,5738,141426,6,203134
21351,0.002062,172.31.36.0-255,66,141492,6,203134
21352,0.002091,74.125.24.0-255,8574,150066,6,203134
21353,0.002096,172.31.36.0-255,66,150132,6,203134
21354,0.002117,74.125.24.0-255,4320,154452,6,203134
21355,0.002125,74.125.24.0-255,8574,163026,6,203134
21356,0.002139,74.125.24.0-255,1484,164510,6,203134
21357,0.002143,172.31.36.0-255,66,164576,6,203134
21358,0.002186,172.31.36.0-255,66,164642,6,203134
21359,0.002194,74.125.24.0-255,6438,171080,6,203134
21360,0.002243,172.31.36.0-255,66,171146,6,203134
21361,0.002301,74.125.24.0-255,5738,176884,6,203134
21362,0.002327,74.125.24.0-255,8574,185458,6,203134
21363,0.002331,172.31.36.0-255,66,185524,6,203134
21364,0.002339,172.31.36.0-255,66,185590,6,203134
21365,0.004623,74.125.24.0-255,5738,191328,6,203134
21366,0.004633,172.31.36.0-255,66,191394,6,203134
21367,0.006882,74.125.24.0-255,5738,197132,6,203134
21368,0.006887,172.31.36.0-255,66,197198,6,203134
21369,0.009213,74.125.24.0-255,2902,200100,6,203134
21370,0.009216,172.31.36.0-255,66,200166,6,203134
21371,0.009235,74.125.24.0-255,2902,203068,6,203134
21372,0.009238,172.31.36.0-255,66,203134,6,203134
21373,0.0,74.125.24.0-255,152,152,6,156758
21374,3e-05,172.31.36.0-255,66,218,6,156758
21375,3.8e-05,74.125.24.0-255,1484,1702,6,156758
21376,4.4e-05,172.31.36.0-255,66,1768,6,156758
21377,4.8e-05,74.125.24.0-255,2902,4670,6,156758
21378,5.1e-05,172.31.36.0-255,66,4736,6,156758
21379,5.7e-05,74.125.24.0-255,7156,11892,6,156758
21380,6e-05,172.31.36.0-255,66,11958,6,156758
21381,6.5e-05,74.125.24.0-255,2067,14025,6,156758
21382,6.7e-05,172.31.36.0-255,66,14091,6,156758
21383,0.000381,74.125.24.0-255,1484,15575,6,156758
21384,0.000386,172.31.36.0-255,66,15641,6,156758
21385,0.000392,74.125.24.0-255,2902,18543,6,156758
21386,0.000396,172.31.36.0-255,66,18609,6,156758
21387,0.000401,74.125.24.0-255,4320,22929,6,156758
21388,0.000403,172.31.36.0-255,66,22995,6,156758
21389,0.000423,74.125.24.0-255,1484,24479,6,156758
21390,0.000425,172.31.36.0-255,66,24545,6,156758
21391,0.000433,74.125.24.0-255,8215,32760,6,156758
21392,0.000436,172.31.36.0-255,66,32826,6,156758
21393,0.000444,74.125.24.0-255,8574,41400,6,156758
21394,0.000446,172.31.36.0-255,66,41466,6,156758
21395,0.000468,74.125.24.0-255,1484,42950,6,156758
21396,0.000471,172.31.36.0-255,66,43016,6,156758
21397,0.000504,172.31.36.0-255,66,43082,6,156758
21398,0.000526,74.125.24.0-255,7156,50238,6,156758
21399,0.000529,172.31.36.0-255,66,50304,6,156758
21400,0.000548,74.125.24.0-255,2517,52821,6,156758
21401,0.000551,172.31.36.0-255,66,52887,6,156758
21402,0.000554,74.125.24.0-255,109,52996,6,156758
21403,0.000556,172.31.36.0-255,66,53062,6,156758
21404,0.000704,74.125.24.0-255,1484,54546,6,156758
21405,0.000709,74.125.24.0-255,1484,56030,6,156758
21406,0.000712,172.31.36.0-255,66,56096,6,156758
21407,0.000731,74.125.24.0-255,1484,57580,6,156758
21408,0.000737,74.125.24.0-255,5738,63318,6,156758
21409,0.00074,172.31.36.0-255,66,63384,6,156758
21410,0.000753,172.31.36.0-255,66,63450,6,156758
21411,0.000774,74.125.24.0-255,1484,64934,6,156758
21412,0.000831,172.31.36.0-255,66,65000,6,156758
21413,0.001221,74.125.24.0-255,1484,66484,6,156758
21414,0.00123,74.125.24.0-255,2902,69386,6,156758
21415,0.001234,172.31.36.0-255,66,69452,6,156758
21416,0.001238,74.125.24.0-255,1484,70936,6,156758
21417,0.001256,74.125.24.0-255,4320,75256,6,156758
21418,0.001259,172.31.36.0-255,66,75322,6,156758
21419,0.001276,74.125.24.0-255,2902,78224,6,156758
21420,0.001279,172.31.36.0-255,66,78290,6,156758
21421,0.001293,74.125.24.0-255,5738,84028,6,156758
21422,0.001296,172.31.36.0-255,66,84094,6,156758
21423,0.001322,74.125.24.0-255,4320,88414,6,156758
21424,0.001325,172.31.36.0-255,66,88480,6,156758
21425,0.001335,74.125.24.0-255,10692,99172,6,156758
21426,0.001337,172.31.36.0-255,66,99238,6,156758
21427,0.001434,74.125.24.0-255,1484,100722,6,156758
21428,0.00144,74.125.24.0-255,2902,103624,6,156758
21429,0.001443,172.31.36.0-255,66,103690,6,156758
21430,0.00145,74.125.24.0-255,5738,109428,6,156758
21431,0.001453,172.31.36.0-255,66,109494,6,156758
21432,0.001478,74.125.24.0-255,8574,118068,6,156758
21433,0.001482,172.31.36.0-255,66,118134,6,156758
21434,0.0015,74.125.24.0-255,4320,122454,6,156758
21435,0.001503,172.31.36.0-255,66,122520,6,156758
21436,0.001509,74.125.24.0-255,4320,126840,6,156758
21437,0.001512,172.31.36.0-255,66,126906,6,156758
21438,0.00153,74.125.24.0-255,4320,131226,6,156758
21439,0.001534,172.31.36.0-255,66,131292,6,156758
21440,0.001549,74.125.24.0-255,2184,133476,6,156758
21441,0.001552,172.31.36.0-255,66,133542,6,156758
21442,0.003584,74.125.24.0-255,5738,139280,6,156758
21443,0.003592,172.31.36.0-255,66,139346,6,156758
21444,0.005624,74.125.24.0-255,5738,145084,6,156758
21445,0.005629,172.31.36.0-255,66,145150,6,156758
21446,0.007701,74.125.24.0-255,5738,150888,6,156758
21447,0.007709,172.31.36.0-255,66,150954,6,156758
21448,0.009749,74.125.24.0-255,5738,156692,6,156758
21449,0.009756,172.31.36.0-255,66,156758,6,156758
21450,0.0,172.253.118.0-255,152,152,6,211684
21451,1.6e-05,172.31.36.0-255,66,218,6,211684
21452,2.4e-05,172.253.118.0-255,1484,1702,6,211684
21453,2.8e-05,172.31.36.0-255,66,1768,6,211684
21454,3.1e-05,172.253.118.0-255,1484,3252,6,211684
21455,3.4e-05,172.31.36.0-255,66,3318,6,211684
21456,5e-05,172.253.118.0-255,1484,4802,6,211684
21457,5.3e-05,172.31.36.0-255,66,4868,6,211684
21458,6.1e-05,172.253.118.0-255,5738,10606,6,211684
21459,6.3e-05,172.31.36.0-255,66,10672,6,211684
21460,8.9e-05,172.253.118.0-255,6324,16996,6,211684
21461,9.2e-05,172.31.36.0-255,66,17062,6,211684
21462,0.000117,172.253.118.0-255,7156,24218,6,211684
21463,0.000119,172.31.36.0-255,66,24284,6,211684
21464,0.00014,172.253.118.0-255,6797,31081,6,211684
21465,0.000143,172.31.36.0-255,66,31147,6,211684
21466,0.000248,172.253.118.0-255,1484,32631,6,211684
21467,0.000252,172.31.36.0-255,66,32697,6,211684
21468,0.000258,172.253.118.0-255,2902,35599,6,211684
21469,0.000261,172.31.36.0-255,66,35665,6,211684
21470,0.000288,172.253.118.0-255,5738,41403,6,211684
21471,0.000291,172.31.36.0-255,66,41469,6,211684
21472,0.000299,172.253.118.0-255,6797,48266,6,211684
21473,0.000301,172.31.36.0-255,66,48332,6,211684
21474,0.000326,172.253.118.0-255,5738,54070,6,211684
21475,0.000329,172.31.36.0-255,66,54136,6,211684
21476,0.000357,172.253.118.0-255,8574,62710,6,211684
21477,0.00036,172.31.36.0-255,66,62776,6,211684
21478,0.000365,172.253.118.0-255,2543,65319,6,211684
21479,0.000367,172.31.36.0-255,66,65385,6,211684
21480,0.000369,172.253.118.0-255,398,65783,6,211684
21481,0.000372,172.31.36.0-255,66,65849,6,211684
21482,0.000572,172.253.118.0-255,111,65960,6,211684
21483,0.000727,172.253.118.0-255,1484,67444,6,211684
21484,0.000732,172.253.118.0-255,1484,68928,6,211684
21485,0.000751,172.253.118.0-255,1484,70412,6,211684
21486,0.000758,172.253.118.0-255,5738,76150,6,211684
21487,0.000762,172.31.36.0-255,66,76216,6,211684
21488,0.000769,172.31.36.0-255,66,76282,6,211684
21489,0.000783,172.253.118.0-255,4320,80602,6,211684
21490,0.000803,172.253.118.0-255,2543,83145,6,211684
21491,0.000811,172.31.36.0-255,66,83211,6,211684
21492,0.000823,172.253.118.0-255,7156,90367,6,211684
21493,0.000829,172.31.36.0-255,66,90433,6,211684
21494,0.000843,172.253.118.0-255,2902,93335,6,211684
21495,0.000863,172.253.118.0-255,6797,100132,6,211684
21496,0.000871,172.31.36.0-255,66,100198,6,211684
21497,0.001222,172.253.118.0-255,1484,101682,6,211684
21498,0.001229,172.253.118.0-255,2902,104584,6,211684
21499,0.001233,172.31.36.0-255,66,104650,6,211684
21500,0.001237,172.253.118.0-255,1484,106134,6,211684
21501,0.00125,172.253.118.0-255,2902,109036,6,211684
21502,0.001255,172.253.118.0-255,2902,111938,6,211684
21503,0.00126,172.31.36.0-255,66,112004,6,211684
21504,0.001281,172.253.118.0-255,5738,117742,6,211684
21505,0.0013,172.253.118.0-255,9992,127734,6,211684
21506,0.001309,172.31.36.0-255,66,127800,6,211684
21507,0.001319,172.253.118.0-255,2902,130702,6,211684
21508,0.001324,172.31.36.0-255,66,130768,6,211684
21509,0.001344,172.253.118.0-255,3602,134370,6,211684
21510,0.001354,172.31.36.0-255,66,134436,6,211684
21511,0.001487,172.253.118.0-255,1484,135920,6,211684
21512,0.001508,172.253.118.0-255,2902,138822,6,211684
21513,0.001512,172.31.36.0-255,66,138888,6,211684
21514,0.001534,172.253.118.0-255,5738,144626,6,211684
21515,0.001563,172.253.118.0-255,7156,151782,6,211684
21516,0.001569,172.31.36.0-255,66,151848,6,211684
21517,0.001593,172.253.118.0-255,2902,154750,6,211684
21518,0.001607,172.253.118.0-255,2184,156934,6,211684
21519,0.001627,172.31.36.0-255,66,157000,6,211684
21520,0.001813,172.253.118.0-255,1484,158484,6,211684
21521,0.001818,172.253.118.0-255,2902,161386,6,211684
21522,0.001824,172.31.36.0-255,66,161452,6,211684
21523,0.001844,172.253.118.0-255,5738,167190,6,211684
21524,0.001849,172.253.118.0-255,4320,171510,6,211684
21525,0.001857,172.31.36.0-255,66,171576,6,211684
21526,0.001867,172.253.118.0-255,4320,175896,6,211684
21527,0.001877,172.31.36.0-255,66,175962,6,211684
21528,0.001905,172.253.118.0-255,4320,180282,6,211684
21529,0.001912,172.31.36.0-255,66,180348,6,211684
21530,0.001937,172.253.118.0-255,10692,191040,6,211684
21531,0.001943,172.31.36.0-255,66,191106,6,211684
21532,0.002036,172.253.118.0-255,1484,192590,6,211684
21533,0.00204,172.253.118.0-255,1484,194074,6,211684
21534,0.002047,172.31.36.0-255,66,194140,6,211684
21535,0.002065,172.253.118.0-255,1484,195624,6,211684
21536,0.00207,172.253.118.0-255,2902,198526,6,211684
21537,0.002072,172.253.118.0-255,1484,200010,6,211684
21538,0.002079,172.31.36.0-255,66,200076,6,211684
21539,0.004104,172.253.118.0-255,5738,205814,6,211684
21540,0.004112,172.31.36.0-255,66,205880,6,211684
21541,0.006143,172.253.118.0-255,5738,211618,6,211684
21542,0.008455,172.31.36.0-255,66,211684,6,211684
21543,0.0,74.125.24.0-255,153,153,6,365887
21544,2.5e-05,172.31.36.0-255,66,219,6,365887
21545,3.2e-05,74.125.24.0-255,1484,1703,6,365887
21546,3.7e-05,172.31.36.0-255,66,1769,6,365887
21547,4.3e-05,74.125.24.0-255,2902,4671,6,365887
21548,4.6e-05,172.31.36.0-255,66,4737,6,365887
21549,5.2e-05,74.125.24.0-255,4320,9057,6,365887
21550,5.5e-05,172.31.36.0-255,66,9123,6,365887
21551,6.1e-05,74.125.24.0-255,4872,13995,6,365887
21552,6.4e-05,172.31.36.0-255,66,14061,6,365887
21553,7.8e-05,172.31.36.0-255,66,14127,6,365887
21554,8.4e-05,74.125.24.0-255,5379,19506,6,365887
21555,8.7e-05,172.31.36.0-255,66,19572,6,365887
21556,0.000496,74.125.24.0-255,1484,21056,6,365887
21557,0.000502,172.31.36.0-255,66,21122,6,365887
21558,0.000509,74.125.24.0-255,2902,24024,6,365887
21559,0.000512,172.31.36.0-255,66,24090,6,365887
21560,0.000517,74.125.24.0-255,2902,26992,6,365887
21561,0.00052,172.31.36.0-255,66,27058,6,365887
21562,0.000541,74.125.24.0-255,2902,29960,6,365887
21563,0.000543,172.31.36.0-255,66,30026,6,365887
21564,0.000549,74.125.24.0-255,4320,34346,6,365887
21565,0.000551,172.31.36.0-255,66,34412,6,365887
21566,0.000581,74.125.24.0-255,5379,39791,6,365887
21567,0.000586,172.31.36.0-255,66,39857,6,365887
21568,0.000598,74.125.24.0-255,5738,45595,6,365887
21569,0.000601,172.31.36.0-255,66,45661,6,365887
21570,0.000613,74.125.24.0-255,5738,51399,6,365887
21571,0.000615,172.31.36.0-255,66,51465,6,365887
21572,0.000645,74.125.24.0-255,2853,54318,6,365887
21573,0.000648,172.31.36.0-255,66,54384,6,365887
21574,0.000692,74.125.24.0-255,344,54728,6,365887
21575,0.000824,74.125.24.0-255,1484,56212,6,365887
21576,0.000829,172.31.36.0-255,66,56278,6,365887
21577,0.000835,74.125.24.0-255,2902,59180,6,365887
21578,0.000837,172.31.36.0-255,66,59246,6,365887
21579,0.000858,74.125.24.0-255,5738,64984,6,365887
21580,0.000861,172.31.36.0-255,66,65050,6,365887
21581,0.000876,74.125.24.0-255,1484,66534,6,365887
21582,0.000893,74.125.24.0-255,5379,71913,6,365887
21583,0.000896,172.31.36.0-255,66,71979,6,365887
21584,0.000937,74.125.24.0-255,8574,80553,6,365887
21585,0.000939,172.31.36.0-255,66,80619,6,365887
21586,0.000957,74.125.24.0-255,1484,82103,6,365887
21587,0.000977,74.125.24.0-255,6797,88900,6,365887
21588,0.00098,172.31.36.0-255,66,88966,6,365887
21589,0.001046,74.125.24.0-255,1484,90450,6,365887
21590,0.001061,74.125.24.0-255,2902,93352,6,365887
21591,0.001064,172.31.36.0-255,66,93418,6,365887
21592,0.001068,74.125.24.0-255,1484,94902,6,365887
21593,0.001089,74.125.24.0-255,4320,99222,6,365887
21594,0.001092,172.31.36.0-255,66,99288,6,365887
21595,0.001096,74.125.24.0-255,2902,102190,6,365887
21596,0.001099,172.31.36.0-255,66,102256,6,365887
21597,0.001119,74.125.24.0-255,9992,112248,6,365887
21598,0.001121,172.31.36.0-255,66,112314,6,365887
21599,0.001141,74.125.24.0-255,4320,116634,6,365887
21600,0.001143,172.31.36.0-255,66,116700,6,365887
21601,0.001166,74.125.24.0-255,6438,123138,6,365887
21602,0.001169,172.31.36.0-255,66,123204,6,365887
21603,0.001174,74.125.24.0-255,2902,126106,6,365887
21604,0.001176,172.31.36.0-255,66,126172,6,365887
21605,0.00119,74.125.24.0-255,1484,127656,6,365887
21606,0.001196,74.125.24.0-255,5738,133394,6,365887
21607,0.001199,172.31.36.0-255,66,133460,6,365887
21608,0.001205,74.125.24.0-255,5738,139198,6,365887
21609,0.001208,172.31.36.0-255,66,139264,6,365887
21610,0.00123,74.125.24.0-255,5738,145002,6,365887
21611,0.001233,172.31.36.0-255,66,145068,6,365887
21612,0.001239,74.125.24.0-255,5738,150806,6,365887
21613,0.001241,172.31.36.0-255,66,150872,6,365887
21614,0.001287,74.125.24.0-255,6438,157310,6,365887
21615,0.00129,172.31.36.0-255,66,157376,6,365887
21616,0.001325,74.125.24.0-255,7156,164532,6,365887
21617,0.001328,172.31.36.0-255,66,164598,6,365887
21618,0.001334,74.125.24.0-255,5738,170336,6,365887
21619,0.001336,172.31.36.0-255,66,170402,6,365887
21620,0.00136,74.125.24.0-255,2902,173304,6,365887
21621,0.001363,172.31.36.0-255,66,173370,6,365887
21622,0.001366,74.125.24.0-255,1484,174854,6,365887
21623,0.001391,172.31.36.0-255,66,174920,6,365887
21624,0.001413,74.125.24.0-255,2184,177104,6,365887
21625,0.001416,172.31.36.0-255,66,177170,6,365887
21626,0.001435,74.125.24.0-255,2902,180072,6,365887
21627,0.001438,172.31.36.0-255,66,180138,6,365887
21628,0.001442,74.125.24.0-255,2902,183040,6,365887
21629,0.001444,172.31.36.0-255,66,183106,6,365887
21630,0.00146,74.125.24.0-255,4320,187426,6,365887
21631,0.001463,172.31.36.0-255,66,187492,6,365887
21632,0.001482,74.125.24.0-255,5738,193230,6,365887
21633,0.001484,172.31.36.0-255,66,193296,6,365887
21634,0.001507,74.125.24.0-255,8574,201870,6,365887
21635,0.001512,172.31.36.0-255,66,201936,6,365887
21636,0.001524,74.125.24.0-255,5738,207674,6,365887
21637,0.001527,172.31.36.0-255,66,207740,6,365887
21638,0.001551,74.125.24.0-255,3602,211342,6,365887
21639,0.001553,172.31.36.0-255,66,211408,6,365887
21640,0.001742,74.125.24.0-255,1484,212892,6,365887
21641,0.001748,74.125.24.0-255,2902,215794,6,365887
21642,0.001751,172.31.36.0-255,66,215860,6,365887
21643,0.001779,74.125.24.0-255,5738,221598,6,365887
21644,0.001782,172.31.36.0-255,66,221664,6,365887
21645,0.001787,74.125.24.0-255,4320,225984,6,365887
21646,0.001789,172.31.36.0-255,66,226050,6,365887
21647,0.001821,74.125.24.0-255,7156,233206,6,365887
21648,0.001823,172.31.36.0-255,66,233272,6,365887
21649,0.001838,74.125.24.0-255,4320,237592,6,365887
21650,0.001845,74.125.24.0-255,7856,245448,6,365887
21651,0.001884,172.31.36.0-255,66,245514,6,365887
21652,0.001894,172.31.36.0-255,66,245580,6,365887
21653,0.001907,74.125.24.0-255,1484,247064,6,365887
21654,0.001912,74.125.24.0-255,2902,249966,6,365887
21655,0.001915,172.31.36.0-255,66,250032,6,365887
21656,0.001936,74.125.24.0-255,5738,255770,6,365887
21657,0.001938,172.31.36.0-255,66,255836,6,365887
21658,0.001963,74.125.24.0-255,2902,258738,6,365887
21659,0.001965,172.31.36.0-255,66,258804,6,365887
21660,0.001989,74.125.24.0-255,9992,268796,6,365887
21661,0.001992,172.31.36.0-255,66,268862,6,365887
21662,0.002002,74.125.24.0-255,9992,278854,6,365887
21663,0.002005,172.31.36.0-255,66,278920,6,365887
21664,0.002042,74.125.24.0-255,4320,283240,6,365887
21665,0.002045,172.31.36.0-255,66,283306,6,365887
21666,0.002071,74.125.24.0-255,7308,290614,6,365887
21667,0.002075,172.31.36.0-255,66,290680,6,365887
21668,0.002089,172.31.36.0-255,66,290746,6,365887
21669,0.002094,74.125.24.0-255,4320,295066,6,365887
21670,0.002096,172.31.36.0-255,66,295132,6,365887
21671,0.002118,74.125.24.0-255,5020,300152,6,365887
21672,0.00212,172.31.36.0-255,66,300218,6,365887
21673,0.002161,74.125.24.0-255,1484,301702,6,365887
21674,0.002178,74.125.24.0-255,2902,304604,6,365887
21675,0.002182,172.31.36.0-255,66,304670,6,365887
21676,0.002213,74.125.24.0-255,5738,310408,6,365887
21677,0.002216,172.31.36.0-255,66,310474,6,365887
21678,0.002235,74.125.24.0-255,7156,317630,6,365887
21679,0.002237,172.31.36.0-255,66,317696,6,365887
21680,0.002262,74.125.24.0-255,5738,323434,6,365887
21681,0.002264,172.31.36.0-255,66,323500,6,365887
21682,0.002269,74.125.24.0-255,4320,327820,6,365887
21683,0.002271,172.31.36.0-255,66,327886,6,365887
21684,0.002313,74.125.24.0-255,6438,334324,6,365887
21685,0.002316,172.31.36.0-255,66,334390,6,365887
21686,0.002368,74.125.24.0-255,1484,335874,6,365887
21687,0.002385,74.125.24.0-255,2902,338776,6,365887
21688,0.002388,172.31.36.0-255,66,338842,6,365887
21689,0.002392,74.125.24.0-255,1484,340326,6,365887
21690,0.002412,74.125.24.0-255,4320,344646,6,365887
21691,0.002415,172.31.36.0-255,66,344712,6,365887
21692,0.00242,74.125.24.0-255,4320,349032,6,365887
21693,0.002423,172.31.36.0-255,66,349098,6,365887
21694,0.002443,74.125.24.0-255,5738,354836,6,365887
21695,0.002446,172.31.36.0-255,66,354902,6,365887
21696,0.002451,74.125.24.0-255,4320,359222,6,365887
21697,0.002453,172.31.36.0-255,66,359288,6,365887
21698,0.002474,74.125.24.0-255,6323,365611,6,365887
21699,0.002477,74.125.24.0-255,105,365716,6,365887
21700,0.002487,172.31.36.0-255,66,365782,6,365887
21701,0.009734,172.31.36.0-255,105,365887,6,365887
21702,0.0,172.217.194.0-255,153,153,6,218241
21703,2e-05,172.31.36.0-255,66,219,6,218241
21704,2.7e-05,172.217.194.0-255,1484,1703,6,218241
21705,3.2e-05,172.31.36.0-255,66,1769,6,218241
21706,3.8e-05,172.217.194.0-255,2902,4671,6,218241
21707,4.9e-05,172.31.36.0-255,66,4737,6,218241
21708,5.7e-05,172.217.194.0-255,7156,11893,6,218241
21709,6e-05,172.31.36.0-255,66,11959,6,218241
21710,0.000113,172.31.36.0-255,66,12025,6,218241
21711,0.000118,172.217.194.0-255,2543,14568,6,218241
21712,0.000121,172.31.36.0-255,66,14634,6,218241
21713,0.000151,172.217.194.0-255,2902,17536,6,218241
21714,0.000153,172.31.36.0-255,66,17602,6,218241
21715,0.000161,172.217.194.0-255,7156,24758,6,218241
21716,0.000163,172.31.36.0-255,66,24824,6,218241
21717,0.000173,172.217.194.0-255,4320,29144,6,218241
21718,0.000176,172.31.36.0-255,66,29210,6,218241
21719,0.000233,172.31.36.0-255,66,29276,6,218241
21720,0.00024,172.217.194.0-255,5669,34945,6,218241
21721,0.000242,172.31.36.0-255,66,35011,6,218241
21722,0.000245,172.217.194.0-255,99,35110,6,218241
21723,0.000252,172.31.36.0-255,66,35176,6,218241
21724,0.000286,172.217.194.0-255,363,35539,6,218241
21725,0.000289,172.31.36.0-255,66,35605,6,218241
21726,0.00047,172.217.194.0-255,1484,37089,6,218241
21727,0.000475,172.31.36.0-255,66,37155,6,218241
21728,0.000481,172.217.194.0-255,2902,40057,6,218241
21729,0.000484,172.31.36.0-255,66,40123,6,218241
21730,0.00052,172.217.194.0-255,5738,45861,6,218241
21731,0.000524,172.31.36.0-255,66,45927,6,218241
21732,0.000543,172.31.36.0-255,66,45993,6,218241
21733,0.000581,172.217.194.0-255,10692,56685,6,218241
21734,0.000584,172.31.36.0-255,66,56751,6,218241
21735,0.000619,172.217.194.0-255,1484,58235,6,218241
21736,0.000625,172.217.194.0-255,2902,61137,6,218241
21737,0.000627,172.31.36.0-255,66,61203,6,218241
21738,0.000659,172.217.194.0-255,5738,66941,6,218241
21739,0.000662,172.31.36.0-255,66,67007,6,218241
21740,0.000671,172.217.194.0-255,8574,75581,6,218241
21741,0.000673,172.31.36.0-255,66,75647,6,218241
21742,0.000695,172.217.194.0-255,4320,79967,6,218241
21743,0.000697,172.31.36.0-255,66,80033,6,218241
21744,0.000705,172.217.194.0-255,7156,87189,6,218241
21745,0.000707,172.31.36.0-255,66,87255,6,218241
21746,0.000738,172.217.194.0-255,3602,90857,6,218241
21747,0.000744,172.31.36.0-255,66,90923,6,218241
21748,0.000839,172.217.194.0-255,1484,92407,6,218241
21749,0.000856,172.217.194.0-255,2902,95309,6,218241
21750,0.00086,172.31.36.0-255,66,95375,6,218241
21751,0.000867,172.217.194.0-255,5738,101113,6,218241
21752,0.000869,172.31.36.0-255,66,101179,6,218241
21753,0.00088,172.217.194.0-255,4320,105499,6,218241
21754,0.000883,172.31.36.0-255,66,105565,6,218241
21755,0.000907,172.217.194.0-255,2902,108467,6,218241
21756,0.000914,172.31.36.0-255,66,108533,6,218241
21757,0.000929,172.31.36.0-255,66,108599,6,218241
21758,0.000934,172.217.194.0-255,2184,110783,6,218241
21759,0.000936,172.31.36.0-255,66,110849,6,218241
21760,0.000964,172.217.194.0-255,2902,113751,6,218241
21761,0.000966,172.31.36.0-255,66,113817,6,218241
21762,0.000978,172.217.194.0-255,7156,120973,6,218241
21763,0.000981,172.31.36.0-255,66,121039,6,218241
21764,0.000988,172.217.194.0-255,7156,128195,6,218241
21765,0.00099,172.31.36.0-255,66,128261,6,218241
21766,0.001035,172.217.194.0-255,766,129027,6,218241
21767,0.001039,172.31.36.0-255,66,129093,6,218241
21768,0.00145,172.217.194.0-255,1484,130577,6,218241
21769,0.001455,172.31.36.0-255,66,130643,6,218241
21770,0.001461,172.217.194.0-255,2902,133545,6,218241
21771,0.001463,172.31.36.0-255,66,133611,6,218241
21772,0.001493,172.217.194.0-255,5738,139349,6,218241
21773,0.001495,172.31.36.0-255,66,139415,6,218241
21774,0.001514,172.31.36.0-255,66,139481,6,218241
21775,0.001522,172.217.194.0-255,7156,146637,6,218241
21776,0.001524,172.31.36.0-255,66,146703,6,218241
21777,0.001554,172.217.194.0-255,3602,150305,6,218241
21778,0.001559,172.31.36.0-255,66,150371,6,218241
21779,0.001632,172.217.194.0-255,1484,151855,6,218241
21780,0.001639,172.217.194.0-255,2902,154757,6,218241
21781,0.001642,172.31.36.0-255,66,154823,6,218241
21782,0.001671,172.217.194.0-255,5738,160561,6,218241
21783,0.001674,172.31.36.0-255,66,160627,6,218241
21784,0.00168,172.217.194.0-255,5738,166365,6,218241
21785,0.001682,172.31.36.0-255,66,166431,6,218241
21786,0.001726,172.217.194.0-255,1484,167915,6,218241
21787,0.001779,172.31.36.0-255,66,167981,6,218241
21788,0.001801,172.31.36.0-255,66,168047,6,218241
21789,0.001817,172.31.36.0-255,66,168113,6,218241
21790,0.001825,172.217.194.0-255,7856,175969,6,218241
21791,0.001828,172.31.36.0-255,66,176035,6,218241
21792,0.001837,172.217.194.0-255,9992,186027,6,218241
21793,0.00184,172.31.36.0-255,66,186093,6,218241
21794,0.001898,172.31.36.0-255,66,186159,6,218241
21795,0.001921,172.31.36.0-255,66,186225,6,218241
21796,0.00193,172.217.194.0-255,8574,194799,6,218241
21797,0.001932,172.31.36.0-255,66,194865,6,218241
21798,0.001968,172.217.194.0-255,9992,204857,6,218241
21799,0.001973,172.217.194.0-255,2184,207041,6,218241
21800,0.001978,172.31.36.0-255,66,207107,6,218241
21801,0.002021,172.31.36.0-255,66,207173,6,218241
21802,0.002052,172.217.194.0-255,7156,214329,6,218241
21803,0.002058,172.217.194.0-255,3570,217899,6,218241
21804,0.00206,172.217.194.0-255,105,218004,6,218241
21805,0.002076,172.31.36.0-255,66,218070,6,218241
21806,0.004469,172.31.36.0-255,105,218175,6,218241
21807,0.006456,172.217.194.0-255,66,218241,6,218241
21808,0.0,172.217.194.0-255,153,153,6,231029
21809,2.4e-05,172.31.36.0-255,66,219,6,231029
21810,3.1e-05,172.217.194.0-255,1484,1703,6,231029
21811,3.5e-05,172.31.36.0-255,66,1769,6,231029
21812,4.1e-05,172.217.194.0-255,2902,4671,6,231029
21813,4.4e-05,172.31.36.0-255,66,4737,6,231029
21814,4.9e-05,172.217.194.0-255,4320,9057,6,231029
21815,5.2e-05,172.31.36.0-255,66,9123,6,231029
21816,6.2e-05,172.217.194.0-255,9101,18224,6,231029
21817,6.6e-05,172.31.36.0-255,66,18290,6,231029
21818,9.6e-05,172.217.194.0-255,9992,28282,6,231029
21819,0.0001,172.31.36.0-255,66,28348,6,231029
21820,0.000125,172.217.194.0-255,2543,30891,6,231029
21821,0.000127,172.31.36.0-255,66,30957,6,231029
21822,0.000152,172.217.194.0-255,1484,32441,6,231029
21823,0.000154,172.31.36.0-255,66,32507,6,231029
21824,0.000172,172.217.194.0-255,1484,33991,6,231029
21825,0.000174,172.31.36.0-255,66,34057,6,231029
21826,0.000182,172.217.194.0-255,7156,41213,6,231029
21827,0.000185,172.31.36.0-255,66,41279,6,231029
21828,0.00024,172.217.194.0-255,2902,44181,6,231029
21829,0.000243,172.31.36.0-255,66,44247,6,231029
21830,0.000263,172.217.194.0-255,3961,48208,6,231029
21831,0.000266,172.31.36.0-255,66,48274,6,231029
21832,0.000317,172.217.194.0-255,1484,49758,6,231029
21833,0.00032,172.31.36.0-255,66,49824,6,231029
21834,0.000338,172.217.194.0-255,2902,52726,6,231029
21835,0.000341,172.31.36.0-255,66,52792,6,231029
21836,0.000347,172.217.194.0-255,5738,58530,6,231029
21837,0.000349,172.31.36.0-255,66,58596,6,231029
21838,0.000381,172.217.194.0-255,1484,60080,6,231029
21839,0.000384,172.31.36.0-255,66,60146,6,231029
21840,0.000404,172.217.194.0-255,5681,65827,6,231029
21841,0.000406,172.31.36.0-255,66,65893,6,231029
21842,0.000421,172.217.194.0-255,376,66269,6,231029
21843,0.0005,172.217.194.0-255,1484,67753,6,231029
21844,0.000504,172.31.36.0-255,66,67819,6,231029
21845,0.000519,172.217.194.0-255,2902,70721,6,231029
21846,0.000522,172.31.36.0-255,66,70787,6,231029
21847,0.000564,172.217.194.0-255,2902,73689,6,231029
21848,0.000566,172.31.36.0-255,66,73755,6,231029
21849,0.000588,172.217.194.0-255,2902,76657,6,231029
21850,0.00059,172.31.36.0-255,66,76723,6,231029
21851,0.000596,172.217.194.0-255,5738,82461,6,231029
21852,0.000599,172.31.36.0-255,66,82527,6,231029
21853,0.000604,172.217.194.0-255,2902,85429,6,231029
21854,0.000605,172.31.36.0-255,66,85495,6,231029
21855,0.000631,172.217.194.0-255,8215,93710,6,231029
21856,0.000634,172.31.36.0-255,66,93776,6,231029
21857,0.000651,172.217.194.0-255,2902,96678,6,231029
21858,0.000654,172.31.36.0-255,66,96744,6,231029
21859,0.000679,172.217.194.0-255,3961,100705,6,231029
21860,0.000682,172.31.36.0-255,66,100771,6,231029
21861,0.001566,172.217.194.0-255,1484,102255,6,231029
21862,0.001576,172.217.194.0-255,2902,105157,6,231029
21863,0.00158,172.31.36.0-255,66,105223,6,231029
21864,0.001588,172.217.194.0-255,5738,110961,6,231029
21865,0.00159,172.31.36.0-255,66,111027,6,231029
21866,0.001593,172.217.194.0-255,1484,112511,6,231029
21867,0.001635,172.31.36.0-255,66,112577,6,231029
21868,0.001643,172.217.194.0-255,9992,122569,6,231029
21869,0.001645,172.31.36.0-255,66,122635,6,231029
21870,0.001649,172.217.194.0-255,766,123401,6,231029
21871,0.001865,172.217.194.0-255,1484,124885,6,231029
21872,0.00187,172.31.36.0-255,66,124951,6,231029
21873,0.001876,172.217.194.0-255,2902,127853,6,231029
21874,0.001878,172.31.36.0-255,66,127919,6,231029
21875,0.001884,172.217.194.0-255,5738,133657,6,231029
21876,0.001888,172.31.36.0-255,66,133723,6,231029
21877,0.001912,172.217.194.0-255,4320,138043,6,231029
21878,0.001915,172.31.36.0-255,66,138109,6,231029
21879,0.001941,172.217.194.0-255,8574,146683,6,231029
21880,0.001943,172.31.36.0-255,66,146749,6,231029
21881,0.001952,172.217.194.0-255,8574,155323,6,231029
21882,0.001954,172.31.36.0-255,66,155389,6,231029
21883,0.001973,172.217.194.0-255,2184,157573,6,231029
21884,0.001975,172.31.36.0-255,66,157639,6,231029
21885,0.002109,172.217.194.0-255,1484,159123,6,231029
21886,0.002129,172.217.194.0-255,2902,162025,6,231029
21887,0.002133,172.31.36.0-255,66,162091,6,231029
21888,0.002139,172.217.194.0-255,2902,164993,6,231029
21889,0.00214,172.31.36.0-255,66,165059,6,231029
21890,0.002156,172.217.194.0-255,2902,167961,6,231029
21891,0.002158,172.31.36.0-255,66,168027,6,231029
21892,0.002174,172.31.36.0-255,66,168093,6,231029
21893,0.0022,172.217.194.0-255,1484,169577,6,231029
21894,0.002208,172.217.194.0-255,8574,178151,6,231029
21895,0.002211,172.31.36.0-255,66,178217,6,231029
21896,0.002232,172.217.194.0-255,2184,180401,6,231029
21897,0.002234,172.31.36.0-255,66,180467,6,231029
21898,0.002238,172.217.194.0-255,1484,181951,6,231029
21899,0.002258,172.217.194.0-255,1484,183435,6,231029
21900,0.00226,172.31.36.0-255,66,183501,6,231029
21901,0.002284,172.217.194.0-255,7156,190657,6,231029
21902,0.002287,172.31.36.0-255,66,190723,6,231029
21903,0.002294,172.217.194.0-255,7156,197879,6,231029
21904,0.002297,172.31.36.0-255,66,197945,6,231029
21905,0.002335,172.31.36.0-255,66,198011,6,231029
21906,0.002338,172.217.194.0-255,766,198777,6,231029
21907,0.002455,172.217.194.0-255,1484,200261,6,231029
21908,0.00246,172.31.36.0-255,66,200327,6,231029
21909,0.002466,172.217.194.0-255,2902,203229,6,231029
21910,0.002469,172.31.36.0-255,66,203295,6,231029
21911,0.002472,172.217.194.0-255,1484,204779,6,231029
21912,0.002501,172.217.194.0-255,4320,209099,6,231029
21913,0.002504,172.31.36.0-255,66,209165,6,231029
21914,0.00251,172.217.194.0-255,4320,213485,6,231029
21915,0.002513,172.31.36.0-255,66,213551,6,231029
21916,0.004949,172.217.194.0-255,1484,215035,6,231029
21917,0.005017,172.217.194.0-255,4320,219355,6,231029
21918,0.00502,172.31.36.0-255,66,219421,6,231029
21919,0.007501,172.217.194.0-255,5738,225159,6,231029
21920,0.007506,172.31.36.0-255,66,225225,6,231029
21921,0.009991,172.217.194.0-255,5738,230963,6,231029
21922,0.009998,172.31.36.0-255,66,231029,6,231029
21923,0.0,74.125.24.0-255,146,146,6,267869
21924,3.2e-05,172.31.36.0-255,66,212,6,267869
21925,3.9e-05,74.125.24.0-255,1484,1696,6,267869
21926,4.3e-05,172.31.36.0-255,66,1762,6,267869
21927,4.8e-05,74.125.24.0-255,2902,4664,6,267869
21928,5.1e-05,172.31.36.0-255,66,4730,6,267869
21929,5.9e-05,74.125.24.0-255,7156,11886,6,267869
21930,6.2e-05,172.31.36.0-255,66,11952,6,267869
21931,0.000117,172.31.36.0-255,66,12018,6,267869
21932,0.000122,74.125.24.0-255,2543,14561,6,267869
21933,0.000124,172.31.36.0-255,66,14627,6,267869
21934,0.000162,74.125.24.0-255,1484,16111,6,267869
21935,0.000165,172.31.36.0-255,66,16177,6,267869
21936,0.000171,74.125.24.0-255,2902,19079,6,267869
21937,0.000176,172.31.36.0-255,66,19145,6,267869
21938,0.00018,74.125.24.0-255,4320,23465,6,267869
21939,0.000183,172.31.36.0-255,66,23531,6,267869
21940,0.00021,74.125.24.0-255,1484,25015,6,267869
21941,0.000212,172.31.36.0-255,66,25081,6,267869
21942,0.00022,74.125.24.0-255,6797,31878,6,267869
21943,0.000222,172.31.36.0-255,66,31944,6,267869
21944,0.000228,74.125.24.0-255,5738,37682,6,267869
21945,0.000231,172.31.36.0-255,66,37748,6,267869
21946,0.000259,74.125.24.0-255,8574,46322,6,267869
21947,0.000262,172.31.36.0-255,66,46388,6,267869
21948,0.000267,74.125.24.0-255,2812,49200,6,267869
21949,0.000269,172.31.36.0-255,66,49266,6,267869
21950,0.000299,74.125.24.0-255,136,49402,6,267869
21951,0.000302,172.31.36.0-255,66,49468,6,267869
21952,0.000358,74.125.24.0-255,1484,50952,6,267869
21953,0.000363,172.31.36.0-255,66,51018,6,267869
21954,0.000368,74.125.24.0-255,2902,53920,6,267869
21955,0.000373,172.31.36.0-255,66,53986,6,267869
21956,0.000389,74.125.24.0-255,5738,59724,6,267869
21957,0.000392,172.31.36.0-255,66,59790,6,267869
21958,0.000408,74.125.24.0-255,6797,66587,6,267869
21959,0.000411,172.31.36.0-255,66,66653,6,267869
21960,0.00046,74.125.24.0-255,8574,75227,6,267869
21961,0.000464,172.31.36.0-255,66,75293,6,267869
21962,0.00048,74.125.24.0-255,1484,76777,6,267869
21963,0.000483,172.31.36.0-255,66,76843,6,267869
21964,0.000497,74.125.24.0-255,1484,78327,6,267869
21965,0.0005,172.31.36.0-255,66,78393,6,267869
21966,0.000529,74.125.24.0-255,5659,84052,6,267869
21967,0.000533,172.31.36.0-255,66,84118,6,267869
21968,0.000821,74.125.24.0-255,1484,85602,6,267869
21969,0.000825,172.31.36.0-255,66,85668,6,267869
21970,0.000831,74.125.24.0-255,2902,88570,6,267869
21971,0.000833,172.31.36.0-255,66,88636,6,267869
21972,0.000853,74.125.24.0-255,5738,94374,6,267869
21973,0.000856,172.31.36.0-255,66,94440,6,267869
21974,0.000887,172.31.36.0-255,66,94506,6,267869
21975,0.000902,74.125.24.0-255,1484,95990,6,267869
21976,0.000906,74.125.24.0-255,2902,98892,6,267869
21977,0.000921,172.31.36.0-255,66,98958,6,267869
21978,0.000935,74.125.24.0-255,5738,104696,6,267869
21979,0.000945,172.31.36.0-255,66,104762,6,267869
21980,0.000972,172.31.36.0-255,66,104828,6,267869
21981,0.000988,172.31.36.0-255,66,104894,6,267869
21982,0.001006,74.125.24.0-255,2902,107796,6,267869
21983,0.001011,172.31.36.0-255,66,107862,6,267869
21984,0.001034,74.125.24.0-255,5020,112882,6,267869
21985,0.001046,172.31.36.0-255,66,112948,6,267869
21986,0.001084,74.125.24.0-255,5738,118686,6,267869
21987,0.001089,172.31.36.0-255,66,118752,6,267869
21988,0.001102,74.125.24.0-255,2902,121654,6,267869
21989,0.001113,172.31.36.0-255,66,121720,6,267869
21990,0.001118,74.125.24.0-255,2902,124622,6,267869
21991,0.001127,172.31.36.0-255,66,124688,6,267869
21992,0.001137,74.125.24.0-255,5379,130067,6,267869
21993,0.001141,172.31.36.0-255,66,130133,6,267869
21994,0.001162,74.125.24.0-255,4320,134453,6,267869
21995,0.001166,172.31.36.0-255,66,134519,6,267869
21996,0.00118,74.125.24.0-255,4320,138839,6,267869
21997,0.001185,172.31.36.0-255,66,138905,6,267869
21998,0.001187,74.125.24.0-255,8574,147479,6,267869
21999,0.001201,172.31.36.0-255,66,147545,6,267869
22000,0.001266,172.31.36.0-255,66,147611,6,267869
22001,0.001567,74.125.24.0-255,1484,149095,6,267869
22002,0.001573,74.125.24.0-255,2902,151997,6,267869
22003,0.001576,172.31.36.0-255,66,152063,6,267869
22004,0.001594,74.125.24.0-255,5738,157801,6,267869
22005,0.001602,172.31.36.0-255,66,157867,6,267869
22006,0.00162,74.125.24.0-255,1484,159351,6,267869
22007,0.001646,74.125.24.0-255,9992,169343,6,267869
22008,0.00165,172.31.36.0-255,66,169409,6,267869
22009,0.001664,74.125.24.0-255,1484,170893,6,267869
22010,0.00169,74.125.24.0-255,10692,181585,6,267869
22011,0.0017,172.31.36.0-255,66,181651,6,267869
22012,0.001818,74.125.24.0-255,1484,183135,6,267869
22013,0.001824,74.125.24.0-255,2902,186037,6,267869
22014,0.001827,172.31.36.0-255,66,186103,6,267869
22015,0.001852,74.125.24.0-255,5738,191841,6,267869
22016,0.001862,172.31.36.0-255,66,191907,6,267869
22017,0.001888,74.125.24.0-255,8574,200481,6,267869
22018,0.001893,172.31.36.0-255,66,200547,6,267869
22019,0.001908,74.125.24.0-255,2902,203449,6,267869
22020,0.001916,172.31.36.0-255,66,203515,6,267869
22021,0.001927,74.125.24.0-255,7156,210671,6,267869
22022,0.001933,74.125.24.0-255,5020,215691,6,267869
22023,0.001934,172.31.36.0-255,66,215757,6,267869
22024,0.001938,172.31.36.0-255,66,215823,6,267869
22025,0.00216,74.125.24.0-255,1484,217307,6,267869
22026,0.002175,74.125.24.0-255,2902,220209,6,267869
22027,0.002179,172.31.36.0-255,66,220275,6,267869
22028,0.002184,74.125.24.0-255,2902,223177,6,267869
22029,0.002186,172.31.36.0-255,66,223243,6,267869
22030,0.002199,74.125.24.0-255,1484,224727,6,267869
22031,0.002218,74.125.24.0-255,5738,230465,6,267869
22032,0.002227,172.31.36.0-255,66,230531,6,267869
22033,0.002238,74.125.24.0-255,5738,236269,6,267869
22034,0.002242,172.31.36.0-255,66,236335,6,267869
22035,0.00227,74.125.24.0-255,9992,246327,6,267869
22036,0.002277,172.31.36.0-255,66,246393,6,267869
22037,0.002297,74.125.24.0-255,3602,249995,6,267869
22038,0.00231,172.31.36.0-255,66,250061,6,267869
22039,0.004544,74.125.24.0-255,1484,251545,6,267869
22040,0.004552,172.31.36.0-255,66,251611,6,267869
22041,0.00462,74.125.24.0-255,4320,255931,6,267869
22042,0.004624,172.31.36.0-255,66,255997,6,267869
22043,0.006866,74.125.24.0-255,1484,257481,6,267869
22044,0.006871,172.31.36.0-255,66,257547,6,267869
22045,0.006944,74.125.24.0-255,4320,261867,6,267869
22046,0.006948,172.31.36.0-255,66,261933,6,267869
22047,0.0092,74.125.24.0-255,1484,263417,6,267869
22048,0.009205,172.31.36.0-255,66,263483,6,267869
22049,0.009285,74.125.24.0-255,4320,267803,6,267869
22050,0.009289,172.31.36.0-255,66,267869,6,267869
22051,0.0,74.125.68.0-255,153,153,6,295508
22052,1.8e-05,172.31.36.0-255,66,219,6,295508
22053,4.4e-05,74.125.68.0-255,1484,1703,6,295508
22054,4.9e-05,172.31.36.0-255,66,1769,6,295508
22055,5.5e-05,74.125.68.0-255,2902,4671,6,295508
22056,5.8e-05,172.31.36.0-255,66,4737,6,295508
22057,9.6e-05,74.125.68.0-255,5738,10475,6,295508
22058,9.9e-05,172.31.36.0-255,66,10541,6,295508
22059,0.000125,74.125.68.0-255,3448,13989,6,295508
22060,0.000127,172.31.36.0-255,66,14055,6,295508
22061,0.000161,74.125.68.0-255,1484,15539,6,295508
22062,0.000164,172.31.36.0-255,66,15605,6,295508
22063,0.000192,74.125.68.0-255,2902,18507,6,295508
22064,0.000195,172.31.36.0-255,66,18573,6,295508
22065,0.000198,74.125.68.0-255,1484,20057,6,295508
22066,0.000201,172.31.36.0-255,66,20123,6,295508
22067,0.000227,74.125.68.0-255,4320,24443,6,295508
22068,0.000229,172.31.36.0-255,66,24509,6,295508
22069,0.000233,74.125.68.0-255,1484,25993,6,295508
22070,0.000235,172.31.36.0-255,66,26059,6,295508
22071,0.000268,74.125.68.0-255,5379,31438,6,295508
22072,0.000271,172.31.36.0-255,66,31504,6,295508
22073,0.000373,74.125.68.0-255,1484,32988,6,295508
22074,0.000377,172.31.36.0-255,66,33054,6,295508
22075,0.000383,74.125.68.0-255,2902,35956,6,295508
22076,0.000385,172.31.36.0-255,66,36022,6,295508
22077,0.000413,74.125.68.0-255,5738,41760,6,295508
22078,0.000417,172.31.36.0-255,66,41826,6,295508
22079,0.000424,74.125.68.0-255,6797,48623,6,295508
22080,0.000426,172.31.36.0-255,66,48689,6,295508
22081,0.000457,74.125.68.0-255,7156,55845,6,295508
22082,0.000459,172.31.36.0-255,66,55911,6,295508
22083,0.000493,74.125.68.0-255,5738,61649,6,295508
22084,0.000495,172.31.36.0-255,66,61715,6,295508
22085,0.000511,74.125.68.0-255,3961,65676,6,295508
22086,0.000514,172.31.36.0-255,66,65742,6,295508
22087,0.000517,74.125.68.0-255,413,66155,6,295508
22088,0.000582,74.125.68.0-255,331,66486,6,295508
22089,0.001036,74.125.68.0-255,1484,67970,6,295508
22090,0.001041,172.31.36.0-255,66,68036,6,295508
22091,0.001047,74.125.68.0-255,2902,70938,6,295508
22092,0.00105,172.31.36.0-255,66,71004,6,295508
22093,0.001086,74.125.68.0-255,5738,76742,6,295508
22094,0.001089,172.31.36.0-255,66,76808,6,295508
22095,0.001093,74.125.68.0-255,2902,79710,6,295508
22096,0.001095,172.31.36.0-255,66,79776,6,295508
22097,0.001106,74.125.68.0-255,4320,84096,6,295508
22098,0.001108,172.31.36.0-255,66,84162,6,295508
22099,0.001131,74.125.68.0-255,8574,92736,6,295508
22100,0.001134,172.31.36.0-255,66,92802,6,295508
22101,0.001141,74.125.68.0-255,7156,99958,6,295508
22102,0.001145,172.31.36.0-255,66,100024,6,295508
22103,0.001193,74.125.68.0-255,766,100790,6,295508
22104,0.001252,74.125.68.0-255,1484,102274,6,295508
22105,0.001255,172.31.36.0-255,66,102340,6,295508
22106,0.001261,74.125.68.0-255,2902,105242,6,295508
22107,0.001265,172.31.36.0-255,66,105308,6,295508
22108,0.001295,74.125.68.0-255,5738,111046,6,295508
22109,0.001298,172.31.36.0-255,66,111112,6,295508
22110,0.001301,74.125.68.0-255,1484,112596,6,295508
22111,0.00132,74.125.68.0-255,5738,118334,6,295508
22112,0.001323,172.31.36.0-255,66,118400,6,295508
22113,0.001361,172.31.36.0-255,66,118466,6,295508
22114,0.00139,74.125.68.0-255,1484,119950,6,295508
22115,0.001394,74.125.68.0-255,2184,122134,6,295508
22116,0.001396,172.31.36.0-255,66,122200,6,295508
22117,0.001425,74.125.68.0-255,2902,125102,6,295508
22118,0.001428,172.31.36.0-255,66,125168,6,295508
22119,0.001431,74.125.68.0-255,1484,126652,6,295508
22120,0.001436,74.125.68.0-255,2902,129554,6,295508
22121,0.001438,172.31.36.0-255,66,129620,6,295508
22122,0.001465,74.125.68.0-255,5738,135358,6,295508
22123,0.001468,172.31.36.0-255,66,135424,6,295508
22124,0.001506,74.125.68.0-255,9992,145416,6,295508
22125,0.001509,172.31.36.0-255,66,145482,6,295508
22126,0.001512,74.125.68.0-255,1484,146966,6,295508
22127,0.001541,74.125.68.0-255,9274,156240,6,295508
22128,0.001544,172.31.36.0-255,66,156306,6,295508
22129,0.001594,74.125.68.0-255,1484,157790,6,295508
22130,0.00161,74.125.68.0-255,2902,160692,6,295508
22131,0.001614,172.31.36.0-255,66,160758,6,295508
22132,0.001645,74.125.68.0-255,5738,166496,6,295508
22133,0.001648,172.31.36.0-255,66,166562,6,295508
22134,0.001653,74.125.68.0-255,2902,169464,6,295508
22135,0.001655,172.31.36.0-255,66,169530,6,295508
22136,0.001665,74.125.68.0-255,4320,173850,6,295508
22137,0.001667,172.31.36.0-255,66,173916,6,295508
22138,0.001715,74.125.68.0-255,8574,182490,6,295508
22139,0.001719,172.31.36.0-255,66,182556,6,295508
22140,0.001728,74.125.68.0-255,7856,190412,6,295508
22141,0.001735,172.31.36.0-255,66,190478,6,295508
22142,0.001772,74.125.68.0-255,9992,200470,6,295508
22143,0.001775,172.31.36.0-255,66,200536,6,295508
22144,0.001793,172.31.36.0-255,66,200602,6,295508
22145,0.001825,74.125.68.0-255,9992,210594,6,295508
22146,0.001829,172.31.36.0-255,66,210660,6,295508
22147,0.001833,74.125.68.0-255,2184,212844,6,295508
22148,0.001836,172.31.36.0-255,66,212910,6,295508
22149,0.001905,74.125.68.0-255,1484,214394,6,295508
22150,0.00192,74.125.68.0-255,2902,217296,6,295508
22151,0.001923,172.31.36.0-255,66,217362,6,295508
22152,0.001927,74.125.68.0-255,1484,218846,6,295508
22153,0.001946,74.125.68.0-255,4320,223166,6,295508
22154,0.001949,172.31.36.0-255,66,223232,6,295508
22155,0.001953,74.125.68.0-255,2902,226134,6,295508
22156,0.001956,172.31.36.0-255,66,226200,6,295508
22157,0.001998,74.125.68.0-255,4320,230520,6,295508
22158,0.002002,172.31.36.0-255,66,230586,6,295508
22159,0.002022,172.31.36.0-255,66,230652,6,295508
22160,0.002049,74.125.68.0-255,2184,232836,6,295508
22161,0.002052,172.31.36.0-255,66,232902,6,295508
22162,0.002057,74.125.68.0-255,2902,235804,6,295508
22163,0.002059,172.31.36.0-255,66,235870,6,295508
22164,0.002087,74.125.68.0-255,5738,241608,6,295508
22165,0.00209,172.31.36.0-255,66,241674,6,295508
22166,0.002116,74.125.68.0-255,1484,243158,6,295508
22167,0.002121,74.125.68.0-255,2902,246060,6,295508
22168,0.002124,172.31.36.0-255,66,246126,6,295508
22169,0.002136,172.31.36.0-255,66,246192,6,295508
22170,0.002149,74.125.68.0-255,8574,254766,6,295508
22171,0.002152,172.31.36.0-255,66,254832,6,295508
22172,0.002222,74.125.68.0-255,9274,264106,6,295508
22173,0.002226,172.31.36.0-255,66,264172,6,295508
22174,0.002232,74.125.68.0-255,4320,268492,6,295508
22175,0.002234,172.31.36.0-255,66,268558,6,295508
22176,0.00224,74.125.68.0-255,4320,272878,6,295508
22177,0.002242,172.31.36.0-255,66,272944,6,295508
22178,0.002289,172.31.36.0-255,66,273010,6,295508
22179,0.002295,74.125.68.0-255,5020,278030,6,295508
22180,0.002298,172.31.36.0-255,66,278096,6,295508
22181,0.004569,74.125.68.0-255,5738,283834,6,295508
22182,0.004576,172.31.36.0-255,66,283900,6,295508
22183,0.006835,74.125.68.0-255,5738,289638,6,295508
22184,0.006842,172.31.36.0-255,66,289704,6,295508
22185,0.009125,74.125.68.0-255,5738,295442,6,295508
22186,0.009131,172.31.36.0-255,66,295508,6,295508
22187,0.0,172.217.160.0-255,146,146,6,280522
22188,2.5e-05,172.31.36.0-255,66,212,6,280522
22189,3.2e-05,172.217.160.0-255,1484,1696,6,280522
22190,3.6e-05,172.31.36.0-255,66,1762,6,280522
22191,4e-05,172.217.160.0-255,2902,4664,6,280522
22192,4.2e-05,172.31.36.0-255,66,4730,6,280522
22193,4.6e-05,172.217.160.0-255,2902,7632,6,280522
22194,5e-05,172.31.36.0-255,66,7698,6,280522
22195,5.5e-05,172.217.160.0-255,4320,12018,6,280522
22196,5.7e-05,172.31.36.0-255,66,12084,6,280522
22197,9.1e-05,172.217.160.0-255,9147,21231,6,280522
22198,9.4e-05,172.31.36.0-255,66,21297,6,280522
22199,0.000102,172.217.160.0-255,8574,29871,6,280522
22200,0.000104,172.31.36.0-255,66,29937,6,280522
22201,0.000122,172.217.160.0-255,1125,31062,6,280522
22202,0.000125,172.31.36.0-255,66,31128,6,280522
22203,0.00015,172.217.160.0-255,1484,32612,6,280522
22204,0.000152,172.31.36.0-255,66,32678,6,280522
22205,0.000158,172.217.160.0-255,2902,35580,6,280522
22206,0.00016,172.31.36.0-255,66,35646,6,280522
22207,0.000168,172.217.160.0-255,5738,41384,6,280522
22208,0.00017,172.31.36.0-255,66,41450,6,280522
22209,0.000193,172.217.160.0-255,6797,48247,6,280522
22210,0.000196,172.31.36.0-255,66,48313,6,280522
22211,0.000499,172.217.160.0-255,1484,49797,6,280522
22212,0.000505,172.31.36.0-255,66,49863,6,280522
22213,0.00051,172.217.160.0-255,2902,52765,6,280522
22214,0.000513,172.31.36.0-255,66,52831,6,280522
22215,0.000519,172.217.160.0-255,5738,58569,6,280522
22216,0.000523,172.31.36.0-255,66,58635,6,280522
22217,0.000559,172.217.160.0-255,1484,60119,6,280522
22218,0.000562,172.31.36.0-255,66,60185,6,280522
22219,0.000583,172.217.160.0-255,5683,65868,6,280522
22220,0.000586,172.31.36.0-255,66,65934,6,280522
22221,0.000664,172.217.160.0-255,1484,67418,6,280522
22222,0.000669,172.217.160.0-255,1484,68902,6,280522
22223,0.000671,172.31.36.0-255,66,68968,6,280522
22224,0.00069,172.217.160.0-255,1484,70452,6,280522
22225,0.000697,172.217.160.0-255,5738,76190,6,280522
22226,0.000699,172.31.36.0-255,66,76256,6,280522
22227,0.000704,172.217.160.0-255,4320,80576,6,280522
22228,0.000706,172.31.36.0-255,66,80642,6,280522
22229,0.000721,172.217.160.0-255,2849,83491,6,280522
22230,0.000723,172.31.36.0-255,66,83557,6,280522
22231,0.000751,172.217.160.0-255,2902,86459,6,280522
22232,0.000754,172.31.36.0-255,66,86525,6,280522
22233,0.000771,172.217.160.0-255,5738,92263,6,280522
22234,0.000774,172.31.36.0-255,66,92329,6,280522
22235,0.000795,172.217.160.0-255,1484,93813,6,280522
22236,0.00082,172.217.160.0-255,6797,100610,6,280522
22237,0.000823,172.31.36.0-255,66,100676,6,280522
22238,0.000856,172.217.160.0-255,7156,107832,6,280522
22239,0.000859,172.31.36.0-255,66,107898,6,280522
22240,0.000875,172.217.160.0-255,1484,109382,6,280522
22241,0.00091,172.217.160.0-255,7156,116538,6,280522
22242,0.000913,172.31.36.0-255,66,116604,6,280522
22243,0.000929,172.217.160.0-255,594,117198,6,280522
22244,0.001004,172.217.160.0-255,1484,118682,6,280522
22245,0.001007,172.31.36.0-255,66,118748,6,280522
22246,0.001013,172.217.160.0-255,2902,121650,6,280522
22247,0.001015,172.31.36.0-255,66,121716,6,280522
22248,0.001036,172.217.160.0-255,5738,127454,6,280522
22249,0.001039,172.31.36.0-255,66,127520,6,280522
22250,0.001044,172.217.160.0-255,4320,131840,6,280522
22251,0.001046,172.31.36.0-255,66,131906,6,280522
22252,0.001073,172.217.160.0-255,8574,140480,6,280522
22253,0.001076,172.31.36.0-255,66,140546,6,280522
22254,0.001082,172.217.160.0-255,5738,146284,6,280522
22255,0.001085,172.31.36.0-255,66,146350,6,280522
22256,0.001102,172.217.160.0-255,2902,149252,6,280522
22257,0.001108,172.31.36.0-255,66,149318,6,280522
22258,0.001114,172.217.160.0-255,2184,151502,6,280522
22259,0.001117,172.31.36.0-255,66,151568,6,280522
22260,0.001145,172.217.160.0-255,2902,154470,6,280522
22261,0.001148,172.31.36.0-255,66,154536,6,280522
22262,0.001153,172.217.160.0-255,4320,158856,6,280522
22263,0.001155,172.31.36.0-255,66,158922,6,280522
22264,0.00116,172.217.160.0-255,8574,167496,6,280522
22265,0.001162,172.31.36.0-255,66,167562,6,280522
22266,0.00119,172.217.160.0-255,7156,174718,6,280522
22267,0.001194,172.31.36.0-255,66,174784,6,280522
22268,0.001216,172.217.160.0-255,2902,177686,6,280522
22269,0.00122,172.31.36.0-255,66,177752,6,280522
22270,0.001224,172.217.160.0-255,7856,185608,6,280522
22271,0.001227,172.31.36.0-255,66,185674,6,280522
22272,0.00129,172.217.160.0-255,8574,194248,6,280522
22273,0.001296,172.217.160.0-255,7156,201404,6,280522
22274,0.001296,172.31.36.0-255,66,201470,6,280522
22275,0.001299,172.31.36.0-255,66,201536,6,280522
22276,0.001315,172.217.160.0-255,8574,210110,6,280522
22277,0.001318,172.31.36.0-255,66,210176,6,280522
22278,0.001335,172.217.160.0-255,8242,218418,6,280522
22279,0.001339,172.31.36.0-255,66,218484,6,280522
22280,0.001358,172.217.160.0-255,7156,225640,6,280522
22281,0.001362,172.31.36.0-255,66,225706,6,280522
22282,0.001398,172.217.160.0-255,9992,235698,6,280522
22283,0.001401,172.31.36.0-255,66,235764,6,280522
22284,0.001409,172.217.160.0-255,8574,244338,6,280522
22285,0.001411,172.31.36.0-255,66,244404,6,280522
22286,0.001417,172.217.160.0-255,5738,250142,6,280522
22287,0.001419,172.31.36.0-255,66,250208,6,280522
22288,0.001442,172.217.160.0-255,2184,252392,6,280522
22289,0.001445,172.31.36.0-255,66,252458,6,280522
22290,0.003049,172.217.160.0-255,2902,255360,6,280522
22291,0.003057,172.31.36.0-255,66,255426,6,280522
22292,0.003081,172.217.160.0-255,2902,258328,6,280522
22293,0.003084,172.31.36.0-255,66,258394,6,280522
22294,0.004676,172.217.160.0-255,2902,261296,6,280522
22295,0.004681,172.31.36.0-255,66,261362,6,280522
22296,0.0047,172.217.160.0-255,2902,264264,6,280522
22297,0.004702,172.31.36.0-255,66,264330,6,280522
22298,0.006306,172.217.160.0-255,2902,267232,6,280522
22299,0.006313,172.31.36.0-255,66,267298,6,280522
22300,0.006333,172.217.160.0-255,2902,270200,6,280522
22301,0.006335,172.31.36.0-255,66,270266,6,280522
22302,0.007942,172.217.160.0-255,4320,274586,6,280522
22303,0.007946,172.31.36.0-255,66,274652,6,280522
22304,0.007977,172.217.160.0-255,1484,276136,6,280522
22305,0.009588,172.217.160.0-255,4320,280456,6,280522
22306,0.009595,172.31.36.0-255,66,280522,6,280522
22307,0.0,74.125.24.0-255,156,156,6,337336
22308,2e-05,172.31.36.0-255,66,222,6,337336
22309,2.7e-05,74.125.24.0-255,1484,1706,6,337336
22310,3.1e-05,172.31.36.0-255,66,1772,6,337336
22311,3.9e-05,74.125.24.0-255,2902,4674,6,337336
22312,4.3e-05,172.31.36.0-255,66,4740,6,337336
22313,4.6e-05,74.125.24.0-255,1484,6224,6,337336
22314,4.9e-05,172.31.36.0-255,66,6290,6,337336
22315,5.5e-05,74.125.24.0-255,2902,9192,6,337336
22316,5.7e-05,172.31.36.0-255,66,9258,6,337336
22317,8.1e-05,74.125.24.0-255,4938,14196,6,337336
22318,8.5e-05,172.31.36.0-255,66,14262,6,337336
22319,0.000133,74.125.24.0-255,1484,15746,6,337336
22320,0.000135,172.31.36.0-255,66,15812,6,337336
22321,0.00014,74.125.24.0-255,2902,18714,6,337336
22322,0.000142,172.31.36.0-255,66,18780,6,337336
22323,0.000148,74.125.24.0-255,4320,23100,6,337336
22324,0.000159,172.31.36.0-255,66,23166,6,337336
22325,0.000182,74.125.24.0-255,1484,24650,6,337336
22326,0.000185,172.31.36.0-255,66,24716,6,337336
22327,0.000195,74.125.24.0-255,9633,34349,6,337336
22328,0.000198,172.31.36.0-255,66,34415,6,337336
22329,0.000207,74.125.24.0-255,9992,44407,6,337336
22330,0.000209,172.31.36.0-255,66,44473,6,337336
22331,0.000232,74.125.24.0-255,3961,48434,6,337336
22332,0.000235,172.31.36.0-255,66,48500,6,337336
22333,0.000272,74.125.24.0-255,4320,52820,6,337336
22334,0.000275,172.31.36.0-255,66,52886,6,337336
22335,0.000296,74.125.24.0-255,7156,60042,6,337336
22336,0.000299,172.31.36.0-255,66,60108,6,337336
22337,0.000337,74.125.24.0-255,4320,64428,6,337336
22338,0.000341,172.31.36.0-255,66,64494,6,337336
22339,0.000356,74.125.24.0-255,1457,65951,6,337336
22340,0.00036,74.125.24.0-255,112,66063,6,337336
22341,0.000412,74.125.24.0-255,331,66394,6,337336
22342,0.000512,172.31.36.0-255,66,66460,6,337336
22343,0.000659,74.125.24.0-255,1484,67944,6,337336
22344,0.000665,74.125.24.0-255,2902,70846,6,337336
22345,0.000677,74.125.24.0-255,1484,72330,6,337336
22346,0.000683,172.31.36.0-255,66,72396,6,337336
22347,0.000693,74.125.24.0-255,4320,76716,6,337336
22348,0.000699,74.125.24.0-255,5738,82454,6,337336
22349,0.000704,172.31.36.0-255,66,82520,6,337336
22350,0.000729,74.125.24.0-255,1125,83645,6,337336
22351,0.000747,74.125.24.0-255,1484,85129,6,337336
22352,0.000761,74.125.24.0-255,4320,89449,6,337336
22353,0.000783,74.125.24.0-255,8574,98023,6,337336
22354,0.000791,172.31.36.0-255,66,98089,6,337336
22355,0.000801,74.125.24.0-255,1484,99573,6,337336
22356,0.000804,74.125.24.0-255,1125,100698,6,337336
22357,0.000809,172.31.36.0-255,66,100764,6,337336
22358,0.001135,74.125.24.0-255,1484,102248,6,337336
22359,0.001142,74.125.24.0-255,2902,105150,6,337336
22360,0.001145,172.31.36.0-255,66,105216,6,337336
22361,0.001153,74.125.24.0-255,5738,110954,6,337336
22362,0.001176,74.125.24.0-255,5738,116692,6,337336
22363,0.001192,74.125.24.0-255,7156,123848,6,337336
22364,0.001196,172.31.36.0-255,66,123914,6,337336
22365,0.001201,172.31.36.0-255,66,123980,6,337336
22366,0.001224,74.125.24.0-255,10692,134672,6,337336
22367,0.001241,172.31.36.0-255,66,134738,6,337336
22368,0.002414,74.125.24.0-255,1484,136222,6,337336
22369,0.002426,74.125.24.0-255,2902,139124,6,337336
22370,0.002431,172.31.36.0-255,66,139190,6,337336
22371,0.00244,74.125.24.0-255,5738,144928,6,337336
22372,0.002447,74.125.24.0-255,5738,150666,6,337336
22373,0.002475,74.125.24.0-255,5738,156404,6,337336
22374,0.002513,74.125.24.0-255,9992,166396,6,337336
22375,0.002527,74.125.24.0-255,2184,168580,6,337336
22376,0.002553,74.125.24.0-255,1484,170064,6,337336
22377,0.002566,74.125.24.0-255,2902,172966,6,337336
22378,0.002588,74.125.24.0-255,5738,178704,6,337336
22379,0.002602,74.125.24.0-255,2902,181606,6,337336
22380,0.002618,74.125.24.0-255,4320,185926,6,337336
22381,0.002625,74.125.24.0-255,5738,191664,6,337336
22382,0.002641,74.125.24.0-255,2902,194566,6,337336
22383,0.002664,74.125.24.0-255,4320,198886,6,337336
22384,0.002683,74.125.24.0-255,3602,202488,6,337336
22385,0.002756,74.125.24.0-255,1484,203972,6,337336
22386,0.002774,74.125.24.0-255,2902,206874,6,337336
22387,0.00278,74.125.24.0-255,4320,211194,6,337336
22388,0.002797,74.125.24.0-255,1484,212678,6,337336
22389,0.002806,74.125.24.0-255,8574,221252,6,337336
22390,0.002824,74.125.24.0-255,4320,225572,6,337336
22391,0.002854,74.125.24.0-255,5738,231310,6,337336
22392,0.002869,74.125.24.0-255,5020,236330,6,337336
22393,0.002949,74.125.24.0-255,1484,237814,6,337336
22394,0.002954,74.125.24.0-255,2902,240716,6,337336
22395,0.002975,74.125.24.0-255,2902,243618,6,337336
22396,0.002986,74.125.24.0-255,2902,246520,6,337336
22397,0.003002,74.125.24.0-255,4320,250840,6,337336
22398,0.003028,74.125.24.0-255,8574,259414,6,337336
22399,0.003033,74.125.24.0-255,4320,263734,6,337336
22400,0.003088,74.125.24.0-255,2184,265918,6,337336
22401,0.003091,74.125.24.0-255,1484,267402,6,337336
22402,0.003102,74.125.24.0-255,1484,268886,6,337336
22403,0.00315,74.125.24.0-255,2184,271070,6,337336
22404,0.003239,74.125.24.0-255,1484,272554,6,337336
22405,0.003244,74.125.24.0-255,2902,275456,6,337336
22406,0.003256,74.125.24.0-255,1484,276940,6,337336
22407,0.003272,74.125.24.0-255,4320,281260,6,337336
22408,0.003275,74.125.24.0-255,1484,282744,6,337336
22409,0.00329,74.125.24.0-255,4320,287064,6,337336
22410,0.003307,74.125.24.0-255,7156,294220,6,337336
22411,0.003337,74.125.24.0-255,10692,304912,6,337336
22412,0.003431,74.125.24.0-255,1484,306396,6,337336
22413,0.003435,74.125.24.0-255,1484,307880,6,337336
22414,0.003455,74.125.24.0-255,1484,309364,6,337336
22415,0.003643,74.125.24.0-255,5738,315102,6,337336
22416,0.003686,74.125.24.0-255,7156,322258,6,337336
22417,0.003714,74.125.24.0-255,5738,327996,6,337336
22418,0.003746,74.125.24.0-255,9103,337099,6,337336
22419,0.003872,172.31.36.0-255,66,337165,6,337336
22420,0.006031,172.31.36.0-255,105,337270,6,337336
22421,0.007979,74.125.24.0-255,66,337336,6,337336
22422,0.0,74.125.24.0-255,153,153,6,151127
22423,1.3e-05,172.31.36.0-255,66,219,6,151127
22424,2.1e-05,74.125.24.0-255,1484,1703,6,151127
22425,2.5e-05,172.31.36.0-255,66,1769,6,151127
22426,3.1e-05,74.125.24.0-255,2902,4671,6,151127
22427,4.2e-05,172.31.36.0-255,66,4737,6,151127
22428,5e-05,74.125.24.0-255,7156,11893,6,151127
22429,5.4e-05,172.31.36.0-255,66,11959,6,151127
22430,5.8e-05,74.125.24.0-255,2041,14000,6,151127
22431,6.1e-05,172.31.36.0-255,66,14066,6,151127
22432,8.7e-05,74.125.24.0-255,1484,15550,6,151127
22433,8.9e-05,172.31.36.0-255,66,15616,6,151127
22434,9.6e-05,74.125.24.0-255,2902,18518,6,151127
22435,9.8e-05,172.31.36.0-255,66,18584,6,151127
22436,0.000105,74.125.24.0-255,5738,24322,6,151127
22437,0.000107,172.31.36.0-255,66,24388,6,151127
22438,0.000142,74.125.24.0-255,6797,31185,6,151127
22439,0.000146,172.31.36.0-255,66,31251,6,151127
22440,0.000519,74.125.24.0-255,1484,32735,6,151127
22441,0.000525,172.31.36.0-255,66,32801,6,151127
22442,0.000531,74.125.24.0-255,2902,35703,6,151127
22443,0.000533,172.31.36.0-255,66,35769,6,151127
22444,0.000546,74.125.24.0-255,5738,41507,6,151127
22445,0.000549,172.31.36.0-255,66,41573,6,151127
22446,0.000606,74.125.24.0-255,6797,48370,6,151127
22447,0.00061,172.31.36.0-255,66,48436,6,151127
22448,0.000796,74.125.24.0-255,1484,49920,6,151127
22449,0.000801,172.31.36.0-255,66,49986,6,151127
22450,0.000807,74.125.24.0-255,2902,52888,6,151127
22451,0.000809,172.31.36.0-255,66,52954,6,151127
22452,0.00082,74.125.24.0-255,5738,58692,6,151127
22453,0.000822,172.31.36.0-255,66,58758,6,151127
22454,0.000874,74.125.24.0-255,7379,66137,6,151127
22455,0.000876,172.31.36.0-255,66,66203,6,151127
22456,0.000938,74.125.24.0-255,1484,67687,6,151127
22457,0.000944,74.125.24.0-255,2902,70589,6,151127
22458,0.000947,172.31.36.0-255,66,70655,6,151127
22459,0.000953,74.125.24.0-255,5738,76393,6,151127
22460,0.000956,172.31.36.0-255,66,76459,6,151127
22461,0.000989,74.125.24.0-255,6797,83256,6,151127
22462,0.000992,172.31.36.0-255,66,83322,6,151127
22463,0.00103,74.125.24.0-255,7156,90478,6,151127
22464,0.001033,172.31.36.0-255,66,90544,6,151127
22465,0.001039,74.125.24.0-255,4320,94864,6,151127
22466,0.001042,172.31.36.0-255,66,94930,6,151127
22467,0.001067,74.125.24.0-255,5379,100309,6,151127
22468,0.00107,172.31.36.0-255,66,100375,6,151127
22469,0.002222,74.125.24.0-255,1484,101859,6,151127
22470,0.002231,74.125.24.0-255,2902,104761,6,151127
22471,0.002235,172.31.36.0-255,66,104827,6,151127
22472,0.002242,74.125.24.0-255,5738,110565,6,151127
22473,0.002243,172.31.36.0-255,66,110631,6,151127
22474,0.002272,74.125.24.0-255,7156,117787,6,151127
22475,0.002274,172.31.36.0-255,66,117853,6,151127
22476,0.002303,74.125.24.0-255,5738,123591,6,151127
22477,0.002305,172.31.36.0-255,66,123657,6,151127
22478,0.002314,74.125.24.0-255,9992,133649,6,151127
22479,0.002315,172.31.36.0-255,66,133715,6,151127
22480,0.004618,74.125.24.0-255,5738,139453,6,151127
22481,0.004622,172.31.36.0-255,66,139519,6,151127
22482,0.006895,74.125.24.0-255,5738,145257,6,151127
22483,0.006899,172.31.36.0-255,66,145323,6,151127
22484,0.009168,74.125.24.0-255,5738,151061,6,151127
22485,0.009176,172.31.36.0-255,66,151127,6,151127
22486,0.0,74.125.24.0-255,152,152,6,134635
22487,3.9e-05,172.31.36.0-255,66,218,6,134635
22488,4.7e-05,74.125.24.0-255,1484,1702,6,134635
22489,5.1e-05,172.31.36.0-255,66,1768,6,134635
22490,6.4e-05,74.125.24.0-255,2902,4670,6,134635
22491,6.8e-05,172.31.36.0-255,66,4736,6,134635
22492,7.2e-05,74.125.24.0-255,2902,7638,6,134635
22493,7.4e-05,172.31.36.0-255,66,7704,6,134635
22494,7.7e-05,74.125.24.0-255,1484,9188,6,134635
22495,8e-05,172.31.36.0-255,66,9254,6,134635
22496,0.000112,74.125.24.0-255,4841,14095,6,134635
22497,0.000117,172.31.36.0-255,66,14161,6,134635
22498,0.000127,74.125.24.0-255,7156,21317,6,134635
22499,0.000129,172.31.36.0-255,66,21383,6,134635
22500,0.000132,74.125.24.0-255,1484,22867,6,134635
22501,0.000133,172.31.36.0-255,66,22933,6,134635
22502,0.000165,74.125.24.0-255,8215,31148,6,134635
22503,0.00017,172.31.36.0-255,66,31214,6,134635
22504,0.000333,74.125.24.0-255,1484,32698,6,134635
22505,0.000337,172.31.36.0-255,66,32764,6,134635
22506,0.000342,74.125.24.0-255,2902,35666,6,134635
22507,0.000345,172.31.36.0-255,66,35732,6,134635
22508,0.000351,74.125.24.0-255,4320,40052,6,134635
22509,0.00036,172.31.36.0-255,66,40118,6,134635
22510,0.000389,74.125.24.0-255,1484,41602,6,134635
22511,0.000392,172.31.36.0-255,66,41668,6,134635
22512,0.000407,172.31.36.0-255,66,41734,6,134635
22513,0.000467,74.125.24.0-255,9633,51367,6,134635
22514,0.000471,172.31.36.0-255,66,51433,6,134635
22515,0.000474,74.125.24.0-255,400,51833,6,134635
22516,0.000476,172.31.36.0-255,66,51899,6,134635
22517,0.000609,74.125.24.0-255,108,52007,6,134635
22518,0.000905,172.31.36.0-255,66,52073,6,134635
22519,0.001039,74.125.24.0-255,334,52407,6,134635
22520,0.001923,74.125.24.0-255,1484,53891,6,134635
22521,0.00193,172.31.36.0-255,66,53957,6,134635
22522,0.001937,74.125.24.0-255,2902,56859,6,134635
22523,0.001939,172.31.36.0-255,66,56925,6,134635
22524,0.001943,74.125.24.0-255,2902,59827,6,134635
22525,0.001944,172.31.36.0-255,66,59893,6,134635
22526,0.001964,74.125.24.0-255,2902,62795,6,134635
22527,0.001966,172.31.36.0-255,66,62861,6,134635
22528,0.001977,74.125.24.0-255,7156,70017,6,134635
22529,0.001978,172.31.36.0-255,66,70083,6,134635
22530,0.001982,74.125.24.0-255,2902,72985,6,134635
22531,0.001985,172.31.36.0-255,66,73051,6,134635
22532,0.002014,172.31.36.0-255,66,73117,6,134635
22533,0.002017,74.125.24.0-255,2184,75301,6,134635
22534,0.002019,172.31.36.0-255,66,75367,6,134635
22535,0.002073,74.125.24.0-255,1484,76851,6,134635
22536,0.002078,74.125.24.0-255,2902,79753,6,134635
22537,0.00208,172.31.36.0-255,66,79819,6,134635
22538,0.002084,74.125.24.0-255,1484,81303,6,134635
22539,0.002108,74.125.24.0-255,4320,85623,6,134635
22540,0.00211,172.31.36.0-255,66,85689,6,134635
22541,0.002116,74.125.24.0-255,5738,91427,6,134635
22542,0.002118,172.31.36.0-255,66,91493,6,134635
22543,0.002159,172.31.36.0-255,66,91559,6,134635
22544,0.002165,74.125.24.0-255,5020,96579,6,134635
22545,0.002167,172.31.36.0-255,66,96645,6,134635
22546,0.002194,74.125.24.0-255,4320,100965,6,134635
22547,0.002196,172.31.36.0-255,66,101031,6,134635
22548,0.002218,74.125.24.0-255,1484,102515,6,134635
22549,0.002222,74.125.24.0-255,2902,105417,6,134635
22550,0.002224,172.31.36.0-255,66,105483,6,134635
22551,0.002233,74.125.24.0-255,9992,115475,6,134635
22552,0.002235,172.31.36.0-255,66,115541,6,134635
22553,0.002274,74.125.24.0-255,2902,118443,6,134635
22554,0.002276,172.31.36.0-255,66,118509,6,134635
22555,0.002307,172.31.36.0-255,66,118575,6,134635
22556,0.004616,74.125.24.0-255,4320,122895,6,134635
22557,0.004619,172.31.36.0-255,66,122961,6,134635
22558,0.004642,74.125.24.0-255,1484,124445,6,134635
22559,0.006939,74.125.24.0-255,4320,128765,6,134635
22560,0.006944,172.31.36.0-255,66,128831,6,134635
22561,0.00929,74.125.24.0-255,5738,134569,6,134635
22562,0.009309,172.31.36.0-255,66,134635,6,134635
22563,0.0,74.125.24.0-255,146,146,6,315926
22564,2.6e-05,172.31.36.0-255,66,212,6,315926
22565,3.3e-05,74.125.24.0-255,1484,1696,6,315926
22566,3.7e-05,172.31.36.0-255,66,1762,6,315926
22567,4.2e-05,74.125.24.0-255,2902,4664,6,315926
22568,4.5e-05,172.31.36.0-255,66,4730,6,315926
22569,5.8e-05,74.125.24.0-255,4320,9050,6,315926
22570,6.1e-05,172.31.36.0-255,66,9116,6,315926
22571,0.000101,74.125.24.0-255,4837,13953,6,315926
22572,0.000105,172.31.36.0-255,66,14019,6,315926
22573,0.000162,74.125.24.0-255,1484,15503,6,315926
22574,0.000165,172.31.36.0-255,66,15569,6,315926
22575,0.000171,74.125.24.0-255,2902,18471,6,315926
22576,0.000175,172.31.36.0-255,66,18537,6,315926
22577,0.000188,74.125.24.0-255,5738,24275,6,315926
22578,0.000191,172.31.36.0-255,66,24341,6,315926
22579,0.000231,74.125.24.0-255,7156,31497,6,315926
22580,0.000235,172.31.36.0-255,66,31563,6,315926
22581,0.000265,74.125.24.0-255,6797,38360,6,315926
22582,0.000269,172.31.36.0-255,66,38426,6,315926
22583,0.000304,74.125.24.0-255,9633,48059,6,315926
22584,0.000307,172.31.36.0-255,66,48125,6,315926
22585,0.000315,74.125.24.0-255,5738,53863,6,315926
22586,0.000318,172.31.36.0-255,66,53929,6,315926
22587,0.000341,74.125.24.0-255,4320,58249,6,315926
22588,0.000345,172.31.36.0-255,66,58315,6,315926
22589,0.000352,74.125.24.0-255,7104,65419,6,315926
22590,0.000355,172.31.36.0-255,66,65485,6,315926
22591,0.000385,74.125.24.0-255,115,65600,6,315926
22592,0.000405,172.31.36.0-255,66,65666,6,315926
22593,0.000429,74.125.24.0-255,331,65997,6,315926
22594,0.000432,172.31.36.0-255,66,66063,6,315926
22595,0.000846,74.125.24.0-255,1484,67547,6,315926
22596,0.000852,74.125.24.0-255,1484,69031,6,315926
22597,0.000856,172.31.36.0-255,66,69097,6,315926
22598,0.000883,74.125.24.0-255,1484,70581,6,315926
22599,0.00089,74.125.24.0-255,5738,76319,6,315926
22600,0.000893,172.31.36.0-255,66,76385,6,315926
22601,0.000923,74.125.24.0-255,7156,83541,6,315926
22602,0.000926,172.31.36.0-255,66,83607,6,315926
22603,0.000934,74.125.24.0-255,7156,90763,6,315926
22604,0.000937,172.31.36.0-255,66,90829,6,315926
22605,0.000957,74.125.24.0-255,7156,97985,6,315926
22606,0.000965,172.31.36.0-255,66,98051,6,315926
22607,0.000969,74.125.24.0-255,2184,100235,6,315926
22608,0.000971,172.31.36.0-255,66,100301,6,315926
22609,0.001885,74.125.24.0-255,1484,101785,6,315926
22610,0.001897,74.125.24.0-255,2902,104687,6,315926
22611,0.001902,172.31.36.0-255,66,104753,6,315926
22612,0.001912,74.125.24.0-255,5738,110491,6,315926
22613,0.001914,172.31.36.0-255,66,110557,6,315926
22614,0.00193,74.125.24.0-255,7156,117713,6,315926
22615,0.001932,172.31.36.0-255,66,117779,6,315926
22616,0.00196,74.125.24.0-255,5738,123517,6,315926
22617,0.001962,172.31.36.0-255,66,123583,6,315926
22618,0.001976,74.125.24.0-255,10692,134275,6,315926
22619,0.001978,172.31.36.0-255,66,134341,6,315926
22620,0.002047,74.125.24.0-255,1484,135825,6,315926
22621,0.002072,74.125.24.0-255,2902,138727,6,315926
22622,0.002075,172.31.36.0-255,66,138793,6,315926
22623,0.002103,74.125.24.0-255,5738,144531,6,315926
22624,0.002106,172.31.36.0-255,66,144597,6,315926
22625,0.002111,74.125.24.0-255,4320,148917,6,315926
22626,0.002113,172.31.36.0-255,66,148983,6,315926
22627,0.002146,172.31.36.0-255,66,149049,6,315926
22628,0.002184,74.125.24.0-255,2902,151951,6,315926
22629,0.002186,172.31.36.0-255,66,152017,6,315926
22630,0.002224,74.125.24.0-255,6438,158455,6,315926
22631,0.002227,172.31.36.0-255,66,158521,6,315926
22632,0.002235,74.125.24.0-255,9992,168513,6,315926
22633,0.002237,172.31.36.0-255,66,168579,6,315926
22634,0.002257,172.31.36.0-255,66,168645,6,315926
22635,0.002264,74.125.24.0-255,7156,175801,6,315926
22636,0.002266,172.31.36.0-255,66,175867,6,315926
22637,0.002305,74.125.24.0-255,9274,185141,6,315926
22638,0.002309,172.31.36.0-255,66,185207,6,315926
22639,0.002317,74.125.24.0-255,9992,195199,6,315926
22640,0.00232,172.31.36.0-255,66,195265,6,315926
22641,0.002357,74.125.24.0-255,7156,202421,6,315926
22642,0.00236,172.31.36.0-255,66,202487,6,315926
22643,0.002365,74.125.24.0-255,5020,207507,6,315926
22644,0.002367,172.31.36.0-255,66,207573,6,315926
22645,0.002436,74.125.24.0-255,1484,209057,6,315926
22646,0.002441,74.125.24.0-255,2902,211959,6,315926
22647,0.002444,172.31.36.0-255,66,212025,6,315926
22648,0.002448,74.125.24.0-255,1484,213509,6,315926
22649,0.002473,74.125.24.0-255,4320,217829,6,315926
22650,0.002477,172.31.36.0-255,66,217895,6,315926
22651,0.002484,74.125.24.0-255,7156,225051,6,315926
22652,0.002486,172.31.36.0-255,66,225117,6,315926
22653,0.002526,172.31.36.0-255,66,225183,6,315926
22654,0.002554,74.125.24.0-255,1484,226667,6,315926
22655,0.002558,74.125.24.0-255,2184,228851,6,315926
22656,0.00256,172.31.36.0-255,66,228917,6,315926
22657,0.002638,74.125.24.0-255,1484,230401,6,315926
22658,0.002654,74.125.24.0-255,2902,233303,6,315926
22659,0.002657,172.31.36.0-255,66,233369,6,315926
22660,0.002677,74.125.24.0-255,4320,237689,6,315926
22661,0.002681,74.125.24.0-255,4320,242009,6,315926
22662,0.002686,172.31.36.0-255,66,242075,6,315926
22663,0.002689,172.31.36.0-255,66,242141,6,315926
22664,0.002705,74.125.24.0-255,4320,246461,6,315926
22665,0.002707,172.31.36.0-255,66,246527,6,315926
22666,0.002712,74.125.24.0-255,4320,250847,6,315926
22667,0.002714,172.31.36.0-255,66,250913,6,315926
22668,0.002744,74.125.24.0-255,4320,255233,6,315926
22669,0.00275,172.31.36.0-255,66,255299,6,315926
22670,0.002753,74.125.24.0-255,1484,256783,6,315926
22671,0.002766,172.31.36.0-255,66,256849,6,315926
22672,0.002771,74.125.24.0-255,4320,261169,6,315926
22673,0.002773,172.31.36.0-255,66,261235,6,315926
22674,0.002806,74.125.24.0-255,7156,268391,6,315926
22675,0.00281,172.31.36.0-255,66,268457,6,315926
22676,0.002847,172.31.36.0-255,66,268523,6,315926
22677,0.002876,74.125.24.0-255,6438,274961,6,315926
22678,0.002879,172.31.36.0-255,66,275027,6,315926
22679,0.002883,74.125.24.0-255,2902,277929,6,315926
22680,0.002885,172.31.36.0-255,66,277995,6,315926
22681,0.002904,172.31.36.0-255,66,278061,6,315926
22682,0.002909,74.125.24.0-255,4320,282381,6,315926
22683,0.002911,172.31.36.0-255,66,282447,6,315926
22684,0.002913,74.125.24.0-255,1484,283931,6,315926
22685,0.002919,74.125.24.0-255,3602,287533,6,315926
22686,0.002921,172.31.36.0-255,66,287599,6,315926
22687,0.002924,74.125.24.0-255,1484,289083,6,315926
22688,0.002985,74.125.24.0-255,4320,293403,6,315926
22689,0.002988,172.31.36.0-255,66,293469,6,315926
22690,0.002992,74.125.24.0-255,2902,296371,6,315926
22691,0.002994,172.31.36.0-255,66,296437,6,315926
22692,0.003006,74.125.24.0-255,8574,305011,6,315926
22693,0.003008,172.31.36.0-255,66,305077,6,315926
22694,0.003023,74.125.24.0-255,2902,307979,6,315926
22695,0.00303,172.31.36.0-255,66,308045,6,315926
22696,0.00306,74.125.24.0-255,7156,315201,6,315926
22697,0.003062,74.125.24.0-255,317,315518,6,315926
22698,0.003066,172.31.36.0-255,66,315584,6,315926
22699,0.003133,74.125.24.0-255,105,315689,6,315926
22700,0.004997,172.31.36.0-255,66,315755,6,315926
22701,0.005034,172.31.36.0-255,105,315860,6,315926
22702,0.0076,74.125.24.0-255,66,315926,6,315926
22703,0.0,74.125.24.0-255,146,146,6,284925
22704,2.3e-05,172.31.36.0-255,66,212,6,284925
22705,2.9e-05,74.125.24.0-255,1484,1696,6,284925
22706,3.3e-05,172.31.36.0-255,66,1762,6,284925
22707,4e-05,74.125.24.0-255,2902,4664,6,284925
22708,4.4e-05,172.31.36.0-255,66,4730,6,284925
22709,6e-05,74.125.24.0-255,7156,11886,6,284925
22710,6.3e-05,172.31.36.0-255,66,11952,6,284925
22711,0.000118,172.31.36.0-255,66,12018,6,284925
22712,0.000122,74.125.24.0-255,2543,14561,6,284925
22713,0.000124,172.31.36.0-255,66,14627,6,284925
22714,0.000203,74.125.24.0-255,1484,16111,6,284925
22715,0.000207,172.31.36.0-255,66,16177,6,284925
22716,0.000211,74.125.24.0-255,1484,17661,6,284925
22717,0.000213,172.31.36.0-255,66,17727,6,284925
22718,0.000242,74.125.24.0-255,1484,19211,6,284925
22719,0.000245,172.31.36.0-255,66,19277,6,284925
22720,0.000252,74.125.24.0-255,5738,25015,6,284925
22721,0.000254,172.31.36.0-255,66,25081,6,284925
22722,0.000276,172.31.36.0-255,66,25147,6,284925
22723,0.000286,74.125.24.0-255,10692,35839,6,284925
22724,0.000289,172.31.36.0-255,66,35905,6,284925
22725,0.000336,74.125.24.0-255,427,36332,6,284925
22726,0.000339,172.31.36.0-255,66,36398,6,284925
22727,0.000444,74.125.24.0-255,1484,37882,6,284925
22728,0.000449,172.31.36.0-255,66,37948,6,284925
22729,0.000454,74.125.24.0-255,2902,40850,6,284925
22730,0.000457,172.31.36.0-255,66,40916,6,284925
22731,0.000461,74.125.24.0-255,2902,43818,6,284925
22732,0.000469,172.31.36.0-255,66,43884,6,284925
22733,0.000495,74.125.24.0-255,2902,46786,6,284925
22734,0.000508,74.125.24.0-255,8574,55360,6,284925
22735,0.000532,74.125.24.0-255,4320,59680,6,284925
22736,0.000635,172.31.36.0-255,66,59746,6,284925
22737,0.000663,74.125.24.0-255,1484,61230,6,284925
22738,0.000668,74.125.24.0-255,2902,64132,6,284925
22739,0.000675,74.125.24.0-255,5738,69870,6,284925
22740,0.00068,74.125.24.0-255,4320,74190,6,284925
22741,0.000701,74.125.24.0-255,5738,79928,6,284925
22742,0.000724,74.125.24.0-255,5738,85666,6,284925
22743,0.000729,74.125.24.0-255,2902,88568,6,284925
22744,0.000741,172.31.36.0-255,66,88634,6,284925
22745,0.000754,74.125.24.0-255,5020,93654,6,284925
22746,0.000767,172.31.36.0-255,66,93720,6,284925
22747,0.00078,74.125.24.0-255,1484,95204,6,284925
22748,0.000789,74.125.24.0-255,2902,98106,6,284925
22749,0.000831,74.125.24.0-255,5738,103844,6,284925
22750,0.00085,172.31.36.0-255,66,103910,6,284925
22751,0.00086,74.125.24.0-255,1484,105394,6,284925
22752,0.000872,74.125.24.0-255,7156,112550,6,284925
22753,0.00088,172.31.36.0-255,66,112616,6,284925
22754,0.000891,74.125.24.0-255,3602,116218,6,284925
22755,0.000901,74.125.24.0-255,4320,120538,6,284925
22756,0.000915,74.125.24.0-255,4320,124858,6,284925
22757,0.000929,74.125.24.0-255,5738,130596,6,284925
22758,0.000933,74.125.24.0-255,1484,132080,6,284925
22759,0.000977,172.31.36.0-255,66,132146,6,284925
22760,0.00099,74.125.24.0-255,2902,135048,6,284925
22761,0.00101,74.125.24.0-255,2184,137232,6,284925
22762,0.001016,74.125.24.0-255,5738,142970,6,284925
22763,0.001019,74.125.24.0-255,1484,144454,6,284925
22764,0.001056,74.125.24.0-255,8574,153028,6,284925
22765,0.00106,172.31.36.0-255,66,153094,6,284925
22766,0.001078,172.31.36.0-255,66,153160,6,284925
22767,0.0011,74.125.24.0-255,6438,159598,6,284925
22768,0.001124,172.31.36.0-255,66,159664,6,284925
22769,0.001146,74.125.24.0-255,5738,165402,6,284925
22770,0.001154,74.125.24.0-255,7156,172558,6,284925
22771,0.001226,74.125.24.0-255,6438,178996,6,284925
22772,0.00125,172.31.36.0-255,66,179062,6,284925
22773,0.001254,74.125.24.0-255,1484,180546,6,284925
22774,0.001257,74.125.24.0-255,2902,183448,6,284925
22775,0.001275,74.125.24.0-255,5738,189186,6,284925
22776,0.001278,74.125.24.0-255,1484,190670,6,284925
22777,0.001283,172.31.36.0-255,66,190736,6,284925
22778,0.001294,74.125.24.0-255,2902,193638,6,284925
22779,0.001339,172.31.36.0-255,66,193704,6,284925
22780,0.001361,74.125.24.0-255,7856,201560,6,284925
22781,0.001386,172.31.36.0-255,66,201626,6,284925
22782,0.001413,74.125.24.0-255,1484,203110,6,284925
22783,0.001419,74.125.24.0-255,2902,206012,6,284925
22784,0.001422,74.125.24.0-255,1484,207496,6,284925
22785,0.001448,74.125.24.0-255,4320,211816,6,284925
22786,0.001454,74.125.24.0-255,4320,216136,6,284925
22787,0.00146,74.125.24.0-255,5738,221874,6,284925
22788,0.001463,172.31.36.0-255,66,221940,6,284925
22789,0.00147,172.31.36.0-255,66,222006,6,284925
22790,0.0015,74.125.24.0-255,5738,227744,6,284925
22791,0.001518,74.125.24.0-255,4320,232064,6,284925
22792,0.001543,74.125.24.0-255,8574,240638,6,284925
22793,0.00156,74.125.24.0-255,5738,246376,6,284925
22794,0.001574,74.125.24.0-255,2902,249278,6,284925
22795,0.001578,172.31.36.0-255,66,249344,6,284925
22796,0.001585,172.31.36.0-255,66,249410,6,284925
22797,0.001605,74.125.24.0-255,7856,257266,6,284925
22798,0.00161,74.125.24.0-255,2902,260168,6,284925
22799,0.001645,74.125.24.0-255,5738,265906,6,284925
22800,0.001654,74.125.24.0-255,9992,275898,6,284925
22801,0.001676,172.31.36.0-255,66,275964,6,284925
22802,0.001707,74.125.24.0-255,8553,284517,6,284925
22803,0.001731,172.31.36.0-255,66,284583,6,284925
22804,0.00174,74.125.24.0-255,105,284688,6,284925
22805,0.00469,172.31.36.0-255,66,284754,6,284925
22806,0.004743,172.31.36.0-255,105,284859,6,284925
22807,0.006718,74.125.24.0-255,66,284925,6,284925
22808,0.0,74.125.68.0-255,153,153,6,173263
22809,3.3e-05,172.31.36.0-255,66,219,6,173263
22810,3.9e-05,74.125.68.0-255,1484,1703,6,173263
22811,4.3e-05,172.31.36.0-255,66,1769,6,173263
22812,4.8e-05,74.125.68.0-255,2902,4671,6,173263
22813,5e-05,172.31.36.0-255,66,4737,6,173263
22814,5.5e-05,74.125.68.0-255,4320,9057,6,173263
22815,5.7e-05,172.31.36.0-255,66,9123,6,173263
22816,9.5e-05,74.125.68.0-255,4941,14064,6,173263
22817,9.8e-05,172.31.36.0-255,66,14130,6,173263
22818,0.000198,74.125.68.0-255,1484,15614,6,173263
22819,0.000202,172.31.36.0-255,66,15680,6,173263
22820,0.000207,74.125.68.0-255,2902,18582,6,173263
22821,0.00021,172.31.36.0-255,66,18648,6,173263
22822,0.000235,74.125.68.0-255,5738,24386,6,173263
22823,0.000238,172.31.36.0-255,66,24452,6,173263
22824,0.000242,74.125.68.0-255,2902,27354,6,173263
22825,0.000244,172.31.36.0-255,66,27420,6,173263
22826,0.000262,74.125.68.0-255,3961,31381,6,173263
22827,0.000264,172.31.36.0-255,66,31447,6,173263
22828,0.000295,74.125.68.0-255,4320,35767,6,173263
22829,0.000299,172.31.36.0-255,66,35833,6,173263
22830,0.000325,74.125.68.0-255,4320,40153,6,173263
22831,0.000329,172.31.36.0-255,66,40219,6,173263
22832,0.000335,74.125.68.0-255,4320,44539,6,173263
22833,0.000337,172.31.36.0-255,66,44605,6,173263
22834,0.000352,172.31.36.0-255,66,44671,6,173263
22835,0.000355,74.125.68.0-255,1484,46155,6,173263
22836,0.000357,172.31.36.0-255,66,46221,6,173263
22837,0.000393,74.125.68.0-255,1484,47705,6,173263
22838,0.000397,172.31.36.0-255,66,47771,6,173263
22839,0.000417,74.125.68.0-255,3602,51373,6,173263
22840,0.00042,172.31.36.0-255,66,51439,6,173263
22841,0.000423,74.125.68.0-255,426,51865,6,173263
22842,0.000515,74.125.68.0-255,1484,53349,6,173263
22843,0.000518,172.31.36.0-255,66,53415,6,173263
22844,0.000534,74.125.68.0-255,2902,56317,6,173263
22845,0.000536,172.31.36.0-255,66,56383,6,173263
22846,0.000539,74.125.68.0-255,1484,57867,6,173263
22847,0.000557,74.125.68.0-255,4320,62187,6,173263
22848,0.00056,172.31.36.0-255,66,62253,6,173263
22849,0.000565,74.125.68.0-255,2902,65155,6,173263
22850,0.000566,172.31.36.0-255,66,65221,6,173263
22851,0.000586,74.125.68.0-255,4320,69541,6,173263
22852,0.000588,172.31.36.0-255,66,69607,6,173263
22853,0.000602,74.125.68.0-255,4320,73927,6,173263
22854,0.000605,172.31.36.0-255,66,73993,6,173263
22855,0.000628,74.125.68.0-255,8574,82567,6,173263
22856,0.000632,172.31.36.0-255,66,82633,6,173263
22857,0.000652,74.125.68.0-255,3602,86235,6,173263
22858,0.000655,172.31.36.0-255,66,86301,6,173263
22859,0.000673,74.125.68.0-255,348,86649,6,173263
22860,0.000875,74.125.68.0-255,1484,88133,6,173263
22861,0.000879,172.31.36.0-255,66,88199,6,173263
22862,0.000884,74.125.68.0-255,2902,91101,6,173263
22863,0.000886,172.31.36.0-255,66,91167,6,173263
22864,0.000905,74.125.68.0-255,2902,94069,6,173263
22865,0.000907,172.31.36.0-255,66,94135,6,173263
22866,0.000925,74.125.68.0-255,1484,95619,6,173263
22867,0.000931,74.125.68.0-255,5738,101357,6,173263
22868,0.000934,172.31.36.0-255,66,101423,6,173263
22869,0.000969,74.125.68.0-255,9992,111415,6,173263
22870,0.000973,172.31.36.0-255,66,111481,6,173263
22871,0.00099,74.125.68.0-255,1484,112965,6,173263
22872,0.000996,74.125.68.0-255,4320,117285,6,173263
22873,0.000998,172.31.36.0-255,66,117351,6,173263
22874,0.001001,74.125.68.0-255,1484,118835,6,173263
22875,0.001017,74.125.68.0-255,2184,121019,6,173263
22876,0.00102,172.31.36.0-255,66,121085,6,173263
22877,0.002135,74.125.68.0-255,1484,122569,6,173263
22878,0.002146,74.125.68.0-255,2902,125471,6,173263
22879,0.002151,172.31.36.0-255,66,125537,6,173263
22880,0.002158,74.125.68.0-255,2902,128439,6,173263
22881,0.00216,172.31.36.0-255,66,128505,6,173263
22882,0.002181,74.125.68.0-255,2902,131407,6,173263
22883,0.002184,172.31.36.0-255,66,131473,6,173263
22884,0.002189,74.125.68.0-255,4320,135793,6,173263
22885,0.00219,172.31.36.0-255,66,135859,6,173263
22886,0.002196,74.125.68.0-255,5738,141597,6,173263
22887,0.002198,172.31.36.0-255,66,141663,6,173263
22888,0.002221,74.125.68.0-255,1484,143147,6,173263
22889,0.002242,74.125.68.0-255,9992,153139,6,173263
22890,0.002244,172.31.36.0-255,66,153205,6,173263
22891,0.002294,74.125.68.0-255,2184,155389,6,173263
22892,0.002296,172.31.36.0-255,66,155455,6,173263
22893,0.004504,74.125.68.0-255,2902,158357,6,173263
22894,0.00451,172.31.36.0-255,66,158423,6,173263
22895,0.004556,74.125.68.0-255,2902,161325,6,173263
22896,0.00456,172.31.36.0-255,66,161391,6,173263
22897,0.006778,74.125.68.0-255,2902,164293,6,173263
22898,0.006783,172.31.36.0-255,66,164359,6,173263
22899,0.006819,74.125.68.0-255,2902,167261,6,173263
22900,0.006824,172.31.36.0-255,66,167327,6,173263
22901,0.009062,74.125.68.0-255,2902,170229,6,173263
22902,0.009069,172.31.36.0-255,66,170295,6,173263
22903,0.009102,74.125.68.0-255,2902,173197,6,173263
22904,0.009106,172.31.36.0-255,66,173263,6,173263
22905,0.0,172.217.194.0-255,153,153,6,244217
22906,2.5e-05,172.31.36.0-255,66,219,6,244217
22907,3.3e-05,172.217.194.0-255,1484,1703,6,244217
22908,3.7e-05,172.31.36.0-255,66,1769,6,244217
22909,4.4e-05,172.217.194.0-255,2902,4671,6,244217
22910,4.8e-05,172.31.36.0-255,66,4737,6,244217
22911,5.5e-05,172.217.194.0-255,7156,11893,6,244217
22912,5.8e-05,172.31.36.0-255,66,11959,6,244217
22913,6.2e-05,172.217.194.0-255,2029,13988,6,244217
22914,6.4e-05,172.31.36.0-255,66,14054,6,244217
22915,9.4e-05,172.217.194.0-255,9992,24046,6,244217
22916,9.7e-05,172.31.36.0-255,66,24112,6,244217
22917,0.000133,172.217.194.0-255,4320,28432,6,244217
22918,0.000136,172.31.36.0-255,66,28498,6,244217
22919,0.000156,172.217.194.0-255,2543,31041,6,244217
22920,0.000159,172.31.36.0-255,66,31107,6,244217
22921,0.000216,172.217.194.0-255,1484,32591,6,244217
22922,0.000218,172.31.36.0-255,66,32657,6,244217
22923,0.000222,172.217.194.0-255,1484,34141,6,244217
22924,0.000224,172.31.36.0-255,66,34207,6,244217
22925,0.000235,172.217.194.0-255,1484,35691,6,244217
22926,0.000237,172.31.36.0-255,66,35757,6,244217
22927,0.000241,172.217.194.0-255,1484,37241,6,244217
22928,0.000243,172.31.36.0-255,66,37307,6,244217
22929,0.000259,172.217.194.0-255,4320,41627,6,244217
22930,0.000261,172.31.36.0-255,66,41693,6,244217
22931,0.000277,172.217.194.0-255,1484,43177,6,244217
22932,0.00028,172.31.36.0-255,66,43243,6,244217
22933,0.00032,172.31.36.0-255,66,43309,6,244217
22934,0.00034,172.217.194.0-255,5738,49047,6,244217
22935,0.000343,172.31.36.0-255,66,49113,6,244217
22936,0.000363,172.217.194.0-255,4218,53331,6,244217
22937,0.000366,172.217.194.0-255,113,53444,6,244217
22938,0.000369,172.217.194.0-255,383,53827,6,244217
22939,0.000525,172.31.36.0-255,66,53893,6,244217
22940,0.000587,172.217.194.0-255,1484,55377,6,244217
22941,0.000594,172.217.194.0-255,2902,58279,6,244217
22942,0.000609,172.217.194.0-255,1484,59763,6,244217
22943,0.000612,172.31.36.0-255,66,59829,6,244217
22944,0.000622,172.217.194.0-255,4320,64149,6,244217
22945,0.000632,172.31.36.0-255,66,64215,6,244217
22946,0.000648,172.217.194.0-255,1484,65699,6,244217
22947,0.000683,172.217.194.0-255,7156,72855,6,244217
22948,0.000695,172.31.36.0-255,66,72921,6,244217
22949,0.000705,172.217.194.0-255,3602,76523,6,244217
22950,0.00071,172.31.36.0-255,66,76589,6,244217
22951,0.000815,172.217.194.0-255,1484,78073,6,244217
22952,0.00082,172.217.194.0-255,2902,80975,6,244217
22953,0.000827,172.31.36.0-255,66,81041,6,244217
22954,0.000837,172.217.194.0-255,4320,85361,6,244217
22955,0.000855,172.217.194.0-255,1484,86845,6,244217
22956,0.000863,172.217.194.0-255,7156,94001,6,244217
22957,0.000906,172.31.36.0-255,66,94067,6,244217
22958,0.000927,172.217.194.0-255,8574,102641,6,244217
22959,0.000935,172.217.194.0-255,7856,110497,6,244217
22960,0.000952,172.31.36.0-255,66,110563,6,244217
22961,0.001205,172.217.194.0-255,1484,112047,6,244217
22962,0.001209,172.217.194.0-255,1484,113531,6,244217
22963,0.001214,172.31.36.0-255,66,113597,6,244217
22964,0.001226,172.217.194.0-255,1484,115081,6,244217
22965,0.001229,172.217.194.0-255,1484,116565,6,244217
22966,0.001243,172.217.194.0-255,4320,120885,6,244217
22967,0.001246,172.31.36.0-255,66,120951,6,244217
22968,0.00125,172.31.36.0-255,66,121017,6,244217
22969,0.001267,172.217.194.0-255,7156,128173,6,244217
22970,0.001282,172.217.194.0-255,4320,132493,6,244217
22971,0.001287,172.217.194.0-255,4320,136813,6,244217
22972,0.001292,172.31.36.0-255,66,136879,6,244217
22973,0.001315,172.217.194.0-255,7856,144735,6,244217
22974,0.001319,172.31.36.0-255,66,144801,6,244217
22975,0.001465,172.217.194.0-255,1484,146285,6,244217
22976,0.001488,172.217.194.0-255,2902,149187,6,244217
22977,0.001492,172.31.36.0-255,66,149253,6,244217
22978,0.001509,172.217.194.0-255,5738,154991,6,244217
22979,0.001515,172.217.194.0-255,5738,160729,6,244217
22980,0.00152,172.31.36.0-255,66,160795,6,244217
22981,0.001553,172.217.194.0-255,4320,165115,6,244217
22982,0.001564,172.31.36.0-255,66,165181,6,244217
22983,0.00158,172.217.194.0-255,766,165947,6,244217
22984,0.001589,172.31.36.0-255,66,166013,6,244217
22985,0.002413,172.217.194.0-255,1484,167497,6,244217
22986,0.002419,172.217.194.0-255,2902,170399,6,244217
22987,0.002423,172.31.36.0-255,66,170465,6,244217
22988,0.002429,172.217.194.0-255,4320,174785,6,244217
22989,0.002443,172.217.194.0-255,1484,176269,6,244217
22990,0.002446,172.31.36.0-255,66,176335,6,244217
22991,0.002468,172.217.194.0-255,5738,182073,6,244217
22992,0.002484,172.217.194.0-255,5738,187811,6,244217
22993,0.002492,172.217.194.0-255,7156,194967,6,244217
22994,0.002495,172.31.36.0-255,66,195033,6,244217
22995,0.0025,172.31.36.0-255,66,195099,6,244217
22996,0.002513,172.217.194.0-255,5020,200119,6,244217
22997,0.002546,172.217.194.0-255,1484,201603,6,244217
22998,0.002552,172.217.194.0-255,2902,204505,6,244217
22999,0.002556,172.31.36.0-255,66,204571,6,244217
23000,0.002576,172.217.194.0-255,5738,210309,6,244217
23001,0.002587,172.31.36.0-255,66,210375,6,244217
23002,0.002592,172.217.194.0-255,2902,213277,6,244217
23003,0.002596,172.31.36.0-255,66,213343,6,244217
23004,0.002617,172.217.194.0-255,9992,223335,6,244217
23005,0.002628,172.217.194.0-255,10692,234027,6,244217
23006,0.00265,172.217.194.0-255,2902,236929,6,244217
23007,0.002673,172.217.194.0-255,4320,241249,6,244217
23008,0.002717,172.217.194.0-255,2902,244151,6,244217
23009,0.007649,172.31.36.0-255,66,244217,6,244217
23010,0.0,172.31.36.0-255,105,105,6,459
23011,0.000193,172.31.36.0-255,90,195,6,459
23012,0.000203,172.31.36.0-255,66,261,6,459
23013,0.002492,74.125.24.0-255,66,327,6,459
23014,0.002517,74.125.24.0-255,66,393,6,459
23015,0.002531,172.31.36.0-255,66,459,6,459
23016,0.0,74.125.24.0-255,152,152,6,216084
23017,2.2e-05,172.31.36.0-255,66,218,6,216084
23018,3e-05,74.125.24.0-255,1484,1702,6,216084
23019,3.4e-05,172.31.36.0-255,66,1768,6,216084
23020,3.9e-05,74.125.24.0-255,2902,4670,6,216084
23021,4.2e-05,172.31.36.0-255,66,4736,6,216084
23022,4.9e-05,74.125.24.0-255,4320,9056,6,216084
23023,5.1e-05,172.31.36.0-255,66,9122,6,216084
23024,6.6e-05,172.31.36.0-255,66,9188,6,216084
23025,7.5e-05,74.125.24.0-255,9633,18821,6,216084
23026,7.8e-05,172.31.36.0-255,66,18887,6,216084
23027,0.000109,74.125.24.0-255,1484,20371,6,216084
23028,0.000112,172.31.36.0-255,66,20437,6,216084
23029,0.000118,74.125.24.0-255,2902,23339,6,216084
23030,0.00012,172.31.36.0-255,66,23405,6,216084
23031,0.000141,74.125.24.0-255,5738,29143,6,216084
23032,0.000144,172.31.36.0-255,66,29209,6,216084
23033,0.000151,74.125.24.0-255,7156,36365,6,216084
23034,0.000154,172.31.36.0-255,66,36431,6,216084
23035,0.000173,74.125.24.0-255,5738,42169,6,216084
23036,0.000175,172.31.36.0-255,66,42235,6,216084
23037,0.0002,74.125.24.0-255,7156,49391,6,216084
23038,0.000202,172.31.36.0-255,66,49457,6,216084
23039,0.000217,74.125.24.0-255,1484,50941,6,216084
23040,0.000219,172.31.36.0-255,66,51007,6,216084
23041,0.000233,74.125.24.0-255,2486,53493,6,216084
23042,0.000236,172.31.36.0-255,66,53559,6,216084
23043,0.000275,74.125.24.0-255,126,53685,6,216084
23044,0.000277,172.31.36.0-255,66,53751,6,216084
23045,0.000413,74.125.24.0-255,1484,55235,6,216084
23046,0.000417,172.31.36.0-255,66,55301,6,216084
23047,0.000423,74.125.24.0-255,2902,58203,6,216084
23048,0.000426,172.31.36.0-255,66,58269,6,216084
23049,0.00043,74.125.24.0-255,2902,61171,6,216084
23050,0.000432,172.31.36.0-255,66,61237,6,216084
23051,0.000461,74.125.24.0-255,2902,64139,6,216084
23052,0.000464,172.31.36.0-255,66,64205,6,216084
23053,0.000478,172.31.36.0-255,66,64271,6,216084
23054,0.000524,172.31.36.0-255,66,64337,6,216084
23055,0.000527,74.125.24.0-255,347,64684,6,216084
23056,0.000898,74.125.24.0-255,1484,66168,6,216084
23057,0.000904,172.31.36.0-255,66,66234,6,216084
23058,0.000909,74.125.24.0-255,2902,69136,6,216084
23059,0.000911,172.31.36.0-255,66,69202,6,216084
23060,0.000917,74.125.24.0-255,5738,74940,6,216084
23061,0.000919,172.31.36.0-255,66,75006,6,216084
23062,0.000953,172.31.36.0-255,66,75072,6,216084
23063,0.000961,74.125.24.0-255,7156,82228,6,216084
23064,0.000963,172.31.36.0-255,66,82294,6,216084
23065,0.000976,74.125.24.0-255,3602,85896,6,216084
23066,0.000979,172.31.36.0-255,66,85962,6,216084
23067,0.001257,74.125.24.0-255,1484,87446,6,216084
23068,0.001264,74.125.24.0-255,2902,90348,6,216084
23069,0.001267,172.31.36.0-255,66,90414,6,216084
23070,0.001271,74.125.24.0-255,1484,91898,6,216084
23071,0.001289,74.125.24.0-255,4320,96218,6,216084
23072,0.001291,172.31.36.0-255,66,96284,6,216084
23073,0.001302,74.125.24.0-255,9992,106276,6,216084
23074,0.001304,172.31.36.0-255,66,106342,6,216084
23075,0.001335,74.125.24.0-255,2902,109244,6,216084
23076,0.001338,172.31.36.0-255,66,109310,6,216084
23077,0.001348,74.125.24.0-255,10692,120002,6,216084
23078,0.00135,172.31.36.0-255,66,120068,6,216084
23079,0.001428,74.125.24.0-255,1484,121552,6,216084
23080,0.001433,74.125.24.0-255,2902,124454,6,216084
23081,0.001436,172.31.36.0-255,66,124520,6,216084
23082,0.00144,74.125.24.0-255,1484,126004,6,216084
23083,0.001459,74.125.24.0-255,4320,130324,6,216084
23084,0.001462,172.31.36.0-255,66,130390,6,216084
23085,0.001467,74.125.24.0-255,2902,133292,6,216084
23086,0.001469,172.31.36.0-255,66,133358,6,216084
23087,0.001487,74.125.24.0-255,5738,139096,6,216084
23088,0.00149,172.31.36.0-255,66,139162,6,216084
23089,0.001495,74.125.24.0-255,4320,143482,6,216084
23090,0.001498,172.31.36.0-255,66,143548,6,216084
23091,0.001534,172.31.36.0-255,66,143614,6,216084
23092,0.001543,74.125.24.0-255,8574,152188,6,216084
23093,0.001546,172.31.36.0-255,66,152254,6,216084
23094,0.00157,74.125.24.0-255,5738,157992,6,216084
23095,0.001572,172.31.36.0-255,66,158058,6,216084
23096,0.001599,172.31.36.0-255,66,158124,6,216084
23097,0.001611,74.125.24.0-255,1484,159608,6,216084
23098,0.001628,74.125.24.0-255,2902,162510,6,216084
23099,0.00163,172.31.36.0-255,66,162576,6,216084
23100,0.001637,74.125.24.0-255,5738,168314,6,216084
23101,0.001639,172.31.36.0-255,66,168380,6,216084
23102,0.001642,74.125.24.0-255,1484,169864,6,216084
23103,0.001677,74.125.24.0-255,7156,177020,6,216084
23104,0.001681,172.31.36.0-255,66,177086,6,216084
23105,0.001703,74.125.24.0-255,2902,179988,6,216084
23106,0.001718,172.31.36.0-255,66,180054,6,216084
23107,0.001722,172.31.36.0-255,66,180120,6,216084
23108,0.001744,74.125.24.0-255,1484,181604,6,216084
23109,0.001765,74.125.24.0-255,2902,184506,6,216084
23110,0.001782,74.125.24.0-255,4320,188826,6,216084
23111,0.001788,172.31.36.0-255,66,188892,6,216084
23112,0.001807,74.125.24.0-255,1484,190376,6,216084
23113,0.001828,74.125.24.0-255,10692,201068,6,216084
23114,0.001835,172.31.36.0-255,66,201134,6,216084
23115,0.001888,172.31.36.0-255,66,201200,6,216084
23116,0.001898,172.31.36.0-255,66,201266,6,216084
23117,0.001929,74.125.24.0-255,9992,211258,6,216084
23118,0.001982,172.31.36.0-255,66,211324,6,216084
23119,0.002044,74.125.24.0-255,4418,215742,6,216084
23120,0.00206,74.125.24.0-255,105,215847,6,216084
23121,0.002067,172.31.36.0-255,66,215913,6,216084
23122,0.004228,172.31.36.0-255,105,216018,6,216084
23123,0.006521,74.125.24.0-255,66,216084,6,216084
23124,0.0,74.125.200.0-255,298,298,6,178460
23125,2.6e-05,172.31.36.0-255,66,364,6,178460
23126,3.3e-05,74.125.200.0-255,1484,1848,6,178460
23127,3.7e-05,172.31.36.0-255,66,1914,6,178460
23128,5.4e-05,74.125.200.0-255,4320,6234,6,178460
23129,5.8e-05,172.31.36.0-255,66,6300,6,178460
23130,6.6e-05,74.125.200.0-255,7156,13456,6,178460
23131,6.8e-05,172.31.36.0-255,66,13522,6,178460
23132,0.000103,74.125.200.0-255,431,13953,6,178460
23133,0.000106,172.31.36.0-255,66,14019,6,178460
23134,0.000365,74.125.200.0-255,1484,15503,6,178460
23135,0.00037,172.31.36.0-255,66,15569,6,178460
23136,0.000376,74.125.200.0-255,2902,18471,6,178460
23137,0.000378,172.31.36.0-255,66,18537,6,178460
23138,0.000382,74.125.200.0-255,1484,20021,6,178460
23139,0.000388,172.31.36.0-255,66,20087,6,178460
23140,0.00042,74.125.200.0-255,4320,24407,6,178460
23141,0.000423,172.31.36.0-255,66,24473,6,178460
23142,0.000428,74.125.200.0-255,2902,27375,6,178460
23143,0.00043,172.31.36.0-255,66,27441,6,178460
23144,0.000436,74.125.200.0-255,3961,31402,6,178460
23145,0.000438,172.31.36.0-255,66,31468,6,178460
23146,0.000465,74.125.200.0-255,1484,32952,6,178460
23147,0.000468,172.31.36.0-255,66,33018,6,178460
23148,0.000471,74.125.200.0-255,1484,34502,6,178460
23149,0.000474,172.31.36.0-255,66,34568,6,178460
23150,0.000494,74.125.200.0-255,1484,36052,6,178460
23151,0.000496,172.31.36.0-255,66,36118,6,178460
23152,0.000502,74.125.200.0-255,4320,40438,6,178460
23153,0.000505,172.31.36.0-255,66,40504,6,178460
23154,0.000535,74.125.200.0-255,1484,41988,6,178460
23155,0.000537,172.31.36.0-255,66,42054,6,178460
23156,0.000544,74.125.200.0-255,4320,46374,6,178460
23157,0.000571,172.31.36.0-255,66,46440,6,178460
23158,0.000576,74.125.200.0-255,2543,48983,6,178460
23159,0.000583,172.31.36.0-255,66,49049,6,178460
23160,0.000975,74.125.200.0-255,1484,50533,6,178460
23161,0.00098,74.125.200.0-255,1484,52017,6,178460
23162,0.000983,172.31.36.0-255,66,52083,6,178460
23163,0.000997,74.125.200.0-255,1484,53567,6,178460
23164,0.001007,74.125.200.0-255,5738,59305,6,178460
23165,0.001011,74.125.200.0-255,2902,62207,6,178460
23166,0.001029,74.125.200.0-255,2902,65109,6,178460
23167,0.001052,74.125.200.0-255,1125,66234,6,178460
23168,0.001058,172.31.36.0-255,66,66300,6,178460
23169,0.001329,74.125.200.0-255,1484,67784,6,178460
23170,0.001339,74.125.200.0-255,2902,70686,6,178460
23171,0.001344,172.31.36.0-255,66,70752,6,178460
23172,0.001349,74.125.200.0-255,1484,72236,6,178460
23173,0.001373,74.125.200.0-255,4320,76556,6,178460
23174,0.001377,74.125.200.0-255,2902,79458,6,178460
23175,0.001392,74.125.200.0-255,1484,80942,6,178460
23176,0.001414,74.125.200.0-255,8574,89516,6,178460
23177,0.001432,74.125.200.0-255,2902,92418,6,178460
23178,0.001444,74.125.200.0-255,2902,95320,6,178460
23179,0.001466,74.125.200.0-255,5020,100340,6,178460
23180,0.001469,74.125.200.0-255,1484,101824,6,178460
23181,0.001472,74.125.200.0-255,1484,103308,6,178460
23182,0.001488,74.125.200.0-255,1484,104792,6,178460
23183,0.001492,74.125.200.0-255,2902,107694,6,178460
23184,0.001508,74.125.200.0-255,2902,110596,6,178460
23185,0.001524,74.125.200.0-255,2902,113498,6,178460
23186,0.001542,74.125.200.0-255,3843,117341,6,178460
23187,0.001544,74.125.200.0-255,763,118104,6,178460
23188,0.001698,74.125.200.0-255,1484,119588,6,178460
23189,0.001704,74.125.200.0-255,1484,121072,6,178460
23190,0.001714,74.125.200.0-255,1484,122556,6,178460
23191,0.001738,74.125.200.0-255,1484,124040,6,178460
23192,0.001757,74.125.200.0-255,2902,126942,6,178460
23193,0.001784,74.125.200.0-255,4320,131262,6,178460
23194,0.001799,74.125.200.0-255,4320,135582,6,178460
23195,0.001821,74.125.200.0-255,8574,144156,6,178460
23196,0.001839,74.125.200.0-255,1484,145640,6,178460
23197,0.001862,74.125.200.0-255,4320,149960,6,178460
23198,0.001884,74.125.200.0-255,2184,152144,6,178460
23199,0.002234,74.125.200.0-255,1484,153628,6,178460
23200,0.002241,74.125.200.0-255,1484,155112,6,178460
23201,0.002255,74.125.200.0-255,1484,156596,6,178460
23202,0.002277,74.125.200.0-255,1484,158080,6,178460
23203,0.002307,74.125.200.0-255,4320,162400,6,178460
23204,0.002329,74.125.200.0-255,1484,163884,6,178460
23205,0.002379,74.125.200.0-255,4320,168204,6,178460
23206,0.002392,74.125.200.0-255,1484,169688,6,178460
23207,0.002397,74.125.200.0-255,2902,172590,6,178460
23208,0.007362,172.31.36.0-255,66,172656,6,178460
23209,0.009672,74.125.200.0-255,5738,178394,6,178460
23210,0.009682,172.31.36.0-255,66,178460,6,178460
23211,0.0,74.125.200.0-255,153,153,6,297351
23212,2.8e-05,172.31.36.0-255,66,219,6,297351
23213,3.5e-05,74.125.200.0-255,1484,1703,6,297351
23214,4e-05,172.31.36.0-255,66,1769,6,297351
23215,4.4e-05,74.125.200.0-255,1484,3253,6,297351
23216,4.7e-05,172.31.36.0-255,66,3319,6,297351
23217,6.3e-05,74.125.200.0-255,2902,6221,6,297351
23218,6.6e-05,172.31.36.0-255,66,6287,6,297351
23219,7.4e-05,74.125.200.0-255,5738,12025,6,297351
23220,7.7e-05,172.31.36.0-255,66,12091,6,297351
23221,8.2e-05,74.125.200.0-255,2013,14104,6,297351
23222,8.4e-05,172.31.36.0-255,66,14170,6,297351
23223,9e-05,74.125.200.0-255,2902,17072,6,297351
23224,9.2e-05,172.31.36.0-255,66,17138,6,297351
23225,0.000127,74.125.200.0-255,7156,24294,6,297351
23226,0.000131,172.31.36.0-255,66,24360,6,297351
23227,0.000135,74.125.200.0-255,1484,25844,6,297351
23228,0.000137,172.31.36.0-255,66,25910,6,297351
23229,0.00017,74.125.200.0-255,4320,30230,6,297351
23230,0.000173,172.31.36.0-255,66,30296,6,297351
23231,0.000181,74.125.200.0-255,7156,37452,6,297351
23232,0.000184,172.31.36.0-255,66,37518,6,297351
23233,0.000187,74.125.200.0-255,1484,39002,6,297351
23234,0.000189,172.31.36.0-255,66,39068,6,297351
23235,0.000229,74.125.200.0-255,9274,48342,6,297351
23236,0.000232,172.31.36.0-255,66,48408,6,297351
23237,0.000538,74.125.200.0-255,1484,49892,6,297351
23238,0.000544,172.31.36.0-255,66,49958,6,297351
23239,0.000551,74.125.200.0-255,2902,52860,6,297351
23240,0.000553,172.31.36.0-255,66,52926,6,297351
23241,0.000582,74.125.200.0-255,5738,58664,6,297351
23242,0.000585,172.31.36.0-255,66,58730,6,297351
23243,0.000589,74.125.200.0-255,1484,60214,6,297351
23244,0.000624,74.125.200.0-255,5647,65861,6,297351
23245,0.000627,172.31.36.0-255,66,65927,6,297351
23246,0.000631,74.125.200.0-255,134,66061,6,297351
23247,0.000896,74.125.200.0-255,1484,67545,6,297351
23248,0.0009,172.31.36.0-255,66,67611,6,297351
23249,0.000905,74.125.200.0-255,1484,69095,6,297351
23250,0.00093,74.125.200.0-255,1484,70579,6,297351
23251,0.000933,172.31.36.0-255,66,70645,6,297351
23252,0.00094,74.125.200.0-255,5738,76383,6,297351
23253,0.000942,172.31.36.0-255,66,76449,6,297351
23254,0.000947,74.125.200.0-255,4320,80769,6,297351
23255,0.000949,172.31.36.0-255,66,80835,6,297351
23256,0.000973,74.125.200.0-255,1484,82319,6,297351
23257,0.001007,74.125.200.0-255,4320,86639,6,297351
23258,0.001009,172.31.36.0-255,66,86705,6,297351
23259,0.001023,172.31.36.0-255,66,86771,6,297351
23260,0.001027,74.125.200.0-255,2184,88955,6,297351
23261,0.001028,172.31.36.0-255,66,89021,6,297351
23262,0.001152,74.125.200.0-255,1484,90505,6,297351
23263,0.001171,74.125.200.0-255,2902,93407,6,297351
23264,0.001175,172.31.36.0-255,66,93473,6,297351
23265,0.001179,74.125.200.0-255,1484,94957,6,297351
23266,0.001209,74.125.200.0-255,4320,99277,6,297351
23267,0.001211,172.31.36.0-255,66,99343,6,297351
23268,0.001219,74.125.200.0-255,7156,106499,6,297351
23269,0.001221,172.31.36.0-255,66,106565,6,297351
23270,0.001255,74.125.200.0-255,5738,112303,6,297351
23271,0.001258,172.31.36.0-255,66,112369,6,297351
23272,0.001286,74.125.200.0-255,2902,115271,6,297351
23273,0.001289,172.31.36.0-255,66,115337,6,297351
23274,0.001299,74.125.200.0-255,9274,124611,6,297351
23275,0.001301,172.31.36.0-255,66,124677,6,297351
23276,0.001311,74.125.200.0-255,4320,128997,6,297351
23277,0.001314,172.31.36.0-255,66,129063,6,297351
23278,0.001362,172.31.36.0-255,66,129129,6,297351
23279,0.00137,74.125.200.0-255,7156,136285,6,297351
23280,0.001373,172.31.36.0-255,66,136351,6,297351
23281,0.001401,74.125.200.0-255,1484,137835,6,297351
23282,0.001407,74.125.200.0-255,3602,141437,6,297351
23283,0.001409,172.31.36.0-255,66,141503,6,297351
23284,0.001433,74.125.200.0-255,4320,145823,6,297351
23285,0.001436,172.31.36.0-255,66,145889,6,297351
23286,0.001441,74.125.200.0-255,2902,148791,6,297351
23287,0.001443,172.31.36.0-255,66,148857,6,297351
23288,0.001461,74.125.200.0-255,2902,151759,6,297351
23289,0.001464,172.31.36.0-255,66,151825,6,297351
23290,0.001475,74.125.200.0-255,7156,158981,6,297351
23291,0.001478,172.31.36.0-255,66,159047,6,297351
23292,0.001508,74.125.200.0-255,4320,163367,6,297351
23293,0.001511,172.31.36.0-255,66,163433,6,297351
23294,0.00154,74.125.200.0-255,5738,169171,6,297351
23295,0.001544,74.125.200.0-255,2902,172073,6,297351
23296,0.001549,172.31.36.0-255,66,172139,6,297351
23297,0.001552,172.31.36.0-255,66,172205,6,297351
23298,0.001566,74.125.200.0-255,3602,175807,6,297351
23299,0.001569,172.31.36.0-255,66,175873,6,297351
23300,0.001607,74.125.200.0-255,7156,183029,6,297351
23301,0.00161,172.31.36.0-255,66,183095,6,297351
23302,0.001639,74.125.200.0-255,7156,190251,6,297351
23303,0.001656,74.125.200.0-255,1484,191735,6,297351
23304,0.001663,74.125.200.0-255,5738,197473,6,297351
23305,0.001666,74.125.200.0-255,1484,198957,6,297351
23306,0.001679,172.31.36.0-255,66,199023,6,297351
23307,0.001686,74.125.200.0-255,5738,204761,6,297351
23308,0.001692,172.31.36.0-255,66,204827,6,297351
23309,0.00171,74.125.200.0-255,5020,209847,6,297351
23310,0.001736,74.125.200.0-255,4320,214167,6,297351
23311,0.001751,74.125.200.0-255,1484,215651,6,297351
23312,0.001754,74.125.200.0-255,2902,218553,6,297351
23313,0.001756,74.125.200.0-255,1484,220037,6,297351
23314,0.00176,172.31.36.0-255,66,220103,6,297351
23315,0.001776,74.125.200.0-255,2902,223005,6,297351
23316,0.001781,172.31.36.0-255,66,223071,6,297351
23317,0.001814,74.125.200.0-255,8574,231645,6,297351
23318,0.001818,74.125.200.0-255,2902,234547,6,297351
23319,0.001835,74.125.200.0-255,4320,238867,6,297351
23320,0.001888,74.125.200.0-255,5020,243887,6,297351
23321,0.00189,172.31.36.0-255,66,243953,6,297351
23322,0.001896,172.31.36.0-255,66,244019,6,297351
23323,0.002436,74.125.200.0-255,1484,245503,6,297351
23324,0.002461,74.125.200.0-255,2902,248405,6,297351
23325,0.002466,172.31.36.0-255,66,248471,6,297351
23326,0.002471,74.125.200.0-255,2902,251373,6,297351
23327,0.002473,172.31.36.0-255,66,251439,6,297351
23328,0.002478,74.125.200.0-255,2902,254341,6,297351
23329,0.00248,172.31.36.0-255,66,254407,6,297351
23330,0.002512,74.125.200.0-255,1484,255891,6,297351
23331,0.002522,74.125.200.0-255,8574,264465,6,297351
23332,0.002524,172.31.36.0-255,66,264531,6,297351
23333,0.002531,74.125.200.0-255,7156,271687,6,297351
23334,0.002552,172.31.36.0-255,66,271753,6,297351
23335,0.002572,74.125.200.0-255,4320,276073,6,297351
23336,0.002587,74.125.200.0-255,2184,278257,6,297351
23337,0.00261,74.125.200.0-255,4320,282577,6,297351
23338,0.002621,172.31.36.0-255,66,282643,6,297351
23339,0.002626,74.125.200.0-255,2902,285545,6,297351
23340,0.002629,74.125.200.0-255,1484,287029,6,297351
23341,0.002641,172.31.36.0-255,66,287095,6,297351
23342,0.005229,74.125.200.0-255,4320,291415,6,297351
23343,0.00524,172.31.36.0-255,66,291481,6,297351
23344,0.005271,74.125.200.0-255,1484,292965,6,297351
23345,0.007845,74.125.200.0-255,4320,297285,6,297351
23346,0.00785,172.31.36.0-255,66,297351,6,297351
23347,0.0,74.125.24.0-255,153,153,6,196756
23348,2.3e-05,172.31.36.0-255,66,219,6,196756
23349,3.1e-05,74.125.24.0-255,1484,1703,6,196756
23350,3.5e-05,172.31.36.0-255,66,1769,6,196756
23351,4.1e-05,74.125.24.0-255,2902,4671,6,196756
23352,4.5e-05,172.31.36.0-255,66,4737,6,196756
23353,5.3e-05,74.125.24.0-255,7156,11893,6,196756
23354,5.6e-05,172.31.36.0-255,66,11959,6,196756
23355,8.2e-05,74.125.24.0-255,1977,13936,6,196756
23356,8.4e-05,172.31.36.0-255,66,14002,6,196756
23357,0.000208,74.125.24.0-255,1484,15486,6,196756
23358,0.000212,172.31.36.0-255,66,15552,6,196756
23359,0.000218,74.125.24.0-255,2902,18454,6,196756
23360,0.00022,172.31.36.0-255,66,18520,6,196756
23361,0.000226,74.125.24.0-255,4320,22840,6,196756
23362,0.000229,172.31.36.0-255,66,22906,6,196756
23363,0.000246,74.125.24.0-255,1484,24390,6,196756
23364,0.000248,172.31.36.0-255,66,24456,6,196756
23365,0.000267,74.125.24.0-255,5738,30194,6,196756
23366,0.00027,172.31.36.0-255,66,30260,6,196756
23367,0.000289,74.125.24.0-255,8215,38475,6,196756
23368,0.000292,172.31.36.0-255,66,38541,6,196756
23369,0.000373,74.125.24.0-255,2902,41443,6,196756
23370,0.000376,172.31.36.0-255,66,41509,6,196756
23371,0.000401,172.31.36.0-255,66,41575,6,196756
23372,0.000474,74.125.24.0-255,5738,47313,6,196756
23373,0.000478,172.31.36.0-255,66,47379,6,196756
23374,0.000502,74.125.24.0-255,6438,53817,6,196756
23375,0.000505,172.31.36.0-255,66,53883,6,196756
23376,0.000546,74.125.24.0-255,396,54279,6,196756
23377,0.000549,172.31.36.0-255,66,54345,6,196756
23378,0.000553,74.125.24.0-255,381,54726,6,196756
23379,0.000848,74.125.24.0-255,1484,56210,6,196756
23380,0.000854,74.125.24.0-255,2902,59112,6,196756
23381,0.000902,172.31.36.0-255,66,59178,6,196756
23382,0.000909,74.125.24.0-255,5738,64916,6,196756
23383,0.000914,74.125.24.0-255,4320,69236,6,196756
23384,0.00092,172.31.36.0-255,66,69302,6,196756
23385,0.000929,74.125.24.0-255,2902,72204,6,196756
23386,0.000958,74.125.24.0-255,4320,76524,6,196756
23387,0.000964,172.31.36.0-255,66,76590,6,196756
23388,0.000989,74.125.24.0-255,9992,86582,6,196756
23389,0.001004,172.31.36.0-255,66,86648,6,196756
23390,0.00106,74.125.24.0-255,2184,88832,6,196756
23391,0.001064,172.31.36.0-255,66,88898,6,196756
23392,0.001248,74.125.24.0-255,1484,90382,6,196756
23393,0.001255,74.125.24.0-255,2902,93284,6,196756
23394,0.001258,172.31.36.0-255,66,93350,6,196756
23395,0.00128,74.125.24.0-255,5738,99088,6,196756
23396,0.001291,172.31.36.0-255,66,99154,6,196756
23397,0.001311,74.125.24.0-255,4320,103474,6,196756
23398,0.001324,74.125.24.0-255,1484,104958,6,196756
23399,0.001328,172.31.36.0-255,66,105024,6,196756
23400,0.001348,74.125.24.0-255,2902,107926,6,196756
23401,0.001356,172.31.36.0-255,66,107992,6,196756
23402,0.001377,74.125.24.0-255,9992,117984,6,196756
23403,0.001393,172.31.36.0-255,66,118050,6,196756
23404,0.001452,74.125.24.0-255,5020,123070,6,196756
23405,0.001459,172.31.36.0-255,66,123136,6,196756
23406,0.002161,74.125.24.0-255,1484,124620,6,196756
23407,0.002167,172.31.36.0-255,66,124686,6,196756
23408,0.002176,74.125.24.0-255,2902,127588,6,196756
23409,0.00218,74.125.24.0-255,1484,129072,6,196756
23410,0.002195,74.125.24.0-255,4320,133392,6,196756
23411,0.002225,74.125.24.0-255,5738,139130,6,196756
23412,0.00225,74.125.24.0-255,4320,143450,6,196756
23413,0.002299,74.125.24.0-255,7156,150606,6,196756
23414,0.002321,74.125.24.0-255,6438,157044,6,196756
23415,0.002396,74.125.24.0-255,1484,158528,6,196756
23416,0.002411,74.125.24.0-255,2902,161430,6,196756
23417,0.002439,74.125.24.0-255,4320,165750,6,196756
23418,0.002452,74.125.24.0-255,1484,167234,6,196756
23419,0.002469,74.125.24.0-255,4320,171554,6,196756
23420,0.002493,74.125.24.0-255,8574,180128,6,196756
23421,0.002579,74.125.24.0-255,7156,187284,6,196756
23422,0.002597,74.125.24.0-255,3602,190886,6,196756
23423,0.006143,172.31.36.0-255,66,190952,6,196756
23424,0.0087,74.125.24.0-255,5738,196690,6,196756
23425,0.008709,172.31.36.0-255,66,196756,6,196756
23426,0.0,104.244.42.0-255,66,66,6,66
23427,0.0,172.217.194.0-255,153,153,6,237162
23428,2.2e-05,172.31.36.0-255,66,219,6,237162
23429,3e-05,172.217.194.0-255,1484,1703,6,237162
23430,3.5e-05,172.31.36.0-255,66,1769,6,237162
23431,5e-05,172.217.194.0-255,2902,4671,6,237162
23432,5.4e-05,172.31.36.0-255,66,4737,6,237162
23433,6.2e-05,172.217.194.0-255,7156,11893,6,237162
23434,6.5e-05,172.31.36.0-255,66,11959,6,237162
23435,7e-05,172.217.194.0-255,2103,14062,6,237162
23436,7.2e-05,172.31.36.0-255,66,14128,6,237162
23437,0.000104,172.217.194.0-255,1484,15612,6,237162
23438,0.000106,172.31.36.0-255,66,15678,6,237162
23439,0.000119,172.217.194.0-255,1484,17162,6,237162
23440,0.000126,172.31.36.0-255,66,17228,6,237162
23441,0.000132,172.217.194.0-255,4320,21548,6,237162
23442,0.000135,172.31.36.0-255,66,21614,6,237162
23443,0.000144,172.217.194.0-255,8574,30188,6,237162
23444,0.000146,172.31.36.0-255,66,30254,6,237162
23445,0.000149,172.217.194.0-255,1125,31379,6,237162
23446,0.000151,172.31.36.0-255,66,31445,6,237162
23447,0.000217,172.217.194.0-255,1484,32929,6,237162
23448,0.00022,172.31.36.0-255,66,32995,6,237162
23449,0.000225,172.217.194.0-255,2902,35897,6,237162
23450,0.000227,172.31.36.0-255,66,35963,6,237162
23451,0.00027,172.217.194.0-255,5738,41701,6,237162
23452,0.000273,172.31.36.0-255,66,41767,6,237162
23453,0.000282,172.217.194.0-255,8215,49982,6,237162
23454,0.000285,172.31.36.0-255,66,50048,6,237162
23455,0.000298,172.217.194.0-255,8574,58622,6,237162
23456,0.000301,172.31.36.0-255,66,58688,6,237162
23457,0.000337,172.217.194.0-255,6797,65485,6,237162
23458,0.000339,172.31.36.0-255,66,65551,6,237162
23459,0.000359,172.217.194.0-255,359,65910,6,237162
23460,0.000431,172.217.194.0-255,384,66294,6,237162
23461,0.000848,172.217.194.0-255,1484,67778,6,237162
23462,0.000862,172.31.36.0-255,66,67844,6,237162
23463,0.000869,172.217.194.0-255,2902,70746,6,237162
23464,0.000872,172.31.36.0-255,66,70812,6,237162
23465,0.00088,172.217.194.0-255,1484,72296,6,237162
23466,0.000887,172.217.194.0-255,5738,78034,6,237162
23467,0.000889,172.31.36.0-255,66,78100,6,237162
23468,0.000935,172.31.36.0-255,66,78166,6,237162
23469,0.000945,172.217.194.0-255,9274,87440,6,237162
23470,0.000947,172.31.36.0-255,66,87506,6,237162
23471,0.001345,172.217.194.0-255,1484,88990,6,237162
23472,0.001359,172.217.194.0-255,2902,91892,6,237162
23473,0.001363,172.31.36.0-255,66,91958,6,237162
23474,0.001394,172.217.194.0-255,5738,97696,6,237162
23475,0.001403,172.217.194.0-255,8574,106270,6,237162
23476,0.001409,172.31.36.0-255,66,106336,6,237162
23477,0.001417,172.31.36.0-255,66,106402,6,237162
23478,0.001424,172.217.194.0-255,1484,107886,6,237162
23479,0.001469,172.31.36.0-255,66,107952,6,237162
23480,0.001473,172.217.194.0-255,2184,110136,6,237162
23481,0.001475,172.31.36.0-255,66,110202,6,237162
23482,0.001524,172.217.194.0-255,1484,111686,6,237162
23483,0.001528,172.217.194.0-255,2902,114588,6,237162
23484,0.001531,172.31.36.0-255,66,114654,6,237162
23485,0.001558,172.217.194.0-255,5738,120392,6,237162
23486,0.001561,172.31.36.0-255,66,120458,6,237162
23487,0.001603,172.217.194.0-255,5738,126196,6,237162
23488,0.001606,172.31.36.0-255,66,126262,6,237162
23489,0.001636,172.217.194.0-255,4320,130582,6,237162
23490,0.001639,172.31.36.0-255,66,130648,6,237162
23491,0.001656,172.31.36.0-255,66,130714,6,237162
23492,0.00166,172.217.194.0-255,2184,132898,6,237162
23493,0.001663,172.31.36.0-255,66,132964,6,237162
23494,0.001695,172.217.194.0-255,2902,135866,6,237162
23495,0.001698,172.31.36.0-255,66,135932,6,237162
23496,0.001706,172.217.194.0-255,7156,143088,6,237162
23497,0.001709,172.31.36.0-255,66,143154,6,237162
23498,0.001724,172.217.194.0-255,7156,150310,6,237162
23499,0.001727,172.31.36.0-255,66,150376,6,237162
23500,0.001757,172.217.194.0-255,4320,154696,6,237162
23501,0.00176,172.31.36.0-255,66,154762,6,237162
23502,0.00177,172.217.194.0-255,9992,164754,6,237162
23503,0.001772,172.31.36.0-255,66,164820,6,237162
23504,0.001794,172.217.194.0-255,2184,167004,6,237162
23505,0.001796,172.31.36.0-255,66,167070,6,237162
23506,0.001995,172.217.194.0-255,1484,168554,6,237162
23507,0.002002,172.217.194.0-255,2902,171456,6,237162
23508,0.002005,172.31.36.0-255,66,171522,6,237162
23509,0.002009,172.217.194.0-255,1484,173006,6,237162
23510,0.002034,172.217.194.0-255,4320,177326,6,237162
23511,0.002037,172.31.36.0-255,66,177392,6,237162
23512,0.002044,172.217.194.0-255,5738,183130,6,237162
23513,0.002047,172.31.36.0-255,66,183196,6,237162
23514,0.002076,172.217.194.0-255,7156,190352,6,237162
23515,0.002079,172.31.36.0-255,66,190418,6,237162
23516,0.002084,172.217.194.0-255,2902,193320,6,237162
23517,0.002085,172.31.36.0-255,66,193386,6,237162
23518,0.002106,172.217.194.0-255,2902,196288,6,237162
23519,0.002109,172.31.36.0-255,66,196354,6,237162
23520,0.002136,172.217.194.0-255,5020,201374,6,237162
23521,0.00214,172.31.36.0-255,66,201440,6,237162
23522,0.002148,172.217.194.0-255,7156,208596,6,237162
23523,0.00215,172.31.36.0-255,66,208662,6,237162
23524,0.002175,172.217.194.0-255,1484,210146,6,237162
23525,0.002181,172.217.194.0-255,4320,214466,6,237162
23526,0.002183,172.31.36.0-255,66,214532,6,237162
23527,0.002205,172.31.36.0-255,66,214598,6,237162
23528,0.002212,172.217.194.0-255,6438,221036,6,237162
23529,0.002248,172.31.36.0-255,66,221102,6,237162
23530,0.004572,172.217.194.0-255,4320,225422,6,237162
23531,0.004579,172.31.36.0-255,66,225488,6,237162
23532,0.004607,172.217.194.0-255,1484,226972,6,237162
23533,0.006915,172.217.194.0-255,4320,231292,6,237162
23534,0.006919,172.31.36.0-255,66,231358,6,237162
23535,0.00923,172.217.194.0-255,5738,237096,6,237162
23536,0.009238,172.31.36.0-255,66,237162,6,237162
23537,0.0,74.125.24.0-255,143,143,6,124646
23538,3.4e-05,172.31.36.0-255,66,209,6,124646
23539,4.1e-05,74.125.24.0-255,1484,1693,6,124646
23540,4.5e-05,172.31.36.0-255,66,1759,6,124646
23541,5.8e-05,74.125.24.0-255,2902,4661,6,124646
23542,6.1e-05,172.31.36.0-255,66,4727,6,124646
23543,6.7e-05,74.125.24.0-255,5738,10465,6,124646
23544,7e-05,172.31.36.0-255,66,10531,6,124646
23545,7.2e-05,74.125.24.0-255,1484,12015,6,124646
23546,7.5e-05,172.31.36.0-255,66,12081,6,124646
23547,0.000106,74.125.24.0-255,1979,14060,6,124646
23548,0.000109,172.31.36.0-255,66,14126,6,124646
23549,0.000114,74.125.24.0-255,4320,18446,6,124646
23550,0.000117,172.31.36.0-255,66,18512,6,124646
23551,0.000125,74.125.24.0-255,9992,28504,6,124646
23552,0.000128,172.31.36.0-255,66,28570,6,124646
23553,0.000133,74.125.24.0-255,2543,31113,6,124646
23554,0.000135,172.31.36.0-255,66,31179,6,124646
23555,0.000178,74.125.24.0-255,2902,34081,6,124646
23556,0.000182,172.31.36.0-255,66,34147,6,124646
23557,0.000187,74.125.24.0-255,2902,37049,6,124646
23558,0.000189,172.31.36.0-255,66,37115,6,124646
23559,0.000237,74.125.24.0-255,7156,44271,6,124646
23560,0.000241,172.31.36.0-255,66,44337,6,124646
23561,0.000246,74.125.24.0-255,3961,48298,6,124646
23562,0.000248,172.31.36.0-255,66,48364,6,124646
23563,0.000291,74.125.24.0-255,4320,52684,6,124646
23564,0.000295,172.31.36.0-255,66,52750,6,124646
23565,0.000303,74.125.24.0-255,5738,58488,6,124646
23566,0.000306,172.31.36.0-255,66,58554,6,124646
23567,0.000349,74.125.24.0-255,4320,62874,6,124646
23568,0.000353,172.31.36.0-255,66,62940,6,124646
23569,0.000372,74.125.24.0-255,2890,65830,6,124646
23570,0.000375,172.31.36.0-255,66,65896,6,124646
23571,0.000485,74.125.24.0-255,332,66228,6,124646
23572,0.000816,172.31.36.0-255,66,66294,6,124646
23573,0.000843,74.125.24.0-255,1484,67778,6,124646
23574,0.00085,74.125.24.0-255,2902,70680,6,124646
23575,0.000853,172.31.36.0-255,66,70746,6,124646
23576,0.000861,74.125.24.0-255,5738,76484,6,124646
23577,0.000863,172.31.36.0-255,66,76550,6,124646
23578,0.0009,172.31.36.0-255,66,76616,6,124646
23579,0.000908,74.125.24.0-255,8574,85190,6,124646
23580,0.00091,172.31.36.0-255,66,85256,6,124646
23581,0.000942,74.125.24.0-255,2184,87440,6,124646
23582,0.000946,172.31.36.0-255,66,87506,6,124646
23583,0.001803,74.125.24.0-255,1484,88990,6,124646
23584,0.001814,74.125.24.0-255,2902,91892,6,124646
23585,0.001818,172.31.36.0-255,66,91958,6,124646
23586,0.001826,74.125.24.0-255,5738,97696,6,124646
23587,0.001827,172.31.36.0-255,66,97762,6,124646
23588,0.001868,172.31.36.0-255,66,97828,6,124646
23589,0.001878,74.125.24.0-255,10692,108520,6,124646
23590,0.00188,172.31.36.0-255,66,108586,6,124646
23591,0.004103,74.125.24.0-255,4320,112906,6,124646
23592,0.004107,172.31.36.0-255,66,112972,6,124646
23593,0.00413,74.125.24.0-255,1484,114456,6,124646
23594,0.006343,74.125.24.0-255,4320,118776,6,124646
23595,0.006349,172.31.36.0-255,66,118842,6,124646
23596,0.008595,74.125.24.0-255,5738,124580,6,124646
23597,0.008601,172.31.36.0-255,66,124646,6,124646
23598,0.0,74.125.130.0-255,153,153,6,222121
23599,1.9e-05,172.31.36.0-255,66,219,6,222121
23600,2.6e-05,74.125.130.0-255,1484,1703,6,222121
23601,3e-05,172.31.36.0-255,66,1769,6,222121
23602,3.4e-05,74.125.130.0-255,2902,4671,6,222121
23603,3.7e-05,172.31.36.0-255,66,4737,6,222121
23604,4.3e-05,74.125.130.0-255,4320,9057,6,222121
23605,4.6e-05,172.31.36.0-255,66,9123,6,222121
23606,6.2e-05,74.125.130.0-255,2902,12025,6,222121
23607,6.4e-05,172.31.36.0-255,66,12091,6,222121
23608,6.8e-05,74.125.130.0-255,2017,14108,6,222121
23609,7.1e-05,172.31.36.0-255,66,14174,6,222121
23610,0.000127,74.125.130.0-255,1484,15658,6,222121
23611,0.000131,172.31.36.0-255,66,15724,6,222121
23612,0.000152,74.125.130.0-255,2902,18626,6,222121
23613,0.000155,172.31.36.0-255,66,18692,6,222121
23614,0.000158,74.125.130.0-255,1484,20176,6,222121
23615,0.00016,172.31.36.0-255,66,20242,6,222121
23616,0.000178,74.125.130.0-255,2902,23144,6,222121
23617,0.000181,172.31.36.0-255,66,23210,6,222121
23618,0.00022,74.125.130.0-255,8215,31425,6,222121
23619,0.000224,172.31.36.0-255,66,31491,6,222121
23620,0.000343,74.125.130.0-255,1484,32975,6,222121
23621,0.000348,172.31.36.0-255,66,33041,6,222121
23622,0.000352,74.125.130.0-255,1484,34525,6,222121
23623,0.000356,172.31.36.0-255,66,34591,6,222121
23624,0.00037,74.125.130.0-255,2902,37493,6,222121
23625,0.000373,172.31.36.0-255,66,37559,6,222121
23626,0.00039,74.125.130.0-255,2902,40461,6,222121
23627,0.000393,172.31.36.0-255,66,40527,6,222121
23628,0.000408,74.125.130.0-255,2902,43429,6,222121
23629,0.000411,172.31.36.0-255,66,43495,6,222121
23630,0.000414,74.125.130.0-255,1484,44979,6,222121
23631,0.00042,74.125.130.0-255,2902,47881,6,222121
23632,0.000422,172.31.36.0-255,66,47947,6,222121
23633,0.000455,74.125.130.0-255,6797,54744,6,222121
23634,0.000458,172.31.36.0-255,66,54810,6,222121
23635,0.00048,74.125.130.0-255,4320,59130,6,222121
23636,0.000483,172.31.36.0-255,66,59196,6,222121
23637,0.000497,74.125.130.0-255,2902,62098,6,222121
23638,0.000514,172.31.36.0-255,66,62164,6,222121
23639,0.000521,74.125.130.0-255,3961,66125,6,222121
23640,0.000523,172.31.36.0-255,66,66191,6,222121
23641,0.000526,74.125.130.0-255,380,66571,6,222121
23642,0.000577,74.125.130.0-255,98,66669,6,222121
23643,0.000648,74.125.130.0-255,362,67031,6,222121
23644,0.00084,172.31.36.0-255,66,67097,6,222121
23645,0.00094,74.125.130.0-255,1484,68581,6,222121
23646,0.000956,74.125.130.0-255,1484,70065,6,222121
23647,0.000959,172.31.36.0-255,66,70131,6,222121
23648,0.000965,74.125.130.0-255,2902,73033,6,222121
23649,0.000967,172.31.36.0-255,66,73099,6,222121
23650,0.000996,74.125.130.0-255,5738,78837,6,222121
23651,0.000999,172.31.36.0-255,66,78903,6,222121
23652,0.001029,74.125.130.0-255,8574,87477,6,222121
23653,0.001031,172.31.36.0-255,66,87543,6,222121
23654,0.00104,74.125.130.0-255,8574,96117,6,222121
23655,0.001042,172.31.36.0-255,66,96183,6,222121
23656,0.001066,74.125.130.0-255,1484,97667,6,222121
23657,0.001073,74.125.130.0-255,3602,101269,6,222121
23658,0.001075,172.31.36.0-255,66,101335,6,222121
23659,0.001123,74.125.130.0-255,1484,102819,6,222121
23660,0.001139,74.125.130.0-255,2902,105721,6,222121
23661,0.001142,172.31.36.0-255,66,105787,6,222121
23662,0.001163,74.125.130.0-255,5738,111525,6,222121
23663,0.001166,172.31.36.0-255,66,111591,6,222121
23664,0.00117,74.125.130.0-255,2902,114493,6,222121
23665,0.001173,172.31.36.0-255,66,114559,6,222121
23666,0.001202,74.125.130.0-255,2902,117461,6,222121
23667,0.001206,172.31.36.0-255,66,117527,6,222121
23668,0.001232,74.125.130.0-255,7156,124683,6,222121
23669,0.001235,172.31.36.0-255,66,124749,6,222121
23670,0.001242,74.125.130.0-255,8574,133323,6,222121
23671,0.001244,172.31.36.0-255,66,133389,6,222121
23672,0.001267,74.125.130.0-255,2184,135573,6,222121
23673,0.001269,172.31.36.0-255,66,135639,6,222121
23674,0.001747,74.125.130.0-255,1484,137123,6,222121
23675,0.001754,74.125.130.0-255,2902,140025,6,222121
23676,0.001759,172.31.36.0-255,66,140091,6,222121
23677,0.001779,74.125.130.0-255,4320,144411,6,222121
23678,0.001781,172.31.36.0-255,66,144477,6,222121
23679,0.001817,74.125.130.0-255,5738,150215,6,222121
23680,0.00182,172.31.36.0-255,66,150281,6,222121
23681,0.001838,74.125.130.0-255,1484,151765,6,222121
23682,0.001843,74.125.130.0-255,5738,157503,6,222121
23683,0.001846,172.31.36.0-255,66,157569,6,222121
23684,0.001857,74.125.130.0-255,2902,160471,6,222121
23685,0.001859,172.31.36.0-255,66,160537,6,222121
23686,0.001864,74.125.130.0-255,4320,164857,6,222121
23687,0.001866,172.31.36.0-255,66,164923,6,222121
23688,0.00188,74.125.130.0-255,2902,167825,6,222121
23689,0.001882,172.31.36.0-255,66,167891,6,222121
23690,0.001916,74.125.130.0-255,2184,170075,6,222121
23691,0.001919,172.31.36.0-255,66,170141,6,222121
23692,0.001937,74.125.130.0-255,2902,173043,6,222121
23693,0.00194,172.31.36.0-255,66,173109,6,222121
23694,0.001959,74.125.130.0-255,2902,176011,6,222121
23695,0.001961,172.31.36.0-255,66,176077,6,222121
23696,0.001974,74.125.130.0-255,4320,180397,6,222121
23697,0.001976,172.31.36.0-255,66,180463,6,222121
23698,0.001979,74.125.130.0-255,2902,183365,6,222121
23699,0.001981,172.31.36.0-255,66,183431,6,222121
23700,0.002005,74.125.130.0-255,4320,187751,6,222121
23701,0.002007,172.31.36.0-255,66,187817,6,222121
23702,0.002024,74.125.130.0-255,4320,192137,6,222121
23703,0.002026,172.31.36.0-255,66,192203,6,222121
23704,0.00208,74.125.130.0-255,2902,195105,6,222121
23705,0.002082,172.31.36.0-255,66,195171,6,222121
23706,0.002098,74.125.130.0-255,2902,198073,6,222121
23707,0.0021,172.31.36.0-255,66,198139,6,222121
23708,0.002116,74.125.130.0-255,1484,199623,6,222121
23709,0.002134,74.125.130.0-255,5020,204643,6,222121
23710,0.002137,172.31.36.0-255,66,204709,6,222121
23711,0.004439,74.125.130.0-255,5738,210447,6,222121
23712,0.004444,172.31.36.0-255,66,210513,6,222121
23713,0.0068,74.125.130.0-255,5738,216251,6,222121
23714,0.006805,172.31.36.0-255,66,216317,6,222121
23715,0.009134,74.125.130.0-255,5738,222055,6,222121
23716,0.009141,172.31.36.0-255,66,222121,6,222121
23717,0.0,74.125.24.0-255,146,146,6,91051
23718,2.9e-05,172.31.36.0-255,66,212,6,91051
23719,3.6e-05,74.125.24.0-255,1484,1696,6,91051
23720,4e-05,172.31.36.0-255,66,1762,6,91051
23721,5.5e-05,74.125.24.0-255,2902,4664,6,91051
23722,5.8e-05,172.31.36.0-255,66,4730,6,91051
23723,0.000105,74.125.24.0-255,4320,9050,6,91051
23724,0.000109,172.31.36.0-255,66,9116,6,91051
23725,0.000125,74.125.24.0-255,1484,10600,6,91051
23726,0.000127,172.31.36.0-255,66,10666,6,91051
23727,0.000228,74.125.24.0-255,4320,14986,6,91051
23728,0.000233,172.31.36.0-255,66,15052,6,91051
23729,0.000258,74.125.24.0-255,6257,21309,6,91051
23730,0.000262,172.31.36.0-255,66,21375,6,91051
23731,0.000454,74.125.24.0-255,1484,22859,6,91051
23732,0.000458,172.31.36.0-255,66,22925,6,91051
23733,0.000481,74.125.24.0-255,5738,28663,6,91051
23734,0.000484,172.31.36.0-255,66,28729,6,91051
23735,0.000626,74.125.24.0-255,2543,31272,6,91051
23736,0.00063,172.31.36.0-255,66,31338,6,91051
23737,0.000696,74.125.24.0-255,8574,39912,6,91051
23738,0.0007,172.31.36.0-255,66,39978,6,91051
23739,0.000734,172.31.36.0-255,66,40044,6,91051
23740,0.001184,74.125.24.0-255,9992,50036,6,91051
23741,0.001191,172.31.36.0-255,66,50102,6,91051
23742,0.001392,74.125.24.0-255,1145,51247,6,91051
23743,0.001398,172.31.36.0-255,66,51313,6,91051
23744,0.001429,74.125.24.0-255,5738,57051,6,91051
23745,0.001432,172.31.36.0-255,66,57117,6,91051
23746,0.001456,172.31.36.0-255,66,57183,6,91051
23747,0.001504,172.31.36.0-255,66,57249,6,91051
23748,0.002171,74.125.24.0-255,4320,61569,6,91051
23749,0.002177,172.31.36.0-255,66,61635,6,91051
23750,0.002227,172.31.36.0-255,66,61701,6,91051
23751,0.002285,74.125.24.0-255,9992,71693,6,91051
23752,0.002288,172.31.36.0-255,66,71759,6,91051
23753,0.003151,74.125.24.0-255,7156,78915,6,91051
23754,0.003157,172.31.36.0-255,66,78981,6,91051
23755,0.00322,172.31.36.0-255,66,79047,6,91051
23756,0.004135,172.31.36.0-255,66,79113,6,91051
23757,0.004196,172.31.36.0-255,66,79179,6,91051
23758,0.006715,74.125.24.0-255,2902,82081,6,91051
23759,0.006721,172.31.36.0-255,66,82147,6,91051
23760,0.006752,74.125.24.0-255,2902,85049,6,91051
23761,0.006756,172.31.36.0-255,66,85115,6,91051
23762,0.009248,74.125.24.0-255,2902,88017,6,91051
23763,0.009256,172.31.36.0-255,66,88083,6,91051
23764,0.009293,74.125.24.0-255,2902,90985,6,91051
23765,0.009298,172.31.36.0-255,66,91051,6,91051
23766,0.0,74.125.24.0-255,146,146,6,227932
23767,2.6e-05,172.31.36.0-255,66,212,6,227932
23768,3.4e-05,74.125.24.0-255,1484,1696,6,227932
23769,3.9e-05,172.31.36.0-255,66,1762,6,227932
23770,4.6e-05,74.125.24.0-255,2902,4664,6,227932
23771,4.9e-05,172.31.36.0-255,66,4730,6,227932
23772,5.3e-05,74.125.24.0-255,1484,6214,6,227932
23773,5.5e-05,172.31.36.0-255,66,6280,6,227932
23774,6.1e-05,74.125.24.0-255,2902,9182,6,227932
23775,6.3e-05,172.31.36.0-255,66,9248,6,227932
23776,7.1e-05,74.125.24.0-255,4858,14106,6,227932
23777,7.4e-05,172.31.36.0-255,66,14172,6,227932
23778,0.000114,74.125.24.0-255,1484,15656,6,227932
23779,0.000117,172.31.36.0-255,66,15722,6,227932
23780,0.000123,74.125.24.0-255,2902,18624,6,227932
23781,0.000125,172.31.36.0-255,66,18690,6,227932
23782,0.000131,74.125.24.0-255,2902,21592,6,227932
23783,0.000133,172.31.36.0-255,66,21658,6,227932
23784,0.00016,74.125.24.0-255,2902,24560,6,227932
23785,0.000163,172.31.36.0-255,66,24626,6,227932
23786,0.000186,74.125.24.0-255,8215,32841,6,227932
23787,0.000189,172.31.36.0-255,66,32907,6,227932
23788,0.000209,74.125.24.0-255,8574,41481,6,227932
23789,0.000212,172.31.36.0-255,66,41547,6,227932
23790,0.000219,74.125.24.0-255,5738,47285,6,227932
23791,0.000221,172.31.36.0-255,66,47351,6,227932
23792,0.00026,74.125.24.0-255,1125,48476,6,227932
23793,0.000263,172.31.36.0-255,66,48542,6,227932
23794,0.001096,74.125.24.0-255,1484,50026,6,227932
23795,0.001105,172.31.36.0-255,66,50092,6,227932
23796,0.001115,74.125.24.0-255,2902,52994,6,227932
23797,0.001118,172.31.36.0-255,66,53060,6,227932
23798,0.001125,74.125.24.0-255,5738,58798,6,227932
23799,0.001128,172.31.36.0-255,66,58864,6,227932
23800,0.001133,74.125.24.0-255,4320,63184,6,227932
23801,0.001136,172.31.36.0-255,66,63250,6,227932
23802,0.001194,172.31.36.0-255,66,63316,6,227932
23803,0.0012,74.125.24.0-255,2902,66218,6,227932
23804,0.001202,172.31.36.0-255,66,66284,6,227932
23805,0.001232,74.125.24.0-255,9992,76276,6,227932
23806,0.001235,172.31.36.0-255,66,76342,6,227932
23807,0.001246,74.125.24.0-255,9992,86334,6,227932
23808,0.001248,172.31.36.0-255,66,86400,6,227932
23809,0.001292,74.125.24.0-255,766,87166,6,227932
23810,0.001298,74.125.24.0-255,1484,88650,6,227932
23811,0.0013,172.31.36.0-255,66,88716,6,227932
23812,0.001306,74.125.24.0-255,2902,91618,6,227932
23813,0.001308,172.31.36.0-255,66,91684,6,227932
23814,0.00132,74.125.24.0-255,1484,93168,6,227932
23815,0.001323,74.125.24.0-255,1484,94652,6,227932
23816,0.001325,172.31.36.0-255,66,94718,6,227932
23817,0.001345,74.125.24.0-255,5738,100456,6,227932
23818,0.001348,172.31.36.0-255,66,100522,6,227932
23819,0.00138,74.125.24.0-255,3846,104368,6,227932
23820,0.001384,172.31.36.0-255,66,104434,6,227932
23821,0.001442,74.125.24.0-255,1484,105918,6,227932
23822,0.001448,74.125.24.0-255,2902,108820,6,227932
23823,0.001452,172.31.36.0-255,66,108886,6,227932
23824,0.001477,74.125.24.0-255,5738,114624,6,227932
23825,0.001481,172.31.36.0-255,66,114690,6,227932
23826,0.001484,74.125.24.0-255,1484,116174,6,227932
23827,0.001505,74.125.24.0-255,6076,122250,6,227932
23828,0.001508,172.31.36.0-255,66,122316,6,227932
23829,0.001532,74.125.24.0-255,1484,123800,6,227932
23830,0.001556,74.125.24.0-255,2902,126702,6,227932
23831,0.001559,172.31.36.0-255,66,126768,6,227932
23832,0.001566,74.125.24.0-255,5738,132506,6,227932
23833,0.001569,172.31.36.0-255,66,132572,6,227932
23834,0.001597,74.125.24.0-255,8574,141146,6,227932
23835,0.001601,172.31.36.0-255,66,141212,6,227932
23836,0.001609,74.125.24.0-255,7156,148368,6,227932
23837,0.001611,172.31.36.0-255,66,148434,6,227932
23838,0.001655,74.125.24.0-255,2902,151336,6,227932
23839,0.001658,172.31.36.0-255,66,151402,6,227932
23840,0.001665,74.125.24.0-255,5020,156422,6,227932
23841,0.001667,172.31.36.0-255,66,156488,6,227932
23842,0.001809,74.125.24.0-255,1484,157972,6,227932
23843,0.001817,74.125.24.0-255,2902,160874,6,227932
23844,0.001822,172.31.36.0-255,66,160940,6,227932
23845,0.001828,74.125.24.0-255,4320,165260,6,227932
23846,0.00183,172.31.36.0-255,66,165326,6,227932
23847,0.001845,74.125.24.0-255,1484,166810,6,227932
23848,0.001852,74.125.24.0-255,4320,171130,6,227932
23849,0.001854,172.31.36.0-255,66,171196,6,227932
23850,0.001877,74.125.24.0-255,9992,181188,6,227932
23851,0.00188,172.31.36.0-255,66,181254,6,227932
23852,0.001903,74.125.24.0-255,5738,186992,6,227932
23853,0.001906,172.31.36.0-255,66,187058,6,227932
23854,0.001912,74.125.24.0-255,3602,190660,6,227932
23855,0.001914,172.31.36.0-255,66,190726,6,227932
23856,0.002053,74.125.24.0-255,1484,192210,6,227932
23857,0.00206,74.125.24.0-255,2902,195112,6,227932
23858,0.002065,172.31.36.0-255,66,195178,6,227932
23859,0.002072,74.125.24.0-255,5738,200916,6,227932
23860,0.002075,172.31.36.0-255,66,200982,6,227932
23861,0.002107,74.125.24.0-255,7156,208138,6,227932
23862,0.00211,172.31.36.0-255,66,208204,6,227932
23863,0.002126,172.31.36.0-255,66,208270,6,227932
23864,0.002145,74.125.24.0-255,2184,210454,6,227932
23865,0.002148,172.31.36.0-255,66,210520,6,227932
23866,0.00451,74.125.24.0-255,5738,216258,6,227932
23867,0.004523,172.31.36.0-255,66,216324,6,227932
23868,0.0069,74.125.24.0-255,5738,222062,6,227932
23869,0.006917,172.31.36.0-255,66,222128,6,227932
23870,0.009316,74.125.24.0-255,5738,227866,6,227932
23871,0.00933,172.31.36.0-255,66,227932,6,227932
23872,0.0,74.125.24.0-255,291,291,6,117239
23873,1.9e-05,172.31.36.0-255,66,357,6,117239
23874,2.6e-05,74.125.24.0-255,1484,1841,6,117239
23875,3e-05,172.31.36.0-255,66,1907,6,117239
23876,3.6e-05,74.125.24.0-255,4320,6227,6,117239
23877,3.9e-05,172.31.36.0-255,66,6293,6,117239
23878,6.5e-05,74.125.24.0-255,7156,13449,6,117239
23879,6.9e-05,172.31.36.0-255,66,13515,6,117239
23880,7.2e-05,74.125.24.0-255,1484,14999,6,117239
23881,7.5e-05,172.31.36.0-255,66,15065,6,117239
23882,0.00011,172.31.36.0-255,66,15131,6,117239
23883,0.000139,74.125.24.0-255,3961,19092,6,117239
23884,0.000141,172.31.36.0-255,66,19158,6,117239
23885,0.000266,74.125.24.0-255,1484,20642,6,117239
23886,0.000272,172.31.36.0-255,66,20708,6,117239
23887,0.000277,74.125.24.0-255,2902,23610,6,117239
23888,0.000279,172.31.36.0-255,66,23676,6,117239
23889,0.000286,74.125.24.0-255,5738,29414,6,117239
23890,0.000289,172.31.36.0-255,66,29480,6,117239
23891,0.000313,74.125.24.0-255,4320,33800,6,117239
23892,0.000316,172.31.36.0-255,66,33866,6,117239
23893,0.000341,74.125.24.0-255,6797,40663,6,117239
23894,0.000345,172.31.36.0-255,66,40729,6,117239
23895,0.000353,74.125.24.0-255,8574,49303,6,117239
23896,0.000356,172.31.36.0-255,66,49369,6,117239
23897,0.000393,74.125.24.0-255,4294,53663,6,117239
23898,0.000397,172.31.36.0-255,66,53729,6,117239
23899,0.000416,74.125.24.0-255,376,54105,6,117239
23900,0.000419,172.31.36.0-255,66,54171,6,117239
23901,0.001059,74.125.24.0-255,1484,55655,6,117239
23902,0.001066,172.31.36.0-255,66,55721,6,117239
23903,0.001072,74.125.24.0-255,2902,58623,6,117239
23904,0.001074,172.31.36.0-255,66,58689,6,117239
23905,0.001081,74.125.24.0-255,5738,64427,6,117239
23906,0.001083,172.31.36.0-255,66,64493,6,117239
23907,0.001086,74.125.24.0-255,1484,65977,6,117239
23908,0.001089,172.31.36.0-255,66,66043,6,117239
23909,0.00113,172.31.36.0-255,66,66109,6,117239
23910,0.001138,74.125.24.0-255,7156,73265,6,117239
23911,0.00114,172.31.36.0-255,66,73331,6,117239
23912,0.00118,74.125.24.0-255,3602,76933,6,117239
23913,0.001183,172.31.36.0-255,66,76999,6,117239
23914,0.001689,74.125.24.0-255,1484,78483,6,117239
23915,0.001696,172.31.36.0-255,66,78549,6,117239
23916,0.001702,74.125.24.0-255,2902,81451,6,117239
23917,0.001704,172.31.36.0-255,66,81517,6,117239
23918,0.00171,74.125.24.0-255,5738,87255,6,117239
23919,0.001712,172.31.36.0-255,66,87321,6,117239
23920,0.001716,74.125.24.0-255,1484,88805,6,117239
23921,0.001717,172.31.36.0-255,66,88871,6,117239
23922,0.001757,172.31.36.0-255,66,88937,6,117239
23923,0.001771,74.125.24.0-255,2902,91839,6,117239
23924,0.001773,172.31.36.0-255,66,91905,6,117239
23925,0.001805,74.125.24.0-255,7856,99761,6,117239
23926,0.001809,172.31.36.0-255,66,99827,6,117239
23927,0.003952,74.125.24.0-255,5738,105565,6,117239
23928,0.003961,172.31.36.0-255,66,105631,6,117239
23929,0.006064,74.125.24.0-255,5738,111369,6,117239
23930,0.006071,172.31.36.0-255,66,111435,6,117239
23931,0.008188,74.125.24.0-255,5738,117173,6,117239
23932,0.008195,172.31.36.0-255,66,117239,6,117239
23933,0.0,172.217.27.0-255,153,153,6,141036
23934,2.2e-05,172.31.36.0-255,66,219,6,141036
23935,2.9e-05,172.217.27.0-255,1484,1703,6,141036
23936,3.3e-05,172.31.36.0-255,66,1769,6,141036
23937,3.8e-05,172.217.27.0-255,2902,4671,6,141036
23938,4e-05,172.31.36.0-255,66,4737,6,141036
23939,4.8e-05,172.217.27.0-255,7156,11893,6,141036
23940,5e-05,172.31.36.0-255,66,11959,6,141036
23941,6.4e-05,172.217.27.0-255,2067,14026,6,141036
23942,6.7e-05,172.31.36.0-255,66,14092,6,141036
23943,7.2e-05,172.217.27.0-255,2902,16994,6,141036
23944,7.4e-05,172.31.36.0-255,66,17060,6,141036
23945,8.2e-05,172.217.27.0-255,7156,24216,6,141036
23946,8.4e-05,172.31.36.0-255,66,24282,6,141036
23947,8.9e-05,172.217.27.0-255,2902,27184,6,141036
23948,9.1e-05,172.31.36.0-255,66,27250,6,141036
23949,0.00012,172.217.27.0-255,3961,31211,6,141036
23950,0.000128,172.31.36.0-255,66,31277,6,141036
23951,0.000204,172.217.27.0-255,1484,32761,6,141036
23952,0.000208,172.31.36.0-255,66,32827,6,141036
23953,0.000212,172.217.27.0-255,2902,35729,6,141036
23954,0.000215,172.31.36.0-255,66,35795,6,141036
23955,0.000248,172.217.27.0-255,5738,41533,6,141036
23956,0.000251,172.31.36.0-255,66,41599,6,141036
23957,0.000258,172.217.27.0-255,7156,48755,6,141036
23958,0.00026,172.31.36.0-255,66,48821,6,141036
23959,0.000285,172.217.27.0-255,1125,49946,6,141036
23960,0.000287,172.31.36.0-255,66,50012,6,141036
23961,0.0003,172.217.27.0-255,8574,58586,6,141036
23962,0.000303,172.31.36.0-255,66,58652,6,141036
23963,0.00031,172.217.27.0-255,7101,65753,6,141036
23964,0.000313,172.31.36.0-255,66,65819,6,141036
23965,0.000638,172.217.27.0-255,116,65935,6,141036
23966,0.000752,172.217.27.0-255,1484,67419,6,141036
23967,0.000758,172.31.36.0-255,66,67485,6,141036
23968,0.000765,172.217.27.0-255,2902,70387,6,141036
23969,0.000767,172.31.36.0-255,66,70453,6,141036
23970,0.00078,172.217.27.0-255,5738,76191,6,141036
23971,0.000782,172.31.36.0-255,66,76257,6,141036
23972,0.000794,172.217.27.0-255,2902,79159,6,141036
23973,0.000796,172.31.36.0-255,66,79225,6,141036
23974,0.000843,172.31.36.0-255,66,79291,6,141036
23975,0.000852,172.217.27.0-255,8574,87865,6,141036
23976,0.000855,172.31.36.0-255,66,87931,6,141036
23977,0.000857,172.217.27.0-255,1125,89056,6,141036
23978,0.001471,172.31.36.0-255,66,89122,6,141036
23979,0.00152,172.217.27.0-255,1484,90606,6,141036
23980,0.001526,172.217.27.0-255,2902,93508,6,141036
23981,0.001529,172.31.36.0-255,66,93574,6,141036
23982,0.001534,172.217.27.0-255,2902,96476,6,141036
23983,0.001536,172.31.36.0-255,66,96542,6,141036
23984,0.001561,172.217.27.0-255,2902,99444,6,141036
23985,0.001563,172.31.36.0-255,66,99510,6,141036
23986,0.001581,172.31.36.0-255,66,99576,6,141036
23987,0.001607,172.217.27.0-255,1484,101060,6,141036
23988,0.001619,172.217.27.0-255,7156,108216,6,141036
23989,0.001621,172.31.36.0-255,66,108282,6,141036
23990,0.001652,172.217.27.0-255,3602,111884,6,141036
23991,0.001654,172.31.36.0-255,66,111950,6,141036
23992,0.003235,172.217.27.0-255,1484,113434,6,141036
23993,0.003268,172.217.27.0-255,4320,117754,6,141036
23994,0.003274,172.31.36.0-255,66,117820,6,141036
23995,0.004899,172.217.27.0-255,5738,123558,6,141036
23996,0.004902,172.31.36.0-255,66,123624,6,141036
23997,0.006521,172.217.27.0-255,5738,129362,6,141036
23998,0.006525,172.31.36.0-255,66,129428,6,141036
23999,0.008152,172.217.27.0-255,5738,135166,6,141036
24000,0.008159,172.31.36.0-255,66,135232,6,141036
24001,0.00979,172.217.27.0-255,5738,140970,6,141036
24002,0.009797,172.31.36.0-255,66,141036,6,141036
24003,0.0,172.217.194.0-255,153,153,6,219286
24004,2.6e-05,172.31.36.0-255,66,219,6,219286
24005,3.2e-05,172.217.194.0-255,1484,1703,6,219286
24006,3.6e-05,172.31.36.0-255,66,1769,6,219286
24007,4.2e-05,172.217.194.0-255,2902,4671,6,219286
24008,4.5e-05,172.31.36.0-255,66,4737,6,219286
24009,5.1e-05,172.217.194.0-255,7156,11893,6,219286
24010,5.5e-05,172.31.36.0-255,66,11959,6,219286
24011,7.3e-05,172.217.194.0-255,2902,14861,6,219286
24012,7.5e-05,172.31.36.0-255,66,14927,6,219286
24013,0.000112,172.31.36.0-255,66,14993,6,219286
24014,0.000181,172.217.194.0-255,1484,16477,6,219286
24015,0.000184,172.31.36.0-255,66,16543,6,219286
24016,0.000187,172.217.194.0-255,1125,17668,6,219286
24017,0.000189,172.31.36.0-255,66,17734,6,219286
24018,0.000208,172.217.194.0-255,4320,22054,6,219286
24019,0.000211,172.31.36.0-255,66,22120,6,219286
24020,0.000214,172.217.194.0-255,1484,23604,6,219286
24021,0.000216,172.31.36.0-255,66,23670,6,219286
24022,0.000247,172.217.194.0-255,8574,32244,6,219286
24023,0.00025,172.31.36.0-255,66,32310,6,219286
24024,0.000291,172.217.194.0-255,4320,36630,6,219286
24025,0.000294,172.31.36.0-255,66,36696,6,219286
24026,0.000308,172.217.194.0-255,3961,40657,6,219286
24027,0.000311,172.31.36.0-255,66,40723,6,219286
24028,0.00035,172.217.194.0-255,5738,46461,6,219286
24029,0.000353,172.31.36.0-255,66,46527,6,219286
24030,0.000372,172.217.194.0-255,5692,52219,6,219286
24031,0.000375,172.31.36.0-255,66,52285,6,219286
24032,0.000646,172.217.194.0-255,99,52384,6,219286
24033,0.00065,172.31.36.0-255,66,52450,6,219286
24034,0.000664,172.217.194.0-255,362,52812,6,219286
24035,0.000726,172.217.194.0-255,1484,54296,6,219286
24036,0.00073,172.31.36.0-255,66,54362,6,219286
24037,0.000733,172.217.194.0-255,1484,55846,6,219286
24038,0.000749,172.217.194.0-255,1484,57330,6,219286
24039,0.000755,172.217.194.0-255,5738,63068,6,219286
24040,0.00076,172.31.36.0-255,66,63134,6,219286
24041,0.000774,172.217.194.0-255,1484,64618,6,219286
24042,0.000804,172.217.194.0-255,8574,73192,6,219286
24043,0.000812,172.31.36.0-255,66,73258,6,219286
24044,0.000839,172.217.194.0-255,2902,76160,6,219286
24045,0.000845,172.31.36.0-255,66,76226,6,219286
24046,0.000869,172.217.194.0-255,10692,86918,6,219286
24047,0.000882,172.31.36.0-255,66,86984,6,219286
24048,0.000959,172.217.194.0-255,1484,88468,6,219286
24049,0.000972,172.217.194.0-255,2902,91370,6,219286
24050,0.000975,172.31.36.0-255,66,91436,6,219286
24051,0.000979,172.217.194.0-255,2902,94338,6,219286
24052,0.00099,172.31.36.0-255,66,94404,6,219286
24053,0.001002,172.217.194.0-255,2902,97306,6,219286
24054,0.001015,172.31.36.0-255,66,97372,6,219286
24055,0.001018,172.217.194.0-255,4320,101692,6,219286
24056,0.00103,172.31.36.0-255,66,101758,6,219286
24057,0.001065,172.31.36.0-255,66,101824,6,219286
24058,0.00107,172.217.194.0-255,4320,106144,6,219286
24059,0.001077,172.31.36.0-255,66,106210,6,219286
24060,0.001139,172.217.194.0-255,3602,109812,6,219286
24061,0.001143,172.31.36.0-255,66,109878,6,219286
24062,0.001372,172.217.194.0-255,1484,111362,6,219286
24063,0.001379,172.217.194.0-255,2902,114264,6,219286
24064,0.001384,172.31.36.0-255,66,114330,6,219286
24065,0.001392,172.217.194.0-255,5738,120068,6,219286
24066,0.001411,172.217.194.0-255,1484,121552,6,219286
24067,0.001412,172.31.36.0-255,66,121618,6,219286
24068,0.001435,172.217.194.0-255,5738,127356,6,219286
24069,0.001448,172.31.36.0-255,66,127422,6,219286
24070,0.001459,172.217.194.0-255,5738,133160,6,219286
24071,0.001472,172.31.36.0-255,66,133226,6,219286
24072,0.001508,172.217.194.0-255,7156,140382,6,219286
24073,0.001512,172.31.36.0-255,66,140448,6,219286
24074,0.001533,172.217.194.0-255,3602,144050,6,219286
24075,0.001545,172.31.36.0-255,66,144116,6,219286
24076,0.001815,172.217.194.0-255,1484,145600,6,219286
24077,0.001824,172.217.194.0-255,2902,148502,6,219286
24078,0.001828,172.31.36.0-255,66,148568,6,219286
24079,0.001834,172.217.194.0-255,2902,151470,6,219286
24080,0.001849,172.217.194.0-255,2902,154372,6,219286
24081,0.001886,172.217.194.0-255,4320,158692,6,219286
24082,0.001892,172.217.194.0-255,2902,161594,6,219286
24083,0.001908,172.217.194.0-255,8574,170168,6,219286
24084,0.001969,172.217.194.0-255,4320,174488,6,219286
24085,0.001987,172.217.194.0-255,3602,178090,6,219286
24086,0.002177,172.217.194.0-255,1484,179574,6,219286
24087,0.002183,172.217.194.0-255,2902,182476,6,219286
24088,0.002211,172.217.194.0-255,4320,186796,6,219286
24089,0.002227,172.217.194.0-255,1484,188280,6,219286
24090,0.002307,172.217.194.0-255,4320,192600,6,219286
24091,0.002329,172.217.194.0-255,6438,199038,6,219286
24092,0.002384,172.217.194.0-255,2902,201940,6,219286
24093,0.002416,172.217.194.0-255,8574,210514,6,219286
24094,0.002454,172.217.194.0-255,2902,213416,6,219286
24095,0.006491,172.31.36.0-255,66,213482,6,219286
24096,0.008797,172.217.194.0-255,5738,219220,6,219286
24097,0.008804,172.31.36.0-255,66,219286,6,219286
24098,0.0,74.125.68.0-255,153,153,6,122772
24099,2.7e-05,172.31.36.0-255,66,219,6,122772
24100,3.4e-05,74.125.68.0-255,1484,1703,6,122772
24101,3.8e-05,172.31.36.0-255,66,1769,6,122772
24102,4.3e-05,74.125.68.0-255,2902,4671,6,122772
24103,4.7e-05,172.31.36.0-255,66,4737,6,122772
24104,5.3e-05,74.125.68.0-255,5738,10475,6,122772
24105,5.5e-05,172.31.36.0-255,66,10541,6,122772
24106,6.4e-05,74.125.68.0-255,6205,16746,6,122772
24107,6.9e-05,172.31.36.0-255,66,16812,6,122772
24108,7.3e-05,74.125.68.0-255,2902,19714,6,122772
24109,7.6e-05,74.125.68.0-255,4320,24034,6,122772
24110,7.7e-05,172.31.36.0-255,66,24100,6,122772
24111,8.1e-05,172.31.36.0-255,66,24166,6,122772
24112,0.000119,74.125.68.0-255,6797,30963,6,122772
24113,0.000123,172.31.36.0-255,66,31029,6,122772
24114,0.000201,74.125.68.0-255,1484,32513,6,122772
24115,0.000205,172.31.36.0-255,66,32579,6,122772
24116,0.000211,74.125.68.0-255,2902,35481,6,122772
24117,0.000213,172.31.36.0-255,66,35547,6,122772
24118,0.000227,74.125.68.0-255,2902,38449,6,122772
24119,0.000229,172.31.36.0-255,66,38515,6,122772
24120,0.000249,74.125.68.0-255,2902,41417,6,122772
24121,0.000253,172.31.36.0-255,66,41483,6,122772
24122,0.000262,74.125.68.0-255,4320,45803,6,122772
24123,0.000265,172.31.36.0-255,66,45869,6,122772
24124,0.000284,74.125.68.0-255,2543,48412,6,122772
24125,0.000287,172.31.36.0-255,66,48478,6,122772
24126,0.000446,74.125.68.0-255,1484,49962,6,122772
24127,0.00045,172.31.36.0-255,66,50028,6,122772
24128,0.000454,74.125.68.0-255,1484,51512,6,122772
24129,0.000456,172.31.36.0-255,66,51578,6,122772
24130,0.00047,74.125.68.0-255,1484,53062,6,122772
24131,0.000477,74.125.68.0-255,4320,57382,6,122772
24132,0.000479,172.31.36.0-255,66,57448,6,122772
24133,0.000507,74.125.68.0-255,4320,61768,6,122772
24134,0.00051,172.31.36.0-255,66,61834,6,122772
24135,0.000529,74.125.68.0-255,4305,66139,6,122772
24136,0.000532,172.31.36.0-255,66,66205,6,122772
24137,0.001089,74.125.68.0-255,333,66538,6,122772
24138,0.00126,74.125.68.0-255,1484,68022,6,122772
24139,0.001267,172.31.36.0-255,66,68088,6,122772
24140,0.001291,74.125.68.0-255,2902,70990,6,122772
24141,0.001294,172.31.36.0-255,66,71056,6,122772
24142,0.001299,74.125.68.0-255,1484,72540,6,122772
24143,0.001314,74.125.68.0-255,4320,76860,6,122772
24144,0.001317,172.31.36.0-255,66,76926,6,122772
24145,0.001321,74.125.68.0-255,2902,79828,6,122772
24146,0.001323,172.31.36.0-255,66,79894,6,122772
24147,0.001339,74.125.68.0-255,2902,82796,6,122772
24148,0.001342,172.31.36.0-255,66,82862,6,122772
24149,0.001349,74.125.68.0-255,7156,90018,6,122772
24150,0.001351,172.31.36.0-255,66,90084,6,122772
24151,0.001374,74.125.68.0-255,1484,91568,6,122772
24152,0.001393,74.125.68.0-255,8574,100142,6,122772
24153,0.001395,172.31.36.0-255,66,100208,6,122772
24154,0.001398,74.125.68.0-255,766,100974,6,122772
24155,0.003378,74.125.68.0-255,4320,105294,6,122772
24156,0.003381,172.31.36.0-255,66,105360,6,122772
24157,0.005377,74.125.68.0-255,5738,111098,6,122772
24158,0.005382,172.31.36.0-255,66,111164,6,122772
24159,0.007384,74.125.68.0-255,5738,116902,6,122772
24160,0.007391,172.31.36.0-255,66,116968,6,122772
24161,0.009399,74.125.68.0-255,5738,122706,6,122772
24162,0.009406,172.31.36.0-255,66,122772,6,122772
24163,0.0,74.125.24.0-255,153,153,6,302092
24164,2.8e-05,172.31.36.0-255,66,219,6,302092
24165,3.5e-05,74.125.24.0-255,1484,1703,6,302092
24166,3.9e-05,172.31.36.0-255,66,1769,6,302092
24167,4.4e-05,74.125.24.0-255,2902,4671,6,302092
24168,5.4e-05,172.31.36.0-255,66,4737,6,302092
24169,5.9e-05,74.125.24.0-255,2902,7639,6,302092
24170,6.1e-05,172.31.36.0-255,66,7705,6,302092
24171,6.7e-05,74.125.24.0-255,4320,12025,6,302092
24172,7e-05,172.31.36.0-255,66,12091,6,302092
24173,0.000108,74.125.24.0-255,2011,14102,6,302092
24174,0.000111,172.31.36.0-255,66,14168,6,302092
24175,0.000153,74.125.24.0-255,1484,15652,6,302092
24176,0.000156,172.31.36.0-255,66,15718,6,302092
24177,0.00016,74.125.24.0-255,2902,18620,6,302092
24178,0.000164,172.31.36.0-255,66,18686,6,302092
24179,0.000185,74.125.24.0-255,2902,21588,6,302092
24180,0.000187,172.31.36.0-255,66,21654,6,302092
24181,0.000212,74.125.24.0-255,2902,24556,6,302092
24182,0.000216,172.31.36.0-255,66,24622,6,302092
24183,0.000221,74.125.24.0-255,2902,27524,6,302092
24184,0.000223,172.31.36.0-255,66,27590,6,302092
24185,0.000249,74.125.24.0-255,3961,31551,6,302092
24186,0.000252,172.31.36.0-255,66,31617,6,302092
24187,0.00037,74.125.24.0-255,1484,33101,6,302092
24188,0.000375,172.31.36.0-255,66,33167,6,302092
24189,0.000381,74.125.24.0-255,2902,36069,6,302092
24190,0.000385,172.31.36.0-255,66,36135,6,302092
24191,0.000415,74.125.24.0-255,5738,41873,6,302092
24192,0.000419,172.31.36.0-255,66,41939,6,302092
24193,0.000426,74.125.24.0-255,5738,47677,6,302092
24194,0.00043,172.31.36.0-255,66,47743,6,302092
24195,0.000467,74.125.24.0-255,8215,55958,6,302092
24196,0.000472,172.31.36.0-255,66,56024,6,302092
24197,0.000504,74.125.24.0-255,9633,65657,6,302092
24198,0.000508,172.31.36.0-255,66,65723,6,302092
24199,0.001582,74.125.24.0-255,399,66122,6,302092
24200,0.001623,172.31.36.0-255,66,66188,6,302092
24201,0.001901,74.125.24.0-255,1484,67672,6,302092
24202,0.001909,74.125.24.0-255,2902,70574,6,302092
24203,0.001912,172.31.36.0-255,66,70640,6,302092
24204,0.001916,74.125.24.0-255,1484,72124,6,302092
24205,0.001946,74.125.24.0-255,4320,76444,6,302092
24206,0.001949,172.31.36.0-255,66,76510,6,302092
24207,0.001954,74.125.24.0-255,4320,80830,6,302092
24208,0.001956,172.31.36.0-255,66,80896,6,302092
24209,0.00196,74.125.24.0-255,2799,83695,6,302092
24210,0.001967,172.31.36.0-255,66,83761,6,302092
24211,0.002011,172.31.36.0-255,66,83827,6,302092
24212,0.002018,74.125.24.0-255,5738,89565,6,302092
24213,0.002019,172.31.36.0-255,66,89631,6,302092
24214,0.002022,74.125.24.0-255,1484,91115,6,302092
24215,0.00206,74.125.24.0-255,10692,101807,6,302092
24216,0.00208,172.31.36.0-255,66,101873,6,302092
24217,0.002183,74.125.24.0-255,1484,103357,6,302092
24218,0.002205,74.125.24.0-255,2902,106259,6,302092
24219,0.002211,74.125.24.0-255,5738,111997,6,302092
24220,0.002226,74.125.24.0-255,2902,114899,6,302092
24221,0.002245,74.125.24.0-255,9992,124891,6,302092
24222,0.002259,172.31.36.0-255,66,124957,6,302092
24223,0.002263,74.125.24.0-255,2902,127859,6,302092
24224,0.002268,172.31.36.0-255,66,127925,6,302092
24225,0.002283,74.125.24.0-255,7856,135781,6,302092
24226,0.002316,74.125.24.0-255,9992,145773,6,302092
24227,0.002319,74.125.24.0-255,1484,147257,6,302092
24228,0.00233,172.31.36.0-255,66,147323,6,302092
24229,0.002348,74.125.24.0-255,5738,153061,6,302092
24230,0.002355,74.125.24.0-255,7156,160217,6,302092
24231,0.002362,172.31.36.0-255,66,160283,6,302092
24232,0.002375,74.125.24.0-255,9274,169557,6,302092
24233,0.002383,74.125.24.0-255,2902,172459,6,302092
24234,0.002412,74.125.24.0-255,8574,181033,6,302092
24235,0.002463,172.31.36.0-255,66,181099,6,302092
24236,0.002481,74.125.24.0-255,9992,191091,6,302092
24237,0.002496,74.125.24.0-255,1484,192575,6,302092
24238,0.002515,74.125.24.0-255,8574,201149,6,302092
24239,0.002527,172.31.36.0-255,66,201215,6,302092
24240,0.002559,74.125.24.0-255,4320,205535,6,302092
24241,0.002577,74.125.24.0-255,7156,212691,6,302092
24242,0.002594,172.31.36.0-255,66,212757,6,302092
24243,0.002619,74.125.24.0-255,7156,219913,6,302092
24244,0.002626,172.31.36.0-255,66,219979,6,302092
24245,0.002666,74.125.24.0-255,10692,230671,6,302092
24246,0.002688,74.125.24.0-255,7156,237827,6,302092
24247,0.002701,172.31.36.0-255,66,237893,6,302092
24248,0.002713,74.125.24.0-255,5738,243631,6,302092
24249,0.002727,74.125.24.0-255,2184,245815,6,302092
24250,0.00273,172.31.36.0-255,66,245881,6,302092
24251,0.002752,74.125.24.0-255,1484,247365,6,302092
24252,0.002766,74.125.24.0-255,2902,250267,6,302092
24253,0.002769,172.31.36.0-255,66,250333,6,302092
24254,0.002779,74.125.24.0-255,4320,254653,6,302092
24255,0.002787,172.31.36.0-255,66,254719,6,302092
24256,0.002796,74.125.24.0-255,1484,256203,6,302092
24257,0.002819,74.125.24.0-255,9992,266195,6,302092
24258,0.002837,74.125.24.0-255,1484,267679,6,302092
24259,0.002845,74.125.24.0-255,8574,276253,6,302092
24260,0.002854,172.31.36.0-255,66,276319,6,302092
24261,0.002865,74.125.24.0-255,3602,279921,6,302092
24262,0.002874,74.125.24.0-255,7156,287077,6,302092
24263,0.002879,74.125.24.0-255,4320,291397,6,302092
24264,0.002893,74.125.24.0-255,4320,295717,6,302092
24265,0.002908,74.125.24.0-255,5738,301455,6,302092
24266,0.002922,172.31.36.0-255,66,301521,6,302092
24267,0.002978,172.31.36.0-255,66,301587,6,302092
24268,0.003001,74.125.24.0-255,97,301684,6,302092
24269,0.003022,172.31.36.0-255,66,301750,6,302092
24270,0.003025,74.125.24.0-255,105,301855,6,302092
24271,0.004887,172.31.36.0-255,66,301921,6,302092
24272,0.004918,172.31.36.0-255,105,302026,6,302092
24273,0.006836,74.125.24.0-255,66,302092,6,302092
24274,0.0,74.125.68.0-255,146,146,6,340823
24275,2.3e-05,172.31.36.0-255,66,212,6,340823
24276,5.5e-05,74.125.68.0-255,1484,1696,6,340823
24277,5.9e-05,172.31.36.0-255,66,1762,6,340823
24278,6.5e-05,74.125.68.0-255,2902,4664,6,340823
24279,6.7e-05,172.31.36.0-255,66,4730,6,340823
24280,0.000101,74.125.68.0-255,4320,9050,6,340823
24281,0.000104,172.31.36.0-255,66,9116,6,340823
24282,0.000117,74.125.68.0-255,1484,10600,6,340823
24283,0.00012,172.31.36.0-255,66,10666,6,340823
24284,0.000164,74.125.68.0-255,6321,16987,6,340823
24285,0.000168,172.31.36.0-255,66,17053,6,340823
24286,0.000177,74.125.68.0-255,7156,24209,6,340823
24287,0.00018,172.31.36.0-255,66,24275,6,340823
24288,0.000201,74.125.68.0-255,1484,25759,6,340823
24289,0.000203,172.31.36.0-255,66,25825,6,340823
24290,0.000221,74.125.68.0-255,5379,31204,6,340823
24291,0.000224,172.31.36.0-255,66,31270,6,340823
24292,0.000299,74.125.68.0-255,1484,32754,6,340823
24293,0.000304,172.31.36.0-255,66,32820,6,340823
24294,0.00031,74.125.68.0-255,2902,35722,6,340823
24295,0.000312,172.31.36.0-255,66,35788,6,340823
24296,0.000335,74.125.68.0-255,4320,40108,6,340823
24297,0.000338,172.31.36.0-255,66,40174,6,340823
24298,0.000362,74.125.68.0-255,1484,41658,6,340823
24299,0.000364,172.31.36.0-255,66,41724,6,340823
24300,0.000372,74.125.68.0-255,5738,47462,6,340823
24301,0.000375,172.31.36.0-255,66,47528,6,340823
24302,0.000408,74.125.68.0-255,1125,48653,6,340823
24303,0.000411,172.31.36.0-255,66,48719,6,340823
24304,0.000531,74.125.68.0-255,1484,50203,6,340823
24305,0.000536,172.31.36.0-255,66,50269,6,340823
24306,0.000539,74.125.68.0-255,1484,51753,6,340823
24307,0.000564,74.125.68.0-255,2902,54655,6,340823
24308,0.000569,172.31.36.0-255,66,54721,6,340823
24309,0.00058,74.125.68.0-255,5738,60459,6,340823
24310,0.000582,172.31.36.0-255,66,60525,6,340823
24311,0.000602,74.125.68.0-255,4320,64845,6,340823
24312,0.000604,172.31.36.0-255,66,64911,6,340823
24313,0.000647,74.125.68.0-255,1125,66036,6,340823
24314,0.000665,74.125.68.0-255,1484,67520,6,340823
24315,0.000668,172.31.36.0-255,66,67586,6,340823
24316,0.000689,74.125.68.0-255,4320,71906,6,340823
24317,0.000693,172.31.36.0-255,66,71972,6,340823
24318,0.000714,74.125.68.0-255,5738,77710,6,340823
24319,0.000717,172.31.36.0-255,66,77776,6,340823
24320,0.00072,74.125.68.0-255,1484,79260,6,340823
24321,0.000746,74.125.68.0-255,4540,83800,6,340823
24322,0.000748,172.31.36.0-255,66,83866,6,340823
24323,0.000818,74.125.68.0-255,1484,85350,6,340823
24324,0.000834,74.125.68.0-255,2902,88252,6,340823
24325,0.000838,172.31.36.0-255,66,88318,6,340823
24326,0.000861,74.125.68.0-255,5738,94056,6,340823
24327,0.000864,172.31.36.0-255,66,94122,6,340823
24328,0.000871,74.125.68.0-255,5738,99860,6,340823
24329,0.000874,172.31.36.0-255,66,99926,6,340823
24330,0.000889,74.125.68.0-255,1484,101410,6,340823
24331,0.000934,172.31.36.0-255,66,101476,6,340823
24332,0.000951,74.125.68.0-255,1484,102960,6,340823
24333,0.000964,74.125.68.0-255,1622,104582,6,340823
24334,0.000966,172.31.36.0-255,66,104648,6,340823
24335,0.001,74.125.68.0-255,1484,106132,6,340823
24336,0.001017,74.125.68.0-255,1484,107616,6,340823
24337,0.001021,172.31.36.0-255,66,107682,6,340823
24338,0.001027,74.125.68.0-255,4320,112002,6,340823
24339,0.00103,172.31.36.0-255,66,112068,6,340823
24340,0.001034,74.125.68.0-255,1484,113552,6,340823
24341,0.001065,74.125.68.0-255,7156,120708,6,340823
24342,0.001068,74.125.68.0-255,1484,122192,6,340823
24343,0.001071,74.125.68.0-255,2902,125094,6,340823
24344,0.001072,172.31.36.0-255,66,125160,6,340823
24345,0.001076,172.31.36.0-255,66,125226,6,340823
24346,0.001091,74.125.68.0-255,5738,130964,6,340823
24347,0.001094,172.31.36.0-255,66,131030,6,340823
24348,0.001123,74.125.68.0-255,7856,138886,6,340823
24349,0.001127,172.31.36.0-255,66,138952,6,340823
24350,0.001407,74.125.68.0-255,1484,140436,6,340823
24351,0.001412,74.125.68.0-255,1484,141920,6,340823
24352,0.001415,172.31.36.0-255,66,141986,6,340823
24353,0.001438,74.125.68.0-255,1484,143470,6,340823
24354,0.001445,74.125.68.0-255,5738,149208,6,340823
24355,0.001447,172.31.36.0-255,66,149274,6,340823
24356,0.001465,74.125.68.0-255,2902,152176,6,340823
24357,0.001468,172.31.36.0-255,66,152242,6,340823
24358,0.001496,74.125.68.0-255,7156,159398,6,340823
24359,0.0015,172.31.36.0-255,66,159464,6,340823
24360,0.001513,172.31.36.0-255,66,159530,6,340823
24361,0.001518,74.125.68.0-255,2184,161714,6,340823
24362,0.00152,172.31.36.0-255,66,161780,6,340823
24363,0.002054,74.125.68.0-255,1484,163264,6,340823
24364,0.002065,74.125.68.0-255,2902,166166,6,340823
24365,0.002069,172.31.36.0-255,66,166232,6,340823
24366,0.002076,74.125.68.0-255,5738,171970,6,340823
24367,0.002078,172.31.36.0-255,66,172036,6,340823
24368,0.002083,74.125.68.0-255,4320,176356,6,340823
24369,0.002085,172.31.36.0-255,66,176422,6,340823
24370,0.002115,74.125.68.0-255,1484,177906,6,340823
24371,0.002124,74.125.68.0-255,7156,185062,6,340823
24372,0.002127,172.31.36.0-255,66,185128,6,340823
24373,0.002131,74.125.68.0-255,1484,186612,6,340823
24374,0.002151,74.125.68.0-255,7156,193768,6,340823
24375,0.002154,172.31.36.0-255,66,193834,6,340823
24376,0.002173,74.125.68.0-255,2184,196018,6,340823
24377,0.002175,172.31.36.0-255,66,196084,6,340823
24378,0.002315,74.125.68.0-255,1484,197568,6,340823
24379,0.002322,74.125.68.0-255,2902,200470,6,340823
24380,0.002326,172.31.36.0-255,66,200536,6,340823
24381,0.002347,74.125.68.0-255,1484,202020,6,340823
24382,0.002367,74.125.68.0-255,4320,206340,6,340823
24383,0.002372,172.31.36.0-255,66,206406,6,340823
24384,0.002395,74.125.68.0-255,4320,210726,6,340823
24385,0.002399,172.31.36.0-255,66,210792,6,340823
24386,0.002406,74.125.68.0-255,4320,215112,6,340823
24387,0.002409,172.31.36.0-255,66,215178,6,340823
24388,0.002412,74.125.68.0-255,1484,216662,6,340823
24389,0.002415,74.125.68.0-255,1484,218146,6,340823
24390,0.002417,172.31.36.0-255,66,218212,6,340823
24391,0.002473,172.31.36.0-255,66,218278,6,340823
24392,0.002477,74.125.68.0-255,1484,219762,6,340823
24393,0.002483,74.125.68.0-255,2902,222664,6,340823
24394,0.002485,172.31.36.0-255,66,222730,6,340823
24395,0.002504,74.125.68.0-255,2902,225632,6,340823
24396,0.002506,172.31.36.0-255,66,225698,6,340823
24397,0.002524,74.125.68.0-255,2902,228600,6,340823
24398,0.002526,172.31.36.0-255,66,228666,6,340823
24399,0.00253,74.125.68.0-255,1484,230150,6,340823
24400,0.002537,74.125.68.0-255,7156,237306,6,340823
24401,0.002539,172.31.36.0-255,66,237372,6,340823
24402,0.002552,172.31.36.0-255,66,237438,6,340823
24403,0.002584,74.125.68.0-255,2902,240340,6,340823
24404,0.002587,172.31.36.0-255,66,240406,6,340823
24405,0.002612,74.125.68.0-255,7856,248262,6,340823
24406,0.002614,172.31.36.0-255,66,248328,6,340823
24407,0.002619,74.125.68.0-255,2902,251230,6,340823
24408,0.002621,172.31.36.0-255,66,251296,6,340823
24409,0.002629,74.125.68.0-255,8574,259870,6,340823
24410,0.002631,172.31.36.0-255,66,259936,6,340823
24411,0.002636,74.125.68.0-255,4320,264256,6,340823
24412,0.002637,172.31.36.0-255,66,264322,6,340823
24413,0.002663,74.125.68.0-255,8574,272896,6,340823
24414,0.002666,172.31.36.0-255,66,272962,6,340823
24415,0.002669,74.125.68.0-255,766,273728,6,340823
24416,0.002691,74.125.68.0-255,1484,275212,6,340823
24417,0.002694,172.31.36.0-255,66,275278,6,340823
24418,0.002697,74.125.68.0-255,1484,276762,6,340823
24419,0.002716,74.125.68.0-255,2902,279664,6,340823
24420,0.002719,172.31.36.0-255,66,279730,6,340823
24421,0.002721,74.125.68.0-255,1484,281214,6,340823
24422,0.002743,74.125.68.0-255,5738,286952,6,340823
24423,0.002746,172.31.36.0-255,66,287018,6,340823
24424,0.002752,74.125.68.0-255,5738,292756,6,340823
24425,0.002754,172.31.36.0-255,66,292822,6,340823
24426,0.00277,74.125.68.0-255,2902,295724,6,340823
24427,0.002772,172.31.36.0-255,66,295790,6,340823
24428,0.00281,172.31.36.0-255,66,295856,6,340823
24429,0.002834,74.125.68.0-255,8574,304430,6,340823
24430,0.002836,172.31.36.0-255,66,304496,6,340823
24431,0.002841,74.125.68.0-255,4320,308816,6,340823
24432,0.002844,172.31.36.0-255,66,308882,6,340823
24433,0.002849,74.125.68.0-255,4320,313202,6,340823
24434,0.002851,172.31.36.0-255,66,313268,6,340823
24435,0.002886,74.125.68.0-255,1484,314752,6,340823
24436,0.002913,74.125.68.0-255,1484,316236,6,340823
24437,0.002916,172.31.36.0-255,66,316302,6,340823
24438,0.002919,74.125.68.0-255,1484,317786,6,340823
24439,0.002922,74.125.68.0-255,2902,320688,6,340823
24440,0.002924,172.31.36.0-255,66,320754,6,340823
24441,0.002927,74.125.68.0-255,1484,322238,6,340823
24442,0.002933,74.125.68.0-255,5738,327976,6,340823
24443,0.002935,172.31.36.0-255,66,328042,6,340823
24444,0.002941,74.125.68.0-255,5020,333062,6,340823
24445,0.002943,172.31.36.0-255,66,333128,6,340823
24446,0.002945,74.125.68.0-255,1484,334612,6,340823
24447,0.002962,74.125.68.0-255,2902,337514,6,340823
24448,0.002965,172.31.36.0-255,66,337580,6,340823
24449,0.002986,74.125.68.0-255,2835,340415,6,340823
24450,0.002989,172.31.36.0-255,66,340481,6,340823
24451,0.003018,74.125.68.0-255,105,340586,6,340823
24452,0.004326,172.31.36.0-255,66,340652,6,340823
24453,0.004364,172.31.36.0-255,105,340757,6,340823
24454,0.006613,74.125.68.0-255,66,340823,6,340823
24455,0.0,172.31.36.0-255,66,66,6,66
24456,0.0,172.217.194.0-255,153,153,6,225873
24457,1.8e-05,172.31.36.0-255,66,219,6,225873
24458,2.5e-05,172.217.194.0-255,1484,1703,6,225873
24459,2.9e-05,172.31.36.0-255,66,1769,6,225873
24460,3.5e-05,172.217.194.0-255,2902,4671,6,225873
24461,4.9e-05,172.31.36.0-255,66,4737,6,225873
24462,7.8e-05,172.217.194.0-255,5738,10475,6,225873
24463,8.2e-05,172.31.36.0-255,66,10541,6,225873
24464,9.8e-05,172.217.194.0-255,7708,18249,6,225873
24465,0.000101,172.31.36.0-255,66,18315,6,225873
24466,0.000144,172.217.194.0-255,2902,21217,6,225873
24467,0.000147,172.31.36.0-255,66,21283,6,225873
24468,0.000182,172.217.194.0-255,9633,30916,6,225873
24469,0.000186,172.31.36.0-255,66,30982,6,225873
24470,0.000189,172.217.194.0-255,1484,32466,6,225873
24471,0.000191,172.31.36.0-255,66,32532,6,225873
24472,0.000219,172.217.194.0-255,1484,34016,6,225873
24473,0.000221,172.31.36.0-255,66,34082,6,225873
24474,0.000247,172.217.194.0-255,1484,35566,6,225873
24475,0.000254,172.31.36.0-255,66,35632,6,225873
24476,0.000261,172.217.194.0-255,5738,41370,6,225873
24477,0.000264,172.31.36.0-255,66,41436,6,225873
24478,0.000279,172.31.36.0-255,66,41502,6,225873
24479,0.000283,172.217.194.0-255,1484,42986,6,225873
24480,0.000285,172.31.36.0-255,66,43052,6,225873
24481,0.000289,172.217.194.0-255,1484,44536,6,225873
24482,0.000291,172.31.36.0-255,66,44602,6,225873
24483,0.000335,172.217.194.0-255,7856,52458,6,225873
24484,0.000339,172.31.36.0-255,66,52524,6,225873
24485,0.000342,172.217.194.0-255,379,52903,6,225873
24486,0.000344,172.31.36.0-255,66,52969,6,225873
24487,0.000375,172.217.194.0-255,364,53333,6,225873
24488,0.000618,172.217.194.0-255,1484,54817,6,225873
24489,0.000626,172.217.194.0-255,2902,57719,6,225873
24490,0.000635,172.31.36.0-255,66,57785,6,225873
24491,0.000655,172.217.194.0-255,5738,63523,6,225873
24492,0.000666,172.217.194.0-255,9992,73515,6,225873
24493,0.000699,172.217.194.0-255,2902,76417,6,225873
24494,0.00071,172.31.36.0-255,66,76483,6,225873
24495,0.000734,172.217.194.0-255,10692,87175,6,225873
24496,0.000775,172.31.36.0-255,66,87241,6,225873
24497,0.000796,172.217.194.0-255,7156,94397,6,225873
24498,0.000803,172.31.36.0-255,66,94463,6,225873
24499,0.000818,172.217.194.0-255,9992,104455,6,225873
24500,0.000855,172.217.194.0-255,7156,111611,6,225873
24501,0.000892,172.31.36.0-255,66,111677,6,225873
24502,0.000895,172.217.194.0-255,766,112443,6,225873
24503,0.000932,172.217.194.0-255,4320,116763,6,225873
24504,0.000965,172.217.194.0-255,9274,126037,6,225873
24505,0.000992,172.31.36.0-255,66,126103,6,225873
24506,0.001093,172.217.194.0-255,1484,127587,6,225873
24507,0.001117,172.217.194.0-255,2902,130489,6,225873
24508,0.001125,172.217.194.0-255,5738,136227,6,225873
24509,0.001163,172.217.194.0-255,1484,137711,6,225873
24510,0.001179,172.31.36.0-255,66,137777,6,225873
24511,0.001185,172.217.194.0-255,4320,142097,6,225873
24512,0.001211,172.217.194.0-255,5020,147117,6,225873
24513,0.001224,172.31.36.0-255,66,147183,6,225873
24514,0.001257,172.217.194.0-255,5738,152921,6,225873
24515,0.001265,172.217.194.0-255,7156,160077,6,225873
24516,0.001342,172.217.194.0-255,6438,166515,6,225873
24517,0.001369,172.31.36.0-255,66,166581,6,225873
24518,0.001426,172.217.194.0-255,1484,168065,6,225873
24519,0.001451,172.217.194.0-255,2902,170967,6,225873
24520,0.001457,172.217.194.0-255,5738,176705,6,225873
24521,0.001461,172.217.194.0-255,2902,179607,6,225873
24522,0.001469,172.31.36.0-255,66,179673,6,225873
24523,0.001501,172.217.194.0-255,4320,183993,6,225873
24524,0.001538,172.217.194.0-255,2184,186177,6,225873
24525,0.00157,172.31.36.0-255,66,186243,6,225873
24526,0.001575,172.217.194.0-255,1484,187727,6,225873
24527,0.001579,172.217.194.0-255,2902,190629,6,225873
24528,0.001611,172.217.194.0-255,5738,196367,6,225873
24529,0.001614,172.217.194.0-255,1484,197851,6,225873
24530,0.001621,172.31.36.0-255,66,197917,6,225873
24531,0.001671,172.217.194.0-255,7156,205073,6,225873
24532,0.001718,172.31.36.0-255,66,205139,6,225873
24533,0.001786,172.31.36.0-255,66,205205,6,225873
24534,0.001793,172.217.194.0-255,5738,210943,6,225873
24535,0.001815,172.31.36.0-255,66,211009,6,225873
24536,0.001898,172.31.36.0-255,66,211075,6,225873
24537,0.001932,172.217.194.0-255,766,211841,6,225873
24538,0.001938,172.31.36.0-255,66,211907,6,225873
24539,0.001996,172.217.194.0-255,7156,219063,6,225873
24540,0.002016,172.217.194.0-255,6402,225465,6,225873
24541,0.002018,172.217.194.0-255,105,225570,6,225873
24542,0.002056,172.31.36.0-255,66,225636,6,225873
24543,0.002062,172.31.36.0-255,66,225702,6,225873
24544,0.004987,172.31.36.0-255,105,225807,6,225873
24545,0.007674,172.217.194.0-255,66,225873,6,225873
24546,0.0,172.217.194.0-255,143,143,6,110792
24547,2.1e-05,172.31.36.0-255,66,209,6,110792
24548,2.7e-05,172.217.194.0-255,1484,1693,6,110792
24549,3.1e-05,172.31.36.0-255,66,1759,6,110792
24550,3.6e-05,172.217.194.0-255,2902,4661,6,110792
24551,3.9e-05,172.31.36.0-255,66,4727,6,110792
24552,7.4e-05,172.217.194.0-255,7156,11883,6,110792
24553,7.7e-05,172.31.36.0-255,66,11949,6,110792
24554,0.000182,172.217.194.0-255,2086,14035,6,110792
24555,0.000185,172.31.36.0-255,66,14101,6,110792
24556,0.00022,172.217.194.0-255,1484,15585,6,110792
24557,0.000223,172.31.36.0-255,66,15651,6,110792
24558,0.000251,172.217.194.0-255,5738,21389,6,110792
24559,0.000254,172.31.36.0-255,66,21455,6,110792
24560,0.000351,172.217.194.0-255,7156,28611,6,110792
24561,0.000355,172.31.36.0-255,66,28677,6,110792
24562,0.000378,172.217.194.0-255,5379,34056,6,110792
24563,0.000381,172.31.36.0-255,66,34122,6,110792
24564,0.000576,172.217.194.0-255,8574,42696,6,110792
24565,0.000582,172.31.36.0-255,66,42762,6,110792
24566,0.000614,172.31.36.0-255,66,42828,6,110792
24567,0.001023,172.217.194.0-255,5675,48503,6,110792
24568,0.001027,172.31.36.0-255,66,48569,6,110792
24569,0.001097,172.217.194.0-255,383,48952,6,110792
24570,0.001101,172.31.36.0-255,66,49018,6,110792
24571,0.001129,172.217.194.0-255,5738,54756,6,110792
24572,0.001132,172.31.36.0-255,66,54822,6,110792
24573,0.001148,172.217.194.0-255,2902,57724,6,110792
24574,0.00115,172.31.36.0-255,66,57790,6,110792
24575,0.001293,172.217.194.0-255,7156,64946,6,110792
24576,0.001296,172.31.36.0-255,66,65012,6,110792
24577,0.001321,172.217.194.0-255,9992,75004,6,110792
24578,0.001323,172.31.36.0-255,66,75070,6,110792
24579,0.001596,172.217.194.0-255,7856,82926,6,110792
24580,0.001602,172.31.36.0-255,66,82992,6,110792
24581,0.001724,172.217.194.0-255,4320,87312,6,110792
24582,0.001726,172.31.36.0-255,66,87378,6,110792
24583,0.00174,172.217.194.0-255,4320,91698,6,110792
24584,0.001742,172.31.36.0-255,66,91764,6,110792
24585,0.001869,172.217.194.0-255,1484,93248,6,110792
24586,0.001871,172.31.36.0-255,66,93314,6,110792
24587,0.001902,172.31.36.0-255,66,93380,6,110792
24588,0.003925,172.217.194.0-255,5738,99118,6,110792
24589,0.00393,172.31.36.0-255,66,99184,6,110792
24590,0.005962,172.217.194.0-255,5738,104922,6,110792
24591,0.005968,172.31.36.0-255,66,104988,6,110792
24592,0.008001,172.217.194.0-255,5738,110726,6,110792
24593,0.008007,172.31.36.0-255,66,110792,6,110792
24594,0.0,74.125.24.0-255,146,146,6,158331
24595,2.7e-05,172.31.36.0-255,66,212,6,158331
24596,3.4e-05,74.125.24.0-255,1484,1696,6,158331
24597,3.9e-05,172.31.36.0-255,66,1762,6,158331
24598,4.5e-05,74.125.24.0-255,2902,4664,6,158331
24599,5.8e-05,172.31.36.0-255,66,4730,6,158331
24600,6.7e-05,74.125.24.0-255,7156,11886,6,158331
24601,7e-05,172.31.36.0-255,66,11952,6,158331
24602,8.5e-05,172.31.36.0-255,66,12018,6,158331
24603,0.000123,74.125.24.0-255,4876,16894,6,158331
24604,0.000127,172.31.36.0-255,66,16960,6,158331
24605,0.00013,74.125.24.0-255,1484,18444,6,158331
24606,0.000133,172.31.36.0-255,66,18510,6,158331
24607,0.000136,74.125.24.0-255,1125,19635,6,158331
24608,0.000143,172.31.36.0-255,66,19701,6,158331
24609,0.000232,74.125.24.0-255,1484,21185,6,158331
24610,0.000235,172.31.36.0-255,66,21251,6,158331
24611,0.000241,74.125.24.0-255,2902,24153,6,158331
24612,0.000244,172.31.36.0-255,66,24219,6,158331
24613,0.000256,74.125.24.0-255,5738,29957,6,158331
24614,0.000259,172.31.36.0-255,66,30023,6,158331
24615,0.000264,74.125.24.0-255,4320,34343,6,158331
24616,0.000266,172.31.36.0-255,66,34409,6,158331
24617,0.000319,74.125.24.0-255,7156,41565,6,158331
24618,0.000322,172.31.36.0-255,66,41631,6,158331
24619,0.000339,74.125.24.0-255,4320,45951,6,158331
24620,0.000342,172.31.36.0-255,66,46017,6,158331
24621,0.00035,74.125.24.0-255,7856,53873,6,158331
24622,0.000352,172.31.36.0-255,66,53939,6,158331
24623,0.000355,74.125.24.0-255,363,54302,6,158331
24624,0.000357,172.31.36.0-255,66,54368,6,158331
24625,0.000384,74.125.24.0-255,125,54493,6,158331
24626,0.000865,74.125.24.0-255,1484,55977,6,158331
24627,0.000871,172.31.36.0-255,66,56043,6,158331
24628,0.000877,74.125.24.0-255,2902,58945,6,158331
24629,0.00088,172.31.36.0-255,66,59011,6,158331
24630,0.000892,74.125.24.0-255,5738,64749,6,158331
24631,0.000894,172.31.36.0-255,66,64815,6,158331
24632,0.000897,74.125.24.0-255,1484,66299,6,158331
24633,0.000937,172.31.36.0-255,66,66365,6,158331
24634,0.000945,74.125.24.0-255,7156,73521,6,158331
24635,0.000948,172.31.36.0-255,66,73587,6,158331
24636,0.000972,74.125.24.0-255,2902,76489,6,158331
24637,0.000974,172.31.36.0-255,66,76555,6,158331
24638,0.001012,74.125.24.0-255,10398,86953,6,158331
24639,0.001016,172.31.36.0-255,66,87019,6,158331
24640,0.001036,172.31.36.0-255,66,87085,6,158331
24641,0.001044,74.125.24.0-255,8574,95659,6,158331
24642,0.001047,172.31.36.0-255,66,95725,6,158331
24643,0.00105,74.125.24.0-255,766,96491,6,158331
24644,0.001265,74.125.24.0-255,1484,97975,6,158331
24645,0.00127,172.31.36.0-255,66,98041,6,158331
24646,0.001275,74.125.24.0-255,2902,100943,6,158331
24647,0.001277,172.31.36.0-255,66,101009,6,158331
24648,0.001314,74.125.24.0-255,5738,106747,6,158331
24649,0.001317,172.31.36.0-255,66,106813,6,158331
24650,0.001354,172.31.36.0-255,66,106879,6,158331
24651,0.001387,74.125.24.0-255,10692,117571,6,158331
24652,0.00139,172.31.36.0-255,66,117637,6,158331
24653,0.001428,74.125.24.0-255,9992,127629,6,158331
24654,0.001431,172.31.36.0-255,66,127695,6,158331
24655,0.001458,74.125.24.0-255,1484,129179,6,158331
24656,0.001465,74.125.24.0-255,5738,134917,6,158331
24657,0.001467,172.31.36.0-255,66,134983,6,158331
24658,0.001508,172.31.36.0-255,66,135049,6,158331
24659,0.001989,74.125.24.0-255,1484,136533,6,158331
24660,0.003504,74.125.24.0-255,4320,140853,6,158331
24661,0.003511,172.31.36.0-255,66,140919,6,158331
24662,0.005472,74.125.24.0-255,5738,146657,6,158331
24663,0.005479,172.31.36.0-255,66,146723,6,158331
24664,0.007459,74.125.24.0-255,5738,152461,6,158331
24665,0.007466,172.31.36.0-255,66,152527,6,158331
24666,0.009454,74.125.24.0-255,5738,158265,6,158331
24667,0.009462,172.31.36.0-255,66,158331,6,158331
24668,0.0,172.217.194.0-255,153,153,6,300138
24669,2.4e-05,172.31.36.0-255,66,219,6,300138
24670,3.1e-05,172.217.194.0-255,1484,1703,6,300138
24671,3.6e-05,172.31.36.0-255,66,1769,6,300138
24672,4.1e-05,172.217.194.0-255,2902,4671,6,300138
24673,5.3e-05,172.31.36.0-255,66,4737,6,300138
24674,6.1e-05,172.217.194.0-255,7156,11893,6,300138
24675,6.5e-05,172.31.36.0-255,66,11959,6,300138
24676,6.9e-05,172.217.194.0-255,2056,14015,6,300138
24677,7.2e-05,172.31.36.0-255,66,14081,6,300138
24678,8.6e-05,172.31.36.0-255,66,14147,6,300138
24679,9.3e-05,172.217.194.0-255,5379,19526,6,300138
24680,9.6e-05,172.31.36.0-255,66,19592,6,300138
24681,0.000136,172.217.194.0-255,1484,21076,6,300138
24682,0.000139,172.31.36.0-255,66,21142,6,300138
24683,0.000144,172.217.194.0-255,2902,24044,6,300138
24684,0.000147,172.31.36.0-255,66,24110,6,300138
24685,0.000156,172.217.194.0-255,2902,27012,6,300138
24686,0.000159,172.31.36.0-255,66,27078,6,300138
24687,0.000188,172.217.194.0-255,2902,29980,6,300138
24688,0.00019,172.31.36.0-255,66,30046,6,300138
24689,0.00021,172.31.36.0-255,66,30112,6,300138
24690,0.000218,172.217.194.0-255,8574,38686,6,300138
24691,0.000221,172.31.36.0-255,66,38752,6,300138
24692,0.000269,172.217.194.0-255,1378,40130,6,300138
24693,0.000271,172.31.36.0-255,66,40196,6,300138
24694,0.000275,172.217.194.0-255,117,40313,6,300138
24695,0.000277,172.31.36.0-255,66,40379,6,300138
24696,0.000314,172.217.194.0-255,1484,41863,6,300138
24697,0.000317,172.31.36.0-255,66,41929,6,300138
24698,0.000343,172.217.194.0-255,2902,44831,6,300138
24699,0.000346,172.31.36.0-255,66,44897,6,300138
24700,0.000354,172.217.194.0-255,7156,52053,6,300138
24701,0.000356,172.31.36.0-255,66,52119,6,300138
24702,0.000402,172.217.194.0-255,5115,57234,6,300138
24703,0.000405,172.31.36.0-255,66,57300,6,300138
24704,0.000551,172.217.194.0-255,1484,58784,6,300138
24705,0.00057,172.217.194.0-255,2902,61686,6,300138
24706,0.000574,172.31.36.0-255,66,61752,6,300138
24707,0.000581,172.217.194.0-255,5738,67490,6,300138
24708,0.000584,172.31.36.0-255,66,67556,6,300138
24709,0.000613,172.217.194.0-255,1484,69040,6,300138
24710,0.000627,172.217.194.0-255,5379,74419,6,300138
24711,0.00063,172.31.36.0-255,66,74485,6,300138
24712,0.000803,172.217.194.0-255,1484,75969,6,300138
24713,0.000822,172.217.194.0-255,2902,78871,6,300138
24714,0.000825,172.31.36.0-255,66,78937,6,300138
24715,0.000832,172.217.194.0-255,5738,84675,6,300138
24716,0.000834,172.31.36.0-255,66,84741,6,300138
24717,0.000875,172.217.194.0-255,5738,90479,6,300138
24718,0.000877,172.31.36.0-255,66,90545,6,300138
24719,0.000911,172.217.194.0-255,7156,97701,6,300138
24720,0.000919,172.31.36.0-255,66,97767,6,300138
24721,0.000929,172.217.194.0-255,9992,107759,6,300138
24722,0.000931,172.31.36.0-255,66,107825,6,300138
24723,0.000933,172.217.194.0-255,766,108591,6,300138
24724,0.000996,172.217.194.0-255,1484,110075,6,300138
24725,0.000999,172.31.36.0-255,66,110141,6,300138
24726,0.001022,172.217.194.0-255,2902,113043,6,300138
24727,0.001025,172.31.36.0-255,66,113109,6,300138
24728,0.001032,172.217.194.0-255,5738,118847,6,300138
24729,0.001035,172.31.36.0-255,66,118913,6,300138
24730,0.00104,172.217.194.0-255,4320,123233,6,300138
24731,0.001043,172.31.36.0-255,66,123299,6,300138
24732,0.001082,172.217.194.0-255,8574,131873,6,300138
24733,0.001092,172.217.194.0-255,10692,142565,6,300138
24734,0.001097,172.31.36.0-255,66,142631,6,300138
24735,0.001104,172.31.36.0-255,66,142697,6,300138
24736,0.001119,172.217.194.0-255,1484,144181,6,300138
24737,0.001143,172.217.194.0-255,7156,151337,6,300138
24738,0.001145,172.31.36.0-255,66,151403,6,300138
24739,0.001165,172.217.194.0-255,2902,154305,6,300138
24740,0.001168,172.31.36.0-255,66,154371,6,300138
24741,0.001182,172.31.36.0-255,66,154437,6,300138
24742,0.001185,172.217.194.0-255,1484,155921,6,300138
24743,0.00122,172.217.194.0-255,7856,163777,6,300138
24744,0.001223,172.31.36.0-255,66,163843,6,300138
24745,0.001227,172.217.194.0-255,2902,166745,6,300138
24746,0.001229,172.31.36.0-255,66,166811,6,300138
24747,0.001234,172.217.194.0-255,4320,171131,6,300138
24748,0.001236,172.31.36.0-255,66,171197,6,300138
24749,0.001248,172.217.194.0-255,8574,179771,6,300138
24750,0.00125,172.31.36.0-255,66,179837,6,300138
24751,0.001287,172.31.36.0-255,66,179903,6,300138
24752,0.001311,172.217.194.0-255,3602,183505,6,300138
24753,0.001314,172.31.36.0-255,66,183571,6,300138
24754,0.001319,172.217.194.0-255,4320,187891,6,300138
24755,0.001321,172.31.36.0-255,66,187957,6,300138
24756,0.001362,172.217.194.0-255,9992,197949,6,300138
24757,0.001365,172.31.36.0-255,66,198015,6,300138
24758,0.001388,172.31.36.0-255,66,198081,6,300138
24759,0.001392,172.217.194.0-255,3602,201683,6,300138
24760,0.001395,172.31.36.0-255,66,201749,6,300138
24761,0.001422,172.217.194.0-255,1484,203233,6,300138
24762,0.001457,172.31.36.0-255,66,203299,6,300138
24763,0.001479,172.217.194.0-255,1484,204783,6,300138
24764,0.001535,172.217.194.0-255,1484,206267,6,300138
24765,0.001539,172.217.194.0-255,2902,209169,6,300138
24766,0.001544,172.217.194.0-255,5738,214907,6,300138
24767,0.001575,172.217.194.0-255,8574,223481,6,300138
24768,0.001595,172.217.194.0-255,4320,227801,6,300138
24769,0.001604,172.217.194.0-255,10692,238493,6,300138
24770,0.001629,172.217.194.0-255,2902,241395,6,300138
24771,0.001651,172.217.194.0-255,8574,249969,6,300138
24772,0.001656,172.217.194.0-255,4320,254289,6,300138
24773,0.001671,172.217.194.0-255,5738,260027,6,300138
24774,0.001681,172.217.194.0-255,2902,262929,6,300138
24775,0.001684,172.217.194.0-255,1484,264413,6,300138
24776,0.001708,172.217.194.0-255,7856,272269,6,300138
24777,0.001732,172.217.194.0-255,9992,282261,6,300138
24778,0.001738,172.217.194.0-255,5738,287999,6,300138
24779,0.001783,172.217.194.0-255,4320,292319,6,300138
24780,0.001805,172.217.194.0-255,7376,299695,6,300138
24781,0.001808,172.217.194.0-255,105,299800,6,300138
24782,0.005564,172.31.36.0-255,66,299866,6,300138
24783,0.007622,172.31.36.0-255,101,299967,6,300138
24784,0.008184,172.31.36.0-255,105,300072,6,300138
24785,0.009591,172.217.194.0-255,66,300138,6,300138
24786,0.0,74.125.68.0-255,146,146,6,135442
24787,2.3e-05,172.31.36.0-255,66,212,6,135442
24788,2.9e-05,74.125.68.0-255,1484,1696,6,135442
24789,3.4e-05,172.31.36.0-255,66,1762,6,135442
24790,3.9e-05,74.125.68.0-255,2902,4664,6,135442
24791,4.2e-05,172.31.36.0-255,66,4730,6,135442
24792,6.9e-05,74.125.68.0-255,4320,9050,6,135442
24793,7.2e-05,172.31.36.0-255,66,9116,6,135442
24794,9e-05,74.125.68.0-255,2902,12018,6,135442
24795,9.2e-05,172.31.36.0-255,66,12084,6,135442
24796,0.000167,74.125.68.0-255,2085,14169,6,135442
24797,0.00017,172.31.36.0-255,66,14235,6,135442
24798,0.000196,74.125.68.0-255,2902,17137,6,135442
24799,0.000199,172.31.36.0-255,66,17203,6,135442
24800,0.000243,74.125.68.0-255,7156,24359,6,135442
24801,0.000247,172.31.36.0-255,66,24425,6,135442
24802,0.000335,74.125.68.0-255,6797,31222,6,135442
24803,0.000339,172.31.36.0-255,66,31288,6,135442
24804,0.000431,74.125.68.0-255,5738,37026,6,135442
24805,0.000435,172.31.36.0-255,66,37092,6,135442
24806,0.000454,74.125.68.0-255,1484,38576,6,135442
24807,0.000456,172.31.36.0-255,66,38642,6,135442
24808,0.000535,74.125.68.0-255,8574,47216,6,135442
24809,0.00054,172.31.36.0-255,66,47282,6,135442
24810,0.000559,74.125.68.0-255,6797,54079,6,135442
24811,0.000562,172.31.36.0-255,66,54145,6,135442
24812,0.000771,74.125.68.0-255,5738,59883,6,135442
24813,0.000777,172.31.36.0-255,66,59949,6,135442
24814,0.000797,74.125.68.0-255,5969,65918,6,135442
24815,0.000802,172.31.36.0-255,66,65984,6,135442
24816,0.000898,74.125.68.0-255,5738,71722,6,135442
24817,0.000904,172.31.36.0-255,66,71788,6,135442
24818,0.000923,74.125.68.0-255,7156,78944,6,135442
24819,0.000927,172.31.36.0-255,66,79010,6,135442
24820,0.001089,74.125.68.0-255,5738,84748,6,135442
24821,0.001095,172.31.36.0-255,66,84814,6,135442
24822,0.001136,172.31.36.0-255,66,84880,6,135442
24823,0.001362,74.125.68.0-255,4320,89200,6,135442
24824,0.00137,172.31.36.0-255,66,89266,6,135442
24825,0.001392,172.31.36.0-255,66,89332,6,135442
24826,0.001424,74.125.68.0-255,10692,100024,6,135442
24827,0.001427,172.31.36.0-255,66,100090,6,135442
24828,0.001848,172.31.36.0-255,66,100156,6,135442
24829,0.001884,172.31.36.0-255,66,100222,6,135442
24830,0.002301,74.125.68.0-255,5738,105960,6,135442
24831,0.002306,172.31.36.0-255,66,106026,6,135442
24832,0.002341,172.31.36.0-255,66,106092,6,135442
24833,0.002377,172.31.36.0-255,66,106158,6,135442
24834,0.002406,172.31.36.0-255,66,106224,6,135442
24835,0.00318,74.125.68.0-255,9992,116216,6,135442
24836,0.003185,172.31.36.0-255,66,116282,6,135442
24837,0.003263,172.31.36.0-255,66,116348,6,135442
24838,0.003291,172.31.36.0-255,66,116414,6,135442
24839,0.004051,74.125.68.0-255,7156,123570,6,135442
24840,0.004057,172.31.36.0-255,66,123636,6,135442
24841,0.004088,172.31.36.0-255,66,123702,6,135442
24842,0.004139,172.31.36.0-255,66,123768,6,135442
24843,0.004157,74.125.68.0-255,1484,125252,6,135442
24844,0.00677,74.125.68.0-255,4320,129572,6,135442
24845,0.006776,172.31.36.0-255,66,129638,6,135442
24846,0.009406,74.125.68.0-255,5738,135376,6,135442
24847,0.009419,172.31.36.0-255,66,135442,6,135442
24848,0.0,74.125.24.0-255,153,153,6,219878
24849,2.1e-05,172.31.36.0-255,66,219,6,219878
24850,2.7e-05,74.125.24.0-255,1484,1703,6,219878
24851,3.3e-05,172.31.36.0-255,66,1769,6,219878
24852,3.9e-05,74.125.24.0-255,2902,4671,6,219878
24853,4.2e-05,172.31.36.0-255,66,4737,6,219878
24854,5.7e-05,74.125.24.0-255,7156,11893,6,219878
24855,6e-05,172.31.36.0-255,66,11959,6,219878
24856,6.3e-05,74.125.24.0-255,1484,13443,6,219878
24857,6.6e-05,172.31.36.0-255,66,13509,6,219878
24858,7.4e-05,74.125.24.0-255,6319,19828,6,219878
24859,7.7e-05,172.31.36.0-255,66,19894,6,219878
24860,8e-05,74.125.24.0-255,1484,21378,6,219878
24861,8.3e-05,172.31.36.0-255,66,21444,6,219878
24862,0.000108,74.125.24.0-255,5738,27182,6,219878
24863,0.000111,172.31.36.0-255,66,27248,6,219878
24864,0.000139,74.125.24.0-255,3961,31209,6,219878
24865,0.000141,172.31.36.0-255,66,31275,6,219878
24866,0.000348,74.125.24.0-255,1484,32759,6,219878
24867,0.000354,172.31.36.0-255,66,32825,6,219878
24868,0.000369,74.125.24.0-255,2902,35727,6,219878
24869,0.000376,172.31.36.0-255,66,35793,6,219878
24870,0.000383,74.125.24.0-255,5738,41531,6,219878
24871,0.000386,172.31.36.0-255,66,41597,6,219878
24872,0.000435,74.125.24.0-255,5738,47335,6,219878
24873,0.000438,172.31.36.0-255,66,47401,6,219878
24874,0.000462,74.125.24.0-255,1125,48526,6,219878
24875,0.000464,172.31.36.0-255,66,48592,6,219878
24876,0.000688,74.125.24.0-255,1484,50076,6,219878
24877,0.000693,172.31.36.0-255,66,50142,6,219878
24878,0.000698,74.125.24.0-255,2902,53044,6,219878
24879,0.0007,172.31.36.0-255,66,53110,6,219878
24880,0.000704,74.125.24.0-255,1484,54594,6,219878
24881,0.000738,74.125.24.0-255,4320,58914,6,219878
24882,0.000741,172.31.36.0-255,66,58980,6,219878
24883,0.000749,74.125.24.0-255,7376,66356,6,219878
24884,0.000751,172.31.36.0-255,66,66422,6,219878
24885,0.001616,74.125.24.0-255,1484,67906,6,219878
24886,0.001627,74.125.24.0-255,2902,70808,6,219878
24887,0.001633,172.31.36.0-255,66,70874,6,219878
24888,0.001639,74.125.24.0-255,2902,73776,6,219878
24889,0.001641,172.31.36.0-255,66,73842,6,219878
24890,0.001665,74.125.24.0-255,2902,76744,6,219878
24891,0.001667,172.31.36.0-255,66,76810,6,219878
24892,0.001678,74.125.24.0-255,5738,82548,6,219878
24893,0.001681,172.31.36.0-255,66,82614,6,219878
24894,0.001727,172.31.36.0-255,66,82680,6,219878
24895,0.00173,74.125.24.0-255,1484,84164,6,219878
24896,0.001738,74.125.24.0-255,7156,91320,6,219878
24897,0.00174,172.31.36.0-255,66,91386,6,219878
24898,0.001779,74.125.24.0-255,9992,101378,6,219878
24899,0.001782,172.31.36.0-255,66,101444,6,219878
24900,0.001786,74.125.24.0-255,2184,103628,6,219878
24901,0.001789,172.31.36.0-255,66,103694,6,219878
24902,0.002036,74.125.24.0-255,1484,105178,6,219878
24903,0.002045,74.125.24.0-255,2902,108080,6,219878
24904,0.002049,172.31.36.0-255,66,108146,6,219878
24905,0.002054,74.125.24.0-255,1484,109630,6,219878
24906,0.00208,74.125.24.0-255,2902,112532,6,219878
24907,0.002082,172.31.36.0-255,66,112598,6,219878
24908,0.002091,74.125.24.0-255,8574,121172,6,219878
24909,0.002093,172.31.36.0-255,66,121238,6,219878
24910,0.002116,74.125.24.0-255,1484,122722,6,219878
24911,0.002152,172.31.36.0-255,66,122788,6,219878
24912,0.002169,74.125.24.0-255,4320,127108,6,219878
24913,0.002172,172.31.36.0-255,66,127174,6,219878
24914,0.002221,172.31.36.0-255,66,127240,6,219878
24915,0.002242,172.31.36.0-255,66,127306,6,219878
24916,0.002244,74.125.24.0-255,766,128072,6,219878
24917,0.002264,74.125.24.0-255,1484,129556,6,219878
24918,0.002267,172.31.36.0-255,66,129622,6,219878
24919,0.002286,74.125.24.0-255,7156,136778,6,219878
24920,0.002293,172.31.36.0-255,66,136844,6,219878
24921,0.002303,74.125.24.0-255,9992,146836,6,219878
24922,0.002305,172.31.36.0-255,66,146902,6,219878
24923,0.002317,74.125.24.0-255,2902,149804,6,219878
24924,0.00232,172.31.36.0-255,66,149870,6,219878
24925,0.002352,74.125.24.0-255,7156,157026,6,219878
24926,0.002355,172.31.36.0-255,66,157092,6,219878
24927,0.00236,74.125.24.0-255,4320,161412,6,219878
24928,0.002362,172.31.36.0-255,66,161478,6,219878
24929,0.002398,74.125.24.0-255,6438,167916,6,219878
24930,0.002401,172.31.36.0-255,66,167982,6,219878
24931,0.002409,74.125.24.0-255,7156,175138,6,219878
24932,0.002411,172.31.36.0-255,66,175204,6,219878
24933,0.002451,74.125.24.0-255,4320,179524,6,219878
24934,0.002454,172.31.36.0-255,66,179590,6,219878
24935,0.002494,172.31.36.0-255,66,179656,6,219878
24936,0.002504,74.125.24.0-255,3602,183258,6,219878
24937,0.002507,172.31.36.0-255,66,183324,6,219878
24938,0.002527,172.31.36.0-255,66,183390,6,219878
24939,0.002568,172.31.36.0-255,66,183456,6,219878
24940,0.002599,74.125.24.0-255,3602,187058,6,219878
24941,0.002601,172.31.36.0-255,66,187124,6,219878
24942,0.002625,172.31.36.0-255,66,187190,6,219878
24943,0.002632,74.125.24.0-255,7156,194346,6,219878
24944,0.002635,172.31.36.0-255,66,194412,6,219878
24945,0.002679,172.31.36.0-255,66,194478,6,219878
24946,0.002688,74.125.24.0-255,9992,204470,6,219878
24947,0.002691,172.31.36.0-255,66,204536,6,219878
24948,0.002695,74.125.24.0-255,3602,208138,6,219878
24949,0.002698,172.31.36.0-255,66,208204,6,219878
24950,0.005299,74.125.24.0-255,1484,209688,6,219878
24951,0.005322,74.125.24.0-255,4320,214008,6,219878
24952,0.005326,172.31.36.0-255,66,214074,6,219878
24953,0.008,74.125.24.0-255,5738,219812,6,219878
24954,0.008007,172.31.36.0-255,66,219878,6,219878
24955,0.0,74.125.24.0-255,153,153,6,173411
24956,3.5e-05,172.31.36.0-255,66,219,6,173411
24957,4.3e-05,74.125.24.0-255,1484,1703,6,173411
24958,4.7e-05,172.31.36.0-255,66,1769,6,173411
24959,6e-05,74.125.24.0-255,2902,4671,6,173411
24960,6.3e-05,172.31.36.0-255,66,4737,6,173411
24961,7e-05,74.125.24.0-255,5738,10475,6,173411
24962,7.3e-05,172.31.36.0-255,66,10541,6,173411
24963,8.3e-05,74.125.24.0-255,10537,21078,6,173411
24964,8.6e-05,172.31.36.0-255,66,21144,6,173411
24965,0.000126,74.125.24.0-255,9633,30777,6,173411
24966,0.000129,172.31.36.0-255,66,30843,6,173411
24967,0.00015,74.125.24.0-255,4320,35163,6,173411
24968,0.000153,172.31.36.0-255,66,35229,6,173411
24969,0.00016,74.125.24.0-255,5738,40967,6,173411
24970,0.000162,172.31.36.0-255,66,41033,6,173411
24971,0.000198,74.125.24.0-255,6797,47830,6,173411
24972,0.000201,172.31.36.0-255,66,47896,6,173411
24973,0.00031,74.125.24.0-255,1484,49380,6,173411
24974,0.000315,172.31.36.0-255,66,49446,6,173411
24975,0.000322,74.125.24.0-255,2902,52348,6,173411
24976,0.000324,172.31.36.0-255,66,52414,6,173411
24977,0.000337,74.125.24.0-255,5738,58152,6,173411
24978,0.00034,172.31.36.0-255,66,58218,6,173411
24979,0.000343,74.125.24.0-255,1484,59702,6,173411
24980,0.000346,172.31.36.0-255,66,59768,6,173411
24981,0.000381,74.125.24.0-255,4320,64088,6,173411
24982,0.000385,172.31.36.0-255,66,64154,6,173411
24983,0.000409,74.125.24.0-255,1125,65279,6,173411
24984,0.000412,172.31.36.0-255,66,65345,6,173411
24985,0.00046,74.125.24.0-255,1484,66829,6,173411
24986,0.000463,172.31.36.0-255,66,66895,6,173411
24987,0.000467,74.125.24.0-255,1484,68379,6,173411
24988,0.000492,74.125.24.0-255,1484,69863,6,173411
24989,0.000495,172.31.36.0-255,66,69929,6,173411
24990,0.000502,74.125.24.0-255,5738,75667,6,173411
24991,0.000505,172.31.36.0-255,66,75733,6,173411
24992,0.000514,74.125.24.0-255,2902,78635,6,173411
24993,0.000516,172.31.36.0-255,66,78701,6,173411
24994,0.000541,74.125.24.0-255,1484,80185,6,173411
24995,0.000568,74.125.24.0-255,9633,89818,6,173411
24996,0.000572,172.31.36.0-255,66,89884,6,173411
24997,0.000605,74.125.24.0-255,9633,99517,6,173411
24998,0.000609,172.31.36.0-255,66,99583,6,173411
24999,0.001023,74.125.24.0-255,1484,101067,6,173411
25000,0.001029,74.125.24.0-255,2902,103969,6,173411
25001,0.001032,172.31.36.0-255,66,104035,6,173411
25002,0.001063,74.125.24.0-255,5738,109773,6,173411
25003,0.001066,172.31.36.0-255,66,109839,6,173411
25004,0.00107,74.125.24.0-255,1484,111323,6,173411
25005,0.001075,74.125.24.0-255,4320,115643,6,173411
25006,0.001077,172.31.36.0-255,66,115709,6,173411
25007,0.001111,74.125.24.0-255,4320,120029,6,173411
25008,0.001114,172.31.36.0-255,66,120095,6,173411
25009,0.001155,74.125.24.0-255,8574,128669,6,173411
25010,0.001158,172.31.36.0-255,66,128735,6,173411
25011,0.001186,74.125.24.0-255,3974,132709,6,173411
25012,0.001189,172.31.36.0-255,66,132775,6,173411
25013,0.001655,74.125.24.0-255,1484,134259,6,173411
25014,0.001665,74.125.24.0-255,2902,137161,6,173411
25015,0.001668,172.31.36.0-255,66,137227,6,173411
25016,0.001673,74.125.24.0-255,1484,138711,6,173411
25017,0.001699,74.125.24.0-255,4320,143031,6,173411
25018,0.001702,172.31.36.0-255,66,143097,6,173411
25019,0.001717,172.31.36.0-255,66,143163,6,173411
25020,0.00173,74.125.24.0-255,9992,153155,6,173411
25021,0.001733,172.31.36.0-255,66,153221,6,173411
25022,0.001736,74.125.24.0-255,766,153987,6,173411
25023,0.00227,74.125.24.0-255,1484,155471,6,173411
25024,0.002277,172.31.36.0-255,66,155537,6,173411
25025,0.002281,74.125.24.0-255,1484,157021,6,173411
25026,0.003989,74.125.24.0-255,1484,158505,6,173411
25027,0.003992,172.31.36.0-255,66,158571,6,173411
25028,0.004524,74.125.24.0-255,2902,161473,6,173411
25029,0.004527,172.31.36.0-255,66,161539,6,173411
25030,0.00624,74.125.24.0-255,2902,164441,6,173411
25031,0.006245,172.31.36.0-255,66,164507,6,173411
25032,0.006775,74.125.24.0-255,2902,167409,6,173411
25033,0.00678,172.31.36.0-255,66,167475,6,173411
25034,0.008511,74.125.24.0-255,2902,170377,6,173411
25035,0.008517,172.31.36.0-255,66,170443,6,173411
25036,0.009014,74.125.24.0-255,2902,173345,6,173411
25037,0.00902,172.31.36.0-255,66,173411,6,173411
25038,0.0,172.217.194.0-255,152,152,6,143896
25039,3e-05,172.31.36.0-255,66,218,6,143896
25040,3.7e-05,172.217.194.0-255,1484,1702,6,143896
25041,4.2e-05,172.31.36.0-255,66,1768,6,143896
25042,4.7e-05,172.217.194.0-255,2902,4670,6,143896
25043,4.9e-05,172.31.36.0-255,66,4736,6,143896
25044,5.2e-05,172.217.194.0-255,1484,6220,6,143896
25045,5.3e-05,172.31.36.0-255,66,6286,6,143896
25046,6.1e-05,172.217.194.0-255,7156,13442,6,143896
25047,6.3e-05,172.31.36.0-255,66,13508,6,143896
25048,9.4e-05,172.217.194.0-255,2148,15656,6,143896
25049,9.8e-05,172.31.36.0-255,66,15722,6,143896
25050,0.000111,172.31.36.0-255,66,15788,6,143896
25051,0.000131,172.217.194.0-255,2543,18331,6,143896
25052,0.000134,172.31.36.0-255,66,18397,6,143896
25053,0.000176,172.217.194.0-255,2902,21299,6,143896
25054,0.000179,172.31.36.0-255,66,21365,6,143896
25055,0.000186,172.217.194.0-255,4320,25685,6,143896
25056,0.00019,172.31.36.0-255,66,25751,6,143896
25057,0.000193,172.217.194.0-255,1484,27235,6,143896
25058,0.000195,172.31.36.0-255,66,27301,6,143896
25059,0.000214,172.217.194.0-255,7156,34457,6,143896
25060,0.000217,172.31.36.0-255,66,34523,6,143896
25061,0.00023,172.217.194.0-255,4320,38843,6,143896
25062,0.000234,172.31.36.0-255,66,38909,6,143896
25063,0.000261,172.31.36.0-255,66,38975,6,143896
25064,0.000279,172.217.194.0-255,2847,41822,6,143896
25065,0.000282,172.31.36.0-255,66,41888,6,143896
25066,0.000296,172.217.194.0-255,382,42270,6,143896
25067,0.000299,172.31.36.0-255,66,42336,6,143896
25068,0.000784,172.217.194.0-255,1484,43820,6,143896
25069,0.000803,172.217.194.0-255,2902,46722,6,143896
25070,0.000808,172.31.36.0-255,66,46788,6,143896
25071,0.000833,172.217.194.0-255,5738,52526,6,143896
25072,0.000838,172.217.194.0-255,5738,58264,6,143896
25073,0.000838,172.31.36.0-255,66,58330,6,143896
25074,0.000841,172.31.36.0-255,66,58396,6,143896
25075,0.000863,172.217.194.0-255,5738,64134,6,143896
25076,0.000866,172.31.36.0-255,66,64200,6,143896
25077,0.000885,172.217.194.0-255,7156,71356,6,143896
25078,0.000887,172.31.36.0-255,66,71422,6,143896
25079,0.000931,172.217.194.0-255,5020,76442,6,143896
25080,0.000935,172.31.36.0-255,66,76508,6,143896
25081,0.001602,172.217.194.0-255,1484,77992,6,143896
25082,0.001613,172.217.194.0-255,2902,80894,6,143896
25083,0.001618,172.31.36.0-255,66,80960,6,143896
25084,0.001625,172.217.194.0-255,4320,85280,6,143896
25085,0.001627,172.31.36.0-255,66,85346,6,143896
25086,0.001657,172.217.194.0-255,1484,86830,6,143896
25087,0.001673,172.31.36.0-255,66,86896,6,143896
25088,0.001695,172.217.194.0-255,5738,92634,6,143896
25089,0.001699,172.31.36.0-255,66,92700,6,143896
25090,0.001714,172.217.194.0-255,5020,97720,6,143896
25091,0.001717,172.31.36.0-255,66,97786,6,143896
25092,0.001918,172.217.194.0-255,1484,99270,6,143896
25093,0.001926,172.217.194.0-255,2902,102172,6,143896
25094,0.00193,172.31.36.0-255,66,102238,6,143896
25095,0.001937,172.217.194.0-255,5738,107976,6,143896
25096,0.001939,172.31.36.0-255,66,108042,6,143896
25097,0.001944,172.217.194.0-255,4320,112362,6,143896
25098,0.001945,172.31.36.0-255,66,112428,6,143896
25099,0.001974,172.217.194.0-255,1484,113912,6,143896
25100,0.001987,172.31.36.0-255,66,113978,6,143896
25101,0.001996,172.217.194.0-255,5020,118998,6,143896
25102,0.001998,172.31.36.0-255,66,119064,6,143896
25103,0.002037,172.217.194.0-255,1484,120548,6,143896
25104,0.002052,172.217.194.0-255,2902,123450,6,143896
25105,0.002057,172.31.36.0-255,66,123516,6,143896
25106,0.002077,172.217.194.0-255,2902,126418,6,143896
25107,0.00208,172.31.36.0-255,66,126484,6,143896
25108,0.004094,172.217.194.0-255,5738,132222,6,143896
25109,0.004099,172.31.36.0-255,66,132288,6,143896
25110,0.006147,172.217.194.0-255,5738,138026,6,143896
25111,0.006153,172.31.36.0-255,66,138092,6,143896
25112,0.008205,172.217.194.0-255,5738,143830,6,143896
25113,0.008212,172.31.36.0-255,66,143896,6,143896
25114,0.0,172.217.194.0-255,146,146,6,308276
25115,2.7e-05,172.31.36.0-255,66,212,6,308276
25116,3.4e-05,172.217.194.0-255,1484,1696,6,308276
25117,3.9e-05,172.31.36.0-255,66,1762,6,308276
25118,4.4e-05,172.217.194.0-255,2902,4664,6,308276
25119,4.6e-05,172.31.36.0-255,66,4730,6,308276
25120,6e-05,172.217.194.0-255,7156,11886,6,308276
25121,6.3e-05,172.31.36.0-255,66,11952,6,308276
25122,6.7e-05,172.217.194.0-255,2103,14055,6,308276
25123,6.9e-05,172.31.36.0-255,66,14121,6,308276
25124,0.000349,172.217.194.0-255,1484,15605,6,308276
25125,0.000355,172.31.36.0-255,66,15671,6,308276
25126,0.000361,172.217.194.0-255,2902,18573,6,308276
25127,0.000364,172.31.36.0-255,66,18639,6,308276
25128,0.000378,172.217.194.0-255,5738,24377,6,308276
25129,0.000381,172.31.36.0-255,66,24443,6,308276
25130,0.000415,172.217.194.0-255,6797,31240,6,308276
25131,0.000418,172.31.36.0-255,66,31306,6,308276
25132,0.000682,172.217.194.0-255,1484,32790,6,308276
25133,0.000688,172.31.36.0-255,66,32856,6,308276
25134,0.000697,172.217.194.0-255,2902,35758,6,308276
25135,0.000699,172.31.36.0-255,66,35824,6,308276
25136,0.000712,172.217.194.0-255,5738,41562,6,308276
25137,0.000716,172.31.36.0-255,66,41628,6,308276
25138,0.000722,172.217.194.0-255,5738,47366,6,308276
25139,0.000724,172.31.36.0-255,66,47432,6,308276
25140,0.000749,172.217.194.0-255,2902,50334,6,308276
25141,0.000752,172.31.36.0-255,66,50400,6,308276
25142,0.000788,172.31.36.0-255,66,50466,6,308276
25143,0.000794,172.217.194.0-255,3961,54427,6,308276
25144,0.000797,172.31.36.0-255,66,54493,6,308276
25145,0.000829,172.217.194.0-255,676,55169,6,308276
25146,0.000832,172.31.36.0-255,66,55235,6,308276
25147,0.000933,172.217.194.0-255,1484,56719,6,308276
25148,0.000939,172.31.36.0-255,66,56785,6,308276
25149,0.000944,172.217.194.0-255,2902,59687,6,308276
25150,0.000946,172.31.36.0-255,66,59753,6,308276
25151,0.000958,172.217.194.0-255,4320,64073,6,308276
25152,0.000961,172.31.36.0-255,66,64139,6,308276
25153,0.000987,172.217.194.0-255,1484,65623,6,308276
25154,0.000994,172.31.36.0-255,66,65689,6,308276
25155,0.001004,172.217.194.0-255,9992,75681,6,308276
25156,0.001007,172.31.36.0-255,66,75747,6,308276
25157,0.001011,172.217.194.0-255,1484,77231,6,308276
25158,0.001012,172.31.36.0-255,66,77297,6,308276
25159,0.001059,172.31.36.0-255,66,77363,6,308276
25160,0.00109,172.217.194.0-255,1484,78847,6,308276
25161,0.001093,172.31.36.0-255,66,78913,6,308276
25162,0.001099,172.217.194.0-255,2902,81815,6,308276
25163,0.001101,172.31.36.0-255,66,81881,6,308276
25164,0.001127,172.217.194.0-255,5738,87619,6,308276
25165,0.00113,172.31.36.0-255,66,87685,6,308276
25166,0.001133,172.217.194.0-255,1484,89169,6,308276
25167,0.00118,172.217.194.0-255,10692,99861,6,308276
25168,0.001659,172.217.194.0-255,1484,101345,6,308276
25169,0.00168,172.217.194.0-255,2902,104247,6,308276
25170,0.001684,172.217.194.0-255,4320,108567,6,308276
25171,0.001689,172.217.194.0-255,2902,111469,6,308276
25172,0.001701,172.217.194.0-255,4320,115789,6,308276
25173,0.001716,172.217.194.0-255,1484,117273,6,308276
25174,0.001719,172.217.194.0-255,1484,118757,6,308276
25175,0.001744,172.217.194.0-255,8574,127331,6,308276
25176,0.001765,172.217.194.0-255,2902,130233,6,308276
25177,0.001776,172.217.194.0-255,3602,133835,6,308276
25178,0.001822,172.217.194.0-255,7156,140991,6,308276
25179,0.00184,172.217.194.0-255,1484,142475,6,308276
25180,0.001857,172.217.194.0-255,7156,149631,6,308276
25181,0.001876,172.217.194.0-255,4320,153951,6,308276
25182,0.001946,172.217.194.0-255,4320,158271,6,308276
25183,0.001969,172.217.194.0-255,9274,167545,6,308276
25184,0.002033,172.217.194.0-255,6438,173983,6,308276
25185,0.002039,172.217.194.0-255,7156,181139,6,308276
25186,0.002045,172.217.194.0-255,5738,186877,6,308276
25187,0.002071,172.217.194.0-255,4320,191197,6,308276
25188,0.002113,172.217.194.0-255,9992,201189,6,308276
25189,0.00212,172.217.194.0-255,6438,207627,6,308276
25190,0.002131,172.217.194.0-255,1484,209111,6,308276
25191,0.002155,172.217.194.0-255,2902,212013,6,308276
25192,0.002158,172.217.194.0-255,1484,213497,6,308276
25193,0.002171,172.217.194.0-255,4320,217817,6,308276
25194,0.002193,172.217.194.0-255,5738,223555,6,308276
25195,0.002205,172.217.194.0-255,1484,225039,6,308276
25196,0.002213,172.217.194.0-255,7156,232195,6,308276
25197,0.002226,172.217.194.0-255,1484,233679,6,308276
25198,0.002231,172.217.194.0-255,4320,237999,6,308276
25199,0.002255,172.217.194.0-255,3602,241601,6,308276
25200,0.002337,172.217.194.0-255,1484,243085,6,308276
25201,0.002343,172.217.194.0-255,2902,245987,6,308276
25202,0.002346,172.217.194.0-255,1484,247471,6,308276
25203,0.002349,172.217.194.0-255,1484,248955,6,308276
25204,0.002372,172.217.194.0-255,7156,256111,6,308276
25205,0.002386,172.217.194.0-255,4320,260431,6,308276
25206,0.00242,172.217.194.0-255,1484,261915,6,308276
25207,0.00244,172.217.194.0-255,2184,264099,6,308276
25208,0.002444,172.217.194.0-255,2902,267001,6,308276
25209,0.002475,172.217.194.0-255,7156,274157,6,308276
25210,0.002483,172.31.36.0-255,66,274223,6,308276
25211,0.002492,172.217.194.0-255,5738,279961,6,308276
25212,0.002516,172.217.194.0-255,9992,289953,6,308276
25213,0.002519,172.217.194.0-255,1484,291437,6,308276
25214,0.00252,172.31.36.0-255,66,291503,6,308276
25215,0.002527,172.31.36.0-255,66,291569,6,308276
25216,0.002584,172.31.36.0-255,66,291635,6,308276
25217,0.002585,172.217.194.0-255,8574,300209,6,308276
25218,0.002589,172.31.36.0-255,66,300275,6,308276
25219,0.002629,172.217.194.0-255,7156,307431,6,308276
25220,0.002632,172.217.194.0-255,503,307934,6,308276
25221,0.002635,172.217.194.0-255,105,308039,6,308276
25222,0.002639,172.31.36.0-255,66,308105,6,308276
25223,0.00544,172.31.36.0-255,105,308210,6,308276
25224,0.007708,172.217.194.0-255,66,308276,6,308276
25225,0.0,172.217.194.0-255,152,152,6,276755
25226,2.3e-05,172.31.36.0-255,66,218,6,276755
25227,2.9e-05,172.217.194.0-255,1484,1702,6,276755
25228,3.3e-05,172.31.36.0-255,66,1768,6,276755
25229,5e-05,172.217.194.0-255,2902,4670,6,276755
25230,5.3e-05,172.31.36.0-255,66,4736,6,276755
25231,8.2e-05,172.217.194.0-255,7156,11892,6,276755
25232,8.6e-05,172.31.36.0-255,66,11958,6,276755
25233,9.2e-05,172.217.194.0-255,2070,14028,6,276755
25234,9.4e-05,172.31.36.0-255,66,14094,6,276755
25235,0.00012,172.217.194.0-255,7156,21250,6,276755
25236,0.000124,172.31.36.0-255,66,21316,6,276755
25237,0.000147,172.217.194.0-255,4320,25636,6,276755
25238,0.000149,172.31.36.0-255,66,25702,6,276755
25239,0.000154,172.217.194.0-255,5379,31081,6,276755
25240,0.000157,172.31.36.0-255,66,31147,6,276755
25241,0.00025,172.217.194.0-255,1484,32631,6,276755
25242,0.000254,172.31.36.0-255,66,32697,6,276755
25243,0.00026,172.217.194.0-255,2902,35599,6,276755
25244,0.000262,172.31.36.0-255,66,35665,6,276755
25245,0.000293,172.217.194.0-255,5738,41403,6,276755
25246,0.000297,172.31.36.0-255,66,41469,6,276755
25247,0.000303,172.217.194.0-255,6797,48266,6,276755
25248,0.000305,172.31.36.0-255,66,48332,6,276755
25249,0.000339,172.31.36.0-255,66,48398,6,276755
25250,0.000343,172.217.194.0-255,2802,51200,6,276755
25251,0.000346,172.31.36.0-255,66,51266,6,276755
25252,0.000378,172.217.194.0-255,427,51693,6,276755
25253,0.000381,172.31.36.0-255,66,51759,6,276755
25254,0.000481,172.217.194.0-255,1484,53243,6,276755
25255,0.000485,172.31.36.0-255,66,53309,6,276755
25256,0.000501,172.217.194.0-255,2902,56211,6,276755
25257,0.000503,172.31.36.0-255,66,56277,6,276755
25258,0.00052,172.217.194.0-255,2902,59179,6,276755
25259,0.000523,172.31.36.0-255,66,59245,6,276755
25260,0.000543,172.217.194.0-255,2902,62147,6,276755
25261,0.000546,172.31.36.0-255,66,62213,6,276755
25262,0.000553,172.217.194.0-255,5738,67951,6,276755
25263,0.000555,172.31.36.0-255,66,68017,6,276755
25264,0.000573,172.217.194.0-255,7156,75173,6,276755
25265,0.000576,172.31.36.0-255,66,75239,6,276755
25266,0.000603,172.217.194.0-255,7156,82395,6,276755
25267,0.000606,172.31.36.0-255,66,82461,6,276755
25268,0.000626,172.217.194.0-255,3602,86063,6,276755
25269,0.000629,172.31.36.0-255,66,86129,6,276755
25270,0.000701,172.217.194.0-255,1484,87613,6,276755
25271,0.000717,172.217.194.0-255,1484,89097,6,276755
25272,0.000721,172.31.36.0-255,66,89163,6,276755
25273,0.000743,172.217.194.0-255,1484,90647,6,276755
25274,0.00075,172.217.194.0-255,5738,96385,6,276755
25275,0.000753,172.31.36.0-255,66,96451,6,276755
25276,0.00076,172.217.194.0-255,7156,103607,6,276755
25277,0.000763,172.31.36.0-255,66,103673,6,276755
25278,0.00077,172.217.194.0-255,8574,112247,6,276755
25279,0.000774,172.31.36.0-255,66,112313,6,276755
25280,0.000798,172.217.194.0-255,5738,118051,6,276755
25281,0.000803,172.31.36.0-255,66,118117,6,276755
25282,0.000811,172.217.194.0-255,2184,120301,6,276755
25283,0.000813,172.31.36.0-255,66,120367,6,276755
25284,0.000968,172.217.194.0-255,1484,121851,6,276755
25285,0.000985,172.217.194.0-255,2902,124753,6,276755
25286,0.00099,172.31.36.0-255,66,124819,6,276755
25287,0.000996,172.217.194.0-255,4320,129139,6,276755
25288,0.000998,172.31.36.0-255,66,129205,6,276755
25289,0.001052,172.217.194.0-255,8574,137779,6,276755
25290,0.001057,172.217.194.0-255,4320,142099,6,276755
25291,0.001057,172.31.36.0-255,66,142165,6,276755
25292,0.001061,172.31.36.0-255,66,142231,6,276755
25293,0.001081,172.217.194.0-255,8574,150805,6,276755
25294,0.001084,172.31.36.0-255,66,150871,6,276755
25295,0.001101,172.217.194.0-255,3602,154473,6,276755
25296,0.001104,172.31.36.0-255,66,154539,6,276755
25297,0.001107,172.217.194.0-255,1484,156023,6,276755
25298,0.001129,172.217.194.0-255,8574,164597,6,276755
25299,0.001132,172.31.36.0-255,66,164663,6,276755
25300,0.001139,172.217.194.0-255,7156,171819,6,276755
25301,0.001142,172.31.36.0-255,66,171885,6,276755
25302,0.001161,172.217.194.0-255,4320,176205,6,276755
25303,0.001164,172.31.36.0-255,66,176271,6,276755
25304,0.001178,172.31.36.0-255,66,176337,6,276755
25305,0.001248,172.217.194.0-255,1484,177821,6,276755
25306,0.001261,172.217.194.0-255,2902,180723,6,276755
25307,0.001264,172.217.194.0-255,1484,182207,6,276755
25308,0.001265,172.31.36.0-255,66,182273,6,276755
25309,0.001287,172.217.194.0-255,4320,186593,6,276755
25310,0.001289,172.31.36.0-255,66,186659,6,276755
25311,0.001305,172.217.194.0-255,4320,190979,6,276755
25312,0.001307,172.31.36.0-255,66,191045,6,276755
25313,0.001329,172.217.194.0-255,8574,199619,6,276755
25314,0.001332,172.31.36.0-255,66,199685,6,276755
25315,0.00134,172.217.194.0-255,8574,208259,6,276755
25316,0.001343,172.31.36.0-255,66,208325,6,276755
25317,0.001354,172.217.194.0-255,1484,209809,6,276755
25318,0.001357,172.217.194.0-255,766,210575,6,276755
25319,0.001359,172.31.36.0-255,66,210641,6,276755
25320,0.001425,172.217.194.0-255,1484,212125,6,276755
25321,0.001431,172.217.194.0-255,2902,215027,6,276755
25322,0.001433,172.31.36.0-255,66,215093,6,276755
25323,0.001437,172.217.194.0-255,1484,216577,6,276755
25324,0.001451,172.217.194.0-255,4320,220897,6,276755
25325,0.001454,172.31.36.0-255,66,220963,6,276755
25326,0.001464,172.217.194.0-255,5738,226701,6,276755
25327,0.001467,172.31.36.0-255,66,226767,6,276755
25328,0.001471,172.217.194.0-255,1484,228251,6,276755
25329,0.00151,172.31.36.0-255,66,228317,6,276755
25330,0.001516,172.217.194.0-255,4320,232637,6,276755
25331,0.001518,172.31.36.0-255,66,232703,6,276755
25332,0.001545,172.31.36.0-255,66,232769,6,276755
25333,0.001554,172.217.194.0-255,9992,242761,6,276755
25334,0.001557,172.31.36.0-255,66,242827,6,276755
25335,0.001582,172.217.194.0-255,7156,249983,6,276755
25336,0.001585,172.31.36.0-255,66,250049,6,276755
25337,0.001591,172.217.194.0-255,5020,255069,6,276755
25338,0.001593,172.31.36.0-255,66,255135,6,276755
25339,0.001627,172.217.194.0-255,7156,262291,6,276755
25340,0.001631,172.31.36.0-255,66,262357,6,276755
25341,0.001675,172.31.36.0-255,66,262423,6,276755
25342,0.001732,172.31.36.0-255,66,262489,6,276755
25343,0.001751,172.217.194.0-255,3602,266091,6,276755
25344,0.001754,172.31.36.0-255,66,266157,6,276755
25345,0.001758,172.217.194.0-255,1484,267641,6,276755
25346,0.001781,172.31.36.0-255,66,267707,6,276755
25347,0.001789,172.217.194.0-255,8574,276281,6,276755
25348,0.001792,172.31.36.0-255,66,276347,6,276755
25349,0.001806,172.31.36.0-255,66,276413,6,276755
25350,0.001809,172.217.194.0-255,105,276518,6,276755
25351,0.003456,172.31.36.0-255,66,276584,6,276755
25352,0.003483,172.31.36.0-255,105,276689,6,276755
25353,0.005697,172.217.194.0-255,66,276755,6,276755
25354,0.0,74.125.130.0-255,152,152,6,283314
25355,1.6e-05,172.31.36.0-255,66,218,6,283314
25356,2.2e-05,74.125.130.0-255,1484,1702,6,283314
25357,2.7e-05,172.31.36.0-255,66,1768,6,283314
25358,3.3e-05,74.125.130.0-255,2902,4670,6,283314
25359,3.6e-05,172.31.36.0-255,66,4736,6,283314
25360,4.2e-05,74.125.130.0-255,2902,7638,6,283314
25361,4.5e-05,172.31.36.0-255,66,7704,6,283314
25362,7.3e-05,74.125.130.0-255,2902,10606,6,283314
25363,7.6e-05,172.31.36.0-255,66,10672,6,283314
25364,8.2e-05,74.125.130.0-255,3437,14109,6,283314
25365,8.4e-05,172.31.36.0-255,66,14175,6,283314
25366,9e-05,74.125.130.0-255,4320,18495,6,283314
25367,9.2e-05,172.31.36.0-255,66,18561,6,283314
25368,0.000107,74.125.130.0-255,4320,22881,6,283314
25369,0.00011,172.31.36.0-255,66,22947,6,283314
25370,0.000126,74.125.130.0-255,5738,28685,6,283314
25371,0.000129,172.31.36.0-255,66,28751,6,283314
25372,0.000133,74.125.130.0-255,2543,31294,6,283314
25373,0.000135,172.31.36.0-255,66,31360,6,283314
25374,0.000261,74.125.130.0-255,1484,32844,6,283314
25375,0.000265,172.31.36.0-255,66,32910,6,283314
25376,0.000271,74.125.130.0-255,2902,35812,6,283314
25377,0.000274,172.31.36.0-255,66,35878,6,283314
25378,0.000291,74.125.130.0-255,5738,41616,6,283314
25379,0.000294,172.31.36.0-255,66,41682,6,283314
25380,0.000321,74.125.130.0-255,5738,47420,6,283314
25381,0.000323,172.31.36.0-255,66,47486,6,283314
25382,0.000351,74.125.130.0-255,8215,55701,6,283314
25383,0.000353,172.31.36.0-255,66,55767,6,283314
25384,0.000365,74.125.130.0-255,1484,57251,6,283314
25385,0.000367,172.31.36.0-255,66,57317,6,283314
25386,0.000381,74.125.130.0-255,2902,60219,6,283314
25387,0.000384,172.31.36.0-255,66,60285,6,283314
25388,0.000411,74.125.130.0-255,5668,65953,6,283314
25389,0.000414,172.31.36.0-255,66,66019,6,283314
25390,0.000417,74.125.130.0-255,365,66384,6,283314
25391,0.000604,74.125.130.0-255,1484,67868,6,283314
25392,0.000609,172.31.36.0-255,66,67934,6,283314
25393,0.000615,74.125.130.0-255,2902,70836,6,283314
25394,0.000617,172.31.36.0-255,66,70902,6,283314
25395,0.000639,74.125.130.0-255,4320,75222,6,283314
25396,0.000642,172.31.36.0-255,66,75288,6,283314
25397,0.000674,74.125.130.0-255,2902,78190,6,283314
25398,0.000677,172.31.36.0-255,66,78256,6,283314
25399,0.000703,74.125.130.0-255,6797,85053,6,283314
25400,0.000705,172.31.36.0-255,66,85119,6,283314
25401,0.000712,74.125.130.0-255,5738,90857,6,283314
25402,0.000714,172.31.36.0-255,66,90923,6,283314
25403,0.000727,74.125.130.0-255,1484,92407,6,283314
25404,0.00075,74.125.130.0-255,8215,100622,6,283314
25405,0.000752,172.31.36.0-255,66,100688,6,283314
25406,0.000818,74.125.130.0-255,1484,102172,6,283314
25407,0.000832,74.125.130.0-255,2902,105074,6,283314
25408,0.000835,172.31.36.0-255,66,105140,6,283314
25409,0.000856,74.125.130.0-255,5738,110878,6,283314
25410,0.000862,172.31.36.0-255,66,110944,6,283314
25411,0.000882,74.125.130.0-255,5738,116682,6,283314
25412,0.000884,172.31.36.0-255,66,116748,6,283314
25413,0.000905,74.125.130.0-255,7156,123904,6,283314
25414,0.000907,172.31.36.0-255,66,123970,6,283314
25415,0.000915,74.125.130.0-255,8574,132544,6,283314
25416,0.000918,172.31.36.0-255,66,132610,6,283314
25417,0.000921,74.125.130.0-255,1484,134094,6,283314
25418,0.000941,74.125.130.0-255,766,134860,6,283314
25419,0.000944,172.31.36.0-255,66,134926,6,283314
25420,0.000959,74.125.130.0-255,2902,137828,6,283314
25421,0.000962,172.31.36.0-255,66,137894,6,283314
25422,0.000991,74.125.130.0-255,4320,142214,6,283314
25423,0.000994,172.31.36.0-255,66,142280,6,283314
25424,0.001013,74.125.130.0-255,2902,145182,6,283314
25425,0.001016,172.31.36.0-255,66,145248,6,283314
25426,0.001025,74.125.130.0-255,8574,153822,6,283314
25427,0.001027,172.31.36.0-255,66,153888,6,283314
25428,0.001056,74.125.130.0-255,7156,161044,6,283314
25429,0.001059,172.31.36.0-255,66,161110,6,283314
25430,0.001077,74.125.130.0-255,2902,164012,6,283314
25431,0.001079,172.31.36.0-255,66,164078,6,283314
25432,0.001085,74.125.130.0-255,5020,169098,6,283314
25433,0.001088,172.31.36.0-255,66,169164,6,283314
25434,0.001164,74.125.130.0-255,1484,170648,6,283314
25435,0.001234,74.125.130.0-255,2902,173550,6,283314
25436,0.001239,172.31.36.0-255,66,173616,6,283314
25437,0.001246,74.125.130.0-255,5738,179354,6,283314
25438,0.001249,172.31.36.0-255,66,179420,6,283314
25439,0.001258,74.125.130.0-255,8574,187994,6,283314
25440,0.00126,172.31.36.0-255,66,188060,6,283314
25441,0.001285,74.125.130.0-255,4320,192380,6,283314
25442,0.001288,172.31.36.0-255,66,192446,6,283314
25443,0.001297,74.125.130.0-255,8574,201020,6,283314
25444,0.0013,172.31.36.0-255,66,201086,6,283314
25445,0.001319,74.125.130.0-255,2184,203270,6,283314
25446,0.001322,172.31.36.0-255,66,203336,6,283314
25447,0.001471,74.125.130.0-255,1484,204820,6,283314
25448,0.001478,74.125.130.0-255,2902,207722,6,283314
25449,0.001483,172.31.36.0-255,66,207788,6,283314
25450,0.001506,74.125.130.0-255,4320,212108,6,283314
25451,0.001509,172.31.36.0-255,66,212174,6,283314
25452,0.001529,74.125.130.0-255,2902,215076,6,283314
25453,0.001531,172.31.36.0-255,66,215142,6,283314
25454,0.001541,74.125.130.0-255,1484,216626,6,283314
25455,0.001563,74.125.130.0-255,4320,220946,6,283314
25456,0.001565,172.31.36.0-255,66,221012,6,283314
25457,0.001569,74.125.130.0-255,1484,222496,6,283314
25458,0.001572,74.125.130.0-255,1484,223980,6,283314
25459,0.001574,172.31.36.0-255,66,224046,6,283314
25460,0.001587,74.125.130.0-255,2902,226948,6,283314
25461,0.00159,172.31.36.0-255,66,227014,6,283314
25462,0.001612,74.125.130.0-255,7156,234170,6,283314
25463,0.001615,172.31.36.0-255,66,234236,6,283314
25464,0.00162,74.125.130.0-255,3602,237838,6,283314
25465,0.001622,172.31.36.0-255,66,237904,6,283314
25466,0.001986,74.125.130.0-255,1484,239388,6,283314
25467,0.001995,74.125.130.0-255,2902,242290,6,283314
25468,0.002,172.31.36.0-255,66,242356,6,283314
25469,0.002006,74.125.130.0-255,4320,246676,6,283314
25470,0.002009,172.31.36.0-255,66,246742,6,283314
25471,0.002013,74.125.130.0-255,1484,248226,6,283314
25472,0.002047,74.125.130.0-255,7156,255382,6,283314
25473,0.00205,172.31.36.0-255,66,255448,6,283314
25474,0.002088,172.31.36.0-255,66,255514,6,283314
25475,0.002177,74.125.130.0-255,1484,256998,6,283314
25476,0.002184,74.125.130.0-255,2902,259900,6,283314
25477,0.002187,172.31.36.0-255,66,259966,6,283314
25478,0.002207,74.125.130.0-255,2902,262868,6,283314
25479,0.00221,172.31.36.0-255,66,262934,6,283314
25480,0.002215,74.125.130.0-255,2902,265836,6,283314
25481,0.002217,172.31.36.0-255,66,265902,6,283314
25482,0.004452,74.125.130.0-255,5738,271640,6,283314
25483,0.004459,172.31.36.0-255,66,271706,6,283314
25484,0.006661,74.125.130.0-255,5738,277444,6,283314
25485,0.006667,172.31.36.0-255,66,277510,6,283314
25486,0.008866,74.125.130.0-255,5738,283248,6,283314
25487,0.008874,172.31.36.0-255,66,283314,6,283314
25488,0.0,172.217.194.0-255,150,150,6,343968
25489,2.2e-05,172.31.36.0-255,66,216,6,343968
25490,3e-05,172.217.194.0-255,1484,1700,6,343968
25491,3.4e-05,172.31.36.0-255,66,1766,6,343968
25492,4e-05,172.217.194.0-255,2902,4668,6,343968
25493,4.3e-05,172.31.36.0-255,66,4734,6,343968
25494,5.2e-05,172.217.194.0-255,7156,11890,6,343968
25495,5.5e-05,172.31.36.0-255,66,11956,6,343968
25496,6.2e-05,172.217.194.0-255,6194,18150,6,343968
25497,6.5e-05,172.31.36.0-255,66,18216,6,343968
25498,7.2e-05,172.217.194.0-255,5738,23954,6,343968
25499,7.5e-05,172.31.36.0-255,66,24020,6,343968
25500,9.7e-05,172.217.194.0-255,1484,25504,6,343968
25501,0.0001,172.31.36.0-255,66,25570,6,343968
25502,0.000138,172.217.194.0-255,5379,30949,6,343968
25503,0.000141,172.31.36.0-255,66,31015,6,343968
25504,0.000263,172.217.194.0-255,1484,32499,6,343968
25505,0.000267,172.31.36.0-255,66,32565,6,343968
25506,0.000273,172.217.194.0-255,2902,35467,6,343968
25507,0.000275,172.31.36.0-255,66,35533,6,343968
25508,0.000278,172.217.194.0-255,1484,37017,6,343968
25509,0.00028,172.31.36.0-255,66,37083,6,343968
25510,0.000294,172.217.194.0-255,4320,41403,6,343968
25511,0.000297,172.31.36.0-255,66,41469,6,343968
25512,0.000328,172.217.194.0-255,6797,48266,6,343968
25513,0.000331,172.31.36.0-255,66,48332,6,343968
25514,0.000564,172.217.194.0-255,1484,49816,6,343968
25515,0.000569,172.31.36.0-255,66,49882,6,343968
25516,0.000576,172.217.194.0-255,2902,52784,6,343968
25517,0.000578,172.31.36.0-255,66,52850,6,343968
25518,0.000605,172.217.194.0-255,5738,58588,6,343968
25519,0.000609,172.31.36.0-255,66,58654,6,343968
25520,0.000612,172.217.194.0-255,1484,60138,6,343968
25521,0.000652,172.217.194.0-255,5379,65517,6,343968
25522,0.000656,172.31.36.0-255,66,65583,6,343968
25523,0.000677,172.217.194.0-255,5738,71321,6,343968
25524,0.00068,172.31.36.0-255,66,71387,6,343968
25525,0.000707,172.217.194.0-255,9992,81379,6,343968
25526,0.00071,172.31.36.0-255,66,81445,6,343968
25527,0.000713,172.217.194.0-255,1484,82929,6,343968
25528,0.000735,172.217.194.0-255,7156,90085,6,343968
25529,0.000738,172.31.36.0-255,66,90151,6,343968
25530,0.000761,172.217.194.0-255,9274,99425,6,343968
25531,0.000764,172.31.36.0-255,66,99491,6,343968
25532,0.000801,172.31.36.0-255,66,99557,6,343968
25533,0.000818,172.217.194.0-255,2902,102459,6,343968
25534,0.00082,172.31.36.0-255,66,102525,6,343968
25535,0.000843,172.217.194.0-255,2529,105054,6,343968
25536,0.000846,172.31.36.0-255,66,105120,6,343968
25537,0.000849,172.217.194.0-255,1484,106604,6,343968
25538,0.000868,172.217.194.0-255,4320,110924,6,343968
25539,0.000871,172.31.36.0-255,66,110990,6,343968
25540,0.000877,172.217.194.0-255,5738,116728,6,343968
25541,0.000879,172.31.36.0-255,66,116794,6,343968
25542,0.000882,172.217.194.0-255,1484,118278,6,343968
25543,0.000921,172.31.36.0-255,66,118344,6,343968
25544,0.00093,172.217.194.0-255,9274,127618,6,343968
25545,0.000932,172.31.36.0-255,66,127684,6,343968
25546,0.000976,172.217.194.0-255,1484,129168,6,343968
25547,0.000992,172.217.194.0-255,2902,132070,6,343968
25548,0.000994,172.217.194.0-255,1484,133554,6,343968
25549,0.000998,172.31.36.0-255,66,133620,6,343968
25550,0.00101,172.217.194.0-255,4320,137940,6,343968
25551,0.001013,172.31.36.0-255,66,138006,6,343968
25552,0.001025,172.217.194.0-255,1484,139490,6,343968
25553,0.001044,172.217.194.0-255,5738,145228,6,343968
25554,0.001047,172.31.36.0-255,66,145294,6,343968
25555,0.001064,172.217.194.0-255,5738,151032,6,343968
25556,0.001067,172.31.36.0-255,66,151098,6,343968
25557,0.001099,172.217.194.0-255,8574,159672,6,343968
25558,0.001102,172.31.36.0-255,66,159738,6,343968
25559,0.001106,172.217.194.0-255,2184,161922,6,343968
25560,0.001109,172.31.36.0-255,66,161988,6,343968
25561,0.00142,172.217.194.0-255,1484,163472,6,343968
25562,0.001427,172.217.194.0-255,2902,166374,6,343968
25563,0.00143,172.31.36.0-255,66,166440,6,343968
25564,0.001453,172.217.194.0-255,4320,170760,6,343968
25565,0.001463,172.31.36.0-255,66,170826,6,343968
25566,0.001466,172.217.194.0-255,1484,172310,6,343968
25567,0.001472,172.217.194.0-255,4320,176630,6,343968
25568,0.001475,172.31.36.0-255,66,176696,6,343968
25569,0.001507,172.217.194.0-255,8574,185270,6,343968
25570,0.00151,172.31.36.0-255,66,185336,6,343968
25571,0.001521,172.217.194.0-255,9992,195328,6,343968
25572,0.001524,172.31.36.0-255,66,195394,6,343968
25573,0.001527,172.217.194.0-255,766,196160,6,343968
25574,0.001624,172.217.194.0-255,1484,197644,6,343968
25575,0.001628,172.31.36.0-255,66,197710,6,343968
25576,0.001633,172.217.194.0-255,2902,200612,6,343968
25577,0.001635,172.31.36.0-255,66,200678,6,343968
25578,0.001679,172.217.194.0-255,5738,206416,6,343968
25579,0.001683,172.31.36.0-255,66,206482,6,343968
25580,0.00169,172.217.194.0-255,4320,210802,6,343968
25581,0.001692,172.31.36.0-255,66,210868,6,343968
25582,0.001723,172.217.194.0-255,8574,219442,6,343968
25583,0.001726,172.31.36.0-255,66,219508,6,343968
25584,0.001736,172.217.194.0-255,9992,229500,6,343968
25585,0.001738,172.31.36.0-255,66,229566,6,343968
25586,0.001807,172.217.194.0-255,10692,240258,6,343968
25587,0.001809,172.217.194.0-255,1484,241742,6,343968
25588,0.001818,172.217.194.0-255,7856,249598,6,343968
25589,0.001826,172.217.194.0-255,8574,258172,6,343968
25590,0.001846,172.217.194.0-255,5738,263910,6,343968
25591,0.001887,172.217.194.0-255,6438,270348,6,343968
25592,0.002183,172.217.194.0-255,1484,271832,6,343968
25593,0.00219,172.217.194.0-255,2902,274734,6,343968
25594,0.002193,172.217.194.0-255,1484,276218,6,343968
25595,0.002219,172.217.194.0-255,4320,280538,6,343968
25596,0.002224,172.217.194.0-255,4320,284858,6,343968
25597,0.00225,172.217.194.0-255,2902,287760,6,343968
25598,0.002271,172.217.194.0-255,8574,296334,6,343968
25599,0.002278,172.217.194.0-255,7156,303490,6,343968
25600,0.002297,172.217.194.0-255,766,304256,6,343968
25601,0.002562,172.217.194.0-255,1484,305740,6,343968
25602,0.002569,172.217.194.0-255,2902,308642,6,343968
25603,0.002576,172.217.194.0-255,4320,312962,6,343968
25604,0.002586,172.217.194.0-255,1484,314446,6,343968
25605,0.002601,172.217.194.0-255,1484,315930,6,343968
25606,0.002619,172.217.194.0-255,8574,324504,6,343968
25607,0.002649,172.217.194.0-255,2902,327406,6,343968
25608,0.002659,172.217.194.0-255,10692,338098,6,343968
25609,0.006147,172.31.36.0-255,66,338164,6,343968
25610,0.008839,172.217.194.0-255,5738,343902,6,343968
25611,0.008847,172.31.36.0-255,66,343968,6,343968
25612,0.0,74.125.68.0-255,150,150,6,169944
25613,2.7e-05,172.31.36.0-255,66,216,6,169944
25614,3.4e-05,74.125.68.0-255,1484,1700,6,169944
25615,3.8e-05,172.31.36.0-255,66,1766,6,169944
25616,4.4e-05,74.125.68.0-255,2902,4668,6,169944
25617,4.6e-05,172.31.36.0-255,66,4734,6,169944
25618,5.2e-05,74.125.68.0-255,4320,9054,6,169944
25619,5.5e-05,172.31.36.0-255,66,9120,6,169944
25620,8.8e-05,74.125.68.0-255,1484,10604,6,169944
25621,9.1e-05,172.31.36.0-255,66,10670,6,169944
25622,0.000111,74.125.68.0-255,7736,18406,6,169944
25623,0.000114,172.31.36.0-255,66,18472,6,169944
25624,0.000194,74.125.68.0-255,2902,21374,6,169944
25625,0.000199,172.31.36.0-255,66,21440,6,169944
25626,0.00022,74.125.68.0-255,1484,22924,6,169944
25627,0.000223,172.31.36.0-255,66,22990,6,169944
25628,0.000264,74.125.68.0-255,8215,31205,6,169944
25629,0.000268,172.31.36.0-255,66,31271,6,169944
25630,0.00032,74.125.68.0-255,1484,32755,6,169944
25631,0.000323,172.31.36.0-255,66,32821,6,169944
25632,0.000343,74.125.68.0-255,2902,35723,6,169944
25633,0.000346,172.31.36.0-255,66,35789,6,169944
25634,0.000376,74.125.68.0-255,5738,41527,6,169944
25635,0.00038,172.31.36.0-255,66,41593,6,169944
25636,0.000431,74.125.68.0-255,7156,48749,6,169944
25637,0.000436,172.31.36.0-255,66,48815,6,169944
25638,0.000459,74.125.68.0-255,6797,55612,6,169944
25639,0.000462,172.31.36.0-255,66,55678,6,169944
25640,0.000584,74.125.68.0-255,4320,59998,6,169944
25641,0.000588,172.31.36.0-255,66,60064,6,169944
25642,0.00061,74.125.68.0-255,5656,65720,6,169944
25643,0.000613,172.31.36.0-255,66,65786,6,169944
25644,0.000747,74.125.68.0-255,5738,71524,6,169944
25645,0.000751,172.31.36.0-255,66,71590,6,169944
25646,0.000783,172.31.36.0-255,66,71656,6,169944
25647,0.000866,74.125.68.0-255,4320,75976,6,169944
25648,0.00087,172.31.36.0-255,66,76042,6,169944
25649,0.000894,172.31.36.0-255,66,76108,6,169944
25650,0.001055,74.125.68.0-255,4320,80428,6,169944
25651,0.001059,172.31.36.0-255,66,80494,6,169944
25652,0.001074,74.125.68.0-255,1484,81978,6,169944
25653,0.001124,74.125.68.0-255,5738,87716,6,169944
25654,0.001127,172.31.36.0-255,66,87782,6,169944
25655,0.001145,74.125.68.0-255,1484,89266,6,169944
25656,0.001184,74.125.68.0-255,1484,90750,6,169944
25657,0.001187,172.31.36.0-255,66,90816,6,169944
25658,0.001231,74.125.68.0-255,5738,96554,6,169944
25659,0.001234,172.31.36.0-255,66,96620,6,169944
25660,0.001261,74.125.68.0-255,8215,104835,6,169944
25661,0.001264,172.31.36.0-255,66,104901,6,169944
25662,0.001358,74.125.68.0-255,4320,109221,6,169944
25663,0.001362,172.31.36.0-255,66,109287,6,169944
25664,0.001398,172.31.36.0-255,66,109353,6,169944
25665,0.001649,74.125.68.0-255,5738,115091,6,169944
25666,0.001653,172.31.36.0-255,66,115157,6,169944
25667,0.001673,74.125.68.0-255,6797,121954,6,169944
25668,0.001675,172.31.36.0-255,66,122020,6,169944
25669,0.001774,74.125.68.0-255,7156,129176,6,169944
25670,0.001777,172.31.36.0-255,66,129242,6,169944
25671,0.001855,74.125.68.0-255,7156,136398,6,169944
25672,0.001858,172.31.36.0-255,66,136464,6,169944
25673,0.0019,172.31.36.0-255,66,136530,6,169944
25674,0.002085,74.125.68.0-255,4320,140850,6,169944
25675,0.002089,172.31.36.0-255,66,140916,6,169944
25676,0.002139,172.31.36.0-255,66,140982,6,169944
25677,0.002564,74.125.68.0-255,8574,149556,6,169944
25678,0.002569,172.31.36.0-255,66,149622,6,169944
25679,0.002616,172.31.36.0-255,66,149688,6,169944
25680,0.002859,74.125.68.0-255,1484,151172,6,169944
25681,0.002891,172.31.36.0-255,66,151238,6,169944
25682,0.002943,172.31.36.0-255,66,151304,6,169944
25683,0.003437,74.125.68.0-255,4320,155624,6,169944
25684,0.003439,172.31.36.0-255,66,155690,6,169944
25685,0.003482,172.31.36.0-255,66,155756,6,169944
25686,0.003508,74.125.68.0-255,2184,157940,6,169944
25687,0.00351,172.31.36.0-255,66,158006,6,169944
25688,0.005733,74.125.68.0-255,2902,160908,6,169944
25689,0.005738,172.31.36.0-255,66,160974,6,169944
25690,0.005759,74.125.68.0-255,1484,162458,6,169944
25691,0.00577,74.125.68.0-255,1484,163942,6,169944
25692,0.005773,172.31.36.0-255,66,164008,6,169944
25693,0.007985,74.125.68.0-255,2902,166910,6,169944
25694,0.007991,172.31.36.0-255,66,166976,6,169944
25695,0.008013,74.125.68.0-255,2902,169878,6,169944
25696,0.008015,172.31.36.0-255,66,169944,6,169944
25697,0.0,172.217.194.0-255,153,153,6,306589
25698,3.7e-05,172.31.36.0-255,66,219,6,306589
25699,4.5e-05,172.217.194.0-255,1484,1703,6,306589
25700,5e-05,172.31.36.0-255,66,1769,6,306589
25701,6.3e-05,172.217.194.0-255,2902,4671,6,306589
25702,6.6e-05,172.31.36.0-255,66,4737,6,306589
25703,7.3e-05,172.217.194.0-255,7156,11893,6,306589
25704,7.7e-05,172.31.36.0-255,66,11959,6,306589
25705,8e-05,172.217.194.0-255,2049,14008,6,306589
25706,8.3e-05,172.31.36.0-255,66,14074,6,306589
25707,8.7e-05,172.217.194.0-255,2902,16976,6,306589
25708,9e-05,172.31.36.0-255,66,17042,6,306589
25709,0.000125,172.217.194.0-255,5738,22780,6,306589
25710,0.000132,172.31.36.0-255,66,22846,6,306589
25711,0.000164,172.217.194.0-255,8215,31061,6,306589
25712,0.000167,172.31.36.0-255,66,31127,6,306589
25713,0.000216,172.217.194.0-255,1484,32611,6,306589
25714,0.000219,172.31.36.0-255,66,32677,6,306589
25715,0.000225,172.217.194.0-255,2902,35579,6,306589
25716,0.000227,172.31.36.0-255,66,35645,6,306589
25717,0.000232,172.217.194.0-255,2902,38547,6,306589
25718,0.00024,172.31.36.0-255,66,38613,6,306589
25719,0.000252,172.217.194.0-255,2902,41515,6,306589
25720,0.000254,172.31.36.0-255,66,41581,6,306589
25721,0.000284,172.217.194.0-255,4320,45901,6,306589
25722,0.000288,172.31.36.0-255,66,45967,6,306589
25723,0.000318,172.217.194.0-255,6797,52764,6,306589
25724,0.000326,172.31.36.0-255,66,52830,6,306589
25725,0.00034,172.31.36.0-255,66,52896,6,306589
25726,0.000343,172.217.194.0-255,1429,54325,6,306589
25727,0.000345,172.31.36.0-255,66,54391,6,306589
25728,0.000347,172.217.194.0-255,382,54773,6,306589
25729,0.000549,172.217.194.0-255,1484,56257,6,306589
25730,0.000554,172.31.36.0-255,66,56323,6,306589
25731,0.00056,172.217.194.0-255,2902,59225,6,306589
25732,0.000562,172.31.36.0-255,66,59291,6,306589
25733,0.000567,172.217.194.0-255,2902,62193,6,306589
25734,0.000575,172.31.36.0-255,66,62259,6,306589
25735,0.000612,172.217.194.0-255,2902,65161,6,306589
25736,0.000615,172.31.36.0-255,66,65227,6,306589
25737,0.000637,172.31.36.0-255,66,65293,6,306589
25738,0.000647,172.217.194.0-255,10692,75985,6,306589
25739,0.00065,172.31.36.0-255,66,76051,6,306589
25740,0.000879,172.217.194.0-255,1484,77535,6,306589
25741,0.000885,172.217.194.0-255,1484,79019,6,306589
25742,0.000888,172.31.36.0-255,66,79085,6,306589
25743,0.000901,172.217.194.0-255,1484,80569,6,306589
25744,0.000912,172.217.194.0-255,5738,86307,6,306589
25745,0.000915,172.31.36.0-255,66,86373,6,306589
25746,0.000924,172.217.194.0-255,8574,94947,6,306589
25747,0.000927,172.31.36.0-255,66,95013,6,306589
25748,0.000972,172.217.194.0-255,4320,99333,6,306589
25749,0.000976,172.31.36.0-255,66,99399,6,306589
25750,0.001013,172.217.194.0-255,10692,110091,6,306589
25751,0.001019,172.31.36.0-255,66,110157,6,306589
25752,0.001063,172.217.194.0-255,1484,111641,6,306589
25753,0.00108,172.217.194.0-255,2902,114543,6,306589
25754,0.001083,172.31.36.0-255,66,114609,6,306589
25755,0.00109,172.217.194.0-255,5738,120347,6,306589
25756,0.001092,172.31.36.0-255,66,120413,6,306589
25757,0.00112,172.217.194.0-255,7156,127569,6,306589
25758,0.001123,172.31.36.0-255,66,127635,6,306589
25759,0.001149,172.217.194.0-255,5738,133373,6,306589
25760,0.001153,172.31.36.0-255,66,133439,6,306589
25761,0.001159,172.217.194.0-255,5738,139177,6,306589
25762,0.001161,172.31.36.0-255,66,139243,6,306589
25763,0.001165,172.217.194.0-255,2902,142145,6,306589
25764,0.001172,172.31.36.0-255,66,142211,6,306589
25765,0.0012,172.217.194.0-255,2184,144395,6,306589
25766,0.001203,172.31.36.0-255,66,144461,6,306589
25767,0.001289,172.217.194.0-255,1484,145945,6,306589
25768,0.001294,172.217.194.0-255,2902,148847,6,306589
25769,0.001297,172.31.36.0-255,66,148913,6,306589
25770,0.001329,172.217.194.0-255,5738,154651,6,306589
25771,0.001333,172.31.36.0-255,66,154717,6,306589
25772,0.001339,172.217.194.0-255,5738,160455,6,306589
25773,0.001343,172.217.194.0-255,4320,164775,6,306589
25774,0.001343,172.31.36.0-255,66,164841,6,306589
25775,0.001347,172.31.36.0-255,66,164907,6,306589
25776,0.001376,172.217.194.0-255,8574,173481,6,306589
25777,0.001384,172.31.36.0-255,66,173547,6,306589
25778,0.00139,172.217.194.0-255,5020,178567,6,306589
25779,0.001393,172.31.36.0-255,66,178633,6,306589
25780,0.00166,172.217.194.0-255,1484,180117,6,306589
25781,0.001666,172.217.194.0-255,2902,183019,6,306589
25782,0.001669,172.31.36.0-255,66,183085,6,306589
25783,0.001701,172.217.194.0-255,5738,188823,6,306589
25784,0.001705,172.31.36.0-255,66,188889,6,306589
25785,0.001746,172.31.36.0-255,66,188955,6,306589
25786,0.001756,172.217.194.0-255,10692,199647,6,306589
25787,0.001765,172.31.36.0-255,66,199713,6,306589
25788,0.001877,172.217.194.0-255,1484,201197,6,306589
25789,0.001883,172.217.194.0-255,2902,204099,6,306589
25790,0.001887,172.31.36.0-255,66,204165,6,306589
25791,0.001896,172.217.194.0-255,4320,208485,6,306589
25792,0.001899,172.31.36.0-255,66,208551,6,306589
25793,0.001917,172.217.194.0-255,1484,210035,6,306589
25794,0.001923,172.217.194.0-255,2902,212937,6,306589
25795,0.00193,172.31.36.0-255,66,213003,6,306589
25796,0.001947,172.217.194.0-255,2902,215905,6,306589
25797,0.001956,172.31.36.0-255,66,215971,6,306589
25798,0.001989,172.217.194.0-255,7156,223127,6,306589
25799,0.001993,172.31.36.0-255,66,223193,6,306589
25800,0.002002,172.217.194.0-255,9992,233185,6,306589
25801,0.002009,172.31.36.0-255,66,233251,6,306589
25802,0.002012,172.217.194.0-255,766,234017,6,306589
25803,0.002045,172.217.194.0-255,1484,235501,6,306589
25804,0.002049,172.31.36.0-255,66,235567,6,306589
25805,0.002054,172.217.194.0-255,2902,238469,6,306589
25806,0.002056,172.31.36.0-255,66,238535,6,306589
25807,0.002059,172.217.194.0-255,1484,240019,6,306589
25808,0.00209,172.217.194.0-255,4320,244339,6,306589
25809,0.002094,172.31.36.0-255,66,244405,6,306589
25810,0.002102,172.217.194.0-255,8574,252979,6,306589
25811,0.002111,172.31.36.0-255,66,253045,6,306589
25812,0.002146,172.217.194.0-255,5738,258783,6,306589
25813,0.00215,172.31.36.0-255,66,258849,6,306589
25814,0.002182,172.217.194.0-255,9274,268123,6,306589
25815,0.002186,172.31.36.0-255,66,268189,6,306589
25816,0.00219,172.217.194.0-255,1484,269673,6,306589
25817,0.002221,172.217.194.0-255,7156,276829,6,306589
25818,0.002224,172.31.36.0-255,66,276895,6,306589
25819,0.002233,172.217.194.0-255,9992,286887,6,306589
25820,0.002241,172.31.36.0-255,66,286953,6,306589
25821,0.002256,172.31.36.0-255,66,287019,6,306589
25822,0.002291,172.217.194.0-255,2184,289203,6,306589
25823,0.002295,172.31.36.0-255,66,289269,6,306589
25824,0.002316,172.31.36.0-255,66,289335,6,306589
25825,0.002324,172.217.194.0-255,9992,299327,6,306589
25826,0.002328,172.31.36.0-255,66,299393,6,306589
25827,0.002363,172.31.36.0-255,66,299459,6,306589
25828,0.00241,172.31.36.0-255,66,299525,6,306589
25829,0.002416,172.217.194.0-255,6656,306181,6,306589
25830,0.00242,172.31.36.0-255,66,306247,6,306589
25831,0.002424,172.217.194.0-255,105,306352,6,306589
25832,0.003468,172.31.36.0-255,66,306418,6,306589
25833,0.003494,172.31.36.0-255,105,306523,6,306589
25834,0.006002,172.217.194.0-255,66,306589,6,306589
25835,0.0,74.125.24.0-255,291,291,6,194089
25836,1.6e-05,172.31.36.0-255,66,357,6,194089
25837,2.2e-05,74.125.24.0-255,1484,1841,6,194089
25838,2.6e-05,172.31.36.0-255,66,1907,6,194089
25839,3.2e-05,74.125.24.0-255,4320,6227,6,194089
25840,3.4e-05,172.31.36.0-255,66,6293,6,194089
25841,3.7e-05,74.125.24.0-255,1484,7777,6,194089
25842,3.8e-05,172.31.36.0-255,66,7843,6,194089
25843,7.1e-05,74.125.24.0-255,7485,15328,6,194089
25844,7.4e-05,172.31.36.0-255,66,15394,6,194089
25845,8.2e-05,74.125.24.0-255,9992,25386,6,194089
25846,8.4e-05,172.31.36.0-255,66,25452,6,194089
25847,0.000109,74.125.24.0-255,5379,30831,6,194089
25848,0.000111,172.31.36.0-255,66,30897,6,194089
25849,0.000195,74.125.24.0-255,1484,32381,6,194089
25850,0.000198,172.31.36.0-255,66,32447,6,194089
25851,0.000202,74.125.24.0-255,1484,33931,6,194089
25852,0.000204,172.31.36.0-255,66,33997,6,194089
25853,0.000223,74.125.24.0-255,1484,35481,6,194089
25854,0.000225,172.31.36.0-255,66,35547,6,194089
25855,0.000231,74.125.24.0-255,5738,41285,6,194089
25856,0.000233,172.31.36.0-255,66,41351,6,194089
25857,0.000266,172.31.36.0-255,66,41417,6,194089
25858,0.000277,172.31.36.0-255,66,41483,6,194089
25859,0.000281,74.125.24.0-255,1125,42608,6,194089
25860,0.000283,172.31.36.0-255,66,42674,6,194089
25861,0.000317,74.125.24.0-255,398,43072,6,194089
25862,0.00032,172.31.36.0-255,66,43138,6,194089
25863,0.000624,74.125.24.0-255,113,43251,6,194089
25864,0.000629,172.31.36.0-255,66,43317,6,194089
25865,0.000649,74.125.24.0-255,332,43649,6,194089
25866,0.001015,172.31.36.0-255,66,43715,6,194089
25867,0.001118,74.125.24.0-255,1484,45199,6,194089
25868,0.001127,74.125.24.0-255,2902,48101,6,194089
25869,0.00113,172.31.36.0-255,66,48167,6,194089
25870,0.001136,74.125.24.0-255,2902,51069,6,194089
25871,0.001138,172.31.36.0-255,66,51135,6,194089
25872,0.00116,74.125.24.0-255,2902,54037,6,194089
25873,0.001162,172.31.36.0-255,66,54103,6,194089
25874,0.00117,74.125.24.0-255,7156,61259,6,194089
25875,0.001171,172.31.36.0-255,66,61325,6,194089
25876,0.001196,74.125.24.0-255,1484,62809,6,194089
25877,0.001226,172.31.36.0-255,66,62875,6,194089
25878,0.00123,74.125.24.0-255,2184,65059,6,194089
25879,0.001232,172.31.36.0-255,66,65125,6,194089
25880,0.001778,74.125.24.0-255,1484,66609,6,194089
25881,0.001786,74.125.24.0-255,2902,69511,6,194089
25882,0.00179,172.31.36.0-255,66,69577,6,194089
25883,0.001798,74.125.24.0-255,5738,75315,6,194089
25884,0.0018,172.31.36.0-255,66,75381,6,194089
25885,0.001827,74.125.24.0-255,4320,79701,6,194089
25886,0.001829,172.31.36.0-255,66,79767,6,194089
25887,0.001856,74.125.24.0-255,8574,88341,6,194089
25888,0.001858,172.31.36.0-255,66,88407,6,194089
25889,0.001863,74.125.24.0-255,2902,91309,6,194089
25890,0.001865,172.31.36.0-255,66,91375,6,194089
25891,0.001884,74.125.24.0-255,7856,99231,6,194089
25892,0.001887,172.31.36.0-255,66,99297,6,194089
25893,0.00191,74.125.24.0-255,2902,102199,6,194089
25894,0.001914,172.31.36.0-255,66,102265,6,194089
25895,0.001943,74.125.24.0-255,7156,109421,6,194089
25896,0.001946,172.31.36.0-255,66,109487,6,194089
25897,0.001959,172.31.36.0-255,66,109553,6,194089
25898,0.001999,172.31.36.0-255,66,109619,6,194089
25899,0.002047,74.125.24.0-255,1484,111103,6,194089
25900,0.002052,74.125.24.0-255,1484,112587,6,194089
25901,0.002054,172.31.36.0-255,66,112653,6,194089
25902,0.002068,74.125.24.0-255,1484,114137,6,194089
25903,0.002075,74.125.24.0-255,5738,119875,6,194089
25904,0.002079,172.31.36.0-255,66,119941,6,194089
25905,0.002096,74.125.24.0-255,7156,127097,6,194089
25906,0.0021,172.31.36.0-255,66,127163,6,194089
25907,0.002116,74.125.24.0-255,5738,132901,6,194089
25908,0.002118,172.31.36.0-255,66,132967,6,194089
25909,0.002129,74.125.24.0-255,10692,143659,6,194089
25910,0.002132,172.31.36.0-255,66,143725,6,194089
25911,0.002279,74.125.24.0-255,1484,145209,6,194089
25912,0.002287,74.125.24.0-255,2902,148111,6,194089
25913,0.002293,172.31.36.0-255,66,148177,6,194089
25914,0.002313,74.125.24.0-255,2902,151079,6,194089
25915,0.002317,172.31.36.0-255,66,151145,6,194089
25916,0.002334,74.125.24.0-255,2902,154047,6,194089
25917,0.002336,172.31.36.0-255,66,154113,6,194089
25918,0.002355,74.125.24.0-255,4320,158433,6,194089
25919,0.002357,172.31.36.0-255,66,158499,6,194089
25920,0.002387,74.125.24.0-255,8574,167073,6,194089
25921,0.002389,172.31.36.0-255,66,167139,6,194089
25922,0.002398,74.125.24.0-255,8574,175713,6,194089
25923,0.002401,172.31.36.0-255,66,175779,6,194089
25924,0.002405,74.125.24.0-255,2184,177963,6,194089
25925,0.002408,172.31.36.0-255,66,178029,6,194089
25926,0.004704,74.125.24.0-255,4320,182349,6,194089
25927,0.004708,172.31.36.0-255,66,182415,6,194089
25928,0.004722,74.125.24.0-255,1484,183899,6,194089
25929,0.007053,74.125.24.0-255,4320,188219,6,194089
25930,0.00706,172.31.36.0-255,66,188285,6,194089
25931,0.00943,74.125.24.0-255,5738,194023,6,194089
25932,0.009437,172.31.36.0-255,66,194089,6,194089
25933,0.0,74.125.24.0-255,150,150,6,169954
25934,2.4e-05,172.31.36.0-255,66,216,6,169954
25935,2.9e-05,74.125.24.0-255,1484,1700,6,169954
25936,3.2e-05,172.31.36.0-255,66,1766,6,169954
25937,3.8e-05,74.125.24.0-255,2902,4668,6,169954
25938,4.1e-05,172.31.36.0-255,66,4734,6,169954
25939,5.6e-05,74.125.24.0-255,2902,7636,6,169954
25940,5.8e-05,172.31.36.0-255,66,7702,6,169954
25941,7.5e-05,74.125.24.0-255,4320,12022,6,169954
25942,7.7e-05,172.31.36.0-255,66,12088,6,169954
25943,8.1e-05,74.125.24.0-255,2104,14192,6,169954
25944,8.4e-05,172.31.36.0-255,66,14258,6,169954
25945,0.000139,74.125.24.0-255,1484,15742,6,169954
25946,0.000142,172.31.36.0-255,66,15808,6,169954
25947,0.000147,74.125.24.0-255,2902,18710,6,169954
25948,0.00015,172.31.36.0-255,66,18776,6,169954
25949,0.000155,74.125.24.0-255,2902,21678,6,169954
25950,0.000156,172.31.36.0-255,66,21744,6,169954
25951,0.000179,74.125.24.0-255,2902,24646,6,169954
25952,0.000182,172.31.36.0-255,66,24712,6,169954
25953,0.000188,74.125.24.0-255,5738,30450,6,169954
25954,0.000191,172.31.36.0-255,66,30516,6,169954
25955,0.000233,74.125.24.0-255,1125,31641,6,169954
25956,0.000236,172.31.36.0-255,66,31707,6,169954
25957,0.000351,74.125.24.0-255,1484,33191,6,169954
25958,0.000356,172.31.36.0-255,66,33257,6,169954
25959,0.000361,74.125.24.0-255,2902,36159,6,169954
25960,0.000364,172.31.36.0-255,66,36225,6,169954
25961,0.000367,74.125.24.0-255,1484,37709,6,169954
25962,0.000369,172.31.36.0-255,66,37775,6,169954
25963,0.000387,74.125.24.0-255,4320,42095,6,169954
25964,0.00039,172.31.36.0-255,66,42161,6,169954
25965,0.000397,74.125.24.0-255,5738,47899,6,169954
25966,0.000399,172.31.36.0-255,66,47965,6,169954
25967,0.00042,74.125.24.0-255,1484,49449,6,169954
25968,0.000456,172.31.36.0-255,66,49515,6,169954
25969,0.000461,74.125.24.0-255,4234,53749,6,169954
25970,0.000463,172.31.36.0-255,66,53815,6,169954
25971,0.000502,74.125.24.0-255,128,53943,6,169954
25972,0.000666,74.125.24.0-255,1484,55427,6,169954
25973,0.00067,172.31.36.0-255,66,55493,6,169954
25974,0.000676,74.125.24.0-255,2902,58395,6,169954
25975,0.000678,172.31.36.0-255,66,58461,6,169954
25976,0.000703,74.125.24.0-255,5738,64199,6,169954
25977,0.000706,172.31.36.0-255,66,64265,6,169954
25978,0.000713,74.125.24.0-255,6797,71062,6,169954
25979,0.000715,172.31.36.0-255,66,71128,6,169954
25980,0.000718,74.125.24.0-255,1484,72612,6,169954
25981,0.000756,172.31.36.0-255,66,72678,6,169954
25982,0.00076,74.125.24.0-255,1484,74162,6,169954
25983,0.000772,74.125.24.0-255,1388,75550,6,169954
25984,0.000774,172.31.36.0-255,66,75616,6,169954
25985,0.000946,74.125.24.0-255,1484,77100,6,169954
25986,0.000951,74.125.24.0-255,2902,80002,6,169954
25987,0.000954,172.31.36.0-255,66,80068,6,169954
25988,0.000957,74.125.24.0-255,1484,81552,6,169954
25989,0.000976,74.125.24.0-255,4320,85872,6,169954
25990,0.000979,172.31.36.0-255,66,85938,6,169954
25991,0.001008,172.31.36.0-255,66,86004,6,169954
25992,0.001017,74.125.24.0-255,8574,94578,6,169954
25993,0.00102,172.31.36.0-255,66,94644,6,169954
25994,0.00104,74.125.24.0-255,1484,96128,6,169954
25995,0.001043,74.125.24.0-255,766,96894,6,169954
25996,0.001046,172.31.36.0-255,66,96960,6,169954
25997,0.001694,74.125.24.0-255,1484,98444,6,169954
25998,0.001726,74.125.24.0-255,1484,99928,6,169954
25999,0.001731,172.31.36.0-255,66,99994,6,169954
26000,0.001737,74.125.24.0-255,2902,102896,6,169954
26001,0.001739,172.31.36.0-255,66,102962,6,169954
26002,0.001743,74.125.24.0-255,1484,104446,6,169954
26003,0.001769,74.125.24.0-255,4320,108766,6,169954
26004,0.001772,172.31.36.0-255,66,108832,6,169954
26005,0.00178,74.125.24.0-255,5738,114570,6,169954
26006,0.001782,172.31.36.0-255,66,114636,6,169954
26007,0.00181,74.125.24.0-255,7156,121792,6,169954
26008,0.001814,172.31.36.0-255,66,121858,6,169954
26009,0.001841,74.125.24.0-255,9274,131132,6,169954
26010,0.001844,172.31.36.0-255,66,131198,6,169954
26011,0.002061,74.125.24.0-255,1484,132682,6,169954
26012,0.002089,74.125.24.0-255,2902,135584,6,169954
26013,0.002093,172.31.36.0-255,66,135650,6,169954
26014,0.0021,74.125.24.0-255,5738,141388,6,169954
26015,0.002104,172.31.36.0-255,66,141454,6,169954
26016,0.002148,172.31.36.0-255,66,141520,6,169954
26017,0.002155,74.125.24.0-255,7156,148676,6,169954
26018,0.002158,172.31.36.0-255,66,148742,6,169954
26019,0.002175,74.125.24.0-255,1484,150226,6,169954
26020,0.00219,74.125.24.0-255,2184,152410,6,169954
26021,0.002193,172.31.36.0-255,66,152476,6,169954
26022,0.004481,74.125.24.0-255,1484,153960,6,169954
26023,0.004538,74.125.24.0-255,4320,158280,6,169954
26024,0.004541,172.31.36.0-255,66,158346,6,169954
26025,0.006881,74.125.24.0-255,5738,164084,6,169954
26026,0.006887,172.31.36.0-255,66,164150,6,169954
26027,0.009246,74.125.24.0-255,5738,169888,6,169954
26028,0.009252,172.31.36.0-255,66,169954,6,169954
26029,0.0,74.125.130.0-255,153,153,6,158918
26030,1.9e-05,172.31.36.0-255,66,219,6,158918
26031,2.6e-05,74.125.130.0-255,1484,1703,6,158918
26032,3e-05,172.31.36.0-255,66,1769,6,158918
26033,3.4e-05,74.125.130.0-255,1484,3253,6,158918
26034,3.6e-05,172.31.36.0-255,66,3319,6,158918
26035,4.2e-05,74.125.130.0-255,2902,6221,6,158918
26036,4.5e-05,172.31.36.0-255,66,6287,6,158918
26037,6.6e-05,74.125.130.0-255,5738,12025,6,158918
26038,7e-05,172.31.36.0-255,66,12091,6,158918
26039,8.6e-05,74.125.130.0-255,2077,14168,6,158918
26040,8.9e-05,172.31.36.0-255,66,14234,6,158918
26041,0.000228,74.125.130.0-255,1484,15718,6,158918
26042,0.000233,172.31.36.0-255,66,15784,6,158918
26043,0.000255,74.125.130.0-255,2902,18686,6,158918
26044,0.000258,172.31.36.0-255,66,18752,6,158918
26045,0.000264,74.125.130.0-255,4320,23072,6,158918
26046,0.000266,172.31.36.0-255,66,23138,6,158918
26047,0.000279,74.125.130.0-255,1484,24622,6,158918
26048,0.000281,172.31.36.0-255,66,24688,6,158918
26049,0.000286,74.125.130.0-255,2902,27590,6,158918
26050,0.000288,172.31.36.0-255,66,27656,6,158918
26051,0.000314,74.125.130.0-255,3961,31617,6,158918
26052,0.000317,172.31.36.0-255,66,31683,6,158918
26053,0.000651,74.125.130.0-255,1484,33167,6,158918
26054,0.000656,172.31.36.0-255,66,33233,6,158918
26055,0.000662,74.125.130.0-255,2902,36135,6,158918
26056,0.000664,172.31.36.0-255,66,36201,6,158918
26057,0.00069,74.125.130.0-255,5738,41939,6,158918
26058,0.000692,172.31.36.0-255,66,42005,6,158918
26059,0.000698,74.125.130.0-255,2902,44907,6,158918
26060,0.0007,172.31.36.0-255,66,44973,6,158918
26061,0.000723,74.125.130.0-255,3961,48934,6,158918
26062,0.000725,172.31.36.0-255,66,49000,6,158918
26063,0.000757,74.125.130.0-255,7156,56156,6,158918
26064,0.00076,172.31.36.0-255,66,56222,6,158918
26065,0.000766,74.125.130.0-255,5738,61960,6,158918
26066,0.000768,172.31.36.0-255,66,62026,6,158918
26067,0.000784,74.125.130.0-255,2902,64928,6,158918
26068,0.000786,172.31.36.0-255,66,64994,6,158918
26069,0.000789,74.125.130.0-255,1125,66119,6,158918
26070,0.000822,74.125.130.0-255,645,66764,6,158918
26071,0.000825,172.31.36.0-255,66,66830,6,158918
26072,0.00109,74.125.130.0-255,1484,68314,6,158918
26073,0.001096,74.125.130.0-255,2902,71216,6,158918
26074,0.001099,172.31.36.0-255,66,71282,6,158918
26075,0.001105,74.125.130.0-255,4320,75602,6,158918
26076,0.001107,172.31.36.0-255,66,75668,6,158918
26077,0.001145,74.125.130.0-255,8574,84242,6,158918
26078,0.001147,172.31.36.0-255,66,84308,6,158918
26079,0.001153,74.125.130.0-255,4320,88628,6,158918
26080,0.001154,172.31.36.0-255,66,88694,6,158918
26081,0.001166,74.125.130.0-255,1484,90178,6,158918
26082,0.001174,74.125.130.0-255,7156,97334,6,158918
26083,0.001176,172.31.36.0-255,66,97400,6,158918
26084,0.001205,74.125.130.0-255,3602,101002,6,158918
26085,0.001207,172.31.36.0-255,66,101068,6,158918
26086,0.001823,74.125.130.0-255,1484,102552,6,158918
26087,0.001833,74.125.130.0-255,2902,105454,6,158918
26088,0.001838,172.31.36.0-255,66,105520,6,158918
26089,0.001845,74.125.130.0-255,5738,111258,6,158918
26090,0.001847,172.31.36.0-255,66,111324,6,158918
26091,0.001851,74.125.130.0-255,1484,112808,6,158918
26092,0.00187,74.125.130.0-255,1484,114292,6,158918
26093,0.001873,172.31.36.0-255,66,114358,6,158918
26094,0.001879,74.125.130.0-255,4320,118678,6,158918
26095,0.001881,172.31.36.0-255,66,118744,6,158918
26096,0.001916,74.125.130.0-255,8574,127318,6,158918
26097,0.001919,172.31.36.0-255,66,127384,6,158918
26098,0.001922,74.125.130.0-255,1484,128868,6,158918
26099,0.001926,74.125.130.0-255,2902,131770,6,158918
26100,0.001928,172.31.36.0-255,66,131836,6,158918
26101,0.001965,74.125.130.0-255,3602,135438,6,158918
26102,0.001968,172.31.36.0-255,66,135504,6,158918
26103,0.003908,74.125.130.0-255,1484,136988,6,158918
26104,0.00395,74.125.130.0-255,4320,141308,6,158918
26105,0.003956,172.31.36.0-255,66,141374,6,158918
26106,0.005936,74.125.130.0-255,2902,144276,6,158918
26107,0.005939,172.31.36.0-255,66,144342,6,158918
26108,0.005958,74.125.130.0-255,2902,147244,6,158918
26109,0.00596,172.31.36.0-255,66,147310,6,158918
26110,0.007932,74.125.130.0-255,5738,153048,6,158918
26111,0.00794,172.31.36.0-255,66,153114,6,158918
26112,0.009958,74.125.130.0-255,5738,158852,6,158918
26113,0.009969,172.31.36.0-255,66,158918,6,158918
26114,0.0,74.125.24.0-255,153,153,6,112058
26115,1.9e-05,172.31.36.0-255,66,219,6,112058
26116,2.6e-05,74.125.24.0-255,1484,1703,6,112058
26117,3e-05,172.31.36.0-255,66,1769,6,112058
26118,3.5e-05,74.125.24.0-255,2902,4671,6,112058
26119,4.8e-05,172.31.36.0-255,66,4737,6,112058
26120,5.6e-05,74.125.24.0-255,7156,11893,6,112058
26121,5.9e-05,172.31.36.0-255,66,11959,6,112058
26122,6.3e-05,74.125.24.0-255,2056,14015,6,112058
26123,6.6e-05,172.31.36.0-255,66,14081,6,112058
26124,0.000111,74.125.24.0-255,1484,15565,6,112058
26125,0.000113,172.31.36.0-255,66,15631,6,112058
26126,0.00014,74.125.24.0-255,2902,18533,6,112058
26127,0.000143,172.31.36.0-255,66,18599,6,112058
26128,0.00015,74.125.24.0-255,5738,24337,6,112058
26129,0.000153,172.31.36.0-255,66,24403,6,112058
26130,0.000162,74.125.24.0-255,4320,28723,6,112058
26131,0.000164,172.31.36.0-255,66,28789,6,112058
26132,0.000195,74.125.24.0-255,2543,31332,6,112058
26133,0.000197,172.31.36.0-255,66,31398,6,112058
26134,0.000433,74.125.24.0-255,1484,32882,6,112058
26135,0.000438,172.31.36.0-255,66,32948,6,112058
26136,0.000444,74.125.24.0-255,2902,35850,6,112058
26137,0.000447,172.31.36.0-255,66,35916,6,112058
26138,0.000452,74.125.24.0-255,2902,38818,6,112058
26139,0.000459,172.31.36.0-255,66,38884,6,112058
26140,0.000495,74.125.24.0-255,1484,40368,6,112058
26141,0.000497,172.31.36.0-255,66,40434,6,112058
26142,0.000505,74.125.24.0-255,5738,46172,6,112058
26143,0.000507,172.31.36.0-255,66,46238,6,112058
26144,0.000526,172.31.36.0-255,66,46304,6,112058
26145,0.000532,74.125.24.0-255,5738,52042,6,112058
26146,0.000535,172.31.36.0-255,66,52108,6,112058
26147,0.000582,74.125.24.0-255,1125,53233,6,112058
26148,0.000812,74.125.24.0-255,645,53878,6,112058
26149,0.000816,172.31.36.0-255,66,53944,6,112058
26150,0.000961,74.125.24.0-255,1484,55428,6,112058
26151,0.000977,74.125.24.0-255,2902,58330,6,112058
26152,0.00098,172.31.36.0-255,66,58396,6,112058
26153,0.000985,74.125.24.0-255,2902,61298,6,112058
26154,0.000987,172.31.36.0-255,66,61364,6,112058
26155,0.001009,74.125.24.0-255,2902,64266,6,112058
26156,0.001011,172.31.36.0-255,66,64332,6,112058
26157,0.001021,74.125.24.0-255,2902,67234,6,112058
26158,0.001023,172.31.36.0-255,66,67300,6,112058
26159,0.001061,74.125.24.0-255,8574,75874,6,112058
26160,0.001081,172.31.36.0-255,66,75940,6,112058
26161,0.001084,172.31.36.0-255,66,76006,6,112058
26162,0.001115,74.125.24.0-255,1484,77490,6,112058
26163,0.001131,74.125.24.0-255,2902,80392,6,112058
26164,0.001133,172.31.36.0-255,66,80458,6,112058
26165,0.001138,74.125.24.0-255,1484,81942,6,112058
26166,0.001163,74.125.24.0-255,4320,86262,6,112058
26167,0.001166,172.31.36.0-255,66,86328,6,112058
26168,0.001171,74.125.24.0-255,2902,89230,6,112058
26169,0.001173,172.31.36.0-255,66,89296,6,112058
26170,0.001196,74.125.24.0-255,4320,93616,6,112058
26171,0.001216,74.125.24.0-255,2184,95800,6,112058
26172,0.001221,172.31.36.0-255,66,95866,6,112058
26173,0.001228,172.31.36.0-255,66,95932,6,112058
26174,0.001231,172.31.36.0-255,66,95998,6,112058
26175,0.003515,74.125.24.0-255,5738,101736,6,112058
26176,0.003523,172.31.36.0-255,66,101802,6,112058
26177,0.005815,74.125.24.0-255,4320,106122,6,112058
26178,0.005818,172.31.36.0-255,66,106188,6,112058
26179,0.005844,74.125.24.0-255,1484,107672,6,112058
26180,0.008139,74.125.24.0-255,4320,111992,6,112058
26181,0.008146,172.31.36.0-255,66,112058,6,112058
26182,0.0,74.125.24.0-255,153,153,6,243644
26183,2.7e-05,172.31.36.0-255,66,219,6,243644
26184,3.2e-05,74.125.24.0-255,1484,1703,6,243644
26185,3.6e-05,172.31.36.0-255,66,1769,6,243644
26186,4.2e-05,74.125.24.0-255,2902,4671,6,243644
26187,4.5e-05,172.31.36.0-255,66,4737,6,243644
26188,5.3e-05,74.125.24.0-255,7156,11893,6,243644
26189,5.6e-05,172.31.36.0-255,66,11959,6,243644
26190,9.8e-05,74.125.24.0-255,3430,15389,6,243644
26191,0.000101,172.31.36.0-255,66,15455,6,243644
26192,0.000106,74.125.24.0-255,4320,19775,6,243644
26193,0.000109,172.31.36.0-255,66,19841,6,243644
26194,0.000113,74.125.24.0-255,2902,22743,6,243644
26195,0.000116,172.31.36.0-255,66,22809,6,243644
26196,0.00014,74.125.24.0-255,7156,29965,6,243644
26197,0.000143,172.31.36.0-255,66,30031,6,243644
26198,0.000146,74.125.24.0-255,1125,31156,6,243644
26199,0.000149,172.31.36.0-255,66,31222,6,243644
26200,0.000241,74.125.24.0-255,1484,32706,6,243644
26201,0.000245,172.31.36.0-255,66,32772,6,243644
26202,0.00025,74.125.24.0-255,2902,35674,6,243644
26203,0.000254,172.31.36.0-255,66,35740,6,243644
26204,0.000259,74.125.24.0-255,2902,38642,6,243644
26205,0.000261,172.31.36.0-255,66,38708,6,243644
26206,0.000268,74.125.24.0-255,7156,45864,6,243644
26207,0.00027,172.31.36.0-255,66,45930,6,243644
26208,0.000291,74.125.24.0-255,8574,54504,6,243644
26209,0.000295,172.31.36.0-255,66,54570,6,243644
26210,0.000316,74.125.24.0-255,8215,62785,6,243644
26211,0.00032,172.31.36.0-255,66,62851,6,243644
26212,0.000324,74.125.24.0-255,2543,65394,6,243644
26213,0.000327,172.31.36.0-255,66,65460,6,243644
26214,0.00033,74.125.24.0-255,413,65873,6,243644
26215,0.000372,74.125.24.0-255,332,66205,6,243644
26216,0.00057,74.125.24.0-255,1484,67689,6,243644
26217,0.000578,74.125.24.0-255,2902,70591,6,243644
26218,0.00058,74.125.24.0-255,1484,72075,6,243644
26219,0.000593,74.125.24.0-255,4320,76395,6,243644
26220,0.000597,74.125.24.0-255,2902,79297,6,243644
26221,0.000611,74.125.24.0-255,1484,80781,6,243644
26222,0.000617,74.125.24.0-255,5738,86519,6,243644
26223,0.000639,74.125.24.0-255,5738,92257,6,243644
26224,0.000643,74.125.24.0-255,1484,93741,6,243644
26225,0.000661,74.125.24.0-255,6438,100179,6,243644
26226,0.00081,74.125.24.0-255,1484,101663,6,243644
26227,0.000816,74.125.24.0-255,2902,104565,6,243644
26228,0.000819,74.125.24.0-255,1484,106049,6,243644
26229,0.000837,74.125.24.0-255,4320,110369,6,243644
26230,0.000896,74.125.24.0-255,2902,113271,6,243644
26231,0.000915,74.125.24.0-255,9274,122545,6,243644
26232,0.00134,74.125.24.0-255,1484,124029,6,243644
26233,0.001346,74.125.24.0-255,1484,125513,6,243644
26234,0.001356,74.125.24.0-255,1484,126997,6,243644
26235,0.001364,74.125.24.0-255,5738,132735,6,243644
26236,0.001417,74.125.24.0-255,10692,143427,6,243644
26237,0.001598,74.125.24.0-255,1484,144911,6,243644
26238,0.001615,74.125.24.0-255,2902,147813,6,243644
26239,0.001621,74.125.24.0-255,5738,153551,6,243644
26240,0.001643,74.125.24.0-255,2902,156453,6,243644
26241,0.00166,74.125.24.0-255,9992,166445,6,243644
26242,0.001666,74.125.24.0-255,7156,173601,6,243644
26243,0.001705,74.125.24.0-255,3602,177203,6,243644
26244,0.001768,74.125.24.0-255,1484,178687,6,243644
26245,0.001772,74.125.24.0-255,2902,181589,6,243644
26246,0.001795,74.125.24.0-255,5738,187327,6,243644
26247,0.001847,74.125.24.0-255,4320,191647,6,243644
26248,0.001886,74.125.24.0-255,8574,200221,6,243644
26249,0.001917,74.125.24.0-255,4320,204541,6,243644
26250,0.001969,74.125.24.0-255,4320,208861,6,243644
26251,0.002003,74.125.24.0-255,6438,215299,6,243644
26252,0.002039,74.125.24.0-255,4320,219619,6,243644
26253,0.002076,74.125.24.0-255,7856,227475,6,243644
26254,0.002082,74.125.24.0-255,5738,233213,6,243644
26255,0.002141,74.125.24.0-255,9992,243205,6,243644
26256,0.002185,74.125.24.0-255,97,243302,6,243644
26257,0.002187,74.125.24.0-255,105,243407,6,243644
26258,0.004053,172.31.36.0-255,66,243473,6,243644
26259,0.006829,172.31.36.0-255,105,243578,6,243644
26260,0.00935,74.125.24.0-255,66,243644,6,243644
26261,0.0,74.125.200.0-255,297,297,6,194073
26262,3.1e-05,172.31.36.0-255,66,363,6,194073
26263,3.8e-05,74.125.200.0-255,1484,1847,6,194073
26264,4.2e-05,172.31.36.0-255,66,1913,6,194073
26265,4.7e-05,74.125.200.0-255,2902,4815,6,194073
26266,5e-05,172.31.36.0-255,66,4881,6,194073
26267,5.5e-05,74.125.200.0-255,4320,9201,6,194073
26268,5.7e-05,172.31.36.0-255,66,9267,6,194073
26269,0.000144,74.125.200.0-255,8933,18200,6,194073
26270,0.000149,172.31.36.0-255,66,18266,6,194073
26271,0.000158,74.125.200.0-255,8574,26840,6,194073
26272,0.00016,172.31.36.0-255,66,26906,6,194073
26273,0.000177,74.125.200.0-255,1484,28390,6,194073
26274,0.000179,172.31.36.0-255,66,28456,6,194073
26275,0.000183,74.125.200.0-255,2543,30999,6,194073
26276,0.000185,172.31.36.0-255,66,31065,6,194073
26277,0.000209,74.125.200.0-255,1484,32549,6,194073
26278,0.000212,172.31.36.0-255,66,32615,6,194073
26279,0.000215,74.125.200.0-255,1484,34099,6,194073
26280,0.000217,172.31.36.0-255,66,34165,6,194073
26281,0.000232,74.125.200.0-255,1484,35649,6,194073
26282,0.000234,172.31.36.0-255,66,35715,6,194073
26283,0.00025,74.125.200.0-255,4320,40035,6,194073
26284,0.000253,172.31.36.0-255,66,40101,6,194073
26285,0.000265,74.125.200.0-255,1484,41585,6,194073
26286,0.000268,172.31.36.0-255,66,41651,6,194073
26287,0.000275,74.125.200.0-255,6797,48448,6,194073
26288,0.000278,172.31.36.0-255,66,48514,6,194073
26289,0.000308,74.125.200.0-255,5738,54252,6,194073
26290,0.000312,172.31.36.0-255,66,54318,6,194073
26291,0.000331,74.125.200.0-255,1484,55802,6,194073
26292,0.000335,172.31.36.0-255,66,55868,6,194073
26293,0.000342,74.125.200.0-255,7156,63024,6,194073
26294,0.000345,172.31.36.0-255,66,63090,6,194073
26295,0.00036,74.125.200.0-255,1484,64574,6,194073
26296,0.000364,74.125.200.0-255,1401,65975,6,194073
26297,0.000367,172.31.36.0-255,66,66041,6,194073
26298,0.00038,74.125.200.0-255,129,66170,6,194073
26299,0.000495,74.125.200.0-255,1484,67654,6,194073
26300,0.000498,172.31.36.0-255,66,67720,6,194073
26301,0.000504,74.125.200.0-255,2902,70622,6,194073
26302,0.000507,172.31.36.0-255,66,70688,6,194073
26303,0.000537,74.125.200.0-255,5738,76426,6,194073
26304,0.000541,172.31.36.0-255,66,76492,6,194073
26305,0.000546,74.125.200.0-255,2902,79394,6,194073
26306,0.000548,172.31.36.0-255,66,79460,6,194073
26307,0.000564,74.125.200.0-255,4320,83780,6,194073
26308,0.000566,172.31.36.0-255,66,83846,6,194073
26309,0.000574,74.125.200.0-255,7156,91002,6,194073
26310,0.000576,172.31.36.0-255,66,91068,6,194073
26311,0.000613,74.125.200.0-255,1484,92552,6,194073
26312,0.000623,74.125.200.0-255,7856,100408,6,194073
26313,0.000627,172.31.36.0-255,66,100474,6,194073
26314,0.000631,74.125.200.0-255,349,100823,6,194073
26315,0.001099,172.31.36.0-255,66,100889,6,194073
26316,0.001108,74.125.200.0-255,1484,102373,6,194073
26317,0.001129,74.125.200.0-255,2902,105275,6,194073
26318,0.001133,172.31.36.0-255,66,105341,6,194073
26319,0.001137,74.125.200.0-255,1484,106825,6,194073
26320,0.001157,74.125.200.0-255,4320,111145,6,194073
26321,0.001159,172.31.36.0-255,66,111211,6,194073
26322,0.001172,172.31.36.0-255,66,111277,6,194073
26323,0.001217,74.125.200.0-255,4320,115597,6,194073
26324,0.00122,172.31.36.0-255,66,115663,6,194073
26325,0.001244,74.125.200.0-255,5738,121401,6,194073
26326,0.001247,172.31.36.0-255,66,121467,6,194073
26327,0.00125,74.125.200.0-255,766,122233,6,194073
26328,0.001308,74.125.200.0-255,1484,123717,6,194073
26329,0.001312,74.125.200.0-255,1484,125201,6,194073
26330,0.001313,172.31.36.0-255,66,125267,6,194073
26331,0.001316,74.125.200.0-255,2902,128169,6,194073
26332,0.001318,172.31.36.0-255,66,128235,6,194073
26333,0.001368,74.125.200.0-255,4320,132555,6,194073
26334,0.001371,172.31.36.0-255,66,132621,6,194073
26335,0.001394,74.125.200.0-255,1484,134105,6,194073
26336,0.001404,74.125.200.0-255,9992,144097,6,194073
26337,0.001407,172.31.36.0-255,66,144163,6,194073
26338,0.001415,172.31.36.0-255,66,144229,6,194073
26339,0.001418,74.125.200.0-255,766,144995,6,194073
26340,0.001682,172.31.36.0-255,66,145061,6,194073
26341,0.001824,74.125.200.0-255,1484,146545,6,194073
26342,0.001834,74.125.200.0-255,2902,149447,6,194073
26343,0.001839,172.31.36.0-255,66,149513,6,194073
26344,0.001845,74.125.200.0-255,2902,152415,6,194073
26345,0.001847,172.31.36.0-255,66,152481,6,194073
26346,0.001863,74.125.200.0-255,2902,155383,6,194073
26347,0.001867,172.31.36.0-255,66,155449,6,194073
26348,0.001872,74.125.200.0-255,2902,158351,6,194073
26349,0.001874,172.31.36.0-255,66,158417,6,194073
26350,0.001879,74.125.200.0-255,4320,162737,6,194073
26351,0.001881,172.31.36.0-255,66,162803,6,194073
26352,0.001917,74.125.200.0-255,8574,171377,6,194073
26353,0.001921,172.31.36.0-255,66,171443,6,194073
26354,0.001929,74.125.200.0-255,7156,178599,6,194073
26355,0.001931,172.31.36.0-255,66,178665,6,194073
26356,0.001954,74.125.200.0-255,766,179431,6,194073
26357,0.0043,74.125.200.0-255,2902,182333,6,194073
26358,0.004307,172.31.36.0-255,66,182399,6,194073
26359,0.004326,74.125.200.0-255,1484,183883,6,194073
26360,0.006671,74.125.200.0-255,4320,188203,6,194073
26361,0.006678,172.31.36.0-255,66,188269,6,194073
26362,0.009032,74.125.200.0-255,5738,194007,6,194073
26363,0.009037,172.31.36.0-255,66,194073,6,194073
26364,0.0,74.125.68.0-255,153,153,6,392413
26365,1.4e-05,172.31.36.0-255,66,219,6,392413
26366,6.1e-05,74.125.68.0-255,1484,1703,6,392413
26367,6.6e-05,172.31.36.0-255,66,1769,6,392413
26368,8.1e-05,74.125.68.0-255,2902,4671,6,392413
26369,8.5e-05,172.31.36.0-255,66,4737,6,392413
26370,8.9e-05,74.125.68.0-255,4320,9057,6,392413
26371,9.2e-05,172.31.36.0-255,66,9123,6,392413
26372,0.000133,74.125.68.0-255,4320,13443,6,392413
26373,0.000135,172.31.36.0-255,66,13509,6,392413
26374,0.000155,74.125.68.0-255,3491,17000,6,392413
26375,0.000157,172.31.36.0-255,66,17066,6,392413
26376,0.000164,74.125.68.0-255,8574,25640,6,392413
26377,0.000166,172.31.36.0-255,66,25706,6,392413
26378,0.000191,74.125.68.0-255,5379,31085,6,392413
26379,0.000193,172.31.36.0-255,66,31151,6,392413
26380,0.00027,74.125.68.0-255,1484,32635,6,392413
26381,0.000275,172.31.36.0-255,66,32701,6,392413
26382,0.000279,74.125.68.0-255,1484,34185,6,392413
26383,0.000281,172.31.36.0-255,66,34251,6,392413
26384,0.000286,74.125.68.0-255,2902,37153,6,392413
26385,0.000288,172.31.36.0-255,66,37219,6,392413
26386,0.000318,74.125.68.0-255,5738,42957,6,392413
26387,0.000322,172.31.36.0-255,66,43023,6,392413
26388,0.000358,74.125.68.0-255,5379,48402,6,392413
26389,0.000363,172.31.36.0-255,66,48468,6,392413
26390,0.000369,74.125.68.0-255,5738,54206,6,392413
26391,0.000371,172.31.36.0-255,66,54272,6,392413
26392,0.000396,74.125.68.0-255,1484,55756,6,392413
26393,0.0004,172.31.36.0-255,66,55822,6,392413
26394,0.000424,74.125.68.0-255,7156,62978,6,392413
26395,0.000427,172.31.36.0-255,66,63044,6,392413
26396,0.000431,74.125.68.0-255,2818,65862,6,392413
26397,0.000433,172.31.36.0-255,66,65928,6,392413
26398,0.000457,74.125.68.0-255,132,66060,6,392413
26399,0.000509,74.125.68.0-255,1484,67544,6,392413
26400,0.000513,172.31.36.0-255,66,67610,6,392413
26401,0.000518,74.125.68.0-255,2902,70512,6,392413
26402,0.000521,172.31.36.0-255,66,70578,6,392413
26403,0.000525,74.125.68.0-255,1484,72062,6,392413
26404,0.000546,74.125.68.0-255,1484,73546,6,392413
26405,0.000549,172.31.36.0-255,66,73612,6,392413
26406,0.000554,74.125.68.0-255,4320,77932,6,392413
26407,0.000556,172.31.36.0-255,66,77998,6,392413
26408,0.000581,74.125.68.0-255,2902,80900,6,392413
26409,0.000585,172.31.36.0-255,66,80966,6,392413
26410,0.000603,74.125.68.0-255,2242,83208,6,392413
26411,0.000607,172.31.36.0-255,66,83274,6,392413
26412,0.000844,74.125.68.0-255,1484,84758,6,392413
26413,0.000851,74.125.68.0-255,2902,87660,6,392413
26414,0.000855,172.31.36.0-255,66,87726,6,392413
26415,0.000882,74.125.68.0-255,5738,93464,6,392413
26416,0.000886,172.31.36.0-255,66,93530,6,392413
26417,0.000893,74.125.68.0-255,7156,100686,6,392413
26418,0.000895,172.31.36.0-255,66,100752,6,392413
26419,0.000939,74.125.68.0-255,8574,109326,6,392413
26420,0.000944,172.31.36.0-255,66,109392,6,392413
26421,0.000951,74.125.68.0-255,7856,117248,6,392413
26422,0.000954,172.31.36.0-255,66,117314,6,392413
26423,0.001639,74.125.68.0-255,1484,118798,6,392413
26424,0.001646,74.125.68.0-255,2902,121700,6,392413
26425,0.001651,172.31.36.0-255,66,121766,6,392413
26426,0.001657,74.125.68.0-255,4320,126086,6,392413
26427,0.001659,172.31.36.0-255,66,126152,6,392413
26428,0.001696,74.125.68.0-255,8574,134726,6,392413
26429,0.001699,172.31.36.0-255,66,134792,6,392413
26430,0.001705,74.125.68.0-255,5738,140530,6,392413
26431,0.001707,172.31.36.0-255,66,140596,6,392413
26432,0.001721,74.125.68.0-255,4320,144916,6,392413
26433,0.001723,172.31.36.0-255,66,144982,6,392413
26434,0.001758,74.125.68.0-255,6438,151420,6,392413
26435,0.001761,172.31.36.0-255,66,151486,6,392413
26436,0.001904,74.125.68.0-255,1484,152970,6,392413
26437,0.001926,74.125.68.0-255,2902,155872,6,392413
26438,0.001929,172.31.36.0-255,66,155938,6,392413
26439,0.001935,74.125.68.0-255,5738,161676,6,392413
26440,0.001937,172.31.36.0-255,66,161742,6,392413
26441,0.00195,74.125.68.0-255,1484,163226,6,392413
26442,0.001968,74.125.68.0-255,7156,170382,6,392413
26443,0.00197,172.31.36.0-255,66,170448,6,392413
26444,0.001975,74.125.68.0-255,4320,174768,6,392413
26445,0.001977,172.31.36.0-255,66,174834,6,392413
26446,0.001993,74.125.68.0-255,5738,180572,6,392413
26447,0.001995,172.31.36.0-255,66,180638,6,392413
26448,0.002022,74.125.68.0-255,5020,185658,6,392413
26449,0.002025,172.31.36.0-255,66,185724,6,392413
26450,0.002031,74.125.68.0-255,5738,191462,6,392413
26451,0.002033,172.31.36.0-255,66,191528,6,392413
26452,0.002052,74.125.68.0-255,2902,194430,6,392413
26453,0.002054,172.31.36.0-255,66,194496,6,392413
26454,0.002079,74.125.68.0-255,8574,203070,6,392413
26455,0.002082,172.31.36.0-255,66,203136,6,392413
26456,0.002086,74.125.68.0-255,4320,207456,6,392413
26457,0.002088,172.31.36.0-255,66,207522,6,392413
26458,0.002109,74.125.68.0-255,8574,216096,6,392413
26459,0.002111,172.31.36.0-255,66,216162,6,392413
26460,0.002116,74.125.68.0-255,3602,219764,6,392413
26461,0.002118,172.31.36.0-255,66,219830,6,392413
26462,0.002144,74.125.68.0-255,4320,224150,6,392413
26463,0.002146,172.31.36.0-255,66,224216,6,392413
26464,0.002149,74.125.68.0-255,1484,225700,6,392413
26465,0.002161,74.125.68.0-255,1484,227184,6,392413
26466,0.002163,172.31.36.0-255,66,227250,6,392413
26467,0.002188,74.125.68.0-255,4320,231570,6,392413
26468,0.002192,172.31.36.0-255,66,231636,6,392413
26469,0.002207,74.125.68.0-255,5738,237374,6,392413
26470,0.00221,172.31.36.0-255,66,237440,6,392413
26471,0.002213,74.125.68.0-255,1484,238924,6,392413
26472,0.002217,74.125.68.0-255,2902,241826,6,392413
26473,0.002219,172.31.36.0-255,66,241892,6,392413
26474,0.002236,74.125.68.0-255,4320,246212,6,392413
26475,0.002239,172.31.36.0-255,66,246278,6,392413
26476,0.002275,74.125.68.0-255,7156,253434,6,392413
26477,0.002279,172.31.36.0-255,66,253500,6,392413
26478,0.002295,74.125.68.0-255,766,254266,6,392413
26479,0.002334,74.125.68.0-255,1484,255750,6,392413
26480,0.002337,172.31.36.0-255,66,255816,6,392413
26481,0.002355,74.125.68.0-255,1484,257300,6,392413
26482,0.002357,74.125.68.0-255,1484,258784,6,392413
26483,0.00236,172.31.36.0-255,66,258850,6,392413
26484,0.002383,74.125.68.0-255,4320,263170,6,392413
26485,0.002386,172.31.36.0-255,66,263236,6,392413
26486,0.002389,74.125.68.0-255,1484,264720,6,392413
26487,0.002409,74.125.68.0-255,2902,267622,6,392413
26488,0.002412,172.31.36.0-255,66,267688,6,392413
26489,0.002428,74.125.68.0-255,4320,272008,6,392413
26490,0.00243,172.31.36.0-255,66,272074,6,392413
26491,0.002434,74.125.68.0-255,2902,274976,6,392413
26492,0.002436,172.31.36.0-255,66,275042,6,392413
26493,0.002438,74.125.68.0-255,1484,276526,6,392413
26494,0.002462,74.125.68.0-255,4320,280846,6,392413
26495,0.002465,172.31.36.0-255,66,280912,6,392413
26496,0.002489,74.125.68.0-255,5738,286650,6,392413
26497,0.002492,172.31.36.0-255,66,286716,6,392413
26498,0.002495,74.125.68.0-255,1484,288200,6,392413
26499,0.002497,74.125.68.0-255,766,288966,6,392413
26500,0.002499,172.31.36.0-255,66,289032,6,392413
26501,0.002503,74.125.68.0-255,2902,291934,6,392413
26502,0.002505,172.31.36.0-255,66,292000,6,392413
26503,0.002558,74.125.68.0-255,4320,296320,6,392413
26504,0.00256,172.31.36.0-255,66,296386,6,392413
26505,0.002568,74.125.68.0-255,8574,304960,6,392413
26506,0.00257,172.31.36.0-255,66,305026,6,392413
26507,0.002582,172.31.36.0-255,66,305092,6,392413
26508,0.002584,74.125.68.0-255,1484,306576,6,392413
26509,0.002588,74.125.68.0-255,2902,309478,6,392413
26510,0.002591,172.31.36.0-255,66,309544,6,392413
26511,0.002615,74.125.68.0-255,2184,311728,6,392413
26512,0.002618,172.31.36.0-255,66,311794,6,392413
26513,0.002641,74.125.68.0-255,2902,314696,6,392413
26514,0.002643,172.31.36.0-255,66,314762,6,392413
26515,0.002662,74.125.68.0-255,7156,321918,6,392413
26516,0.002664,172.31.36.0-255,66,321984,6,392413
26517,0.002668,74.125.68.0-255,2902,324886,6,392413
26518,0.002671,172.31.36.0-255,66,324952,6,392413
26519,0.002673,74.125.68.0-255,1484,326436,6,392413
26520,0.002687,74.125.68.0-255,1484,327920,6,392413
26521,0.002689,172.31.36.0-255,66,327986,6,392413
26522,0.002715,74.125.68.0-255,4320,332306,6,392413
26523,0.002718,172.31.36.0-255,66,332372,6,392413
26524,0.002724,74.125.68.0-255,7156,339528,6,392413
26525,0.002726,172.31.36.0-255,66,339594,6,392413
26526,0.002754,74.125.68.0-255,7156,346750,6,392413
26527,0.002757,172.31.36.0-255,66,346816,6,392413
26528,0.002771,74.125.68.0-255,766,347582,6,392413
26529,0.002776,74.125.68.0-255,4320,351902,6,392413
26530,0.002778,172.31.36.0-255,66,351968,6,392413
26531,0.002801,74.125.68.0-255,5738,357706,6,392413
26532,0.002803,172.31.36.0-255,66,357772,6,392413
26533,0.002825,74.125.68.0-255,8574,366346,6,392413
26534,0.002828,172.31.36.0-255,66,366412,6,392413
26535,0.002834,74.125.68.0-255,7156,373568,6,392413
26536,0.002836,172.31.36.0-255,66,373634,6,392413
26537,0.00284,74.125.68.0-255,2902,376536,6,392413
26538,0.002842,172.31.36.0-255,66,376602,6,392413
26539,0.002868,74.125.68.0-255,5020,381622,6,392413
26540,0.002871,172.31.36.0-255,66,381688,6,392413
26541,0.002878,74.125.68.0-255,8574,390262,6,392413
26542,0.00288,172.31.36.0-255,66,390328,6,392413
26543,0.002928,74.125.68.0-255,1677,392005,6,392413
26544,0.00293,172.31.36.0-255,66,392071,6,392413
26545,0.002952,74.125.68.0-255,105,392176,6,392413
26546,0.004941,172.31.36.0-255,66,392242,6,392413
26547,0.004978,172.31.36.0-255,105,392347,6,392413
26548,0.007012,74.125.68.0-255,66,392413,6,392413
26549,0.0,172.217.194.0-255,455,455,6,244178
26550,2.7e-05,172.31.36.0-255,66,521,6,244178
26551,3.4e-05,172.217.194.0-255,1484,2005,6,244178
26552,3.8e-05,172.31.36.0-255,66,2071,6,244178
26553,4.4e-05,172.217.194.0-255,4320,6391,6,244178
26554,4.6e-05,172.31.36.0-255,66,6457,6,244178
26555,7.9e-05,172.217.194.0-255,7559,14016,6,244178
26556,8.2e-05,172.31.36.0-255,66,14082,6,244178
26557,8.6e-05,172.217.194.0-255,2902,16984,6,244178
26558,8.9e-05,172.31.36.0-255,66,17050,6,244178
26559,0.000107,172.217.194.0-255,5738,22788,6,244178
26560,0.00011,172.31.36.0-255,66,22854,6,244178
26561,0.000117,172.217.194.0-255,8215,31069,6,244178
26562,0.00012,172.31.36.0-255,66,31135,6,244178
26563,0.000222,172.217.194.0-255,1484,32619,6,244178
26564,0.000225,172.31.36.0-255,66,32685,6,244178
26565,0.000231,172.217.194.0-255,2902,35587,6,244178
26566,0.000232,172.31.36.0-255,66,35653,6,244178
26567,0.000252,172.217.194.0-255,5738,41391,6,244178
26568,0.000254,172.31.36.0-255,66,41457,6,244178
26569,0.000257,172.217.194.0-255,1484,42941,6,244178
26570,0.000259,172.31.36.0-255,66,43007,6,244178
26571,0.000293,172.217.194.0-255,9633,52640,6,244178
26572,0.000297,172.31.36.0-255,66,52706,6,244178
26573,0.000311,172.217.194.0-255,1484,54190,6,244178
26574,0.000314,172.31.36.0-255,66,54256,6,244178
26575,0.000339,172.31.36.0-255,66,54322,6,244178
26576,0.000707,172.217.194.0-255,366,54688,6,244178
26577,0.000712,172.31.36.0-255,66,54754,6,244178
26578,0.000854,172.217.194.0-255,1484,56238,6,244178
26579,0.000859,172.31.36.0-255,66,56304,6,244178
26580,0.000867,172.217.194.0-255,2902,59206,6,244178
26581,0.00087,172.31.36.0-255,66,59272,6,244178
26582,0.000877,172.217.194.0-255,5738,65010,6,244178
26583,0.000879,172.31.36.0-255,66,65076,6,244178
26584,0.000892,172.31.36.0-255,66,65142,6,244178
26585,0.000895,172.217.194.0-255,1484,66626,6,244178
26586,0.000924,172.217.194.0-255,5738,72364,6,244178
26587,0.000927,172.31.36.0-255,66,72430,6,244178
26588,0.000948,172.217.194.0-255,3602,76032,6,244178
26589,0.000951,172.31.36.0-255,66,76098,6,244178
26590,0.000954,172.217.194.0-255,378,76476,6,244178
26591,0.001185,172.217.194.0-255,1484,77960,6,244178
26592,0.001191,172.31.36.0-255,66,78026,6,244178
26593,0.001197,172.217.194.0-255,2902,80928,6,244178
26594,0.001199,172.31.36.0-255,66,80994,6,244178
26595,0.001206,172.217.194.0-255,5738,86732,6,244178
26596,0.001208,172.31.36.0-255,66,86798,6,244178
26597,0.00124,172.31.36.0-255,66,86864,6,244178
26598,0.00128,172.217.194.0-255,4320,91184,6,244178
26599,0.001284,172.31.36.0-255,66,91250,6,244178
26600,0.001309,172.217.194.0-255,6438,97688,6,244178
26601,0.001313,172.31.36.0-255,66,97754,6,244178
26602,0.001316,172.217.194.0-255,1484,99238,6,244178
26603,0.001335,172.217.194.0-255,2902,102140,6,244178
26604,0.001339,172.31.36.0-255,66,102206,6,244178
26605,0.001343,172.217.194.0-255,2902,105108,6,244178
26606,0.001346,172.31.36.0-255,66,105174,6,244178
26607,0.00136,172.217.194.0-255,2902,108076,6,244178
26608,0.001363,172.31.36.0-255,66,108142,6,244178
26609,0.00137,172.217.194.0-255,5738,113880,6,244178
26610,0.001373,172.31.36.0-255,66,113946,6,244178
26611,0.001391,172.217.194.0-255,7156,121102,6,244178
26612,0.001394,172.31.36.0-255,66,121168,6,244178
26613,0.001404,172.217.194.0-255,10692,131860,6,244178
26614,0.001406,172.31.36.0-255,66,131926,6,244178
26615,0.001769,172.217.194.0-255,1484,133410,6,244178
26616,0.001777,172.217.194.0-255,2902,136312,6,244178
26617,0.00178,172.31.36.0-255,66,136378,6,244178
26618,0.001824,172.217.194.0-255,4320,140698,6,244178
26619,0.001827,172.31.36.0-255,66,140764,6,244178
26620,0.001842,172.217.194.0-255,1484,142248,6,244178
26621,0.001855,172.31.36.0-255,66,142314,6,244178
26622,0.00189,172.217.194.0-255,10692,153006,6,244178
26623,0.001893,172.31.36.0-255,66,153072,6,244178
26624,0.001904,172.31.36.0-255,66,153138,6,244178
26625,0.001912,172.217.194.0-255,9992,163130,6,244178
26626,0.001914,172.31.36.0-255,66,163196,6,244178
26627,0.001939,172.217.194.0-255,5738,168934,6,244178
26628,0.001941,172.31.36.0-255,66,169000,6,244178
26629,0.001964,172.217.194.0-255,6438,175438,6,244178
26630,0.001966,172.31.36.0-255,66,175504,6,244178
26631,0.002087,172.217.194.0-255,1484,176988,6,244178
26632,0.002092,172.217.194.0-255,2902,179890,6,244178
26633,0.002094,172.31.36.0-255,66,179956,6,244178
26634,0.002098,172.217.194.0-255,2902,182858,6,244178
26635,0.0021,172.31.36.0-255,66,182924,6,244178
26636,0.002115,172.217.194.0-255,2902,185826,6,244178
26637,0.002118,172.31.36.0-255,66,185892,6,244178
26638,0.002143,172.31.36.0-255,66,185958,6,244178
26639,0.002165,172.217.194.0-255,1484,187442,6,244178
26640,0.002175,172.217.194.0-255,10692,198134,6,244178
26641,0.002177,172.31.36.0-255,66,198200,6,244178
26642,0.002451,172.217.194.0-255,1484,199684,6,244178
26643,0.002456,172.217.194.0-255,2902,202586,6,244178
26644,0.002459,172.31.36.0-255,66,202652,6,244178
26645,0.002484,172.217.194.0-255,5738,208390,6,244178
26646,0.002486,172.31.36.0-255,66,208456,6,244178
26647,0.00249,172.217.194.0-255,2902,211358,6,244178
26648,0.002492,172.31.36.0-255,66,211424,6,244178
26649,0.00252,172.217.194.0-255,9992,221416,6,244178
26650,0.002522,172.31.36.0-255,66,221482,6,244178
26651,0.002525,172.217.194.0-255,1484,222966,6,244178
26652,0.002555,172.217.194.0-255,5738,228704,6,244178
26653,0.002557,172.31.36.0-255,66,228770,6,244178
26654,0.002574,172.217.194.0-255,3602,232372,6,244178
26655,0.002576,172.31.36.0-255,66,232438,6,244178
26656,0.005099,172.217.194.0-255,1484,233922,6,244178
26657,0.005119,172.217.194.0-255,4320,238242,6,244178
26658,0.005122,172.31.36.0-255,66,238308,6,244178
26659,0.007657,172.217.194.0-255,4320,242628,6,244178
26660,0.007665,172.31.36.0-255,66,242694,6,244178
26661,0.007679,172.217.194.0-255,1484,244178,6,244178
26662,0.0,74.125.200.0-255,152,152,6,161949
26663,2.8e-05,172.31.36.0-255,66,218,6,161949
26664,3.5e-05,74.125.200.0-255,1484,1702,6,161949
26665,3.9e-05,172.31.36.0-255,66,1768,6,161949
26666,4.5e-05,74.125.200.0-255,2902,4670,6,161949
26667,4.8e-05,172.31.36.0-255,66,4736,6,161949
26668,6.2e-05,74.125.200.0-255,5738,10474,6,161949
26669,6.5e-05,172.31.36.0-255,66,10540,6,161949
26670,0.000106,74.125.200.0-255,6247,16787,6,161949
26671,0.00011,172.31.36.0-255,66,16853,6,161949
26672,0.00013,172.31.36.0-255,66,16919,6,161949
26673,0.000155,74.125.200.0-255,1125,18044,6,161949
26674,0.000157,172.31.36.0-255,66,18110,6,161949
26675,0.000206,74.125.200.0-255,1484,19594,6,161949
26676,0.00021,172.31.36.0-255,66,19660,6,161949
26677,0.000239,74.125.200.0-255,2902,22562,6,161949
26678,0.000241,172.31.36.0-255,66,22628,6,161949
26679,0.000248,74.125.200.0-255,5738,28366,6,161949
26680,0.00025,172.31.36.0-255,66,28432,6,161949
26681,0.000275,74.125.200.0-255,5738,34170,6,161949
26682,0.000281,172.31.36.0-255,66,34236,6,161949
26683,0.000281,74.125.200.0-255,6797,41033,6,161949
26684,0.000285,172.31.36.0-255,66,41099,6,161949
26685,0.00031,74.125.200.0-255,4320,45419,6,161949
26686,0.000313,172.31.36.0-255,66,45485,6,161949
26687,0.000348,74.125.200.0-255,7074,52559,6,161949
26688,0.000352,172.31.36.0-255,66,52625,6,161949
26689,0.000356,74.125.200.0-255,129,52754,6,161949
26690,0.000358,172.31.36.0-255,66,52820,6,161949
26691,0.000448,74.125.200.0-255,347,53167,6,161949
26692,0.000454,172.31.36.0-255,66,53233,6,161949
26693,0.000824,74.125.200.0-255,1484,54717,6,161949
26694,0.000832,74.125.200.0-255,2902,57619,6,161949
26695,0.000836,172.31.36.0-255,66,57685,6,161949
26696,0.000841,74.125.200.0-255,1484,59169,6,161949
26697,0.000869,74.125.200.0-255,4320,63489,6,161949
26698,0.000871,172.31.36.0-255,66,63555,6,161949
26699,0.000877,74.125.200.0-255,4320,67875,6,161949
26700,0.000879,172.31.36.0-255,66,67941,6,161949
26701,0.00089,74.125.200.0-255,5738,73679,6,161949
26702,0.000894,172.31.36.0-255,66,73745,6,161949
26703,0.000899,74.125.200.0-255,2902,76647,6,161949
26704,0.000901,172.31.36.0-255,66,76713,6,161949
26705,0.000942,74.125.200.0-255,8574,85287,6,161949
26706,0.000946,172.31.36.0-255,66,85353,6,161949
26707,0.00095,74.125.200.0-255,2184,87537,6,161949
26708,0.000952,172.31.36.0-255,66,87603,6,161949
26709,0.001261,74.125.200.0-255,1484,89087,6,161949
26710,0.001269,74.125.200.0-255,1484,90571,6,161949
26711,0.001274,172.31.36.0-255,66,90637,6,161949
26712,0.001302,74.125.200.0-255,1484,92121,6,161949
26713,0.001311,74.125.200.0-255,5738,97859,6,161949
26714,0.001314,172.31.36.0-255,66,97925,6,161949
26715,0.001339,74.125.200.0-255,2902,100827,6,161949
26716,0.001343,172.31.36.0-255,66,100893,6,161949
26717,0.001378,74.125.200.0-255,9992,110885,6,161949
26718,0.001382,172.31.36.0-255,66,110951,6,161949
26719,0.001393,74.125.200.0-255,10692,121643,6,161949
26720,0.001403,172.31.36.0-255,66,121709,6,161949
26721,0.00199,74.125.200.0-255,1484,123193,6,161949
26722,0.001998,74.125.200.0-255,2902,126095,6,161949
26723,0.002002,172.31.36.0-255,66,126161,6,161949
26724,0.002017,74.125.200.0-255,1484,127645,6,161949
26725,0.002035,74.125.200.0-255,4320,131965,6,161949
26726,0.002037,172.31.36.0-255,66,132031,6,161949
26727,0.002065,74.125.200.0-255,7156,139187,6,161949
26728,0.002068,172.31.36.0-255,66,139253,6,161949
26729,0.002105,172.31.36.0-255,66,139319,6,161949
26730,0.002126,74.125.200.0-255,1484,140803,6,161949
26731,0.002145,74.125.200.0-255,3602,144405,6,161949
26732,0.002147,172.31.36.0-255,66,144471,6,161949
26733,0.004447,74.125.200.0-255,5738,150209,6,161949
26734,0.004452,172.31.36.0-255,66,150275,6,161949
26735,0.006785,74.125.200.0-255,5738,156013,6,161949
26736,0.00679,172.31.36.0-255,66,156079,6,161949
26737,0.009108,74.125.200.0-255,4320,160399,6,161949
26738,0.009115,172.31.36.0-255,66,160465,6,161949
26739,0.009163,74.125.200.0-255,1484,161949,6,161949
26740,0.0,74.125.24.0-255,143,143,6,161298
26741,2.1e-05,172.31.36.0-255,66,209,6,161298
26742,2.9e-05,74.125.24.0-255,1484,1693,6,161298
26743,3.4e-05,172.31.36.0-255,66,1759,6,161298
26744,3.9e-05,74.125.24.0-255,2902,4661,6,161298
26745,4.2e-05,172.31.36.0-255,66,4727,6,161298
26746,5e-05,74.125.24.0-255,7156,11883,6,161298
26747,5.3e-05,172.31.36.0-255,66,11949,6,161298
26748,7.4e-05,74.125.24.0-255,4320,16269,6,161298
26749,7.7e-05,172.31.36.0-255,66,16335,6,161298
26750,0.000107,172.31.36.0-255,66,16401,6,161298
26751,0.000112,74.125.24.0-255,2543,18944,6,161298
26752,0.000114,172.31.36.0-255,66,19010,6,161298
26753,0.000186,74.125.24.0-255,1484,20494,6,161298
26754,0.000189,172.31.36.0-255,66,20560,6,161298
26755,0.000194,74.125.24.0-255,2902,23462,6,161298
26756,0.000196,172.31.36.0-255,66,23528,6,161298
26757,0.000214,74.125.24.0-255,5738,29266,6,161298
26758,0.000216,172.31.36.0-255,66,29332,6,161298
26759,0.000221,74.125.24.0-255,2902,32234,6,161298
26760,0.000223,172.31.36.0-255,66,32300,6,161298
26761,0.00024,74.125.24.0-255,3961,36261,6,161298
26762,0.000243,172.31.36.0-255,66,36327,6,161298
26763,0.000246,74.125.24.0-255,1484,37811,6,161298
26764,0.000248,172.31.36.0-255,66,37877,6,161298
26765,0.000279,172.31.36.0-255,66,37943,6,161298
26766,0.000315,74.125.24.0-255,2850,40793,6,161298
26767,0.000318,172.31.36.0-255,66,40859,6,161298
26768,0.000341,74.125.24.0-255,115,40974,6,161298
26769,0.000343,172.31.36.0-255,66,41040,6,161298
26770,0.000526,74.125.24.0-255,330,41370,6,161298
26771,0.000976,172.31.36.0-255,66,41436,6,161298
26772,0.001042,74.125.24.0-255,1484,42920,6,161298
26773,0.001062,74.125.24.0-255,2902,45822,6,161298
26774,0.001065,172.31.36.0-255,66,45888,6,161298
26775,0.001086,74.125.24.0-255,5738,51626,6,161298
26776,0.001089,172.31.36.0-255,66,51692,6,161298
26777,0.001106,74.125.24.0-255,1484,53176,6,161298
26778,0.001126,74.125.24.0-255,8574,61750,6,161298
26779,0.001129,172.31.36.0-255,66,61816,6,161298
26780,0.001147,74.125.24.0-255,2902,64718,6,161298
26781,0.001149,172.31.36.0-255,66,64784,6,161298
26782,0.001174,74.125.24.0-255,10692,75476,6,161298
26783,0.001176,172.31.36.0-255,66,75542,6,161298
26784,0.00146,74.125.24.0-255,1484,77026,6,161298
26785,0.001466,74.125.24.0-255,1484,78510,6,161298
26786,0.00147,172.31.36.0-255,66,78576,6,161298
26787,0.001493,74.125.24.0-255,1484,80060,6,161298
26788,0.0015,74.125.24.0-255,5738,85798,6,161298
26789,0.001502,172.31.36.0-255,66,85864,6,161298
26790,0.00151,74.125.24.0-255,7156,93020,6,161298
26791,0.001512,172.31.36.0-255,66,93086,6,161298
26792,0.001534,74.125.24.0-255,5738,98824,6,161298
26793,0.001536,172.31.36.0-255,66,98890,6,161298
26794,0.001553,74.125.24.0-255,8574,107464,6,161298
26795,0.001555,172.31.36.0-255,66,107530,6,161298
26796,0.00156,74.125.24.0-255,2184,109714,6,161298
26797,0.001562,172.31.36.0-255,66,109780,6,161298
26798,0.001826,74.125.24.0-255,1484,111264,6,161298
26799,0.001834,74.125.24.0-255,2902,114166,6,161298
26800,0.001837,172.31.36.0-255,66,114232,6,161298
26801,0.001845,74.125.24.0-255,4320,118552,6,161298
26802,0.001847,172.31.36.0-255,66,118618,6,161298
26803,0.001865,74.125.24.0-255,1484,120102,6,161298
26804,0.001872,74.125.24.0-255,5738,125840,6,161298
26805,0.001874,172.31.36.0-255,66,125906,6,161298
26806,0.0019,74.125.24.0-255,7156,133062,6,161298
26807,0.001902,172.31.36.0-255,66,133128,6,161298
26808,0.001913,74.125.24.0-255,10692,143820,6,161298
26809,0.001915,172.31.36.0-255,66,143886,6,161298
26810,0.004005,74.125.24.0-255,5738,149624,6,161298
26811,0.004014,172.31.36.0-255,66,149690,6,161298
26812,0.006086,74.125.24.0-255,5738,155428,6,161298
26813,0.006092,172.31.36.0-255,66,155494,6,161298
26814,0.008197,74.125.24.0-255,5738,161232,6,161298
26815,0.008204,172.31.36.0-255,66,161298,6,161298
26816,0.0,172.217.194.0-255,143,143,6,266983
26817,2.3e-05,172.31.36.0-255,66,209,6,266983
26818,3.1e-05,172.217.194.0-255,1484,1693,6,266983
26819,3.5e-05,172.31.36.0-255,66,1759,6,266983
26820,4.1e-05,172.217.194.0-255,2902,4661,6,266983
26821,4.5e-05,172.31.36.0-255,66,4727,6,266983
26822,5.2e-05,172.217.194.0-255,7156,11883,6,266983
26823,5.6e-05,172.31.36.0-255,66,11949,6,266983
26824,7.7e-05,172.217.194.0-255,2065,14014,6,266983
26825,7.9e-05,172.31.36.0-255,66,14080,6,266983
26826,8.4e-05,172.217.194.0-255,2902,16982,6,266983
26827,8.7e-05,172.31.36.0-255,66,17048,6,266983
26828,9.5e-05,172.217.194.0-255,7156,24204,6,266983
26829,9.7e-05,172.31.36.0-255,66,24270,6,266983
26830,0.000119,172.217.194.0-255,4320,28590,6,266983
26831,0.000121,172.31.36.0-255,66,28656,6,266983
26832,0.000142,172.217.194.0-255,2543,31199,6,266983
26833,0.000145,172.31.36.0-255,66,31265,6,266983
26834,0.000149,172.217.194.0-255,2902,34167,6,266983
26835,0.000151,172.31.36.0-255,66,34233,6,266983
26836,0.000167,172.217.194.0-255,4320,38553,6,266983
26837,0.000169,172.31.36.0-255,66,38619,6,266983
26838,0.000177,172.217.194.0-255,7156,45775,6,266983
26839,0.000179,172.31.36.0-255,66,45841,6,266983
26840,0.0002,172.217.194.0-255,2543,48384,6,266983
26841,0.000202,172.31.36.0-255,66,48450,6,266983
26842,0.000222,172.217.194.0-255,4320,52770,6,266983
26843,0.000224,172.31.36.0-255,66,52836,6,266983
26844,0.000244,172.217.194.0-255,4320,57156,6,266983
26845,0.000247,172.31.36.0-255,66,57222,6,266983
26846,0.000278,172.217.194.0-255,5738,62960,6,266983
26847,0.000281,172.31.36.0-255,66,63026,6,266983
26848,0.000301,172.217.194.0-255,2819,65845,6,266983
26849,0.000303,172.31.36.0-255,66,65911,6,266983
26850,0.000306,172.217.194.0-255,117,66028,6,266983
26851,0.00033,172.217.194.0-255,382,66410,6,266983
26852,0.000643,172.217.194.0-255,1484,67894,6,266983
26853,0.000649,172.31.36.0-255,66,67960,6,266983
26854,0.000655,172.217.194.0-255,2902,70862,6,266983
26855,0.000659,172.31.36.0-255,66,70928,6,266983
26856,0.000665,172.217.194.0-255,5738,76666,6,266983
26857,0.000668,172.31.36.0-255,66,76732,6,266983
26858,0.000697,172.31.36.0-255,66,76798,6,266983
26859,0.000738,172.217.194.0-255,2902,79700,6,266983
26860,0.000741,172.31.36.0-255,66,79766,6,266983
26861,0.000771,172.217.194.0-255,7856,87622,6,266983
26862,0.000776,172.31.36.0-255,66,87688,6,266983
26863,0.000934,172.217.194.0-255,1484,89172,6,266983
26864,0.000941,172.217.194.0-255,2902,92074,6,266983
26865,0.000944,172.31.36.0-255,66,92140,6,266983
26866,0.000952,172.217.194.0-255,5738,97878,6,266983
26867,0.000954,172.31.36.0-255,66,97944,6,266983
26868,0.001005,172.31.36.0-255,66,98010,6,266983
26869,0.001015,172.217.194.0-255,10692,108702,6,266983
26870,0.001018,172.31.36.0-255,66,108768,6,266983
26871,0.001074,172.217.194.0-255,1484,110252,6,266983
26872,0.001077,172.217.194.0-255,1484,111736,6,266983
26873,0.00108,172.31.36.0-255,66,111802,6,266983
26874,0.001096,172.217.194.0-255,1484,113286,6,266983
26875,0.001103,172.217.194.0-255,5738,119024,6,266983
26876,0.001105,172.31.36.0-255,66,119090,6,266983
26877,0.001139,172.31.36.0-255,66,119156,6,266983
26878,0.001142,172.217.194.0-255,1484,120640,6,266983
26879,0.001166,172.217.194.0-255,9274,129914,6,266983
26880,0.001169,172.31.36.0-255,66,129980,6,266983
26881,0.001694,172.217.194.0-255,1484,131464,6,266983
26882,0.001708,172.217.194.0-255,2902,134366,6,266983
26883,0.001711,172.31.36.0-255,66,134432,6,266983
26884,0.001718,172.217.194.0-255,5738,140170,6,266983
26885,0.00172,172.31.36.0-255,66,140236,6,266983
26886,0.001739,172.217.194.0-255,5738,145974,6,266983
26887,0.001742,172.31.36.0-255,66,146040,6,266983
26888,0.001764,172.217.194.0-255,7156,153196,6,266983
26889,0.001766,172.31.36.0-255,66,153262,6,266983
26890,0.001777,172.217.194.0-255,10692,163954,6,266983
26891,0.001779,172.31.36.0-255,66,164020,6,266983
26892,0.001829,172.217.194.0-255,1484,165504,6,266983
26893,0.001845,172.217.194.0-255,2902,168406,6,266983
26894,0.001848,172.31.36.0-255,66,168472,6,266983
26895,0.001854,172.217.194.0-255,5738,174210,6,266983
26896,0.001857,172.31.36.0-255,66,174276,6,266983
26897,0.001863,172.217.194.0-255,4320,178596,6,266983
26898,0.001866,172.31.36.0-255,66,178662,6,266983
26899,0.001893,172.217.194.0-255,2902,181564,6,266983
26900,0.001896,172.31.36.0-255,66,181630,6,266983
26901,0.001912,172.31.36.0-255,66,181696,6,266983
26902,0.00193,172.217.194.0-255,1484,183180,6,266983
26903,0.001934,172.217.194.0-255,2184,185364,6,266983
26904,0.001937,172.31.36.0-255,66,185430,6,266983
26905,0.001942,172.217.194.0-255,2902,188332,6,266983
26906,0.001944,172.31.36.0-255,66,188398,6,266983
26907,0.00195,172.217.194.0-255,4320,192718,6,266983
26908,0.001952,172.31.36.0-255,66,192784,6,266983
26909,0.001974,172.217.194.0-255,2902,195686,6,266983
26910,0.001977,172.31.36.0-255,66,195752,6,266983
26911,0.001999,172.31.36.0-255,66,195818,6,266983
26912,0.002007,172.217.194.0-255,7856,203674,6,266983
26913,0.002009,172.31.36.0-255,66,203740,6,266983
26914,0.002072,172.217.194.0-255,1484,205224,6,266983
26915,0.002077,172.217.194.0-255,1484,206708,6,266983
26916,0.002079,172.31.36.0-255,66,206774,6,266983
26917,0.002099,172.217.194.0-255,1484,208258,6,266983
26918,0.002106,172.217.194.0-255,5738,213996,6,266983
26919,0.002109,172.31.36.0-255,66,214062,6,266983
26920,0.002122,172.31.36.0-255,66,214128,6,266983
26921,0.002149,172.217.194.0-255,1484,215612,6,266983
26922,0.00216,172.217.194.0-255,10692,226304,6,266983
26923,0.002163,172.31.36.0-255,66,226370,6,266983
26924,0.002212,172.217.194.0-255,1484,227854,6,266983
26925,0.002216,172.217.194.0-255,2902,230756,6,266983
26926,0.002219,172.31.36.0-255,66,230822,6,266983
26927,0.002225,172.217.194.0-255,5738,236560,6,266983
26928,0.002227,172.31.36.0-255,66,236626,6,266983
26929,0.002241,172.31.36.0-255,66,236692,6,266983
26930,0.00225,172.217.194.0-255,9992,246684,6,266983
26931,0.002252,172.31.36.0-255,66,246750,6,266983
26932,0.002278,172.217.194.0-255,766,247516,6,266983
26933,0.002284,172.217.194.0-255,4320,251836,6,266983
26934,0.002287,172.31.36.0-255,66,251902,6,266983
26935,0.002318,172.31.36.0-255,66,251968,6,266983
26936,0.002328,172.217.194.0-255,10692,262660,6,266983
26937,0.00233,172.31.36.0-255,66,262726,6,266983
26938,0.002387,172.31.36.0-255,66,262792,6,266983
26939,0.0024,172.217.194.0-255,3849,266641,6,266983
26940,0.002403,172.31.36.0-255,66,266707,6,266983
26941,0.004694,172.217.194.0-255,105,266812,6,266983
26942,0.008631,172.31.36.0-255,66,266878,6,266983
26943,0.008673,172.31.36.0-255,105,266983,6,266983
26944,0.0,172.217.194.0-255,153,153,6,279412
26945,3.9e-05,172.31.36.0-255,66,219,6,279412
26946,4.5e-05,172.217.194.0-255,1484,1703,6,279412
26947,4.9e-05,172.31.36.0-255,66,1769,6,279412
26948,5.5e-05,172.217.194.0-255,2902,4671,6,279412
26949,5.8e-05,172.31.36.0-255,66,4737,6,279412
26950,6.3e-05,172.217.194.0-255,4320,9057,6,279412
26951,6.6e-05,172.31.36.0-255,66,9123,6,279412
26952,7.5e-05,172.217.194.0-255,9110,18233,6,279412
26953,7.9e-05,172.31.36.0-255,66,18299,6,279412
26954,8.6e-05,172.217.194.0-255,7156,25455,6,279412
26955,8.9e-05,172.31.36.0-255,66,25521,6,279412
26956,0.000111,172.217.194.0-255,5379,30900,6,279412
26957,0.000114,172.31.36.0-255,66,30966,6,279412
26958,0.000128,172.31.36.0-255,66,31032,6,279412
26959,0.000149,172.217.194.0-255,1484,32516,6,279412
26960,0.000152,172.31.36.0-255,66,32582,6,279412
26961,0.000172,172.217.194.0-255,2543,35125,6,279412
26962,0.000175,172.31.36.0-255,66,35191,6,279412
26963,0.000232,172.217.194.0-255,1484,36675,6,279412
26964,0.000236,172.31.36.0-255,66,36741,6,279412
26965,0.000262,172.217.194.0-255,2902,39643,6,279412
26966,0.000265,172.31.36.0-255,66,39709,6,279412
26967,0.00027,172.217.194.0-255,5738,45447,6,279412
26968,0.000272,172.31.36.0-255,66,45513,6,279412
26969,0.000292,172.217.194.0-255,6797,52310,6,279412
26970,0.000295,172.31.36.0-255,66,52376,6,279412
26971,0.000318,172.217.194.0-255,382,52758,6,279412
26972,0.00032,172.31.36.0-255,66,52824,6,279412
26973,0.000523,172.217.194.0-255,363,53187,6,279412
26974,0.000528,172.31.36.0-255,66,53253,6,279412
26975,0.000712,172.217.194.0-255,1484,54737,6,279412
26976,0.00072,172.217.194.0-255,2902,57639,6,279412
26977,0.000723,172.31.36.0-255,66,57705,6,279412
26978,0.000727,172.217.194.0-255,1484,59189,6,279412
26979,0.000749,172.217.194.0-255,4320,63509,6,279412
26980,0.000752,172.31.36.0-255,66,63575,6,279412
26981,0.000758,172.217.194.0-255,5738,69313,6,279412
26982,0.00076,172.31.36.0-255,66,69379,6,279412
26983,0.000779,172.217.194.0-255,4320,73699,6,279412
26984,0.000782,172.31.36.0-255,66,73765,6,279412
26985,0.000787,172.217.194.0-255,4320,78085,6,279412
26986,0.000789,172.31.36.0-255,66,78151,6,279412
26987,0.000814,172.217.194.0-255,9274,87425,6,279412
26988,0.000818,172.31.36.0-255,66,87491,6,279412
26989,0.001051,172.217.194.0-255,1484,88975,6,279412
26990,0.001058,172.217.194.0-255,2902,91877,6,279412
26991,0.001061,172.31.36.0-255,66,91943,6,279412
26992,0.001067,172.217.194.0-255,5738,97681,6,279412
26993,0.001069,172.31.36.0-255,66,97747,6,279412
26994,0.001091,172.217.194.0-255,1484,99231,6,279412
26995,0.001124,172.31.36.0-255,66,99297,6,279412
26996,0.001142,172.217.194.0-255,7156,106453,6,279412
26997,0.001145,172.31.36.0-255,66,106519,6,279412
26998,0.001168,172.217.194.0-255,3602,110121,6,279412
26999,0.001171,172.31.36.0-255,66,110187,6,279412
27000,0.001398,172.217.194.0-255,1484,111671,6,279412
27001,0.001429,172.217.194.0-255,2902,114573,6,279412
27002,0.001434,172.31.36.0-255,66,114639,6,279412
27003,0.001441,172.217.194.0-255,5738,120377,6,279412
27004,0.001443,172.31.36.0-255,66,120443,6,279412
27005,0.00145,172.217.194.0-255,8574,129017,6,279412
27006,0.001452,172.31.36.0-255,66,129083,6,279412
27007,0.001481,172.217.194.0-255,4320,133403,6,279412
27008,0.001485,172.31.36.0-255,66,133469,6,279412
27009,0.001489,172.217.194.0-255,1484,134953,6,279412
27010,0.001494,172.217.194.0-255,2902,137855,6,279412
27011,0.001496,172.31.36.0-255,66,137921,6,279412
27012,0.001516,172.217.194.0-255,6438,144359,6,279412
27013,0.00152,172.31.36.0-255,66,144425,6,279412
27014,0.001548,172.217.194.0-255,5738,150163,6,279412
27015,0.001552,172.31.36.0-255,66,150229,6,279412
27016,0.001583,172.217.194.0-255,4320,154549,6,279412
27017,0.001587,172.31.36.0-255,66,154615,6,279412
27018,0.001599,172.31.36.0-255,66,154681,6,279412
27019,0.001611,172.31.36.0-255,66,154747,6,279412
27020,0.001628,172.217.194.0-255,766,155513,6,279412
27021,0.001677,172.217.194.0-255,1484,156997,6,279412
27022,0.001683,172.31.36.0-255,66,157063,6,279412
27023,0.001691,172.217.194.0-255,4320,161383,6,279412
27024,0.001694,172.31.36.0-255,66,161449,6,279412
27025,0.001699,172.217.194.0-255,4320,165769,6,279412
27026,0.001702,172.31.36.0-255,66,165835,6,279412
27027,0.001726,172.217.194.0-255,9992,175827,6,279412
27028,0.001729,172.31.36.0-255,66,175893,6,279412
27029,0.001746,172.217.194.0-255,2902,178795,6,279412
27030,0.001749,172.31.36.0-255,66,178861,6,279412
27031,0.001796,172.217.194.0-255,9992,188853,6,279412
27032,0.001799,172.31.36.0-255,66,188919,6,279412
27033,0.00181,172.217.194.0-255,766,189685,6,279412
27034,0.001841,172.217.194.0-255,1484,191169,6,279412
27035,0.001844,172.31.36.0-255,66,191235,6,279412
27036,0.00186,172.217.194.0-255,2902,194137,6,279412
27037,0.001862,172.31.36.0-255,66,194203,6,279412
27038,0.001866,172.217.194.0-255,1484,195687,6,279412
27039,0.00189,172.217.194.0-255,4320,200007,6,279412
27040,0.001894,172.31.36.0-255,66,200073,6,279412
27041,0.0019,172.217.194.0-255,5738,205811,6,279412
27042,0.001902,172.31.36.0-255,66,205877,6,279412
27043,0.001924,172.217.194.0-255,7156,213033,6,279412
27044,0.001927,172.31.36.0-255,66,213099,6,279412
27045,0.001937,172.217.194.0-255,9992,223091,6,279412
27046,0.00194,172.31.36.0-255,66,223157,6,279412
27047,0.001943,172.217.194.0-255,766,223923,6,279412
27048,0.00198,172.217.194.0-255,1484,225407,6,279412
27049,0.001983,172.31.36.0-255,66,225473,6,279412
27050,0.00199,172.217.194.0-255,4320,229793,6,279412
27051,0.001992,172.31.36.0-255,66,229859,6,279412
27052,0.002031,172.217.194.0-255,9992,239851,6,279412
27053,0.002035,172.31.36.0-255,66,239917,6,279412
27054,0.002038,172.217.194.0-255,1484,241401,6,279412
27055,0.002053,172.31.36.0-255,66,241467,6,279412
27056,0.002056,172.217.194.0-255,1484,242951,6,279412
27057,0.0021,172.31.36.0-255,66,243017,6,279412
27058,0.002118,172.31.36.0-255,66,243083,6,279412
27059,0.002122,172.217.194.0-255,2902,245985,6,279412
27060,0.002125,172.31.36.0-255,66,246051,6,279412
27061,0.002157,172.217.194.0-255,10692,256743,6,279412
27062,0.00216,172.31.36.0-255,66,256809,6,279412
27063,0.002175,172.31.36.0-255,66,256875,6,279412
27064,0.002181,172.217.194.0-255,5738,262613,6,279412
27065,0.002184,172.31.36.0-255,66,262679,6,279412
27066,0.002225,172.217.194.0-255,7156,269835,6,279412
27067,0.002228,172.31.36.0-255,66,269901,6,279412
27068,0.002253,172.217.194.0-255,9274,279175,6,279412
27069,0.002256,172.31.36.0-255,66,279241,6,279412
27070,0.002299,172.31.36.0-255,66,279307,6,279412
27071,0.004505,172.217.194.0-255,105,279412,6,279412
27072,0.0,172.217.194.0-255,150,150,6,240087
27073,2.3e-05,172.31.36.0-255,66,216,6,240087
27074,3e-05,172.217.194.0-255,1484,1700,6,240087
27075,3.4e-05,172.31.36.0-255,66,1766,6,240087
27076,4e-05,172.217.194.0-255,2902,4668,6,240087
27077,4.3e-05,172.31.36.0-255,66,4734,6,240087
27078,5.1e-05,172.217.194.0-255,7156,11890,6,240087
27079,5.4e-05,172.31.36.0-255,66,11956,6,240087
27080,5.8e-05,172.217.194.0-255,2068,14024,6,240087
27081,6.1e-05,172.31.36.0-255,66,14090,6,240087
27082,0.000172,172.217.194.0-255,1484,15574,6,240087
27083,0.000176,172.31.36.0-255,66,15640,6,240087
27084,0.000183,172.217.194.0-255,2902,18542,6,240087
27085,0.000186,172.31.36.0-255,66,18608,6,240087
27086,0.000192,172.217.194.0-255,5738,24346,6,240087
27087,0.000194,172.31.36.0-255,66,24412,6,240087
27088,0.000199,172.217.194.0-255,2902,27314,6,240087
27089,0.000201,172.31.36.0-255,66,27380,6,240087
27090,0.000231,172.217.194.0-255,3961,31341,6,240087
27091,0.000234,172.31.36.0-255,66,31407,6,240087
27092,0.000237,172.217.194.0-255,1484,32891,6,240087
27093,0.000239,172.31.36.0-255,66,32957,6,240087
27094,0.000266,172.31.36.0-255,66,33023,6,240087
27095,0.000278,172.217.194.0-255,1484,34507,6,240087
27096,0.00028,172.31.36.0-255,66,34573,6,240087
27097,0.000285,172.217.194.0-255,2543,37116,6,240087
27098,0.000287,172.31.36.0-255,66,37182,6,240087
27099,0.000374,172.217.194.0-255,1484,38666,6,240087
27100,0.000378,172.31.36.0-255,66,38732,6,240087
27101,0.0004,172.217.194.0-255,2902,41634,6,240087
27102,0.000403,172.31.36.0-255,66,41700,6,240087
27103,0.000406,172.217.194.0-255,1484,43184,6,240087
27104,0.000423,172.217.194.0-255,4320,47504,6,240087
27105,0.000425,172.31.36.0-255,66,47570,6,240087
27106,0.000433,172.217.194.0-255,6797,54367,6,240087
27107,0.000436,172.31.36.0-255,66,54433,6,240087
27108,0.000439,172.217.194.0-255,646,55079,6,240087
27109,0.000739,172.217.194.0-255,1484,56563,6,240087
27110,0.000744,172.31.36.0-255,66,56629,6,240087
27111,0.00075,172.217.194.0-255,2902,59531,6,240087
27112,0.000752,172.31.36.0-255,66,59597,6,240087
27113,0.000755,172.217.194.0-255,1484,61081,6,240087
27114,0.000789,172.217.194.0-255,4320,65401,6,240087
27115,0.000792,172.31.36.0-255,66,65467,6,240087
27116,0.000806,172.31.36.0-255,66,65533,6,240087
27117,0.000841,172.217.194.0-255,10692,76225,6,240087
27118,0.000846,172.31.36.0-255,66,76291,6,240087
27119,0.000924,172.217.194.0-255,1484,77775,6,240087
27120,0.00093,172.217.194.0-255,2902,80677,6,240087
27121,0.000934,172.31.36.0-255,66,80743,6,240087
27122,0.000937,172.217.194.0-255,1484,82227,6,240087
27123,0.000957,172.217.194.0-255,4320,86547,6,240087
27124,0.00096,172.31.36.0-255,66,86613,6,240087
27125,0.000963,172.217.194.0-255,1484,88097,6,240087
27126,0.000979,172.217.194.0-255,7156,95253,6,240087
27127,0.000981,172.31.36.0-255,66,95319,6,240087
27128,0.001003,172.217.194.0-255,4320,99639,6,240087
27129,0.001006,172.31.36.0-255,66,99705,6,240087
27130,0.001026,172.217.194.0-255,1484,101189,6,240087
27131,0.001046,172.217.194.0-255,9274,110463,6,240087
27132,0.001048,172.31.36.0-255,66,110529,6,240087
27133,0.001117,172.217.194.0-255,1484,112013,6,240087
27134,0.001122,172.217.194.0-255,2902,114915,6,240087
27135,0.001125,172.31.36.0-255,66,114981,6,240087
27136,0.00113,172.217.194.0-255,2902,117883,6,240087
27137,0.001132,172.31.36.0-255,66,117949,6,240087
27138,0.001145,172.217.194.0-255,2902,120851,6,240087
27139,0.001147,172.31.36.0-255,66,120917,6,240087
27140,0.001167,172.217.194.0-255,1484,122401,6,240087
27141,0.001204,172.31.36.0-255,66,122467,6,240087
27142,0.001272,172.217.194.0-255,10692,133159,6,240087
27143,0.001275,172.31.36.0-255,66,133225,6,240087
27144,0.001501,172.217.194.0-255,1484,134709,6,240087
27145,0.001518,172.217.194.0-255,1484,136193,6,240087
27146,0.001521,172.31.36.0-255,66,136259,6,240087
27147,0.001542,172.217.194.0-255,1484,137743,6,240087
27148,0.001547,172.217.194.0-255,4320,142063,6,240087
27149,0.001549,172.31.36.0-255,66,142129,6,240087
27150,0.001558,172.217.194.0-255,8574,150703,6,240087
27151,0.001561,172.31.36.0-255,66,150769,6,240087
27152,0.001584,172.217.194.0-255,4320,155089,6,240087
27153,0.001589,172.31.36.0-255,66,155155,6,240087
27154,0.001623,172.31.36.0-255,66,155221,6,240087
27155,0.00194,172.217.194.0-255,1484,156705,6,240087
27156,0.001944,172.217.194.0-255,1484,158189,6,240087
27157,0.001947,172.31.36.0-255,66,158255,6,240087
27158,0.001968,172.217.194.0-255,1484,159739,6,240087
27159,0.001975,172.217.194.0-255,5738,165477,6,240087
27160,0.001977,172.31.36.0-255,66,165543,6,240087
27161,0.001981,172.217.194.0-255,1484,167027,6,240087
27162,0.002015,172.31.36.0-255,66,167093,6,240087
27163,0.002059,172.217.194.0-255,10692,177785,6,240087
27164,0.002063,172.31.36.0-255,66,177851,6,240087
27165,0.002082,172.217.194.0-255,2902,180753,6,240087
27166,0.002084,172.31.36.0-255,66,180819,6,240087
27167,0.002088,172.217.194.0-255,1484,182303,6,240087
27168,0.002103,172.217.194.0-255,2902,185205,6,240087
27169,0.002105,172.31.36.0-255,66,185271,6,240087
27170,0.00211,172.217.194.0-255,4320,189591,6,240087
27171,0.002113,172.31.36.0-255,66,189657,6,240087
27172,0.00215,172.217.194.0-255,4320,193977,6,240087
27173,0.002153,172.31.36.0-255,66,194043,6,240087
27174,0.00217,172.31.36.0-255,66,194109,6,240087
27175,0.002216,172.31.36.0-255,66,194175,6,240087
27176,0.002225,172.217.194.0-255,7156,201331,6,240087
27177,0.002227,172.31.36.0-255,66,201397,6,240087
27178,0.002252,172.217.194.0-255,5738,207135,6,240087
27179,0.002255,172.31.36.0-255,66,207201,6,240087
27180,0.00226,172.217.194.0-255,3602,210803,6,240087
27181,0.002262,172.31.36.0-255,66,210869,6,240087
27182,0.002526,172.217.194.0-255,1484,212353,6,240087
27183,0.002532,172.217.194.0-255,2902,215255,6,240087
27184,0.002535,172.31.36.0-255,66,215321,6,240087
27185,0.002539,172.217.194.0-255,1484,216805,6,240087
27186,0.002559,172.217.194.0-255,4320,221125,6,240087
27187,0.002561,172.31.36.0-255,66,221191,6,240087
27188,0.00257,172.217.194.0-255,8574,229765,6,240087
27189,0.002573,172.31.36.0-255,66,229831,6,240087
27190,0.002588,172.217.194.0-255,4320,234151,6,240087
27191,0.00259,172.31.36.0-255,66,234217,6,240087
27192,0.002593,172.217.194.0-255,1484,235701,6,240087
27193,0.005192,172.217.194.0-255,4320,240021,6,240087
27194,0.008687,172.31.36.0-255,66,240087,6,240087
27195,0.0,172.253.118.0-255,152,152,6,288717
27196,2.3e-05,172.31.36.0-255,66,218,6,288717
27197,3.1e-05,172.253.118.0-255,1484,1702,6,288717
27198,3.5e-05,172.31.36.0-255,66,1768,6,288717
27199,4.8e-05,172.253.118.0-255,2902,4670,6,288717
27200,5.1e-05,172.31.36.0-255,66,4736,6,288717
27201,5.9e-05,172.253.118.0-255,7156,11892,6,288717
27202,6.1e-05,172.31.36.0-255,66,11958,6,288717
27203,6.5e-05,172.253.118.0-255,2104,14062,6,288717
27204,6.9e-05,172.31.36.0-255,66,14128,6,288717
27205,7.4e-05,172.253.118.0-255,1484,15612,6,288717
27206,7.6e-05,172.31.36.0-255,66,15678,6,288717
27207,0.00011,172.253.118.0-255,9992,25670,6,288717
27208,0.000114,172.31.36.0-255,66,25736,6,288717
27209,0.00012,172.253.118.0-255,5379,31115,6,288717
27210,0.000123,172.31.36.0-255,66,31181,6,288717
27211,0.000187,172.253.118.0-255,1484,32665,6,288717
27212,0.000189,172.31.36.0-255,66,32731,6,288717
27213,0.000214,172.253.118.0-255,2902,35633,6,288717
27214,0.000217,172.31.36.0-255,66,35699,6,288717
27215,0.000224,172.253.118.0-255,5738,41437,6,288717
27216,0.000226,172.31.36.0-255,66,41503,6,288717
27217,0.000286,172.31.36.0-255,66,41569,6,288717
27218,0.000313,172.253.118.0-255,9906,51475,6,288717
27219,0.000316,172.31.36.0-255,66,51541,6,288717
27220,0.000319,172.253.118.0-255,127,51668,6,288717
27221,0.000321,172.31.36.0-255,66,51734,6,288717
27222,0.000428,172.253.118.0-255,1484,53218,6,288717
27223,0.000432,172.31.36.0-255,66,53284,6,288717
27224,0.000438,172.253.118.0-255,2902,56186,6,288717
27225,0.00044,172.31.36.0-255,66,56252,6,288717
27226,0.000477,172.253.118.0-255,5738,61990,6,288717
27227,0.00048,172.31.36.0-255,66,62056,6,288717
27228,0.000504,172.253.118.0-255,2902,64958,6,288717
27229,0.000506,172.31.36.0-255,66,65024,6,288717
27230,0.000528,172.253.118.0-255,7156,72180,6,288717
27231,0.000531,172.31.36.0-255,66,72246,6,288717
27232,0.000556,172.253.118.0-255,3961,76207,6,288717
27233,0.000559,172.31.36.0-255,66,76273,6,288717
27234,0.000569,172.253.118.0-255,9633,85906,6,288717
27235,0.000571,172.31.36.0-255,66,85972,6,288717
27236,0.000687,172.253.118.0-255,1484,87456,6,288717
27237,0.000694,172.253.118.0-255,2902,90358,6,288717
27238,0.000697,172.31.36.0-255,66,90424,6,288717
27239,0.000724,172.253.118.0-255,5738,96162,6,288717
27240,0.000728,172.31.36.0-255,66,96228,6,288717
27241,0.000732,172.253.118.0-255,2902,99130,6,288717
27242,0.000735,172.31.36.0-255,66,99196,6,288717
27243,0.000782,172.253.118.0-255,9992,109188,6,288717
27244,0.000786,172.31.36.0-255,66,109254,6,288717
27245,0.000793,172.253.118.0-255,7156,116410,6,288717
27246,0.000795,172.31.36.0-255,66,116476,6,288717
27247,0.000889,172.253.118.0-255,3602,120078,6,288717
27248,0.000903,172.31.36.0-255,66,120144,6,288717
27249,0.000932,172.253.118.0-255,1484,121628,6,288717
27250,0.000947,172.253.118.0-255,2902,124530,6,288717
27251,0.000952,172.253.118.0-255,2902,127432,6,288717
27252,0.000978,172.253.118.0-255,7156,134588,6,288717
27253,0.001021,172.31.36.0-255,66,134654,6,288717
27254,0.00106,172.253.118.0-255,3602,138256,6,288717
27255,0.001071,172.253.118.0-255,1484,139740,6,288717
27256,0.001075,172.253.118.0-255,1484,141224,6,288717
27257,0.001084,172.31.36.0-255,66,141290,6,288717
27258,0.001092,172.253.118.0-255,1484,142774,6,288717
27259,0.001104,172.253.118.0-255,5738,148512,6,288717
27260,0.001111,172.253.118.0-255,6797,155309,6,288717
27261,0.001117,172.31.36.0-255,66,155375,6,288717
27262,0.001166,172.253.118.0-255,1484,156859,6,288717
27263,0.001174,172.253.118.0-255,7156,164015,6,288717
27264,0.00118,172.31.36.0-255,66,164081,6,288717
27265,0.001199,172.253.118.0-255,5738,169819,6,288717
27266,0.001253,172.31.36.0-255,66,169885,6,288717
27267,0.001305,172.31.36.0-255,66,169951,6,288717
27268,0.001694,172.253.118.0-255,1484,171435,6,288717
27269,0.001702,172.253.118.0-255,2902,174337,6,288717
27270,0.001707,172.253.118.0-255,2902,177239,6,288717
27271,0.00172,172.253.118.0-255,2902,180141,6,288717
27272,0.00174,172.253.118.0-255,7156,187297,6,288717
27273,0.00175,172.31.36.0-255,66,187363,6,288717
27274,0.001769,172.253.118.0-255,5738,193101,6,288717
27275,0.001776,172.253.118.0-255,7156,200257,6,288717
27276,0.001796,172.253.118.0-255,3602,203859,6,288717
27277,0.001812,172.31.36.0-255,66,203925,6,288717
27278,0.00184,172.253.118.0-255,4320,208245,6,288717
27279,0.001843,172.31.36.0-255,66,208311,6,288717
27280,0.001851,172.253.118.0-255,7156,215467,6,288717
27281,0.001875,172.253.118.0-255,1484,216951,6,288717
27282,0.001879,172.253.118.0-255,2902,219853,6,288717
27283,0.001886,172.31.36.0-255,66,219919,6,288717
27284,0.001926,172.253.118.0-255,6438,226357,6,288717
27285,0.001944,172.31.36.0-255,66,226423,6,288717
27286,0.001967,172.253.118.0-255,1484,227907,6,288717
27287,0.001972,172.253.118.0-255,2902,230809,6,288717
27288,0.001978,172.253.118.0-255,5738,236547,6,288717
27289,0.001989,172.31.36.0-255,66,236613,6,288717
27290,0.001997,172.253.118.0-255,2902,239515,6,288717
27291,0.002003,172.31.36.0-255,66,239581,6,288717
27292,0.002022,172.253.118.0-255,9992,249573,6,288717
27293,0.002055,172.31.36.0-255,66,249639,6,288717
27294,0.002075,172.253.118.0-255,10692,260331,6,288717
27295,0.002124,172.253.118.0-255,1484,261815,6,288717
27296,0.002129,172.253.118.0-255,2902,264717,6,288717
27297,0.002136,172.253.118.0-255,5738,270455,6,288717
27298,0.002156,172.253.118.0-255,4320,274775,6,288717
27299,0.002163,172.31.36.0-255,66,274841,6,288717
27300,0.002189,172.253.118.0-255,4320,279161,6,288717
27301,0.0022,172.253.118.0-255,9288,288449,6,288717
27302,0.002202,172.253.118.0-255,97,288546,6,288717
27303,0.002211,172.31.36.0-255,66,288612,6,288717
27304,0.002239,172.253.118.0-255,105,288717,6,288717
27305,0.0,172.217.24.0-255,146,146,6,109479
27306,1.6e-05,172.31.36.0-255,66,212,6,109479
27307,2.4e-05,172.217.24.0-255,1484,1696,6,109479
27308,2.8e-05,172.31.36.0-255,66,1762,6,109479
27309,3.5e-05,172.217.24.0-255,2902,4664,6,109479
27310,3.9e-05,172.31.36.0-255,66,4730,6,109479
27311,4.3e-05,172.217.24.0-255,2902,7632,6,109479
27312,4.6e-05,172.31.36.0-255,66,7698,6,109479
27313,5.2e-05,172.217.24.0-255,4320,12018,6,109479
27314,5.6e-05,172.31.36.0-255,66,12084,6,109479
27315,6.1e-05,172.217.24.0-255,2902,14986,6,109479
27316,6.3e-05,172.31.36.0-255,66,15052,6,109479
27317,9.9e-05,172.217.24.0-255,6297,21349,6,109479
27318,0.000102,172.31.36.0-255,66,21415,6,109479
27319,0.000112,172.217.24.0-255,9633,31048,6,109479
27320,0.000115,172.31.36.0-255,66,31114,6,109479
27321,0.00025,172.217.24.0-255,1484,32598,6,109479
27322,0.000254,172.31.36.0-255,66,32664,6,109479
27323,0.00026,172.217.24.0-255,2902,35566,6,109479
27324,0.000262,172.31.36.0-255,66,35632,6,109479
27325,0.000268,172.217.24.0-255,5738,41370,6,109479
27326,0.000272,172.31.36.0-255,66,41436,6,109479
27327,0.000302,172.217.24.0-255,6797,48233,6,109479
27328,0.000304,172.31.36.0-255,66,48299,6,109479
27329,0.000561,172.217.24.0-255,1484,49783,6,109479
27330,0.000567,172.31.36.0-255,66,49849,6,109479
27331,0.000572,172.217.24.0-255,2902,52751,6,109479
27332,0.000575,172.31.36.0-255,66,52817,6,109479
27333,0.00058,172.217.24.0-255,4320,57137,6,109479
27334,0.000583,172.31.36.0-255,66,57203,6,109479
27335,0.000595,172.217.24.0-255,1484,58687,6,109479
27336,0.000601,172.217.24.0-255,4320,63007,6,109479
27337,0.000604,172.31.36.0-255,66,63073,6,109479
27338,0.000612,172.31.36.0-255,66,63139,6,109479
27339,0.000638,172.217.24.0-255,2833,65972,6,109479
27340,0.00064,172.31.36.0-255,66,66038,6,109479
27341,0.001047,172.217.24.0-255,138,66176,6,109479
27342,0.00107,172.31.36.0-255,66,66242,6,109479
27343,0.001259,172.217.24.0-255,1484,67726,6,109479
27344,0.001268,172.217.24.0-255,2902,70628,6,109479
27345,0.001272,172.31.36.0-255,66,70694,6,109479
27346,0.00128,172.217.24.0-255,5738,76432,6,109479
27347,0.001282,172.31.36.0-255,66,76498,6,109479
27348,0.001338,172.31.36.0-255,66,76564,6,109479
27349,0.001349,172.217.24.0-255,9633,86197,6,109479
27350,0.001352,172.31.36.0-255,66,86263,6,109479
27351,0.003308,172.217.24.0-255,5738,92001,6,109479
27352,0.003314,172.31.36.0-255,66,92067,6,109479
27353,0.005253,172.217.24.0-255,5738,97805,6,109479
27354,0.005259,172.31.36.0-255,66,97871,6,109479
27355,0.007196,172.217.24.0-255,5738,103609,6,109479
27356,0.007201,172.31.36.0-255,66,103675,6,109479
27357,0.009142,172.217.24.0-255,5738,109413,6,109479
27358,0.009149,172.31.36.0-255,66,109479,6,109479
27359,0.0,172.217.194.0-255,153,153,6,99226
27360,2.3e-05,172.31.36.0-255,66,219,6,99226
27361,3.1e-05,172.217.194.0-255,1484,1703,6,99226
27362,3.6e-05,172.31.36.0-255,66,1769,6,99226
27363,4.2e-05,172.217.194.0-255,2902,4671,6,99226
27364,4.6e-05,172.31.36.0-255,66,4737,6,99226
27365,5.5e-05,172.217.194.0-255,7156,11893,6,99226
27366,5.8e-05,172.31.36.0-255,66,11959,6,99226
27367,6.2e-05,172.217.194.0-255,2106,14065,6,99226
27368,6.5e-05,172.31.36.0-255,66,14131,6,99226
27369,9.2e-05,172.217.194.0-255,2902,17033,6,99226
27370,9.5e-05,172.31.36.0-255,66,17099,6,99226
27371,0.000101,172.217.194.0-255,4320,21419,6,99226
27372,0.000104,172.31.36.0-255,66,21485,6,99226
27373,0.000134,172.217.194.0-255,8574,30059,6,99226
27374,0.000136,172.31.36.0-255,66,30125,6,99226
27375,0.000188,172.31.36.0-255,66,30191,6,99226
27376,0.000212,172.217.194.0-255,5379,35570,6,99226
27377,0.000215,172.31.36.0-255,66,35636,6,99226
27378,0.000235,172.217.194.0-255,1484,37120,6,99226
27379,0.000238,172.31.36.0-255,66,37186,6,99226
27380,0.000259,172.217.194.0-255,4320,41506,6,99226
27381,0.000262,172.31.36.0-255,66,41572,6,99226
27382,0.000285,172.217.194.0-255,7156,48728,6,99226
27383,0.000287,172.31.36.0-255,66,48794,6,99226
27384,0.000303,172.217.194.0-255,3961,52755,6,99226
27385,0.000305,172.31.36.0-255,66,52821,6,99226
27386,0.00067,172.217.194.0-255,361,53182,6,99226
27387,0.000676,172.31.36.0-255,66,53248,6,99226
27388,0.001095,172.217.194.0-255,1484,54732,6,99226
27389,0.0011,172.31.36.0-255,66,54798,6,99226
27390,0.001107,172.217.194.0-255,2902,57700,6,99226
27391,0.001109,172.31.36.0-255,66,57766,6,99226
27392,0.001137,172.217.194.0-255,5738,63504,6,99226
27393,0.001139,172.31.36.0-255,66,63570,6,99226
27394,0.001168,172.31.36.0-255,66,63636,6,99226
27395,0.001181,172.217.194.0-255,1484,65120,6,99226
27396,0.001215,172.217.194.0-255,4320,69440,6,99226
27397,0.001218,172.31.36.0-255,66,69506,6,99226
27398,0.00124,172.217.194.0-255,6438,75944,6,99226
27399,0.001242,172.31.36.0-255,66,76010,6,99226
27400,0.003199,172.217.194.0-255,5738,81748,6,99226
27401,0.003207,172.31.36.0-255,66,81814,6,99226
27402,0.005141,172.217.194.0-255,5738,87552,6,99226
27403,0.005145,172.31.36.0-255,66,87618,6,99226
27404,0.007111,172.217.194.0-255,5738,93356,6,99226
27405,0.007118,172.31.36.0-255,66,93422,6,99226
27406,0.009086,172.217.194.0-255,5738,99160,6,99226
27407,0.009094,172.31.36.0-255,66,99226,6,99226
27408,0.0,74.125.24.0-255,149,149,6,152349
27409,1.5e-05,172.31.36.0-255,66,215,6,152349
27410,2.2e-05,74.125.24.0-255,1484,1699,6,152349
27411,2.6e-05,172.31.36.0-255,66,1765,6,152349
27412,3.2e-05,74.125.24.0-255,2902,4667,6,152349
27413,3.5e-05,172.31.36.0-255,66,4733,6,152349
27414,3.9e-05,74.125.24.0-255,1484,6217,6,152349
27415,4.2e-05,172.31.36.0-255,66,6283,6,152349
27416,7.4e-05,74.125.24.0-255,5738,12021,6,152349
27417,7.7e-05,172.31.36.0-255,66,12087,6,152349
27418,8.2e-05,74.125.24.0-255,2040,14127,6,152349
27419,8.3e-05,172.31.36.0-255,66,14193,6,152349
27420,0.000173,74.125.24.0-255,1484,15677,6,152349
27421,0.000177,172.31.36.0-255,66,15743,6,152349
27422,0.000181,74.125.24.0-255,2902,18645,6,152349
27423,0.000184,172.31.36.0-255,66,18711,6,152349
27424,0.000188,74.125.24.0-255,2902,21613,6,152349
27425,0.00019,172.31.36.0-255,66,21679,6,152349
27426,0.000214,74.125.24.0-255,2902,24581,6,152349
27427,0.000217,172.31.36.0-255,66,24647,6,152349
27428,0.000226,74.125.24.0-255,6797,31444,6,152349
27429,0.000228,172.31.36.0-255,66,31510,6,152349
27430,0.000256,74.125.24.0-255,7156,38666,6,152349
27431,0.000259,172.31.36.0-255,66,38732,6,152349
27432,0.000264,74.125.24.0-255,2902,41634,6,152349
27433,0.000266,172.31.36.0-255,66,41700,6,152349
27434,0.000284,74.125.24.0-255,5738,47438,6,152349
27435,0.000286,172.31.36.0-255,66,47504,6,152349
27436,0.000307,74.125.24.0-255,1125,48629,6,152349
27437,0.000309,172.31.36.0-255,66,48695,6,152349
27438,0.001288,74.125.24.0-255,1484,50179,6,152349
27439,0.001295,172.31.36.0-255,66,50245,6,152349
27440,0.001306,74.125.24.0-255,2902,53147,6,152349
27441,0.001309,172.31.36.0-255,66,53213,6,152349
27442,0.001316,74.125.24.0-255,5738,58951,6,152349
27443,0.001319,172.31.36.0-255,66,59017,6,152349
27444,0.001363,74.125.24.0-255,6797,65814,6,152349
27445,0.001366,172.31.36.0-255,66,65880,6,152349
27446,0.001422,74.125.24.0-255,1484,67364,6,152349
27447,0.001428,74.125.24.0-255,2902,70266,6,152349
27448,0.00143,172.31.36.0-255,66,70332,6,152349
27449,0.001435,74.125.24.0-255,2902,73234,6,152349
27450,0.001437,172.31.36.0-255,66,73300,6,152349
27451,0.001453,74.125.24.0-255,2902,76202,6,152349
27452,0.001455,172.31.36.0-255,66,76268,6,152349
27453,0.001492,74.125.24.0-255,8574,84842,6,152349
27454,0.001495,172.31.36.0-255,66,84908,6,152349
27455,0.001517,74.125.24.0-255,5379,90287,6,152349
27456,0.001519,172.31.36.0-255,66,90353,6,152349
27457,0.001524,74.125.24.0-255,2902,93255,6,152349
27458,0.001527,172.31.36.0-255,66,93321,6,152349
27459,0.001582,74.125.24.0-255,7378,100699,6,152349
27460,0.001587,172.31.36.0-255,66,100765,6,152349
27461,0.002259,74.125.24.0-255,1484,102249,6,152349
27462,0.00227,74.125.24.0-255,2902,105151,6,152349
27463,0.002274,172.31.36.0-255,66,105217,6,152349
27464,0.002283,74.125.24.0-255,5738,110955,6,152349
27465,0.002285,172.31.36.0-255,66,111021,6,152349
27466,0.002311,74.125.24.0-255,8574,119595,6,152349
27467,0.002314,172.31.36.0-255,66,119661,6,152349
27468,0.002339,74.125.24.0-255,4320,123981,6,152349
27469,0.002342,172.31.36.0-255,66,124047,6,152349
27470,0.002351,74.125.24.0-255,8574,132621,6,152349
27471,0.002353,172.31.36.0-255,66,132687,6,152349
27472,0.002357,74.125.24.0-255,2184,134871,6,152349
27473,0.00236,172.31.36.0-255,66,134937,6,152349
27474,0.004641,74.125.24.0-255,5738,140675,6,152349
27475,0.004645,172.31.36.0-255,66,140741,6,152349
27476,0.006926,74.125.24.0-255,5738,146479,6,152349
27477,0.006933,172.31.36.0-255,66,146545,6,152349
27478,0.009236,74.125.24.0-255,5738,152283,6,152349
27479,0.009244,172.31.36.0-255,66,152349,6,152349
27480,0.0,74.125.200.0-255,150,150,6,202776
27481,2.1e-05,172.31.36.0-255,66,216,6,202776
27482,2.9e-05,74.125.200.0-255,1484,1700,6,202776
27483,3.2e-05,172.31.36.0-255,66,1766,6,202776
27484,3.9e-05,74.125.200.0-255,2902,4668,6,202776
27485,4.3e-05,172.31.36.0-255,66,4734,6,202776
27486,5.8e-05,74.125.200.0-255,1484,6218,6,202776
27487,6e-05,172.31.36.0-255,66,6284,6,202776
27488,6.6e-05,74.125.200.0-255,2902,9186,6,202776
27489,6.8e-05,172.31.36.0-255,66,9252,6,202776
27490,9.7e-05,74.125.200.0-255,2902,12154,6,202776
27491,9.9e-05,172.31.36.0-255,66,12220,6,202776
27492,0.000144,74.125.200.0-255,2003,14223,6,202776
27493,0.000146,172.31.36.0-255,66,14289,6,202776
27494,0.000182,74.125.200.0-255,2902,17191,6,202776
27495,0.000186,172.31.36.0-255,66,17257,6,202776
27496,0.000199,74.125.200.0-255,2902,20159,6,202776
27497,0.000201,172.31.36.0-255,66,20225,6,202776
27498,0.000225,74.125.200.0-255,4320,24545,6,202776
27499,0.000228,172.31.36.0-255,66,24611,6,202776
27500,0.000242,74.125.200.0-255,4320,28931,6,202776
27501,0.000245,172.31.36.0-255,66,28997,6,202776
27502,0.00027,74.125.200.0-255,3961,32958,6,202776
27503,0.000273,172.31.36.0-255,66,33024,6,202776
27504,0.000281,74.125.200.0-255,8574,41598,6,202776
27505,0.000284,172.31.36.0-255,66,41664,6,202776
27506,0.000306,74.125.200.0-255,2902,44566,6,202776
27507,0.000309,172.31.36.0-255,66,44632,6,202776
27508,0.000329,74.125.200.0-255,3961,48593,6,202776
27509,0.000331,172.31.36.0-255,66,48659,6,202776
27510,0.00061,74.125.200.0-255,1484,50143,6,202776
27511,0.000615,172.31.36.0-255,66,50209,6,202776
27512,0.000633,74.125.200.0-255,2902,53111,6,202776
27513,0.000635,172.31.36.0-255,66,53177,6,202776
27514,0.000649,74.125.200.0-255,2902,56079,6,202776
27515,0.000652,172.31.36.0-255,66,56145,6,202776
27516,0.000657,74.125.200.0-255,4320,60465,6,202776
27517,0.000659,172.31.36.0-255,66,60531,6,202776
27518,0.000708,74.125.200.0-255,2902,63433,6,202776
27519,0.000711,172.31.36.0-255,66,63499,6,202776
27520,0.000748,74.125.200.0-255,2543,66042,6,202776
27521,0.000752,172.31.36.0-255,66,66108,6,202776
27522,0.00085,74.125.200.0-255,1484,67592,6,202776
27523,0.000871,74.125.200.0-255,2902,70494,6,202776
27524,0.000874,172.31.36.0-255,66,70560,6,202776
27525,0.000897,74.125.200.0-255,5738,76298,6,202776
27526,0.000899,74.125.200.0-255,1484,77782,6,202776
27527,0.000903,172.31.36.0-255,66,77848,6,202776
27528,0.000965,74.125.200.0-255,7156,85004,6,202776
27529,0.000969,172.31.36.0-255,66,85070,6,202776
27530,0.000988,74.125.200.0-255,2543,87613,6,202776
27531,0.00099,172.31.36.0-255,66,87679,6,202776
27532,0.000996,74.125.200.0-255,2902,90581,6,202776
27533,0.000997,172.31.36.0-255,66,90647,6,202776
27534,0.001012,74.125.200.0-255,4320,94967,6,202776
27535,0.001014,172.31.36.0-255,66,95033,6,202776
27536,0.001032,74.125.200.0-255,2902,97935,6,202776
27537,0.001034,172.31.36.0-255,66,98001,6,202776
27538,0.001038,74.125.200.0-255,2902,100903,6,202776
27539,0.001041,172.31.36.0-255,66,100969,6,202776
27540,0.001043,74.125.200.0-255,287,101256,6,202776
27541,0.001295,74.125.200.0-255,1484,102740,6,202776
27542,0.0013,172.31.36.0-255,66,102806,6,202776
27543,0.001321,74.125.200.0-255,1484,104290,6,202776
27544,0.001342,74.125.200.0-255,2902,107192,6,202776
27545,0.001345,172.31.36.0-255,66,107258,6,202776
27546,0.001374,74.125.200.0-255,1484,108742,6,202776
27547,0.001396,74.125.200.0-255,4320,113062,6,202776
27548,0.001398,172.31.36.0-255,66,113128,6,202776
27549,0.001403,74.125.200.0-255,2902,116030,6,202776
27550,0.001405,172.31.36.0-255,66,116096,6,202776
27551,0.00141,74.125.200.0-255,4320,120416,6,202776
27552,0.001412,172.31.36.0-255,66,120482,6,202776
27553,0.00142,74.125.200.0-255,8574,129056,6,202776
27554,0.001423,172.31.36.0-255,66,129122,6,202776
27555,0.001428,74.125.200.0-255,4320,133442,6,202776
27556,0.00143,172.31.36.0-255,66,133508,6,202776
27557,0.001464,74.125.200.0-255,2184,135692,6,202776
27558,0.001467,172.31.36.0-255,66,135758,6,202776
27559,0.001801,74.125.200.0-255,1484,137242,6,202776
27560,0.001824,74.125.200.0-255,1484,138726,6,202776
27561,0.001828,172.31.36.0-255,66,138792,6,202776
27562,0.00185,74.125.200.0-255,2902,141694,6,202776
27563,0.001852,172.31.36.0-255,66,141760,6,202776
27564,0.001858,74.125.200.0-255,5738,147498,6,202776
27565,0.00186,172.31.36.0-255,66,147564,6,202776
27566,0.001865,74.125.200.0-255,2902,150466,6,202776
27567,0.001867,172.31.36.0-255,66,150532,6,202776
27568,0.001888,74.125.200.0-255,2902,153434,6,202776
27569,0.001892,74.125.200.0-255,4320,157754,6,202776
27570,0.001897,172.31.36.0-255,66,157820,6,202776
27571,0.001904,172.31.36.0-255,66,157886,6,202776
27572,0.001909,74.125.200.0-255,2902,160788,6,202776
27573,0.001911,172.31.36.0-255,66,160854,6,202776
27574,0.001932,74.125.200.0-255,9274,170128,6,202776
27575,0.001934,172.31.36.0-255,66,170194,6,202776
27576,0.001998,74.125.200.0-255,1484,171678,6,202776
27577,0.002002,74.125.200.0-255,1484,173162,6,202776
27578,0.002004,172.31.36.0-255,66,173228,6,202776
27579,0.002023,74.125.200.0-255,1484,174712,6,202776
27580,0.002026,74.125.200.0-255,1484,176196,6,202776
27581,0.002028,172.31.36.0-255,66,176262,6,202776
27582,0.002033,74.125.200.0-255,2902,179164,6,202776
27583,0.002035,172.31.36.0-255,66,179230,6,202776
27584,0.002062,74.125.200.0-255,2902,182132,6,202776
27585,0.002065,172.31.36.0-255,66,182198,6,202776
27586,0.002084,74.125.200.0-255,2902,185100,6,202776
27587,0.002087,172.31.36.0-255,66,185166,6,202776
27588,0.00209,74.125.200.0-255,1484,186650,6,202776
27589,0.004109,74.125.200.0-255,1484,188134,6,202776
27590,0.004118,172.31.36.0-255,66,188200,6,202776
27591,0.004136,74.125.200.0-255,2902,191102,6,202776
27592,0.004139,172.31.36.0-255,66,191168,6,202776
27593,0.006199,74.125.200.0-255,5738,196906,6,202776
27594,0.006206,172.31.36.0-255,66,196972,6,202776
27595,0.008259,74.125.200.0-255,5738,202710,6,202776
27596,0.008264,172.31.36.0-255,66,202776,6,202776
27597,0.0,74.125.200.0-255,152,152,6,236820
27598,2.7e-05,172.31.36.0-255,66,218,6,236820
27599,3.4e-05,74.125.200.0-255,1484,1702,6,236820
27600,3.9e-05,172.31.36.0-255,66,1768,6,236820
27601,4.3e-05,74.125.200.0-255,2902,4670,6,236820
27602,4.6e-05,172.31.36.0-255,66,4736,6,236820
27603,6.7e-05,74.125.200.0-255,4320,9056,6,236820
27604,6.9e-05,172.31.36.0-255,66,9122,6,236820
27605,9.7e-05,74.125.200.0-255,4875,13997,6,236820
27606,9.9e-05,172.31.36.0-255,66,14063,6,236820
27607,0.000102,74.125.200.0-255,1484,15547,6,236820
27608,0.000104,172.31.36.0-255,66,15613,6,236820
27609,0.000119,74.125.200.0-255,2902,18515,6,236820
27610,0.000121,172.31.36.0-255,66,18581,6,236820
27611,0.000147,74.125.200.0-255,4320,22901,6,236820
27612,0.00015,172.31.36.0-255,66,22967,6,236820
27613,0.000169,74.125.200.0-255,1484,24451,6,236820
27614,0.000171,172.31.36.0-255,66,24517,6,236820
27615,0.000174,74.125.200.0-255,1484,26001,6,236820
27616,0.000176,172.31.36.0-255,66,26067,6,236820
27617,0.000181,74.125.200.0-255,2902,28969,6,236820
27618,0.000183,172.31.36.0-255,66,29035,6,236820
27619,0.000225,74.125.200.0-255,2543,31578,6,236820
27620,0.000228,172.31.36.0-255,66,31644,6,236820
27621,0.000348,74.125.200.0-255,1484,33128,6,236820
27622,0.000352,172.31.36.0-255,66,33194,6,236820
27623,0.000357,74.125.200.0-255,2902,36096,6,236820
27624,0.00036,172.31.36.0-255,66,36162,6,236820
27625,0.000378,74.125.200.0-255,5738,41900,6,236820
27626,0.000381,172.31.36.0-255,66,41966,6,236820
27627,0.000414,74.125.200.0-255,1484,43450,6,236820
27628,0.000417,172.31.36.0-255,66,43516,6,236820
27629,0.00044,74.125.200.0-255,7156,50672,6,236820
27630,0.000444,172.31.36.0-255,66,50738,6,236820
27631,0.000463,74.125.200.0-255,5379,56117,6,236820
27632,0.000466,172.31.36.0-255,66,56183,6,236820
27633,0.000472,74.125.200.0-255,5738,61921,6,236820
27634,0.000474,172.31.36.0-255,66,61987,6,236820
27635,0.000493,74.125.200.0-255,3961,65948,6,236820
27636,0.000495,172.31.36.0-255,66,66014,6,236820
27637,0.000532,74.125.200.0-255,362,66376,6,236820
27638,0.000621,74.125.200.0-255,1484,67860,6,236820
27639,0.000624,172.31.36.0-255,66,67926,6,236820
27640,0.000652,74.125.200.0-255,2902,70828,6,236820
27641,0.000655,172.31.36.0-255,66,70894,6,236820
27642,0.000658,74.125.200.0-255,1484,72378,6,236820
27643,0.000674,74.125.200.0-255,2902,75280,6,236820
27644,0.000676,172.31.36.0-255,66,75346,6,236820
27645,0.000692,74.125.200.0-255,2902,78248,6,236820
27646,0.000694,172.31.36.0-255,66,78314,6,236820
27647,0.000711,74.125.200.0-255,2902,81216,6,236820
27648,0.000714,172.31.36.0-255,66,81282,6,236820
27649,0.000718,74.125.200.0-255,4320,85602,6,236820
27650,0.00072,172.31.36.0-255,66,85668,6,236820
27651,0.000747,74.125.200.0-255,7156,92824,6,236820
27652,0.000751,74.125.200.0-255,4320,97144,6,236820
27653,0.000751,172.31.36.0-255,66,97210,6,236820
27654,0.000754,172.31.36.0-255,66,97276,6,236820
27655,0.000792,74.125.200.0-255,3918,101194,6,236820
27656,0.000795,172.31.36.0-255,66,101260,6,236820
27657,0.001029,74.125.200.0-255,1484,102744,6,236820
27658,0.001035,74.125.200.0-255,2902,105646,6,236820
27659,0.001038,172.31.36.0-255,66,105712,6,236820
27660,0.001062,74.125.200.0-255,5738,111450,6,236820
27661,0.001064,172.31.36.0-255,66,111516,6,236820
27662,0.001076,74.125.200.0-255,2902,114418,6,236820
27663,0.001079,172.31.36.0-255,66,114484,6,236820
27664,0.001097,74.125.200.0-255,5738,120222,6,236820
27665,0.0011,172.31.36.0-255,66,120288,6,236820
27666,0.001103,74.125.200.0-255,1484,121772,6,236820
27667,0.001118,74.125.200.0-255,4320,126092,6,236820
27668,0.001121,172.31.36.0-255,66,126158,6,236820
27669,0.00113,74.125.200.0-255,4320,130478,6,236820
27670,0.001132,172.31.36.0-255,66,130544,6,236820
27671,0.001137,74.125.200.0-255,5020,135564,6,236820
27672,0.001139,172.31.36.0-255,66,135630,6,236820
27673,0.001337,74.125.200.0-255,1484,137114,6,236820
27674,0.001345,74.125.200.0-255,1484,138598,6,236820
27675,0.001349,172.31.36.0-255,66,138664,6,236820
27676,0.001363,74.125.200.0-255,1484,140148,6,236820
27677,0.001369,74.125.200.0-255,5738,145886,6,236820
27678,0.001372,172.31.36.0-255,66,145952,6,236820
27679,0.001375,74.125.200.0-255,1484,147436,6,236820
27680,0.001393,74.125.200.0-255,2902,150338,6,236820
27681,0.001396,172.31.36.0-255,66,150404,6,236820
27682,0.0014,74.125.200.0-255,2902,153306,6,236820
27683,0.001402,172.31.36.0-255,66,153372,6,236820
27684,0.001417,74.125.200.0-255,2902,156274,6,236820
27685,0.001419,172.31.36.0-255,66,156340,6,236820
27686,0.001441,74.125.200.0-255,7156,163496,6,236820
27687,0.001445,172.31.36.0-255,66,163562,6,236820
27688,0.001455,74.125.200.0-255,4320,167882,6,236820
27689,0.001458,172.31.36.0-255,66,167948,6,236820
27690,0.001462,74.125.200.0-255,2184,170132,6,236820
27691,0.001464,172.31.36.0-255,66,170198,6,236820
27692,0.001865,74.125.200.0-255,1484,171682,6,236820
27693,0.001875,74.125.200.0-255,2902,174584,6,236820
27694,0.001879,172.31.36.0-255,66,174650,6,236820
27695,0.001883,74.125.200.0-255,1484,176134,6,236820
27696,0.001901,74.125.200.0-255,4320,180454,6,236820
27697,0.001904,172.31.36.0-255,66,180520,6,236820
27698,0.001932,74.125.200.0-255,2902,183422,6,236820
27699,0.001935,172.31.36.0-255,66,183488,6,236820
27700,0.001955,74.125.200.0-255,4320,187808,6,236820
27701,0.001958,172.31.36.0-255,66,187874,6,236820
27702,0.001986,74.125.200.0-255,1484,189358,6,236820
27703,0.002004,74.125.200.0-255,4320,193678,6,236820
27704,0.002007,172.31.36.0-255,66,193744,6,236820
27705,0.002027,74.125.200.0-255,4320,198064,6,236820
27706,0.002029,172.31.36.0-255,66,198130,6,236820
27707,0.002056,74.125.200.0-255,6438,204568,6,236820
27708,0.002059,172.31.36.0-255,66,204634,6,236820
27709,0.002066,74.125.200.0-255,7156,211790,6,236820
27710,0.002068,172.31.36.0-255,66,211856,6,236820
27711,0.002093,74.125.200.0-255,4320,216176,6,236820
27712,0.002096,172.31.36.0-255,66,216242,6,236820
27713,0.002101,74.125.200.0-255,2902,219144,6,236820
27714,0.002102,172.31.36.0-255,66,219210,6,236820
27715,0.004101,74.125.200.0-255,2902,222112,6,236820
27716,0.004108,172.31.36.0-255,66,222178,6,236820
27717,0.004126,74.125.200.0-255,2902,225080,6,236820
27718,0.004129,172.31.36.0-255,66,225146,6,236820
27719,0.006107,74.125.200.0-255,1484,226630,6,236820
27720,0.006124,74.125.200.0-255,4320,230950,6,236820
27721,0.006126,172.31.36.0-255,66,231016,6,236820
27722,0.008191,74.125.200.0-255,5738,236754,6,236820
27723,0.008196,172.31.36.0-255,66,236820,6,236820
27724,0.0,74.125.24.0-255,146,146,6,209029
27725,1.3e-05,172.31.36.0-255,66,212,6,209029
27726,1.9e-05,74.125.24.0-255,1484,1696,6,209029
27727,4.2e-05,172.31.36.0-255,66,1762,6,209029
27728,4.8e-05,74.125.24.0-255,2902,4664,6,209029
27729,5.1e-05,172.31.36.0-255,66,4730,6,209029
27730,5.4e-05,74.125.24.0-255,1484,6214,6,209029
27731,5.6e-05,172.31.36.0-255,66,6280,6,209029
27732,6.3e-05,74.125.24.0-255,5738,12018,6,209029
27733,6.6e-05,172.31.36.0-255,66,12084,6,209029
27734,9.6e-05,74.125.24.0-255,1967,14051,6,209029
27735,9.8e-05,172.31.36.0-255,66,14117,6,209029
27736,0.000251,74.125.24.0-255,1484,15601,6,209029
27737,0.000255,172.31.36.0-255,66,15667,6,209029
27738,0.000261,74.125.24.0-255,2902,18569,6,209029
27739,0.000263,172.31.36.0-255,66,18635,6,209029
27740,0.000294,74.125.24.0-255,5738,24373,6,209029
27741,0.000297,172.31.36.0-255,66,24439,6,209029
27742,0.000345,172.31.36.0-255,66,24505,6,209029
27743,0.00035,74.125.24.0-255,4320,28825,6,209029
27744,0.000351,172.31.36.0-255,66,28891,6,209029
27745,0.000398,172.31.36.0-255,66,28957,6,209029
27746,0.000417,74.125.24.0-255,5738,34695,6,209029
27747,0.000419,172.31.36.0-255,66,34761,6,209029
27748,0.000423,74.125.24.0-255,2902,37663,6,209029
27749,0.000425,172.31.36.0-255,66,37729,6,209029
27750,0.000444,74.125.24.0-255,1484,39213,6,209029
27751,0.000449,172.31.36.0-255,66,39279,6,209029
27752,0.000472,74.125.24.0-255,3980,43259,6,209029
27753,0.000475,172.31.36.0-255,66,43325,6,209029
27754,0.000477,74.125.24.0-255,332,43657,6,209029
27755,0.000479,172.31.36.0-255,66,43723,6,209029
27756,0.000658,74.125.24.0-255,1484,45207,6,209029
27757,0.000662,172.31.36.0-255,66,45273,6,209029
27758,0.000667,74.125.24.0-255,2902,48175,6,209029
27759,0.00067,172.31.36.0-255,66,48241,6,209029
27760,0.000676,74.125.24.0-255,5738,53979,6,209029
27761,0.000682,172.31.36.0-255,66,54045,6,209029
27762,0.000722,172.31.36.0-255,66,54111,6,209029
27763,0.000729,74.125.24.0-255,7156,61267,6,209029
27764,0.000731,172.31.36.0-255,66,61333,6,209029
27765,0.000772,74.125.24.0-255,3602,64935,6,209029
27766,0.000774,172.31.36.0-255,66,65001,6,209029
27767,0.001574,74.125.24.0-255,1484,66485,6,209029
27768,0.001579,172.31.36.0-255,66,66551,6,209029
27769,0.001587,74.125.24.0-255,2902,69453,6,209029
27770,0.001589,172.31.36.0-255,66,69519,6,209029
27771,0.001596,74.125.24.0-255,5738,75257,6,209029
27772,0.001597,172.31.36.0-255,66,75323,6,209029
27773,0.001605,74.125.24.0-255,2902,78225,6,209029
27774,0.001608,172.31.36.0-255,66,78291,6,209029
27775,0.001612,74.125.24.0-255,2902,81193,6,209029
27776,0.001614,172.31.36.0-255,66,81259,6,209029
27777,0.001644,74.125.24.0-255,7156,88415,6,209029
27778,0.001646,172.31.36.0-255,66,88481,6,209029
27779,0.001649,74.125.24.0-255,1484,89965,6,209029
27780,0.001677,74.125.24.0-255,9274,99239,6,209029
27781,0.001712,74.125.24.0-255,1484,100723,6,209029
27782,0.001722,74.125.24.0-255,2902,103625,6,209029
27783,0.001725,74.125.24.0-255,1484,105109,6,209029
27784,0.001745,74.125.24.0-255,4320,109429,6,209029
27785,0.001833,74.125.24.0-255,8574,118003,6,209029
27786,0.001846,74.125.24.0-255,2184,120187,6,209029
27787,0.001916,74.125.24.0-255,1484,121671,6,209029
27788,0.001921,74.125.24.0-255,2902,124573,6,209029
27789,0.00194,74.125.24.0-255,5738,130311,6,209029
27790,0.001958,74.125.24.0-255,5738,136049,6,209029
27791,0.001971,74.125.24.0-255,4320,140369,6,209029
27792,0.002139,74.125.24.0-255,1484,141853,6,209029
27793,0.002146,74.125.24.0-255,2902,144755,6,209029
27794,0.002172,74.125.24.0-255,5738,150493,6,209029
27795,0.002213,74.125.24.0-255,9992,160485,6,209029
27796,0.002224,74.125.24.0-255,766,161251,6,209029
27797,0.002251,74.125.24.0-255,2902,164153,6,209029
27798,0.002306,74.125.24.0-255,8574,172727,6,209029
27799,0.002313,74.125.24.0-255,7856,180583,6,209029
27800,0.002334,74.125.24.0-255,2902,183485,6,209029
27801,0.002387,74.125.24.0-255,7156,190641,6,209029
27802,0.002431,74.125.24.0-255,7156,197797,6,209029
27803,0.002468,74.125.24.0-255,2184,199981,6,209029
27804,0.002546,74.125.24.0-255,5738,205719,6,209029
27805,0.002571,74.125.24.0-255,2902,208621,6,209029
27806,0.004397,172.31.36.0-255,66,208687,6,209029
27807,0.006904,74.125.24.0-255,105,208792,6,209029
27808,0.00704,172.31.36.0-255,66,208858,6,209029
27809,0.007077,172.31.36.0-255,105,208963,6,209029
27810,0.009552,74.125.24.0-255,66,209029,6,209029
27811,0.0,172.217.194.0-255,146,146,6,306873
27812,3.4e-05,172.31.36.0-255,66,212,6,306873
27813,4.2e-05,172.217.194.0-255,1484,1696,6,306873
27814,4.6e-05,172.31.36.0-255,66,1762,6,306873
27815,5.1e-05,172.217.194.0-255,2902,4664,6,306873
27816,6.1e-05,172.31.36.0-255,66,4730,6,306873
27817,6.9e-05,172.217.194.0-255,7156,11886,6,306873
27818,7.2e-05,172.31.36.0-255,66,11952,6,306873
27819,7.6e-05,172.217.194.0-255,1949,13901,6,306873
27820,7.9e-05,172.31.36.0-255,66,13967,6,306873
27821,0.000106,172.217.194.0-255,2902,16869,6,306873
27822,0.000109,172.31.36.0-255,66,16935,6,306873
27823,0.000135,172.217.194.0-255,7156,24091,6,306873
27824,0.000139,172.31.36.0-255,66,24157,6,306873
27825,0.000152,172.31.36.0-255,66,24223,6,306873
27826,0.000192,172.217.194.0-255,8574,32797,6,306873
27827,0.000196,172.31.36.0-255,66,32863,6,306873
27828,0.000223,172.217.194.0-255,3602,36465,6,306873
27829,0.000226,172.31.36.0-255,66,36531,6,306873
27830,0.000367,172.217.194.0-255,1484,38015,6,306873
27831,0.000371,172.31.36.0-255,66,38081,6,306873
27832,0.000378,172.217.194.0-255,2902,40983,6,306873
27833,0.00038,172.31.36.0-255,66,41049,6,306873
27834,0.000395,172.217.194.0-255,5738,46787,6,306873
27835,0.000398,172.31.36.0-255,66,46853,6,306873
27836,0.000427,172.217.194.0-255,9633,56486,6,306873
27837,0.000431,172.31.36.0-255,66,56552,6,306873
27838,0.000464,172.217.194.0-255,7156,63708,6,306873
27839,0.000467,172.31.36.0-255,66,63774,6,306873
27840,0.000495,172.217.194.0-255,6797,70571,6,306873
27841,0.000499,172.31.36.0-255,66,70637,6,306873
27842,0.000502,172.217.194.0-255,646,71283,6,306873
27843,0.000507,172.217.194.0-255,1484,72767,6,306873
27844,0.000509,172.31.36.0-255,66,72833,6,306873
27845,0.00052,172.217.194.0-255,4320,77153,6,306873
27846,0.000524,172.31.36.0-255,66,77219,6,306873
27847,0.000564,172.217.194.0-255,9992,87211,6,306873
27848,0.000567,172.217.194.0-255,1125,88336,6,306873
27849,0.00057,172.31.36.0-255,66,88402,6,306873
27850,0.000827,172.217.194.0-255,1484,89886,6,306873
27851,0.000831,172.31.36.0-255,66,89952,6,306873
27852,0.00086,172.217.194.0-255,1484,91436,6,306873
27853,0.000873,172.217.194.0-255,2902,94338,6,306873
27854,0.000877,172.31.36.0-255,66,94404,6,306873
27855,0.000895,172.217.194.0-255,2902,97306,6,306873
27856,0.000899,172.31.36.0-255,66,97372,6,306873
27857,0.000923,172.217.194.0-255,2902,100274,6,306873
27858,0.000926,172.31.36.0-255,66,100340,6,306873
27859,0.000929,172.217.194.0-255,1484,101824,6,306873
27860,0.000952,172.217.194.0-255,4320,106144,6,306873
27861,0.000955,172.31.36.0-255,66,106210,6,306873
27862,0.000958,172.217.194.0-255,1484,107694,6,306873
27863,0.000986,172.217.194.0-255,8574,116268,6,306873
27864,0.00099,172.31.36.0-255,66,116334,6,306873
27865,0.001053,172.217.194.0-255,6438,122772,6,306873
27866,0.001057,172.31.36.0-255,66,122838,6,306873
27867,0.001141,172.217.194.0-255,1484,124322,6,306873
27868,0.001155,172.217.194.0-255,1484,125806,6,306873
27869,0.001159,172.31.36.0-255,66,125872,6,306873
27870,0.001175,172.217.194.0-255,1484,127356,6,306873
27871,0.001179,172.217.194.0-255,1484,128840,6,306873
27872,0.001182,172.31.36.0-255,66,128906,6,306873
27873,0.001207,172.217.194.0-255,4320,133226,6,306873
27874,0.00121,172.31.36.0-255,66,133292,6,306873
27875,0.001219,172.217.194.0-255,8574,141866,6,306873
27876,0.001221,172.31.36.0-255,66,141932,6,306873
27877,0.001249,172.217.194.0-255,4320,146252,6,306873
27878,0.001253,172.31.36.0-255,66,146318,6,306873
27879,0.001259,172.217.194.0-255,5738,152056,6,306873
27880,0.001261,172.31.36.0-255,66,152122,6,306873
27881,0.001285,172.217.194.0-255,5020,157142,6,306873
27882,0.001289,172.31.36.0-255,66,157208,6,306873
27883,0.001416,172.217.194.0-255,1484,158692,6,306873
27884,0.001422,172.217.194.0-255,2902,161594,6,306873
27885,0.001426,172.31.36.0-255,66,161660,6,306873
27886,0.001429,172.217.194.0-255,1484,163144,6,306873
27887,0.001454,172.217.194.0-255,4320,167464,6,306873
27888,0.001457,172.31.36.0-255,66,167530,6,306873
27889,0.001498,172.31.36.0-255,66,167596,6,306873
27890,0.001538,172.217.194.0-255,5738,173334,6,306873
27891,0.001542,172.31.36.0-255,66,173400,6,306873
27892,0.00157,172.217.194.0-255,5020,178420,6,306873
27893,0.001573,172.31.36.0-255,66,178486,6,306873
27894,0.001772,172.217.194.0-255,1484,179970,6,306873
27895,0.001777,172.217.194.0-255,2902,182872,6,306873
27896,0.00178,172.31.36.0-255,66,182938,6,306873
27897,0.001786,172.217.194.0-255,4320,187258,6,306873
27898,0.001788,172.31.36.0-255,66,187324,6,306873
27899,0.001807,172.217.194.0-255,1484,188808,6,306873
27900,0.001813,172.217.194.0-255,4320,193128,6,306873
27901,0.00182,172.31.36.0-255,66,193194,6,306873
27902,0.001851,172.217.194.0-255,8574,201768,6,306873
27903,0.001854,172.31.36.0-255,66,201834,6,306873
27904,0.001868,172.31.36.0-255,66,201900,6,306873
27905,0.001929,172.31.36.0-255,66,201966,6,306873
27906,0.001936,172.217.194.0-255,7156,209122,6,306873
27907,0.001938,172.31.36.0-255,66,209188,6,306873
27908,0.001945,172.217.194.0-255,4320,213508,6,306873
27909,0.001947,172.31.36.0-255,66,213574,6,306873
27910,0.001979,172.217.194.0-255,5020,218594,6,306873
27911,0.001982,172.31.36.0-255,66,218660,6,306873
27912,0.001991,172.217.194.0-255,8574,227234,6,306873
27913,0.001993,172.31.36.0-255,66,227300,6,306873
27914,0.002024,172.217.194.0-255,1484,228784,6,306873
27915,0.002031,172.217.194.0-255,7156,235940,6,306873
27916,0.002036,172.31.36.0-255,66,236006,6,306873
27917,0.002069,172.217.194.0-255,9992,245998,6,306873
27918,0.002073,172.31.36.0-255,66,246064,6,306873
27919,0.002097,172.217.194.0-255,6438,252502,6,306873
27920,0.0021,172.31.36.0-255,66,252568,6,306873
27921,0.002128,172.217.194.0-255,1484,254052,6,306873
27922,0.002133,172.217.194.0-255,2902,256954,6,306873
27923,0.002139,172.31.36.0-255,66,257020,6,306873
27924,0.002181,172.217.194.0-255,4320,261340,6,306873
27925,0.002184,172.31.36.0-255,66,261406,6,306873
27926,0.002212,172.217.194.0-255,1484,262890,6,306873
27927,0.00222,172.217.194.0-255,5738,268628,6,306873
27928,0.002223,172.31.36.0-255,66,268694,6,306873
27929,0.002239,172.31.36.0-255,66,268760,6,306873
27930,0.002247,172.31.36.0-255,66,268826,6,306873
27931,0.002262,172.31.36.0-255,66,268892,6,306873
27932,0.002271,172.217.194.0-255,10692,279584,6,306873
27933,0.002274,172.31.36.0-255,66,279650,6,306873
27934,0.002301,172.217.194.0-255,1484,281134,6,306873
27935,0.002335,172.217.194.0-255,9992,291126,6,306873
27936,0.002338,172.31.36.0-255,66,291192,6,306873
27937,0.002344,172.217.194.0-255,2902,294094,6,306873
27938,0.002346,172.31.36.0-255,66,294160,6,306873
27939,0.002377,172.217.194.0-255,9992,304152,6,306873
27940,0.002381,172.31.36.0-255,66,304218,6,306873
27941,0.002386,172.217.194.0-255,2247,306465,6,306873
27942,0.002388,172.31.36.0-255,66,306531,6,306873
27943,0.002409,172.217.194.0-255,105,306636,6,306873
27944,0.003474,172.31.36.0-255,66,306702,6,306873
27945,0.003503,172.31.36.0-255,105,306807,6,306873
27946,0.006013,172.217.194.0-255,66,306873,6,306873
27947,0.0,74.125.24.0-255,150,150,6,273247
27948,3.1e-05,172.31.36.0-255,66,216,6,273247
27949,3.9e-05,74.125.24.0-255,1484,1700,6,273247
27950,4.3e-05,172.31.36.0-255,66,1766,6,273247
27951,4.8e-05,74.125.24.0-255,2902,4668,6,273247
27952,5.9e-05,172.31.36.0-255,66,4734,6,273247
27953,6.5e-05,74.125.24.0-255,5738,10472,6,273247
27954,6.7e-05,172.31.36.0-255,66,10538,6,273247
27955,9.5e-05,74.125.24.0-255,3377,13915,6,273247
27956,9.7e-05,172.31.36.0-255,66,13981,6,273247
27957,0.000188,74.125.24.0-255,1484,15465,6,273247
27958,0.000196,172.31.36.0-255,66,15531,6,273247
27959,0.000201,74.125.24.0-255,2902,18433,6,273247
27960,0.000203,172.31.36.0-255,66,18499,6,273247
27961,0.000216,74.125.24.0-255,5738,24237,6,273247
27962,0.000218,172.31.36.0-255,66,24303,6,273247
27963,0.000245,74.125.24.0-255,2902,27205,6,273247
27964,0.000248,172.31.36.0-255,66,27271,6,273247
27965,0.000287,172.31.36.0-255,66,27337,6,273247
27966,0.000295,74.125.24.0-255,8574,35911,6,273247
27967,0.000297,172.31.36.0-255,66,35977,6,273247
27968,0.000357,172.31.36.0-255,66,36043,6,273247
27969,0.00078,74.125.24.0-255,412,36455,6,273247
27970,0.000785,172.31.36.0-255,66,36521,6,273247
27971,0.000809,74.125.24.0-255,1484,38005,6,273247
27972,0.000812,172.31.36.0-255,66,38071,6,273247
27973,0.000825,74.125.24.0-255,4320,42391,6,273247
27974,0.000831,172.31.36.0-255,66,42457,6,273247
27975,0.000837,74.125.24.0-255,7156,49613,6,273247
27976,0.000839,172.31.36.0-255,66,49679,6,273247
27977,0.000864,74.125.24.0-255,2902,52581,6,273247
27978,0.000867,172.31.36.0-255,66,52647,6,273247
27979,0.000903,172.31.36.0-255,66,52713,6,273247
27980,0.000908,74.125.24.0-255,5020,57733,6,273247
27981,0.00091,172.31.36.0-255,66,57799,6,273247
27982,0.001079,74.125.24.0-255,332,58131,6,273247
27983,0.001106,172.31.36.0-255,66,58197,6,273247
27984,0.001187,74.125.24.0-255,1484,59681,6,273247
27985,0.001192,74.125.24.0-255,1484,61165,6,273247
27986,0.001195,172.31.36.0-255,66,61231,6,273247
27987,0.001218,74.125.24.0-255,1484,62715,6,273247
27988,0.001224,74.125.24.0-255,5738,68453,6,273247
27989,0.001228,74.125.24.0-255,4320,72773,6,273247
27990,0.001228,172.31.36.0-255,66,72839,6,273247
27991,0.001232,172.31.36.0-255,66,72905,6,273247
27992,0.001255,74.125.24.0-255,2902,75807,6,273247
27993,0.001261,172.31.36.0-255,66,75873,6,273247
27994,0.001269,74.125.24.0-255,8574,84447,6,273247
27995,0.001271,172.31.36.0-255,66,84513,6,273247
27996,0.001291,74.125.24.0-255,9992,94505,6,273247
27997,0.001294,172.31.36.0-255,66,94571,6,273247
27998,0.001322,74.125.24.0-255,7856,102427,6,273247
27999,0.001325,172.31.36.0-255,66,102493,6,273247
28000,0.00134,172.31.36.0-255,66,102559,6,273247
28001,0.001345,74.125.24.0-255,5020,107579,6,273247
28002,0.001348,172.31.36.0-255,66,107645,6,273247
28003,0.001372,74.125.24.0-255,5738,113383,6,273247
28004,0.001375,172.31.36.0-255,66,113449,6,273247
28005,0.001381,74.125.24.0-255,4320,117769,6,273247
28006,0.001382,172.31.36.0-255,66,117835,6,273247
28007,0.001402,74.125.24.0-255,4320,122155,6,273247
28008,0.001405,172.31.36.0-255,66,122221,6,273247
28009,0.001411,74.125.24.0-255,5738,127959,6,273247
28010,0.001413,172.31.36.0-255,66,128025,6,273247
28011,0.001443,74.125.24.0-255,9992,138017,6,273247
28012,0.001446,172.31.36.0-255,66,138083,6,273247
28013,0.001451,74.125.24.0-255,3602,141685,6,273247
28014,0.001454,172.31.36.0-255,66,141751,6,273247
28015,0.001491,74.125.24.0-255,1484,143235,6,273247
28016,0.001508,74.125.24.0-255,2902,146137,6,273247
28017,0.001511,172.31.36.0-255,66,146203,6,273247
28018,0.001515,74.125.24.0-255,2902,149105,6,273247
28019,0.001517,172.31.36.0-255,66,149171,6,273247
28020,0.001544,74.125.24.0-255,2902,152073,6,273247
28021,0.001547,172.31.36.0-255,66,152139,6,273247
28022,0.001562,172.31.36.0-255,66,152205,6,273247
28023,0.001575,172.31.36.0-255,66,152271,6,273247
28024,0.001696,74.125.24.0-255,1484,153755,6,273247
28025,0.0017,74.125.24.0-255,1484,155239,6,273247
28026,0.001702,172.31.36.0-255,66,155305,6,273247
28027,0.001736,74.125.24.0-255,1484,156789,6,273247
28028,0.001742,74.125.24.0-255,5738,162527,6,273247
28029,0.001744,172.31.36.0-255,66,162593,6,273247
28030,0.001756,74.125.24.0-255,8574,171167,6,273247
28031,0.001765,172.31.36.0-255,66,171233,6,273247
28032,0.001786,74.125.24.0-255,1484,172717,6,273247
28033,0.001813,172.31.36.0-255,66,172783,6,273247
28034,0.001952,74.125.24.0-255,1484,174267,6,273247
28035,0.001955,74.125.24.0-255,1484,175751,6,273247
28036,0.001957,172.31.36.0-255,66,175817,6,273247
28037,0.001979,74.125.24.0-255,1484,177301,6,273247
28038,0.001985,74.125.24.0-255,5738,183039,6,273247
28039,0.001987,172.31.36.0-255,66,183105,6,273247
28040,0.001991,74.125.24.0-255,2902,186007,6,273247
28041,0.001993,172.31.36.0-255,66,186073,6,273247
28042,0.002015,74.125.24.0-255,9992,196065,6,273247
28043,0.002018,172.31.36.0-255,66,196131,6,273247
28044,0.002071,74.125.24.0-255,10692,206823,6,273247
28045,0.002074,172.31.36.0-255,66,206889,6,273247
28046,0.002087,172.31.36.0-255,66,206955,6,273247
28047,0.002099,74.125.24.0-255,4320,211275,6,273247
28048,0.002101,172.31.36.0-255,66,211341,6,273247
28049,0.00213,74.125.24.0-255,4320,215661,6,273247
28050,0.002137,172.31.36.0-255,66,215727,6,273247
28051,0.002138,74.125.24.0-255,9992,225719,6,273247
28052,0.00214,172.31.36.0-255,66,225785,6,273247
28053,0.002183,172.31.36.0-255,66,225851,6,273247
28054,0.002186,74.125.24.0-255,9992,235843,6,273247
28055,0.002189,172.31.36.0-255,66,235909,6,273247
28056,0.002221,74.125.24.0-255,5738,241647,6,273247
28057,0.002225,172.31.36.0-255,66,241713,6,273247
28058,0.002231,74.125.24.0-255,6438,248151,6,273247
28059,0.002234,172.31.36.0-255,66,248217,6,273247
28060,0.002256,74.125.24.0-255,1484,249701,6,273247
28061,0.002261,74.125.24.0-255,2902,252603,6,273247
28062,0.002264,172.31.36.0-255,66,252669,6,273247
28063,0.002286,74.125.24.0-255,2902,255571,6,273247
28064,0.002289,172.31.36.0-255,66,255637,6,273247
28065,0.004547,74.125.24.0-255,5738,261375,6,273247
28066,0.004554,172.31.36.0-255,66,261441,6,273247
28067,0.006822,74.125.24.0-255,2902,264343,6,273247
28068,0.006826,172.31.36.0-255,66,264409,6,273247
28069,0.006847,74.125.24.0-255,2902,267311,6,273247
28070,0.006849,172.31.36.0-255,66,267377,6,273247
28071,0.009102,74.125.24.0-255,1484,268861,6,273247
28072,0.009116,74.125.24.0-255,4320,273181,6,273247
28073,0.009121,172.31.36.0-255,66,273247,6,273247
28074,0.0,172.217.194.0-255,153,153,6,116987
28075,2.8e-05,172.31.36.0-255,66,219,6,116987
28076,3.6e-05,172.217.194.0-255,1484,1703,6,116987
28077,4e-05,172.31.36.0-255,66,1769,6,116987
28078,4.6e-05,172.217.194.0-255,2902,4671,6,116987
28079,4.8e-05,172.31.36.0-255,66,4737,6,116987
28080,5.6e-05,172.217.194.0-255,7156,11893,6,116987
28081,5.9e-05,172.31.36.0-255,66,11959,6,116987
28082,0.000121,172.217.194.0-255,1974,13933,6,116987
28083,0.000124,172.31.36.0-255,66,13999,6,116987
28084,0.000166,172.31.36.0-255,66,14065,6,116987
28085,0.00028,172.217.194.0-255,5738,19803,6,116987
28086,0.000285,172.31.36.0-255,66,19869,6,116987
28087,0.000318,172.31.36.0-255,66,19935,6,116987
28088,0.000532,172.217.194.0-255,7156,27091,6,116987
28089,0.000536,172.31.36.0-255,66,27157,6,116987
28090,0.000563,172.217.194.0-255,9633,36790,6,116987
28091,0.000566,172.31.36.0-255,66,36856,6,116987
28092,0.000719,172.217.194.0-255,5738,42594,6,116987
28093,0.000723,172.31.36.0-255,66,42660,6,116987
28094,0.000758,172.31.36.0-255,66,42726,6,116987
28095,0.000915,172.217.194.0-255,7156,49882,6,116987
28096,0.00092,172.31.36.0-255,66,49948,6,116987
28097,0.000941,172.217.194.0-255,9083,59031,6,116987
28098,0.000945,172.31.36.0-255,66,59097,6,116987
28099,0.001095,172.217.194.0-255,7156,66253,6,116987
28100,0.001099,172.31.36.0-255,66,66319,6,116987
28101,0.001118,172.217.194.0-255,2902,69221,6,116987
28102,0.001121,172.31.36.0-255,66,69287,6,116987
28103,0.00124,172.217.194.0-255,5020,74307,6,116987
28104,0.001243,172.31.36.0-255,66,74373,6,116987
28105,0.001249,172.31.36.0-255,66,74439,6,116987
28106,0.001515,172.31.36.0-255,66,74505,6,116987
28107,0.001533,172.217.194.0-255,1484,75989,6,116987
28108,0.001652,172.217.194.0-255,4320,80309,6,116987
28109,0.001866,172.217.194.0-255,8574,88883,6,116987
28110,0.001922,172.217.194.0-255,10692,99575,6,116987
28111,0.002259,172.217.194.0-255,5738,105313,6,116987
28112,0.002997,172.217.194.0-255,4320,109633,6,116987
28113,0.003144,172.217.194.0-255,1484,111117,6,116987
28114,0.006406,172.31.36.0-255,66,111183,6,116987
28115,0.008688,172.217.194.0-255,5738,116921,6,116987
28116,0.008694,172.31.36.0-255,66,116987,6,116987
28117,0.0,172.217.194.0-255,146,146,6,274439
28118,1.4e-05,172.31.36.0-255,66,212,6,274439
28119,2.1e-05,172.217.194.0-255,1484,1696,6,274439
28120,2.7e-05,172.31.36.0-255,66,1762,6,274439
28121,3.3e-05,172.217.194.0-255,2902,4664,6,274439
28122,4.3e-05,172.31.36.0-255,66,4730,6,274439
28123,5.2e-05,172.217.194.0-255,7156,11886,6,274439
28124,5.5e-05,172.31.36.0-255,66,11952,6,274439
28125,9.1e-05,172.217.194.0-255,2071,14023,6,274439
28126,9.4e-05,172.31.36.0-255,66,14089,6,274439
28127,9.9e-05,172.217.194.0-255,2902,16991,6,274439
28128,0.000102,172.31.36.0-255,66,17057,6,274439
28129,0.00011,172.217.194.0-255,7156,24213,6,274439
28130,0.000112,172.31.36.0-255,66,24279,6,274439
28131,0.000118,172.217.194.0-255,4320,28599,6,274439
28132,0.00012,172.31.36.0-255,66,28665,6,274439
28133,0.000148,172.217.194.0-255,2543,31208,6,274439
28134,0.000152,172.31.36.0-255,66,31274,6,274439
28135,0.000291,172.217.194.0-255,1484,32758,6,274439
28136,0.000296,172.31.36.0-255,66,32824,6,274439
28137,0.000302,172.217.194.0-255,2902,35726,6,274439
28138,0.000305,172.31.36.0-255,66,35792,6,274439
28139,0.000317,172.217.194.0-255,5738,41530,6,274439
28140,0.00032,172.31.36.0-255,66,41596,6,274439
28141,0.000323,172.217.194.0-255,1484,43080,6,274439
28142,0.000324,172.31.36.0-255,66,43146,6,274439
28143,0.00036,172.217.194.0-255,5379,48525,6,274439
28144,0.000362,172.31.36.0-255,66,48591,6,274439
28145,0.000384,172.217.194.0-255,8574,57165,6,274439
28146,0.000387,172.31.36.0-255,66,57231,6,274439
28147,0.000425,172.217.194.0-255,5738,62969,6,274439
28148,0.000428,172.31.36.0-255,66,63035,6,274439
28149,0.000452,172.217.194.0-255,2543,65578,6,274439
28150,0.000455,172.31.36.0-255,66,65644,6,274439
28151,0.000457,172.217.194.0-255,359,66003,6,274439
28152,0.000479,172.217.194.0-255,386,66389,6,274439
28153,0.000938,172.217.194.0-255,1484,67873,6,274439
28154,0.000943,172.31.36.0-255,66,67939,6,274439
28155,0.000948,172.217.194.0-255,2902,70841,6,274439
28156,0.00095,172.31.36.0-255,66,70907,6,274439
28157,0.000956,172.217.194.0-255,5738,76645,6,274439
28158,0.000962,172.31.36.0-255,66,76711,6,274439
28159,0.000995,172.217.194.0-255,8574,85285,6,274439
28160,0.000998,172.31.36.0-255,66,85351,6,274439
28161,0.001014,172.217.194.0-255,4320,89671,6,274439
28162,0.001019,172.31.36.0-255,66,89737,6,274439
28163,0.001028,172.217.194.0-255,10692,100429,6,274439
28164,0.00103,172.31.36.0-255,66,100495,6,274439
28165,0.001089,172.31.36.0-255,101,100596,6,274439
28166,0.001423,172.217.194.0-255,1484,102080,6,274439
28167,0.001431,172.217.194.0-255,2902,104982,6,274439
28168,0.001435,172.31.36.0-255,66,105048,6,274439
28169,0.001442,172.217.194.0-255,5738,110786,6,274439
28170,0.001444,172.31.36.0-255,66,110852,6,274439
28171,0.001449,172.217.194.0-255,4320,115172,6,274439
28172,0.001455,172.31.36.0-255,66,115238,6,274439
28173,0.001486,172.217.194.0-255,5738,120976,6,274439
28174,0.001488,172.31.36.0-255,66,121042,6,274439
28175,0.00152,172.31.36.0-255,66,121108,6,274439
28176,0.001571,172.217.194.0-255,9992,131100,6,274439
28177,0.001574,172.31.36.0-255,66,131166,6,274439
28178,0.001586,172.31.36.0-255,66,131232,6,274439
28179,0.001648,172.31.36.0-255,66,131298,6,274439
28180,0.001659,172.31.36.0-255,66,131364,6,274439
28181,0.001683,172.217.194.0-255,1484,132848,6,274439
28182,0.001691,172.217.194.0-255,8574,141422,6,274439
28183,0.001694,172.31.36.0-255,66,141488,6,274439
28184,0.001726,172.31.36.0-255,66,141554,6,274439
28185,0.001738,172.217.194.0-255,1484,143038,6,274439
28186,0.001764,172.31.36.0-255,66,143104,6,274439
28187,0.001772,172.217.194.0-255,9992,153096,6,274439
28188,0.001778,172.31.36.0-255,66,153162,6,274439
28189,0.001811,172.217.194.0-255,2902,156064,6,274439
28190,0.001814,172.31.36.0-255,66,156130,6,274439
28191,0.001846,172.217.194.0-255,7856,163986,6,274439
28192,0.00185,172.31.36.0-255,66,164052,6,274439
28193,0.001855,172.217.194.0-255,4320,168372,6,274439
28194,0.001857,172.31.36.0-255,66,168438,6,274439
28195,0.001893,172.217.194.0-255,7156,175594,6,274439
28196,0.001896,172.31.36.0-255,66,175660,6,274439
28197,0.001913,172.31.36.0-255,66,175726,6,274439
28198,0.001925,172.31.36.0-255,66,175792,6,274439
28199,0.00193,172.217.194.0-255,4320,180112,6,274439
28200,0.001932,172.31.36.0-255,66,180178,6,274439
28201,0.001957,172.217.194.0-255,8574,188752,6,274439
28202,0.00196,172.31.36.0-255,66,188818,6,274439
28203,0.001979,172.217.194.0-255,9992,198810,6,274439
28204,0.001982,172.31.36.0-255,66,198876,6,274439
28205,0.002014,172.217.194.0-255,7856,206732,6,274439
28206,0.002017,172.31.36.0-255,66,206798,6,274439
28207,0.002026,172.217.194.0-255,9992,216790,6,274439
28208,0.002029,172.31.36.0-255,66,216856,6,274439
28209,0.00205,172.217.194.0-255,7156,224012,6,274439
28210,0.002052,172.31.36.0-255,66,224078,6,274439
28211,0.002085,172.31.36.0-255,66,224144,6,274439
28212,0.002112,172.217.194.0-255,3602,227746,6,274439
28213,0.002116,172.31.36.0-255,66,227812,6,274439
28214,0.002135,172.31.36.0-255,66,227878,6,274439
28215,0.002176,172.217.194.0-255,9992,237870,6,274439
28216,0.002179,172.31.36.0-255,66,237936,6,274439
28217,0.002208,172.217.194.0-255,6438,244374,6,274439
28218,0.002211,172.31.36.0-255,66,244440,6,274439
28219,0.002214,172.217.194.0-255,1484,245924,6,274439
28220,0.002218,172.217.194.0-255,2902,248826,6,274439
28221,0.00222,172.31.36.0-255,66,248892,6,274439
28222,0.00223,172.217.194.0-255,5738,254630,6,274439
28223,0.002233,172.31.36.0-255,66,254696,6,274439
28224,0.002239,172.217.194.0-255,5738,260434,6,274439
28225,0.002242,172.31.36.0-255,66,260500,6,274439
28226,0.002272,172.217.194.0-255,7156,267656,6,274439
28227,0.002275,172.31.36.0-255,66,267722,6,274439
28228,0.002285,172.217.194.0-255,6309,274031,6,274439
28229,0.002287,172.31.36.0-255,66,274097,6,274439
28230,0.002314,172.217.194.0-255,105,274202,6,274439
28231,0.003683,172.217.194.0-255,66,274268,6,274439
28232,0.005147,172.31.36.0-255,105,274373,6,274439
28233,0.007748,172.217.194.0-255,66,274439,6,274439
28234,0.0,216.58.221.0-255,153,153,6,112545
28235,2.9e-05,172.31.36.0-255,66,219,6,112545
28236,3.6e-05,216.58.221.0-255,1484,1703,6,112545
28237,4.1e-05,172.31.36.0-255,66,1769,6,112545
28238,4.6e-05,216.58.221.0-255,2902,4671,6,112545
28239,5.5e-05,172.31.36.0-255,66,4737,6,112545
28240,6.3e-05,216.58.221.0-255,7156,11893,6,112545
28241,6.6e-05,172.31.36.0-255,66,11959,6,112545
28242,7e-05,216.58.221.0-255,2002,13961,6,112545
28243,7.3e-05,172.31.36.0-255,66,14027,6,112545
28244,7.7e-05,216.58.221.0-255,2902,16929,6,112545
28245,7.9e-05,172.31.36.0-255,66,16995,6,112545
28246,8.6e-05,216.58.221.0-255,7156,24151,6,112545
28247,8.9e-05,172.31.36.0-255,66,24217,6,112545
28248,9.2e-05,216.58.221.0-255,1484,25701,6,112545
28249,9.3e-05,172.31.36.0-255,66,25767,6,112545
28250,0.000128,216.58.221.0-255,4320,30087,6,112545
28251,0.000131,172.31.36.0-255,66,30153,6,112545
28252,0.000159,216.58.221.0-255,1125,31278,6,112545
28253,0.000162,172.31.36.0-255,66,31344,6,112545
28254,0.000224,216.58.221.0-255,1484,32828,6,112545
28255,0.000228,172.31.36.0-255,66,32894,6,112545
28256,0.000233,216.58.221.0-255,2902,35796,6,112545
28257,0.000236,172.31.36.0-255,66,35862,6,112545
28258,0.000246,216.58.221.0-255,2902,38764,6,112545
28259,0.000248,172.31.36.0-255,66,38830,6,112545
28260,0.000287,216.58.221.0-255,2902,41732,6,112545
28261,0.000291,172.31.36.0-255,66,41798,6,112545
28262,0.000296,216.58.221.0-255,4320,46118,6,112545
28263,0.000299,172.31.36.0-255,66,46184,6,112545
28264,0.000304,216.58.221.0-255,5379,51563,6,112545
28265,0.000312,172.31.36.0-255,66,51629,6,112545
28266,0.000325,172.31.36.0-255,66,51695,6,112545
28267,0.00033,216.58.221.0-255,2849,54544,6,112545
28268,0.000332,172.31.36.0-255,66,54610,6,112545
28269,0.001143,216.58.221.0-255,349,54959,6,112545
28270,0.001195,172.31.36.0-255,66,55025,6,112545
28271,0.001267,216.58.221.0-255,1484,56509,6,112545
28272,0.001287,216.58.221.0-255,2902,59411,6,112545
28273,0.001291,172.31.36.0-255,66,59477,6,112545
28274,0.001298,216.58.221.0-255,5738,65215,6,112545
28275,0.0013,172.31.36.0-255,66,65281,6,112545
28276,0.001313,216.58.221.0-255,6797,72078,6,112545
28277,0.001316,172.31.36.0-255,66,72144,6,112545
28278,0.001343,216.58.221.0-255,2902,75046,6,112545
28279,0.001346,172.31.36.0-255,66,75112,6,112545
28280,0.001376,216.58.221.0-255,4320,79432,6,112545
28281,0.001379,172.31.36.0-255,66,79498,6,112545
28282,0.001385,216.58.221.0-255,4320,83818,6,112545
28283,0.001388,172.31.36.0-255,66,83884,6,112545
28284,0.001396,216.58.221.0-255,5379,89263,6,112545
28285,0.001398,172.31.36.0-255,66,89329,6,112545
28286,0.003364,216.58.221.0-255,5738,95067,6,112545
28287,0.003371,172.31.36.0-255,66,95133,6,112545
28288,0.005361,216.58.221.0-255,5738,100871,6,112545
28289,0.005366,172.31.36.0-255,66,100937,6,112545
28290,0.007347,216.58.221.0-255,5738,106675,6,112545
28291,0.007354,172.31.36.0-255,66,106741,6,112545
28292,0.009331,216.58.221.0-255,5738,112479,6,112545
28293,0.00934,172.31.36.0-255,66,112545,6,112545
28294,0.0,172.31.36.0-255,105,105,6,105
28295,0.0,172.217.194.0-255,161,161,6,106372
28296,2e-05,172.31.36.0-255,66,227,6,106372
28297,4.2e-05,172.217.194.0-255,1484,1711,6,106372
28298,4.6e-05,172.31.36.0-255,66,1777,6,106372
28299,7.9e-05,172.217.194.0-255,2902,4679,6,106372
28300,8.4e-05,172.31.36.0-255,66,4745,6,106372
28301,8.6e-05,172.217.194.0-255,7156,11901,6,106372
28302,9e-05,172.217.194.0-255,2082,13983,6,106372
28303,9e-05,172.31.36.0-255,66,14049,6,106372
28304,9.2e-05,172.31.36.0-255,66,14115,6,106372
28305,0.000134,172.217.194.0-255,1484,15599,6,106372
28306,0.000138,172.31.36.0-255,66,15665,6,106372
28307,0.000143,172.217.194.0-255,2902,18567,6,106372
28308,0.000146,172.31.36.0-255,66,18633,6,106372
28309,0.000165,172.217.194.0-255,1484,20117,6,106372
28310,0.000167,172.31.36.0-255,66,20183,6,106372
28311,0.000183,172.217.194.0-255,4320,24503,6,106372
28312,0.000186,172.31.36.0-255,66,24569,6,106372
28313,0.000188,172.217.194.0-255,1484,26053,6,106372
28314,0.000191,172.31.36.0-255,66,26119,6,106372
28315,0.000225,172.217.194.0-255,5379,31498,6,106372
28316,0.000228,172.31.36.0-255,66,31564,6,106372
28317,0.000231,172.217.194.0-255,1484,33048,6,106372
28318,0.000233,172.31.36.0-255,66,33114,6,106372
28319,0.000249,172.217.194.0-255,4320,37434,6,106372
28320,0.000252,172.31.36.0-255,66,37500,6,106372
28321,0.000286,172.217.194.0-255,7156,44656,6,106372
28322,0.00029,172.31.36.0-255,66,44722,6,106372
28323,0.000309,172.217.194.0-255,3961,48683,6,106372
28324,0.000313,172.31.36.0-255,66,48749,6,106372
28325,0.00129,172.217.194.0-255,1484,50233,6,106372
28326,0.001296,172.31.36.0-255,66,50299,6,106372
28327,0.001306,172.217.194.0-255,2902,53201,6,106372
28328,0.001308,172.31.36.0-255,66,53267,6,106372
28329,0.001315,172.217.194.0-255,5738,59005,6,106372
28330,0.001316,172.31.36.0-255,66,59071,6,106372
28331,0.001338,172.217.194.0-255,6797,65868,6,106372
28332,0.001341,172.31.36.0-255,66,65934,6,106372
28333,0.001438,172.217.194.0-255,1484,67418,6,106372
28334,0.001451,172.217.194.0-255,2902,70320,6,106372
28335,0.001453,172.31.36.0-255,66,70386,6,106372
28336,0.001475,172.217.194.0-255,5738,76124,6,106372
28337,0.001477,172.31.36.0-255,66,76190,6,106372
28338,0.001482,172.217.194.0-255,4320,80510,6,106372
28339,0.001484,172.31.36.0-255,66,80576,6,106372
28340,0.001498,172.217.194.0-255,2543,83119,6,106372
28341,0.0015,172.31.36.0-255,66,83185,6,106372
28342,0.001542,172.31.36.0-255,66,83251,6,106372
28343,0.001559,172.217.194.0-255,2902,86153,6,106372
28344,0.001561,172.31.36.0-255,66,86219,6,106372
28345,0.001565,172.217.194.0-255,2543,88762,6,106372
28346,0.001567,172.31.36.0-255,66,88828,6,106372
28347,0.003917,172.217.194.0-255,2902,91730,6,106372
28348,0.003921,172.31.36.0-255,66,91796,6,106372
28349,0.003938,172.217.194.0-255,2902,94698,6,106372
28350,0.003941,172.31.36.0-255,66,94764,6,106372
28351,0.006302,172.217.194.0-255,5738,100502,6,106372
28352,0.006309,172.31.36.0-255,66,100568,6,106372
28353,0.008733,172.217.194.0-255,5738,106306,6,106372
28354,0.008744,172.31.36.0-255,66,106372,6,106372
28355,0.0,172.217.194.0-255,297,297,6,177541
28356,2.5e-05,172.31.36.0-255,66,363,6,177541
28357,3.2e-05,172.217.194.0-255,1484,1847,6,177541
28358,3.7e-05,172.31.36.0-255,66,1913,6,177541
28359,4.4e-05,172.217.194.0-255,4320,6233,6,177541
28360,4.8e-05,172.31.36.0-255,66,6299,6,177541
28361,5.7e-05,172.217.194.0-255,7558,13857,6,177541
28362,6e-05,172.31.36.0-255,66,13923,6,177541
28363,6.8e-05,172.217.194.0-255,8574,22497,6,177541
28364,7.1e-05,172.31.36.0-255,66,22563,6,177541
28365,8.7e-05,172.217.194.0-255,1484,24047,6,177541
28366,8.9e-05,172.31.36.0-255,66,24113,6,177541
28367,0.000116,172.217.194.0-255,6797,30910,6,177541
28368,0.000119,172.31.36.0-255,66,30976,6,177541
28369,0.000507,172.217.194.0-255,1484,32460,6,177541
28370,0.000512,172.31.36.0-255,66,32526,6,177541
28371,0.000518,172.217.194.0-255,2902,35428,6,177541
28372,0.00052,172.31.36.0-255,66,35494,6,177541
28373,0.000523,172.217.194.0-255,1484,36978,6,177541
28374,0.000525,172.31.36.0-255,66,37044,6,177541
28375,0.00055,172.217.194.0-255,4320,41364,6,177541
28376,0.000553,172.31.36.0-255,66,41430,6,177541
28377,0.00056,172.217.194.0-255,6797,48227,6,177541
28378,0.000563,172.31.36.0-255,66,48293,6,177541
28379,0.000595,172.217.194.0-255,2902,51195,6,177541
28380,0.000598,172.31.36.0-255,66,51261,6,177541
28381,0.000622,172.31.36.0-255,66,51327,6,177541
28382,0.000626,172.217.194.0-255,2796,54123,6,177541
28383,0.000628,172.31.36.0-255,66,54189,6,177541
28384,0.000692,172.217.194.0-255,120,54309,6,177541
28385,0.000696,172.31.36.0-255,66,54375,6,177541
28386,0.000971,172.217.194.0-255,1484,55859,6,177541
28387,0.000982,172.217.194.0-255,2902,58761,6,177541
28388,0.000987,172.31.36.0-255,66,58827,6,177541
28389,0.000992,172.217.194.0-255,1484,60311,6,177541
28390,0.001011,172.217.194.0-255,4320,64631,6,177541
28391,0.001015,172.31.36.0-255,66,64697,6,177541
28392,0.001028,172.31.36.0-255,66,64763,6,177541
28393,0.001066,172.217.194.0-255,5738,70501,6,177541
28394,0.00107,172.31.36.0-255,66,70567,6,177541
28395,0.001089,172.217.194.0-255,6438,77005,6,177541
28396,0.001092,172.31.36.0-255,66,77071,6,177541
28397,0.00122,172.217.194.0-255,1484,78555,6,177541
28398,0.001254,172.217.194.0-255,2902,81457,6,177541
28399,0.001259,172.31.36.0-255,66,81523,6,177541
28400,0.001265,172.217.194.0-255,5738,87261,6,177541
28401,0.001267,172.31.36.0-255,66,87327,6,177541
28402,0.001275,172.217.194.0-255,8574,95901,6,177541
28403,0.001278,172.31.36.0-255,66,95967,6,177541
28404,0.001295,172.217.194.0-255,1484,97451,6,177541
28405,0.001324,172.31.36.0-255,66,97517,6,177541
28406,0.001345,172.217.194.0-255,766,98283,6,177541
28407,0.00136,172.31.36.0-255,66,98349,6,177541
28408,0.001402,172.31.36.0-255,66,98415,6,177541
28409,0.001419,172.217.194.0-255,766,99181,6,177541
28410,0.001499,172.217.194.0-255,1484,100665,6,177541
28411,0.001504,172.31.36.0-255,66,100731,6,177541
28412,0.00151,172.217.194.0-255,2902,103633,6,177541
28413,0.001512,172.31.36.0-255,66,103699,6,177541
28414,0.001553,172.217.194.0-255,2902,106601,6,177541
28415,0.001556,172.31.36.0-255,66,106667,6,177541
28416,0.001599,172.217.194.0-255,2902,109569,6,177541
28417,0.001604,172.31.36.0-255,66,109635,6,177541
28418,0.001618,172.31.36.0-255,66,109701,6,177541
28419,0.001626,172.217.194.0-255,10692,120393,6,177541
28420,0.001628,172.31.36.0-255,66,120459,6,177541
28421,0.001632,172.217.194.0-255,1484,121943,6,177541
28422,0.001637,172.217.194.0-255,2902,124845,6,177541
28423,0.001639,172.31.36.0-255,66,124911,6,177541
28424,0.001643,172.217.194.0-255,1484,126395,6,177541
28425,0.00167,172.217.194.0-255,4320,130715,6,177541
28426,0.001674,172.31.36.0-255,66,130781,6,177541
28427,0.001692,172.31.36.0-255,66,130847,6,177541
28428,0.001699,172.217.194.0-255,8574,139421,6,177541
28429,0.001702,172.31.36.0-255,66,139487,6,177541
28430,0.001737,172.217.194.0-255,5738,145225,6,177541
28431,0.00174,172.31.36.0-255,66,145291,6,177541
28432,0.001781,172.31.36.0-255,66,145357,6,177541
28433,0.00179,172.217.194.0-255,8574,153931,6,177541
28434,0.001792,172.31.36.0-255,66,153997,6,177541
28435,0.001832,172.217.194.0-255,3602,157599,6,177541
28436,0.001836,172.31.36.0-255,66,157665,6,177541
28437,0.001859,172.31.36.0-255,66,157731,6,177541
28438,0.001873,172.31.36.0-255,66,157797,6,177541
28439,0.001911,172.31.36.0-255,66,157863,6,177541
28440,0.001917,172.217.194.0-255,5738,163601,6,177541
28441,0.001919,172.31.36.0-255,66,163667,6,177541
28442,0.001979,172.31.36.0-255,66,163733,6,177541
28443,0.002005,172.217.194.0-255,7856,171589,6,177541
28444,0.002007,172.31.36.0-255,66,171655,6,177541
28445,0.002058,172.31.36.0-255,66,171721,6,177541
28446,0.002075,172.217.194.0-255,2184,173905,6,177541
28447,0.002077,172.31.36.0-255,66,173971,6,177541
28448,0.002095,172.31.36.0-255,66,174037,6,177541
28449,0.002099,172.217.194.0-255,3162,177199,6,177541
28450,0.002101,172.31.36.0-255,66,177265,6,177541
28451,0.002104,172.217.194.0-255,105,177370,6,177541
28452,0.009483,172.31.36.0-255,66,177436,6,177541
28453,0.009512,172.31.36.0-255,105,177541,6,177541
28454,0.0,74.125.24.0-255,153,153,6,340087
28455,1.9e-05,172.31.36.0-255,66,219,6,340087
28456,2.7e-05,74.125.24.0-255,1484,1703,6,340087
28457,3.1e-05,172.31.36.0-255,66,1769,6,340087
28458,3.7e-05,74.125.24.0-255,2902,4671,6,340087
28459,4.8e-05,172.31.36.0-255,66,4737,6,340087
28460,5.6e-05,74.125.24.0-255,7156,11893,6,340087
28461,5.9e-05,172.31.36.0-255,66,11959,6,340087
28462,6.3e-05,74.125.24.0-255,2040,13999,6,340087
28463,6.6e-05,172.31.36.0-255,66,14065,6,340087
28464,7e-05,74.125.24.0-255,2902,16967,6,340087
28465,7.3e-05,172.31.36.0-255,66,17033,6,340087
28466,8e-05,74.125.24.0-255,7156,24189,6,340087
28467,8.3e-05,172.31.36.0-255,66,24255,6,340087
28468,8.6e-05,74.125.24.0-255,1484,25739,6,340087
28469,8.8e-05,172.31.36.0-255,66,25805,6,340087
28470,0.000121,74.125.24.0-255,5379,31184,6,340087
28471,0.000124,172.31.36.0-255,66,31250,6,340087
28472,0.000297,74.125.24.0-255,1484,32734,6,340087
28473,0.000303,172.31.36.0-255,66,32800,6,340087
28474,0.000309,74.125.24.0-255,2902,35702,6,340087
28475,0.000311,172.31.36.0-255,66,35768,6,340087
28476,0.000366,74.125.24.0-255,5738,41506,6,340087
28477,0.00037,172.31.36.0-255,66,41572,6,340087
28478,0.000379,74.125.24.0-255,9633,51205,6,340087
28479,0.000381,172.31.36.0-255,66,51271,6,340087
28480,0.00039,74.125.24.0-255,9992,61263,6,340087
28481,0.000393,172.31.36.0-255,66,61329,6,340087
28482,0.000422,74.125.24.0-255,3961,65290,6,340087
28483,0.000425,172.31.36.0-255,66,65356,6,340087
28484,0.00043,74.125.24.0-255,2902,68258,6,340087
28485,0.000432,172.31.36.0-255,66,68324,6,340087
28486,0.000462,74.125.24.0-255,1484,69808,6,340087
28487,0.000472,74.125.24.0-255,9992,79800,6,340087
28488,0.000476,172.31.36.0-255,66,79866,6,340087
28489,0.0005,74.125.24.0-255,1484,81350,6,340087
28490,0.000515,74.125.24.0-255,2543,83893,6,340087
28491,0.000517,172.31.36.0-255,66,83959,6,340087
28492,0.000523,74.125.24.0-255,4320,88279,6,340087
28493,0.000525,172.31.36.0-255,66,88345,6,340087
28494,0.000535,74.125.24.0-255,4320,92665,6,340087
28495,0.000537,172.31.36.0-255,66,92731,6,340087
28496,0.000571,74.125.24.0-255,5738,98469,6,340087
28497,0.000574,172.31.36.0-255,66,98535,6,340087
28498,0.000578,74.125.24.0-255,1708,100243,6,340087
28499,0.00058,172.31.36.0-255,66,100309,6,340087
28500,0.001559,74.125.24.0-255,1484,101793,6,340087
28501,0.001568,74.125.24.0-255,2902,104695,6,340087
28502,0.001573,172.31.36.0-255,66,104761,6,340087
28503,0.001579,74.125.24.0-255,2902,107663,6,340087
28504,0.001581,172.31.36.0-255,66,107729,6,340087
28505,0.001601,74.125.24.0-255,2902,110631,6,340087
28506,0.001608,172.31.36.0-255,66,110697,6,340087
28507,0.001614,74.125.24.0-255,2902,113599,6,340087
28508,0.001616,172.31.36.0-255,66,113665,6,340087
28509,0.001622,74.125.24.0-255,4320,117985,6,340087
28510,0.001624,172.31.36.0-255,66,118051,6,340087
28511,0.001652,74.125.24.0-255,5738,123789,6,340087
28512,0.001654,172.31.36.0-255,66,123855,6,340087
28513,0.001665,74.125.24.0-255,10692,134547,6,340087
28514,0.001667,172.31.36.0-255,66,134613,6,340087
28515,0.001955,74.125.24.0-255,1484,136097,6,340087
28516,0.001963,74.125.24.0-255,1484,137581,6,340087
28517,0.001967,172.31.36.0-255,66,137647,6,340087
28518,0.002,74.125.24.0-255,1484,139131,6,340087
28519,0.002007,74.125.24.0-255,5738,144869,6,340087
28520,0.002009,172.31.36.0-255,66,144935,6,340087
28521,0.002034,74.125.24.0-255,4320,149255,6,340087
28522,0.002036,172.31.36.0-255,66,149321,6,340087
28523,0.002058,74.125.24.0-255,7156,156477,6,340087
28524,0.00206,172.31.36.0-255,66,156543,6,340087
28525,0.002075,172.31.36.0-255,66,156609,6,340087
28526,0.002421,74.125.24.0-255,1484,158093,6,340087
28527,0.002441,74.125.24.0-255,2902,160995,6,340087
28528,0.002446,172.31.36.0-255,66,161061,6,340087
28529,0.00245,74.125.24.0-255,1484,162545,6,340087
28530,0.002477,74.125.24.0-255,2902,165447,6,340087
28531,0.002479,172.31.36.0-255,66,165513,6,340087
28532,0.002488,74.125.24.0-255,8574,174087,6,340087
28533,0.00249,172.31.36.0-255,66,174153,6,340087
28534,0.002517,74.125.24.0-255,8574,182727,6,340087
28535,0.00252,172.31.36.0-255,66,182793,6,340087
28536,0.00255,74.125.24.0-255,7856,190649,6,340087
28537,0.002553,172.31.36.0-255,66,190715,6,340087
28538,0.002654,74.125.24.0-255,1484,192199,6,340087
28539,0.002661,74.125.24.0-255,2902,195101,6,340087
28540,0.002665,172.31.36.0-255,66,195167,6,340087
28541,0.002668,74.125.24.0-255,1484,196651,6,340087
28542,0.002696,74.125.24.0-255,4320,200971,6,340087
28543,0.0027,172.31.36.0-255,66,201037,6,340087
28544,0.002706,74.125.24.0-255,5738,206775,6,340087
28545,0.002708,172.31.36.0-255,66,206841,6,340087
28546,0.002749,74.125.24.0-255,1484,208325,6,340087
28547,0.002781,74.125.24.0-255,5738,214063,6,340087
28548,0.002784,172.31.36.0-255,66,214129,6,340087
28549,0.002794,74.125.24.0-255,10692,224821,6,340087
28550,0.002797,172.31.36.0-255,66,224887,6,340087
28551,0.0028,74.125.24.0-255,1484,226371,6,340087
28552,0.002815,172.31.36.0-255,66,226437,6,340087
28553,0.002829,74.125.24.0-255,9992,236429,6,340087
28554,0.002831,172.31.36.0-255,66,236495,6,340087
28555,0.002837,74.125.24.0-255,5738,242233,6,340087
28556,0.002841,172.31.36.0-255,66,242299,6,340087
28557,0.002845,74.125.24.0-255,2184,244483,6,340087
28558,0.002847,172.31.36.0-255,66,244549,6,340087
28559,0.002937,74.125.24.0-255,1484,246033,6,340087
28560,0.002963,74.125.24.0-255,2902,248935,6,340087
28561,0.002967,172.31.36.0-255,66,249001,6,340087
28562,0.002971,74.125.24.0-255,1484,250485,6,340087
28563,0.002996,74.125.24.0-255,4320,254805,6,340087
28564,0.002999,172.31.36.0-255,66,254871,6,340087
28565,0.003008,74.125.24.0-255,8574,263445,6,340087
28566,0.00301,172.31.36.0-255,66,263511,6,340087
28567,0.003043,74.125.24.0-255,4320,267831,6,340087
28568,0.003045,172.31.36.0-255,66,267897,6,340087
28569,0.00305,74.125.24.0-255,2902,270799,6,340087
28570,0.003052,172.31.36.0-255,66,270865,6,340087
28571,0.003081,74.125.24.0-255,7856,278721,6,340087
28572,0.003083,172.31.36.0-255,66,278787,6,340087
28573,0.003157,74.125.24.0-255,1484,280271,6,340087
28574,0.003161,74.125.24.0-255,1484,281755,6,340087
28575,0.003164,172.31.36.0-255,66,281821,6,340087
28576,0.003187,74.125.24.0-255,1484,283305,6,340087
28577,0.003193,74.125.24.0-255,5738,289043,6,340087
28578,0.003195,172.31.36.0-255,66,289109,6,340087
28579,0.003219,74.125.24.0-255,4320,293429,6,340087
28580,0.003221,172.31.36.0-255,66,293495,6,340087
28581,0.00325,74.125.24.0-255,8574,302069,6,340087
28582,0.003252,172.31.36.0-255,66,302135,6,340087
28583,0.003259,74.125.24.0-255,5738,307873,6,340087
28584,0.003262,172.31.36.0-255,66,307939,6,340087
28585,0.003296,74.125.24.0-255,7856,315795,6,340087
28586,0.003299,172.31.36.0-255,66,315861,6,340087
28587,0.003307,74.125.24.0-255,8574,324435,6,340087
28588,0.00331,172.31.36.0-255,66,324501,6,340087
28589,0.003321,74.125.24.0-255,5738,330239,6,340087
28590,0.003323,172.31.36.0-255,66,330305,6,340087
28591,0.003374,172.31.36.0-255,66,330371,6,340087
28592,0.003381,74.125.24.0-255,5738,336109,6,340087
28593,0.003386,172.31.36.0-255,66,336175,6,340087
28594,0.003417,172.31.36.0-255,66,336241,6,340087
28595,0.003423,74.125.24.0-255,3504,339745,6,340087
28596,0.003425,172.31.36.0-255,66,339811,6,340087
28597,0.003448,74.125.24.0-255,105,339916,6,340087
28598,0.009351,172.31.36.0-255,66,339982,6,340087
28599,0.009394,172.31.36.0-255,105,340087,6,340087
28600,0.0,74.125.24.0-255,155,155,6,188025
28601,1.8e-05,172.31.36.0-255,66,221,6,188025
28602,2.5e-05,74.125.24.0-255,1484,1705,6,188025
28603,2.9e-05,172.31.36.0-255,66,1771,6,188025
28604,3.6e-05,74.125.24.0-255,2902,4673,6,188025
28605,3.9e-05,172.31.36.0-255,66,4739,6,188025
28606,4.7e-05,74.125.24.0-255,7156,11895,6,188025
28607,5e-05,172.31.36.0-255,66,11961,6,188025
28608,9.6e-05,172.31.36.0-255,66,12027,6,188025
28609,0.0001,74.125.24.0-255,2902,14929,6,188025
28610,0.000103,172.31.36.0-255,66,14995,6,188025
28611,0.000124,74.125.24.0-255,2543,17538,6,188025
28612,0.000127,172.31.36.0-255,66,17604,6,188025
28613,0.000175,74.125.24.0-255,1484,19088,6,188025
28614,0.000179,172.31.36.0-255,66,19154,6,188025
28615,0.000213,74.125.24.0-255,2902,22056,6,188025
28616,0.000216,172.31.36.0-255,66,22122,6,188025
28617,0.000223,74.125.24.0-255,5738,27860,6,188025
28618,0.000226,172.31.36.0-255,66,27926,6,188025
28619,0.000252,74.125.24.0-255,7156,35082,6,188025
28620,0.000255,172.31.36.0-255,66,35148,6,188025
28621,0.000277,74.125.24.0-255,5379,40527,6,188025
28622,0.000279,172.31.36.0-255,66,40593,6,188025
28623,0.000317,74.125.24.0-255,9992,50585,6,188025
28624,0.00032,172.31.36.0-255,66,50651,6,188025
28625,0.000334,74.125.24.0-255,1450,52101,6,188025
28626,0.000336,172.31.36.0-255,66,52167,6,188025
28627,0.000549,74.125.24.0-255,353,52520,6,188025
28628,0.000556,172.31.36.0-255,66,52586,6,188025
28629,0.000686,74.125.24.0-255,1484,54070,6,188025
28630,0.000691,172.31.36.0-255,66,54136,6,188025
28631,0.000697,74.125.24.0-255,2902,57038,6,188025
28632,0.000705,74.125.24.0-255,5738,62776,6,188025
28633,0.000737,74.125.24.0-255,7156,69932,6,188025
28634,0.000741,172.31.36.0-255,66,69998,6,188025
28635,0.000747,172.31.36.0-255,66,70064,6,188025
28636,0.000766,74.125.24.0-255,6797,76861,6,188025
28637,0.000776,74.125.24.0-255,9633,86494,6,188025
28638,0.000793,172.31.36.0-255,66,86560,6,188025
28639,0.001499,74.125.24.0-255,1484,88044,6,188025
28640,0.001509,74.125.24.0-255,2902,90946,6,188025
28641,0.001513,172.31.36.0-255,66,91012,6,188025
28642,0.001522,74.125.24.0-255,5738,96750,6,188025
28643,0.001567,74.125.24.0-255,10692,107442,6,188025
28644,0.001664,74.125.24.0-255,1484,108926,6,188025
28645,0.00167,74.125.24.0-255,2902,111828,6,188025
28646,0.001696,74.125.24.0-255,5738,117566,6,188025
28647,0.001699,74.125.24.0-255,1484,119050,6,188025
28648,0.001729,74.125.24.0-255,8574,127624,6,188025
28649,0.00176,74.125.24.0-255,4320,131944,6,188025
28650,0.001917,74.125.24.0-255,7156,139100,6,188025
28651,0.002,74.125.24.0-255,6438,145538,6,188025
28652,0.002022,74.125.24.0-255,5020,150558,6,188025
28653,0.002064,74.125.24.0-255,7156,157714,6,188025
28654,0.002084,74.125.24.0-255,4320,162034,6,188025
28655,0.002118,74.125.24.0-255,7156,169190,6,188025
28656,0.002146,74.125.24.0-255,7856,177046,6,188025
28657,0.002166,74.125.24.0-255,5738,182784,6,188025
28658,0.002235,74.125.24.0-255,4320,187104,6,188025
28659,0.002262,74.125.24.0-255,750,187854,6,188025
28660,0.002265,74.125.24.0-255,105,187959,6,188025
28661,0.008285,172.31.36.0-255,66,188025,6,188025
28662,0.0,74.125.130.0-255,297,297,6,303803
28663,2.7e-05,172.31.36.0-255,66,363,6,303803
28664,3.4e-05,74.125.130.0-255,1484,1847,6,303803
28665,3.9e-05,172.31.36.0-255,66,1913,6,303803
28666,4.5e-05,74.125.130.0-255,2902,4815,6,303803
28667,4.8e-05,172.31.36.0-255,66,4881,6,303803
28668,7.1e-05,74.125.130.0-255,5738,10619,6,303803
28669,7.4e-05,172.31.36.0-255,66,10685,6,303803
28670,0.000114,74.125.130.0-255,1484,12169,6,303803
28671,0.000117,172.31.36.0-255,66,12235,6,303803
28672,0.000142,74.125.130.0-255,4703,16938,6,303803
28673,0.000145,172.31.36.0-255,66,17004,6,303803
28674,0.000147,74.125.130.0-255,1484,18488,6,303803
28675,0.000149,172.31.36.0-255,66,18554,6,303803
28676,0.000168,74.125.130.0-255,5738,24292,6,303803
28677,0.00017,172.31.36.0-255,66,24358,6,303803
28678,0.000194,74.125.130.0-255,4320,28678,6,303803
28679,0.000196,172.31.36.0-255,66,28744,6,303803
28680,0.000199,74.125.130.0-255,1484,30228,6,303803
28681,0.000201,172.31.36.0-255,66,30294,6,303803
28682,0.000227,74.125.130.0-255,1125,31419,6,303803
28683,0.00023,172.31.36.0-255,66,31485,6,303803
28684,0.00036,74.125.130.0-255,1484,32969,6,303803
28685,0.000365,172.31.36.0-255,66,33035,6,303803
28686,0.000371,74.125.130.0-255,2902,35937,6,303803
28687,0.000374,172.31.36.0-255,66,36003,6,303803
28688,0.000377,74.125.130.0-255,1484,37487,6,303803
28689,0.000379,172.31.36.0-255,66,37553,6,303803
28690,0.000383,74.125.130.0-255,1484,39037,6,303803
28691,0.000385,172.31.36.0-255,66,39103,6,303803
28692,0.000403,74.125.130.0-255,1484,40587,6,303803
28693,0.000406,172.31.36.0-255,66,40653,6,303803
28694,0.000422,74.125.130.0-255,5738,46391,6,303803
28695,0.000425,172.31.36.0-255,66,46457,6,303803
28696,0.000465,74.125.130.0-255,4320,50777,6,303803
28697,0.000468,172.31.36.0-255,66,50843,6,303803
28698,0.000481,74.125.130.0-255,1484,52327,6,303803
28699,0.000512,74.125.130.0-255,7156,59483,6,303803
28700,0.000515,172.31.36.0-255,66,59549,6,303803
28701,0.000521,74.125.130.0-255,4320,63869,6,303803
28702,0.000523,172.31.36.0-255,66,63935,6,303803
28703,0.000547,74.125.130.0-255,2184,66119,6,303803
28704,0.00055,172.31.36.0-255,66,66185,6,303803
28705,0.000566,74.125.130.0-255,410,66595,6,303803
28706,0.000754,74.125.130.0-255,1484,68079,6,303803
28707,0.000759,172.31.36.0-255,66,68145,6,303803
28708,0.000778,74.125.130.0-255,1484,69629,6,303803
28709,0.000795,74.125.130.0-255,1484,71113,6,303803
28710,0.000798,172.31.36.0-255,66,71179,6,303803
28711,0.000801,74.125.130.0-255,1484,72663,6,303803
28712,0.000807,74.125.130.0-255,2902,75565,6,303803
28713,0.000809,172.31.36.0-255,66,75631,6,303803
28714,0.000814,74.125.130.0-255,2902,78533,6,303803
28715,0.000816,172.31.36.0-255,66,78599,6,303803
28716,0.00084,74.125.130.0-255,2902,81501,6,303803
28717,0.000843,172.31.36.0-255,66,81567,6,303803
28718,0.000849,74.125.130.0-255,4320,85887,6,303803
28719,0.000851,172.31.36.0-255,66,85953,6,303803
28720,0.000854,74.125.130.0-255,1484,87437,6,303803
28721,0.000881,74.125.130.0-255,4320,91757,6,303803
28722,0.000884,172.31.36.0-255,66,91823,6,303803
28723,0.000891,74.125.130.0-255,5738,97561,6,303803
28724,0.000893,172.31.36.0-255,66,97627,6,303803
28725,0.000909,74.125.130.0-255,3320,100947,6,303803
28726,0.000912,172.31.36.0-255,66,101013,6,303803
28727,0.000917,74.125.130.0-255,2902,103915,6,303803
28728,0.000919,172.31.36.0-255,66,103981,6,303803
28729,0.000944,74.125.130.0-255,7156,111137,6,303803
28730,0.000947,172.31.36.0-255,66,111203,6,303803
28731,0.000956,74.125.130.0-255,8574,119777,6,303803
28732,0.000958,172.31.36.0-255,66,119843,6,303803
28733,0.000961,74.125.130.0-255,1484,121327,6,303803
28734,0.000987,74.125.130.0-255,8574,129901,6,303803
28735,0.00099,172.31.36.0-255,66,129967,6,303803
28736,0.000997,74.125.130.0-255,5020,134987,6,303803
28737,0.000999,172.31.36.0-255,66,135053,6,303803
28738,0.001238,74.125.130.0-255,1484,136537,6,303803
28739,0.001257,74.125.130.0-255,2902,139439,6,303803
28740,0.001261,172.31.36.0-255,66,139505,6,303803
28741,0.001267,74.125.130.0-255,2902,142407,6,303803
28742,0.001269,172.31.36.0-255,66,142473,6,303803
28743,0.001284,74.125.130.0-255,2902,145375,6,303803
28744,0.001287,172.31.36.0-255,66,145441,6,303803
28745,0.001294,74.125.130.0-255,5738,151179,6,303803
28746,0.001296,172.31.36.0-255,66,151245,6,303803
28747,0.001328,74.125.130.0-255,7156,158401,6,303803
28748,0.001331,172.31.36.0-255,66,158467,6,303803
28749,0.001334,74.125.130.0-255,1484,159951,6,303803
28750,0.001353,74.125.130.0-255,5738,165689,6,303803
28751,0.001356,172.31.36.0-255,66,165755,6,303803
28752,0.001385,74.125.130.0-255,1484,167239,6,303803
28753,0.001401,74.125.130.0-255,2184,169423,6,303803
28754,0.001404,172.31.36.0-255,66,169489,6,303803
28755,0.00146,74.125.130.0-255,1484,170973,6,303803
28756,0.001465,74.125.130.0-255,2902,173875,6,303803
28757,0.001468,172.31.36.0-255,66,173941,6,303803
28758,0.001472,74.125.130.0-255,1484,175425,6,303803
28759,0.001493,74.125.130.0-255,4320,179745,6,303803
28760,0.001496,172.31.36.0-255,66,179811,6,303803
28761,0.001501,74.125.130.0-255,2902,182713,6,303803
28762,0.001503,172.31.36.0-255,66,182779,6,303803
28763,0.001508,74.125.130.0-255,4320,187099,6,303803
28764,0.001511,172.31.36.0-255,66,187165,6,303803
28765,0.001514,74.125.130.0-255,1484,188649,6,303803
28766,0.001538,74.125.130.0-255,7156,195805,6,303803
28767,0.001541,172.31.36.0-255,66,195871,6,303803
28768,0.001549,74.125.130.0-255,7856,203727,6,303803
28769,0.001552,172.31.36.0-255,66,203793,6,303803
28770,0.001631,74.125.130.0-255,1484,205277,6,303803
28771,0.001644,74.125.130.0-255,2902,208179,6,303803
28772,0.001648,172.31.36.0-255,66,208245,6,303803
28773,0.001651,74.125.130.0-255,1484,209729,6,303803
28774,0.00167,74.125.130.0-255,4320,214049,6,303803
28775,0.001673,172.31.36.0-255,66,214115,6,303803
28776,0.001725,172.31.36.0-255,66,214181,6,303803
28777,0.001744,74.125.130.0-255,1484,215665,6,303803
28778,0.00177,74.125.130.0-255,9274,224939,6,303803
28779,0.001774,172.31.36.0-255,66,225005,6,303803
28780,0.001822,74.125.130.0-255,1484,226489,6,303803
28781,0.001851,74.125.130.0-255,2902,229391,6,303803
28782,0.001856,172.31.36.0-255,66,229457,6,303803
28783,0.001861,74.125.130.0-255,4320,233777,6,303803
28784,0.001864,172.31.36.0-255,66,233843,6,303803
28785,0.001867,74.125.130.0-255,1484,235327,6,303803
28786,0.001899,74.125.130.0-255,7156,242483,6,303803
28787,0.001903,172.31.36.0-255,66,242549,6,303803
28788,0.001913,74.125.130.0-255,9992,252541,6,303803
28789,0.001915,172.31.36.0-255,66,252607,6,303803
28790,0.001952,74.125.130.0-255,4320,256927,6,303803
28791,0.001955,172.31.36.0-255,66,256993,6,303803
28792,0.001973,74.125.130.0-255,2184,259177,6,303803
28793,0.001977,172.31.36.0-255,66,259243,6,303803
28794,0.002095,74.125.130.0-255,1484,260727,6,303803
28795,0.002101,74.125.130.0-255,2902,263629,6,303803
28796,0.002104,172.31.36.0-255,66,263695,6,303803
28797,0.002124,74.125.130.0-255,5738,269433,6,303803
28798,0.002126,172.31.36.0-255,66,269499,6,303803
28799,0.002156,74.125.130.0-255,7156,276655,6,303803
28800,0.002159,172.31.36.0-255,66,276721,6,303803
28801,0.002176,74.125.130.0-255,5738,282459,6,303803
28802,0.00218,172.31.36.0-255,66,282525,6,303803
28803,0.002215,74.125.130.0-255,2902,285427,6,303803
28804,0.002218,172.31.36.0-255,66,285493,6,303803
28805,0.00224,74.125.130.0-255,7156,292649,6,303803
28806,0.002243,172.31.36.0-255,66,292715,6,303803
28807,0.002246,74.125.130.0-255,766,293481,6,303803
28808,0.003807,172.31.36.0-255,66,293547,6,303803
28809,0.004818,74.125.130.0-255,4320,297867,6,303803
28810,0.004826,172.31.36.0-255,66,297933,6,303803
28811,0.006364,74.125.130.0-255,1484,299417,6,303803
28812,0.007415,74.125.130.0-255,4320,303737,6,303803
28813,0.007427,172.31.36.0-255,66,303803,6,303803
28814,0.0,74.125.24.0-255,153,153,6,279464
28815,2.2e-05,172.31.36.0-255,66,219,6,279464
28816,3.6e-05,74.125.24.0-255,1484,1703,6,279464
28817,4.1e-05,172.31.36.0-255,66,1769,6,279464
28818,6.7e-05,74.125.24.0-255,2902,4671,6,279464
28819,7e-05,172.31.36.0-255,66,4737,6,279464
28820,7.6e-05,74.125.24.0-255,5738,10475,6,279464
28821,7.8e-05,172.31.36.0-255,66,10541,6,279464
28822,9.6e-05,74.125.24.0-255,1484,12025,6,279464
28823,9.8e-05,172.31.36.0-255,66,12091,6,279464
28824,0.000118,74.125.24.0-255,2048,14139,6,279464
28825,0.000121,172.31.36.0-255,66,14205,6,279464
28826,0.000126,74.125.24.0-255,4320,18525,6,279464
28827,0.00013,172.31.36.0-255,66,18591,6,279464
28828,0.000133,74.125.24.0-255,1484,20075,6,279464
28829,0.000136,172.31.36.0-255,66,20141,6,279464
28830,0.000165,74.125.24.0-255,8574,28715,6,279464
28831,0.000169,172.31.36.0-255,66,28781,6,279464
28832,0.000175,74.125.24.0-255,2543,31324,6,279464
28833,0.000177,172.31.36.0-255,66,31390,6,279464
28834,0.000244,74.125.24.0-255,1484,32874,6,279464
28835,0.000247,172.31.36.0-255,66,32940,6,279464
28836,0.000252,74.125.24.0-255,2902,35842,6,279464
28837,0.000256,172.31.36.0-255,66,35908,6,279464
28838,0.00028,74.125.24.0-255,5738,41646,6,279464
28839,0.000285,172.31.36.0-255,66,41712,6,279464
28840,0.000307,74.125.24.0-255,5738,47450,6,279464
28841,0.000311,172.31.36.0-255,66,47516,6,279464
28842,0.000329,74.125.24.0-255,1125,48641,6,279464
28843,0.000331,172.31.36.0-255,66,48707,6,279464
28844,0.000336,74.125.24.0-255,2902,51609,6,279464
28845,0.00034,172.31.36.0-255,66,51675,6,279464
28846,0.000353,74.125.24.0-255,4320,55995,6,279464
28847,0.000355,74.125.24.0-255,1484,57479,6,279464
28848,0.000357,172.31.36.0-255,66,57545,6,279464
28849,0.000383,74.125.24.0-255,7156,64701,6,279464
28850,0.000387,172.31.36.0-255,66,64767,6,279464
28851,0.000403,74.125.24.0-255,1459,66226,6,279464
28852,0.000563,74.125.24.0-255,343,66569,6,279464
28853,0.000568,172.31.36.0-255,66,66635,6,279464
28854,0.000762,74.125.24.0-255,1484,68119,6,279464
28855,0.000798,74.125.24.0-255,2902,71021,6,279464
28856,0.000802,172.31.36.0-255,66,71087,6,279464
28857,0.000808,74.125.24.0-255,5738,76825,6,279464
28858,0.000811,172.31.36.0-255,66,76891,6,279464
28859,0.000827,172.31.36.0-255,66,76957,6,279464
28860,0.000839,74.125.24.0-255,1484,78441,6,279464
28861,0.000849,74.125.24.0-255,10692,89133,6,279464
28862,0.000852,172.31.36.0-255,66,89199,6,279464
28863,0.000899,74.125.24.0-255,1484,90683,6,279464
28864,0.000919,74.125.24.0-255,2902,93585,6,279464
28865,0.000922,172.31.36.0-255,66,93651,6,279464
28866,0.000928,74.125.24.0-255,5738,99389,6,279464
28867,0.00093,172.31.36.0-255,66,99455,6,279464
28868,0.00097,74.125.24.0-255,5738,105193,6,279464
28869,0.000973,172.31.36.0-255,66,105259,6,279464
28870,0.000994,74.125.24.0-255,7156,112415,6,279464
28871,0.000997,172.31.36.0-255,66,112481,6,279464
28872,0.001023,74.125.24.0-255,10692,123173,6,279464
28873,0.001026,172.31.36.0-255,66,123239,6,279464
28874,0.001044,74.125.24.0-255,1484,124723,6,279464
28875,0.00106,74.125.24.0-255,2902,127625,6,279464
28876,0.001064,74.125.24.0-255,2902,130527,6,279464
28877,0.001065,172.31.36.0-255,66,130593,6,279464
28878,0.001068,172.31.36.0-255,66,130659,6,279464
28879,0.001085,74.125.24.0-255,2902,133561,6,279464
28880,0.001088,172.31.36.0-255,66,133627,6,279464
28881,0.001102,74.125.24.0-255,5738,139365,6,279464
28882,0.001106,172.31.36.0-255,66,139431,6,279464
28883,0.001131,74.125.24.0-255,7156,146587,6,279464
28884,0.001136,172.31.36.0-255,66,146653,6,279464
28885,0.001145,74.125.24.0-255,10692,157345,6,279464
28886,0.001148,172.31.36.0-255,66,157411,6,279464
28887,0.00117,74.125.24.0-255,5738,163149,6,279464
28888,0.001173,172.31.36.0-255,66,163215,6,279464
28889,0.001178,74.125.24.0-255,2902,166117,6,279464
28890,0.00118,172.31.36.0-255,66,166183,6,279464
28891,0.001197,74.125.24.0-255,4320,170503,6,279464
28892,0.0012,172.31.36.0-255,66,170569,6,279464
28893,0.001207,74.125.24.0-255,5738,176307,6,279464
28894,0.00121,172.31.36.0-255,66,176373,6,279464
28895,0.001233,74.125.24.0-255,8574,184947,6,279464
28896,0.001237,172.31.36.0-255,66,185013,6,279464
28897,0.001244,74.125.24.0-255,6438,191451,6,279464
28898,0.001246,172.31.36.0-255,66,191517,6,279464
28899,0.001283,74.125.24.0-255,1484,193001,6,279464
28900,0.001298,74.125.24.0-255,2902,195903,6,279464
28901,0.001302,172.31.36.0-255,66,195969,6,279464
28902,0.001307,74.125.24.0-255,4320,200289,6,279464
28903,0.00131,172.31.36.0-255,66,200355,6,279464
28904,0.001322,74.125.24.0-255,1484,201839,6,279464
28905,0.001326,74.125.24.0-255,2902,204741,6,279464
28906,0.001329,172.31.36.0-255,66,204807,6,279464
28907,0.001346,74.125.24.0-255,4320,209127,6,279464
28908,0.001349,172.31.36.0-255,66,209193,6,279464
28909,0.001371,74.125.24.0-255,4320,213513,6,279464
28910,0.001374,172.31.36.0-255,66,213579,6,279464
28911,0.001382,74.125.24.0-255,8574,222153,6,279464
28912,0.001386,172.31.36.0-255,66,222219,6,279464
28913,0.001418,74.125.24.0-255,3602,225821,6,279464
28914,0.001422,172.31.36.0-255,66,225887,6,279464
28915,0.001435,172.31.36.0-255,66,225953,6,279464
28916,0.001458,172.31.36.0-255,66,226019,6,279464
28917,0.001466,74.125.24.0-255,7856,233875,6,279464
28918,0.00147,172.31.36.0-255,66,233941,6,279464
28919,0.001477,74.125.24.0-255,8574,242515,6,279464
28920,0.001481,172.31.36.0-255,66,242581,6,279464
28921,0.001539,172.31.36.0-255,66,242647,6,279464
28922,0.00156,74.125.24.0-255,2902,245549,6,279464
28923,0.001563,172.31.36.0-255,66,245615,6,279464
28924,0.001566,74.125.24.0-255,766,246381,6,279464
28925,0.001581,172.31.36.0-255,66,246447,6,279464
28926,0.001597,172.31.36.0-255,66,246513,6,279464
28927,0.0016,74.125.24.0-255,766,247279,6,279464
28928,0.001644,74.125.24.0-255,5738,253017,6,279464
28929,0.001648,172.31.36.0-255,66,253083,6,279464
28930,0.001675,172.31.36.0-255,66,253149,6,279464
28931,0.001687,172.31.36.0-255,66,253215,6,279464
28932,0.001712,74.125.24.0-255,1484,254699,6,279464
28933,0.001722,74.125.24.0-255,9274,263973,6,279464
28934,0.001726,172.31.36.0-255,66,264039,6,279464
28935,0.001734,74.125.24.0-255,9992,274031,6,279464
28936,0.001736,172.31.36.0-255,66,274097,6,279464
28937,0.001771,74.125.24.0-255,4862,278959,6,279464
28938,0.001775,172.31.36.0-255,66,279025,6,279464
28939,0.001778,74.125.24.0-255,97,279122,6,279464
28940,0.001833,74.125.24.0-255,105,279227,6,279464
28941,0.003366,172.31.36.0-255,66,279293,6,279464
28942,0.00339,172.31.36.0-255,105,279398,6,279464
28943,0.005859,74.125.24.0-255,66,279464,6,279464
28944,0.0,74.125.130.0-255,153,153,6,100869
28945,2.2e-05,172.31.36.0-255,66,219,6,100869
28946,2.8e-05,74.125.130.0-255,1484,1703,6,100869
28947,3.3e-05,172.31.36.0-255,66,1769,6,100869
28948,4.8e-05,74.125.130.0-255,2902,4671,6,100869
28949,5.3e-05,172.31.36.0-255,66,4737,6,100869
28950,5.8e-05,74.125.130.0-255,2902,7639,6,100869
28951,6.1e-05,172.31.36.0-255,66,7705,6,100869
28952,8.5e-05,74.125.130.0-255,2902,10607,6,100869
28953,8.8e-05,172.31.36.0-255,66,10673,6,100869
28954,9.9e-05,74.125.130.0-255,3465,14138,6,100869
28955,0.000102,172.31.36.0-255,66,14204,6,100869
28956,0.000108,74.125.130.0-255,4320,18524,6,100869
28957,0.000111,172.31.36.0-255,66,18590,6,100869
28958,0.000127,74.125.130.0-255,2902,21492,6,100869
28959,0.00013,172.31.36.0-255,66,21558,6,100869
28960,0.000167,74.125.130.0-255,7156,28714,6,100869
28961,0.00017,172.31.36.0-255,66,28780,6,100869
28962,0.000175,74.125.130.0-255,2543,31323,6,100869
28963,0.000178,172.31.36.0-255,66,31389,6,100869
28964,0.000271,74.125.130.0-255,1484,32873,6,100869
28965,0.000277,172.31.36.0-255,66,32939,6,100869
28966,0.000281,74.125.130.0-255,1484,34423,6,100869
28967,0.000283,172.31.36.0-255,66,34489,6,100869
28968,0.000288,74.125.130.0-255,2902,37391,6,100869
28969,0.000297,172.31.36.0-255,66,37457,6,100869
28970,0.000337,74.125.130.0-255,5738,43195,6,100869
28971,0.000341,172.31.36.0-255,66,43261,6,100869
28972,0.000348,74.125.130.0-255,5379,48640,6,100869
28973,0.000351,172.31.36.0-255,66,48706,6,100869
28974,0.000364,74.125.130.0-255,5738,54444,6,100869
28975,0.000367,172.31.36.0-255,66,54510,6,100869
28976,0.000575,172.31.36.0-255,66,54576,6,100869
28977,0.001066,74.125.130.0-255,645,55221,6,100869
28978,0.001184,172.31.36.0-255,66,55287,6,100869
28979,0.001255,74.125.130.0-255,1484,56771,6,100869
28980,0.001274,74.125.130.0-255,2902,59673,6,100869
28981,0.001288,74.125.130.0-255,4320,63993,6,100869
28982,0.001309,74.125.130.0-255,5738,69731,6,100869
28983,0.001326,172.31.36.0-255,66,69797,6,100869
28984,0.001351,74.125.130.0-255,8215,78012,6,100869
28985,0.001357,74.125.130.0-255,2902,80914,6,100869
28986,0.001383,74.125.130.0-255,5738,86652,6,100869
28987,0.001388,74.125.130.0-255,2543,89195,6,100869
28988,0.001407,172.31.36.0-255,66,89261,6,100869
28989,0.003684,74.125.130.0-255,5738,94999,6,100869
28990,0.003692,172.31.36.0-255,66,95065,6,100869
28991,0.005933,74.125.130.0-255,5738,100803,6,100869
28992,0.007725,172.31.36.0-255,66,100869,6,100869
28993,0.0,74.125.24.0-255,296,296,6,374651
28994,2.2e-05,172.31.36.0-255,66,362,6,374651
28995,2.8e-05,74.125.24.0-255,1484,1846,6,374651
28996,3.2e-05,172.31.36.0-255,66,1912,6,374651
28997,3.9e-05,74.125.24.0-255,4320,6232,6,374651
28998,4.1e-05,172.31.36.0-255,66,6298,6,374651
28999,5e-05,74.125.24.0-255,7458,13756,6,374651
29000,5.3e-05,172.31.36.0-255,66,13822,6,374651
29001,6.1e-05,74.125.24.0-255,8574,22396,6,374651
29002,6.5e-05,172.31.36.0-255,66,22462,6,374651
29003,0.000112,74.125.24.0-255,8215,30677,6,374651
29004,0.000115,172.31.36.0-255,66,30743,6,374651
29005,0.00016,74.125.24.0-255,1484,32227,6,374651
29006,0.000163,172.31.36.0-255,66,32293,6,374651
29007,0.000168,74.125.24.0-255,2902,35195,6,374651
29008,0.00017,172.31.36.0-255,66,35261,6,374651
29009,0.000195,74.125.24.0-255,4320,39581,6,374651
29010,0.000198,172.31.36.0-255,66,39647,6,374651
29011,0.000217,74.125.24.0-255,1484,41131,6,374651
29012,0.000219,172.31.36.0-255,66,41197,6,374651
29013,0.000235,172.31.36.0-255,66,41263,6,374651
29014,0.000245,74.125.24.0-255,9944,51207,6,374651
29015,0.000248,172.31.36.0-255,66,51273,6,374651
29016,0.000328,74.125.24.0-255,111,51384,6,374651
29017,0.000331,172.31.36.0-255,66,51450,6,374651
29018,0.00045,74.125.24.0-255,1484,52934,6,374651
29019,0.000454,172.31.36.0-255,66,53000,6,374651
29020,0.000459,74.125.24.0-255,2902,55902,6,374651
29021,0.000461,172.31.36.0-255,66,55968,6,374651
29022,0.000483,74.125.24.0-255,1484,57452,6,374651
29023,0.000486,172.31.36.0-255,66,57518,6,374651
29024,0.000491,74.125.24.0-255,2902,60420,6,374651
29025,0.000493,172.31.36.0-255,66,60486,6,374651
29026,0.000509,74.125.24.0-255,4320,64806,6,374651
29027,0.000511,172.31.36.0-255,66,64872,6,374651
29028,0.000532,74.125.24.0-255,1484,66356,6,374651
29029,0.000539,74.125.24.0-255,3961,70317,6,374651
29030,0.000541,172.31.36.0-255,66,70383,6,374651
29031,0.000563,74.125.24.0-255,4320,74703,6,374651
29032,0.000565,172.31.36.0-255,66,74769,6,374651
29033,0.000583,74.125.24.0-255,1484,76253,6,374651
29034,0.000603,74.125.24.0-255,7156,83409,6,374651
29035,0.000606,172.31.36.0-255,66,83475,6,374651
29036,0.000648,74.125.24.0-255,2543,86018,6,374651
29037,0.000651,172.31.36.0-255,66,86084,6,374651
29038,0.000725,74.125.24.0-255,1484,87568,6,374651
29039,0.000747,74.125.24.0-255,2902,90470,6,374651
29040,0.000751,172.31.36.0-255,66,90536,6,374651
29041,0.000758,74.125.24.0-255,5738,96274,6,374651
29042,0.000761,172.31.36.0-255,66,96340,6,374651
29043,0.000775,74.125.24.0-255,1484,97824,6,374651
29044,0.000805,74.125.24.0-255,8574,106398,6,374651
29045,0.000808,172.31.36.0-255,66,106464,6,374651
29046,0.000817,74.125.24.0-255,8574,115038,6,374651
29047,0.00082,172.31.36.0-255,66,115104,6,374651
29048,0.00084,74.125.24.0-255,2902,118006,6,374651
29049,0.000842,172.31.36.0-255,66,118072,6,374651
29050,0.000846,74.125.24.0-255,2184,120256,6,374651
29051,0.000848,172.31.36.0-255,66,120322,6,374651
29052,0.000947,74.125.24.0-255,1484,121806,6,374651
29053,0.00096,74.125.24.0-255,2902,124708,6,374651
29054,0.000969,172.31.36.0-255,66,124774,6,374651
29055,0.000977,74.125.24.0-255,5738,130512,6,374651
29056,0.000979,172.31.36.0-255,66,130578,6,374651
29057,0.001007,74.125.24.0-255,7156,137734,6,374651
29058,0.00101,172.31.36.0-255,66,137800,6,374651
29059,0.001039,74.125.24.0-255,4320,142120,6,374651
29060,0.001042,172.31.36.0-255,66,142186,6,374651
29061,0.001069,74.125.24.0-255,8574,150760,6,374651
29062,0.001072,172.31.36.0-255,66,150826,6,374651
29063,0.001094,74.125.24.0-255,3602,154428,6,374651
29064,0.001097,172.31.36.0-255,66,154494,6,374651
29065,0.001157,74.125.24.0-255,4320,158814,6,374651
29066,0.00116,172.31.36.0-255,66,158880,6,374651
29067,0.001168,74.125.24.0-255,5738,164618,6,374651
29068,0.00117,172.31.36.0-255,66,164684,6,374651
29069,0.001186,74.125.24.0-255,1484,166168,6,374651
29070,0.001196,74.125.24.0-255,1484,167652,6,374651
29071,0.0012,172.31.36.0-255,66,167718,6,374651
29072,0.001208,74.125.24.0-255,1484,169202,6,374651
29073,0.001213,74.125.24.0-255,2902,172104,6,374651
29074,0.001215,172.31.36.0-255,66,172170,6,374651
29075,0.001237,74.125.24.0-255,2902,175072,6,374651
29076,0.00124,172.31.36.0-255,66,175138,6,374651
29077,0.001247,74.125.24.0-255,5738,180876,6,374651
29078,0.001249,172.31.36.0-255,66,180942,6,374651
29079,0.001289,74.125.24.0-255,5738,186680,6,374651
29080,0.001292,172.31.36.0-255,66,186746,6,374651
29081,0.001311,74.125.24.0-255,2448,189194,6,374651
29082,0.001313,172.31.36.0-255,66,189260,6,374651
29083,0.001344,74.125.24.0-255,7156,196416,6,374651
29084,0.001347,172.31.36.0-255,66,196482,6,374651
29085,0.001389,74.125.24.0-255,2902,199384,6,374651
29086,0.001392,172.31.36.0-255,66,199450,6,374651
29087,0.001414,74.125.24.0-255,5738,205188,6,374651
29088,0.001417,172.31.36.0-255,66,205254,6,374651
29089,0.001426,74.125.24.0-255,8574,213828,6,374651
29090,0.001428,172.31.36.0-255,66,213894,6,374651
29091,0.001436,74.125.24.0-255,9274,223168,6,374651
29092,0.001438,172.31.36.0-255,66,223234,6,374651
29093,0.001589,74.125.24.0-255,1484,224718,6,374651
29094,0.001594,74.125.24.0-255,2902,227620,6,374651
29095,0.001597,172.31.36.0-255,66,227686,6,374651
29096,0.001616,74.125.24.0-255,5738,233424,6,374651
29097,0.001618,172.31.36.0-255,66,233490,6,374651
29098,0.001636,74.125.24.0-255,2902,236392,6,374651
29099,0.001639,172.31.36.0-255,66,236458,6,374651
29100,0.001659,74.125.24.0-255,5738,242196,6,374651
29101,0.001661,172.31.36.0-255,66,242262,6,374651
29102,0.001671,74.125.24.0-255,9992,252254,6,374651
29103,0.001674,172.31.36.0-255,66,252320,6,374651
29104,0.001692,74.125.24.0-255,1484,253804,6,374651
29105,0.001713,74.125.24.0-255,3602,257406,6,374651
29106,0.001716,172.31.36.0-255,66,257472,6,374651
29107,0.001789,74.125.24.0-255,1484,258956,6,374651
29108,0.001793,74.125.24.0-255,1484,260440,6,374651
29109,0.001796,172.31.36.0-255,66,260506,6,374651
29110,0.001811,74.125.24.0-255,1484,261990,6,374651
29111,0.001817,74.125.24.0-255,4320,266310,6,374651
29112,0.00182,172.31.36.0-255,66,266376,6,374651
29113,0.001838,74.125.24.0-255,1484,267860,6,374651
29114,0.001843,74.125.24.0-255,2902,270762,6,374651
29115,0.001845,172.31.36.0-255,66,270828,6,374651
29116,0.001873,74.125.24.0-255,4320,275148,6,374651
29117,0.001879,74.125.24.0-255,5738,280886,6,374651
29118,0.001895,74.125.24.0-255,2902,283788,6,374651
29119,0.001901,74.125.24.0-255,5738,289526,6,374651
29120,0.001906,172.31.36.0-255,66,289592,6,374651
29121,0.00191,172.31.36.0-255,66,289658,6,374651
29122,0.001917,172.31.36.0-255,66,289724,6,374651
29123,0.00192,172.31.36.0-255,66,289790,6,374651
29124,0.001953,74.125.24.0-255,6438,296228,6,374651
29125,0.001956,172.31.36.0-255,66,296294,6,374651
29126,0.001972,74.125.24.0-255,4320,300614,6,374651
29127,0.001975,172.31.36.0-255,66,300680,6,374651
29128,0.001997,74.125.24.0-255,2902,303582,6,374651
29129,0.002,172.31.36.0-255,66,303648,6,374651
29130,0.002021,74.125.24.0-255,2902,306550,6,374651
29131,0.002024,172.31.36.0-255,66,306616,6,374651
29132,0.00205,74.125.24.0-255,9992,316608,6,374651
29133,0.002053,172.31.36.0-255,66,316674,6,374651
29134,0.002071,74.125.24.0-255,2902,319576,6,374651
29135,0.002075,172.31.36.0-255,66,319642,6,374651
29136,0.002084,74.125.24.0-255,9992,329634,6,374651
29137,0.002086,172.31.36.0-255,66,329700,6,374651
29138,0.002106,74.125.24.0-255,5020,334720,6,374651
29139,0.00211,74.125.24.0-255,4320,339040,6,374651
29140,0.002115,172.31.36.0-255,66,339106,6,374651
29141,0.002117,172.31.36.0-255,66,339172,6,374651
29142,0.002141,172.31.36.0-255,66,339238,6,374651
29143,0.002148,74.125.24.0-255,7156,346394,6,374651
29144,0.002151,172.31.36.0-255,66,346460,6,374651
29145,0.002165,74.125.24.0-255,2902,349362,6,374651
29146,0.002167,172.31.36.0-255,66,349428,6,374651
29147,0.002192,74.125.24.0-255,9274,358702,6,374651
29148,0.002194,172.31.36.0-255,66,358768,6,374651
29149,0.002201,74.125.24.0-255,7156,365924,6,374651
29150,0.002203,172.31.36.0-255,66,365990,6,374651
29151,0.002224,74.125.24.0-255,5738,371728,6,374651
29152,0.002227,172.31.36.0-255,66,371794,6,374651
29153,0.002231,74.125.24.0-255,2589,374383,6,374651
29154,0.002234,172.31.36.0-255,66,374449,6,374651
29155,0.002237,74.125.24.0-255,97,374546,6,374651
29156,0.002285,74.125.24.0-255,105,374651,6,374651
29157,0.0,172.217.194.0-255,153,153,6,292673
29158,2.4e-05,172.31.36.0-255,66,219,6,292673
29159,3.1e-05,172.217.194.0-255,1484,1703,6,292673
29160,3.5e-05,172.31.36.0-255,66,1769,6,292673
29161,4.1e-05,172.217.194.0-255,2902,4671,6,292673
29162,4.5e-05,172.31.36.0-255,66,4737,6,292673
29163,5.1e-05,172.217.194.0-255,4320,9057,6,292673
29164,5.4e-05,172.31.36.0-255,66,9123,6,292673
29165,6e-05,172.217.194.0-255,4939,14062,6,292673
29166,6.3e-05,172.31.36.0-255,66,14128,6,292673
29167,0.000117,172.31.36.0-255,66,14194,6,292673
29168,0.000134,172.217.194.0-255,1484,15678,6,292673
29169,0.000136,172.31.36.0-255,66,15744,6,292673
29170,0.000159,172.217.194.0-255,3961,19705,6,292673
29171,0.000161,172.31.36.0-255,66,19771,6,292673
29172,0.000368,172.217.194.0-255,1484,21255,6,292673
29173,0.000373,172.31.36.0-255,66,21321,6,292673
29174,0.000379,172.217.194.0-255,2902,24223,6,292673
29175,0.000382,172.31.36.0-255,66,24289,6,292673
29176,0.000388,172.217.194.0-255,4320,28609,6,292673
29177,0.000391,172.31.36.0-255,66,28675,6,292673
29178,0.000408,172.217.194.0-255,1484,30159,6,292673
29179,0.00041,172.31.36.0-255,66,30225,6,292673
29180,0.000428,172.217.194.0-255,8574,38799,6,292673
29181,0.000431,172.31.36.0-255,66,38865,6,292673
29182,0.000457,172.217.194.0-255,5379,44244,6,292673
29183,0.00046,172.31.36.0-255,66,44310,6,292673
29184,0.00047,172.217.194.0-255,9633,53943,6,292673
29185,0.000472,172.31.36.0-255,66,54009,6,292673
29186,0.000474,172.217.194.0-255,362,54371,6,292673
29187,0.000476,172.31.36.0-255,66,54437,6,292673
29188,0.000621,172.217.194.0-255,381,54818,6,292673
29189,0.000855,172.217.194.0-255,1484,56302,6,292673
29190,0.00086,172.31.36.0-255,66,56368,6,292673
29191,0.000881,172.217.194.0-255,2902,59270,6,292673
29192,0.000883,172.31.36.0-255,66,59336,6,292673
29193,0.000902,172.217.194.0-255,5738,65074,6,292673
29194,0.000904,172.31.36.0-255,66,65140,6,292673
29195,0.000912,172.217.194.0-255,8574,73714,6,292673
29196,0.000914,172.31.36.0-255,66,73780,6,292673
29197,0.000954,172.217.194.0-255,5738,79518,6,292673
29198,0.000957,172.31.36.0-255,66,79584,6,292673
29199,0.000982,172.217.194.0-255,9274,88858,6,292673
29200,0.000985,172.31.36.0-255,66,88924,6,292673
29201,0.00099,172.217.194.0-255,2902,91826,6,292673
29202,0.000992,172.31.36.0-255,66,91892,6,292673
29203,0.001028,172.31.36.0-255,66,91958,6,292673
29204,0.001037,172.217.194.0-255,9992,101950,6,292673
29205,0.00104,172.31.36.0-255,66,102016,6,292673
29206,0.001067,172.217.194.0-255,7856,109872,6,292673
29207,0.001071,172.31.36.0-255,66,109938,6,292673
29208,0.001121,172.217.194.0-255,2902,112840,6,292673
29209,0.001125,172.31.36.0-255,66,112906,6,292673
29210,0.00113,172.217.194.0-255,4320,117226,6,292673
29211,0.001132,172.31.36.0-255,66,117292,6,292673
29212,0.001136,172.217.194.0-255,1484,118776,6,292673
29213,0.001156,172.217.194.0-255,7156,125932,6,292673
29214,0.001159,172.31.36.0-255,66,125998,6,292673
29215,0.001165,172.217.194.0-255,4320,130318,6,292673
29216,0.001167,172.31.36.0-255,66,130384,6,292673
29217,0.001229,172.31.36.0-255,66,130450,6,292673
29218,0.001284,172.217.194.0-255,1484,131934,6,292673
29219,0.001301,172.217.194.0-255,2902,134836,6,292673
29220,0.001305,172.31.36.0-255,66,134902,6,292673
29221,0.001308,172.217.194.0-255,1484,136386,6,292673
29222,0.001329,172.217.194.0-255,4320,140706,6,292673
29223,0.001332,172.31.36.0-255,66,140772,6,292673
29224,0.001367,172.217.194.0-255,5738,146510,6,292673
29225,0.001374,172.31.36.0-255,66,146576,6,292673
29226,0.001378,172.31.36.0-255,66,146642,6,292673
29227,0.00139,172.217.194.0-255,4320,150962,6,292673
29228,0.001393,172.31.36.0-255,66,151028,6,292673
29229,0.001396,172.217.194.0-255,766,151794,6,292673
29230,0.001503,172.217.194.0-255,1484,153278,6,292673
29231,0.001507,172.31.36.0-255,66,153344,6,292673
29232,0.001512,172.217.194.0-255,2902,156246,6,292673
29233,0.001515,172.31.36.0-255,66,156312,6,292673
29234,0.001518,172.217.194.0-255,1484,157796,6,292673
29235,0.001536,172.217.194.0-255,4320,162116,6,292673
29236,0.001538,172.31.36.0-255,66,162182,6,292673
29237,0.00155,172.217.194.0-255,2902,165084,6,292673
29238,0.001554,172.31.36.0-255,66,165150,6,292673
29239,0.00158,172.217.194.0-255,9992,175142,6,292673
29240,0.001583,172.31.36.0-255,66,175208,6,292673
29241,0.001594,172.217.194.0-255,10692,185900,6,292673
29242,0.001596,172.31.36.0-255,66,185966,6,292673
29243,0.001628,172.217.194.0-255,1484,187450,6,292673
29244,0.001648,172.217.194.0-255,2902,190352,6,292673
29245,0.001651,172.31.36.0-255,66,190418,6,292673
29246,0.001657,172.217.194.0-255,5738,196156,6,292673
29247,0.001659,172.31.36.0-255,66,196222,6,292673
29248,0.001673,172.217.194.0-255,8574,204796,6,292673
29249,0.001676,172.31.36.0-255,66,204862,6,292673
29250,0.001744,172.31.36.0-255,66,204928,6,292673
29251,0.002516,172.217.194.0-255,1484,206412,6,292673
29252,0.002523,172.217.194.0-255,2902,209314,6,292673
29253,0.002526,172.31.36.0-255,66,209380,6,292673
29254,0.002531,172.217.194.0-255,1484,210864,6,292673
29255,0.00255,172.217.194.0-255,4320,215184,6,292673
29256,0.002552,172.31.36.0-255,66,215250,6,292673
29257,0.002559,172.217.194.0-255,5738,220988,6,292673
29258,0.002562,172.31.36.0-255,66,221054,6,292673
29259,0.002584,172.217.194.0-255,7156,228210,6,292673
29260,0.002586,172.31.36.0-255,66,228276,6,292673
29261,0.002596,172.217.194.0-255,10692,238968,6,292673
29262,0.002599,172.31.36.0-255,66,239034,6,292673
29263,0.002697,172.217.194.0-255,1484,240518,6,292673
29264,0.002703,172.217.194.0-255,2902,243420,6,292673
29265,0.002705,172.31.36.0-255,66,243486,6,292673
29266,0.002728,172.217.194.0-255,5738,249224,6,292673
29267,0.00273,172.31.36.0-255,66,249290,6,292673
29268,0.002738,172.217.194.0-255,7156,256446,6,292673
29269,0.00274,172.31.36.0-255,66,256512,6,292673
29270,0.002778,172.217.194.0-255,4320,260832,6,292673
29271,0.002782,172.31.36.0-255,66,260898,6,292673
29272,0.002802,172.217.194.0-255,9992,270890,6,292673
29273,0.002805,172.31.36.0-255,66,270956,6,292673
29274,0.002809,172.217.194.0-255,2184,273140,6,292673
29275,0.002811,172.31.36.0-255,66,273206,6,292673
29276,0.002853,172.31.36.0-255,66,273272,6,292673
29277,0.002878,172.217.194.0-255,2902,276174,6,292673
29278,0.002881,172.31.36.0-255,66,276240,6,292673
29279,0.002896,172.31.36.0-255,66,276306,6,292673
29280,0.002903,172.217.194.0-255,5738,282044,6,292673
29281,0.002905,172.31.36.0-255,66,282110,6,292673
29282,0.002917,172.31.36.0-255,66,282176,6,292673
29283,0.002947,172.217.194.0-255,5738,287914,6,292673
29284,0.00295,172.31.36.0-255,66,287980,6,292673
29285,0.002956,172.217.194.0-255,4285,292265,6,292673
29286,0.002958,172.31.36.0-255,66,292331,6,292673
29287,0.002961,172.217.194.0-255,105,292436,6,292673
29288,0.00453,172.31.36.0-255,66,292502,6,292673
29289,0.004567,172.31.36.0-255,105,292607,6,292673
29290,0.007047,172.217.194.0-255,66,292673,6,292673
29291,0.0,74.125.24.0-255,153,153,6,317029
29292,3e-05,172.31.36.0-255,66,219,6,317029
29293,3.8e-05,74.125.24.0-255,1484,1703,6,317029
29294,4.3e-05,172.31.36.0-255,66,1769,6,317029
29295,4.8e-05,74.125.24.0-255,2902,4671,6,317029
29296,5.1e-05,172.31.36.0-255,66,4737,6,317029
29297,5.7e-05,74.125.24.0-255,7156,11893,6,317029
29298,6e-05,172.31.36.0-255,66,11959,6,317029
29299,6.4e-05,74.125.24.0-255,2067,14026,6,317029
29300,6.7e-05,172.31.36.0-255,66,14092,6,317029
29301,0.000218,74.125.24.0-255,1484,15576,6,317029
29302,0.000222,172.31.36.0-255,66,15642,6,317029
29303,0.000227,74.125.24.0-255,1484,17126,6,317029
29304,0.000229,172.31.36.0-255,66,17192,6,317029
29305,0.000244,74.125.24.0-255,1484,18676,6,317029
29306,0.000246,172.31.36.0-255,66,18742,6,317029
29307,0.000252,74.125.24.0-255,5738,24480,6,317029
29308,0.000255,172.31.36.0-255,66,24546,6,317029
29309,0.000261,74.125.24.0-255,5738,30284,6,317029
29310,0.000264,172.31.36.0-255,66,30350,6,317029
29311,0.000302,172.31.36.0-255,66,30416,6,317029
29312,0.00031,74.125.24.0-255,7156,37572,6,317029
29313,0.000312,172.31.36.0-255,66,37638,6,317029
29314,0.000345,74.125.24.0-255,8574,46212,6,317029
29315,0.000349,172.31.36.0-255,66,46278,6,317029
29316,0.000355,74.125.24.0-255,5631,51909,6,317029
29317,0.000358,172.31.36.0-255,66,51975,6,317029
29318,0.0005,74.125.24.0-255,1484,53459,6,317029
29319,0.000504,172.31.36.0-255,66,53525,6,317029
29320,0.00051,74.125.24.0-255,2902,56427,6,317029
29321,0.000512,172.31.36.0-255,66,56493,6,317029
29322,0.000527,74.125.24.0-255,5738,62231,6,317029
29323,0.000534,172.31.36.0-255,66,62297,6,317029
29324,0.000541,74.125.24.0-255,1484,63781,6,317029
29325,0.000567,74.125.24.0-255,4320,68101,6,317029
29326,0.000568,172.31.36.0-255,66,68167,6,317029
29327,0.00058,74.125.24.0-255,4320,72487,6,317029
29328,0.000585,172.31.36.0-255,66,72553,6,317029
29329,0.000601,74.125.24.0-255,2184,74737,6,317029
29330,0.000617,172.31.36.0-255,66,74803,6,317029
29331,0.00062,74.125.24.0-255,2902,77705,6,317029
29332,0.000634,172.31.36.0-255,66,77771,6,317029
29333,0.000642,74.125.24.0-255,7156,84927,6,317029
29334,0.000648,172.31.36.0-255,66,84993,6,317029
29335,0.00066,74.125.24.0-255,4320,89313,6,317029
29336,0.000663,172.31.36.0-255,66,89379,6,317029
29337,0.000705,74.125.24.0-255,2902,92281,6,317029
29338,0.00071,172.31.36.0-255,66,92347,6,317029
29339,0.000723,74.125.24.0-255,5020,97367,6,317029
29340,0.000726,172.31.36.0-255,66,97433,6,317029
29341,0.000742,74.125.24.0-255,5738,103171,6,317029
29342,0.000756,172.31.36.0-255,66,103237,6,317029
29343,0.000758,74.125.24.0-255,2902,106139,6,317029
29344,0.000763,74.125.24.0-255,4320,110459,6,317029
29345,0.000769,172.31.36.0-255,66,110525,6,317029
29346,0.000796,172.31.36.0-255,66,110591,6,317029
29347,0.000837,74.125.24.0-255,7856,118447,6,317029
29348,0.00085,172.31.36.0-255,66,118513,6,317029
29349,0.000938,74.125.24.0-255,1484,119997,6,317029
29350,0.000943,74.125.24.0-255,2902,122899,6,317029
29351,0.000949,172.31.36.0-255,66,122965,6,317029
29352,0.000963,74.125.24.0-255,4320,127285,6,317029
29353,0.000974,172.31.36.0-255,66,127351,6,317029
29354,0.000977,74.125.24.0-255,1484,128835,6,317029
29355,0.000982,74.125.24.0-255,2902,131737,6,317029
29356,0.000991,74.125.24.0-255,9992,141729,6,317029
29357,0.000991,172.31.36.0-255,66,141795,6,317029
29358,0.000996,172.31.36.0-255,66,141861,6,317029
29359,0.001022,74.125.24.0-255,7156,149017,6,317029
29360,0.001033,172.31.36.0-255,66,149083,6,317029
29361,0.001037,74.125.24.0-255,3602,152685,6,317029
29362,0.001055,172.31.36.0-255,66,152751,6,317029
29363,0.001113,74.125.24.0-255,1484,154235,6,317029
29364,0.001119,74.125.24.0-255,2902,157137,6,317029
29365,0.001121,172.31.36.0-255,66,157203,6,317029
29366,0.001152,74.125.24.0-255,5738,162941,6,317029
29367,0.001158,172.31.36.0-255,66,163007,6,317029
29368,0.001159,74.125.24.0-255,7156,170163,6,317029
29369,0.001162,172.31.36.0-255,66,170229,6,317029
29370,0.001186,74.125.24.0-255,5738,175967,6,317029
29371,0.001196,74.125.24.0-255,10692,186659,6,317029
29372,0.001197,172.31.36.0-255,66,186725,6,317029
29373,0.001202,172.31.36.0-255,66,186791,6,317029
29374,0.001216,74.125.24.0-255,2902,189693,6,317029
29375,0.001218,74.125.24.0-255,1484,191177,6,317029
29376,0.001232,74.125.24.0-255,2902,194079,6,317029
29377,0.001237,74.125.24.0-255,2902,196981,6,317029
29378,0.001239,172.31.36.0-255,66,197047,6,317029
29379,0.001244,172.31.36.0-255,66,197113,6,317029
29380,0.001258,74.125.24.0-255,5738,202851,6,317029
29381,0.001268,172.31.36.0-255,66,202917,6,317029
29382,0.001283,74.125.24.0-255,4320,207237,6,317029
29383,0.001294,172.31.36.0-255,66,207303,6,317029
29384,0.001328,172.31.36.0-255,66,207369,6,317029
29385,0.001332,74.125.24.0-255,8574,215943,6,317029
29386,0.001341,172.31.36.0-255,66,216009,6,317029
29387,0.001363,74.125.24.0-255,6438,222447,6,317029
29388,0.001366,74.125.24.0-255,1484,223931,6,317029
29389,0.001367,172.31.36.0-255,66,223997,6,317029
29390,0.001369,74.125.24.0-255,1484,225481,6,317029
29391,0.001372,172.31.36.0-255,66,225547,6,317029
29392,0.001394,74.125.24.0-255,1484,227031,6,317029
29393,0.001401,74.125.24.0-255,5738,232769,6,317029
29394,0.001413,172.31.36.0-255,66,232835,6,317029
29395,0.001419,74.125.24.0-255,4320,237155,6,317029
29396,0.001426,172.31.36.0-255,66,237221,6,317029
29397,0.001441,74.125.24.0-255,8574,245795,6,317029
29398,0.001451,172.31.36.0-255,66,245861,6,317029
29399,0.001473,74.125.24.0-255,5738,251599,6,317029
29400,0.001488,172.31.36.0-255,66,251665,6,317029
29401,0.001496,74.125.24.0-255,5020,256685,6,317029
29402,0.001504,172.31.36.0-255,66,256751,6,317029
29403,0.001543,74.125.24.0-255,1484,258235,6,317029
29404,0.001548,74.125.24.0-255,2902,261137,6,317029
29405,0.001558,172.31.36.0-255,66,261203,6,317029
29406,0.001599,74.125.24.0-255,5738,266941,6,317029
29407,0.001608,74.125.24.0-255,8574,275515,6,317029
29408,0.001613,172.31.36.0-255,66,275581,6,317029
29409,0.001616,74.125.24.0-255,9992,285573,6,317029
29410,0.001628,172.31.36.0-255,66,285639,6,317029
29411,0.00164,74.125.24.0-255,5020,290659,6,317029
29412,0.001645,172.31.36.0-255,66,290725,6,317029
29413,0.001676,74.125.24.0-255,5738,296463,6,317029
29414,0.001682,74.125.24.0-255,2902,299365,6,317029
29415,0.001684,172.31.36.0-255,66,299431,6,317029
29416,0.001689,172.31.36.0-255,66,299497,6,317029
29417,0.001707,74.125.24.0-255,4320,303817,6,317029
29418,0.001725,172.31.36.0-255,66,303883,6,317029
29419,0.001734,74.125.24.0-255,5738,309621,6,317029
29420,0.00174,172.31.36.0-255,66,309687,6,317029
29421,0.001741,74.125.24.0-255,6934,316621,6,317029
29422,0.001744,172.31.36.0-255,66,316687,6,317029
29423,0.001796,74.125.24.0-255,105,316792,6,317029
29424,0.00365,172.31.36.0-255,66,316858,6,317029
29425,0.003678,172.31.36.0-255,105,316963,6,317029
29426,0.005967,74.125.24.0-255,66,317029,6,317029
29427,0.0,172.31.36.0-255,66,66,6,66
29428,0.0,74.125.24.0-255,153,153,6,305076
29429,2.3e-05,172.31.36.0-255,66,219,6,305076
29430,3.1e-05,74.125.24.0-255,1484,1703,6,305076
29431,3.5e-05,172.31.36.0-255,66,1769,6,305076
29432,4.1e-05,74.125.24.0-255,2902,4671,6,305076
29433,4.4e-05,172.31.36.0-255,66,4737,6,305076
29434,5.4e-05,74.125.24.0-255,7156,11893,6,305076
29435,5.7e-05,172.31.36.0-255,66,11959,6,305076
29436,6.5e-05,74.125.24.0-255,7659,19618,6,305076
29437,6.8e-05,172.31.36.0-255,66,19684,6,305076
29438,0.000107,172.31.36.0-255,66,19750,6,305076
29439,0.00017,74.125.24.0-255,1484,21234,6,305076
29440,0.000174,172.31.36.0-255,66,21300,6,305076
29441,0.000179,74.125.24.0-255,2902,24202,6,305076
29442,0.000181,172.31.36.0-255,66,24268,6,305076
29443,0.000207,74.125.24.0-255,4320,28588,6,305076
29444,0.00021,172.31.36.0-255,66,28654,6,305076
29445,0.000217,74.125.24.0-255,5738,34392,6,305076
29446,0.000219,172.31.36.0-255,66,34458,6,305076
29447,0.000266,172.31.36.0-255,66,34524,6,305076
29448,0.000274,74.125.24.0-255,6797,41321,6,305076
29449,0.000276,172.31.36.0-255,66,41387,6,305076
29450,0.000317,74.125.24.0-255,359,41746,6,305076
29451,0.00032,172.31.36.0-255,66,41812,6,305076
29452,0.000323,74.125.24.0-255,134,41946,6,305076
29453,0.000325,172.31.36.0-255,66,42012,6,305076
29454,0.000338,74.125.24.0-255,348,42360,6,305076
29455,0.00034,172.31.36.0-255,66,42426,6,305076
29456,0.000552,74.125.24.0-255,1484,43910,6,305076
29457,0.000558,172.31.36.0-255,66,43976,6,305076
29458,0.000565,74.125.24.0-255,2902,46878,6,305076
29459,0.000573,74.125.24.0-255,5738,52616,6,305076
29460,0.000602,74.125.24.0-255,8574,61190,6,305076
29461,0.000644,74.125.24.0-255,5738,66928,6,305076
29462,0.000674,74.125.24.0-255,8724,75652,6,305076
29463,0.000693,172.31.36.0-255,66,75718,6,305076
29464,0.000902,74.125.24.0-255,1484,77202,6,305076
29465,0.000909,74.125.24.0-255,2902,80104,6,305076
29466,0.00093,172.31.36.0-255,66,80170,6,305076
29467,0.000938,74.125.24.0-255,5738,85908,6,305076
29468,0.000945,74.125.24.0-255,7156,93064,6,305076
29469,0.000955,74.125.24.0-255,1484,94548,6,305076
29470,0.000959,172.31.36.0-255,66,94614,6,305076
29471,0.000999,74.125.24.0-255,5738,100352,6,305076
29472,0.001017,74.125.24.0-255,9274,109626,6,305076
29473,0.00102,172.31.36.0-255,66,109692,6,305076
29474,0.001031,172.31.36.0-255,66,109758,6,305076
29475,0.0011,74.125.24.0-255,1484,111242,6,305076
29476,0.001106,74.125.24.0-255,2902,114144,6,305076
29477,0.001128,74.125.24.0-255,5738,119882,6,305076
29478,0.001143,172.31.36.0-255,66,119948,6,305076
29479,0.00116,74.125.24.0-255,7156,127104,6,305076
29480,0.00118,74.125.24.0-255,8574,135678,6,305076
29481,0.001192,172.31.36.0-255,66,135744,6,305076
29482,0.001211,74.125.24.0-255,7856,143600,6,305076
29483,0.001228,172.31.36.0-255,66,143666,6,305076
29484,0.001273,74.125.24.0-255,1484,145150,6,305076
29485,0.001292,74.125.24.0-255,2902,148052,6,305076
29486,0.001299,74.125.24.0-255,5738,153790,6,305076
29487,0.001311,172.31.36.0-255,66,153856,6,305076
29488,0.001336,74.125.24.0-255,7156,161012,6,305076
29489,0.001341,172.31.36.0-255,66,161078,6,305076
29490,0.001373,74.125.24.0-255,2184,163262,6,305076
29491,0.001387,172.31.36.0-255,66,163328,6,305076
29492,0.001403,74.125.24.0-255,1484,164812,6,305076
29493,0.001416,74.125.24.0-255,2902,167714,6,305076
29494,0.001423,172.31.36.0-255,66,167780,6,305076
29495,0.001433,74.125.24.0-255,4320,172100,6,305076
29496,0.001448,74.125.24.0-255,1484,173584,6,305076
29497,0.001458,74.125.24.0-255,9992,183576,6,305076
29498,0.001474,74.125.24.0-255,2902,186478,6,305076
29499,0.00151,74.125.24.0-255,1484,187962,6,305076
29500,0.001526,74.125.24.0-255,4320,192282,6,305076
29501,0.001533,74.125.24.0-255,5020,197302,6,305076
29502,0.001538,172.31.36.0-255,66,197368,6,305076
29503,0.001662,74.125.24.0-255,1484,198852,6,305076
29504,0.001681,74.125.24.0-255,2902,201754,6,305076
29505,0.001684,74.125.24.0-255,1484,203238,6,305076
29506,0.001699,74.125.24.0-255,4320,207558,6,305076
29507,0.001714,172.31.36.0-255,66,207624,6,305076
29508,0.001748,74.125.24.0-255,5738,213362,6,305076
29509,0.001761,172.31.36.0-255,66,213428,6,305076
29510,0.001772,74.125.24.0-255,1484,214912,6,305076
29511,0.001791,74.125.24.0-255,3602,218514,6,305076
29512,0.001797,74.125.24.0-255,4320,222834,6,305076
29513,0.001812,74.125.24.0-255,1484,224318,6,305076
29514,0.001822,172.31.36.0-255,66,224384,6,305076
29515,0.001837,74.125.24.0-255,9992,234376,6,305076
29516,0.001852,74.125.24.0-255,2902,237278,6,305076
29517,0.001855,172.31.36.0-255,66,237344,6,305076
29518,0.001869,74.125.24.0-255,2902,240246,6,305076
29519,0.001887,74.125.24.0-255,4320,244566,6,305076
29520,0.001893,74.125.24.0-255,5738,250304,6,305076
29521,0.001913,74.125.24.0-255,2184,252488,6,305076
29522,0.00193,172.31.36.0-255,66,252554,6,305076
29523,0.001958,172.31.36.0-255,66,252620,6,305076
29524,0.001984,74.125.24.0-255,5020,257640,6,305076
29525,0.001988,74.125.24.0-255,1484,259124,6,305076
29526,0.002009,74.125.24.0-255,2902,262026,6,305076
29527,0.002016,74.125.24.0-255,5738,267764,6,305076
29528,0.00203,74.125.24.0-255,2902,270666,6,305076
29529,0.002033,172.31.36.0-255,66,270732,6,305076
29530,0.002046,74.125.24.0-255,4320,275052,6,305076
29531,0.002051,172.31.36.0-255,66,275118,6,305076
29532,0.002092,172.31.36.0-255,66,275184,6,305076
29533,0.002106,74.125.24.0-255,2184,277368,6,305076
29534,0.002134,74.125.24.0-255,1484,278852,6,305076
29535,0.002138,74.125.24.0-255,2902,281754,6,305076
29536,0.002142,74.125.24.0-255,1484,283238,6,305076
29537,0.002155,74.125.24.0-255,4320,287558,6,305076
29538,0.00217,74.125.24.0-255,1484,289042,6,305076
29539,0.002184,74.125.24.0-255,5738,294780,6,305076
29540,0.002195,172.31.36.0-255,66,294846,6,305076
29541,0.002206,74.125.24.0-255,5738,300584,6,305076
29542,0.002212,74.125.24.0-255,3987,304571,6,305076
29543,0.002215,74.125.24.0-255,97,304668,6,305076
29544,0.00222,172.31.36.0-255,66,304734,6,305076
29545,0.002236,74.125.24.0-255,105,304839,6,305076
29546,0.004694,172.31.36.0-255,66,304905,6,305076
29547,0.004731,172.31.36.0-255,105,305010,6,305076
29548,0.007056,74.125.24.0-255,66,305076,6,305076
29549,0.0,172.217.194.0-255,154,154,6,145722
29550,2.2e-05,172.31.36.0-255,66,220,6,145722
29551,2.9e-05,172.217.194.0-255,1484,1704,6,145722
29552,3.3e-05,172.31.36.0-255,66,1770,6,145722
29553,3.9e-05,172.217.194.0-255,2902,4672,6,145722
29554,5e-05,172.31.36.0-255,66,4738,6,145722
29555,5.9e-05,172.217.194.0-255,7156,11894,6,145722
29556,6.2e-05,172.31.36.0-255,66,11960,6,145722
29557,9.6e-05,172.217.194.0-255,2040,14000,6,145722
29558,9.9e-05,172.31.36.0-255,66,14066,6,145722
29559,0.000202,172.217.194.0-255,1484,15550,6,145722
29560,0.000206,172.31.36.0-255,66,15616,6,145722
29561,0.000234,172.217.194.0-255,2902,18518,6,145722
29562,0.000237,172.31.36.0-255,66,18584,6,145722
29563,0.000243,172.217.194.0-255,5738,24322,6,145722
29564,0.000245,172.31.36.0-255,66,24388,6,145722
29565,0.000264,172.217.194.0-255,2902,27290,6,145722
29566,0.000266,172.31.36.0-255,66,27356,6,145722
29567,0.000299,172.217.194.0-255,6797,34153,6,145722
29568,0.000302,172.31.36.0-255,66,34219,6,145722
29569,0.000311,172.217.194.0-255,9992,44211,6,145722
29570,0.000318,172.31.36.0-255,66,44277,6,145722
29571,0.000325,172.217.194.0-255,7156,51433,6,145722
29572,0.000328,172.31.36.0-255,66,51499,6,145722
29573,0.000371,172.31.36.0-255,66,51565,6,145722
29574,0.000374,172.217.194.0-255,1040,52605,6,145722
29575,0.000376,172.31.36.0-255,66,52671,6,145722
29576,0.000431,172.217.194.0-255,120,52791,6,145722
29577,0.000434,172.31.36.0-255,66,52857,6,145722
29578,0.000557,172.217.194.0-255,1484,54341,6,145722
29579,0.000561,172.31.36.0-255,66,54407,6,145722
29580,0.000566,172.217.194.0-255,2902,57309,6,145722
29581,0.000569,172.31.36.0-255,66,57375,6,145722
29582,0.000572,172.217.194.0-255,1484,58859,6,145722
29583,0.000603,172.217.194.0-255,4320,63179,6,145722
29584,0.000605,172.31.36.0-255,66,63245,6,145722
29585,0.000619,172.31.36.0-255,66,63311,6,145722
29586,0.000632,172.217.194.0-255,8574,71885,6,145722
29587,0.000634,172.31.36.0-255,66,71951,6,145722
29588,0.000664,172.217.194.0-255,2184,74135,6,145722
29589,0.000666,172.31.36.0-255,66,74201,6,145722
29590,0.00095,172.217.194.0-255,381,74582,6,145722
29591,0.001539,172.31.36.0-255,66,74648,6,145722
29592,0.001816,172.217.194.0-255,1484,76132,6,145722
29593,0.001826,172.217.194.0-255,2902,79034,6,145722
29594,0.00183,172.31.36.0-255,66,79100,6,145722
29595,0.001838,172.217.194.0-255,5738,84838,6,145722
29596,0.00184,172.31.36.0-255,66,84904,6,145722
29597,0.001856,172.217.194.0-255,9992,94896,6,145722
29598,0.001859,172.31.36.0-255,66,94962,6,145722
29599,0.001897,172.217.194.0-255,2902,97864,6,145722
29600,0.0019,172.31.36.0-255,66,97930,6,145722
29601,0.00191,172.217.194.0-255,9992,107922,6,145722
29602,0.001916,172.31.36.0-255,66,107988,6,145722
29603,0.00192,172.217.194.0-255,766,108754,6,145722
29604,0.00226,172.217.194.0-255,1484,110238,6,145722
29605,0.002267,172.31.36.0-255,66,110304,6,145722
29606,0.002274,172.217.194.0-255,2902,113206,6,145722
29607,0.002276,172.31.36.0-255,66,113272,6,145722
29608,0.002304,172.217.194.0-255,4320,117592,6,145722
29609,0.002306,172.31.36.0-255,66,117658,6,145722
29610,0.002315,172.217.194.0-255,7156,124814,6,145722
29611,0.002317,172.31.36.0-255,66,124880,6,145722
29612,0.00234,172.217.194.0-255,1484,126364,6,145722
29613,0.002343,172.217.194.0-255,1484,127848,6,145722
29614,0.002349,172.31.36.0-255,66,127914,6,145722
29615,0.004603,172.217.194.0-255,2902,130816,6,145722
29616,0.004609,172.31.36.0-255,66,130882,6,145722
29617,0.004647,172.217.194.0-255,2902,133784,6,145722
29618,0.00465,172.31.36.0-255,66,133850,6,145722
29619,0.006903,172.217.194.0-255,2902,136752,6,145722
29620,0.006909,172.31.36.0-255,66,136818,6,145722
29621,0.006938,172.217.194.0-255,2902,139720,6,145722
29622,0.006941,172.31.36.0-255,66,139786,6,145722
29623,0.009194,172.217.194.0-255,2902,142688,6,145722
29624,0.009203,172.31.36.0-255,66,142754,6,145722
29625,0.009262,172.217.194.0-255,2902,145656,6,145722
29626,0.009266,172.31.36.0-255,66,145722,6,145722
29627,0.0,172.217.194.0-255,152,152,6,146866
29628,2.3e-05,172.31.36.0-255,66,218,6,146866
29629,2.9e-05,172.217.194.0-255,1484,1702,6,146866
29630,3.4e-05,172.31.36.0-255,66,1768,6,146866
29631,4.1e-05,172.217.194.0-255,2902,4670,6,146866
29632,4.4e-05,172.31.36.0-255,66,4736,6,146866
29633,5.1e-05,172.217.194.0-255,5738,10474,6,146866
29634,5.4e-05,172.31.36.0-255,66,10540,6,146866
29635,6e-05,172.217.194.0-255,3518,14058,6,146866
29636,6.3e-05,172.31.36.0-255,66,14124,6,146866
29637,0.000141,172.217.194.0-255,1484,15608,6,146866
29638,0.000144,172.31.36.0-255,66,15674,6,146866
29639,0.000149,172.217.194.0-255,2902,18576,6,146866
29640,0.000152,172.31.36.0-255,66,18642,6,146866
29641,0.000179,172.217.194.0-255,4320,22962,6,146866
29642,0.000182,172.31.36.0-255,66,23028,6,146866
29643,0.000229,172.217.194.0-255,8215,31243,6,146866
29644,0.000232,172.31.36.0-255,66,31309,6,146866
29645,0.000254,172.217.194.0-255,8574,39883,6,146866
29646,0.000257,172.31.36.0-255,66,39949,6,146866
29647,0.00028,172.217.194.0-255,8215,48164,6,146866
29648,0.000282,172.31.36.0-255,66,48230,6,146866
29649,0.000345,172.217.194.0-255,1484,49714,6,146866
29650,0.000348,172.31.36.0-255,66,49780,6,146866
29651,0.000353,172.217.194.0-255,2902,52682,6,146866
29652,0.000356,172.31.36.0-255,66,52748,6,146866
29653,0.000362,172.217.194.0-255,5738,58486,6,146866
29654,0.000365,172.31.36.0-255,66,58552,6,146866
29655,0.000371,172.217.194.0-255,5738,64290,6,146866
29656,0.000374,172.31.36.0-255,66,64356,6,146866
29657,0.000413,172.217.194.0-255,1125,65481,6,146866
29658,0.000416,172.31.36.0-255,66,65547,6,146866
29659,0.000456,172.217.194.0-255,343,65890,6,146866
29660,0.001044,172.31.36.0-255,66,65956,6,146866
29661,0.001295,172.217.194.0-255,120,66076,6,146866
29662,0.001313,172.217.194.0-255,376,66452,6,146866
29663,0.001632,172.217.194.0-255,1484,67936,6,146866
29664,0.001639,172.31.36.0-255,66,68002,6,146866
29665,0.001647,172.217.194.0-255,2902,70904,6,146866
29666,0.00165,172.31.36.0-255,66,70970,6,146866
29667,0.001678,172.217.194.0-255,5738,76708,6,146866
29668,0.001681,172.31.36.0-255,66,76774,6,146866
29669,0.001685,172.217.194.0-255,2902,79676,6,146866
29670,0.001687,172.31.36.0-255,66,79742,6,146866
29671,0.001727,172.217.194.0-255,9992,89734,6,146866
29672,0.00173,172.31.36.0-255,66,89800,6,146866
29673,0.00175,172.217.194.0-255,2902,92702,6,146866
29674,0.001752,172.31.36.0-255,66,92768,6,146866
29675,0.001778,172.217.194.0-255,7856,100624,6,146866
29676,0.00178,172.31.36.0-255,66,100690,6,146866
29677,0.002391,172.217.194.0-255,1484,102174,6,146866
29678,0.002397,172.217.194.0-255,1484,103658,6,146866
29679,0.002401,172.31.36.0-255,66,103724,6,146866
29680,0.002422,172.217.194.0-255,1484,105208,6,146866
29681,0.002428,172.217.194.0-255,5738,110946,6,146866
29682,0.00243,172.31.36.0-255,66,111012,6,146866
29683,0.002447,172.217.194.0-255,1484,112496,6,146866
29684,0.002464,172.217.194.0-255,5738,118234,6,146866
29685,0.002466,172.31.36.0-255,66,118300,6,146866
29686,0.002489,172.217.194.0-255,2902,121202,6,146866
29687,0.002491,172.31.36.0-255,66,121268,6,146866
29688,0.002512,172.217.194.0-255,5738,127006,6,146866
29689,0.002514,172.31.36.0-255,66,127072,6,146866
29690,0.00252,172.217.194.0-255,4320,131392,6,146866
29691,0.002522,172.31.36.0-255,66,131458,6,146866
29692,0.002526,172.217.194.0-255,1484,132942,6,146866
29693,0.002562,172.217.194.0-255,2184,135126,6,146866
29694,0.002564,172.31.36.0-255,66,135192,6,146866
29695,0.004978,172.217.194.0-255,1484,136676,6,146866
29696,0.005032,172.217.194.0-255,4320,140996,6,146866
29697,0.005035,172.31.36.0-255,66,141062,6,146866
29698,0.007532,172.217.194.0-255,5738,146800,6,146866
29699,0.007538,172.31.36.0-255,66,146866,6,146866
29700,0.0,74.125.68.0-255,146,146,6,221751
29701,2.5e-05,172.31.36.0-255,66,212,6,221751
29702,3.2e-05,74.125.68.0-255,1484,1696,6,221751
29703,3.6e-05,172.31.36.0-255,66,1762,6,221751
29704,4.1e-05,74.125.68.0-255,2902,4664,6,221751
29705,4.4e-05,172.31.36.0-255,66,4730,6,221751
29706,4.7e-05,74.125.68.0-255,1484,6214,6,221751
29707,5e-05,172.31.36.0-255,66,6280,6,221751
29708,7.8e-05,74.125.68.0-255,2902,9182,6,221751
29709,8.2e-05,172.31.36.0-255,66,9248,6,221751
29710,8.9e-05,74.125.68.0-255,4914,14162,6,221751
29711,9.2e-05,172.31.36.0-255,66,14228,6,221751
29712,0.000143,74.125.68.0-255,5738,19966,6,221751
29713,0.000146,172.31.36.0-255,66,20032,6,221751
29714,0.000153,74.125.68.0-255,5738,25770,6,221751
29715,0.000155,172.31.36.0-255,66,25836,6,221751
29716,0.000175,74.125.68.0-255,1484,27320,6,221751
29717,0.000178,172.31.36.0-255,66,27386,6,221751
29718,0.000202,74.125.68.0-255,3961,31347,6,221751
29719,0.000205,172.31.36.0-255,66,31413,6,221751
29720,0.000234,74.125.68.0-255,2902,34315,6,221751
29721,0.000237,172.31.36.0-255,66,34381,6,221751
29722,0.000253,74.125.68.0-255,4320,38701,6,221751
29723,0.000256,172.31.36.0-255,66,38767,6,221751
29724,0.000285,74.125.68.0-255,8574,47341,6,221751
29725,0.000288,172.31.36.0-255,66,47407,6,221751
29726,0.000291,74.125.68.0-255,1125,48532,6,221751
29727,0.000293,172.31.36.0-255,66,48598,6,221751
29728,0.000361,74.125.68.0-255,1484,50082,6,221751
29729,0.000364,172.31.36.0-255,66,50148,6,221751
29730,0.000368,74.125.68.0-255,1484,51632,6,221751
29731,0.00037,172.31.36.0-255,66,51698,6,221751
29732,0.000384,74.125.68.0-255,1484,53182,6,221751
29733,0.000387,172.31.36.0-255,66,53248,6,221751
29734,0.000392,74.125.68.0-255,4320,57568,6,221751
29735,0.000394,172.31.36.0-255,66,57634,6,221751
29736,0.000398,74.125.68.0-255,1484,59118,6,221751
29737,0.0004,172.31.36.0-255,66,59184,6,221751
29738,0.000415,74.125.68.0-255,4320,63504,6,221751
29739,0.000417,172.31.36.0-255,66,63570,6,221751
29740,0.000436,74.125.68.0-255,2873,66443,6,221751
29741,0.000438,172.31.36.0-255,66,66509,6,221751
29742,0.000578,74.125.68.0-255,350,66859,6,221751
29743,0.000583,172.31.36.0-255,66,66925,6,221751
29744,0.000892,74.125.68.0-255,1484,68409,6,221751
29745,0.000897,74.125.68.0-255,2902,71311,6,221751
29746,0.000902,172.31.36.0-255,66,71377,6,221751
29747,0.000911,172.31.36.0-255,66,71443,6,221751
29748,0.000916,74.125.68.0-255,2902,74345,6,221751
29749,0.000918,172.31.36.0-255,66,74411,6,221751
29750,0.000935,74.125.68.0-255,2902,77313,6,221751
29751,0.000937,172.31.36.0-255,66,77379,6,221751
29752,0.000944,74.125.68.0-255,4320,81699,6,221751
29753,0.000946,172.31.36.0-255,66,81765,6,221751
29754,0.000963,74.125.68.0-255,2543,84308,6,221751
29755,0.000968,74.125.68.0-255,4320,88628,6,221751
29756,0.000972,172.31.36.0-255,66,88694,6,221751
29757,0.000975,172.31.36.0-255,66,88760,6,221751
29758,0.000993,74.125.68.0-255,2902,91662,6,221751
29759,0.001001,74.125.68.0-255,8574,100236,6,221751
29760,0.001005,172.31.36.0-255,66,100302,6,221751
29761,0.001012,172.31.36.0-255,66,100368,6,221751
29762,0.001016,74.125.68.0-255,1125,101493,6,221751
29763,0.001328,74.125.68.0-255,1484,102977,6,221751
29764,0.001332,172.31.36.0-255,66,103043,6,221751
29765,0.001337,74.125.68.0-255,2902,105945,6,221751
29766,0.001339,172.31.36.0-255,66,106011,6,221751
29767,0.00136,74.125.68.0-255,5738,111749,6,221751
29768,0.001362,172.31.36.0-255,66,111815,6,221751
29769,0.001389,74.125.68.0-255,7156,118971,6,221751
29770,0.001418,172.31.36.0-255,66,119037,6,221751
29771,0.001442,74.125.68.0-255,8574,127611,6,221751
29772,0.001445,172.31.36.0-255,66,127677,6,221751
29773,0.001454,74.125.68.0-255,7856,135533,6,221751
29774,0.001456,172.31.36.0-255,66,135599,6,221751
29775,0.001479,74.125.68.0-255,1484,137083,6,221751
29776,0.001482,74.125.68.0-255,1484,138567,6,221751
29777,0.001484,172.31.36.0-255,66,138633,6,221751
29778,0.001495,74.125.68.0-255,1484,140117,6,221751
29779,0.001514,74.125.68.0-255,5738,145855,6,221751
29780,0.001517,172.31.36.0-255,66,145921,6,221751
29781,0.00152,74.125.68.0-255,1484,147405,6,221751
29782,0.00154,74.125.68.0-255,4320,151725,6,221751
29783,0.001544,74.125.68.0-255,2902,154627,6,221751
29784,0.001547,172.31.36.0-255,66,154693,6,221751
29785,0.001555,172.31.36.0-255,66,154759,6,221751
29786,0.001561,74.125.68.0-255,4320,159079,6,221751
29787,0.001563,172.31.36.0-255,66,159145,6,221751
29788,0.001588,74.125.68.0-255,5738,164883,6,221751
29789,0.001591,172.31.36.0-255,66,164949,6,221751
29790,0.001612,74.125.68.0-255,5020,169969,6,221751
29791,0.001615,172.31.36.0-255,66,170035,6,221751
29792,0.00188,74.125.68.0-255,1484,171519,6,221751
29793,0.001897,74.125.68.0-255,2902,174421,6,221751
29794,0.0019,172.31.36.0-255,66,174487,6,221751
29795,0.001904,74.125.68.0-255,1484,175971,6,221751
29796,0.001924,74.125.68.0-255,4320,180291,6,221751
29797,0.001927,172.31.36.0-255,66,180357,6,221751
29798,0.001934,74.125.68.0-255,5738,186095,6,221751
29799,0.001936,172.31.36.0-255,66,186161,6,221751
29800,0.001968,74.125.68.0-255,7156,193317,6,221751
29801,0.001971,172.31.36.0-255,66,193383,6,221751
29802,0.001975,74.125.68.0-255,1484,194867,6,221751
29803,0.001998,74.125.68.0-255,9274,204141,6,221751
29804,0.002001,172.31.36.0-255,66,204207,6,221751
29805,0.004559,74.125.68.0-255,5738,209945,6,221751
29806,0.004569,172.31.36.0-255,66,210011,6,221751
29807,0.00711,74.125.68.0-255,2902,212913,6,221751
29808,0.007114,172.31.36.0-255,66,212979,6,221751
29809,0.007133,74.125.68.0-255,2902,215881,6,221751
29810,0.007135,172.31.36.0-255,66,215947,6,221751
29811,0.009696,74.125.68.0-255,5738,221685,6,221751
29812,0.009708,172.31.36.0-255,66,221751,6,221751
29813,0.0,172.217.194.0-255,146,146,6,235624
29814,1.7e-05,172.31.36.0-255,66,212,6,235624
29815,2.4e-05,172.217.194.0-255,1484,1696,6,235624
29816,2.9e-05,172.31.36.0-255,66,1762,6,235624
29817,3.5e-05,172.217.194.0-255,2902,4664,6,235624
29818,3.9e-05,172.31.36.0-255,66,4730,6,235624
29819,4.4e-05,172.217.194.0-255,2902,7632,6,235624
29820,4.7e-05,172.31.36.0-255,66,7698,6,235624
29821,0.000108,172.217.194.0-255,6310,14008,6,235624
29822,0.000112,172.31.36.0-255,66,14074,6,235624
29823,0.00012,172.217.194.0-255,7156,21230,6,235624
29824,0.000123,172.31.36.0-255,66,21296,6,235624
29825,0.000153,172.217.194.0-255,9633,30929,6,235624
29826,0.000157,172.31.36.0-255,66,30995,6,235624
29827,0.000198,172.217.194.0-255,1484,32479,6,235624
29828,0.000201,172.31.36.0-255,66,32545,6,235624
29829,0.000227,172.217.194.0-255,2902,35447,6,235624
29830,0.000229,172.31.36.0-255,66,35513,6,235624
29831,0.000236,172.217.194.0-255,5738,41251,6,235624
29832,0.000239,172.31.36.0-255,66,41317,6,235624
29833,0.00027,172.31.36.0-255,66,41383,6,235624
29834,0.000293,172.217.194.0-255,1484,42867,6,235624
29835,0.000296,172.31.36.0-255,66,42933,6,235624
29836,0.000324,172.217.194.0-255,8526,51459,6,235624
29837,0.000327,172.31.36.0-255,66,51525,6,235624
29838,0.000398,172.217.194.0-255,377,51902,6,235624
29839,0.000402,172.31.36.0-255,66,51968,6,235624
29840,0.000687,172.217.194.0-255,1484,53452,6,235624
29841,0.000692,172.31.36.0-255,66,53518,6,235624
29842,0.000697,172.217.194.0-255,2902,56420,6,235624
29843,0.0007,172.31.36.0-255,66,56486,6,235624
29844,0.000706,172.217.194.0-255,4320,60806,6,235624
29845,0.000708,172.31.36.0-255,66,60872,6,235624
29846,0.000712,172.217.194.0-255,1484,62356,6,235624
29847,0.00074,172.217.194.0-255,7156,69512,6,235624
29848,0.000743,172.31.36.0-255,66,69578,6,235624
29849,0.000783,172.217.194.0-255,2902,72480,6,235624
29850,0.000786,172.31.36.0-255,66,72546,6,235624
29851,0.000815,172.31.36.0-255,66,72612,6,235624
29852,0.001435,172.217.194.0-255,1484,74096,6,235624
29853,0.001454,172.217.194.0-255,2902,76998,6,235624
29854,0.001458,172.31.36.0-255,66,77064,6,235624
29855,0.001464,172.217.194.0-255,4320,81384,6,235624
29856,0.001466,172.31.36.0-255,66,81450,6,235624
29857,0.00148,172.217.194.0-255,1484,82934,6,235624
29858,0.00149,172.217.194.0-255,9992,92926,6,235624
29859,0.001492,172.31.36.0-255,66,92992,6,235624
29860,0.001556,172.31.36.0-255,66,93058,6,235624
29861,0.001571,172.217.194.0-255,766,93824,6,235624
29862,0.00175,172.217.194.0-255,1484,95308,6,235624
29863,0.001754,172.31.36.0-255,66,95374,6,235624
29864,0.001759,172.217.194.0-255,2902,98276,6,235624
29865,0.001761,172.31.36.0-255,66,98342,6,235624
29866,0.001768,172.217.194.0-255,5738,104080,6,235624
29867,0.00177,172.31.36.0-255,66,104146,6,235624
29868,0.001779,172.217.194.0-255,8574,112720,6,235624
29869,0.001782,172.31.36.0-255,66,112786,6,235624
29870,0.001798,172.217.194.0-255,4320,117106,6,235624
29871,0.001801,172.31.36.0-255,66,117172,6,235624
29872,0.001812,172.217.194.0-255,10692,127864,6,235624
29873,0.001814,172.31.36.0-255,66,127930,6,235624
29874,0.001842,172.217.194.0-255,1484,129414,6,235624
29875,0.001847,172.217.194.0-255,2902,132316,6,235624
29876,0.00185,172.31.36.0-255,66,132382,6,235624
29877,0.001868,172.217.194.0-255,1484,133866,6,235624
29878,0.00189,172.217.194.0-255,4320,138186,6,235624
29879,0.001892,172.31.36.0-255,66,138252,6,235624
29880,0.001898,172.217.194.0-255,4320,142572,6,235624
29881,0.0019,172.31.36.0-255,66,142638,6,235624
29882,0.001919,172.217.194.0-255,8574,151212,6,235624
29883,0.001921,172.31.36.0-255,66,151278,6,235624
29884,0.001928,172.217.194.0-255,5738,157016,6,235624
29885,0.001931,172.31.36.0-255,66,157082,6,235624
29886,0.001934,172.217.194.0-255,1484,158566,6,235624
29887,0.00196,172.217.194.0-255,3602,162168,6,235624
29888,0.001963,172.31.36.0-255,66,162234,6,235624
29889,0.002003,172.217.194.0-255,1484,163718,6,235624
29890,0.002009,172.217.194.0-255,2902,166620,6,235624
29891,0.002012,172.31.36.0-255,66,166686,6,235624
29892,0.002017,172.217.194.0-255,4320,171006,6,235624
29893,0.00202,172.31.36.0-255,66,171072,6,235624
29894,0.002034,172.217.194.0-255,1484,172556,6,235624
29895,0.002037,172.217.194.0-255,1484,174040,6,235624
29896,0.002039,172.31.36.0-255,66,174106,6,235624
29897,0.002071,172.31.36.0-255,66,174172,6,235624
29898,0.002079,172.217.194.0-255,7156,181328,6,235624
29899,0.002081,172.31.36.0-255,66,181394,6,235624
29900,0.002102,172.217.194.0-255,3602,184996,6,235624
29901,0.002104,172.31.36.0-255,66,185062,6,235624
29902,0.00216,172.217.194.0-255,1484,186546,6,235624
29903,0.002165,172.217.194.0-255,1484,188030,6,235624
29904,0.002167,172.31.36.0-255,66,188096,6,235624
29905,0.00218,172.217.194.0-255,1484,189580,6,235624
29906,0.002245,172.217.194.0-255,2902,192482,6,235624
29907,0.002248,172.31.36.0-255,66,192548,6,235624
29908,0.00227,172.217.194.0-255,2902,195450,6,235624
29909,0.002273,172.31.36.0-255,66,195516,6,235624
29910,0.002292,172.31.36.0-255,66,195582,6,235624
29911,0.002348,172.217.194.0-255,9992,205574,6,235624
29912,0.002351,172.31.36.0-255,66,205640,6,235624
29913,0.002395,172.31.36.0-255,66,205706,6,235624
29914,0.002412,172.31.36.0-255,66,205772,6,235624
29915,0.00242,172.217.194.0-255,8574,214346,6,235624
29916,0.002423,172.31.36.0-255,66,214412,6,235624
29917,0.002456,172.31.36.0-255,66,214478,6,235624
29918,0.00248,172.217.194.0-255,5020,219498,6,235624
29919,0.002482,172.31.36.0-255,66,219564,6,235624
29920,0.004782,172.217.194.0-255,5738,225302,6,235624
29921,0.004791,172.31.36.0-255,66,225368,6,235624
29922,0.007081,172.217.194.0-255,4320,229688,6,235624
29923,0.007085,172.31.36.0-255,66,229754,6,235624
29924,0.007097,172.217.194.0-255,1484,231238,6,235624
29925,0.009382,172.217.194.0-255,4320,235558,6,235624
29926,0.009389,172.31.36.0-255,66,235624,6,235624
29927,0.0,74.125.68.0-255,146,146,6,278760
29928,2.3e-05,172.31.36.0-255,66,212,6,278760
29929,3e-05,74.125.68.0-255,1484,1696,6,278760
29930,3.5e-05,172.31.36.0-255,66,1762,6,278760
29931,4e-05,74.125.68.0-255,2902,4664,6,278760
29932,5.4e-05,172.31.36.0-255,66,4730,6,278760
29933,6e-05,74.125.68.0-255,4320,9050,6,278760
29934,6.3e-05,172.31.36.0-255,66,9116,6,278760
29935,6.9e-05,74.125.68.0-255,4814,13930,6,278760
29936,7.2e-05,172.31.36.0-255,66,13996,6,278760
29937,0.000211,74.125.68.0-255,1484,15480,6,278760
29938,0.000216,172.31.36.0-255,66,15546,6,278760
29939,0.000222,74.125.68.0-255,2902,18448,6,278760
29940,0.000224,172.31.36.0-255,66,18514,6,278760
29941,0.000227,74.125.68.0-255,1484,19998,6,278760
29942,0.000234,172.31.36.0-255,66,20064,6,278760
29943,0.000279,74.125.68.0-255,4320,24384,6,278760
29944,0.000282,172.31.36.0-255,66,24450,6,278760
29945,0.00029,74.125.68.0-255,6797,31247,6,278760
29946,0.000293,172.31.36.0-255,66,31313,6,278760
29947,0.000398,74.125.68.0-255,1484,32797,6,278760
29948,0.000402,172.31.36.0-255,66,32863,6,278760
29949,0.00043,74.125.68.0-255,2902,35765,6,278760
29950,0.000433,172.31.36.0-255,66,35831,6,278760
29951,0.000438,74.125.68.0-255,4320,40151,6,278760
29952,0.00044,172.31.36.0-255,66,40217,6,278760
29953,0.000469,74.125.68.0-255,4320,44537,6,278760
29954,0.000471,172.31.36.0-255,66,44603,6,278760
29955,0.000496,74.125.68.0-255,3961,48564,6,278760
29956,0.000498,172.31.36.0-255,66,48630,6,278760
29957,0.000507,74.125.68.0-255,8574,57204,6,278760
29958,0.000509,172.31.36.0-255,66,57270,6,278760
29959,0.000545,74.125.68.0-255,8215,65485,6,278760
29960,0.000549,74.125.68.0-255,362,65847,6,278760
29961,0.000574,172.31.36.0-255,66,65913,6,278760
29962,0.000662,74.125.68.0-255,1484,67397,6,278760
29963,0.000691,74.125.68.0-255,2902,70299,6,278760
29964,0.000695,74.125.68.0-255,1484,71783,6,278760
29965,0.00071,74.125.68.0-255,4320,76103,6,278760
29966,0.000723,172.31.36.0-255,66,76169,6,278760
29967,0.000727,74.125.68.0-255,1484,77653,6,278760
29968,0.000753,74.125.68.0-255,4320,81973,6,278760
29969,0.000768,74.125.68.0-255,1419,83392,6,278760
29970,0.000775,74.125.68.0-255,7156,90548,6,278760
29971,0.000778,74.125.68.0-255,1484,92032,6,278760
29972,0.000785,172.31.36.0-255,66,92098,6,278760
29973,0.000807,74.125.68.0-255,7156,99254,6,278760
29974,0.000821,74.125.68.0-255,1125,100379,6,278760
29975,0.000833,172.31.36.0-255,66,100445,6,278760
29976,0.000896,74.125.68.0-255,1484,101929,6,278760
29977,0.000902,74.125.68.0-255,2902,104831,6,278760
29978,0.000915,74.125.68.0-255,1484,106315,6,278760
29979,0.000929,74.125.68.0-255,1484,107799,6,278760
29980,0.000943,74.125.68.0-255,2902,110701,6,278760
29981,0.000945,74.125.68.0-255,1484,112185,6,278760
29982,0.000948,172.31.36.0-255,66,112251,6,278760
29983,0.000956,74.125.68.0-255,1484,113735,6,278760
29984,0.000965,172.31.36.0-255,66,113801,6,278760
29985,0.001,74.125.68.0-255,9992,123793,6,278760
29986,0.00101,74.125.68.0-255,10692,134485,6,278760
29987,0.001058,172.31.36.0-255,66,134551,6,278760
29988,0.001473,74.125.68.0-255,1484,136035,6,278760
29989,0.001494,74.125.68.0-255,2902,138937,6,278760
29990,0.001497,172.31.36.0-255,66,139003,6,278760
29991,0.001502,74.125.68.0-255,4320,143323,6,278760
29992,0.001508,172.31.36.0-255,66,143389,6,278760
29993,0.001536,74.125.68.0-255,5738,149127,6,278760
29994,0.001552,74.125.68.0-255,2902,152029,6,278760
29995,0.001558,74.125.68.0-255,5738,157767,6,278760
29996,0.001572,172.31.36.0-255,66,157833,6,278760
29997,0.00158,74.125.68.0-255,2902,160735,6,278760
29998,0.001586,172.31.36.0-255,66,160801,6,278760
29999,0.001602,74.125.68.0-255,4320,165121,6,278760
30000,0.001606,74.125.68.0-255,3602,168723,6,278760
30001,0.001629,172.31.36.0-255,66,168789,6,278760
30002,0.00181,74.125.68.0-255,1484,170273,6,278760
30003,0.001816,74.125.68.0-255,2902,173175,6,278760
30004,0.001818,172.31.36.0-255,66,173241,6,278760
30005,0.001842,74.125.68.0-255,2902,176143,6,278760
30006,0.001845,172.31.36.0-255,66,176209,6,278760
30007,0.00187,74.125.68.0-255,2902,179111,6,278760
30008,0.001873,74.125.68.0-255,2902,182013,6,278760
30009,0.001884,172.31.36.0-255,66,182079,6,278760
30010,0.001904,74.125.68.0-255,4320,186399,6,278760
30011,0.001912,74.125.68.0-255,8574,194973,6,278760
30012,0.00192,172.31.36.0-255,66,195039,6,278760
30013,0.001936,74.125.68.0-255,5738,200777,6,278760
30014,0.001939,74.125.68.0-255,2184,202961,6,278760
30015,0.001948,172.31.36.0-255,66,203027,6,278760
30016,0.002012,74.125.68.0-255,1484,204511,6,278760
30017,0.002032,74.125.68.0-255,2902,207413,6,278760
30018,0.002045,172.31.36.0-255,66,207479,6,278760
30019,0.002056,74.125.68.0-255,4320,211799,6,278760
30020,0.002062,74.125.68.0-255,1484,213283,6,278760
30021,0.002079,74.125.68.0-255,4320,217603,6,278760
30022,0.002087,172.31.36.0-255,66,217669,6,278760
30023,0.002104,74.125.68.0-255,5738,223407,6,278760
30024,0.002115,172.31.36.0-255,66,223473,6,278760
30025,0.002125,74.125.68.0-255,5738,229211,6,278760
30026,0.002132,74.125.68.0-255,2902,232113,6,278760
30027,0.002139,172.31.36.0-255,66,232179,6,278760
30028,0.002169,74.125.68.0-255,5020,237199,6,278760
30029,0.002174,172.31.36.0-255,66,237265,6,278760
30030,0.002199,74.125.68.0-255,1484,238749,6,278760
30031,0.002204,74.125.68.0-255,2902,241651,6,278760
30032,0.002208,172.31.36.0-255,66,241717,6,278760
30033,0.002231,74.125.68.0-255,5738,247455,6,278760
30034,0.002249,172.31.36.0-255,66,247521,6,278760
30035,0.002257,74.125.68.0-255,2902,250423,6,278760
30036,0.002261,172.31.36.0-255,66,250489,6,278760
30037,0.002292,74.125.68.0-255,7156,257645,6,278760
30038,0.002297,74.125.68.0-255,4320,261965,6,278760
30039,0.002311,74.125.68.0-255,7156,269121,6,278760
30040,0.002315,74.125.68.0-255,2184,271305,6,278760
30041,0.002332,74.125.68.0-255,2902,274207,6,278760
30042,0.002336,74.125.68.0-255,2902,277109,6,278760
30043,0.002349,74.125.68.0-255,1484,278593,6,278760
30044,0.008253,172.31.36.0-255,66,278659,6,278760
30045,0.008974,172.31.36.0-255,101,278760,6,278760
30046,0.0,74.125.200.0-255,295,295,6,382509
30047,2.8e-05,172.31.36.0-255,66,361,6,382509
30048,3.4e-05,74.125.200.0-255,1484,1845,6,382509
30049,3.8e-05,172.31.36.0-255,66,1911,6,382509
30050,4.3e-05,74.125.200.0-255,4320,6231,6,382509
30051,4.7e-05,172.31.36.0-255,66,6297,6,382509
30052,5.8e-05,74.125.200.0-255,1484,7781,6,382509
30053,6e-05,172.31.36.0-255,66,7847,6,382509
30054,6.6e-05,74.125.200.0-255,2902,10749,6,382509
30055,6.8e-05,172.31.36.0-255,66,10815,6,382509
30056,0.000103,74.125.200.0-255,6057,16872,6,382509
30057,0.000106,172.31.36.0-255,66,16938,6,382509
30058,0.00011,74.125.200.0-255,2902,19840,6,382509
30059,0.000112,172.31.36.0-255,66,19906,6,382509
30060,0.000138,74.125.200.0-255,4320,24226,6,382509
30061,0.000141,172.31.36.0-255,66,24292,6,382509
30062,0.000174,74.125.200.0-255,6797,31089,6,382509
30063,0.000179,172.31.36.0-255,66,31155,6,382509
30064,0.000262,74.125.200.0-255,1484,32639,6,382509
30065,0.000265,172.31.36.0-255,66,32705,6,382509
30066,0.000269,74.125.200.0-255,2902,35607,6,382509
30067,0.000271,172.31.36.0-255,66,35673,6,382509
30068,0.000329,74.125.200.0-255,5738,41411,6,382509
30069,0.000333,172.31.36.0-255,66,41477,6,382509
30070,0.000338,74.125.200.0-255,2902,44379,6,382509
30071,0.00034,172.31.36.0-255,66,44445,6,382509
30072,0.000345,74.125.200.0-255,3961,48406,6,382509
30073,0.000349,172.31.36.0-255,66,48472,6,382509
30074,0.000356,74.125.200.0-255,5738,54210,6,382509
30075,0.000359,172.31.36.0-255,66,54276,6,382509
30076,0.000391,74.125.200.0-255,2902,57178,6,382509
30077,0.000395,172.31.36.0-255,66,57244,6,382509
30078,0.000398,74.125.200.0-255,1484,58728,6,382509
30079,0.000427,74.125.200.0-255,7112,65840,6,382509
30080,0.000431,172.31.36.0-255,66,65906,6,382509
30081,0.000434,74.125.200.0-255,108,66014,6,382509
30082,0.000514,74.125.200.0-255,1484,67498,6,382509
30083,0.000518,172.31.36.0-255,66,67564,6,382509
30084,0.000524,74.125.200.0-255,2902,70466,6,382509
30085,0.000526,172.31.36.0-255,66,70532,6,382509
30086,0.000558,74.125.200.0-255,5738,76270,6,382509
30087,0.000561,172.31.36.0-255,66,76336,6,382509
30088,0.000566,74.125.200.0-255,2902,79238,6,382509
30089,0.000567,172.31.36.0-255,66,79304,6,382509
30090,0.000593,74.125.200.0-255,4320,83624,6,382509
30091,0.000601,172.31.36.0-255,66,83690,6,382509
30092,0.000634,74.125.200.0-255,7156,90846,6,382509
30093,0.000638,172.31.36.0-255,66,90912,6,382509
30094,0.000671,74.125.200.0-255,8574,99486,6,382509
30095,0.000675,172.31.36.0-255,66,99552,6,382509
30096,0.000678,74.125.200.0-255,766,100318,6,382509
30097,0.000702,74.125.200.0-255,332,100650,6,382509
30098,0.000797,74.125.200.0-255,1484,102134,6,382509
30099,0.000802,172.31.36.0-255,66,102200,6,382509
30100,0.000829,74.125.200.0-255,2902,105102,6,382509
30101,0.000832,172.31.36.0-255,66,105168,6,382509
30102,0.000839,74.125.200.0-255,5738,110906,6,382509
30103,0.000841,172.31.36.0-255,66,110972,6,382509
30104,0.00087,74.125.200.0-255,1484,112456,6,382509
30105,0.000875,74.125.200.0-255,2902,115358,6,382509
30106,0.000877,172.31.36.0-255,66,115424,6,382509
30107,0.000884,74.125.200.0-255,5738,121162,6,382509
30108,0.000886,172.31.36.0-255,66,121228,6,382509
30109,0.000908,74.125.200.0-255,4320,125548,6,382509
30110,0.000911,172.31.36.0-255,66,125614,6,382509
30111,0.000933,74.125.200.0-255,2902,128516,6,382509
30112,0.000936,172.31.36.0-255,66,128582,6,382509
30113,0.000947,74.125.200.0-255,4320,132902,6,382509
30114,0.00095,172.31.36.0-255,66,132968,6,382509
30115,0.000981,74.125.200.0-255,2184,135152,6,382509
30116,0.000984,172.31.36.0-255,66,135218,6,382509
30117,0.00102,74.125.200.0-255,1484,136702,6,382509
30118,0.001031,74.125.200.0-255,1484,138186,6,382509
30119,0.001034,172.31.36.0-255,66,138252,6,382509
30120,0.001059,74.125.200.0-255,2902,141154,6,382509
30121,0.001062,172.31.36.0-255,66,141220,6,382509
30122,0.001067,74.125.200.0-255,2902,144122,6,382509
30123,0.001069,172.31.36.0-255,66,144188,6,382509
30124,0.001102,74.125.200.0-255,2902,147090,6,382509
30125,0.001106,172.31.36.0-255,66,147156,6,382509
30126,0.001113,74.125.200.0-255,7156,154312,6,382509
30127,0.001115,172.31.36.0-255,66,154378,6,382509
30128,0.00114,74.125.200.0-255,1484,155862,6,382509
30129,0.001162,74.125.200.0-255,2902,158764,6,382509
30130,0.001165,172.31.36.0-255,66,158830,6,382509
30131,0.001194,74.125.200.0-255,5738,164568,6,382509
30132,0.001197,172.31.36.0-255,66,164634,6,382509
30133,0.001201,74.125.200.0-255,2902,167536,6,382509
30134,0.001204,172.31.36.0-255,66,167602,6,382509
30135,0.001244,74.125.200.0-255,2184,169786,6,382509
30136,0.001248,172.31.36.0-255,66,169852,6,382509
30137,0.00143,74.125.200.0-255,1484,171336,6,382509
30138,0.001435,74.125.200.0-255,1484,172820,6,382509
30139,0.001438,172.31.36.0-255,66,172886,6,382509
30140,0.001466,74.125.200.0-255,2902,175788,6,382509
30141,0.001469,172.31.36.0-255,66,175854,6,382509
30142,0.001476,74.125.200.0-255,5738,181592,6,382509
30143,0.001479,172.31.36.0-255,66,181658,6,382509
30144,0.001509,74.125.200.0-255,1484,183142,6,382509
30145,0.001514,74.125.200.0-255,2902,186044,6,382509
30146,0.001516,172.31.36.0-255,66,186110,6,382509
30147,0.001543,74.125.200.0-255,5738,191848,6,382509
30148,0.001546,172.31.36.0-255,66,191914,6,382509
30149,0.00155,74.125.200.0-255,2902,194816,6,382509
30150,0.001552,172.31.36.0-255,66,194882,6,382509
30151,0.001556,74.125.200.0-255,2902,197784,6,382509
30152,0.001558,172.31.36.0-255,66,197850,6,382509
30153,0.001573,74.125.200.0-255,1484,199334,6,382509
30154,0.001597,74.125.200.0-255,1484,200818,6,382509
30155,0.0016,172.31.36.0-255,66,200884,6,382509
30156,0.001629,74.125.200.0-255,3602,204486,6,382509
30157,0.001639,172.31.36.0-255,66,204552,6,382509
30158,0.001752,74.125.200.0-255,1484,206036,6,382509
30159,0.001769,74.125.200.0-255,2902,208938,6,382509
30160,0.001772,172.31.36.0-255,66,209004,6,382509
30161,0.001777,74.125.200.0-255,2902,211906,6,382509
30162,0.001779,172.31.36.0-255,66,211972,6,382509
30163,0.001815,74.125.200.0-255,2902,214874,6,382509
30164,0.001818,172.31.36.0-255,66,214940,6,382509
30165,0.001823,74.125.200.0-255,4320,219260,6,382509
30166,0.001826,172.31.36.0-255,66,219326,6,382509
30167,0.001837,74.125.200.0-255,5738,225064,6,382509
30168,0.00184,172.31.36.0-255,66,225130,6,382509
30169,0.001852,172.31.36.0-255,66,225196,6,382509
30170,0.001856,74.125.200.0-255,2184,227380,6,382509
30171,0.001859,172.31.36.0-255,66,227446,6,382509
30172,0.001955,74.125.200.0-255,1484,228930,6,382509
30173,0.00197,74.125.200.0-255,2902,231832,6,382509
30174,0.001973,172.31.36.0-255,66,231898,6,382509
30175,0.001978,74.125.200.0-255,2902,234800,6,382509
30176,0.00198,172.31.36.0-255,66,234866,6,382509
30177,0.002006,74.125.200.0-255,2902,237768,6,382509
30178,0.002009,172.31.36.0-255,66,237834,6,382509
30179,0.002033,74.125.200.0-255,2902,240736,6,382509
30180,0.002037,172.31.36.0-255,66,240802,6,382509
30181,0.002042,74.125.200.0-255,4320,245122,6,382509
30182,0.002044,172.31.36.0-255,66,245188,6,382509
30183,0.002051,74.125.200.0-255,8574,253762,6,382509
30184,0.002053,172.31.36.0-255,66,253828,6,382509
30185,0.002057,74.125.200.0-255,2902,256730,6,382509
30186,0.002059,172.31.36.0-255,66,256796,6,382509
30187,0.002095,74.125.200.0-255,5020,261816,6,382509
30188,0.002098,172.31.36.0-255,66,261882,6,382509
30189,0.002101,74.125.200.0-255,1484,263366,6,382509
30190,0.002134,74.125.200.0-255,7156,270522,6,382509
30191,0.002137,172.31.36.0-255,66,270588,6,382509
30192,0.00214,74.125.200.0-255,1484,272072,6,382509
30193,0.002146,74.125.200.0-255,5738,277810,6,382509
30194,0.002148,172.31.36.0-255,66,277876,6,382509
30195,0.002175,74.125.200.0-255,5738,283614,6,382509
30196,0.002179,172.31.36.0-255,66,283680,6,382509
30197,0.002186,74.125.200.0-255,8574,292254,6,382509
30198,0.002189,172.31.36.0-255,66,292320,6,382509
30199,0.002214,74.125.200.0-255,4320,296640,6,382509
30200,0.002216,172.31.36.0-255,66,296706,6,382509
30201,0.002246,74.125.200.0-255,2184,298890,6,382509
30202,0.002248,172.31.36.0-255,66,298956,6,382509
30203,0.002256,74.125.200.0-255,7156,306112,6,382509
30204,0.002259,172.31.36.0-255,66,306178,6,382509
30205,0.002272,74.125.200.0-255,8574,314752,6,382509
30206,0.002274,172.31.36.0-255,66,314818,6,382509
30207,0.00228,74.125.200.0-255,5738,320556,6,382509
30208,0.002283,172.31.36.0-255,66,320622,6,382509
30209,0.002307,74.125.200.0-255,4320,324942,6,382509
30210,0.00231,172.31.36.0-255,66,325008,6,382509
30211,0.002322,74.125.200.0-255,5020,330028,6,382509
30212,0.002325,172.31.36.0-255,66,330094,6,382509
30213,0.00233,74.125.200.0-255,4320,334414,6,382509
30214,0.002332,172.31.36.0-255,66,334480,6,382509
30215,0.002357,74.125.200.0-255,1484,335964,6,382509
30216,0.002364,74.125.200.0-255,5738,341702,6,382509
30217,0.002372,172.31.36.0-255,66,341768,6,382509
30218,0.002399,74.125.200.0-255,4320,346088,6,382509
30219,0.002403,172.31.36.0-255,66,346154,6,382509
30220,0.002411,74.125.200.0-255,8574,354728,6,382509
30221,0.002413,172.31.36.0-255,66,354794,6,382509
30222,0.002439,74.125.200.0-255,2902,357696,6,382509
30223,0.002442,172.31.36.0-255,66,357762,6,382509
30224,0.002447,74.125.200.0-255,6438,364200,6,382509
30225,0.00245,172.31.36.0-255,66,364266,6,382509
30226,0.002488,74.125.200.0-255,7156,371422,6,382509
30227,0.002492,172.31.36.0-255,66,371488,6,382509
30228,0.002504,172.31.36.0-255,66,371554,6,382509
30229,0.002533,74.125.200.0-255,2902,374456,6,382509
30230,0.002536,172.31.36.0-255,66,374522,6,382509
30231,0.002544,74.125.200.0-255,7921,382443,6,382509
30232,0.007941,172.31.36.0-255,66,382509,6,382509
30233,0.0,172.217.194.0-255,153,153,6,139072
30234,3e-05,172.31.36.0-255,66,219,6,139072
30235,3.8e-05,172.217.194.0-255,1484,1703,6,139072
30236,4.4e-05,172.31.36.0-255,66,1769,6,139072
30237,7.4e-05,172.217.194.0-255,2902,4671,6,139072
30238,7.8e-05,172.31.36.0-255,66,4737,6,139072
30239,8.5e-05,172.217.194.0-255,5738,10475,6,139072
30240,8.8e-05,172.31.36.0-255,66,10541,6,139072
30241,0.000127,172.217.194.0-255,3437,13978,6,139072
30242,0.00013,172.31.36.0-255,66,14044,6,139072
30243,0.000175,172.217.194.0-255,1484,15528,6,139072
30244,0.000178,172.31.36.0-255,66,15594,6,139072
30245,0.000182,172.217.194.0-255,1484,17078,6,139072
30246,0.000184,172.31.36.0-255,66,17144,6,139072
30247,0.000218,172.217.194.0-255,1484,18628,6,139072
30248,0.000221,172.31.36.0-255,66,18694,6,139072
30249,0.000228,172.217.194.0-255,5738,24432,6,139072
30250,0.00023,172.31.36.0-255,66,24498,6,139072
30251,0.000245,172.217.194.0-255,8215,32713,6,139072
30252,0.000248,172.31.36.0-255,66,32779,6,139072
30253,0.000251,172.217.194.0-255,1484,34263,6,139072
30254,0.000253,172.31.36.0-255,66,34329,6,139072
30255,0.000286,172.217.194.0-255,7156,41485,6,139072
30256,0.000294,172.31.36.0-255,66,41551,6,139072
30257,0.000302,172.217.194.0-255,6797,48348,6,139072
30258,0.000304,172.31.36.0-255,66,48414,6,139072
30259,0.00031,172.217.194.0-255,4320,52734,6,139072
30260,0.000312,172.31.36.0-255,66,52800,6,139072
30261,0.000344,172.217.194.0-255,2902,55702,6,139072
30262,0.000347,172.31.36.0-255,66,55768,6,139072
30263,0.000359,172.217.194.0-255,9633,65401,6,139072
30264,0.000365,172.31.36.0-255,66,65467,6,139072
30265,0.000368,172.217.194.0-255,378,65845,6,139072
30266,0.000488,172.217.194.0-255,365,66210,6,139072
30267,0.000867,172.217.194.0-255,1484,67694,6,139072
30268,0.000873,172.31.36.0-255,66,67760,6,139072
30269,0.00088,172.217.194.0-255,2902,70662,6,139072
30270,0.000883,172.31.36.0-255,66,70728,6,139072
30271,0.000917,172.217.194.0-255,5738,76466,6,139072
30272,0.00092,172.31.36.0-255,66,76532,6,139072
30273,0.00093,172.217.194.0-255,9992,86524,6,139072
30274,0.000937,172.31.36.0-255,66,86590,6,139072
30275,0.000965,172.217.194.0-255,2902,89492,6,139072
30276,0.000968,172.31.36.0-255,66,89558,6,139072
30277,0.000978,172.217.194.0-255,10692,100250,6,139072
30278,0.000986,172.31.36.0-255,66,100316,6,139072
30279,0.001756,172.217.194.0-255,1484,101800,6,139072
30280,0.001765,172.217.194.0-255,2902,104702,6,139072
30281,0.001769,172.31.36.0-255,66,104768,6,139072
30282,0.001778,172.217.194.0-255,5738,110506,6,139072
30283,0.00178,172.31.36.0-255,66,110572,6,139072
30284,0.001803,172.217.194.0-255,1484,112056,6,139072
30285,0.001832,172.31.36.0-255,66,112122,6,139072
30286,0.00184,172.217.194.0-255,9992,122114,6,139072
30287,0.001842,172.31.36.0-255,66,122180,6,139072
30288,0.001848,172.217.194.0-255,766,122946,6,139072
30289,0.004092,172.217.194.0-255,4320,127266,6,139072
30290,0.004101,172.31.36.0-255,66,127332,6,139072
30291,0.006344,172.217.194.0-255,2902,130234,6,139072
30292,0.006347,172.31.36.0-255,66,130300,6,139072
30293,0.006362,172.217.194.0-255,2902,133202,6,139072
30294,0.006364,172.31.36.0-255,66,133268,6,139072
30295,0.008629,172.217.194.0-255,5738,139006,6,139072
30296,0.00864,172.31.36.0-255,66,139072,6,139072
30297,0.0,74.125.24.0-255,146,146,6,102657
30298,1.8e-05,172.31.36.0-255,66,212,6,102657
30299,2.5e-05,74.125.24.0-255,1484,1696,6,102657
30300,3e-05,172.31.36.0-255,66,1762,6,102657
30301,3.5e-05,74.125.24.0-255,2902,4664,6,102657
30302,3.9e-05,172.31.36.0-255,66,4730,6,102657
30303,4.8e-05,74.125.24.0-255,7156,11886,6,102657
30304,5.3e-05,172.31.36.0-255,66,11952,6,102657
30305,5.8e-05,74.125.24.0-255,2902,14854,6,102657
30306,6.1e-05,172.31.36.0-255,66,14920,6,102657
30307,8.2e-05,74.125.24.0-255,2076,16996,6,102657
30308,8.6e-05,172.31.36.0-255,66,17062,6,102657
30309,9.2e-05,74.125.24.0-255,5738,22800,6,102657
30310,9.5e-05,172.31.36.0-255,66,22866,6,102657
30311,0.000109,172.31.36.0-255,66,22932,6,102657
30312,0.000115,74.125.24.0-255,5738,28670,6,102657
30313,0.000117,172.31.36.0-255,66,28736,6,102657
30314,0.00014,74.125.24.0-255,6438,35174,6,102657
30315,0.000143,172.31.36.0-255,66,35240,6,102657
30316,0.000547,74.125.24.0-255,1484,36724,6,102657
30317,0.000554,74.125.24.0-255,2902,39626,6,102657
30318,0.000572,74.125.24.0-255,5738,45364,6,102657
30319,0.00058,172.31.36.0-255,66,45430,6,102657
30320,0.000589,172.31.36.0-255,66,45496,6,102657
30321,0.000592,172.31.36.0-255,66,45562,6,102657
30322,0.000621,74.125.24.0-255,6797,52359,6,102657
30323,0.000624,172.31.36.0-255,66,52425,6,102657
30324,0.000656,74.125.24.0-255,7156,59581,6,102657
30325,0.000659,172.31.36.0-255,66,59647,6,102657
30326,0.000666,74.125.24.0-255,5738,65385,6,102657
30327,0.000669,172.31.36.0-255,66,65451,6,102657
30328,0.000685,74.125.24.0-255,3961,69412,6,102657
30329,0.000688,172.31.36.0-255,66,69478,6,102657
30330,0.001747,74.125.24.0-255,1484,70962,6,102657
30331,0.001758,74.125.24.0-255,2902,73864,6,102657
30332,0.001763,172.31.36.0-255,66,73930,6,102657
30333,0.001771,74.125.24.0-255,5738,79668,6,102657
30334,0.001774,172.31.36.0-255,66,79734,6,102657
30335,0.00178,74.125.24.0-255,5738,85472,6,102657
30336,0.001783,172.31.36.0-255,66,85538,6,102657
30337,0.001805,74.125.24.0-255,1125,86663,6,102657
30338,0.004104,74.125.24.0-255,4320,90983,6,102657
30339,0.004108,172.31.36.0-255,66,91049,6,102657
30340,0.00645,74.125.24.0-255,5738,96787,6,102657
30341,0.006456,172.31.36.0-255,66,96853,6,102657
30342,0.008799,74.125.24.0-255,5738,102591,6,102657
30343,0.008808,172.31.36.0-255,66,102657,6,102657
30344,0.0,74.125.68.0-255,152,152,6,134329
30345,2.9e-05,172.31.36.0-255,66,218,6,134329
30346,3.7e-05,74.125.68.0-255,1484,1702,6,134329
30347,4.1e-05,172.31.36.0-255,66,1768,6,134329
30348,7.8e-05,74.125.68.0-255,2902,4670,6,134329
30349,8.1e-05,172.31.36.0-255,66,4736,6,134329
30350,8.7e-05,74.125.68.0-255,4320,9056,6,134329
30351,8.9e-05,172.31.36.0-255,66,9122,6,134329
30352,0.000106,74.125.68.0-255,1484,10606,6,134329
30353,0.000108,172.31.36.0-255,66,10672,6,134329
30354,0.000131,74.125.68.0-255,3431,14103,6,134329
30355,0.000141,172.31.36.0-255,66,14169,6,134329
30356,0.000165,74.125.68.0-255,1484,15653,6,134329
30357,0.000167,172.31.36.0-255,66,15719,6,134329
30358,0.000201,74.125.68.0-255,2902,18621,6,134329
30359,0.000204,172.31.36.0-255,66,18687,6,134329
30360,0.00023,74.125.68.0-255,1484,20171,6,134329
30361,0.000233,172.31.36.0-255,66,20237,6,134329
30362,0.000237,74.125.68.0-255,1484,21721,6,134329
30363,0.000239,172.31.36.0-255,66,21787,6,134329
30364,0.00026,74.125.68.0-255,1484,23271,6,134329
30365,0.000268,172.31.36.0-255,66,23337,6,134329
30366,0.000271,74.125.68.0-255,1484,24821,6,134329
30367,0.000273,172.31.36.0-255,66,24887,6,134329
30368,0.00031,74.125.68.0-255,4320,29207,6,134329
30369,0.000315,172.31.36.0-255,66,29273,6,134329
30370,0.000362,74.125.68.0-255,2543,31816,6,134329
30371,0.000365,172.31.36.0-255,66,31882,6,134329
30372,0.000369,74.125.68.0-255,1484,33366,6,134329
30373,0.000371,172.31.36.0-255,66,33432,6,134329
30374,0.000397,74.125.68.0-255,2902,36334,6,134329
30375,0.000405,172.31.36.0-255,66,36400,6,134329
30376,0.000429,74.125.68.0-255,2902,39302,6,134329
30377,0.000438,172.31.36.0-255,66,39368,6,134329
30378,0.000445,74.125.68.0-255,4320,43688,6,134329
30379,0.000454,172.31.36.0-255,66,43754,6,134329
30380,0.000466,74.125.68.0-255,1484,45238,6,134329
30381,0.000563,74.125.68.0-255,3961,49199,6,134329
30382,0.000568,172.31.36.0-255,66,49265,6,134329
30383,0.000598,74.125.68.0-255,1484,50749,6,134329
30384,0.000618,74.125.68.0-255,2902,53651,6,134329
30385,0.000627,172.31.36.0-255,66,53717,6,134329
30386,0.000647,74.125.68.0-255,5738,59455,6,134329
30387,0.000655,172.31.36.0-255,66,59521,6,134329
30388,0.000714,74.125.68.0-255,4320,63841,6,134329
30389,0.00072,172.31.36.0-255,66,63907,6,134329
30390,0.000727,74.125.68.0-255,1484,65391,6,134329
30391,0.000771,74.125.68.0-255,1125,66516,6,134329
30392,0.000774,172.31.36.0-255,66,66582,6,134329
30393,0.000778,74.125.68.0-255,1484,68066,6,134329
30394,0.000805,74.125.68.0-255,7156,75222,6,134329
30395,0.000812,172.31.36.0-255,66,75288,6,134329
30396,0.000888,74.125.68.0-255,2902,78190,6,134329
30397,0.000899,172.31.36.0-255,66,78256,6,134329
30398,0.00092,74.125.68.0-255,8215,86471,6,134329
30399,0.000934,172.31.36.0-255,66,86537,6,134329
30400,0.001038,74.125.68.0-255,2902,89439,6,134329
30401,0.001041,172.31.36.0-255,66,89505,6,134329
30402,0.00109,172.31.36.0-255,66,89571,6,134329
30403,0.001206,74.125.68.0-255,4320,93891,6,134329
30404,0.001211,172.31.36.0-255,66,93957,6,134329
30405,0.001256,172.31.36.0-255,66,94023,6,134329
30406,0.001452,74.125.68.0-255,7156,101179,6,134329
30407,0.001456,172.31.36.0-255,66,101245,6,134329
30408,0.001495,74.125.68.0-255,7856,109101,6,134329
30409,0.001518,172.31.36.0-255,66,109167,6,134329
30410,0.001671,172.31.36.0-255,66,109233,6,134329
30411,0.001745,172.31.36.0-255,66,109299,6,134329
30412,0.002039,74.125.68.0-255,5738,115037,6,134329
30413,0.002062,172.31.36.0-255,66,115103,6,134329
30414,0.002101,172.31.36.0-255,66,115169,6,134329
30415,0.002499,172.31.36.0-255,66,115235,6,134329
30416,0.002599,172.31.36.0-255,66,115301,6,134329
30417,0.003215,74.125.68.0-255,8574,123875,6,134329
30418,0.00322,172.31.36.0-255,66,123941,6,134329
30419,0.003285,172.31.36.0-255,66,124007,6,134329
30420,0.003332,172.31.36.0-255,66,124073,6,134329
30421,0.005568,74.125.68.0-255,4320,128393,6,134329
30422,0.005573,172.31.36.0-255,66,128459,6,134329
30423,0.005596,74.125.68.0-255,1484,129943,6,134329
30424,0.007805,74.125.68.0-255,4320,134263,6,134329
30425,0.007811,172.31.36.0-255,66,134329,6,134329
30426,0.0,74.125.24.0-255,146,146,6,347786
30427,2.2e-05,172.31.36.0-255,66,212,6,347786
30428,3e-05,74.125.24.0-255,1484,1696,6,347786
30429,3.4e-05,172.31.36.0-255,66,1762,6,347786
30430,3.9e-05,74.125.24.0-255,2902,4664,6,347786
30431,4.2e-05,172.31.36.0-255,66,4730,6,347786
30432,4.5e-05,74.125.24.0-255,1484,6214,6,347786
30433,4.9e-05,172.31.36.0-255,66,6280,6,347786
30434,5.5e-05,74.125.24.0-255,2902,9182,6,347786
30435,5.8e-05,172.31.36.0-255,66,9248,6,347786
30436,8.5e-05,74.125.24.0-255,4860,14108,6,347786
30437,8.8e-05,172.31.36.0-255,66,14174,6,347786
30438,0.000131,74.125.24.0-255,1484,15658,6,347786
30439,0.000134,172.31.36.0-255,66,15724,6,347786
30440,0.000154,74.125.24.0-255,2902,18626,6,347786
30441,0.000156,172.31.36.0-255,66,18692,6,347786
30442,0.000163,74.125.24.0-255,5738,24430,6,347786
30443,0.000165,172.31.36.0-255,66,24496,6,347786
30444,0.000194,74.125.24.0-255,1484,25980,6,347786
30445,0.000197,172.31.36.0-255,66,26046,6,347786
30446,0.000222,74.125.24.0-255,6797,32843,6,347786
30447,0.000225,172.31.36.0-255,66,32909,6,347786
30448,0.000251,74.125.24.0-255,5738,38647,6,347786
30449,0.000254,172.31.36.0-255,66,38713,6,347786
30450,0.00027,74.125.24.0-255,2902,41615,6,347786
30451,0.000272,172.31.36.0-255,66,41681,6,347786
30452,0.000321,74.125.24.0-255,5738,47419,6,347786
30453,0.000324,172.31.36.0-255,66,47485,6,347786
30454,0.000339,74.125.24.0-255,1125,48610,6,347786
30455,0.000342,172.31.36.0-255,66,48676,6,347786
30456,0.000369,74.125.24.0-255,4320,52996,6,347786
30457,0.000371,172.31.36.0-255,66,53062,6,347786
30458,0.000406,172.31.36.0-255,66,53128,6,347786
30459,0.000459,74.125.24.0-255,363,53491,6,347786
30460,0.000717,74.125.24.0-255,127,53618,6,347786
30461,0.000839,74.125.24.0-255,1484,55102,6,347786
30462,0.000844,74.125.24.0-255,2902,58004,6,347786
30463,0.000854,172.31.36.0-255,66,58070,6,347786
30464,0.000859,172.31.36.0-255,66,58136,6,347786
30465,0.000862,74.125.24.0-255,1484,59620,6,347786
30466,0.000866,74.125.24.0-255,2902,62522,6,347786
30467,0.000869,172.31.36.0-255,66,62588,6,347786
30468,0.000889,74.125.24.0-255,5738,68326,6,347786
30469,0.000891,172.31.36.0-255,66,68392,6,347786
30470,0.000927,74.125.24.0-255,2247,70639,6,347786
30471,0.000931,172.31.36.0-255,66,70705,6,347786
30472,0.000992,74.125.24.0-255,1484,72189,6,347786
30473,0.001007,74.125.24.0-255,2902,75091,6,347786
30474,0.00101,172.31.36.0-255,66,75157,6,347786
30475,0.001015,74.125.24.0-255,2902,78059,6,347786
30476,0.001017,172.31.36.0-255,66,78125,6,347786
30477,0.001037,74.125.24.0-255,2902,81027,6,347786
30478,0.001041,172.31.36.0-255,66,81093,6,347786
30479,0.001059,74.125.24.0-255,4320,85413,6,347786
30480,0.001062,172.31.36.0-255,66,85479,6,347786
30481,0.001086,74.125.24.0-255,8574,94053,6,347786
30482,0.001091,172.31.36.0-255,66,94119,6,347786
30483,0.001153,74.125.24.0-255,8574,102693,6,347786
30484,0.001158,172.31.36.0-255,66,102759,6,347786
30485,0.001176,74.125.24.0-255,1484,104243,6,347786
30486,0.001198,74.125.24.0-255,766,105009,6,347786
30487,0.001201,172.31.36.0-255,66,105075,6,347786
30488,0.001586,74.125.24.0-255,1484,106559,6,347786
30489,0.001593,74.125.24.0-255,2902,109461,6,347786
30490,0.001597,172.31.36.0-255,66,109527,6,347786
30491,0.001603,74.125.24.0-255,2902,112429,6,347786
30492,0.001605,172.31.36.0-255,66,112495,6,347786
30493,0.001622,74.125.24.0-255,2902,115397,6,347786
30494,0.001624,172.31.36.0-255,66,115463,6,347786
30495,0.001644,74.125.24.0-255,5738,121201,6,347786
30496,0.001646,172.31.36.0-255,66,121267,6,347786
30497,0.001667,74.125.24.0-255,1484,122751,6,347786
30498,0.001695,74.125.24.0-255,5738,128489,6,347786
30499,0.001698,172.31.36.0-255,66,128555,6,347786
30500,0.001721,74.125.24.0-255,8574,137129,6,347786
30501,0.001724,172.31.36.0-255,66,137195,6,347786
30502,0.001793,74.125.24.0-255,2184,139379,6,347786
30503,0.001796,172.31.36.0-255,66,139445,6,347786
30504,0.001803,74.125.24.0-255,2902,142347,6,347786
30505,0.001805,172.31.36.0-255,66,142413,6,347786
30506,0.001827,74.125.24.0-255,1484,143897,6,347786
30507,0.001875,74.125.24.0-255,8574,152471,6,347786
30508,0.001879,172.31.36.0-255,66,152537,6,347786
30509,0.001899,74.125.24.0-255,4320,156857,6,347786
30510,0.001902,172.31.36.0-255,66,156923,6,347786
30511,0.001927,172.31.36.0-255,66,156989,6,347786
30512,0.00204,74.125.24.0-255,2184,159173,6,347786
30513,0.002044,172.31.36.0-255,66,159239,6,347786
30514,0.002048,74.125.24.0-255,2902,162141,6,347786
30515,0.00205,172.31.36.0-255,66,162207,6,347786
30516,0.002083,74.125.24.0-255,4320,166527,6,347786
30517,0.002086,172.31.36.0-255,66,166593,6,347786
30518,0.002104,74.125.24.0-255,2902,169495,6,347786
30519,0.002106,172.31.36.0-255,66,169561,6,347786
30520,0.002122,74.125.24.0-255,5738,175299,6,347786
30521,0.002124,172.31.36.0-255,66,175365,6,347786
30522,0.002148,74.125.24.0-255,9992,185357,6,347786
30523,0.00215,172.31.36.0-255,66,185423,6,347786
30524,0.00225,74.125.24.0-255,7856,193279,6,347786
30525,0.002255,172.31.36.0-255,66,193345,6,347786
30526,0.002384,74.125.24.0-255,1484,194829,6,347786
30527,0.00239,74.125.24.0-255,2902,197731,6,347786
30528,0.002393,172.31.36.0-255,66,197797,6,347786
30529,0.002397,74.125.24.0-255,1484,199281,6,347786
30530,0.002424,74.125.24.0-255,5738,205019,6,347786
30531,0.002426,172.31.36.0-255,66,205085,6,347786
30532,0.002444,74.125.24.0-255,2902,207987,6,347786
30533,0.002446,172.31.36.0-255,66,208053,6,347786
30534,0.002474,74.125.24.0-255,5738,213791,6,347786
30535,0.002476,172.31.36.0-255,66,213857,6,347786
30536,0.002495,74.125.24.0-255,1484,215341,6,347786
30537,0.002524,74.125.24.0-255,4320,219661,6,347786
30538,0.002527,172.31.36.0-255,66,219727,6,347786
30539,0.002565,74.125.24.0-255,7856,227583,6,347786
30540,0.002568,172.31.36.0-255,66,227649,6,347786
30541,0.003,74.125.24.0-255,1484,229133,6,347786
30542,0.003008,74.125.24.0-255,2902,232035,6,347786
30543,0.003014,172.31.36.0-255,66,232101,6,347786
30544,0.003031,74.125.24.0-255,4320,236421,6,347786
30545,0.003034,172.31.36.0-255,66,236487,6,347786
30546,0.003038,74.125.24.0-255,1484,237971,6,347786
30547,0.003053,74.125.24.0-255,2902,240873,6,347786
30548,0.003055,172.31.36.0-255,66,240939,6,347786
30549,0.003079,74.125.24.0-255,4320,245259,6,347786
30550,0.003082,172.31.36.0-255,66,245325,6,347786
30551,0.003102,74.125.24.0-255,4320,249645,6,347786
30552,0.003105,172.31.36.0-255,66,249711,6,347786
30553,0.003132,172.31.36.0-255,66,249777,6,347786
30554,0.003207,74.125.24.0-255,766,250543,6,347786
30555,0.003276,74.125.24.0-255,1484,252027,6,347786
30556,0.003278,172.31.36.0-255,66,252093,6,347786
30557,0.003298,74.125.24.0-255,2902,254995,6,347786
30558,0.003301,172.31.36.0-255,66,255061,6,347786
30559,0.003326,74.125.24.0-255,4320,259381,6,347786
30560,0.003329,172.31.36.0-255,66,259447,6,347786
30561,0.003345,74.125.24.0-255,1484,260931,6,347786
30562,0.003352,74.125.24.0-255,4320,265251,6,347786
30563,0.003354,172.31.36.0-255,66,265317,6,347786
30564,0.003372,74.125.24.0-255,1484,266801,6,347786
30565,0.003393,74.125.24.0-255,8574,275375,6,347786
30566,0.003396,172.31.36.0-255,66,275441,6,347786
30567,0.00341,74.125.24.0-255,1484,276925,6,347786
30568,0.003447,74.125.24.0-255,1484,278409,6,347786
30569,0.00345,172.31.36.0-255,66,278475,6,347786
30570,0.003467,74.125.24.0-255,1484,279959,6,347786
30571,0.003472,74.125.24.0-255,2902,282861,6,347786
30572,0.003474,172.31.36.0-255,66,282927,6,347786
30573,0.003492,74.125.24.0-255,2184,285111,6,347786
30574,0.003495,172.31.36.0-255,66,285177,6,347786
30575,0.003498,74.125.24.0-255,1484,286661,6,347786
30576,0.003519,74.125.24.0-255,2902,289563,6,347786
30577,0.003522,172.31.36.0-255,66,289629,6,347786
30578,0.00354,74.125.24.0-255,5738,295367,6,347786
30579,0.003542,172.31.36.0-255,66,295433,6,347786
30580,0.003578,74.125.24.0-255,2902,298335,6,347786
30581,0.00358,172.31.36.0-255,66,298401,6,347786
30582,0.003591,74.125.24.0-255,1484,299885,6,347786
30583,0.003603,74.125.24.0-255,1484,301369,6,347786
30584,0.003605,172.31.36.0-255,66,301435,6,347786
30585,0.003664,74.125.24.0-255,8574,310009,6,347786
30586,0.003667,172.31.36.0-255,66,310075,6,347786
30587,0.003684,74.125.24.0-255,8574,318649,6,347786
30588,0.003687,172.31.36.0-255,66,318715,6,347786
30589,0.003719,74.125.24.0-255,766,319481,6,347786
30590,0.003738,74.125.24.0-255,2902,322383,6,347786
30591,0.00374,172.31.36.0-255,66,322449,6,347786
30592,0.003753,74.125.24.0-255,4320,326769,6,347786
30593,0.003755,172.31.36.0-255,66,326835,6,347786
30594,0.003819,74.125.24.0-255,9992,336827,6,347786
30595,0.003859,74.125.24.0-255,1484,338311,6,347786
30596,0.00401,74.125.24.0-255,5738,344049,6,347786
30597,0.004025,74.125.24.0-255,3566,347615,6,347786
30598,0.00405,74.125.24.0-255,105,347720,6,347786
30599,0.006367,172.31.36.0-255,66,347786,6,347786
30600,0.0,216.58.221.0-255,153,153,6,207721
30601,1.6e-05,172.31.36.0-255,66,219,6,207721
30602,2.2e-05,216.58.221.0-255,1484,1703,6,207721
30603,2.7e-05,172.31.36.0-255,66,1769,6,207721
30604,4.2e-05,216.58.221.0-255,2902,4671,6,207721
30605,4.5e-05,172.31.36.0-255,66,4737,6,207721
30606,5.2e-05,216.58.221.0-255,5738,10475,6,207721
30607,5.5e-05,172.31.36.0-255,66,10541,6,207721
30608,6.1e-05,216.58.221.0-255,6332,16873,6,207721
30609,6.4e-05,172.31.36.0-255,66,16939,6,207721
30610,9.9e-05,172.31.36.0-255,66,17005,6,207721
30611,0.000135,216.58.221.0-255,1484,18489,6,207721
30612,0.000138,172.31.36.0-255,66,18555,6,207721
30613,0.000144,216.58.221.0-255,2902,21457,6,207721
30614,0.000146,172.31.36.0-255,66,21523,6,207721
30615,0.000156,216.58.221.0-255,2902,24425,6,207721
30616,0.000158,172.31.36.0-255,66,24491,6,207721
30617,0.000211,216.58.221.0-255,2902,27393,6,207721
30618,0.000216,172.31.36.0-255,66,27459,6,207721
30619,0.000224,216.58.221.0-255,6797,34256,6,207721
30620,0.000226,172.31.36.0-255,66,34322,6,207721
30621,0.00034,216.58.221.0-255,1484,35806,6,207721
30622,0.000343,172.31.36.0-255,66,35872,6,207721
30623,0.000349,216.58.221.0-255,2902,38774,6,207721
30624,0.000352,172.31.36.0-255,66,38840,6,207721
30625,0.000364,216.58.221.0-255,5738,44578,6,207721
30626,0.000367,172.31.36.0-255,66,44644,6,207721
30627,0.000397,216.58.221.0-255,7086,51730,6,207721
30628,0.0004,172.31.36.0-255,66,51796,6,207721
30629,0.00084,216.58.221.0-255,135,51931,6,207721
30630,0.000847,172.31.36.0-255,66,51997,6,207721
30631,0.000957,216.58.221.0-255,1484,53481,6,207721
30632,0.000964,216.58.221.0-255,2902,56383,6,207721
30633,0.000968,172.31.36.0-255,66,56449,6,207721
30634,0.000972,216.58.221.0-255,1484,57933,6,207721
30635,0.000993,216.58.221.0-255,4320,62253,6,207721
30636,0.000995,172.31.36.0-255,66,62319,6,207721
30637,0.001003,216.58.221.0-255,6797,69116,6,207721
30638,0.001005,172.31.36.0-255,66,69182,6,207721
30639,0.001047,216.58.221.0-255,7156,76338,6,207721
30640,0.001049,172.31.36.0-255,66,76404,6,207721
30641,0.001053,216.58.221.0-255,1484,77888,6,207721
30642,0.001081,216.58.221.0-255,7156,85044,6,207721
30643,0.001084,172.31.36.0-255,66,85110,6,207721
30644,0.001087,216.58.221.0-255,1125,86235,6,207721
30645,0.001338,216.58.221.0-255,1484,87719,6,207721
30646,0.001343,172.31.36.0-255,66,87785,6,207721
30647,0.001349,216.58.221.0-255,2902,90687,6,207721
30648,0.001351,172.31.36.0-255,66,90753,6,207721
30649,0.001357,216.58.221.0-255,4320,95073,6,207721
30650,0.001363,172.31.36.0-255,66,95139,6,207721
30651,0.001391,216.58.221.0-255,1484,96623,6,207721
30652,0.001406,172.31.36.0-255,66,96689,6,207721
30653,0.00141,216.58.221.0-255,2902,99591,6,207721
30654,0.001412,172.31.36.0-255,66,99657,6,207721
30655,0.001444,216.58.221.0-255,7856,107513,6,207721
30656,0.001448,172.31.36.0-255,66,107579,6,207721
30657,0.001489,216.58.221.0-255,1484,109063,6,207721
30658,0.001493,216.58.221.0-255,1484,110547,6,207721
30659,0.001496,172.31.36.0-255,66,110613,6,207721
30660,0.001523,216.58.221.0-255,1484,112097,6,207721
30661,0.00153,216.58.221.0-255,5738,117835,6,207721
30662,0.001533,172.31.36.0-255,66,117901,6,207721
30663,0.001547,172.31.36.0-255,66,117967,6,207721
30664,0.001552,216.58.221.0-255,2902,120869,6,207721
30665,0.001554,172.31.36.0-255,66,120935,6,207721
30666,0.001587,216.58.221.0-255,7856,128791,6,207721
30667,0.00159,172.31.36.0-255,66,128857,6,207721
30668,0.001623,216.58.221.0-255,1484,130341,6,207721
30669,0.001636,216.58.221.0-255,2902,133243,6,207721
30670,0.001639,172.31.36.0-255,66,133309,6,207721
30671,0.001643,216.58.221.0-255,2902,136211,6,207721
30672,0.001646,172.31.36.0-255,66,136277,6,207721
30673,0.001675,216.58.221.0-255,2902,139179,6,207721
30674,0.001678,172.31.36.0-255,66,139245,6,207721
30675,0.001685,216.58.221.0-255,7156,146401,6,207721
30676,0.001688,172.31.36.0-255,66,146467,6,207721
30677,0.001707,172.31.36.0-255,66,146533,6,207721
30678,0.001734,216.58.221.0-255,1484,148017,6,207721
30679,0.001739,216.58.221.0-255,2184,150201,6,207721
30680,0.001741,172.31.36.0-255,66,150267,6,207721
30681,0.001832,216.58.221.0-255,1484,151751,6,207721
30682,0.001838,216.58.221.0-255,2902,154653,6,207721
30683,0.00184,172.31.36.0-255,66,154719,6,207721
30684,0.001844,216.58.221.0-255,1484,156203,6,207721
30685,0.00187,216.58.221.0-255,4320,160523,6,207721
30686,0.001873,172.31.36.0-255,66,160589,6,207721
30687,0.00188,216.58.221.0-255,7156,167745,6,207721
30688,0.001882,172.31.36.0-255,66,167811,6,207721
30689,0.001894,216.58.221.0-255,5738,173549,6,207721
30690,0.001896,172.31.36.0-255,66,173615,6,207721
30691,0.001913,216.58.221.0-255,8574,182189,6,207721
30692,0.001916,172.31.36.0-255,66,182255,6,207721
30693,0.001924,216.58.221.0-255,2184,184439,6,207721
30694,0.001927,172.31.36.0-255,66,184505,6,207721
30695,0.00384,216.58.221.0-255,5738,190243,6,207721
30696,0.003848,172.31.36.0-255,66,190309,6,207721
30697,0.005775,216.58.221.0-255,5738,196047,6,207721
30698,0.005784,172.31.36.0-255,66,196113,6,207721
30699,0.007729,216.58.221.0-255,5738,201851,6,207721
30700,0.007733,172.31.36.0-255,66,201917,6,207721
30701,0.009654,216.58.221.0-255,5738,207655,6,207721
30702,0.009661,172.31.36.0-255,66,207721,6,207721
30703,0.0,74.125.130.0-255,153,153,6,317908
30704,3.3e-05,172.31.36.0-255,66,219,6,317908
30705,4e-05,74.125.130.0-255,1484,1703,6,317908
30706,4.5e-05,172.31.36.0-255,66,1769,6,317908
30707,5e-05,74.125.130.0-255,2902,4671,6,317908
30708,6.1e-05,172.31.36.0-255,66,4737,6,317908
30709,6.7e-05,74.125.130.0-255,7156,11893,6,317908
30710,7e-05,172.31.36.0-255,66,11959,6,317908
30711,7.5e-05,74.125.130.0-255,2139,14098,6,317908
30712,7.7e-05,172.31.36.0-255,66,14164,6,317908
30713,0.000109,74.125.130.0-255,2902,17066,6,317908
30714,0.000113,172.31.36.0-255,66,17132,6,317908
30715,0.000118,74.125.130.0-255,5738,22870,6,317908
30716,0.000121,172.31.36.0-255,66,22936,6,317908
30717,0.000141,74.125.130.0-255,1484,24420,6,317908
30718,0.000143,172.31.36.0-255,66,24486,6,317908
30719,0.000156,74.125.130.0-255,6797,31283,6,317908
30720,0.000158,172.31.36.0-255,66,31349,6,317908
30721,0.000228,74.125.130.0-255,1484,32833,6,317908
30722,0.000231,172.31.36.0-255,66,32899,6,317908
30723,0.000259,74.125.130.0-255,2902,35801,6,317908
30724,0.000262,172.31.36.0-255,66,35867,6,317908
30725,0.000269,74.125.130.0-255,5738,41605,6,317908
30726,0.000272,172.31.36.0-255,66,41671,6,317908
30727,0.000314,74.125.130.0-255,5738,47409,6,317908
30728,0.000314,172.31.36.0-255,66,47475,6,317908
30729,0.000318,172.31.36.0-255,66,47541,6,317908
30730,0.000344,74.125.130.0-255,2902,50443,6,317908
30731,0.000352,172.31.36.0-255,66,50509,6,317908
30732,0.000356,74.125.130.0-255,1381,51890,6,317908
30733,0.000358,172.31.36.0-255,66,51956,6,317908
30734,0.000389,74.125.130.0-255,119,52075,6,317908
30735,0.000751,74.125.130.0-255,379,52454,6,317908
30736,0.000775,172.31.36.0-255,66,52520,6,317908
30737,0.001066,74.125.130.0-255,1484,54004,6,317908
30738,0.001078,74.125.130.0-255,2902,56906,6,317908
30739,0.001082,172.31.36.0-255,66,56972,6,317908
30740,0.001089,74.125.130.0-255,5738,62710,6,317908
30741,0.001091,172.31.36.0-255,66,62776,6,317908
30742,0.001129,74.125.130.0-255,9992,72768,6,317908
30743,0.001133,172.31.36.0-255,66,72834,6,317908
30744,0.001158,74.125.130.0-255,1484,74318,6,317908
30745,0.001172,172.31.36.0-255,66,74384,6,317908
30746,0.001571,74.125.130.0-255,1484,75868,6,317908
30747,0.00158,74.125.130.0-255,2902,78770,6,317908
30748,0.001584,172.31.36.0-255,66,78836,6,317908
30749,0.001591,74.125.130.0-255,5738,84574,6,317908
30750,0.001593,172.31.36.0-255,66,84640,6,317908
30751,0.00163,74.125.130.0-255,7156,91796,6,317908
30752,0.001632,172.31.36.0-255,66,91862,6,317908
30753,0.00164,74.125.130.0-255,8574,100436,6,317908
30754,0.001642,172.31.36.0-255,66,100502,6,317908
30755,0.001678,74.125.130.0-255,4320,104822,6,317908
30756,0.00168,172.31.36.0-255,66,104888,6,317908
30757,0.001705,74.125.130.0-255,3602,108490,6,317908
30758,0.001707,172.31.36.0-255,66,108556,6,317908
30759,0.001992,74.125.130.0-255,1484,110040,6,317908
30760,0.002,74.125.130.0-255,2902,112942,6,317908
30761,0.002003,172.31.36.0-255,66,113008,6,317908
30762,0.002007,74.125.130.0-255,1484,114492,6,317908
30763,0.002032,74.125.130.0-255,1484,115976,6,317908
30764,0.002034,172.31.36.0-255,66,116042,6,317908
30765,0.00204,74.125.130.0-255,4320,120362,6,317908
30766,0.002042,172.31.36.0-255,66,120428,6,317908
30767,0.002068,74.125.130.0-255,2902,123330,6,317908
30768,0.002071,172.31.36.0-255,66,123396,6,317908
30769,0.002098,74.125.130.0-255,5738,129134,6,317908
30770,0.0021,172.31.36.0-255,66,129200,6,317908
30771,0.002132,74.125.130.0-255,9992,139192,6,317908
30772,0.002135,172.31.36.0-255,66,139258,6,317908
30773,0.00214,74.125.130.0-255,3602,142860,6,317908
30774,0.002142,172.31.36.0-255,66,142926,6,317908
30775,0.002208,74.125.130.0-255,1484,144410,6,317908
30776,0.002213,74.125.130.0-255,2902,147312,6,317908
30777,0.002216,172.31.36.0-255,66,147378,6,317908
30778,0.002222,74.125.130.0-255,5738,153116,6,317908
30779,0.002224,172.31.36.0-255,66,153182,6,317908
30780,0.00223,74.125.130.0-255,5738,158920,6,317908
30781,0.002231,172.31.36.0-255,66,158986,6,317908
30782,0.002244,74.125.130.0-255,7156,166142,6,317908
30783,0.002246,172.31.36.0-255,66,166208,6,317908
30784,0.002256,74.125.130.0-255,10692,176900,6,317908
30785,0.002259,172.31.36.0-255,66,176966,6,317908
30786,0.002551,74.125.130.0-255,1484,178450,6,317908
30787,0.002555,74.125.130.0-255,1484,179934,6,317908
30788,0.002561,172.31.36.0-255,66,180000,6,317908
30789,0.002579,74.125.130.0-255,1484,181484,6,317908
30790,0.002582,74.125.130.0-255,1484,182968,6,317908
30791,0.002584,172.31.36.0-255,66,183034,6,317908
30792,0.002589,74.125.130.0-255,2902,185936,6,317908
30793,0.002591,172.31.36.0-255,66,186002,6,317908
30794,0.002594,74.125.130.0-255,1484,187486,6,317908
30795,0.002631,74.125.130.0-255,4320,191806,6,317908
30796,0.002647,74.125.130.0-255,6438,198244,6,317908
30797,0.002657,172.31.36.0-255,66,198310,6,317908
30798,0.002661,172.31.36.0-255,66,198376,6,317908
30799,0.002663,172.31.36.0-255,66,198442,6,317908
30800,0.0027,74.125.130.0-255,1484,199926,6,317908
30801,0.002706,74.125.130.0-255,2902,202828,6,317908
30802,0.002708,172.31.36.0-255,66,202894,6,317908
30803,0.002715,74.125.130.0-255,5738,208632,6,317908
30804,0.002717,172.31.36.0-255,66,208698,6,317908
30805,0.002729,74.125.130.0-255,8574,217272,6,317908
30806,0.002731,172.31.36.0-255,66,217338,6,317908
30807,0.00277,74.125.130.0-255,4320,221658,6,317908
30808,0.002774,172.31.36.0-255,66,221724,6,317908
30809,0.002781,74.125.130.0-255,7156,228880,6,317908
30810,0.002783,172.31.36.0-255,66,228946,6,317908
30811,0.00281,74.125.130.0-255,1484,230430,6,317908
30812,0.002826,74.125.130.0-255,2184,232614,6,317908
30813,0.002829,172.31.36.0-255,66,232680,6,317908
30814,0.002834,74.125.130.0-255,4320,237000,6,317908
30815,0.002836,172.31.36.0-255,66,237066,6,317908
30816,0.002841,74.125.130.0-255,4320,241386,6,317908
30817,0.002848,172.31.36.0-255,66,241452,6,317908
30818,0.002853,74.125.130.0-255,2902,244354,6,317908
30819,0.002855,172.31.36.0-255,66,244420,6,317908
30820,0.002884,74.125.130.0-255,2902,247322,6,317908
30821,0.002891,172.31.36.0-255,66,247388,6,317908
30822,0.002903,172.31.36.0-255,66,247454,6,317908
30823,0.00291,74.125.130.0-255,7856,255310,6,317908
30824,0.002912,172.31.36.0-255,66,255376,6,317908
30825,0.002979,74.125.130.0-255,1484,256860,6,317908
30826,0.002986,74.125.130.0-255,2902,259762,6,317908
30827,0.00299,172.31.36.0-255,66,259828,6,317908
30828,0.002998,74.125.130.0-255,5738,265566,6,317908
30829,0.003001,172.31.36.0-255,66,265632,6,317908
30830,0.003031,74.125.130.0-255,5738,271370,6,317908
30831,0.003034,172.31.36.0-255,66,271436,6,317908
30832,0.00307,74.125.130.0-255,7156,278592,6,317908
30833,0.003074,172.31.36.0-255,66,278658,6,317908
30834,0.003082,74.125.130.0-255,7156,285814,6,317908
30835,0.003085,172.31.36.0-255,66,285880,6,317908
30836,0.003094,74.125.130.0-255,3602,289482,6,317908
30837,0.003097,172.31.36.0-255,66,289548,6,317908
30838,0.003135,74.125.130.0-255,1484,291032,6,317908
30839,0.00314,74.125.130.0-255,1484,292516,6,317908
30840,0.003144,172.31.36.0-255,66,292582,6,317908
30841,0.003176,74.125.130.0-255,1484,294066,6,317908
30842,0.003184,74.125.130.0-255,5738,299804,6,317908
30843,0.003187,172.31.36.0-255,66,299870,6,317908
30844,0.003239,172.31.36.0-255,66,299936,6,317908
30845,0.003277,74.125.130.0-255,1484,301420,6,317908
30846,0.003285,74.125.130.0-255,8574,309994,6,317908
30847,0.003289,172.31.36.0-255,66,310060,6,317908
30848,0.003315,172.31.36.0-255,66,310126,6,317908
30849,0.003323,74.125.130.0-255,7374,317500,6,317908
30850,0.003328,172.31.36.0-255,66,317566,6,317908
30851,0.003332,74.125.130.0-255,105,317671,6,317908
30852,0.005085,172.31.36.0-255,66,317737,6,317908
30853,0.005121,172.31.36.0-255,105,317842,6,317908
30854,0.007305,74.125.130.0-255,66,317908,6,317908
30855,0.0,74.125.200.0-255,153,153,6,227405
30856,2.2e-05,172.31.36.0-255,66,219,6,227405
30857,2.8e-05,74.125.200.0-255,1484,1703,6,227405
30858,3.2e-05,172.31.36.0-255,66,1769,6,227405
30859,3.7e-05,74.125.200.0-255,2902,4671,6,227405
30860,4.8e-05,172.31.36.0-255,66,4737,6,227405
30861,5.1e-05,74.125.200.0-255,1484,6221,6,227405
30862,5.3e-05,172.31.36.0-255,66,6287,6,227405
30863,5.8e-05,74.125.200.0-255,2902,9189,6,227405
30864,6e-05,172.31.36.0-255,66,9255,6,227405
30865,0.000109,74.125.200.0-255,4882,14137,6,227405
30866,0.000112,172.31.36.0-255,66,14203,6,227405
30867,0.000139,74.125.200.0-255,4320,18523,6,227405
30868,0.000142,172.31.36.0-255,66,18589,6,227405
30869,0.000168,74.125.200.0-255,1484,20073,6,227405
30870,0.000171,172.31.36.0-255,66,20139,6,227405
30871,0.000176,74.125.200.0-255,4320,24459,6,227405
30872,0.000178,172.31.36.0-255,66,24525,6,227405
30873,0.000189,74.125.200.0-255,5738,30263,6,227405
30874,0.000191,172.31.36.0-255,66,30329,6,227405
30875,0.000193,74.125.200.0-255,1125,31454,6,227405
30876,0.000195,172.31.36.0-255,66,31520,6,227405
30877,0.00027,74.125.200.0-255,1484,33004,6,227405
30878,0.000273,172.31.36.0-255,66,33070,6,227405
30879,0.000294,74.125.200.0-255,2902,35972,6,227405
30880,0.000296,172.31.36.0-255,66,36038,6,227405
30881,0.000302,74.125.200.0-255,5738,41776,6,227405
30882,0.000304,172.31.36.0-255,66,41842,6,227405
30883,0.00036,74.125.200.0-255,6797,48639,6,227405
30884,0.000363,172.31.36.0-255,66,48705,6,227405
30885,0.000371,74.125.200.0-255,9992,58697,6,227405
30886,0.000374,172.31.36.0-255,66,58763,6,227405
30887,0.000408,74.125.200.0-255,7154,65917,6,227405
30888,0.000412,172.31.36.0-255,66,65983,6,227405
30889,0.000438,74.125.200.0-255,330,66313,6,227405
30890,0.000737,74.125.200.0-255,1484,67797,6,227405
30891,0.000743,172.31.36.0-255,66,67863,6,227405
30892,0.000748,74.125.200.0-255,2902,70765,6,227405
30893,0.000752,172.31.36.0-255,66,70831,6,227405
30894,0.000757,74.125.200.0-255,5738,76569,6,227405
30895,0.000766,172.31.36.0-255,66,76635,6,227405
30896,0.00077,74.125.200.0-255,2902,79537,6,227405
30897,0.000773,172.31.36.0-255,66,79603,6,227405
30898,0.000789,74.125.200.0-255,4320,83923,6,227405
30899,0.000797,172.31.36.0-255,66,83989,6,227405
30900,0.0008,74.125.200.0-255,1484,85473,6,227405
30901,0.00083,74.125.200.0-255,7156,92629,6,227405
30902,0.000834,172.31.36.0-255,66,92695,6,227405
30903,0.000838,74.125.200.0-255,2902,95597,6,227405
30904,0.00084,172.31.36.0-255,66,95663,6,227405
30905,0.000874,74.125.200.0-255,5020,100683,6,227405
30906,0.000883,172.31.36.0-255,66,100749,6,227405
30907,0.000926,74.125.200.0-255,1484,102233,6,227405
30908,0.000948,74.125.200.0-255,2902,105135,6,227405
30909,0.000952,172.31.36.0-255,66,105201,6,227405
30910,0.000984,74.125.200.0-255,2902,108103,6,227405
30911,0.000987,172.31.36.0-255,66,108169,6,227405
30912,0.000992,74.125.200.0-255,4320,112489,6,227405
30913,0.000995,172.31.36.0-255,66,112555,6,227405
30914,0.001012,74.125.200.0-255,8574,121129,6,227405
30915,0.001015,172.31.36.0-255,66,121195,6,227405
30916,0.001022,74.125.200.0-255,5738,126933,6,227405
30917,0.001025,172.31.36.0-255,66,126999,6,227405
30918,0.001052,74.125.200.0-255,7156,134155,6,227405
30919,0.001055,172.31.36.0-255,66,134221,6,227405
30920,0.001063,74.125.200.0-255,766,134987,6,227405
30921,0.001415,74.125.200.0-255,1484,136471,6,227405
30922,0.001421,172.31.36.0-255,66,136537,6,227405
30923,0.001427,74.125.200.0-255,2902,139439,6,227405
30924,0.001429,172.31.36.0-255,66,139505,6,227405
30925,0.001433,74.125.200.0-255,4320,143825,6,227405
30926,0.001435,172.31.36.0-255,66,143891,6,227405
30927,0.001445,74.125.200.0-255,2902,146793,6,227405
30928,0.001447,172.31.36.0-255,66,146859,6,227405
30929,0.001483,74.125.200.0-255,5738,152597,6,227405
30930,0.001486,172.31.36.0-255,66,152663,6,227405
30931,0.001494,74.125.200.0-255,8574,161237,6,227405
30932,0.001496,172.31.36.0-255,66,161303,6,227405
30933,0.001528,74.125.200.0-255,7856,169159,6,227405
30934,0.001531,172.31.36.0-255,66,169225,6,227405
30935,0.001585,74.125.200.0-255,1484,170709,6,227405
30936,0.001604,74.125.200.0-255,2902,173611,6,227405
30937,0.001607,172.31.36.0-255,66,173677,6,227405
30938,0.001612,74.125.200.0-255,4320,177997,6,227405
30939,0.001614,172.31.36.0-255,66,178063,6,227405
30940,0.001646,74.125.200.0-255,1484,179547,6,227405
30941,0.00165,74.125.200.0-255,2902,182449,6,227405
30942,0.001652,172.31.36.0-255,66,182515,6,227405
30943,0.001657,74.125.200.0-255,4320,186835,6,227405
30944,0.001659,172.31.36.0-255,66,186901,6,227405
30945,0.001666,74.125.200.0-255,8574,195475,6,227405
30946,0.001673,172.31.36.0-255,66,195541,6,227405
30947,0.001679,74.125.200.0-255,5738,201279,6,227405
30948,0.001681,172.31.36.0-255,66,201345,6,227405
30949,0.001707,74.125.200.0-255,1484,202829,6,227405
30950,0.001709,74.125.200.0-255,766,203595,6,227405
30951,0.001729,172.31.36.0-255,66,203661,6,227405
30952,0.003699,74.125.200.0-255,2902,206563,6,227405
30953,0.003705,172.31.36.0-255,66,206629,6,227405
30954,0.003746,74.125.200.0-255,2902,209531,6,227405
30955,0.003749,172.31.36.0-255,66,209597,6,227405
30956,0.005745,74.125.200.0-255,2902,212499,6,227405
30957,0.00575,172.31.36.0-255,66,212565,6,227405
30958,0.005776,74.125.200.0-255,2902,215467,6,227405
30959,0.005779,172.31.36.0-255,66,215533,6,227405
30960,0.007788,74.125.200.0-255,2902,218435,6,227405
30961,0.007795,172.31.36.0-255,66,218501,6,227405
30962,0.007831,74.125.200.0-255,2902,221403,6,227405
30963,0.007835,172.31.36.0-255,66,221469,6,227405
30964,0.009825,74.125.200.0-255,2902,224371,6,227405
30965,0.009833,172.31.36.0-255,66,224437,6,227405
30966,0.009893,74.125.200.0-255,2902,227339,6,227405
30967,0.009897,172.31.36.0-255,66,227405,6,227405
30968,0.0,74.125.68.0-255,302,302,6,209599
30969,2.8e-05,172.31.36.0-255,66,368,6,209599
30970,3.5e-05,74.125.68.0-255,1484,1852,6,209599
30971,3.8e-05,172.31.36.0-255,66,1918,6,209599
30972,4.6e-05,74.125.68.0-255,4320,6238,6,209599
30973,4.8e-05,172.31.36.0-255,66,6304,6,209599
30974,5.2e-05,74.125.68.0-255,2902,9206,6,209599
30975,5.6e-05,172.31.36.0-255,66,9272,6,209599
30976,6.1e-05,74.125.68.0-255,4320,13592,6,209599
30977,6.4e-05,172.31.36.0-255,66,13658,6,209599
30978,6.6e-05,74.125.68.0-255,394,14052,6,209599
30979,6.8e-05,172.31.36.0-255,66,14118,6,209599
30980,0.000176,74.125.68.0-255,1484,15602,6,209599
30981,0.000181,172.31.36.0-255,66,15668,6,209599
30982,0.0002,74.125.68.0-255,2902,18570,6,209599
30983,0.000202,172.31.36.0-255,66,18636,6,209599
30984,0.000227,74.125.68.0-255,5738,24374,6,209599
30985,0.000229,172.31.36.0-255,66,24440,6,209599
30986,0.000254,74.125.68.0-255,6797,31237,6,209599
30987,0.000257,172.31.36.0-255,66,31303,6,209599
30988,0.000285,74.125.68.0-255,7156,38459,6,209599
30989,0.000288,74.125.68.0-255,1484,39943,6,209599
30990,0.000291,172.31.36.0-255,66,40009,6,209599
30991,0.000295,172.31.36.0-255,66,40075,6,209599
30992,0.000303,74.125.68.0-255,5738,45813,6,209599
30993,0.000306,172.31.36.0-255,66,45879,6,209599
30994,0.000326,74.125.68.0-255,2902,48781,6,209599
30995,0.000329,172.31.36.0-255,66,48847,6,209599
30996,0.000341,172.31.36.0-255,66,48913,6,209599
30997,0.000347,74.125.68.0-255,5020,53933,6,209599
30998,0.000351,172.31.36.0-255,66,53999,6,209599
30999,0.000371,74.125.68.0-255,442,54441,6,209599
31000,0.000418,74.125.68.0-255,332,54773,6,209599
31001,0.000822,74.125.68.0-255,1484,56257,6,209599
31002,0.000825,172.31.36.0-255,66,56323,6,209599
31003,0.000842,74.125.68.0-255,2902,59225,6,209599
31004,0.000844,172.31.36.0-255,66,59291,6,209599
31005,0.000858,74.125.68.0-255,2902,62193,6,209599
31006,0.00086,172.31.36.0-255,66,62259,6,209599
31007,0.000883,74.125.68.0-255,2902,65161,6,209599
31008,0.000886,172.31.36.0-255,66,65227,6,209599
31009,0.000892,74.125.68.0-255,7156,72383,6,209599
31010,0.000894,172.31.36.0-255,66,72449,6,209599
31011,0.000898,74.125.68.0-255,2902,75351,6,209599
31012,0.0009,172.31.36.0-255,66,75417,6,209599
31013,0.00093,74.125.68.0-255,9992,85409,6,209599
31014,0.000933,172.31.36.0-255,66,85475,6,209599
31015,0.000951,74.125.68.0-255,3602,89077,6,209599
31016,0.000953,172.31.36.0-255,66,89143,6,209599
31017,0.001001,74.125.68.0-255,4320,93463,6,209599
31018,0.001004,172.31.36.0-255,66,93529,6,209599
31019,0.001008,74.125.68.0-255,2902,96431,6,209599
31020,0.00101,172.31.36.0-255,66,96497,6,209599
31021,0.001023,74.125.68.0-255,2902,99399,6,209599
31022,0.001025,172.31.36.0-255,66,99465,6,209599
31023,0.001043,74.125.68.0-255,4320,103785,6,209599
31024,0.001045,172.31.36.0-255,66,103851,6,209599
31025,0.001071,74.125.68.0-255,7156,111007,6,209599
31026,0.001073,172.31.36.0-255,66,111073,6,209599
31027,0.001079,74.125.68.0-255,4320,115393,6,209599
31028,0.00108,172.31.36.0-255,66,115459,6,209599
31029,0.001119,74.125.68.0-255,1484,116943,6,209599
31030,0.001136,74.125.68.0-255,6438,123381,6,209599
31031,0.001138,172.31.36.0-255,66,123447,6,209599
31032,0.001284,74.125.68.0-255,1484,124931,6,209599
31033,0.001308,74.125.68.0-255,2902,127833,6,209599
31034,0.001311,172.31.36.0-255,66,127899,6,209599
31035,0.001314,74.125.68.0-255,1484,129383,6,209599
31036,0.001318,74.125.68.0-255,2902,132285,6,209599
31037,0.001319,172.31.36.0-255,66,132351,6,209599
31038,0.001347,74.125.68.0-255,5738,138089,6,209599
31039,0.001351,172.31.36.0-255,66,138155,6,209599
31040,0.001359,74.125.68.0-255,2902,141057,6,209599
31041,0.001361,172.31.36.0-255,66,141123,6,209599
31042,0.001384,74.125.68.0-255,7156,148279,6,209599
31043,0.001386,172.31.36.0-255,66,148345,6,209599
31044,0.001418,74.125.68.0-255,2902,151247,6,209599
31045,0.001421,172.31.36.0-255,66,151313,6,209599
31046,0.001442,74.125.68.0-255,6438,157751,6,209599
31047,0.001444,172.31.36.0-255,66,157817,6,209599
31048,0.001821,74.125.68.0-255,1484,159301,6,209599
31049,0.001831,74.125.68.0-255,2902,162203,6,209599
31050,0.001836,172.31.36.0-255,66,162269,6,209599
31051,0.00184,74.125.68.0-255,1484,163753,6,209599
31052,0.001862,74.125.68.0-255,4320,168073,6,209599
31053,0.001865,172.31.36.0-255,66,168139,6,209599
31054,0.001886,74.125.68.0-255,2902,171041,6,209599
31055,0.00189,172.31.36.0-255,66,171107,6,209599
31056,0.001903,74.125.68.0-255,2902,174009,6,209599
31057,0.001905,172.31.36.0-255,66,174075,6,209599
31058,0.001912,74.125.68.0-255,7156,181231,6,209599
31059,0.001915,172.31.36.0-255,66,181297,6,209599
31060,0.001921,74.125.68.0-255,4320,185617,6,209599
31061,0.001923,172.31.36.0-255,66,185683,6,209599
31062,0.001948,74.125.68.0-255,6438,192121,6,209599
31063,0.001951,172.31.36.0-255,66,192187,6,209599
31064,0.004272,74.125.68.0-255,5738,197925,6,209599
31065,0.004279,172.31.36.0-255,66,197991,6,209599
31066,0.006605,74.125.68.0-255,5738,203729,6,209599
31067,0.006611,172.31.36.0-255,66,203795,6,209599
31068,0.008939,74.125.68.0-255,5738,209533,6,209599
31069,0.008944,172.31.36.0-255,66,209599,6,209599
31070,0.0,74.125.68.0-255,153,153,6,135705
31071,2.7e-05,172.31.36.0-255,66,219,6,135705
31072,3.4e-05,74.125.68.0-255,1484,1703,6,135705
31073,3.8e-05,172.31.36.0-255,66,1769,6,135705
31074,4.3e-05,74.125.68.0-255,2902,4671,6,135705
31075,4.5e-05,172.31.36.0-255,66,4737,6,135705
31076,5e-05,74.125.68.0-255,4320,9057,6,135705
31077,5.3e-05,172.31.36.0-255,66,9123,6,135705
31078,7.5e-05,74.125.68.0-255,1484,10607,6,135705
31079,7.7e-05,172.31.36.0-255,66,10673,6,135705
31080,8.3e-05,74.125.68.0-255,3433,14106,6,135705
31081,8.5e-05,172.31.36.0-255,66,14172,6,135705
31082,0.000189,74.125.68.0-255,1484,15656,6,135705
31083,0.000194,172.31.36.0-255,66,15722,6,135705
31084,0.0002,74.125.68.0-255,2902,18624,6,135705
31085,0.000202,172.31.36.0-255,66,18690,6,135705
31086,0.000227,74.125.68.0-255,5738,24428,6,135705
31087,0.00023,172.31.36.0-255,66,24494,6,135705
31088,0.000234,74.125.68.0-255,2902,27396,6,135705
31089,0.000236,172.31.36.0-255,66,27462,6,135705
31090,0.000274,74.125.68.0-255,5738,33200,6,135705
31091,0.000277,172.31.36.0-255,66,33266,6,135705
31092,0.000298,74.125.68.0-255,5379,38645,6,135705
31093,0.000301,172.31.36.0-255,66,38711,6,135705
31094,0.000306,74.125.68.0-255,4320,43031,6,135705
31095,0.000308,172.31.36.0-255,66,43097,6,135705
31096,0.00035,172.31.36.0-255,66,43163,6,135705
31097,0.000364,74.125.68.0-255,1484,44647,6,135705
31098,0.000366,172.31.36.0-255,66,44713,6,135705
31099,0.000373,74.125.68.0-255,5020,49733,6,135705
31100,0.000376,172.31.36.0-255,66,49799,6,135705
31101,0.000379,74.125.68.0-255,361,50160,6,135705
31102,0.000407,74.125.68.0-255,134,50294,6,135705
31103,0.000595,74.125.68.0-255,347,50641,6,135705
31104,0.000828,172.31.36.0-255,66,50707,6,135705
31105,0.001105,74.125.68.0-255,1484,52191,6,135705
31106,0.001114,74.125.68.0-255,2902,55093,6,135705
31107,0.001118,172.31.36.0-255,66,55159,6,135705
31108,0.001122,74.125.68.0-255,1484,56643,6,135705
31109,0.001145,74.125.68.0-255,4320,60963,6,135705
31110,0.001148,172.31.36.0-255,66,61029,6,135705
31111,0.001155,74.125.68.0-255,4320,65349,6,135705
31112,0.001157,172.31.36.0-255,66,65415,6,135705
31113,0.001159,74.125.68.0-255,1484,66899,6,135705
31114,0.001186,74.125.68.0-255,4320,71219,6,135705
31115,0.001189,172.31.36.0-255,66,71285,6,135705
31116,0.001194,74.125.68.0-255,4320,75605,6,135705
31117,0.001196,172.31.36.0-255,66,75671,6,135705
31118,0.001218,74.125.68.0-255,7156,82827,6,135705
31119,0.00122,172.31.36.0-255,66,82893,6,135705
31120,0.001224,74.125.68.0-255,2184,85077,6,135705
31121,0.001227,172.31.36.0-255,66,85143,6,135705
31122,0.00136,74.125.68.0-255,1484,86627,6,135705
31123,0.001382,74.125.68.0-255,2902,89529,6,135705
31124,0.001386,172.31.36.0-255,66,89595,6,135705
31125,0.00143,74.125.68.0-255,2902,92497,6,135705
31126,0.001433,172.31.36.0-255,66,92563,6,135705
31127,0.001464,74.125.68.0-255,2902,95465,6,135705
31128,0.001467,172.31.36.0-255,66,95531,6,135705
31129,0.001471,74.125.68.0-255,2902,98433,6,135705
31130,0.001473,172.31.36.0-255,66,98499,6,135705
31131,0.001478,74.125.68.0-255,4320,102819,6,135705
31132,0.00148,172.31.36.0-255,66,102885,6,135705
31133,0.001488,74.125.68.0-255,8574,111459,6,135705
31134,0.00149,172.31.36.0-255,66,111525,6,135705
31135,0.001512,74.125.68.0-255,1484,113009,6,135705
31136,0.001522,74.125.68.0-255,1484,114493,6,135705
31137,0.001524,172.31.36.0-255,66,114559,6,135705
31138,0.00154,74.125.68.0-255,5020,119579,6,135705
31139,0.001542,172.31.36.0-255,66,119645,6,135705
31140,0.003777,74.125.68.0-255,5738,125383,6,135705
31141,0.003782,172.31.36.0-255,66,125449,6,135705
31142,0.006017,74.125.68.0-255,4320,129769,6,135705
31143,0.006022,172.31.36.0-255,66,129835,6,135705
31144,0.006045,74.125.68.0-255,1484,131319,6,135705
31145,0.008269,74.125.68.0-255,4320,135639,6,135705
31146,0.008277,172.31.36.0-255,66,135705,6,135705
31147,0.0,74.125.200.0-255,297,297,6,122805
31148,2e-05,172.31.36.0-255,66,363,6,122805
31149,2.6e-05,74.125.200.0-255,1484,1847,6,122805
31150,3e-05,172.31.36.0-255,66,1913,6,122805
31151,3.8e-05,74.125.200.0-255,4320,6233,6,122805
31152,5e-05,172.31.36.0-255,66,6299,6,122805
31153,5.8e-05,74.125.200.0-255,7156,13455,6,122805
31154,6.1e-05,172.31.36.0-255,66,13521,6,122805
31155,6.4e-05,74.125.200.0-255,413,13934,6,122805
31156,6.6e-05,172.31.36.0-255,66,14000,6,122805
31157,0.000364,74.125.200.0-255,1484,15484,6,122805
31158,0.00037,172.31.36.0-255,66,15550,6,122805
31159,0.000376,74.125.200.0-255,2902,18452,6,122805
31160,0.000379,172.31.36.0-255,66,18518,6,122805
31161,0.000411,74.125.200.0-255,5738,24256,6,122805
31162,0.000413,172.31.36.0-255,66,24322,6,122805
31163,0.000434,74.125.200.0-255,6797,31119,6,122805
31164,0.000437,172.31.36.0-255,66,31185,6,122805
31165,0.000586,74.125.200.0-255,1484,32669,6,122805
31166,0.000589,172.31.36.0-255,66,32735,6,122805
31167,0.000594,74.125.200.0-255,1484,34219,6,122805
31168,0.000596,172.31.36.0-255,66,34285,6,122805
31169,0.000616,74.125.200.0-255,1484,35769,6,122805
31170,0.00062,74.125.200.0-255,2902,38671,6,122805
31171,0.000627,172.31.36.0-255,66,38737,6,122805
31172,0.00063,172.31.36.0-255,66,38803,6,122805
31173,0.000641,74.125.200.0-255,2902,41705,6,122805
31174,0.000648,172.31.36.0-255,66,41771,6,122805
31175,0.000652,74.125.200.0-255,2902,44673,6,122805
31176,0.000655,172.31.36.0-255,66,44739,6,122805
31177,0.00066,74.125.200.0-255,3961,48700,6,122805
31178,0.000663,172.31.36.0-255,66,48766,6,122805
31179,0.0007,74.125.200.0-255,8574,57340,6,122805
31180,0.000704,172.31.36.0-255,66,57406,6,122805
31181,0.000709,74.125.200.0-255,4320,61726,6,122805
31182,0.000711,172.31.36.0-255,66,61792,6,122805
31183,0.000746,74.125.200.0-255,4271,66063,6,122805
31184,0.000749,172.31.36.0-255,66,66129,6,122805
31185,0.000776,74.125.200.0-255,111,66240,6,122805
31186,0.000867,74.125.200.0-255,331,66571,6,122805
31187,0.001213,172.31.36.0-255,66,66637,6,122805
31188,0.001359,74.125.200.0-255,1484,68121,6,122805
31189,0.001383,74.125.200.0-255,2902,71023,6,122805
31190,0.001388,172.31.36.0-255,66,71089,6,122805
31191,0.001396,74.125.200.0-255,5738,76827,6,122805
31192,0.001398,172.31.36.0-255,66,76893,6,122805
31193,0.001401,74.125.200.0-255,1484,78377,6,122805
31194,0.001433,74.125.200.0-255,4320,82697,6,122805
31195,0.001436,172.31.36.0-255,66,82763,6,122805
31196,0.001443,74.125.200.0-255,7156,89919,6,122805
31197,0.001445,172.31.36.0-255,66,89985,6,122805
31198,0.001454,74.125.200.0-255,2902,92887,6,122805
31199,0.001457,172.31.36.0-255,66,92953,6,122805
31200,0.001491,74.125.200.0-255,7856,100809,6,122805
31201,0.001493,172.31.36.0-255,66,100875,6,122805
31202,0.003724,74.125.200.0-255,1484,102359,6,122805
31203,0.003733,74.125.200.0-255,2902,105261,6,122805
31204,0.003738,172.31.36.0-255,66,105327,6,122805
31205,0.003743,74.125.200.0-255,1484,106811,6,122805
31206,0.005714,74.125.200.0-255,4320,111131,6,122805
31207,0.005717,172.31.36.0-255,66,111197,6,122805
31208,0.007695,74.125.200.0-255,5738,116935,6,122805
31209,0.007702,172.31.36.0-255,66,117001,6,122805
31210,0.009672,74.125.200.0-255,5738,122739,6,122805
31211,0.009678,172.31.36.0-255,66,122805,6,122805
31212,0.0,172.217.194.0-255,153,153,6,251588
31213,2.5e-05,172.31.36.0-255,66,219,6,251588
31214,3.1e-05,172.217.194.0-255,1484,1703,6,251588
31215,3.6e-05,172.31.36.0-255,66,1769,6,251588
31216,4.1e-05,172.217.194.0-255,2902,4671,6,251588
31217,4.4e-05,172.31.36.0-255,66,4737,6,251588
31218,5.3e-05,172.217.194.0-255,7156,11893,6,251588
31219,5.6e-05,172.31.36.0-255,66,11959,6,251588
31220,5.9e-05,172.217.194.0-255,2076,14035,6,251588
31221,6.2e-05,172.31.36.0-255,66,14101,6,251588
31222,8.6e-05,172.217.194.0-255,2902,17003,6,251588
31223,8.9e-05,172.31.36.0-255,66,17069,6,251588
31224,0.000108,172.217.194.0-255,7156,24225,6,251588
31225,0.00011,172.31.36.0-255,66,24291,6,251588
31226,0.000117,172.217.194.0-255,5738,30029,6,251588
31227,0.00012,172.31.36.0-255,66,30095,6,251588
31228,0.00015,172.217.194.0-255,1125,31220,6,251588
31229,0.000154,172.31.36.0-255,66,31286,6,251588
31230,0.000195,172.217.194.0-255,1484,32770,6,251588
31231,0.000198,172.31.36.0-255,66,32836,6,251588
31232,0.000213,172.217.194.0-255,2902,35738,6,251588
31233,0.000215,172.31.36.0-255,66,35804,6,251588
31234,0.00024,172.217.194.0-255,5738,41542,6,251588
31235,0.000243,172.31.36.0-255,66,41608,6,251588
31236,0.000264,172.217.194.0-255,8574,50182,6,251588
31237,0.000267,172.31.36.0-255,66,50248,6,251588
31238,0.000291,172.217.194.0-255,5379,55627,6,251588
31239,0.000294,172.31.36.0-255,66,55693,6,251588
31240,0.000302,172.217.194.0-255,8574,64267,6,251588
31241,0.000304,172.31.36.0-255,66,64333,6,251588
31242,0.000327,172.217.194.0-255,1426,65759,6,251588
31243,0.000332,172.31.36.0-255,66,65825,6,251588
31244,0.000344,172.217.194.0-255,385,66210,6,251588
31245,0.000842,172.31.36.0-255,66,66276,6,251588
31246,0.000969,172.217.194.0-255,1484,67760,6,251588
31247,0.000987,172.217.194.0-255,2902,70662,6,251588
31248,0.00099,172.31.36.0-255,66,70728,6,251588
31249,0.000998,172.217.194.0-255,5738,76466,6,251588
31250,0.001,172.31.36.0-255,66,76532,6,251588
31251,0.001029,172.217.194.0-255,7156,83688,6,251588
31252,0.001031,172.31.36.0-255,66,83754,6,251588
31253,0.00105,172.217.194.0-255,2902,86656,6,251588
31254,0.001053,172.31.36.0-255,66,86722,6,251588
31255,0.001068,172.31.36.0-255,66,86788,6,251588
31256,0.001089,172.217.194.0-255,766,87554,6,251588
31257,0.001475,172.217.194.0-255,1484,89038,6,251588
31258,0.001482,172.31.36.0-255,66,89104,6,251588
31259,0.001488,172.217.194.0-255,2902,92006,6,251588
31260,0.00149,172.31.36.0-255,66,92072,6,251588
31261,0.001497,172.217.194.0-255,5738,97810,6,251588
31262,0.001499,172.31.36.0-255,66,97876,6,251588
31263,0.001504,172.217.194.0-255,4320,102196,6,251588
31264,0.001506,172.31.36.0-255,66,102262,6,251588
31265,0.001536,172.217.194.0-255,9992,112254,6,251588
31266,0.001539,172.31.36.0-255,66,112320,6,251588
31267,0.001553,172.217.194.0-255,1484,113804,6,251588
31268,0.00156,172.217.194.0-255,7856,121660,6,251588
31269,0.001562,172.31.36.0-255,66,121726,6,251588
31270,0.001609,172.217.194.0-255,4320,126046,6,251588
31271,0.001612,172.31.36.0-255,66,126112,6,251588
31272,0.001631,172.217.194.0-255,4320,130432,6,251588
31273,0.001634,172.31.36.0-255,66,130498,6,251588
31274,0.001642,172.217.194.0-255,9992,140490,6,251588
31275,0.001644,172.31.36.0-255,66,140556,6,251588
31276,0.001708,172.31.36.0-255,66,140622,6,251588
31277,0.001726,172.217.194.0-255,766,141388,6,251588
31278,0.001743,172.217.194.0-255,1484,142872,6,251588
31279,0.001745,172.31.36.0-255,66,142938,6,251588
31280,0.001769,172.217.194.0-255,2902,145840,6,251588
31281,0.001771,172.31.36.0-255,66,145906,6,251588
31282,0.001777,172.217.194.0-255,5738,151644,6,251588
31283,0.001779,172.31.36.0-255,66,151710,6,251588
31284,0.001784,172.217.194.0-255,4320,156030,6,251588
31285,0.001787,172.31.36.0-255,66,156096,6,251588
31286,0.00181,172.217.194.0-255,2902,158998,6,251588
31287,0.001812,172.31.36.0-255,66,159064,6,251588
31288,0.001827,172.31.36.0-255,66,159130,6,251588
31289,0.001831,172.217.194.0-255,2184,161314,6,251588
31290,0.001833,172.31.36.0-255,66,161380,6,251588
31291,0.002003,172.217.194.0-255,1484,162864,6,251588
31292,0.002018,172.217.194.0-255,2902,165766,6,251588
31293,0.002021,172.31.36.0-255,66,165832,6,251588
31294,0.002024,172.217.194.0-255,1484,167316,6,251588
31295,0.002041,172.217.194.0-255,4320,171636,6,251588
31296,0.002043,172.31.36.0-255,66,171702,6,251588
31297,0.002048,172.217.194.0-255,4320,176022,6,251588
31298,0.00205,172.31.36.0-255,66,176088,6,251588
31299,0.002074,172.217.194.0-255,8574,184662,6,251588
31300,0.002076,172.31.36.0-255,66,184728,6,251588
31301,0.002085,172.217.194.0-255,10692,195420,6,251588
31302,0.002105,172.31.36.0-255,66,195486,6,251588
31303,0.002138,172.217.194.0-255,7156,202642,6,251588
31304,0.002142,172.31.36.0-255,66,202708,6,251588
31305,0.002174,172.31.36.0-255,66,202774,6,251588
31306,0.002176,172.217.194.0-255,1484,204258,6,251588
31307,0.002185,172.217.194.0-255,8574,212832,6,251588
31308,0.002187,172.31.36.0-255,66,212898,6,251588
31309,0.002219,172.31.36.0-255,66,212964,6,251588
31310,0.002256,172.31.36.0-255,66,213030,6,251588
31311,0.002273,172.217.194.0-255,3602,216632,6,251588
31312,0.002275,172.31.36.0-255,66,216698,6,251588
31313,0.002281,172.217.194.0-255,5738,222436,6,251588
31314,0.002283,172.31.36.0-255,66,222502,6,251588
31315,0.002327,172.31.36.0-255,66,222568,6,251588
31316,0.00233,172.217.194.0-255,1484,224052,6,251588
31317,0.002371,172.217.194.0-255,9992,234044,6,251588
31318,0.002373,172.31.36.0-255,66,234110,6,251588
31319,0.0024,172.31.36.0-255,66,234176,6,251588
31320,0.004667,172.217.194.0-255,5738,239914,6,251588
31321,0.00467,172.31.36.0-255,66,239980,6,251588
31322,0.006966,172.217.194.0-255,5738,245718,6,251588
31323,0.006975,172.31.36.0-255,66,245784,6,251588
31324,0.009267,172.217.194.0-255,5738,251522,6,251588
31325,0.009275,172.31.36.0-255,66,251588,6,251588
31326,0.0,74.125.68.0-255,150,150,6,175855
31327,2.3e-05,172.31.36.0-255,66,216,6,175855
31328,7.5e-05,74.125.68.0-255,1484,1700,6,175855
31329,8.2e-05,172.31.36.0-255,66,1766,6,175855
31330,0.000105,74.125.68.0-255,2902,4668,6,175855
31331,0.00011,172.31.36.0-255,66,4734,6,175855
31332,0.000114,74.125.68.0-255,2902,7636,6,175855
31333,0.000116,172.31.36.0-255,66,7702,6,175855
31334,0.000153,74.125.68.0-255,4320,12022,6,175855
31335,0.000156,172.31.36.0-255,66,12088,6,175855
31336,0.00018,74.125.68.0-255,2090,14178,6,175855
31337,0.000183,172.31.36.0-255,66,14244,6,175855
31338,0.000251,74.125.68.0-255,1484,15728,6,175855
31339,0.000254,172.31.36.0-255,66,15794,6,175855
31340,0.000268,74.125.68.0-255,2902,18696,6,175855
31341,0.000271,172.31.36.0-255,66,18762,6,175855
31342,0.000297,74.125.68.0-255,4320,23082,6,175855
31343,0.000301,172.31.36.0-255,66,23148,6,175855
31344,0.000355,74.125.68.0-255,2902,26050,6,175855
31345,0.000358,172.31.36.0-255,66,26116,6,175855
31346,0.000384,74.125.68.0-255,5379,31495,6,175855
31347,0.000387,172.31.36.0-255,66,31561,6,175855
31348,0.000395,74.125.68.0-255,8574,40135,6,175855
31349,0.000397,172.31.36.0-255,66,40201,6,175855
31350,0.000401,74.125.68.0-255,2902,43103,6,175855
31351,0.000404,172.31.36.0-255,66,43169,6,175855
31352,0.000435,74.125.68.0-255,1484,44653,6,175855
31353,0.000438,172.31.36.0-255,66,44719,6,175855
31354,0.000454,74.125.68.0-255,3961,48680,6,175855
31355,0.000458,172.31.36.0-255,66,48746,6,175855
31356,0.001021,74.125.68.0-255,1484,50230,6,175855
31357,0.001027,172.31.36.0-255,66,50296,6,175855
31358,0.001035,74.125.68.0-255,1484,51780,6,175855
31359,0.001055,74.125.68.0-255,2902,54682,6,175855
31360,0.001075,74.125.68.0-255,5738,60420,6,175855
31361,0.001098,74.125.68.0-255,2902,63322,6,175855
31362,0.001114,74.125.68.0-255,2543,65865,6,175855
31363,0.001132,74.125.68.0-255,648,66513,6,175855
31364,0.00115,74.125.68.0-255,1484,67997,6,175855
31365,0.001184,74.125.68.0-255,4320,72317,6,175855
31366,0.001199,74.125.68.0-255,2902,75219,6,175855
31367,0.001211,74.125.68.0-255,2902,78121,6,175855
31368,0.00123,74.125.68.0-255,4320,82441,6,175855
31369,0.001256,74.125.68.0-255,7156,89597,6,175855
31370,0.001261,74.125.68.0-255,4320,93917,6,175855
31371,0.001295,74.125.68.0-255,4320,98237,6,175855
31372,0.001307,74.125.68.0-255,2184,100421,6,175855
31373,0.0017,74.125.68.0-255,1484,101905,6,175855
31374,0.001715,74.125.68.0-255,2902,104807,6,175855
31375,0.001734,74.125.68.0-255,2902,107709,6,175855
31376,0.001746,74.125.68.0-255,1484,109193,6,175855
31377,0.001762,74.125.68.0-255,4320,113513,6,175855
31378,0.001777,74.125.68.0-255,4320,117833,6,175855
31379,0.001779,74.125.68.0-255,1484,119317,6,175855
31380,0.001783,74.125.68.0-255,2902,122219,6,175855
31381,0.001808,74.125.68.0-255,1484,123703,6,175855
31382,0.001819,74.125.68.0-255,2902,126605,6,175855
31383,0.001846,74.125.68.0-255,4320,130925,6,175855
31384,0.001898,74.125.68.0-255,3602,134527,6,175855
31385,0.002035,74.125.68.0-255,1484,136011,6,175855
31386,0.002038,74.125.68.0-255,1484,137495,6,175855
31387,0.002064,74.125.68.0-255,2902,140397,6,175855
31388,0.002094,74.125.68.0-255,1484,141881,6,175855
31389,0.002107,74.125.68.0-255,2902,144783,6,175855
31390,0.002124,74.125.68.0-255,5738,150521,6,175855
31391,0.002163,74.125.68.0-255,7156,157677,6,175855
31392,0.002174,74.125.68.0-255,1484,159161,6,175855
31393,0.002179,74.125.68.0-255,4320,163481,6,175855
31394,0.0022,74.125.68.0-255,5020,168501,6,175855
31395,0.002334,74.125.68.0-255,1484,169985,6,175855
31396,0.005758,172.31.36.0-255,66,170051,6,175855
31397,0.00808,74.125.68.0-255,5738,175789,6,175855
31398,0.008087,172.31.36.0-255,66,175855,6,175855
31399,0.0,74.125.200.0-255,146,146,6,129856
31400,1.3e-05,172.31.36.0-255,66,212,6,129856
31401,4.7e-05,74.125.200.0-255,1484,1696,6,129856
31402,5.2e-05,172.31.36.0-255,66,1762,6,129856
31403,6e-05,74.125.200.0-255,2902,4664,6,129856
31404,6.4e-05,172.31.36.0-255,66,4730,6,129856
31405,7.2e-05,74.125.200.0-255,7156,11886,6,129856
31406,7.7e-05,172.31.36.0-255,66,11952,6,129856
31407,0.000118,74.125.200.0-255,2010,13962,6,129856
31408,0.000121,172.31.36.0-255,66,14028,6,129856
31409,0.000148,74.125.200.0-255,2902,16930,6,129856
31410,0.000151,172.31.36.0-255,66,16996,6,129856
31411,0.000154,74.125.200.0-255,1484,18480,6,129856
31412,0.000156,172.31.36.0-255,66,18546,6,129856
31413,0.000201,74.125.200.0-255,2902,21448,6,129856
31414,0.000204,172.31.36.0-255,66,21514,6,129856
31415,0.000211,74.125.200.0-255,5738,27252,6,129856
31416,0.000213,172.31.36.0-255,66,27318,6,129856
31417,0.000218,74.125.200.0-255,3961,31279,6,129856
31418,0.000221,172.31.36.0-255,66,31345,6,129856
31419,0.000253,74.125.200.0-255,4320,35665,6,129856
31420,0.000256,172.31.36.0-255,66,35731,6,129856
31421,0.000261,74.125.200.0-255,4320,40051,6,129856
31422,0.000264,172.31.36.0-255,66,40117,6,129856
31423,0.000267,74.125.200.0-255,1484,41601,6,129856
31424,0.000268,172.31.36.0-255,66,41667,6,129856
31425,0.000301,74.125.200.0-255,4320,45987,6,129856
31426,0.000304,172.31.36.0-255,66,46053,6,129856
31427,0.000309,74.125.200.0-255,2543,48596,6,129856
31428,0.00031,172.31.36.0-255,66,48662,6,129856
31429,0.001501,74.125.200.0-255,1484,50146,6,129856
31430,0.001508,172.31.36.0-255,66,50212,6,129856
31431,0.001519,74.125.200.0-255,2902,53114,6,129856
31432,0.001521,172.31.36.0-255,66,53180,6,129856
31433,0.00153,74.125.200.0-255,1484,54664,6,129856
31434,0.001532,172.31.36.0-255,66,54730,6,129856
31435,0.001537,74.125.200.0-255,2902,57632,6,129856
31436,0.00156,74.125.200.0-255,4320,61952,6,129856
31437,0.001574,74.125.200.0-255,1484,63436,6,129856
31438,0.001577,74.125.200.0-255,1484,64920,6,129856
31439,0.0016,172.31.36.0-255,66,64986,6,129856
31440,0.001625,74.125.200.0-255,1125,66111,6,129856
31441,0.001749,172.31.36.0-255,66,66177,6,129856
31442,0.001947,74.125.200.0-255,1484,67661,6,129856
31443,0.001951,172.31.36.0-255,66,67727,6,129856
31444,0.001959,74.125.200.0-255,2902,70629,6,129856
31445,0.001963,74.125.200.0-255,1484,72113,6,129856
31446,0.001988,74.125.200.0-255,4320,76433,6,129856
31447,0.001992,74.125.200.0-255,2902,79335,6,129856
31448,0.002003,172.31.36.0-255,66,79401,6,129856
31449,0.002043,74.125.200.0-255,4320,83721,6,129856
31450,0.002065,172.31.36.0-255,66,83787,6,129856
31451,0.002094,74.125.200.0-255,5961,89748,6,129856
31452,0.002112,172.31.36.0-255,66,89814,6,129856
31453,0.002149,74.125.200.0-255,1484,91298,6,129856
31454,0.00217,74.125.200.0-255,2902,94200,6,129856
31455,0.002175,172.31.36.0-255,66,94266,6,129856
31456,0.002201,74.125.200.0-255,5738,100004,6,129856
31457,0.002209,74.125.200.0-255,7156,107160,6,129856
31458,0.002223,172.31.36.0-255,66,107226,6,129856
31459,0.002232,74.125.200.0-255,2902,110128,6,129856
31460,0.002236,172.31.36.0-255,66,110194,6,129856
31461,0.002285,74.125.200.0-255,2184,112378,6,129856
31462,0.002302,172.31.36.0-255,66,112444,6,129856
31463,0.004636,74.125.200.0-255,5738,118182,6,129856
31464,0.004642,172.31.36.0-255,66,118248,6,129856
31465,0.006968,74.125.200.0-255,5738,123986,6,129856
31466,0.006974,172.31.36.0-255,66,124052,6,129856
31467,0.009303,74.125.200.0-255,5738,129790,6,129856
31468,0.009311,172.31.36.0-255,66,129856,6,129856
31469,0.0,172.217.194.0-255,152,152,6,281340
31470,3.4e-05,172.31.36.0-255,66,218,6,281340
31471,4.1e-05,172.217.194.0-255,1484,1702,6,281340
31472,4.5e-05,172.31.36.0-255,66,1768,6,281340
31473,5e-05,172.217.194.0-255,2902,4670,6,281340
31474,5.2e-05,172.31.36.0-255,66,4736,6,281340
31475,6e-05,172.217.194.0-255,7156,11892,6,281340
31476,6.2e-05,172.31.36.0-255,66,11958,6,281340
31477,6.7e-05,172.217.194.0-255,2049,14007,6,281340
31478,7e-05,172.31.36.0-255,66,14073,6,281340
31479,0.00011,172.217.194.0-255,5738,19811,6,281340
31480,0.000114,172.31.36.0-255,66,19877,6,281340
31481,0.000138,172.217.194.0-255,5738,25615,6,281340
31482,0.000141,172.31.36.0-255,66,25681,6,281340
31483,0.000147,172.217.194.0-255,5379,31060,6,281340
31484,0.000149,172.31.36.0-255,66,31126,6,281340
31485,0.000222,172.217.194.0-255,1484,32610,6,281340
31486,0.000225,172.31.36.0-255,66,32676,6,281340
31487,0.000231,172.217.194.0-255,2902,35578,6,281340
31488,0.000233,172.31.36.0-255,66,35644,6,281340
31489,0.00024,172.217.194.0-255,5738,41382,6,281340
31490,0.000242,172.31.36.0-255,66,41448,6,281340
31491,0.000271,172.217.194.0-255,5738,47186,6,281340
31492,0.000273,172.31.36.0-255,66,47252,6,281340
31493,0.0003,172.217.194.0-255,7156,54408,6,281340
31494,0.000303,172.31.36.0-255,66,54474,6,281340
31495,0.000312,172.217.194.0-255,9992,64466,6,281340
31496,0.000314,172.31.36.0-255,66,64532,6,281340
31497,0.000317,172.217.194.0-255,1096,65628,6,281340
31498,0.000318,172.31.36.0-255,66,65694,6,281340
31499,0.000627,172.217.194.0-255,1484,67178,6,281340
31500,0.000632,172.31.36.0-255,66,67244,6,281340
31501,0.000637,172.217.194.0-255,2902,70146,6,281340
31502,0.000645,172.217.194.0-255,5738,75884,6,281340
31503,0.000648,172.31.36.0-255,66,75950,6,281340
31504,0.000654,172.31.36.0-255,66,76016,6,281340
31505,0.000671,172.217.194.0-255,4320,80336,6,281340
31506,0.00068,172.31.36.0-255,66,80402,6,281340
31507,0.000695,172.217.194.0-255,8574,88976,6,281340
31508,0.000704,172.217.194.0-255,10692,99668,6,281340
31509,0.000712,172.31.36.0-255,66,99734,6,281340
31510,0.000716,172.217.194.0-255,379,100113,6,281340
31511,0.001134,172.31.36.0-255,66,100179,6,281340
31512,0.001155,172.217.194.0-255,1484,101663,6,281340
31513,0.001159,172.217.194.0-255,1484,103147,6,281340
31514,0.001185,172.217.194.0-255,1484,104631,6,281340
31515,0.001191,172.217.194.0-255,4320,108951,6,281340
31516,0.001201,172.217.194.0-255,1484,110435,6,281340
31517,0.00121,172.31.36.0-255,66,110501,6,281340
31518,0.001229,172.217.194.0-255,2902,113403,6,281340
31519,0.001256,172.31.36.0-255,66,113469,6,281340
31520,0.001259,172.217.194.0-255,9992,123461,6,281340
31521,0.001269,172.31.36.0-255,66,123527,6,281340
31522,0.001292,172.217.194.0-255,4320,127847,6,281340
31523,0.001301,172.31.36.0-255,66,127913,6,281340
31524,0.001321,172.217.194.0-255,6438,134351,6,281340
31525,0.001331,172.31.36.0-255,66,134417,6,281340
31526,0.001336,172.31.36.0-255,66,134483,6,281340
31527,0.00135,172.31.36.0-255,66,134549,6,281340
31528,0.001352,172.217.194.0-255,5738,140287,6,281340
31529,0.001364,172.31.36.0-255,66,140353,6,281340
31530,0.001394,172.31.36.0-255,66,140419,6,281340
31531,0.001405,172.217.194.0-255,5738,146157,6,281340
31532,0.001409,172.217.194.0-255,2902,149059,6,281340
31533,0.00141,172.31.36.0-255,66,149125,6,281340
31534,0.001414,172.31.36.0-255,66,149191,6,281340
31535,0.001441,172.217.194.0-255,7856,157047,6,281340
31536,0.00145,172.31.36.0-255,66,157113,6,281340
31537,0.001464,172.217.194.0-255,1484,158597,6,281340
31538,0.001483,172.217.194.0-255,2902,161499,6,281340
31539,0.001487,172.217.194.0-255,1484,162983,6,281340
31540,0.001489,172.31.36.0-255,66,163049,6,281340
31541,0.001507,172.217.194.0-255,4320,167369,6,281340
31542,0.001513,172.217.194.0-255,4320,171689,6,281340
31543,0.001515,172.31.36.0-255,66,171755,6,281340
31544,0.00152,172.31.36.0-255,66,171821,6,281340
31545,0.001569,172.217.194.0-255,2902,174723,6,281340
31546,0.001584,172.31.36.0-255,66,174789,6,281340
31547,0.001593,172.217.194.0-255,7156,181945,6,281340
31548,0.001598,172.31.36.0-255,66,182011,6,281340
31549,0.001626,172.217.194.0-255,9274,191285,6,281340
31550,0.001633,172.31.36.0-255,66,191351,6,281340
31551,0.001707,172.217.194.0-255,1484,192835,6,281340
31552,0.001721,172.217.194.0-255,2902,195737,6,281340
31553,0.001726,172.217.194.0-255,5738,201475,6,281340
31554,0.001737,172.31.36.0-255,66,201541,6,281340
31555,0.001753,172.217.194.0-255,2902,204443,6,281340
31556,0.001763,172.31.36.0-255,66,204509,6,281340
31557,0.001787,172.217.194.0-255,9992,214501,6,281340
31558,0.00179,172.217.194.0-255,1484,215985,6,281340
31559,0.001791,172.31.36.0-255,66,216051,6,281340
31560,0.001848,172.217.194.0-255,5738,221789,6,281340
31561,0.001852,172.31.36.0-255,66,221855,6,281340
31562,0.001879,172.217.194.0-255,3602,225457,6,281340
31563,0.001888,172.217.194.0-255,9992,235449,6,281340
31564,0.00189,172.31.36.0-255,66,235515,6,281340
31565,0.001894,172.217.194.0-255,5738,241253,6,281340
31566,0.001895,172.31.36.0-255,66,241319,6,281340
31567,0.001909,172.31.36.0-255,66,241385,6,281340
31568,0.001917,172.217.194.0-255,8574,249959,6,281340
31569,0.001921,172.31.36.0-255,66,250025,6,281340
31570,0.001949,172.217.194.0-255,8574,258599,6,281340
31571,0.001954,172.217.194.0-255,3602,262201,6,281340
31572,0.001957,172.31.36.0-255,66,262267,6,281340
31573,0.001962,172.31.36.0-255,66,262333,6,281340
31574,0.002004,172.217.194.0-255,2902,265235,6,281340
31575,0.002022,172.31.36.0-255,66,265301,6,281340
31576,0.002037,172.31.36.0-255,66,265367,6,281340
31577,0.002041,172.217.194.0-255,7856,273223,6,281340
31578,0.002043,172.217.194.0-255,1484,274707,6,281340
31579,0.002054,172.31.36.0-255,66,274773,6,281340
31580,0.00208,172.31.36.0-255,66,274839,6,281340
31581,0.002119,172.31.36.0-255,66,274905,6,281340
31582,0.002135,172.31.36.0-255,66,274971,6,281340
31583,0.002155,172.217.194.0-255,5020,279991,6,281340
31584,0.002159,172.217.194.0-255,1007,280998,6,281340
31585,0.00216,172.31.36.0-255,66,281064,6,281340
31586,0.002223,172.217.194.0-255,105,281169,6,281340
31587,0.003733,172.31.36.0-255,66,281235,6,281340
31588,0.007901,172.31.36.0-255,105,281340,6,281340
31589,0.0,172.217.160.0-255,153,153,6,191695
31590,1.6e-05,172.31.36.0-255,66,219,6,191695
31591,2.1e-05,172.217.160.0-255,1484,1703,6,191695
31592,2.5e-05,172.31.36.0-255,66,1769,6,191695
31593,4.7e-05,172.217.160.0-255,2902,4671,6,191695
31594,4.9e-05,172.31.36.0-255,66,4737,6,191695
31595,5.5e-05,172.217.160.0-255,4320,9057,6,191695
31596,5.8e-05,172.31.36.0-255,66,9123,6,191695
31597,8.4e-05,172.217.160.0-255,2902,12025,6,191695
31598,8.7e-05,172.31.36.0-255,66,12091,6,191695
31599,9.2e-05,172.217.160.0-255,4320,16411,6,191695
31600,9.5e-05,172.31.36.0-255,66,16477,6,191695
31601,0.000111,172.217.160.0-255,3485,19962,6,191695
31602,0.000114,172.31.36.0-255,66,20028,6,191695
31603,0.000123,172.217.160.0-255,8574,28602,6,191695
31604,0.000127,172.31.36.0-255,66,28668,6,191695
31605,0.000158,172.217.160.0-255,2543,31211,6,191695
31606,0.000161,172.31.36.0-255,66,31277,6,191695
31607,0.000167,172.217.160.0-255,2902,34179,6,191695
31608,0.000168,172.31.36.0-255,66,34245,6,191695
31609,0.000176,172.217.160.0-255,7156,41401,6,191695
31610,0.000179,172.31.36.0-255,66,41467,6,191695
31611,0.000221,172.217.160.0-255,5738,47205,6,191695
31612,0.000225,172.31.36.0-255,66,47271,6,191695
31613,0.000239,172.217.160.0-255,1125,48396,6,191695
31614,0.000242,172.31.36.0-255,66,48462,6,191695
31615,0.000413,172.217.160.0-255,1484,49946,6,191695
31616,0.000418,172.31.36.0-255,66,50012,6,191695
31617,0.000424,172.217.160.0-255,2902,52914,6,191695
31618,0.000428,172.31.36.0-255,66,52980,6,191695
31619,0.000434,172.217.160.0-255,5738,58718,6,191695
31620,0.000436,172.31.36.0-255,66,58784,6,191695
31621,0.000446,172.217.160.0-255,6797,65581,6,191695
31622,0.000449,172.31.36.0-255,66,65647,6,191695
31623,0.000465,172.217.160.0-255,375,66022,6,191695
31624,0.000665,172.217.160.0-255,102,66124,6,191695
31625,0.000783,172.217.160.0-255,1484,67608,6,191695
31626,0.000789,172.217.160.0-255,2902,70510,6,191695
31627,0.000802,172.217.160.0-255,1484,71994,6,191695
31628,0.000815,172.31.36.0-255,66,72060,6,191695
31629,0.000828,172.217.160.0-255,4320,76380,6,191695
31630,0.000833,172.217.160.0-255,4320,80700,6,191695
31631,0.000845,172.31.36.0-255,66,80766,6,191695
31632,0.000863,172.217.160.0-255,5738,86504,6,191695
31633,0.000893,172.217.160.0-255,2543,89047,6,191695
31634,0.000896,172.31.36.0-255,66,89113,6,191695
31635,0.000903,172.31.36.0-255,66,89179,6,191695
31636,0.001298,172.217.160.0-255,1484,90663,6,191695
31637,0.001304,172.217.160.0-255,2902,93565,6,191695
31638,0.001308,172.31.36.0-255,66,93631,6,191695
31639,0.001315,172.217.160.0-255,4320,97951,6,191695
31640,0.00133,172.217.160.0-255,1484,99435,6,191695
31641,0.001337,172.31.36.0-255,66,99501,6,191695
31642,0.001361,172.217.160.0-255,2902,102403,6,191695
31643,0.001378,172.217.160.0-255,4320,106723,6,191695
31644,0.001385,172.217.160.0-255,7156,113879,6,191695
31645,0.001392,172.31.36.0-255,66,113945,6,191695
31646,0.001401,172.217.160.0-255,1484,115429,6,191695
31647,0.001407,172.217.160.0-255,5738,121167,6,191695
31648,0.001413,172.31.36.0-255,66,121233,6,191695
31649,0.001429,172.217.160.0-255,2184,123417,6,191695
31650,0.001443,172.217.160.0-255,1484,124901,6,191695
31651,0.001451,172.31.36.0-255,66,124967,6,191695
31652,0.00146,172.217.160.0-255,1484,126451,6,191695
31653,0.001473,172.217.160.0-255,1484,127935,6,191695
31654,0.001491,172.217.160.0-255,4320,132255,6,191695
31655,0.001497,172.31.36.0-255,66,132321,6,191695
31656,0.001509,172.217.160.0-255,1484,133805,6,191695
31657,0.001533,172.217.160.0-255,1484,135289,6,191695
31658,0.001537,172.217.160.0-255,1484,136773,6,191695
31659,0.001544,172.31.36.0-255,66,136839,6,191695
31660,0.001554,172.217.160.0-255,1484,138323,6,191695
31661,0.001557,172.217.160.0-255,1484,139807,6,191695
31662,0.001572,172.217.160.0-255,4320,144127,6,191695
31663,0.001578,172.217.160.0-255,4320,148447,6,191695
31664,0.001607,172.31.36.0-255,66,148513,6,191695
31665,0.001615,172.217.160.0-255,7156,155669,6,191695
31666,0.00162,172.31.36.0-255,66,155735,6,191695
31667,0.001632,172.217.160.0-255,5020,160755,6,191695
31668,0.00166,172.217.160.0-255,1484,162239,6,191695
31669,0.001698,172.217.160.0-255,9274,171513,6,191695
31670,0.001719,172.217.160.0-255,8574,180087,6,191695
31671,0.001733,172.31.36.0-255,66,180153,6,191695
31672,0.003403,172.217.160.0-255,5738,185891,6,191695
31673,0.00341,172.31.36.0-255,66,185957,6,191695
31674,0.005061,172.217.160.0-255,5738,191695,6,191695
31675,0.0,74.125.24.0-255,298,298,6,347738
31676,3.4e-05,172.31.36.0-255,66,364,6,347738
31677,4.1e-05,74.125.24.0-255,1484,1848,6,347738
31678,4.5e-05,172.31.36.0-255,66,1914,6,347738
31679,5.1e-05,74.125.24.0-255,4320,6234,6,347738
31680,5.4e-05,172.31.36.0-255,66,6300,6,347738
31681,5.8e-05,74.125.24.0-255,2902,9202,6,347738
31682,6.1e-05,172.31.36.0-255,66,9268,6,347738
31683,6.8e-05,74.125.24.0-255,4320,13588,6,347738
31684,7e-05,172.31.36.0-255,66,13654,6,347738
31685,7.3e-05,74.125.24.0-255,423,14077,6,347738
31686,7.5e-05,172.31.36.0-255,66,14143,6,347738
31687,0.000132,74.125.24.0-255,1484,15627,6,347738
31688,0.000135,172.31.36.0-255,66,15693,6,347738
31689,0.000156,74.125.24.0-255,2902,18595,6,347738
31690,0.000159,172.31.36.0-255,66,18661,6,347738
31691,0.000168,74.125.24.0-255,5738,24399,6,347738
31692,0.00017,172.31.36.0-255,66,24465,6,347738
31693,0.000194,74.125.24.0-255,6797,31262,6,347738
31694,0.000197,172.31.36.0-255,66,31328,6,347738
31695,0.000244,74.125.24.0-255,1484,32812,6,347738
31696,0.000247,172.31.36.0-255,66,32878,6,347738
31697,0.000265,74.125.24.0-255,2902,35780,6,347738
31698,0.000267,172.31.36.0-255,66,35846,6,347738
31699,0.000272,74.125.24.0-255,2902,38748,6,347738
31700,0.000274,172.31.36.0-255,66,38814,6,347738
31701,0.00029,74.125.24.0-255,2902,41716,6,347738
31702,0.000293,172.31.36.0-255,66,41782,6,347738
31703,0.000297,74.125.24.0-255,2902,44684,6,347738
31704,0.0003,172.31.36.0-255,66,44750,6,347738
31705,0.000339,74.125.24.0-255,1484,46234,6,347738
31706,0.000341,172.31.36.0-255,66,46300,6,347738
31707,0.000363,74.125.24.0-255,2543,48843,6,347738
31708,0.000367,172.31.36.0-255,66,48909,6,347738
31709,0.000372,74.125.24.0-255,4320,53229,6,347738
31710,0.000375,172.31.36.0-255,66,53295,6,347738
31711,0.000377,74.125.24.0-255,1484,54779,6,347738
31712,0.000408,74.125.24.0-255,8574,63353,6,347738
31713,0.000411,172.31.36.0-255,66,63419,6,347738
31714,0.000449,74.125.24.0-255,2543,65962,6,347738
31715,0.000455,172.31.36.0-255,66,66028,6,347738
31716,0.000511,74.125.24.0-255,647,66675,6,347738
31717,0.000553,74.125.24.0-255,1484,68159,6,347738
31718,0.000557,172.31.36.0-255,66,68225,6,347738
31719,0.000562,74.125.24.0-255,2902,71127,6,347738
31720,0.000564,172.31.36.0-255,66,71193,6,347738
31721,0.00057,74.125.24.0-255,5738,76931,6,347738
31722,0.000573,172.31.36.0-255,66,76997,6,347738
31723,0.000595,74.125.24.0-255,2902,79899,6,347738
31724,0.000599,172.31.36.0-255,66,79965,6,347738
31725,0.000619,74.125.24.0-255,3961,83926,6,347738
31726,0.000622,172.31.36.0-255,66,83992,6,347738
31727,0.000626,74.125.24.0-255,2902,86894,6,347738
31728,0.000629,172.31.36.0-255,66,86960,6,347738
31729,0.000645,74.125.24.0-255,4320,91280,6,347738
31730,0.000649,172.31.36.0-255,66,91346,6,347738
31731,0.000657,74.125.24.0-255,9633,100979,6,347738
31732,0.000661,172.31.36.0-255,66,101045,6,347738
31733,0.000941,74.125.24.0-255,1484,102529,6,347738
31734,0.000947,74.125.24.0-255,2902,105431,6,347738
31735,0.00095,172.31.36.0-255,66,105497,6,347738
31736,0.000974,74.125.24.0-255,5738,111235,6,347738
31737,0.000978,172.31.36.0-255,66,111301,6,347738
31738,0.000983,74.125.24.0-255,4320,115621,6,347738
31739,0.000985,172.31.36.0-255,66,115687,6,347738
31740,0.00101,74.125.24.0-255,8574,124261,6,347738
31741,0.001013,172.31.36.0-255,66,124327,6,347738
31742,0.001019,74.125.24.0-255,5738,130065,6,347738
31743,0.001021,172.31.36.0-255,66,130131,6,347738
31744,0.001085,74.125.24.0-255,4320,134451,6,347738
31745,0.001089,172.31.36.0-255,66,134517,6,347738
31746,0.001102,74.125.24.0-255,766,135283,6,347738
31747,0.001167,74.125.24.0-255,1484,136767,6,347738
31748,0.00117,172.31.36.0-255,66,136833,6,347738
31749,0.001189,74.125.24.0-255,2902,139735,6,347738
31750,0.001192,172.31.36.0-255,66,139801,6,347738
31751,0.001212,74.125.24.0-255,5738,145539,6,347738
31752,0.001215,172.31.36.0-255,66,145605,6,347738
31753,0.001238,74.125.24.0-255,2902,148507,6,347738
31754,0.001241,172.31.36.0-255,66,148573,6,347738
31755,0.00126,74.125.24.0-255,7156,155729,6,347738
31756,0.001264,172.31.36.0-255,66,155795,6,347738
31757,0.001265,74.125.24.0-255,5738,161533,6,347738
31758,0.001267,172.31.36.0-255,66,161599,6,347738
31759,0.001285,74.125.24.0-255,1484,163083,6,347738
31760,0.001311,74.125.24.0-255,4320,167403,6,347738
31761,0.001315,172.31.36.0-255,66,167469,6,347738
31762,0.001333,74.125.24.0-255,2184,169653,6,347738
31763,0.001335,172.31.36.0-255,66,169719,6,347738
31764,0.001448,74.125.24.0-255,1484,171203,6,347738
31765,0.001453,74.125.24.0-255,2902,174105,6,347738
31766,0.001456,172.31.36.0-255,66,174171,6,347738
31767,0.001477,74.125.24.0-255,1484,175655,6,347738
31768,0.001492,74.125.24.0-255,2902,178557,6,347738
31769,0.001495,172.31.36.0-255,66,178623,6,347738
31770,0.001529,74.125.24.0-255,5738,184361,6,347738
31771,0.001532,172.31.36.0-255,66,184427,6,347738
31772,0.001541,74.125.24.0-255,9992,194419,6,347738
31773,0.001543,172.31.36.0-255,66,194485,6,347738
31774,0.001561,74.125.24.0-255,5738,200223,6,347738
31775,0.001563,172.31.36.0-255,66,200289,6,347738
31776,0.001585,74.125.24.0-255,3602,203891,6,347738
31777,0.001588,172.31.36.0-255,66,203957,6,347738
31778,0.001621,74.125.24.0-255,4320,208277,6,347738
31779,0.001624,172.31.36.0-255,66,208343,6,347738
31780,0.001646,74.125.24.0-255,5738,214081,6,347738
31781,0.001648,172.31.36.0-255,66,214147,6,347738
31782,0.001665,74.125.24.0-255,4320,218467,6,347738
31783,0.001667,172.31.36.0-255,66,218533,6,347738
31784,0.001698,74.125.24.0-255,7156,225689,6,347738
31785,0.001701,172.31.36.0-255,66,225755,6,347738
31786,0.001716,172.31.36.0-255,66,225821,6,347738
31787,0.001805,74.125.24.0-255,1484,227305,6,347738
31788,0.001826,74.125.24.0-255,2902,230207,6,347738
31789,0.001829,172.31.36.0-255,66,230273,6,347738
31790,0.001836,74.125.24.0-255,5738,236011,6,347738
31791,0.001838,172.31.36.0-255,66,236077,6,347738
31792,0.001865,74.125.24.0-255,7156,243233,6,347738
31793,0.001869,172.31.36.0-255,66,243299,6,347738
31794,0.001873,74.125.24.0-255,1484,244783,6,347738
31795,0.001902,74.125.24.0-255,8574,253357,6,347738
31796,0.001904,172.31.36.0-255,66,253423,6,347738
31797,0.001922,74.125.24.0-255,4320,257743,6,347738
31798,0.001925,172.31.36.0-255,66,257809,6,347738
31799,0.00193,74.125.24.0-255,2184,259993,6,347738
31800,0.001933,172.31.36.0-255,66,260059,6,347738
31801,0.001981,74.125.24.0-255,1484,261543,6,347738
31802,0.001996,74.125.24.0-255,2902,264445,6,347738
31803,0.001999,172.31.36.0-255,66,264511,6,347738
31804,0.002024,74.125.24.0-255,5738,270249,6,347738
31805,0.002027,172.31.36.0-255,66,270315,6,347738
31806,0.002035,74.125.24.0-255,7156,277471,6,347738
31807,0.002038,172.31.36.0-255,66,277537,6,347738
31808,0.002056,74.125.24.0-255,5738,283275,6,347738
31809,0.002059,172.31.36.0-255,66,283341,6,347738
31810,0.002064,74.125.24.0-255,2902,286243,6,347738
31811,0.002067,172.31.36.0-255,66,286309,6,347738
31812,0.00207,74.125.24.0-255,1484,287793,6,347738
31813,0.002086,74.125.24.0-255,1484,289277,6,347738
31814,0.002089,172.31.36.0-255,66,289343,6,347738
31815,0.002106,74.125.24.0-255,2902,292245,6,347738
31816,0.002109,172.31.36.0-255,66,292311,6,347738
31817,0.002129,74.125.24.0-255,2184,294495,6,347738
31818,0.002131,172.31.36.0-255,66,294561,6,347738
31819,0.002236,74.125.24.0-255,1484,296045,6,347738
31820,0.002252,74.125.24.0-255,2902,298947,6,347738
31821,0.002256,172.31.36.0-255,66,299013,6,347738
31822,0.002262,74.125.24.0-255,4320,303333,6,347738
31823,0.002265,172.31.36.0-255,66,303399,6,347738
31824,0.002278,74.125.24.0-255,1484,304883,6,347738
31825,0.002281,74.125.24.0-255,1484,306367,6,347738
31826,0.002283,172.31.36.0-255,66,306433,6,347738
31827,0.002345,172.31.36.0-255,66,306499,6,347738
31828,0.002359,74.125.24.0-255,1484,307983,6,347738
31829,0.002368,74.125.24.0-255,7156,315139,6,347738
31830,0.002371,172.31.36.0-255,66,315205,6,347738
31831,0.002375,74.125.24.0-255,2184,317389,6,347738
31832,0.002377,172.31.36.0-255,66,317455,6,347738
31833,0.002405,74.125.24.0-255,5738,323193,6,347738
31834,0.002409,172.31.36.0-255,66,323259,6,347738
31835,0.002436,172.31.36.0-255,66,323325,6,347738
31836,0.00244,74.125.24.0-255,1484,324809,6,347738
31837,0.002445,74.125.24.0-255,2902,327711,6,347738
31838,0.002447,172.31.36.0-255,66,327777,6,347738
31839,0.002485,172.31.36.0-255,66,327843,6,347738
31840,0.002505,74.125.24.0-255,2184,330027,6,347738
31841,0.002509,172.31.36.0-255,66,330093,6,347738
31842,0.002518,74.125.24.0-255,7156,337249,6,347738
31843,0.00252,172.31.36.0-255,66,337315,6,347738
31844,0.002554,74.125.24.0-255,9984,347299,6,347738
31845,0.002558,172.31.36.0-255,66,347365,6,347738
31846,0.002561,74.125.24.0-255,97,347462,6,347738
31847,0.002576,74.125.24.0-255,105,347567,6,347738
31848,0.009815,172.31.36.0-255,66,347633,6,347738
31849,0.009847,172.31.36.0-255,105,347738,6,347738
31850,0.0,74.125.24.0-255,153,153,6,229208
31851,2.2e-05,172.31.36.0-255,66,219,6,229208
31852,2.9e-05,74.125.24.0-255,1484,1703,6,229208
31853,3.3e-05,172.31.36.0-255,66,1769,6,229208
31854,3.9e-05,74.125.24.0-255,2902,4671,6,229208
31855,4.3e-05,172.31.36.0-255,66,4737,6,229208
31856,5.1e-05,74.125.24.0-255,7156,11893,6,229208
31857,5.3e-05,172.31.36.0-255,66,11959,6,229208
31858,5.7e-05,74.125.24.0-255,1484,13443,6,229208
31859,5.9e-05,172.31.36.0-255,66,13509,6,229208
31860,8.2e-05,74.125.24.0-255,585,14094,6,229208
31861,8.5e-05,172.31.36.0-255,66,14160,6,229208
31862,0.000328,74.125.24.0-255,1484,15644,6,229208
31863,0.000334,172.31.36.0-255,66,15710,6,229208
31864,0.00034,74.125.24.0-255,2902,18612,6,229208
31865,0.000342,172.31.36.0-255,66,18678,6,229208
31866,0.000349,74.125.24.0-255,5738,24416,6,229208
31867,0.000352,172.31.36.0-255,66,24482,6,229208
31868,0.000395,74.125.24.0-255,6797,31279,6,229208
31869,0.000398,172.31.36.0-255,66,31345,6,229208
31870,0.000405,74.125.24.0-255,7156,38501,6,229208
31871,0.000408,172.31.36.0-255,66,38567,6,229208
31872,0.000447,74.125.24.0-255,8574,47141,6,229208
31873,0.00045,172.31.36.0-255,66,47207,6,229208
31874,0.000453,74.125.24.0-255,1125,48332,6,229208
31875,0.000455,172.31.36.0-255,66,48398,6,229208
31876,0.000521,74.125.24.0-255,1484,49882,6,229208
31877,0.000524,172.31.36.0-255,66,49948,6,229208
31878,0.000548,74.125.24.0-255,2902,52850,6,229208
31879,0.000551,172.31.36.0-255,66,52916,6,229208
31880,0.000557,74.125.24.0-255,5738,58654,6,229208
31881,0.00056,172.31.36.0-255,66,58720,6,229208
31882,0.000566,74.125.24.0-255,5738,64458,6,229208
31883,0.000568,172.31.36.0-255,66,64524,6,229208
31884,0.000615,74.125.24.0-255,1461,65985,6,229208
31885,0.000696,74.125.24.0-255,1484,67469,6,229208
31886,0.0007,172.31.36.0-255,66,67535,6,229208
31887,0.000706,74.125.24.0-255,2902,70437,6,229208
31888,0.000709,172.31.36.0-255,66,70503,6,229208
31889,0.000746,74.125.24.0-255,5738,76241,6,229208
31890,0.000749,172.31.36.0-255,66,76307,6,229208
31891,0.000756,74.125.24.0-255,7156,83463,6,229208
31892,0.000759,172.31.36.0-255,66,83529,6,229208
31893,0.000777,74.125.24.0-255,6797,90326,6,229208
31894,0.000785,74.125.24.0-255,7156,97482,6,229208
31895,0.00079,172.31.36.0-255,66,97548,6,229208
31896,0.000793,172.31.36.0-255,66,97614,6,229208
31897,0.000821,74.125.24.0-255,2543,100157,6,229208
31898,0.000824,172.31.36.0-255,66,100223,6,229208
31899,0.000866,74.125.24.0-255,351,100574,6,229208
31900,0.001132,74.125.24.0-255,1484,102058,6,229208
31901,0.001137,172.31.36.0-255,66,102124,6,229208
31902,0.001143,74.125.24.0-255,2902,105026,6,229208
31903,0.001145,172.31.36.0-255,66,105092,6,229208
31904,0.001184,74.125.24.0-255,5738,110830,6,229208
31905,0.001187,172.31.36.0-255,66,110896,6,229208
31906,0.001192,74.125.24.0-255,2902,113798,6,229208
31907,0.001194,172.31.36.0-255,66,113864,6,229208
31908,0.001204,74.125.24.0-255,9992,123856,6,229208
31909,0.001206,172.31.36.0-255,66,123922,6,229208
31910,0.001242,74.125.24.0-255,10692,134614,6,229208
31911,0.001245,172.31.36.0-255,66,134680,6,229208
31912,0.001888,74.125.24.0-255,1484,136164,6,229208
31913,0.001897,74.125.24.0-255,2902,139066,6,229208
31914,0.001901,172.31.36.0-255,66,139132,6,229208
31915,0.001915,74.125.24.0-255,1484,140616,6,229208
31916,0.001933,74.125.24.0-255,4320,144936,6,229208
31917,0.001935,172.31.36.0-255,66,145002,6,229208
31918,0.00194,74.125.24.0-255,2902,147904,6,229208
31919,0.001942,172.31.36.0-255,66,147970,6,229208
31920,0.001955,74.125.24.0-255,2902,150872,6,229208
31921,0.001957,172.31.36.0-255,66,150938,6,229208
31922,0.001978,74.125.24.0-255,7156,158094,6,229208
31923,0.00198,172.31.36.0-255,66,158160,6,229208
31924,0.001987,74.125.24.0-255,5738,163898,6,229208
31925,0.001989,172.31.36.0-255,66,163964,6,229208
31926,0.00201,74.125.24.0-255,5020,168984,6,229208
31927,0.002013,172.31.36.0-255,66,169050,6,229208
31928,0.002138,74.125.24.0-255,1484,170534,6,229208
31929,0.002156,74.125.24.0-255,2902,173436,6,229208
31930,0.00216,172.31.36.0-255,66,173502,6,229208
31931,0.002167,74.125.24.0-255,5738,179240,6,229208
31932,0.002169,172.31.36.0-255,66,179306,6,229208
31933,0.002194,74.125.24.0-255,7156,186462,6,229208
31934,0.002196,172.31.36.0-255,66,186528,6,229208
31935,0.002231,74.125.24.0-255,8574,195102,6,229208
31936,0.002234,172.31.36.0-255,66,195168,6,229208
31937,0.002244,74.125.24.0-255,7856,203024,6,229208
31938,0.002246,172.31.36.0-255,66,203090,6,229208
31939,0.002255,74.125.24.0-255,8574,211664,6,229208
31940,0.002257,172.31.36.0-255,66,211730,6,229208
31941,0.002321,172.31.36.0-255,66,211796,6,229208
31942,0.004551,74.125.24.0-255,5738,217534,6,229208
31943,0.004558,172.31.36.0-255,66,217600,6,229208
31944,0.006768,74.125.24.0-255,5738,223338,6,229208
31945,0.006773,172.31.36.0-255,66,223404,6,229208
31946,0.008992,74.125.24.0-255,5738,229142,6,229208
31947,0.008998,172.31.36.0-255,66,229208,6,229208
31948,0.0,74.125.24.0-255,153,153,6,277050
31949,2.3e-05,172.31.36.0-255,66,219,6,277050
31950,3e-05,74.125.24.0-255,1484,1703,6,277050
31951,3.5e-05,172.31.36.0-255,66,1769,6,277050
31952,3.9e-05,74.125.24.0-255,1484,3253,6,277050
31953,4.2e-05,172.31.36.0-255,66,3319,6,277050
31954,5.9e-05,74.125.24.0-255,4320,7639,6,277050
31955,6.2e-05,172.31.36.0-255,66,7705,6,277050
31956,7.1e-05,74.125.24.0-255,10593,18298,6,277050
31957,7.4e-05,172.31.36.0-255,66,18364,6,277050
31958,9.9e-05,74.125.24.0-255,2902,21266,6,277050
31959,0.000101,172.31.36.0-255,66,21332,6,277050
31960,0.000134,74.125.24.0-255,8574,29906,6,277050
31961,0.000138,172.31.36.0-255,66,29972,6,277050
31962,0.000141,74.125.24.0-255,1125,31097,6,277050
31963,0.000143,172.31.36.0-255,66,31163,6,277050
31964,0.000257,74.125.24.0-255,1484,32647,6,277050
31965,0.000262,172.31.36.0-255,66,32713,6,277050
31966,0.000267,74.125.24.0-255,2902,35615,6,277050
31967,0.000269,172.31.36.0-255,66,35681,6,277050
31968,0.000275,74.125.24.0-255,5738,41419,6,277050
31969,0.000282,172.31.36.0-255,66,41485,6,277050
31970,0.000306,74.125.24.0-255,7156,48641,6,277050
31971,0.000309,172.31.36.0-255,66,48707,6,277050
31972,0.000339,74.125.24.0-255,5738,54445,6,277050
31973,0.000342,172.31.36.0-255,66,54511,6,277050
31974,0.000349,74.125.24.0-255,7156,61667,6,277050
31975,0.000351,172.31.36.0-255,66,61733,6,277050
31976,0.000381,74.125.24.0-255,3900,65633,6,277050
31977,0.000383,172.31.36.0-255,66,65699,6,277050
31978,0.001068,74.125.24.0-255,128,65827,6,277050
31979,0.001074,172.31.36.0-255,66,65893,6,277050
31980,0.001099,74.125.24.0-255,351,66244,6,277050
31981,0.001132,172.31.36.0-255,66,66310,6,277050
31982,0.001683,74.125.24.0-255,1484,67794,6,277050
31983,0.001694,74.125.24.0-255,2902,70696,6,277050
31984,0.001699,172.31.36.0-255,66,70762,6,277050
31985,0.001706,74.125.24.0-255,4320,75082,6,277050
31986,0.001708,172.31.36.0-255,66,75148,6,277050
31987,0.001732,74.125.24.0-255,1484,76632,6,277050
31988,0.001748,74.125.24.0-255,9992,86624,6,277050
31989,0.00175,172.31.36.0-255,66,86690,6,277050
31990,0.001759,74.125.24.0-255,8574,95264,6,277050
31991,0.001762,172.31.36.0-255,66,95330,6,277050
31992,0.001788,74.125.24.0-255,2902,98232,6,277050
31993,0.001791,172.31.36.0-255,66,98298,6,277050
31994,0.001796,74.125.24.0-255,2184,100482,6,277050
31995,0.001798,172.31.36.0-255,66,100548,6,277050
31996,0.002002,74.125.24.0-255,1484,102032,6,277050
31997,0.002008,74.125.24.0-255,2902,104934,6,277050
31998,0.00201,172.31.36.0-255,66,105000,6,277050
31999,0.002017,74.125.24.0-255,5738,110738,6,277050
32000,0.002019,172.31.36.0-255,66,110804,6,277050
32001,0.00205,74.125.24.0-255,8574,119378,6,277050
32002,0.002052,172.31.36.0-255,66,119444,6,277050
32003,0.002098,74.125.24.0-255,7156,126600,6,277050
32004,0.0021,172.31.36.0-255,66,126666,6,277050
32005,0.002124,74.125.24.0-255,2902,129568,6,277050
32006,0.002126,172.31.36.0-255,66,129634,6,277050
32007,0.002132,74.125.24.0-255,5020,134654,6,277050
32008,0.002134,172.31.36.0-255,66,134720,6,277050
32009,0.002137,74.125.24.0-255,1484,136204,6,277050
32010,0.002143,74.125.24.0-255,2902,139106,6,277050
32011,0.002145,172.31.36.0-255,66,139172,6,277050
32012,0.002148,74.125.24.0-255,1484,140656,6,277050
32013,0.002176,74.125.24.0-255,4320,144976,6,277050
32014,0.002179,172.31.36.0-255,66,145042,6,277050
32015,0.002193,172.31.36.0-255,66,145108,6,277050
32016,0.002201,74.125.24.0-255,7156,152264,6,277050
32017,0.002203,172.31.36.0-255,66,152330,6,277050
32018,0.002238,74.125.24.0-255,4320,156650,6,277050
32019,0.00224,172.31.36.0-255,66,156716,6,277050
32020,0.002282,172.31.36.0-255,66,156782,6,277050
32021,0.002302,172.31.36.0-255,66,156848,6,277050
32022,0.002305,74.125.24.0-255,766,157614,6,277050
32023,0.002329,74.125.24.0-255,1484,159098,6,277050
32024,0.002331,172.31.36.0-255,66,159164,6,277050
32025,0.002337,74.125.24.0-255,4320,163484,6,277050
32026,0.002339,172.31.36.0-255,66,163550,6,277050
32027,0.002367,74.125.24.0-255,5738,169288,6,277050
32028,0.00237,172.31.36.0-255,66,169354,6,277050
32029,0.002373,74.125.24.0-255,1484,170838,6,277050
32030,0.00241,74.125.24.0-255,9992,180830,6,277050
32031,0.002412,172.31.36.0-255,66,180896,6,277050
32032,0.002423,74.125.24.0-255,10692,191588,6,277050
32033,0.002432,172.31.36.0-255,66,191654,6,277050
32034,0.002516,74.125.24.0-255,1484,193138,6,277050
32035,0.002521,74.125.24.0-255,2902,196040,6,277050
32036,0.002523,172.31.36.0-255,66,196106,6,277050
32037,0.002551,74.125.24.0-255,5738,201844,6,277050
32038,0.002554,172.31.36.0-255,66,201910,6,277050
32039,0.00256,74.125.24.0-255,5738,207648,6,277050
32040,0.002563,172.31.36.0-255,66,207714,6,277050
32041,0.002591,74.125.24.0-255,4320,212034,6,277050
32042,0.002594,172.31.36.0-255,66,212100,6,277050
32043,0.002598,74.125.24.0-255,1484,213584,6,277050
32044,0.002603,74.125.24.0-255,2902,216486,6,277050
32045,0.002605,172.31.36.0-255,66,216552,6,277050
32046,0.002608,74.125.24.0-255,1484,218036,6,277050
32047,0.002637,74.125.24.0-255,4320,222356,6,277050
32048,0.00264,172.31.36.0-255,66,222422,6,277050
32049,0.002643,74.125.24.0-255,1484,223906,6,277050
32050,0.002647,74.125.24.0-255,1484,225390,6,277050
32051,0.00265,172.31.36.0-255,66,225456,6,277050
32052,0.002652,74.125.24.0-255,766,226222,6,277050
32053,0.002655,74.125.24.0-255,1484,227706,6,277050
32054,0.002658,172.31.36.0-255,66,227772,6,277050
32055,0.002664,74.125.24.0-255,4320,232092,6,277050
32056,0.002666,172.31.36.0-255,66,232158,6,277050
32057,0.002712,74.125.24.0-255,9992,242150,6,277050
32058,0.002715,172.31.36.0-255,66,242216,6,277050
32059,0.002728,172.31.36.0-255,66,242282,6,277050
32060,0.002767,172.31.36.0-255,66,242348,6,277050
32061,0.00277,74.125.24.0-255,1484,243832,6,277050
32062,0.002818,74.125.24.0-255,9992,253824,6,277050
32063,0.002821,172.31.36.0-255,66,253890,6,277050
32064,0.002863,74.125.24.0-255,5738,259628,6,277050
32065,0.002865,172.31.36.0-255,66,259694,6,277050
32066,0.002883,172.31.36.0-255,66,259760,6,277050
32067,0.002901,172.31.36.0-255,66,259826,6,277050
32068,0.002911,74.125.24.0-255,10692,270518,6,277050
32069,0.002913,172.31.36.0-255,66,270584,6,277050
32070,0.002928,172.31.36.0-255,66,270650,6,277050
32071,0.002953,74.125.24.0-255,6058,276708,6,277050
32072,0.002955,172.31.36.0-255,66,276774,6,277050
32073,0.002958,74.125.24.0-255,105,276879,6,277050
32074,0.009744,172.31.36.0-255,66,276945,6,277050
32075,0.009784,172.31.36.0-255,105,277050,6,277050
32076,0.0,172.217.194.0-255,152,152,6,258584
32077,2.3e-05,172.31.36.0-255,66,218,6,258584
32078,3.1e-05,172.217.194.0-255,1484,1702,6,258584
32079,3.7e-05,172.31.36.0-255,66,1768,6,258584
32080,4.4e-05,172.217.194.0-255,2902,4670,6,258584
32081,4.7e-05,172.31.36.0-255,66,4736,6,258584
32082,6.3e-05,172.217.194.0-255,7156,11892,6,258584
32083,6.7e-05,172.31.36.0-255,66,11958,6,258584
32084,0.000118,172.31.36.0-255,66,12024,6,258584
32085,0.000123,172.217.194.0-255,4320,16344,6,258584
32086,0.000126,172.31.36.0-255,66,16410,6,258584
32087,0.000156,172.217.194.0-255,1125,17535,6,258584
32088,0.000159,172.31.36.0-255,66,17601,6,258584
32089,0.000188,172.217.194.0-255,2902,20503,6,258584
32090,0.000192,172.31.36.0-255,66,20569,6,258584
32091,0.000197,172.217.194.0-255,4320,24889,6,258584
32092,0.0002,172.31.36.0-255,66,24955,6,258584
32093,0.000207,172.217.194.0-255,7156,32111,6,258584
32094,0.00021,172.31.36.0-255,66,32177,6,258584
32095,0.000238,172.217.194.0-255,1484,33661,6,258584
32096,0.000241,172.31.36.0-255,66,33727,6,258584
32097,0.000256,172.31.36.0-255,66,33793,6,258584
32098,0.000282,172.217.194.0-255,2543,36336,6,258584
32099,0.000284,172.31.36.0-255,66,36402,6,258584
32100,0.000289,172.217.194.0-255,2543,38945,6,258584
32101,0.000292,172.31.36.0-255,66,39011,6,258584
32102,0.000438,172.217.194.0-255,378,39389,6,258584
32103,0.000442,172.31.36.0-255,66,39455,6,258584
32104,0.000636,172.217.194.0-255,1484,40939,6,258584
32105,0.000642,172.31.36.0-255,66,41005,6,258584
32106,0.000648,172.217.194.0-255,2902,43907,6,258584
32107,0.000651,172.31.36.0-255,66,43973,6,258584
32108,0.000664,172.217.194.0-255,5738,49711,6,258584
32109,0.000667,172.31.36.0-255,66,49777,6,258584
32110,0.000673,172.217.194.0-255,4320,54097,6,258584
32111,0.000675,172.31.36.0-255,66,54163,6,258584
32112,0.000699,172.217.194.0-255,1484,55647,6,258584
32113,0.000703,172.217.194.0-255,1484,57131,6,258584
32114,0.000706,172.31.36.0-255,66,57197,6,258584
32115,0.00075,172.217.194.0-255,4739,61936,6,258584
32116,0.000756,172.31.36.0-255,66,62002,6,258584
32117,0.000759,172.31.36.0-255,66,62068,6,258584
32118,0.000886,172.217.194.0-255,1484,63552,6,258584
32119,0.000893,172.217.194.0-255,2902,66454,6,258584
32120,0.000896,172.31.36.0-255,66,66520,6,258584
32121,0.0009,172.217.194.0-255,1484,68004,6,258584
32122,0.000927,172.217.194.0-255,4320,72324,6,258584
32123,0.000929,172.31.36.0-255,66,72390,6,258584
32124,0.000964,172.217.194.0-255,7156,79546,6,258584
32125,0.000967,172.31.36.0-255,66,79612,6,258584
32126,0.000994,172.217.194.0-255,5738,85350,6,258584
32127,0.001004,172.217.194.0-255,10692,96042,6,258584
32128,0.00101,172.31.36.0-255,66,96108,6,258584
32129,0.001013,172.31.36.0-255,66,96174,6,258584
32130,0.001342,172.217.194.0-255,1484,97658,6,258584
32131,0.001347,172.217.194.0-255,1484,99142,6,258584
32132,0.00135,172.31.36.0-255,66,99208,6,258584
32133,0.001363,172.217.194.0-255,1484,100692,6,258584
32134,0.001374,172.217.194.0-255,5738,106430,6,258584
32135,0.001377,172.31.36.0-255,66,106496,6,258584
32136,0.001405,172.217.194.0-255,5738,112234,6,258584
32137,0.001407,172.31.36.0-255,66,112300,6,258584
32138,0.001432,172.217.194.0-255,5738,118038,6,258584
32139,0.001434,172.31.36.0-255,66,118104,6,258584
32140,0.001449,172.31.36.0-255,66,118170,6,258584
32141,0.001472,172.217.194.0-255,2902,121072,6,258584
32142,0.001501,172.217.194.0-255,9992,131064,6,258584
32143,0.001511,172.217.194.0-255,9992,141056,6,258584
32144,0.001528,172.31.36.0-255,66,141122,6,258584
32145,0.001594,172.217.194.0-255,8574,149696,6,258584
32146,0.001607,172.217.194.0-255,2184,151880,6,258584
32147,0.001617,172.31.36.0-255,66,151946,6,258584
32148,0.001688,172.217.194.0-255,1484,153430,6,258584
32149,0.001692,172.217.194.0-255,1484,154914,6,258584
32150,0.001695,172.31.36.0-255,66,154980,6,258584
32151,0.001719,172.217.194.0-255,1484,156464,6,258584
32152,0.001726,172.217.194.0-255,5738,162202,6,258584
32153,0.001734,172.31.36.0-255,66,162268,6,258584
32154,0.001787,172.217.194.0-255,2902,165170,6,258584
32155,0.001804,172.217.194.0-255,7856,173026,6,258584
32156,0.001825,172.31.36.0-255,66,173092,6,258584
32157,0.002002,172.217.194.0-255,1484,174576,6,258584
32158,0.002009,172.217.194.0-255,2902,177478,6,258584
32159,0.002012,172.31.36.0-255,66,177544,6,258584
32160,0.002016,172.217.194.0-255,1484,179028,6,258584
32161,0.002045,172.217.194.0-255,4320,183348,6,258584
32162,0.00205,172.217.194.0-255,4320,187668,6,258584
32163,0.002055,172.217.194.0-255,2902,190570,6,258584
32164,0.002069,172.31.36.0-255,66,190636,6,258584
32165,0.002094,172.217.194.0-255,8574,199210,6,258584
32166,0.0021,172.217.194.0-255,5738,204948,6,258584
32167,0.002108,172.31.36.0-255,66,205014,6,258584
32168,0.002118,172.217.194.0-255,2184,207198,6,258584
32169,0.002165,172.31.36.0-255,66,207264,6,258584
32170,0.002196,172.217.194.0-255,1484,208748,6,258584
32171,0.002201,172.217.194.0-255,2902,211650,6,258584
32172,0.002207,172.31.36.0-255,66,211716,6,258584
32173,0.002236,172.217.194.0-255,5738,217454,6,258584
32174,0.002246,172.217.194.0-255,8574,226028,6,258584
32175,0.002253,172.31.36.0-255,66,226094,6,258584
32176,0.002264,172.217.194.0-255,4320,230414,6,258584
32177,0.00228,172.217.194.0-255,10692,241106,6,258584
32178,0.002336,172.31.36.0-255,66,241172,6,258584
32179,0.004564,172.217.194.0-255,5738,246910,6,258584
32180,0.004572,172.31.36.0-255,66,246976,6,258584
32181,0.006785,172.217.194.0-255,5738,252714,6,258584
32182,0.006792,172.31.36.0-255,66,252780,6,258584
32183,0.009025,172.217.194.0-255,5738,258518,6,258584
32184,0.009028,172.31.36.0-255,66,258584,6,258584
32185,0.0,74.125.68.0-255,153,153,6,366280
32186,1.5e-05,172.31.36.0-255,66,219,6,366280
32187,2.1e-05,74.125.68.0-255,1484,1703,6,366280
32188,2.7e-05,172.31.36.0-255,66,1769,6,366280
32189,3.3e-05,74.125.68.0-255,2902,4671,6,366280
32190,3.7e-05,172.31.36.0-255,66,4737,6,366280
32191,5.8e-05,74.125.68.0-255,5738,10475,6,366280
32192,6.1e-05,172.31.36.0-255,66,10541,6,366280
32193,6.7e-05,74.125.68.0-255,3509,14050,6,366280
32194,6.9e-05,172.31.36.0-255,66,14116,6,366280
32195,0.000177,74.125.68.0-255,1484,15600,6,366280
32196,0.000181,172.31.36.0-255,66,15666,6,366280
32197,0.000186,74.125.68.0-255,2902,18568,6,366280
32198,0.000189,172.31.36.0-255,66,18634,6,366280
32199,0.000219,74.125.68.0-255,5738,24372,6,366280
32200,0.000221,172.31.36.0-255,66,24438,6,366280
32201,0.000227,74.125.68.0-255,4320,28758,6,366280
32202,0.000229,172.31.36.0-255,66,28824,6,366280
32203,0.000272,74.125.68.0-255,2543,31367,6,366280
32204,0.000276,172.31.36.0-255,66,31433,6,366280
32205,0.000294,74.125.68.0-255,2902,34335,6,366280
32206,0.000296,172.31.36.0-255,66,34401,6,366280
32207,0.00032,74.125.68.0-255,7156,41557,6,366280
32208,0.000323,172.31.36.0-255,66,41623,6,366280
32209,0.000328,74.125.68.0-255,4320,45943,6,366280
32210,0.000332,172.31.36.0-255,66,46009,6,366280
32211,0.000338,74.125.68.0-255,5738,51747,6,366280
32212,0.000341,172.31.36.0-255,66,51813,6,366280
32213,0.000381,172.31.36.0-255,66,51879,6,366280
32214,0.000386,74.125.68.0-255,2184,54063,6,366280
32215,0.000388,172.31.36.0-255,66,54129,6,366280
32216,0.00041,74.125.68.0-255,397,54526,6,366280
32217,0.000413,172.31.36.0-255,66,54592,6,366280
32218,0.000452,74.125.68.0-255,346,54938,6,366280
32219,0.000454,172.31.36.0-255,66,55004,6,366280
32220,0.000611,74.125.68.0-255,1484,56488,6,366280
32221,0.000617,172.31.36.0-255,66,56554,6,366280
32222,0.000622,74.125.68.0-255,2902,59456,6,366280
32223,0.000625,172.31.36.0-255,66,59522,6,366280
32224,0.000628,74.125.68.0-255,1484,61006,6,366280
32225,0.00063,172.31.36.0-255,66,61072,6,366280
32226,0.000649,74.125.68.0-255,1484,62556,6,366280
32227,0.000652,172.31.36.0-255,66,62622,6,366280
32228,0.000658,74.125.68.0-255,4320,66942,6,366280
32229,0.000661,172.31.36.0-255,66,67008,6,366280
32230,0.000684,74.125.68.0-255,2902,69910,6,366280
32231,0.000687,172.31.36.0-255,66,69976,6,366280
32232,0.000709,74.125.68.0-255,5738,75714,6,366280
32233,0.000712,172.31.36.0-255,66,75780,6,366280
32234,0.000721,74.125.68.0-255,9992,85772,6,366280
32235,0.000723,172.31.36.0-255,66,85838,6,366280
32236,0.000768,74.125.68.0-255,3602,89440,6,366280
32237,0.000771,172.31.36.0-255,66,89506,6,366280
32238,0.00095,74.125.68.0-255,1484,90990,6,366280
32239,0.000954,172.31.36.0-255,66,91056,6,366280
32240,0.000961,74.125.68.0-255,2902,93958,6,366280
32241,0.000963,172.31.36.0-255,66,94024,6,366280
32242,0.000966,74.125.68.0-255,1484,95508,6,366280
32243,0.000968,172.31.36.0-255,66,95574,6,366280
32244,0.00099,74.125.68.0-255,4320,99894,6,366280
32245,0.000992,172.31.36.0-255,66,99960,6,366280
32246,0.000998,74.125.68.0-255,5738,105698,6,366280
32247,0.001,172.31.36.0-255,66,105764,6,366280
32248,0.001031,74.125.68.0-255,7156,112920,6,366280
32249,0.001034,172.31.36.0-255,66,112986,6,366280
32250,0.001037,74.125.68.0-255,1484,114470,6,366280
32251,0.001039,172.31.36.0-255,66,114536,6,366280
32252,0.001064,74.125.68.0-255,9274,123810,6,366280
32253,0.001068,172.31.36.0-255,66,123876,6,366280
32254,0.001096,74.125.68.0-255,1484,125360,6,366280
32255,0.001099,172.31.36.0-255,66,125426,6,366280
32256,0.001105,74.125.68.0-255,2902,128328,6,366280
32257,0.001107,172.31.36.0-255,66,128394,6,366280
32258,0.001136,74.125.68.0-255,5738,134132,6,366280
32259,0.001139,172.31.36.0-255,66,134198,6,366280
32260,0.001142,74.125.68.0-255,1484,135682,6,366280
32261,0.001144,172.31.36.0-255,66,135748,6,366280
32262,0.001168,74.125.68.0-255,2902,138650,6,366280
32263,0.001175,74.125.68.0-255,5738,144388,6,366280
32264,0.001183,172.31.36.0-255,66,144454,6,366280
32265,0.001192,74.125.68.0-255,1484,145938,6,366280
32266,0.001218,74.125.68.0-255,8574,154512,6,366280
32267,0.001236,172.31.36.0-255,66,154578,6,366280
32268,0.001249,74.125.68.0-255,3602,158180,6,366280
32269,0.001279,172.31.36.0-255,66,158246,6,366280
32270,0.001446,74.125.68.0-255,1484,159730,6,366280
32271,0.001451,74.125.68.0-255,2902,162632,6,366280
32272,0.001454,172.31.36.0-255,66,162698,6,366280
32273,0.001479,74.125.68.0-255,5738,168436,6,366280
32274,0.001495,74.125.68.0-255,4320,172756,6,366280
32275,0.0015,172.31.36.0-255,66,172822,6,366280
32276,0.001511,74.125.68.0-255,5738,178560,6,366280
32277,0.001519,172.31.36.0-255,66,178626,6,366280
32278,0.001523,74.125.68.0-255,1484,180110,6,366280
32279,0.00155,74.125.68.0-255,9992,190102,6,366280
32280,0.001554,74.125.68.0-255,2184,192286,6,366280
32281,0.001572,172.31.36.0-255,66,192352,6,366280
32282,0.001612,74.125.68.0-255,1484,193836,6,366280
32283,0.001634,74.125.68.0-255,2902,196738,6,366280
32284,0.001644,172.31.36.0-255,66,196804,6,366280
32285,0.001659,74.125.68.0-255,5738,202542,6,366280
32286,0.001664,74.125.68.0-255,2902,205444,6,366280
32287,0.001668,74.125.68.0-255,4320,209764,6,366280
32288,0.001688,172.31.36.0-255,66,209830,6,366280
32289,0.001701,74.125.68.0-255,8574,218404,6,366280
32290,0.001707,74.125.68.0-255,4320,222724,6,366280
32291,0.001712,172.31.36.0-255,66,222790,6,366280
32292,0.001757,74.125.68.0-255,1484,224274,6,366280
32293,0.001772,74.125.68.0-255,2184,226458,6,366280
32294,0.001784,172.31.36.0-255,66,226524,6,366280
32295,0.001852,74.125.68.0-255,1484,228008,6,366280
32296,0.001856,74.125.68.0-255,1484,229492,6,366280
32297,0.001866,172.31.36.0-255,66,229558,6,366280
32298,0.001875,74.125.68.0-255,1484,231042,6,366280
32299,0.001881,74.125.68.0-255,5738,236780,6,366280
32300,0.001892,172.31.36.0-255,66,236846,6,366280
32301,0.001983,74.125.68.0-255,10692,247538,6,366280
32302,0.001995,172.31.36.0-255,66,247604,6,366280
32303,0.002027,74.125.68.0-255,1484,249088,6,366280
32304,0.002033,74.125.68.0-255,2902,251990,6,366280
32305,0.002046,172.31.36.0-255,66,252056,6,366280
32306,0.002064,74.125.68.0-255,5738,257794,6,366280
32307,0.002068,74.125.68.0-255,2902,260696,6,366280
32308,0.002105,172.31.36.0-255,66,260762,6,366280
32309,0.002127,74.125.68.0-255,4320,265082,6,366280
32310,0.002135,74.125.68.0-255,8574,273656,6,366280
32311,0.00214,74.125.68.0-255,2902,276558,6,366280
32312,0.002156,172.31.36.0-255,66,276624,6,366280
32313,0.002174,74.125.68.0-255,4320,280944,6,366280
32314,0.002183,172.31.36.0-255,66,281010,6,366280
32315,0.002205,74.125.68.0-255,6438,287448,6,366280
32316,0.002223,74.125.68.0-255,7156,294604,6,366280
32317,0.002236,74.125.68.0-255,1484,296088,6,366280
32318,0.00224,172.31.36.0-255,66,296154,6,366280
32319,0.00227,74.125.68.0-255,2902,299056,6,366280
32320,0.002286,74.125.68.0-255,6438,305494,6,366280
32321,0.002289,74.125.68.0-255,1484,306978,6,366280
32322,0.002296,172.31.36.0-255,66,307044,6,366280
32323,0.002312,74.125.68.0-255,8574,315618,6,366280
32324,0.002331,172.31.36.0-255,66,315684,6,366280
32325,0.002339,74.125.68.0-255,8574,324258,6,366280
32326,0.002345,74.125.68.0-255,5738,329996,6,366280
32327,0.002359,74.125.68.0-255,4320,334316,6,366280
32328,0.002362,172.31.36.0-255,66,334382,6,366280
32329,0.002371,74.125.68.0-255,3602,337984,6,366280
32330,0.002386,74.125.68.0-255,4320,342304,6,366280
32331,0.002402,172.31.36.0-255,66,342370,6,366280
32332,0.002417,74.125.68.0-255,8574,350944,6,366280
32333,0.002433,74.125.68.0-255,1484,352428,6,366280
32334,0.002437,74.125.68.0-255,2902,355330,6,366280
32335,0.002449,172.31.36.0-255,66,355396,6,366280
32336,0.002498,74.125.68.0-255,10542,365938,6,366280
32337,0.002524,74.125.68.0-255,105,366043,6,366280
32338,0.003009,172.31.36.0-255,66,366109,6,366280
32339,0.005189,172.31.36.0-255,105,366214,6,366280
32340,0.007768,74.125.68.0-255,66,366280,6,366280
32341,0.0,172.217.194.0-255,297,297,6,71796
32342,2.3e-05,172.31.36.0-255,66,363,6,71796
32343,2.9e-05,172.217.194.0-255,1484,1847,6,71796
32344,3.3e-05,172.31.36.0-255,66,1913,6,71796
32345,5.2e-05,172.217.194.0-255,2902,4815,6,71796
32346,5.5e-05,172.31.36.0-255,66,4881,6,71796
32347,6.1e-05,172.217.194.0-255,4320,9201,6,71796
32348,6.4e-05,172.31.36.0-255,66,9267,6,71796
32349,9.2e-05,172.217.194.0-255,7156,16423,6,71796
32350,9.5e-05,172.31.36.0-255,66,16489,6,71796
32351,0.000115,172.217.194.0-255,1843,18332,6,71796
32352,0.000118,172.31.36.0-255,66,18398,6,71796
32353,0.000126,172.217.194.0-255,8574,26972,6,71796
32354,0.000128,172.31.36.0-255,66,27038,6,71796
32355,0.00014,172.217.194.0-255,1484,28522,6,71796
32356,0.000143,172.31.36.0-255,66,28588,6,71796
32357,0.000151,172.217.194.0-255,8574,37162,6,71796
32358,0.000154,172.31.36.0-255,66,37228,6,71796
32359,0.0002,172.217.194.0-255,8574,45802,6,71796
32360,0.000205,172.31.36.0-255,66,45868,6,71796
32361,0.00022,172.217.194.0-255,2184,48052,6,71796
32362,0.000223,172.31.36.0-255,66,48118,6,71796
32363,0.00247,172.217.194.0-255,2902,51020,6,71796
32364,0.002478,172.31.36.0-255,66,51086,6,71796
32365,0.002501,172.217.194.0-255,2902,53988,6,71796
32366,0.002503,172.31.36.0-255,66,54054,6,71796
32367,0.004742,172.217.194.0-255,2902,56956,6,71796
32368,0.004749,172.31.36.0-255,66,57022,6,71796
32369,0.00479,172.217.194.0-255,2902,59924,6,71796
32370,0.004793,172.31.36.0-255,66,59990,6,71796
32371,0.007026,172.217.194.0-255,2902,62892,6,71796
32372,0.007031,172.31.36.0-255,66,62958,6,71796
32373,0.007066,172.217.194.0-255,2902,65860,6,71796
32374,0.007071,172.31.36.0-255,66,65926,6,71796
32375,0.009304,172.217.194.0-255,2902,68828,6,71796
32376,0.009311,172.31.36.0-255,66,68894,6,71796
32377,0.009368,172.217.194.0-255,2902,71796,6,71796
32378,0.0,74.125.200.0-255,152,152,6,222253
32379,2.1e-05,172.31.36.0-255,66,218,6,222253
32380,2.8e-05,74.125.200.0-255,1484,1702,6,222253
32381,3.2e-05,172.31.36.0-255,66,1768,6,222253
32382,3.7e-05,74.125.200.0-255,2902,4670,6,222253
32383,3.9e-05,172.31.36.0-255,66,4736,6,222253
32384,4.5e-05,74.125.200.0-255,5738,10474,6,222253
32385,4.8e-05,172.31.36.0-255,66,10540,6,222253
32386,7.5e-05,74.125.200.0-255,3421,13961,6,222253
32387,7.7e-05,172.31.36.0-255,66,14027,6,222253
32388,0.000109,74.125.200.0-255,4320,18347,6,222253
32389,0.000111,172.31.36.0-255,66,18413,6,222253
32390,0.000131,74.125.200.0-255,4320,22733,6,222253
32391,0.000133,172.31.36.0-255,66,22799,6,222253
32392,0.000137,74.125.200.0-255,2902,25701,6,222253
32393,0.000138,172.31.36.0-255,66,25767,6,222253
32394,0.000157,74.125.200.0-255,2902,28669,6,222253
32395,0.000159,172.31.36.0-255,66,28735,6,222253
32396,0.000174,74.125.200.0-255,1484,30219,6,222253
32397,0.000175,172.31.36.0-255,66,30285,6,222253
32398,0.000186,74.125.200.0-255,1125,31410,6,222253
32399,0.000188,172.31.36.0-255,66,31476,6,222253
32400,0.000247,74.125.200.0-255,1484,32960,6,222253
32401,0.00025,172.31.36.0-255,66,33026,6,222253
32402,0.000255,74.125.200.0-255,2902,35928,6,222253
32403,0.000257,172.31.36.0-255,66,35994,6,222253
32404,0.000263,74.125.200.0-255,5738,41732,6,222253
32405,0.000265,172.31.36.0-255,66,41798,6,222253
32406,0.000267,74.125.200.0-255,1484,43282,6,222253
32407,0.000269,172.31.36.0-255,66,43348,6,222253
32408,0.000297,74.125.200.0-255,5738,49086,6,222253
32409,0.0003,172.31.36.0-255,66,49152,6,222253
32410,0.00032,74.125.200.0-255,3961,53113,6,222253
32411,0.000322,172.31.36.0-255,66,53179,6,222253
32412,0.000329,74.125.200.0-255,7156,60335,6,222253
32413,0.00033,172.31.36.0-255,66,60401,6,222253
32414,0.000378,74.125.200.0-255,4320,64721,6,222253
32415,0.000381,172.31.36.0-255,66,64787,6,222253
32416,0.000398,74.125.200.0-255,1436,66223,6,222253
32417,0.000402,74.125.200.0-255,110,66333,6,222253
32418,0.000489,74.125.200.0-255,333,66666,6,222253
32419,0.000492,172.31.36.0-255,66,66732,6,222253
32420,0.00094,74.125.200.0-255,1484,68216,6,222253
32421,0.000956,74.125.200.0-255,2902,71118,6,222253
32422,0.000959,172.31.36.0-255,66,71184,6,222253
32423,0.000978,74.125.200.0-255,4320,75504,6,222253
32424,0.00098,172.31.36.0-255,66,75570,6,222253
32425,0.000997,74.125.200.0-255,5738,81308,6,222253
32426,0.000999,172.31.36.0-255,66,81374,6,222253
32427,0.001023,74.125.200.0-255,2902,84276,6,222253
32428,0.001026,172.31.36.0-255,66,84342,6,222253
32429,0.001034,74.125.200.0-255,8574,92916,6,222253
32430,0.001035,172.31.36.0-255,66,92982,6,222253
32431,0.001069,74.125.200.0-255,1484,94466,6,222253
32432,0.001089,74.125.200.0-255,6438,100904,6,222253
32433,0.001091,172.31.36.0-255,66,100970,6,222253
32434,0.001224,74.125.200.0-255,1484,102454,6,222253
32435,0.001239,74.125.200.0-255,2902,105356,6,222253
32436,0.001242,172.31.36.0-255,66,105422,6,222253
32437,0.001277,74.125.200.0-255,5738,111160,6,222253
32438,0.001279,172.31.36.0-255,66,111226,6,222253
32439,0.001294,74.125.200.0-255,1484,112710,6,222253
32440,0.001322,74.125.200.0-255,2902,115612,6,222253
32441,0.001325,172.31.36.0-255,66,115678,6,222253
32442,0.00133,74.125.200.0-255,5738,121416,6,222253
32443,0.001332,172.31.36.0-255,66,121482,6,222253
32444,0.001334,74.125.200.0-255,1484,122966,6,222253
32445,0.001361,74.125.200.0-255,5738,128704,6,222253
32446,0.001363,172.31.36.0-255,66,128770,6,222253
32447,0.001392,74.125.200.0-255,6438,135208,6,222253
32448,0.001395,172.31.36.0-255,66,135274,6,222253
32449,0.001426,74.125.200.0-255,1484,136758,6,222253
32450,0.001446,74.125.200.0-255,2902,139660,6,222253
32451,0.001448,172.31.36.0-255,66,139726,6,222253
32452,0.001489,74.125.200.0-255,5738,145464,6,222253
32453,0.001491,172.31.36.0-255,66,145530,6,222253
32454,0.001493,74.125.200.0-255,1484,147014,6,222253
32455,0.001497,74.125.200.0-255,2902,149916,6,222253
32456,0.001499,172.31.36.0-255,66,149982,6,222253
32457,0.001505,74.125.200.0-255,5738,155720,6,222253
32458,0.001507,172.31.36.0-255,66,155786,6,222253
32459,0.001542,172.31.36.0-255,66,155852,6,222253
32460,0.001577,74.125.200.0-255,2184,158036,6,222253
32461,0.001579,172.31.36.0-255,66,158102,6,222253
32462,0.001583,74.125.200.0-255,2902,161004,6,222253
32463,0.001585,172.31.36.0-255,66,161070,6,222253
32464,0.001599,74.125.200.0-255,2902,163972,6,222253
32465,0.001601,172.31.36.0-255,66,164038,6,222253
32466,0.001621,74.125.200.0-255,4320,168358,6,222253
32467,0.001626,74.125.200.0-255,5738,174096,6,222253
32468,0.00163,172.31.36.0-255,66,174162,6,222253
32469,0.001633,172.31.36.0-255,66,174228,6,222253
32470,0.001642,74.125.200.0-255,1484,175712,6,222253
32471,0.001666,74.125.200.0-255,5738,181450,6,222253
32472,0.001668,172.31.36.0-255,66,181516,6,222253
32473,0.001683,74.125.200.0-255,4320,185836,6,222253
32474,0.001686,172.31.36.0-255,66,185902,6,222253
32475,0.001712,74.125.200.0-255,5738,191640,6,222253
32476,0.001714,172.31.36.0-255,66,191706,6,222253
32477,0.001716,74.125.200.0-255,766,192472,6,222253
32478,0.001904,74.125.200.0-255,1484,193956,6,222253
32479,0.001907,172.31.36.0-255,66,194022,6,222253
32480,0.001911,74.125.200.0-255,1484,195506,6,222253
32481,0.001922,74.125.200.0-255,1484,196990,6,222253
32482,0.001924,172.31.36.0-255,66,197056,6,222253
32483,0.001927,74.125.200.0-255,1484,198540,6,222253
32484,0.001945,74.125.200.0-255,1484,200024,6,222253
32485,0.001947,172.31.36.0-255,66,200090,6,222253
32486,0.00222,172.31.36.0-255,101,200191,6,222253
32487,0.003835,74.125.200.0-255,2902,203093,6,222253
32488,0.003843,172.31.36.0-255,66,203159,6,222253
32489,0.003865,74.125.200.0-255,2902,206061,6,222253
32490,0.003867,172.31.36.0-255,66,206127,6,222253
32491,0.004092,74.125.200.0-255,66,206193,6,222253
32492,0.005769,74.125.200.0-255,4320,210513,6,222253
32493,0.005772,172.31.36.0-255,66,210579,6,222253
32494,0.005791,74.125.200.0-255,1484,212063,6,222253
32495,0.007694,74.125.200.0-255,4320,216383,6,222253
32496,0.007698,172.31.36.0-255,66,216449,6,222253
32497,0.009618,74.125.200.0-255,5738,222187,6,222253
32498,0.009627,172.31.36.0-255,66,222253,6,222253
32499,0.0,74.125.130.0-255,153,153,6,333543
32500,3.3e-05,172.31.36.0-255,66,219,6,333543
32501,4e-05,74.125.130.0-255,1484,1703,6,333543
32502,4.4e-05,172.31.36.0-255,66,1769,6,333543
32503,4.9e-05,74.125.130.0-255,2902,4671,6,333543
32504,5.1e-05,172.31.36.0-255,66,4737,6,333543
32505,5.8e-05,74.125.130.0-255,5738,10475,6,333543
32506,6.1e-05,172.31.36.0-255,66,10541,6,333543
32507,8e-05,74.125.130.0-255,3483,14024,6,333543
32508,8.2e-05,172.31.36.0-255,66,14090,6,333543
32509,0.000101,74.125.130.0-255,4320,18410,6,333543
32510,0.000103,172.31.36.0-255,66,18476,6,333543
32511,0.00013,74.125.130.0-255,5738,24214,6,333543
32512,0.000133,172.31.36.0-255,66,24280,6,333543
32513,0.000155,74.125.130.0-255,5738,30018,6,333543
32514,0.000158,172.31.36.0-255,66,30084,6,333543
32515,0.000173,74.125.130.0-255,1125,31209,6,333543
32516,0.000175,172.31.36.0-255,66,31275,6,333543
32517,0.000313,74.125.130.0-255,1484,32759,6,333543
32518,0.000317,172.31.36.0-255,66,32825,6,333543
32519,0.000323,74.125.130.0-255,2902,35727,6,333543
32520,0.000327,172.31.36.0-255,66,35793,6,333543
32521,0.00033,74.125.130.0-255,1484,37277,6,333543
32522,0.000332,172.31.36.0-255,66,37343,6,333543
32523,0.000352,74.125.130.0-255,2902,40245,6,333543
32524,0.000355,172.31.36.0-255,66,40311,6,333543
32525,0.000371,74.125.130.0-255,1484,41795,6,333543
32526,0.000374,172.31.36.0-255,66,41861,6,333543
32527,0.000407,74.125.130.0-255,8215,50076,6,333543
32528,0.00041,172.31.36.0-255,66,50142,6,333543
32529,0.000414,74.125.130.0-255,2902,53044,6,333543
32530,0.000417,172.31.36.0-255,66,53110,6,333543
32531,0.000477,172.31.36.0-255,66,53176,6,333543
32532,0.000591,74.125.130.0-255,99,53275,6,333543
32533,0.000842,74.125.130.0-255,1484,54759,6,333543
32534,0.000847,172.31.36.0-255,66,54825,6,333543
32535,0.000853,74.125.130.0-255,2902,57727,6,333543
32536,0.000855,172.31.36.0-255,66,57793,6,333543
32537,0.000869,74.125.130.0-255,1484,59277,6,333543
32538,0.000888,74.125.130.0-255,4320,63597,6,333543
32539,0.000892,172.31.36.0-255,66,63663,6,333543
32540,0.000897,74.125.130.0-255,4320,67983,6,333543
32541,0.000899,172.31.36.0-255,66,68049,6,333543
32542,0.000905,74.125.130.0-255,5738,73787,6,333543
32543,0.000907,172.31.36.0-255,66,73853,6,333543
32544,0.000927,74.125.130.0-255,1484,75337,6,333543
32545,0.000954,74.125.130.0-255,9992,85329,6,333543
32546,0.000958,172.31.36.0-255,66,85395,6,333543
32547,0.000962,74.125.130.0-255,2184,87579,6,333543
32548,0.000964,172.31.36.0-255,66,87645,6,333543
32549,0.001028,74.125.130.0-255,1484,89129,6,333543
32550,0.001044,74.125.130.0-255,2902,92031,6,333543
32551,0.001047,172.31.36.0-255,66,92097,6,333543
32552,0.001052,74.125.130.0-255,4320,96417,6,333543
32553,0.001055,172.31.36.0-255,66,96483,6,333543
32554,0.001077,74.125.130.0-255,4320,100803,6,333543
32555,0.00108,172.31.36.0-255,66,100869,6,333543
32556,0.001101,74.125.130.0-255,4320,105189,6,333543
32557,0.001104,172.31.36.0-255,66,105255,6,333543
32558,0.001111,74.125.130.0-255,7156,112411,6,333543
32559,0.001113,172.31.36.0-255,66,112477,6,333543
32560,0.001136,74.125.130.0-255,1484,113961,6,333543
32561,0.001151,74.125.130.0-255,7156,121117,6,333543
32562,0.001154,172.31.36.0-255,66,121183,6,333543
32563,0.001177,74.125.130.0-255,1484,122667,6,333543
32564,0.001196,74.125.130.0-255,7856,130523,6,333543
32565,0.0012,74.125.130.0-255,4320,134843,6,333543
32566,0.001201,172.31.36.0-255,66,134909,6,333543
32567,0.001204,172.31.36.0-255,66,134975,6,333543
32568,0.001226,74.125.130.0-255,5738,140713,6,333543
32569,0.001229,172.31.36.0-255,66,140779,6,333543
32570,0.001242,74.125.130.0-255,2902,143681,6,333543
32571,0.001244,172.31.36.0-255,66,143747,6,333543
32572,0.001277,74.125.130.0-255,8574,152321,6,333543
32573,0.00128,172.31.36.0-255,66,152387,6,333543
32574,0.001285,74.125.130.0-255,3602,155989,6,333543
32575,0.001287,172.31.36.0-255,66,156055,6,333543
32576,0.001335,74.125.130.0-255,362,156417,6,333543
32577,0.001392,74.125.130.0-255,1484,157901,6,333543
32578,0.001396,172.31.36.0-255,66,157967,6,333543
32579,0.001412,74.125.130.0-255,2902,160869,6,333543
32580,0.001415,172.31.36.0-255,66,160935,6,333543
32581,0.001421,74.125.130.0-255,4320,165255,6,333543
32582,0.001423,172.31.36.0-255,66,165321,6,333543
32583,0.001443,74.125.130.0-255,1484,166805,6,333543
32584,0.001465,74.125.130.0-255,8574,175379,6,333543
32585,0.001471,172.31.36.0-255,66,175445,6,333543
32586,0.001485,74.125.130.0-255,2902,178347,6,333543
32587,0.001488,172.31.36.0-255,66,178413,6,333543
32588,0.001504,74.125.130.0-255,4320,182733,6,333543
32589,0.001507,172.31.36.0-255,66,182799,6,333543
32590,0.001529,74.125.130.0-255,7856,190655,6,333543
32591,0.001533,172.31.36.0-255,66,190721,6,333543
32592,0.001699,74.125.130.0-255,1484,192205,6,333543
32593,0.001704,74.125.130.0-255,2902,195107,6,333543
32594,0.001707,172.31.36.0-255,66,195173,6,333543
32595,0.001725,74.125.130.0-255,1484,196657,6,333543
32596,0.001741,74.125.130.0-255,4320,200977,6,333543
32597,0.001745,172.31.36.0-255,66,201043,6,333543
32598,0.001764,74.125.130.0-255,5738,206781,6,333543
32599,0.001767,172.31.36.0-255,66,206847,6,333543
32600,0.001785,74.125.130.0-255,4320,211167,6,333543
32601,0.001788,172.31.36.0-255,66,211233,6,333543
32602,0.001791,74.125.130.0-255,1484,212717,6,333543
32603,0.00181,74.125.130.0-255,7156,219873,6,333543
32604,0.001813,172.31.36.0-255,66,219939,6,333543
32605,0.001837,74.125.130.0-255,2902,222841,6,333543
32606,0.00184,172.31.36.0-255,66,222907,6,333543
32607,0.001845,74.125.130.0-255,2184,225091,6,333543
32608,0.001847,172.31.36.0-255,66,225157,6,333543
32609,0.001968,74.125.130.0-255,1484,226641,6,333543
32610,0.001986,74.125.130.0-255,2902,229543,6,333543
32611,0.00199,172.31.36.0-255,66,229609,6,333543
32612,0.002014,74.125.130.0-255,5738,235347,6,333543
32613,0.002017,172.31.36.0-255,66,235413,6,333543
32614,0.002022,74.125.130.0-255,2902,238315,6,333543
32615,0.002024,172.31.36.0-255,66,238381,6,333543
32616,0.002035,74.125.130.0-255,4320,242701,6,333543
32617,0.002039,172.31.36.0-255,66,242767,6,333543
32618,0.00204,74.125.130.0-255,4320,247087,6,333543
32619,0.002042,172.31.36.0-255,66,247153,6,333543
32620,0.002073,74.125.130.0-255,4320,251473,6,333543
32621,0.002077,172.31.36.0-255,66,251539,6,333543
32622,0.002084,74.125.130.0-255,5738,257277,6,333543
32623,0.002086,172.31.36.0-255,66,257343,6,333543
32624,0.002092,74.125.130.0-255,4320,261663,6,333543
32625,0.002094,172.31.36.0-255,66,261729,6,333543
32626,0.002115,74.125.130.0-255,2184,263913,6,333543
32627,0.002118,172.31.36.0-255,66,263979,6,333543
32628,0.002127,74.125.130.0-255,8574,272553,6,333543
32629,0.00213,172.31.36.0-255,66,272619,6,333543
32630,0.002137,74.125.130.0-255,7156,279775,6,333543
32631,0.002141,172.31.36.0-255,66,279841,6,333543
32632,0.002167,74.125.130.0-255,2902,282743,6,333543
32633,0.00217,172.31.36.0-255,66,282809,6,333543
32634,0.002178,74.125.130.0-255,8574,291383,6,333543
32635,0.002181,172.31.36.0-255,66,291449,6,333543
32636,0.002219,74.125.130.0-255,7856,299305,6,333543
32637,0.002223,172.31.36.0-255,66,299371,6,333543
32638,0.002227,74.125.130.0-255,2902,302273,6,333543
32639,0.002229,172.31.36.0-255,66,302339,6,333543
32640,0.002247,74.125.130.0-255,5738,308077,6,333543
32641,0.00225,172.31.36.0-255,66,308143,6,333543
32642,0.002284,172.31.36.0-255,66,308209,6,333543
32643,0.002337,74.125.130.0-255,7856,316065,6,333543
32644,0.00234,172.31.36.0-255,66,316131,6,333543
32645,0.00465,74.125.130.0-255,5738,321869,6,333543
32646,0.004663,172.31.36.0-255,66,321935,6,333543
32647,0.006955,74.125.130.0-255,5738,327673,6,333543
32648,0.006958,172.31.36.0-255,66,327739,6,333543
32649,0.009259,74.125.130.0-255,5738,333477,6,333543
32650,0.009274,172.31.36.0-255,66,333543,6,333543
32651,0.0,172.217.194.0-255,153,153,6,337064
32652,2.9e-05,172.31.36.0-255,66,219,6,337064
32653,3.6e-05,172.217.194.0-255,1484,1703,6,337064
32654,4.1e-05,172.31.36.0-255,66,1769,6,337064
32655,4.6e-05,172.217.194.0-255,2902,4671,6,337064
32656,4.8e-05,172.31.36.0-255,66,4737,6,337064
32657,5.4e-05,172.217.194.0-255,5738,10475,6,337064
32658,5.7e-05,172.31.36.0-255,66,10541,6,337064
32659,9.4e-05,172.217.194.0-255,3473,14014,6,337064
32660,9.8e-05,172.31.36.0-255,66,14080,6,337064
32661,0.00016,172.217.194.0-255,1484,15564,6,337064
32662,0.000166,172.31.36.0-255,66,15630,6,337064
32663,0.000171,172.217.194.0-255,1484,17114,6,337064
32664,0.000173,172.31.36.0-255,66,17180,6,337064
32665,0.000202,172.217.194.0-255,1484,18664,6,337064
32666,0.000205,172.31.36.0-255,66,18730,6,337064
32667,0.000211,172.217.194.0-255,5738,24468,6,337064
32668,0.000214,172.31.36.0-255,66,24534,6,337064
32669,0.00022,172.217.194.0-255,5738,30272,6,337064
32670,0.000222,172.31.36.0-255,66,30338,6,337064
32671,0.000253,172.217.194.0-255,8574,38912,6,337064
32672,0.000256,172.31.36.0-255,66,38978,6,337064
32673,0.000282,172.217.194.0-255,9274,48252,6,337064
32674,0.000285,172.31.36.0-255,66,48318,6,337064
32675,0.000387,172.217.194.0-255,1484,49802,6,337064
32676,0.000391,172.31.36.0-255,66,49868,6,337064
32677,0.000396,172.217.194.0-255,2902,52770,6,337064
32678,0.000398,172.217.194.0-255,1484,54254,6,337064
32679,0.0004,172.31.36.0-255,66,54320,6,337064
32680,0.000403,172.31.36.0-255,66,54386,6,337064
32681,0.000411,172.217.194.0-255,2902,57288,6,337064
32682,0.000414,172.31.36.0-255,66,57354,6,337064
32683,0.000428,172.217.194.0-255,1484,58838,6,337064
32684,0.00044,172.217.194.0-255,1484,60322,6,337064
32685,0.000443,172.31.36.0-255,66,60388,6,337064
32686,0.000476,172.217.194.0-255,4320,64708,6,337064
32687,0.000485,172.31.36.0-255,66,64774,6,337064
32688,0.000502,172.217.194.0-255,1484,66258,6,337064
32689,0.000519,172.217.194.0-255,4540,70798,6,337064
32690,0.000524,172.31.36.0-255,66,70864,6,337064
32691,0.000561,172.217.194.0-255,1484,72348,6,337064
32692,0.000567,172.217.194.0-255,2902,75250,6,337064
32693,0.000573,172.217.194.0-255,4320,79570,6,337064
32694,0.000587,172.31.36.0-255,66,79636,6,337064
32695,0.000589,172.217.194.0-255,1484,81120,6,337064
32696,0.0006,172.217.194.0-255,1484,82604,6,337064
32697,0.000604,172.31.36.0-255,66,82670,6,337064
32698,0.000617,172.217.194.0-255,5379,88049,6,337064
32699,0.000622,172.31.36.0-255,66,88115,6,337064
32700,0.000967,172.217.194.0-255,1484,89599,6,337064
32701,0.000984,172.217.194.0-255,1484,91083,6,337064
32702,0.000987,172.31.36.0-255,66,91149,6,337064
32703,0.001009,172.217.194.0-255,1484,92633,6,337064
32704,0.001015,172.217.194.0-255,5738,98371,6,337064
32705,0.001022,172.217.194.0-255,7156,105527,6,337064
32706,0.001024,172.31.36.0-255,66,105593,6,337064
32707,0.001029,172.31.36.0-255,66,105659,6,337064
32708,0.001047,172.217.194.0-255,5738,111397,6,337064
32709,0.00105,172.31.36.0-255,66,111463,6,337064
32710,0.00106,172.217.194.0-255,9992,121455,6,337064
32711,0.001063,172.217.194.0-255,766,122221,6,337064
32712,0.001068,172.31.36.0-255,66,122287,6,337064
32713,0.001116,172.217.194.0-255,1484,123771,6,337064
32714,0.00113,172.217.194.0-255,2902,126673,6,337064
32715,0.001143,172.31.36.0-255,66,126739,6,337064
32716,0.001179,172.217.194.0-255,5738,132477,6,337064
32717,0.001184,172.31.36.0-255,66,132543,6,337064
32718,0.001196,172.217.194.0-255,5738,138281,6,337064
32719,0.001202,172.31.36.0-255,66,138347,6,337064
32720,0.001215,172.217.194.0-255,1484,139831,6,337064
32721,0.00123,172.217.194.0-255,2184,142015,6,337064
32722,0.001238,172.31.36.0-255,66,142081,6,337064
32723,0.001462,172.217.194.0-255,1484,143565,6,337064
32724,0.00147,172.217.194.0-255,2902,146467,6,337064
32725,0.001474,172.31.36.0-255,66,146533,6,337064
32726,0.001479,172.217.194.0-255,1484,148017,6,337064
32727,0.001499,172.217.194.0-255,4320,152337,6,337064
32728,0.001502,172.217.194.0-255,1484,153821,6,337064
32729,0.001553,172.217.194.0-255,7156,160977,6,337064
32730,0.001572,172.217.194.0-255,3602,164579,6,337064
32731,0.001601,172.217.194.0-255,1484,166063,6,337064
32732,0.001618,172.217.194.0-255,2902,168965,6,337064
32733,0.001622,172.217.194.0-255,1484,170449,6,337064
32734,0.001643,172.217.194.0-255,4320,174769,6,337064
32735,0.001649,172.217.194.0-255,7156,181925,6,337064
32736,0.001665,172.217.194.0-255,4320,186245,6,337064
32737,0.001713,172.217.194.0-255,7156,193401,6,337064
32738,0.001733,172.217.194.0-255,2902,196303,6,337064
32739,0.001739,172.217.194.0-255,2184,198487,6,337064
32740,0.001975,172.217.194.0-255,1484,199971,6,337064
32741,0.001982,172.217.194.0-255,2902,202873,6,337064
32742,0.001988,172.217.194.0-255,5738,208611,6,337064
32743,0.00201,172.217.194.0-255,7156,215767,6,337064
32744,0.002015,172.217.194.0-255,2902,218669,6,337064
32745,0.002025,172.217.194.0-255,2902,221571,6,337064
32746,0.00205,172.217.194.0-255,8574,230145,6,337064
32747,0.002054,172.217.194.0-255,2902,233047,6,337064
32748,0.002073,172.217.194.0-255,7156,240203,6,337064
32749,0.002086,172.217.194.0-255,6438,246641,6,337064
32750,0.002089,172.217.194.0-255,1484,248125,6,337064
32751,0.002105,172.217.194.0-255,5738,253863,6,337064
32752,0.002119,172.217.194.0-255,5738,259601,6,337064
32753,0.002132,172.217.194.0-255,4320,263921,6,337064
32754,0.002136,172.217.194.0-255,2184,266105,6,337064
32755,0.002139,172.217.194.0-255,2902,269007,6,337064
32756,0.002145,172.217.194.0-255,5738,274745,6,337064
32757,0.002161,172.217.194.0-255,1484,276229,6,337064
32758,0.002164,172.217.194.0-255,2902,279131,6,337064
32759,0.002178,172.217.194.0-255,4320,283451,6,337064
32760,0.00219,172.217.194.0-255,4320,287771,6,337064
32761,0.002195,172.217.194.0-255,4320,292091,6,337064
32762,0.00222,172.217.194.0-255,7856,299947,6,337064
32763,0.002257,172.217.194.0-255,4320,304267,6,337064
32764,0.002272,172.217.194.0-255,4320,308587,6,337064
32765,0.002274,172.217.194.0-255,1484,310071,6,337064
32766,0.002295,172.217.194.0-255,7156,317227,6,337064
32767,0.002313,172.217.194.0-255,1484,318711,6,337064
32768,0.00232,172.217.194.0-255,7156,325867,6,337064
32769,0.002345,172.217.194.0-255,7856,333723,6,337064
32770,0.002366,172.217.194.0-255,2902,336625,6,337064
32771,0.002405,172.217.194.0-255,97,336722,6,337064
32772,0.005712,172.31.36.0-255,66,336788,6,337064
32773,0.008048,172.217.194.0-255,105,336893,6,337064
32774,0.009225,172.31.36.0-255,66,336959,6,337064
32775,0.00926,172.31.36.0-255,105,337064,6,337064
32776,0.0,74.125.24.0-255,152,152,6,220102
32777,1.9e-05,172.31.36.0-255,66,218,6,220102
32778,2.8e-05,74.125.24.0-255,1484,1702,6,220102
32779,3.2e-05,172.31.36.0-255,66,1768,6,220102
32780,3.7e-05,74.125.24.0-255,2902,4670,6,220102
32781,4.1e-05,172.31.36.0-255,66,4736,6,220102
32782,4.9e-05,74.125.24.0-255,7156,11892,6,220102
32783,5.3e-05,172.31.36.0-255,66,11958,6,220102
32784,5.7e-05,74.125.24.0-255,2065,14023,6,220102
32785,6e-05,172.31.36.0-255,66,14089,6,220102
32786,7.9e-05,74.125.24.0-255,2902,16991,6,220102
32787,8.2e-05,172.31.36.0-255,66,17057,6,220102
32788,8.9e-05,74.125.24.0-255,7156,24213,6,220102
32789,9.1e-05,172.31.36.0-255,66,24279,6,220102
32790,0.000123,74.125.24.0-255,6797,31076,6,220102
32791,0.000126,172.31.36.0-255,66,31142,6,220102
32792,0.00017,74.125.24.0-255,1484,32626,6,220102
32793,0.000175,172.31.36.0-255,66,32692,6,220102
32794,0.000185,74.125.24.0-255,2902,35594,6,220102
32795,0.000187,172.31.36.0-255,66,35660,6,220102
32796,0.000191,74.125.24.0-255,1484,37144,6,220102
32797,0.000193,172.31.36.0-255,66,37210,6,220102
32798,0.000219,74.125.24.0-255,4320,41530,6,220102
32799,0.000222,172.31.36.0-255,66,41596,6,220102
32800,0.000228,74.125.24.0-255,4320,45916,6,220102
32801,0.00023,172.31.36.0-255,66,45982,6,220102
32802,0.000244,172.31.36.0-255,66,46048,6,220102
32803,0.000287,74.125.24.0-255,7094,53142,6,220102
32804,0.00029,172.31.36.0-255,66,53208,6,220102
32805,0.000299,74.125.24.0-255,130,53338,6,220102
32806,0.000304,172.31.36.0-255,66,53404,6,220102
32807,0.00031,74.125.24.0-255,348,53752,6,220102
32808,0.000695,74.125.24.0-255,1484,55236,6,220102
32809,0.000701,172.31.36.0-255,66,55302,6,220102
32810,0.000707,74.125.24.0-255,2902,58204,6,220102
32811,0.00071,172.31.36.0-255,66,58270,6,220102
32812,0.000717,74.125.24.0-255,5738,64008,6,220102
32813,0.00072,172.31.36.0-255,66,64074,6,220102
32814,0.000725,74.125.24.0-255,4320,68394,6,220102
32815,0.000727,172.31.36.0-255,66,68460,6,220102
32816,0.00074,172.31.36.0-255,66,68526,6,220102
32817,0.000771,74.125.24.0-255,7856,76382,6,220102
32818,0.000774,172.31.36.0-255,66,76448,6,220102
32819,0.001171,74.125.24.0-255,1484,77932,6,220102
32820,0.001177,74.125.24.0-255,2902,80834,6,220102
32821,0.001181,172.31.36.0-255,66,80900,6,220102
32822,0.001188,74.125.24.0-255,5738,86638,6,220102
32823,0.00119,172.31.36.0-255,66,86704,6,220102
32824,0.001215,74.125.24.0-255,8574,95278,6,220102
32825,0.001217,172.31.36.0-255,66,95344,6,220102
32826,0.001245,74.125.24.0-255,4320,99664,6,220102
32827,0.001248,172.31.36.0-255,66,99730,6,220102
32828,0.001256,74.125.24.0-255,7156,106886,6,220102
32829,0.001258,172.31.36.0-255,66,106952,6,220102
32830,0.001284,74.125.24.0-255,3602,110554,6,220102
32831,0.001287,172.31.36.0-255,66,110620,6,220102
32832,0.001492,74.125.24.0-255,1484,112104,6,220102
32833,0.001499,74.125.24.0-255,2902,115006,6,220102
32834,0.001502,172.31.36.0-255,66,115072,6,220102
32835,0.001507,74.125.24.0-255,2902,117974,6,220102
32836,0.001509,172.31.36.0-255,66,118040,6,220102
32837,0.001523,74.125.24.0-255,2902,120942,6,220102
32838,0.001526,172.31.36.0-255,66,121008,6,220102
32839,0.001532,74.125.24.0-255,4320,125328,6,220102
32840,0.001534,172.31.36.0-255,66,125394,6,220102
32841,0.001566,74.125.24.0-255,5738,131132,6,220102
32842,0.001569,172.31.36.0-255,66,131198,6,220102
32843,0.001581,172.31.36.0-255,66,131264,6,220102
32844,0.001585,74.125.24.0-255,2184,133448,6,220102
32845,0.001587,172.31.36.0-255,66,133514,6,220102
32846,0.00227,74.125.24.0-255,1484,134998,6,220102
32847,0.002279,74.125.24.0-255,2902,137900,6,220102
32848,0.002284,172.31.36.0-255,66,137966,6,220102
32849,0.002291,74.125.24.0-255,4320,142286,6,220102
32850,0.002293,172.31.36.0-255,66,142352,6,220102
32851,0.002308,74.125.24.0-255,1484,143836,6,220102
32852,0.002322,172.31.36.0-255,66,143902,6,220102
32853,0.002348,74.125.24.0-255,10692,154594,6,220102
32854,0.00235,172.31.36.0-255,66,154660,6,220102
32855,0.002382,74.125.24.0-255,1484,156144,6,220102
32856,0.002387,74.125.24.0-255,2902,159046,6,220102
32857,0.002389,172.31.36.0-255,66,159112,6,220102
32858,0.002404,74.125.24.0-255,5738,164850,6,220102
32859,0.002407,172.31.36.0-255,66,164916,6,220102
32860,0.002443,172.31.36.0-255,66,164982,6,220102
32861,0.002451,74.125.24.0-255,7156,172138,6,220102
32862,0.002453,172.31.36.0-255,66,172204,6,220102
32863,0.002491,74.125.24.0-255,6438,178642,6,220102
32864,0.002494,172.31.36.0-255,66,178708,6,220102
32865,0.002499,74.125.24.0-255,4320,183028,6,220102
32866,0.002502,172.31.36.0-255,66,183094,6,220102
32867,0.002516,74.125.24.0-255,2902,185996,6,220102
32868,0.002518,172.31.36.0-255,66,186062,6,220102
32869,0.002542,74.125.24.0-255,7156,193218,6,220102
32870,0.002544,172.31.36.0-255,66,193284,6,220102
32871,0.002574,74.125.24.0-255,8574,201858,6,220102
32872,0.002577,172.31.36.0-255,66,201924,6,220102
32873,0.002584,74.125.24.0-255,7156,209080,6,220102
32874,0.002587,172.31.36.0-255,66,209146,6,220102
32875,0.002589,74.125.24.0-255,766,209912,6,220102
32876,0.005134,74.125.24.0-255,4320,214232,6,220102
32877,0.005142,172.31.36.0-255,66,214298,6,220102
32878,0.007682,74.125.24.0-255,5738,220036,6,220102
32879,0.007688,172.31.36.0-255,66,220102,6,220102
32880,0.0,74.125.24.0-255,153,153,6,226509
32881,1.4e-05,172.31.36.0-255,66,219,6,226509
32882,2e-05,74.125.24.0-255,1484,1703,6,226509
32883,2.6e-05,172.31.36.0-255,66,1769,6,226509
32884,3.2e-05,74.125.24.0-255,2902,4671,6,226509
32885,3.6e-05,172.31.36.0-255,66,4737,6,226509
32886,4.4e-05,74.125.24.0-255,7156,11893,6,226509
32887,4.7e-05,172.31.36.0-255,66,11959,6,226509
32888,5.1e-05,74.125.24.0-255,2076,14035,6,226509
32889,5.4e-05,172.31.36.0-255,66,14101,6,226509
32890,0.0001,74.125.24.0-255,4320,18421,6,226509
32891,0.000103,172.31.36.0-255,66,18487,6,226509
32892,0.00013,74.125.24.0-255,7156,25643,6,226509
32893,0.000133,172.31.36.0-255,66,25709,6,226509
32894,0.000141,74.125.24.0-255,8574,34283,6,226509
32895,0.000143,172.31.36.0-255,66,34349,6,226509
32896,0.000177,172.31.36.0-255,66,34415,6,226509
32897,0.000592,74.125.24.0-255,1484,35899,6,226509
32898,0.000597,172.31.36.0-255,66,35965,6,226509
32899,0.000604,74.125.24.0-255,2902,38867,6,226509
32900,0.000606,172.31.36.0-255,66,38933,6,226509
32901,0.000613,74.125.24.0-255,5738,44671,6,226509
32902,0.000615,172.31.36.0-255,66,44737,6,226509
32903,0.000668,74.125.24.0-255,7133,51870,6,226509
32904,0.000671,172.31.36.0-255,66,51936,6,226509
32905,0.000691,74.125.24.0-255,4320,56256,6,226509
32906,0.000694,172.31.36.0-255,66,56322,6,226509
32907,0.000712,74.125.24.0-255,2902,59224,6,226509
32908,0.000715,172.31.36.0-255,66,59290,6,226509
32909,0.000722,74.125.24.0-255,7156,66446,6,226509
32910,0.000725,172.31.36.0-255,66,66512,6,226509
32911,0.000739,74.125.24.0-255,1484,67996,6,226509
32912,0.000767,172.31.36.0-255,66,68062,6,226509
32913,0.000772,74.125.24.0-255,3885,71947,6,226509
32914,0.000774,172.31.36.0-255,66,72013,6,226509
32915,0.000862,74.125.24.0-255,1484,73497,6,226509
32916,0.000868,74.125.24.0-255,2902,76399,6,226509
32917,0.00087,172.31.36.0-255,66,76465,6,226509
32918,0.000893,74.125.24.0-255,5738,82203,6,226509
32919,0.000895,172.31.36.0-255,66,82269,6,226509
32920,0.000899,74.125.24.0-255,1484,83753,6,226509
32921,0.000921,74.125.24.0-255,8574,92327,6,226509
32922,0.000924,172.31.36.0-255,66,92393,6,226509
32923,0.000938,74.125.24.0-255,2902,95295,6,226509
32924,0.000944,74.125.24.0-255,4320,99615,6,226509
32925,0.000952,172.31.36.0-255,66,99681,6,226509
32926,0.000956,172.31.36.0-255,66,99747,6,226509
32927,0.000994,74.125.24.0-255,6438,106185,6,226509
32928,0.000998,172.31.36.0-255,66,106251,6,226509
32929,0.001134,74.125.24.0-255,1484,107735,6,226509
32930,0.001146,74.125.24.0-255,1484,109219,6,226509
32931,0.001149,172.31.36.0-255,66,109285,6,226509
32932,0.001168,74.125.24.0-255,1484,110769,6,226509
32933,0.001175,74.125.24.0-255,5738,116507,6,226509
32934,0.001177,172.31.36.0-255,66,116573,6,226509
32935,0.001182,74.125.24.0-255,2902,119475,6,226509
32936,0.001184,172.31.36.0-255,66,119541,6,226509
32937,0.001201,74.125.24.0-255,4320,123861,6,226509
32938,0.001203,172.31.36.0-255,66,123927,6,226509
32939,0.001211,74.125.24.0-255,7156,131083,6,226509
32940,0.001213,172.31.36.0-255,66,131149,6,226509
32941,0.00124,74.125.24.0-255,7156,138305,6,226509
32942,0.001243,74.125.24.0-255,2184,140489,6,226509
32943,0.001247,74.125.24.0-255,2902,143391,6,226509
32944,0.001251,172.31.36.0-255,66,143457,6,226509
32945,0.001254,172.31.36.0-255,66,143523,6,226509
32946,0.001257,172.31.36.0-255,66,143589,6,226509
32947,0.001271,74.125.24.0-255,7156,150745,6,226509
32948,0.001274,172.31.36.0-255,66,150811,6,226509
32949,0.0013,74.125.24.0-255,5738,156549,6,226509
32950,0.001304,172.31.36.0-255,66,156615,6,226509
32951,0.001329,74.125.24.0-255,9992,166607,6,226509
32952,0.001332,172.31.36.0-255,66,166673,6,226509
32953,0.001335,74.125.24.0-255,1484,168157,6,226509
32954,0.001358,74.125.24.0-255,6438,174595,6,226509
32955,0.001361,172.31.36.0-255,66,174661,6,226509
32956,0.001615,74.125.24.0-255,1484,176145,6,226509
32957,0.00164,74.125.24.0-255,2902,179047,6,226509
32958,0.001644,172.31.36.0-255,66,179113,6,226509
32959,0.001665,74.125.24.0-255,2902,182015,6,226509
32960,0.001668,172.31.36.0-255,66,182081,6,226509
32961,0.001674,74.125.24.0-255,5738,187819,6,226509
32962,0.001676,172.31.36.0-255,66,187885,6,226509
32963,0.001693,74.125.24.0-255,1484,189369,6,226509
32964,0.001714,74.125.24.0-255,9992,199361,6,226509
32965,0.001717,172.31.36.0-255,66,199427,6,226509
32966,0.001733,74.125.24.0-255,5738,205165,6,226509
32967,0.001735,172.31.36.0-255,66,205231,6,226509
32968,0.001752,74.125.24.0-255,3602,208833,6,226509
32969,0.001755,172.31.36.0-255,66,208899,6,226509
32970,0.004058,74.125.24.0-255,1484,210383,6,226509
32971,0.004142,74.125.24.0-255,4320,214703,6,226509
32972,0.004148,172.31.36.0-255,66,214769,6,226509
32973,0.006476,74.125.24.0-255,2902,217671,6,226509
32974,0.006482,172.31.36.0-255,66,217737,6,226509
32975,0.006499,74.125.24.0-255,2902,220639,6,226509
32976,0.006501,172.31.36.0-255,66,220705,6,226509
32977,0.008867,74.125.24.0-255,5738,226443,6,226509
32978,0.008874,172.31.36.0-255,66,226509,6,226509
32979,0.0,74.125.24.0-255,152,152,6,288357
32980,3.6e-05,172.31.36.0-255,66,218,6,288357
32981,4.3e-05,74.125.24.0-255,1484,1702,6,288357
32982,4.7e-05,172.31.36.0-255,66,1768,6,288357
32983,5.3e-05,74.125.24.0-255,2902,4670,6,288357
32984,5.7e-05,172.31.36.0-255,66,4736,6,288357
32985,6.4e-05,74.125.24.0-255,7156,11892,6,288357
32986,6.7e-05,172.31.36.0-255,66,11958,6,288357
32987,7.1e-05,74.125.24.0-255,1978,13936,6,288357
32988,7.3e-05,172.31.36.0-255,66,14002,6,288357
32989,7.8e-05,74.125.24.0-255,2902,16904,6,288357
32990,8e-05,172.31.36.0-255,66,16970,6,288357
32991,0.00011,74.125.24.0-255,7156,24126,6,288357
32992,0.000113,172.31.36.0-255,66,24192,6,288357
32993,0.000119,74.125.24.0-255,5738,29930,6,288357
32994,0.000121,172.31.36.0-255,66,29996,6,288357
32995,0.000133,74.125.24.0-255,1125,31121,6,288357
32996,0.000136,172.31.36.0-255,66,31187,6,288357
32997,0.000219,74.125.24.0-255,1484,32671,6,288357
32998,0.000223,172.31.36.0-255,66,32737,6,288357
32999,0.000228,74.125.24.0-255,2902,35639,6,288357
33000,0.00023,172.31.36.0-255,66,35705,6,288357
33001,0.000235,74.125.24.0-255,4320,40025,6,288357
33002,0.000238,172.31.36.0-255,66,40091,6,288357
33003,0.000255,74.125.24.0-255,1484,41575,6,288357
33004,0.000258,172.31.36.0-255,66,41641,6,288357
33005,0.000263,74.125.24.0-255,4320,45961,6,288357
33006,0.000266,172.31.36.0-255,66,46027,6,288357
33007,0.000295,74.125.24.0-255,6797,52824,6,288357
33008,0.000298,172.31.36.0-255,66,52890,6,288357
33009,0.000311,172.31.36.0-255,66,52956,6,288357
33010,0.000314,74.125.24.0-255,1472,54428,6,288357
33011,0.000341,74.125.24.0-255,331,54759,6,288357
33012,0.000345,172.31.36.0-255,66,54825,6,288357
33013,0.000512,74.125.24.0-255,1484,56309,6,288357
33014,0.000518,74.125.24.0-255,2902,59211,6,288357
33015,0.000521,172.31.36.0-255,66,59277,6,288357
33016,0.000546,74.125.24.0-255,5738,65015,6,288357
33017,0.000549,172.31.36.0-255,66,65081,6,288357
33018,0.000572,172.31.36.0-255,66,65147,6,288357
33019,0.000593,74.125.24.0-255,1484,66631,6,288357
33020,0.000601,74.125.24.0-255,5738,72369,6,288357
33021,0.000606,172.31.36.0-255,66,72435,6,288357
33022,0.00063,74.125.24.0-255,5020,77455,6,288357
33023,0.000635,172.31.36.0-255,66,77521,6,288357
33024,0.000908,74.125.24.0-255,1484,79005,6,288357
33025,0.000913,74.125.24.0-255,2902,81907,6,288357
33026,0.000917,172.31.36.0-255,66,81973,6,288357
33027,0.000922,74.125.24.0-255,2902,84875,6,288357
33028,0.000924,172.31.36.0-255,66,84941,6,288357
33029,0.00094,74.125.24.0-255,2902,87843,6,288357
33030,0.000943,172.31.36.0-255,66,87909,6,288357
33031,0.00096,74.125.24.0-255,5738,93647,6,288357
33032,0.000962,172.31.36.0-255,66,93713,6,288357
33033,0.000979,74.125.24.0-255,7156,100869,6,288357
33034,0.000982,172.31.36.0-255,66,100935,6,288357
33035,0.00102,74.125.24.0-255,8574,109509,6,288357
33036,0.001023,172.31.36.0-255,66,109575,6,288357
33037,0.001048,74.125.24.0-255,2184,111759,6,288357
33038,0.001051,172.31.36.0-255,66,111825,6,288357
33039,0.001059,74.125.24.0-255,8574,120399,6,288357
33040,0.001061,172.31.36.0-255,66,120465,6,288357
33041,0.00107,74.125.24.0-255,9992,130457,6,288357
33042,0.001073,172.31.36.0-255,66,130523,6,288357
33043,0.001092,74.125.24.0-255,8574,139097,6,288357
33044,0.001103,172.31.36.0-255,66,139163,6,288357
33045,0.00111,74.125.24.0-255,6438,145601,6,288357
33046,0.001118,172.31.36.0-255,66,145667,6,288357
33047,0.001134,74.125.24.0-255,1484,147151,6,288357
33048,0.001139,74.125.24.0-255,2902,150053,6,288357
33049,0.001145,172.31.36.0-255,66,150119,6,288357
33050,0.001158,74.125.24.0-255,4320,154439,6,288357
33051,0.001169,172.31.36.0-255,66,154505,6,288357
33052,0.001172,74.125.24.0-255,1484,155989,6,288357
33053,0.001179,74.125.24.0-255,7156,163145,6,288357
33054,0.001186,172.31.36.0-255,66,163211,6,288357
33055,0.001196,74.125.24.0-255,5738,168949,6,288357
33056,0.001199,74.125.24.0-255,1484,170433,6,288357
33057,0.001203,172.31.36.0-255,66,170499,6,288357
33058,0.001233,74.125.24.0-255,4320,174819,6,288357
33059,0.001237,172.31.36.0-255,66,174885,6,288357
33060,0.001259,74.125.24.0-255,5020,179905,6,288357
33061,0.001272,172.31.36.0-255,66,179971,6,288357
33062,0.001715,74.125.24.0-255,1484,181455,6,288357
33063,0.001722,74.125.24.0-255,2902,184357,6,288357
33064,0.001726,172.31.36.0-255,66,184423,6,288357
33065,0.001745,74.125.24.0-255,1484,185907,6,288357
33066,0.001751,74.125.24.0-255,4320,190227,6,288357
33067,0.001753,172.31.36.0-255,66,190293,6,288357
33068,0.001769,74.125.24.0-255,1484,191777,6,288357
33069,0.001773,74.125.24.0-255,1484,193261,6,288357
33070,0.001775,172.31.36.0-255,66,193327,6,288357
33071,0.001813,172.31.36.0-255,66,193393,6,288357
33072,0.001822,74.125.24.0-255,9274,202667,6,288357
33073,0.001825,172.31.36.0-255,66,202733,6,288357
33074,0.001843,74.125.24.0-255,1484,204217,6,288357
33075,0.001863,74.125.24.0-255,2902,207119,6,288357
33076,0.001866,172.31.36.0-255,66,207185,6,288357
33077,0.001873,74.125.24.0-255,5738,212923,6,288357
33078,0.001875,172.31.36.0-255,66,212989,6,288357
33079,0.001879,74.125.24.0-255,2902,215891,6,288357
33080,0.001884,172.31.36.0-255,66,215957,6,288357
33081,0.001904,74.125.24.0-255,9992,225949,6,288357
33082,0.001911,74.125.24.0-255,7156,233105,6,288357
33083,0.001912,172.31.36.0-255,66,233171,6,288357
33084,0.001915,172.31.36.0-255,66,233237,6,288357
33085,0.001954,74.125.24.0-255,3602,236839,6,288357
33086,0.00196,74.125.24.0-255,4320,241159,6,288357
33087,0.001964,172.31.36.0-255,66,241225,6,288357
33088,0.001973,74.125.24.0-255,2902,244127,6,288357
33089,0.001978,172.31.36.0-255,66,244193,6,288357
33090,0.001992,74.125.24.0-255,7156,251349,6,288357
33091,0.001995,74.125.24.0-255,1484,252833,6,288357
33092,0.001995,172.31.36.0-255,66,252899,6,288357
33093,0.002021,74.125.24.0-255,9992,262891,6,288357
33094,0.002029,172.31.36.0-255,66,262957,6,288357
33095,0.002053,74.125.24.0-255,7856,270813,6,288357
33096,0.002058,172.31.36.0-255,66,270879,6,288357
33097,0.002098,74.125.24.0-255,1484,272363,6,288357
33098,0.004131,74.125.24.0-255,4320,276683,6,288357
33099,0.004151,172.31.36.0-255,66,276749,6,288357
33100,0.006243,74.125.24.0-255,5738,282487,6,288357
33101,0.00626,172.31.36.0-255,66,282553,6,288357
33102,0.008336,74.125.24.0-255,5738,288291,6,288357
33103,0.008339,172.31.36.0-255,66,288357,6,288357
33104,0.0,172.31.36.0-255,105,105,6,459
33105,0.000232,172.31.36.0-255,90,195,6,459
33106,0.000243,172.31.36.0-255,66,261,6,459
33107,0.002536,74.125.130.0-255,66,327,6,459
33108,0.002558,74.125.130.0-255,66,393,6,459
33109,0.002574,172.31.36.0-255,66,459,6,459
33110,0.0,172.31.36.0-255,66,66,6,66
33111,0.0,74.125.130.0-255,150,150,6,227300
33112,3e-05,172.31.36.0-255,66,216,6,227300
33113,3.8e-05,74.125.130.0-255,1484,1700,6,227300
33114,4.2e-05,172.31.36.0-255,66,1766,6,227300
33115,4.7e-05,74.125.130.0-255,2902,4668,6,227300
33116,5.8e-05,172.31.36.0-255,66,4734,6,227300
33117,6.1e-05,74.125.130.0-255,1484,6218,6,227300
33118,7.2e-05,172.31.36.0-255,66,6284,6,227300
33119,0.0001,74.125.130.0-255,2902,9186,6,227300
33120,0.000104,172.31.36.0-255,66,9252,6,227300
33121,0.00011,74.125.130.0-255,4320,13572,6,227300
33122,0.000114,172.31.36.0-255,66,13638,6,227300
33123,0.00014,74.125.130.0-255,691,14329,6,227300
33124,0.000143,172.31.36.0-255,66,14395,6,227300
33125,0.000198,74.125.130.0-255,1484,15879,6,227300
33126,0.000202,172.31.36.0-255,66,15945,6,227300
33127,0.000205,74.125.130.0-255,1484,17429,6,227300
33128,0.000207,172.31.36.0-255,66,17495,6,227300
33129,0.000228,74.125.130.0-255,2902,20397,6,227300
33130,0.000232,172.31.36.0-255,66,20463,6,227300
33131,0.000243,74.125.130.0-255,5738,26201,6,227300
33132,0.000246,172.31.36.0-255,66,26267,6,227300
33133,0.000284,74.125.130.0-255,5379,31646,6,227300
33134,0.000289,172.31.36.0-255,66,31712,6,227300
33135,0.00045,74.125.130.0-255,1484,33196,6,227300
33136,0.000454,172.31.36.0-255,66,33262,6,227300
33137,0.000484,74.125.130.0-255,2902,36164,6,227300
33138,0.000488,172.31.36.0-255,66,36230,6,227300
33139,0.000494,74.125.130.0-255,4320,40550,6,227300
33140,0.000497,172.31.36.0-255,66,40616,6,227300
33141,0.000527,74.125.130.0-255,4320,44936,6,227300
33142,0.00053,172.31.36.0-255,66,45002,6,227300
33143,0.000556,74.125.130.0-255,4320,49322,6,227300
33144,0.000559,172.31.36.0-255,66,49388,6,227300
33145,0.000584,74.125.130.0-255,1125,50513,6,227300
33146,0.000589,74.125.130.0-255,1484,51997,6,227300
33147,0.000592,172.31.36.0-255,66,52063,6,227300
33148,0.000619,74.125.130.0-255,8574,60637,6,227300
33149,0.000623,172.31.36.0-255,66,60703,6,227300
33150,0.000626,74.125.130.0-255,1484,62187,6,227300
33151,0.00063,74.125.130.0-255,2902,65089,6,227300
33152,0.000635,172.31.36.0-255,66,65155,6,227300
33153,0.000672,74.125.130.0-255,1125,66280,6,227300
33154,0.000752,74.125.130.0-255,646,66926,6,227300
33155,0.000756,172.31.36.0-255,66,66992,6,227300
33156,0.00108,74.125.130.0-255,1484,68476,6,227300
33157,0.00109,74.125.130.0-255,2902,71378,6,227300
33158,0.001094,172.31.36.0-255,66,71444,6,227300
33159,0.001099,74.125.130.0-255,1484,72928,6,227300
33160,0.001102,74.125.130.0-255,1484,74412,6,227300
33161,0.001104,172.31.36.0-255,66,74478,6,227300
33162,0.001121,74.125.130.0-255,1484,75962,6,227300
33163,0.001128,74.125.130.0-255,5738,81700,6,227300
33164,0.001134,172.31.36.0-255,66,81766,6,227300
33165,0.001162,74.125.130.0-255,7156,88922,6,227300
33166,0.001165,172.31.36.0-255,66,88988,6,227300
33167,0.00118,74.125.130.0-255,1484,90472,6,227300
33168,0.001194,74.125.130.0-255,9992,100464,6,227300
33169,0.001197,172.31.36.0-255,66,100530,6,227300
33170,0.001199,74.125.130.0-255,766,101296,6,227300
33171,0.001539,74.125.130.0-255,1484,102780,6,227300
33172,0.001544,172.31.36.0-255,66,102846,6,227300
33173,0.001571,74.125.130.0-255,1484,104330,6,227300
33174,0.001575,74.125.130.0-255,2902,107232,6,227300
33175,0.001577,172.31.36.0-255,66,107298,6,227300
33176,0.001582,74.125.130.0-255,4320,111618,6,227300
33177,0.001584,172.31.36.0-255,66,111684,6,227300
33178,0.001598,74.125.130.0-255,1484,113168,6,227300
33179,0.00161,74.125.130.0-255,2902,116070,6,227300
33180,0.001612,172.31.36.0-255,66,116136,6,227300
33181,0.001643,74.125.130.0-255,7156,123292,6,227300
33182,0.001646,172.31.36.0-255,66,123358,6,227300
33183,0.001678,74.125.130.0-255,8574,131932,6,227300
33184,0.00168,172.31.36.0-255,66,131998,6,227300
33185,0.001702,74.125.130.0-255,2902,134900,6,227300
33186,0.001704,172.31.36.0-255,66,134966,6,227300
33187,0.001706,74.125.130.0-255,766,135732,6,227300
33188,0.001831,74.125.130.0-255,1484,137216,6,227300
33189,0.001834,172.31.36.0-255,66,137282,6,227300
33190,0.001853,74.125.130.0-255,2902,140184,6,227300
33191,0.001855,172.31.36.0-255,66,140250,6,227300
33192,0.001859,74.125.130.0-255,2902,143152,6,227300
33193,0.001861,172.31.36.0-255,66,143218,6,227300
33194,0.001864,74.125.130.0-255,1484,144702,6,227300
33195,0.001891,74.125.130.0-255,2902,147604,6,227300
33196,0.001893,172.31.36.0-255,66,147670,6,227300
33197,0.0019,74.125.130.0-255,7156,154826,6,227300
33198,0.001903,172.31.36.0-255,66,154892,6,227300
33199,0.001938,74.125.130.0-255,1484,156376,6,227300
33200,0.001944,74.125.130.0-255,5738,162114,6,227300
33201,0.001947,172.31.36.0-255,66,162180,6,227300
33202,0.001954,74.125.130.0-255,7156,169336,6,227300
33203,0.001956,172.31.36.0-255,66,169402,6,227300
33204,0.001958,74.125.130.0-255,766,170168,6,227300
33205,0.002203,74.125.130.0-255,1484,171652,6,227300
33206,0.002205,172.31.36.0-255,66,171718,6,227300
33207,0.002229,74.125.130.0-255,2902,174620,6,227300
33208,0.002231,172.31.36.0-255,66,174686,6,227300
33209,0.002237,74.125.130.0-255,4320,179006,6,227300
33210,0.002239,172.31.36.0-255,66,179072,6,227300
33211,0.002266,74.125.130.0-255,1484,180556,6,227300
33212,0.002269,74.125.130.0-255,1484,182040,6,227300
33213,0.002271,172.31.36.0-255,66,182106,6,227300
33214,0.002306,172.31.36.0-255,66,182172,6,227300
33215,0.002335,74.125.130.0-255,10692,192864,6,227300
33216,0.002337,172.31.36.0-255,66,192930,6,227300
33217,0.002376,172.31.36.0-255,66,192996,6,227300
33218,0.002382,74.125.130.0-255,5738,198734,6,227300
33219,0.002386,172.31.36.0-255,66,198800,6,227300
33220,0.002389,74.125.130.0-255,1484,200284,6,227300
33221,0.002413,74.125.130.0-255,5738,206022,6,227300
33222,0.002415,172.31.36.0-255,66,206088,6,227300
33223,0.00245,74.125.130.0-255,9274,215362,6,227300
33224,0.002453,172.31.36.0-255,66,215428,6,227300
33225,0.005074,74.125.130.0-255,2902,218330,6,227300
33226,0.005078,172.31.36.0-255,66,218396,6,227300
33227,0.005096,74.125.130.0-255,2902,221298,6,227300
33228,0.005098,172.31.36.0-255,66,221364,6,227300
33229,0.007715,74.125.130.0-255,2902,224266,6,227300
33230,0.007722,172.31.36.0-255,66,224332,6,227300
33231,0.007764,74.125.130.0-255,2902,227234,6,227300
33232,0.007768,172.31.36.0-255,66,227300,6,227300
33233,0.0,172.217.194.0-255,296,296,6,163677
33234,2.3e-05,172.31.36.0-255,66,362,6,163677
33235,3e-05,172.217.194.0-255,1484,1846,6,163677
33236,3.3e-05,172.31.36.0-255,66,1912,6,163677
33237,4e-05,172.217.194.0-255,4320,6232,6,163677
33238,4.2e-05,172.31.36.0-255,66,6298,6,163677
33239,0.00011,172.217.194.0-255,7488,13786,6,163677
33240,0.000116,172.31.36.0-255,66,13852,6,163677
33241,0.00012,172.217.194.0-255,2902,16754,6,163677
33242,0.000122,172.31.36.0-255,66,16820,6,163677
33243,0.000128,172.217.194.0-255,4320,21140,6,163677
33244,0.000137,172.31.36.0-255,66,21206,6,163677
33245,0.000146,172.217.194.0-255,8574,29780,6,163677
33246,0.000149,172.31.36.0-255,66,29846,6,163677
33247,0.000179,172.217.194.0-255,1125,30971,6,163677
33248,0.000184,172.31.36.0-255,66,31037,6,163677
33249,0.000501,172.217.194.0-255,1484,32521,6,163677
33250,0.000506,172.31.36.0-255,66,32587,6,163677
33251,0.000511,172.217.194.0-255,2902,35489,6,163677
33252,0.000514,172.31.36.0-255,66,35555,6,163677
33253,0.000526,172.217.194.0-255,5738,41293,6,163677
33254,0.00053,172.31.36.0-255,66,41359,6,163677
33255,0.000538,172.217.194.0-255,6797,48156,6,163677
33256,0.000541,172.31.36.0-255,66,48222,6,163677
33257,0.000548,172.217.194.0-255,7156,55378,6,163677
33258,0.000551,172.31.36.0-255,66,55444,6,163677
33259,0.000592,172.217.194.0-255,9905,65349,6,163677
33260,0.000596,172.31.36.0-255,66,65415,6,163677
33261,0.0006,172.217.194.0-255,121,65536,6,163677
33262,0.000602,172.31.36.0-255,66,65602,6,163677
33263,0.000763,172.217.194.0-255,381,65983,6,163677
33264,0.000769,172.31.36.0-255,66,66049,6,163677
33265,0.001302,172.217.194.0-255,1484,67533,6,163677
33266,0.001313,172.217.194.0-255,2902,70435,6,163677
33267,0.001317,172.31.36.0-255,66,70501,6,163677
33268,0.001325,172.217.194.0-255,5738,76239,6,163677
33269,0.001327,172.31.36.0-255,66,76305,6,163677
33270,0.001341,172.217.194.0-255,5738,82043,6,163677
33271,0.001344,172.31.36.0-255,66,82109,6,163677
33272,0.001375,172.217.194.0-255,5738,87847,6,163677
33273,0.001383,172.31.36.0-255,66,87913,6,163677
33274,0.001387,172.217.194.0-255,1484,89397,6,163677
33275,0.001416,172.217.194.0-255,10692,100089,6,163677
33276,0.001418,172.31.36.0-255,66,100155,6,163677
33277,0.00196,172.217.194.0-255,1484,101639,6,163677
33278,0.001968,172.217.194.0-255,2902,104541,6,163677
33279,0.001973,172.31.36.0-255,66,104607,6,163677
33280,0.00198,172.217.194.0-255,5738,110345,6,163677
33281,0.001981,172.31.36.0-255,66,110411,6,163677
33282,0.001997,172.217.194.0-255,1484,111895,6,163677
33283,0.002029,172.217.194.0-255,8574,120469,6,163677
33284,0.002032,172.31.36.0-255,66,120535,6,163677
33285,0.002049,172.31.36.0-255,66,120601,6,163677
33286,0.002053,172.217.194.0-255,2184,122785,6,163677
33287,0.002055,172.31.36.0-255,66,122851,6,163677
33288,0.002242,172.217.194.0-255,1484,124335,6,163677
33289,0.002245,172.217.194.0-255,1484,125819,6,163677
33290,0.002247,172.31.36.0-255,66,125885,6,163677
33291,0.002274,172.217.194.0-255,1484,127369,6,163677
33292,0.002281,172.217.194.0-255,5738,133107,6,163677
33293,0.002283,172.31.36.0-255,66,133173,6,163677
33294,0.002288,172.217.194.0-255,4320,137493,6,163677
33295,0.00229,172.31.36.0-255,66,137559,6,163677
33296,0.00232,172.217.194.0-255,8574,146133,6,163677
33297,0.002323,172.31.36.0-255,66,146199,6,163677
33298,0.002325,172.217.194.0-255,1484,147683,6,163677
33299,0.004584,172.217.194.0-255,4320,152003,6,163677
33300,0.004593,172.31.36.0-255,66,152069,6,163677
33301,0.006847,172.217.194.0-255,5738,157807,6,163677
33302,0.006857,172.31.36.0-255,66,157873,6,163677
33303,0.009103,172.217.194.0-255,5738,163611,6,163677
33304,0.00911,172.31.36.0-255,66,163677,6,163677
33305,0.0,74.125.200.0-255,155,155,6,221051
33306,3e-05,172.31.36.0-255,66,221,6,221051
33307,3.8e-05,74.125.200.0-255,1484,1705,6,221051
33308,4.2e-05,172.31.36.0-255,66,1771,6,221051
33309,6.4e-05,74.125.200.0-255,2902,4673,6,221051
33310,6.8e-05,172.31.36.0-255,66,4739,6,221051
33311,7.6e-05,74.125.200.0-255,5738,10477,6,221051
33312,7.8e-05,172.31.36.0-255,66,10543,6,221051
33313,8.1e-05,74.125.200.0-255,1484,12027,6,221051
33314,8.3e-05,172.31.36.0-255,66,12093,6,221051
33315,8.8e-05,74.125.200.0-255,2022,14115,6,221051
33316,9e-05,172.31.36.0-255,66,14181,6,221051
33317,0.000128,74.125.200.0-255,5738,19919,6,221051
33318,0.000132,172.31.36.0-255,66,19985,6,221051
33319,0.000158,74.125.200.0-255,1484,21469,6,221051
33320,0.00016,172.31.36.0-255,66,21535,6,221051
33321,0.000166,74.125.200.0-255,2902,24437,6,221051
33322,0.000169,172.31.36.0-255,66,24503,6,221051
33323,0.000201,74.125.200.0-255,2902,27405,6,221051
33324,0.000205,172.31.36.0-255,66,27471,6,221051
33325,0.00021,74.125.200.0-255,3961,31432,6,221051
33326,0.000213,172.31.36.0-255,66,31498,6,221051
33327,0.000397,74.125.200.0-255,1484,32982,6,221051
33328,0.000402,172.31.36.0-255,66,33048,6,221051
33329,0.000407,74.125.200.0-255,2902,35950,6,221051
33330,0.00041,172.31.36.0-255,66,36016,6,221051
33331,0.000413,74.125.200.0-255,1484,37500,6,221051
33332,0.000421,172.31.36.0-255,66,37566,6,221051
33333,0.000446,74.125.200.0-255,4320,41886,6,221051
33334,0.00045,172.31.36.0-255,66,41952,6,221051
33335,0.000456,74.125.200.0-255,5738,47690,6,221051
33336,0.000458,172.31.36.0-255,66,47756,6,221051
33337,0.000491,74.125.200.0-255,6797,54553,6,221051
33338,0.000495,172.31.36.0-255,66,54619,6,221051
33339,0.000498,74.125.200.0-255,1484,56103,6,221051
33340,0.000538,74.125.200.0-255,9942,66045,6,221051
33341,0.000542,172.31.36.0-255,66,66111,6,221051
33342,0.000568,74.125.200.0-255,110,66221,6,221051
33343,0.000618,74.125.200.0-255,1484,67705,6,221051
33344,0.000621,172.31.36.0-255,66,67771,6,221051
33345,0.000649,74.125.200.0-255,2902,70673,6,221051
33346,0.000651,172.31.36.0-255,66,70739,6,221051
33347,0.000655,74.125.200.0-255,1484,72223,6,221051
33348,0.000658,74.125.200.0-255,2902,75125,6,221051
33349,0.000663,172.31.36.0-255,66,75191,6,221051
33350,0.000679,74.125.200.0-255,4320,79511,6,221051
33351,0.000683,172.31.36.0-255,66,79577,6,221051
33352,0.000704,74.125.200.0-255,1484,81061,6,221051
33353,0.000712,74.125.200.0-255,7156,88217,6,221051
33354,0.000716,172.31.36.0-255,66,88283,6,221051
33355,0.000724,74.125.200.0-255,8574,96857,6,221051
33356,0.000727,172.31.36.0-255,66,96923,6,221051
33357,0.000751,74.125.200.0-255,3870,100793,6,221051
33358,0.000755,172.31.36.0-255,66,100859,6,221051
33359,0.00114,74.125.200.0-255,1484,102343,6,221051
33360,0.001161,74.125.200.0-255,2902,105245,6,221051
33361,0.001166,172.31.36.0-255,66,105311,6,221051
33362,0.001172,74.125.200.0-255,5738,111049,6,221051
33363,0.001175,172.31.36.0-255,66,111115,6,221051
33364,0.001205,74.125.200.0-255,8574,119689,6,221051
33365,0.001209,172.31.36.0-255,66,119755,6,221051
33366,0.001213,74.125.200.0-255,1484,121239,6,221051
33367,0.001241,74.125.200.0-255,8574,129813,6,221051
33368,0.001243,172.31.36.0-255,66,129879,6,221051
33369,0.001249,74.125.200.0-255,4320,134199,6,221051
33370,0.001251,172.31.36.0-255,66,134265,6,221051
33371,0.001267,74.125.200.0-255,766,135031,6,221051
33372,0.00144,172.31.36.0-255,66,135097,6,221051
33373,0.001797,74.125.200.0-255,1484,136581,6,221051
33374,0.00182,74.125.200.0-255,2902,139483,6,221051
33375,0.001825,172.31.36.0-255,66,139549,6,221051
33376,0.001832,74.125.200.0-255,5738,145287,6,221051
33377,0.001834,172.31.36.0-255,66,145353,6,221051
33378,0.001847,74.125.200.0-255,5738,151091,6,221051
33379,0.001849,172.31.36.0-255,66,151157,6,221051
33380,0.001889,74.125.200.0-255,1484,152641,6,221051
33381,0.0019,74.125.200.0-255,7156,159797,6,221051
33382,0.001903,172.31.36.0-255,66,159863,6,221051
33383,0.001965,74.125.200.0-255,4320,164183,6,221051
33384,0.001969,172.31.36.0-255,66,164249,6,221051
33385,0.001992,74.125.200.0-255,1484,165733,6,221051
33386,0.001996,74.125.200.0-255,1484,167217,6,221051
33387,0.001998,172.31.36.0-255,66,167283,6,221051
33388,0.002025,74.125.200.0-255,1484,168767,6,221051
33389,0.002028,74.125.200.0-255,766,169533,6,221051
33390,0.00203,172.31.36.0-255,66,169599,6,221051
33391,0.00215,74.125.200.0-255,1484,171083,6,221051
33392,0.002156,74.125.200.0-255,2902,173985,6,221051
33393,0.002159,172.31.36.0-255,66,174051,6,221051
33394,0.002226,74.125.200.0-255,5738,179789,6,221051
33395,0.00223,172.31.36.0-255,66,179855,6,221051
33396,0.002237,74.125.200.0-255,7156,187011,6,221051
33397,0.002239,172.31.36.0-255,66,187077,6,221051
33398,0.002253,74.125.200.0-255,8574,195651,6,221051
33399,0.002255,172.31.36.0-255,66,195717,6,221051
33400,0.002264,74.125.200.0-255,7856,203573,6,221051
33401,0.002266,172.31.36.0-255,66,203639,6,221051
33402,0.004511,74.125.200.0-255,5738,209377,6,221051
33403,0.004516,172.31.36.0-255,66,209443,6,221051
33404,0.006772,74.125.200.0-255,5738,215181,6,221051
33405,0.006777,172.31.36.0-255,66,215247,6,221051
33406,0.009029,74.125.200.0-255,5738,220985,6,221051
33407,0.009036,172.31.36.0-255,66,221051,6,221051
33408,0.0,172.217.194.0-255,153,153,6,272090
33409,3.9e-05,172.31.36.0-255,66,219,6,272090
33410,4.7e-05,172.217.194.0-255,1484,1703,6,272090
33411,5.2e-05,172.31.36.0-255,66,1769,6,272090
33412,5.4e-05,172.217.194.0-255,1484,3253,6,272090
33413,5.7e-05,172.31.36.0-255,66,3319,6,272090
33414,6.4e-05,172.217.194.0-255,4320,7639,6,272090
33415,6.6e-05,172.31.36.0-255,66,7705,6,272090
33416,7.2e-05,172.217.194.0-255,2902,10607,6,272090
33417,7.5e-05,172.31.36.0-255,66,10673,6,272090
33418,9.8e-05,172.217.194.0-255,3457,14130,6,272090
33419,0.000101,172.31.36.0-255,66,14196,6,272090
33420,0.000128,172.217.194.0-255,1484,15680,6,272090
33421,0.000131,172.31.36.0-255,66,15746,6,272090
33422,0.000135,172.217.194.0-255,2902,18648,6,272090
33423,0.000137,172.31.36.0-255,66,18714,6,272090
33424,0.000172,172.217.194.0-255,2902,21616,6,272090
33425,0.000175,172.31.36.0-255,66,21682,6,272090
33426,0.000194,172.217.194.0-255,2902,24584,6,272090
33427,0.000198,172.31.36.0-255,66,24650,6,272090
33428,0.000205,172.217.194.0-255,6797,31447,6,272090
33429,0.000208,172.31.36.0-255,66,31513,6,272090
33430,0.000215,172.217.194.0-255,7156,38669,6,272090
33431,0.000217,172.31.36.0-255,66,38735,6,272090
33432,0.00024,172.217.194.0-255,7156,45891,6,272090
33433,0.000243,172.31.36.0-255,66,45957,6,272090
33434,0.000264,172.217.194.0-255,2543,48500,6,272090
33435,0.000268,172.31.36.0-255,66,48566,6,272090
33436,0.000483,172.217.194.0-255,1484,50050,6,272090
33437,0.000489,172.31.36.0-255,66,50116,6,272090
33438,0.000507,172.217.194.0-255,2902,53018,6,272090
33439,0.00051,172.31.36.0-255,66,53084,6,272090
33440,0.000515,172.217.194.0-255,2902,55986,6,272090
33441,0.000517,172.31.36.0-255,66,56052,6,272090
33442,0.000543,172.217.194.0-255,2902,58954,6,272090
33443,0.000546,172.31.36.0-255,66,59020,6,272090
33444,0.000552,172.217.194.0-255,5738,64758,6,272090
33445,0.000554,172.31.36.0-255,66,64824,6,272090
33446,0.000585,172.217.194.0-255,1706,66530,6,272090
33447,0.000587,172.31.36.0-255,66,66596,6,272090
33448,0.000616,172.217.194.0-255,2902,69498,6,272090
33449,0.000619,172.31.36.0-255,66,69564,6,272090
33450,0.000627,172.217.194.0-255,7156,76720,6,272090
33451,0.000629,172.31.36.0-255,66,76786,6,272090
33452,0.000635,172.217.194.0-255,4320,81106,6,272090
33453,0.000637,172.31.36.0-255,66,81172,6,272090
33454,0.000653,172.217.194.0-255,2543,83715,6,272090
33455,0.000656,172.31.36.0-255,66,83781,6,272090
33456,0.000672,172.217.194.0-255,5738,89519,6,272090
33457,0.000676,172.31.36.0-255,66,89585,6,272090
33458,0.000699,172.217.194.0-255,9992,99577,6,272090
33459,0.000702,172.31.36.0-255,66,99643,6,272090
33460,0.000705,172.217.194.0-255,1125,100768,6,272090
33461,0.001034,172.31.36.0-255,66,100834,6,272090
33462,0.001285,172.217.194.0-255,1484,102318,6,272090
33463,0.001309,172.217.194.0-255,2902,105220,6,272090
33464,0.001314,172.31.36.0-255,66,105286,6,272090
33465,0.001322,172.217.194.0-255,5738,111024,6,272090
33466,0.001324,172.31.36.0-255,66,111090,6,272090
33467,0.001328,172.217.194.0-255,4320,115410,6,272090
33468,0.001331,172.31.36.0-255,66,115476,6,272090
33469,0.001366,172.31.36.0-255,66,115542,6,272090
33470,0.001419,172.217.194.0-255,7856,123398,6,272090
33471,0.001423,172.31.36.0-255,66,123464,6,272090
33472,0.002011,172.217.194.0-255,1484,124948,6,272090
33473,0.002019,172.217.194.0-255,2902,127850,6,272090
33474,0.002023,172.31.36.0-255,66,127916,6,272090
33475,0.002045,172.217.194.0-255,5738,133654,6,272090
33476,0.002047,172.31.36.0-255,66,133720,6,272090
33477,0.002052,172.217.194.0-255,4320,138040,6,272090
33478,0.002055,172.31.36.0-255,66,138106,6,272090
33479,0.002092,172.217.194.0-255,7156,145262,6,272090
33480,0.002094,172.31.36.0-255,66,145328,6,272090
33481,0.002115,172.217.194.0-255,4320,149648,6,272090
33482,0.002117,172.31.36.0-255,66,149714,6,272090
33483,0.002125,172.217.194.0-255,7856,157570,6,272090
33484,0.002127,172.31.36.0-255,66,157636,6,272090
33485,0.002313,172.217.194.0-255,1484,159120,6,272090
33486,0.002333,172.217.194.0-255,2902,162022,6,272090
33487,0.002336,172.31.36.0-255,66,162088,6,272090
33488,0.00234,172.217.194.0-255,2902,164990,6,272090
33489,0.002342,172.31.36.0-255,66,165056,6,272090
33490,0.002354,172.217.194.0-255,2902,167958,6,272090
33491,0.002357,172.31.36.0-255,66,168024,6,272090
33492,0.002363,172.217.194.0-255,5738,173762,6,272090
33493,0.002365,172.31.36.0-255,66,173828,6,272090
33494,0.002377,172.217.194.0-255,4320,178148,6,272090
33495,0.002379,172.31.36.0-255,66,178214,6,272090
33496,0.00241,172.217.194.0-255,4320,182534,6,272090
33497,0.002413,172.31.36.0-255,66,182600,6,272090
33498,0.002435,172.217.194.0-255,9274,191874,6,272090
33499,0.002438,172.31.36.0-255,66,191940,6,272090
33500,0.002473,172.217.194.0-255,1484,193424,6,272090
33501,0.002527,172.217.194.0-255,2902,196326,6,272090
33502,0.002529,172.31.36.0-255,66,196392,6,272090
33503,0.002535,172.217.194.0-255,5738,202130,6,272090
33504,0.002537,172.31.36.0-255,66,202196,6,272090
33505,0.002543,172.217.194.0-255,5738,207934,6,272090
33506,0.002545,172.31.36.0-255,66,208000,6,272090
33507,0.002552,172.217.194.0-255,7156,215156,6,272090
33508,0.002554,172.31.36.0-255,66,215222,6,272090
33509,0.002582,172.217.194.0-255,5738,220960,6,272090
33510,0.002584,172.31.36.0-255,66,221026,6,272090
33511,0.00259,172.217.194.0-255,5020,226046,6,272090
33512,0.002592,172.31.36.0-255,66,226112,6,272090
33513,0.002609,172.217.194.0-255,2902,229014,6,272090
33514,0.002611,172.31.36.0-255,66,229080,6,272090
33515,0.002616,172.217.194.0-255,4320,233400,6,272090
33516,0.002618,172.31.36.0-255,66,233466,6,272090
33517,0.002639,172.217.194.0-255,4320,237786,6,272090
33518,0.002641,172.31.36.0-255,66,237852,6,272090
33519,0.002663,172.217.194.0-255,4320,242172,6,272090
33520,0.002665,172.31.36.0-255,66,242238,6,272090
33521,0.002673,172.217.194.0-255,8574,250812,6,272090
33522,0.002675,172.31.36.0-255,66,250878,6,272090
33523,0.002697,172.217.194.0-255,4320,255198,6,272090
33524,0.002699,172.31.36.0-255,66,255264,6,272090
33525,0.002704,172.217.194.0-255,5020,260284,6,272090
33526,0.002706,172.31.36.0-255,66,260350,6,272090
33527,0.005314,172.217.194.0-255,2902,263252,6,272090
33528,0.005317,172.31.36.0-255,66,263318,6,272090
33529,0.005334,172.217.194.0-255,2902,266220,6,272090
33530,0.005337,172.31.36.0-255,66,266286,6,272090
33531,0.007966,172.217.194.0-255,5738,272024,6,272090
33532,0.007974,172.31.36.0-255,66,272090,6,272090
33533,0.0,74.125.24.0-255,297,297,6,169030
33534,3.6e-05,172.31.36.0-255,66,363,6,169030
33535,4.2e-05,74.125.24.0-255,1484,1847,6,169030
33536,4.6e-05,172.31.36.0-255,66,1913,6,169030
33537,5.2e-05,74.125.24.0-255,4320,6233,6,169030
33538,6.3e-05,172.31.36.0-255,66,6299,6,169030
33539,7e-05,74.125.24.0-255,5738,12037,6,169030
33540,7.2e-05,172.31.36.0-255,66,12103,6,169030
33541,7.8e-05,74.125.24.0-255,6094,18197,6,169030
33542,8e-05,172.31.36.0-255,66,18263,6,169030
33543,0.000124,172.31.36.0-255,66,18329,6,169030
33544,0.000174,74.125.24.0-255,1484,19813,6,169030
33545,0.000177,172.31.36.0-255,66,19879,6,169030
33546,0.000182,74.125.24.0-255,2902,22781,6,169030
33547,0.000184,172.31.36.0-255,66,22847,6,169030
33548,0.00021,74.125.24.0-255,5738,28585,6,169030
33549,0.000218,172.31.36.0-255,66,28651,6,169030
33550,0.000257,172.31.36.0-255,66,28717,6,169030
33551,0.000266,74.125.24.0-255,8574,37291,6,169030
33552,0.000274,172.31.36.0-255,66,37357,6,169030
33553,0.000298,74.125.24.0-255,1481,38838,6,169030
33554,0.000302,172.31.36.0-255,66,38904,6,169030
33555,0.000326,74.125.24.0-255,330,39234,6,169030
33556,0.000329,172.31.36.0-255,66,39300,6,169030
33557,0.000798,74.125.24.0-255,1484,40784,6,169030
33558,0.000802,172.31.36.0-255,66,40850,6,169030
33559,0.000808,74.125.24.0-255,2902,43752,6,169030
33560,0.00081,172.31.36.0-255,66,43818,6,169030
33561,0.000823,74.125.24.0-255,4320,48138,6,169030
33562,0.000825,172.31.36.0-255,66,48204,6,169030
33563,0.000848,74.125.24.0-255,1484,49688,6,169030
33564,0.00087,172.31.36.0-255,66,49754,6,169030
33565,0.000876,74.125.24.0-255,4320,54074,6,169030
33566,0.000878,172.31.36.0-255,66,54140,6,169030
33567,0.000885,74.125.24.0-255,5738,59878,6,169030
33568,0.000887,172.31.36.0-255,66,59944,6,169030
33569,0.000909,74.125.24.0-255,766,60710,6,169030
33570,0.001093,172.31.36.0-255,66,60776,6,169030
33571,0.001124,74.125.24.0-255,1484,62260,6,169030
33572,0.00113,74.125.24.0-255,2902,65162,6,169030
33573,0.001134,172.31.36.0-255,66,65228,6,169030
33574,0.001151,74.125.24.0-255,4320,69548,6,169030
33575,0.001154,172.31.36.0-255,66,69614,6,169030
33576,0.001179,74.125.24.0-255,1484,71098,6,169030
33577,0.001193,172.31.36.0-255,66,71164,6,169030
33578,0.001219,74.125.24.0-255,1484,72648,6,169030
33579,0.001248,74.125.24.0-255,10692,83340,6,169030
33580,0.001251,172.31.36.0-255,66,83406,6,169030
33581,0.001276,74.125.24.0-255,1484,84890,6,169030
33582,0.001298,74.125.24.0-255,2902,87792,6,169030
33583,0.001301,172.31.36.0-255,66,87858,6,169030
33584,0.001308,74.125.24.0-255,5738,93596,6,169030
33585,0.00131,172.31.36.0-255,66,93662,6,169030
33586,0.001346,74.125.24.0-255,5738,99400,6,169030
33587,0.00135,172.31.36.0-255,66,99466,6,169030
33588,0.001355,74.125.24.0-255,4320,103786,6,169030
33589,0.001357,172.31.36.0-255,66,103852,6,169030
33590,0.001398,74.125.24.0-255,8574,112426,6,169030
33591,0.001402,172.31.36.0-255,66,112492,6,169030
33592,0.001409,74.125.24.0-255,5020,117512,6,169030
33593,0.001411,172.31.36.0-255,66,117578,6,169030
33594,0.001795,74.125.24.0-255,1484,119062,6,169030
33595,0.001807,74.125.24.0-255,2902,121964,6,169030
33596,0.001811,172.31.36.0-255,66,122030,6,169030
33597,0.001843,74.125.24.0-255,5738,127768,6,169030
33598,0.001846,172.31.36.0-255,66,127834,6,169030
33599,0.001855,74.125.24.0-255,8574,136408,6,169030
33600,0.001858,172.31.36.0-255,66,136474,6,169030
33601,0.001904,74.125.24.0-255,4320,140794,6,169030
33602,0.001908,172.31.36.0-255,66,140860,6,169030
33603,0.001943,74.125.24.0-255,10692,151552,6,169030
33604,0.001947,172.31.36.0-255,66,151618,6,169030
33605,0.003949,74.125.24.0-255,5738,157356,6,169030
33606,0.003959,172.31.36.0-255,66,157422,6,169030
33607,0.005996,74.125.24.0-255,5738,163160,6,169030
33608,0.006,172.31.36.0-255,66,163226,6,169030
33609,0.008007,74.125.24.0-255,5738,168964,6,169030
33610,0.008016,172.31.36.0-255,66,169030,6,169030
33611,0.0,74.125.24.0-255,153,153,6,174168
33612,2.3e-05,172.31.36.0-255,66,219,6,174168
33613,3.1e-05,74.125.24.0-255,1484,1703,6,174168
33614,3.6e-05,172.31.36.0-255,66,1769,6,174168
33615,5e-05,74.125.24.0-255,2902,4671,6,174168
33616,5.3e-05,172.31.36.0-255,66,4737,6,174168
33617,6e-05,74.125.24.0-255,5738,10475,6,174168
33618,6.3e-05,172.31.36.0-255,66,10541,6,174168
33619,6.8e-05,74.125.24.0-255,2902,13443,6,174168
33620,7.1e-05,172.31.36.0-255,66,13509,6,174168
33621,0.000101,74.125.24.0-255,674,14183,6,174168
33622,0.000104,172.31.36.0-255,66,14249,6,174168
33623,0.000264,74.125.24.0-255,1484,15733,6,174168
33624,0.000269,172.31.36.0-255,66,15799,6,174168
33625,0.000275,74.125.24.0-255,2902,18701,6,174168
33626,0.000277,172.31.36.0-255,66,18767,6,174168
33627,0.000308,74.125.24.0-255,5738,24505,6,174168
33628,0.000311,172.31.36.0-255,66,24571,6,174168
33629,0.000315,74.125.24.0-255,1484,26055,6,174168
33630,0.000317,172.31.36.0-255,66,26121,6,174168
33631,0.00037,172.31.36.0-255,66,26187,6,174168
33632,0.000377,74.125.24.0-255,5738,31925,6,174168
33633,0.000379,172.31.36.0-255,66,31991,6,174168
33634,0.00044,74.125.24.0-255,1484,33475,6,174168
33635,0.000442,172.31.36.0-255,66,33541,6,174168
33636,0.000468,172.31.36.0-255,66,33607,6,174168
33637,0.00047,74.125.24.0-255,425,34032,6,174168
33638,0.000472,172.31.36.0-255,66,34098,6,174168
33639,0.000627,74.125.24.0-255,1484,35582,6,174168
33640,0.000632,172.31.36.0-255,66,35648,6,174168
33641,0.000637,74.125.24.0-255,2902,38550,6,174168
33642,0.00064,172.31.36.0-255,66,38616,6,174168
33643,0.000644,74.125.24.0-255,2902,41518,6,174168
33644,0.000652,172.31.36.0-255,66,41584,6,174168
33645,0.000659,74.125.24.0-255,5738,47322,6,174168
33646,0.000661,172.31.36.0-255,66,47388,6,174168
33647,0.000685,74.125.24.0-255,1484,48872,6,174168
33648,0.000695,74.125.24.0-255,7156,56028,6,174168
33649,0.000743,74.125.24.0-255,8574,64602,6,174168
33650,0.000748,74.125.24.0-255,3602,68204,6,174168
33651,0.000751,74.125.24.0-255,348,68552,6,174168
33652,0.000994,172.31.36.0-255,66,68618,6,174168
33653,0.00119,74.125.24.0-255,1484,70102,6,174168
33654,0.001198,74.125.24.0-255,2902,73004,6,174168
33655,0.001201,172.31.36.0-255,66,73070,6,174168
33656,0.001228,74.125.24.0-255,4320,77390,6,174168
33657,0.001231,172.31.36.0-255,66,77456,6,174168
33658,0.00126,74.125.24.0-255,8574,86030,6,174168
33659,0.00127,172.31.36.0-255,66,86096,6,174168
33660,0.001319,74.125.24.0-255,1484,87580,6,174168
33661,0.001334,74.125.24.0-255,2184,89764,6,174168
33662,0.001345,172.31.36.0-255,66,89830,6,174168
33663,0.001477,74.125.24.0-255,1484,91314,6,174168
33664,0.001482,74.125.24.0-255,2902,94216,6,174168
33665,0.001485,172.31.36.0-255,66,94282,6,174168
33666,0.001512,74.125.24.0-255,5738,100020,6,174168
33667,0.001516,74.125.24.0-255,1484,101504,6,174168
33668,0.00153,74.125.24.0-255,2902,104406,6,174168
33669,0.001537,74.125.24.0-255,5738,110144,6,174168
33670,0.001551,172.31.36.0-255,66,110210,6,174168
33671,0.001582,74.125.24.0-255,4320,114530,6,174168
33672,0.001599,74.125.24.0-255,4320,118850,6,174168
33673,0.001636,172.31.36.0-255,66,118916,6,174168
33674,0.001653,74.125.24.0-255,5020,123936,6,174168
33675,0.001658,172.31.36.0-255,66,124002,6,174168
33676,0.001685,172.31.36.0-255,66,124068,6,174168
33677,0.002034,74.125.24.0-255,1484,125552,6,174168
33678,0.00204,74.125.24.0-255,2902,128454,6,174168
33679,0.002043,172.31.36.0-255,66,128520,6,174168
33680,0.002047,74.125.24.0-255,1484,130004,6,174168
33681,0.002075,74.125.24.0-255,4320,134324,6,174168
33682,0.002079,74.125.24.0-255,2902,137226,6,174168
33683,0.002104,74.125.24.0-255,9992,147218,6,174168
33684,0.002113,74.125.24.0-255,9992,157210,6,174168
33685,0.002126,74.125.24.0-255,766,157976,6,174168
33686,0.00213,172.31.36.0-255,66,158042,6,174168
33687,0.002833,172.31.36.0-255,66,158108,6,174168
33688,0.0044,74.125.24.0-255,4320,162428,6,174168
33689,0.004407,172.31.36.0-255,66,162494,6,174168
33690,0.005094,74.125.24.0-255,1484,163978,6,174168
33691,0.00665,74.125.24.0-255,4320,168298,6,174168
33692,0.006654,172.31.36.0-255,66,168364,6,174168
33693,0.008947,74.125.24.0-255,5738,174102,6,174168
33694,0.008954,172.31.36.0-255,66,174168,6,174168
33695,0.0,74.125.24.0-255,290,290,6,241352
33696,2.7e-05,172.31.36.0-255,66,356,6,241352
33697,3.1e-05,74.125.24.0-255,1484,1840,6,241352
33698,3.6e-05,172.31.36.0-255,66,1906,6,241352
33699,4.8e-05,74.125.24.0-255,4320,6226,6,241352
33700,5.1e-05,172.31.36.0-255,66,6292,6,241352
33701,5.4e-05,74.125.24.0-255,2902,9194,6,241352
33702,5.7e-05,172.31.36.0-255,66,9260,6,241352
33703,8.5e-05,74.125.24.0-255,4738,13998,6,241352
33704,9.1e-05,172.31.36.0-255,66,14064,6,241352
33705,9.8e-05,74.125.24.0-255,8574,22638,6,241352
33706,0.0001,172.31.36.0-255,66,22704,6,241352
33707,0.00013,74.125.24.0-255,8215,30919,6,241352
33708,0.00014,172.31.36.0-255,66,30985,6,241352
33709,0.000169,74.125.24.0-255,1484,32469,6,241352
33710,0.000171,172.31.36.0-255,66,32535,6,241352
33711,0.000177,74.125.24.0-255,2902,35437,6,241352
33712,0.000179,172.31.36.0-255,66,35503,6,241352
33713,0.000193,74.125.24.0-255,5738,41241,6,241352
33714,0.000195,172.31.36.0-255,66,41307,6,241352
33715,0.000231,172.31.36.0-255,66,41373,6,241352
33716,0.000256,74.125.24.0-255,1484,42857,6,241352
33717,0.000259,172.31.36.0-255,66,42923,6,241352
33718,0.000291,74.125.24.0-255,8516,51439,6,241352
33719,0.000295,172.31.36.0-255,66,51505,6,241352
33720,0.000299,74.125.24.0-255,130,51635,6,241352
33721,0.000301,172.31.36.0-255,66,51701,6,241352
33722,0.000423,74.125.24.0-255,1484,53185,6,241352
33723,0.000427,172.31.36.0-255,66,53251,6,241352
33724,0.000433,74.125.24.0-255,2902,56153,6,241352
33725,0.000436,172.31.36.0-255,66,56219,6,241352
33726,0.000467,74.125.24.0-255,5738,61957,6,241352
33727,0.000471,172.31.36.0-255,66,62023,6,241352
33728,0.000476,74.125.24.0-255,2902,64925,6,241352
33729,0.000479,172.31.36.0-255,66,64991,6,241352
33730,0.000482,74.125.24.0-255,1484,66475,6,241352
33731,0.000517,74.125.24.0-255,9633,76108,6,241352
33732,0.000521,172.31.36.0-255,66,76174,6,241352
33733,0.000527,74.125.24.0-255,4320,80494,6,241352
33734,0.000529,172.31.36.0-255,66,80560,6,241352
33735,0.000563,74.125.24.0-255,5379,85939,6,241352
33736,0.000568,172.31.36.0-255,66,86005,6,241352
33737,0.000571,74.125.24.0-255,1484,87489,6,241352
33738,0.000576,74.125.24.0-255,2902,90391,6,241352
33739,0.000579,172.31.36.0-255,66,90457,6,241352
33740,0.000615,74.125.24.0-255,5738,96195,6,241352
33741,0.000618,172.31.36.0-255,66,96261,6,241352
33742,0.000631,172.31.36.0-255,66,96327,6,241352
33743,0.000647,74.125.24.0-255,10692,107019,6,241352
33744,0.00065,172.31.36.0-255,66,107085,6,241352
33745,0.000714,74.125.24.0-255,344,107429,6,241352
33746,0.000718,74.125.24.0-255,1484,108913,6,241352
33747,0.000721,172.31.36.0-255,66,108979,6,241352
33748,0.000727,74.125.24.0-255,4320,113299,6,241352
33749,0.000729,172.31.36.0-255,66,113365,6,241352
33750,0.000742,74.125.24.0-255,8574,121939,6,241352
33751,0.000746,172.31.36.0-255,66,122005,6,241352
33752,0.000777,74.125.24.0-255,1484,123489,6,241352
33753,0.000786,74.125.24.0-255,7156,130645,6,241352
33754,0.000794,74.125.24.0-255,8574,139219,6,241352
33755,0.000794,172.31.36.0-255,66,139285,6,241352
33756,0.000797,172.31.36.0-255,66,139351,6,241352
33757,0.000823,74.125.24.0-255,2184,141535,6,241352
33758,0.000831,172.31.36.0-255,66,141601,6,241352
33759,0.000954,74.125.24.0-255,1484,143085,6,241352
33760,0.000982,74.125.24.0-255,2902,145987,6,241352
33761,0.000985,172.31.36.0-255,66,146053,6,241352
33762,0.000992,74.125.24.0-255,5738,151791,6,241352
33763,0.000996,74.125.24.0-255,2902,154693,6,241352
33764,0.001005,172.31.36.0-255,66,154759,6,241352
33765,0.001042,74.125.24.0-255,9992,164751,6,241352
33766,0.001045,172.31.36.0-255,66,164817,6,241352
33767,0.001055,74.125.24.0-255,10692,175509,6,241352
33768,0.001063,172.31.36.0-255,66,175575,6,241352
33769,0.001207,74.125.24.0-255,1484,177059,6,241352
33770,0.001211,74.125.24.0-255,1484,178543,6,241352
33771,0.001214,172.31.36.0-255,66,178609,6,241352
33772,0.001222,74.125.24.0-255,1484,180093,6,241352
33773,0.001233,74.125.24.0-255,5738,185831,6,241352
33774,0.001236,172.31.36.0-255,66,185897,6,241352
33775,0.001266,74.125.24.0-255,4320,190217,6,241352
33776,0.001269,172.31.36.0-255,66,190283,6,241352
33777,0.00129,74.125.24.0-255,8574,198857,6,241352
33778,0.001293,74.125.24.0-255,1484,200341,6,241352
33779,0.001296,172.31.36.0-255,66,200407,6,241352
33780,0.001325,74.125.24.0-255,2902,203309,6,241352
33781,0.001336,172.31.36.0-255,66,203375,6,241352
33782,0.001354,74.125.24.0-255,6438,209813,6,241352
33783,0.001359,172.31.36.0-255,66,209879,6,241352
33784,0.001492,74.125.24.0-255,1484,211363,6,241352
33785,0.001506,74.125.24.0-255,1484,212847,6,241352
33786,0.001509,172.31.36.0-255,66,212913,6,241352
33787,0.001537,74.125.24.0-255,1484,214397,6,241352
33788,0.001544,74.125.24.0-255,5738,220135,6,241352
33789,0.001546,74.125.24.0-255,1484,221619,6,241352
33790,0.001559,172.31.36.0-255,66,221685,6,241352
33791,0.001567,74.125.24.0-255,4320,226005,6,241352
33792,0.001573,172.31.36.0-255,66,226071,6,241352
33793,0.001629,172.31.36.0-255,66,226137,6,241352
33794,0.001639,74.125.24.0-255,10692,236829,6,241352
33795,0.001687,74.125.24.0-255,766,237595,6,241352
33796,0.001776,74.125.24.0-255,1484,239079,6,241352
33797,0.001839,74.125.24.0-255,1931,241010,6,241352
33798,0.001861,74.125.24.0-255,105,241115,6,241352
33799,0.00598,172.31.36.0-255,66,241181,6,241352
33800,0.007862,172.31.36.0-255,105,241286,6,241352
33801,0.009904,74.125.24.0-255,66,241352,6,241352
33802,0.0,172.217.194.0-255,143,143,6,195525
33803,2.9e-05,172.31.36.0-255,66,209,6,195525
33804,3.6e-05,172.217.194.0-255,1484,1693,6,195525
33805,4.1e-05,172.31.36.0-255,66,1759,6,195525
33806,4.5e-05,172.217.194.0-255,2902,4661,6,195525
33807,4.7e-05,172.31.36.0-255,66,4727,6,195525
33808,6.3e-05,172.217.194.0-255,7156,11883,6,195525
33809,6.6e-05,172.31.36.0-255,66,11949,6,195525
33810,7e-05,172.217.194.0-255,2033,13982,6,195525
33811,7.2e-05,172.31.36.0-255,66,14048,6,195525
33812,0.000111,172.217.194.0-255,9992,24040,6,195525
33813,0.000114,172.31.36.0-255,66,24106,6,195525
33814,0.000143,172.217.194.0-255,1484,25590,6,195525
33815,0.000146,172.31.36.0-255,66,25656,6,195525
33816,0.000155,172.217.194.0-255,8574,34230,6,195525
33817,0.000164,172.31.36.0-255,66,34296,6,195525
33818,0.000196,172.217.194.0-255,7156,41452,6,195525
33819,0.0002,172.31.36.0-255,66,41518,6,195525
33820,0.000231,172.217.194.0-255,6438,47956,6,195525
33821,0.000234,172.31.36.0-255,66,48022,6,195525
33822,0.000241,172.217.194.0-255,7156,55178,6,195525
33823,0.000243,172.31.36.0-255,66,55244,6,195525
33824,0.000271,172.217.194.0-255,7156,62400,6,195525
33825,0.000273,172.31.36.0-255,66,62466,6,195525
33826,0.000278,172.217.194.0-255,2543,65009,6,195525
33827,0.000282,172.31.36.0-255,66,65075,6,195525
33828,0.000362,172.217.194.0-255,646,65721,6,195525
33829,0.000366,172.31.36.0-255,66,65787,6,195525
33830,0.000545,172.217.194.0-255,1484,67271,6,195525
33831,0.000548,172.31.36.0-255,66,67337,6,195525
33832,0.000567,172.217.194.0-255,2902,70239,6,195525
33833,0.00057,172.31.36.0-255,66,70305,6,195525
33834,0.000578,172.217.194.0-255,5738,76043,6,195525
33835,0.000582,172.31.36.0-255,66,76109,6,195525
33836,0.000583,172.217.194.0-255,4320,80429,6,195525
33837,0.000585,172.31.36.0-255,66,80495,6,195525
33838,0.000615,172.217.194.0-255,1484,81979,6,195525
33839,0.000642,172.217.194.0-255,4320,86299,6,195525
33840,0.000646,172.31.36.0-255,66,86365,6,195525
33841,0.000675,172.217.194.0-255,9633,95998,6,195525
33842,0.000679,172.31.36.0-255,66,96064,6,195525
33843,0.000682,172.217.194.0-255,1484,97548,6,195525
33844,0.000704,172.217.194.0-255,2543,100091,6,195525
33845,0.000706,172.31.36.0-255,66,100157,6,195525
33846,0.001186,172.217.194.0-255,1484,101641,6,195525
33847,0.001196,172.217.194.0-255,2902,104543,6,195525
33848,0.0012,172.31.36.0-255,66,104609,6,195525
33849,0.001207,172.217.194.0-255,5738,110347,6,195525
33850,0.00121,172.31.36.0-255,66,110413,6,195525
33851,0.001251,172.31.36.0-255,66,110479,6,195525
33852,0.001261,172.217.194.0-255,9992,120471,6,195525
33853,0.001263,172.31.36.0-255,66,120537,6,195525
33854,0.001305,172.217.194.0-255,766,121303,6,195525
33855,0.00178,172.217.194.0-255,1484,122787,6,195525
33856,0.001786,172.31.36.0-255,66,122853,6,195525
33857,0.001793,172.217.194.0-255,2902,125755,6,195525
33858,0.001795,172.31.36.0-255,66,125821,6,195525
33859,0.001821,172.217.194.0-255,1484,127305,6,195525
33860,0.001827,172.217.194.0-255,5738,133043,6,195525
33861,0.001829,172.31.36.0-255,66,133109,6,195525
33862,0.001896,172.31.36.0-255,66,133175,6,195525
33863,0.001904,172.217.194.0-255,8574,141749,6,195525
33864,0.001906,172.31.36.0-255,66,141815,6,195525
33865,0.001908,172.217.194.0-255,766,142581,6,195525
33866,0.001955,172.217.194.0-255,1484,144065,6,195525
33867,0.001957,172.31.36.0-255,66,144131,6,195525
33868,0.001961,172.217.194.0-255,1484,145615,6,195525
33869,0.001981,172.217.194.0-255,1484,147099,6,195525
33870,0.001983,172.31.36.0-255,66,147165,6,195525
33871,0.001989,172.217.194.0-255,5738,152903,6,195525
33872,0.001992,172.31.36.0-255,66,152969,6,195525
33873,0.001994,172.217.194.0-255,1484,154453,6,195525
33874,0.002029,172.31.36.0-255,66,154519,6,195525
33875,0.002034,172.217.194.0-255,4320,158839,6,195525
33876,0.002036,172.31.36.0-255,66,158905,6,195525
33877,0.002058,172.217.194.0-255,5738,164643,6,195525
33878,0.002064,172.31.36.0-255,66,164709,6,195525
33879,0.002103,172.31.36.0-255,66,164775,6,195525
33880,0.00213,172.217.194.0-255,2184,166959,6,195525
33881,0.002132,172.31.36.0-255,66,167025,6,195525
33882,0.002151,172.31.36.0-255,66,167091,6,195525
33883,0.002162,172.31.36.0-255,66,167157,6,195525
33884,0.002189,172.217.194.0-255,4320,171477,6,195525
33885,0.002192,172.31.36.0-255,66,171543,6,195525
33886,0.002209,172.31.36.0-255,66,171609,6,195525
33887,0.002243,172.217.194.0-255,6438,178047,6,195525
33888,0.002246,172.31.36.0-255,66,178113,6,195525
33889,0.004479,172.217.194.0-255,5738,183851,6,195525
33890,0.004482,172.31.36.0-255,66,183917,6,195525
33891,0.006705,172.217.194.0-255,5738,189655,6,195525
33892,0.006711,172.31.36.0-255,66,189721,6,195525
33893,0.008924,172.217.194.0-255,5738,195459,6,195525
33894,0.00893,172.31.36.0-255,66,195525,6,195525
33895,0.0,74.125.24.0-255,162,162,6,376767
33896,1.6e-05,172.31.36.0-255,66,228,6,376767
33897,2.2e-05,74.125.24.0-255,1484,1712,6,376767
33898,2.6e-05,172.31.36.0-255,66,1778,6,376767
33899,3.2e-05,74.125.24.0-255,2902,4680,6,376767
33900,3.4e-05,172.31.36.0-255,66,4746,6,376767
33901,4.1e-05,74.125.24.0-255,7156,11902,6,376767
33902,4.4e-05,172.31.36.0-255,66,11968,6,376767
33903,4.8e-05,74.125.24.0-255,2039,14007,6,376767
33904,5.1e-05,172.31.36.0-255,66,14073,6,376767
33905,0.000507,74.125.24.0-255,1484,15557,6,376767
33906,0.000513,172.31.36.0-255,66,15623,6,376767
33907,0.000523,74.125.24.0-255,2902,18525,6,376767
33908,0.000525,172.31.36.0-255,66,18591,6,376767
33909,0.000532,74.125.24.0-255,5738,24329,6,376767
33910,0.000534,172.31.36.0-255,66,24395,6,376767
33911,0.000556,74.125.24.0-255,2902,27297,6,376767
33912,0.000559,172.31.36.0-255,66,27363,6,376767
33913,0.000583,74.125.24.0-255,2902,30265,6,376767
33914,0.000585,172.31.36.0-255,66,30331,6,376767
33915,0.000615,74.125.24.0-255,8215,38546,6,376767
33916,0.00062,172.31.36.0-255,66,38612,6,376767
33917,0.000625,74.125.24.0-255,4320,42932,6,376767
33918,0.000628,172.31.36.0-255,66,42998,6,376767
33919,0.000651,74.125.24.0-255,1484,44482,6,376767
33920,0.000653,172.31.36.0-255,66,44548,6,376767
33921,0.000676,74.125.24.0-255,3961,48509,6,376767
33922,0.00068,172.31.36.0-255,66,48575,6,376767
33923,0.000686,74.125.24.0-255,5738,54313,6,376767
33924,0.000689,172.31.36.0-255,66,54379,6,376767
33925,0.000692,74.125.24.0-255,1484,55863,6,376767
33926,0.000694,172.31.36.0-255,66,55929,6,376767
33927,0.00073,74.125.24.0-255,9941,65870,6,376767
33928,0.000733,172.31.36.0-255,66,65936,6,376767
33929,0.000794,74.125.24.0-255,110,66046,6,376767
33930,0.000963,74.125.24.0-255,1484,67530,6,376767
33931,0.000968,172.31.36.0-255,66,67596,6,376767
33932,0.000975,74.125.24.0-255,2902,70498,6,376767
33933,0.000978,172.31.36.0-255,66,70564,6,376767
33934,0.000984,74.125.24.0-255,5738,76302,6,376767
33935,0.000987,172.31.36.0-255,66,76368,6,376767
33936,0.001012,74.125.24.0-255,6797,83165,6,376767
33937,0.001015,172.31.36.0-255,66,83231,6,376767
33938,0.001805,74.125.24.0-255,1484,84715,6,376767
33939,0.001813,74.125.24.0-255,2902,87617,6,376767
33940,0.001817,172.31.36.0-255,66,87683,6,376767
33941,0.001825,74.125.24.0-255,5738,93421,6,376767
33942,0.001829,172.31.36.0-255,66,93487,6,376767
33943,0.001866,74.125.24.0-255,6797,100284,6,376767
33944,0.001869,172.31.36.0-255,66,100350,6,376767
33945,0.001902,74.125.24.0-255,7156,107506,6,376767
33946,0.001905,172.31.36.0-255,66,107572,6,376767
33947,0.001937,172.31.36.0-255,66,107638,6,376767
33948,0.001969,74.125.24.0-255,8574,116212,6,376767
33949,0.001971,172.31.36.0-255,66,116278,6,376767
33950,0.001995,74.125.24.0-255,6438,122716,6,376767
33951,0.001997,172.31.36.0-255,66,122782,6,376767
33952,0.002078,74.125.24.0-255,1484,124266,6,376767
33953,0.002091,74.125.24.0-255,2902,127168,6,376767
33954,0.002094,172.31.36.0-255,66,127234,6,376767
33955,0.002102,74.125.24.0-255,5738,132972,6,376767
33956,0.002104,172.31.36.0-255,66,133038,6,376767
33957,0.002109,74.125.24.0-255,2902,135940,6,376767
33958,0.002112,172.31.36.0-255,66,136006,6,376767
33959,0.002165,74.125.24.0-255,9992,145998,6,376767
33960,0.002167,172.31.36.0-255,66,146064,6,376767
33961,0.002178,74.125.24.0-255,10692,156756,6,376767
33962,0.00218,172.31.36.0-255,66,156822,6,376767
33963,0.002214,74.125.24.0-255,1484,158306,6,376767
33964,0.002232,74.125.24.0-255,2902,161208,6,376767
33965,0.002234,172.31.36.0-255,66,161274,6,376767
33966,0.002255,74.125.24.0-255,4320,165594,6,376767
33967,0.002258,172.31.36.0-255,66,165660,6,376767
33968,0.002279,74.125.24.0-255,5738,171398,6,376767
33969,0.002281,172.31.36.0-255,66,171464,6,376767
33970,0.002302,74.125.24.0-255,7156,178620,6,376767
33971,0.002305,172.31.36.0-255,66,178686,6,376767
33972,0.00232,74.125.24.0-255,2902,181588,6,376767
33973,0.002323,172.31.36.0-255,66,181654,6,376767
33974,0.002343,74.125.24.0-255,10692,192346,6,376767
33975,0.002346,172.31.36.0-255,66,192412,6,376767
33976,0.002372,172.31.36.0-255,66,192478,6,376767
33977,0.002392,74.125.24.0-255,2902,195380,6,376767
33978,0.002394,172.31.36.0-255,66,195446,6,376767
33979,0.002402,74.125.24.0-255,8574,204020,6,376767
33980,0.002406,172.31.36.0-255,66,204086,6,376767
33981,0.002423,74.125.24.0-255,2902,206988,6,376767
33982,0.002425,172.31.36.0-255,66,207054,6,376767
33983,0.002442,74.125.24.0-255,2902,209956,6,376767
33984,0.002445,172.31.36.0-255,66,210022,6,376767
33985,0.002469,74.125.24.0-255,3602,213624,6,376767
33986,0.002471,172.31.36.0-255,66,213690,6,376767
33987,0.002502,74.125.24.0-255,1484,215174,6,376767
33988,0.002507,74.125.24.0-255,2902,218076,6,376767
33989,0.002509,172.31.36.0-255,66,218142,6,376767
33990,0.002515,74.125.24.0-255,5738,223880,6,376767
33991,0.002518,172.31.36.0-255,66,223946,6,376767
33992,0.00254,74.125.24.0-255,8574,232520,6,376767
33993,0.002543,172.31.36.0-255,66,232586,6,376767
33994,0.002587,74.125.24.0-255,8574,241160,6,376767
33995,0.002602,74.125.24.0-255,4320,245480,6,376767
33996,0.002619,74.125.24.0-255,2184,247664,6,376767
33997,0.002652,74.125.24.0-255,1484,249148,6,376767
33998,0.002667,74.125.24.0-255,2902,252050,6,376767
33999,0.002671,74.125.24.0-255,2902,254952,6,376767
34000,0.002692,74.125.24.0-255,2902,257854,6,376767
34001,0.002717,74.125.24.0-255,4320,262174,6,376767
34002,0.002723,74.125.24.0-255,5738,267912,6,376767
34003,0.002726,74.125.24.0-255,1484,269396,6,376767
34004,0.00273,74.125.24.0-255,2902,272298,6,376767
34005,0.002734,74.125.24.0-255,2902,275200,6,376767
34006,0.002737,74.125.24.0-255,1484,276684,6,376767
34007,0.002741,74.125.24.0-255,1484,278168,6,376767
34008,0.002785,74.125.24.0-255,5020,283188,6,376767
34009,0.002788,74.125.24.0-255,1484,284672,6,376767
34010,0.00281,74.125.24.0-255,8574,293246,6,376767
34011,0.002813,74.125.24.0-255,1484,294730,6,376767
34012,0.002816,74.125.24.0-255,1484,296214,6,376767
34013,0.00284,74.125.24.0-255,7156,303370,6,376767
34014,0.002847,74.125.24.0-255,5738,309108,6,376767
34015,0.00285,74.125.24.0-255,1484,310592,6,376767
34016,0.002907,74.125.24.0-255,7856,318448,6,376767
34017,0.002922,74.125.24.0-255,4320,322768,6,376767
34018,0.002948,74.125.24.0-255,8574,331342,6,376767
34019,0.002951,74.125.24.0-255,1484,332826,6,376767
34020,0.002974,74.125.24.0-255,5738,338564,6,376767
34021,0.003007,74.125.24.0-255,7156,345720,6,376767
34022,0.003013,74.125.24.0-255,5020,350740,6,376767
34023,0.003022,74.125.24.0-255,8574,359314,6,376767
34024,0.00304,74.125.24.0-255,8574,367888,6,376767
34025,0.003045,74.125.24.0-255,2902,370790,6,376767
34026,0.003064,74.125.24.0-255,5635,376425,6,376767
34027,0.003076,74.125.24.0-255,105,376530,6,376767
34028,0.003893,172.31.36.0-255,66,376596,6,376767
34029,0.006924,172.31.36.0-255,105,376701,6,376767
34030,0.009103,74.125.24.0-255,66,376767,6,376767
34031,0.0,74.125.200.0-255,153,153,6,180430
34032,1.5e-05,172.31.36.0-255,66,219,6,180430
34033,2.1e-05,74.125.200.0-255,1484,1703,6,180430
34034,2.6e-05,172.31.36.0-255,66,1769,6,180430
34035,2.9e-05,74.125.200.0-255,1484,3253,6,180430
34036,3.2e-05,172.31.36.0-255,66,3319,6,180430
34037,3.8e-05,74.125.200.0-255,2902,6221,6,180430
34038,4e-05,172.31.36.0-255,66,6287,6,180430
34039,7.2e-05,74.125.200.0-255,5738,12025,6,180430
34040,7.4e-05,172.31.36.0-255,66,12091,6,180430
34041,7.8e-05,74.125.200.0-255,2056,14147,6,180430
34042,8e-05,172.31.36.0-255,66,14213,6,180430
34043,0.000124,74.125.200.0-255,2902,17115,6,180430
34044,0.000127,172.31.36.0-255,66,17181,6,180430
34045,0.000139,74.125.200.0-255,2902,20083,6,180430
34046,0.000142,172.31.36.0-255,66,20149,6,180430
34047,0.000152,74.125.200.0-255,1484,21633,6,180430
34048,0.000154,172.31.36.0-255,66,21699,6,180430
34049,0.00017,74.125.200.0-255,5738,27437,6,180430
34050,0.000172,172.31.36.0-255,66,27503,6,180430
34051,0.000184,74.125.200.0-255,2902,30405,6,180430
34052,0.000187,172.31.36.0-255,66,30471,6,180430
34053,0.000189,74.125.200.0-255,1125,31596,6,180430
34054,0.000191,172.31.36.0-255,66,31662,6,180430
34055,0.00032,74.125.200.0-255,1484,33146,6,180430
34056,0.000325,172.31.36.0-255,66,33212,6,180430
34057,0.000329,74.125.200.0-255,1484,34696,6,180430
34058,0.000331,172.31.36.0-255,66,34762,6,180430
34059,0.000355,74.125.200.0-255,2902,37664,6,180430
34060,0.000358,172.31.36.0-255,66,37730,6,180430
34061,0.000386,74.125.200.0-255,5738,43468,6,180430
34062,0.00039,172.31.36.0-255,66,43534,6,180430
34063,0.000395,74.125.200.0-255,2902,46436,6,180430
34064,0.000397,172.31.36.0-255,66,46502,6,180430
34065,0.000422,74.125.200.0-255,3961,50463,6,180430
34066,0.000427,172.31.36.0-255,66,50529,6,180430
34067,0.000449,74.125.200.0-255,4320,54849,6,180430
34068,0.000452,172.31.36.0-255,66,54915,6,180430
34069,0.000457,74.125.200.0-255,2902,57817,6,180430
34070,0.00046,172.31.36.0-255,66,57883,6,180430
34071,0.000484,74.125.200.0-255,2902,60785,6,180430
34072,0.000486,172.31.36.0-255,66,60851,6,180430
34073,0.00049,74.125.200.0-255,2902,63753,6,180430
34074,0.000491,172.31.36.0-255,66,63819,6,180430
34075,0.000506,74.125.200.0-255,2543,66362,6,180430
34076,0.000508,172.31.36.0-255,66,66428,6,180430
34077,0.000511,74.125.200.0-255,410,66838,6,180430
34078,0.000584,74.125.200.0-255,332,67170,6,180430
34079,0.000737,74.125.200.0-255,1484,68654,6,180430
34080,0.000743,172.31.36.0-255,66,68720,6,180430
34081,0.00076,74.125.200.0-255,1484,70204,6,180430
34082,0.000765,74.125.200.0-255,1484,71688,6,180430
34083,0.000768,172.31.36.0-255,66,71754,6,180430
34084,0.000795,74.125.200.0-255,1484,73238,6,180430
34085,0.000801,74.125.200.0-255,2902,76140,6,180430
34086,0.000804,172.31.36.0-255,66,76206,6,180430
34087,0.000809,74.125.200.0-255,4320,80526,6,180430
34088,0.000812,172.31.36.0-255,66,80592,6,180430
34089,0.000835,74.125.200.0-255,1484,82076,6,180430
34090,0.000856,74.125.200.0-255,2543,84619,6,180430
34091,0.00086,172.31.36.0-255,66,84685,6,180430
34092,0.000949,74.125.200.0-255,1484,86169,6,180430
34093,0.000993,74.125.200.0-255,2902,89071,6,180430
34094,0.000998,172.31.36.0-255,66,89137,6,180430
34095,0.001004,74.125.200.0-255,5738,94875,6,180430
34096,0.001007,172.31.36.0-255,66,94941,6,180430
34097,0.001009,74.125.200.0-255,1484,96425,6,180430
34098,0.001013,74.125.200.0-255,2902,99327,6,180430
34099,0.001016,172.31.36.0-255,66,99393,6,180430
34100,0.001055,74.125.200.0-255,2543,101936,6,180430
34101,0.001059,172.31.36.0-255,66,102002,6,180430
34102,0.001328,74.125.200.0-255,1484,103486,6,180430
34103,0.001347,74.125.200.0-255,2902,106388,6,180430
34104,0.001353,172.31.36.0-255,66,106454,6,180430
34105,0.001373,74.125.200.0-255,4320,110774,6,180430
34106,0.001376,172.31.36.0-255,66,110840,6,180430
34107,0.001403,74.125.200.0-255,8574,119414,6,180430
34108,0.001405,172.31.36.0-255,66,119480,6,180430
34109,0.001408,74.125.200.0-255,1484,120964,6,180430
34110,0.001441,74.125.200.0-255,4320,125284,6,180430
34111,0.001443,172.31.36.0-255,66,125350,6,180430
34112,0.001472,74.125.200.0-255,7156,132506,6,180430
34113,0.001474,172.31.36.0-255,66,132572,6,180430
34114,0.001477,74.125.200.0-255,1484,134056,6,180430
34115,0.001503,74.125.200.0-255,2184,136240,6,180430
34116,0.001506,172.31.36.0-255,66,136306,6,180430
34117,0.002216,74.125.200.0-255,1484,137790,6,180430
34118,0.002238,74.125.200.0-255,2902,140692,6,180430
34119,0.002242,172.31.36.0-255,66,140758,6,180430
34120,0.002248,74.125.200.0-255,2902,143660,6,180430
34121,0.00225,172.31.36.0-255,66,143726,6,180430
34122,0.002265,74.125.200.0-255,2902,146628,6,180430
34123,0.002268,172.31.36.0-255,66,146694,6,180430
34124,0.002271,74.125.200.0-255,1484,148178,6,180430
34125,0.002298,74.125.200.0-255,2902,151080,6,180430
34126,0.0023,172.31.36.0-255,66,151146,6,180430
34127,0.002321,74.125.200.0-255,5738,156884,6,180430
34128,0.002323,172.31.36.0-255,66,156950,6,180430
34129,0.002328,74.125.200.0-255,4320,161270,6,180430
34130,0.00233,172.31.36.0-255,66,161336,6,180430
34131,0.002333,74.125.200.0-255,1484,162820,6,180430
34132,0.002345,74.125.200.0-255,1484,164304,6,180430
34133,0.002347,172.31.36.0-255,66,164370,6,180430
34134,0.004652,74.125.200.0-255,4320,168690,6,180430
34135,0.00466,172.31.36.0-255,66,168756,6,180430
34136,0.004682,74.125.200.0-255,1484,170240,6,180430
34137,0.006984,74.125.200.0-255,4320,174560,6,180430
34138,0.006993,172.31.36.0-255,66,174626,6,180430
34139,0.009345,74.125.200.0-255,5738,180364,6,180430
34140,0.009369,172.31.36.0-255,66,180430,6,180430
34141,0.0,172.217.194.0-255,296,296,6,236516
34142,2.5e-05,172.31.36.0-255,66,362,6,236516
34143,3.2e-05,172.217.194.0-255,1484,1846,6,236516
34144,3.6e-05,172.31.36.0-255,66,1912,6,236516
34145,4.4e-05,172.217.194.0-255,4320,6232,6,236516
34146,4.8e-05,172.31.36.0-255,66,6298,6,236516
34147,5.7e-05,172.217.194.0-255,7513,13811,6,236516
34148,6.1e-05,172.31.36.0-255,66,13877,6,236516
34149,6.4e-05,172.217.194.0-255,1484,15361,6,236516
34150,6.7e-05,172.31.36.0-255,66,15427,6,236516
34151,7.2e-05,172.217.194.0-255,2902,18329,6,236516
34152,7.5e-05,172.31.36.0-255,66,18395,6,236516
34153,8.2e-05,172.217.194.0-255,5738,24133,6,236516
34154,8.5e-05,172.31.36.0-255,66,24199,6,236516
34155,0.000115,172.217.194.0-255,5738,29937,6,236516
34156,0.000118,172.31.36.0-255,66,30003,6,236516
34157,0.000136,172.217.194.0-255,1125,31128,6,236516
34158,0.000139,172.31.36.0-255,66,31194,6,236516
34159,0.000173,172.217.194.0-255,1484,32678,6,236516
34160,0.000175,172.31.36.0-255,66,32744,6,236516
34161,0.000191,172.217.194.0-255,2902,35646,6,236516
34162,0.000194,172.31.36.0-255,66,35712,6,236516
34163,0.000197,172.217.194.0-255,1484,37196,6,236516
34164,0.000199,172.31.36.0-255,66,37262,6,236516
34165,0.00022,172.217.194.0-255,4320,41582,6,236516
34166,0.000223,172.31.36.0-255,66,41648,6,236516
34167,0.000255,172.217.194.0-255,6797,48445,6,236516
34168,0.000258,172.31.36.0-255,66,48511,6,236516
34169,0.000338,172.217.194.0-255,1484,49995,6,236516
34170,0.000341,172.31.36.0-255,66,50061,6,236516
34171,0.000346,172.217.194.0-255,2902,52963,6,236516
34172,0.000349,172.31.36.0-255,66,53029,6,236516
34173,0.000354,172.217.194.0-255,2902,55931,6,236516
34174,0.000356,172.31.36.0-255,66,55997,6,236516
34175,0.000388,172.217.194.0-255,2902,58899,6,236516
34176,0.00039,172.31.36.0-255,66,58965,6,236516
34177,0.000396,172.217.194.0-255,4320,63285,6,236516
34178,0.000398,172.31.36.0-255,66,63351,6,236516
34179,0.000418,172.217.194.0-255,2856,66207,6,236516
34180,0.00042,172.31.36.0-255,66,66273,6,236516
34181,0.000445,172.217.194.0-255,365,66638,6,236516
34182,0.000947,172.217.194.0-255,1484,68122,6,236516
34183,0.000953,172.31.36.0-255,66,68188,6,236516
34184,0.000959,172.217.194.0-255,2902,71090,6,236516
34185,0.000962,172.31.36.0-255,66,71156,6,236516
34186,0.000967,172.217.194.0-255,2902,74058,6,236516
34187,0.000969,172.31.36.0-255,66,74124,6,236516
34188,0.000991,172.217.194.0-255,2902,77026,6,236516
34189,0.000994,172.31.36.0-255,66,77092,6,236516
34190,0.001,172.217.194.0-255,4320,81412,6,236516
34191,0.001002,172.31.36.0-255,66,81478,6,236516
34192,0.001035,172.31.36.0-255,66,81544,6,236516
34193,0.001043,172.217.194.0-255,7856,89400,6,236516
34194,0.001046,172.31.36.0-255,66,89466,6,236516
34195,0.001769,172.217.194.0-255,1484,90950,6,236516
34196,0.001779,172.217.194.0-255,2902,93852,6,236516
34197,0.001784,172.31.36.0-255,66,93918,6,236516
34198,0.001793,172.217.194.0-255,5738,99656,6,236516
34199,0.001795,172.31.36.0-255,66,99722,6,236516
34200,0.001831,172.31.36.0-255,66,99788,6,236516
34201,0.001842,172.217.194.0-255,9992,109780,6,236516
34202,0.001844,172.31.36.0-255,66,109846,6,236516
34203,0.001856,172.217.194.0-255,766,110612,6,236516
34204,0.001884,172.217.194.0-255,1484,112096,6,236516
34205,0.001886,172.31.36.0-255,66,112162,6,236516
34206,0.00189,172.217.194.0-255,1484,113646,6,236516
34207,0.001907,172.217.194.0-255,1484,115130,6,236516
34208,0.001909,172.31.36.0-255,66,115196,6,236516
34209,0.001916,172.217.194.0-255,5738,120934,6,236516
34210,0.001918,172.31.36.0-255,66,121000,6,236516
34211,0.001921,172.217.194.0-255,1484,122484,6,236516
34212,0.001948,172.217.194.0-255,7156,129640,6,236516
34213,0.001951,172.31.36.0-255,66,129706,6,236516
34214,0.001989,172.217.194.0-255,7156,136862,6,236516
34215,0.001992,172.31.36.0-255,66,136928,6,236516
34216,0.002016,172.217.194.0-255,7856,144784,6,236516
34217,0.002019,172.31.36.0-255,66,144850,6,236516
34218,0.002111,172.217.194.0-255,1484,146334,6,236516
34219,0.002118,172.217.194.0-255,2902,149236,6,236516
34220,0.002121,172.31.36.0-255,66,149302,6,236516
34221,0.002126,172.217.194.0-255,2902,152204,6,236516
34222,0.002128,172.31.36.0-255,66,152270,6,236516
34223,0.002144,172.217.194.0-255,2902,155172,6,236516
34224,0.002146,172.31.36.0-255,66,155238,6,236516
34225,0.002153,172.217.194.0-255,5738,160976,6,236516
34226,0.002155,172.31.36.0-255,66,161042,6,236516
34227,0.002183,172.217.194.0-255,7156,168198,6,236516
34228,0.002186,172.31.36.0-255,66,168264,6,236516
34229,0.002197,172.217.194.0-255,10692,178956,6,236516
34230,0.002255,172.217.194.0-255,1484,180440,6,236516
34231,0.002274,172.217.194.0-255,2902,183342,6,236516
34232,0.002281,172.217.194.0-255,5738,189080,6,236516
34233,0.002299,172.217.194.0-255,1484,190564,6,236516
34234,0.002373,172.217.194.0-255,5020,195584,6,236516
34235,0.002412,172.217.194.0-255,7856,203440,6,236516
34236,0.002452,172.217.194.0-255,8574,212014,6,236516
34237,0.002499,172.217.194.0-255,8574,220588,6,236516
34238,0.002536,172.217.194.0-255,4320,224908,6,236516
34239,0.002574,172.217.194.0-255,5738,230646,6,236516
34240,0.007036,172.31.36.0-255,66,230712,6,236516
34241,0.009611,172.217.194.0-255,5738,236450,6,236516
34242,0.009624,172.31.36.0-255,66,236516,6,236516
34243,0.0,74.125.130.0-255,153,153,6,226300
34244,3.3e-05,172.31.36.0-255,66,219,6,226300
34245,4e-05,74.125.130.0-255,1484,1703,6,226300
34246,4.4e-05,172.31.36.0-255,66,1769,6,226300
34247,4.7e-05,74.125.130.0-255,1484,3253,6,226300
34248,4.9e-05,172.31.36.0-255,66,3319,6,226300
34249,6.3e-05,74.125.130.0-255,2902,6221,6,226300
34250,6.5e-05,172.31.36.0-255,66,6287,6,226300
34251,7.3e-05,74.125.130.0-255,5738,12025,6,226300
34252,7.5e-05,172.31.36.0-255,66,12091,6,226300
34253,9.9e-05,74.125.130.0-255,2039,14130,6,226300
34254,0.000101,172.31.36.0-255,66,14196,6,226300
34255,0.000249,74.125.130.0-255,1484,15680,6,226300
34256,0.000254,172.31.36.0-255,66,15746,6,226300
34257,0.000286,74.125.130.0-255,2902,18648,6,226300
34258,0.000288,172.31.36.0-255,66,18714,6,226300
34259,0.000292,74.125.130.0-255,2902,21616,6,226300
34260,0.000294,172.31.36.0-255,66,21682,6,226300
34261,0.000324,74.125.130.0-255,4320,26002,6,226300
34262,0.000327,172.31.36.0-255,66,26068,6,226300
34263,0.000353,74.125.130.0-255,5379,31447,6,226300
34264,0.000356,172.31.36.0-255,66,31513,6,226300
34265,0.000393,74.125.130.0-255,2902,34415,6,226300
34266,0.000396,172.31.36.0-255,66,34481,6,226300
34267,0.0004,74.125.130.0-255,1484,35965,6,226300
34268,0.000402,172.31.36.0-255,66,36031,6,226300
34269,0.000425,74.125.130.0-255,2902,38933,6,226300
34270,0.000428,172.31.36.0-255,66,38999,6,226300
34271,0.000435,74.125.130.0-255,5738,44737,6,226300
34272,0.000438,172.31.36.0-255,66,44803,6,226300
34273,0.000462,74.125.130.0-255,2902,47705,6,226300
34274,0.000465,74.125.130.0-255,1125,48830,6,226300
34275,0.000467,172.31.36.0-255,66,48896,6,226300
34276,0.000719,74.125.130.0-255,1484,50380,6,226300
34277,0.000722,74.125.130.0-255,1484,51864,6,226300
34278,0.000724,172.31.36.0-255,66,51930,6,226300
34279,0.000727,172.31.36.0-255,66,51996,6,226300
34280,0.000748,74.125.130.0-255,1484,53480,6,226300
34281,0.000759,74.125.130.0-255,5738,59218,6,226300
34282,0.000762,172.31.36.0-255,66,59284,6,226300
34283,0.000767,74.125.130.0-255,2902,62186,6,226300
34284,0.000769,172.31.36.0-255,66,62252,6,226300
34285,0.000794,74.125.130.0-255,3961,66213,6,226300
34286,0.000797,172.31.36.0-255,66,66279,6,226300
34287,0.000803,74.125.130.0-255,4320,70599,6,226300
34288,0.000805,172.31.36.0-255,66,70665,6,226300
34289,0.000835,74.125.130.0-255,4320,74985,6,226300
34290,0.000838,172.31.36.0-255,66,75051,6,226300
34291,0.000846,74.125.130.0-255,8795,83846,6,226300
34292,0.000848,172.31.36.0-255,66,83912,6,226300
34293,0.000913,74.125.130.0-255,1484,85396,6,226300
34294,0.000916,74.125.130.0-255,1484,86880,6,226300
34295,0.000922,172.31.36.0-255,66,86946,6,226300
34296,0.000928,74.125.130.0-255,1484,88430,6,226300
34297,0.000955,74.125.130.0-255,5738,94168,6,226300
34298,0.000958,172.31.36.0-255,66,94234,6,226300
34299,0.000963,74.125.130.0-255,4320,98554,6,226300
34300,0.000966,172.31.36.0-255,66,98620,6,226300
34301,0.000983,74.125.130.0-255,4320,102940,6,226300
34302,0.000986,172.31.36.0-255,66,103006,6,226300
34303,0.001008,74.125.130.0-255,1484,104490,6,226300
34304,0.001014,74.125.130.0-255,4320,108810,6,226300
34305,0.001016,172.31.36.0-255,66,108876,6,226300
34306,0.001046,74.125.130.0-255,5738,114614,6,226300
34307,0.001049,172.31.36.0-255,66,114680,6,226300
34308,0.001078,74.125.130.0-255,2938,117618,6,226300
34309,0.001082,172.31.36.0-255,66,117684,6,226300
34310,0.001317,74.125.130.0-255,1484,119168,6,226300
34311,0.001345,74.125.130.0-255,2902,122070,6,226300
34312,0.001349,172.31.36.0-255,66,122136,6,226300
34313,0.001352,74.125.130.0-255,1484,123620,6,226300
34314,0.001384,74.125.130.0-255,2902,126522,6,226300
34315,0.001388,172.31.36.0-255,66,126588,6,226300
34316,0.001401,74.125.130.0-255,1484,128072,6,226300
34317,0.00142,74.125.130.0-255,4320,132392,6,226300
34318,0.001423,172.31.36.0-255,66,132458,6,226300
34319,0.001428,74.125.130.0-255,2902,135360,6,226300
34320,0.00143,172.31.36.0-255,66,135426,6,226300
34321,0.001483,74.125.130.0-255,10328,145754,6,226300
34322,0.001486,172.31.36.0-255,66,145820,6,226300
34323,0.001526,172.31.36.0-255,66,145886,6,226300
34324,0.001535,74.125.130.0-255,8574,154460,6,226300
34325,0.001537,172.31.36.0-255,66,154526,6,226300
34326,0.001569,74.125.130.0-255,1484,156010,6,226300
34327,0.001582,74.125.130.0-255,2184,158194,6,226300
34328,0.001585,172.31.36.0-255,66,158260,6,226300
34329,0.001793,74.125.130.0-255,1484,159744,6,226300
34330,0.001798,74.125.130.0-255,2902,162646,6,226300
34331,0.001801,172.31.36.0-255,66,162712,6,226300
34332,0.001828,74.125.130.0-255,4320,167032,6,226300
34333,0.001831,172.31.36.0-255,66,167098,6,226300
34334,0.001855,74.125.130.0-255,2902,170000,6,226300
34335,0.001858,172.31.36.0-255,66,170066,6,226300
34336,0.001884,74.125.130.0-255,2902,172968,6,226300
34337,0.001887,172.31.36.0-255,66,173034,6,226300
34338,0.001893,74.125.130.0-255,4320,177354,6,226300
34339,0.001895,172.31.36.0-255,66,177420,6,226300
34340,0.001924,74.125.130.0-255,5738,183158,6,226300
34341,0.001932,172.31.36.0-255,66,183224,6,226300
34342,0.001937,74.125.130.0-255,2902,186126,6,226300
34343,0.001939,172.31.36.0-255,66,186192,6,226300
34344,0.001943,74.125.130.0-255,4320,190512,6,226300
34345,0.001945,172.31.36.0-255,66,190578,6,226300
34346,0.001987,74.125.130.0-255,2184,192762,6,226300
34347,0.00199,172.31.36.0-255,66,192828,6,226300
34348,0.002234,74.125.130.0-255,1484,194312,6,226300
34349,0.002259,74.125.130.0-255,2902,197214,6,226300
34350,0.002262,172.31.36.0-255,66,197280,6,226300
34351,0.00229,74.125.130.0-255,5738,203018,6,226300
34352,0.002293,172.31.36.0-255,66,203084,6,226300
34353,0.002322,74.125.130.0-255,5738,208822,6,226300
34354,0.002325,172.31.36.0-255,66,208888,6,226300
34355,0.004627,74.125.130.0-255,5738,214626,6,226300
34356,0.004635,172.31.36.0-255,66,214692,6,226300
34357,0.006914,74.125.130.0-255,5738,220430,6,226300
34358,0.00692,172.31.36.0-255,66,220496,6,226300
34359,0.009191,74.125.130.0-255,5738,226234,6,226300
34360,0.009198,172.31.36.0-255,66,226300,6,226300
34361,0.0,216.58.203.0-255,152,152,6,374475
34362,1.5e-05,172.31.36.0-255,66,218,6,374475
34363,2.1e-05,216.58.203.0-255,1484,1702,6,374475
34364,2.5e-05,172.31.36.0-255,66,1768,6,374475
34365,3.1e-05,216.58.203.0-255,2902,4670,6,374475
34366,4.3e-05,172.31.36.0-255,66,4736,6,374475
34367,4.8e-05,216.58.203.0-255,4320,9056,6,374475
34368,5.1e-05,172.31.36.0-255,66,9122,6,374475
34369,5.5e-05,216.58.203.0-255,1484,10606,6,374475
34370,5.7e-05,172.31.36.0-255,66,10672,6,374475
34371,8.4e-05,216.58.203.0-255,2902,13574,6,374475
34372,8.6e-05,172.31.36.0-255,66,13640,6,374475
34373,0.000107,216.58.203.0-255,583,14223,6,374475
34374,0.00011,172.31.36.0-255,66,14289,6,374475
34375,0.000159,216.58.203.0-255,1484,15773,6,374475
34376,0.000162,172.31.36.0-255,66,15839,6,374475
34377,0.000167,216.58.203.0-255,2902,18741,6,374475
34378,0.000169,172.31.36.0-255,66,18807,6,374475
34379,0.000173,216.58.203.0-255,1484,20291,6,374475
34380,0.000179,172.31.36.0-255,66,20357,6,374475
34381,0.000208,216.58.203.0-255,1484,21841,6,374475
34382,0.000211,172.31.36.0-255,66,21907,6,374475
34383,0.000216,216.58.203.0-255,4320,26227,6,374475
34384,0.000218,172.31.36.0-255,66,26293,6,374475
34385,0.000234,216.58.203.0-255,4320,30613,6,374475
34386,0.000236,172.31.36.0-255,66,30679,6,374475
34387,0.00026,216.58.203.0-255,1125,31804,6,374475
34388,0.000262,172.31.36.0-255,66,31870,6,374475
34389,0.000289,216.58.203.0-255,4320,36190,6,374475
34390,0.000291,172.31.36.0-255,66,36256,6,374475
34391,0.000297,216.58.203.0-255,5738,41994,6,374475
34392,0.0003,172.31.36.0-255,66,42060,6,374475
34393,0.000355,216.58.203.0-255,1484,43544,6,374475
34394,0.00036,216.58.203.0-255,2902,46446,6,374475
34395,0.000363,172.31.36.0-255,66,46512,6,374475
34396,0.000367,216.58.203.0-255,2543,49055,6,374475
34397,0.000369,172.31.36.0-255,66,49121,6,374475
34398,0.000404,216.58.203.0-255,1484,50605,6,374475
34399,0.000424,216.58.203.0-255,2902,53507,6,374475
34400,0.000427,172.31.36.0-255,66,53573,6,374475
34401,0.000433,216.58.203.0-255,4320,57893,6,374475
34402,0.000435,172.31.36.0-255,66,57959,6,374475
34403,0.000439,216.58.203.0-255,1484,59443,6,374475
34404,0.000465,216.58.203.0-255,4320,63763,6,374475
34405,0.000467,172.31.36.0-255,66,63829,6,374475
34406,0.000472,216.58.203.0-255,2543,66372,6,374475
34407,0.000474,172.31.36.0-255,66,66438,6,374475
34408,0.000477,216.58.203.0-255,396,66834,6,374475
34409,0.000741,216.58.203.0-255,116,66950,6,374475
34410,0.001116,216.58.203.0-255,1484,68434,6,374475
34411,0.001122,172.31.36.0-255,66,68500,6,374475
34412,0.001129,216.58.203.0-255,2902,71402,6,374475
34413,0.001131,172.31.36.0-255,66,71468,6,374475
34414,0.001143,216.58.203.0-255,5738,77206,6,374475
34415,0.001145,172.31.36.0-255,66,77272,6,374475
34416,0.001154,216.58.203.0-255,6797,84069,6,374475
34417,0.001156,172.31.36.0-255,66,84135,6,374475
34418,0.001188,216.58.203.0-255,9992,94127,6,374475
34419,0.001191,172.31.36.0-255,66,94193,6,374475
34420,0.001223,216.58.203.0-255,4320,98513,6,374475
34421,0.001226,172.31.36.0-255,66,98579,6,374475
34422,0.001231,216.58.203.0-255,2785,101364,6,374475
34423,0.001233,172.31.36.0-255,66,101430,6,374475
34424,0.001494,216.58.203.0-255,1484,102914,6,374475
34425,0.001501,216.58.203.0-255,2902,105816,6,374475
34426,0.001505,172.31.36.0-255,66,105882,6,374475
34427,0.001512,216.58.203.0-255,5738,111620,6,374475
34428,0.001514,172.31.36.0-255,66,111686,6,374475
34429,0.001538,216.58.203.0-255,8574,120260,6,374475
34430,0.00154,172.31.36.0-255,66,120326,6,374475
34431,0.001572,216.58.203.0-255,4320,124646,6,374475
34432,0.001575,172.31.36.0-255,66,124712,6,374475
34433,0.001582,216.58.203.0-255,5738,130450,6,374475
34434,0.001584,172.31.36.0-255,66,130516,6,374475
34435,0.001589,216.58.203.0-255,2902,133418,6,374475
34436,0.001591,172.31.36.0-255,66,133484,6,374475
34437,0.001655,216.58.203.0-255,2184,135668,6,374475
34438,0.001659,172.31.36.0-255,66,135734,6,374475
34439,0.001911,172.31.36.0-255,101,135835,6,374475
34440,0.002265,216.58.203.0-255,1484,137319,6,374475
34441,0.002316,216.58.203.0-255,1484,138803,6,374475
34442,0.002322,172.31.36.0-255,66,138869,6,374475
34443,0.002328,216.58.203.0-255,2902,141771,6,374475
34444,0.00233,172.31.36.0-255,66,141837,6,374475
34445,0.002333,216.58.203.0-255,1484,143321,6,374475
34446,0.002379,216.58.203.0-255,4320,147641,6,374475
34447,0.002382,172.31.36.0-255,66,147707,6,374475
34448,0.002391,216.58.203.0-255,8574,156281,6,374475
34449,0.002393,172.31.36.0-255,66,156347,6,374475
34450,0.002403,216.58.203.0-255,9992,166339,6,374475
34451,0.002405,172.31.36.0-255,66,166405,6,374475
34452,0.00241,216.58.203.0-255,3602,170007,6,374475
34453,0.002412,172.31.36.0-255,66,170073,6,374475
34454,0.002511,216.58.203.0-255,1484,171557,6,374475
34455,0.002518,216.58.203.0-255,2902,174459,6,374475
34456,0.002521,172.31.36.0-255,66,174525,6,374475
34457,0.002525,216.58.203.0-255,1484,176009,6,374475
34458,0.002549,216.58.203.0-255,1484,177493,6,374475
34459,0.002551,172.31.36.0-255,66,177559,6,374475
34460,0.002604,216.58.203.0-255,1484,179043,6,374475
34461,0.002616,216.58.203.0-255,2902,181945,6,374475
34462,0.00262,172.31.36.0-255,66,182011,6,374475
34463,0.002627,216.58.203.0-255,5738,187749,6,374475
34464,0.002629,172.31.36.0-255,66,187815,6,374475
34465,0.002659,216.58.203.0-255,7156,194971,6,374475
34466,0.002662,172.31.36.0-255,66,195037,6,374475
34467,0.002683,216.58.203.0-255,5738,200775,6,374475
34468,0.002685,172.31.36.0-255,66,200841,6,374475
34469,0.002691,216.58.203.0-255,3602,204443,6,374475
34470,0.002693,172.31.36.0-255,66,204509,6,374475
34471,0.002732,172.31.36.0-255,66,204575,6,374475
34472,0.002767,216.58.203.0-255,2902,207477,6,374475
34473,0.00277,172.31.36.0-255,66,207543,6,374475
34474,0.002783,172.31.36.0-255,66,207609,6,374475
34475,0.002789,216.58.203.0-255,3602,211211,6,374475
34476,0.002792,172.31.36.0-255,66,211277,6,374475
34477,0.002855,216.58.203.0-255,1484,212761,6,374475
34478,0.002868,216.58.203.0-255,1484,214245,6,374475
34479,0.002872,172.31.36.0-255,66,214311,6,374475
34480,0.002876,216.58.203.0-255,2902,217213,6,374475
34481,0.002879,172.31.36.0-255,66,217279,6,374475
34482,0.00291,216.58.203.0-255,4320,221599,6,374475
34483,0.002913,172.31.36.0-255,66,221665,6,374475
34484,0.002922,216.58.203.0-255,2902,224567,6,374475
34485,0.002925,172.31.36.0-255,66,224633,6,374475
34486,0.002952,216.58.203.0-255,8574,233207,6,374475
34487,0.002955,172.31.36.0-255,66,233273,6,374475
34488,0.002963,216.58.203.0-255,7156,240429,6,374475
34489,0.002965,172.31.36.0-255,66,240495,6,374475
34490,0.002998,216.58.203.0-255,5020,245515,6,374475
34491,0.003002,172.31.36.0-255,66,245581,6,374475
34492,0.003066,216.58.203.0-255,1484,247065,6,374475
34493,0.00307,216.58.203.0-255,1484,248549,6,374475
34494,0.003073,172.31.36.0-255,66,248615,6,374475
34495,0.003097,216.58.203.0-255,1484,250099,6,374475
34496,0.003103,216.58.203.0-255,5738,255837,6,374475
34497,0.003106,172.31.36.0-255,66,255903,6,374475
34498,0.003116,216.58.203.0-255,8574,264477,6,374475
34499,0.003119,172.31.36.0-255,66,264543,6,374475
34500,0.003149,216.58.203.0-255,4320,268863,6,374475
34501,0.003152,172.31.36.0-255,66,268929,6,374475
34502,0.00316,216.58.203.0-255,8574,277503,6,374475
34503,0.003163,172.31.36.0-255,66,277569,6,374475
34504,0.003172,216.58.203.0-255,9274,286843,6,374475
34505,0.003175,172.31.36.0-255,66,286909,6,374475
34506,0.003184,216.58.203.0-255,8574,295483,6,374475
34507,0.003187,172.31.36.0-255,66,295549,6,374475
34508,0.003213,216.58.203.0-255,2902,298451,6,374475
34509,0.003216,172.31.36.0-255,66,298517,6,374475
34510,0.00322,216.58.203.0-255,1484,300001,6,374475
34511,0.003229,216.58.203.0-255,9992,309993,6,374475
34512,0.00324,216.58.203.0-255,10692,320685,6,374475
34513,0.003244,216.58.203.0-255,2902,323587,6,374475
34514,0.003249,216.58.203.0-255,4320,327907,6,374475
34515,0.003277,216.58.203.0-255,4320,332227,6,374475
34516,0.00328,216.58.203.0-255,1484,333711,6,374475
34517,0.003308,216.58.203.0-255,9992,343703,6,374475
34518,0.003314,216.58.203.0-255,5738,349441,6,374475
34519,0.003339,216.58.203.0-255,6438,355879,6,374475
34520,0.003342,216.58.203.0-255,1484,357363,6,374475
34521,0.003351,216.58.203.0-255,8574,365937,6,374475
34522,0.003354,216.58.203.0-255,1484,367421,6,374475
34523,0.003375,216.58.203.0-255,6646,374067,6,374475
34524,0.00339,216.58.203.0-255,105,374172,6,374475
34525,0.00356,216.58.203.0-255,66,374238,6,374475
34526,0.005647,172.31.36.0-255,66,374304,6,374475
34527,0.007697,172.31.36.0-255,105,374409,6,374475
34528,0.009335,216.58.203.0-255,66,374475,6,374475
34529,0.0,74.125.68.0-255,146,146,6,139349
34530,2.2e-05,172.31.36.0-255,66,212,6,139349
34531,3e-05,74.125.68.0-255,1484,1696,6,139349
34532,3.5e-05,172.31.36.0-255,66,1762,6,139349
34533,4.2e-05,74.125.68.0-255,2902,4664,6,139349
34534,4.5e-05,172.31.36.0-255,66,4730,6,139349
34535,6.8e-05,74.125.68.0-255,1484,6214,6,139349
34536,7.1e-05,172.31.36.0-255,66,6280,6,139349
34537,9e-05,74.125.68.0-255,2902,9182,6,139349
34538,9.3e-05,172.31.36.0-255,66,9248,6,139349
34539,0.000169,74.125.68.0-255,1484,10732,6,139349
34540,0.000172,172.31.36.0-255,66,10798,6,139349
34541,0.00019,74.125.68.0-255,3464,14262,6,139349
34542,0.000193,172.31.36.0-255,66,14328,6,139349
34543,0.000275,74.125.68.0-255,1484,15812,6,139349
34544,0.000279,172.31.36.0-255,66,15878,6,139349
34545,0.000313,74.125.68.0-255,2902,18780,6,139349
34546,0.000316,172.31.36.0-255,66,18846,6,139349
34547,0.000383,74.125.68.0-255,1484,20330,6,139349
34548,0.000385,172.31.36.0-255,66,20396,6,139349
34549,0.000401,74.125.68.0-255,4320,24716,6,139349
34550,0.000404,172.31.36.0-255,66,24782,6,139349
34551,0.000526,74.125.68.0-255,9992,34774,6,139349
34552,0.000531,172.31.36.0-255,66,34840,6,139349
34553,0.000552,74.125.68.0-255,3961,38801,6,139349
34554,0.000554,172.31.36.0-255,66,38867,6,139349
34555,0.000828,74.125.68.0-255,5738,44605,6,139349
34556,0.000833,172.31.36.0-255,66,44671,6,139349
34557,0.000872,172.31.36.0-255,66,44737,6,139349
34558,0.001302,74.125.68.0-255,5020,49757,6,139349
34559,0.001308,172.31.36.0-255,66,49823,6,139349
34560,0.001394,74.125.68.0-255,678,50501,6,139349
34561,0.001423,74.125.68.0-255,2902,53403,6,139349
34562,0.002114,74.125.68.0-255,3602,57005,6,139349
34563,0.002177,74.125.68.0-255,4320,61325,6,139349
34564,0.002273,74.125.68.0-255,2902,64227,6,139349
34565,0.002328,74.125.68.0-255,1484,65711,6,139349
34566,0.002364,74.125.68.0-255,2902,68613,6,139349
34567,0.002375,74.125.68.0-255,2902,71515,6,139349
34568,0.002498,74.125.68.0-255,2902,74417,6,139349
34569,0.002561,74.125.68.0-255,1484,75901,6,139349
34570,0.00293,74.125.68.0-255,1484,77385,6,139349
34571,0.002965,74.125.68.0-255,2902,80287,6,139349
34572,0.003039,74.125.68.0-255,2902,83189,6,139349
34573,0.003054,74.125.68.0-255,2902,86091,6,139349
34574,0.003157,74.125.68.0-255,5738,91829,6,139349
34575,0.003179,74.125.68.0-255,7156,98985,6,139349
34576,0.003452,74.125.68.0-255,7156,106141,6,139349
34577,0.004095,74.125.68.0-255,4320,110461,6,139349
34578,0.00445,74.125.68.0-255,5738,116199,6,139349
34579,0.005196,74.125.68.0-255,4320,120519,6,139349
34580,0.006591,172.31.36.0-255,66,120585,6,139349
34581,0.00871,172.31.36.0-255,66,120651,6,139349
34582,0.008781,74.125.68.0-255,5738,126389,6,139349
34583,0.009148,74.125.68.0-255,4320,130709,6,139349
34584,0.009171,74.125.68.0-255,4320,135029,6,139349
34585,0.009304,74.125.68.0-255,4320,139349,6,139349
34586,0.0,74.125.24.0-255,153,153,6,166897
34587,2.5e-05,172.31.36.0-255,66,219,6,166897
34588,3.3e-05,74.125.24.0-255,1484,1703,6,166897
34589,3.8e-05,172.31.36.0-255,66,1769,6,166897
34590,4.3e-05,74.125.24.0-255,2902,4671,6,166897
34591,4.7e-05,172.31.36.0-255,66,4737,6,166897
34592,6.6e-05,74.125.24.0-255,7156,11893,6,166897
34593,7e-05,172.31.36.0-255,66,11959,6,166897
34594,7.8e-05,74.125.24.0-255,7765,19724,6,166897
34595,8.1e-05,172.31.36.0-255,66,19790,6,166897
34596,0.000126,172.31.36.0-255,66,19856,6,166897
34597,0.000421,74.125.24.0-255,1484,21340,6,166897
34598,0.000427,172.31.36.0-255,66,21406,6,166897
34599,0.000434,74.125.24.0-255,2902,24308,6,166897
34600,0.000437,172.31.36.0-255,66,24374,6,166897
34601,0.000443,74.125.24.0-255,5738,30112,6,166897
34602,0.000453,172.31.36.0-255,66,30178,6,166897
34603,0.000461,74.125.24.0-255,6797,36975,6,166897
34604,0.000464,172.31.36.0-255,66,37041,6,166897
34605,0.000468,74.125.24.0-255,1484,38525,6,166897
34606,0.00047,172.31.36.0-255,66,38591,6,166897
34607,0.000517,172.31.36.0-255,66,38657,6,166897
34608,0.000521,74.125.24.0-255,2543,41200,6,166897
34609,0.000522,172.31.36.0-255,66,41266,6,166897
34610,0.000591,74.125.24.0-255,645,41911,6,166897
34611,0.000596,172.31.36.0-255,66,41977,6,166897
34612,0.000688,74.125.24.0-255,1484,43461,6,166897
34613,0.000694,172.31.36.0-255,66,43527,6,166897
34614,0.000699,74.125.24.0-255,2902,46429,6,166897
34615,0.000702,172.31.36.0-255,66,46495,6,166897
34616,0.000716,74.125.24.0-255,5738,52233,6,166897
34617,0.000762,74.125.24.0-255,2902,55135,6,166897
34618,0.000771,172.31.36.0-255,66,55201,6,166897
34619,0.000795,74.125.24.0-255,9633,64834,6,166897
34620,0.00081,74.125.24.0-255,1484,66318,6,166897
34621,0.000813,74.125.24.0-255,1484,67802,6,166897
34622,0.000822,74.125.24.0-255,1484,69286,6,166897
34623,0.000825,74.125.24.0-255,2902,72188,6,166897
34624,0.000836,74.125.24.0-255,2902,75090,6,166897
34625,0.000862,74.125.24.0-255,2902,77992,6,166897
34626,0.000878,172.31.36.0-255,66,78058,6,166897
34627,0.000883,74.125.24.0-255,3413,81471,6,166897
34628,0.000897,172.31.36.0-255,66,81537,6,166897
34629,0.000914,74.125.24.0-255,4320,85857,6,166897
34630,0.000931,74.125.24.0-255,1484,87341,6,166897
34631,0.000939,74.125.24.0-255,7156,94497,6,166897
34632,0.000957,74.125.24.0-255,8574,103071,6,166897
34633,0.00097,74.125.24.0-255,5738,108809,6,166897
34634,0.000975,74.125.24.0-255,6438,115247,6,166897
34635,0.001008,172.31.36.0-255,66,115313,6,166897
34636,0.001233,74.125.24.0-255,1484,116797,6,166897
34637,0.001241,74.125.24.0-255,2902,119699,6,166897
34638,0.001244,74.125.24.0-255,1484,121183,6,166897
34639,0.001263,74.125.24.0-255,4320,125503,6,166897
34640,0.001267,74.125.24.0-255,2902,128405,6,166897
34641,0.001281,74.125.24.0-255,4320,132725,6,166897
34642,0.001286,74.125.24.0-255,4320,137045,6,166897
34643,0.001306,74.125.24.0-255,4320,141365,6,166897
34644,0.001319,74.125.24.0-255,2902,144267,6,166897
34645,0.001339,172.31.36.0-255,66,144333,6,166897
34646,0.001346,74.125.24.0-255,5020,149353,6,166897
34647,0.001359,172.31.36.0-255,66,149419,6,166897
34648,0.003603,74.125.24.0-255,5738,155157,6,166897
34649,0.003609,172.31.36.0-255,66,155223,6,166897
34650,0.005862,74.125.24.0-255,5738,160961,6,166897
34651,0.005867,172.31.36.0-255,66,161027,6,166897
34652,0.008128,74.125.24.0-255,1484,162511,6,166897
34653,0.008152,74.125.24.0-255,4320,166831,6,166897
34654,0.008159,172.31.36.0-255,66,166897,6,166897
34655,0.0,74.125.68.0-255,297,297,6,160597
34656,2.4e-05,172.31.36.0-255,66,363,6,160597
34657,3.1e-05,74.125.68.0-255,1484,1847,6,160597
34658,3.5e-05,172.31.36.0-255,66,1913,6,160597
34659,5.1e-05,74.125.68.0-255,4320,6233,6,160597
34660,5.4e-05,172.31.36.0-255,66,6299,6,160597
34661,6.3e-05,74.125.68.0-255,7156,13455,6,160597
34662,6.6e-05,172.31.36.0-255,66,13521,6,160597
34663,9.7e-05,74.125.68.0-255,441,13962,6,160597
34664,0.0001,172.31.36.0-255,66,14028,6,160597
34665,0.00011,74.125.68.0-255,8574,22602,6,160597
34666,0.000112,172.31.36.0-255,66,22668,6,160597
34667,0.000167,74.125.68.0-255,5738,28406,6,160597
34668,0.000169,172.31.36.0-255,66,28472,6,160597
34669,0.000203,74.125.68.0-255,2543,31015,6,160597
34670,0.000205,172.31.36.0-255,66,31081,6,160597
34671,0.000209,74.125.68.0-255,1484,32565,6,160597
34672,0.000211,172.31.36.0-255,66,32631,6,160597
34673,0.000233,74.125.68.0-255,1484,34115,6,160597
34674,0.000236,172.31.36.0-255,66,34181,6,160597
34675,0.00024,74.125.68.0-255,2902,37083,6,160597
34676,0.000243,172.31.36.0-255,66,37149,6,160597
34677,0.000274,74.125.68.0-255,4320,41469,6,160597
34678,0.000277,172.31.36.0-255,66,41535,6,160597
34679,0.000314,172.31.36.0-255,66,41601,6,160597
34680,0.000406,74.125.68.0-255,5738,47339,6,160597
34681,0.000411,172.31.36.0-255,66,47405,6,160597
34682,0.000437,74.125.68.0-255,3891,51296,6,160597
34683,0.00044,172.31.36.0-255,66,51362,6,160597
34684,0.000444,74.125.68.0-255,418,51780,6,160597
34685,0.000445,172.31.36.0-255,66,51846,6,160597
34686,0.000679,74.125.68.0-255,1484,53330,6,160597
34687,0.000687,74.125.68.0-255,2902,56232,6,160597
34688,0.000692,172.31.36.0-255,66,56298,6,160597
34689,0.000721,74.125.68.0-255,5738,62036,6,160597
34690,0.000724,172.31.36.0-255,66,62102,6,160597
34691,0.000751,74.125.68.0-255,4320,66422,6,160597
34692,0.000754,172.31.36.0-255,66,66488,6,160597
34693,0.000782,74.125.68.0-255,5738,72226,6,160597
34694,0.000785,172.31.36.0-255,66,72292,6,160597
34695,0.000816,74.125.68.0-255,5738,78030,6,160597
34696,0.000819,172.31.36.0-255,66,78096,6,160597
34697,0.000844,74.125.68.0-255,5738,83834,6,160597
34698,0.000847,172.31.36.0-255,66,83900,6,160597
34699,0.000904,74.125.68.0-255,2184,86084,6,160597
34700,0.000908,172.31.36.0-255,66,86150,6,160597
34701,0.000943,74.125.68.0-255,1484,87634,6,160597
34702,0.000948,74.125.68.0-255,2902,90536,6,160597
34703,0.000953,172.31.36.0-255,66,90602,6,160597
34704,0.000961,74.125.68.0-255,1484,92086,6,160597
34705,0.000981,74.125.68.0-255,4320,96406,6,160597
34706,0.000983,172.31.36.0-255,66,96472,6,160597
34707,0.001015,74.125.68.0-255,5738,102210,6,160597
34708,0.001018,172.31.36.0-255,66,102276,6,160597
34709,0.001041,74.125.68.0-255,2902,105178,6,160597
34710,0.001044,172.31.36.0-255,66,105244,6,160597
34711,0.001064,74.125.68.0-255,4320,109564,6,160597
34712,0.001067,172.31.36.0-255,66,109630,6,160597
34713,0.001109,74.125.68.0-255,10692,120322,6,160597
34714,0.001144,172.31.36.0-255,66,120388,6,160597
34715,0.001842,74.125.68.0-255,1484,121872,6,160597
34716,0.001848,74.125.68.0-255,1484,123356,6,160597
34717,0.001852,172.31.36.0-255,66,123422,6,160597
34718,0.001876,74.125.68.0-255,1484,124906,6,160597
34719,0.001882,74.125.68.0-255,5738,130644,6,160597
34720,0.001885,172.31.36.0-255,66,130710,6,160597
34721,0.001923,172.31.36.0-255,66,130776,6,160597
34722,0.001981,74.125.68.0-255,1484,132260,6,160597
34723,0.002012,74.125.68.0-255,10692,142952,6,160597
34724,0.002016,172.31.36.0-255,66,143018,6,160597
34725,0.00205,172.31.36.0-255,101,143119,6,160597
34726,0.004308,74.125.68.0-255,5738,148857,6,160597
34727,0.004314,172.31.36.0-255,66,148923,6,160597
34728,0.004345,74.125.68.0-255,66,148989,6,160597
34729,0.00663,74.125.68.0-255,5738,154727,6,160597
34730,0.006638,172.31.36.0-255,66,154793,6,160597
34731,0.008942,74.125.68.0-255,5738,160531,6,160597
34732,0.008947,172.31.36.0-255,66,160597,6,160597
34733,0.0,172.217.194.0-255,291,291,6,98951
34734,2.3e-05,172.31.36.0-255,66,357,6,98951
34735,3e-05,172.217.194.0-255,1484,1841,6,98951
34736,3.5e-05,172.31.36.0-255,66,1907,6,98951
34737,3.8e-05,172.217.194.0-255,1484,3391,6,98951
34738,4.9e-05,172.31.36.0-255,66,3457,6,98951
34739,5.7e-05,172.217.194.0-255,4320,7777,6,98951
34740,6e-05,172.31.36.0-255,66,7843,6,98951
34741,8.9e-05,172.217.194.0-255,10412,18255,6,98951
34742,9.2e-05,172.31.36.0-255,66,18321,6,98951
34743,0.000106,172.31.36.0-255,66,18387,6,98951
34744,0.000141,172.217.194.0-255,8574,26961,6,98951
34745,0.000145,172.31.36.0-255,66,27027,6,98951
34746,0.000179,172.217.194.0-255,9274,36301,6,98951
34747,0.000182,172.31.36.0-255,66,36367,6,98951
34748,0.000191,172.217.194.0-255,8574,44941,6,98951
34749,0.000193,172.31.36.0-255,66,45007,6,98951
34750,0.000219,172.217.194.0-255,7156,52163,6,98951
34751,0.000222,172.31.36.0-255,66,52229,6,98951
34752,0.000225,172.217.194.0-255,1399,53628,6,98951
34753,0.000228,172.31.36.0-255,66,53694,6,98951
34754,0.000651,172.217.194.0-255,122,53816,6,98951
34755,0.000655,172.217.194.0-255,377,54193,6,98951
34756,0.000665,172.31.36.0-255,66,54259,6,98951
34757,0.000674,172.31.36.0-255,66,54325,6,98951
34758,0.001483,172.217.194.0-255,1484,55809,6,98951
34759,0.001489,172.31.36.0-255,66,55875,6,98951
34760,0.001499,172.217.194.0-255,2902,58777,6,98951
34761,0.001501,172.31.36.0-255,66,58843,6,98951
34762,0.001513,172.217.194.0-255,4320,63163,6,98951
34763,0.001515,172.31.36.0-255,66,63229,6,98951
34764,0.001553,172.217.194.0-255,1484,64713,6,98951
34765,0.001557,172.31.36.0-255,66,64779,6,98951
34766,0.001572,172.31.36.0-255,66,64845,6,98951
34767,0.001592,172.217.194.0-255,5738,70583,6,98951
34768,0.001594,172.31.36.0-255,66,70649,6,98951
34769,0.001624,172.217.194.0-255,5020,75669,6,98951
34770,0.001627,172.31.36.0-255,66,75735,6,98951
34771,0.003699,172.217.194.0-255,5738,81473,6,98951
34772,0.003706,172.31.36.0-255,66,81539,6,98951
34773,0.005796,172.217.194.0-255,5738,87277,6,98951
34774,0.0058,172.31.36.0-255,66,87343,6,98951
34775,0.007862,172.217.194.0-255,5738,93081,6,98951
34776,0.007869,172.31.36.0-255,66,93147,6,98951
34777,0.009941,172.217.194.0-255,5738,98885,6,98951
34778,0.009948,172.31.36.0-255,66,98951,6,98951
34779,0.0,74.125.24.0-255,146,146,6,132032
34780,2.3e-05,172.31.36.0-255,66,212,6,132032
34781,3.1e-05,74.125.24.0-255,1484,1696,6,132032
34782,3.5e-05,172.31.36.0-255,66,1762,6,132032
34783,4e-05,74.125.24.0-255,2902,4664,6,132032
34784,4.3e-05,172.31.36.0-255,66,4730,6,132032
34785,5e-05,74.125.24.0-255,2902,7632,6,132032
34786,5.2e-05,172.31.36.0-255,66,7698,6,132032
34787,5.9e-05,74.125.24.0-255,4320,12018,6,132032
34788,6.2e-05,172.31.36.0-255,66,12084,6,132032
34789,8.8e-05,74.125.24.0-255,1991,14075,6,132032
34790,9.1e-05,172.31.36.0-255,66,14141,6,132032
34791,0.000119,74.125.24.0-255,1484,15625,6,132032
34792,0.000122,172.31.36.0-255,66,15691,6,132032
34793,0.000138,74.125.24.0-255,2902,18593,6,132032
34794,0.000141,172.31.36.0-255,66,18659,6,132032
34795,0.000147,74.125.24.0-255,5738,24397,6,132032
34796,0.00015,172.31.36.0-255,66,24463,6,132032
34797,0.000184,74.125.24.0-255,6797,31260,6,132032
34798,0.000188,172.31.36.0-255,66,31326,6,132032
34799,0.000244,74.125.24.0-255,1484,32810,6,132032
34800,0.000246,172.31.36.0-255,66,32876,6,132032
34801,0.000252,74.125.24.0-255,2902,35778,6,132032
34802,0.000254,172.31.36.0-255,66,35844,6,132032
34803,0.000282,74.125.24.0-255,5738,41582,6,132032
34804,0.000285,172.31.36.0-255,66,41648,6,132032
34805,0.000288,74.125.24.0-255,1484,43132,6,132032
34806,0.00029,172.31.36.0-255,66,43198,6,132032
34807,0.000307,74.125.24.0-255,5379,48577,6,132032
34808,0.00031,172.31.36.0-255,66,48643,6,132032
34809,0.001363,74.125.24.0-255,1484,50127,6,132032
34810,0.00137,172.31.36.0-255,66,50193,6,132032
34811,0.00138,74.125.24.0-255,2902,53095,6,132032
34812,0.001382,172.31.36.0-255,66,53161,6,132032
34813,0.001389,74.125.24.0-255,5738,58899,6,132032
34814,0.001391,172.31.36.0-255,66,58965,6,132032
34815,0.001434,172.31.36.0-255,66,59031,6,132032
34816,0.001443,74.125.24.0-255,9633,68664,6,132032
34817,0.001445,172.31.36.0-255,66,68730,6,132032
34818,0.001449,74.125.24.0-255,1484,70214,6,132032
34819,0.001484,74.125.24.0-255,8574,78788,6,132032
34820,0.001486,172.31.36.0-255,66,78854,6,132032
34821,0.001492,74.125.24.0-255,5738,84592,6,132032
34822,0.001494,172.31.36.0-255,66,84658,6,132032
34823,0.001527,74.125.24.0-255,1705,86363,6,132032
34824,0.001531,172.31.36.0-255,66,86429,6,132032
34825,0.002221,74.125.24.0-255,1484,87913,6,132032
34826,0.002239,74.125.24.0-255,2902,90815,6,132032
34827,0.002243,172.31.36.0-255,66,90881,6,132032
34828,0.002248,74.125.24.0-255,4320,95201,6,132032
34829,0.002251,172.31.36.0-255,66,95267,6,132032
34830,0.002274,74.125.24.0-255,1484,96751,6,132032
34831,0.002288,172.31.36.0-255,66,96817,6,132032
34832,0.002296,74.125.24.0-255,7156,103973,6,132032
34833,0.002298,172.31.36.0-255,66,104039,6,132032
34834,0.00235,74.125.24.0-255,10515,114554,6,132032
34835,0.002353,172.31.36.0-255,66,114620,6,132032
34836,0.004616,74.125.24.0-255,5738,120358,6,132032
34837,0.00462,172.31.36.0-255,66,120424,6,132032
34838,0.006877,74.125.24.0-255,5738,126162,6,132032
34839,0.006884,172.31.36.0-255,66,126228,6,132032
34840,0.009158,74.125.24.0-255,5738,131966,6,132032
34841,0.009165,172.31.36.0-255,66,132032,6,132032
34842,0.0,172.253.118.0-255,158,158,6,126349
34843,1.8e-05,172.31.36.0-255,66,224,6,126349
34844,2.4e-05,172.253.118.0-255,1484,1708,6,126349
34845,2.8e-05,172.31.36.0-255,66,1774,6,126349
34846,3.1e-05,172.253.118.0-255,1484,3258,6,126349
34847,3.4e-05,172.31.36.0-255,66,3324,6,126349
34848,3.8e-05,172.253.118.0-255,1484,4808,6,126349
34849,4.1e-05,172.31.36.0-255,66,4874,6,126349
34850,6.5e-05,172.253.118.0-255,2902,7776,6,126349
34851,6.9e-05,172.31.36.0-255,66,7842,6,126349
34852,8.6e-05,172.253.118.0-255,2902,10744,6,126349
34853,8.9e-05,172.31.36.0-255,66,10810,6,126349
34854,0.000116,172.253.118.0-255,6210,17020,6,126349
34855,0.000119,172.31.36.0-255,66,17086,6,126349
34856,0.000123,172.253.118.0-255,1484,18570,6,126349
34857,0.000124,172.31.36.0-255,66,18636,6,126349
34858,0.000148,172.253.118.0-255,8574,27210,6,126349
34859,0.00015,172.31.36.0-255,66,27276,6,126349
34860,0.000154,172.253.118.0-255,2902,30178,6,126349
34861,0.000157,172.31.36.0-255,66,30244,6,126349
34862,0.00019,172.253.118.0-255,1125,31369,6,126349
34863,0.000193,172.31.36.0-255,66,31435,6,126349
34864,0.000326,172.253.118.0-255,1484,32919,6,126349
34865,0.000331,172.31.36.0-255,66,32985,6,126349
34866,0.000355,172.253.118.0-255,2902,35887,6,126349
34867,0.000358,172.31.36.0-255,66,35953,6,126349
34868,0.000365,172.253.118.0-255,5738,41691,6,126349
34869,0.000367,172.31.36.0-255,66,41757,6,126349
34870,0.000416,172.31.36.0-255,66,41823,6,126349
34871,0.000445,172.253.118.0-255,2902,44725,6,126349
34872,0.000448,172.31.36.0-255,66,44791,6,126349
34873,0.000473,172.253.118.0-255,7856,52647,6,126349
34874,0.000477,172.31.36.0-255,66,52713,6,126349
34875,0.00048,172.253.118.0-255,400,53113,6,126349
34876,0.000522,172.253.118.0-255,110,53223,6,126349
34877,0.000617,172.253.118.0-255,330,53553,6,126349
34878,0.001079,172.253.118.0-255,1484,55037,6,126349
34879,0.001085,172.31.36.0-255,66,55103,6,126349
34880,0.001092,172.253.118.0-255,2902,58005,6,126349
34881,0.001094,172.31.36.0-255,66,58071,6,126349
34882,0.001099,172.253.118.0-255,4320,62391,6,126349
34883,0.001101,172.31.36.0-255,66,62457,6,126349
34884,0.001114,172.253.118.0-255,1484,63941,6,126349
34885,0.001123,172.253.118.0-255,7156,71097,6,126349
34886,0.001125,172.31.36.0-255,66,71163,6,126349
34887,0.001153,172.253.118.0-255,5738,76901,6,126349
34888,0.001156,172.31.36.0-255,66,76967,6,126349
34889,0.001165,172.253.118.0-255,10692,87659,6,126349
34890,0.001167,172.31.36.0-255,66,87725,6,126349
34891,0.001952,172.253.118.0-255,1484,89209,6,126349
34892,0.001963,172.253.118.0-255,2902,92111,6,126349
34893,0.001967,172.31.36.0-255,66,92177,6,126349
34894,0.001975,172.253.118.0-255,5738,97915,6,126349
34895,0.001977,172.31.36.0-255,66,97981,6,126349
34896,0.002014,172.31.36.0-255,66,98047,6,126349
34897,0.002021,172.253.118.0-255,5738,103785,6,126349
34898,0.002022,172.31.36.0-255,66,103851,6,126349
34899,0.002056,172.253.118.0-255,5020,108871,6,126349
34900,0.002058,172.31.36.0-255,66,108937,6,126349
34901,0.0044,172.253.118.0-255,5738,114675,6,126349
34902,0.004405,172.31.36.0-255,66,114741,6,126349
34903,0.00677,172.253.118.0-255,5738,120479,6,126349
34904,0.006776,172.31.36.0-255,66,120545,6,126349
34905,0.009198,172.253.118.0-255,5738,126283,6,126349
34906,0.009208,172.31.36.0-255,66,126349,6,126349
34907,0.0,172.217.194.0-255,153,153,6,197079
34908,4.5e-05,172.31.36.0-255,66,219,6,197079
34909,5.3e-05,172.217.194.0-255,1484,1703,6,197079
34910,5.8e-05,172.31.36.0-255,66,1769,6,197079
34911,7.3e-05,172.217.194.0-255,2902,4671,6,197079
34912,7.5e-05,172.31.36.0-255,66,4737,6,197079
34913,8.3e-05,172.217.194.0-255,5738,10475,6,197079
34914,8.5e-05,172.31.36.0-255,66,10541,6,197079
34915,0.000101,172.31.36.0-255,66,10607,6,197079
34916,0.000108,172.217.194.0-255,6797,17404,6,197079
34917,0.000111,172.31.36.0-255,66,17470,6,197079
34918,0.000143,172.217.194.0-255,1484,18954,6,197079
34919,0.000145,172.31.36.0-255,66,19020,6,197079
34920,0.000152,172.217.194.0-255,2902,21922,6,197079
34921,0.000154,172.31.36.0-255,66,21988,6,197079
34922,0.000166,172.217.194.0-255,5738,27726,6,197079
34923,0.000169,172.31.36.0-255,66,27792,6,197079
34924,0.000207,172.31.36.0-255,66,27858,6,197079
34925,0.000252,172.217.194.0-255,9633,37491,6,197079
34926,0.000256,172.31.36.0-255,66,37557,6,197079
34927,0.000275,172.217.194.0-255,363,37920,6,197079
34928,0.000279,172.31.36.0-255,66,37986,6,197079
34929,0.000282,172.217.194.0-255,382,38368,6,197079
34930,0.000284,172.31.36.0-255,66,38434,6,197079
34931,0.000468,172.217.194.0-255,1484,39918,6,197079
34932,0.000474,172.31.36.0-255,66,39984,6,197079
34933,0.00048,172.217.194.0-255,2902,42886,6,197079
34934,0.000483,172.31.36.0-255,66,42952,6,197079
34935,0.000496,172.217.194.0-255,5738,48690,6,197079
34936,0.000499,172.31.36.0-255,66,48756,6,197079
34937,0.000502,172.217.194.0-255,1484,50240,6,197079
34938,0.000535,172.217.194.0-255,5379,55619,6,197079
34939,0.000539,172.31.36.0-255,66,55685,6,197079
34940,0.000564,172.217.194.0-255,1484,57169,6,197079
34941,0.000571,172.217.194.0-255,2902,60071,6,197079
34942,0.000574,172.31.36.0-255,66,60137,6,197079
34943,0.000579,172.217.194.0-255,2902,63039,6,197079
34944,0.000582,172.31.36.0-255,66,63105,6,197079
34945,0.000606,172.217.194.0-255,2902,66007,6,197079
34946,0.000614,172.31.36.0-255,66,66073,6,197079
34947,0.000622,172.217.194.0-255,6246,72319,6,197079
34948,0.000625,172.31.36.0-255,66,72385,6,197079
34949,0.000813,172.217.194.0-255,1484,73869,6,197079
34950,0.000819,172.217.194.0-255,2902,76771,6,197079
34951,0.000822,172.31.36.0-255,66,76837,6,197079
34952,0.000828,172.217.194.0-255,4320,81157,6,197079
34953,0.000831,172.31.36.0-255,66,81223,6,197079
34954,0.000859,172.217.194.0-255,1484,82707,6,197079
34955,0.000868,172.217.194.0-255,8574,91281,6,197079
34956,0.000871,172.31.36.0-255,66,91347,6,197079
34957,0.000944,172.31.36.0-255,66,91413,6,197079
34958,0.001944,172.217.194.0-255,1484,92897,6,197079
34959,0.00196,172.217.194.0-255,2902,95799,6,197079
34960,0.001966,172.31.36.0-255,66,95865,6,197079
34961,0.001974,172.217.194.0-255,5738,101603,6,197079
34962,0.001976,172.31.36.0-255,66,101669,6,197079
34963,0.001993,172.217.194.0-255,9992,111661,6,197079
34964,0.001996,172.31.36.0-255,66,111727,6,197079
34965,0.002045,172.31.36.0-255,66,111793,6,197079
34966,0.002658,172.217.194.0-255,1484,113277,6,197079
34967,0.002666,172.217.194.0-255,2902,116179,6,197079
34968,0.00267,172.31.36.0-255,66,116245,6,197079
34969,0.002675,172.217.194.0-255,2902,119147,6,197079
34970,0.002677,172.31.36.0-255,66,119213,6,197079
34971,0.002693,172.217.194.0-255,2902,122115,6,197079
34972,0.002694,172.31.36.0-255,66,122181,6,197079
34973,0.002735,172.31.36.0-255,66,122247,6,197079
34974,0.002743,172.217.194.0-255,8574,130821,6,197079
34975,0.002745,172.31.36.0-255,66,130887,6,197079
34976,0.002773,172.217.194.0-255,2184,133071,6,197079
34977,0.002775,172.31.36.0-255,66,133137,6,197079
34978,0.002832,172.217.194.0-255,1484,134621,6,197079
34979,0.002838,172.217.194.0-255,2902,137523,6,197079
34980,0.00284,172.31.36.0-255,66,137589,6,197079
34981,0.002864,172.217.194.0-255,4320,141909,6,197079
34982,0.002866,172.31.36.0-255,66,141975,6,197079
34983,0.002897,172.217.194.0-255,9992,151967,6,197079
34984,0.002899,172.31.36.0-255,66,152033,6,197079
34985,0.002906,172.217.194.0-255,4320,156353,6,197079
34986,0.002908,172.31.36.0-255,66,156419,6,197079
34987,0.002939,172.217.194.0-255,7156,163575,6,197079
34988,0.002941,172.31.36.0-255,66,163641,6,197079
34989,0.002946,172.217.194.0-255,3602,167243,6,197079
34990,0.002949,172.31.36.0-255,66,167309,6,197079
34991,0.003034,172.217.194.0-255,1484,168793,6,197079
34992,0.003038,172.217.194.0-255,2902,171695,6,197079
34993,0.00304,172.31.36.0-255,66,171761,6,197079
34994,0.003055,172.217.194.0-255,5738,177499,6,197079
34995,0.003062,172.31.36.0-255,66,177565,6,197079
34996,0.003111,172.31.36.0-255,66,177631,6,197079
34997,0.003141,172.217.194.0-255,10692,188323,6,197079
34998,0.003145,172.31.36.0-255,66,188389,6,197079
34999,0.003189,172.31.36.0-255,66,188455,6,197079
35000,0.003205,172.31.36.0-255,66,188521,6,197079
35001,0.003208,172.217.194.0-255,1484,190005,6,197079
35002,0.003261,172.31.36.0-255,66,190071,6,197079
35003,0.003274,172.31.36.0-255,66,190137,6,197079
35004,0.003396,172.217.194.0-255,6600,196737,6,197079
35005,0.003417,172.217.194.0-255,105,196842,6,197079
35006,0.003532,172.31.36.0-255,66,196908,6,197079
35007,0.005785,172.31.36.0-255,105,197013,6,197079
35008,0.00768,172.217.194.0-255,66,197079,6,197079
35009,0.0,74.125.24.0-255,153,153,6,187132
35010,3.3e-05,172.31.36.0-255,66,219,6,187132
35011,4e-05,74.125.24.0-255,1484,1703,6,187132
35012,4.5e-05,172.31.36.0-255,66,1769,6,187132
35013,4.9e-05,74.125.24.0-255,2902,4671,6,187132
35014,5.1e-05,172.31.36.0-255,66,4737,6,187132
35015,6.7e-05,74.125.24.0-255,7156,11893,6,187132
35016,7e-05,172.31.36.0-255,66,11959,6,187132
35017,7.3e-05,74.125.24.0-255,1484,13443,6,187132
35018,7.6e-05,172.31.36.0-255,66,13509,6,187132
35019,8.2e-05,74.125.24.0-255,4320,17829,6,187132
35020,8.4e-05,172.31.36.0-255,66,17895,6,187132
35021,0.000113,74.125.24.0-255,6340,24235,6,187132
35022,0.000116,172.31.36.0-255,66,24301,6,187132
35023,0.000124,74.125.24.0-255,6797,31098,6,187132
35024,0.000126,172.31.36.0-255,66,31164,6,187132
35025,0.000155,74.125.24.0-255,1484,32648,6,187132
35026,0.000158,172.31.36.0-255,66,32714,6,187132
35027,0.000163,74.125.24.0-255,2902,35616,6,187132
35028,0.000165,172.31.36.0-255,66,35682,6,187132
35029,0.000172,74.125.24.0-255,2902,38584,6,187132
35030,0.000174,172.31.36.0-255,66,38650,6,187132
35031,0.000197,74.125.24.0-255,2902,41552,6,187132
35032,0.0002,172.31.36.0-255,66,41618,6,187132
35033,0.000225,74.125.24.0-255,6797,48415,6,187132
35034,0.000229,172.31.36.0-255,66,48481,6,187132
35035,0.00075,74.125.24.0-255,1484,49965,6,187132
35036,0.000755,172.31.36.0-255,66,50031,6,187132
35037,0.000764,74.125.24.0-255,2902,52933,6,187132
35038,0.000767,172.31.36.0-255,66,52999,6,187132
35039,0.00078,74.125.24.0-255,5738,58737,6,187132
35040,0.000782,172.31.36.0-255,66,58803,6,187132
35041,0.000816,74.125.24.0-255,8574,67377,6,187132
35042,0.000819,172.31.36.0-255,66,67443,6,187132
35043,0.000848,74.125.24.0-255,5379,72822,6,187132
35044,0.000851,172.31.36.0-255,66,72888,6,187132
35045,0.000856,74.125.24.0-255,2902,75790,6,187132
35046,0.000858,172.31.36.0-255,66,75856,6,187132
35047,0.000893,74.125.24.0-255,6797,82653,6,187132
35048,0.000897,172.31.36.0-255,66,82719,6,187132
35049,0.000905,74.125.24.0-255,7156,89875,6,187132
35050,0.000907,172.31.36.0-255,66,89941,6,187132
35051,0.000911,74.125.24.0-255,1484,91425,6,187132
35052,0.000945,74.125.24.0-255,7156,98581,6,187132
35053,0.000948,172.31.36.0-255,66,98647,6,187132
35054,0.000975,74.125.24.0-255,1706,100353,6,187132
35055,0.00098,172.31.36.0-255,66,100419,6,187132
35056,0.001009,74.125.24.0-255,2902,103321,6,187132
35057,0.001011,172.31.36.0-255,66,103387,6,187132
35058,0.001017,74.125.24.0-255,4320,107707,6,187132
35059,0.001019,172.31.36.0-255,66,107773,6,187132
35060,0.001054,74.125.24.0-255,8574,116347,6,187132
35061,0.001058,172.31.36.0-255,66,116413,6,187132
35062,0.001073,74.125.24.0-255,4320,120733,6,187132
35063,0.00108,172.31.36.0-255,66,120799,6,187132
35064,0.001112,172.31.36.0-255,66,120865,6,187132
35065,0.001117,74.125.24.0-255,2184,123049,6,187132
35066,0.001119,172.31.36.0-255,66,123115,6,187132
35067,0.001385,74.125.24.0-255,1484,124599,6,187132
35068,0.001392,74.125.24.0-255,2902,127501,6,187132
35069,0.001396,172.31.36.0-255,66,127567,6,187132
35070,0.00143,74.125.24.0-255,5738,133305,6,187132
35071,0.001432,172.31.36.0-255,66,133371,6,187132
35072,0.001439,74.125.24.0-255,6233,139604,6,187132
35073,0.001441,172.31.36.0-255,66,139670,6,187132
35074,0.00166,74.125.24.0-255,1484,141154,6,187132
35075,0.001677,74.125.24.0-255,2902,144056,6,187132
35076,0.001679,172.31.36.0-255,66,144122,6,187132
35077,0.001684,74.125.24.0-255,2902,147024,6,187132
35078,0.001686,172.31.36.0-255,66,147090,6,187132
35079,0.001714,74.125.24.0-255,2902,149992,6,187132
35080,0.001717,172.31.36.0-255,66,150058,6,187132
35081,0.001755,74.125.24.0-255,1484,151542,6,187132
35082,0.001792,172.31.36.0-255,66,151608,6,187132
35083,0.001805,172.31.36.0-255,66,151674,6,187132
35084,0.001813,74.125.24.0-255,8574,160248,6,187132
35085,0.001815,172.31.36.0-255,66,160314,6,187132
35086,0.001848,172.31.36.0-255,66,160380,6,187132
35087,0.001885,74.125.24.0-255,9274,169654,6,187132
35088,0.001888,172.31.36.0-255,66,169720,6,187132
35089,0.004138,74.125.24.0-255,5738,175458,6,187132
35090,0.004142,172.31.36.0-255,66,175524,6,187132
35091,0.006381,74.125.24.0-255,5738,181262,6,187132
35092,0.00639,172.31.36.0-255,66,181328,6,187132
35093,0.00864,74.125.24.0-255,5738,187066,6,187132
35094,0.008647,172.31.36.0-255,66,187132,6,187132
35095,0.0,172.217.160.0-255,298,298,6,198161
35096,1.5e-05,172.31.36.0-255,66,364,6,198161
35097,1.9e-05,172.217.160.0-255,1484,1848,6,198161
35098,2.3e-05,172.31.36.0-255,66,1914,6,198161
35099,3.7e-05,172.217.160.0-255,4320,6234,6,198161
35100,4e-05,172.31.36.0-255,66,6300,6,198161
35101,4.4e-05,172.217.160.0-255,2902,9202,6,198161
35102,4.8e-05,172.31.36.0-255,66,9268,6,198161
35103,9.8e-05,172.217.160.0-255,8930,18198,6,198161
35104,0.000101,172.31.36.0-255,66,18264,6,198161
35105,0.000106,172.217.160.0-255,2902,21166,6,198161
35106,0.000109,172.31.36.0-255,66,21232,6,198161
35107,0.000149,172.217.160.0-255,4320,25552,6,198161
35108,0.000152,172.31.36.0-255,66,25618,6,198161
35109,0.000159,172.217.160.0-255,5379,30997,6,198161
35110,0.000161,172.31.36.0-255,66,31063,6,198161
35111,0.000202,172.217.160.0-255,1484,32547,6,198161
35112,0.000204,172.31.36.0-255,66,32613,6,198161
35113,0.000209,172.217.160.0-255,2902,35515,6,198161
35114,0.000211,172.31.36.0-255,66,35581,6,198161
35115,0.000244,172.217.160.0-255,5738,41319,6,198161
35116,0.000246,172.31.36.0-255,66,41385,6,198161
35117,0.000256,172.217.160.0-255,6797,48182,6,198161
35118,0.000258,172.31.36.0-255,66,48248,6,198161
35119,0.000291,172.31.36.0-255,66,48314,6,198161
35120,0.000295,172.217.160.0-255,2826,51140,6,198161
35121,0.000297,172.31.36.0-255,66,51206,6,198161
35122,0.000905,172.217.160.0-255,103,51309,6,198161
35123,0.00091,172.31.36.0-255,66,51375,6,198161
35124,0.001139,172.217.160.0-255,1484,52859,6,198161
35125,0.001143,172.31.36.0-255,66,52925,6,198161
35126,0.001149,172.217.160.0-255,2902,55827,6,198161
35127,0.001155,172.217.160.0-255,2902,58729,6,198161
35128,0.001174,172.217.160.0-255,2902,61631,6,198161
35129,0.001197,172.217.160.0-255,8574,70205,6,198161
35130,0.00122,172.217.160.0-255,5379,75584,6,198161
35131,0.001226,172.217.160.0-255,7156,82740,6,198161
35132,0.001242,172.217.160.0-255,2543,85283,6,198161
35133,0.001251,172.31.36.0-255,66,85349,6,198161
35134,0.00132,172.217.160.0-255,1484,86833,6,198161
35135,0.001326,172.217.160.0-255,2902,89735,6,198161
35136,0.001333,172.31.36.0-255,66,89801,6,198161
35137,0.001352,172.217.160.0-255,5738,95539,6,198161
35138,0.00136,172.217.160.0-255,7156,102695,6,198161
35139,0.001376,172.217.160.0-255,5738,108433,6,198161
35140,0.001392,172.31.36.0-255,66,108499,6,198161
35141,0.001419,172.217.160.0-255,4320,112819,6,198161
35142,0.001427,172.31.36.0-255,66,112885,6,198161
35143,0.001454,172.217.160.0-255,6438,119323,6,198161
35144,0.001523,172.217.160.0-255,2902,122225,6,198161
35145,0.001529,172.217.160.0-255,3602,125827,6,198161
35146,0.001534,172.31.36.0-255,66,125893,6,198161
35147,0.001563,172.217.160.0-255,4320,130213,6,198161
35148,0.00157,172.217.160.0-255,7156,137369,6,198161
35149,0.001581,172.31.36.0-255,66,137435,6,198161
35150,0.001611,172.217.160.0-255,4320,141755,6,198161
35151,0.001626,172.217.160.0-255,5020,146775,6,198161
35152,0.001647,172.31.36.0-255,66,146841,6,198161
35153,0.0017,172.217.160.0-255,1484,148325,6,198161
35154,0.001706,172.217.160.0-255,2902,151227,6,198161
35155,0.001721,172.217.160.0-255,2902,154129,6,198161
35156,0.001729,172.217.160.0-255,7156,161285,6,198161
35157,0.001751,172.217.160.0-255,5738,167023,6,198161
35158,0.001757,172.31.36.0-255,66,167089,6,198161
35159,0.00179,172.217.160.0-255,9992,177081,6,198161
35160,0.001796,172.217.160.0-255,3602,180683,6,198161
35161,0.001805,172.31.36.0-255,66,180749,6,198161
35162,0.003746,172.217.160.0-255,5738,186487,6,198161
35163,0.003753,172.31.36.0-255,66,186553,6,198161
35164,0.005695,172.217.160.0-255,5738,192291,6,198161
35165,0.007949,172.31.36.0-255,66,192357,6,198161
35166,0.009896,172.217.160.0-255,5738,198095,6,198161
35167,0.009905,172.31.36.0-255,66,198161,6,198161
35168,0.0,172.217.194.0-255,289,289,6,281304
35169,2e-05,172.31.36.0-255,66,355,6,281304
35170,2.6e-05,172.217.194.0-255,1484,1839,6,281304
35171,3.1e-05,172.31.36.0-255,66,1905,6,281304
35172,3.9e-05,172.217.194.0-255,4320,6225,6,281304
35173,4.2e-05,172.31.36.0-255,66,6291,6,281304
35174,4.7e-05,172.217.194.0-255,2902,9193,6,281304
35175,5e-05,172.31.36.0-255,66,9259,6,281304
35176,7.7e-05,172.217.194.0-255,6087,15346,6,281304
35177,8.1e-05,172.31.36.0-255,66,15412,6,281304
35178,9.7e-05,172.31.36.0-255,66,15478,6,281304
35179,0.000184,172.217.194.0-255,1484,16962,6,281304
35180,0.000189,172.217.194.0-255,2902,19864,6,281304
35181,0.000197,172.31.36.0-255,66,19930,6,281304
35182,0.000201,172.31.36.0-255,66,19996,6,281304
35183,0.000207,172.217.194.0-255,4320,24316,6,281304
35184,0.000209,172.31.36.0-255,66,24382,6,281304
35185,0.000236,172.217.194.0-255,1484,25866,6,281304
35186,0.000239,172.31.36.0-255,66,25932,6,281304
35187,0.000247,172.217.194.0-255,6797,32729,6,281304
35188,0.000249,172.31.36.0-255,66,32795,6,281304
35189,0.000253,172.217.194.0-255,2902,35697,6,281304
35190,0.000255,172.31.36.0-255,66,35763,6,281304
35191,0.000281,172.217.194.0-255,4320,40083,6,281304
35192,0.000284,172.31.36.0-255,66,40149,6,281304
35193,0.000289,172.217.194.0-255,2902,43051,6,281304
35194,0.000291,172.31.36.0-255,66,43117,6,281304
35195,0.000321,172.217.194.0-255,7049,50166,6,281304
35196,0.000325,172.31.36.0-255,66,50232,6,281304
35197,0.000328,172.217.194.0-255,115,50347,6,281304
35198,0.00033,172.31.36.0-255,66,50413,6,281304
35199,0.000757,172.217.194.0-255,386,50799,6,281304
35200,0.000789,172.217.194.0-255,1484,52283,6,281304
35201,0.000794,172.31.36.0-255,66,52349,6,281304
35202,0.000801,172.217.194.0-255,4320,56669,6,281304
35203,0.000804,172.31.36.0-255,66,56735,6,281304
35204,0.000831,172.217.194.0-255,9992,66727,6,281304
35205,0.000834,172.31.36.0-255,66,66793,6,281304
35206,0.000846,172.217.194.0-255,4320,71113,6,281304
35207,0.000849,172.31.36.0-255,66,71179,6,281304
35208,0.000868,172.217.194.0-255,5738,76917,6,281304
35209,0.000871,172.31.36.0-255,66,76983,6,281304
35210,0.000887,172.217.194.0-255,5738,82721,6,281304
35211,0.00089,172.31.36.0-255,66,82787,6,281304
35212,0.000913,172.217.194.0-255,2184,84971,6,281304
35213,0.000916,172.31.36.0-255,66,85037,6,281304
35214,0.000945,172.217.194.0-255,1484,86521,6,281304
35215,0.00095,172.217.194.0-255,2902,89423,6,281304
35216,0.000955,172.31.36.0-255,66,89489,6,281304
35217,0.000974,172.217.194.0-255,5738,95227,6,281304
35218,0.000977,172.31.36.0-255,66,95293,6,281304
35219,0.000982,172.217.194.0-255,2902,98195,6,281304
35220,0.000984,172.31.36.0-255,66,98261,6,281304
35221,0.001017,172.217.194.0-255,9992,108253,6,281304
35222,0.001019,172.31.36.0-255,66,108319,6,281304
35223,0.001048,172.217.194.0-255,2902,111221,6,281304
35224,0.001051,172.31.36.0-255,66,111287,6,281304
35225,0.001073,172.217.194.0-255,7856,119143,6,281304
35226,0.001075,172.31.36.0-255,66,119209,6,281304
35227,0.00122,172.217.194.0-255,1484,120693,6,281304
35228,0.001233,172.217.194.0-255,2902,123595,6,281304
35229,0.001236,172.31.36.0-255,66,123661,6,281304
35230,0.001242,172.217.194.0-255,4320,127981,6,281304
35231,0.001244,172.31.36.0-255,66,128047,6,281304
35232,0.001257,172.217.194.0-255,1484,129531,6,281304
35233,0.001278,172.217.194.0-255,8574,138105,6,281304
35234,0.001281,172.31.36.0-255,66,138171,6,281304
35235,0.001301,172.217.194.0-255,4320,142491,6,281304
35236,0.001304,172.31.36.0-255,66,142557,6,281304
35237,0.001313,172.217.194.0-255,8574,151131,6,281304
35238,0.001315,172.31.36.0-255,66,151197,6,281304
35239,0.001331,172.217.194.0-255,2184,153381,6,281304
35240,0.001333,172.31.36.0-255,66,153447,6,281304
35241,0.001357,172.217.194.0-255,1484,154931,6,281304
35242,0.001362,172.217.194.0-255,2902,157833,6,281304
35243,0.001364,172.31.36.0-255,66,157899,6,281304
35244,0.001385,172.217.194.0-255,5738,163637,6,281304
35245,0.001387,172.31.36.0-255,66,163703,6,281304
35246,0.001395,172.217.194.0-255,7156,170859,6,281304
35247,0.001397,172.31.36.0-255,66,170925,6,281304
35248,0.001414,172.217.194.0-255,2902,173827,6,281304
35249,0.001416,172.31.36.0-255,66,173893,6,281304
35250,0.001449,172.217.194.0-255,1484,175377,6,281304
35251,0.001486,172.31.36.0-255,66,175443,6,281304
35252,0.002006,172.217.194.0-255,1484,176927,6,281304
35253,0.002012,172.217.194.0-255,2902,179829,6,281304
35254,0.002015,172.31.36.0-255,66,179895,6,281304
35255,0.002034,172.217.194.0-255,5738,185633,6,281304
35256,0.002037,172.31.36.0-255,66,185699,6,281304
35257,0.002093,172.31.36.0-255,66,185765,6,281304
35258,0.002101,172.217.194.0-255,8574,194339,6,281304
35259,0.002103,172.31.36.0-255,66,194405,6,281304
35260,0.002123,172.217.194.0-255,2184,196589,6,281304
35261,0.002125,172.31.36.0-255,66,196655,6,281304
35262,0.002151,172.217.194.0-255,1484,198139,6,281304
35263,0.002155,172.217.194.0-255,2902,201041,6,281304
35264,0.002158,172.31.36.0-255,66,201107,6,281304
35265,0.002165,172.217.194.0-255,5738,206845,6,281304
35266,0.002166,172.31.36.0-255,66,206911,6,281304
35267,0.002171,172.217.194.0-255,2902,209813,6,281304
35268,0.002172,172.31.36.0-255,66,209879,6,281304
35269,0.002194,172.217.194.0-255,1484,211363,6,281304
35270,0.002232,172.31.36.0-255,66,211429,6,281304
35271,0.002247,172.31.36.0-255,66,211495,6,281304
35272,0.002256,172.217.194.0-255,9992,221487,6,281304
35273,0.002259,172.31.36.0-255,66,221553,6,281304
35274,0.002276,172.217.194.0-255,5738,227291,6,281304
35275,0.002278,172.31.36.0-255,66,227357,6,281304
35276,0.002286,172.217.194.0-255,8574,235931,6,281304
35277,0.002289,172.31.36.0-255,66,235997,6,281304
35278,0.002306,172.217.194.0-255,2184,238181,6,281304
35279,0.002309,172.31.36.0-255,66,238247,6,281304
35280,0.002324,172.217.194.0-255,1484,239731,6,281304
35281,0.002339,172.217.194.0-255,7156,246887,6,281304
35282,0.002342,172.31.36.0-255,66,246953,6,281304
35283,0.002376,172.31.36.0-255,66,247019,6,281304
35284,0.002398,172.217.194.0-255,5738,252757,6,281304
35285,0.002401,172.31.36.0-255,66,252823,6,281304
35286,0.002408,172.217.194.0-255,6438,259261,6,281304
35287,0.00241,172.31.36.0-255,66,259327,6,281304
35288,0.002429,172.217.194.0-255,1484,260811,6,281304
35289,0.002449,172.217.194.0-255,4320,265131,6,281304
35290,0.002452,172.31.36.0-255,66,265197,6,281304
35291,0.002475,172.217.194.0-255,8574,273771,6,281304
35292,0.002478,172.31.36.0-255,66,273837,6,281304
35293,0.002512,172.31.36.0-255,66,273903,6,281304
35294,0.002524,172.31.36.0-255,66,273969,6,281304
35295,0.002554,172.217.194.0-255,2184,276153,6,281304
35296,0.002557,172.31.36.0-255,66,276219,6,281304
35297,0.002572,172.31.36.0-255,66,276285,6,281304
35298,0.002578,172.217.194.0-255,4719,281004,6,281304
35299,0.00258,172.31.36.0-255,66,281070,6,281304
35300,0.002584,172.217.194.0-255,105,281175,6,281304
35301,0.002644,172.217.194.0-255,129,281304,6,281304
35302,0.0,74.125.24.0-255,153,153,6,207360
35303,3.8e-05,172.31.36.0-255,66,219,6,207360
35304,4.6e-05,74.125.24.0-255,1484,1703,6,207360
35305,5e-05,172.31.36.0-255,66,1769,6,207360
35306,5.5e-05,74.125.24.0-255,2902,4671,6,207360
35307,5.7e-05,172.31.36.0-255,66,4737,6,207360
35308,6.4e-05,74.125.24.0-255,5738,10475,6,207360
35309,6.6e-05,172.31.36.0-255,66,10541,6,207360
35310,9.5e-05,74.125.24.0-255,10611,21152,6,207360
35311,9.8e-05,172.31.36.0-255,66,21218,6,207360
35312,0.000118,74.125.24.0-255,1484,22702,6,207360
35313,0.000121,172.31.36.0-255,66,22768,6,207360
35314,0.000146,74.125.24.0-255,8215,30983,6,207360
35315,0.000149,172.31.36.0-255,66,31049,6,207360
35316,0.000209,74.125.24.0-255,1484,32533,6,207360
35317,0.000215,172.31.36.0-255,66,32599,6,207360
35318,0.00022,74.125.24.0-255,2902,35501,6,207360
35319,0.000222,172.31.36.0-255,66,35567,6,207360
35320,0.000226,74.125.24.0-255,1484,37051,6,207360
35321,0.000228,172.31.36.0-255,66,37117,6,207360
35322,0.000256,74.125.24.0-255,4320,41437,6,207360
35323,0.000259,172.31.36.0-255,66,41503,6,207360
35324,0.000264,74.125.24.0-255,4320,45823,6,207360
35325,0.000266,172.31.36.0-255,66,45889,6,207360
35326,0.000285,74.125.24.0-255,8574,54463,6,207360
35327,0.000289,172.31.36.0-255,66,54529,6,207360
35328,0.000306,74.125.24.0-255,1125,55654,6,207360
35329,0.000308,172.31.36.0-255,66,55720,6,207360
35330,0.000317,74.125.24.0-255,9905,65625,6,207360
35331,0.000319,172.31.36.0-255,66,65691,6,207360
35332,0.000363,74.125.24.0-255,133,65824,6,207360
35333,0.000366,172.31.36.0-255,66,65890,6,207360
35334,0.000522,74.125.24.0-255,1484,67374,6,207360
35335,0.000528,74.125.24.0-255,2902,70276,6,207360
35336,0.000532,172.31.36.0-255,66,70342,6,207360
35337,0.000536,74.125.24.0-255,1484,71826,6,207360
35338,0.000555,74.125.24.0-255,4320,76146,6,207360
35339,0.000559,172.31.36.0-255,66,76212,6,207360
35340,0.000579,74.125.24.0-255,4320,80532,6,207360
35341,0.000584,172.31.36.0-255,66,80598,6,207360
35342,0.000592,74.125.24.0-255,4320,84918,6,207360
35343,0.000595,172.31.36.0-255,66,84984,6,207360
35344,0.000622,74.125.24.0-255,5379,90363,6,207360
35345,0.000625,172.31.36.0-255,66,90429,6,207360
35346,0.000634,74.125.24.0-255,9633,100062,6,207360
35347,0.000637,172.31.36.0-255,66,100128,6,207360
35348,0.000681,74.125.24.0-255,1484,101612,6,207360
35349,0.000686,74.125.24.0-255,2902,104514,6,207360
35350,0.000689,172.31.36.0-255,66,104580,6,207360
35351,0.000694,74.125.24.0-255,2902,107482,6,207360
35352,0.000696,172.31.36.0-255,66,107548,6,207360
35353,0.00071,74.125.24.0-255,2902,110450,6,207360
35354,0.000713,172.31.36.0-255,66,110516,6,207360
35355,0.000722,74.125.24.0-255,8574,119090,6,207360
35356,0.000724,172.31.36.0-255,66,119156,6,207360
35357,0.000745,74.125.24.0-255,4320,123476,6,207360
35358,0.000748,172.31.36.0-255,66,123542,6,207360
35359,0.000758,74.125.24.0-255,10692,134234,6,207360
35360,0.00076,172.31.36.0-255,66,134300,6,207360
35361,0.000945,74.125.24.0-255,1484,135784,6,207360
35362,0.000951,74.125.24.0-255,2902,138686,6,207360
35363,0.000954,172.31.36.0-255,66,138752,6,207360
35364,0.000959,74.125.24.0-255,2902,141654,6,207360
35365,0.000963,172.31.36.0-255,66,141720,6,207360
35366,0.000977,74.125.24.0-255,2902,144622,6,207360
35367,0.000981,172.31.36.0-255,66,144688,6,207360
35368,0.000982,74.125.24.0-255,4320,149008,6,207360
35369,0.000984,172.31.36.0-255,66,149074,6,207360
35370,0.001012,74.125.24.0-255,8574,157648,6,207360
35371,0.001015,172.31.36.0-255,66,157714,6,207360
35372,0.001024,74.125.24.0-255,9992,167706,6,207360
35373,0.001027,172.31.36.0-255,66,167772,6,207360
35374,0.001029,74.125.24.0-255,766,168538,6,207360
35375,0.001642,172.31.36.0-255,66,168604,6,207360
35376,0.00201,74.125.24.0-255,1484,170088,6,207360
35377,0.00202,74.125.24.0-255,2902,172990,6,207360
35378,0.002025,172.31.36.0-255,66,173056,6,207360
35379,0.002034,74.125.24.0-255,5738,178794,6,207360
35380,0.002036,172.31.36.0-255,66,178860,6,207360
35381,0.00204,74.125.24.0-255,2902,181762,6,207360
35382,0.002042,172.31.36.0-255,66,181828,6,207360
35383,0.002081,74.125.24.0-255,2902,184730,6,207360
35384,0.002084,172.31.36.0-255,66,184796,6,207360
35385,0.002097,172.31.36.0-255,66,184862,6,207360
35386,0.00214,74.125.24.0-255,5020,189882,6,207360
35387,0.002143,172.31.36.0-255,66,189948,6,207360
35388,0.004504,74.125.24.0-255,5738,195686,6,207360
35389,0.00451,172.31.36.0-255,66,195752,6,207360
35390,0.006808,74.125.24.0-255,5738,201490,6,207360
35391,0.006815,172.31.36.0-255,66,201556,6,207360
35392,0.009152,74.125.24.0-255,5738,207294,6,207360
35393,0.00916,172.31.36.0-255,66,207360,6,207360
35394,0.0,172.217.194.0-255,153,153,6,326742
35395,2e-05,172.31.36.0-255,66,219,6,326742
35396,2.8e-05,172.217.194.0-255,1484,1703,6,326742
35397,3.3e-05,172.31.36.0-255,66,1769,6,326742
35398,3.9e-05,172.217.194.0-255,2902,4671,6,326742
35399,4.2e-05,172.31.36.0-255,66,4737,6,326742
35400,5e-05,172.217.194.0-255,7156,11893,6,326742
35401,5.2e-05,172.31.36.0-255,66,11959,6,326742
35402,7.7e-05,172.217.194.0-255,2041,14000,6,326742
35403,8e-05,172.31.36.0-255,66,14066,6,326742
35404,8.5e-05,172.217.194.0-255,2902,16968,6,326742
35405,8.7e-05,172.31.36.0-255,66,17034,6,326742
35406,9.4e-05,172.217.194.0-255,4320,21354,6,326742
35407,9.6e-05,172.31.36.0-255,66,21420,6,326742
35408,0.000115,172.217.194.0-255,2902,24322,6,326742
35409,0.000117,172.31.36.0-255,66,24388,6,326742
35410,0.000125,172.217.194.0-255,6797,31185,6,326742
35411,0.000127,172.31.36.0-255,66,31251,6,326742
35412,0.000218,172.217.194.0-255,1484,32735,6,326742
35413,0.000221,172.31.36.0-255,66,32801,6,326742
35414,0.000226,172.217.194.0-255,2902,35703,6,326742
35415,0.000229,172.31.36.0-255,66,35769,6,326742
35416,0.000235,172.217.194.0-255,5738,41507,6,326742
35417,0.000237,172.31.36.0-255,66,41573,6,326742
35418,0.00027,172.217.194.0-255,8574,50147,6,326742
35419,0.000272,172.31.36.0-255,66,50213,6,326742
35420,0.000302,172.217.194.0-255,5379,55592,6,326742
35421,0.000305,172.31.36.0-255,66,55658,6,326742
35422,0.000315,172.217.194.0-255,9633,65291,6,326742
35423,0.000317,172.31.36.0-255,66,65357,6,326742
35424,0.000615,172.217.194.0-255,364,65721,6,326742
35425,0.000623,172.31.36.0-255,66,65787,6,326742
35426,0.000641,172.217.194.0-255,380,66167,6,326742
35427,0.00094,172.217.194.0-255,1484,67651,6,326742
35428,0.000945,172.31.36.0-255,66,67717,6,326742
35429,0.000959,172.217.194.0-255,2902,70619,6,326742
35430,0.000961,172.31.36.0-255,66,70685,6,326742
35431,0.000996,172.217.194.0-255,2902,73587,6,326742
35432,0.000999,172.31.36.0-255,66,73653,6,326742
35433,0.001018,172.217.194.0-255,2902,76555,6,326742
35434,0.00102,172.31.36.0-255,66,76621,6,326742
35435,0.001028,172.217.194.0-255,7156,83777,6,326742
35436,0.00103,172.31.36.0-255,66,83843,6,326742
35437,0.001053,172.217.194.0-255,5738,89581,6,326742
35438,0.001055,172.31.36.0-255,66,89647,6,326742
35439,0.001058,172.217.194.0-255,1484,91131,6,326742
35440,0.001078,172.217.194.0-255,9274,100405,6,326742
35441,0.00108,172.31.36.0-255,66,100471,6,326742
35442,0.001096,172.217.194.0-255,1484,101955,6,326742
35443,0.0011,172.217.194.0-255,2902,104857,6,326742
35444,0.001103,172.31.36.0-255,66,104923,6,326742
35445,0.001109,172.217.194.0-255,5738,110661,6,326742
35446,0.001111,172.31.36.0-255,66,110727,6,326742
35447,0.001118,172.217.194.0-255,5738,116465,6,326742
35448,0.001119,172.31.36.0-255,66,116531,6,326742
35449,0.001153,172.217.194.0-255,7156,123687,6,326742
35450,0.001156,172.31.36.0-255,66,123753,6,326742
35451,0.001167,172.217.194.0-255,10692,134445,6,326742
35452,0.001169,172.31.36.0-255,66,134511,6,326742
35453,0.001182,172.31.36.0-255,66,134577,6,326742
35454,0.001202,172.31.36.0-255,66,134643,6,326742
35455,0.001208,172.217.194.0-255,4320,138963,6,326742
35456,0.00121,172.31.36.0-255,66,139029,6,326742
35457,0.001216,172.217.194.0-255,5738,144767,6,326742
35458,0.001219,172.31.36.0-255,66,144833,6,326742
35459,0.001233,172.31.36.0-255,66,144899,6,326742
35460,0.001242,172.217.194.0-255,9992,154891,6,326742
35461,0.001244,172.31.36.0-255,66,154957,6,326742
35462,0.001281,172.217.194.0-255,1484,156441,6,326742
35463,0.001313,172.31.36.0-255,66,156507,6,326742
35464,0.001322,172.217.194.0-255,9992,166499,6,326742
35465,0.001324,172.31.36.0-255,66,166565,6,326742
35466,0.001341,172.217.194.0-255,6797,173362,6,326742
35467,0.001344,172.31.36.0-255,66,173428,6,326742
35468,0.001352,172.217.194.0-255,7156,180584,6,326742
35469,0.001354,172.31.36.0-255,66,180650,6,326742
35470,0.001378,172.217.194.0-255,9633,190283,6,326742
35471,0.001382,172.31.36.0-255,66,190349,6,326742
35472,0.001489,172.217.194.0-255,1484,191833,6,326742
35473,0.0015,172.217.194.0-255,2902,194735,6,326742
35474,0.001503,172.31.36.0-255,66,194801,6,326742
35475,0.00151,172.217.194.0-255,5738,200539,6,326742
35476,0.001513,172.31.36.0-255,66,200605,6,326742
35477,0.001553,172.217.194.0-255,6797,207402,6,326742
35478,0.001556,172.31.36.0-255,66,207468,6,326742
35479,0.001627,172.217.194.0-255,1484,208952,6,326742
35480,0.001633,172.217.194.0-255,2902,211854,6,326742
35481,0.001635,172.31.36.0-255,66,211920,6,326742
35482,0.001655,172.217.194.0-255,5738,217658,6,326742
35483,0.001659,172.31.36.0-255,66,217724,6,326742
35484,0.001678,172.217.194.0-255,4320,222044,6,326742
35485,0.001681,172.31.36.0-255,66,222110,6,326742
35486,0.001686,172.217.194.0-255,2902,225012,6,326742
35487,0.001687,172.31.36.0-255,66,225078,6,326742
35488,0.001715,172.217.194.0-255,8574,233652,6,326742
35489,0.001718,172.31.36.0-255,66,233718,6,326742
35490,0.00174,172.217.194.0-255,7856,241574,6,326742
35491,0.001743,172.31.36.0-255,66,241640,6,326742
35492,0.00194,172.217.194.0-255,1484,243124,6,326742
35493,0.001946,172.217.194.0-255,2902,246026,6,326742
35494,0.00195,172.31.36.0-255,66,246092,6,326742
35495,0.001953,172.217.194.0-255,1484,247576,6,326742
35496,0.001968,172.217.194.0-255,4320,251896,6,326742
35497,0.001971,172.31.36.0-255,66,251962,6,326742
35498,0.002012,172.217.194.0-255,6797,258759,6,326742
35499,0.002015,172.31.36.0-255,66,258825,6,326742
35500,0.002022,172.217.194.0-255,4320,263145,6,326742
35501,0.002024,172.31.36.0-255,66,263211,6,326742
35502,0.002038,172.217.194.0-255,2902,266113,6,326742
35503,0.002041,172.31.36.0-255,66,266179,6,326742
35504,0.002048,172.217.194.0-255,5738,271917,6,326742
35505,0.00205,172.31.36.0-255,66,271983,6,326742
35506,0.002083,172.217.194.0-255,9992,281975,6,326742
35507,0.002086,172.31.36.0-255,66,282041,6,326742
35508,0.002097,172.217.194.0-255,10692,292733,6,326742
35509,0.002099,172.31.36.0-255,66,292799,6,326742
35510,0.00214,172.217.194.0-255,1484,294283,6,326742
35511,0.002145,172.217.194.0-255,2902,297185,6,326742
35512,0.002147,172.31.36.0-255,66,297251,6,326742
35513,0.002153,172.217.194.0-255,4320,301571,6,326742
35514,0.002156,172.31.36.0-255,66,301637,6,326742
35515,0.002167,172.217.194.0-255,1484,303121,6,326742
35516,0.002175,172.217.194.0-255,7156,310277,6,326742
35517,0.002178,172.31.36.0-255,66,310343,6,326742
35518,0.002243,172.31.36.0-255,66,310409,6,326742
35519,0.002257,172.217.194.0-255,1484,311893,6,326742
35520,0.002266,172.217.194.0-255,9274,321167,6,326742
35521,0.002269,172.31.36.0-255,66,321233,6,326742
35522,0.002275,172.217.194.0-255,5101,326334,6,326742
35523,0.002277,172.31.36.0-255,66,326400,6,326742
35524,0.002312,172.217.194.0-255,105,326505,6,326742
35525,0.004345,172.31.36.0-255,66,326571,6,326742
35526,0.004384,172.31.36.0-255,105,326676,6,326742
35527,0.006896,172.217.194.0-255,66,326742,6,326742
35528,0.0,74.125.24.0-255,146,146,6,318209
35529,2.8e-05,172.31.36.0-255,66,212,6,318209
35530,3.5e-05,74.125.24.0-255,1484,1696,6,318209
35531,3.9e-05,172.31.36.0-255,66,1762,6,318209
35532,4.4e-05,74.125.24.0-255,2902,4664,6,318209
35533,4.7e-05,172.31.36.0-255,66,4730,6,318209
35534,7.5e-05,74.125.24.0-255,7156,11886,6,318209
35535,7.8e-05,172.31.36.0-255,66,11952,6,318209
35536,8.3e-05,74.125.24.0-255,4320,16272,6,318209
35537,8.5e-05,172.31.36.0-255,66,16338,6,318209
35538,0.0001,74.125.24.0-255,3490,19828,6,318209
35539,0.000103,172.31.36.0-255,66,19894,6,318209
35540,0.000132,172.31.36.0-255,66,19960,6,318209
35541,0.000173,74.125.24.0-255,7156,27116,6,318209
35542,0.000177,172.31.36.0-255,66,27182,6,318209
35543,0.000183,74.125.24.0-255,4320,31502,6,318209
35544,0.000186,172.31.36.0-255,66,31568,6,318209
35545,0.000204,74.125.24.0-255,4320,35888,6,318209
35546,0.000207,172.31.36.0-255,66,35954,6,318209
35547,0.000221,74.125.24.0-255,1125,37079,6,318209
35548,0.000223,172.31.36.0-255,66,37145,6,318209
35549,0.000267,74.125.24.0-255,1484,38629,6,318209
35550,0.00027,172.31.36.0-255,66,38695,6,318209
35551,0.000283,74.125.24.0-255,2902,41597,6,318209
35552,0.000286,172.31.36.0-255,66,41663,6,318209
35553,0.000292,74.125.24.0-255,4320,45983,6,318209
35554,0.000295,172.31.36.0-255,66,46049,6,318209
35555,0.00031,74.125.24.0-255,1484,47533,6,318209
35556,0.000313,172.31.36.0-255,66,47599,6,318209
35557,0.000319,74.125.24.0-255,4320,51919,6,318209
35558,0.000322,172.31.36.0-255,66,51985,6,318209
35559,0.000342,74.125.24.0-255,2843,54828,6,318209
35560,0.000344,172.31.36.0-255,66,54894,6,318209
35561,0.000393,74.125.24.0-255,126,55020,6,318209
35562,0.000397,172.31.36.0-255,66,55086,6,318209
35563,0.000524,74.125.24.0-255,348,55434,6,318209
35564,0.000528,172.31.36.0-255,66,55500,6,318209
35565,0.001668,74.125.24.0-255,1484,56984,6,318209
35566,0.001674,172.31.36.0-255,66,57050,6,318209
35567,0.001684,74.125.24.0-255,2902,59952,6,318209
35568,0.001686,172.31.36.0-255,66,60018,6,318209
35569,0.001692,74.125.24.0-255,5738,65756,6,318209
35570,0.001694,172.31.36.0-255,66,65822,6,318209
35571,0.001702,74.125.24.0-255,7156,72978,6,318209
35572,0.001704,172.31.36.0-255,66,73044,6,318209
35573,0.001767,172.31.36.0-255,66,73110,6,318209
35574,0.001771,74.125.24.0-255,2184,75294,6,318209
35575,0.001772,172.31.36.0-255,66,75360,6,318209
35576,0.001794,74.125.24.0-255,1484,76844,6,318209
35577,0.001796,172.31.36.0-255,66,76910,6,318209
35578,0.0018,74.125.24.0-255,2902,79812,6,318209
35579,0.001802,172.31.36.0-255,66,79878,6,318209
35580,0.001814,74.125.24.0-255,2902,82780,6,318209
35581,0.001816,172.31.36.0-255,66,82846,6,318209
35582,0.001831,74.125.24.0-255,2902,85748,6,318209
35583,0.001833,172.31.36.0-255,66,85814,6,318209
35584,0.001839,74.125.24.0-255,4320,90134,6,318209
35585,0.001841,172.31.36.0-255,66,90200,6,318209
35586,0.00187,74.125.24.0-255,8574,98774,6,318209
35587,0.001872,172.31.36.0-255,66,98840,6,318209
35588,0.001881,74.125.24.0-255,10692,109532,6,318209
35589,0.001883,172.31.36.0-255,66,109598,6,318209
35590,0.0019,74.125.24.0-255,1484,111082,6,318209
35591,0.001902,172.31.36.0-255,66,111148,6,318209
35592,0.001906,74.125.24.0-255,2902,114050,6,318209
35593,0.001908,172.31.36.0-255,66,114116,6,318209
35594,0.001932,74.125.24.0-255,5738,119854,6,318209
35595,0.001934,172.31.36.0-255,66,119920,6,318209
35596,0.001937,74.125.24.0-255,2902,122822,6,318209
35597,0.001939,172.31.36.0-255,66,122888,6,318209
35598,0.00196,74.125.24.0-255,9992,132880,6,318209
35599,0.001963,172.31.36.0-255,66,132946,6,318209
35600,0.00197,74.125.24.0-255,8574,141520,6,318209
35601,0.001972,172.31.36.0-255,66,141586,6,318209
35602,0.002008,74.125.24.0-255,2184,143770,6,318209
35603,0.00201,172.31.36.0-255,66,143836,6,318209
35604,0.002064,74.125.24.0-255,1484,145320,6,318209
35605,0.002066,172.31.36.0-255,66,145386,6,318209
35606,0.00207,74.125.24.0-255,1484,146870,6,318209
35607,0.002072,172.31.36.0-255,66,146936,6,318209
35608,0.002083,74.125.24.0-255,1484,148420,6,318209
35609,0.002085,172.31.36.0-255,66,148486,6,318209
35610,0.002092,74.125.24.0-255,5738,154224,6,318209
35611,0.002094,172.31.36.0-255,66,154290,6,318209
35612,0.002107,74.125.24.0-255,4320,158610,6,318209
35613,0.002109,172.31.36.0-255,66,158676,6,318209
35614,0.002125,74.125.24.0-255,4320,162996,6,318209
35615,0.002128,172.31.36.0-255,66,163062,6,318209
35616,0.002157,74.125.24.0-255,1484,164546,6,318209
35617,0.002159,172.31.36.0-255,66,164612,6,318209
35618,0.002189,172.31.36.0-255,66,164678,6,318209
35619,0.002553,74.125.24.0-255,1484,166162,6,318209
35620,0.002555,172.31.36.0-255,66,166228,6,318209
35621,0.002559,74.125.24.0-255,2902,169130,6,318209
35622,0.002562,172.31.36.0-255,66,169196,6,318209
35623,0.002568,74.125.24.0-255,5738,174934,6,318209
35624,0.00257,172.31.36.0-255,66,175000,6,318209
35625,0.002576,74.125.24.0-255,7156,182156,6,318209
35626,0.002579,172.31.36.0-255,66,182222,6,318209
35627,0.002585,74.125.24.0-255,7156,189378,6,318209
35628,0.002588,172.31.36.0-255,66,189444,6,318209
35629,0.002649,74.125.24.0-255,9274,198718,6,318209
35630,0.002652,172.31.36.0-255,66,198784,6,318209
35631,0.002655,74.125.24.0-255,1484,200268,6,318209
35632,0.002657,172.31.36.0-255,66,200334,6,318209
35633,0.002665,74.125.24.0-255,8574,208908,6,318209
35634,0.002668,172.31.36.0-255,66,208974,6,318209
35635,0.00275,74.125.24.0-255,4320,213294,6,318209
35636,0.002753,172.31.36.0-255,66,213360,6,318209
35637,0.002775,172.31.36.0-255,66,213426,6,318209
35638,0.002778,74.125.24.0-255,1484,214910,6,318209
35639,0.00278,172.31.36.0-255,66,214976,6,318209
35640,0.002784,74.125.24.0-255,2902,217878,6,318209
35641,0.002786,172.31.36.0-255,66,217944,6,318209
35642,0.002792,74.125.24.0-255,5738,223682,6,318209
35643,0.002795,172.31.36.0-255,66,223748,6,318209
35644,0.002801,74.125.24.0-255,4320,228068,6,318209
35645,0.002803,172.31.36.0-255,66,228134,6,318209
35646,0.002846,74.125.24.0-255,9992,238126,6,318209
35647,0.002848,172.31.36.0-255,66,238192,6,318209
35648,0.002867,74.125.24.0-255,1484,239676,6,318209
35649,0.002874,74.125.24.0-255,7856,247532,6,318209
35650,0.002876,172.31.36.0-255,66,247598,6,318209
35651,0.002879,74.125.24.0-255,1484,249082,6,318209
35652,0.002882,74.125.24.0-255,1484,250566,6,318209
35653,0.002884,172.31.36.0-255,66,250632,6,318209
35654,0.002913,74.125.24.0-255,1484,252116,6,318209
35655,0.002918,74.125.24.0-255,5738,257854,6,318209
35656,0.002921,172.31.36.0-255,66,257920,6,318209
35657,0.002928,74.125.24.0-255,7156,265076,6,318209
35658,0.00293,172.31.36.0-255,66,265142,6,318209
35659,0.002955,74.125.24.0-255,5738,270880,6,318209
35660,0.002964,74.125.24.0-255,10692,281572,6,318209
35661,0.003023,74.125.24.0-255,1484,283056,6,318209
35662,0.003026,74.125.24.0-255,1484,284540,6,318209
35663,0.003045,74.125.24.0-255,1484,286024,6,318209
35664,0.003049,74.125.24.0-255,1484,287508,6,318209
35665,0.003078,74.125.24.0-255,4320,291828,6,318209
35666,0.003092,74.125.24.0-255,2902,294730,6,318209
35667,0.003114,74.125.24.0-255,7856,302586,6,318209
35668,0.003121,74.125.24.0-255,7156,309742,6,318209
35669,0.003135,74.125.24.0-255,4320,314062,6,318209
35670,0.003138,74.125.24.0-255,1484,315546,6,318209
35671,0.003187,74.125.24.0-255,2321,317867,6,318209
35672,0.003216,74.125.24.0-255,105,317972,6,318209
35673,0.004097,172.31.36.0-255,66,318038,6,318209
35674,0.006637,172.31.36.0-255,105,318143,6,318209
35675,0.008925,74.125.24.0-255,66,318209,6,318209
35676,0.0,74.125.24.0-255,150,150,6,276432
35677,3.3e-05,172.31.36.0-255,66,216,6,276432
35678,3.9e-05,74.125.24.0-255,1484,1700,6,276432
35679,4.4e-05,172.31.36.0-255,66,1766,6,276432
35680,4.9e-05,74.125.24.0-255,2902,4668,6,276432
35681,6.2e-05,172.31.36.0-255,66,4734,6,276432
35682,6.9e-05,74.125.24.0-255,7156,11890,6,276432
35683,7.3e-05,172.31.36.0-255,66,11956,6,276432
35684,9.3e-05,74.125.24.0-255,7156,19112,6,276432
35685,9.5e-05,172.31.36.0-255,66,19178,6,276432
35686,0.000132,74.125.24.0-255,7748,26926,6,276432
35687,0.000136,172.31.36.0-255,66,26992,6,276432
35688,0.000141,74.125.24.0-255,3961,30953,6,276432
35689,0.000145,172.31.36.0-255,66,31019,6,276432
35690,0.000214,74.125.24.0-255,1484,32503,6,276432
35691,0.000219,172.31.36.0-255,66,32569,6,276432
35692,0.000223,74.125.24.0-255,1484,34053,6,276432
35693,0.000224,172.31.36.0-255,66,34119,6,276432
35694,0.000249,74.125.24.0-255,1484,35603,6,276432
35695,0.000252,172.31.36.0-255,66,35669,6,276432
35696,0.000262,74.125.24.0-255,5738,41407,6,276432
35697,0.000265,172.31.36.0-255,66,41473,6,276432
35698,0.000269,74.125.24.0-255,2902,44375,6,276432
35699,0.000271,172.31.36.0-255,66,44441,6,276432
35700,0.000317,74.125.24.0-255,9992,54433,6,276432
35701,0.000321,172.31.36.0-255,66,54499,6,276432
35702,0.000339,74.125.24.0-255,10692,65191,6,276432
35703,0.000342,172.31.36.0-255,66,65257,6,276432
35704,0.000369,74.125.24.0-255,363,65620,6,276432
35705,0.000371,172.31.36.0-255,66,65686,6,276432
35706,0.000413,74.125.24.0-255,126,65812,6,276432
35707,0.000417,172.31.36.0-255,66,65878,6,276432
35708,0.000539,74.125.24.0-255,1484,67362,6,276432
35709,0.000546,74.125.24.0-255,2902,70264,6,276432
35710,0.000548,74.125.24.0-255,1484,71748,6,276432
35711,0.00056,172.31.36.0-255,66,71814,6,276432
35712,0.000568,74.125.24.0-255,4320,76134,6,276432
35713,0.00058,172.31.36.0-255,66,76200,6,276432
35714,0.000611,172.31.36.0-255,66,76266,6,276432
35715,0.000644,74.125.24.0-255,10692,86958,6,276432
35716,0.000652,172.31.36.0-255,66,87024,6,276432
35717,0.000676,74.125.24.0-255,2902,89926,6,276432
35718,0.00068,172.31.36.0-255,66,89992,6,276432
35719,0.000703,74.125.24.0-255,8574,98566,6,276432
35720,0.000709,172.31.36.0-255,66,98632,6,276432
35721,0.00071,74.125.24.0-255,4320,102952,6,276432
35722,0.000712,74.125.24.0-255,1484,104436,6,276432
35723,0.000713,172.31.36.0-255,66,104502,6,276432
35724,0.000775,74.125.24.0-255,9274,113776,6,276432
35725,0.000775,172.31.36.0-255,66,113842,6,276432
35726,0.000781,172.31.36.0-255,66,113908,6,276432
35727,0.000783,74.125.24.0-255,9992,123900,6,276432
35728,0.000795,172.31.36.0-255,66,123966,6,276432
35729,0.000847,172.31.36.0-255,66,124032,6,276432
35730,0.000896,74.125.24.0-255,1484,125516,6,276432
35731,0.000901,74.125.24.0-255,2902,128418,6,276432
35732,0.00091,172.31.36.0-255,66,128484,6,276432
35733,0.000929,74.125.24.0-255,5738,134222,6,276432
35734,0.000938,172.31.36.0-255,66,134288,6,276432
35735,0.000989,172.31.36.0-255,66,134354,6,276432
35736,0.001023,74.125.24.0-255,10692,145046,6,276432
35737,0.001039,172.31.36.0-255,66,145112,6,276432
35738,0.0011,74.125.24.0-255,1484,146596,6,276432
35739,0.001105,74.125.24.0-255,2902,149498,6,276432
35740,0.001108,74.125.24.0-255,1484,150982,6,276432
35741,0.001115,172.31.36.0-255,66,151048,6,276432
35742,0.001125,74.125.24.0-255,4320,155368,6,276432
35743,0.001128,74.125.24.0-255,1484,156852,6,276432
35744,0.001128,172.31.36.0-255,66,156918,6,276432
35745,0.001164,172.31.36.0-255,66,156984,6,276432
35746,0.001191,74.125.24.0-255,5738,162722,6,276432
35747,0.0012,172.31.36.0-255,66,162788,6,276432
35748,0.001211,74.125.24.0-255,5020,167808,6,276432
35749,0.001233,172.31.36.0-255,66,167874,6,276432
35750,0.00124,74.125.24.0-255,5738,173612,6,276432
35751,0.001247,172.31.36.0-255,66,173678,6,276432
35752,0.001269,74.125.24.0-255,5738,179416,6,276432
35753,0.001274,172.31.36.0-255,66,179482,6,276432
35754,0.001301,74.125.24.0-255,4320,183802,6,276432
35755,0.001303,172.31.36.0-255,66,183868,6,276432
35756,0.001307,172.31.36.0-255,66,183934,6,276432
35757,0.001345,74.125.24.0-255,5020,188954,6,276432
35758,0.001352,172.31.36.0-255,66,189020,6,276432
35759,0.001354,74.125.24.0-255,7156,196176,6,276432
35760,0.001364,172.31.36.0-255,66,196242,6,276432
35761,0.001392,74.125.24.0-255,2902,199144,6,276432
35762,0.001393,172.31.36.0-255,66,199210,6,276432
35763,0.001398,172.31.36.0-255,66,199276,6,276432
35764,0.001425,74.125.24.0-255,6438,205714,6,276432
35765,0.001441,74.125.24.0-255,8574,214288,6,276432
35766,0.001446,172.31.36.0-255,66,214354,6,276432
35767,0.001479,74.125.24.0-255,1484,215838,6,276432
35768,0.001485,74.125.24.0-255,5738,221576,6,276432
35769,0.001496,172.31.36.0-255,66,221642,6,276432
35770,0.0015,172.31.36.0-255,66,221708,6,276432
35771,0.001539,74.125.24.0-255,5738,227446,6,276432
35772,0.001544,74.125.24.0-255,766,228212,6,276432
35773,0.001546,74.125.24.0-255,1484,229696,6,276432
35774,0.001548,172.31.36.0-255,66,229762,6,276432
35775,0.00155,74.125.24.0-255,2902,232664,6,276432
35776,0.001556,74.125.24.0-255,5738,238402,6,276432
35777,0.001555,172.31.36.0-255,66,238468,6,276432
35778,0.001574,172.31.36.0-255,66,238534,6,276432
35779,0.001604,172.31.36.0-255,66,238600,6,276432
35780,0.001606,74.125.24.0-255,10692,249292,6,276432
35781,0.001609,172.31.36.0-255,66,249358,6,276432
35782,0.001653,74.125.24.0-255,4320,253678,6,276432
35783,0.001659,74.125.24.0-255,5738,259416,6,276432
35784,0.001668,172.31.36.0-255,66,259482,6,276432
35785,0.001726,74.125.24.0-255,8574,268056,6,276432
35786,0.001738,172.31.36.0-255,66,268122,6,276432
35787,0.001746,74.125.24.0-255,2902,271024,6,276432
35788,0.001753,172.31.36.0-255,66,271090,6,276432
35789,0.001757,74.125.24.0-255,5171,276261,6,276432
35790,0.001761,74.125.24.0-255,105,276366,6,276432
35791,0.001778,172.31.36.0-255,66,276432,6,276432
