,TIME,SRC,PACKET_SIZE,CUMULATIVE_PACKET_SIZE,PAGE_NUMBER,TOTAL_PACKET_SIZE
0,0.0,74.125.130.0-255,143,143,7,384177
1,3.6e-05,172.31.36.0-255,66,209,7,384177
2,4.3e-05,74.125.130.0-255,1484,1693,7,384177
3,4.7e-05,172.31.36.0-255,66,1759,7,384177
4,5.2e-05,74.125.130.0-255,2902,4661,7,384177
5,6.3e-05,172.31.36.0-255,66,4727,7,384177
6,6.8e-05,74.125.130.0-255,4320,9047,7,384177
7,7e-05,172.31.36.0-255,66,9113,7,384177
8,0.00011,172.31.36.0-255,66,9179,7,384177
9,0.000117,74.125.130.0-255,5738,14917,7,384177
10,0.000119,172.31.36.0-255,66,14983,7,384177
11,0.000152,74.125.130.0-255,4320,19303,7,384177
12,0.000156,172.31.36.0-255,66,19369,7,384177
13,0.00016,74.125.130.0-255,2543,21912,7,384177
14,0.000161,172.31.36.0-255,66,21978,7,384177
15,0.00021,74.125.130.0-255,1484,23462,7,384177
16,0.000213,172.31.36.0-255,66,23528,7,384177
17,0.000219,74.125.130.0-255,2902,26430,7,384177
18,0.000222,172.31.36.0-255,66,26496,7,384177
19,0.000245,74.125.130.0-255,5738,32234,7,384177
20,0.000248,172.31.36.0-255,66,32300,7,384177
21,0.000286,74.125.130.0-255,6797,39097,7,384177
22,0.000288,172.31.36.0-255,66,39163,7,384177
23,0.000584,74.125.130.0-255,1484,40647,7,384177
24,0.000588,172.31.36.0-255,66,40713,7,384177
25,0.000592,74.125.130.0-255,1484,42197,7,384177
26,0.000594,172.31.36.0-255,66,42263,7,384177
27,0.000599,74.125.130.0-255,2902,45165,7,384177
28,0.000601,172.31.36.0-255,66,45231,7,384177
29,0.000636,74.125.130.0-255,5738,50969,7,384177
30,0.00064,172.31.36.0-255,66,51035,7,384177
31,0.00067,74.125.130.0-255,4320,55355,7,384177
32,0.000673,172.31.36.0-255,66,55421,7,384177
33,0.000702,74.125.130.0-255,1125,56546,7,384177
34,0.000815,172.31.36.0-255,66,56612,7,384177
35,0.000887,74.125.130.0-255,1484,58096,7,384177
36,0.00092,74.125.130.0-255,2902,60998,7,384177
37,0.000924,172.31.36.0-255,66,61064,7,384177
38,0.000928,74.125.130.0-255,1484,62548,7,384177
39,0.000954,74.125.130.0-255,4320,66868,7,384177
40,0.000956,172.31.36.0-255,66,66934,7,384177
41,0.000961,74.125.130.0-255,2902,69836,7,384177
42,0.000962,172.31.36.0-255,66,69902,7,384177
43,0.000967,74.125.130.0-255,3961,73863,7,384177
44,0.000969,172.31.36.0-255,66,73929,7,384177
45,0.001001,74.125.130.0-255,5738,79667,7,384177
46,0.001005,172.31.36.0-255,66,79733,7,384177
47,0.001034,74.125.130.0-255,2902,82635,7,384177
48,0.001037,172.31.36.0-255,66,82701,7,384177
49,0.00104,74.125.130.0-255,1484,84185,7,384177
50,0.001052,172.31.36.0-255,66,84251,7,384177
51,0.00108,74.125.130.0-255,1484,85735,7,384177
52,0.001093,172.31.36.0-255,66,85801,7,384177
53,0.001097,74.125.130.0-255,2069,87870,7,384177
54,0.0011,172.31.36.0-255,66,87936,7,384177
55,0.001134,74.125.130.0-255,198,88134,7,384177
56,0.001235,74.125.130.0-255,1484,89618,7,384177
57,0.00124,172.31.36.0-255,66,89684,7,384177
58,0.001246,74.125.130.0-255,2902,92586,7,384177
59,0.001249,172.31.36.0-255,66,92652,7,384177
60,0.001317,74.125.130.0-255,4320,96972,7,384177
61,0.001322,172.31.36.0-255,66,97038,7,384177
62,0.001333,172.31.36.0-255,66,97104,7,384177
63,0.001338,74.125.130.0-255,5738,102842,7,384177
64,0.00134,172.31.36.0-255,66,102908,7,384177
65,0.001347,74.125.130.0-255,7156,110064,7,384177
66,0.001349,172.31.36.0-255,66,110130,7,384177
67,0.001383,74.125.130.0-255,3602,113732,7,384177
68,0.001386,172.31.36.0-255,66,113798,7,384177
69,0.00141,74.125.130.0-255,1484,115282,7,384177
70,0.001426,74.125.130.0-255,2902,118184,7,384177
71,0.00143,172.31.36.0-255,66,118250,7,384177
72,0.001435,74.125.130.0-255,2902,121152,7,384177
73,0.001437,172.31.36.0-255,66,121218,7,384177
74,0.001459,74.125.130.0-255,2902,124120,7,384177
75,0.001463,172.31.36.0-255,66,124186,7,384177
76,0.001474,74.125.130.0-255,4320,128506,7,384177
77,0.001476,172.31.36.0-255,66,128572,7,384177
78,0.001502,74.125.130.0-255,1484,130056,7,384177
79,0.00151,74.125.130.0-255,7156,137212,7,384177
80,0.001512,172.31.36.0-255,66,137278,7,384177
81,0.001519,74.125.130.0-255,5738,143016,7,384177
82,0.001521,172.31.36.0-255,66,143082,7,384177
83,0.001556,74.125.130.0-255,5020,148102,7,384177
84,0.001559,172.31.36.0-255,66,148168,7,384177
85,0.001821,74.125.130.0-255,1484,149652,7,384177
86,0.001837,74.125.130.0-255,1484,151136,7,384177
87,0.001839,172.31.36.0-255,66,151202,7,384177
88,0.001864,74.125.130.0-255,1484,152686,7,384177
89,0.00187,74.125.130.0-255,5738,158424,7,384177
90,0.001873,172.31.36.0-255,66,158490,7,384177
91,0.001877,74.125.130.0-255,2902,161392,7,384177
92,0.001879,172.31.36.0-255,66,161458,7,384177
93,0.001883,74.125.130.0-255,1484,162942,7,384177
94,0.001916,172.31.36.0-255,66,163008,7,384177
95,0.001921,74.125.130.0-255,4320,167328,7,384177
96,0.001923,172.31.36.0-255,66,167394,7,384177
97,0.001951,74.125.130.0-255,6438,173832,7,384177
98,0.001959,172.31.36.0-255,66,173898,7,384177
99,0.004067,74.125.130.0-255,5738,179636,7,384177
100,0.004073,172.31.36.0-255,66,179702,7,384177
101,0.006197,74.125.130.0-255,1484,181186,7,384177
102,0.006228,74.125.130.0-255,4320,185506,7,384177
103,0.006233,172.31.36.0-255,66,185572,7,384177
104,0.008391,74.125.130.0-255,5738,191310,7,384177
105,0.008398,172.31.36.0-255,66,191376,7,384177
106,0.010514,74.125.130.0-255,5738,197114,7,384177
107,0.010521,172.31.36.0-255,66,197180,7,384177
108,0.012639,74.125.130.0-255,5738,202918,7,384177
109,0.012647,172.31.36.0-255,66,202984,7,384177
110,0.014765,74.125.130.0-255,5738,208722,7,384177
111,0.014772,172.31.36.0-255,66,208788,7,384177
112,0.016894,74.125.130.0-255,5738,214526,7,384177
113,0.0169,172.31.36.0-255,66,214592,7,384177
114,0.019013,74.125.130.0-255,5738,220330,7,384177
115,0.01902,172.31.36.0-255,66,220396,7,384177
116,0.021156,74.125.130.0-255,5738,226134,7,384177
117,0.021173,172.31.36.0-255,66,226200,7,384177
118,0.023293,74.125.130.0-255,5738,231938,7,384177
119,0.023302,172.31.36.0-255,66,232004,7,384177
120,0.02543,74.125.130.0-255,5738,237742,7,384177
121,0.025438,172.31.36.0-255,66,237808,7,384177
122,0.027555,74.125.130.0-255,5738,243546,7,384177
123,0.027563,172.31.36.0-255,66,243612,7,384177
124,0.029717,74.125.130.0-255,4320,247932,7,384177
125,0.029726,172.31.36.0-255,66,247998,7,384177
126,0.029765,74.125.130.0-255,1484,249482,7,384177
127,0.031843,74.125.130.0-255,4320,253802,7,384177
128,0.031851,172.31.36.0-255,66,253868,7,384177
129,0.033102,172.31.36.0-255,164,254032,7,384177
130,0.03313,172.31.36.0-255,1124,255156,7,384177
131,0.033189,172.31.36.0-255,1514,256670,7,384177
132,0.033208,172.31.36.0-255,1514,258184,7,384177
133,0.033209,172.31.36.0-255,1514,259698,7,384177
134,0.03323,172.31.36.0-255,1514,261212,7,384177
135,0.033234,172.31.36.0-255,1509,262721,7,384177
136,0.033967,74.125.130.0-255,5738,268459,7,384177
137,0.033972,172.31.36.0-255,66,268525,7,384177
138,0.034667,104.244.42.0-255,66,268591,7,384177
139,0.034673,104.244.42.0-255,66,268657,7,384177
140,0.0348,104.244.42.0-255,66,268723,7,384177
141,0.034802,104.244.42.0-255,66,268789,7,384177
142,0.036112,74.125.130.0-255,4320,273109,7,384177
143,0.036115,172.31.36.0-255,66,273175,7,384177
144,0.036154,74.125.130.0-255,1484,274659,7,384177
145,0.03823,74.125.130.0-255,4320,278979,7,384177
146,0.038235,172.31.36.0-255,66,279045,7,384177
147,0.040368,74.125.130.0-255,4320,283365,7,384177
148,0.040373,172.31.36.0-255,66,283431,7,384177
149,0.040402,74.125.130.0-255,1484,284915,7,384177
150,0.042508,74.125.130.0-255,2902,287817,7,384177
151,0.042514,172.31.36.0-255,66,287883,7,384177
152,0.042549,74.125.130.0-255,1484,289367,7,384177
153,0.044618,74.125.130.0-255,4320,293687,7,384177
154,0.044624,172.31.36.0-255,66,293753,7,384177
155,0.046733,74.125.130.0-255,5738,299491,7,384177
156,0.04674,172.31.36.0-255,66,299557,7,384177
157,0.048861,74.125.130.0-255,5738,305295,7,384177
158,0.048866,172.31.36.0-255,66,305361,7,384177
159,0.050978,74.125.130.0-255,5738,311099,7,384177
160,0.050983,172.31.36.0-255,66,311165,7,384177
161,0.053091,74.125.130.0-255,5738,316903,7,384177
162,0.053097,172.31.36.0-255,66,316969,7,384177
163,0.055202,74.125.130.0-255,4320,321289,7,384177
164,0.055207,172.31.36.0-255,66,321355,7,384177
165,0.055242,74.125.130.0-255,1484,322839,7,384177
166,0.057325,74.125.130.0-255,4320,327159,7,384177
167,0.057331,172.31.36.0-255,66,327225,7,384177
168,0.059442,74.125.130.0-255,5738,332963,7,384177
169,0.059448,172.31.36.0-255,66,333029,7,384177
170,0.061556,74.125.130.0-255,5738,338767,7,384177
171,0.061562,172.31.36.0-255,66,338833,7,384177
172,0.063683,74.125.130.0-255,5738,344571,7,384177
173,0.063689,172.31.36.0-255,66,344637,7,384177
174,0.065798,74.125.130.0-255,5738,350375,7,384177
175,0.065803,172.31.36.0-255,66,350441,7,384177
176,0.067909,74.125.130.0-255,1484,351925,7,384177
177,0.067943,74.125.130.0-255,4320,356245,7,384177
178,0.067948,172.31.36.0-255,66,356311,7,384177
179,0.070067,74.125.130.0-255,5738,362049,7,384177
180,0.070074,172.31.36.0-255,66,362115,7,384177
181,0.072188,74.125.130.0-255,5738,367853,7,384177
182,0.072194,172.31.36.0-255,66,367919,7,384177
183,0.074292,74.125.130.0-255,2902,370821,7,384177
184,0.074296,172.31.36.0-255,66,370887,7,384177
185,0.074329,74.125.130.0-255,2902,373789,7,384177
186,0.074332,172.31.36.0-255,66,373855,7,384177
187,0.076403,74.125.130.0-255,1484,375339,7,384177
188,0.076445,74.125.130.0-255,2902,378241,7,384177
189,0.07645,172.31.36.0-255,66,378307,7,384177
190,0.076477,74.125.130.0-255,1484,379791,7,384177
191,0.078556,74.125.130.0-255,4320,384111,7,384177
192,0.078561,172.31.36.0-255,66,384177,7,384177
193,0.0,74.125.24.0-255,218,218,7,343968
194,2e-05,172.31.36.0-255,66,284,7,343968
195,2.8e-05,74.125.24.0-255,1484,1768,7,343968
196,3.4e-05,172.31.36.0-255,66,1834,7,343968
197,4.1e-05,74.125.24.0-255,4320,6154,7,343968
198,4.5e-05,172.31.36.0-255,66,6220,7,343968
199,7.6e-05,172.31.36.0-255,66,6286,7,343968
200,9.5e-05,74.125.24.0-255,1484,7770,7,343968
201,9.7e-05,172.31.36.0-255,66,7836,7,343968
202,0.000125,74.125.24.0-255,7156,14992,7,343968
203,0.000128,172.31.36.0-255,66,15058,7,343968
204,0.000147,74.125.24.0-255,5738,20796,7,343968
205,0.00015,172.31.36.0-255,66,20862,7,343968
206,0.000165,74.125.24.0-255,2543,23405,7,343968
207,0.000168,172.31.36.0-255,66,23471,7,343968
208,0.000259,74.125.24.0-255,1484,24955,7,343968
209,0.000262,172.31.36.0-255,66,25021,7,343968
210,0.000284,74.125.24.0-255,2902,27923,7,343968
211,0.000287,172.31.36.0-255,66,27989,7,343968
212,0.000293,74.125.24.0-255,5738,33727,7,343968
213,0.000296,172.31.36.0-255,66,33793,7,343968
214,0.000324,172.31.36.0-255,66,33859,7,343968
215,0.000344,74.125.24.0-255,5379,39238,7,343968
216,0.000347,172.31.36.0-255,66,39304,7,343968
217,0.000365,74.125.24.0-255,7156,46460,7,343968
218,0.000367,172.31.36.0-255,66,46526,7,343968
219,0.000391,74.125.24.0-255,2889,49415,7,343968
220,0.000393,172.31.36.0-255,66,49481,7,343968
221,0.000396,74.125.24.0-255,331,49812,7,343968
222,0.000398,172.31.36.0-255,66,49878,7,343968
223,0.000734,74.125.24.0-255,1484,51362,7,343968
224,0.000742,74.125.24.0-255,2902,54264,7,343968
225,0.000746,172.31.36.0-255,66,54330,7,343968
226,0.000753,74.125.24.0-255,5738,60068,7,343968
227,0.000768,74.125.24.0-255,4320,64388,7,343968
228,0.000775,172.31.36.0-255,66,64454,7,343968
229,0.0008,74.125.24.0-255,7156,71610,7,343968
230,0.000809,172.31.36.0-255,66,71676,7,343968
231,0.00082,74.125.24.0-255,4320,75996,7,343968
232,0.00084,172.31.36.0-255,66,76062,7,343968
233,0.001077,74.125.24.0-255,1484,77546,7,343968
234,0.001085,74.125.24.0-255,2902,80448,7,343968
235,0.001089,172.31.36.0-255,66,80514,7,343968
236,0.001096,74.125.24.0-255,5738,86252,7,343968
237,0.001109,74.125.24.0-255,1484,87736,7,343968
238,0.001124,172.31.36.0-255,66,87802,7,343968
239,0.001154,74.125.24.0-255,7156,94958,7,343968
240,0.001168,172.31.36.0-255,66,95024,7,343968
241,0.001184,74.125.24.0-255,3602,98626,7,343968
242,0.001202,172.31.36.0-255,66,98692,7,343968
243,0.001276,74.125.24.0-255,1484,100176,7,343968
244,0.001282,74.125.24.0-255,2902,103078,7,343968
245,0.001285,172.31.36.0-255,66,103144,7,343968
246,0.001289,74.125.24.0-255,1484,104628,7,343968
247,0.001308,74.125.24.0-255,4320,108948,7,343968
248,0.001312,172.31.36.0-255,66,109014,7,343968
249,0.001358,74.125.24.0-255,766,109780,7,343968
250,0.00138,172.31.36.0-255,66,109846,7,343968
251,0.001406,74.125.24.0-255,1484,111330,7,343968
252,0.001421,74.125.24.0-255,4320,115650,7,343968
253,0.001427,74.125.24.0-255,4320,119970,7,343968
254,0.001456,74.125.24.0-255,7156,127126,7,343968
255,0.001471,74.125.24.0-255,5738,132864,7,343968
256,0.001483,172.31.36.0-255,66,132930,7,343968
257,0.00188,74.125.24.0-255,1484,134414,7,343968
258,0.001887,74.125.24.0-255,2902,137316,7,343968
259,0.001893,74.125.24.0-255,5738,143054,7,343968
260,0.00191,74.125.24.0-255,2902,145956,7,343968
261,0.001964,74.125.24.0-255,4320,150276,7,343968
262,0.001982,74.125.24.0-255,6438,156714,7,343968
263,0.002026,74.125.24.0-255,1484,158198,7,343968
264,0.002039,74.125.24.0-255,2902,161100,7,343968
265,0.002044,74.125.24.0-255,4320,165420,7,343968
266,0.00206,74.125.24.0-255,1484,166904,7,343968
267,0.006308,172.31.36.0-255,66,166970,7,343968
268,0.008341,74.125.24.0-255,5738,172708,7,343968
269,0.008347,172.31.36.0-255,66,172774,7,343968
270,0.010385,74.125.24.0-255,5738,178512,7,343968
271,0.010392,172.31.36.0-255,66,178578,7,343968
272,0.012426,74.125.24.0-255,5738,184316,7,343968
273,0.012435,172.31.36.0-255,66,184382,7,343968
274,0.014485,74.125.24.0-255,5738,190120,7,343968
275,0.017603,172.31.36.0-255,66,190186,7,343968
276,0.019626,74.125.24.0-255,5738,195924,7,343968
277,0.019638,172.31.36.0-255,66,195990,7,343968
278,0.021711,74.125.24.0-255,5738,201728,7,343968
279,0.021719,172.31.36.0-255,66,201794,7,343968
280,0.023757,74.125.24.0-255,5738,207532,7,343968
281,0.023766,172.31.36.0-255,66,207598,7,343968
282,0.025787,74.125.24.0-255,5738,213336,7,343968
283,0.025794,172.31.36.0-255,66,213402,7,343968
284,0.025885,172.31.36.0-255,101,213503,7,343968
285,0.027846,74.125.24.0-255,5738,219241,7,343968
286,0.027853,172.31.36.0-255,66,219307,7,343968
287,0.027887,74.125.24.0-255,66,219373,7,343968
288,0.029896,74.125.24.0-255,5738,225111,7,343968
289,0.029903,172.31.36.0-255,66,225177,7,343968
290,0.031946,74.125.24.0-255,5738,230915,7,343968
291,0.031954,172.31.36.0-255,66,230981,7,343968
292,0.032094,172.31.36.0-255,176,231157,7,343968
293,0.032122,172.31.36.0-255,1115,232272,7,343968
294,0.03224,172.31.36.0-255,1514,233786,7,343968
295,0.032242,172.31.36.0-255,1293,235079,7,343968
296,0.033575,104.244.42.0-255,66,235145,7,343968
297,0.03361,104.244.42.0-255,66,235211,7,343968
298,0.033735,104.244.42.0-255,66,235277,7,343968
299,0.034002,74.125.24.0-255,5738,241015,7,343968
300,0.034007,172.31.36.0-255,66,241081,7,343968
301,0.036069,74.125.24.0-255,5738,246819,7,343968
302,0.036076,172.31.36.0-255,66,246885,7,343968
303,0.038137,74.125.24.0-255,5738,252623,7,343968
304,0.038143,172.31.36.0-255,66,252689,7,343968
305,0.040239,74.125.24.0-255,5738,258427,7,343968
306,0.040246,172.31.36.0-255,66,258493,7,343968
307,0.042282,74.125.24.0-255,5738,264231,7,343968
308,0.042297,172.31.36.0-255,66,264297,7,343968
309,0.044343,74.125.24.0-255,5738,270035,7,343968
310,0.044356,172.31.36.0-255,66,270101,7,343968
311,0.046401,74.125.24.0-255,5738,275839,7,343968
312,0.046414,172.31.36.0-255,66,275905,7,343968
313,0.048471,74.125.24.0-255,5738,281643,7,343968
314,0.048487,172.31.36.0-255,66,281709,7,343968
315,0.050551,74.125.24.0-255,5738,287447,7,343968
316,0.050563,172.31.36.0-255,66,287513,7,343968
317,0.052629,74.125.24.0-255,5738,293251,7,343968
318,0.052641,172.31.36.0-255,66,293317,7,343968
319,0.054683,74.125.24.0-255,5738,299055,7,343968
320,0.054697,172.31.36.0-255,66,299121,7,343968
321,0.05675,74.125.24.0-255,5738,304859,7,343968
322,0.056757,172.31.36.0-255,66,304925,7,343968
323,0.058795,74.125.24.0-255,5738,310663,7,343968
324,0.058801,172.31.36.0-255,66,310729,7,343968
325,0.060887,74.125.24.0-255,5738,316467,7,343968
326,0.060895,172.31.36.0-255,66,316533,7,343968
327,0.062926,74.125.24.0-255,5738,322271,7,343968
328,0.062933,172.31.36.0-255,66,322337,7,343968
329,0.064959,74.125.24.0-255,5738,328075,7,343968
330,0.064966,172.31.36.0-255,66,328141,7,343968
331,0.066999,74.125.24.0-255,5738,333879,7,343968
332,0.067005,172.31.36.0-255,66,333945,7,343968
333,0.069053,74.125.24.0-255,5738,339683,7,343968
334,0.06906,172.31.36.0-255,66,339749,7,343968
335,0.071144,74.125.24.0-255,3982,343731,7,343968
336,0.07115,172.31.36.0-255,66,343797,7,343968
337,0.071323,172.31.36.0-255,105,343902,7,343968
338,0.078917,74.125.24.0-255,66,343968,7,343968
339,0.0,74.125.68.0-255,153,153,7,410825
340,2.2e-05,172.31.36.0-255,66,219,7,410825
341,3e-05,74.125.68.0-255,1484,1703,7,410825
342,3.4e-05,172.31.36.0-255,66,1769,7,410825
343,3.8e-05,74.125.68.0-255,1484,3253,7,410825
344,4.1e-05,172.31.36.0-255,66,3319,7,410825
345,4.9e-05,74.125.68.0-255,2902,6221,7,410825
346,5.2e-05,172.31.36.0-255,66,6287,7,410825
347,8.3e-05,74.125.68.0-255,5738,12025,7,410825
348,8.6e-05,172.31.36.0-255,66,12091,7,410825
349,9e-05,74.125.68.0-255,1951,14042,7,410825
350,9.2e-05,172.31.36.0-255,66,14108,7,410825
351,0.000156,74.125.68.0-255,1484,15592,7,410825
352,0.000159,172.31.36.0-255,66,15658,7,410825
353,0.000207,74.125.68.0-255,1484,17142,7,410825
354,0.00021,172.31.36.0-255,66,17208,7,410825
355,0.000215,74.125.68.0-255,2902,20110,7,410825
356,0.000217,172.31.36.0-255,66,20176,7,410825
357,0.000245,74.125.68.0-255,5738,25914,7,410825
358,0.000249,172.31.36.0-255,66,25980,7,410825
359,0.000282,74.125.68.0-255,1484,27464,7,410825
360,0.000284,172.31.36.0-255,66,27530,7,410825
361,0.000306,74.125.68.0-255,3961,31491,7,410825
362,0.000309,172.31.36.0-255,66,31557,7,410825
363,0.000408,74.125.68.0-255,1484,33041,7,410825
364,0.000412,172.31.36.0-255,66,33107,7,410825
365,0.000432,74.125.68.0-255,2902,36009,7,410825
366,0.000435,172.31.36.0-255,66,36075,7,410825
367,0.000437,74.125.68.0-255,1484,37559,7,410825
368,0.000439,172.31.36.0-255,66,37625,7,410825
369,0.000454,74.125.68.0-255,2902,40527,7,410825
370,0.000457,172.31.36.0-255,66,40593,7,410825
371,0.000489,74.125.68.0-255,5738,46331,7,410825
372,0.000495,74.125.68.0-255,2543,48874,7,410825
373,0.000498,74.125.68.0-255,2902,51776,7,410825
374,0.000516,74.125.68.0-255,1484,53260,7,410825
375,0.000541,74.125.68.0-255,5738,58998,7,410825
376,0.000549,74.125.68.0-255,7104,66102,7,410825
377,0.000594,172.31.36.0-255,66,66168,7,410825
378,0.000625,74.125.68.0-255,112,66280,7,410825
379,0.000796,74.125.68.0-255,1484,67764,7,410825
380,0.000803,172.31.36.0-255,66,67830,7,410825
381,0.000816,74.125.68.0-255,2902,70732,7,410825
382,0.00083,74.125.68.0-255,2902,73634,7,410825
383,0.00084,172.31.36.0-255,66,73700,7,410825
384,0.00086,74.125.68.0-255,2902,76602,7,410825
385,0.000867,74.125.68.0-255,5738,82340,7,410825
386,0.000874,74.125.68.0-255,7156,89496,7,410825
387,0.000888,172.31.36.0-255,66,89562,7,410825
388,0.000894,74.125.68.0-255,4320,93882,7,410825
389,0.000904,172.31.36.0-255,66,93948,7,410825
390,0.00091,74.125.68.0-255,2902,96850,7,410825
391,0.000931,172.31.36.0-255,66,96916,7,410825
392,0.000962,74.125.68.0-255,1484,98400,7,410825
393,0.000979,74.125.68.0-255,2452,100852,7,410825
394,0.000989,172.31.36.0-255,66,100918,7,410825
395,0.001027,74.125.68.0-255,1484,102402,7,410825
396,0.001042,74.125.68.0-255,2902,105304,7,410825
397,0.00106,74.125.68.0-255,4320,109624,7,410825
398,0.001065,172.31.36.0-255,66,109690,7,410825
399,0.00107,172.31.36.0-255,66,109756,7,410825
400,0.001081,74.125.68.0-255,5738,115494,7,410825
401,0.001099,74.125.68.0-255,2902,118396,7,410825
402,0.001105,74.125.68.0-255,5738,124134,7,410825
403,0.001117,172.31.36.0-255,66,124200,7,410825
404,0.001129,74.125.68.0-255,7156,131356,7,410825
405,0.001139,172.31.36.0-255,66,131422,7,410825
406,0.001157,74.125.68.0-255,3602,135024,7,410825
407,0.001166,172.31.36.0-255,66,135090,7,410825
408,0.001207,74.125.68.0-255,1484,136574,7,410825
409,0.001219,74.125.68.0-255,1484,138058,7,410825
410,0.001232,74.125.68.0-255,1484,139542,7,410825
411,0.001245,172.31.36.0-255,66,139608,7,410825
412,0.001249,74.125.68.0-255,1484,141092,7,410825
413,0.001272,74.125.68.0-255,2902,143994,7,410825
414,0.001284,172.31.36.0-255,66,144060,7,410825
415,0.001302,74.125.68.0-255,5738,149798,7,410825
416,0.001307,74.125.68.0-255,2902,152700,7,410825
417,0.001312,74.125.68.0-255,4320,157020,7,410825
418,0.00133,172.31.36.0-255,66,157086,7,410825
419,0.00135,74.125.68.0-255,3602,160688,7,410825
420,0.001364,172.31.36.0-255,66,160754,7,410825
421,0.0014,74.125.68.0-255,1484,162238,7,410825
422,0.001414,74.125.68.0-255,2902,165140,7,410825
423,0.001421,172.31.36.0-255,66,165206,7,410825
424,0.001442,74.125.68.0-255,5738,170944,7,410825
425,0.001459,74.125.68.0-255,4320,175264,7,410825
426,0.001464,172.31.36.0-255,66,175330,7,410825
427,0.0015,74.125.68.0-255,5738,181068,7,410825
428,0.001526,74.125.68.0-255,2902,183970,7,410825
429,0.001531,74.125.68.0-255,4320,188290,7,410825
430,0.001536,172.31.36.0-255,66,188356,7,410825
431,0.001547,172.31.36.0-255,66,188422,7,410825
432,0.001553,74.125.68.0-255,5738,194160,7,410825
433,0.001572,74.125.68.0-255,766,194926,7,410825
434,0.001579,172.31.36.0-255,66,194992,7,410825
435,0.0016,74.125.68.0-255,4320,199312,7,410825
436,0.001606,172.31.36.0-255,66,199378,7,410825
437,0.001624,74.125.68.0-255,1484,200862,7,410825
438,0.001632,74.125.68.0-255,7156,208018,7,410825
439,0.001675,172.31.36.0-255,66,208084,7,410825
440,0.001687,74.125.68.0-255,4320,212404,7,410825
441,0.001709,74.125.68.0-255,1484,213888,7,410825
442,0.001723,74.125.68.0-255,2902,216790,7,410825
443,0.00173,74.125.68.0-255,5738,222528,7,410825
444,0.001742,172.31.36.0-255,66,222594,7,410825
445,0.001758,74.125.68.0-255,6438,229032,7,410825
446,0.00178,172.31.36.0-255,66,229098,7,410825
447,0.001919,74.125.68.0-255,1484,230582,7,410825
448,0.001938,74.125.68.0-255,2902,233484,7,410825
449,0.001944,172.31.36.0-255,66,233550,7,410825
450,0.002018,74.125.68.0-255,1484,235034,7,410825
451,0.002044,74.125.68.0-255,2902,237936,7,410825
452,0.00206,172.31.36.0-255,66,238002,7,410825
453,0.002065,74.125.68.0-255,2902,240904,7,410825
454,0.002071,172.31.36.0-255,66,240970,7,410825
455,0.002087,74.125.68.0-255,2902,243872,7,410825
456,0.0021,74.125.68.0-255,1484,245356,7,410825
457,0.002115,74.125.68.0-255,5738,251094,7,410825
458,0.00213,74.125.68.0-255,1484,252578,7,410825
459,0.002156,74.125.68.0-255,1484,254062,7,410825
460,0.002186,74.125.68.0-255,766,254828,7,410825
461,0.002293,74.125.68.0-255,1484,256312,7,410825
462,0.00231,74.125.68.0-255,2902,259214,7,410825
463,0.002314,74.125.68.0-255,2902,262116,7,410825
464,0.002327,74.125.68.0-255,2902,265018,7,410825
465,0.002343,74.125.68.0-255,1484,266502,7,410825
466,0.002349,74.125.68.0-255,5738,272240,7,410825
467,0.002368,74.125.68.0-255,2902,275142,7,410825
468,0.002376,74.125.68.0-255,7156,282298,7,410825
469,0.002427,74.125.68.0-255,6438,288736,7,410825
470,0.002533,74.125.68.0-255,1484,290220,7,410825
471,0.002556,74.125.68.0-255,2902,293122,7,410825
472,0.002559,74.125.68.0-255,1484,294606,7,410825
473,0.002574,74.125.68.0-255,4320,298926,7,410825
474,0.002587,74.125.68.0-255,1484,300410,7,410825
475,0.002599,74.125.68.0-255,1484,301894,7,410825
476,0.009097,172.31.36.0-255,66,301960,7,410825
477,0.011678,74.125.68.0-255,5738,307698,7,410825
478,0.011691,172.31.36.0-255,66,307764,7,410825
479,0.011896,172.31.36.0-255,101,307865,7,410825
480,0.014257,74.125.68.0-255,5738,313603,7,410825
481,0.014272,172.31.36.0-255,66,313669,7,410825
482,0.014398,74.125.68.0-255,66,313735,7,410825
483,0.016837,74.125.68.0-255,5738,319473,7,410825
484,0.016846,172.31.36.0-255,66,319539,7,410825
485,0.019408,74.125.68.0-255,5738,325277,7,410825
486,0.019422,172.31.36.0-255,66,325343,7,410825
487,0.021985,74.125.68.0-255,5738,331081,7,410825
488,0.021994,172.31.36.0-255,66,331147,7,410825
489,0.024553,74.125.68.0-255,5738,336885,7,410825
490,0.024561,172.31.36.0-255,66,336951,7,410825
491,0.027131,74.125.68.0-255,5738,342689,7,410825
492,0.027142,172.31.36.0-255,66,342755,7,410825
493,0.029702,74.125.68.0-255,5738,348493,7,410825
494,0.029714,172.31.36.0-255,66,348559,7,410825
495,0.032277,74.125.68.0-255,5738,354297,7,410825
496,0.032285,172.31.36.0-255,66,354363,7,410825
497,0.0341,172.31.36.0-255,172,354535,7,410825
498,0.034133,172.31.36.0-255,1114,355649,7,410825
499,0.03419,172.31.36.0-255,1514,357163,7,410825
500,0.034191,172.31.36.0-255,1292,358455,7,410825
501,0.034841,74.125.68.0-255,5738,364193,7,410825
502,0.034848,172.31.36.0-255,66,364259,7,410825
503,0.035686,104.244.42.0-255,66,364325,7,410825
504,0.035714,104.244.42.0-255,66,364391,7,410825
505,0.035774,104.244.42.0-255,66,364457,7,410825
506,0.037409,74.125.68.0-255,5738,370195,7,410825
507,0.037414,172.31.36.0-255,66,370261,7,410825
508,0.039982,74.125.68.0-255,5738,375999,7,410825
509,0.039988,172.31.36.0-255,66,376065,7,410825
510,0.042593,74.125.68.0-255,5738,381803,7,410825
511,0.042602,172.31.36.0-255,66,381869,7,410825
512,0.045203,74.125.68.0-255,5738,387607,7,410825
513,0.04521,172.31.36.0-255,66,387673,7,410825
514,0.047793,74.125.68.0-255,5738,393411,7,410825
515,0.0478,172.31.36.0-255,66,393477,7,410825
516,0.050372,74.125.68.0-255,5738,399215,7,410825
517,0.050378,172.31.36.0-255,66,399281,7,410825
518,0.052937,74.125.68.0-255,5738,405019,7,410825
519,0.052944,172.31.36.0-255,66,405085,7,410825
520,0.055503,74.125.68.0-255,5503,410588,7,410825
521,0.05551,172.31.36.0-255,66,410654,7,410825
522,0.055708,172.31.36.0-255,105,410759,7,410825
523,0.062936,74.125.68.0-255,66,410825,7,410825
524,0.0,74.125.24.0-255,226,226,7,235346
525,2.2e-05,172.31.36.0-255,66,292,7,235346
526,2.9e-05,74.125.24.0-255,1484,1776,7,235346
527,3.2e-05,172.31.36.0-255,66,1842,7,235346
528,8.1e-05,74.125.24.0-255,4320,6162,7,235346
529,8.4e-05,172.31.36.0-255,66,6228,7,235346
530,0.00032,74.125.24.0-255,7156,13384,7,235346
531,0.000325,172.31.36.0-255,66,13450,7,235346
532,0.00071,74.125.24.0-255,648,14098,7,235346
533,0.000715,172.31.36.0-255,66,14164,7,235346
534,0.00075,74.125.24.0-255,1484,15648,7,235346
535,0.000754,172.31.36.0-255,66,15714,7,235346
536,0.000827,74.125.24.0-255,1484,17198,7,235346
537,0.000831,172.31.36.0-255,66,17264,7,235346
538,0.000849,74.125.24.0-255,2902,20166,7,235346
539,0.000851,172.31.36.0-255,66,20232,7,235346
540,0.001084,74.125.24.0-255,4320,24552,7,235346
541,0.001089,172.31.36.0-255,66,24618,7,235346
542,0.001118,74.125.24.0-255,5738,30356,7,235346
543,0.00112,172.31.36.0-255,66,30422,7,235346
544,0.002406,74.125.24.0-255,2484,32906,7,235346
545,0.002411,172.31.36.0-255,66,32972,7,235346
546,0.003459,74.125.24.0-255,2902,35874,7,235346
547,0.003468,172.31.36.0-255,66,35940,7,235346
548,0.004777,74.125.24.0-255,2902,38842,7,235346
549,0.004784,172.31.36.0-255,66,38908,7,235346
550,0.005847,74.125.24.0-255,2902,41810,7,235346
551,0.005854,172.31.36.0-255,66,41876,7,235346
552,0.007135,74.125.24.0-255,2902,44778,7,235346
553,0.007144,172.31.36.0-255,66,44844,7,235346
554,0.008176,74.125.24.0-255,484,45328,7,235346
555,0.008183,172.31.36.0-255,66,45394,7,235346
556,0.008212,74.125.24.0-255,1484,46878,7,235346
557,0.008216,172.31.36.0-255,66,46944,7,235346
558,0.009541,74.125.24.0-255,2902,49846,7,235346
559,0.009548,172.31.36.0-255,66,49912,7,235346
560,0.010629,74.125.24.0-255,2902,52814,7,235346
561,0.010636,172.31.36.0-255,66,52880,7,235346
562,0.011894,74.125.24.0-255,2902,55782,7,235346
563,0.011901,172.31.36.0-255,66,55848,7,235346
564,0.013052,74.125.24.0-255,2902,58750,7,235346
565,0.013058,172.31.36.0-255,66,58816,7,235346
566,0.014273,74.125.24.0-255,1484,60300,7,235346
567,0.01428,172.31.36.0-255,66,60366,7,235346
568,0.01431,74.125.24.0-255,1484,61850,7,235346
569,0.014314,172.31.36.0-255,66,61916,7,235346
570,0.015425,74.125.24.0-255,2902,64818,7,235346
571,0.015431,172.31.36.0-255,66,64884,7,235346
572,0.016662,74.125.24.0-255,1484,66368,7,235346
573,0.016668,172.31.36.0-255,66,66434,7,235346
574,0.016697,74.125.24.0-255,1484,67918,7,235346
575,0.0167,172.31.36.0-255,66,67984,7,235346
576,0.01778,74.125.24.0-255,2902,70886,7,235346
577,0.017786,172.31.36.0-255,66,70952,7,235346
578,0.01901,74.125.24.0-255,1484,72436,7,235346
579,0.019016,172.31.36.0-255,66,72502,7,235346
580,0.020133,74.125.24.0-255,2902,75404,7,235346
581,0.020139,172.31.36.0-255,66,75470,7,235346
582,0.020197,74.125.24.0-255,1484,76954,7,235346
583,0.020203,172.31.36.0-255,66,77020,7,235346
584,0.021389,74.125.24.0-255,1484,78504,7,235346
585,0.022503,74.125.24.0-255,2902,81406,7,235346
586,0.02251,172.31.36.0-255,66,81472,7,235346
587,0.022581,74.125.24.0-255,1484,82956,7,235346
588,0.023541,172.31.36.0-255,172,83128,7,235346
589,0.023583,172.31.36.0-255,1113,84241,7,235346
590,0.023762,172.31.36.0-255,1514,85755,7,235346
591,0.023765,172.31.36.0-255,1514,87269,7,235346
592,0.023766,172.31.36.0-255,1514,88783,7,235346
593,0.023771,172.31.36.0-255,1514,90297,7,235346
594,0.023772,172.31.36.0-255,1514,91811,7,235346
595,0.023773,172.31.36.0-255,71,91882,7,235346
596,0.024887,74.125.24.0-255,4320,96202,7,235346
597,0.024893,172.31.36.0-255,66,96268,7,235346
598,0.025092,104.244.42.0-255,66,96334,7,235346
599,0.025121,104.244.42.0-255,66,96400,7,235346
600,0.025342,104.244.42.0-255,66,96466,7,235346
601,0.025348,104.244.42.0-255,66,96532,7,235346
602,0.025934,104.244.42.0-255,108,96640,7,235346
603,0.025947,172.31.36.0-255,66,96706,7,235346
604,0.027232,74.125.24.0-255,2902,99608,7,235346
605,0.027238,172.31.36.0-255,66,99674,7,235346
606,0.027295,74.125.24.0-255,2902,102576,7,235346
607,0.027299,172.31.36.0-255,66,102642,7,235346
608,0.029621,74.125.24.0-255,2902,105544,7,235346
609,0.029628,172.31.36.0-255,66,105610,7,235346
610,0.029688,74.125.24.0-255,2902,108512,7,235346
611,0.029692,172.31.36.0-255,66,108578,7,235346
612,0.03205,74.125.24.0-255,2902,111480,7,235346
613,0.032055,172.31.36.0-255,66,111546,7,235346
614,0.032115,74.125.24.0-255,2902,114448,7,235346
615,0.032119,172.31.36.0-255,66,114514,7,235346
616,0.034435,74.125.24.0-255,2902,117416,7,235346
617,0.03444,172.31.36.0-255,66,117482,7,235346
618,0.034507,74.125.24.0-255,2902,120384,7,235346
619,0.034511,172.31.36.0-255,66,120450,7,235346
620,0.036813,74.125.24.0-255,1484,121934,7,235346
621,0.036818,172.31.36.0-255,66,122000,7,235346
622,0.036877,74.125.24.0-255,4320,126320,7,235346
623,0.036881,172.31.36.0-255,66,126386,7,235346
624,0.039178,74.125.24.0-255,1484,127870,7,235346
625,0.039183,172.31.36.0-255,66,127936,7,235346
626,0.039265,74.125.24.0-255,4320,132256,7,235346
627,0.039268,172.31.36.0-255,66,132322,7,235346
628,0.041552,74.125.24.0-255,1484,133806,7,235346
629,0.041556,172.31.36.0-255,66,133872,7,235346
630,0.041612,74.125.24.0-255,4320,138192,7,235346
631,0.041615,172.31.36.0-255,66,138258,7,235346
632,0.043941,74.125.24.0-255,1484,139742,7,235346
633,0.043947,172.31.36.0-255,66,139808,7,235346
634,0.044015,74.125.24.0-255,4320,144128,7,235346
635,0.044019,172.31.36.0-255,66,144194,7,235346
636,0.046326,74.125.24.0-255,1484,145678,7,235346
637,0.046331,172.31.36.0-255,66,145744,7,235346
638,0.046407,74.125.24.0-255,2902,148646,7,235346
639,0.046411,172.31.36.0-255,66,148712,7,235346
640,0.046438,74.125.24.0-255,1484,150196,7,235346
641,0.046442,172.31.36.0-255,66,150262,7,235346
642,0.048702,74.125.24.0-255,1484,151746,7,235346
643,0.048708,172.31.36.0-255,66,151812,7,235346
644,0.048759,74.125.24.0-255,2902,154714,7,235346
645,0.048763,172.31.36.0-255,66,154780,7,235346
646,0.048902,74.125.24.0-255,1484,156264,7,235346
647,0.048907,172.31.36.0-255,66,156330,7,235346
648,0.051074,74.125.24.0-255,1484,157814,7,235346
649,0.051078,172.31.36.0-255,66,157880,7,235346
650,0.051135,74.125.24.0-255,1484,159364,7,235346
651,0.051139,172.31.36.0-255,66,159430,7,235346
652,0.051175,74.125.24.0-255,1484,160914,7,235346
653,0.051179,172.31.36.0-255,66,160980,7,235346
654,0.051265,74.125.24.0-255,1484,162464,7,235346
655,0.051268,172.31.36.0-255,66,162530,7,235346
656,0.053442,74.125.24.0-255,1484,164014,7,235346
657,0.053446,172.31.36.0-255,66,164080,7,235346
658,0.053539,74.125.24.0-255,2902,166982,7,235346
659,0.053543,172.31.36.0-255,66,167048,7,235346
660,0.053637,74.125.24.0-255,1484,168532,7,235346
661,0.053639,172.31.36.0-255,66,168598,7,235346
662,0.055836,74.125.24.0-255,1484,170082,7,235346
663,0.05584,172.31.36.0-255,66,170148,7,235346
664,0.055904,74.125.24.0-255,2902,173050,7,235346
665,0.055907,172.31.36.0-255,66,173116,7,235346
666,0.056031,74.125.24.0-255,1484,174600,7,235346
667,0.056035,172.31.36.0-255,66,174666,7,235346
668,0.058229,74.125.24.0-255,1484,176150,7,235346
669,0.058233,172.31.36.0-255,66,176216,7,235346
670,0.058307,74.125.24.0-255,2902,179118,7,235346
671,0.058311,172.31.36.0-255,66,179184,7,235346
672,0.058408,74.125.24.0-255,1484,180668,7,235346
673,0.058414,172.31.36.0-255,66,180734,7,235346
674,0.060602,74.125.24.0-255,1484,182218,7,235346
675,0.060623,172.31.36.0-255,66,182284,7,235346
676,0.060658,74.125.24.0-255,2902,185186,7,235346
677,0.060663,172.31.36.0-255,66,185252,7,235346
678,0.060808,74.125.24.0-255,1484,186736,7,235346
679,0.060813,172.31.36.0-255,66,186802,7,235346
680,0.063019,74.125.24.0-255,1484,188286,7,235346
681,0.063025,172.31.36.0-255,66,188352,7,235346
682,0.063065,74.125.24.0-255,2902,191254,7,235346
683,0.063068,172.31.36.0-255,66,191320,7,235346
684,0.063193,74.125.24.0-255,1484,192804,7,235346
685,0.063198,172.31.36.0-255,66,192870,7,235346
686,0.065406,74.125.24.0-255,1484,194354,7,235346
687,0.06541,172.31.36.0-255,66,194420,7,235346
688,0.065445,74.125.24.0-255,2902,197322,7,235346
689,0.065448,172.31.36.0-255,66,197388,7,235346
690,0.065603,74.125.24.0-255,1484,198872,7,235346
691,0.065607,172.31.36.0-255,66,198938,7,235346
692,0.067808,74.125.24.0-255,1484,200422,7,235346
693,0.067813,172.31.36.0-255,66,200488,7,235346
694,0.067844,74.125.24.0-255,2902,203390,7,235346
695,0.067847,172.31.36.0-255,66,203456,7,235346
696,0.068006,74.125.24.0-255,1484,204940,7,235346
697,0.068011,172.31.36.0-255,66,205006,7,235346
698,0.070162,74.125.24.0-255,1484,206490,7,235346
699,0.070168,172.31.36.0-255,66,206556,7,235346
700,0.07023,74.125.24.0-255,2902,209458,7,235346
701,0.070234,172.31.36.0-255,66,209524,7,235346
702,0.070368,74.125.24.0-255,1484,211008,7,235346
703,0.070372,172.31.36.0-255,66,211074,7,235346
704,0.072568,74.125.24.0-255,1484,212558,7,235346
705,0.072574,172.31.36.0-255,66,212624,7,235346
706,0.072638,74.125.24.0-255,2902,215526,7,235346
707,0.072644,172.31.36.0-255,66,215592,7,235346
708,0.072765,74.125.24.0-255,1484,217076,7,235346
709,0.07277,172.31.36.0-255,66,217142,7,235346
710,0.074935,74.125.24.0-255,1484,218626,7,235346
711,0.07494,172.31.36.0-255,66,218692,7,235346
712,0.075038,74.125.24.0-255,2902,221594,7,235346
713,0.075042,172.31.36.0-255,66,221660,7,235346
714,0.075126,74.125.24.0-255,1484,223144,7,235346
715,0.075131,172.31.36.0-255,66,223210,7,235346
716,0.077307,74.125.24.0-255,1484,224694,7,235346
717,0.077316,172.31.36.0-255,66,224760,7,235346
718,0.077409,74.125.24.0-255,2902,227662,7,235346
719,0.077413,172.31.36.0-255,66,227728,7,235346
720,0.077492,74.125.24.0-255,1484,229212,7,235346
721,0.077496,172.31.36.0-255,66,229278,7,235346
722,0.079672,74.125.24.0-255,1484,230762,7,235346
723,0.079677,172.31.36.0-255,66,230828,7,235346
724,0.079809,74.125.24.0-255,2902,233730,7,235346
725,0.079814,172.31.36.0-255,66,233796,7,235346
726,0.079867,74.125.24.0-255,1484,235280,7,235346
727,0.079872,172.31.36.0-255,66,235346,7,235346
728,0.0,74.125.24.0-255,153,153,7,271826
729,2.2e-05,172.31.36.0-255,66,219,7,271826
730,2.9e-05,74.125.24.0-255,1484,1703,7,271826
731,3.3e-05,172.31.36.0-255,66,1769,7,271826
732,3.9e-05,74.125.24.0-255,2902,4671,7,271826
733,4.2e-05,172.31.36.0-255,66,4737,7,271826
734,5e-05,74.125.24.0-255,7156,11893,7,271826
735,5.3e-05,172.31.36.0-255,66,11959,7,271826
736,5.7e-05,74.125.24.0-255,2075,14034,7,271826
737,5.9e-05,172.31.36.0-255,66,14100,7,271826
738,0.000302,74.125.24.0-255,1484,15584,7,271826
739,0.000307,172.31.36.0-255,66,15650,7,271826
740,0.000314,74.125.24.0-255,2902,18552,7,271826
741,0.000317,172.31.36.0-255,66,18618,7,271826
742,0.000321,74.125.24.0-255,2902,21520,7,271826
743,0.000323,172.31.36.0-255,66,21586,7,271826
744,0.000344,74.125.24.0-255,2902,24488,7,271826
745,0.000346,172.31.36.0-255,66,24554,7,271826
746,0.000358,74.125.24.0-255,2902,27456,7,271826
747,0.00036,172.31.36.0-255,66,27522,7,271826
748,0.000378,74.125.24.0-255,3961,31483,7,271826
749,0.00038,172.31.36.0-255,66,31549,7,271826
750,0.000473,74.125.24.0-255,1484,33033,7,271826
751,0.000477,172.31.36.0-255,66,33099,7,271826
752,0.000481,74.125.24.0-255,1484,34583,7,271826
753,0.000483,172.31.36.0-255,66,34649,7,271826
754,0.000498,74.125.24.0-255,1484,36133,7,271826
755,0.000501,172.31.36.0-255,66,36199,7,271826
756,0.000507,74.125.24.0-255,4320,40519,7,271826
757,0.000509,172.31.36.0-255,66,40585,7,271826
758,0.000515,74.125.24.0-255,5738,46323,7,271826
759,0.000517,172.31.36.0-255,66,46389,7,271826
760,0.000539,74.125.24.0-255,1484,47873,7,271826
761,0.000566,172.31.36.0-255,66,47939,7,271826
762,0.00057,74.125.24.0-255,2902,50841,7,271826
763,0.000572,172.31.36.0-255,66,50907,7,271826
764,0.000616,74.125.24.0-255,3961,54868,7,271826
765,0.00062,172.31.36.0-255,66,54934,7,271826
766,0.001501,74.125.24.0-255,645,55579,7,271826
767,0.001627,74.125.24.0-255,1484,57063,7,271826
768,0.001633,172.31.36.0-255,66,57129,7,271826
769,0.001641,74.125.24.0-255,2902,60031,7,271826
770,0.001643,172.31.36.0-255,66,60097,7,271826
771,0.001649,74.125.24.0-255,4320,64417,7,271826
772,0.001651,172.31.36.0-255,66,64483,7,271826
773,0.001666,74.125.24.0-255,1484,65967,7,271826
774,0.001698,172.31.36.0-255,66,66033,7,271826
775,0.001704,74.125.24.0-255,4320,70353,7,271826
776,0.001706,172.31.36.0-255,66,70419,7,271826
777,0.00172,74.125.24.0-255,4320,74739,7,271826
778,0.001723,172.31.36.0-255,66,74805,7,271826
779,0.001742,74.125.24.0-255,2184,76989,7,271826
780,0.001745,172.31.36.0-255,66,77055,7,271826
781,0.004009,74.125.24.0-255,5738,82793,7,271826
782,0.004015,172.31.36.0-255,66,82859,7,271826
783,0.006288,74.125.24.0-255,4320,87179,7,271826
784,0.006292,172.31.36.0-255,66,87245,7,271826
785,0.006309,74.125.24.0-255,1484,88729,7,271826
786,0.008571,74.125.24.0-255,4320,93049,7,271826
787,0.008578,172.31.36.0-255,66,93115,7,271826
788,0.010871,74.125.24.0-255,5738,98853,7,271826
789,0.01088,172.31.36.0-255,66,98919,7,271826
790,0.013169,74.125.24.0-255,5738,104657,7,271826
791,0.013179,172.31.36.0-255,66,104723,7,271826
792,0.015457,74.125.24.0-255,5738,110461,7,271826
793,0.015466,172.31.36.0-255,66,110527,7,271826
794,0.017779,74.125.24.0-255,5738,116265,7,271826
795,0.01779,172.31.36.0-255,66,116331,7,271826
796,0.020088,74.125.24.0-255,5738,122069,7,271826
797,0.020096,172.31.36.0-255,66,122135,7,271826
798,0.022446,74.125.24.0-255,5738,127873,7,271826
799,0.022453,172.31.36.0-255,66,127939,7,271826
800,0.02426,172.31.36.0-255,167,128106,7,271826
801,0.024289,172.31.36.0-255,1115,129221,7,271826
802,0.024345,172.31.36.0-255,1514,130735,7,271826
803,0.024346,172.31.36.0-255,1291,132026,7,271826
804,0.024757,74.125.24.0-255,5738,137764,7,271826
805,0.024764,172.31.36.0-255,66,137830,7,271826
806,0.025854,104.244.42.0-255,66,137896,7,271826
807,0.025861,104.244.42.0-255,66,137962,7,271826
808,0.025934,104.244.42.0-255,66,138028,7,271826
809,0.026564,104.244.42.0-255,108,138136,7,271826
810,0.026586,172.31.36.0-255,66,138202,7,271826
811,0.027095,74.125.24.0-255,5738,143940,7,271826
812,0.0271,172.31.36.0-255,66,144006,7,271826
813,0.029381,74.125.24.0-255,5738,149744,7,271826
814,0.029388,172.31.36.0-255,66,149810,7,271826
815,0.031699,74.125.24.0-255,5738,155548,7,271826
816,0.031706,172.31.36.0-255,66,155614,7,271826
817,0.034009,74.125.24.0-255,5738,161352,7,271826
818,0.034016,172.31.36.0-255,66,161418,7,271826
819,0.03634,74.125.24.0-255,5738,167156,7,271826
820,0.036346,172.31.36.0-255,66,167222,7,271826
821,0.038669,74.125.24.0-255,5738,172960,7,271826
822,0.038676,172.31.36.0-255,66,173026,7,271826
823,0.04099,74.125.24.0-255,5738,178764,7,271826
824,0.040997,172.31.36.0-255,66,178830,7,271826
825,0.043349,74.125.24.0-255,5738,184568,7,271826
826,0.043358,172.31.36.0-255,66,184634,7,271826
827,0.045666,74.125.24.0-255,5738,190372,7,271826
828,0.045672,172.31.36.0-255,66,190438,7,271826
829,0.047984,74.125.24.0-255,5738,196176,7,271826
830,0.047991,172.31.36.0-255,66,196242,7,271826
831,0.050301,74.125.24.0-255,5738,201980,7,271826
832,0.050306,172.31.36.0-255,66,202046,7,271826
833,0.052609,74.125.24.0-255,5738,207784,7,271826
834,0.052617,172.31.36.0-255,66,207850,7,271826
835,0.054925,74.125.24.0-255,5738,213588,7,271826
836,0.054931,172.31.36.0-255,66,213654,7,271826
837,0.057219,74.125.24.0-255,5738,219392,7,271826
838,0.057226,172.31.36.0-255,66,219458,7,271826
839,0.05952,74.125.24.0-255,5738,225196,7,271826
840,0.059526,172.31.36.0-255,66,225262,7,271826
841,0.061856,74.125.24.0-255,5738,231000,7,271826
842,0.061863,172.31.36.0-255,66,231066,7,271826
843,0.064169,74.125.24.0-255,5738,236804,7,271826
844,0.064177,172.31.36.0-255,66,236870,7,271826
845,0.066441,74.125.24.0-255,5738,242608,7,271826
846,0.066448,172.31.36.0-255,66,242674,7,271826
847,0.06876,74.125.24.0-255,5738,248412,7,271826
848,0.068766,172.31.36.0-255,66,248478,7,271826
849,0.071077,74.125.24.0-255,5738,254216,7,271826
850,0.071083,172.31.36.0-255,66,254282,7,271826
851,0.073376,74.125.24.0-255,2902,257184,7,271826
852,0.073382,172.31.36.0-255,66,257250,7,271826
853,0.073399,74.125.24.0-255,2902,260152,7,271826
854,0.073401,172.31.36.0-255,66,260218,7,271826
855,0.075706,74.125.24.0-255,5738,265956,7,271826
856,0.075713,172.31.36.0-255,66,266022,7,271826
857,0.078037,74.125.24.0-255,5738,271760,7,271826
858,0.078044,172.31.36.0-255,66,271826,7,271826
859,0.0,74.125.24.0-255,153,153,7,295709
860,1.5e-05,172.31.36.0-255,66,219,7,295709
861,2.1e-05,74.125.24.0-255,1484,1703,7,295709
862,2.6e-05,172.31.36.0-255,66,1769,7,295709
863,6.1e-05,74.125.24.0-255,2902,4671,7,295709
864,7.1e-05,172.31.36.0-255,66,4737,7,295709
865,7.8e-05,74.125.24.0-255,4320,9057,7,295709
866,8.2e-05,172.31.36.0-255,66,9123,7,295709
867,8.5e-05,74.125.24.0-255,1484,10607,7,295709
868,8.8e-05,172.31.36.0-255,66,10673,7,295709
869,0.000143,172.31.36.0-255,66,10739,7,295709
870,0.000154,172.31.36.0-255,66,10805,7,295709
871,0.000169,74.125.24.0-255,3961,14766,7,295709
872,0.000173,172.31.36.0-255,66,14832,7,295709
873,0.000591,74.125.24.0-255,1484,16316,7,295709
874,0.000597,172.31.36.0-255,66,16382,7,295709
875,0.000604,74.125.24.0-255,2902,19284,7,295709
876,0.000608,172.31.36.0-255,66,19350,7,295709
877,0.000638,74.125.24.0-255,5738,25088,7,295709
878,0.000648,172.31.36.0-255,66,25154,7,295709
879,0.000651,74.125.24.0-255,1484,26638,7,295709
880,0.000653,172.31.36.0-255,66,26704,7,295709
881,0.000694,172.31.36.0-255,66,26770,7,295709
882,0.000699,74.125.24.0-255,2902,29672,7,295709
883,0.000701,172.31.36.0-255,66,29738,7,295709
884,0.000757,172.31.36.0-255,66,29804,7,295709
885,0.000979,74.125.24.0-255,347,30151,7,295709
886,0.000985,172.31.36.0-255,66,30217,7,295709
887,0.001046,74.125.24.0-255,1484,31701,7,295709
888,0.00107,74.125.24.0-255,2902,34603,7,295709
889,0.001074,172.31.36.0-255,66,34669,7,295709
890,0.00108,74.125.24.0-255,5738,40407,7,295709
891,0.001083,172.31.36.0-255,66,40473,7,295709
892,0.001086,74.125.24.0-255,1484,41957,7,295709
893,0.001141,74.125.24.0-255,4831,46788,7,295709
894,0.001147,172.31.36.0-255,66,46854,7,295709
895,0.001184,74.125.24.0-255,5738,52592,7,295709
896,0.001189,172.31.36.0-255,66,52658,7,295709
897,0.001211,172.31.36.0-255,66,52724,7,295709
898,0.001245,74.125.24.0-255,2543,55267,7,295709
899,0.001248,172.31.36.0-255,66,55333,7,295709
900,0.001689,74.125.24.0-255,1484,56817,7,295709
901,0.001695,74.125.24.0-255,2902,59719,7,295709
902,0.001698,172.31.36.0-255,66,59785,7,295709
903,0.001702,74.125.24.0-255,1484,61269,7,295709
904,0.001729,74.125.24.0-255,4320,65589,7,295709
905,0.001732,172.31.36.0-255,66,65655,7,295709
906,0.001737,74.125.24.0-255,4320,69975,7,295709
907,0.001739,172.31.36.0-255,66,70041,7,295709
908,0.001771,172.31.36.0-255,66,70107,7,295709
909,0.001787,172.31.36.0-255,66,70173,7,295709
910,0.003791,74.125.24.0-255,2902,73075,7,295709
911,0.003796,172.31.36.0-255,66,73141,7,295709
912,0.003826,74.125.24.0-255,2902,76043,7,295709
913,0.003828,172.31.36.0-255,66,76109,7,295709
914,0.005822,74.125.24.0-255,5738,81847,7,295709
915,0.005827,172.31.36.0-255,66,81913,7,295709
916,0.007877,74.125.24.0-255,5738,87651,7,295709
917,0.007884,172.31.36.0-255,66,87717,7,295709
918,0.009895,74.125.24.0-255,5738,93455,7,295709
919,0.009901,172.31.36.0-255,66,93521,7,295709
920,0.011895,74.125.24.0-255,5738,99259,7,295709
921,0.011902,172.31.36.0-255,66,99325,7,295709
922,0.013925,74.125.24.0-255,5738,105063,7,295709
923,0.013934,172.31.36.0-255,66,105129,7,295709
924,0.015937,74.125.24.0-255,5738,110867,7,295709
925,0.015947,172.31.36.0-255,66,110933,7,295709
926,0.018054,74.125.24.0-255,5738,116671,7,295709
927,0.018063,172.31.36.0-255,66,116737,7,295709
928,0.020099,74.125.24.0-255,2902,119639,7,295709
929,0.020106,172.31.36.0-255,66,119705,7,295709
930,0.020139,74.125.24.0-255,2902,122607,7,295709
931,0.020144,172.31.36.0-255,66,122673,7,295709
932,0.022141,74.125.24.0-255,5738,128411,7,295709
933,0.022148,172.31.36.0-255,66,128477,7,295709
934,0.024198,74.125.24.0-255,5738,134215,7,295709
935,0.024205,172.31.36.0-255,66,134281,7,295709
936,0.025438,172.31.36.0-255,172,134453,7,295709
937,0.02565,172.31.36.0-255,1115,135568,7,295709
938,0.02575,172.31.36.0-255,1514,137082,7,295709
939,0.025752,172.31.36.0-255,1291,138373,7,295709
940,0.026206,74.125.24.0-255,5738,144111,7,295709
941,0.026214,172.31.36.0-255,66,144177,7,295709
942,0.026974,104.244.42.0-255,66,144243,7,295709
943,0.02721,104.244.42.0-255,66,144309,7,295709
944,0.027315,104.244.42.0-255,66,144375,7,295709
945,0.028256,74.125.24.0-255,1484,145859,7,295709
946,0.02831,74.125.24.0-255,4320,150179,7,295709
947,0.028315,172.31.36.0-255,66,150245,7,295709
948,0.030323,74.125.24.0-255,5738,155983,7,295709
949,0.030335,172.31.36.0-255,66,156049,7,295709
950,0.032358,74.125.24.0-255,5738,161787,7,295709
951,0.032372,172.31.36.0-255,66,161853,7,295709
952,0.034377,74.125.24.0-255,5738,167591,7,295709
953,0.034382,172.31.36.0-255,66,167657,7,295709
954,0.03638,74.125.24.0-255,5738,173395,7,295709
955,0.036385,172.31.36.0-255,66,173461,7,295709
956,0.038385,74.125.24.0-255,2902,176363,7,295709
957,0.038391,172.31.36.0-255,66,176429,7,295709
958,0.038427,74.125.24.0-255,2902,179331,7,295709
959,0.03843,172.31.36.0-255,66,179397,7,295709
960,0.040428,74.125.24.0-255,2902,182299,7,295709
961,0.040434,172.31.36.0-255,66,182365,7,295709
962,0.040466,74.125.24.0-255,2902,185267,7,295709
963,0.040469,172.31.36.0-255,66,185333,7,295709
964,0.042434,74.125.24.0-255,2902,188235,7,295709
965,0.042441,172.31.36.0-255,66,188301,7,295709
966,0.042481,74.125.24.0-255,2902,191203,7,295709
967,0.042484,172.31.36.0-255,66,191269,7,295709
968,0.044475,74.125.24.0-255,2902,194171,7,295709
969,0.044482,172.31.36.0-255,66,194237,7,295709
970,0.044519,74.125.24.0-255,2902,197139,7,295709
971,0.044523,172.31.36.0-255,66,197205,7,295709
972,0.046525,74.125.24.0-255,5738,202943,7,295709
973,0.046532,172.31.36.0-255,66,203009,7,295709
974,0.048563,74.125.24.0-255,5738,208747,7,295709
975,0.048571,172.31.36.0-255,66,208813,7,295709
976,0.050588,74.125.24.0-255,5738,214551,7,295709
977,0.050596,172.31.36.0-255,66,214617,7,295709
978,0.052631,74.125.24.0-255,5738,220355,7,295709
979,0.052638,172.31.36.0-255,66,220421,7,295709
980,0.054702,74.125.24.0-255,5738,226159,7,295709
981,0.054707,172.31.36.0-255,66,226225,7,295709
982,0.056726,74.125.24.0-255,4320,230545,7,295709
983,0.056733,172.31.36.0-255,66,230611,7,295709
984,0.056765,74.125.24.0-255,1484,232095,7,295709
985,0.058741,74.125.24.0-255,4320,236415,7,295709
986,0.058747,172.31.36.0-255,66,236481,7,295709
987,0.060776,74.125.24.0-255,5738,242219,7,295709
988,0.060782,172.31.36.0-255,66,242285,7,295709
989,0.062789,74.125.24.0-255,2902,245187,7,295709
990,0.062795,172.31.36.0-255,66,245253,7,295709
991,0.062826,74.125.24.0-255,2902,248155,7,295709
992,0.06283,172.31.36.0-255,66,248221,7,295709
993,0.064797,74.125.24.0-255,2902,251123,7,295709
994,0.064802,172.31.36.0-255,66,251189,7,295709
995,0.064861,74.125.24.0-255,2902,254091,7,295709
996,0.064865,172.31.36.0-255,66,254157,7,295709
997,0.066809,74.125.24.0-255,2902,257059,7,295709
998,0.066816,172.31.36.0-255,66,257125,7,295709
999,0.066873,74.125.24.0-255,2902,260027,7,295709
1000,0.066878,172.31.36.0-255,66,260093,7,295709
1001,0.068845,74.125.24.0-255,2902,262995,7,295709
1002,0.068851,172.31.36.0-255,66,263061,7,295709
1003,0.0689,74.125.24.0-255,2902,265963,7,295709
1004,0.068905,172.31.36.0-255,66,266029,7,295709
1005,0.070855,74.125.24.0-255,2902,268931,7,295709
1006,0.070861,172.31.36.0-255,66,268997,7,295709
1007,0.070917,74.125.24.0-255,2902,271899,7,295709
1008,0.070921,172.31.36.0-255,66,271965,7,295709
1009,0.072863,74.125.24.0-255,2902,274867,7,295709
1010,0.072869,172.31.36.0-255,66,274933,7,295709
1011,0.072942,74.125.24.0-255,2902,277835,7,295709
1012,0.072947,172.31.36.0-255,66,277901,7,295709
1013,0.074867,74.125.24.0-255,2902,280803,7,295709
1014,0.074873,172.31.36.0-255,66,280869,7,295709
1015,0.075011,74.125.24.0-255,2902,283771,7,295709
1016,0.075017,172.31.36.0-255,66,283837,7,295709
1017,0.076862,74.125.24.0-255,2902,286739,7,295709
1018,0.076868,172.31.36.0-255,66,286805,7,295709
1019,0.077058,74.125.24.0-255,2902,289707,7,295709
1020,0.077064,172.31.36.0-255,66,289773,7,295709
1021,0.07888,74.125.24.0-255,2902,292675,7,295709
1022,0.078885,172.31.36.0-255,66,292741,7,295709
1023,0.079055,74.125.24.0-255,2902,295643,7,295709
1024,0.07906,172.31.36.0-255,66,295709,7,295709
1025,0.0,172.217.194.0-255,153,153,7,156153
1026,2.6e-05,172.31.36.0-255,66,219,7,156153
1027,3.4e-05,172.217.194.0-255,1484,1703,7,156153
1028,3.9e-05,172.31.36.0-255,66,1769,7,156153
1029,4.5e-05,172.217.194.0-255,2902,4671,7,156153
1030,5.7e-05,172.31.36.0-255,66,4737,7,156153
1031,6.4e-05,172.217.194.0-255,5738,10475,7,156153
1032,6.8e-05,172.31.36.0-255,66,10541,7,156153
1033,7.4e-05,172.217.194.0-255,4320,14861,7,156153
1034,7.9e-05,172.31.36.0-255,66,14927,7,156153
1035,0.000114,172.217.194.0-255,6229,21156,7,156153
1036,0.000124,172.31.36.0-255,66,21222,7,156153
1037,0.000135,172.31.36.0-255,66,21288,7,156153
1038,0.000147,172.31.36.0-255,66,21354,7,156153
1039,0.000154,172.217.194.0-255,6797,28151,7,156153
1040,0.000156,172.31.36.0-255,66,28217,7,156153
1041,0.000458,172.217.194.0-255,1484,29701,7,156153
1042,0.000464,172.31.36.0-255,66,29767,7,156153
1043,0.000471,172.217.194.0-255,2902,32669,7,156153
1044,0.000473,172.31.36.0-255,66,32735,7,156153
1045,0.000486,172.217.194.0-255,5738,38473,7,156153
1046,0.00049,172.31.36.0-255,66,38539,7,156153
1047,0.000493,172.217.194.0-255,1484,40023,7,156153
1048,0.000495,172.31.36.0-255,66,40089,7,156153
1049,0.000527,172.217.194.0-255,5961,46050,7,156153
1050,0.000531,172.31.36.0-255,66,46116,7,156153
1051,0.000534,172.217.194.0-255,1484,47600,7,156153
1052,0.000536,172.31.36.0-255,66,47666,7,156153
1053,0.000581,172.31.36.0-255,66,47732,7,156153
1054,0.000583,172.217.194.0-255,574,48306,7,156153
1055,0.000673,172.217.194.0-255,1484,49790,7,156153
1056,0.000679,172.31.36.0-255,66,49856,7,156153
1057,0.000685,172.217.194.0-255,2902,52758,7,156153
1058,0.000688,172.31.36.0-255,66,52824,7,156153
1059,0.000694,172.217.194.0-255,5738,58562,7,156153
1060,0.000703,172.31.36.0-255,66,58628,7,156153
1061,0.000716,172.31.36.0-255,66,58694,7,156153
1062,0.000795,172.31.36.0-255,66,58760,7,156153
1063,0.000999,172.217.194.0-255,1484,60244,7,156153
1064,0.001007,172.217.194.0-255,2902,63146,7,156153
1065,0.001011,172.31.36.0-255,66,63212,7,156153
1066,0.001018,172.217.194.0-255,5738,68950,7,156153
1067,0.001021,172.31.36.0-255,66,69016,7,156153
1068,0.001032,172.217.194.0-255,2902,71918,7,156153
1069,0.001035,172.31.36.0-255,66,71984,7,156153
1070,0.001082,172.31.36.0-255,66,72050,7,156153
1071,0.001101,172.31.36.0-255,66,72116,7,156153
1072,0.001197,172.217.194.0-255,1484,73600,7,156153
1073,0.001203,172.217.194.0-255,2902,76502,7,156153
1074,0.001208,172.31.36.0-255,66,76568,7,156153
1075,0.001215,172.217.194.0-255,5738,82306,7,156153
1076,0.001217,172.31.36.0-255,66,82372,7,156153
1077,0.001262,172.31.36.0-255,66,82438,7,156153
1078,0.001275,172.31.36.0-255,66,82504,7,156153
1079,0.001323,172.217.194.0-255,1484,83988,7,156153
1080,0.001327,172.217.194.0-255,1484,85472,7,156153
1081,0.00133,172.31.36.0-255,66,85538,7,156153
1082,0.001361,172.217.194.0-255,1484,87022,7,156153
1083,0.001369,172.217.194.0-255,5738,92760,7,156153
1084,0.001372,172.31.36.0-255,66,92826,7,156153
1085,0.001396,172.31.36.0-255,66,92892,7,156153
1086,0.001433,172.31.36.0-255,66,92958,7,156153
1087,0.001448,172.31.36.0-255,66,93024,7,156153
1088,0.001493,172.31.36.0-255,66,93090,7,156153
1089,0.001528,172.31.36.0-255,66,93156,7,156153
1090,0.00153,172.217.194.0-255,766,93922,7,156153
1091,0.001615,172.217.194.0-255,1484,95406,7,156153
1092,0.001619,172.31.36.0-255,66,95472,7,156153
1093,0.00163,172.217.194.0-255,2902,98374,7,156153
1094,0.001632,172.31.36.0-255,66,98440,7,156153
1095,0.001642,172.217.194.0-255,5738,104178,7,156153
1096,0.001645,172.31.36.0-255,66,104244,7,156153
1097,0.001648,172.217.194.0-255,1484,105728,7,156153
1098,0.001701,172.31.36.0-255,66,105794,7,156153
1099,0.001713,172.217.194.0-255,2184,107978,7,156153
1100,0.001755,172.217.194.0-255,1484,109462,7,156153
1101,0.001773,172.31.36.0-255,66,109528,7,156153
1102,0.001792,172.217.194.0-255,1484,111012,7,156153
1103,0.0018,172.217.194.0-255,7156,118168,7,156153
1104,0.001802,172.31.36.0-255,66,118234,7,156153
1105,0.00182,172.217.194.0-255,5738,123972,7,156153
1106,0.001824,172.217.194.0-255,2184,126156,7,156153
1107,0.001853,172.31.36.0-255,66,126222,7,156153
1108,0.001961,172.217.194.0-255,1484,127706,7,156153
1109,0.001967,172.217.194.0-255,2902,130608,7,156153
1110,0.001971,172.31.36.0-255,66,130674,7,156153
1111,0.001994,172.217.194.0-255,5738,136412,7,156153
1112,0.002,172.217.194.0-255,4320,140732,7,156153
1113,0.002008,172.31.36.0-255,66,140798,7,156153
1114,0.002037,172.31.36.0-255,66,140864,7,156153
1115,0.002053,172.217.194.0-255,1484,142348,7,156153
1116,0.00211,172.31.36.0-255,66,142414,7,156153
1117,0.002117,172.217.194.0-255,7156,149570,7,156153
1118,0.002137,172.31.36.0-255,66,149636,7,156153
1119,0.002183,172.217.194.0-255,1731,151367,7,156153
1120,0.002191,172.31.36.0-255,66,151433,7,156153
1121,0.002202,172.217.194.0-255,105,151538,7,156153
1122,0.005341,172.31.36.0-255,66,151604,7,156153
1123,0.005394,172.31.36.0-255,105,151709,7,156153
1124,0.007692,172.217.194.0-255,66,151775,7,156153
1125,0.032118,172.31.36.0-255,192,151967,7,156153
1126,0.032175,172.31.36.0-255,958,152925,7,156153
1127,0.032253,172.31.36.0-255,1514,154439,7,156153
1128,0.032279,172.31.36.0-255,1450,155889,7,156153
1129,0.033666,104.244.42.0-255,66,155955,7,156153
1130,0.033706,104.244.42.0-255,66,156021,7,156153
1131,0.033845,104.244.42.0-255,66,156087,7,156153
1132,0.033894,104.244.42.0-255,66,156153,7,156153
1133,0.0,172.217.194.0-255,148,148,7,217936
1134,1.3e-05,172.31.36.0-255,66,214,7,217936
1135,3.2e-05,172.217.194.0-255,1484,1698,7,217936
1136,3.6e-05,172.31.36.0-255,66,1764,7,217936
1137,5.2e-05,172.217.194.0-255,2902,4666,7,217936
1138,5.4e-05,172.31.36.0-255,66,4732,7,217936
1139,6e-05,172.217.194.0-255,4320,9052,7,217936
1140,6.2e-05,172.31.36.0-255,66,9118,7,217936
1141,8.6e-05,172.217.194.0-255,2902,12020,7,217936
1142,8.8e-05,172.31.36.0-255,66,12086,7,217936
1143,9.2e-05,172.217.194.0-255,1966,14052,7,217936
1144,9.4e-05,172.31.36.0-255,66,14118,7,217936
1145,0.000102,172.217.194.0-255,7156,21274,7,217936
1146,0.000104,172.31.36.0-255,66,21340,7,217936
1147,0.000125,172.217.194.0-255,4320,25660,7,217936
1148,0.000127,172.31.36.0-255,66,25726,7,217936
1149,0.000133,172.217.194.0-255,5379,31105,7,217936
1150,0.000135,172.31.36.0-255,66,31171,7,217936
1151,0.000215,172.217.194.0-255,1484,32655,7,217936
1152,0.000219,172.31.36.0-255,66,32721,7,217936
1153,0.000223,172.217.194.0-255,2902,35623,7,217936
1154,0.000225,172.31.36.0-255,66,35689,7,217936
1155,0.000245,172.217.194.0-255,5738,41427,7,217936
1156,0.000247,172.31.36.0-255,66,41493,7,217936
1157,0.000279,172.217.194.0-255,1484,42977,7,217936
1158,0.000281,172.31.36.0-255,66,43043,7,217936
1159,0.000304,172.217.194.0-255,6797,49840,7,217936
1160,0.000306,172.31.36.0-255,66,49906,7,217936
1161,0.000316,172.31.36.0-255,66,49972,7,217936
1162,0.000336,172.217.194.0-255,7088,57060,7,217936
1163,0.000339,172.31.36.0-255,66,57126,7,217936
1164,0.000364,172.217.194.0-255,367,57493,7,217936
1165,0.00044,172.217.194.0-255,1484,58977,7,217936
1166,0.000444,172.31.36.0-255,66,59043,7,217936
1167,0.000449,172.217.194.0-255,1484,60527,7,217936
1168,0.000461,172.217.194.0-255,1484,62011,7,217936
1169,0.000463,172.31.36.0-255,66,62077,7,217936
1170,0.000467,172.217.194.0-255,1484,63561,7,217936
1171,0.000491,172.217.194.0-255,4320,67881,7,217936
1172,0.000494,172.31.36.0-255,66,67947,7,217936
1173,0.000499,172.217.194.0-255,2902,70849,7,217936
1174,0.000502,172.31.36.0-255,66,70915,7,217936
1175,0.000527,172.31.36.0-255,66,70981,7,217936
1176,0.000532,172.217.194.0-255,4320,75301,7,217936
1177,0.000535,172.31.36.0-255,66,75367,7,217936
1178,0.00056,172.217.194.0-255,5379,80746,7,217936
1179,0.000563,172.31.36.0-255,66,80812,7,217936
1180,0.000766,172.217.194.0-255,1484,82296,7,217936
1181,0.000791,172.217.194.0-255,2902,85198,7,217936
1182,0.000794,172.31.36.0-255,66,85264,7,217936
1183,0.0008,172.217.194.0-255,4320,89584,7,217936
1184,0.000801,172.31.36.0-255,66,89650,7,217936
1185,0.000843,172.31.36.0-255,66,89716,7,217936
1186,0.000851,172.217.194.0-255,7156,96872,7,217936
1187,0.000853,172.31.36.0-255,66,96938,7,217936
1188,0.00087,172.217.194.0-255,5738,102676,7,217936
1189,0.000873,172.31.36.0-255,66,102742,7,217936
1190,0.000888,172.217.194.0-255,3602,106344,7,217936
1191,0.000892,172.31.36.0-255,66,106410,7,217936
1192,0.000957,172.217.194.0-255,1484,107894,7,217936
1193,0.000993,172.217.194.0-255,1484,109378,7,217936
1194,0.000996,172.31.36.0-255,66,109444,7,217936
1195,0.00102,172.217.194.0-255,1484,110928,7,217936
1196,0.001028,172.217.194.0-255,5738,116666,7,217936
1197,0.00103,172.31.36.0-255,66,116732,7,217936
1198,0.001038,172.217.194.0-255,7156,123888,7,217936
1199,0.00104,172.31.36.0-255,66,123954,7,217936
1200,0.001046,172.217.194.0-255,4320,128274,7,217936
1201,0.001049,172.31.36.0-255,66,128340,7,217936
1202,0.001086,172.31.36.0-255,66,128406,7,217936
1203,0.001091,172.217.194.0-255,2184,130590,7,217936
1204,0.001093,172.31.36.0-255,66,130656,7,217936
1205,0.00114,172.217.194.0-255,1484,132140,7,217936
1206,0.001155,172.217.194.0-255,2902,135042,7,217936
1207,0.001158,172.31.36.0-255,66,135108,7,217936
1208,0.00118,172.217.194.0-255,5738,140846,7,217936
1209,0.001183,172.31.36.0-255,66,140912,7,217936
1210,0.001187,172.217.194.0-255,2902,143814,7,217936
1211,0.00119,172.31.36.0-255,66,143880,7,217936
1212,0.001214,172.31.36.0-255,66,143946,7,217936
1213,0.001224,172.31.36.0-255,66,144012,7,217936
1214,0.001259,172.217.194.0-255,2184,146196,7,217936
1215,0.001262,172.31.36.0-255,66,146262,7,217936
1216,0.001279,172.217.194.0-255,2902,149164,7,217936
1217,0.001282,172.31.36.0-255,66,149230,7,217936
1218,0.001297,172.217.194.0-255,2902,152132,7,217936
1219,0.001299,172.31.36.0-255,66,152198,7,217936
1220,0.00132,172.217.194.0-255,4320,156518,7,217936
1221,0.001323,172.31.36.0-255,66,156584,7,217936
1222,0.001329,172.217.194.0-255,5738,162322,7,217936
1223,0.001331,172.31.36.0-255,66,162388,7,217936
1224,0.001337,172.217.194.0-255,4320,166708,7,217936
1225,0.001339,172.31.36.0-255,66,166774,7,217936
1226,0.001373,172.31.36.0-255,66,166840,7,217936
1227,0.001389,172.31.36.0-255,66,166906,7,217936
1228,0.001406,172.31.36.0-255,66,166972,7,217936
1229,0.001433,172.217.194.0-255,2902,169874,7,217936
1230,0.001436,172.31.36.0-255,66,169940,7,217936
1231,0.001448,172.31.36.0-255,66,170006,7,217936
1232,0.001507,172.217.194.0-255,1484,171490,7,217936
1233,0.001511,172.217.194.0-255,1484,172974,7,217936
1234,0.001514,172.31.36.0-255,66,173040,7,217936
1235,0.001531,172.217.194.0-255,1484,174524,7,217936
1236,0.001538,172.217.194.0-255,5738,180262,7,217936
1237,0.001541,172.31.36.0-255,66,180328,7,217936
1238,0.001544,172.217.194.0-255,1484,181812,7,217936
1239,0.001587,172.31.36.0-255,66,181878,7,217936
1240,0.001598,172.31.36.0-255,66,181944,7,217936
1241,0.001624,172.217.194.0-255,2184,184128,7,217936
1242,0.001627,172.31.36.0-255,66,184194,7,217936
1243,0.001674,172.217.194.0-255,1484,185678,7,217936
1244,0.001678,172.217.194.0-255,1484,187162,7,217936
1245,0.00168,172.31.36.0-255,66,187228,7,217936
1246,0.0017,172.217.194.0-255,1484,188712,7,217936
1247,0.001707,172.217.194.0-255,5738,194450,7,217936
1248,0.001709,172.31.36.0-255,66,194516,7,217936
1249,0.001714,172.217.194.0-255,2902,197418,7,217936
1250,0.001716,172.31.36.0-255,66,197484,7,217936
1251,0.001734,172.217.194.0-255,4320,201804,7,217936
1252,0.001737,172.31.36.0-255,66,201870,7,217936
1253,0.001774,172.217.194.0-255,2902,204772,7,217936
1254,0.001777,172.31.36.0-255,66,204838,7,217936
1255,0.001806,172.31.36.0-255,66,204904,7,217936
1256,0.00181,172.217.194.0-255,2184,207088,7,217936
1257,0.001812,172.31.36.0-255,66,207154,7,217936
1258,0.001826,172.31.36.0-255,66,207220,7,217936
1259,0.001855,172.217.194.0-255,5738,212958,7,217936
1260,0.001858,172.31.36.0-255,66,213024,7,217936
1261,0.001871,172.31.36.0-255,66,213090,7,217936
1262,0.001909,172.31.36.0-255,66,213156,7,217936
1263,0.00194,172.31.36.0-255,66,213222,7,217936
1264,0.001955,172.31.36.0-255,66,213288,7,217936
1265,0.001958,172.217.194.0-255,105,213393,7,217936
1266,0.004508,172.31.36.0-255,66,213459,7,217936
1267,0.004548,172.31.36.0-255,105,213564,7,217936
1268,0.007084,172.217.194.0-255,66,213630,7,217936
1269,0.032069,172.31.36.0-255,188,213818,7,217936
1270,0.032106,172.31.36.0-255,958,214776,7,217936
1271,0.032175,172.31.36.0-255,1514,216290,7,217936
1272,0.032177,172.31.36.0-255,1448,217738,7,217936
1273,0.033607,104.244.42.0-255,66,217804,7,217936
1274,0.033618,104.244.42.0-255,66,217870,7,217936
1275,0.033712,104.244.42.0-255,66,217936,7,217936
1276,0.0,172.217.194.0-255,153,153,7,239980
1277,2.1e-05,172.31.36.0-255,66,219,7,239980
1278,2.8e-05,172.217.194.0-255,1484,1703,7,239980
1279,3.2e-05,172.31.36.0-255,66,1769,7,239980
1280,4.8e-05,172.217.194.0-255,2902,4671,7,239980
1281,5.2e-05,172.31.36.0-255,66,4737,7,239980
1282,5.7e-05,172.217.194.0-255,2902,7639,7,239980
1283,5.9e-05,172.31.36.0-255,66,7705,7,239980
1284,0.000101,172.31.36.0-255,66,7771,7,239980
1285,0.000107,172.217.194.0-255,4320,12091,7,239980
1286,0.00011,172.31.36.0-255,66,12157,7,239980
1287,0.000151,172.31.36.0-255,66,12223,7,239980
1288,0.000158,172.217.194.0-255,7156,19379,7,239980
1289,0.000161,172.31.36.0-255,66,19445,7,239980
1290,0.0002,172.217.194.0-255,4320,23765,7,239980
1291,0.000202,172.31.36.0-255,66,23831,7,239980
1292,0.000231,172.217.194.0-255,2184,26015,7,239980
1293,0.000234,172.31.36.0-255,66,26081,7,239980
1294,0.00047,172.217.194.0-255,1484,27565,7,239980
1295,0.000476,172.31.36.0-255,66,27631,7,239980
1296,0.000481,172.217.194.0-255,2902,30533,7,239980
1297,0.000484,172.31.36.0-255,66,30599,7,239980
1298,0.000487,172.217.194.0-255,1484,32083,7,239980
1299,0.000489,172.31.36.0-255,66,32149,7,239980
1300,0.000516,172.217.194.0-255,2902,35051,7,239980
1301,0.000524,172.31.36.0-255,66,35117,7,239980
1302,0.000535,172.31.36.0-255,66,35183,7,239980
1303,0.000537,172.217.194.0-255,119,35302,7,239980
1304,0.000539,172.31.36.0-255,66,35368,7,239980
1305,0.001382,172.217.194.0-255,1484,36852,7,239980
1306,0.001391,172.217.194.0-255,2902,39754,7,239980
1307,0.001395,172.31.36.0-255,66,39820,7,239980
1308,0.001427,172.217.194.0-255,5738,45558,7,239980
1309,0.001432,172.31.36.0-255,66,45624,7,239980
1310,0.001437,172.217.194.0-255,4320,49944,7,239980
1311,0.001439,172.31.36.0-255,66,50010,7,239980
1312,0.001443,172.217.194.0-255,1484,51494,7,239980
1313,0.001481,172.31.36.0-255,66,51560,7,239980
1314,0.001493,172.31.36.0-255,66,51626,7,239980
1315,0.001727,172.217.194.0-255,1484,53110,7,239980
1316,0.001744,172.217.194.0-255,2902,56012,7,239980
1317,0.001747,172.31.36.0-255,66,56078,7,239980
1318,0.001751,172.217.194.0-255,1484,57562,7,239980
1319,0.001781,172.217.194.0-255,4320,61882,7,239980
1320,0.001785,172.31.36.0-255,66,61948,7,239980
1321,0.001791,172.217.194.0-255,5738,67686,7,239980
1322,0.001794,172.31.36.0-255,66,67752,7,239980
1323,0.001838,172.31.36.0-255,66,67818,7,239980
1324,0.001844,172.217.194.0-255,5020,72838,7,239980
1325,0.001847,172.31.36.0-255,66,72904,7,239980
1326,0.001923,172.31.36.0-255,66,72970,7,239980
1327,0.001935,172.31.36.0-255,66,73036,7,239980
1328,0.001963,172.217.194.0-255,2902,75938,7,239980
1329,0.001967,172.31.36.0-255,66,76004,7,239980
1330,0.001978,172.31.36.0-255,66,76070,7,239980
1331,0.002047,172.217.194.0-255,1484,77554,7,239980
1332,0.002053,172.217.194.0-255,2902,80456,7,239980
1333,0.002056,172.31.36.0-255,66,80522,7,239980
1334,0.002084,172.217.194.0-255,5738,86260,7,239980
1335,0.002088,172.31.36.0-255,66,86326,7,239980
1336,0.002094,172.217.194.0-255,4320,90646,7,239980
1337,0.002096,172.31.36.0-255,66,90712,7,239980
1338,0.002102,172.217.194.0-255,5738,96450,7,239980
1339,0.002111,172.31.36.0-255,66,96516,7,239980
1340,0.002147,172.31.36.0-255,66,96582,7,239980
1341,0.002151,172.217.194.0-255,2184,98766,7,239980
1342,0.002154,172.31.36.0-255,66,98832,7,239980
1343,0.00222,172.217.194.0-255,1484,100316,7,239980
1344,0.002232,172.217.194.0-255,1484,101800,7,239980
1345,0.002236,172.31.36.0-255,66,101866,7,239980
1346,0.002264,172.217.194.0-255,1484,103350,7,239980
1347,0.002268,172.217.194.0-255,1484,104834,7,239980
1348,0.00227,172.31.36.0-255,66,104900,7,239980
1349,0.002282,172.217.194.0-255,5738,110638,7,239980
1350,0.002285,172.31.36.0-255,66,110704,7,239980
1351,0.002322,172.217.194.0-255,7156,117860,7,239980
1352,0.002327,172.31.36.0-255,66,117926,7,239980
1353,0.002376,172.31.36.0-255,66,117992,7,239980
1354,0.002379,172.217.194.0-255,766,118758,7,239980
1355,0.002421,172.31.36.0-255,66,118824,7,239980
1356,0.002457,172.31.36.0-255,66,118890,7,239980
1357,0.002493,172.31.36.0-255,66,118956,7,239980
1358,0.002534,172.31.36.0-255,66,119022,7,239980
1359,0.002557,172.31.36.0-255,66,119088,7,239980
1360,0.0026,172.31.36.0-255,66,119154,7,239980
1361,0.005129,172.217.194.0-255,5738,124892,7,239980
1362,0.005136,172.31.36.0-255,66,124958,7,239980
1363,0.007682,172.217.194.0-255,5738,130696,7,239980
1364,0.007691,172.31.36.0-255,66,130762,7,239980
1365,0.010274,172.217.194.0-255,5738,136500,7,239980
1366,0.010277,172.31.36.0-255,66,136566,7,239980
1367,0.012874,172.217.194.0-255,5738,142304,7,239980
1368,0.012884,172.31.36.0-255,66,142370,7,239980
1369,0.015428,172.217.194.0-255,5738,148108,7,239980
1370,0.015436,172.31.36.0-255,66,148174,7,239980
1371,0.017981,172.217.194.0-255,5738,153912,7,239980
1372,0.017992,172.31.36.0-255,66,153978,7,239980
1373,0.020536,172.217.194.0-255,5738,159716,7,239980
1374,0.020547,172.31.36.0-255,66,159782,7,239980
1375,0.023094,172.217.194.0-255,5738,165520,7,239980
1376,0.023105,172.31.36.0-255,66,165586,7,239980
1377,0.025662,172.217.194.0-255,5738,171324,7,239980
1378,0.025677,172.31.36.0-255,66,171390,7,239980
1379,0.028217,172.217.194.0-255,5738,177128,7,239980
1380,0.028231,172.31.36.0-255,66,177194,7,239980
1381,0.030796,172.217.194.0-255,5738,182932,7,239980
1382,0.030808,172.31.36.0-255,66,182998,7,239980
1383,0.033357,172.217.194.0-255,5738,188736,7,239980
1384,0.033373,172.31.36.0-255,66,188802,7,239980
1385,0.035934,172.217.194.0-255,5738,194540,7,239980
1386,0.035949,172.31.36.0-255,66,194606,7,239980
1387,0.038498,172.217.194.0-255,5738,200344,7,239980
1388,0.038513,172.31.36.0-255,66,200410,7,239980
1389,0.041046,172.217.194.0-255,5738,206148,7,239980
1390,0.041072,172.31.36.0-255,66,206214,7,239980
1391,0.042654,172.31.36.0-255,172,206386,7,239980
1392,0.042693,172.31.36.0-255,1114,207500,7,239980
1393,0.04273,172.31.36.0-255,1514,209014,7,239980
1394,0.042732,172.31.36.0-255,1293,210307,7,239980
1395,0.043607,172.217.194.0-255,5738,216045,7,239980
1396,0.043615,172.31.36.0-255,66,216111,7,239980
1397,0.044201,104.244.42.0-255,66,216177,7,239980
1398,0.044391,104.244.42.0-255,66,216243,7,239980
1399,0.044394,104.244.42.0-255,66,216309,7,239980
1400,0.046162,172.217.194.0-255,5738,222047,7,239980
1401,0.04617,172.31.36.0-255,66,222113,7,239980
1402,0.048703,172.217.194.0-255,5738,227851,7,239980
1403,0.048715,172.31.36.0-255,66,227917,7,239980
1404,0.05127,172.217.194.0-255,5738,233655,7,239980
1405,0.051288,172.31.36.0-255,66,233721,7,239980
1406,0.053818,172.217.194.0-255,5738,239459,7,239980
1407,0.053827,172.31.36.0-255,66,239525,7,239980
1408,0.056332,172.217.194.0-255,218,239743,7,239980
1409,0.056514,172.31.36.0-255,66,239809,7,239980
1410,0.056545,172.31.36.0-255,105,239914,7,239980
1411,0.059038,172.217.194.0-255,66,239980,7,239980
1412,0.0,172.217.160.0-255,153,153,7,341358
1413,2.4e-05,172.31.36.0-255,66,219,7,341358
1414,3.1e-05,172.217.160.0-255,1484,1703,7,341358
1415,3.5e-05,172.31.36.0-255,66,1769,7,341358
1416,4e-05,172.217.160.0-255,2902,4671,7,341358
1417,4.2e-05,172.31.36.0-255,66,4737,7,341358
1418,5.5e-05,172.217.160.0-255,4320,9057,7,341358
1419,5.8e-05,172.31.36.0-255,66,9123,7,341358
1420,7e-05,172.31.36.0-255,66,9189,7,341358
1421,8.3e-05,172.31.36.0-255,66,9255,7,341358
1422,8.7e-05,172.217.160.0-255,1484,10739,7,341358
1423,9e-05,172.31.36.0-255,66,10805,7,341358
1424,9.5e-05,172.217.160.0-255,2902,13707,7,341358
1425,9.7e-05,172.31.36.0-255,66,13773,7,341358
1426,0.000118,172.217.160.0-255,1484,15257,7,341358
1427,0.000121,172.31.36.0-255,66,15323,7,341358
1428,0.000152,172.217.160.0-255,4320,19643,7,341358
1429,0.000157,172.31.36.0-255,66,19709,7,341358
1430,0.000165,172.217.160.0-255,6797,26506,7,341358
1431,0.000167,172.31.36.0-255,66,26572,7,341358
1432,0.000199,172.217.160.0-255,1484,28056,7,341358
1433,0.000202,172.31.36.0-255,66,28122,7,341358
1434,0.000229,172.217.160.0-255,2902,31024,7,341358
1435,0.000232,172.31.36.0-255,66,31090,7,341358
1436,0.000238,172.217.160.0-255,5738,36828,7,341358
1437,0.000241,172.31.36.0-255,66,36894,7,341358
1438,0.000246,172.217.160.0-255,4320,41214,7,341358
1439,0.000254,172.31.36.0-255,66,41280,7,341358
1440,0.000284,172.217.160.0-255,2543,43823,7,341358
1441,0.000287,172.31.36.0-255,66,43889,7,341358
1442,0.000291,172.217.160.0-255,334,44223,7,341358
1443,0.00056,172.217.160.0-255,123,44346,7,341358
1444,0.000664,172.217.160.0-255,1484,45830,7,341358
1445,0.000668,172.31.36.0-255,66,45896,7,341358
1446,0.000674,172.217.160.0-255,2902,48798,7,341358
1447,0.000676,172.31.36.0-255,66,48864,7,341358
1448,0.000702,172.217.160.0-255,5738,54602,7,341358
1449,0.000705,172.31.36.0-255,66,54668,7,341358
1450,0.000712,172.217.160.0-255,6797,61465,7,341358
1451,0.000714,172.31.36.0-255,66,61531,7,341358
1452,0.000758,172.31.36.0-255,66,61597,7,341358
1453,0.000762,172.217.160.0-255,2543,64140,7,341358
1454,0.000764,172.31.36.0-255,66,64206,7,341358
1455,0.000792,172.217.160.0-255,382,64588,7,341358
1456,0.001025,172.217.160.0-255,1484,66072,7,341358
1457,0.001031,172.31.36.0-255,66,66138,7,341358
1458,0.001038,172.217.160.0-255,2902,69040,7,341358
1459,0.001039,172.31.36.0-255,66,69106,7,341358
1460,0.001044,172.217.160.0-255,2902,72008,7,341358
1461,0.001053,172.31.36.0-255,66,72074,7,341358
1462,0.001088,172.217.160.0-255,2902,74976,7,341358
1463,0.001091,172.31.36.0-255,66,75042,7,341358
1464,0.001097,172.217.160.0-255,5738,80780,7,341358
1465,0.0011,172.31.36.0-255,66,80846,7,341358
1466,0.00112,172.31.36.0-255,66,80912,7,341358
1467,0.001126,172.217.160.0-255,5020,85932,7,341358
1468,0.001128,172.31.36.0-255,66,85998,7,341358
1469,0.001134,172.217.160.0-255,4320,90318,7,341358
1470,0.001136,172.31.36.0-255,66,90384,7,341358
1471,0.00116,172.217.160.0-255,1484,91868,7,341358
1472,0.001179,172.31.36.0-255,66,91934,7,341358
1473,0.001187,172.217.160.0-255,5738,97672,7,341358
1474,0.00119,172.31.36.0-255,66,97738,7,341358
1475,0.001221,172.217.160.0-255,4320,102058,7,341358
1476,0.001224,172.31.36.0-255,66,102124,7,341358
1477,0.00123,172.217.160.0-255,5020,107144,7,341358
1478,0.001232,172.31.36.0-255,66,107210,7,341358
1479,0.001425,172.217.160.0-255,1484,108694,7,341358
1480,0.001432,172.217.160.0-255,2902,111596,7,341358
1481,0.001436,172.31.36.0-255,66,111662,7,341358
1482,0.001443,172.217.160.0-255,5738,117400,7,341358
1483,0.001445,172.31.36.0-255,66,117466,7,341358
1484,0.001469,172.217.160.0-255,7156,124622,7,341358
1485,0.001471,172.31.36.0-255,66,124688,7,341358
1486,0.001501,172.217.160.0-255,4320,129008,7,341358
1487,0.001503,172.31.36.0-255,66,129074,7,341358
1488,0.001536,172.31.36.0-255,66,129140,7,341358
1489,0.001602,172.217.160.0-255,1484,130624,7,341358
1490,0.001614,172.217.160.0-255,2902,133526,7,341358
1491,0.001616,172.31.36.0-255,66,133592,7,341358
1492,0.00164,172.217.160.0-255,5738,139330,7,341358
1493,0.001643,172.31.36.0-255,66,139396,7,341358
1494,0.001645,172.217.160.0-255,1484,140880,7,341358
1495,0.001674,172.31.36.0-255,66,140946,7,341358
1496,0.003293,172.217.160.0-255,5738,146684,7,341358
1497,0.003296,172.31.36.0-255,66,146750,7,341358
1498,0.004924,172.217.160.0-255,5738,152488,7,341358
1499,0.004932,172.31.36.0-255,66,152554,7,341358
1500,0.006561,172.217.160.0-255,5738,158292,7,341358
1501,0.006568,172.31.36.0-255,66,158358,7,341358
1502,0.008203,172.217.160.0-255,5738,164096,7,341358
1503,0.008209,172.31.36.0-255,66,164162,7,341358
1504,0.009843,172.217.160.0-255,5738,169900,7,341358
1505,0.009851,172.31.36.0-255,66,169966,7,341358
1506,0.01148,172.217.160.0-255,5738,175704,7,341358
1507,0.011487,172.31.36.0-255,66,175770,7,341358
1508,0.013157,172.217.160.0-255,5738,181508,7,341358
1509,0.013165,172.31.36.0-255,66,181574,7,341358
1510,0.014838,172.217.160.0-255,4320,185894,7,341358
1511,0.014847,172.31.36.0-255,66,185960,7,341358
1512,0.014873,172.217.160.0-255,1484,187444,7,341358
1513,0.01647,172.217.160.0-255,4320,191764,7,341358
1514,0.016477,172.31.36.0-255,66,191830,7,341358
1515,0.018103,172.217.160.0-255,5738,197568,7,341358
1516,0.018109,172.31.36.0-255,66,197634,7,341358
1517,0.019736,172.217.160.0-255,5738,203372,7,341358
1518,0.019742,172.31.36.0-255,66,203438,7,341358
1519,0.021381,172.217.160.0-255,5738,209176,7,341358
1520,0.021388,172.31.36.0-255,66,209242,7,341358
1521,0.023017,172.217.160.0-255,5738,214980,7,341358
1522,0.023024,172.31.36.0-255,66,215046,7,341358
1523,0.024654,172.217.160.0-255,5738,220784,7,341358
1524,0.024662,172.31.36.0-255,66,220850,7,341358
1525,0.026288,172.217.160.0-255,5738,226588,7,341358
1526,0.026295,172.31.36.0-255,66,226654,7,341358
1527,0.027927,172.217.160.0-255,5738,232392,7,341358
1528,0.027933,172.31.36.0-255,66,232458,7,341358
1529,0.029627,172.217.160.0-255,5738,238196,7,341358
1530,0.029635,172.31.36.0-255,66,238262,7,341358
1531,0.031255,172.217.160.0-255,5738,244000,7,341358
1532,0.031262,172.31.36.0-255,66,244066,7,341358
1533,0.03244,172.31.36.0-255,172,244238,7,341358
1534,0.032473,172.31.36.0-255,1115,245353,7,341358
1535,0.032512,172.31.36.0-255,1514,246867,7,341358
1536,0.032514,172.31.36.0-255,1514,248381,7,341358
1537,0.032519,172.31.36.0-255,1514,249895,7,341358
1538,0.03252,172.31.36.0-255,1072,250967,7,341358
1539,0.032886,172.217.160.0-255,5738,256705,7,341358
1540,0.032893,172.31.36.0-255,66,256771,7,341358
1541,0.033961,104.244.42.0-255,66,256837,7,341358
1542,0.033997,104.244.42.0-255,66,256903,7,341358
1543,0.034057,104.244.42.0-255,66,256969,7,341358
1544,0.034061,104.244.42.0-255,66,257035,7,341358
1545,0.034525,172.217.160.0-255,5738,262773,7,341358
1546,0.034532,172.31.36.0-255,66,262839,7,341358
1547,0.036155,172.217.160.0-255,5738,268577,7,341358
1548,0.036161,172.31.36.0-255,66,268643,7,341358
1549,0.037779,172.217.160.0-255,5738,274381,7,341358
1550,0.037784,172.31.36.0-255,66,274447,7,341358
1551,0.039398,172.217.160.0-255,2902,277349,7,341358
1552,0.039404,172.31.36.0-255,66,277415,7,341358
1553,0.039442,172.217.160.0-255,2902,280317,7,341358
1554,0.039445,172.31.36.0-255,66,280383,7,341358
1555,0.04102,172.217.160.0-255,1484,281867,7,341358
1556,0.041075,172.217.160.0-255,4320,286187,7,341358
1557,0.041081,172.31.36.0-255,66,286253,7,341358
1558,0.042703,172.217.160.0-255,5738,291991,7,341358
1559,0.042707,172.31.36.0-255,66,292057,7,341358
1560,0.04433,172.217.160.0-255,5738,297795,7,341358
1561,0.044335,172.31.36.0-255,66,297861,7,341358
1562,0.045968,172.217.160.0-255,4320,302181,7,341358
1563,0.045974,172.31.36.0-255,66,302247,7,341358
1564,0.046008,172.217.160.0-255,1484,303731,7,341358
1565,0.047596,172.217.160.0-255,4320,308051,7,341358
1566,0.047602,172.31.36.0-255,66,308117,7,341358
1567,0.049232,172.217.160.0-255,5738,313855,7,341358
1568,0.049238,172.31.36.0-255,66,313921,7,341358
1569,0.050878,172.217.160.0-255,5738,319659,7,341358
1570,0.050883,172.31.36.0-255,66,319725,7,341358
1571,0.052515,172.217.160.0-255,5738,325463,7,341358
1572,0.052521,172.31.36.0-255,66,325529,7,341358
1573,0.054165,172.217.160.0-255,4320,329849,7,341358
1574,0.054171,172.31.36.0-255,66,329915,7,341358
1575,0.054203,172.217.160.0-255,1484,331399,7,341358
1576,0.05579,172.217.160.0-255,4320,335719,7,341358
1577,0.055795,172.31.36.0-255,66,335785,7,341358
1578,0.057426,172.217.160.0-255,5336,341121,7,341358
1579,0.057431,172.31.36.0-255,66,341187,7,341358
1580,0.057614,172.31.36.0-255,105,341292,7,341358
1581,0.059206,172.217.160.0-255,66,341358,7,341358
1582,0.0,172.217.194.0-255,150,150,7,252501
1583,1.4e-05,172.31.36.0-255,66,216,7,252501
1584,2.1e-05,172.217.194.0-255,1484,1700,7,252501
1585,2.6e-05,172.31.36.0-255,66,1766,7,252501
1586,3.1e-05,172.217.194.0-255,2902,4668,7,252501
1587,4.2e-05,172.31.36.0-255,66,4734,7,252501
1588,5.1e-05,172.217.194.0-255,7156,11890,7,252501
1589,5.4e-05,172.31.36.0-255,66,11956,7,252501
1590,5.9e-05,172.217.194.0-255,2065,14021,7,252501
1591,6.1e-05,172.31.36.0-255,66,14087,7,252501
1592,0.000146,172.217.194.0-255,2902,16989,7,252501
1593,0.000154,172.217.194.0-255,7156,24145,7,252501
1594,0.000159,172.217.194.0-255,5738,29883,7,252501
1595,0.000166,172.31.36.0-255,66,29949,7,252501
1596,0.00017,172.31.36.0-255,66,30015,7,252501
1597,0.000172,172.31.36.0-255,66,30081,7,252501
1598,0.00027,172.217.194.0-255,1125,31206,7,252501
1599,0.000274,172.31.36.0-255,66,31272,7,252501
1600,0.000279,172.217.194.0-255,1484,32756,7,252501
1601,0.000281,172.31.36.0-255,66,32822,7,252501
1602,0.000288,172.217.194.0-255,4320,37142,7,252501
1603,0.000291,172.31.36.0-255,66,37208,7,252501
1604,0.000303,172.31.36.0-255,66,37274,7,252501
1605,0.000306,172.217.194.0-255,1125,38399,7,252501
1606,0.000309,172.31.36.0-255,66,38465,7,252501
1607,0.001629,172.217.194.0-255,1484,39949,7,252501
1608,0.00164,172.31.36.0-255,66,40015,7,252501
1609,0.001651,172.217.194.0-255,2902,42917,7,252501
1610,0.001654,172.31.36.0-255,66,42983,7,252501
1611,0.001667,172.217.194.0-255,5738,48721,7,252501
1612,0.00167,172.31.36.0-255,66,48787,7,252501
1613,0.001709,172.217.194.0-255,6797,55584,7,252501
1614,0.001711,172.31.36.0-255,66,55650,7,252501
1615,0.001889,172.217.194.0-255,1484,57134,7,252501
1616,0.001905,172.217.194.0-255,2902,60036,7,252501
1617,0.001907,172.31.36.0-255,66,60102,7,252501
1618,0.001935,172.217.194.0-255,5738,65840,7,252501
1619,0.001937,172.31.36.0-255,66,65906,7,252501
1620,0.001944,172.217.194.0-255,5738,71644,7,252501
1621,0.001946,172.31.36.0-255,66,71710,7,252501
1622,0.001996,172.217.194.0-255,2902,74612,7,252501
1623,0.001998,172.31.36.0-255,66,74678,7,252501
1624,0.002029,172.217.194.0-255,5379,80057,7,252501
1625,0.002031,172.31.36.0-255,66,80123,7,252501
1626,0.002042,172.31.36.0-255,66,80189,7,252501
1627,0.002049,172.217.194.0-255,1125,81314,7,252501
1628,0.004667,172.217.194.0-255,4320,85634,7,252501
1629,0.004673,172.31.36.0-255,66,85700,7,252501
1630,0.007294,172.217.194.0-255,5738,91438,7,252501
1631,0.007301,172.31.36.0-255,66,91504,7,252501
1632,0.009943,172.217.194.0-255,5738,97242,7,252501
1633,0.009952,172.31.36.0-255,66,97308,7,252501
1634,0.012578,172.217.194.0-255,5738,103046,7,252501
1635,0.012586,172.31.36.0-255,66,103112,7,252501
1636,0.01523,172.217.194.0-255,5738,108850,7,252501
1637,0.015241,172.31.36.0-255,66,108916,7,252501
1638,0.017901,172.217.194.0-255,5738,114654,7,252501
1639,0.017915,172.31.36.0-255,66,114720,7,252501
1640,0.020571,172.217.194.0-255,5738,120458,7,252501
1641,0.020581,172.31.36.0-255,66,120524,7,252501
1642,0.023214,172.217.194.0-255,5738,126262,7,252501
1643,0.023222,172.31.36.0-255,66,126328,7,252501
1644,0.023567,172.31.36.0-255,171,126499,7,252501
1645,0.023619,172.31.36.0-255,1138,127637,7,252501
1646,0.023697,172.31.36.0-255,1514,129151,7,252501
1647,0.023699,172.31.36.0-255,1268,130419,7,252501
1648,0.025135,104.244.42.0-255,66,130485,7,252501
1649,0.025145,104.244.42.0-255,66,130551,7,252501
1650,0.025265,104.244.42.0-255,66,130617,7,252501
1651,0.025875,172.217.194.0-255,5738,136355,7,252501
1652,0.02588,172.31.36.0-255,66,136421,7,252501
1653,0.028623,172.217.194.0-255,5738,142159,7,252501
1654,0.02863,172.31.36.0-255,66,142225,7,252501
1655,0.031291,172.217.194.0-255,5738,147963,7,252501
1656,0.031299,172.31.36.0-255,66,148029,7,252501
1657,0.033944,172.217.194.0-255,5738,153767,7,252501
1658,0.033951,172.31.36.0-255,66,153833,7,252501
1659,0.036593,172.217.194.0-255,5738,159571,7,252501
1660,0.036599,172.31.36.0-255,66,159637,7,252501
1661,0.039245,172.217.194.0-255,5738,165375,7,252501
1662,0.039252,172.31.36.0-255,66,165441,7,252501
1663,0.041871,172.217.194.0-255,5738,171179,7,252501
1664,0.04188,172.31.36.0-255,66,171245,7,252501
1665,0.044531,172.217.194.0-255,5738,176983,7,252501
1666,0.044537,172.31.36.0-255,66,177049,7,252501
1667,0.047198,172.217.194.0-255,5738,182787,7,252501
1668,0.047205,172.31.36.0-255,66,182853,7,252501
1669,0.049836,172.217.194.0-255,5738,188591,7,252501
1670,0.049843,172.31.36.0-255,66,188657,7,252501
1671,0.052514,172.217.194.0-255,5738,194395,7,252501
1672,0.05252,172.31.36.0-255,66,194461,7,252501
1673,0.055165,172.217.194.0-255,5738,200199,7,252501
1674,0.055172,172.31.36.0-255,66,200265,7,252501
1675,0.057826,172.217.194.0-255,5738,206003,7,252501
1676,0.057833,172.31.36.0-255,66,206069,7,252501
1677,0.060465,172.217.194.0-255,5738,211807,7,252501
1678,0.060471,172.31.36.0-255,66,211873,7,252501
1679,0.063129,172.217.194.0-255,5738,217611,7,252501
1680,0.063135,172.31.36.0-255,66,217677,7,252501
1681,0.065814,172.217.194.0-255,5738,223415,7,252501
1682,0.065821,172.31.36.0-255,66,223481,7,252501
1683,0.068452,172.217.194.0-255,5738,229219,7,252501
1684,0.068459,172.31.36.0-255,66,229285,7,252501
1685,0.071125,172.217.194.0-255,5738,235023,7,252501
1686,0.071131,172.31.36.0-255,66,235089,7,252501
1687,0.073786,172.217.194.0-255,5738,240827,7,252501
1688,0.073793,172.31.36.0-255,66,240893,7,252501
1689,0.076424,172.217.194.0-255,5738,246631,7,252501
1690,0.076431,172.31.36.0-255,66,246697,7,252501
1691,0.079069,172.217.194.0-255,5738,252435,7,252501
1692,0.079076,172.31.36.0-255,66,252501,7,252501
1693,0.0,172.217.194.0-255,153,153,7,292957
1694,3.4e-05,172.31.36.0-255,66,219,7,292957
1695,4.1e-05,172.217.194.0-255,1484,1703,7,292957
1696,4.6e-05,172.31.36.0-255,66,1769,7,292957
1697,5.1e-05,172.217.194.0-255,2902,4671,7,292957
1698,5.4e-05,172.31.36.0-255,66,4737,7,292957
1699,6e-05,172.217.194.0-255,7156,11893,7,292957
1700,6.2e-05,172.31.36.0-255,66,11959,7,292957
1701,6.6e-05,172.217.194.0-255,2014,13973,7,292957
1702,6.8e-05,172.31.36.0-255,66,14039,7,292957
1703,0.000134,172.217.194.0-255,1484,15523,7,292957
1704,0.000139,172.31.36.0-255,66,15589,7,292957
1705,0.000144,172.217.194.0-255,2902,18491,7,292957
1706,0.000146,172.31.36.0-255,66,18557,7,292957
1707,0.000151,172.217.194.0-255,2902,21459,7,292957
1708,0.000153,172.31.36.0-255,66,21525,7,292957
1709,0.000175,172.217.194.0-255,2902,24427,7,292957
1710,0.00018,172.31.36.0-255,66,24493,7,292957
1711,0.000209,172.217.194.0-255,6797,31290,7,292957
1712,0.000212,172.31.36.0-255,66,31356,7,292957
1713,0.000251,172.217.194.0-255,1484,32840,7,292957
1714,0.000254,172.31.36.0-255,66,32906,7,292957
1715,0.000258,172.217.194.0-255,1484,34390,7,292957
1716,0.000261,172.31.36.0-255,66,34456,7,292957
1717,0.000274,172.217.194.0-255,1484,35940,7,292957
1718,0.000276,172.31.36.0-255,66,36006,7,292957
1719,0.000282,172.217.194.0-255,5738,41744,7,292957
1720,0.000288,172.31.36.0-255,66,41810,7,292957
1721,0.000305,172.217.194.0-255,4320,46130,7,292957
1722,0.000308,172.31.36.0-255,66,46196,7,292957
1723,0.000344,172.31.36.0-255,66,46262,7,292957
1724,0.000375,172.217.194.0-255,381,46643,7,292957
1725,0.000384,172.31.36.0-255,66,46709,7,292957
1726,0.000697,172.217.194.0-255,1484,48193,7,292957
1727,0.000703,172.217.194.0-255,2902,51095,7,292957
1728,0.000707,172.31.36.0-255,66,51161,7,292957
1729,0.00073,172.217.194.0-255,5738,56899,7,292957
1730,0.000735,172.31.36.0-255,66,56965,7,292957
1731,0.000752,172.31.36.0-255,66,57031,7,292957
1732,0.000756,172.217.194.0-255,4320,61351,7,292957
1733,0.00076,172.217.194.0-255,1484,62835,7,292957
1734,0.000766,172.31.36.0-255,66,62901,7,292957
1735,0.000801,172.31.36.0-255,66,62967,7,292957
1736,0.001425,172.217.194.0-255,1484,64451,7,292957
1737,0.001437,172.217.194.0-255,2902,67353,7,292957
1738,0.00144,172.31.36.0-255,66,67419,7,292957
1739,0.00145,172.217.194.0-255,5738,73157,7,292957
1740,0.001458,172.217.194.0-255,5738,78895,7,292957
1741,0.001486,172.217.194.0-255,7156,86051,7,292957
1742,0.002011,172.217.194.0-255,1484,87535,7,292957
1743,0.002018,172.217.194.0-255,2902,90437,7,292957
1744,0.00203,172.217.194.0-255,2902,93339,7,292957
1745,0.002043,172.217.194.0-255,2902,96241,7,292957
1746,0.002052,172.217.194.0-255,2902,99143,7,292957
1747,0.002089,172.217.194.0-255,766,99909,7,292957
1748,0.005259,172.31.36.0-255,66,99975,7,292957
1749,0.007541,172.217.194.0-255,5738,105713,7,292957
1750,0.007548,172.31.36.0-255,66,105779,7,292957
1751,0.009862,172.217.194.0-255,5738,111517,7,292957
1752,0.009871,172.31.36.0-255,66,111583,7,292957
1753,0.012136,172.217.194.0-255,5738,117321,7,292957
1754,0.012144,172.31.36.0-255,66,117387,7,292957
1755,0.014403,172.217.194.0-255,5738,123125,7,292957
1756,0.014412,172.31.36.0-255,66,123191,7,292957
1757,0.016686,172.217.194.0-255,5738,128929,7,292957
1758,0.016692,172.31.36.0-255,66,128995,7,292957
1759,0.018978,172.217.194.0-255,5738,134733,7,292957
1760,0.018986,172.31.36.0-255,66,134799,7,292957
1761,0.021293,172.217.194.0-255,5738,140537,7,292957
1762,0.021298,172.31.36.0-255,66,140603,7,292957
1763,0.023601,172.217.194.0-255,5738,146341,7,292957
1764,0.023608,172.31.36.0-255,66,146407,7,292957
1765,0.025902,172.217.194.0-255,5738,152145,7,292957
1766,0.025909,172.31.36.0-255,66,152211,7,292957
1767,0.027931,172.31.36.0-255,188,152399,7,292957
1768,0.027964,172.31.36.0-255,958,153357,7,292957
1769,0.028006,172.31.36.0-255,1514,154871,7,292957
1770,0.028008,172.31.36.0-255,1450,156321,7,292957
1771,0.028198,172.217.194.0-255,5738,162059,7,292957
1772,0.028205,172.31.36.0-255,66,162125,7,292957
1773,0.02943,104.244.42.0-255,66,162191,7,292957
1774,0.029453,104.244.42.0-255,66,162257,7,292957
1775,0.029545,104.244.42.0-255,66,162323,7,292957
1776,0.030178,104.244.42.0-255,108,162431,7,292957
1777,0.030182,172.31.36.0-255,66,162497,7,292957
1778,0.030496,172.217.194.0-255,5738,168235,7,292957
1779,0.030499,172.31.36.0-255,66,168301,7,292957
1780,0.03278,172.217.194.0-255,2902,171203,7,292957
1781,0.032785,172.31.36.0-255,66,171269,7,292957
1782,0.03281,172.217.194.0-255,2902,174171,7,292957
1783,0.03283,172.31.36.0-255,66,174237,7,292957
1784,0.035064,172.217.194.0-255,2902,177139,7,292957
1785,0.03507,172.31.36.0-255,66,177205,7,292957
1786,0.03511,172.217.194.0-255,2902,180107,7,292957
1787,0.035123,172.31.36.0-255,66,180173,7,292957
1788,0.03731,172.217.194.0-255,2902,183075,7,292957
1789,0.037316,172.31.36.0-255,66,183141,7,292957
1790,0.037407,172.217.194.0-255,2902,186043,7,292957
1791,0.037411,172.31.36.0-255,66,186109,7,292957
1792,0.039563,172.217.194.0-255,2902,189011,7,292957
1793,0.039569,172.31.36.0-255,66,189077,7,292957
1794,0.039645,172.217.194.0-255,2902,191979,7,292957
1795,0.039653,172.31.36.0-255,66,192045,7,292957
1796,0.041858,172.217.194.0-255,2902,194947,7,292957
1797,0.041864,172.31.36.0-255,66,195013,7,292957
1798,0.041908,172.217.194.0-255,2902,197915,7,292957
1799,0.041919,172.31.36.0-255,66,197981,7,292957
1800,0.044131,172.217.194.0-255,2902,200883,7,292957
1801,0.044136,172.31.36.0-255,66,200949,7,292957
1802,0.044198,172.217.194.0-255,2902,203851,7,292957
1803,0.044216,172.31.36.0-255,66,203917,7,292957
1804,0.046405,172.217.194.0-255,2902,206819,7,292957
1805,0.046411,172.31.36.0-255,66,206885,7,292957
1806,0.046533,172.217.194.0-255,2902,209787,7,292957
1807,0.046538,172.31.36.0-255,66,209853,7,292957
1808,0.048678,172.217.194.0-255,2902,212755,7,292957
1809,0.048682,172.31.36.0-255,66,212821,7,292957
1810,0.048818,172.217.194.0-255,2902,215723,7,292957
1811,0.048822,172.31.36.0-255,66,215789,7,292957
1812,0.050945,172.217.194.0-255,2902,218691,7,292957
1813,0.05095,172.31.36.0-255,66,218757,7,292957
1814,0.051074,172.217.194.0-255,2902,221659,7,292957
1815,0.05108,172.31.36.0-255,66,221725,7,292957
1816,0.05327,172.217.194.0-255,2902,224627,7,292957
1817,0.053277,172.31.36.0-255,66,224693,7,292957
1818,0.053333,172.217.194.0-255,2902,227595,7,292957
1819,0.054804,172.31.36.0-255,66,227661,7,292957
1820,0.055535,172.217.194.0-255,2902,230563,7,292957
1821,0.055542,172.31.36.0-255,66,230629,7,292957
1822,0.057072,172.217.194.0-255,2902,233531,7,292957
1823,0.057077,172.31.36.0-255,66,233597,7,292957
1824,0.057814,172.217.194.0-255,2902,236499,7,292957
1825,0.057819,172.31.36.0-255,66,236565,7,292957
1826,0.059357,172.217.194.0-255,2902,239467,7,292957
1827,0.059361,172.31.36.0-255,66,239533,7,292957
1828,0.060092,172.217.194.0-255,2902,242435,7,292957
1829,0.060096,172.31.36.0-255,66,242501,7,292957
1830,0.061657,172.217.194.0-255,2902,245403,7,292957
1831,0.061661,172.31.36.0-255,66,245469,7,292957
1832,0.062348,172.217.194.0-255,2902,248371,7,292957
1833,0.062353,172.31.36.0-255,66,248437,7,292957
1834,0.063935,172.217.194.0-255,2902,251339,7,292957
1835,0.063939,172.31.36.0-255,66,251405,7,292957
1836,0.064599,172.217.194.0-255,2902,254307,7,292957
1837,0.064603,172.31.36.0-255,66,254373,7,292957
1838,0.066221,172.217.194.0-255,2902,257275,7,292957
1839,0.066226,172.31.36.0-255,66,257341,7,292957
1840,0.066949,172.217.194.0-255,2902,260243,7,292957
1841,0.066955,172.31.36.0-255,66,260309,7,292957
1842,0.068511,172.217.194.0-255,2902,263211,7,292957
1843,0.068517,172.31.36.0-255,66,263277,7,292957
1844,0.069269,172.217.194.0-255,2902,266179,7,292957
1845,0.069274,172.31.36.0-255,66,266245,7,292957
1846,0.070776,172.217.194.0-255,2902,269147,7,292957
1847,0.070781,172.31.36.0-255,66,269213,7,292957
1848,0.071549,172.217.194.0-255,2902,272115,7,292957
1849,0.071555,172.31.36.0-255,66,272181,7,292957
1850,0.073074,172.217.194.0-255,2902,275083,7,292957
1851,0.07308,172.31.36.0-255,66,275149,7,292957
1852,0.07381,172.217.194.0-255,2902,278051,7,292957
1853,0.073815,172.31.36.0-255,66,278117,7,292957
1854,0.07537,172.217.194.0-255,2902,281019,7,292957
1855,0.075375,172.31.36.0-255,66,281085,7,292957
1856,0.076092,172.217.194.0-255,2902,283987,7,292957
1857,0.076098,172.31.36.0-255,66,284053,7,292957
1858,0.077692,172.217.194.0-255,2902,286955,7,292957
1859,0.077699,172.31.36.0-255,66,287021,7,292957
1860,0.078407,172.217.194.0-255,2902,289923,7,292957
1861,0.07924,172.31.36.0-255,66,289989,7,292957
1862,0.079972,172.217.194.0-255,2902,292891,7,292957
1863,0.079978,172.31.36.0-255,66,292957,7,292957
1864,0.0,172.217.194.0-255,143,143,7,143834
1865,2.9e-05,172.31.36.0-255,66,209,7,143834
1866,3.5e-05,172.217.194.0-255,1484,1693,7,143834
1867,3.9e-05,172.31.36.0-255,66,1759,7,143834
1868,4.3e-05,172.217.194.0-255,2902,4661,7,143834
1869,4.5e-05,172.31.36.0-255,66,4727,7,143834
1870,6.1e-05,172.217.194.0-255,7156,11883,7,143834
1871,6.3e-05,172.31.36.0-255,66,11949,7,143834
1872,7e-05,172.217.194.0-255,7156,19105,7,143834
1873,7.3e-05,172.31.36.0-255,66,19171,7,143834
1874,0.000109,172.31.36.0-255,66,19237,7,143834
1875,0.000113,172.217.194.0-255,2543,21780,7,143834
1876,0.000115,172.31.36.0-255,66,21846,7,143834
1877,0.000143,172.217.194.0-255,1484,23330,7,143834
1878,0.000146,172.31.36.0-255,66,23396,7,143834
1879,0.00015,172.217.194.0-255,2902,26298,7,143834
1880,0.000153,172.31.36.0-255,66,26364,7,143834
1881,0.000161,172.217.194.0-255,5738,32102,7,143834
1882,0.000163,172.31.36.0-255,66,32168,7,143834
1883,0.000188,172.217.194.0-255,7156,39324,7,143834
1884,0.000192,172.31.36.0-255,66,39390,7,143834
1885,0.000218,172.217.194.0-255,5379,44769,7,143834
1886,0.00022,172.31.36.0-255,66,44835,7,143834
1887,0.000258,172.31.36.0-255,66,44901,7,143834
1888,0.000284,172.217.194.0-255,386,45287,7,143834
1889,0.000289,172.31.36.0-255,66,45353,7,143834
1890,0.000497,172.217.194.0-255,1484,46837,7,143834
1891,0.000502,172.31.36.0-255,66,46903,7,143834
1892,0.000508,172.217.194.0-255,2902,49805,7,143834
1893,0.000511,172.31.36.0-255,66,49871,7,143834
1894,0.000517,172.217.194.0-255,5738,55609,7,143834
1895,0.000525,172.31.36.0-255,66,55675,7,143834
1896,0.000571,172.31.36.0-255,66,55741,7,143834
1897,0.000605,172.31.36.0-255,66,55807,7,143834
1898,0.000877,172.217.194.0-255,1484,57291,7,143834
1899,0.000928,172.217.194.0-255,2902,60193,7,143834
1900,0.000932,172.31.36.0-255,66,60259,7,143834
1901,0.000939,172.217.194.0-255,5738,65997,7,143834
1902,0.000941,172.31.36.0-255,66,66063,7,143834
1903,0.00096,172.31.36.0-255,66,66129,7,143834
1904,0.000973,172.31.36.0-255,66,66195,7,143834
1905,0.001087,172.217.194.0-255,1484,67679,7,143834
1906,0.001093,172.217.194.0-255,2902,70581,7,143834
1907,0.001096,172.31.36.0-255,66,70647,7,143834
1908,0.001103,172.217.194.0-255,5738,76385,7,143834
1909,0.001105,172.31.36.0-255,66,76451,7,143834
1910,0.00111,172.217.194.0-255,4320,80771,7,143834
1911,0.001112,172.31.36.0-255,66,80837,7,143834
1912,0.001139,172.217.194.0-255,5738,86575,7,143834
1913,0.001142,172.31.36.0-255,66,86641,7,143834
1914,0.001145,172.217.194.0-255,1484,88125,7,143834
1915,0.00119,172.31.36.0-255,66,88191,7,143834
1916,0.00123,172.31.36.0-255,66,88257,7,143834
1917,0.001234,172.217.194.0-255,1484,89741,7,143834
1918,0.001254,172.31.36.0-255,66,89807,7,143834
1919,0.00128,172.217.194.0-255,4320,94127,7,143834
1920,0.001284,172.31.36.0-255,66,94193,7,143834
1921,0.001288,172.217.194.0-255,766,94959,7,143834
1922,0.001316,172.31.36.0-255,66,95025,7,143834
1923,0.001346,172.217.194.0-255,1484,96509,7,143834
1924,0.00136,172.31.36.0-255,66,96575,7,143834
1925,0.001375,172.31.36.0-255,66,96641,7,143834
1926,0.001398,172.217.194.0-255,1484,98125,7,143834
1927,0.001416,172.217.194.0-255,1484,99609,7,143834
1928,0.001419,172.31.36.0-255,66,99675,7,143834
1929,0.001426,172.217.194.0-255,4320,103995,7,143834
1930,0.001429,172.31.36.0-255,66,104061,7,143834
1931,0.001725,172.217.194.0-255,1484,105545,7,143834
1932,0.001732,172.217.194.0-255,2902,108447,7,143834
1933,0.001755,172.217.194.0-255,5738,114185,7,143834
1934,0.001763,172.217.194.0-255,7156,121341,7,143834
1935,0.001845,172.217.194.0-255,2902,124243,7,143834
1936,0.001882,172.217.194.0-255,2902,127145,7,143834
1937,0.001927,172.217.194.0-255,5738,132883,7,143834
1938,0.001973,172.217.194.0-255,1484,134367,7,143834
1939,0.002031,172.217.194.0-255,105,134472,7,143834
1940,0.004879,172.31.36.0-255,66,134538,7,143834
1941,0.007258,172.31.36.0-255,105,134643,7,143834
1942,0.009533,172.217.194.0-255,66,134709,7,143834
1943,0.034276,172.31.36.0-255,171,134880,7,143834
1944,0.034312,172.31.36.0-255,1153,136033,7,143834
1945,0.034357,172.31.36.0-255,1514,137547,7,143834
1946,0.034359,172.31.36.0-255,1514,139061,7,143834
1947,0.03436,172.31.36.0-255,1514,140575,7,143834
1948,0.034365,172.31.36.0-255,1514,142089,7,143834
1949,0.034366,172.31.36.0-255,1481,143570,7,143834
1950,0.035834,104.244.42.0-255,66,143636,7,143834
1951,0.036006,104.244.42.0-255,66,143702,7,143834
1952,0.036008,104.244.42.0-255,66,143768,7,143834
1953,0.036011,104.244.42.0-255,66,143834,7,143834
1954,0.0,172.217.194.0-255,294,294,7,189321
1955,1.7e-05,172.31.36.0-255,66,360,7,189321
1956,2.4e-05,172.217.194.0-255,1484,1844,7,189321
1957,2.8e-05,172.31.36.0-255,66,1910,7,189321
1958,6.1e-05,172.217.194.0-255,4320,6230,7,189321
1959,6.9e-05,172.31.36.0-255,66,6296,7,189321
1960,0.000248,172.31.36.0-255,66,6362,7,189321
1961,0.000629,172.31.36.0-255,66,6428,7,189321
1962,0.001258,172.217.194.0-255,4320,10748,7,189321
1963,0.001266,172.31.36.0-255,66,10814,7,189321
1964,0.001304,172.31.36.0-255,66,10880,7,189321
1965,0.002627,172.217.194.0-255,2902,13782,7,189321
1966,0.002635,172.31.36.0-255,66,13848,7,189321
1967,0.003914,172.217.194.0-255,2902,16750,7,189321
1968,0.00392,172.31.36.0-255,66,16816,7,189321
1969,0.005254,172.217.194.0-255,2902,19718,7,189321
1970,0.00526,172.31.36.0-255,66,19784,7,189321
1971,0.006525,172.217.194.0-255,2902,22686,7,189321
1972,0.006532,172.31.36.0-255,66,22752,7,189321
1973,0.00787,172.217.194.0-255,2902,25654,7,189321
1974,0.007877,172.31.36.0-255,66,25720,7,189321
1975,0.009152,172.217.194.0-255,2902,28622,7,189321
1976,0.00916,172.31.36.0-255,66,28688,7,189321
1977,0.010503,172.217.194.0-255,2902,31590,7,189321
1978,0.010509,172.31.36.0-255,66,31656,7,189321
1979,0.011764,172.217.194.0-255,2902,34558,7,189321
1980,0.01177,172.31.36.0-255,66,34624,7,189321
1981,0.013147,172.217.194.0-255,2902,37526,7,189321
1982,0.013153,172.31.36.0-255,66,37592,7,189321
1983,0.014391,172.217.194.0-255,2902,40494,7,189321
1984,0.014397,172.31.36.0-255,66,40560,7,189321
1985,0.015768,172.217.194.0-255,2902,43462,7,189321
1986,0.015775,172.31.36.0-255,66,43528,7,189321
1987,0.016979,172.217.194.0-255,2902,46430,7,189321
1988,0.016987,172.31.36.0-255,66,46496,7,189321
1989,0.018392,172.217.194.0-255,2902,49398,7,189321
1990,0.0184,172.31.36.0-255,66,49464,7,189321
1991,0.0196,172.217.194.0-255,2902,52366,7,189321
1992,0.019608,172.31.36.0-255,66,52432,7,189321
1993,0.0204,172.31.36.0-255,172,52604,7,189321
1994,0.020431,172.31.36.0-255,1114,53718,7,189321
1995,0.020491,172.31.36.0-255,1514,55232,7,189321
1996,0.020493,172.31.36.0-255,331,55563,7,189321
1997,0.021022,172.217.194.0-255,2902,58465,7,189321
1998,0.021029,172.31.36.0-255,66,58531,7,189321
1999,0.021942,104.244.42.0-255,66,58597,7,189321
2000,0.021951,104.244.42.0-255,66,58663,7,189321
2001,0.022062,104.244.42.0-255,66,58729,7,189321
2002,0.022261,172.217.194.0-255,2902,61631,7,189321
2003,0.022268,172.31.36.0-255,66,61697,7,189321
2004,0.023632,172.217.194.0-255,2902,64599,7,189321
2005,0.023638,172.31.36.0-255,66,64665,7,189321
2006,0.02488,172.217.194.0-255,2902,67567,7,189321
2007,0.024887,172.31.36.0-255,66,67633,7,189321
2008,0.026273,172.217.194.0-255,2902,70535,7,189321
2009,0.02628,172.31.36.0-255,66,70601,7,189321
2010,0.027516,172.217.194.0-255,2902,73503,7,189321
2011,0.027522,172.31.36.0-255,66,73569,7,189321
2012,0.028881,172.217.194.0-255,2902,76471,7,189321
2013,0.028888,172.31.36.0-255,66,76537,7,189321
2014,0.030134,172.217.194.0-255,2902,79439,7,189321
2015,0.030141,172.31.36.0-255,66,79505,7,189321
2016,0.031531,172.217.194.0-255,2902,82407,7,189321
2017,0.031539,172.31.36.0-255,66,82473,7,189321
2018,0.032778,172.217.194.0-255,2902,85375,7,189321
2019,0.032784,172.31.36.0-255,66,85441,7,189321
2020,0.034164,172.217.194.0-255,2902,88343,7,189321
2021,0.03417,172.31.36.0-255,66,88409,7,189321
2022,0.035419,172.217.194.0-255,2902,91311,7,189321
2023,0.035424,172.31.36.0-255,66,91377,7,189321
2024,0.036777,172.217.194.0-255,2902,94279,7,189321
2025,0.036784,172.31.36.0-255,66,94345,7,189321
2026,0.03805,172.217.194.0-255,2902,97247,7,189321
2027,0.038056,172.31.36.0-255,66,97313,7,189321
2028,0.039412,172.217.194.0-255,2902,100215,7,189321
2029,0.039418,172.31.36.0-255,66,100281,7,189321
2030,0.04067,172.217.194.0-255,2902,103183,7,189321
2031,0.040677,172.31.36.0-255,66,103249,7,189321
2032,0.04201,172.217.194.0-255,2902,106151,7,189321
2033,0.042017,172.31.36.0-255,66,106217,7,189321
2034,0.043277,172.217.194.0-255,2902,109119,7,189321
2035,0.043283,172.31.36.0-255,66,109185,7,189321
2036,0.04462,172.217.194.0-255,2902,112087,7,189321
2037,0.044626,172.31.36.0-255,66,112153,7,189321
2038,0.045923,172.217.194.0-255,2902,115055,7,189321
2039,0.045929,172.31.36.0-255,66,115121,7,189321
2040,0.047212,172.217.194.0-255,2902,118023,7,189321
2041,0.047217,172.31.36.0-255,66,118089,7,189321
2042,0.048553,172.217.194.0-255,2902,120991,7,189321
2043,0.048561,172.31.36.0-255,66,121057,7,189321
2044,0.049825,172.217.194.0-255,2902,123959,7,189321
2045,0.049832,172.31.36.0-255,66,124025,7,189321
2046,0.051179,172.217.194.0-255,2902,126927,7,189321
2047,0.051185,172.31.36.0-255,66,126993,7,189321
2048,0.052449,172.217.194.0-255,2902,129895,7,189321
2049,0.052455,172.31.36.0-255,66,129961,7,189321
2050,0.053789,172.217.194.0-255,2902,132863,7,189321
2051,0.053795,172.31.36.0-255,66,132929,7,189321
2052,0.055085,172.217.194.0-255,2902,135831,7,189321
2053,0.055091,172.31.36.0-255,66,135897,7,189321
2054,0.056384,172.217.194.0-255,2902,138799,7,189321
2055,0.05639,172.31.36.0-255,66,138865,7,189321
2056,0.0577,172.217.194.0-255,2902,141767,7,189321
2057,0.057705,172.31.36.0-255,66,141833,7,189321
2058,0.058997,172.217.194.0-255,2902,144735,7,189321
2059,0.059003,172.31.36.0-255,66,144801,7,189321
2060,0.060311,172.217.194.0-255,2902,147703,7,189321
2061,0.060318,172.31.36.0-255,66,147769,7,189321
2062,0.061619,172.217.194.0-255,2902,150671,7,189321
2063,0.061626,172.31.36.0-255,66,150737,7,189321
2064,0.062943,172.217.194.0-255,2902,153639,7,189321
2065,0.06295,172.31.36.0-255,66,153705,7,189321
2066,0.064263,172.217.194.0-255,2902,156607,7,189321
2067,0.06427,172.31.36.0-255,66,156673,7,189321
2068,0.065544,172.217.194.0-255,2902,159575,7,189321
2069,0.065551,172.31.36.0-255,66,159641,7,189321
2070,0.066878,172.217.194.0-255,2902,162543,7,189321
2071,0.066887,172.31.36.0-255,66,162609,7,189321
2072,0.068166,172.217.194.0-255,2902,165511,7,189321
2073,0.068172,172.31.36.0-255,66,165577,7,189321
2074,0.069498,172.217.194.0-255,2902,168479,7,189321
2075,0.069504,172.31.36.0-255,66,168545,7,189321
2076,0.070777,172.217.194.0-255,2902,171447,7,189321
2077,0.070784,172.31.36.0-255,66,171513,7,189321
2078,0.07214,172.217.194.0-255,2902,174415,7,189321
2079,0.072147,172.31.36.0-255,66,174481,7,189321
2080,0.073395,172.217.194.0-255,2902,177383,7,189321
2081,0.073402,172.31.36.0-255,66,177449,7,189321
2082,0.07477,172.217.194.0-255,2902,180351,7,189321
2083,0.074777,172.31.36.0-255,66,180417,7,189321
2084,0.076025,172.217.194.0-255,2902,183319,7,189321
2085,0.076032,172.31.36.0-255,66,183385,7,189321
2086,0.07738,172.217.194.0-255,2902,186287,7,189321
2087,0.077387,172.31.36.0-255,66,186353,7,189321
2088,0.078641,172.217.194.0-255,2902,189255,7,189321
2089,0.078647,172.31.36.0-255,66,189321,7,189321
2090,0.0,172.217.194.0-255,296,296,7,346822
2091,3.3e-05,172.31.36.0-255,66,362,7,346822
2092,4e-05,172.217.194.0-255,1484,1846,7,346822
2093,4.3e-05,172.31.36.0-255,66,1912,7,346822
2094,4.9e-05,172.217.194.0-255,4320,6232,7,346822
2095,5.1e-05,172.31.36.0-255,66,6298,7,346822
2096,5.6e-05,172.217.194.0-255,2902,9200,7,346822
2097,5.9e-05,172.31.36.0-255,66,9266,7,346822
2098,8.1e-05,172.217.194.0-255,6129,15395,7,346822
2099,8.4e-05,172.31.36.0-255,66,15461,7,346822
2100,9.2e-05,172.217.194.0-255,5738,21199,7,346822
2101,9.4e-05,172.31.36.0-255,66,21265,7,346822
2102,0.000123,172.217.194.0-255,2902,24167,7,346822
2103,0.000125,172.31.36.0-255,66,24233,7,346822
2104,0.00015,172.217.194.0-255,6797,31030,7,346822
2105,0.000153,172.31.36.0-255,66,31096,7,346822
2106,0.00023,172.217.194.0-255,1484,32580,7,346822
2107,0.000234,172.31.36.0-255,66,32646,7,346822
2108,0.000239,172.217.194.0-255,2902,35548,7,346822
2109,0.000241,172.31.36.0-255,66,35614,7,346822
2110,0.000245,172.217.194.0-255,2902,38516,7,346822
2111,0.000247,172.31.36.0-255,66,38582,7,346822
2112,0.000267,172.217.194.0-255,2902,41484,7,346822
2113,0.000269,172.31.36.0-255,66,41550,7,346822
2114,0.000287,172.217.194.0-255,5738,47288,7,346822
2115,0.00029,172.31.36.0-255,66,47354,7,346822
2116,0.000309,172.217.194.0-255,6797,54151,7,346822
2117,0.000313,172.31.36.0-255,66,54217,7,346822
2118,0.000338,172.217.194.0-255,7156,61373,7,346822
2119,0.000341,172.31.36.0-255,66,61439,7,346822
2120,0.000364,172.217.194.0-255,4215,65654,7,346822
2121,0.000367,172.31.36.0-255,66,65720,7,346822
2122,0.000371,172.217.194.0-255,117,65837,7,346822
2123,0.000426,172.217.194.0-255,381,66218,7,346822
2124,0.000749,172.217.194.0-255,1484,67702,7,346822
2125,0.000755,172.31.36.0-255,66,67768,7,346822
2126,0.000775,172.217.194.0-255,2902,70670,7,346822
2127,0.000778,172.217.194.0-255,1484,72154,7,346822
2128,0.000786,172.31.36.0-255,66,72220,7,346822
2129,0.000795,172.217.194.0-255,2902,75122,7,346822
2130,0.000799,172.217.194.0-255,2902,78024,7,346822
2131,0.000803,172.31.36.0-255,66,78090,7,346822
2132,0.000814,172.217.194.0-255,5738,83828,7,346822
2133,0.000819,172.31.36.0-255,66,83894,7,346822
2134,0.000838,172.217.194.0-255,4320,88214,7,346822
2135,0.000841,172.31.36.0-255,66,88280,7,346822
2136,0.000875,172.31.36.0-255,66,88346,7,346822
2137,0.000889,172.217.194.0-255,2184,90530,7,346822
2138,0.000901,172.31.36.0-255,66,90596,7,346822
2139,0.001394,172.217.194.0-255,1484,92080,7,346822
2140,0.001419,172.217.194.0-255,2902,94982,7,346822
2141,0.001423,172.31.36.0-255,66,95048,7,346822
2142,0.001431,172.217.194.0-255,5738,100786,7,346822
2143,0.001434,172.217.194.0-255,1484,102270,7,346822
2144,0.001459,172.217.194.0-255,2902,105172,7,346822
2145,0.001466,172.217.194.0-255,5738,110910,7,346822
2146,0.001505,172.217.194.0-255,4320,115230,7,346822
2147,0.001508,172.217.194.0-255,766,115996,7,346822
2148,0.001546,172.217.194.0-255,7156,123152,7,346822
2149,0.001577,172.217.194.0-255,1484,124636,7,346822
2150,0.001594,172.217.194.0-255,7156,131792,7,346822
2151,0.001617,172.217.194.0-255,1484,133276,7,346822
2152,0.00162,172.217.194.0-255,766,134042,7,346822
2153,0.00208,172.217.194.0-255,1484,135526,7,346822
2154,0.002088,172.217.194.0-255,2902,138428,7,346822
2155,0.002091,172.217.194.0-255,1484,139912,7,346822
2156,0.002115,172.217.194.0-255,4320,144232,7,346822
2157,0.00212,172.217.194.0-255,4320,148552,7,346822
2158,0.002134,172.217.194.0-255,7156,155708,7,346822
2159,0.002152,172.217.194.0-255,4320,160028,7,346822
2160,0.002156,172.217.194.0-255,2902,162930,7,346822
2161,0.002177,172.217.194.0-255,5020,167950,7,346822
2162,0.006003,172.31.36.0-255,66,168016,7,346822
2163,0.00832,172.217.194.0-255,5738,173754,7,346822
2164,0.008328,172.31.36.0-255,66,173820,7,346822
2165,0.010635,172.217.194.0-255,5738,179558,7,346822
2166,0.010643,172.31.36.0-255,66,179624,7,346822
2167,0.012968,172.217.194.0-255,5738,185362,7,346822
2168,0.013311,172.31.36.0-255,66,185428,7,346822
2169,0.015653,172.217.194.0-255,5738,191166,7,346822
2170,0.015669,172.31.36.0-255,66,191232,7,346822
2171,0.018043,172.217.194.0-255,5738,196970,7,346822
2172,0.018057,172.31.36.0-255,66,197036,7,346822
2173,0.020387,172.217.194.0-255,5738,202774,7,346822
2174,0.020398,172.31.36.0-255,66,202840,7,346822
2175,0.022733,172.217.194.0-255,5738,208578,7,346822
2176,0.022742,172.31.36.0-255,66,208644,7,346822
2177,0.025046,172.217.194.0-255,5738,214382,7,346822
2178,0.025055,172.31.36.0-255,66,214448,7,346822
2179,0.027341,172.217.194.0-255,5738,220186,7,346822
2180,0.027349,172.31.36.0-255,66,220252,7,346822
2181,0.027528,172.31.36.0-255,172,220424,7,346822
2182,0.027557,172.31.36.0-255,1115,221539,7,346822
2183,0.027595,172.31.36.0-255,1514,223053,7,346822
2184,0.027597,172.31.36.0-255,1291,224344,7,346822
2185,0.02911,104.244.42.0-255,66,224410,7,346822
2186,0.029145,104.244.42.0-255,66,224476,7,346822
2187,0.029188,104.244.42.0-255,66,224542,7,346822
2188,0.029674,172.217.194.0-255,4320,228862,7,346822
2189,0.029678,172.31.36.0-255,66,228928,7,346822
2190,0.029704,172.217.194.0-255,1484,230412,7,346822
2191,0.031977,172.217.194.0-255,4320,234732,7,346822
2192,0.031983,172.31.36.0-255,66,234798,7,346822
2193,0.034306,172.217.194.0-255,5738,240536,7,346822
2194,0.034361,172.31.36.0-255,66,240602,7,346822
2195,0.036689,172.217.194.0-255,5738,246340,7,346822
2196,0.036694,172.31.36.0-255,66,246406,7,346822
2197,0.039034,172.217.194.0-255,5738,252144,7,346822
2198,0.03904,172.31.36.0-255,66,252210,7,346822
2199,0.041343,172.217.194.0-255,5738,257948,7,346822
2200,0.041351,172.31.36.0-255,66,258014,7,346822
2201,0.043644,172.217.194.0-255,5738,263752,7,346822
2202,0.043651,172.31.36.0-255,66,263818,7,346822
2203,0.045929,172.217.194.0-255,4320,268138,7,346822
2204,0.045935,172.31.36.0-255,66,268204,7,346822
2205,0.045967,172.217.194.0-255,1484,269688,7,346822
2206,0.048267,172.217.194.0-255,4320,274008,7,346822
2207,0.048271,172.31.36.0-255,66,274074,7,346822
2208,0.050572,172.217.194.0-255,5738,279812,7,346822
2209,0.050625,172.31.36.0-255,66,279878,7,346822
2210,0.052941,172.217.194.0-255,5738,285616,7,346822
2211,0.052947,172.31.36.0-255,66,285682,7,346822
2212,0.055324,172.217.194.0-255,5738,291420,7,346822
2213,0.055329,172.31.36.0-255,66,291486,7,346822
2214,0.057642,172.217.194.0-255,5738,297224,7,346822
2215,0.057649,172.31.36.0-255,66,297290,7,346822
2216,0.059961,172.217.194.0-255,5738,303028,7,346822
2217,0.059967,172.31.36.0-255,66,303094,7,346822
2218,0.062235,172.217.194.0-255,5738,308832,7,346822
2219,0.062241,172.31.36.0-255,66,308898,7,346822
2220,0.064525,172.217.194.0-255,4320,313218,7,346822
2221,0.06453,172.31.36.0-255,66,313284,7,346822
2222,0.064562,172.217.194.0-255,1484,314768,7,346822
2223,0.066841,172.217.194.0-255,4320,319088,7,346822
2224,0.066846,172.31.36.0-255,66,319154,7,346822
2225,0.069157,172.217.194.0-255,5738,324892,7,346822
2226,0.06921,172.31.36.0-255,66,324958,7,346822
2227,0.071495,172.217.194.0-255,4320,329278,7,346822
2228,0.0715,172.31.36.0-255,66,329344,7,346822
2229,0.071529,172.217.194.0-255,1484,330828,7,346822
2230,0.073829,172.217.194.0-255,4320,335148,7,346822
2231,0.073834,172.31.36.0-255,66,335214,7,346822
2232,0.076134,172.217.194.0-255,5738,340952,7,346822
2233,0.076192,172.31.36.0-255,66,341018,7,346822
2234,0.078527,172.217.194.0-255,5738,346756,7,346822
2235,0.078532,172.31.36.0-255,66,346822,7,346822
2236,0.0,172.217.194.0-255,153,153,7,286374
2237,3.7e-05,172.31.36.0-255,66,219,7,286374
2238,4.4e-05,172.217.194.0-255,1484,1703,7,286374
2239,4.8e-05,172.31.36.0-255,66,1769,7,286374
2240,6.1e-05,172.217.194.0-255,2902,4671,7,286374
2241,6.4e-05,172.31.36.0-255,66,4737,7,286374
2242,7e-05,172.217.194.0-255,4320,9057,7,286374
2243,7.2e-05,172.31.36.0-255,66,9123,7,286374
2244,8.4e-05,172.31.36.0-255,66,9189,7,286374
2245,9e-05,172.217.194.0-255,4320,13509,7,286374
2246,9.3e-05,172.31.36.0-255,66,13575,7,286374
2247,0.000138,172.31.36.0-255,66,13641,7,286374
2248,0.000141,172.217.194.0-255,1484,15125,7,286374
2249,0.000143,172.31.36.0-255,66,15191,7,286374
2250,0.000148,172.217.194.0-255,2902,18093,7,286374
2251,0.00015,172.31.36.0-255,66,18159,7,286374
2252,0.000163,172.217.194.0-255,5738,23897,7,286374
2253,0.000167,172.31.36.0-255,66,23963,7,286374
2254,0.000171,172.217.194.0-255,2902,26865,7,286374
2255,0.000173,172.31.36.0-255,66,26931,7,286374
2256,0.000248,172.31.36.0-255,66,26997,7,286374
2257,0.000256,172.217.194.0-255,7156,34153,7,286374
2258,0.000259,172.31.36.0-255,66,34219,7,286374
2259,0.00027,172.217.194.0-255,4213,38432,7,286374
2260,0.000272,172.31.36.0-255,66,38498,7,286374
2261,0.000336,172.217.194.0-255,1484,39982,7,286374
2262,0.000341,172.31.36.0-255,66,40048,7,286374
2263,0.000346,172.217.194.0-255,2902,42950,7,286374
2264,0.000348,172.31.36.0-255,66,43016,7,286374
2265,0.000353,172.217.194.0-255,2902,45918,7,286374
2266,0.000356,172.31.36.0-255,66,45984,7,286374
2267,0.000375,172.217.194.0-255,2902,48886,7,286374
2268,0.000378,172.31.36.0-255,66,48952,7,286374
2269,0.000399,172.31.36.0-255,66,49018,7,286374
2270,0.000445,172.31.36.0-255,66,49084,7,286374
2271,0.000479,172.217.194.0-255,4320,53404,7,286374
2272,0.000484,172.31.36.0-255,66,53470,7,286374
2273,0.00049,172.217.194.0-255,5738,59208,7,286374
2274,0.000494,172.31.36.0-255,66,59274,7,286374
2275,0.00054,172.217.194.0-255,6797,66071,7,286374
2276,0.000544,172.31.36.0-255,66,66137,7,286374
2277,0.000571,172.217.194.0-255,4320,70457,7,286374
2278,0.000574,172.31.36.0-255,66,70523,7,286374
2279,0.00058,172.217.194.0-255,4320,74843,7,286374
2280,0.000583,172.31.36.0-255,66,74909,7,286374
2281,0.000605,172.217.194.0-255,1484,76393,7,286374
2282,0.000626,172.31.36.0-255,66,76459,7,286374
2283,0.000633,172.217.194.0-255,5738,82197,7,286374
2284,0.000637,172.31.36.0-255,66,82263,7,286374
2285,0.00067,172.217.194.0-255,2902,85165,7,286374
2286,0.000674,172.31.36.0-255,66,85231,7,286374
2287,0.00068,172.217.194.0-255,3602,88833,7,286374
2288,0.000683,172.31.36.0-255,66,88899,7,286374
2289,0.001359,172.217.194.0-255,1484,90383,7,286374
2290,0.001367,172.217.194.0-255,2902,93285,7,286374
2291,0.001374,172.31.36.0-255,66,93351,7,286374
2292,0.00138,172.217.194.0-255,2902,96253,7,286374
2293,0.001382,172.31.36.0-255,66,96319,7,286374
2294,0.001419,172.217.194.0-255,2902,99221,7,286374
2295,0.001423,172.31.36.0-255,66,99287,7,286374
2296,0.001443,172.31.36.0-255,66,99353,7,286374
2297,0.001448,172.217.194.0-255,2902,102255,7,286374
2298,0.00145,172.31.36.0-255,66,102321,7,286374
2299,0.001493,172.31.36.0-255,66,102387,7,286374
2300,0.001613,172.217.194.0-255,1484,103871,7,286374
2301,0.001619,172.217.194.0-255,2902,106773,7,286374
2302,0.001623,172.31.36.0-255,66,106839,7,286374
2303,0.001626,172.217.194.0-255,1484,108323,7,286374
2304,0.001655,172.217.194.0-255,4320,112643,7,286374
2305,0.001658,172.31.36.0-255,66,112709,7,286374
2306,0.001671,172.31.36.0-255,66,112775,7,286374
2307,0.001689,172.31.36.0-255,66,112841,7,286374
2308,0.00172,172.217.194.0-255,2902,115743,7,286374
2309,0.001723,172.31.36.0-255,66,115809,7,286374
2310,0.001757,172.217.194.0-255,7156,122965,7,286374
2311,0.001761,172.31.36.0-255,66,123031,7,286374
2312,0.001779,172.31.36.0-255,66,123097,7,286374
2313,0.00182,172.31.36.0-255,66,123163,7,286374
2314,0.001853,172.217.194.0-255,3602,126765,7,286374
2315,0.001858,172.31.36.0-255,66,126831,7,286374
2316,0.002061,172.217.194.0-255,1484,128315,7,286374
2317,0.002066,172.217.194.0-255,2902,131217,7,286374
2318,0.00207,172.31.36.0-255,66,131283,7,286374
2319,0.002089,172.217.194.0-255,2902,134185,7,286374
2320,0.002093,172.31.36.0-255,66,134251,7,286374
2321,0.002097,172.217.194.0-255,1484,135735,7,286374
2322,0.002123,172.217.194.0-255,5738,141473,7,286374
2323,0.002127,172.31.36.0-255,66,141539,7,286374
2324,0.002165,172.31.36.0-255,66,141605,7,286374
2325,0.002201,172.217.194.0-255,5020,146625,7,286374
2326,0.002204,172.31.36.0-255,66,146691,7,286374
2327,0.002256,172.217.194.0-255,1484,148175,7,286374
2328,0.002261,172.217.194.0-255,2902,151077,7,286374
2329,0.002264,172.31.36.0-255,66,151143,7,286374
2330,0.002295,172.217.194.0-255,4320,155463,7,286374
2331,0.002299,172.31.36.0-255,66,155529,7,286374
2332,0.002302,172.217.194.0-255,1484,157013,7,286374
2333,0.004583,172.217.194.0-255,4320,161333,7,286374
2334,0.00459,172.31.36.0-255,66,161399,7,286374
2335,0.006871,172.217.194.0-255,5738,167137,7,286374
2336,0.006877,172.31.36.0-255,66,167203,7,286374
2337,0.009162,172.217.194.0-255,5738,172941,7,286374
2338,0.009169,172.31.36.0-255,66,173007,7,286374
2339,0.011446,172.217.194.0-255,5738,178745,7,286374
2340,0.011454,172.31.36.0-255,66,178811,7,286374
2341,0.013754,172.217.194.0-255,5738,184549,7,286374
2342,0.013766,172.31.36.0-255,66,184615,7,286374
2343,0.016028,172.217.194.0-255,5738,190353,7,286374
2344,0.016038,172.31.36.0-255,66,190419,7,286374
2345,0.018283,172.217.194.0-255,5738,196157,7,286374
2346,0.018291,172.31.36.0-255,66,196223,7,286374
2347,0.020583,172.217.194.0-255,5738,201961,7,286374
2348,0.020589,172.31.36.0-255,66,202027,7,286374
2349,0.022859,172.217.194.0-255,5738,207765,7,286374
2350,0.022867,172.31.36.0-255,66,207831,7,286374
2351,0.025149,172.217.194.0-255,5738,213569,7,286374
2352,0.025159,172.31.36.0-255,66,213635,7,286374
2353,0.027399,172.217.194.0-255,5738,219373,7,286374
2354,0.027408,172.31.36.0-255,66,219439,7,286374
2355,0.029719,172.217.194.0-255,5738,225177,7,286374
2356,0.029726,172.31.36.0-255,66,225243,7,286374
2357,0.029867,172.31.36.0-255,172,225415,7,286374
2358,0.030046,172.31.36.0-255,1115,226530,7,286374
2359,0.030113,172.31.36.0-255,1514,228044,7,286374
2360,0.030141,172.31.36.0-255,1291,229335,7,286374
2361,0.031405,104.244.42.0-255,66,229401,7,286374
2362,0.031594,104.244.42.0-255,66,229467,7,286374
2363,0.031698,104.244.42.0-255,66,229533,7,286374
2364,0.031976,172.217.194.0-255,5738,235271,7,286374
2365,0.031981,172.31.36.0-255,66,235337,7,286374
2366,0.034261,172.217.194.0-255,5738,241075,7,286374
2367,0.034268,172.31.36.0-255,66,241141,7,286374
2368,0.036591,172.217.194.0-255,5738,246879,7,286374
2369,0.036604,172.31.36.0-255,66,246945,7,286374
2370,0.038887,172.217.194.0-255,5738,252683,7,286374
2371,0.038904,172.31.36.0-255,66,252749,7,286374
2372,0.041176,172.217.194.0-255,5738,258487,7,286374
2373,0.041187,172.31.36.0-255,66,258553,7,286374
2374,0.043502,172.217.194.0-255,5738,264291,7,286374
2375,0.043508,172.31.36.0-255,66,264357,7,286374
2376,0.045772,172.217.194.0-255,5738,270095,7,286374
2377,0.045779,172.31.36.0-255,66,270161,7,286374
2378,0.04803,172.217.194.0-255,5738,275899,7,286374
2379,0.048037,172.31.36.0-255,66,275965,7,286374
2380,0.050287,172.217.194.0-255,5738,281703,7,286374
2381,0.050294,172.31.36.0-255,66,281769,7,286374
2382,0.052576,172.217.194.0-255,4368,286137,7,286374
2383,0.052583,172.31.36.0-255,66,286203,7,286374
2384,0.052787,172.31.36.0-255,105,286308,7,286374
2385,0.055054,172.217.194.0-255,66,286374,7,286374
2386,0.0,172.217.194.0-255,152,152,7,285135
2387,3.4e-05,172.31.36.0-255,66,218,7,285135
2388,4.1e-05,172.217.194.0-255,1484,1702,7,285135
2389,4.5e-05,172.31.36.0-255,66,1768,7,285135
2390,5.9e-05,172.217.194.0-255,2902,4670,7,285135
2391,6.3e-05,172.31.36.0-255,66,4736,7,285135
2392,7e-05,172.217.194.0-255,7156,11892,7,285135
2393,7.3e-05,172.31.36.0-255,66,11958,7,285135
2394,7.6e-05,172.217.194.0-255,2139,14097,7,285135
2395,7.9e-05,172.31.36.0-255,66,14163,7,285135
2396,0.000122,172.217.194.0-255,1484,15647,7,285135
2397,0.000126,172.31.36.0-255,66,15713,7,285135
2398,0.000146,172.217.194.0-255,2902,18615,7,285135
2399,0.00015,172.31.36.0-255,66,18681,7,285135
2400,0.000155,172.217.194.0-255,2902,21583,7,285135
2401,0.000157,172.31.36.0-255,66,21649,7,285135
2402,0.000166,172.217.194.0-255,7156,28805,7,285135
2403,0.000168,172.31.36.0-255,66,28871,7,285135
2404,0.000218,172.31.36.0-255,66,28937,7,285135
2405,0.000223,172.217.194.0-255,4320,33257,7,285135
2406,0.000225,172.31.36.0-255,66,33323,7,285135
2407,0.000271,172.31.36.0-255,66,33389,7,285135
2408,0.000303,172.217.194.0-255,3875,37264,7,285135
2409,0.000308,172.31.36.0-255,66,37330,7,285135
2410,0.000311,172.217.194.0-255,123,37453,7,285135
2411,0.000313,172.31.36.0-255,66,37519,7,285135
2412,0.000398,172.217.194.0-255,379,37898,7,285135
2413,0.000403,172.31.36.0-255,66,37964,7,285135
2414,0.000809,172.217.194.0-255,1484,39448,7,285135
2415,0.000816,172.31.36.0-255,66,39514,7,285135
2416,0.000822,172.217.194.0-255,2902,42416,7,285135
2417,0.000825,172.31.36.0-255,66,42482,7,285135
2418,0.000837,172.217.194.0-255,5738,48220,7,285135
2419,0.000841,172.31.36.0-255,66,48286,7,285135
2420,0.000847,172.217.194.0-255,4320,52606,7,285135
2421,0.000849,172.31.36.0-255,66,52672,7,285135
2422,0.000885,172.31.36.0-255,66,52738,7,285135
2423,0.000898,172.31.36.0-255,66,52804,7,285135
2424,0.001999,172.217.194.0-255,1484,54288,7,285135
2425,0.002019,172.217.194.0-255,2902,57190,7,285135
2426,0.002023,172.31.36.0-255,66,57256,7,285135
2427,0.002029,172.217.194.0-255,5738,62994,7,285135
2428,0.00203,172.31.36.0-255,66,63060,7,285135
2429,0.002064,172.31.36.0-255,66,63126,7,285135
2430,0.002096,172.217.194.0-255,1484,64610,7,285135
2431,0.002114,172.217.194.0-255,7156,71766,7,285135
2432,0.002117,172.31.36.0-255,66,71832,7,285135
2433,0.002144,172.217.194.0-255,5020,76852,7,285135
2434,0.002147,172.31.36.0-255,66,76918,7,285135
2435,0.002211,172.217.194.0-255,1484,78402,7,285135
2436,0.002215,172.217.194.0-255,2902,81304,7,285135
2437,0.00222,172.31.36.0-255,66,81370,7,285135
2438,0.002263,172.217.194.0-255,5738,87108,7,285135
2439,0.00228,172.31.36.0-255,66,87174,7,285135
2440,0.00229,172.31.36.0-255,66,87240,7,285135
2441,0.00233,172.217.194.0-255,2902,90142,7,285135
2442,0.002334,172.31.36.0-255,66,90208,7,285135
2443,0.00237,172.31.36.0-255,66,90274,7,285135
2444,0.004693,172.217.194.0-255,5738,96012,7,285135
2445,0.004698,172.31.36.0-255,66,96078,7,285135
2446,0.007011,172.217.194.0-255,5738,101816,7,285135
2447,0.007018,172.31.36.0-255,66,101882,7,285135
2448,0.009334,172.217.194.0-255,5738,107620,7,285135
2449,0.009343,172.31.36.0-255,66,107686,7,285135
2450,0.01168,172.217.194.0-255,5738,113424,7,285135
2451,0.011689,172.31.36.0-255,66,113490,7,285135
2452,0.014026,172.217.194.0-255,5738,119228,7,285135
2453,0.014036,172.31.36.0-255,66,119294,7,285135
2454,0.016374,172.217.194.0-255,5738,125032,7,285135
2455,0.016383,172.31.36.0-255,66,125098,7,285135
2456,0.018729,172.217.194.0-255,5738,130836,7,285135
2457,0.018736,172.31.36.0-255,66,130902,7,285135
2458,0.021077,172.217.194.0-255,5738,136640,7,285135
2459,0.021085,172.31.36.0-255,66,136706,7,285135
2460,0.021289,172.31.36.0-255,172,136878,7,285135
2461,0.02132,172.31.36.0-255,1114,137992,7,285135
2462,0.02145,172.31.36.0-255,1514,139506,7,285135
2463,0.021453,172.31.36.0-255,331,139837,7,285135
2464,0.022857,104.244.42.0-255,66,139903,7,285135
2465,0.022894,104.244.42.0-255,66,139969,7,285135
2466,0.023026,104.244.42.0-255,66,140035,7,285135
2467,0.02343,172.217.194.0-255,5738,145773,7,285135
2468,0.023438,172.31.36.0-255,66,145839,7,285135
2469,0.025773,172.217.194.0-255,5738,151577,7,285135
2470,0.025782,172.31.36.0-255,66,151643,7,285135
2471,0.028136,172.217.194.0-255,5738,157381,7,285135
2472,0.028143,172.31.36.0-255,66,157447,7,285135
2473,0.03047,172.217.194.0-255,5738,163185,7,285135
2474,0.03048,172.31.36.0-255,66,163251,7,285135
2475,0.032797,172.217.194.0-255,5738,168989,7,285135
2476,0.032805,172.31.36.0-255,66,169055,7,285135
2477,0.035151,172.217.194.0-255,5738,174793,7,285135
2478,0.035159,172.31.36.0-255,66,174859,7,285135
2479,0.037497,172.217.194.0-255,5738,180597,7,285135
2480,0.037504,172.31.36.0-255,66,180663,7,285135
2481,0.039849,172.217.194.0-255,5738,186401,7,285135
2482,0.039859,172.31.36.0-255,66,186467,7,285135
2483,0.042214,172.217.194.0-255,5738,192205,7,285135
2484,0.042221,172.31.36.0-255,66,192271,7,285135
2485,0.044571,172.217.194.0-255,5738,198009,7,285135
2486,0.044578,172.31.36.0-255,66,198075,7,285135
2487,0.046908,172.217.194.0-255,5738,203813,7,285135
2488,0.046914,172.31.36.0-255,66,203879,7,285135
2489,0.049251,172.217.194.0-255,5738,209617,7,285135
2490,0.049258,172.31.36.0-255,66,209683,7,285135
2491,0.051573,172.217.194.0-255,5738,215421,7,285135
2492,0.05158,172.31.36.0-255,66,215487,7,285135
2493,0.053926,172.217.194.0-255,5738,221225,7,285135
2494,0.053932,172.31.36.0-255,66,221291,7,285135
2495,0.056257,172.217.194.0-255,5738,227029,7,285135
2496,0.056263,172.31.36.0-255,66,227095,7,285135
2497,0.05861,172.217.194.0-255,5738,232833,7,285135
2498,0.058616,172.31.36.0-255,66,232899,7,285135
2499,0.060998,172.217.194.0-255,5738,238637,7,285135
2500,0.061005,172.31.36.0-255,66,238703,7,285135
2501,0.063375,172.217.194.0-255,5738,244441,7,285135
2502,0.063381,172.31.36.0-255,66,244507,7,285135
2503,0.065759,172.217.194.0-255,5738,250245,7,285135
2504,0.065766,172.31.36.0-255,66,250311,7,285135
2505,0.068113,172.217.194.0-255,5738,256049,7,285135
2506,0.06812,172.31.36.0-255,66,256115,7,285135
2507,0.070457,172.217.194.0-255,5738,261853,7,285135
2508,0.070464,172.31.36.0-255,66,261919,7,285135
2509,0.07279,172.217.194.0-255,5738,267657,7,285135
2510,0.072799,172.31.36.0-255,66,267723,7,285135
2511,0.075138,172.217.194.0-255,5738,273461,7,285135
2512,0.075145,172.31.36.0-255,66,273527,7,285135
2513,0.077475,172.217.194.0-255,5738,279265,7,285135
2514,0.077482,172.31.36.0-255,66,279331,7,285135
2515,0.079816,172.217.194.0-255,5738,285069,7,285135
2516,0.079822,172.31.36.0-255,66,285135,7,285135
2517,0.0,74.125.200.0-255,152,152,7,356329
2518,1.4e-05,172.31.36.0-255,66,218,7,356329
2519,2.1e-05,74.125.200.0-255,1484,1702,7,356329
2520,2.5e-05,172.31.36.0-255,66,1768,7,356329
2521,3.2e-05,74.125.200.0-255,2902,4670,7,356329
2522,4.5e-05,172.31.36.0-255,66,4736,7,356329
2523,6.8e-05,74.125.200.0-255,7156,11892,7,356329
2524,7.2e-05,172.31.36.0-255,66,11958,7,356329
2525,7.6e-05,74.125.200.0-255,2047,14005,7,356329
2526,7.8e-05,172.31.36.0-255,66,14071,7,356329
2527,8.3e-05,74.125.200.0-255,2902,16973,7,356329
2528,8.5e-05,172.31.36.0-255,66,17039,7,356329
2529,9.2e-05,74.125.200.0-255,7156,24195,7,356329
2530,9.5e-05,172.31.36.0-255,66,24261,7,356329
2531,0.000102,74.125.200.0-255,6797,31058,7,356329
2532,0.000106,172.31.36.0-255,66,31124,7,356329
2533,0.000181,74.125.200.0-255,1484,32608,7,356329
2534,0.000186,172.31.36.0-255,66,32674,7,356329
2535,0.000194,74.125.200.0-255,2902,35576,7,356329
2536,0.000197,172.31.36.0-255,66,35642,7,356329
2537,0.000208,74.125.200.0-255,4320,39962,7,356329
2538,0.000211,172.31.36.0-255,66,40028,7,356329
2539,0.000246,74.125.200.0-255,4320,44348,7,356329
2540,0.000256,172.31.36.0-255,66,44414,7,356329
2541,0.000284,74.125.200.0-255,5379,49793,7,356329
2542,0.000288,172.31.36.0-255,66,49859,7,356329
2543,0.000294,74.125.200.0-255,4320,54179,7,356329
2544,0.000296,172.31.36.0-255,66,54245,7,356329
2545,0.000355,172.31.36.0-255,66,54311,7,356329
2546,0.000359,74.125.200.0-255,114,54425,7,356329
2547,0.000361,172.31.36.0-255,66,54491,7,356329
2548,0.000638,74.125.200.0-255,1484,55975,7,356329
2549,0.000646,74.125.200.0-255,2902,58877,7,356329
2550,0.00065,172.31.36.0-255,66,58943,7,356329
2551,0.000655,74.125.200.0-255,2902,61845,7,356329
2552,0.000657,172.31.36.0-255,66,61911,7,356329
2553,0.000678,74.125.200.0-255,2902,64813,7,356329
2554,0.00068,172.31.36.0-255,66,64879,7,356329
2555,0.000693,74.125.200.0-255,6797,71676,7,356329
2556,0.000696,172.31.36.0-255,66,71742,7,356329
2557,0.000728,74.125.200.0-255,4320,76062,7,356329
2558,0.000732,172.31.36.0-255,66,76128,7,356329
2559,0.000739,74.125.200.0-255,5738,81866,7,356329
2560,0.000741,172.31.36.0-255,66,81932,7,356329
2561,0.000744,74.125.200.0-255,1484,83416,7,356329
2562,0.000791,172.31.36.0-255,66,83482,7,356329
2563,0.000799,74.125.200.0-255,4320,87802,7,356329
2564,0.000801,172.31.36.0-255,66,87868,7,356329
2565,0.000847,172.31.36.0-255,66,87934,7,356329
2566,0.001336,74.125.200.0-255,1484,89418,7,356329
2567,0.001342,74.125.200.0-255,1484,90902,7,356329
2568,0.001347,172.31.36.0-255,66,90968,7,356329
2569,0.001379,74.125.200.0-255,1484,92452,7,356329
2570,0.001386,74.125.200.0-255,5738,98190,7,356329
2571,0.001389,172.31.36.0-255,66,98256,7,356329
2572,0.001396,74.125.200.0-255,6797,105053,7,356329
2573,0.001398,172.31.36.0-255,66,105119,7,356329
2574,0.001427,74.125.200.0-255,7156,112275,7,356329
2575,0.001431,172.31.36.0-255,66,112341,7,356329
2576,0.001469,172.31.36.0-255,66,112407,7,356329
2577,0.001476,74.125.200.0-255,5738,118145,7,356329
2578,0.001479,172.31.36.0-255,66,118211,7,356329
2579,0.001524,172.31.36.0-255,66,118277,7,356329
2580,0.001529,74.125.200.0-255,3602,121879,7,356329
2581,0.001531,172.31.36.0-255,66,121945,7,356329
2582,0.001859,74.125.200.0-255,1484,123429,7,356329
2583,0.001863,74.125.200.0-255,1484,124913,7,356329
2584,0.001865,172.31.36.0-255,66,124979,7,356329
2585,0.001883,74.125.200.0-255,1484,126463,7,356329
2586,0.001888,74.125.200.0-255,4320,130783,7,356329
2587,0.00189,172.31.36.0-255,66,130849,7,356329
2588,0.001916,74.125.200.0-255,7156,138005,7,356329
2589,0.001919,172.31.36.0-255,66,138071,7,356329
2590,0.00194,74.125.200.0-255,1484,139555,7,356329
2591,0.001944,74.125.200.0-255,4320,143875,7,356329
2592,0.001948,74.125.200.0-255,5738,149613,7,356329
2593,0.001952,172.31.36.0-255,66,149679,7,356329
2594,0.001958,172.31.36.0-255,66,149745,7,356329
2595,0.001978,74.125.200.0-255,6438,156183,7,356329
2596,0.001986,172.31.36.0-255,66,156249,7,356329
2597,0.002121,74.125.200.0-255,1484,157733,7,356329
2598,0.002139,74.125.200.0-255,2902,160635,7,356329
2599,0.002142,172.31.36.0-255,66,160701,7,356329
2600,0.002167,74.125.200.0-255,5738,166439,7,356329
2601,0.002169,172.31.36.0-255,66,166505,7,356329
2602,0.002198,74.125.200.0-255,4320,170825,7,356329
2603,0.002201,74.125.200.0-255,2902,173727,7,356329
2604,0.002204,172.31.36.0-255,66,173793,7,356329
2605,0.002207,172.31.36.0-255,66,173859,7,356329
2606,0.002214,74.125.200.0-255,2902,176761,7,356329
2607,0.002216,172.31.36.0-255,66,176827,7,356329
2608,0.002242,74.125.200.0-255,7156,183983,7,356329
2609,0.002244,172.31.36.0-255,66,184049,7,356329
2610,0.002323,172.31.36.0-255,66,184115,7,356329
2611,0.002343,172.31.36.0-255,66,184181,7,356329
2612,0.002347,74.125.200.0-255,2902,187083,7,356329
2613,0.002348,172.31.36.0-255,66,187149,7,356329
2614,0.002357,74.125.200.0-255,4320,191469,7,356329
2615,0.002359,172.31.36.0-255,66,191535,7,356329
2616,0.002383,74.125.200.0-255,5738,197273,7,356329
2617,0.002386,172.31.36.0-255,66,197339,7,356329
2618,0.002406,74.125.200.0-255,2902,200241,7,356329
2619,0.002408,172.31.36.0-255,66,200307,7,356329
2620,0.002439,172.31.36.0-255,66,200373,7,356329
2621,0.002481,74.125.200.0-255,4320,204693,7,356329
2622,0.002484,172.31.36.0-255,66,204759,7,356329
2623,0.002506,74.125.200.0-255,4320,209079,7,356329
2624,0.002509,172.31.36.0-255,66,209145,7,356329
2625,0.002513,74.125.200.0-255,4320,213465,7,356329
2626,0.002515,172.31.36.0-255,66,213531,7,356329
2627,0.002545,74.125.200.0-255,5738,219269,7,356329
2628,0.002548,172.31.36.0-255,66,219335,7,356329
2629,0.00255,74.125.200.0-255,1484,220819,7,356329
2630,0.002554,74.125.200.0-255,2902,223721,7,356329
2631,0.002555,172.31.36.0-255,66,223787,7,356329
2632,0.002578,74.125.200.0-255,2902,226689,7,356329
2633,0.00258,172.31.36.0-255,66,226755,7,356329
2634,0.005093,74.125.200.0-255,1484,228239,7,356329
2635,0.005116,74.125.200.0-255,4320,232559,7,356329
2636,0.00512,172.31.36.0-255,66,232625,7,356329
2637,0.007694,74.125.200.0-255,5738,238363,7,356329
2638,0.007702,172.31.36.0-255,66,238429,7,356329
2639,0.010254,74.125.200.0-255,5738,244167,7,356329
2640,0.010261,172.31.36.0-255,66,244233,7,356329
2641,0.012811,74.125.200.0-255,5738,249971,7,356329
2642,0.012818,172.31.36.0-255,66,250037,7,356329
2643,0.015381,74.125.200.0-255,5738,255775,7,356329
2644,0.015388,172.31.36.0-255,66,255841,7,356329
2645,0.017949,74.125.200.0-255,5738,261579,7,356329
2646,0.017957,172.31.36.0-255,66,261645,7,356329
2647,0.020518,74.125.200.0-255,5738,267383,7,356329
2648,0.020525,172.31.36.0-255,66,267449,7,356329
2649,0.023088,74.125.200.0-255,5738,273187,7,356329
2650,0.023097,172.31.36.0-255,66,273253,7,356329
2651,0.02567,74.125.200.0-255,5738,278991,7,356329
2652,0.025679,172.31.36.0-255,66,279057,7,356329
2653,0.028234,74.125.200.0-255,5738,284795,7,356329
2654,0.028242,172.31.36.0-255,66,284861,7,356329
2655,0.029254,172.31.36.0-255,172,285033,7,356329
2656,0.029293,172.31.36.0-255,1113,286146,7,356329
2657,0.029376,172.31.36.0-255,1514,287660,7,356329
2658,0.029378,172.31.36.0-255,1514,289174,7,356329
2659,0.029379,172.31.36.0-255,1514,290688,7,356329
2660,0.029383,172.31.36.0-255,1514,292202,7,356329
2661,0.029393,172.31.36.0-255,1514,293716,7,356329
2662,0.029394,172.31.36.0-255,71,293787,7,356329
2663,0.030798,104.244.42.0-255,66,293853,7,356329
2664,0.030806,74.125.200.0-255,5738,299591,7,356329
2665,0.03081,172.31.36.0-255,66,299657,7,356329
2666,0.030857,104.244.42.0-255,66,299723,7,356329
2667,0.030956,104.244.42.0-255,66,299789,7,356329
2668,0.030961,104.244.42.0-255,66,299855,7,356329
2669,0.033376,74.125.200.0-255,5738,305593,7,356329
2670,0.033385,172.31.36.0-255,66,305659,7,356329
2671,0.035962,74.125.200.0-255,5738,311397,7,356329
2672,0.035974,172.31.36.0-255,66,311463,7,356329
2673,0.038531,74.125.200.0-255,5738,317201,7,356329
2674,0.038536,172.31.36.0-255,66,317267,7,356329
2675,0.041092,74.125.200.0-255,5738,323005,7,356329
2676,0.041098,172.31.36.0-255,66,323071,7,356329
2677,0.043652,74.125.200.0-255,5738,328809,7,356329
2678,0.043657,172.31.36.0-255,66,328875,7,356329
2679,0.046207,74.125.200.0-255,5738,334613,7,356329
2680,0.046227,172.31.36.0-255,66,334679,7,356329
2681,0.048777,74.125.200.0-255,5738,340417,7,356329
2682,0.048793,172.31.36.0-255,66,340483,7,356329
2683,0.051353,74.125.200.0-255,5738,346221,7,356329
2684,0.05136,172.31.36.0-255,66,346287,7,356329
2685,0.053924,74.125.200.0-255,4320,350607,7,356329
2686,0.053933,172.31.36.0-255,66,350673,7,356329
2687,0.053969,74.125.200.0-255,1484,352157,7,356329
2688,0.056541,74.125.200.0-255,1484,353641,7,356329
2689,0.056546,172.31.36.0-255,66,353707,7,356329
2690,0.056581,74.125.200.0-255,2385,356092,7,356329
2691,0.056585,172.31.36.0-255,66,356158,7,356329
2692,0.056743,172.31.36.0-255,105,356263,7,356329
2693,0.05926,74.125.200.0-255,66,356329,7,356329
2694,0.0,172.217.194.0-255,143,143,7,235038
2695,1.5e-05,172.31.36.0-255,66,209,7,235038
2696,2.1e-05,172.217.194.0-255,1484,1693,7,235038
2697,2.5e-05,172.31.36.0-255,66,1759,7,235038
2698,3.1e-05,172.217.194.0-255,2902,4661,7,235038
2699,3.9e-05,172.31.36.0-255,66,4727,7,235038
2700,4.8e-05,172.217.194.0-255,7156,11883,7,235038
2701,5.1e-05,172.31.36.0-255,66,11949,7,235038
2702,5.5e-05,172.217.194.0-255,2072,14021,7,235038
2703,5.8e-05,172.31.36.0-255,66,14087,7,235038
2704,0.000168,172.217.194.0-255,1484,15571,7,235038
2705,0.000172,172.31.36.0-255,66,15637,7,235038
2706,0.000179,172.217.194.0-255,2902,18539,7,235038
2707,0.000181,172.31.36.0-255,66,18605,7,235038
2708,0.000211,172.217.194.0-255,5738,24343,7,235038
2709,0.000215,172.31.36.0-255,66,24409,7,235038
2710,0.000222,172.217.194.0-255,6797,31206,7,235038
2711,0.000225,172.31.36.0-255,66,31272,7,235038
2712,0.000267,172.31.36.0-255,66,31338,7,235038
2713,0.00028,172.31.36.0-255,66,31404,7,235038
2714,0.000332,172.31.36.0-255,66,31470,7,235038
2715,0.000335,172.217.194.0-255,114,31584,7,235038
2716,0.000337,172.31.36.0-255,66,31650,7,235038
2717,0.00034,172.217.194.0-255,382,32032,7,235038
2718,0.000342,172.31.36.0-255,66,32098,7,235038
2719,0.000691,172.217.194.0-255,1484,33582,7,235038
2720,0.000696,172.31.36.0-255,66,33648,7,235038
2721,0.000703,172.217.194.0-255,2902,36550,7,235038
2722,0.000705,172.31.36.0-255,66,36616,7,235038
2723,0.000711,172.217.194.0-255,5738,42354,7,235038
2724,0.00072,172.31.36.0-255,66,42420,7,235038
2725,0.000723,172.217.194.0-255,1484,43904,7,235038
2726,0.000735,172.31.36.0-255,66,43970,7,235038
2727,0.000776,172.217.194.0-255,7156,51126,7,235038
2728,0.000781,172.31.36.0-255,66,51192,7,235038
2729,0.000804,172.217.194.0-255,6438,57630,7,235038
2730,0.00081,172.31.36.0-255,66,57696,7,235038
2731,0.001109,172.217.194.0-255,1484,59180,7,235038
2732,0.001115,172.217.194.0-255,2902,62082,7,235038
2733,0.001119,172.31.36.0-255,66,62148,7,235038
2734,0.001126,172.217.194.0-255,5738,67886,7,235038
2735,0.001128,172.31.36.0-255,66,67952,7,235038
2736,0.001167,172.31.36.0-255,66,68018,7,235038
2737,0.001173,172.217.194.0-255,4320,72338,7,235038
2738,0.001175,172.31.36.0-255,66,72404,7,235038
2739,0.001202,172.217.194.0-255,6438,78842,7,235038
2740,0.001205,172.31.36.0-255,66,78908,7,235038
2741,0.001366,172.217.194.0-255,1484,80392,7,235038
2742,0.001372,172.217.194.0-255,2902,83294,7,235038
2743,0.001375,172.31.36.0-255,66,83360,7,235038
2744,0.00138,172.217.194.0-255,1484,84844,7,235038
2745,0.001408,172.217.194.0-255,4320,89164,7,235038
2746,0.00141,172.31.36.0-255,66,89230,7,235038
2747,0.001425,172.31.36.0-255,66,89296,7,235038
2748,0.001433,172.217.194.0-255,7156,96452,7,235038
2749,0.001435,172.31.36.0-255,66,96518,7,235038
2750,0.001459,172.217.194.0-255,3602,100120,7,235038
2751,0.001462,172.31.36.0-255,66,100186,7,235038
2752,0.001486,172.217.194.0-255,1484,101670,7,235038
2753,0.001491,172.217.194.0-255,2902,104572,7,235038
2754,0.001496,172.31.36.0-255,66,104638,7,235038
2755,0.001517,172.217.194.0-255,5738,110376,7,235038
2756,0.00152,172.31.36.0-255,66,110442,7,235038
2757,0.001526,172.217.194.0-255,4320,114762,7,235038
2758,0.001528,172.31.36.0-255,66,114828,7,235038
2759,0.001571,172.31.36.0-255,66,114894,7,235038
2760,0.001578,172.217.194.0-255,5738,120632,7,235038
2761,0.00158,172.31.36.0-255,66,120698,7,235038
2762,0.001602,172.217.194.0-255,5020,125718,7,235038
2763,0.001609,172.31.36.0-255,66,125784,7,235038
2764,0.001652,172.217.194.0-255,1484,127268,7,235038
2765,0.001669,172.217.194.0-255,2902,130170,7,235038
2766,0.001672,172.31.36.0-255,66,130236,7,235038
2767,0.001678,172.217.194.0-255,4320,134556,7,235038
2768,0.001681,172.31.36.0-255,66,134622,7,235038
2769,0.001711,172.217.194.0-255,1484,136106,7,235038
2770,0.001727,172.31.36.0-255,66,136172,7,235038
2771,0.001761,172.31.36.0-255,66,136238,7,235038
2772,0.001785,172.217.194.0-255,1484,137722,7,235038
2773,0.001847,172.217.194.0-255,2902,140624,7,235038
2774,0.001852,172.217.194.0-255,5738,146362,7,235038
2775,0.001872,172.31.36.0-255,66,146428,7,235038
2776,0.001876,172.31.36.0-255,66,146494,7,235038
2777,0.001879,172.31.36.0-255,66,146560,7,235038
2778,0.001906,172.31.36.0-255,66,146626,7,235038
2779,0.002315,172.217.194.0-255,1484,148110,7,235038
2780,0.002322,172.217.194.0-255,2902,151012,7,235038
2781,0.002325,172.31.36.0-255,66,151078,7,235038
2782,0.002331,172.217.194.0-255,2902,153980,7,235038
2783,0.002333,172.31.36.0-255,66,154046,7,235038
2784,0.002363,172.217.194.0-255,2902,156948,7,235038
2785,0.002365,172.31.36.0-255,66,157014,7,235038
2786,0.002373,172.217.194.0-255,5738,162752,7,235038
2787,0.002375,172.31.36.0-255,66,162818,7,235038
2788,0.002412,172.217.194.0-255,7156,169974,7,235038
2789,0.002415,172.31.36.0-255,66,170040,7,235038
2790,0.002428,172.31.36.0-255,66,170106,7,235038
2791,0.002457,172.217.194.0-255,7156,177262,7,235038
2792,0.00246,172.31.36.0-255,66,177328,7,235038
2793,0.002463,172.217.194.0-255,1484,178812,7,235038
2794,0.002466,172.217.194.0-255,1484,180296,7,235038
2795,0.002468,172.31.36.0-255,66,180362,7,235038
2796,0.002494,172.217.194.0-255,4320,184682,7,235038
2797,0.002496,172.31.36.0-255,66,184748,7,235038
2798,0.002503,172.217.194.0-255,4320,189068,7,235038
2799,0.002506,172.31.36.0-255,66,189134,7,235038
2800,0.002512,172.217.194.0-255,5738,194872,7,235038
2801,0.002514,172.31.36.0-255,66,194938,7,235038
2802,0.002541,172.217.194.0-255,4320,199258,7,235038
2803,0.002544,172.31.36.0-255,66,199324,7,235038
2804,0.00255,172.217.194.0-255,5020,204344,7,235038
2805,0.002553,172.31.36.0-255,66,204410,7,235038
2806,0.002582,172.217.194.0-255,1484,205894,7,235038
2807,0.002587,172.217.194.0-255,2902,208796,7,235038
2808,0.00259,172.31.36.0-255,66,208862,7,235038
2809,0.002615,172.217.194.0-255,2902,211764,7,235038
2810,0.002619,172.31.36.0-255,66,211830,7,235038
2811,0.002629,172.31.36.0-255,66,211896,7,235038
2812,0.002655,172.217.194.0-255,1484,213380,7,235038
2813,0.002672,172.31.36.0-255,66,213446,7,235038
2814,0.002702,172.217.194.0-255,766,214212,7,235038
2815,0.002708,172.217.194.0-255,2902,217114,7,235038
2816,0.00271,172.31.36.0-255,66,217180,7,235038
2817,0.002717,172.217.194.0-255,4320,221500,7,235038
2818,0.00272,172.31.36.0-255,66,221566,7,235038
2819,0.002727,172.217.194.0-255,7156,228722,7,235038
2820,0.00273,172.31.36.0-255,66,228788,7,235038
2821,0.002758,172.217.194.0-255,1484,230272,7,235038
2822,0.002776,172.31.36.0-255,66,230338,7,235038
2823,0.002818,172.31.36.0-255,66,230404,7,235038
2824,0.002821,172.217.194.0-255,105,230509,7,235038
2825,0.010771,172.31.36.0-255,66,230575,7,235038
2826,0.010811,172.31.36.0-255,105,230680,7,235038
2827,0.013066,172.217.194.0-255,66,230746,7,235038
2828,0.030549,172.31.36.0-255,172,230918,7,235038
2829,0.030579,172.31.36.0-255,1114,232032,7,235038
2830,0.03064,172.31.36.0-255,1514,233546,7,235038
2831,0.030663,172.31.36.0-255,1294,234840,7,235038
2832,0.032042,104.244.42.0-255,66,234906,7,235038
2833,0.03208,104.244.42.0-255,66,234972,7,235038
2834,0.032156,104.244.42.0-255,66,235038,7,235038
2835,0.0,74.125.24.0-255,150,150,7,390348
2836,2.4e-05,172.31.36.0-255,66,216,7,390348
2837,3.2e-05,74.125.24.0-255,1484,1700,7,390348
2838,3.6e-05,172.31.36.0-255,66,1766,7,390348
2839,5.2e-05,74.125.24.0-255,2902,4668,7,390348
2840,5.7e-05,172.31.36.0-255,66,4734,7,390348
2841,6.5e-05,74.125.24.0-255,7156,11890,7,390348
2842,6.8e-05,172.31.36.0-255,66,11956,7,390348
2843,7.2e-05,74.125.24.0-255,2063,14019,7,390348
2844,7.5e-05,172.31.36.0-255,66,14085,7,390348
2845,0.000118,74.125.24.0-255,1484,15569,7,390348
2846,0.00012,172.31.36.0-255,66,15635,7,390348
2847,0.000126,74.125.24.0-255,2902,18537,7,390348
2848,0.000128,172.31.36.0-255,66,18603,7,390348
2849,0.000134,74.125.24.0-255,5738,24341,7,390348
2850,0.000137,172.31.36.0-255,66,24407,7,390348
2851,0.000166,74.125.24.0-255,6797,31204,7,390348
2852,0.000169,172.31.36.0-255,66,31270,7,390348
2853,0.000213,74.125.24.0-255,1484,32754,7,390348
2854,0.000216,172.31.36.0-255,66,32820,7,390348
2855,0.000221,74.125.24.0-255,2902,35722,7,390348
2856,0.000223,172.31.36.0-255,66,35788,7,390348
2857,0.000228,74.125.24.0-255,2902,38690,7,390348
2858,0.00023,172.31.36.0-255,66,38756,7,390348
2859,0.000256,74.125.24.0-255,2902,41658,7,390348
2860,0.000259,172.31.36.0-255,66,41724,7,390348
2861,0.000285,74.125.24.0-255,4320,46044,7,390348
2862,0.000288,172.31.36.0-255,66,46110,7,390348
2863,0.000314,74.125.24.0-255,2543,48653,7,390348
2864,0.000318,172.31.36.0-255,66,48719,7,390348
2865,0.000841,74.125.24.0-255,1484,50203,7,390348
2866,0.000847,172.31.36.0-255,66,50269,7,390348
2867,0.000853,74.125.24.0-255,2902,53171,7,390348
2868,0.000856,172.31.36.0-255,66,53237,7,390348
2869,0.000868,74.125.24.0-255,5738,58975,7,390348
2870,0.00087,172.31.36.0-255,66,59041,7,390348
2871,0.000876,74.125.24.0-255,5738,64779,7,390348
2872,0.000878,172.31.36.0-255,66,64845,7,390348
2873,0.00091,74.125.24.0-255,1125,65970,7,390348
2874,0.000937,74.125.24.0-255,1484,67454,7,390348
2875,0.00094,172.31.36.0-255,66,67520,7,390348
2876,0.000944,74.125.24.0-255,1484,69004,7,390348
2877,0.000969,74.125.24.0-255,2902,71906,7,390348
2878,0.000973,172.31.36.0-255,66,71972,7,390348
2879,0.000978,74.125.24.0-255,4320,76292,7,390348
2880,0.000981,172.31.36.0-255,66,76358,7,390348
2881,0.000986,74.125.24.0-255,2902,79260,7,390348
2882,0.000988,172.31.36.0-255,66,79326,7,390348
2883,0.001013,74.125.24.0-255,2902,82228,7,390348
2884,0.001016,172.31.36.0-255,66,82294,7,390348
2885,0.001029,172.31.36.0-255,66,82360,7,390348
2886,0.001072,74.125.24.0-255,6797,89157,7,390348
2887,0.001076,172.31.36.0-255,66,89223,7,390348
2888,0.001189,74.125.24.0-255,646,89869,7,390348
2889,0.001289,74.125.24.0-255,1484,91353,7,390348
2890,0.001292,172.31.36.0-255,66,91419,7,390348
2891,0.001296,74.125.24.0-255,1484,92903,7,390348
2892,0.001318,74.125.24.0-255,1484,94387,7,390348
2893,0.001321,172.31.36.0-255,66,94453,7,390348
2894,0.001328,74.125.24.0-255,5738,100191,7,390348
2895,0.001331,172.31.36.0-255,66,100257,7,390348
2896,0.001354,74.125.24.0-255,4320,104577,7,390348
2897,0.001357,172.31.36.0-255,66,104643,7,390348
2898,0.001362,74.125.24.0-255,1994,106637,7,390348
2899,0.001364,172.31.36.0-255,66,106703,7,390348
2900,0.001502,74.125.24.0-255,1484,108187,7,390348
2901,0.001509,74.125.24.0-255,2902,111089,7,390348
2902,0.001511,172.31.36.0-255,66,111155,7,390348
2903,0.00154,74.125.24.0-255,5738,116893,7,390348
2904,0.001543,172.31.36.0-255,66,116959,7,390348
2905,0.001568,74.125.24.0-255,5738,122697,7,390348
2906,0.001571,172.31.36.0-255,66,122763,7,390348
2907,0.001608,74.125.24.0-255,7156,129919,7,390348
2908,0.001611,172.31.36.0-255,66,129985,7,390348
2909,0.001616,74.125.24.0-255,2902,132887,7,390348
2910,0.001618,172.31.36.0-255,66,132953,7,390348
2911,0.001635,74.125.24.0-255,1484,134437,7,390348
2912,0.001647,74.125.24.0-255,6438,140875,7,390348
2913,0.00165,172.31.36.0-255,66,140941,7,390348
2914,0.001687,74.125.24.0-255,2902,143843,7,390348
2915,0.00169,172.31.36.0-255,66,143909,7,390348
2916,0.001693,74.125.24.0-255,1484,145393,7,390348
2917,0.001717,74.125.24.0-255,2902,148295,7,390348
2918,0.00172,172.31.36.0-255,66,148361,7,390348
2919,0.001735,172.31.36.0-255,66,148427,7,390348
2920,0.001758,74.125.24.0-255,2902,151329,7,390348
2921,0.00176,172.31.36.0-255,66,151395,7,390348
2922,0.001799,74.125.24.0-255,1484,152879,7,390348
2923,0.00183,172.31.36.0-255,66,152945,7,390348
2924,0.001848,74.125.24.0-255,2184,155129,7,390348
2925,0.001851,172.31.36.0-255,66,155195,7,390348
2926,0.001855,74.125.24.0-255,2902,158097,7,390348
2927,0.001858,172.31.36.0-255,66,158163,7,390348
2928,0.001904,74.125.24.0-255,7156,165319,7,390348
2929,0.001908,172.31.36.0-255,66,165385,7,390348
2930,0.001915,74.125.24.0-255,7156,172541,7,390348
2931,0.001953,172.31.36.0-255,66,172607,7,390348
2932,0.001984,74.125.24.0-255,2902,175509,7,390348
2933,0.001996,172.31.36.0-255,66,175575,7,390348
2934,0.002,74.125.24.0-255,2902,178477,7,390348
2935,0.002005,172.31.36.0-255,66,178543,7,390348
2936,0.00202,74.125.24.0-255,2184,180727,7,390348
2937,0.002044,172.31.36.0-255,66,180793,7,390348
2938,0.004078,74.125.24.0-255,2902,183695,7,390348
2939,0.004086,172.31.36.0-255,66,183761,7,390348
2940,0.004109,74.125.24.0-255,2902,186663,7,390348
2941,0.004111,172.31.36.0-255,66,186729,7,390348
2942,0.006174,74.125.24.0-255,5738,192467,7,390348
2943,0.006177,172.31.36.0-255,66,192533,7,390348
2944,0.008209,74.125.24.0-255,4320,196853,7,390348
2945,0.008216,172.31.36.0-255,66,196919,7,390348
2946,0.008248,74.125.24.0-255,1484,198403,7,390348
2947,0.010259,74.125.24.0-255,4320,202723,7,390348
2948,0.010267,172.31.36.0-255,66,202789,7,390348
2949,0.012305,74.125.24.0-255,5738,208527,7,390348
2950,0.012315,172.31.36.0-255,66,208593,7,390348
2951,0.014364,74.125.24.0-255,5738,214331,7,390348
2952,0.014375,172.31.36.0-255,66,214397,7,390348
2953,0.016427,74.125.24.0-255,5738,220135,7,390348
2954,0.016436,172.31.36.0-255,66,220201,7,390348
2955,0.018523,74.125.24.0-255,5738,225939,7,390348
2956,0.018531,172.31.36.0-255,66,226005,7,390348
2957,0.020639,74.125.24.0-255,2902,228907,7,390348
2958,0.020645,172.31.36.0-255,66,228973,7,390348
2959,0.020673,74.125.24.0-255,2902,231875,7,390348
2960,0.020676,172.31.36.0-255,66,231941,7,390348
2961,0.022719,74.125.24.0-255,5738,237679,7,390348
2962,0.022725,172.31.36.0-255,66,237745,7,390348
2963,0.024799,74.125.24.0-255,5738,243483,7,390348
2964,0.024807,172.31.36.0-255,66,243549,7,390348
2965,0.026871,74.125.24.0-255,5738,249287,7,390348
2966,0.026877,172.31.36.0-255,66,249353,7,390348
2967,0.028977,74.125.24.0-255,5738,255091,7,390348
2968,0.028985,172.31.36.0-255,66,255157,7,390348
2969,0.031059,74.125.24.0-255,5738,260895,7,390348
2970,0.031068,172.31.36.0-255,66,260961,7,390348
2971,0.033147,74.125.24.0-255,5738,266699,7,390348
2972,0.033153,172.31.36.0-255,66,266765,7,390348
2973,0.034079,172.31.36.0-255,172,266937,7,390348
2974,0.034115,172.31.36.0-255,1113,268050,7,390348
2975,0.034184,172.31.36.0-255,1514,269564,7,390348
2976,0.034186,172.31.36.0-255,1514,271078,7,390348
2977,0.034187,172.31.36.0-255,1514,272592,7,390348
2978,0.034194,172.31.36.0-255,1514,274106,7,390348
2979,0.034217,172.31.36.0-255,1514,275620,7,390348
2980,0.034218,172.31.36.0-255,72,275692,7,390348
2981,0.035261,74.125.24.0-255,5738,281430,7,390348
2982,0.035268,172.31.36.0-255,66,281496,7,390348
2983,0.03565,104.244.42.0-255,66,281562,7,390348
2984,0.035659,104.244.42.0-255,66,281628,7,390348
2985,0.035766,104.244.42.0-255,66,281694,7,390348
2986,0.035772,104.244.42.0-255,66,281760,7,390348
2987,0.037346,74.125.24.0-255,5738,287498,7,390348
2988,0.037353,172.31.36.0-255,66,287564,7,390348
2989,0.039407,74.125.24.0-255,5738,293302,7,390348
2990,0.039417,172.31.36.0-255,66,293368,7,390348
2991,0.041468,74.125.24.0-255,5738,299106,7,390348
2992,0.041475,172.31.36.0-255,66,299172,7,390348
2993,0.043552,74.125.24.0-255,5738,304910,7,390348
2994,0.043559,172.31.36.0-255,66,304976,7,390348
2995,0.045624,74.125.24.0-255,5738,310714,7,390348
2996,0.045631,172.31.36.0-255,66,310780,7,390348
2997,0.047705,74.125.24.0-255,5738,316518,7,390348
2998,0.047715,172.31.36.0-255,66,316584,7,390348
2999,0.049823,74.125.24.0-255,5738,322322,7,390348
3000,0.049829,172.31.36.0-255,66,322388,7,390348
3001,0.051912,74.125.24.0-255,5738,328126,7,390348
3002,0.051917,172.31.36.0-255,66,328192,7,390348
3003,0.053963,74.125.24.0-255,5738,333930,7,390348
3004,0.053969,172.31.36.0-255,66,333996,7,390348
3005,0.056052,74.125.24.0-255,5738,339734,7,390348
3006,0.056059,172.31.36.0-255,66,339800,7,390348
3007,0.058117,74.125.24.0-255,5738,345538,7,390348
3008,0.058123,172.31.36.0-255,66,345604,7,390348
3009,0.060169,74.125.24.0-255,5738,351342,7,390348
3010,0.060177,172.31.36.0-255,66,351408,7,390348
3011,0.062237,74.125.24.0-255,5738,357146,7,390348
3012,0.062244,172.31.36.0-255,66,357212,7,390348
3013,0.064334,74.125.24.0-255,5738,362950,7,390348
3014,0.064341,172.31.36.0-255,66,363016,7,390348
3015,0.066405,74.125.24.0-255,5738,368754,7,390348
3016,0.066412,172.31.36.0-255,66,368820,7,390348
3017,0.068444,74.125.24.0-255,5738,374558,7,390348
3018,0.068451,172.31.36.0-255,66,374624,7,390348
3019,0.070505,74.125.24.0-255,5738,380362,7,390348
3020,0.070512,172.31.36.0-255,66,380428,7,390348
3021,0.072567,74.125.24.0-255,5738,386166,7,390348
3022,0.072574,172.31.36.0-255,66,386232,7,390348
3023,0.074646,74.125.24.0-255,3879,390111,7,390348
3024,0.074653,172.31.36.0-255,66,390177,7,390348
3025,0.074861,172.31.36.0-255,105,390282,7,390348
3026,0.076956,74.125.24.0-255,66,390348,7,390348
3027,0.0,172.31.36.0-255,105,105,7,459
3028,0.000175,172.31.36.0-255,90,195,7,459
3029,0.000184,172.31.36.0-255,66,261,7,459
3030,0.002492,74.125.24.0-255,66,327,7,459
3031,0.002519,74.125.24.0-255,66,393,7,459
3032,0.002538,172.31.36.0-255,66,459,7,459
3033,0.0,172.217.194.0-255,153,153,7,328756
3034,1.9e-05,172.31.36.0-255,66,219,7,328756
3035,2.6e-05,172.217.194.0-255,1484,1703,7,328756
3036,3.1e-05,172.31.36.0-255,66,1769,7,328756
3037,3.8e-05,172.217.194.0-255,2902,4671,7,328756
3038,4.1e-05,172.31.36.0-255,66,4737,7,328756
3039,4.9e-05,172.217.194.0-255,7156,11893,7,328756
3040,5.1e-05,172.31.36.0-255,66,11959,7,328756
3041,7e-05,172.217.194.0-255,2902,14861,7,328756
3042,7.4e-05,172.31.36.0-255,66,14927,7,328756
3043,0.000104,172.31.36.0-255,66,14993,7,328756
3044,0.000111,172.217.194.0-255,6797,21790,7,328756
3045,0.000114,172.31.36.0-255,66,21856,7,328756
3046,0.000121,172.217.194.0-255,7156,29012,7,328756
3047,0.000124,172.31.36.0-255,66,29078,7,328756
3048,0.000156,172.217.194.0-255,2902,31980,7,328756
3049,0.000158,172.31.36.0-255,66,32046,7,328756
3050,0.00018,172.217.194.0-255,6797,38843,7,328756
3051,0.000182,172.31.36.0-255,66,38909,7,328756
3052,0.000609,172.217.194.0-255,1484,40393,7,328756
3053,0.000615,172.31.36.0-255,66,40459,7,328756
3054,0.000621,172.217.194.0-255,2902,43361,7,328756
3055,0.000624,172.31.36.0-255,66,43427,7,328756
3056,0.000651,172.217.194.0-255,5738,49165,7,328756
3057,0.000655,172.31.36.0-255,66,49231,7,328756
3058,0.000681,172.217.194.0-255,6797,56028,7,328756
3059,0.000684,172.31.36.0-255,66,56094,7,328756
3060,0.000719,172.217.194.0-255,1484,57578,7,328756
3061,0.000722,172.31.36.0-255,66,57644,7,328756
3062,0.000727,172.217.194.0-255,2902,60546,7,328756
3063,0.000729,172.31.36.0-255,66,60612,7,328756
3064,0.000736,172.217.194.0-255,4320,64932,7,328756
3065,0.000738,172.31.36.0-255,66,64998,7,328756
3066,0.000763,172.217.194.0-255,1484,66482,7,328756
3067,0.00078,172.31.36.0-255,66,66548,7,328756
3068,0.000788,172.217.194.0-255,7156,73704,7,328756
3069,0.00079,172.31.36.0-255,66,73770,7,328756
3070,0.000803,172.217.194.0-255,2902,76672,7,328756
3071,0.000804,172.217.194.0-255,288,76960,7,328756
3072,0.000808,172.31.36.0-255,66,77026,7,328756
3073,0.000894,172.217.194.0-255,1484,78510,7,328756
3074,0.000898,172.31.36.0-255,66,78576,7,328756
3075,0.00092,172.217.194.0-255,2902,81478,7,328756
3076,0.000923,172.31.36.0-255,66,81544,7,328756
3077,0.000929,172.217.194.0-255,5738,87282,7,328756
3078,0.000932,172.31.36.0-255,66,87348,7,328756
3079,0.000943,172.217.194.0-255,1484,88832,7,328756
3080,0.000969,172.31.36.0-255,66,88898,7,328756
3081,0.000974,172.217.194.0-255,2902,91800,7,328756
3082,0.000975,172.31.36.0-255,66,91866,7,328756
3083,0.000996,172.31.36.0-255,66,91932,7,328756
3084,0.00102,172.217.194.0-255,1484,93416,7,328756
3085,0.001034,172.217.194.0-255,2902,96318,7,328756
3086,0.001037,172.31.36.0-255,66,96384,7,328756
3087,0.001041,172.217.194.0-255,2902,99286,7,328756
3088,0.001044,172.31.36.0-255,66,99352,7,328756
3089,0.001057,172.217.194.0-255,2902,102254,7,328756
3090,0.001059,172.31.36.0-255,66,102320,7,328756
3091,0.001066,172.217.194.0-255,7156,109476,7,328756
3092,0.001069,172.31.36.0-255,66,109542,7,328756
3093,0.001099,172.217.194.0-255,4320,113862,7,328756
3094,0.001102,172.31.36.0-255,66,113928,7,328756
3095,0.001109,172.217.194.0-255,5738,119666,7,328756
3096,0.001111,172.31.36.0-255,66,119732,7,328756
3097,0.001141,172.217.194.0-255,6438,126170,7,328756
3098,0.001144,172.31.36.0-255,66,126236,7,328756
3099,0.001773,172.217.194.0-255,1484,127720,7,328756
3100,0.001781,172.217.194.0-255,2902,130622,7,328756
3101,0.001785,172.31.36.0-255,66,130688,7,328756
3102,0.00181,172.217.194.0-255,5738,136426,7,328756
3103,0.001813,172.31.36.0-255,66,136492,7,328756
3104,0.001818,172.217.194.0-255,4320,140812,7,328756
3105,0.001821,172.31.36.0-255,66,140878,7,328756
3106,0.001842,172.31.36.0-255,66,140944,7,328756
3107,0.001855,172.31.36.0-255,66,141010,7,328756
3108,0.001908,172.217.194.0-255,1484,142494,7,328756
3109,0.001913,172.217.194.0-255,2902,145396,7,328756
3110,0.001915,172.31.36.0-255,66,145462,7,328756
3111,0.001921,172.217.194.0-255,5738,151200,7,328756
3112,0.001923,172.31.36.0-255,66,151266,7,328756
3113,0.001964,172.31.36.0-255,66,151332,7,328756
3114,0.001981,172.217.194.0-255,1484,152816,7,328756
3115,0.00202,172.217.194.0-255,5738,158554,7,328756
3116,0.002024,172.31.36.0-255,66,158620,7,328756
3117,0.002031,172.31.36.0-255,66,158686,7,328756
3118,0.002049,172.31.36.0-255,66,158752,7,328756
3119,0.002072,172.217.194.0-255,2902,161654,7,328756
3120,0.002074,172.31.36.0-255,66,161720,7,328756
3121,0.002081,172.217.194.0-255,6438,168158,7,328756
3122,0.002083,172.31.36.0-255,66,168224,7,328756
3123,0.004087,172.217.194.0-255,5738,173962,7,328756
3124,0.004093,172.31.36.0-255,66,174028,7,328756
3125,0.006077,172.217.194.0-255,2902,176930,7,328756
3126,0.006082,172.31.36.0-255,66,176996,7,328756
3127,0.006099,172.217.194.0-255,2902,179898,7,328756
3128,0.006101,172.31.36.0-255,66,179964,7,328756
3129,0.008108,172.217.194.0-255,2902,182866,7,328756
3130,0.008116,172.31.36.0-255,66,182932,7,328756
3131,0.008138,172.217.194.0-255,2902,185834,7,328756
3132,0.008141,172.31.36.0-255,66,185900,7,328756
3133,0.010134,172.217.194.0-255,5738,191638,7,328756
3134,0.01014,172.31.36.0-255,66,191704,7,328756
3135,0.012162,172.217.194.0-255,5738,197442,7,328756
3136,0.01217,172.31.36.0-255,66,197508,7,328756
3137,0.014173,172.217.194.0-255,5738,203246,7,328756
3138,0.014182,172.31.36.0-255,66,203312,7,328756
3139,0.016194,172.217.194.0-255,5738,209050,7,328756
3140,0.016201,172.31.36.0-255,66,209116,7,328756
3141,0.018231,172.217.194.0-255,5738,214854,7,328756
3142,0.018241,172.31.36.0-255,66,214920,7,328756
3143,0.020261,172.217.194.0-255,5738,220658,7,328756
3144,0.02027,172.31.36.0-255,66,220724,7,328756
3145,0.022274,172.217.194.0-255,5738,226462,7,328756
3146,0.022281,172.31.36.0-255,66,226528,7,328756
3147,0.024298,172.217.194.0-255,5738,232266,7,328756
3148,0.024305,172.31.36.0-255,66,232332,7,328756
3149,0.026329,172.217.194.0-255,4320,236652,7,328756
3150,0.026335,172.31.36.0-255,66,236718,7,328756
3151,0.026356,172.217.194.0-255,1484,238202,7,328756
3152,0.028353,172.217.194.0-255,4320,242522,7,328756
3153,0.028361,172.31.36.0-255,66,242588,7,328756
3154,0.03035,172.217.194.0-255,5738,248326,7,328756
3155,0.030356,172.31.36.0-255,66,248392,7,328756
3156,0.031916,172.31.36.0-255,188,248580,7,328756
3157,0.03195,172.31.36.0-255,958,249538,7,328756
3158,0.032012,172.31.36.0-255,1514,251052,7,328756
3159,0.032013,172.31.36.0-255,1448,252500,7,328756
3160,0.03238,172.217.194.0-255,5738,258238,7,328756
3161,0.032386,172.31.36.0-255,66,258304,7,328756
3162,0.033529,104.244.42.0-255,66,258370,7,328756
3163,0.033564,104.244.42.0-255,66,258436,7,328756
3164,0.033591,104.244.42.0-255,66,258502,7,328756
3165,0.034394,172.217.194.0-255,5738,264240,7,328756
3166,0.0344,172.31.36.0-255,66,264306,7,328756
3167,0.034615,104.244.42.0-255,108,264414,7,328756
3168,0.034621,172.31.36.0-255,66,264480,7,328756
3169,0.036431,172.217.194.0-255,5738,270218,7,328756
3170,0.036437,172.31.36.0-255,66,270284,7,328756
3171,0.038432,172.217.194.0-255,5738,276022,7,328756
3172,0.038439,172.31.36.0-255,66,276088,7,328756
3173,0.040449,172.217.194.0-255,5738,281826,7,328756
3174,0.040456,172.31.36.0-255,66,281892,7,328756
3175,0.042483,172.217.194.0-255,5738,287630,7,328756
3176,0.042488,172.31.36.0-255,66,287696,7,328756
3177,0.044555,172.217.194.0-255,5738,293434,7,328756
3178,0.044562,172.31.36.0-255,66,293500,7,328756
3179,0.046563,172.217.194.0-255,5738,299238,7,328756
3180,0.04657,172.31.36.0-255,66,299304,7,328756
3181,0.048618,172.217.194.0-255,5738,305042,7,328756
3182,0.048625,172.31.36.0-255,66,305108,7,328756
3183,0.050621,172.217.194.0-255,5738,310846,7,328756
3184,0.050627,172.31.36.0-255,66,310912,7,328756
3185,0.052651,172.217.194.0-255,5738,316650,7,328756
3186,0.052657,172.31.36.0-255,66,316716,7,328756
3187,0.054673,172.217.194.0-255,5738,322454,7,328756
3188,0.05468,172.31.36.0-255,66,322520,7,328756
3189,0.056702,172.217.194.0-255,5738,328258,7,328756
3190,0.056708,172.31.36.0-255,66,328324,7,328756
3191,0.058729,172.217.194.0-255,195,328519,7,328756
3192,0.058863,172.31.36.0-255,66,328585,7,328756
3193,0.058899,172.31.36.0-255,105,328690,7,328756
3194,0.060873,172.217.194.0-255,66,328756,7,328756
3195,0.0,172.217.194.0-255,153,153,7,305159
3196,1.7e-05,172.31.36.0-255,66,219,7,305159
3197,2.5e-05,172.217.194.0-255,1484,1703,7,305159
3198,2.9e-05,172.31.36.0-255,66,1769,7,305159
3199,3.4e-05,172.217.194.0-255,2902,4671,7,305159
3200,3.7e-05,172.31.36.0-255,66,4737,7,305159
3201,5.3e-05,172.217.194.0-255,7156,11893,7,305159
3202,5.6e-05,172.31.36.0-255,66,11959,7,305159
3203,6e-05,172.217.194.0-255,2018,13977,7,305159
3204,6.2e-05,172.31.36.0-255,66,14043,7,305159
3205,8.6e-05,172.217.194.0-255,2902,16945,7,305159
3206,9.4e-05,172.31.36.0-255,66,17011,7,305159
3207,0.000121,172.217.194.0-255,5738,22749,7,305159
3208,0.000124,172.31.36.0-255,66,22815,7,305159
3209,0.000139,172.217.194.0-255,4320,27135,7,305159
3210,0.000141,172.31.36.0-255,66,27201,7,305159
3211,0.00017,172.217.194.0-255,3961,31162,7,305159
3212,0.000173,172.31.36.0-255,66,31228,7,305159
3213,0.000188,172.31.36.0-255,66,31294,7,305159
3214,0.000223,172.31.36.0-255,66,31360,7,305159
3215,0.000266,172.217.194.0-255,1484,32844,7,305159
3216,0.000268,172.31.36.0-255,66,32910,7,305159
3217,0.000271,172.217.194.0-255,1484,34394,7,305159
3218,0.000273,172.31.36.0-255,66,34460,7,305159
3219,0.000296,172.217.194.0-255,1484,35944,7,305159
3220,0.000299,172.31.36.0-255,66,36010,7,305159
3221,0.00031,172.217.194.0-255,5738,41748,7,305159
3222,0.000313,172.31.36.0-255,66,41814,7,305159
3223,0.000351,172.217.194.0-255,7111,48925,7,305159
3224,0.000354,172.31.36.0-255,66,48991,7,305159
3225,0.000828,172.217.194.0-255,363,49354,7,305159
3226,0.000977,172.217.194.0-255,1484,50838,7,305159
3227,0.000982,172.31.36.0-255,66,50904,7,305159
3228,0.000988,172.217.194.0-255,2902,53806,7,305159
3229,0.00099,172.31.36.0-255,66,53872,7,305159
3230,0.000994,172.217.194.0-255,1484,55356,7,305159
3231,0.001019,172.217.194.0-255,4320,59676,7,305159
3232,0.001026,172.31.36.0-255,66,59742,7,305159
3233,0.001038,172.31.36.0-255,66,59808,7,305159
3234,0.001082,172.217.194.0-255,4320,64128,7,305159
3235,0.001085,172.31.36.0-255,66,64194,7,305159
3236,0.001097,172.31.36.0-255,66,64260,7,305159
3237,0.001446,172.217.194.0-255,1484,65744,7,305159
3238,0.001453,172.217.194.0-255,2902,68646,7,305159
3239,0.001456,172.31.36.0-255,66,68712,7,305159
3240,0.001461,172.217.194.0-255,2902,71614,7,305159
3241,0.001463,172.31.36.0-255,66,71680,7,305159
3242,0.001497,172.217.194.0-255,7156,78836,7,305159
3243,0.0015,172.31.36.0-255,66,78902,7,305159
3244,0.001509,172.217.194.0-255,7156,86058,7,305159
3245,0.001511,172.31.36.0-255,66,86124,7,305159
3246,0.001538,172.31.36.0-255,66,86190,7,305159
3247,0.001543,172.217.194.0-255,3602,89792,7,305159
3248,0.001545,172.31.36.0-255,66,89858,7,305159
3249,0.003591,172.217.194.0-255,2902,92760,7,305159
3250,0.0036,172.31.36.0-255,66,92826,7,305159
3251,0.003633,172.217.194.0-255,2902,95728,7,305159
3252,0.003636,172.31.36.0-255,66,95794,7,305159
3253,0.005662,172.217.194.0-255,2902,98696,7,305159
3254,0.005665,172.31.36.0-255,66,98762,7,305159
3255,0.005693,172.217.194.0-255,2902,101664,7,305159
3256,0.005695,172.31.36.0-255,66,101730,7,305159
3257,0.007728,172.217.194.0-255,2902,104632,7,305159
3258,0.007734,172.31.36.0-255,66,104698,7,305159
3259,0.007766,172.217.194.0-255,2902,107600,7,305159
3260,0.007769,172.31.36.0-255,66,107666,7,305159
3261,0.009796,172.217.194.0-255,2902,110568,7,305159
3262,0.009804,172.31.36.0-255,66,110634,7,305159
3263,0.009837,172.217.194.0-255,2902,113536,7,305159
3264,0.00984,172.31.36.0-255,66,113602,7,305159
3265,0.011905,172.217.194.0-255,5738,119340,7,305159
3266,0.011914,172.31.36.0-255,66,119406,7,305159
3267,0.013967,172.217.194.0-255,5738,125144,7,305159
3268,0.013975,172.31.36.0-255,66,125210,7,305159
3269,0.016056,172.217.194.0-255,5738,130948,7,305159
3270,0.016064,172.31.36.0-255,66,131014,7,305159
3271,0.018128,172.217.194.0-255,5738,136752,7,305159
3272,0.018136,172.31.36.0-255,66,136818,7,305159
3273,0.020206,172.217.194.0-255,5738,142556,7,305159
3274,0.020214,172.31.36.0-255,66,142622,7,305159
3275,0.022277,172.217.194.0-255,5738,148360,7,305159
3276,0.022285,172.31.36.0-255,66,148426,7,305159
3277,0.024381,172.217.194.0-255,5738,154164,7,305159
3278,0.024388,172.31.36.0-255,66,154230,7,305159
3279,0.026477,172.217.194.0-255,5738,159968,7,305159
3280,0.026484,172.31.36.0-255,66,160034,7,305159
3281,0.02856,172.217.194.0-255,5738,165772,7,305159
3282,0.028567,172.31.36.0-255,66,165838,7,305159
3283,0.030643,172.217.194.0-255,5738,171576,7,305159
3284,0.030651,172.31.36.0-255,66,171642,7,305159
3285,0.032707,172.217.194.0-255,5738,177380,7,305159
3286,0.032716,172.31.36.0-255,66,177446,7,305159
3287,0.033642,172.31.36.0-255,172,177618,7,305159
3288,0.033674,172.31.36.0-255,1073,178691,7,305159
3289,0.034785,172.217.194.0-255,5738,184429,7,305159
3290,0.034792,172.31.36.0-255,66,184495,7,305159
3291,0.035205,104.244.42.0-255,66,184561,7,305159
3292,0.035214,104.244.42.0-255,66,184627,7,305159
3293,0.03687,172.217.194.0-255,5738,190365,7,305159
3294,0.036877,172.31.36.0-255,66,190431,7,305159
3295,0.038956,172.217.194.0-255,5738,196169,7,305159
3296,0.038965,172.31.36.0-255,66,196235,7,305159
3297,0.041051,172.217.194.0-255,5738,201973,7,305159
3298,0.041058,172.31.36.0-255,66,202039,7,305159
3299,0.04315,172.217.194.0-255,5738,207777,7,305159
3300,0.043161,172.31.36.0-255,66,207843,7,305159
3301,0.04524,172.217.194.0-255,5738,213581,7,305159
3302,0.045247,172.31.36.0-255,66,213647,7,305159
3303,0.047404,172.217.194.0-255,5738,219385,7,305159
3304,0.047411,172.31.36.0-255,66,219451,7,305159
3305,0.049489,172.217.194.0-255,5738,225189,7,305159
3306,0.049496,172.31.36.0-255,66,225255,7,305159
3307,0.051611,172.217.194.0-255,5738,230993,7,305159
3308,0.051618,172.31.36.0-255,66,231059,7,305159
3309,0.053696,172.217.194.0-255,5738,236797,7,305159
3310,0.053703,172.31.36.0-255,66,236863,7,305159
3311,0.055774,172.217.194.0-255,5738,242601,7,305159
3312,0.055781,172.31.36.0-255,66,242667,7,305159
3313,0.057877,172.217.194.0-255,5738,248405,7,305159
3314,0.057883,172.31.36.0-255,66,248471,7,305159
3315,0.05995,172.217.194.0-255,5738,254209,7,305159
3316,0.059957,172.31.36.0-255,66,254275,7,305159
3317,0.062031,172.217.194.0-255,5738,260013,7,305159
3318,0.062037,172.31.36.0-255,66,260079,7,305159
3319,0.064112,172.217.194.0-255,5738,265817,7,305159
3320,0.064119,172.31.36.0-255,66,265883,7,305159
3321,0.066212,172.217.194.0-255,4320,270203,7,305159
3322,0.066219,172.31.36.0-255,66,270269,7,305159
3323,0.066246,172.217.194.0-255,1484,271753,7,305159
3324,0.068306,172.217.194.0-255,4320,276073,7,305159
3325,0.068313,172.31.36.0-255,66,276139,7,305159
3326,0.070376,172.217.194.0-255,5738,281877,7,305159
3327,0.070383,172.31.36.0-255,66,281943,7,305159
3328,0.072457,172.217.194.0-255,5738,287681,7,305159
3329,0.072464,172.31.36.0-255,66,287747,7,305159
3330,0.074547,172.217.194.0-255,5738,293485,7,305159
3331,0.074554,172.31.36.0-255,66,293551,7,305159
3332,0.076643,172.217.194.0-255,5738,299289,7,305159
3333,0.07665,172.31.36.0-255,66,299355,7,305159
3334,0.07874,172.217.194.0-255,5738,305093,7,305159
3335,0.078746,172.31.36.0-255,66,305159,7,305159
3336,0.0,172.217.194.0-255,146,146,7,172738
3337,2.7e-05,172.31.36.0-255,66,212,7,172738
3338,3.3e-05,172.217.194.0-255,1484,1696,7,172738
3339,3.8e-05,172.31.36.0-255,66,1762,7,172738
3340,4.3e-05,172.217.194.0-255,2902,4664,7,172738
3341,4.6e-05,172.31.36.0-255,66,4730,7,172738
3342,6.1e-05,172.217.194.0-255,7156,11886,7,172738
3343,6.4e-05,172.31.36.0-255,66,11952,7,172738
3344,6.9e-05,172.217.194.0-255,2093,14045,7,172738
3345,7.2e-05,172.31.36.0-255,66,14111,7,172738
3346,0.0001,172.217.194.0-255,2902,17013,7,172738
3347,0.000104,172.31.36.0-255,66,17079,7,172738
3348,0.000114,172.217.194.0-255,5738,22817,7,172738
3349,0.000117,172.31.36.0-255,66,22883,7,172738
3350,0.000174,172.31.36.0-255,66,22949,7,172738
3351,0.000178,172.217.194.0-255,1484,24433,7,172738
3352,0.00018,172.31.36.0-255,66,24499,7,172738
3353,0.000217,172.217.194.0-255,7156,31655,7,172738
3354,0.00022,172.31.36.0-255,66,31721,7,172738
3355,0.00023,172.31.36.0-255,66,31787,7,172738
3356,0.000358,172.217.194.0-255,1484,33271,7,172738
3357,0.000362,172.31.36.0-255,66,33337,7,172738
3358,0.000367,172.217.194.0-255,2902,36239,7,172738
3359,0.00037,172.31.36.0-255,66,36305,7,172738
3360,0.000374,172.217.194.0-255,2902,39207,7,172738
3361,0.000376,172.31.36.0-255,66,39273,7,172738
3362,0.00041,172.217.194.0-255,2902,42175,7,172738
3363,0.000414,172.31.36.0-255,66,42241,7,172738
3364,0.000421,172.217.194.0-255,6797,49038,7,172738
3365,0.000423,172.31.36.0-255,66,49104,7,172738
3366,0.000465,172.217.194.0-255,7156,56260,7,172738
3367,0.000469,172.31.36.0-255,66,56326,7,172738
3368,0.000473,172.217.194.0-255,1484,57810,7,172738
3369,0.000523,172.217.194.0-255,7156,64966,7,172738
3370,0.000528,172.31.36.0-255,66,65032,7,172738
3371,0.000554,172.217.194.0-255,1705,66737,7,172738
3372,0.000558,172.31.36.0-255,66,66803,7,172738
3373,0.000576,172.31.36.0-255,66,66869,7,172738
3374,0.000584,172.217.194.0-255,6797,73666,7,172738
3375,0.000587,172.31.36.0-255,66,73732,7,172738
3376,0.000938,172.217.194.0-255,1484,75216,7,172738
3377,0.000944,172.217.194.0-255,2902,78118,7,172738
3378,0.000947,172.31.36.0-255,66,78184,7,172738
3379,0.000954,172.217.194.0-255,4320,82504,7,172738
3380,0.000956,172.31.36.0-255,66,82570,7,172738
3381,0.000974,172.217.194.0-255,1484,84054,7,172738
3382,0.000991,172.31.36.0-255,66,84120,7,172738
3383,0.001016,172.217.194.0-255,1484,85604,7,172738
3384,0.001019,172.217.194.0-255,1484,87088,7,172738
3385,0.001022,172.31.36.0-255,66,87154,7,172738
3386,0.001059,172.31.36.0-255,66,87220,7,172738
3387,0.001077,172.217.194.0-255,1484,88704,7,172738
3388,0.001082,172.217.194.0-255,2902,91606,7,172738
3389,0.001085,172.31.36.0-255,66,91672,7,172738
3390,0.001119,172.217.194.0-255,1484,93156,7,172738
3391,0.001152,172.217.194.0-255,4320,97476,7,172738
3392,0.001156,172.31.36.0-255,66,97542,7,172738
3393,0.001174,172.31.36.0-255,66,97608,7,172738
3394,0.001186,172.31.36.0-255,66,97674,7,172738
3395,0.00119,172.217.194.0-255,766,98440,7,172738
3396,0.001214,172.217.194.0-255,1484,99924,7,172738
3397,0.001217,172.31.36.0-255,66,99990,7,172738
3398,0.001222,172.217.194.0-255,4320,104310,7,172738
3399,0.001225,172.31.36.0-255,66,104376,7,172738
3400,0.001228,172.217.194.0-255,1484,105860,7,172738
3401,0.001266,172.217.194.0-255,7156,113016,7,172738
3402,0.00127,172.31.36.0-255,66,113082,7,172738
3403,0.001286,172.31.36.0-255,66,113148,7,172738
3404,0.001297,172.217.194.0-255,1484,114632,7,172738
3405,0.001303,172.217.194.0-255,3602,118234,7,172738
3406,0.001307,172.31.36.0-255,66,118300,7,172738
3407,0.001354,172.31.36.0-255,66,118366,7,172738
3408,0.001388,172.31.36.0-255,66,118432,7,172738
3409,0.001408,172.31.36.0-255,66,118498,7,172738
3410,0.001539,172.217.194.0-255,1484,119982,7,172738
3411,0.001543,172.217.194.0-255,1484,121466,7,172738
3412,0.001547,172.31.36.0-255,66,121532,7,172738
3413,0.001555,172.217.194.0-255,1484,123016,7,172738
3414,0.001574,172.217.194.0-255,5738,128754,7,172738
3415,0.001578,172.31.36.0-255,66,128820,7,172738
3416,0.001618,172.31.36.0-255,66,128886,7,172738
3417,0.001665,172.31.36.0-255,66,128952,7,172738
3418,0.001722,172.217.194.0-255,1484,130436,7,172738
3419,0.00174,172.217.194.0-255,2902,133338,7,172738
3420,0.001743,172.31.36.0-255,66,133404,7,172738
3421,0.00175,172.217.194.0-255,5738,139142,7,172738
3422,0.001752,172.31.36.0-255,66,139208,7,172738
3423,0.00179,172.31.36.0-255,66,139274,7,172738
3424,0.001798,172.217.194.0-255,5738,145012,7,172738
3425,0.0018,172.31.36.0-255,66,145078,7,172738
3426,0.001828,172.217.194.0-255,5020,150098,7,172738
3427,0.001831,172.31.36.0-255,66,150164,7,172738
3428,0.001852,172.217.194.0-255,1484,151648,7,172738
3429,0.001858,172.217.194.0-255,2902,154550,7,172738
3430,0.00186,172.31.36.0-255,66,154616,7,172738
3431,0.001863,172.217.194.0-255,1484,156100,7,172738
3432,0.001891,172.217.194.0-255,4320,160420,7,172738
3433,0.001895,172.31.36.0-255,66,160486,7,172738
3434,0.001906,172.31.36.0-255,66,160552,7,172738
3435,0.001989,172.31.36.0-255,66,160618,7,172738
3436,0.002,172.31.36.0-255,66,160684,7,172738
3437,0.002013,172.217.194.0-255,7156,167840,7,172738
3438,0.002017,172.31.36.0-255,66,167906,7,172738
3439,0.002057,172.31.36.0-255,66,167972,7,172738
3440,0.002078,172.31.36.0-255,66,168038,7,172738
3441,0.002092,172.31.36.0-255,66,168104,7,172738
3442,0.002104,172.217.194.0-255,105,168209,7,172738
3443,0.007632,172.31.36.0-255,66,168275,7,172738
3444,0.007668,172.31.36.0-255,105,168380,7,172738
3445,0.009933,172.217.194.0-255,66,168446,7,172738
3446,0.03416,172.31.36.0-255,172,168618,7,172738
3447,0.034193,172.31.36.0-255,1115,169733,7,172738
3448,0.034242,172.31.36.0-255,1514,171247,7,172738
3449,0.034244,172.31.36.0-255,1293,172540,7,172738
3450,0.03567,104.244.42.0-255,66,172606,7,172738
3451,0.035871,104.244.42.0-255,66,172672,7,172738
3452,0.035873,104.244.42.0-255,66,172738,7,172738
3453,0.0,172.217.194.0-255,146,146,7,128399
3454,2e-05,172.31.36.0-255,66,212,7,128399
3455,2.7e-05,172.217.194.0-255,1484,1696,7,128399
3456,3.2e-05,172.31.36.0-255,66,1762,7,128399
3457,4.6e-05,172.217.194.0-255,2902,4664,7,128399
3458,5e-05,172.31.36.0-255,66,4730,7,128399
3459,5.8e-05,172.217.194.0-255,7156,11886,7,128399
3460,6.1e-05,172.31.36.0-255,66,11952,7,128399
3461,6.6e-05,172.217.194.0-255,2035,13987,7,128399
3462,6.8e-05,172.31.36.0-255,66,14053,7,128399
3463,0.000149,172.217.194.0-255,1484,15537,7,128399
3464,0.000153,172.31.36.0-255,66,15603,7,128399
3465,0.00016,172.217.194.0-255,2902,18505,7,128399
3466,0.000163,172.31.36.0-255,66,18571,7,128399
3467,0.000174,172.217.194.0-255,4320,22891,7,128399
3468,0.000177,172.31.36.0-255,66,22957,7,128399
3469,0.000205,172.217.194.0-255,1484,24441,7,128399
3470,0.000208,172.31.36.0-255,66,24507,7,128399
3471,0.000239,172.31.36.0-255,66,24573,7,128399
3472,0.000265,172.217.194.0-255,1484,26057,7,128399
3473,0.000267,172.31.36.0-255,66,26123,7,128399
3474,0.000301,172.31.36.0-255,66,26189,7,128399
3475,0.000317,172.31.36.0-255,66,26255,7,128399
3476,0.00034,172.217.194.0-255,7076,33331,7,128399
3477,0.000342,172.31.36.0-255,66,33397,7,128399
3478,0.000345,172.217.194.0-255,116,33513,7,128399
3479,0.000347,172.31.36.0-255,66,33579,7,128399
3480,0.000376,172.217.194.0-255,381,33960,7,128399
3481,0.000379,172.31.36.0-255,66,34026,7,128399
3482,0.000483,172.217.194.0-255,1484,35510,7,128399
3483,0.000502,172.217.194.0-255,2902,38412,7,128399
3484,0.000506,172.31.36.0-255,66,38478,7,128399
3485,0.00051,172.217.194.0-255,1484,39962,7,128399
3486,0.000539,172.217.194.0-255,4320,44282,7,128399
3487,0.000542,172.31.36.0-255,66,44348,7,128399
3488,0.000574,172.217.194.0-255,6797,51145,7,128399
3489,0.000577,172.31.36.0-255,66,51211,7,128399
3490,0.000584,172.217.194.0-255,7156,58367,7,128399
3491,0.000587,172.31.36.0-255,66,58433,7,128399
3492,0.000655,172.31.36.0-255,66,58499,7,128399
3493,0.000757,172.217.194.0-255,1484,59983,7,128399
3494,0.000773,172.217.194.0-255,2902,62885,7,128399
3495,0.000776,172.31.36.0-255,66,62951,7,128399
3496,0.000783,172.217.194.0-255,5738,68689,7,128399
3497,0.000786,172.31.36.0-255,66,68755,7,128399
3498,0.000829,172.31.36.0-255,66,68821,7,128399
3499,0.000868,172.31.36.0-255,66,68887,7,128399
3500,0.001336,172.217.194.0-255,1484,70371,7,128399
3501,0.001357,172.217.194.0-255,2902,73273,7,128399
3502,0.001361,172.31.36.0-255,66,73339,7,128399
3503,0.001368,172.217.194.0-255,5738,79077,7,128399
3504,0.001371,172.31.36.0-255,66,79143,7,128399
3505,0.001409,172.31.36.0-255,66,79209,7,128399
3506,0.001416,172.217.194.0-255,5738,84947,7,128399
3507,0.001418,172.31.36.0-255,66,85013,7,128399
3508,0.001463,172.217.194.0-255,5020,90033,7,128399
3509,0.001466,172.31.36.0-255,66,90099,7,128399
3510,0.001625,172.217.194.0-255,1484,91583,7,128399
3511,0.001632,172.217.194.0-255,2902,94485,7,128399
3512,0.001636,172.31.36.0-255,66,94551,7,128399
3513,0.001668,172.217.194.0-255,4320,98871,7,128399
3514,0.00167,172.31.36.0-255,66,98937,7,128399
3515,0.001677,172.217.194.0-255,5738,104675,7,128399
3516,0.001679,172.31.36.0-255,66,104741,7,128399
3517,0.001717,172.31.36.0-255,66,104807,7,128399
3518,0.001727,172.31.36.0-255,66,104873,7,128399
3519,0.001753,172.217.194.0-255,1484,106357,7,128399
3520,0.001788,172.31.36.0-255,66,106423,7,128399
3521,0.001832,172.31.36.0-255,66,106489,7,128399
3522,0.001857,172.31.36.0-255,66,106555,7,128399
3523,0.001915,172.31.36.0-255,66,106621,7,128399
3524,0.001993,172.31.36.0-255,66,106687,7,128399
3525,0.002034,172.31.36.0-255,66,106753,7,128399
3526,0.00204,172.217.194.0-255,4320,111073,7,128399
3527,0.002043,172.31.36.0-255,66,111139,7,128399
3528,0.002098,172.31.36.0-255,66,111205,7,128399
3529,0.002138,172.217.194.0-255,7156,118361,7,128399
3530,0.002153,172.31.36.0-255,66,118427,7,128399
3531,0.002187,172.31.36.0-255,66,118493,7,128399
3532,0.002228,172.31.36.0-255,66,118559,7,128399
3533,0.002303,172.31.36.0-255,66,118625,7,128399
3534,0.002361,172.31.36.0-255,66,118691,7,128399
3535,0.002407,172.217.194.0-255,105,118796,7,128399
3536,0.004807,172.31.36.0-255,66,118862,7,128399
3537,0.004845,172.31.36.0-255,105,118967,7,128399
3538,0.007378,172.217.194.0-255,66,119033,7,128399
3539,0.035166,172.31.36.0-255,172,119205,7,128399
3540,0.035201,172.31.36.0-255,1113,120318,7,128399
3541,0.03527,172.31.36.0-255,1514,121832,7,128399
3542,0.035272,172.31.36.0-255,1514,123346,7,128399
3543,0.035273,172.31.36.0-255,1514,124860,7,128399
3544,0.035275,172.31.36.0-255,1514,126374,7,128399
3545,0.035304,172.31.36.0-255,1514,127888,7,128399
3546,0.035305,172.31.36.0-255,73,127961,7,128399
3547,0.036662,104.244.42.0-255,66,128027,7,128399
3548,0.036693,104.244.42.0-255,66,128093,7,128399
3549,0.036806,104.244.42.0-255,66,128159,7,128399
3550,0.036824,104.244.42.0-255,66,128225,7,128399
3551,0.037307,104.244.42.0-255,108,128333,7,128399
3552,0.037314,172.31.36.0-255,66,128399,7,128399
3553,0.0,172.217.194.0-255,143,143,7,140375
3554,3.6e-05,172.31.36.0-255,66,209,7,140375
3555,4.3e-05,172.217.194.0-255,1484,1693,7,140375
3556,4.8e-05,172.31.36.0-255,66,1759,7,140375
3557,5.4e-05,172.217.194.0-255,2902,4661,7,140375
3558,6.5e-05,172.31.36.0-255,66,4727,7,140375
3559,7.3e-05,172.217.194.0-255,7156,11883,7,140375
3560,7.6e-05,172.31.36.0-255,66,11949,7,140375
3561,9.3e-05,172.217.194.0-255,5738,17687,7,140375
3562,9.6e-05,172.31.36.0-255,66,17753,7,140375
3563,0.000125,172.31.36.0-255,66,17819,7,140375
3564,0.00013,172.217.194.0-255,2543,20362,7,140375
3565,0.000133,172.31.36.0-255,66,20428,7,140375
3566,0.00023,172.217.194.0-255,1484,21912,7,140375
3567,0.000234,172.31.36.0-255,66,21978,7,140375
3568,0.00024,172.217.194.0-255,2902,24880,7,140375
3569,0.000242,172.31.36.0-255,66,24946,7,140375
3570,0.000247,172.217.194.0-255,2902,27848,7,140375
3571,0.000256,172.31.36.0-255,66,27914,7,140375
3572,0.000282,172.217.194.0-255,2902,30816,7,140375
3573,0.000285,172.31.36.0-255,66,30882,7,140375
3574,0.000305,172.31.36.0-255,66,30948,7,140375
3575,0.000332,172.217.194.0-255,4320,35268,7,140375
3576,0.000335,172.31.36.0-255,66,35334,7,140375
3577,0.000369,172.217.194.0-255,5667,41001,7,140375
3578,0.000374,172.31.36.0-255,66,41067,7,140375
3579,0.000643,172.217.194.0-255,99,41166,7,140375
3580,0.000648,172.31.36.0-255,66,41232,7,140375
3581,0.000684,172.217.194.0-255,1484,42716,7,140375
3582,0.000687,172.31.36.0-255,66,42782,7,140375
3583,0.000692,172.217.194.0-255,2902,45684,7,140375
3584,0.000695,172.31.36.0-255,66,45750,7,140375
3585,0.000698,172.217.194.0-255,1484,47234,7,140375
3586,0.000726,172.217.194.0-255,5738,52972,7,140375
3587,0.00073,172.31.36.0-255,66,53038,7,140375
3588,0.000736,172.217.194.0-255,4320,57358,7,140375
3589,0.000738,172.31.36.0-255,66,57424,7,140375
3590,0.000744,172.217.194.0-255,4320,61744,7,140375
3591,0.000753,172.31.36.0-255,66,61810,7,140375
3592,0.000777,172.217.194.0-255,1484,63294,7,140375
3593,0.000796,172.31.36.0-255,66,63360,7,140375
3594,0.000799,172.217.194.0-255,766,64126,7,140375
3595,0.000845,172.31.36.0-255,66,64192,7,140375
3596,0.00085,172.217.194.0-255,2902,67094,7,140375
3597,0.000854,172.31.36.0-255,66,67160,7,140375
3598,0.000885,172.31.36.0-255,66,67226,7,140375
3599,0.000892,172.217.194.0-255,5738,72964,7,140375
3600,0.000894,172.31.36.0-255,66,73030,7,140375
3601,0.000933,172.31.36.0-255,66,73096,7,140375
3602,0.000958,172.31.36.0-255,66,73162,7,140375
3603,0.00097,172.31.36.0-255,66,73228,7,140375
3604,0.001108,172.217.194.0-255,1484,74712,7,140375
3605,0.001114,172.217.194.0-255,2902,77614,7,140375
3606,0.001117,172.31.36.0-255,66,77680,7,140375
3607,0.001139,172.217.194.0-255,5738,83418,7,140375
3608,0.001143,172.31.36.0-255,66,83484,7,140375
3609,0.001148,172.217.194.0-255,4320,87804,7,140375
3610,0.00115,172.31.36.0-255,66,87870,7,140375
3611,0.001203,172.31.36.0-255,66,87936,7,140375
3612,0.00122,172.31.36.0-255,66,88002,7,140375
3613,0.001283,172.217.194.0-255,2902,90904,7,140375
3614,0.001287,172.217.194.0-255,4320,95224,7,140375
3615,0.001288,172.31.36.0-255,66,95290,7,140375
3616,0.001292,172.31.36.0-255,66,95356,7,140375
3617,0.001296,172.31.36.0-255,66,95422,7,140375
3618,0.001354,172.31.36.0-255,66,95488,7,140375
3619,0.001392,172.31.36.0-255,66,95554,7,140375
3620,0.001415,172.31.36.0-255,66,95620,7,140375
3621,0.001435,172.31.36.0-255,66,95686,7,140375
3622,0.001462,172.217.194.0-255,4320,100006,7,140375
3623,0.001466,172.31.36.0-255,66,100072,7,140375
3624,0.001514,172.31.36.0-255,66,100138,7,140375
3625,0.00152,172.217.194.0-255,5020,105158,7,140375
3626,0.001522,172.31.36.0-255,66,105224,7,140375
3627,0.001632,172.217.194.0-255,1484,106708,7,140375
3628,0.001638,172.217.194.0-255,2902,109610,7,140375
3629,0.001642,172.31.36.0-255,66,109676,7,140375
3630,0.001676,172.217.194.0-255,5738,115414,7,140375
3631,0.001686,172.31.36.0-255,66,115480,7,140375
3632,0.00171,172.31.36.0-255,66,115546,7,140375
3633,0.001722,172.31.36.0-255,66,115612,7,140375
3634,0.001748,172.217.194.0-255,766,116378,7,140375
3635,0.001765,172.217.194.0-255,1484,117862,7,140375
3636,0.001768,172.31.36.0-255,66,117928,7,140375
3637,0.001774,172.217.194.0-255,2902,120830,7,140375
3638,0.001776,172.31.36.0-255,66,120896,7,140375
3639,0.001794,172.217.194.0-255,2902,123798,7,140375
3640,0.001798,172.31.36.0-255,66,123864,7,140375
3641,0.001824,172.217.194.0-255,2902,126766,7,140375
3642,0.001827,172.31.36.0-255,66,126832,7,140375
3643,0.001846,172.31.36.0-255,66,126898,7,140375
3644,0.001887,172.31.36.0-255,66,126964,7,140375
3645,0.001899,172.31.36.0-255,66,127030,7,140375
3646,0.001917,172.217.194.0-255,4320,131350,7,140375
3647,0.00192,172.31.36.0-255,66,131416,7,140375
3648,0.00194,172.31.36.0-255,66,131482,7,140375
3649,0.002016,172.31.36.0-255,66,131548,7,140375
3650,0.002022,172.217.194.0-255,4123,135671,7,140375
3651,0.002024,172.31.36.0-255,66,135737,7,140375
3652,0.002045,172.217.194.0-255,105,135842,7,140375
3653,0.010605,172.31.36.0-255,66,135908,7,140375
3654,0.010639,172.31.36.0-255,105,136013,7,140375
3655,0.013263,172.217.194.0-255,66,136079,7,140375
3656,0.030772,172.31.36.0-255,176,136255,7,140375
3657,0.030809,172.31.36.0-255,1114,137369,7,140375
3658,0.030855,172.31.36.0-255,1514,138883,7,140375
3659,0.030857,172.31.36.0-255,1294,140177,7,140375
3660,0.032294,104.244.42.0-255,66,140243,7,140375
3661,0.032367,104.244.42.0-255,66,140309,7,140375
3662,0.032369,104.244.42.0-255,66,140375,7,140375
3663,0.0,74.125.130.0-255,153,153,7,275238
3664,2.4e-05,172.31.36.0-255,66,219,7,275238
3665,3e-05,74.125.130.0-255,1484,1703,7,275238
3666,3.5e-05,172.31.36.0-255,66,1769,7,275238
3667,5.1e-05,74.125.130.0-255,2902,4671,7,275238
3668,5.5e-05,172.31.36.0-255,66,4737,7,275238
3669,6e-05,74.125.130.0-255,2902,7639,7,275238
3670,6.2e-05,172.31.36.0-255,66,7705,7,275238
3671,6.9e-05,74.125.130.0-255,4320,12025,7,275238
3672,7.2e-05,172.31.36.0-255,66,12091,7,275238
3673,9.4e-05,74.125.130.0-255,2121,14212,7,275238
3674,0.000102,172.31.36.0-255,66,14278,7,275238
3675,0.00013,74.125.130.0-255,2902,17180,7,275238
3676,0.000133,172.31.36.0-255,66,17246,7,275238
3677,0.000164,74.125.130.0-255,4320,21566,7,275238
3678,0.000167,172.31.36.0-255,66,21632,7,275238
3679,0.000174,74.125.130.0-255,5738,27370,7,275238
3680,0.000176,172.31.36.0-255,66,27436,7,275238
3681,0.000206,74.125.130.0-255,4320,31756,7,275238
3682,0.000208,172.31.36.0-255,66,31822,7,275238
3683,0.000237,74.125.130.0-255,4320,36142,7,275238
3684,0.000239,172.31.36.0-255,66,36208,7,275238
3685,0.000257,172.31.36.0-255,66,36274,7,275238
3686,0.000261,74.125.130.0-255,2184,38458,7,275238
3687,0.000263,172.31.36.0-255,66,38524,7,275238
3688,0.001492,74.125.130.0-255,1484,40008,7,275238
3689,0.001499,172.31.36.0-255,66,40074,7,275238
3690,0.00151,74.125.130.0-255,2902,42976,7,275238
3691,0.001512,172.31.36.0-255,66,43042,7,275238
3692,0.001522,74.125.130.0-255,1484,44526,7,275238
3693,0.001524,172.31.36.0-255,66,44592,7,275238
3694,0.001529,74.125.130.0-255,2902,47494,7,275238
3695,0.001532,172.31.36.0-255,66,47560,7,275238
3696,0.001573,74.125.130.0-255,5738,53298,7,275238
3697,0.001575,172.31.36.0-255,66,53364,7,275238
3698,0.001579,74.125.130.0-255,1484,54848,7,275238
3699,0.001607,74.125.130.0-255,1397,56245,7,275238
3700,0.003516,74.125.130.0-255,2902,59147,7,275238
3701,0.005093,172.31.36.0-255,66,59213,7,275238
3702,0.007067,74.125.130.0-255,5738,64951,7,275238
3703,0.007081,172.31.36.0-255,66,65017,7,275238
3704,0.009042,74.125.130.0-255,5738,70755,7,275238
3705,0.009053,172.31.36.0-255,66,70821,7,275238
3706,0.011002,74.125.130.0-255,5738,76559,7,275238
3707,0.012791,172.31.36.0-255,66,76625,7,275238
3708,0.014748,74.125.130.0-255,5738,82363,7,275238
3709,0.014762,172.31.36.0-255,66,82429,7,275238
3710,0.016713,74.125.130.0-255,5738,88167,7,275238
3711,0.016723,172.31.36.0-255,66,88233,7,275238
3712,0.018674,74.125.130.0-255,5738,93971,7,275238
3713,0.018683,172.31.36.0-255,66,94037,7,275238
3714,0.020662,74.125.130.0-255,5738,99775,7,275238
3715,0.020674,172.31.36.0-255,66,99841,7,275238
3716,0.022632,74.125.130.0-255,5738,105579,7,275238
3717,0.022643,172.31.36.0-255,66,105645,7,275238
3718,0.024221,172.31.36.0-255,164,105809,7,275238
3719,0.024252,172.31.36.0-255,1122,106931,7,275238
3720,0.02431,172.31.36.0-255,1514,108445,7,275238
3721,0.024312,172.31.36.0-255,323,108768,7,275238
3722,0.024586,74.125.130.0-255,5738,114506,7,275238
3723,0.024613,172.31.36.0-255,66,114572,7,275238
3724,0.025767,104.244.42.0-255,66,114638,7,275238
3725,0.025777,104.244.42.0-255,66,114704,7,275238
3726,0.025848,104.244.42.0-255,66,114770,7,275238
3727,0.026551,74.125.130.0-255,5738,120508,7,275238
3728,0.026559,172.31.36.0-255,66,120574,7,275238
3729,0.028505,74.125.130.0-255,5738,126312,7,275238
3730,0.028512,172.31.36.0-255,66,126378,7,275238
3731,0.030498,74.125.130.0-255,5738,132116,7,275238
3732,0.030508,172.31.36.0-255,66,132182,7,275238
3733,0.032464,74.125.130.0-255,5738,137920,7,275238
3734,0.032474,172.31.36.0-255,66,137986,7,275238
3735,0.034441,74.125.130.0-255,5738,143724,7,275238
3736,0.034458,172.31.36.0-255,66,143790,7,275238
3737,0.036418,74.125.130.0-255,5738,149528,7,275238
3738,0.036427,172.31.36.0-255,66,149594,7,275238
3739,0.038392,74.125.130.0-255,5738,155332,7,275238
3740,0.038399,172.31.36.0-255,66,155398,7,275238
3741,0.040366,74.125.130.0-255,5738,161136,7,275238
3742,0.040373,172.31.36.0-255,66,161202,7,275238
3743,0.042332,74.125.130.0-255,5738,166940,7,275238
3744,0.042348,172.31.36.0-255,66,167006,7,275238
3745,0.044294,74.125.130.0-255,5738,172744,7,275238
3746,0.044303,172.31.36.0-255,66,172810,7,275238
3747,0.046251,74.125.130.0-255,5738,178548,7,275238
3748,0.046259,172.31.36.0-255,66,178614,7,275238
3749,0.04821,74.125.130.0-255,5738,184352,7,275238
3750,0.048217,172.31.36.0-255,66,184418,7,275238
3751,0.050162,74.125.130.0-255,5738,190156,7,275238
3752,0.050174,172.31.36.0-255,66,190222,7,275238
3753,0.052129,74.125.130.0-255,5738,195960,7,275238
3754,0.05214,172.31.36.0-255,66,196026,7,275238
3755,0.054103,74.125.130.0-255,5738,201764,7,275238
3756,0.054119,172.31.36.0-255,66,201830,7,275238
3757,0.056087,74.125.130.0-255,5738,207568,7,275238
3758,0.056097,172.31.36.0-255,66,207634,7,275238
3759,0.058044,74.125.130.0-255,5738,213372,7,275238
3760,0.058053,172.31.36.0-255,66,213438,7,275238
3761,0.060001,74.125.130.0-255,5738,219176,7,275238
3762,0.060012,172.31.36.0-255,66,219242,7,275238
3763,0.061963,74.125.130.0-255,5738,224980,7,275238
3764,0.061975,172.31.36.0-255,66,225046,7,275238
3765,0.063919,74.125.130.0-255,5738,230784,7,275238
3766,0.063926,172.31.36.0-255,66,230850,7,275238
3767,0.065882,74.125.130.0-255,5738,236588,7,275238
3768,0.065891,172.31.36.0-255,66,236654,7,275238
3769,0.067852,74.125.130.0-255,2902,239556,7,275238
3770,0.067865,172.31.36.0-255,66,239622,7,275238
3771,0.067902,74.125.130.0-255,2902,242524,7,275238
3772,0.068649,172.31.36.0-255,66,242590,7,275238
3773,0.069818,74.125.130.0-255,2902,245492,7,275238
3774,0.06983,172.31.36.0-255,66,245558,7,275238
3775,0.070594,74.125.130.0-255,2902,248460,7,275238
3776,0.070601,172.31.36.0-255,66,248526,7,275238
3777,0.07177,74.125.130.0-255,2902,251428,7,275238
3778,0.071776,172.31.36.0-255,66,251494,7,275238
3779,0.072541,74.125.130.0-255,2902,254396,7,275238
3780,0.072549,172.31.36.0-255,66,254462,7,275238
3781,0.07374,74.125.130.0-255,2902,257364,7,275238
3782,0.073748,172.31.36.0-255,66,257430,7,275238
3783,0.074483,74.125.130.0-255,2902,260332,7,275238
3784,0.074489,172.31.36.0-255,66,260398,7,275238
3785,0.075705,74.125.130.0-255,2902,263300,7,275238
3786,0.075711,172.31.36.0-255,66,263366,7,275238
3787,0.076469,74.125.130.0-255,2902,266268,7,275238
3788,0.076476,172.31.36.0-255,66,266334,7,275238
3789,0.077664,74.125.130.0-255,2902,269236,7,275238
3790,0.077671,172.31.36.0-255,66,269302,7,275238
3791,0.078412,74.125.130.0-255,2902,272204,7,275238
3792,0.078419,172.31.36.0-255,66,272270,7,275238
3793,0.07962,74.125.130.0-255,2902,275172,7,275238
3794,0.079626,172.31.36.0-255,66,275238,7,275238
3795,0.0,172.217.160.0-255,298,298,7,359600
3796,3.6e-05,172.31.36.0-255,66,364,7,359600
3797,4.3e-05,172.217.160.0-255,1484,1848,7,359600
3798,4.7e-05,172.31.36.0-255,66,1914,7,359600
3799,6.2e-05,172.217.160.0-255,4320,6234,7,359600
3800,6.5e-05,172.31.36.0-255,66,6300,7,359600
3801,7.7e-05,172.31.36.0-255,66,6366,7,359600
3802,8.8e-05,172.31.36.0-255,66,6432,7,359600
3803,0.000119,172.217.160.0-255,5379,11811,7,359600
3804,0.000122,172.31.36.0-255,66,11877,7,359600
3805,0.000149,172.217.160.0-255,2902,14779,7,359600
3806,0.000153,172.31.36.0-255,66,14845,7,359600
3807,0.000181,172.217.160.0-255,2902,17747,7,359600
3808,0.000184,172.31.36.0-255,66,17813,7,359600
3809,0.000187,172.217.160.0-255,1484,19297,7,359600
3810,0.00019,172.31.36.0-255,66,19363,7,359600
3811,0.000208,172.31.36.0-255,66,19429,7,359600
3812,0.000211,172.217.160.0-255,1125,20554,7,359600
3813,0.000212,172.31.36.0-255,66,20620,7,359600
3814,0.000366,172.217.160.0-255,1484,22104,7,359600
3815,0.000371,172.31.36.0-255,66,22170,7,359600
3816,0.000376,172.217.160.0-255,2902,25072,7,359600
3817,0.000379,172.31.36.0-255,66,25138,7,359600
3818,0.000384,172.217.160.0-255,2902,28040,7,359600
3819,0.000386,172.31.36.0-255,66,28106,7,359600
3820,0.000408,172.217.160.0-255,2902,31008,7,359600
3821,0.000411,172.31.36.0-255,66,31074,7,359600
3822,0.000425,172.217.160.0-255,7103,38177,7,359600
3823,0.000428,172.31.36.0-255,66,38243,7,359600
3824,0.000934,172.217.160.0-255,103,38346,7,359600
3825,0.001008,172.217.160.0-255,1484,39830,7,359600
3826,0.001013,172.31.36.0-255,66,39896,7,359600
3827,0.001017,172.217.160.0-255,1484,41380,7,359600
3828,0.001024,172.217.160.0-255,4320,45700,7,359600
3829,0.001033,172.31.36.0-255,66,45766,7,359600
3830,0.001073,172.217.160.0-255,7156,52922,7,359600
3831,0.001077,172.31.36.0-255,66,52988,7,359600
3832,0.001096,172.217.160.0-255,2543,55531,7,359600
3833,0.001098,172.31.36.0-255,66,55597,7,359600
3834,0.001106,172.217.160.0-255,7156,62753,7,359600
3835,0.001108,172.31.36.0-255,66,62819,7,359600
3836,0.001133,172.217.160.0-255,2902,65721,7,359600
3837,0.001135,172.31.36.0-255,66,65787,7,359600
3838,0.001147,172.217.160.0-255,6797,72584,7,359600
3839,0.00115,172.31.36.0-255,66,72650,7,359600
3840,0.00119,172.217.160.0-255,1484,74134,7,359600
3841,0.001203,172.217.160.0-255,2902,77036,7,359600
3842,0.001205,172.31.36.0-255,66,77102,7,359600
3843,0.001209,172.217.160.0-255,1484,78586,7,359600
3844,0.001234,172.217.160.0-255,4320,82906,7,359600
3845,0.001237,172.31.36.0-255,66,82972,7,359600
3846,0.001267,172.217.160.0-255,2902,85874,7,359600
3847,0.001269,172.31.36.0-255,66,85940,7,359600
3848,0.001297,172.217.160.0-255,3563,89503,7,359600
3849,0.0013,172.31.36.0-255,66,89569,7,359600
3850,0.001303,172.217.160.0-255,214,89783,7,359600
3851,0.001342,172.217.160.0-255,1484,91267,7,359600
3852,0.001345,172.31.36.0-255,66,91333,7,359600
3853,0.001349,172.217.160.0-255,1484,92817,7,359600
3854,0.001373,172.217.160.0-255,2902,95719,7,359600
3855,0.001376,172.31.36.0-255,66,95785,7,359600
3856,0.001386,172.31.36.0-255,66,95851,7,359600
3857,0.001405,172.31.36.0-255,66,95917,7,359600
3858,0.001451,172.31.36.0-255,66,95983,7,359600
3859,0.001533,172.217.160.0-255,1484,97467,7,359600
3860,0.00154,172.217.160.0-255,2902,100369,7,359600
3861,0.001544,172.31.36.0-255,66,100435,7,359600
3862,0.001551,172.217.160.0-255,5738,106173,7,359600
3863,0.001554,172.31.36.0-255,66,106239,7,359600
3864,0.001565,172.217.160.0-255,2902,109141,7,359600
3865,0.001568,172.31.36.0-255,66,109207,7,359600
3866,0.001615,172.31.36.0-255,66,109273,7,359600
3867,0.001622,172.217.160.0-255,5738,115011,7,359600
3868,0.001624,172.31.36.0-255,66,115077,7,359600
3869,0.00165,172.217.160.0-255,5020,120097,7,359600
3870,0.001663,172.31.36.0-255,66,120163,7,359600
3871,0.001792,172.217.160.0-255,1484,121647,7,359600
3872,0.001799,172.217.160.0-255,2902,124549,7,359600
3873,0.001802,172.31.36.0-255,66,124615,7,359600
3874,0.001809,172.217.160.0-255,5738,130353,7,359600
3875,0.001811,172.31.36.0-255,66,130419,7,359600
3876,0.001832,172.217.160.0-255,7156,137575,7,359600
3877,0.001842,172.31.36.0-255,66,137641,7,359600
3878,0.001885,172.217.160.0-255,7156,144797,7,359600
3879,0.001888,172.31.36.0-255,66,144863,7,359600
3880,0.001921,172.217.160.0-255,7156,152019,7,359600
3881,0.001924,172.31.36.0-255,66,152085,7,359600
3882,0.001928,172.217.160.0-255,2184,154269,7,359600
3883,0.00193,172.31.36.0-255,66,154335,7,359600
3884,0.003873,172.217.160.0-255,5738,160073,7,359600
3885,0.00388,172.31.36.0-255,66,160139,7,359600
3886,0.00582,172.217.160.0-255,5738,165877,7,359600
3887,0.005825,172.31.36.0-255,66,165943,7,359600
3888,0.007766,172.217.160.0-255,5738,171681,7,359600
3889,0.007769,172.31.36.0-255,66,171747,7,359600
3890,0.009706,172.217.160.0-255,5738,177485,7,359600
3891,0.009712,172.31.36.0-255,66,177551,7,359600
3892,0.011671,172.217.160.0-255,5738,183289,7,359600
3893,0.011676,172.31.36.0-255,66,183355,7,359600
3894,0.013638,172.217.160.0-255,5738,189093,7,359600
3895,0.013646,172.31.36.0-255,66,189159,7,359600
3896,0.015606,172.217.160.0-255,5738,194897,7,359600
3897,0.015625,172.31.36.0-255,66,194963,7,359600
3898,0.017582,172.217.160.0-255,5738,200701,7,359600
3899,0.017596,172.31.36.0-255,66,200767,7,359600
3900,0.019556,172.217.160.0-255,5738,206505,7,359600
3901,0.019575,172.31.36.0-255,66,206571,7,359600
3902,0.021524,172.217.160.0-255,5738,212309,7,359600
3903,0.021534,172.31.36.0-255,66,212375,7,359600
3904,0.023502,172.217.160.0-255,5738,218113,7,359600
3905,0.023521,172.31.36.0-255,66,218179,7,359600
3906,0.025475,172.217.160.0-255,5738,223917,7,359600
3907,0.025482,172.31.36.0-255,66,223983,7,359600
3908,0.027432,172.217.160.0-255,5738,229721,7,359600
3909,0.027445,172.31.36.0-255,66,229787,7,359600
3910,0.029414,172.217.160.0-255,4320,234107,7,359600
3911,0.029422,172.31.36.0-255,66,234173,7,359600
3912,0.02946,172.217.160.0-255,1484,235657,7,359600
3913,0.031379,172.217.160.0-255,4320,239977,7,359600
3914,0.031386,172.31.36.0-255,66,240043,7,359600
3915,0.033327,172.217.160.0-255,5738,245781,7,359600
3916,0.033335,172.31.36.0-255,66,245847,7,359600
3917,0.035307,172.217.160.0-255,5738,251585,7,359600
3918,0.035314,172.31.36.0-255,66,251651,7,359600
3919,0.037259,172.217.160.0-255,5738,257389,7,359600
3920,0.037266,172.31.36.0-255,66,257455,7,359600
3921,0.039214,172.217.160.0-255,5738,263193,7,359600
3922,0.03922,172.31.36.0-255,66,263259,7,359600
3923,0.03983,172.31.36.0-255,167,263426,7,359600
3924,0.039858,172.31.36.0-255,1114,264540,7,359600
3925,0.039894,172.31.36.0-255,1514,266054,7,359600
3926,0.039895,172.31.36.0-255,1292,267346,7,359600
3927,0.041169,172.217.160.0-255,5738,273084,7,359600
3928,0.041174,172.31.36.0-255,66,273150,7,359600
3929,0.041344,104.244.42.0-255,66,273216,7,359600
3930,0.041392,104.244.42.0-255,66,273282,7,359600
3931,0.041442,104.244.42.0-255,66,273348,7,359600
3932,0.043122,172.217.160.0-255,5738,279086,7,359600
3933,0.043128,172.31.36.0-255,66,279152,7,359600
3934,0.045072,172.217.160.0-255,5738,284890,7,359600
3935,0.045078,172.31.36.0-255,66,284956,7,359600
3936,0.047018,172.217.160.0-255,5738,290694,7,359600
3937,0.047024,172.31.36.0-255,66,290760,7,359600
3938,0.048968,172.217.160.0-255,4320,295080,7,359600
3939,0.048973,172.31.36.0-255,66,295146,7,359600
3940,0.049002,172.217.160.0-255,1484,296630,7,359600
3941,0.050903,172.217.160.0-255,4320,300950,7,359600
3942,0.050908,172.31.36.0-255,66,301016,7,359600
3943,0.052856,172.217.160.0-255,5738,306754,7,359600
3944,0.052861,172.31.36.0-255,66,306820,7,359600
3945,0.0548,172.217.160.0-255,5738,312558,7,359600
3946,0.054806,172.31.36.0-255,66,312624,7,359600
3947,0.05674,172.217.160.0-255,5738,318362,7,359600
3948,0.056746,172.31.36.0-255,66,318428,7,359600
3949,0.058688,172.217.160.0-255,5738,324166,7,359600
3950,0.058694,172.31.36.0-255,66,324232,7,359600
3951,0.060651,172.217.160.0-255,4320,328552,7,359600
3952,0.060657,172.31.36.0-255,66,328618,7,359600
3953,0.060691,172.217.160.0-255,1484,330102,7,359600
3954,0.062594,172.217.160.0-255,4320,334422,7,359600
3955,0.062601,172.31.36.0-255,66,334488,7,359600
3956,0.064542,172.217.160.0-255,5738,340226,7,359600
3957,0.064549,172.31.36.0-255,66,340292,7,359600
3958,0.066478,172.217.160.0-255,5738,346030,7,359600
3959,0.066484,172.31.36.0-255,66,346096,7,359600
3960,0.068419,172.217.160.0-255,5738,351834,7,359600
3961,0.068424,172.31.36.0-255,66,351900,7,359600
3962,0.070373,172.217.160.0-255,5738,357638,7,359600
3963,0.070378,172.31.36.0-255,66,357704,7,359600
3964,0.072309,172.217.160.0-255,1659,359363,7,359600
3965,0.072314,172.31.36.0-255,66,359429,7,359600
3966,0.072499,172.31.36.0-255,105,359534,7,359600
3967,0.074399,172.217.160.0-255,66,359600,7,359600
3968,0.0,74.125.24.0-255,153,153,7,322733
3969,3.2e-05,172.31.36.0-255,66,219,7,322733
3970,4e-05,74.125.24.0-255,1484,1703,7,322733
3971,4.4e-05,172.31.36.0-255,66,1769,7,322733
3972,5e-05,74.125.24.0-255,2902,4671,7,322733
3973,5.3e-05,172.31.36.0-255,66,4737,7,322733
3974,5.7e-05,74.125.24.0-255,2902,7639,7,322733
3975,6e-05,172.31.36.0-255,66,7705,7,322733
3976,8.4e-05,74.125.24.0-255,4320,12025,7,322733
3977,9e-05,172.31.36.0-255,66,12091,7,322733
3978,9.4e-05,172.31.36.0-255,66,12157,7,322733
3979,0.000116,74.125.24.0-255,1484,13641,7,322733
3980,0.000118,172.31.36.0-255,66,13707,7,322733
3981,0.000144,172.31.36.0-255,66,13773,7,322733
3982,0.000157,74.125.24.0-255,1484,15257,7,322733
3983,0.00016,172.31.36.0-255,66,15323,7,322733
3984,0.000175,74.125.24.0-255,4320,19643,7,322733
3985,0.00018,172.31.36.0-255,66,19709,7,322733
3986,0.000189,74.125.24.0-255,7156,26865,7,322733
3987,0.000191,172.31.36.0-255,66,26931,7,322733
3988,0.000217,74.125.24.0-255,3961,30892,7,322733
3989,0.00022,172.31.36.0-255,66,30958,7,322733
3990,0.00028,74.125.24.0-255,1484,32442,7,322733
3991,0.000284,172.31.36.0-255,66,32508,7,322733
3992,0.00029,74.125.24.0-255,2902,35410,7,322733
3993,0.000292,172.31.36.0-255,66,35476,7,322733
3994,0.000297,74.125.24.0-255,5738,41214,7,322733
3995,0.0003,172.31.36.0-255,66,41280,7,322733
3996,0.000365,74.125.24.0-255,6797,48077,7,322733
3997,0.00037,172.31.36.0-255,66,48143,7,322733
3998,0.00071,74.125.24.0-255,646,48789,7,322733
3999,0.000814,172.31.36.0-255,66,48855,7,322733
4000,0.000943,74.125.24.0-255,1484,50339,7,322733
4001,0.000953,74.125.24.0-255,2902,53241,7,322733
4002,0.000957,172.31.36.0-255,66,53307,7,322733
4003,0.000964,74.125.24.0-255,5738,59045,7,322733
4004,0.000966,172.31.36.0-255,66,59111,7,322733
4005,0.001017,74.125.24.0-255,4320,63431,7,322733
4006,0.00102,172.31.36.0-255,66,63497,7,322733
4007,0.001037,74.125.24.0-255,1994,65491,7,322733
4008,0.00104,172.31.36.0-255,66,65557,7,322733
4009,0.001246,74.125.24.0-255,1484,67041,7,322733
4010,0.001253,74.125.24.0-255,2902,69943,7,322733
4011,0.001256,172.31.36.0-255,66,70009,7,322733
4012,0.001261,74.125.24.0-255,2902,72911,7,322733
4013,0.001263,172.31.36.0-255,66,72977,7,322733
4014,0.001277,74.125.24.0-255,2902,75879,7,322733
4015,0.001279,172.31.36.0-255,66,75945,7,322733
4016,0.001291,74.125.24.0-255,2902,78847,7,322733
4017,0.001293,172.31.36.0-255,66,78913,7,322733
4018,0.001323,172.31.36.0-255,66,78979,7,322733
4019,0.001336,74.125.24.0-255,4320,83299,7,322733
4020,0.001338,172.31.36.0-255,66,83365,7,322733
4021,0.001364,74.125.24.0-255,6438,89803,7,322733
4022,0.001366,172.31.36.0-255,66,89869,7,322733
4023,0.001758,74.125.24.0-255,1484,91353,7,322733
4024,0.001764,74.125.24.0-255,2902,94255,7,322733
4025,0.001767,172.31.36.0-255,66,94321,7,322733
4026,0.001771,74.125.24.0-255,1484,95805,7,322733
4027,0.001788,74.125.24.0-255,4320,100125,7,322733
4028,0.00179,172.31.36.0-255,66,100191,7,322733
4029,0.001794,74.125.24.0-255,2902,103093,7,322733
4030,0.001795,172.31.36.0-255,66,103159,7,322733
4031,0.001816,172.31.36.0-255,66,103225,7,322733
4032,0.001838,74.125.24.0-255,2902,106127,7,322733
4033,0.00184,172.31.36.0-255,66,106193,7,322733
4034,0.001864,172.31.36.0-255,66,106259,7,322733
4035,0.002014,74.125.24.0-255,1484,107743,7,322733
4036,0.002019,74.125.24.0-255,2902,110645,7,322733
4037,0.00202,172.31.36.0-255,66,110711,7,322733
4038,0.00204,74.125.24.0-255,5738,116449,7,322733
4039,0.002042,172.31.36.0-255,66,116515,7,322733
4040,0.002063,74.125.24.0-255,7156,123671,7,322733
4041,0.002065,172.31.36.0-255,66,123737,7,322733
4042,0.002079,74.125.24.0-255,5738,129475,7,322733
4043,0.002081,172.31.36.0-255,66,129541,7,322733
4044,0.002085,74.125.24.0-255,2902,132443,7,322733
4045,0.002087,172.31.36.0-255,66,132509,7,322733
4046,0.002103,172.31.36.0-255,66,132575,7,322733
4047,0.002541,74.125.24.0-255,1484,134059,7,322733
4048,0.002553,74.125.24.0-255,2902,136961,7,322733
4049,0.002555,172.31.36.0-255,66,137027,7,322733
4050,0.002558,74.125.24.0-255,1484,138511,7,322733
4051,0.002574,74.125.24.0-255,4320,142831,7,322733
4052,0.002576,172.31.36.0-255,66,142897,7,322733
4053,0.002579,74.125.24.0-255,1484,144381,7,322733
4054,0.002591,74.125.24.0-255,5738,150119,7,322733
4055,0.002593,172.31.36.0-255,66,150185,7,322733
4056,0.002604,74.125.24.0-255,1484,151669,7,322733
4057,0.002651,172.31.36.0-255,66,151735,7,322733
4058,0.002671,74.125.24.0-255,6438,158173,7,322733
4059,0.002673,172.31.36.0-255,66,158239,7,322733
4060,0.005254,74.125.24.0-255,5738,163977,7,322733
4061,0.005261,172.31.36.0-255,66,164043,7,322733
4062,0.007839,74.125.24.0-255,5738,169781,7,322733
4063,0.007845,172.31.36.0-255,66,169847,7,322733
4064,0.010454,74.125.24.0-255,5738,175585,7,322733
4065,0.010461,172.31.36.0-255,66,175651,7,322733
4066,0.013056,74.125.24.0-255,5738,181389,7,322733
4067,0.013063,172.31.36.0-255,66,181455,7,322733
4068,0.015695,74.125.24.0-255,5738,187193,7,322733
4069,0.015706,172.31.36.0-255,66,187259,7,322733
4070,0.01832,74.125.24.0-255,5738,192997,7,322733
4071,0.018331,172.31.36.0-255,66,193063,7,322733
4072,0.02094,74.125.24.0-255,5738,198801,7,322733
4073,0.020946,172.31.36.0-255,66,198867,7,322733
4074,0.023558,74.125.24.0-255,5738,204605,7,322733
4075,0.023565,172.31.36.0-255,66,204671,7,322733
4076,0.026235,74.125.24.0-255,5738,210409,7,322733
4077,0.026244,172.31.36.0-255,66,210475,7,322733
4078,0.028835,74.125.24.0-255,5738,216213,7,322733
4079,0.028844,172.31.36.0-255,66,216279,7,322733
4080,0.031435,74.125.24.0-255,5738,222017,7,322733
4081,0.031443,172.31.36.0-255,66,222083,7,322733
4082,0.034038,74.125.24.0-255,5738,227821,7,322733
4083,0.034044,172.31.36.0-255,66,227887,7,322733
4084,0.03476,172.31.36.0-255,172,228059,7,322733
4085,0.034809,172.31.36.0-255,1114,229173,7,322733
4086,0.034848,172.31.36.0-255,1514,230687,7,322733
4087,0.03485,172.31.36.0-255,1292,231979,7,322733
4088,0.036302,104.244.42.0-255,66,232045,7,322733
4089,0.036352,104.244.42.0-255,66,232111,7,322733
4090,0.036417,104.244.42.0-255,66,232177,7,322733
4091,0.036643,74.125.24.0-255,5738,237915,7,322733
4092,0.036649,172.31.36.0-255,66,237981,7,322733
4093,0.039243,74.125.24.0-255,5738,243719,7,322733
4094,0.039251,172.31.36.0-255,66,243785,7,322733
4095,0.041839,74.125.24.0-255,5738,249523,7,322733
4096,0.041863,172.31.36.0-255,66,249589,7,322733
4097,0.044446,74.125.24.0-255,4320,253909,7,322733
4098,0.044452,172.31.36.0-255,66,253975,7,322733
4099,0.04448,74.125.24.0-255,1484,255459,7,322733
4100,0.047048,74.125.24.0-255,2902,258361,7,322733
4101,0.047053,172.31.36.0-255,66,258427,7,322733
4102,0.047088,74.125.24.0-255,1484,259911,7,322733
4103,0.049645,74.125.24.0-255,2902,262813,7,322733
4104,0.049649,172.31.36.0-255,66,262879,7,322733
4105,0.049675,74.125.24.0-255,1484,264363,7,322733
4106,0.052243,74.125.24.0-255,4320,268683,7,322733
4107,0.052249,172.31.36.0-255,66,268749,7,322733
4108,0.054834,74.125.24.0-255,5738,274487,7,322733
4109,0.054839,172.31.36.0-255,66,274553,7,322733
4110,0.057441,74.125.24.0-255,4320,278873,7,322733
4111,0.057446,172.31.36.0-255,66,278939,7,322733
4112,0.057476,74.125.24.0-255,1484,280423,7,322733
4113,0.06005,74.125.24.0-255,4320,284743,7,322733
4114,0.060055,172.31.36.0-255,66,284809,7,322733
4115,0.062658,74.125.24.0-255,5738,290547,7,322733
4116,0.062663,172.31.36.0-255,66,290613,7,322733
4117,0.065233,74.125.24.0-255,5738,296351,7,322733
4118,0.065238,172.31.36.0-255,66,296417,7,322733
4119,0.067822,74.125.24.0-255,4320,300737,7,322733
4120,0.067827,172.31.36.0-255,66,300803,7,322733
4121,0.067858,74.125.24.0-255,1484,302287,7,322733
4122,0.070408,74.125.24.0-255,4320,306607,7,322733
4123,0.070414,172.31.36.0-255,66,306673,7,322733
4124,0.073016,74.125.24.0-255,4320,310993,7,322733
4125,0.073021,172.31.36.0-255,66,311059,7,322733
4126,0.073047,74.125.24.0-255,1484,312543,7,322733
4127,0.075648,74.125.24.0-255,4320,316863,7,322733
4128,0.075655,172.31.36.0-255,66,316929,7,322733
4129,0.078252,74.125.24.0-255,5738,322667,7,322733
4130,0.078258,172.31.36.0-255,66,322733,7,322733
4131,0.0,172.217.194.0-255,150,150,7,288682
4132,1.7e-05,172.31.36.0-255,66,216,7,288682
4133,2.4e-05,172.217.194.0-255,1484,1700,7,288682
4134,2.9e-05,172.31.36.0-255,66,1766,7,288682
4135,4.2e-05,172.217.194.0-255,2902,4668,7,288682
4136,4.6e-05,172.31.36.0-255,66,4734,7,288682
4137,5.5e-05,172.217.194.0-255,7156,11890,7,288682
4138,5.7e-05,172.31.36.0-255,66,11956,7,288682
4139,9.3e-05,172.217.194.0-255,2078,14034,7,288682
4140,9.7e-05,172.31.36.0-255,66,14100,7,288682
4141,0.00012,172.217.194.0-255,2902,17002,7,288682
4142,0.000123,172.31.36.0-255,66,17068,7,288682
4143,0.00013,172.217.194.0-255,4320,21388,7,288682
4144,0.000133,172.31.36.0-255,66,21454,7,288682
4145,0.000163,172.217.194.0-255,2902,24356,7,288682
4146,0.000166,172.31.36.0-255,66,24422,7,288682
4147,0.000188,172.217.194.0-255,6797,31219,7,288682
4148,0.00019,172.31.36.0-255,66,31285,7,288682
4149,0.00058,172.217.194.0-255,1484,32769,7,288682
4150,0.000587,172.31.36.0-255,66,32835,7,288682
4151,0.000594,172.217.194.0-255,2902,35737,7,288682
4152,0.000597,172.31.36.0-255,66,35803,7,288682
4153,0.000614,172.217.194.0-255,4320,40123,7,288682
4154,0.000617,172.31.36.0-255,66,40189,7,288682
4155,0.000645,172.217.194.0-255,1484,41673,7,288682
4156,0.000647,172.31.36.0-255,66,41739,7,288682
4157,0.000655,172.217.194.0-255,6797,48536,7,288682
4158,0.000657,172.31.36.0-255,66,48602,7,288682
4159,0.000669,172.217.194.0-255,4320,52922,7,288682
4160,0.000671,172.31.36.0-255,66,52988,7,288682
4161,0.000718,172.31.36.0-255,66,53054,7,288682
4162,0.000722,172.217.194.0-255,2543,55597,7,288682
4163,0.000724,172.31.36.0-255,66,55663,7,288682
4164,0.000727,172.217.194.0-255,680,56343,7,288682
4165,0.000973,172.217.194.0-255,1484,57827,7,288682
4166,0.000977,172.31.36.0-255,66,57893,7,288682
4167,0.000983,172.217.194.0-255,2902,60795,7,288682
4168,0.000986,172.31.36.0-255,66,60861,7,288682
4169,0.000989,172.217.194.0-255,1484,62345,7,288682
4170,0.001001,172.217.194.0-255,5738,68083,7,288682
4171,0.001003,172.31.36.0-255,66,68149,7,288682
4172,0.001078,172.31.36.0-255,66,68215,7,288682
4173,0.00109,172.31.36.0-255,66,68281,7,288682
4174,0.001467,172.217.194.0-255,1484,69765,7,288682
4175,0.001474,172.217.194.0-255,2902,72667,7,288682
4176,0.001477,172.31.36.0-255,66,72733,7,288682
4177,0.001485,172.217.194.0-255,5738,78471,7,288682
4178,0.001487,172.31.36.0-255,66,78537,7,288682
4179,0.001494,172.217.194.0-255,5738,84275,7,288682
4180,0.0015,172.31.36.0-255,66,84341,7,288682
4181,0.001523,172.217.194.0-255,1484,85825,7,288682
4182,0.001539,172.31.36.0-255,66,85891,7,288682
4183,0.001543,172.217.194.0-255,2184,88075,7,288682
4184,0.001545,172.31.36.0-255,66,88141,7,288682
4185,0.001776,172.217.194.0-255,1484,89625,7,288682
4186,0.001783,172.217.194.0-255,2902,92527,7,288682
4187,0.001786,172.31.36.0-255,66,92593,7,288682
4188,0.001821,172.217.194.0-255,5738,98331,7,288682
4189,0.001824,172.31.36.0-255,66,98397,7,288682
4190,0.001838,172.31.36.0-255,66,98463,7,288682
4191,0.001886,172.31.36.0-255,66,98529,7,288682
4192,0.001938,172.217.194.0-255,1484,100013,7,288682
4193,0.001942,172.217.194.0-255,1484,101497,7,288682
4194,0.001945,172.31.36.0-255,66,101563,7,288682
4195,0.001974,172.217.194.0-255,1484,103047,7,288682
4196,0.00198,172.217.194.0-255,5738,108785,7,288682
4197,0.001983,172.31.36.0-255,66,108851,7,288682
4198,0.001999,172.31.36.0-255,66,108917,7,288682
4199,0.002001,172.217.194.0-255,1484,110401,7,288682
4200,0.002041,172.31.36.0-255,66,110467,7,288682
4201,0.002063,172.217.194.0-255,1484,111951,7,288682
4202,0.002068,172.217.194.0-255,2902,114853,7,288682
4203,0.002071,172.31.36.0-255,66,114919,7,288682
4204,0.002077,172.217.194.0-255,4320,119239,7,288682
4205,0.002079,172.31.36.0-255,66,119305,7,288682
4206,0.002108,172.217.194.0-255,1484,120789,7,288682
4207,0.002115,172.217.194.0-255,7156,127945,7,288682
4208,0.002118,172.31.36.0-255,66,128011,7,288682
4209,0.002147,172.217.194.0-255,5738,133749,7,288682
4210,0.00215,172.31.36.0-255,66,133815,7,288682
4211,0.002167,172.31.36.0-255,66,133881,7,288682
4212,0.002175,172.217.194.0-255,7156,141037,7,288682
4213,0.002177,172.31.36.0-255,66,141103,7,288682
4214,0.0022,172.217.194.0-255,2902,144005,7,288682
4215,0.002202,172.31.36.0-255,66,144071,7,288682
4216,0.002221,172.31.36.0-255,66,144137,7,288682
4217,0.002267,172.31.36.0-255,66,144203,7,288682
4218,0.002304,172.217.194.0-255,4320,148523,7,288682
4219,0.002306,172.31.36.0-255,66,148589,7,288682
4220,0.002336,172.217.194.0-255,5738,154327,7,288682
4221,0.002339,172.31.36.0-255,66,154393,7,288682
4222,0.002352,172.31.36.0-255,66,154459,7,288682
4223,0.002355,172.217.194.0-255,1484,155943,7,288682
4224,0.004615,172.217.194.0-255,4320,160263,7,288682
4225,0.004623,172.31.36.0-255,66,160329,7,288682
4226,0.006882,172.217.194.0-255,5738,166067,7,288682
4227,0.006889,172.31.36.0-255,66,166133,7,288682
4228,0.00917,172.217.194.0-255,5738,171871,7,288682
4229,0.009175,172.31.36.0-255,66,171937,7,288682
4230,0.011443,172.217.194.0-255,5738,177675,7,288682
4231,0.011451,172.31.36.0-255,66,177741,7,288682
4232,0.013714,172.217.194.0-255,5738,183479,7,288682
4233,0.013723,172.31.36.0-255,66,183545,7,288682
4234,0.015986,172.217.194.0-255,5738,189283,7,288682
4235,0.015995,172.31.36.0-255,66,189349,7,288682
4236,0.018242,172.217.194.0-255,5738,195087,7,288682
4237,0.018252,172.31.36.0-255,66,195153,7,288682
4238,0.020525,172.217.194.0-255,5738,200891,7,288682
4239,0.020533,172.31.36.0-255,66,200957,7,288682
4240,0.022777,172.217.194.0-255,5738,206695,7,288682
4241,0.022786,172.31.36.0-255,66,206761,7,288682
4242,0.025067,172.217.194.0-255,5738,212499,7,288682
4243,0.025074,172.31.36.0-255,66,212565,7,288682
4244,0.027345,172.217.194.0-255,5738,218303,7,288682
4245,0.027353,172.31.36.0-255,66,218369,7,288682
4246,0.029651,172.217.194.0-255,5738,224107,7,288682
4247,0.029659,172.31.36.0-255,66,224173,7,288682
4248,0.031912,172.217.194.0-255,5738,229911,7,288682
4249,0.031919,172.31.36.0-255,66,229977,7,288682
4250,0.034183,172.217.194.0-255,5738,235715,7,288682
4251,0.03419,172.31.36.0-255,66,235781,7,288682
4252,0.035915,172.31.36.0-255,172,235953,7,288682
4253,0.035944,172.31.36.0-255,1113,237066,7,288682
4254,0.036002,172.31.36.0-255,1514,238580,7,288682
4255,0.036004,172.31.36.0-255,1514,240094,7,288682
4256,0.036005,172.31.36.0-255,1514,241608,7,288682
4257,0.036009,172.31.36.0-255,1514,243122,7,288682
4258,0.036011,172.31.36.0-255,1514,244636,7,288682
4259,0.036011,172.31.36.0-255,73,244709,7,288682
4260,0.036464,172.217.194.0-255,5738,250447,7,288682
4261,0.036472,172.31.36.0-255,66,250513,7,288682
4262,0.037406,104.244.42.0-255,66,250579,7,288682
4263,0.037439,104.244.42.0-255,66,250645,7,288682
4264,0.037508,104.244.42.0-255,66,250711,7,288682
4265,0.037514,104.244.42.0-255,66,250777,7,288682
4266,0.038742,172.217.194.0-255,5738,256515,7,288682
4267,0.03875,172.31.36.0-255,66,256581,7,288682
4268,0.04102,172.217.194.0-255,5738,262319,7,288682
4269,0.04103,172.31.36.0-255,66,262385,7,288682
4270,0.043296,172.217.194.0-255,5738,268123,7,288682
4271,0.043303,172.31.36.0-255,66,268189,7,288682
4272,0.04557,172.217.194.0-255,5738,273927,7,288682
4273,0.045576,172.31.36.0-255,66,273993,7,288682
4274,0.047832,172.217.194.0-255,5738,279731,7,288682
4275,0.047839,172.31.36.0-255,66,279797,7,288682
4276,0.050112,172.217.194.0-255,5738,285535,7,288682
4277,0.050119,172.31.36.0-255,66,285601,7,288682
4278,0.05237,172.217.194.0-255,2319,287920,7,288682
4279,0.052378,172.31.36.0-255,66,287986,7,288682
4280,0.052544,172.31.36.0-255,105,288091,7,288682
4281,0.052579,172.31.36.0-255,105,288196,7,288682
4282,0.052862,172.31.36.0-255,90,288286,7,288682
4283,0.05288,172.31.36.0-255,66,288352,7,288682
4284,0.054782,172.217.194.0-255,66,288418,7,288682
4285,0.054811,172.217.194.0-255,66,288484,7,288682
4286,0.055089,172.217.194.0-255,66,288550,7,288682
4287,0.055105,172.217.194.0-255,66,288616,7,288682
4288,0.055118,172.31.36.0-255,66,288682,7,288682
4289,0.0,74.125.24.0-255,146,146,7,291803
4290,3.5e-05,172.31.36.0-255,66,212,7,291803
4291,4.2e-05,74.125.24.0-255,1484,1696,7,291803
4292,4.7e-05,172.31.36.0-255,66,1762,7,291803
4293,5.2e-05,74.125.24.0-255,2902,4664,7,291803
4294,5.4e-05,172.31.36.0-255,66,4730,7,291803
4295,6.1e-05,74.125.24.0-255,7156,11886,7,291803
4296,6.3e-05,172.31.36.0-255,66,11952,7,291803
4297,6.7e-05,74.125.24.0-255,1484,13436,7,291803
4298,7e-05,172.31.36.0-255,66,13502,7,291803
4299,8.7e-05,74.125.24.0-255,2026,15528,7,291803
4300,8.9e-05,172.31.36.0-255,66,15594,7,291803
4301,9.5e-05,74.125.24.0-255,4320,19914,7,291803
4302,9.7e-05,172.31.36.0-255,66,19980,7,291803
4303,0.000101,74.125.24.0-255,2902,22882,7,291803
4304,0.000105,172.31.36.0-255,66,22948,7,291803
4305,0.000136,74.125.24.0-255,7156,30104,7,291803
4306,0.000139,172.31.36.0-255,66,30170,7,291803
4307,0.000142,74.125.24.0-255,1125,31295,7,291803
4308,0.000144,172.31.36.0-255,66,31361,7,291803
4309,0.000297,74.125.24.0-255,1484,32845,7,291803
4310,0.000302,172.31.36.0-255,66,32911,7,291803
4311,0.000308,74.125.24.0-255,2902,35813,7,291803
4312,0.000311,172.31.36.0-255,66,35879,7,291803
4313,0.000314,74.125.24.0-255,1484,37363,7,291803
4314,0.000316,172.31.36.0-255,66,37429,7,291803
4315,0.000337,74.125.24.0-255,1484,38913,7,291803
4316,0.000341,172.31.36.0-255,66,38979,7,291803
4317,0.00035,74.125.24.0-255,7156,46135,7,291803
4318,0.000353,172.31.36.0-255,66,46201,7,291803
4319,0.000384,74.125.24.0-255,5379,51580,7,291803
4320,0.000389,172.31.36.0-255,66,51646,7,291803
4321,0.000395,74.125.24.0-255,5738,57384,7,291803
4322,0.000398,172.31.36.0-255,66,57450,7,291803
4323,0.000456,74.125.24.0-255,5738,63188,7,291803
4324,0.000461,172.31.36.0-255,66,63254,7,291803
4325,0.000481,74.125.24.0-255,2820,66074,7,291803
4326,0.000485,172.31.36.0-255,66,66140,7,291803
4327,0.000515,74.125.24.0-255,378,66518,7,291803
4328,0.000556,74.125.24.0-255,1484,68002,7,291803
4329,0.000561,172.31.36.0-255,66,68068,7,291803
4330,0.000582,74.125.24.0-255,1484,69552,7,291803
4331,0.000587,74.125.24.0-255,2902,72454,7,291803
4332,0.000589,172.31.36.0-255,66,72520,7,291803
4333,0.000613,74.125.24.0-255,5738,78258,7,291803
4334,0.000616,172.31.36.0-255,66,78324,7,291803
4335,0.000621,74.125.24.0-255,2902,81226,7,291803
4336,0.000623,172.31.36.0-255,66,81292,7,291803
4337,0.000687,74.125.24.0-255,2543,83835,7,291803
4338,0.000692,172.31.36.0-255,66,83901,7,291803
4339,0.000832,74.125.24.0-255,1484,85385,7,291803
4340,0.000839,74.125.24.0-255,2902,88287,7,291803
4341,0.000842,172.31.36.0-255,66,88353,7,291803
4342,0.000849,74.125.24.0-255,5738,94091,7,291803
4343,0.000851,172.31.36.0-255,66,94157,7,291803
4344,0.000878,74.125.24.0-255,5738,99895,7,291803
4345,0.000882,172.31.36.0-255,66,99961,7,291803
4346,0.000908,74.125.24.0-255,6797,106758,7,291803
4347,0.000912,172.31.36.0-255,66,106824,7,291803
4348,0.000926,172.31.36.0-255,66,106890,7,291803
4349,0.000967,74.125.24.0-255,5738,112628,7,291803
4350,0.000972,172.31.36.0-255,66,112694,7,291803
4351,0.001,74.125.24.0-255,5738,118432,7,291803
4352,0.001004,172.31.36.0-255,66,118498,7,291803
4353,0.001009,74.125.24.0-255,3602,122100,7,291803
4354,0.001012,172.31.36.0-255,66,122166,7,291803
4355,0.001027,74.125.24.0-255,1484,123650,7,291803
4356,0.001056,74.125.24.0-255,2902,126552,7,291803
4357,0.00106,172.31.36.0-255,66,126618,7,291803
4358,0.001067,74.125.24.0-255,5738,132356,7,291803
4359,0.001069,172.31.36.0-255,66,132422,7,291803
4360,0.001074,74.125.24.0-255,4320,136742,7,291803
4361,0.001077,172.31.36.0-255,66,136808,7,291803
4362,0.001091,74.125.24.0-255,1484,138292,7,291803
4363,0.001117,172.31.36.0-255,66,138358,7,291803
4364,0.001146,172.31.36.0-255,66,138424,7,291803
4365,0.001809,74.125.24.0-255,1484,139908,7,291803
4366,0.001829,74.125.24.0-255,2902,142810,7,291803
4367,0.001834,172.31.36.0-255,66,142876,7,291803
4368,0.001841,74.125.24.0-255,5738,148614,7,291803
4369,0.001843,172.31.36.0-255,66,148680,7,291803
4370,0.001846,74.125.24.0-255,1484,150164,7,291803
4371,0.001849,74.125.24.0-255,1484,151648,7,291803
4372,0.001851,172.31.36.0-255,66,151714,7,291803
4373,0.001874,74.125.24.0-255,7156,158870,7,291803
4374,0.001879,172.31.36.0-255,66,158936,7,291803
4375,0.001888,74.125.24.0-255,2902,161838,7,291803
4376,0.001891,172.31.36.0-255,66,161904,7,291803
4377,0.001921,172.31.36.0-255,66,161970,7,291803
4378,0.002028,74.125.24.0-255,1484,163454,7,291803
4379,0.002032,74.125.24.0-255,2902,166356,7,291803
4380,0.002035,172.31.36.0-255,66,166422,7,291803
4381,0.002038,74.125.24.0-255,1484,167906,7,291803
4382,0.00206,74.125.24.0-255,4320,172226,7,291803
4383,0.002064,172.31.36.0-255,66,172292,7,291803
4384,0.002065,74.125.24.0-255,5738,178030,7,291803
4385,0.002068,172.31.36.0-255,66,178096,7,291803
4386,0.002091,74.125.24.0-255,7156,185252,7,291803
4387,0.002094,172.31.36.0-255,66,185318,7,291803
4388,0.002104,172.31.36.0-255,66,185384,7,291803
4389,0.002132,74.125.24.0-255,2184,187568,7,291803
4390,0.002135,172.31.36.0-255,66,187634,7,291803
4391,0.002148,172.31.36.0-255,66,187700,7,291803
4392,0.002165,172.31.36.0-255,66,187766,7,291803
4393,0.00219,74.125.24.0-255,5738,193504,7,291803
4394,0.002193,172.31.36.0-255,66,193570,7,291803
4395,0.002201,74.125.24.0-255,6438,200008,7,291803
4396,0.002203,172.31.36.0-255,66,200074,7,291803
4397,0.002239,74.125.24.0-255,1484,201558,7,291803
4398,0.002243,74.125.24.0-255,1484,203042,7,291803
4399,0.002245,172.31.36.0-255,66,203108,7,291803
4400,0.002262,74.125.24.0-255,1484,204592,7,291803
4401,0.002268,74.125.24.0-255,5738,210330,7,291803
4402,0.002271,172.31.36.0-255,66,210396,7,291803
4403,0.002294,74.125.24.0-255,2902,213298,7,291803
4404,0.002297,172.31.36.0-255,66,213364,7,291803
4405,0.002323,74.125.24.0-255,7156,220520,7,291803
4406,0.002326,172.31.36.0-255,66,220586,7,291803
4407,0.002339,74.125.24.0-255,1484,222070,7,291803
4408,0.002344,74.125.24.0-255,2902,224972,7,291803
4409,0.002346,172.31.36.0-255,66,225038,7,291803
4410,0.002378,172.31.36.0-255,66,225104,7,291803
4411,0.002454,74.125.24.0-255,1484,226588,7,291803
4412,0.00246,74.125.24.0-255,2902,229490,7,291803
4413,0.002464,172.31.36.0-255,66,229556,7,291803
4414,0.002523,74.125.24.0-255,5738,235294,7,291803
4415,0.002528,172.31.36.0-255,66,235360,7,291803
4416,0.00254,172.31.36.0-255,66,235426,7,291803
4417,0.002554,74.125.24.0-255,5738,241164,7,291803
4418,0.002557,172.31.36.0-255,66,241230,7,291803
4419,0.002569,172.31.36.0-255,66,241296,7,291803
4420,0.002607,74.125.24.0-255,5738,247034,7,291803
4421,0.002608,172.31.36.0-255,66,247100,7,291803
4422,0.002612,172.31.36.0-255,66,247166,7,291803
4423,0.002647,172.31.36.0-255,66,247232,7,291803
4424,0.005187,74.125.24.0-255,5738,252970,7,291803
4425,0.005193,172.31.36.0-255,66,253036,7,291803
4426,0.007756,74.125.24.0-255,5738,258774,7,291803
4427,0.007764,172.31.36.0-255,66,258840,7,291803
4428,0.010326,74.125.24.0-255,5738,264578,7,291803
4429,0.010333,172.31.36.0-255,66,264644,7,291803
4430,0.012943,74.125.24.0-255,5738,270382,7,291803
4431,0.012954,172.31.36.0-255,66,270448,7,291803
4432,0.015545,74.125.24.0-255,5738,276186,7,291803
4433,0.015554,172.31.36.0-255,66,276252,7,291803
4434,0.018141,74.125.24.0-255,5738,281990,7,291803
4435,0.018148,172.31.36.0-255,66,282056,7,291803
4436,0.020711,74.125.24.0-255,5738,287794,7,291803
4437,0.020722,172.31.36.0-255,66,287860,7,291803
4438,0.023276,74.125.24.0-255,2329,290189,7,291803
4439,0.023286,172.31.36.0-255,66,290255,7,291803
4440,0.026094,172.31.36.0-255,172,290427,7,291803
4441,0.026124,172.31.36.0-255,1073,291500,7,291803
4442,0.026217,172.31.36.0-255,105,291605,7,291803
4443,0.027661,104.244.42.0-255,66,291671,7,291803
4444,0.027683,104.244.42.0-255,66,291737,7,291803
4445,0.028736,74.125.24.0-255,66,291803,7,291803
4446,0.0,172.31.36.0-255,105,105,7,276
4447,0.001488,157.240.13.0-255,105,210,7,276
4448,0.001501,172.31.36.0-255,66,276,7,276
4449,0.0,74.125.24.0-255,145,145,7,298721
4450,2.3e-05,172.31.36.0-255,66,211,7,298721
4451,3e-05,74.125.24.0-255,1484,1695,7,298721
4452,3.3e-05,172.31.36.0-255,66,1761,7,298721
4453,3.8e-05,74.125.24.0-255,2902,4663,7,298721
4454,4.1e-05,172.31.36.0-255,66,4729,7,298721
4455,4.8e-05,74.125.24.0-255,7156,11885,7,298721
4456,5e-05,172.31.36.0-255,66,11951,7,298721
4457,5.4e-05,74.125.24.0-255,2013,13964,7,298721
4458,5.6e-05,172.31.36.0-255,66,14030,7,298721
4459,0.000104,74.125.24.0-255,1484,15514,7,298721
4460,0.000107,172.31.36.0-255,66,15580,7,298721
4461,0.00011,74.125.24.0-255,1484,17064,7,298721
4462,0.000112,172.31.36.0-255,66,17130,7,298721
4463,0.000131,74.125.24.0-255,1484,18614,7,298721
4464,0.000133,172.31.36.0-255,66,18680,7,298721
4465,0.00014,74.125.24.0-255,5738,24418,7,298721
4466,0.000142,172.31.36.0-255,66,24484,7,298721
4467,0.000172,74.125.24.0-255,6797,31281,7,298721
4468,0.000174,172.31.36.0-255,66,31347,7,298721
4469,0.000233,74.125.24.0-255,1484,32831,7,298721
4470,0.000236,172.31.36.0-255,66,32897,7,298721
4471,0.00024,74.125.24.0-255,1484,34381,7,298721
4472,0.000242,172.31.36.0-255,66,34447,7,298721
4473,0.000257,74.125.24.0-255,1484,35931,7,298721
4474,0.000261,172.31.36.0-255,66,35997,7,298721
4475,0.000265,74.125.24.0-255,2902,38899,7,298721
4476,0.000267,172.31.36.0-255,66,38965,7,298721
4477,0.000288,74.125.24.0-255,7156,46121,7,298721
4478,0.000291,172.31.36.0-255,66,46187,7,298721
4479,0.000311,74.125.24.0-255,2543,48730,7,298721
4480,0.000314,172.31.36.0-255,66,48796,7,298721
4481,0.001285,74.125.24.0-255,1484,50280,7,298721
4482,0.001296,74.125.24.0-255,2902,53182,7,298721
4483,0.0013,172.31.36.0-255,66,53248,7,298721
4484,0.001308,74.125.24.0-255,5738,58986,7,298721
4485,0.00131,172.31.36.0-255,66,59052,7,298721
4486,0.001314,74.125.24.0-255,2902,61954,7,298721
4487,0.001316,172.31.36.0-255,66,62020,7,298721
4488,0.001336,74.125.24.0-255,4543,66563,7,298721
4489,0.001338,172.31.36.0-255,66,66629,7,298721
4490,0.00136,74.125.24.0-255,1484,68113,7,298721
4491,0.001371,74.125.24.0-255,1484,69597,7,298721
4492,0.001373,172.31.36.0-255,66,69663,7,298721
4493,0.001394,74.125.24.0-255,1484,71147,7,298721
4494,0.0014,74.125.24.0-255,5738,76885,7,298721
4495,0.001403,172.31.36.0-255,66,76951,7,298721
4496,0.001434,172.31.36.0-255,66,77017,7,298721
4497,0.001453,74.125.24.0-255,2543,79560,7,298721
4498,0.001455,172.31.36.0-255,66,79626,7,298721
4499,0.001466,172.31.36.0-255,66,79692,7,298721
4500,0.001511,74.125.24.0-255,1125,80817,7,298721
4501,0.001845,172.31.36.0-255,66,80883,7,298721
4502,0.003487,74.125.24.0-255,4320,85203,7,298721
4503,0.003492,172.31.36.0-255,66,85269,7,298721
4504,0.003881,74.125.24.0-255,1484,86753,7,298721
4505,0.005562,74.125.24.0-255,4320,91073,7,298721
4506,0.005566,172.31.36.0-255,66,91139,7,298721
4507,0.007617,74.125.24.0-255,5738,96877,7,298721
4508,0.007625,172.31.36.0-255,66,96943,7,298721
4509,0.009656,74.125.24.0-255,5738,102681,7,298721
4510,0.009664,172.31.36.0-255,66,102747,7,298721
4511,0.01181,74.125.24.0-255,5738,108485,7,298721
4512,0.011821,172.31.36.0-255,66,108551,7,298721
4513,0.013876,74.125.24.0-255,5738,114289,7,298721
4514,0.013883,172.31.36.0-255,66,114355,7,298721
4515,0.015926,74.125.24.0-255,5738,120093,7,298721
4516,0.015933,172.31.36.0-255,66,120159,7,298721
4517,0.017976,74.125.24.0-255,5738,125897,7,298721
4518,0.017984,172.31.36.0-255,66,125963,7,298721
4519,0.020056,74.125.24.0-255,5738,131701,7,298721
4520,0.020064,172.31.36.0-255,66,131767,7,298721
4521,0.022124,74.125.24.0-255,5738,137505,7,298721
4522,0.022131,172.31.36.0-255,66,137571,7,298721
4523,0.024172,74.125.24.0-255,5738,143309,7,298721
4524,0.024179,172.31.36.0-255,66,143375,7,298721
4525,0.026224,74.125.24.0-255,5738,149113,7,298721
4526,0.02623,172.31.36.0-255,66,149179,7,298721
4527,0.026846,172.31.36.0-255,172,149351,7,298721
4528,0.026886,172.31.36.0-255,1113,150464,7,298721
4529,0.026965,172.31.36.0-255,1514,151978,7,298721
4530,0.026967,172.31.36.0-255,1514,153492,7,298721
4531,0.026968,172.31.36.0-255,1514,155006,7,298721
4532,0.026973,172.31.36.0-255,1514,156520,7,298721
4533,0.026974,172.31.36.0-255,1514,158034,7,298721
4534,0.026974,172.31.36.0-255,71,158105,7,298721
4535,0.028298,74.125.24.0-255,5738,163843,7,298721
4536,0.028305,172.31.36.0-255,66,163909,7,298721
4537,0.028416,104.244.42.0-255,66,163975,7,298721
4538,0.028476,104.244.42.0-255,66,164041,7,298721
4539,0.028568,104.244.42.0-255,66,164107,7,298721
4540,0.028574,104.244.42.0-255,66,164173,7,298721
4541,0.030342,74.125.24.0-255,4320,168493,7,298721
4542,0.030348,172.31.36.0-255,66,168559,7,298721
4543,0.03038,74.125.24.0-255,1484,170043,7,298721
4544,0.032392,74.125.24.0-255,4320,174363,7,298721
4545,0.032398,172.31.36.0-255,66,174429,7,298721
4546,0.034447,74.125.24.0-255,5738,180167,7,298721
4547,0.034451,172.31.36.0-255,66,180233,7,298721
4548,0.036493,74.125.24.0-255,5738,185971,7,298721
4549,0.036498,172.31.36.0-255,66,186037,7,298721
4550,0.038562,74.125.24.0-255,5738,191775,7,298721
4551,0.038568,172.31.36.0-255,66,191841,7,298721
4552,0.040629,74.125.24.0-255,5738,197579,7,298721
4553,0.040633,172.31.36.0-255,66,197645,7,298721
4554,0.042708,74.125.24.0-255,5738,203383,7,298721
4555,0.042714,172.31.36.0-255,66,203449,7,298721
4556,0.044824,74.125.24.0-255,5738,209187,7,298721
4557,0.044829,172.31.36.0-255,66,209253,7,298721
4558,0.046847,74.125.24.0-255,1484,210737,7,298721
4559,0.046879,74.125.24.0-255,4320,215057,7,298721
4560,0.046884,172.31.36.0-255,66,215123,7,298721
4561,0.048924,74.125.24.0-255,5738,220861,7,298721
4562,0.04893,172.31.36.0-255,66,220927,7,298721
4563,0.051049,74.125.24.0-255,1484,222411,7,298721
4564,0.051077,74.125.24.0-255,4320,226731,7,298721
4565,0.051082,172.31.36.0-255,66,226797,7,298721
4566,0.053144,74.125.24.0-255,5738,232535,7,298721
4567,0.05315,172.31.36.0-255,66,232601,7,298721
4568,0.055179,74.125.24.0-255,5738,238339,7,298721
4569,0.055185,172.31.36.0-255,66,238405,7,298721
4570,0.057213,74.125.24.0-255,5738,244143,7,298721
4571,0.057218,172.31.36.0-255,66,244209,7,298721
4572,0.059243,74.125.24.0-255,4320,248529,7,298721
4573,0.059249,172.31.36.0-255,66,248595,7,298721
4574,0.059275,74.125.24.0-255,1484,250079,7,298721
4575,0.061379,74.125.24.0-255,2902,252981,7,298721
4576,0.061385,172.31.36.0-255,66,253047,7,298721
4577,0.061403,74.125.24.0-255,1484,254531,7,298721
4578,0.063426,74.125.24.0-255,4320,258851,7,298721
4579,0.063431,172.31.36.0-255,66,258917,7,298721
4580,0.06549,74.125.24.0-255,5738,264655,7,298721
4581,0.065495,172.31.36.0-255,66,264721,7,298721
4582,0.067544,74.125.24.0-255,5738,270459,7,298721
4583,0.06755,172.31.36.0-255,66,270525,7,298721
4584,0.069594,74.125.24.0-255,4320,274845,7,298721
4585,0.0696,172.31.36.0-255,66,274911,7,298721
4586,0.069666,74.125.24.0-255,1484,276395,7,298721
4587,0.071747,74.125.24.0-255,1484,277879,7,298721
4588,0.071751,172.31.36.0-255,66,277945,7,298721
4589,0.071782,74.125.24.0-255,2902,280847,7,298721
4590,0.071784,172.31.36.0-255,66,280913,7,298721
4591,0.073806,74.125.24.0-255,2902,283815,7,298721
4592,0.073811,172.31.36.0-255,66,283881,7,298721
4593,0.073844,74.125.24.0-255,2902,286783,7,298721
4594,0.073847,172.31.36.0-255,66,286849,7,298721
4595,0.075849,74.125.24.0-255,2902,289751,7,298721
4596,0.075854,172.31.36.0-255,66,289817,7,298721
4597,0.075895,74.125.24.0-255,2902,292719,7,298721
4598,0.075899,172.31.36.0-255,66,292785,7,298721
4599,0.078212,74.125.24.0-255,2902,295687,7,298721
4600,0.078217,172.31.36.0-255,66,295753,7,298721
4601,0.078255,74.125.24.0-255,2902,298655,7,298721
4602,0.078257,172.31.36.0-255,66,298721,7,298721
4603,0.0,172.217.194.0-255,153,153,7,265549
4604,3.4e-05,172.31.36.0-255,66,219,7,265549
4605,4.1e-05,172.217.194.0-255,1484,1703,7,265549
4606,4.6e-05,172.31.36.0-255,66,1769,7,265549
4607,4.9e-05,172.217.194.0-255,1484,3253,7,265549
4608,5.1e-05,172.31.36.0-255,66,3319,7,265549
4609,8.2e-05,172.217.194.0-255,1484,4803,7,265549
4610,8.6e-05,172.31.36.0-255,66,4869,7,265549
4611,9.3e-05,172.217.194.0-255,5738,10607,7,265549
4612,9.5e-05,172.31.36.0-255,66,10673,7,265549
4613,0.000111,172.31.36.0-255,66,10739,7,265549
4614,0.000118,172.217.194.0-255,6797,17536,7,265549
4615,0.000121,172.31.36.0-255,66,17602,7,265549
4616,0.000159,172.217.194.0-255,1484,19086,7,265549
4617,0.000162,172.31.36.0-255,66,19152,7,265549
4618,0.000168,172.217.194.0-255,2902,22054,7,265549
4619,0.00017,172.31.36.0-255,66,22120,7,265549
4620,0.000184,172.217.194.0-255,5738,27858,7,265549
4621,0.000187,172.31.36.0-255,66,27924,7,265549
4622,0.000198,172.31.36.0-255,66,27990,7,265549
4623,0.000243,172.217.194.0-255,2902,30892,7,265549
4624,0.000246,172.31.36.0-255,66,30958,7,265549
4625,0.000288,172.31.36.0-255,66,31024,7,265549
4626,0.000374,172.217.194.0-255,120,31144,7,265549
4627,0.000379,172.31.36.0-255,66,31210,7,265549
4628,0.000404,172.217.194.0-255,380,31590,7,265549
4629,0.000407,172.31.36.0-255,66,31656,7,265549
4630,0.000651,172.217.194.0-255,1484,33140,7,265549
4631,0.000656,172.31.36.0-255,66,33206,7,265549
4632,0.000661,172.217.194.0-255,2902,36108,7,265549
4633,0.000663,172.31.36.0-255,66,36174,7,265549
4634,0.000697,172.217.194.0-255,5738,41912,7,265549
4635,0.0007,172.31.36.0-255,66,41978,7,265549
4636,0.000713,172.31.36.0-255,66,42044,7,265549
4637,0.000735,172.217.194.0-255,1484,43528,7,265549
4638,0.000741,172.217.194.0-255,1484,45012,7,265549
4639,0.000743,172.31.36.0-255,66,45078,7,265549
4640,0.000749,172.217.194.0-255,4320,49398,7,265549
4641,0.000751,172.31.36.0-255,66,49464,7,265549
4642,0.000779,172.217.194.0-255,5020,54484,7,265549
4643,0.000782,172.31.36.0-255,66,54550,7,265549
4644,0.001212,172.217.194.0-255,1484,56034,7,265549
4645,0.001221,172.217.194.0-255,2902,58936,7,265549
4646,0.001225,172.31.36.0-255,66,59002,7,265549
4647,0.001257,172.217.194.0-255,5738,64740,7,265549
4648,0.001261,172.31.36.0-255,66,64806,7,265549
4649,0.001293,172.217.194.0-255,5738,70544,7,265549
4650,0.001296,172.31.36.0-255,66,70610,7,265549
4651,0.001347,172.31.36.0-255,66,70676,7,265549
4652,0.001376,172.217.194.0-255,1484,72160,7,265549
4653,0.001383,172.217.194.0-255,5020,77180,7,265549
4654,0.001385,172.31.36.0-255,66,77246,7,265549
4655,0.00139,172.217.194.0-255,1484,78730,7,265549
4656,0.001394,172.217.194.0-255,2902,81632,7,265549
4657,0.001397,172.31.36.0-255,66,81698,7,265549
4658,0.00143,172.217.194.0-255,5738,87436,7,265549
4659,0.001433,172.31.36.0-255,66,87502,7,265549
4660,0.001444,172.31.36.0-255,66,87568,7,265549
4661,0.001474,172.31.36.0-255,66,87634,7,265549
4662,0.001498,172.217.194.0-255,3602,91236,7,265549
4663,0.001502,172.31.36.0-255,66,91302,7,265549
4664,0.001528,172.31.36.0-255,66,91368,7,265549
4665,0.001559,172.217.194.0-255,1484,92852,7,265549
4666,0.001574,172.31.36.0-255,66,92918,7,265549
4667,0.001588,172.31.36.0-255,66,92984,7,265549
4668,0.001598,172.31.36.0-255,66,93050,7,265549
4669,0.001625,172.217.194.0-255,4320,97370,7,265549
4670,0.001628,172.31.36.0-255,66,97436,7,265549
4671,0.001647,172.31.36.0-255,66,97502,7,265549
4672,0.001683,172.217.194.0-255,2184,99686,7,265549
4673,0.001686,172.31.36.0-255,66,99752,7,265549
4674,0.00169,172.217.194.0-255,1484,101236,7,265549
4675,0.001694,172.217.194.0-255,2902,104138,7,265549
4676,0.001696,172.31.36.0-255,66,104204,7,265549
4677,0.001702,172.217.194.0-255,5738,109942,7,265549
4678,0.001704,172.31.36.0-255,66,110008,7,265549
4679,0.001744,172.31.36.0-255,66,110074,7,265549
4680,0.001755,172.31.36.0-255,66,110140,7,265549
4681,0.001781,172.217.194.0-255,766,110906,7,265549
4682,0.002115,172.217.194.0-255,1484,112390,7,265549
4683,0.002117,172.31.36.0-255,66,112456,7,265549
4684,0.002141,172.217.194.0-255,2902,115358,7,265549
4685,0.002143,172.31.36.0-255,66,115424,7,265549
4686,0.002148,172.217.194.0-255,2902,118326,7,265549
4687,0.00215,172.31.36.0-255,66,118392,7,265549
4688,0.002173,172.217.194.0-255,2902,121294,7,265549
4689,0.002176,172.31.36.0-255,66,121360,7,265549
4690,0.002183,172.217.194.0-255,1484,122844,7,265549
4691,0.002186,172.217.194.0-255,2902,125746,7,265549
4692,0.002188,172.31.36.0-255,66,125812,7,265549
4693,0.002191,172.217.194.0-255,1484,127296,7,265549
4694,0.002213,172.217.194.0-255,4320,131616,7,265549
4695,0.002215,172.31.36.0-255,66,131682,7,265549
4696,0.002218,172.217.194.0-255,1484,133166,7,265549
4697,0.002252,172.217.194.0-255,2902,136068,7,265549
4698,0.002254,172.31.36.0-255,66,136134,7,265549
4699,0.002267,172.217.194.0-255,4320,140454,7,265549
4700,0.002274,172.31.36.0-255,66,140520,7,265549
4701,0.002298,172.217.194.0-255,5020,145540,7,265549
4702,0.002301,172.31.36.0-255,66,145606,7,265549
4703,0.00456,172.217.194.0-255,2902,148508,7,265549
4704,0.004563,172.31.36.0-255,66,148574,7,265549
4705,0.004621,172.217.194.0-255,2902,151476,7,265549
4706,0.004623,172.31.36.0-255,66,151542,7,265549
4707,0.006829,172.217.194.0-255,2902,154444,7,265549
4708,0.006837,172.31.36.0-255,66,154510,7,265549
4709,0.006865,172.217.194.0-255,2902,157412,7,265549
4710,0.006869,172.31.36.0-255,66,157478,7,265549
4711,0.009096,172.217.194.0-255,2902,160380,7,265549
4712,0.009103,172.31.36.0-255,66,160446,7,265549
4713,0.009148,172.217.194.0-255,2902,163348,7,265549
4714,0.009151,172.31.36.0-255,66,163414,7,265549
4715,0.011374,172.217.194.0-255,2902,166316,7,265549
4716,0.011393,172.31.36.0-255,66,166382,7,265549
4717,0.01144,172.217.194.0-255,2902,169284,7,265549
4718,0.011443,172.31.36.0-255,66,169350,7,265549
4719,0.01366,172.217.194.0-255,2902,172252,7,265549
4720,0.013668,172.31.36.0-255,66,172318,7,265549
4721,0.013706,172.217.194.0-255,2902,175220,7,265549
4722,0.013709,172.31.36.0-255,66,175286,7,265549
4723,0.015936,172.217.194.0-255,2902,178188,7,265549
4724,0.015944,172.31.36.0-255,66,178254,7,265549
4725,0.015966,172.217.194.0-255,2902,181156,7,265549
4726,0.015968,172.31.36.0-255,66,181222,7,265549
4727,0.018229,172.217.194.0-255,5738,186960,7,265549
4728,0.018237,172.31.36.0-255,66,187026,7,265549
4729,0.020515,172.217.194.0-255,5738,192764,7,265549
4730,0.020523,172.31.36.0-255,66,192830,7,265549
4731,0.022787,172.217.194.0-255,5738,198568,7,265549
4732,0.022795,172.31.36.0-255,66,198634,7,265549
4733,0.025042,172.217.194.0-255,5738,204372,7,265549
4734,0.025048,172.31.36.0-255,66,204438,7,265549
4735,0.027323,172.217.194.0-255,5738,210176,7,265549
4736,0.02733,172.31.36.0-255,66,210242,7,265549
4737,0.029648,172.217.194.0-255,5738,215980,7,265549
4738,0.029669,172.31.36.0-255,66,216046,7,265549
4739,0.031924,172.217.194.0-255,5738,221784,7,265549
4740,0.031931,172.31.36.0-255,66,221850,7,265549
4741,0.034236,172.217.194.0-255,5738,227588,7,265549
4742,0.034254,172.31.36.0-255,66,227654,7,265549
4743,0.036522,172.217.194.0-255,5738,233392,7,265549
4744,0.036529,172.31.36.0-255,66,233458,7,265549
4745,0.038794,172.217.194.0-255,5738,239196,7,265549
4746,0.038835,172.31.36.0-255,66,239262,7,265549
4747,0.039964,172.31.36.0-255,172,239434,7,265549
4748,0.039993,172.31.36.0-255,1114,240548,7,265549
4749,0.040035,172.31.36.0-255,1514,242062,7,265549
4750,0.040037,172.31.36.0-255,1292,243354,7,265549
4751,0.041126,172.217.194.0-255,5738,249092,7,265549
4752,0.041134,172.31.36.0-255,66,249158,7,265549
4753,0.041553,104.244.42.0-255,66,249224,7,265549
4754,0.041593,104.244.42.0-255,66,249290,7,265549
4755,0.041597,104.244.42.0-255,66,249356,7,265549
4756,0.042265,104.244.42.0-255,108,249464,7,265549
4757,0.042272,172.31.36.0-255,66,249530,7,265549
4758,0.04343,172.217.194.0-255,5738,255268,7,265549
4759,0.043436,172.31.36.0-255,66,255334,7,265549
4760,0.045714,172.217.194.0-255,5738,261072,7,265549
4761,0.04572,172.31.36.0-255,66,261138,7,265549
4762,0.047981,172.217.194.0-255,1484,262622,7,265549
4763,0.048012,172.217.194.0-255,2690,265312,7,265549
4764,0.048017,172.31.36.0-255,66,265378,7,265549
4765,0.048176,172.31.36.0-255,105,265483,7,265549
4766,0.05041,172.217.194.0-255,66,265549,7,265549
4767,0.0,172.31.36.0-255,105,105,7,105
4768,0.0,172.217.194.0-255,143,143,7,280992
4769,3.4e-05,172.31.36.0-255,66,209,7,280992
4770,4.1e-05,172.217.194.0-255,1484,1693,7,280992
4771,4.6e-05,172.31.36.0-255,66,1759,7,280992
4772,5.1e-05,172.217.194.0-255,2902,4661,7,280992
4773,5.3e-05,172.31.36.0-255,66,4727,7,280992
4774,6.1e-05,172.217.194.0-255,7156,11883,7,280992
4775,6.4e-05,172.31.36.0-255,66,11949,7,280992
4776,9.8e-05,172.217.194.0-255,2085,14034,7,280992
4777,0.000102,172.31.36.0-255,66,14100,7,280992
4778,0.000136,172.217.194.0-255,2902,17002,7,280992
4779,0.000139,172.31.36.0-255,66,17068,7,280992
4780,0.000145,172.217.194.0-255,4320,21388,7,280992
4781,0.000147,172.31.36.0-255,66,21454,7,280992
4782,0.000162,172.217.194.0-255,5738,27192,7,280992
4783,0.000164,172.31.36.0-255,66,27258,7,280992
4784,0.000187,172.217.194.0-255,2902,30160,7,280992
4785,0.000189,172.31.36.0-255,66,30226,7,280992
4786,0.000192,172.217.194.0-255,1125,31351,7,280992
4787,0.000194,172.31.36.0-255,66,31417,7,280992
4788,0.000197,172.217.194.0-255,1484,32901,7,280992
4789,0.000199,172.31.36.0-255,66,32967,7,280992
4790,0.000223,172.217.194.0-255,4320,37287,7,280992
4791,0.000226,172.31.36.0-255,66,37353,7,280992
4792,0.000244,172.217.194.0-255,2902,40255,7,280992
4793,0.000247,172.31.36.0-255,66,40321,7,280992
4794,0.000275,172.217.194.0-255,7156,47477,7,280992
4795,0.000278,172.31.36.0-255,66,47543,7,280992
4796,0.00029,172.217.194.0-255,1125,48668,7,280992
4797,0.000293,172.31.36.0-255,66,48734,7,280992
4798,0.000974,172.217.194.0-255,1484,50218,7,280992
4799,0.000981,172.31.36.0-255,66,50284,7,280992
4800,0.000991,172.217.194.0-255,2902,53186,7,280992
4801,0.000993,172.31.36.0-255,66,53252,7,280992
4802,0.001,172.217.194.0-255,5738,58990,7,280992
4803,0.001002,172.31.36.0-255,66,59056,7,280992
4804,0.001052,172.31.36.0-255,66,59122,7,280992
4805,0.001064,172.31.36.0-255,66,59188,7,280992
4806,0.001086,172.217.194.0-255,3961,63149,7,280992
4807,0.001088,172.31.36.0-255,66,63215,7,280992
4808,0.001129,172.31.36.0-255,66,63281,7,280992
4809,0.001154,172.217.194.0-255,1484,64765,7,280992
4810,0.001158,172.217.194.0-255,1125,65890,7,280992
4811,0.001161,172.31.36.0-255,66,65956,7,280992
4812,0.001167,172.217.194.0-255,4320,70276,7,280992
4813,0.00117,172.31.36.0-255,66,70342,7,280992
4814,0.001213,172.31.36.0-255,66,70408,7,280992
4815,0.00124,172.217.194.0-255,1010,71418,7,280992
4816,0.001292,172.217.194.0-255,198,71616,7,280992
4817,0.001681,172.31.36.0-255,66,71682,7,280992
4818,0.001764,172.217.194.0-255,1484,73166,7,280992
4819,0.001784,172.217.194.0-255,2902,76068,7,280992
4820,0.001787,172.31.36.0-255,66,76134,7,280992
4821,0.00181,172.217.194.0-255,1484,77618,7,280992
4822,0.001824,172.217.194.0-255,4320,81938,7,280992
4823,0.001827,172.31.36.0-255,66,82004,7,280992
4824,0.001832,172.217.194.0-255,4320,86324,7,280992
4825,0.001834,172.31.36.0-255,66,86390,7,280992
4826,0.001849,172.217.194.0-255,4320,90710,7,280992
4827,0.001851,172.31.36.0-255,66,90776,7,280992
4828,0.001869,172.217.194.0-255,2902,93678,7,280992
4829,0.001871,172.31.36.0-255,66,93744,7,280992
4830,0.001882,172.31.36.0-255,66,93810,7,280992
4831,0.001902,172.217.194.0-255,766,94576,7,280992
4832,0.002111,172.31.36.0-255,66,94642,7,280992
4833,0.002415,172.217.194.0-255,1484,96126,7,280992
4834,0.004222,172.217.194.0-255,2902,99028,7,280992
4835,0.004227,172.31.36.0-255,66,99094,7,280992
4836,0.006581,172.217.194.0-255,5738,104832,7,280992
4837,0.006587,172.31.36.0-255,66,104898,7,280992
4838,0.008893,172.217.194.0-255,5738,110636,7,280992
4839,0.008903,172.31.36.0-255,66,110702,7,280992
4840,0.011247,172.217.194.0-255,5738,116440,7,280992
4841,0.011255,172.31.36.0-255,66,116506,7,280992
4842,0.013608,172.217.194.0-255,5738,122244,7,280992
4843,0.013615,172.31.36.0-255,66,122310,7,280992
4844,0.016028,172.217.194.0-255,5738,128048,7,280992
4845,0.016036,172.31.36.0-255,66,128114,7,280992
4846,0.018369,172.217.194.0-255,5738,133852,7,280992
4847,0.018377,172.31.36.0-255,66,133918,7,280992
4848,0.020749,172.217.194.0-255,5738,139656,7,280992
4849,0.020757,172.31.36.0-255,66,139722,7,280992
4850,0.023094,172.217.194.0-255,5738,145460,7,280992
4851,0.023103,172.31.36.0-255,66,145526,7,280992
4852,0.024265,172.31.36.0-255,164,145690,7,280992
4853,0.024297,172.31.36.0-255,1124,146814,7,280992
4854,0.024333,172.31.36.0-255,1514,148328,7,280992
4855,0.024335,172.31.36.0-255,1282,149610,7,280992
4856,0.025445,172.217.194.0-255,5738,155348,7,280992
4857,0.025452,172.31.36.0-255,66,155414,7,280992
4858,0.025841,104.244.42.0-255,66,155480,7,280992
4859,0.025849,104.244.42.0-255,66,155546,7,280992
4860,0.025886,104.244.42.0-255,66,155612,7,280992
4861,0.027781,172.217.194.0-255,5738,161350,7,280992
4862,0.027787,172.31.36.0-255,66,161416,7,280992
4863,0.030117,172.217.194.0-255,5738,167154,7,280992
4864,0.030123,172.31.36.0-255,66,167220,7,280992
4865,0.032456,172.217.194.0-255,5738,172958,7,280992
4866,0.032461,172.31.36.0-255,66,173024,7,280992
4867,0.034773,172.217.194.0-255,5738,178762,7,280992
4868,0.034781,172.31.36.0-255,66,178828,7,280992
4869,0.037126,172.217.194.0-255,4320,183148,7,280992
4870,0.037134,172.31.36.0-255,66,183214,7,280992
4871,0.037168,172.217.194.0-255,1484,184698,7,280992
4872,0.039485,172.217.194.0-255,2902,187600,7,280992
4873,0.03949,172.31.36.0-255,66,187666,7,280992
4874,0.039517,172.217.194.0-255,1484,189150,7,280992
4875,0.041817,172.217.194.0-255,2902,192052,7,280992
4876,0.041822,172.31.36.0-255,66,192118,7,280992
4877,0.041854,172.217.194.0-255,1484,193602,7,280992
4878,0.044181,172.217.194.0-255,4320,197922,7,280992
4879,0.044187,172.31.36.0-255,66,197988,7,280992
4880,0.046512,172.217.194.0-255,5738,203726,7,280992
4881,0.046519,172.31.36.0-255,66,203792,7,280992
4882,0.048859,172.217.194.0-255,4320,208112,7,280992
4883,0.048863,172.31.36.0-255,66,208178,7,280992
4884,0.048895,172.217.194.0-255,1484,209662,7,280992
4885,0.051231,172.217.194.0-255,4320,213982,7,280992
4886,0.051237,172.31.36.0-255,66,214048,7,280992
4887,0.053564,172.217.194.0-255,5738,219786,7,280992
4888,0.05357,172.31.36.0-255,66,219852,7,280992
4889,0.055937,172.217.194.0-255,5738,225590,7,280992
4890,0.055943,172.31.36.0-255,66,225656,7,280992
4891,0.05825,172.217.194.0-255,5738,231394,7,280992
4892,0.058256,172.31.36.0-255,66,231460,7,280992
4893,0.060571,172.217.194.0-255,5738,237198,7,280992
4894,0.060576,172.31.36.0-255,66,237264,7,280992
4895,0.062913,172.217.194.0-255,5738,243002,7,280992
4896,0.062918,172.31.36.0-255,66,243068,7,280992
4897,0.065268,172.217.194.0-255,4320,247388,7,280992
4898,0.065274,172.31.36.0-255,66,247454,7,280992
4899,0.065301,172.217.194.0-255,1484,248938,7,280992
4900,0.067625,172.217.194.0-255,4320,253258,7,280992
4901,0.06763,172.31.36.0-255,66,253324,7,280992
4902,0.069948,172.217.194.0-255,4320,257644,7,280992
4903,0.069953,172.31.36.0-255,66,257710,7,280992
4904,0.069983,172.217.194.0-255,1484,259194,7,280992
4905,0.072291,172.217.194.0-255,4320,263514,7,280992
4906,0.072296,172.31.36.0-255,66,263580,7,280992
4907,0.074609,172.217.194.0-255,5738,269318,7,280992
4908,0.074614,172.31.36.0-255,66,269384,7,280992
4909,0.076938,172.217.194.0-255,5738,275122,7,280992
4910,0.076943,172.31.36.0-255,66,275188,7,280992
4911,0.079283,172.217.194.0-255,5738,280926,7,280992
4912,0.079288,172.31.36.0-255,66,280992,7,280992
4913,0.0,74.125.24.0-255,152,152,7,263548
4914,3.6e-05,172.31.36.0-255,66,218,7,263548
4915,4.3e-05,74.125.24.0-255,1484,1702,7,263548
4916,4.8e-05,172.31.36.0-255,66,1768,7,263548
4917,5.1e-05,74.125.24.0-255,1484,3252,7,263548
4918,5.3e-05,172.31.36.0-255,66,3318,7,263548
4919,6e-05,74.125.24.0-255,4320,7638,7,263548
4920,6.3e-05,172.31.36.0-255,66,7704,7,263548
4921,7.1e-05,74.125.24.0-255,6204,13908,7,263548
4922,7.4e-05,172.31.36.0-255,66,13974,7,263548
4923,0.000115,74.125.24.0-255,2902,16876,7,263548
4924,0.000117,172.31.36.0-255,66,16942,7,263548
4925,0.000141,74.125.24.0-255,4320,21262,7,263548
4926,0.000144,172.31.36.0-255,66,21328,7,263548
4927,0.000155,172.31.36.0-255,66,21394,7,263548
4928,0.000158,74.125.24.0-255,1125,22519,7,263548
4929,0.00016,172.31.36.0-255,66,22585,7,263548
4930,0.000332,74.125.24.0-255,1484,24069,7,263548
4931,0.000337,172.31.36.0-255,66,24135,7,263548
4932,0.000343,74.125.24.0-255,2902,27037,7,263548
4933,0.000347,172.31.36.0-255,66,27103,7,263548
4934,0.000363,74.125.24.0-255,2902,30005,7,263548
4935,0.000365,172.31.36.0-255,66,30071,7,263548
4936,0.000369,74.125.24.0-255,1484,31555,7,263548
4937,0.000371,172.31.36.0-255,66,31621,7,263548
4938,0.000395,74.125.24.0-255,5738,37359,7,263548
4939,0.000398,172.31.36.0-255,66,37425,7,263548
4940,0.000412,74.125.24.0-255,1484,38909,7,263548
4941,0.000414,172.31.36.0-255,66,38975,7,263548
4942,0.000436,74.125.24.0-255,5379,44354,7,263548
4943,0.000439,172.31.36.0-255,66,44420,7,263548
4944,0.000447,74.125.24.0-255,7156,51576,7,263548
4945,0.00045,172.31.36.0-255,66,51642,7,263548
4946,0.000473,74.125.24.0-255,5379,57021,7,263548
4947,0.000476,172.31.36.0-255,66,57087,7,263548
4948,0.00049,74.125.24.0-255,399,57486,7,263548
4949,0.000973,74.125.24.0-255,108,57594,7,263548
4950,0.001055,172.31.36.0-255,66,57660,7,263548
4951,0.001212,74.125.24.0-255,333,57993,7,263548
4952,0.001629,74.125.24.0-255,1484,59477,7,263548
4953,0.001636,172.31.36.0-255,66,59543,7,263548
4954,0.001643,74.125.24.0-255,2902,62445,7,263548
4955,0.001645,172.31.36.0-255,66,62511,7,263548
4956,0.001698,74.125.24.0-255,5738,68249,7,263548
4957,0.0017,172.31.36.0-255,66,68315,7,263548
4958,0.001715,172.31.36.0-255,66,68381,7,263548
4959,0.001756,172.31.36.0-255,66,68447,7,263548
4960,0.004031,74.125.24.0-255,1484,69931,7,263548
4961,0.004048,74.125.24.0-255,4320,74251,7,263548
4962,0.004052,172.31.36.0-255,66,74317,7,263548
4963,0.00633,74.125.24.0-255,5738,80055,7,263548
4964,0.006336,172.31.36.0-255,66,80121,7,263548
4965,0.008662,74.125.24.0-255,5738,85859,7,263548
4966,0.008671,172.31.36.0-255,66,85925,7,263548
4967,0.010946,74.125.24.0-255,5738,91663,7,263548
4968,0.010954,172.31.36.0-255,66,91729,7,263548
4969,0.013253,74.125.24.0-255,2902,94631,7,263548
4970,0.013259,172.31.36.0-255,66,94697,7,263548
4971,0.013278,74.125.24.0-255,2902,97599,7,263548
4972,0.013281,172.31.36.0-255,66,97665,7,263548
4973,0.015549,74.125.24.0-255,5738,103403,7,263548
4974,0.015557,172.31.36.0-255,66,103469,7,263548
4975,0.017849,74.125.24.0-255,5738,109207,7,263548
4976,0.017858,172.31.36.0-255,66,109273,7,263548
4977,0.020159,74.125.24.0-255,5738,115011,7,263548
4978,0.020167,172.31.36.0-255,66,115077,7,263548
4979,0.022437,74.125.24.0-255,5738,120815,7,263548
4980,0.022444,172.31.36.0-255,66,120881,7,263548
4981,0.024744,74.125.24.0-255,5738,126619,7,263548
4982,0.024752,172.31.36.0-255,66,126685,7,263548
4983,0.027047,74.125.24.0-255,5738,132423,7,263548
4984,0.027055,172.31.36.0-255,66,132489,7,263548
4985,0.029358,74.125.24.0-255,5738,138227,7,263548
4986,0.029368,172.31.36.0-255,66,138293,7,263548
4987,0.031648,74.125.24.0-255,5738,144031,7,263548
4988,0.031655,172.31.36.0-255,66,144097,7,263548
4989,0.033404,172.31.36.0-255,167,144264,7,263548
4990,0.033436,172.31.36.0-255,1114,145378,7,263548
4991,0.033502,172.31.36.0-255,1514,146892,7,263548
4992,0.033504,172.31.36.0-255,1292,148184,7,263548
4993,0.033946,74.125.24.0-255,5738,153922,7,263548
4994,0.033953,172.31.36.0-255,66,153988,7,263548
4995,0.034949,104.244.42.0-255,66,154054,7,263548
4996,0.034971,104.244.42.0-255,66,154120,7,263548
4997,0.03509,104.244.42.0-255,66,154186,7,263548
4998,0.035619,104.244.42.0-255,108,154294,7,263548
4999,0.035623,172.31.36.0-255,66,154360,7,263548
5000,0.036246,74.125.24.0-255,4320,158680,7,263548
5001,0.03625,172.31.36.0-255,66,158746,7,263548
5002,0.036268,74.125.24.0-255,1484,160230,7,263548
5003,0.038535,74.125.24.0-255,4320,164550,7,263548
5004,0.038541,172.31.36.0-255,66,164616,7,263548
5005,0.040841,74.125.24.0-255,5738,170354,7,263548
5006,0.040847,172.31.36.0-255,66,170420,7,263548
5007,0.04313,74.125.24.0-255,5738,176158,7,263548
5008,0.043137,172.31.36.0-255,66,176224,7,263548
5009,0.045421,74.125.24.0-255,5738,181962,7,263548
5010,0.045428,172.31.36.0-255,66,182028,7,263548
5011,0.047745,74.125.24.0-255,5738,187766,7,263548
5012,0.047753,172.31.36.0-255,66,187832,7,263548
5013,0.050038,74.125.24.0-255,2902,190734,7,263548
5014,0.050045,172.31.36.0-255,66,190800,7,263548
5015,0.050065,74.125.24.0-255,2902,193702,7,263548
5016,0.050069,172.31.36.0-255,66,193768,7,263548
5017,0.052317,74.125.24.0-255,2902,196670,7,263548
5018,0.052324,172.31.36.0-255,66,196736,7,263548
5019,0.052348,74.125.24.0-255,2902,199638,7,263548
5020,0.052351,172.31.36.0-255,66,199704,7,263548
5021,0.054638,74.125.24.0-255,5738,205442,7,263548
5022,0.054644,172.31.36.0-255,66,205508,7,263548
5023,0.056945,74.125.24.0-255,5738,211246,7,263548
5024,0.056951,172.31.36.0-255,66,211312,7,263548
5025,0.059231,74.125.24.0-255,5738,217050,7,263548
5026,0.059238,172.31.36.0-255,66,217116,7,263548
5027,0.061538,74.125.24.0-255,5738,222854,7,263548
5028,0.061544,172.31.36.0-255,66,222920,7,263548
5029,0.063881,74.125.24.0-255,5738,228658,7,263548
5030,0.063888,172.31.36.0-255,66,228724,7,263548
5031,0.066226,74.125.24.0-255,5738,234462,7,263548
5032,0.066232,172.31.36.0-255,66,234528,7,263548
5033,0.068548,74.125.24.0-255,5738,240266,7,263548
5034,0.068554,172.31.36.0-255,66,240332,7,263548
5035,0.070839,74.125.24.0-255,5738,246070,7,263548
5036,0.070846,172.31.36.0-255,66,246136,7,263548
5037,0.073122,74.125.24.0-255,5738,251874,7,263548
5038,0.073128,172.31.36.0-255,66,251940,7,263548
5039,0.075449,74.125.24.0-255,5738,257678,7,263548
5040,0.075456,172.31.36.0-255,66,257744,7,263548
5041,0.077735,74.125.24.0-255,5738,263482,7,263548
5042,0.077741,172.31.36.0-255,66,263548,7,263548
5043,0.0,74.125.24.0-255,153,153,7,351697
5044,3.9e-05,172.31.36.0-255,66,219,7,351697
5045,4.8e-05,74.125.24.0-255,1484,1703,7,351697
5046,5.3e-05,172.31.36.0-255,66,1769,7,351697
5047,5.7e-05,74.125.24.0-255,2902,4671,7,351697
5048,6e-05,172.31.36.0-255,66,4737,7,351697
5049,6.6e-05,74.125.24.0-255,7156,11893,7,351697
5050,6.9e-05,172.31.36.0-255,66,11959,7,351697
5051,7.4e-05,74.125.24.0-255,2059,14018,7,351697
5052,7.6e-05,172.31.36.0-255,66,14084,7,351697
5053,8.8e-05,172.31.36.0-255,66,14150,7,351697
5054,9.4e-05,74.125.24.0-255,5379,19529,7,351697
5055,9.6e-05,172.31.36.0-255,66,19595,7,351697
5056,0.000274,74.125.24.0-255,1484,21079,7,351697
5057,0.000279,172.31.36.0-255,66,21145,7,351697
5058,0.000285,74.125.24.0-255,2902,24047,7,351697
5059,0.000287,172.31.36.0-255,66,24113,7,351697
5060,0.000292,74.125.24.0-255,2902,27015,7,351697
5061,0.000295,172.31.36.0-255,66,27081,7,351697
5062,0.000311,74.125.24.0-255,2902,29983,7,351697
5063,0.000314,172.31.36.0-255,66,30049,7,351697
5064,0.000321,74.125.24.0-255,6797,36846,7,351697
5065,0.000323,172.31.36.0-255,66,36912,7,351697
5066,0.000885,74.125.24.0-255,1484,38396,7,351697
5067,0.00089,172.31.36.0-255,66,38462,7,351697
5068,0.000898,74.125.24.0-255,2902,41364,7,351697
5069,0.0009,172.31.36.0-255,66,41430,7,351697
5070,0.000906,74.125.24.0-255,5738,47168,7,351697
5071,0.000908,172.31.36.0-255,66,47234,7,351697
5072,0.00095,74.125.24.0-255,1484,48718,7,351697
5073,0.000954,172.31.36.0-255,66,48784,7,351697
5074,0.000972,74.125.24.0-255,5379,54163,7,351697
5075,0.000975,172.31.36.0-255,66,54229,7,351697
5076,0.00098,74.125.24.0-255,2902,57131,7,351697
5077,0.000982,172.31.36.0-255,66,57197,7,351697
5078,0.000999,74.125.24.0-255,4320,61517,7,351697
5079,0.001002,172.31.36.0-255,66,61583,7,351697
5080,0.001007,74.125.24.0-255,2902,64485,7,351697
5081,0.001009,172.31.36.0-255,66,64551,7,351697
5082,0.001012,74.125.24.0-255,1484,66035,7,351697
5083,0.001031,74.125.24.0-255,2902,68937,7,351697
5084,0.001034,172.31.36.0-255,66,69003,7,351697
5085,0.00104,74.125.24.0-255,4320,73323,7,351697
5086,0.001042,172.31.36.0-255,66,73389,7,351697
5087,0.001065,74.125.24.0-255,5379,78768,7,351697
5088,0.001069,172.31.36.0-255,66,78834,7,351697
5089,0.001074,74.125.24.0-255,4320,83154,7,351697
5090,0.001076,172.31.36.0-255,66,83220,7,351697
5091,0.001115,74.125.24.0-255,5959,89179,7,351697
5092,0.001119,172.31.36.0-255,66,89245,7,351697
5093,0.001533,74.125.24.0-255,1484,90729,7,351697
5094,0.001554,74.125.24.0-255,2902,93631,7,351697
5095,0.001559,172.31.36.0-255,66,93697,7,351697
5096,0.001566,74.125.24.0-255,4320,98017,7,351697
5097,0.001568,172.31.36.0-255,66,98083,7,351697
5098,0.00158,74.125.24.0-255,2902,100985,7,351697
5099,0.001609,172.31.36.0-255,66,101051,7,351697
5100,0.001634,74.125.24.0-255,5738,106789,7,351697
5101,0.001637,172.31.36.0-255,66,106855,7,351697
5102,0.001649,172.31.36.0-255,66,106921,7,351697
5103,0.001651,74.125.24.0-255,1484,108405,7,351697
5104,0.001673,74.125.24.0-255,2184,110589,7,351697
5105,0.001675,172.31.36.0-255,66,110655,7,351697
5106,0.001785,74.125.24.0-255,1484,112139,7,351697
5107,0.001799,74.125.24.0-255,2902,115041,7,351697
5108,0.001802,172.31.36.0-255,66,115107,7,351697
5109,0.001825,74.125.24.0-255,5738,120845,7,351697
5110,0.001827,172.31.36.0-255,66,120911,7,351697
5111,0.001852,74.125.24.0-255,4320,125231,7,351697
5112,0.001854,172.31.36.0-255,66,125297,7,351697
5113,0.001894,172.31.36.0-255,66,125363,7,351697
5114,0.0019,74.125.24.0-255,7156,132519,7,351697
5115,0.001902,172.31.36.0-255,66,132585,7,351697
5116,0.001922,74.125.24.0-255,3602,136187,7,351697
5117,0.001925,172.31.36.0-255,66,136253,7,351697
5118,0.003995,74.125.24.0-255,1484,137737,7,351697
5119,0.004015,74.125.24.0-255,4320,142057,7,351697
5120,0.004018,172.31.36.0-255,66,142123,7,351697
5121,0.006134,74.125.24.0-255,5738,147861,7,351697
5122,0.006145,172.31.36.0-255,66,147927,7,351697
5123,0.008215,74.125.24.0-255,5738,153665,7,351697
5124,0.008224,172.31.36.0-255,66,153731,7,351697
5125,0.010363,74.125.24.0-255,5738,159469,7,351697
5126,0.01037,172.31.36.0-255,66,159535,7,351697
5127,0.012421,74.125.24.0-255,5738,165273,7,351697
5128,0.012429,172.31.36.0-255,66,165339,7,351697
5129,0.014522,74.125.24.0-255,5738,171077,7,351697
5130,0.014529,172.31.36.0-255,66,171143,7,351697
5131,0.016604,74.125.24.0-255,5738,176881,7,351697
5132,0.016615,172.31.36.0-255,66,176947,7,351697
5133,0.018789,74.125.24.0-255,5738,182685,7,351697
5134,0.018798,172.31.36.0-255,66,182751,7,351697
5135,0.020855,74.125.24.0-255,5738,188489,7,351697
5136,0.020862,172.31.36.0-255,66,188555,7,351697
5137,0.022945,74.125.24.0-255,5738,194293,7,351697
5138,0.022954,172.31.36.0-255,66,194359,7,351697
5139,0.025074,74.125.24.0-255,5738,200097,7,351697
5140,0.025081,172.31.36.0-255,66,200163,7,351697
5141,0.027251,74.125.24.0-255,5738,205901,7,351697
5142,0.027259,172.31.36.0-255,66,205967,7,351697
5143,0.029317,74.125.24.0-255,5738,211705,7,351697
5144,0.029325,172.31.36.0-255,66,211771,7,351697
5145,0.031409,74.125.24.0-255,5738,217509,7,351697
5146,0.031418,172.31.36.0-255,66,217575,7,351697
5147,0.033414,172.31.36.0-255,172,217747,7,351697
5148,0.033445,172.31.36.0-255,1115,218862,7,351697
5149,0.033484,172.31.36.0-255,1514,220376,7,351697
5150,0.033486,172.31.36.0-255,1291,221667,7,351697
5151,0.033522,74.125.24.0-255,5738,227405,7,351697
5152,0.033527,172.31.36.0-255,66,227471,7,351697
5153,0.034954,104.244.42.0-255,66,227537,7,351697
5154,0.034976,104.244.42.0-255,66,227603,7,351697
5155,0.035031,104.244.42.0-255,66,227669,7,351697
5156,0.035617,74.125.24.0-255,2902,230571,7,351697
5157,0.035623,172.31.36.0-255,66,230637,7,351697
5158,0.035644,74.125.24.0-255,2902,233539,7,351697
5159,0.035647,172.31.36.0-255,66,233605,7,351697
5160,0.037706,74.125.24.0-255,2902,236507,7,351697
5161,0.037712,172.31.36.0-255,66,236573,7,351697
5162,0.037772,74.125.24.0-255,2902,239475,7,351697
5163,0.037777,172.31.36.0-255,66,239541,7,351697
5164,0.039817,74.125.24.0-255,2902,242443,7,351697
5165,0.039823,172.31.36.0-255,66,242509,7,351697
5166,0.039873,74.125.24.0-255,2902,245411,7,351697
5167,0.039877,172.31.36.0-255,66,245477,7,351697
5168,0.041932,74.125.24.0-255,4320,249797,7,351697
5169,0.041954,172.31.36.0-255,66,249863,7,351697
5170,0.041966,74.125.24.0-255,1484,251347,7,351697
5171,0.044069,74.125.24.0-255,4320,255667,7,351697
5172,0.044074,172.31.36.0-255,66,255733,7,351697
5173,0.046175,74.125.24.0-255,5738,261471,7,351697
5174,0.04618,172.31.36.0-255,66,261537,7,351697
5175,0.048247,74.125.24.0-255,4320,265857,7,351697
5176,0.048252,172.31.36.0-255,66,265923,7,351697
5177,0.048283,74.125.24.0-255,1484,267407,7,351697
5178,0.050347,74.125.24.0-255,4320,271727,7,351697
5179,0.050353,172.31.36.0-255,66,271793,7,351697
5180,0.052433,74.125.24.0-255,5738,277531,7,351697
5181,0.05244,172.31.36.0-255,66,277597,7,351697
5182,0.054516,74.125.24.0-255,5738,283335,7,351697
5183,0.054522,172.31.36.0-255,66,283401,7,351697
5184,0.056625,74.125.24.0-255,5738,289139,7,351697
5185,0.05663,172.31.36.0-255,66,289205,7,351697
5186,0.05872,74.125.24.0-255,5738,294943,7,351697
5187,0.058726,172.31.36.0-255,66,295009,7,351697
5188,0.060857,74.125.24.0-255,5738,300747,7,351697
5189,0.060865,172.31.36.0-255,66,300813,7,351697
5190,0.063047,74.125.24.0-255,5738,306551,7,351697
5191,0.063054,172.31.36.0-255,66,306617,7,351697
5192,0.065131,74.125.24.0-255,5738,312355,7,351697
5193,0.065136,172.31.36.0-255,66,312421,7,351697
5194,0.067228,74.125.24.0-255,5738,318159,7,351697
5195,0.067234,172.31.36.0-255,66,318225,7,351697
5196,0.069326,74.125.24.0-255,5738,323963,7,351697
5197,0.069332,172.31.36.0-255,66,324029,7,351697
5198,0.071423,74.125.24.0-255,5738,329767,7,351697
5199,0.071429,172.31.36.0-255,66,329833,7,351697
5200,0.073559,74.125.24.0-255,5738,335571,7,351697
5201,0.073564,172.31.36.0-255,66,335637,7,351697
5202,0.075634,74.125.24.0-255,5738,341375,7,351697
5203,0.075639,172.31.36.0-255,66,341441,7,351697
5204,0.077741,74.125.24.0-255,4320,345761,7,351697
5205,0.077747,172.31.36.0-255,66,345827,7,351697
5206,0.077773,74.125.24.0-255,1484,347311,7,351697
5207,0.079857,74.125.24.0-255,4320,351631,7,351697
5208,0.079863,172.31.36.0-255,66,351697,7,351697
5209,0.0,172.217.194.0-255,146,146,7,295018
5210,2e-05,172.31.36.0-255,66,212,7,295018
5211,2.8e-05,172.217.194.0-255,1484,1696,7,295018
5212,3.2e-05,172.31.36.0-255,66,1762,7,295018
5213,4.7e-05,172.217.194.0-255,2902,4664,7,295018
5214,5e-05,172.31.36.0-255,66,4730,7,295018
5215,5.8e-05,172.217.194.0-255,7156,11886,7,295018
5216,6.2e-05,172.31.36.0-255,66,11952,7,295018
5217,6.6e-05,172.217.194.0-255,2039,13991,7,295018
5218,6.9e-05,172.31.36.0-255,66,14057,7,295018
5219,7.4e-05,172.217.194.0-255,2902,16959,7,295018
5220,7.7e-05,172.31.36.0-255,66,17025,7,295018
5221,9.9e-05,172.217.194.0-255,7156,24181,7,295018
5222,0.000103,172.31.36.0-255,66,24247,7,295018
5223,0.000114,172.217.194.0-255,6797,31044,7,295018
5224,0.000117,172.31.36.0-255,66,31110,7,295018
5225,0.000156,172.217.194.0-255,1484,32594,7,295018
5226,0.000159,172.31.36.0-255,66,32660,7,295018
5227,0.000187,172.217.194.0-255,2902,35562,7,295018
5228,0.00019,172.31.36.0-255,66,35628,7,295018
5229,0.000198,172.217.194.0-255,5738,41366,7,295018
5230,0.000201,172.31.36.0-255,66,41432,7,295018
5231,0.000206,172.217.194.0-255,4320,45752,7,295018
5232,0.000209,172.31.36.0-255,66,45818,7,295018
5233,0.000239,172.217.194.0-255,2543,48361,7,295018
5234,0.000241,172.31.36.0-255,66,48427,7,295018
5235,0.000292,172.217.194.0-255,1484,49911,7,295018
5236,0.000295,172.31.36.0-255,66,49977,7,295018
5237,0.0003,172.217.194.0-255,2902,52879,7,295018
5238,0.000303,172.31.36.0-255,66,52945,7,295018
5239,0.000332,172.217.194.0-255,5738,58683,7,295018
5240,0.000335,172.31.36.0-255,66,58749,7,295018
5241,0.000364,172.217.194.0-255,5738,64487,7,295018
5242,0.000367,172.31.36.0-255,66,64553,7,295018
5243,0.000393,172.217.194.0-255,1705,66258,7,295018
5244,0.000395,172.31.36.0-255,66,66324,7,295018
5245,0.000594,172.217.194.0-255,1484,67808,7,295018
5246,0.000602,172.217.194.0-255,2902,70710,7,295018
5247,0.000607,172.31.36.0-255,66,70776,7,295018
5248,0.000611,172.217.194.0-255,1484,72260,7,295018
5249,0.00064,172.217.194.0-255,4320,76580,7,295018
5250,0.000643,172.31.36.0-255,66,76646,7,295018
5251,0.00065,172.217.194.0-255,5738,82384,7,295018
5252,0.000653,172.31.36.0-255,66,82450,7,295018
5253,0.000683,172.217.194.0-255,4320,86770,7,295018
5254,0.000686,172.31.36.0-255,66,86836,7,295018
5255,0.000692,172.217.194.0-255,4320,91156,7,295018
5256,0.000694,172.31.36.0-255,66,91222,7,295018
5257,0.000725,172.31.36.0-255,66,91288,7,295018
5258,0.00073,172.217.194.0-255,4320,95608,7,295018
5259,0.000732,172.31.36.0-255,66,95674,7,295018
5260,0.000776,172.31.36.0-255,66,95740,7,295018
5261,0.00078,172.217.194.0-255,1980,97720,7,295018
5262,0.000782,172.31.36.0-255,66,97786,7,295018
5263,0.000828,172.217.194.0-255,1484,99270,7,295018
5264,0.000833,172.217.194.0-255,2902,102172,7,295018
5265,0.000836,172.31.36.0-255,66,102238,7,295018
5266,0.000841,172.217.194.0-255,2902,105140,7,295018
5267,0.000843,172.31.36.0-255,66,105206,7,295018
5268,0.000867,172.217.194.0-255,2902,108108,7,295018
5269,0.000869,172.31.36.0-255,66,108174,7,295018
5270,0.000911,172.217.194.0-255,5738,113912,7,295018
5271,0.000914,172.31.36.0-255,66,113978,7,295018
5272,0.000945,172.217.194.0-255,7156,121134,7,295018
5273,0.000948,172.31.36.0-255,66,121200,7,295018
5274,0.000951,172.217.194.0-255,1484,122684,7,295018
5275,0.000964,172.31.36.0-255,66,122750,7,295018
5276,0.000999,172.31.36.0-255,66,122816,7,295018
5277,0.001006,172.217.194.0-255,6797,129613,7,295018
5278,0.001009,172.31.36.0-255,66,129679,7,295018
5279,0.00106,172.217.194.0-255,1484,131163,7,295018
5280,0.001065,172.217.194.0-255,2902,134065,7,295018
5281,0.001067,172.31.36.0-255,66,134131,7,295018
5282,0.001097,172.217.194.0-255,5738,139869,7,295018
5283,0.0011,172.31.36.0-255,66,139935,7,295018
5284,0.001108,172.217.194.0-255,7156,147091,7,295018
5285,0.00111,172.31.36.0-255,66,147157,7,295018
5286,0.001146,172.217.194.0-255,5738,152895,7,295018
5287,0.001149,172.31.36.0-255,66,152961,7,295018
5288,0.001162,172.31.36.0-255,66,153027,7,295018
5289,0.001391,172.217.194.0-255,1484,154511,7,295018
5290,0.001408,172.217.194.0-255,2902,157413,7,295018
5291,0.001411,172.31.36.0-255,66,157479,7,295018
5292,0.001419,172.217.194.0-255,5738,163217,7,295018
5293,0.001421,172.31.36.0-255,66,163283,7,295018
5294,0.001459,172.31.36.0-255,66,163349,7,295018
5295,0.001497,172.217.194.0-255,7156,170505,7,295018
5296,0.001499,172.31.36.0-255,66,170571,7,295018
5297,0.001533,172.217.194.0-255,6438,177009,7,295018
5298,0.001537,172.31.36.0-255,66,177075,7,295018
5299,0.001638,172.217.194.0-255,1484,178559,7,295018
5300,0.001651,172.217.194.0-255,2902,181461,7,295018
5301,0.001654,172.31.36.0-255,66,181527,7,295018
5302,0.001684,172.217.194.0-255,5738,187265,7,295018
5303,0.001689,172.31.36.0-255,66,187331,7,295018
5304,0.001727,172.31.36.0-255,66,187397,7,295018
5305,0.001764,172.217.194.0-255,5738,193135,7,295018
5306,0.001767,172.31.36.0-255,66,193201,7,295018
5307,0.00181,172.31.36.0-255,66,193267,7,295018
5308,0.001835,172.31.36.0-255,66,193333,7,295018
5309,0.001841,172.217.194.0-255,5020,198353,7,295018
5310,0.001844,172.31.36.0-255,66,198419,7,295018
5311,0.001873,172.217.194.0-255,1484,199903,7,295018
5312,0.001878,172.217.194.0-255,2902,202805,7,295018
5313,0.00188,172.31.36.0-255,66,202871,7,295018
5314,0.001887,172.217.194.0-255,5738,208609,7,295018
5315,0.00189,172.31.36.0-255,66,208675,7,295018
5316,0.001925,172.217.194.0-255,2902,211577,7,295018
5317,0.001928,172.31.36.0-255,66,211643,7,295018
5318,0.001962,172.217.194.0-255,7156,218799,7,295018
5319,0.001965,172.31.36.0-255,66,218865,7,295018
5320,0.001983,172.31.36.0-255,66,218931,7,295018
5321,0.001987,172.217.194.0-255,2902,221833,7,295018
5322,0.001989,172.31.36.0-255,66,221899,7,295018
5323,0.002019,172.217.194.0-255,4320,226219,7,295018
5324,0.002022,172.31.36.0-255,66,226285,7,295018
5325,0.002047,172.31.36.0-255,66,226351,7,295018
5326,0.00208,172.217.194.0-255,7156,233507,7,295018
5327,0.002083,172.31.36.0-255,66,233573,7,295018
5328,0.002088,172.217.194.0-255,3602,237175,7,295018
5329,0.00209,172.31.36.0-255,66,237241,7,295018
5330,0.0042,172.217.194.0-255,2902,240143,7,295018
5331,0.004206,172.31.36.0-255,66,240209,7,295018
5332,0.004233,172.217.194.0-255,2902,243111,7,295018
5333,0.004236,172.31.36.0-255,66,243177,7,295018
5334,0.006309,172.217.194.0-255,5738,248915,7,295018
5335,0.006315,172.31.36.0-255,66,248981,7,295018
5336,0.008418,172.217.194.0-255,2902,251883,7,295018
5337,0.008422,172.31.36.0-255,66,251949,7,295018
5338,0.008442,172.217.194.0-255,2902,254851,7,295018
5339,0.008444,172.31.36.0-255,66,254917,7,295018
5340,0.010503,172.217.194.0-255,5738,260655,7,295018
5341,0.010509,172.31.36.0-255,66,260721,7,295018
5342,0.012605,172.217.194.0-255,5738,266459,7,295018
5343,0.012613,172.31.36.0-255,66,266525,7,295018
5344,0.014716,172.217.194.0-255,5738,272263,7,295018
5345,0.014723,172.31.36.0-255,66,272329,7,295018
5346,0.016832,172.217.194.0-255,5738,278067,7,295018
5347,0.016841,172.31.36.0-255,66,278133,7,295018
5348,0.018922,172.217.194.0-255,5738,283871,7,295018
5349,0.018932,172.31.36.0-255,66,283937,7,295018
5350,0.02103,172.217.194.0-255,1653,285590,7,295018
5351,0.021038,172.31.36.0-255,66,285656,7,295018
5352,0.022885,172.31.36.0-255,105,285761,7,295018
5353,0.024962,172.217.194.0-255,66,285827,7,295018
5354,0.038746,172.31.36.0-255,172,285999,7,295018
5355,0.03879,172.31.36.0-255,1113,287112,7,295018
5356,0.038853,172.31.36.0-255,1514,288626,7,295018
5357,0.038855,172.31.36.0-255,1514,290140,7,295018
5358,0.038856,172.31.36.0-255,1514,291654,7,295018
5359,0.038861,172.31.36.0-255,1514,293168,7,295018
5360,0.038882,172.31.36.0-255,1514,294682,7,295018
5361,0.038883,172.31.36.0-255,72,294754,7,295018
5362,0.040319,104.244.42.0-255,66,294820,7,295018
5363,0.04035,104.244.42.0-255,66,294886,7,295018
5364,0.040438,104.244.42.0-255,66,294952,7,295018
5365,0.040444,104.244.42.0-255,66,295018,7,295018
5366,0.0,172.217.194.0-255,153,153,7,322867
5367,1.9e-05,172.31.36.0-255,66,219,7,322867
5368,2.6e-05,172.217.194.0-255,1484,1703,7,322867
5369,3.2e-05,172.31.36.0-255,66,1769,7,322867
5370,6.5e-05,172.217.194.0-255,2902,4671,7,322867
5371,6.8e-05,172.31.36.0-255,66,4737,7,322867
5372,7.5e-05,172.217.194.0-255,5738,10475,7,322867
5373,7.7e-05,172.31.36.0-255,66,10541,7,322867
5374,0.000122,172.31.36.0-255,66,10607,7,322867
5375,0.000177,172.217.194.0-255,2902,13509,7,322867
5376,0.00018,172.31.36.0-255,66,13575,7,322867
5377,0.000207,172.217.194.0-255,2902,16477,7,322867
5378,0.000209,172.31.36.0-255,66,16543,7,322867
5379,0.00025,172.217.194.0-255,3961,20504,7,322867
5380,0.000254,172.31.36.0-255,66,20570,7,322867
5381,0.000283,172.217.194.0-255,1484,22054,7,322867
5382,0.000287,172.31.36.0-255,66,22120,7,322867
5383,0.000292,172.217.194.0-255,2902,25022,7,322867
5384,0.000294,172.31.36.0-255,66,25088,7,322867
5385,0.000304,172.217.194.0-255,2902,27990,7,322867
5386,0.000307,172.31.36.0-255,66,28056,7,322867
5387,0.000338,172.217.194.0-255,2902,30958,7,322867
5388,0.000341,172.31.36.0-255,66,31024,7,322867
5389,0.000362,172.217.194.0-255,6797,37821,7,322867
5390,0.000365,172.31.36.0-255,66,37887,7,322867
5391,0.00043,172.31.36.0-255,66,37953,7,322867
5392,0.000459,172.217.194.0-255,4320,42273,7,322867
5393,0.000462,172.31.36.0-255,66,42339,7,322867
5394,0.000539,172.217.194.0-255,2543,44882,7,322867
5395,0.000542,172.31.36.0-255,66,44948,7,322867
5396,0.000545,172.217.194.0-255,338,45286,7,322867
5397,0.000565,172.217.194.0-255,1484,46770,7,322867
5398,0.000568,172.31.36.0-255,66,46836,7,322867
5399,0.000595,172.217.194.0-255,2902,49738,7,322867
5400,0.000598,172.31.36.0-255,66,49804,7,322867
5401,0.000633,172.31.36.0-255,66,49870,7,322867
5402,0.00069,172.217.194.0-255,2302,52172,7,322867
5403,0.000694,172.31.36.0-255,66,52238,7,322867
5404,0.00079,172.217.194.0-255,1484,53722,7,322867
5405,0.000807,172.217.194.0-255,2902,56624,7,322867
5406,0.000811,172.31.36.0-255,66,56690,7,322867
5407,0.000815,172.217.194.0-255,1484,58174,7,322867
5408,0.000845,172.217.194.0-255,4320,62494,7,322867
5409,0.000848,172.31.36.0-255,66,62560,7,322867
5410,0.000882,172.31.36.0-255,66,62626,7,322867
5411,0.000952,172.217.194.0-255,5738,68364,7,322867
5412,0.000957,172.31.36.0-255,66,68430,7,322867
5413,0.000987,172.217.194.0-255,5738,74168,7,322867
5414,0.00099,172.31.36.0-255,66,74234,7,322867
5415,0.001052,172.217.194.0-255,2184,76418,7,322867
5416,0.001056,172.31.36.0-255,66,76484,7,322867
5417,0.001936,172.217.194.0-255,1484,77968,7,322867
5418,0.001942,172.217.194.0-255,1484,79452,7,322867
5419,0.001946,172.31.36.0-255,66,79518,7,322867
5420,0.001982,172.217.194.0-255,1484,81002,7,322867
5421,0.001989,172.217.194.0-255,5738,86740,7,322867
5422,0.001992,172.31.36.0-255,66,86806,7,322867
5423,0.002001,172.217.194.0-255,7156,93962,7,322867
5424,0.002003,172.31.36.0-255,66,94028,7,322867
5425,0.002017,172.217.194.0-255,1484,95512,7,322867
5426,0.002097,172.217.194.0-255,5738,101250,7,322867
5427,0.002101,172.31.36.0-255,66,101316,7,322867
5428,0.002129,172.217.194.0-255,4320,105636,7,322867
5429,0.002132,172.31.36.0-255,66,105702,7,322867
5430,0.002158,172.217.194.0-255,1484,107186,7,322867
5431,0.002174,172.217.194.0-255,3602,110788,7,322867
5432,0.002177,172.31.36.0-255,66,110854,7,322867
5433,0.002263,172.217.194.0-255,1484,112338,7,322867
5434,0.002285,172.217.194.0-255,2902,115240,7,322867
5435,0.002288,172.31.36.0-255,66,115306,7,322867
5436,0.002315,172.217.194.0-255,5738,121044,7,322867
5437,0.002318,172.31.36.0-255,66,121110,7,322867
5438,0.002334,172.217.194.0-255,1484,122594,7,322867
5439,0.002352,172.217.194.0-255,5738,128332,7,322867
5440,0.002355,172.31.36.0-255,66,128398,7,322867
5441,0.004643,172.217.194.0-255,5738,134136,7,322867
5442,0.00465,172.31.36.0-255,66,134202,7,322867
5443,0.006973,172.217.194.0-255,5738,139940,7,322867
5444,0.006979,172.31.36.0-255,66,140006,7,322867
5445,0.009265,172.217.194.0-255,5738,145744,7,322867
5446,0.009272,172.31.36.0-255,66,145810,7,322867
5447,0.011573,172.217.194.0-255,5738,151548,7,322867
5448,0.011586,172.31.36.0-255,66,151614,7,322867
5449,0.013896,172.217.194.0-255,5738,157352,7,322867
5450,0.01391,172.31.36.0-255,66,157418,7,322867
5451,0.016194,172.217.194.0-255,5738,163156,7,322867
5452,0.016208,172.31.36.0-255,66,163222,7,322867
5453,0.018536,172.217.194.0-255,5738,168960,7,322867
5454,0.018547,172.31.36.0-255,66,169026,7,322867
5455,0.020853,172.217.194.0-255,5738,174764,7,322867
5456,0.020868,172.31.36.0-255,66,174830,7,322867
5457,0.023176,172.217.194.0-255,5738,180568,7,322867
5458,0.023191,172.31.36.0-255,66,180634,7,322867
5459,0.025526,172.217.194.0-255,5738,186372,7,322867
5460,0.025542,172.31.36.0-255,66,186438,7,322867
5461,0.027838,172.217.194.0-255,5738,192176,7,322867
5462,0.02785,172.31.36.0-255,66,192242,7,322867
5463,0.029414,172.31.36.0-255,171,192413,7,322867
5464,0.029444,172.31.36.0-255,1138,193551,7,322867
5465,0.029506,172.31.36.0-255,1514,195065,7,322867
5466,0.029507,172.31.36.0-255,1268,196333,7,322867
5467,0.030137,172.217.194.0-255,5738,202071,7,322867
5468,0.030146,172.31.36.0-255,66,202137,7,322867
5469,0.030997,104.244.42.0-255,66,202203,7,322867
5470,0.031033,104.244.42.0-255,66,202269,7,322867
5471,0.031141,104.244.42.0-255,66,202335,7,322867
5472,0.032436,172.217.194.0-255,5738,208073,7,322867
5473,0.032442,172.31.36.0-255,66,208139,7,322867
5474,0.034727,172.217.194.0-255,5738,213877,7,322867
5475,0.034738,172.31.36.0-255,66,213943,7,322867
5476,0.037015,172.217.194.0-255,5738,219681,7,322867
5477,0.037022,172.31.36.0-255,66,219747,7,322867
5478,0.039312,172.217.194.0-255,5738,225485,7,322867
5479,0.039319,172.31.36.0-255,66,225551,7,322867
5480,0.04159,172.217.194.0-255,5738,231289,7,322867
5481,0.041598,172.31.36.0-255,66,231355,7,322867
5482,0.043906,172.217.194.0-255,5738,237093,7,322867
5483,0.043918,172.31.36.0-255,66,237159,7,322867
5484,0.046224,172.217.194.0-255,5738,242897,7,322867
5485,0.046236,172.31.36.0-255,66,242963,7,322867
5486,0.048526,172.217.194.0-255,5738,248701,7,322867
5487,0.048537,172.31.36.0-255,66,248767,7,322867
5488,0.050847,172.217.194.0-255,5738,254505,7,322867
5489,0.050858,172.31.36.0-255,66,254571,7,322867
5490,0.053165,172.217.194.0-255,4320,258891,7,322867
5491,0.053173,172.31.36.0-255,66,258957,7,322867
5492,0.053202,172.217.194.0-255,1484,260441,7,322867
5493,0.055482,172.217.194.0-255,4320,264761,7,322867
5494,0.055491,172.31.36.0-255,66,264827,7,322867
5495,0.057795,172.217.194.0-255,5738,270565,7,322867
5496,0.057809,172.31.36.0-255,66,270631,7,322867
5497,0.060125,172.217.194.0-255,5738,276369,7,322867
5498,0.060134,172.31.36.0-255,66,276435,7,322867
5499,0.062427,172.217.194.0-255,5738,282173,7,322867
5500,0.062434,172.31.36.0-255,66,282239,7,322867
5501,0.064726,172.217.194.0-255,5738,287977,7,322867
5502,0.064734,172.31.36.0-255,66,288043,7,322867
5503,0.067028,172.217.194.0-255,5738,293781,7,322867
5504,0.067037,172.31.36.0-255,66,293847,7,322867
5505,0.069336,172.217.194.0-255,5738,299585,7,322867
5506,0.069344,172.31.36.0-255,66,299651,7,322867
5507,0.071645,172.217.194.0-255,5738,305389,7,322867
5508,0.071651,172.31.36.0-255,66,305455,7,322867
5509,0.073938,172.217.194.0-255,5738,311193,7,322867
5510,0.073946,172.31.36.0-255,66,311259,7,322867
5511,0.076251,172.217.194.0-255,5738,316997,7,322867
5512,0.076258,172.31.36.0-255,66,317063,7,322867
5513,0.078544,172.217.194.0-255,5738,322801,7,322867
5514,0.078551,172.31.36.0-255,66,322867,7,322867
5515,0.0,74.125.24.0-255,150,150,7,292541
5516,1.7e-05,172.31.36.0-255,66,216,7,292541
5517,2.4e-05,74.125.24.0-255,1484,1700,7,292541
5518,2.8e-05,172.31.36.0-255,66,1766,7,292541
5519,3.4e-05,74.125.24.0-255,2902,4668,7,292541
5520,4.7e-05,172.31.36.0-255,66,4734,7,292541
5521,5.2e-05,74.125.24.0-255,2902,7636,7,292541
5522,5.5e-05,172.31.36.0-255,66,7702,7,292541
5523,6.1e-05,74.125.24.0-255,4320,12022,7,292541
5524,6.3e-05,172.31.36.0-255,66,12088,7,292541
5525,8.2e-05,74.125.24.0-255,2002,14090,7,292541
5526,8.9e-05,172.31.36.0-255,66,14156,7,292541
5527,9.3e-05,74.125.24.0-255,1484,15640,7,292541
5528,9.5e-05,172.31.36.0-255,66,15706,7,292541
5529,0.000116,74.125.24.0-255,1484,17190,7,292541
5530,0.000118,172.31.36.0-255,66,17256,7,292541
5531,0.000127,74.125.24.0-255,7156,24412,7,292541
5532,0.000133,172.31.36.0-255,66,24478,7,292541
5533,0.000141,74.125.24.0-255,6797,31275,7,292541
5534,0.000143,172.31.36.0-255,66,31341,7,292541
5535,0.000251,74.125.24.0-255,1484,32825,7,292541
5536,0.000254,172.31.36.0-255,66,32891,7,292541
5537,0.00026,74.125.24.0-255,2902,35793,7,292541
5538,0.000262,172.31.36.0-255,66,35859,7,292541
5539,0.000295,74.125.24.0-255,5738,41597,7,292541
5540,0.000297,172.31.36.0-255,66,41663,7,292541
5541,0.000334,172.31.36.0-255,66,41729,7,292541
5542,0.00034,74.125.24.0-255,4320,46049,7,292541
5543,0.000342,172.31.36.0-255,66,46115,7,292541
5544,0.000375,172.31.36.0-255,66,46181,7,292541
5545,0.000382,74.125.24.0-255,376,46557,7,292541
5546,0.000616,74.125.24.0-255,1484,48041,7,292541
5547,0.000623,74.125.24.0-255,2902,50943,7,292541
5548,0.000628,74.125.24.0-255,4320,55263,7,292541
5549,0.000641,74.125.24.0-255,1484,56747,7,292541
5550,0.000646,74.125.24.0-255,4320,61067,7,292541
5551,0.000649,172.31.36.0-255,66,61133,7,292541
5552,0.000655,172.31.36.0-255,66,61199,7,292541
5553,0.000722,74.125.24.0-255,5738,66937,7,292541
5554,0.000747,74.125.24.0-255,2184,69121,7,292541
5555,0.000757,172.31.36.0-255,66,69187,7,292541
5556,0.001022,74.125.24.0-255,1484,70671,7,292541
5557,0.001028,74.125.24.0-255,2902,73573,7,292541
5558,0.001031,172.31.36.0-255,66,73639,7,292541
5559,0.001035,74.125.24.0-255,1484,75123,7,292541
5560,0.001064,74.125.24.0-255,4320,79443,7,292541
5561,0.001072,74.125.24.0-255,7156,86599,7,292541
5562,0.001075,74.125.24.0-255,2902,89501,7,292541
5563,0.001083,172.31.36.0-255,66,89567,7,292541
5564,0.001121,74.125.24.0-255,2184,91751,7,292541
5565,0.001139,172.31.36.0-255,66,91817,7,292541
5566,0.00352,74.125.24.0-255,5738,97555,7,292541
5567,0.003525,172.31.36.0-255,66,97621,7,292541
5568,0.005886,74.125.24.0-255,5738,103359,7,292541
5569,0.005892,172.31.36.0-255,66,103425,7,292541
5570,0.00824,74.125.24.0-255,5738,109163,7,292541
5571,0.008246,172.31.36.0-255,66,109229,7,292541
5572,0.010588,74.125.24.0-255,5738,114967,7,292541
5573,0.01154,172.31.36.0-255,66,115033,7,292541
5574,0.013865,74.125.24.0-255,5738,120771,7,292541
5575,0.013871,172.31.36.0-255,66,120837,7,292541
5576,0.01619,74.125.24.0-255,5738,126575,7,292541
5577,0.016198,172.31.36.0-255,66,126641,7,292541
5578,0.018521,74.125.24.0-255,5738,132379,7,292541
5579,0.018528,172.31.36.0-255,66,132445,7,292541
5580,0.020847,74.125.24.0-255,5738,138183,7,292541
5581,0.020854,172.31.36.0-255,66,138249,7,292541
5582,0.023196,74.125.24.0-255,5738,143987,7,292541
5583,0.023205,172.31.36.0-255,66,144053,7,292541
5584,0.025529,74.125.24.0-255,5738,149791,7,292541
5585,0.025536,172.31.36.0-255,66,149857,7,292541
5586,0.027871,74.125.24.0-255,5738,155595,7,292541
5587,0.027878,172.31.36.0-255,66,155661,7,292541
5588,0.030196,74.125.24.0-255,5738,161399,7,292541
5589,0.030203,172.31.36.0-255,66,161465,7,292541
5590,0.032524,74.125.24.0-255,5738,167203,7,292541
5591,0.032532,172.31.36.0-255,66,167269,7,292541
5592,0.03487,74.125.24.0-255,5738,173007,7,292541
5593,0.034879,172.31.36.0-255,66,173073,7,292541
5594,0.037216,74.125.24.0-255,5738,178811,7,292541
5595,0.037224,172.31.36.0-255,66,178877,7,292541
5596,0.038497,172.31.36.0-255,172,179049,7,292541
5597,0.038537,172.31.36.0-255,1113,180162,7,292541
5598,0.038606,172.31.36.0-255,1514,181676,7,292541
5599,0.038608,172.31.36.0-255,1514,183190,7,292541
5600,0.038609,172.31.36.0-255,1514,184704,7,292541
5601,0.038614,172.31.36.0-255,1514,186218,7,292541
5602,0.038615,172.31.36.0-255,1514,187732,7,292541
5603,0.038616,172.31.36.0-255,73,187805,7,292541
5604,0.039554,74.125.24.0-255,5738,193543,7,292541
5605,0.039562,172.31.36.0-255,66,193609,7,292541
5606,0.040025,104.244.42.0-255,66,193675,7,292541
5607,0.040122,104.244.42.0-255,66,193741,7,292541
5608,0.040169,104.244.42.0-255,66,193807,7,292541
5609,0.040174,104.244.42.0-255,66,193873,7,292541
5610,0.041898,74.125.24.0-255,5738,199611,7,292541
5611,0.041905,172.31.36.0-255,66,199677,7,292541
5612,0.044244,74.125.24.0-255,5738,205415,7,292541
5613,0.044251,172.31.36.0-255,66,205481,7,292541
5614,0.046597,74.125.24.0-255,5738,211219,7,292541
5615,0.046604,172.31.36.0-255,66,211285,7,292541
5616,0.048959,74.125.24.0-255,5738,217023,7,292541
5617,0.04897,172.31.36.0-255,66,217089,7,292541
5618,0.051292,74.125.24.0-255,5738,222827,7,292541
5619,0.051299,172.31.36.0-255,66,222893,7,292541
5620,0.053622,74.125.24.0-255,5738,228631,7,292541
5621,0.053629,172.31.36.0-255,66,228697,7,292541
5622,0.055983,74.125.24.0-255,5738,234435,7,292541
5623,0.055989,172.31.36.0-255,66,234501,7,292541
5624,0.058309,74.125.24.0-255,5738,240239,7,292541
5625,0.058316,172.31.36.0-255,66,240305,7,292541
5626,0.060699,74.125.24.0-255,5738,246043,7,292541
5627,0.060706,172.31.36.0-255,66,246109,7,292541
5628,0.063058,74.125.24.0-255,5738,251847,7,292541
5629,0.063065,172.31.36.0-255,66,251913,7,292541
5630,0.06541,74.125.24.0-255,5738,257651,7,292541
5631,0.065417,172.31.36.0-255,66,257717,7,292541
5632,0.06776,74.125.24.0-255,5738,263455,7,292541
5633,0.067767,172.31.36.0-255,66,263521,7,292541
5634,0.070086,74.125.24.0-255,5738,269259,7,292541
5635,0.070092,172.31.36.0-255,66,269325,7,292541
5636,0.072423,74.125.24.0-255,5738,275063,7,292541
5637,0.07243,172.31.36.0-255,66,275129,7,292541
5638,0.07478,74.125.24.0-255,5738,280867,7,292541
5639,0.074786,172.31.36.0-255,66,280933,7,292541
5640,0.077125,74.125.24.0-255,5738,286671,7,292541
5641,0.077132,172.31.36.0-255,66,286737,7,292541
5642,0.079487,74.125.24.0-255,5738,292475,7,292541
5643,0.079494,172.31.36.0-255,66,292541,7,292541
5644,0.0,172.217.194.0-255,66,66,7,66
5645,0.0,172.217.160.0-255,296,296,7,313325
5646,2.4e-05,172.31.36.0-255,66,362,7,313325
5647,3e-05,172.217.160.0-255,1484,1846,7,313325
5648,3.5e-05,172.31.36.0-255,66,1912,7,313325
5649,9.1e-05,172.217.160.0-255,4320,6232,7,313325
5650,9.5e-05,172.31.36.0-255,66,6298,7,313325
5651,0.000404,172.217.160.0-255,4320,10618,7,313325
5652,0.000412,172.31.36.0-255,66,10684,7,313325
5653,0.000432,172.217.160.0-255,4603,15287,7,313325
5654,0.000436,172.31.36.0-255,66,15353,7,313325
5655,0.001085,172.31.36.0-255,66,15419,7,313325
5656,0.001979,172.217.160.0-255,5738,21157,7,313325
5657,0.001988,172.31.36.0-255,66,21223,7,313325
5658,0.002013,172.217.160.0-255,7156,28379,7,313325
5659,0.002016,172.31.36.0-255,66,28445,7,313325
5660,0.00289,172.217.160.0-255,5738,34183,7,313325
5661,0.002894,172.31.36.0-255,66,34249,7,313325
5662,0.002914,172.217.160.0-255,2902,37151,7,313325
5663,0.002917,172.31.36.0-255,66,37217,7,313325
5664,0.004529,172.217.160.0-255,1484,38701,7,313325
5665,0.004538,172.31.36.0-255,66,38767,7,313325
5666,0.004575,172.217.160.0-255,4320,43087,7,313325
5667,0.004579,172.31.36.0-255,66,43153,7,313325
5668,0.006252,172.217.160.0-255,5738,48891,7,313325
5669,0.006265,172.31.36.0-255,66,48957,7,313325
5670,0.007909,172.217.160.0-255,5738,54695,7,313325
5671,0.007943,172.31.36.0-255,66,54761,7,313325
5672,0.009598,172.217.160.0-255,5738,60499,7,313325
5673,0.00961,172.31.36.0-255,66,60565,7,313325
5674,0.011274,172.217.160.0-255,5738,66303,7,313325
5675,0.011282,172.31.36.0-255,66,66369,7,313325
5676,0.012922,172.217.160.0-255,5738,72107,7,313325
5677,0.012931,172.31.36.0-255,66,72173,7,313325
5678,0.014559,172.217.160.0-255,5738,77911,7,313325
5679,0.014567,172.31.36.0-255,66,77977,7,313325
5680,0.016209,172.217.160.0-255,5738,83715,7,313325
5681,0.016219,172.31.36.0-255,66,83781,7,313325
5682,0.017855,172.217.160.0-255,5738,89519,7,313325
5683,0.017864,172.31.36.0-255,66,89585,7,313325
5684,0.0195,172.217.160.0-255,5738,95323,7,313325
5685,0.019508,172.31.36.0-255,66,95389,7,313325
5686,0.021137,172.217.160.0-255,5738,101127,7,313325
5687,0.021145,172.31.36.0-255,66,101193,7,313325
5688,0.022785,172.217.160.0-255,2902,104095,7,313325
5689,0.022792,172.31.36.0-255,66,104161,7,313325
5690,0.022877,172.217.160.0-255,2902,107063,7,313325
5691,0.022911,172.31.36.0-255,66,107129,7,313325
5692,0.024429,172.217.160.0-255,2902,110031,7,313325
5693,0.024436,172.31.36.0-255,66,110097,7,313325
5694,0.024528,172.217.160.0-255,2902,112999,7,313325
5695,0.024532,172.31.36.0-255,66,113065,7,313325
5696,0.026066,172.217.160.0-255,2902,115967,7,313325
5697,0.026074,172.31.36.0-255,66,116033,7,313325
5698,0.026148,172.217.160.0-255,2902,118935,7,313325
5699,0.026169,172.31.36.0-255,66,119001,7,313325
5700,0.027382,172.31.36.0-255,188,119189,7,313325
5701,0.027417,172.31.36.0-255,958,120147,7,313325
5702,0.027479,172.31.36.0-255,1514,121661,7,313325
5703,0.027481,172.31.36.0-255,1448,123109,7,313325
5704,0.027724,172.217.160.0-255,2902,126011,7,313325
5705,0.02773,172.31.36.0-255,66,126077,7,313325
5706,0.027858,172.217.160.0-255,2902,128979,7,313325
5707,0.027871,172.31.36.0-255,66,129045,7,313325
5708,0.028937,104.244.42.0-255,66,129111,7,313325
5709,0.028991,104.244.42.0-255,66,129177,7,313325
5710,0.029038,104.244.42.0-255,66,129243,7,313325
5711,0.029358,172.217.160.0-255,2902,132145,7,313325
5712,0.029365,172.31.36.0-255,66,132211,7,313325
5713,0.029485,172.217.160.0-255,2902,135113,7,313325
5714,0.029489,172.31.36.0-255,66,135179,7,313325
5715,0.03101,172.217.160.0-255,2902,138081,7,313325
5716,0.031018,172.31.36.0-255,66,138147,7,313325
5717,0.031106,172.217.160.0-255,2902,141049,7,313325
5718,0.031113,172.31.36.0-255,66,141115,7,313325
5719,0.032648,172.217.160.0-255,2902,144017,7,313325
5720,0.032655,172.31.36.0-255,66,144083,7,313325
5721,0.032735,172.217.160.0-255,2902,146985,7,313325
5722,0.032765,172.31.36.0-255,66,147051,7,313325
5723,0.034284,172.217.160.0-255,2902,149953,7,313325
5724,0.03429,172.31.36.0-255,66,150019,7,313325
5725,0.034377,172.217.160.0-255,2902,152921,7,313325
5726,0.034395,172.31.36.0-255,66,152987,7,313325
5727,0.035917,172.217.160.0-255,2902,155889,7,313325
5728,0.035927,172.31.36.0-255,66,155955,7,313325
5729,0.036014,172.217.160.0-255,2902,158857,7,313325
5730,0.036034,172.31.36.0-255,66,158923,7,313325
5731,0.037581,172.217.160.0-255,2902,161825,7,313325
5732,0.037589,172.31.36.0-255,66,161891,7,313325
5733,0.037651,172.217.160.0-255,2902,164793,7,313325
5734,0.037677,172.31.36.0-255,66,164859,7,313325
5735,0.039221,172.217.160.0-255,2902,167761,7,313325
5736,0.039229,172.31.36.0-255,66,167827,7,313325
5737,0.039301,172.217.160.0-255,2902,170729,7,313325
5738,0.039311,172.31.36.0-255,66,170795,7,313325
5739,0.04087,172.217.160.0-255,2902,173697,7,313325
5740,0.040877,172.31.36.0-255,66,173763,7,313325
5741,0.040944,172.217.160.0-255,2902,176665,7,313325
5742,0.040952,172.31.36.0-255,66,176731,7,313325
5743,0.042503,172.217.160.0-255,2902,179633,7,313325
5744,0.04251,172.31.36.0-255,66,179699,7,313325
5745,0.042592,172.217.160.0-255,2902,182601,7,313325
5746,0.042613,172.31.36.0-255,66,182667,7,313325
5747,0.044153,172.217.160.0-255,2902,185569,7,313325
5748,0.04416,172.31.36.0-255,66,185635,7,313325
5749,0.044235,172.217.160.0-255,2902,188537,7,313325
5750,0.04425,172.31.36.0-255,66,188603,7,313325
5751,0.045797,172.217.160.0-255,2902,191505,7,313325
5752,0.045806,172.31.36.0-255,66,191571,7,313325
5753,0.045873,172.217.160.0-255,2902,194473,7,313325
5754,0.045905,172.31.36.0-255,66,194539,7,313325
5755,0.047437,172.217.160.0-255,2902,197441,7,313325
5756,0.047444,172.31.36.0-255,66,197507,7,313325
5757,0.047521,172.217.160.0-255,2902,200409,7,313325
5758,0.047534,172.31.36.0-255,66,200475,7,313325
5759,0.049118,172.217.160.0-255,2902,203377,7,313325
5760,0.049129,172.31.36.0-255,66,203443,7,313325
5761,0.049152,172.217.160.0-255,2902,206345,7,313325
5762,0.049195,172.31.36.0-255,66,206411,7,313325
5763,0.050761,172.217.160.0-255,2902,209313,7,313325
5764,0.050769,172.31.36.0-255,66,209379,7,313325
5765,0.050838,172.217.160.0-255,1484,210863,7,313325
5766,0.050851,172.217.160.0-255,1484,212347,7,313325
5767,0.050861,172.31.36.0-255,66,212413,7,313325
5768,0.052414,172.217.160.0-255,2902,215315,7,313325
5769,0.052421,172.31.36.0-255,66,215381,7,313325
5770,0.052493,172.217.160.0-255,2902,218283,7,313325
5771,0.052513,172.31.36.0-255,66,218349,7,313325
5772,0.054078,172.217.160.0-255,2902,221251,7,313325
5773,0.054086,172.31.36.0-255,66,221317,7,313325
5774,0.054153,172.217.160.0-255,2902,224219,7,313325
5775,0.05418,172.31.36.0-255,66,224285,7,313325
5776,0.055719,172.217.160.0-255,2902,227187,7,313325
5777,0.055724,172.31.36.0-255,66,227253,7,313325
5778,0.055805,172.217.160.0-255,2902,230155,7,313325
5779,0.05583,172.31.36.0-255,66,230221,7,313325
5780,0.05736,172.217.160.0-255,2902,233123,7,313325
5781,0.057366,172.31.36.0-255,66,233189,7,313325
5782,0.057445,172.217.160.0-255,2902,236091,7,313325
5783,0.057467,172.31.36.0-255,66,236157,7,313325
5784,0.058996,172.217.160.0-255,2902,239059,7,313325
5785,0.059003,172.31.36.0-255,66,239125,7,313325
5786,0.059081,172.217.160.0-255,2902,242027,7,313325
5787,0.059435,172.31.36.0-255,66,242093,7,313325
5788,0.060631,172.217.160.0-255,2902,244995,7,313325
5789,0.060638,172.31.36.0-255,66,245061,7,313325
5790,0.061066,172.217.160.0-255,2902,247963,7,313325
5791,0.061073,172.31.36.0-255,66,248029,7,313325
5792,0.062263,172.217.160.0-255,2902,250931,7,313325
5793,0.06227,172.31.36.0-255,66,250997,7,313325
5794,0.062698,172.217.160.0-255,2902,253899,7,313325
5795,0.062704,172.31.36.0-255,66,253965,7,313325
5796,0.06391,172.217.160.0-255,2902,256867,7,313325
5797,0.063917,172.31.36.0-255,66,256933,7,313325
5798,0.064354,172.217.160.0-255,2902,259835,7,313325
5799,0.064361,172.31.36.0-255,66,259901,7,313325
5800,0.065546,172.217.160.0-255,2902,262803,7,313325
5801,0.065553,172.31.36.0-255,66,262869,7,313325
5802,0.065988,172.217.160.0-255,2902,265771,7,313325
5803,0.065995,172.31.36.0-255,66,265837,7,313325
5804,0.067187,172.217.160.0-255,2902,268739,7,313325
5805,0.067194,172.31.36.0-255,66,268805,7,313325
5806,0.067633,172.217.160.0-255,2902,271707,7,313325
5807,0.06764,172.31.36.0-255,66,271773,7,313325
5808,0.068828,172.217.160.0-255,2902,274675,7,313325
5809,0.068835,172.31.36.0-255,66,274741,7,313325
5810,0.069269,172.217.160.0-255,2902,277643,7,313325
5811,0.069275,172.31.36.0-255,66,277709,7,313325
5812,0.070465,172.217.160.0-255,2902,280611,7,313325
5813,0.070472,172.31.36.0-255,66,280677,7,313325
5814,0.070907,172.217.160.0-255,2902,283579,7,313325
5815,0.070914,172.31.36.0-255,66,283645,7,313325
5816,0.072102,172.217.160.0-255,2902,286547,7,313325
5817,0.072108,172.31.36.0-255,66,286613,7,313325
5818,0.072544,172.217.160.0-255,2902,289515,7,313325
5819,0.07255,172.31.36.0-255,66,289581,7,313325
5820,0.073749,172.217.160.0-255,2902,292483,7,313325
5821,0.073756,172.31.36.0-255,66,292549,7,313325
5822,0.074172,172.217.160.0-255,2902,295451,7,313325
5823,0.074179,172.31.36.0-255,66,295517,7,313325
5824,0.075392,172.217.160.0-255,2902,298419,7,313325
5825,0.075399,172.31.36.0-255,66,298485,7,313325
5826,0.075809,172.217.160.0-255,2902,301387,7,313325
5827,0.075816,172.31.36.0-255,66,301453,7,313325
5828,0.077056,172.217.160.0-255,2902,304355,7,313325
5829,0.077065,172.31.36.0-255,66,304421,7,313325
5830,0.077438,172.217.160.0-255,2902,307323,7,313325
5831,0.077445,172.31.36.0-255,66,307389,7,313325
5832,0.078699,172.217.160.0-255,2902,310291,7,313325
5833,0.078705,172.31.36.0-255,66,310357,7,313325
5834,0.079077,172.217.160.0-255,2902,313259,7,313325
5835,0.079084,172.31.36.0-255,66,313325,7,313325
5836,0.0,172.217.194.0-255,152,152,7,318456
5837,2.4e-05,172.31.36.0-255,66,218,7,318456
5838,3.1e-05,172.217.194.0-255,1484,1702,7,318456
5839,3.4e-05,172.31.36.0-255,66,1768,7,318456
5840,3.9e-05,172.217.194.0-255,2902,4670,7,318456
5841,4.2e-05,172.31.36.0-255,66,4736,7,318456
5842,4.9e-05,172.217.194.0-255,7156,11892,7,318456
5843,5.1e-05,172.31.36.0-255,66,11958,7,318456
5844,5.5e-05,172.217.194.0-255,4839,16797,7,318456
5845,5.8e-05,172.31.36.0-255,66,16863,7,318456
5846,7.9e-05,172.217.194.0-255,1484,18347,7,318456
5847,8.2e-05,172.31.36.0-255,66,18413,7,318456
5848,0.000118,172.31.36.0-255,66,18479,7,318456
5849,0.000178,172.217.194.0-255,5738,24217,7,318456
5850,0.000181,172.31.36.0-255,66,24283,7,318456
5851,0.0002,172.217.194.0-255,5738,30021,7,318456
5852,0.000203,172.31.36.0-255,66,30087,7,318456
5853,0.000216,172.217.194.0-255,2902,32989,7,318456
5854,0.000218,172.31.36.0-255,66,33055,7,318456
5855,0.000234,172.217.194.0-255,3961,37016,7,318456
5856,0.000236,172.31.36.0-255,66,37082,7,318456
5857,0.000242,172.217.194.0-255,7156,44238,7,318456
5858,0.000244,172.31.36.0-255,66,44304,7,318456
5859,0.000271,172.31.36.0-255,66,44370,7,318456
5860,0.000286,172.217.194.0-255,647,45017,7,318456
5861,0.000289,172.31.36.0-255,66,45083,7,318456
5862,0.000498,172.217.194.0-255,1484,46567,7,318456
5863,0.000501,172.31.36.0-255,66,46633,7,318456
5864,0.000506,172.217.194.0-255,2902,49535,7,318456
5865,0.000508,172.31.36.0-255,66,49601,7,318456
5866,0.000548,172.217.194.0-255,5738,55339,7,318456
5867,0.000552,172.217.194.0-255,2902,58241,7,318456
5868,0.000555,172.31.36.0-255,66,58307,7,318456
5869,0.000569,172.31.36.0-255,66,58373,7,318456
5870,0.000585,172.31.36.0-255,66,58439,7,318456
5871,0.000597,172.31.36.0-255,66,58505,7,318456
5872,0.000919,172.217.194.0-255,1484,59989,7,318456
5873,0.000942,172.217.194.0-255,2902,62891,7,318456
5874,0.000945,172.31.36.0-255,66,62957,7,318456
5875,0.00095,172.217.194.0-255,2902,65859,7,318456
5876,0.000952,172.31.36.0-255,66,65925,7,318456
5877,0.000968,172.217.194.0-255,2902,68827,7,318456
5878,0.00097,172.31.36.0-255,66,68893,7,318456
5879,0.000975,172.217.194.0-255,2902,71795,7,318456
5880,0.000976,172.31.36.0-255,66,71861,7,318456
5881,0.001017,172.217.194.0-255,7156,79017,7,318456
5882,0.001024,172.31.36.0-255,66,79083,7,318456
5883,0.001035,172.217.194.0-255,1484,80567,7,318456
5884,0.00105,172.217.194.0-255,2902,83469,7,318456
5885,0.001058,172.31.36.0-255,66,83535,7,318456
5886,0.001076,172.217.194.0-255,2184,85719,7,318456
5887,0.001082,172.217.194.0-255,5738,91457,7,318456
5888,0.001084,172.31.36.0-255,66,91523,7,318456
5889,0.001086,172.217.194.0-255,4320,95843,7,318456
5890,0.001089,172.31.36.0-255,66,95909,7,318456
5891,0.001103,172.31.36.0-255,66,95975,7,318456
5892,0.001115,172.31.36.0-255,66,96041,7,318456
5893,0.001136,172.31.36.0-255,66,96107,7,318456
5894,0.001192,172.217.194.0-255,1484,97591,7,318456
5895,0.001197,172.217.194.0-255,2902,100493,7,318456
5896,0.001208,172.31.36.0-255,66,100559,7,318456
5897,0.001209,172.217.194.0-255,1484,102043,7,318456
5898,0.001223,172.217.194.0-255,4320,106363,7,318456
5899,0.001235,172.31.36.0-255,66,106429,7,318456
5900,0.001241,172.217.194.0-255,4320,110749,7,318456
5901,0.001249,172.31.36.0-255,66,110815,7,318456
5902,0.001259,172.217.194.0-255,5738,116553,7,318456
5903,0.001262,172.31.36.0-255,66,116619,7,318456
5904,0.001273,172.217.194.0-255,2184,118803,7,318456
5905,0.001278,172.31.36.0-255,66,118869,7,318456
5906,0.001553,172.217.194.0-255,1484,120353,7,318456
5907,0.001567,172.217.194.0-255,2902,123255,7,318456
5908,0.001571,172.31.36.0-255,66,123321,7,318456
5909,0.001593,172.217.194.0-255,5738,129059,7,318456
5910,0.001597,172.31.36.0-255,66,129125,7,318456
5911,0.001621,172.217.194.0-255,1484,130609,7,318456
5912,0.001643,172.31.36.0-255,66,130675,7,318456
5913,0.001648,172.217.194.0-255,2902,133577,7,318456
5914,0.001653,172.217.194.0-255,4320,137897,7,318456
5915,0.001661,172.31.36.0-255,66,137963,7,318456
5916,0.001708,172.217.194.0-255,3602,141565,7,318456
5917,0.001713,172.31.36.0-255,66,141631,7,318456
5918,0.001914,172.217.194.0-255,1484,143115,7,318456
5919,0.001928,172.217.194.0-255,2902,146017,7,318456
5920,0.001932,172.31.36.0-255,66,146083,7,318456
5921,0.001956,172.217.194.0-255,5738,151821,7,318456
5922,0.00196,172.217.194.0-255,1484,153305,7,318456
5923,0.001965,172.31.36.0-255,66,153371,7,318456
5924,0.002001,172.217.194.0-255,5738,159109,7,318456
5925,0.002001,172.31.36.0-255,66,159175,7,318456
5926,0.002016,172.31.36.0-255,66,159241,7,318456
5927,0.002042,172.31.36.0-255,66,159307,7,318456
5928,0.004104,172.217.194.0-255,5738,165045,7,318456
5929,0.00411,172.31.36.0-255,66,165111,7,318456
5930,0.006133,172.217.194.0-255,5738,170849,7,318456
5931,0.00614,172.31.36.0-255,66,170915,7,318456
5932,0.008193,172.217.194.0-255,5738,176653,7,318456
5933,0.008197,172.31.36.0-255,66,176719,7,318456
5934,0.010256,172.217.194.0-255,5738,182457,7,318456
5935,0.010262,172.31.36.0-255,66,182523,7,318456
5936,0.012294,172.217.194.0-255,5738,188261,7,318456
5937,0.012299,172.31.36.0-255,66,188327,7,318456
5938,0.014358,172.217.194.0-255,5738,194065,7,318456
5939,0.014369,172.31.36.0-255,66,194131,7,318456
5940,0.016411,172.217.194.0-255,5738,199869,7,318456
5941,0.016417,172.31.36.0-255,66,199935,7,318456
5942,0.018446,172.217.194.0-255,5738,205673,7,318456
5943,0.018453,172.31.36.0-255,66,205739,7,318456
5944,0.020495,172.217.194.0-255,5738,211477,7,318456
5945,0.020502,172.31.36.0-255,66,211543,7,318456
5946,0.022504,172.217.194.0-255,5738,217281,7,318456
5947,0.022512,172.31.36.0-255,66,217347,7,318456
5948,0.024543,172.217.194.0-255,5738,223085,7,318456
5949,0.024551,172.31.36.0-255,66,223151,7,318456
5950,0.026586,172.217.194.0-255,5738,228889,7,318456
5951,0.026593,172.31.36.0-255,66,228955,7,318456
5952,0.028656,172.217.194.0-255,2902,231857,7,318456
5953,0.028662,172.31.36.0-255,66,231923,7,318456
5954,0.028694,172.217.194.0-255,2902,234825,7,318456
5955,0.028697,172.31.36.0-255,66,234891,7,318456
5956,0.029182,172.31.36.0-255,188,235079,7,318456
5957,0.029212,172.31.36.0-255,958,236037,7,318456
5958,0.029297,172.31.36.0-255,1514,237551,7,318456
5959,0.029299,172.31.36.0-255,1514,239065,7,318456
5960,0.029304,172.31.36.0-255,1514,240579,7,318456
5961,0.029306,172.31.36.0-255,1229,241808,7,318456
5962,0.03068,172.217.194.0-255,2902,244710,7,318456
5963,0.030686,172.31.36.0-255,66,244776,7,318456
5964,0.030726,104.244.42.0-255,66,244842,7,318456
5965,0.030763,172.217.194.0-255,2902,247744,7,318456
5966,0.030768,172.31.36.0-255,66,247810,7,318456
5967,0.03083,104.244.42.0-255,66,247876,7,318456
5968,0.030861,104.244.42.0-255,66,247942,7,318456
5969,0.030866,104.244.42.0-255,66,248008,7,318456
5970,0.032684,172.217.194.0-255,2902,250910,7,318456
5971,0.032689,172.31.36.0-255,66,250976,7,318456
5972,0.032798,172.217.194.0-255,2902,253878,7,318456
5973,0.032803,172.31.36.0-255,66,253944,7,318456
5974,0.034717,172.217.194.0-255,2902,256846,7,318456
5975,0.034723,172.31.36.0-255,66,256912,7,318456
5976,0.03483,172.217.194.0-255,2902,259814,7,318456
5977,0.034835,172.31.36.0-255,66,259880,7,318456
5978,0.036738,172.217.194.0-255,2902,262782,7,318456
5979,0.036744,172.31.36.0-255,66,262848,7,318456
5980,0.036851,172.217.194.0-255,2902,265750,7,318456
5981,0.036855,172.31.36.0-255,66,265816,7,318456
5982,0.038753,172.217.194.0-255,2902,268718,7,318456
5983,0.038761,172.31.36.0-255,66,268784,7,318456
5984,0.038873,172.217.194.0-255,2902,271686,7,318456
5985,0.038878,172.31.36.0-255,66,271752,7,318456
5986,0.040777,172.217.194.0-255,2902,274654,7,318456
5987,0.040796,172.31.36.0-255,66,274720,7,318456
5988,0.040949,172.217.194.0-255,2902,277622,7,318456
5989,0.040955,172.31.36.0-255,66,277688,7,318456
5990,0.042832,172.217.194.0-255,2902,280590,7,318456
5991,0.042837,172.31.36.0-255,66,280656,7,318456
5992,0.042948,172.217.194.0-255,2902,283558,7,318456
5993,0.042953,172.31.36.0-255,66,283624,7,318456
5994,0.044862,172.217.194.0-255,2902,286526,7,318456
5995,0.044873,172.31.36.0-255,66,286592,7,318456
5996,0.044965,172.217.194.0-255,2902,289494,7,318456
5997,0.044972,172.31.36.0-255,66,289560,7,318456
5998,0.046878,172.217.194.0-255,2902,292462,7,318456
5999,0.046884,172.31.36.0-255,66,292528,7,318456
6000,0.04697,172.217.194.0-255,2902,295430,7,318456
6001,0.046975,172.31.36.0-255,66,295496,7,318456
6002,0.048898,172.217.194.0-255,2902,298398,7,318456
6003,0.048903,172.31.36.0-255,66,298464,7,318456
6004,0.049001,172.217.194.0-255,2902,301366,7,318456
6005,0.049006,172.31.36.0-255,66,301432,7,318456
6006,0.050943,172.217.194.0-255,2902,304334,7,318456
6007,0.050949,172.31.36.0-255,66,304400,7,318456
6008,0.051038,172.217.194.0-255,2902,307302,7,318456
6009,0.051043,172.31.36.0-255,66,307368,7,318456
6010,0.05297,172.217.194.0-255,2902,310270,7,318456
6011,0.052976,172.31.36.0-255,66,310336,7,318456
6012,0.053064,172.217.194.0-255,2902,313238,7,318456
6013,0.05307,172.31.36.0-255,66,313304,7,318456
6014,0.054982,172.217.194.0-255,2902,316206,7,318456
6015,0.054987,172.31.36.0-255,66,316272,7,318456
6016,0.05506,172.217.194.0-255,1947,318219,7,318456
6017,0.055066,172.31.36.0-255,66,318285,7,318456
6018,0.055193,172.31.36.0-255,105,318390,7,318456
6019,0.05718,172.217.194.0-255,66,318456,7,318456
6020,0.0,172.31.36.0-255,97,97,7,163
6021,0.005653,172.217.27.0-255,66,163,7,163
6022,0.0,74.125.24.0-255,146,146,7,297751
6023,1.9e-05,172.31.36.0-255,66,212,7,297751
6024,2.6e-05,74.125.24.0-255,1484,1696,7,297751
6025,3.1e-05,172.31.36.0-255,66,1762,7,297751
6026,3.6e-05,74.125.24.0-255,2902,4664,7,297751
6027,3.9e-05,172.31.36.0-255,66,4730,7,297751
6028,5.4e-05,74.125.24.0-255,7156,11886,7,297751
6029,5.9e-05,172.31.36.0-255,66,11952,7,297751
6030,0.000104,172.31.36.0-255,66,12018,7,297751
6031,0.000116,172.31.36.0-255,66,12084,7,297751
6032,0.00013,74.125.24.0-255,4320,16404,7,297751
6033,0.000132,172.31.36.0-255,66,16470,7,297751
6034,0.00017,172.31.36.0-255,66,16536,7,297751
6035,0.000173,74.125.24.0-255,766,17302,7,297751
6036,0.000175,172.31.36.0-255,66,17368,7,297751
6037,0.000512,74.125.24.0-255,1484,18852,7,297751
6038,0.000519,172.31.36.0-255,66,18918,7,297751
6039,0.000525,74.125.24.0-255,2902,21820,7,297751
6040,0.000528,172.31.36.0-255,66,21886,7,297751
6041,0.000532,74.125.24.0-255,1484,23370,7,297751
6042,0.000533,172.31.36.0-255,66,23436,7,297751
6043,0.000571,74.125.24.0-255,4320,27756,7,297751
6044,0.000574,172.31.36.0-255,66,27822,7,297751
6045,0.000581,74.125.24.0-255,6797,34619,7,297751
6046,0.000584,172.31.36.0-255,66,34685,7,297751
6047,0.000639,74.125.24.0-255,1484,36169,7,297751
6048,0.000642,172.31.36.0-255,66,36235,7,297751
6049,0.000648,74.125.24.0-255,2902,39137,7,297751
6050,0.000651,172.31.36.0-255,66,39203,7,297751
6051,0.000677,74.125.24.0-255,5738,44941,7,297751
6052,0.000679,172.31.36.0-255,66,45007,7,297751
6053,0.000704,74.125.24.0-255,1484,46491,7,297751
6054,0.00072,74.125.24.0-255,5959,52450,7,297751
6055,0.000722,172.31.36.0-255,66,52516,7,297751
6056,0.001282,74.125.24.0-255,1484,54000,7,297751
6057,0.001299,74.125.24.0-255,2902,56902,7,297751
6058,0.001303,172.31.36.0-255,66,56968,7,297751
6059,0.001309,74.125.24.0-255,2902,59870,7,297751
6060,0.001311,172.31.36.0-255,66,59936,7,297751
6061,0.001314,74.125.24.0-255,1484,61420,7,297751
6062,0.001347,74.125.24.0-255,5738,67158,7,297751
6063,0.00135,172.31.36.0-255,66,67224,7,297751
6064,0.001363,172.31.36.0-255,66,67290,7,297751
6065,0.001391,74.125.24.0-255,5379,72669,7,297751
6066,0.001398,74.125.24.0-255,7156,79825,7,297751
6067,0.001403,172.31.36.0-255,66,79891,7,297751
6068,0.001406,172.31.36.0-255,66,79957,7,297751
6069,0.001437,172.31.36.0-255,66,80023,7,297751
6070,0.001441,74.125.24.0-255,2184,82207,7,297751
6071,0.001444,172.31.36.0-255,66,82273,7,297751
6072,0.001471,74.125.24.0-255,1484,83757,7,297751
6073,0.001495,74.125.24.0-255,2902,86659,7,297751
6074,0.001497,172.31.36.0-255,66,86725,7,297751
6075,0.001505,74.125.24.0-255,5738,92463,7,297751
6076,0.001507,172.31.36.0-255,66,92529,7,297751
6077,0.001567,172.31.36.0-255,66,92595,7,297751
6078,0.001595,74.125.24.0-255,1484,94079,7,297751
6079,0.001611,172.31.36.0-255,66,94145,7,297751
6080,0.001619,74.125.24.0-255,7156,101301,7,297751
6081,0.001622,172.31.36.0-255,66,101367,7,297751
6082,0.001626,74.125.24.0-255,2902,104269,7,297751
6083,0.001628,172.31.36.0-255,66,104335,7,297751
6084,0.001661,74.125.24.0-255,5738,110073,7,297751
6085,0.001679,172.31.36.0-255,66,110139,7,297751
6086,0.001686,172.31.36.0-255,66,110205,7,297751
6087,0.001696,74.125.24.0-255,2902,113107,7,297751
6088,0.001698,172.31.36.0-255,66,113173,7,297751
6089,0.001701,74.125.24.0-255,766,113939,7,297751
6090,0.001925,74.125.24.0-255,1484,115423,7,297751
6091,0.00193,172.31.36.0-255,66,115489,7,297751
6092,0.00195,74.125.24.0-255,2902,118391,7,297751
6093,0.001952,172.31.36.0-255,66,118457,7,297751
6094,0.001992,74.125.24.0-255,5738,124195,7,297751
6095,0.001995,172.31.36.0-255,66,124261,7,297751
6096,0.002009,172.31.36.0-255,66,124327,7,297751
6097,0.002021,172.31.36.0-255,66,124393,7,297751
6098,0.002025,74.125.24.0-255,2184,126577,7,297751
6099,0.002029,172.31.36.0-255,66,126643,7,297751
6100,0.002056,74.125.24.0-255,2902,129545,7,297751
6101,0.002059,172.31.36.0-255,66,129611,7,297751
6102,0.002064,74.125.24.0-255,2902,132513,7,297751
6103,0.002066,172.31.36.0-255,66,132579,7,297751
6104,0.002095,74.125.24.0-255,4320,136899,7,297751
6105,0.002099,172.31.36.0-255,66,136965,7,297751
6106,0.002116,172.31.36.0-255,66,137031,7,297751
6107,0.00215,74.125.24.0-255,1484,138515,7,297751
6108,0.002165,172.31.36.0-255,66,138581,7,297751
6109,0.004739,74.125.24.0-255,5738,144319,7,297751
6110,0.004748,172.31.36.0-255,66,144385,7,297751
6111,0.007328,74.125.24.0-255,5738,150123,7,297751
6112,0.007332,172.31.36.0-255,66,150189,7,297751
6113,0.009935,74.125.24.0-255,5738,155927,7,297751
6114,0.009942,172.31.36.0-255,66,155993,7,297751
6115,0.012559,74.125.24.0-255,5738,161731,7,297751
6116,0.012567,172.31.36.0-255,66,161797,7,297751
6117,0.01516,74.125.24.0-255,5738,167535,7,297751
6118,0.015168,172.31.36.0-255,66,167601,7,297751
6119,0.017803,74.125.24.0-255,5738,173339,7,297751
6120,0.017816,172.31.36.0-255,66,173405,7,297751
6121,0.020419,74.125.24.0-255,5738,179143,7,297751
6122,0.020429,172.31.36.0-255,66,179209,7,297751
6123,0.023056,74.125.24.0-255,5738,184947,7,297751
6124,0.023069,172.31.36.0-255,66,185013,7,297751
6125,0.02567,74.125.24.0-255,5738,190751,7,297751
6126,0.025676,172.31.36.0-255,66,190817,7,297751
6127,0.02827,74.125.24.0-255,5738,196555,7,297751
6128,0.028279,172.31.36.0-255,66,196621,7,297751
6129,0.030862,74.125.24.0-255,5738,202359,7,297751
6130,0.030869,172.31.36.0-255,66,202425,7,297751
6131,0.033534,74.125.24.0-255,5738,208163,7,297751
6132,0.033542,172.31.36.0-255,66,208229,7,297751
6133,0.036121,74.125.24.0-255,5738,213967,7,297751
6134,0.036129,172.31.36.0-255,66,214033,7,297751
6135,0.036775,172.31.36.0-255,176,214209,7,297751
6136,0.036805,172.31.36.0-255,1115,215324,7,297751
6137,0.03687,172.31.36.0-255,1514,216838,7,297751
6138,0.036872,172.31.36.0-255,1514,218352,7,297751
6139,0.036878,172.31.36.0-255,1514,219866,7,297751
6140,0.036879,172.31.36.0-255,1514,221380,7,297751
6141,0.036902,172.31.36.0-255,1514,222894,7,297751
6142,0.036904,172.31.36.0-255,69,222963,7,297751
6143,0.038314,104.244.42.0-255,66,223029,7,297751
6144,0.038369,104.244.42.0-255,66,223095,7,297751
6145,0.038483,104.244.42.0-255,66,223161,7,297751
6146,0.038544,104.244.42.0-255,66,223227,7,297751
6147,0.038708,74.125.24.0-255,5738,228965,7,297751
6148,0.038714,172.31.36.0-255,66,229031,7,297751
6149,0.041298,74.125.24.0-255,5738,234769,7,297751
6150,0.041307,172.31.36.0-255,66,234835,7,297751
6151,0.043899,74.125.24.0-255,5738,240573,7,297751
6152,0.043907,172.31.36.0-255,66,240639,7,297751
6153,0.04651,74.125.24.0-255,5738,246377,7,297751
6154,0.046519,172.31.36.0-255,66,246443,7,297751
6155,0.049085,74.125.24.0-255,5738,252181,7,297751
6156,0.049091,172.31.36.0-255,66,252247,7,297751
6157,0.051694,74.125.24.0-255,5738,257985,7,297751
6158,0.051705,172.31.36.0-255,66,258051,7,297751
6159,0.054351,74.125.24.0-255,5738,263789,7,297751
6160,0.054359,172.31.36.0-255,66,263855,7,297751
6161,0.056958,74.125.24.0-255,5738,269593,7,297751
6162,0.056965,172.31.36.0-255,66,269659,7,297751
6163,0.059571,74.125.24.0-255,5738,275397,7,297751
6164,0.059578,172.31.36.0-255,66,275463,7,297751
6165,0.062167,74.125.24.0-255,5738,281201,7,297751
6166,0.062174,172.31.36.0-255,66,281267,7,297751
6167,0.064773,74.125.24.0-255,5738,287005,7,297751
6168,0.06478,172.31.36.0-255,66,287071,7,297751
6169,0.06739,74.125.24.0-255,5738,292809,7,297751
6170,0.0674,172.31.36.0-255,66,292875,7,297751
6171,0.070015,74.125.24.0-255,4639,297514,7,297751
6172,0.07002,172.31.36.0-255,66,297580,7,297751
6173,0.070188,172.31.36.0-255,105,297685,7,297751
6174,0.072746,74.125.24.0-255,66,297751,7,297751
6175,0.0,74.125.24.0-255,153,153,7,220528
6176,2.1e-05,172.31.36.0-255,66,219,7,220528
6177,2.8e-05,74.125.24.0-255,1484,1703,7,220528
6178,3.2e-05,172.31.36.0-255,66,1769,7,220528
6179,3.8e-05,74.125.24.0-255,2902,4671,7,220528
6180,5e-05,172.31.36.0-255,66,4737,7,220528
6181,5.8e-05,74.125.24.0-255,7156,11893,7,220528
6182,6.2e-05,172.31.36.0-255,66,11959,7,220528
6183,7.3e-05,172.31.36.0-255,66,12025,7,220528
6184,7.7e-05,74.125.24.0-255,1484,13509,7,220528
6185,8e-05,172.31.36.0-255,66,13575,7,220528
6186,0.000133,74.125.24.0-255,7156,20731,7,220528
6187,0.000137,172.31.36.0-255,66,20797,7,220528
6188,0.000142,74.125.24.0-255,2543,23340,7,220528
6189,0.000144,172.31.36.0-255,66,23406,7,220528
6190,0.000149,74.125.24.0-255,2902,26308,7,220528
6191,0.000151,172.31.36.0-255,66,26374,7,220528
6192,0.000159,74.125.24.0-255,7156,33530,7,220528
6193,0.000162,172.31.36.0-255,66,33596,7,220528
6194,0.000166,74.125.24.0-255,2902,36498,7,220528
6195,0.000168,172.31.36.0-255,66,36564,7,220528
6196,0.000196,74.125.24.0-255,3961,40525,7,220528
6197,0.000199,172.31.36.0-255,66,40591,7,220528
6198,0.000267,74.125.24.0-255,1484,42075,7,220528
6199,0.000269,172.31.36.0-255,66,42141,7,220528
6200,0.000302,74.125.24.0-255,2902,45043,7,220528
6201,0.000305,172.31.36.0-255,66,45109,7,220528
6202,0.000311,74.125.24.0-255,5738,50847,7,220528
6203,0.000314,172.31.36.0-255,66,50913,7,220528
6204,0.000318,74.125.24.0-255,2902,53815,7,220528
6205,0.000321,172.31.36.0-255,66,53881,7,220528
6206,0.000336,74.125.24.0-255,3961,57842,7,220528
6207,0.000338,172.31.36.0-255,66,57908,7,220528
6208,0.000515,74.125.24.0-255,1484,59392,7,220528
6209,0.000522,74.125.24.0-255,1484,60876,7,220528
6210,0.000525,172.31.36.0-255,66,60942,7,220528
6211,0.000556,74.125.24.0-255,1484,62426,7,220528
6212,0.000563,74.125.24.0-255,5738,68164,7,220528
6213,0.000566,172.31.36.0-255,66,68230,7,220528
6214,0.000573,74.125.24.0-255,5738,73968,7,220528
6215,0.000576,172.31.36.0-255,66,74034,7,220528
6216,0.000606,172.31.36.0-255,66,74100,7,220528
6217,0.000616,172.31.36.0-255,66,74166,7,220528
6218,0.000619,74.125.24.0-255,1484,75650,7,220528
6219,0.000671,172.31.36.0-255,66,75716,7,220528
6220,0.000675,74.125.24.0-255,1156,76872,7,220528
6221,0.000832,74.125.24.0-255,1484,78356,7,220528
6222,0.000836,74.125.24.0-255,2902,81258,7,220528
6223,0.000841,172.31.36.0-255,66,81324,7,220528
6224,0.000846,172.31.36.0-255,66,81390,7,220528
6225,0.000863,74.125.24.0-255,5738,87128,7,220528
6226,0.000866,172.31.36.0-255,66,87194,7,220528
6227,0.000878,172.31.36.0-255,66,87260,7,220528
6228,0.000907,74.125.24.0-255,4320,91580,7,220528
6229,0.00091,172.31.36.0-255,66,91646,7,220528
6230,0.000917,74.125.24.0-255,7156,98802,7,220528
6231,0.00092,172.31.36.0-255,66,98868,7,220528
6232,0.000925,74.125.24.0-255,3602,102470,7,220528
6233,0.000928,172.31.36.0-255,66,102536,7,220528
6234,0.001365,74.125.24.0-255,1484,104020,7,220528
6235,0.001387,74.125.24.0-255,2902,106922,7,220528
6236,0.001391,172.31.36.0-255,66,106988,7,220528
6237,0.001397,74.125.24.0-255,4320,111308,7,220528
6238,0.001399,172.31.36.0-255,66,111374,7,220528
6239,0.001437,172.31.36.0-255,66,111440,7,220528
6240,0.001442,74.125.24.0-255,2902,114342,7,220528
6241,0.001445,172.31.36.0-255,66,114408,7,220528
6242,0.001494,172.31.36.0-255,66,114474,7,220528
6243,0.001498,74.125.24.0-255,1484,115958,7,220528
6244,0.001502,74.125.24.0-255,2902,118860,7,220528
6245,0.001504,172.31.36.0-255,66,118926,7,220528
6246,0.001545,74.125.24.0-255,1484,120410,7,220528
6247,0.001577,74.125.24.0-255,4320,124730,7,220528
6248,0.001581,172.31.36.0-255,66,124796,7,220528
6249,0.001586,74.125.24.0-255,2902,127698,7,220528
6250,0.001588,172.31.36.0-255,66,127764,7,220528
6251,0.001593,74.125.24.0-255,4320,132084,7,220528
6252,0.001595,172.31.36.0-255,66,132150,7,220528
6253,0.001606,172.31.36.0-255,66,132216,7,220528
6254,0.001618,172.31.36.0-255,66,132282,7,220528
6255,0.001625,74.125.24.0-255,5738,138020,7,220528
6256,0.001628,172.31.36.0-255,66,138086,7,220528
6257,0.00168,172.31.36.0-255,66,138152,7,220528
6258,0.001696,172.31.36.0-255,66,138218,7,220528
6259,0.001711,172.31.36.0-255,66,138284,7,220528
6260,0.001724,172.31.36.0-255,66,138350,7,220528
6261,0.001759,172.31.36.0-255,66,138416,7,220528
6262,0.001916,74.125.24.0-255,1484,139900,7,220528
6263,0.001922,74.125.24.0-255,2902,142802,7,220528
6264,0.001926,172.31.36.0-255,66,142868,7,220528
6265,0.001959,74.125.24.0-255,5738,148606,7,220528
6266,0.001962,172.31.36.0-255,66,148672,7,220528
6267,0.001969,74.125.24.0-255,4320,152992,7,220528
6268,0.001971,172.31.36.0-255,66,153058,7,220528
6269,0.002,172.31.36.0-255,66,153124,7,220528
6270,0.002013,172.31.36.0-255,66,153190,7,220528
6271,0.002753,74.125.24.0-255,1484,154674,7,220528
6272,0.002759,74.125.24.0-255,2902,157576,7,220528
6273,0.002763,172.31.36.0-255,66,157642,7,220528
6274,0.002768,74.125.24.0-255,2902,160544,7,220528
6275,0.002771,172.31.36.0-255,66,160610,7,220528
6276,0.002803,74.125.24.0-255,2902,163512,7,220528
6277,0.002806,172.31.36.0-255,66,163578,7,220528
6278,0.002817,172.31.36.0-255,66,163644,7,220528
6279,0.002825,74.125.24.0-255,7156,170800,7,220528
6280,0.002827,172.31.36.0-255,66,170866,7,220528
6281,0.002859,74.125.24.0-255,4320,175186,7,220528
6282,0.002862,172.31.36.0-255,66,175252,7,220528
6283,0.002866,74.125.24.0-255,2184,177436,7,220528
6284,0.002868,172.31.36.0-255,66,177502,7,220528
6285,0.002871,74.125.24.0-255,1484,178986,7,220528
6286,0.002878,74.125.24.0-255,5738,184724,7,220528
6287,0.00288,172.31.36.0-255,66,184790,7,220528
6288,0.002886,74.125.24.0-255,4320,189110,7,220528
6289,0.002887,172.31.36.0-255,66,189176,7,220528
6290,0.002897,172.31.36.0-255,66,189242,7,220528
6291,0.0029,74.125.24.0-255,1484,190726,7,220528
6292,0.002964,74.125.24.0-255,5738,196464,7,220528
6293,0.002967,172.31.36.0-255,66,196530,7,220528
6294,0.002975,74.125.24.0-255,6438,202968,7,220528
6295,0.002977,172.31.36.0-255,66,203034,7,220528
6296,0.002979,74.125.24.0-255,1484,204518,7,220528
6297,0.00299,172.31.36.0-255,66,204584,7,220528
6298,0.002993,74.125.24.0-255,1484,206068,7,220528
6299,0.003015,172.31.36.0-255,66,206134,7,220528
6300,0.003036,74.125.24.0-255,7156,213290,7,220528
6301,0.00304,74.125.24.0-255,2269,215559,7,220528
6302,0.003059,74.125.24.0-255,105,215664,7,220528
6303,0.003063,172.31.36.0-255,66,215730,7,220528
6304,0.016143,172.31.36.0-255,66,215796,7,220528
6305,0.0162,172.31.36.0-255,105,215901,7,220528
6306,0.018484,74.125.24.0-255,66,215967,7,220528
6307,0.037315,172.31.36.0-255,167,216134,7,220528
6308,0.037348,172.31.36.0-255,1114,217248,7,220528
6309,0.03741,172.31.36.0-255,1514,218762,7,220528
6310,0.037412,172.31.36.0-255,1292,220054,7,220528
6311,0.03891,104.244.42.0-255,66,220120,7,220528
6312,0.038943,104.244.42.0-255,66,220186,7,220528
6313,0.038994,104.244.42.0-255,66,220252,7,220528
6314,0.0592,172.31.36.0-255,105,220357,7,220528
6315,0.060706,157.240.13.0-255,105,220462,7,220528
6316,0.060714,172.31.36.0-255,66,220528,7,220528
6317,0.0,74.125.200.0-255,156,156,7,392553
6318,2.1e-05,172.31.36.0-255,66,222,7,392553
6319,2.8e-05,74.125.200.0-255,1484,1706,7,392553
6320,3.2e-05,172.31.36.0-255,66,1772,7,392553
6321,3.8e-05,74.125.200.0-255,2902,4674,7,392553
6322,4.1e-05,172.31.36.0-255,66,4740,7,392553
6323,4.7e-05,74.125.200.0-255,4320,9060,7,392553
6324,5.1e-05,172.31.36.0-255,66,9126,7,392553
6325,0.000102,74.125.200.0-255,4892,14018,7,392553
6326,0.000106,172.31.36.0-255,66,14084,7,392553
6327,0.000179,74.125.200.0-255,1484,15568,7,392553
6328,0.000182,172.31.36.0-255,66,15634,7,392553
6329,0.000202,74.125.200.0-255,2902,18536,7,392553
6330,0.000204,172.31.36.0-255,66,18602,7,392553
6331,0.000209,74.125.200.0-255,2902,21504,7,392553
6332,0.000211,172.31.36.0-255,66,21570,7,392553
6333,0.000214,74.125.200.0-255,1484,23054,7,392553
6334,0.000216,172.31.36.0-255,66,23120,7,392553
6335,0.000241,74.125.200.0-255,2902,26022,7,392553
6336,0.000244,172.31.36.0-255,66,26088,7,392553
6337,0.000261,74.125.200.0-255,2902,28990,7,392553
6338,0.000264,172.31.36.0-255,66,29056,7,392553
6339,0.000282,74.125.200.0-255,2543,31599,7,392553
6340,0.000284,172.31.36.0-255,66,31665,7,392553
6341,0.00032,74.125.200.0-255,1484,33149,7,392553
6342,0.000323,172.31.36.0-255,66,33215,7,392553
6343,0.000343,74.125.200.0-255,2902,36117,7,392553
6344,0.000346,172.31.36.0-255,66,36183,7,392553
6345,0.000349,74.125.200.0-255,1484,37667,7,392553
6346,0.000351,172.31.36.0-255,66,37733,7,392553
6347,0.000367,74.125.200.0-255,4320,42053,7,392553
6348,0.00037,172.31.36.0-255,66,42119,7,392553
6349,0.000374,74.125.200.0-255,2902,45021,7,392553
6350,0.000377,172.31.36.0-255,66,45087,7,392553
6351,0.000392,74.125.200.0-255,1484,46571,7,392553
6352,0.000407,74.125.200.0-255,2543,49114,7,392553
6353,0.000409,172.31.36.0-255,66,49180,7,392553
6354,0.000415,74.125.200.0-255,5738,54918,7,392553
6355,0.000418,172.31.36.0-255,66,54984,7,392553
6356,0.000434,74.125.200.0-255,2902,57886,7,392553
6357,0.000436,172.31.36.0-255,66,57952,7,392553
6358,0.00044,74.125.200.0-255,2902,60854,7,392553
6359,0.000442,172.31.36.0-255,66,60920,7,392553
6360,0.000466,74.125.200.0-255,2902,63822,7,392553
6361,0.000468,172.31.36.0-255,66,63888,7,392553
6362,0.00048,74.125.200.0-255,2898,66786,7,392553
6363,0.000482,172.31.36.0-255,66,66852,7,392553
6364,0.000496,74.125.200.0-255,332,67184,7,392553
6365,0.000767,74.125.200.0-255,1484,68668,7,392553
6366,0.000773,172.31.36.0-255,66,68734,7,392553
6367,0.000776,74.125.200.0-255,1484,70218,7,392553
6368,0.000779,74.125.200.0-255,1484,71702,7,392553
6369,0.000782,172.31.36.0-255,66,71768,7,392553
6370,0.000794,74.125.200.0-255,1484,73252,7,392553
6371,0.000797,74.125.200.0-255,1484,74736,7,392553
6372,0.000799,172.31.36.0-255,66,74802,7,392553
6373,0.000815,74.125.200.0-255,4320,79122,7,392553
6374,0.000818,172.31.36.0-255,66,79188,7,392553
6375,0.000836,74.125.200.0-255,4320,83508,7,392553
6376,0.000841,172.31.36.0-255,66,83574,7,392553
6377,0.000851,74.125.200.0-255,2902,86476,7,392553
6378,0.000853,172.31.36.0-255,66,86542,7,392553
6379,0.000858,74.125.200.0-255,2902,89444,7,392553
6380,0.00086,172.31.36.0-255,66,89510,7,392553
6381,0.000886,74.125.200.0-255,5738,95248,7,392553
6382,0.000889,172.31.36.0-255,66,95314,7,392553
6383,0.000895,74.125.200.0-255,6438,101752,7,392553
6384,0.000897,172.31.36.0-255,66,101818,7,392553
6385,0.001019,74.125.200.0-255,1484,103302,7,392553
6386,0.001024,74.125.200.0-255,1484,104786,7,392553
6387,0.001029,172.31.36.0-255,66,104852,7,392553
6388,0.001044,74.125.200.0-255,1484,106336,7,392553
6389,0.001047,74.125.200.0-255,1484,107820,7,392553
6390,0.001049,172.31.36.0-255,66,107886,7,392553
6391,0.001072,74.125.200.0-255,4320,112206,7,392553
6392,0.001074,172.31.36.0-255,66,112272,7,392553
6393,0.001079,74.125.200.0-255,2902,115174,7,392553
6394,0.001082,172.31.36.0-255,66,115240,7,392553
6395,0.001096,74.125.200.0-255,4320,119560,7,392553
6396,0.001099,172.31.36.0-255,66,119626,7,392553
6397,0.001102,74.125.200.0-255,1484,121110,7,392553
6398,0.001125,74.125.200.0-255,7156,128266,7,392553
6399,0.001128,172.31.36.0-255,66,128332,7,392553
6400,0.001138,172.31.36.0-255,66,128398,7,392553
6401,0.001215,74.125.200.0-255,1484,129882,7,392553
6402,0.001228,74.125.200.0-255,1484,131366,7,392553
6403,0.001232,172.31.36.0-255,66,131432,7,392553
6404,0.001238,74.125.200.0-255,2902,134334,7,392553
6405,0.00124,172.31.36.0-255,66,134400,7,392553
6406,0.001267,74.125.200.0-255,5738,140138,7,392553
6407,0.00127,172.31.36.0-255,66,140204,7,392553
6408,0.001274,74.125.200.0-255,1484,141688,7,392553
6409,0.001291,74.125.200.0-255,2902,144590,7,392553
6410,0.001293,172.31.36.0-255,66,144656,7,392553
6411,0.001299,74.125.200.0-255,4320,148976,7,392553
6412,0.001301,172.31.36.0-255,66,149042,7,392553
6413,0.001318,74.125.200.0-255,1484,150526,7,392553
6414,0.001334,74.125.200.0-255,4320,154846,7,392553
6415,0.001337,172.31.36.0-255,66,154912,7,392553
6416,0.001354,74.125.200.0-255,7156,162068,7,392553
6417,0.001357,172.31.36.0-255,66,162134,7,392553
6418,0.001359,74.125.200.0-255,766,162900,7,392553
6419,0.001422,74.125.200.0-255,1484,164384,7,392553
6420,0.001426,172.31.36.0-255,66,164450,7,392553
6421,0.001432,74.125.200.0-255,4320,168770,7,392553
6422,0.001435,172.31.36.0-255,66,168836,7,392553
6423,0.001457,74.125.200.0-255,5738,174574,7,392553
6424,0.001461,172.31.36.0-255,66,174640,7,392553
6425,0.001485,74.125.200.0-255,5738,180378,7,392553
6426,0.001487,172.31.36.0-255,66,180444,7,392553
6427,0.001512,74.125.200.0-255,5738,186182,7,392553
6428,0.001515,172.31.36.0-255,66,186248,7,392553
6429,0.001521,74.125.200.0-255,4320,190568,7,392553
6430,0.001524,172.31.36.0-255,66,190634,7,392553
6431,0.001565,74.125.200.0-255,1484,192118,7,392553
6432,0.001579,74.125.200.0-255,5020,197138,7,392553
6433,0.001582,172.31.36.0-255,66,197204,7,392553
6434,0.002188,74.125.200.0-255,1484,198688,7,392553
6435,0.002196,74.125.200.0-255,2902,201590,7,392553
6436,0.002201,172.31.36.0-255,66,201656,7,392553
6437,0.002205,74.125.200.0-255,1484,203140,7,392553
6438,0.002226,74.125.200.0-255,4320,207460,7,392553
6439,0.002279,74.125.200.0-255,4320,211780,7,392553
6440,0.002319,74.125.200.0-255,2184,213964,7,392553
6441,0.002323,74.125.200.0-255,2902,216866,7,392553
6442,0.002353,74.125.200.0-255,2902,219768,7,392553
6443,0.004849,172.31.36.0-255,66,219834,7,392553
6444,0.007171,74.125.200.0-255,5738,225572,7,392553
6445,0.007179,172.31.36.0-255,66,225638,7,392553
6446,0.009507,74.125.200.0-255,5738,231376,7,392553
6447,0.009516,172.31.36.0-255,66,231442,7,392553
6448,0.011845,74.125.200.0-255,5738,237180,7,392553
6449,0.011853,172.31.36.0-255,66,237246,7,392553
6450,0.014169,74.125.200.0-255,5738,242984,7,392553
6451,0.014177,172.31.36.0-255,66,243050,7,392553
6452,0.016519,74.125.200.0-255,1484,244534,7,392553
6453,0.016544,74.125.200.0-255,4320,248854,7,392553
6454,0.01655,172.31.36.0-255,66,248920,7,392553
6455,0.018868,74.125.200.0-255,5738,254658,7,392553
6456,0.01888,172.31.36.0-255,66,254724,7,392553
6457,0.021219,74.125.200.0-255,5738,260462,7,392553
6458,0.021232,172.31.36.0-255,66,260528,7,392553
6459,0.023555,74.125.200.0-255,5738,266266,7,392553
6460,0.023563,172.31.36.0-255,66,266332,7,392553
6461,0.025894,74.125.200.0-255,5738,272070,7,392553
6462,0.025904,172.31.36.0-255,66,272136,7,392553
6463,0.028249,74.125.200.0-255,5738,277874,7,392553
6464,0.028259,172.31.36.0-255,66,277940,7,392553
6465,0.03057,74.125.200.0-255,5738,283678,7,392553
6466,0.030578,172.31.36.0-255,66,283744,7,392553
6467,0.031632,172.31.36.0-255,172,283916,7,392553
6468,0.031664,172.31.36.0-255,1115,285031,7,392553
6469,0.031741,172.31.36.0-255,1514,286545,7,392553
6470,0.031742,172.31.36.0-255,1291,287836,7,392553
6471,0.032896,74.125.200.0-255,5738,293574,7,392553
6472,0.032921,172.31.36.0-255,66,293640,7,392553
6473,0.033161,104.244.42.0-255,66,293706,7,392553
6474,0.033239,104.244.42.0-255,66,293772,7,392553
6475,0.03329,104.244.42.0-255,66,293838,7,392553
6476,0.035251,74.125.200.0-255,5738,299576,7,392553
6477,0.035258,172.31.36.0-255,66,299642,7,392553
6478,0.037583,74.125.200.0-255,5738,305380,7,392553
6479,0.03759,172.31.36.0-255,66,305446,7,392553
6480,0.039908,74.125.200.0-255,5738,311184,7,392553
6481,0.039916,172.31.36.0-255,66,311250,7,392553
6482,0.042235,74.125.200.0-255,5738,316988,7,392553
6483,0.042242,172.31.36.0-255,66,317054,7,392553
6484,0.044571,74.125.200.0-255,5738,322792,7,392553
6485,0.044577,172.31.36.0-255,66,322858,7,392553
6486,0.046896,74.125.200.0-255,5738,328596,7,392553
6487,0.046903,172.31.36.0-255,66,328662,7,392553
6488,0.049242,74.125.200.0-255,5738,334400,7,392553
6489,0.049249,172.31.36.0-255,66,334466,7,392553
6490,0.051565,74.125.200.0-255,5738,340204,7,392553
6491,0.051572,172.31.36.0-255,66,340270,7,392553
6492,0.053924,74.125.200.0-255,5738,346008,7,392553
6493,0.053934,172.31.36.0-255,66,346074,7,392553
6494,0.056308,74.125.200.0-255,5738,351812,7,392553
6495,0.056315,172.31.36.0-255,66,351878,7,392553
6496,0.058656,74.125.200.0-255,5738,357616,7,392553
6497,0.058663,172.31.36.0-255,66,357682,7,392553
6498,0.060985,74.125.200.0-255,5738,363420,7,392553
6499,0.060992,172.31.36.0-255,66,363486,7,392553
6500,0.06332,74.125.200.0-255,5738,369224,7,392553
6501,0.063327,172.31.36.0-255,66,369290,7,392553
6502,0.065649,74.125.200.0-255,5738,375028,7,392553
6503,0.065656,172.31.36.0-255,66,375094,7,392553
6504,0.067975,74.125.200.0-255,5738,380832,7,392553
6505,0.067982,172.31.36.0-255,66,380898,7,392553
6506,0.070299,74.125.200.0-255,5738,386636,7,392553
6507,0.070306,172.31.36.0-255,66,386702,7,392553
6508,0.072628,74.125.200.0-255,5614,392316,7,392553
6509,0.072635,172.31.36.0-255,66,392382,7,392553
6510,0.072821,172.31.36.0-255,105,392487,7,392553
6511,0.075111,74.125.200.0-255,66,392553,7,392553
6512,0.0,74.125.24.0-255,152,152,7,321394
6513,1.9e-05,172.31.36.0-255,66,218,7,321394
6514,2.6e-05,74.125.24.0-255,1484,1702,7,321394
6515,3e-05,172.31.36.0-255,66,1768,7,321394
6516,3.6e-05,74.125.24.0-255,2902,4670,7,321394
6517,3.9e-05,172.31.36.0-255,66,4736,7,321394
6518,4.7e-05,74.125.24.0-255,7156,11892,7,321394
6519,5.1e-05,172.31.36.0-255,66,11958,7,321394
6520,6.7e-05,74.125.24.0-255,1484,13442,7,321394
6521,6.9e-05,172.31.36.0-255,66,13508,7,321394
6522,8.7e-05,74.125.24.0-255,731,14239,7,321394
6523,9e-05,172.31.36.0-255,66,14305,7,321394
6524,0.000229,74.125.24.0-255,1484,15789,7,321394
6525,0.000232,172.31.36.0-255,66,15855,7,321394
6526,0.000238,74.125.24.0-255,2902,18757,7,321394
6527,0.000241,172.31.36.0-255,66,18823,7,321394
6528,0.000245,74.125.24.0-255,2902,21725,7,321394
6529,0.000248,172.31.36.0-255,66,21791,7,321394
6530,0.000271,74.125.24.0-255,2902,24693,7,321394
6531,0.000273,172.31.36.0-255,66,24759,7,321394
6532,0.000291,74.125.24.0-255,6797,31556,7,321394
6533,0.000295,172.31.36.0-255,66,31622,7,321394
6534,0.000339,74.125.24.0-255,2902,34524,7,321394
6535,0.000341,172.31.36.0-255,66,34590,7,321394
6536,0.000356,74.125.24.0-255,4320,38910,7,321394
6537,0.000358,172.31.36.0-255,66,38976,7,321394
6538,0.000373,74.125.24.0-255,1484,40460,7,321394
6539,0.000376,172.31.36.0-255,66,40526,7,321394
6540,0.000406,74.125.24.0-255,7156,47682,7,321394
6541,0.000408,172.31.36.0-255,66,47748,7,321394
6542,0.000425,74.125.24.0-255,1125,48873,7,321394
6543,0.000427,172.31.36.0-255,66,48939,7,321394
6544,0.001142,74.125.24.0-255,1484,50423,7,321394
6545,0.001149,74.125.24.0-255,2902,53325,7,321394
6546,0.001174,74.125.24.0-255,5738,59063,7,321394
6547,0.001186,74.125.24.0-255,1484,60547,7,321394
6548,0.001194,172.31.36.0-255,66,60613,7,321394
6549,0.001229,74.125.24.0-255,5960,66573,7,321394
6550,0.001407,172.31.36.0-255,66,66639,7,321394
6551,0.001474,74.125.24.0-255,1484,68123,7,321394
6552,0.001482,74.125.24.0-255,2902,71025,7,321394
6553,0.001485,74.125.24.0-255,1484,72509,7,321394
6554,0.001489,172.31.36.0-255,66,72575,7,321394
6555,0.0015,74.125.24.0-255,4320,76895,7,321394
6556,0.001503,74.125.24.0-255,1484,78379,7,321394
6557,0.001508,172.31.36.0-255,66,78445,7,321394
6558,0.001549,172.31.36.0-255,66,78511,7,321394
6559,0.00159,74.125.24.0-255,4320,82831,7,321394
6560,0.001603,172.31.36.0-255,66,82897,7,321394
6561,0.001614,74.125.24.0-255,5738,88635,7,321394
6562,0.001625,172.31.36.0-255,66,88701,7,321394
6563,0.001677,74.125.24.0-255,2902,91603,7,321394
6564,0.001714,172.31.36.0-255,66,91669,7,321394
6565,0.001789,74.125.24.0-255,1484,93153,7,321394
6566,0.001808,74.125.24.0-255,2902,96055,7,321394
6567,0.001814,74.125.24.0-255,4320,100375,7,321394
6568,0.001819,172.31.36.0-255,66,100441,7,321394
6569,0.001827,74.125.24.0-255,1484,101925,7,321394
6570,0.00187,172.31.36.0-255,66,101991,7,321394
6571,0.002167,74.125.24.0-255,1484,103475,7,321394
6572,0.002175,74.125.24.0-255,2902,106377,7,321394
6573,0.002181,74.125.24.0-255,5738,112115,7,321394
6574,0.002202,172.31.36.0-255,66,112181,7,321394
6575,0.002214,74.125.24.0-255,5738,117919,7,321394
6576,0.002224,172.31.36.0-255,66,117985,7,321394
6577,0.002231,74.125.24.0-255,7156,125141,7,321394
6578,0.002257,172.31.36.0-255,66,125207,7,321394
6579,0.002296,74.125.24.0-255,5738,130945,7,321394
6580,0.002319,172.31.36.0-255,66,131011,7,321394
6581,0.002338,74.125.24.0-255,5020,136031,7,321394
6582,0.002347,172.31.36.0-255,66,136097,7,321394
6583,0.004644,74.125.24.0-255,5738,141835,7,321394
6584,0.004651,172.31.36.0-255,66,141901,7,321394
6585,0.006917,74.125.24.0-255,5738,147639,7,321394
6586,0.008802,172.31.36.0-255,66,147705,7,321394
6587,0.011128,74.125.24.0-255,5738,153443,7,321394
6588,0.011137,172.31.36.0-255,66,153509,7,321394
6589,0.013406,74.125.24.0-255,5738,159247,7,321394
6590,0.015975,172.31.36.0-255,66,159313,7,321394
6591,0.018255,74.125.24.0-255,5738,165051,7,321394
6592,0.018265,172.31.36.0-255,66,165117,7,321394
6593,0.020529,74.125.24.0-255,5738,170855,7,321394
6594,0.020536,172.31.36.0-255,66,170921,7,321394
6595,0.022821,74.125.24.0-255,5738,176659,7,321394
6596,0.02283,172.31.36.0-255,66,176725,7,321394
6597,0.024719,172.31.36.0-255,172,176897,7,321394
6598,0.02475,172.31.36.0-255,1114,178011,7,321394
6599,0.024813,172.31.36.0-255,1514,179525,7,321394
6600,0.024815,172.31.36.0-255,332,179857,7,321394
6601,0.025104,74.125.24.0-255,5738,185595,7,321394
6602,0.02511,172.31.36.0-255,66,185661,7,321394
6603,0.026292,104.244.42.0-255,66,185727,7,321394
6604,0.0263,104.244.42.0-255,66,185793,7,321394
6605,0.026373,104.244.42.0-255,66,185859,7,321394
6606,0.027402,74.125.24.0-255,5738,191597,7,321394
6607,0.027408,172.31.36.0-255,66,191663,7,321394
6608,0.029697,74.125.24.0-255,5738,197401,7,321394
6609,0.029704,172.31.36.0-255,66,197467,7,321394
6610,0.031974,74.125.24.0-255,5738,203205,7,321394
6611,0.031982,172.31.36.0-255,66,203271,7,321394
6612,0.034257,74.125.24.0-255,5738,209009,7,321394
6613,0.034264,172.31.36.0-255,66,209075,7,321394
6614,0.036531,74.125.24.0-255,5738,214813,7,321394
6615,0.036537,172.31.36.0-255,66,214879,7,321394
6616,0.03767,172.31.36.0-255,105,214984,7,321394
6617,0.037828,172.31.36.0-255,90,215074,7,321394
6618,0.037837,172.31.36.0-255,66,215140,7,321394
6619,0.038822,74.125.24.0-255,5738,220878,7,321394
6620,0.038828,172.31.36.0-255,66,220944,7,321394
6621,0.040208,74.125.130.0-255,66,221010,7,321394
6622,0.040235,74.125.130.0-255,66,221076,7,321394
6623,0.040255,172.31.36.0-255,66,221142,7,321394
6624,0.041089,74.125.24.0-255,5738,226880,7,321394
6625,0.041096,172.31.36.0-255,66,226946,7,321394
6626,0.043395,74.125.24.0-255,5738,232684,7,321394
6627,0.043402,172.31.36.0-255,66,232750,7,321394
6628,0.045663,74.125.24.0-255,5738,238488,7,321394
6629,0.04567,172.31.36.0-255,66,238554,7,321394
6630,0.047965,74.125.24.0-255,5738,244292,7,321394
6631,0.047972,172.31.36.0-255,66,244358,7,321394
6632,0.050285,74.125.24.0-255,5738,250096,7,321394
6633,0.050592,172.31.36.0-255,66,250162,7,321394
6634,0.052876,74.125.24.0-255,2902,253064,7,321394
6635,0.052883,172.31.36.0-255,66,253130,7,321394
6636,0.052901,74.125.24.0-255,2902,256032,7,321394
6637,0.053374,172.31.36.0-255,66,256098,7,321394
6638,0.055154,74.125.24.0-255,2902,259000,7,321394
6639,0.055161,172.31.36.0-255,66,259066,7,321394
6640,0.055645,74.125.24.0-255,2902,261968,7,321394
6641,0.055652,172.31.36.0-255,66,262034,7,321394
6642,0.057446,74.125.24.0-255,2902,264936,7,321394
6643,0.057453,172.31.36.0-255,66,265002,7,321394
6644,0.057924,74.125.24.0-255,2902,267904,7,321394
6645,0.05793,172.31.36.0-255,66,267970,7,321394
6646,0.059718,74.125.24.0-255,2902,270872,7,321394
6647,0.059724,172.31.36.0-255,66,270938,7,321394
6648,0.060193,74.125.24.0-255,2902,273840,7,321394
6649,0.0602,172.31.36.0-255,66,273906,7,321394
6650,0.061973,74.125.24.0-255,2902,276808,7,321394
6651,0.061979,172.31.36.0-255,66,276874,7,321394
6652,0.062488,74.125.24.0-255,2902,279776,7,321394
6653,0.062494,172.31.36.0-255,66,279842,7,321394
6654,0.064241,74.125.24.0-255,2902,282744,7,321394
6655,0.064248,172.31.36.0-255,66,282810,7,321394
6656,0.064779,74.125.24.0-255,2902,285712,7,321394
6657,0.064786,172.31.36.0-255,66,285778,7,321394
6658,0.066527,74.125.24.0-255,2902,288680,7,321394
6659,0.066533,172.31.36.0-255,66,288746,7,321394
6660,0.067075,74.125.24.0-255,2902,291648,7,321394
6661,0.067082,172.31.36.0-255,66,291714,7,321394
6662,0.068807,74.125.24.0-255,2902,294616,7,321394
6663,0.068813,172.31.36.0-255,66,294682,7,321394
6664,0.069347,74.125.24.0-255,2902,297584,7,321394
6665,0.069354,172.31.36.0-255,66,297650,7,321394
6666,0.071081,74.125.24.0-255,2902,300552,7,321394
6667,0.071087,172.31.36.0-255,66,300618,7,321394
6668,0.071629,74.125.24.0-255,2902,303520,7,321394
6669,0.071635,172.31.36.0-255,66,303586,7,321394
6670,0.073359,74.125.24.0-255,2902,306488,7,321394
6671,0.073366,172.31.36.0-255,66,306554,7,321394
6672,0.073898,74.125.24.0-255,2902,309456,7,321394
6673,0.073905,172.31.36.0-255,66,309522,7,321394
6674,0.075658,74.125.24.0-255,2902,312424,7,321394
6675,0.075664,172.31.36.0-255,66,312490,7,321394
6676,0.076149,74.125.24.0-255,2902,315392,7,321394
6677,0.076156,172.31.36.0-255,66,315458,7,321394
6678,0.077941,74.125.24.0-255,2902,318360,7,321394
6679,0.077948,172.31.36.0-255,66,318426,7,321394
6680,0.078416,74.125.24.0-255,2902,321328,7,321394
6681,0.078423,172.31.36.0-255,66,321394,7,321394
6682,0.0,172.31.36.0-255,66,66,7,183875
6683,0.010745,74.125.24.0-255,146,212,7,183875
6684,0.010771,172.31.36.0-255,66,278,7,183875
6685,0.010776,74.125.24.0-255,1484,1762,7,183875
6686,0.010781,172.31.36.0-255,66,1828,7,183875
6687,0.010802,74.125.24.0-255,2902,4730,7,183875
6688,0.010805,172.31.36.0-255,66,4796,7,183875
6689,0.010834,74.125.24.0-255,7156,11952,7,183875
6690,0.010837,172.31.36.0-255,66,12018,7,183875
6691,0.010882,74.125.24.0-255,2902,14920,7,183875
6692,0.010885,172.31.36.0-255,66,14986,7,183875
6693,0.010903,74.125.24.0-255,1993,16979,7,183875
6694,0.010906,172.31.36.0-255,66,17045,7,183875
6695,0.010972,74.125.24.0-255,5738,22783,7,183875
6696,0.010976,172.31.36.0-255,66,22849,7,183875
6697,0.011014,74.125.24.0-255,2902,25751,7,183875
6698,0.011017,172.31.36.0-255,66,25817,7,183875
6699,0.011048,172.31.36.0-255,66,25883,7,183875
6700,0.01115,74.125.24.0-255,4320,30203,7,183875
6701,0.011155,172.31.36.0-255,66,30269,7,183875
6702,0.011167,74.125.24.0-255,1484,31753,7,183875
6703,0.011171,172.31.36.0-255,66,31819,7,183875
6704,0.011218,74.125.24.0-255,6438,38257,7,183875
6705,0.011222,172.31.36.0-255,66,38323,7,183875
6706,0.011277,74.125.24.0-255,2902,41225,7,183875
6707,0.01128,172.31.36.0-255,66,41291,7,183875
6708,0.011308,172.31.36.0-255,66,41357,7,183875
6709,0.011428,74.125.24.0-255,2902,44259,7,183875
6710,0.011432,172.31.36.0-255,66,44325,7,183875
6711,0.011449,74.125.24.0-255,1449,45774,7,183875
6712,0.011451,172.31.36.0-255,66,45840,7,183875
6713,0.011623,74.125.24.0-255,1484,47324,7,183875
6714,0.011634,74.125.24.0-255,2902,50226,7,183875
6715,0.011637,172.31.36.0-255,66,50292,7,183875
6716,0.011643,74.125.24.0-255,2902,53194,7,183875
6717,0.011644,172.31.36.0-255,66,53260,7,183875
6718,0.011661,74.125.24.0-255,2902,56162,7,183875
6719,0.011664,172.31.36.0-255,66,56228,7,183875
6720,0.011715,74.125.24.0-255,7156,63384,7,183875
6721,0.01172,172.31.36.0-255,66,63450,7,183875
6722,0.011739,74.125.24.0-255,2543,65993,7,183875
6723,0.011742,172.31.36.0-255,66,66059,7,183875
6724,0.01182,74.125.24.0-255,5738,71797,7,183875
6725,0.011826,172.31.36.0-255,66,71863,7,183875
6726,0.01185,74.125.24.0-255,4320,76183,7,183875
6727,0.011853,172.31.36.0-255,66,76249,7,183875
6728,0.011941,172.31.36.0-255,66,76315,7,183875
6729,0.011987,172.31.36.0-255,66,76381,7,183875
6730,0.012176,172.31.36.0-255,66,76447,7,183875
6731,0.012209,172.31.36.0-255,66,76513,7,183875
6732,0.012456,172.31.36.0-255,66,76579,7,183875
6733,0.012492,172.31.36.0-255,66,76645,7,183875
6734,0.012732,172.31.36.0-255,66,76711,7,183875
6735,0.012763,172.31.36.0-255,66,76777,7,183875
6736,0.013027,74.125.24.0-255,5738,82515,7,183875
6737,0.013031,172.31.36.0-255,66,82581,7,183875
6738,0.01305,74.125.24.0-255,2184,84765,7,183875
6739,0.013054,172.31.36.0-255,66,84831,7,183875
6740,0.013094,74.125.24.0-255,5738,90569,7,183875
6741,0.013098,172.31.36.0-255,66,90635,7,183875
6742,0.013129,172.31.36.0-255,66,90701,7,183875
6743,0.01316,172.31.36.0-255,66,90767,7,183875
6744,0.013456,74.125.24.0-255,5738,96505,7,183875
6745,0.01346,172.31.36.0-255,66,96571,7,183875
6746,0.013483,172.31.36.0-255,66,96637,7,183875
6747,0.013532,172.31.36.0-255,66,96703,7,183875
6748,0.01383,74.125.24.0-255,7156,103859,7,183875
6749,0.013835,172.31.36.0-255,66,103925,7,183875
6750,0.013874,172.31.36.0-255,66,103991,7,183875
6751,0.014163,74.125.24.0-255,5738,109729,7,183875
6752,0.014168,172.31.36.0-255,66,109795,7,183875
6753,0.01421,172.31.36.0-255,66,109861,7,183875
6754,0.014243,172.31.36.0-255,66,109927,7,183875
6755,0.014257,74.125.24.0-255,5738,115665,7,183875
6756,0.014259,172.31.36.0-255,66,115731,7,183875
6757,0.014278,74.125.24.0-255,7138,122869,7,183875
6758,0.01428,172.31.36.0-255,66,122935,7,183875
6759,0.016865,74.125.24.0-255,5738,128673,7,183875
6760,0.01687,172.31.36.0-255,66,128739,7,183875
6761,0.019477,74.125.24.0-255,5738,134477,7,183875
6762,0.019485,172.31.36.0-255,66,134543,7,183875
6763,0.022074,74.125.24.0-255,5738,140281,7,183875
6764,0.022081,172.31.36.0-255,66,140347,7,183875
6765,0.024708,74.125.24.0-255,5738,146085,7,183875
6766,0.024722,172.31.36.0-255,66,146151,7,183875
6767,0.027335,74.125.24.0-255,5738,151889,7,183875
6768,0.027345,172.31.36.0-255,66,151955,7,183875
6769,0.029937,74.125.24.0-255,5738,157693,7,183875
6770,0.029944,172.31.36.0-255,66,157759,7,183875
6771,0.032537,74.125.24.0-255,5738,163497,7,183875
6772,0.032544,172.31.36.0-255,66,163563,7,183875
6773,0.035153,74.125.24.0-255,5738,169301,7,183875
6774,0.03516,172.31.36.0-255,66,169367,7,183875
6775,0.037775,74.125.24.0-255,5738,175105,7,183875
6776,0.037784,172.31.36.0-255,66,175171,7,183875
6777,0.040405,74.125.24.0-255,3987,179158,7,183875
6778,0.040413,172.31.36.0-255,66,179224,7,183875
6779,0.040816,172.31.36.0-255,188,179412,7,183875
6780,0.040854,172.31.36.0-255,958,180370,7,183875
6781,0.040926,172.31.36.0-255,1514,181884,7,183875
6782,0.040928,172.31.36.0-255,1448,183332,7,183875
6783,0.041039,172.31.36.0-255,105,183437,7,183875
6784,0.042403,104.244.42.0-255,66,183503,7,183875
6785,0.042411,104.244.42.0-255,66,183569,7,183875
6786,0.042493,104.244.42.0-255,66,183635,7,183875
6787,0.043592,74.125.24.0-255,66,183701,7,183875
6788,0.043743,104.244.42.0-255,108,183809,7,183875
6789,0.043747,172.31.36.0-255,66,183875,7,183875
6790,0.0,172.217.194.0-255,146,146,7,215100
6791,2.4e-05,172.31.36.0-255,66,212,7,215100
6792,3.1e-05,172.217.194.0-255,1484,1696,7,215100
6793,3.5e-05,172.31.36.0-255,66,1762,7,215100
6794,4.1e-05,172.217.194.0-255,2902,4664,7,215100
6795,5.3e-05,172.31.36.0-255,66,4730,7,215100
6796,6e-05,172.217.194.0-255,5738,10468,7,215100
6797,6.4e-05,172.31.36.0-255,66,10534,7,215100
6798,6.7e-05,172.217.194.0-255,1484,12018,7,215100
6799,7e-05,172.31.36.0-255,66,12084,7,215100
6800,0.000121,172.31.36.0-255,66,12150,7,215100
6801,0.000129,172.217.194.0-255,6797,18947,7,215100
6802,0.000131,172.31.36.0-255,66,19013,7,215100
6803,0.00014,172.217.194.0-255,1484,20497,7,215100
6804,0.000143,172.31.36.0-255,66,20563,7,215100
6805,0.000148,172.217.194.0-255,2902,23465,7,215100
6806,0.00015,172.31.36.0-255,66,23531,7,215100
6807,0.000155,172.217.194.0-255,2902,26433,7,215100
6808,0.000157,172.31.36.0-255,66,26499,7,215100
6809,0.00019,172.217.194.0-255,2902,29401,7,215100
6810,0.000192,172.31.36.0-255,66,29467,7,215100
6811,0.000199,172.217.194.0-255,5738,35205,7,215100
6812,0.000202,172.31.36.0-255,66,35271,7,215100
6813,0.000241,172.31.36.0-255,66,35337,7,215100
6814,0.000253,172.31.36.0-255,66,35403,7,215100
6815,0.000278,172.217.194.0-255,430,35833,7,215100
6816,0.000284,172.31.36.0-255,66,35899,7,215100
6817,0.000395,172.217.194.0-255,1484,37383,7,215100
6818,0.000399,172.31.36.0-255,66,37449,7,215100
6819,0.000405,172.217.194.0-255,2902,40351,7,215100
6820,0.000408,172.31.36.0-255,66,40417,7,215100
6821,0.000442,172.217.194.0-255,5738,46155,7,215100
6822,0.000445,172.31.36.0-255,66,46221,7,215100
6823,0.000453,172.217.194.0-255,6247,52468,7,215100
6824,0.000566,172.31.36.0-255,66,52534,7,215100
6825,0.001003,172.217.194.0-255,1484,54018,7,215100
6826,0.00101,172.217.194.0-255,2902,56920,7,215100
6827,0.001013,172.31.36.0-255,66,56986,7,215100
6828,0.001018,172.217.194.0-255,1484,58470,7,215100
6829,0.001046,172.217.194.0-255,4320,62790,7,215100
6830,0.001052,172.217.194.0-255,4320,67110,7,215100
6831,0.001064,172.31.36.0-255,66,67176,7,215100
6832,0.001074,172.217.194.0-255,2902,70078,7,215100
6833,0.001093,172.31.36.0-255,66,70144,7,215100
6834,0.001104,172.217.194.0-255,4320,74464,7,215100
6835,0.001122,172.217.194.0-255,3602,78066,7,215100
6836,0.001134,172.31.36.0-255,66,78132,7,215100
6837,0.001409,172.217.194.0-255,1484,79616,7,215100
6838,0.001425,172.217.194.0-255,2902,82518,7,215100
6839,0.001429,172.31.36.0-255,66,82584,7,215100
6840,0.001436,172.217.194.0-255,4320,86904,7,215100
6841,0.001441,172.31.36.0-255,66,86970,7,215100
6842,0.00147,172.217.194.0-255,1484,88454,7,215100
6843,0.001499,172.31.36.0-255,66,88520,7,215100
6844,0.001508,172.217.194.0-255,2902,91422,7,215100
6845,0.001546,172.31.36.0-255,66,91488,7,215100
6846,0.001602,172.217.194.0-255,1484,92972,7,215100
6847,0.001607,172.217.194.0-255,2902,95874,7,215100
6848,0.00161,172.31.36.0-255,66,95940,7,215100
6849,0.001633,172.217.194.0-255,5738,101678,7,215100
6850,0.001645,172.31.36.0-255,66,101744,7,215100
6851,0.001726,172.217.194.0-255,2184,103928,7,215100
6852,0.00175,172.217.194.0-255,2902,106830,7,215100
6853,0.001753,172.217.194.0-255,1484,108314,7,215100
6854,0.001757,172.31.36.0-255,66,108380,7,215100
6855,0.001777,172.217.194.0-255,5738,114118,7,215100
6856,0.001792,172.31.36.0-255,66,114184,7,215100
6857,0.001871,172.31.36.0-255,66,114250,7,215100
6858,0.001899,172.217.194.0-255,1484,115734,7,215100
6859,0.001905,172.217.194.0-255,2902,118636,7,215100
6860,0.00191,172.31.36.0-255,66,118702,7,215100
6861,0.001941,172.217.194.0-255,5738,124440,7,215100
6862,0.001961,172.31.36.0-255,66,124506,7,215100
6863,0.001967,172.217.194.0-255,4320,128826,7,215100
6864,0.002012,172.31.36.0-255,66,128892,7,215100
6865,0.002086,172.217.194.0-255,1484,130376,7,215100
6866,0.002096,172.217.194.0-255,2902,133278,7,215100
6867,0.002101,172.217.194.0-255,4320,137598,7,215100
6868,0.002116,172.217.194.0-255,1484,139082,7,215100
6869,0.002122,172.217.194.0-255,5738,144820,7,215100
6870,0.002145,172.217.194.0-255,7156,151976,7,215100
6871,0.002162,172.217.194.0-255,5738,157714,7,215100
6872,0.002166,172.217.194.0-255,2902,160616,7,215100
6873,0.002178,172.217.194.0-255,2184,162800,7,215100
6874,0.002221,172.217.194.0-255,2902,165702,7,215100
6875,0.002244,172.217.194.0-255,4320,170022,7,215100
6876,0.002252,172.217.194.0-255,7156,177178,7,215100
6877,0.002265,172.217.194.0-255,1484,178662,7,215100
6878,0.002268,172.217.194.0-255,1484,180146,7,215100
6879,0.002324,172.217.194.0-255,3602,183748,7,215100
6880,0.002346,172.217.194.0-255,4320,188068,7,215100
6881,0.002377,172.217.194.0-255,4320,192388,7,215100
6882,0.002391,172.217.194.0-255,2902,195290,7,215100
6883,0.002423,172.217.194.0-255,4320,199610,7,215100
6884,0.002558,172.217.194.0-255,4320,203930,7,215100
6885,0.002591,172.217.194.0-255,2902,206832,7,215100
6886,0.002603,172.217.194.0-255,3634,210466,7,215100
6887,0.002629,172.217.194.0-255,105,210571,7,215100
6888,0.00897,172.31.36.0-255,66,210637,7,215100
6889,0.011348,172.31.36.0-255,105,210742,7,215100
6890,0.013963,172.217.194.0-255,66,210808,7,215100
6891,0.031473,172.31.36.0-255,172,210980,7,215100
6892,0.031507,172.31.36.0-255,1112,212092,7,215100
6893,0.03157,172.31.36.0-255,1514,213606,7,215100
6894,0.031572,172.31.36.0-255,1296,214902,7,215100
6895,0.033023,104.244.42.0-255,66,214968,7,215100
6896,0.033062,104.244.42.0-255,66,215034,7,215100
6897,0.03309,104.244.42.0-255,66,215100,7,215100
6898,0.0,74.125.24.0-255,297,297,7,261925
6899,1.8e-05,172.31.36.0-255,66,363,7,261925
6900,2.5e-05,74.125.24.0-255,1484,1847,7,261925
6901,2.8e-05,172.31.36.0-255,66,1913,7,261925
6902,3.4e-05,74.125.24.0-255,4320,6233,7,261925
6903,4.4e-05,172.31.36.0-255,66,6299,7,261925
6904,5e-05,74.125.24.0-255,4320,10619,7,261925
6905,5.3e-05,172.31.36.0-255,66,10685,7,261925
6906,7.1e-05,74.125.24.0-255,3254,13939,7,261925
6907,7.7e-05,172.31.36.0-255,66,14005,7,261925
6908,0.000166,74.125.24.0-255,1484,15489,7,261925
6909,0.00017,172.31.36.0-255,66,15555,7,261925
6910,0.000176,74.125.24.0-255,2902,18457,7,261925
6911,0.000179,172.31.36.0-255,66,18523,7,261925
6912,0.000209,74.125.24.0-255,5738,24261,7,261925
6913,0.000212,172.31.36.0-255,66,24327,7,261925
6914,0.000217,74.125.24.0-255,4320,28647,7,261925
6915,0.00022,172.31.36.0-255,66,28713,7,261925
6916,0.000248,74.125.24.0-255,2543,31256,7,261925
6917,0.000251,172.31.36.0-255,66,31322,7,261925
6918,0.000561,74.125.24.0-255,1484,32806,7,261925
6919,0.000567,172.31.36.0-255,66,32872,7,261925
6920,0.000572,74.125.24.0-255,2902,35774,7,261925
6921,0.000575,172.31.36.0-255,66,35840,7,261925
6922,0.000605,74.125.24.0-255,5738,41578,7,261925
6923,0.000608,172.31.36.0-255,66,41644,7,261925
6924,0.000614,74.125.24.0-255,5738,47382,7,261925
6925,0.000616,172.31.36.0-255,66,47448,7,261925
6926,0.000644,74.125.24.0-255,6797,54245,7,261925
6927,0.000647,172.31.36.0-255,66,54311,7,261925
6928,0.00065,74.125.24.0-255,1484,55795,7,261925
6929,0.000652,172.31.36.0-255,66,55861,7,261925
6930,0.000695,74.125.24.0-255,1125,56986,7,261925
6931,0.000719,172.31.36.0-255,66,57052,7,261925
6932,0.000746,74.125.24.0-255,363,57415,7,261925
6933,0.001096,172.31.36.0-255,66,57481,7,261925
6934,0.001592,74.125.24.0-255,381,57862,7,261925
6935,0.001793,74.125.24.0-255,1484,59346,7,261925
6936,0.001799,172.31.36.0-255,66,59412,7,261925
6937,0.001806,74.125.24.0-255,2902,62314,7,261925
6938,0.001808,172.31.36.0-255,66,62380,7,261925
6939,0.001835,74.125.24.0-255,5738,68118,7,261925
6940,0.001838,172.31.36.0-255,66,68184,7,261925
6941,0.001877,74.125.24.0-255,6797,74981,7,261925
6942,0.001921,74.125.24.0-255,7156,82137,7,261925
6943,0.00197,74.125.24.0-255,1125,83262,7,261925
6944,0.007115,172.31.36.0-255,66,83328,7,261925
6945,0.009479,74.125.24.0-255,5738,89066,7,261925
6946,0.009488,172.31.36.0-255,66,89132,7,261925
6947,0.01186,74.125.24.0-255,5738,94870,7,261925
6948,0.01187,172.31.36.0-255,66,94936,7,261925
6949,0.014232,74.125.24.0-255,5738,100674,7,261925
6950,0.014239,172.31.36.0-255,66,100740,7,261925
6951,0.016572,74.125.24.0-255,5738,106478,7,261925
6952,0.016583,172.31.36.0-255,66,106544,7,261925
6953,0.018947,74.125.24.0-255,5738,112282,7,261925
6954,0.018956,172.31.36.0-255,66,112348,7,261925
6955,0.021313,74.125.24.0-255,5738,118086,7,261925
6956,0.021321,172.31.36.0-255,66,118152,7,261925
6957,0.023644,74.125.24.0-255,5738,123890,7,261925
6958,0.023652,172.31.36.0-255,66,123956,7,261925
6959,0.026005,74.125.24.0-255,5738,129694,7,261925
6960,0.026011,172.31.36.0-255,66,129760,7,261925
6961,0.026861,172.31.36.0-255,192,129952,7,261925
6962,0.026911,172.31.36.0-255,958,130910,7,261925
6963,0.026971,172.31.36.0-255,1514,132424,7,261925
6964,0.026973,172.31.36.0-255,1448,133872,7,261925
6965,0.028375,74.125.24.0-255,5738,139610,7,261925
6966,0.028383,172.31.36.0-255,66,139676,7,261925
6967,0.028547,104.244.42.0-255,66,139742,7,261925
6968,0.028563,172.31.36.0-255,101,139843,7,261925
6969,0.028652,104.244.42.0-255,66,139909,7,261925
6970,0.028799,104.244.42.0-255,66,139975,7,261925
6971,0.030757,74.125.24.0-255,5738,145713,7,261925
6972,0.030763,172.31.36.0-255,66,145779,7,261925
6973,0.030911,74.125.24.0-255,66,145845,7,261925
6974,0.03314,74.125.24.0-255,5738,151583,7,261925
6975,0.033145,172.31.36.0-255,66,151649,7,261925
6976,0.035509,74.125.24.0-255,5738,157387,7,261925
6977,0.035515,172.31.36.0-255,66,157453,7,261925
6978,0.037839,74.125.24.0-255,5738,163191,7,261925
6979,0.037845,172.31.36.0-255,66,163257,7,261925
6980,0.0402,74.125.24.0-255,5738,168995,7,261925
6981,0.04021,172.31.36.0-255,66,169061,7,261925
6982,0.04258,74.125.24.0-255,5738,174799,7,261925
6983,0.042586,172.31.36.0-255,66,174865,7,261925
6984,0.044961,74.125.24.0-255,5738,180603,7,261925
6985,0.044968,172.31.36.0-255,66,180669,7,261925
6986,0.047317,74.125.24.0-255,5738,186407,7,261925
6987,0.047324,172.31.36.0-255,66,186473,7,261925
6988,0.049674,74.125.24.0-255,5738,192211,7,261925
6989,0.04968,172.31.36.0-255,66,192277,7,261925
6990,0.052013,74.125.24.0-255,5738,198015,7,261925
6991,0.052019,172.31.36.0-255,66,198081,7,261925
6992,0.054386,74.125.24.0-255,5738,203819,7,261925
6993,0.054393,172.31.36.0-255,66,203885,7,261925
6994,0.056779,74.125.24.0-255,5738,209623,7,261925
6995,0.056785,172.31.36.0-255,66,209689,7,261925
6996,0.059119,74.125.24.0-255,5738,215427,7,261925
6997,0.059125,172.31.36.0-255,66,215493,7,261925
6998,0.061489,74.125.24.0-255,5738,221231,7,261925
6999,0.061495,172.31.36.0-255,66,221297,7,261925
7000,0.063875,74.125.24.0-255,5738,227035,7,261925
7001,0.063882,172.31.36.0-255,66,227101,7,261925
7002,0.066259,74.125.24.0-255,5738,232839,7,261925
7003,0.066266,172.31.36.0-255,66,232905,7,261925
7004,0.068635,74.125.24.0-255,5738,238643,7,261925
7005,0.068642,172.31.36.0-255,66,238709,7,261925
7006,0.071017,74.125.24.0-255,5738,244447,7,261925
7007,0.071023,172.31.36.0-255,66,244513,7,261925
7008,0.07336,74.125.24.0-255,5738,250251,7,261925
7009,0.073371,172.31.36.0-255,66,250317,7,261925
7010,0.075728,74.125.24.0-255,5738,256055,7,261925
7011,0.075738,172.31.36.0-255,66,256121,7,261925
7012,0.078062,74.125.24.0-255,5738,261859,7,261925
7013,0.078069,172.31.36.0-255,66,261925,7,261925
7014,0.0,74.125.24.0-255,144,144,7,287948
7015,2.8e-05,172.31.36.0-255,66,210,7,287948
7016,3.6e-05,74.125.24.0-255,1484,1694,7,287948
7017,4.1e-05,172.31.36.0-255,66,1760,7,287948
7018,5.6e-05,74.125.24.0-255,2902,4662,7,287948
7019,6e-05,172.31.36.0-255,66,4728,7,287948
7020,6.8e-05,74.125.24.0-255,7156,11884,7,287948
7021,7.2e-05,172.31.36.0-255,66,11950,7,287948
7022,7.8e-05,74.125.24.0-255,2014,13964,7,287948
7023,8.1e-05,172.31.36.0-255,66,14030,7,287948
7024,0.000258,74.125.24.0-255,1484,15514,7,287948
7025,0.000263,172.31.36.0-255,66,15580,7,287948
7026,0.00027,74.125.24.0-255,2902,18482,7,287948
7027,0.000272,172.31.36.0-255,66,18548,7,287948
7028,0.000285,74.125.24.0-255,5738,24286,7,287948
7029,0.000287,172.31.36.0-255,66,24352,7,287948
7030,0.000338,74.125.24.0-255,6797,31149,7,287948
7031,0.000341,172.31.36.0-255,66,31215,7,287948
7032,0.000348,74.125.24.0-255,5738,36953,7,287948
7033,0.000351,172.31.36.0-255,66,37019,7,287948
7034,0.000372,74.125.24.0-255,1484,38503,7,287948
7035,0.000374,172.31.36.0-255,66,38569,7,287948
7036,0.000387,74.125.24.0-255,5738,44307,7,287948
7037,0.00039,172.31.36.0-255,66,44373,7,287948
7038,0.000413,74.125.24.0-255,3961,48334,7,287948
7039,0.00042,172.31.36.0-255,66,48400,7,287948
7040,0.000883,74.125.24.0-255,1484,49884,7,287948
7041,0.000888,172.31.36.0-255,66,49950,7,287948
7042,0.000894,74.125.24.0-255,2902,52852,7,287948
7043,0.000896,172.31.36.0-255,66,52918,7,287948
7044,0.000902,74.125.24.0-255,2902,55820,7,287948
7045,0.000909,172.31.36.0-255,66,55886,7,287948
7046,0.000916,74.125.24.0-255,7156,63042,7,287948
7047,0.000918,172.31.36.0-255,66,63108,7,287948
7048,0.000981,172.31.36.0-255,66,63174,7,287948
7049,0.000986,74.125.24.0-255,2543,65717,7,287948
7050,0.000988,172.31.36.0-255,66,65783,7,287948
7051,0.001029,172.31.36.0-255,66,65849,7,287948
7052,0.001061,74.125.24.0-255,5960,71809,7,287948
7053,0.001064,172.31.36.0-255,66,71875,7,287948
7054,0.0015,74.125.24.0-255,1484,73359,7,287948
7055,0.001508,74.125.24.0-255,2902,76261,7,287948
7056,0.001512,172.31.36.0-255,66,76327,7,287948
7057,0.001543,74.125.24.0-255,5738,82065,7,287948
7058,0.001546,172.31.36.0-255,66,82131,7,287948
7059,0.001565,172.31.36.0-255,66,82197,7,287948
7060,0.001578,172.31.36.0-255,66,82263,7,287948
7061,0.00158,74.125.24.0-255,766,83029,7,287948
7062,0.001839,172.31.36.0-255,66,83095,7,287948
7063,0.00201,74.125.24.0-255,1484,84579,7,287948
7064,0.002019,74.125.24.0-255,2902,87481,7,287948
7065,0.002023,172.31.36.0-255,66,87547,7,287948
7066,0.002031,74.125.24.0-255,5738,93285,7,287948
7067,0.002033,172.31.36.0-255,66,93351,7,287948
7068,0.00208,172.31.36.0-255,66,93417,7,287948
7069,0.002097,172.31.36.0-255,66,93483,7,287948
7070,0.004396,74.125.24.0-255,5738,99221,7,287948
7071,0.004404,172.31.36.0-255,66,99287,7,287948
7072,0.006705,74.125.24.0-255,4320,103607,7,287948
7073,0.006708,172.31.36.0-255,66,103673,7,287948
7074,0.006734,74.125.24.0-255,1484,105157,7,287948
7075,0.009016,74.125.24.0-255,4320,109477,7,287948
7076,0.009024,172.31.36.0-255,66,109543,7,287948
7077,0.011339,74.125.24.0-255,5738,115281,7,287948
7078,0.011347,172.31.36.0-255,66,115347,7,287948
7079,0.013658,74.125.24.0-255,5738,121085,7,287948
7080,0.013668,172.31.36.0-255,66,121151,7,287948
7081,0.015966,74.125.24.0-255,5738,126889,7,287948
7082,0.015976,172.31.36.0-255,66,126955,7,287948
7083,0.018299,74.125.24.0-255,5738,132693,7,287948
7084,0.018313,172.31.36.0-255,66,132759,7,287948
7085,0.020656,74.125.24.0-255,5738,138497,7,287948
7086,0.020668,172.31.36.0-255,66,138563,7,287948
7087,0.022983,74.125.24.0-255,5738,144301,7,287948
7088,0.022991,172.31.36.0-255,66,144367,7,287948
7089,0.025307,74.125.24.0-255,5738,150105,7,287948
7090,0.025316,172.31.36.0-255,66,150171,7,287948
7091,0.027644,74.125.24.0-255,5738,155909,7,287948
7092,0.027653,172.31.36.0-255,66,155975,7,287948
7093,0.029951,74.125.24.0-255,5738,161713,7,287948
7094,0.029959,172.31.36.0-255,66,161779,7,287948
7095,0.030927,172.31.36.0-255,167,161946,7,287948
7096,0.030958,172.31.36.0-255,1116,163062,7,287948
7097,0.031017,172.31.36.0-255,1514,164576,7,287948
7098,0.031018,172.31.36.0-255,1290,165866,7,287948
7099,0.032271,74.125.24.0-255,5738,171604,7,287948
7100,0.032279,172.31.36.0-255,66,171670,7,287948
7101,0.032458,104.244.42.0-255,66,171736,7,287948
7102,0.032632,104.244.42.0-255,66,171802,7,287948
7103,0.032661,104.244.42.0-255,66,171868,7,287948
7104,0.034572,74.125.24.0-255,5738,177606,7,287948
7105,0.034577,172.31.36.0-255,66,177672,7,287948
7106,0.036898,74.125.24.0-255,5738,183410,7,287948
7107,0.036908,172.31.36.0-255,66,183476,7,287948
7108,0.03923,74.125.24.0-255,5738,189214,7,287948
7109,0.039239,172.31.36.0-255,66,189280,7,287948
7110,0.041564,74.125.24.0-255,5738,195018,7,287948
7111,0.041576,172.31.36.0-255,66,195084,7,287948
7112,0.043897,74.125.24.0-255,5738,200822,7,287948
7113,0.043908,172.31.36.0-255,66,200888,7,287948
7114,0.046203,74.125.24.0-255,5738,206626,7,287948
7115,0.04621,172.31.36.0-255,66,206692,7,287948
7116,0.048506,74.125.24.0-255,5738,212430,7,287948
7117,0.048513,172.31.36.0-255,66,212496,7,287948
7118,0.050817,74.125.24.0-255,5738,218234,7,287948
7119,0.050825,172.31.36.0-255,66,218300,7,287948
7120,0.053122,74.125.24.0-255,5738,224038,7,287948
7121,0.05313,172.31.36.0-255,66,224104,7,287948
7122,0.055417,74.125.24.0-255,5738,229842,7,287948
7123,0.055424,172.31.36.0-255,66,229908,7,287948
7124,0.057746,74.125.24.0-255,5738,235646,7,287948
7125,0.057759,172.31.36.0-255,66,235712,7,287948
7126,0.060067,74.125.24.0-255,5738,241450,7,287948
7127,0.060074,172.31.36.0-255,66,241516,7,287948
7128,0.062377,74.125.24.0-255,5738,247254,7,287948
7129,0.062384,172.31.36.0-255,66,247320,7,287948
7130,0.064679,74.125.24.0-255,5738,253058,7,287948
7131,0.064686,172.31.36.0-255,66,253124,7,287948
7132,0.066995,74.125.24.0-255,5738,258862,7,287948
7133,0.067002,172.31.36.0-255,66,258928,7,287948
7134,0.069325,74.125.24.0-255,5738,264666,7,287948
7135,0.069334,172.31.36.0-255,66,264732,7,287948
7136,0.071605,74.125.24.0-255,5738,270470,7,287948
7137,0.071612,172.31.36.0-255,66,270536,7,287948
7138,0.073913,74.125.24.0-255,5738,276274,7,287948
7139,0.073923,172.31.36.0-255,66,276340,7,287948
7140,0.076232,74.125.24.0-255,5738,282078,7,287948
7141,0.07624,172.31.36.0-255,66,282144,7,287948
7142,0.078548,74.125.24.0-255,5738,287882,7,287948
7143,0.078555,172.31.36.0-255,66,287948,7,287948
7144,0.0,74.125.24.0-255,297,297,7,297936
7145,2.9e-05,172.31.36.0-255,66,363,7,297936
7146,3.7e-05,74.125.24.0-255,1484,1847,7,297936
7147,4.1e-05,172.31.36.0-255,66,1913,7,297936
7148,4.6e-05,74.125.24.0-255,4320,6233,7,297936
7149,4.9e-05,172.31.36.0-255,66,6299,7,297936
7150,6.8e-05,172.31.36.0-255,66,6365,7,297936
7151,7.5e-05,74.125.24.0-255,7156,13521,7,297936
7152,7.7e-05,172.31.36.0-255,66,13587,7,297936
7153,0.00012,172.31.36.0-255,66,13653,7,297936
7154,0.000146,74.125.24.0-255,5738,19391,7,297936
7155,0.000148,172.31.36.0-255,66,19457,7,297936
7156,0.000156,74.125.24.0-255,6438,25895,7,297936
7157,0.000158,172.31.36.0-255,66,25961,7,297936
7158,0.0002,74.125.24.0-255,1484,27445,7,297936
7159,0.000203,172.31.36.0-255,66,27511,7,297936
7160,0.000208,74.125.24.0-255,2902,30413,7,297936
7161,0.000211,172.31.36.0-255,66,30479,7,297936
7162,0.000214,74.125.24.0-255,2902,33381,7,297936
7163,0.000216,172.31.36.0-255,66,33447,7,297936
7164,0.000245,74.125.24.0-255,2902,36349,7,297936
7165,0.000249,172.31.36.0-255,66,36415,7,297936
7166,0.000278,74.125.24.0-255,7134,43549,7,297936
7167,0.000281,172.31.36.0-255,66,43615,7,297936
7168,0.00047,74.125.24.0-255,1484,45099,7,297936
7169,0.000476,74.125.24.0-255,2902,48001,7,297936
7170,0.000478,74.125.24.0-255,1484,49485,7,297936
7171,0.000479,172.31.36.0-255,66,49551,7,297936
7172,0.000483,172.31.36.0-255,66,49617,7,297936
7173,0.000486,172.31.36.0-255,66,49683,7,297936
7174,0.000492,74.125.24.0-255,4320,54003,7,297936
7175,0.000505,74.125.24.0-255,5738,59741,7,297936
7176,0.000506,172.31.36.0-255,66,59807,7,297936
7177,0.000512,172.31.36.0-255,66,59873,7,297936
7178,0.000547,74.125.24.0-255,7156,67029,7,297936
7179,0.000554,74.125.24.0-255,5738,72767,7,297936
7180,0.00056,172.31.36.0-255,66,72833,7,297936
7181,0.000572,74.125.24.0-255,5020,77853,7,297936
7182,0.000576,172.31.36.0-255,66,77919,7,297936
7183,0.000764,74.125.24.0-255,349,78268,7,297936
7184,0.000789,74.125.24.0-255,1484,79752,7,297936
7185,0.000793,172.31.36.0-255,66,79818,7,297936
7186,0.000807,74.125.24.0-255,4320,84138,7,297936
7187,0.000817,172.31.36.0-255,66,84204,7,297936
7188,0.000824,74.125.24.0-255,1484,85688,7,297936
7189,0.000879,74.125.24.0-255,6438,92126,7,297936
7190,0.000883,172.31.36.0-255,66,92192,7,297936
7191,0.000889,172.31.36.0-255,66,92258,7,297936
7192,0.001427,74.125.24.0-255,1484,93742,7,297936
7193,0.001433,74.125.24.0-255,1484,95226,7,297936
7194,0.001436,172.31.36.0-255,66,95292,7,297936
7195,0.001448,74.125.24.0-255,1484,96776,7,297936
7196,0.001459,74.125.24.0-255,5738,102514,7,297936
7197,0.001462,172.31.36.0-255,66,102580,7,297936
7198,0.001515,172.31.36.0-255,66,102646,7,297936
7199,0.001531,172.31.36.0-255,66,102712,7,297936
7200,0.001547,74.125.24.0-255,2184,104896,7,297936
7201,0.001558,172.31.36.0-255,66,104962,7,297936
7202,0.001813,74.125.24.0-255,1484,106446,7,297936
7203,0.001823,74.125.24.0-255,2902,109348,7,297936
7204,0.001827,172.31.36.0-255,66,109414,7,297936
7205,0.001834,74.125.24.0-255,5738,115152,7,297936
7206,0.001836,172.31.36.0-255,66,115218,7,297936
7207,0.001848,74.125.24.0-255,2902,118120,7,297936
7208,0.00185,172.31.36.0-255,66,118186,7,297936
7209,0.001856,74.125.24.0-255,4320,122506,7,297936
7210,0.001858,172.31.36.0-255,66,122572,7,297936
7211,0.001886,74.125.24.0-255,5738,128310,7,297936
7212,0.001895,172.31.36.0-255,66,128376,7,297936
7213,0.001901,74.125.24.0-255,4320,132696,7,297936
7214,0.001903,172.31.36.0-255,66,132762,7,297936
7215,0.001953,74.125.24.0-255,5738,138500,7,297936
7216,0.001971,172.31.36.0-255,66,138566,7,297936
7217,0.002041,74.125.24.0-255,4320,142886,7,297936
7218,0.002066,74.125.24.0-255,4320,147206,7,297936
7219,0.002077,74.125.24.0-255,7156,154362,7,297936
7220,0.002118,172.31.36.0-255,66,154428,7,297936
7221,0.002151,74.125.24.0-255,1484,155912,7,297936
7222,0.002156,74.125.24.0-255,2902,158814,7,297936
7223,0.002158,74.125.24.0-255,1484,160298,7,297936
7224,0.00218,74.125.24.0-255,5738,166036,7,297936
7225,0.002202,74.125.24.0-255,5738,171774,7,297936
7226,0.002206,172.31.36.0-255,66,171840,7,297936
7227,0.002219,74.125.24.0-255,7156,178996,7,297936
7228,0.002262,172.31.36.0-255,66,179062,7,297936
7229,0.002355,74.125.24.0-255,766,179828,7,297936
7230,0.003544,172.31.36.0-255,66,179894,7,297936
7231,0.004566,74.125.24.0-255,4320,184214,7,297936
7232,0.004572,172.31.36.0-255,66,184280,7,297936
7233,0.005851,74.125.24.0-255,1484,185764,7,297936
7234,0.006883,74.125.24.0-255,1484,187248,7,297936
7235,0.006888,172.31.36.0-255,66,187314,7,297936
7236,0.006916,74.125.24.0-255,2902,190216,7,297936
7237,0.006919,172.31.36.0-255,66,190282,7,297936
7238,0.009206,74.125.24.0-255,2902,193184,7,297936
7239,0.009213,172.31.36.0-255,66,193250,7,297936
7240,0.009246,74.125.24.0-255,2902,196152,7,297936
7241,0.00925,172.31.36.0-255,66,196218,7,297936
7242,0.011511,74.125.24.0-255,2902,199120,7,297936
7243,0.011521,172.31.36.0-255,66,199186,7,297936
7244,0.01156,74.125.24.0-255,2902,202088,7,297936
7245,0.011564,172.31.36.0-255,66,202154,7,297936
7246,0.013842,74.125.24.0-255,2902,205056,7,297936
7247,0.013855,172.31.36.0-255,66,205122,7,297936
7248,0.013914,74.125.24.0-255,2902,208024,7,297936
7249,0.013919,172.31.36.0-255,66,208090,7,297936
7250,0.016154,74.125.24.0-255,2902,210992,7,297936
7251,0.016162,172.31.36.0-255,66,211058,7,297936
7252,0.016234,74.125.24.0-255,2902,213960,7,297936
7253,0.016239,172.31.36.0-255,66,214026,7,297936
7254,0.018476,74.125.24.0-255,2902,216928,7,297936
7255,0.018487,172.31.36.0-255,66,216994,7,297936
7256,0.018538,74.125.24.0-255,2902,219896,7,297936
7257,0.018542,172.31.36.0-255,66,219962,7,297936
7258,0.020808,74.125.24.0-255,2902,222864,7,297936
7259,0.020815,172.31.36.0-255,66,222930,7,297936
7260,0.020865,74.125.24.0-255,2902,225832,7,297936
7261,0.02087,172.31.36.0-255,66,225898,7,297936
7262,0.023148,74.125.24.0-255,2902,228800,7,297936
7263,0.023154,172.31.36.0-255,66,228866,7,297936
7264,0.023181,74.125.24.0-255,2902,231768,7,297936
7265,0.023184,172.31.36.0-255,66,231834,7,297936
7266,0.025468,74.125.24.0-255,2902,234736,7,297936
7267,0.025475,172.31.36.0-255,66,234802,7,297936
7268,0.025528,74.125.24.0-255,2902,237704,7,297936
7269,0.025532,172.31.36.0-255,66,237770,7,297936
7270,0.027778,74.125.24.0-255,2902,240672,7,297936
7271,0.027786,172.31.36.0-255,66,240738,7,297936
7272,0.02785,74.125.24.0-255,2902,243640,7,297936
7273,0.027854,172.31.36.0-255,66,243706,7,297936
7274,0.030069,74.125.24.0-255,2902,246608,7,297936
7275,0.030076,172.31.36.0-255,66,246674,7,297936
7276,0.030163,74.125.24.0-255,2902,249576,7,297936
7277,0.030168,172.31.36.0-255,66,249642,7,297936
7278,0.032393,74.125.24.0-255,2902,252544,7,297936
7279,0.032405,172.31.36.0-255,66,252610,7,297936
7280,0.032442,74.125.24.0-255,2902,255512,7,297936
7281,0.032447,172.31.36.0-255,66,255578,7,297936
7282,0.032816,172.31.36.0-255,172,255750,7,297936
7283,0.032859,172.31.36.0-255,1116,256866,7,297936
7284,0.032974,172.31.36.0-255,1514,258380,7,297936
7285,0.032977,172.31.36.0-255,1290,259670,7,297936
7286,0.034393,104.244.42.0-255,66,259736,7,297936
7287,0.034429,104.244.42.0-255,66,259802,7,297936
7288,0.034527,104.244.42.0-255,66,259868,7,297936
7289,0.034703,74.125.24.0-255,2902,262770,7,297936
7290,0.034706,172.31.36.0-255,66,262836,7,297936
7291,0.03474,74.125.24.0-255,2902,265738,7,297936
7292,0.034743,172.31.36.0-255,66,265804,7,297936
7293,0.035148,104.244.42.0-255,108,265912,7,297936
7294,0.035154,172.31.36.0-255,66,265978,7,297936
7295,0.037011,74.125.24.0-255,2902,268880,7,297936
7296,0.037015,172.31.36.0-255,66,268946,7,297936
7297,0.037048,74.125.24.0-255,2902,271848,7,297936
7298,0.037051,172.31.36.0-255,66,271914,7,297936
7299,0.039298,74.125.24.0-255,2902,274816,7,297936
7300,0.039304,172.31.36.0-255,66,274882,7,297936
7301,0.039347,74.125.24.0-255,2902,277784,7,297936
7302,0.039351,172.31.36.0-255,66,277850,7,297936
7303,0.041606,74.125.24.0-255,2902,280752,7,297936
7304,0.041611,172.31.36.0-255,66,280818,7,297936
7305,0.041644,74.125.24.0-255,2902,283720,7,297936
7306,0.041648,172.31.36.0-255,66,283786,7,297936
7307,0.043908,74.125.24.0-255,2902,286688,7,297936
7308,0.043919,172.31.36.0-255,66,286754,7,297936
7309,0.043949,74.125.24.0-255,2902,289656,7,297936
7310,0.043953,172.31.36.0-255,66,289722,7,297936
7311,0.04624,74.125.24.0-255,2902,292624,7,297936
7312,0.046246,172.31.36.0-255,66,292690,7,297936
7313,0.046273,74.125.24.0-255,2902,295592,7,297936
7314,0.046276,172.31.36.0-255,66,295658,7,297936
7315,0.048557,74.125.24.0-255,2041,297699,7,297936
7316,0.048568,172.31.36.0-255,66,297765,7,297936
7317,0.048814,172.31.36.0-255,105,297870,7,297936
7318,0.051084,74.125.24.0-255,66,297936,7,297936
7319,0.0,74.125.24.0-255,148,148,7,248341
7320,2.7e-05,172.31.36.0-255,66,214,7,248341
7321,3.4e-05,74.125.24.0-255,1484,1698,7,248341
7322,3.8e-05,172.31.36.0-255,66,1764,7,248341
7323,4.3e-05,74.125.24.0-255,2902,4666,7,248341
7324,4.5e-05,172.31.36.0-255,66,4732,7,248341
7325,4.8e-05,74.125.24.0-255,1484,6216,7,248341
7326,5e-05,172.31.36.0-255,66,6282,7,248341
7327,9.4e-05,74.125.24.0-255,5738,12020,7,248341
7328,9.7e-05,172.31.36.0-255,66,12086,7,248341
7329,0.000115,74.125.24.0-255,1995,14081,7,248341
7330,0.000117,172.31.36.0-255,66,14147,7,248341
7331,0.000557,74.125.24.0-255,1484,15631,7,248341
7332,0.000564,172.31.36.0-255,66,15697,7,248341
7333,0.000584,74.125.24.0-255,2902,18599,7,248341
7334,0.000587,172.31.36.0-255,66,18665,7,248341
7335,0.000594,74.125.24.0-255,5738,24403,7,248341
7336,0.000596,172.31.36.0-255,66,24469,7,248341
7337,0.000603,74.125.24.0-255,6797,31266,7,248341
7338,0.000607,172.31.36.0-255,66,31332,7,248341
7339,0.001285,74.125.24.0-255,1484,32816,7,248341
7340,0.001292,172.31.36.0-255,66,32882,7,248341
7341,0.001313,74.125.24.0-255,2902,35784,7,248341
7342,0.001316,172.31.36.0-255,66,35850,7,248341
7343,0.001322,74.125.24.0-255,5738,41588,7,248341
7344,0.001324,172.31.36.0-255,66,41654,7,248341
7345,0.001367,172.31.36.0-255,66,41720,7,248341
7346,0.001372,74.125.24.0-255,5738,47458,7,248341
7347,0.001374,172.31.36.0-255,66,47524,7,248341
7348,0.00141,74.125.24.0-255,3961,51485,7,248341
7349,0.001413,172.31.36.0-255,66,51551,7,248341
7350,0.001513,74.125.24.0-255,396,51947,7,248341
7351,0.001599,172.31.36.0-255,66,52013,7,248341
7352,0.00178,74.125.24.0-255,348,52361,7,248341
7353,0.001818,172.31.36.0-255,66,52427,7,248341
7354,0.001927,74.125.24.0-255,1484,53911,7,248341
7355,0.001944,74.125.24.0-255,2902,56813,7,248341
7356,0.001948,172.31.36.0-255,66,56879,7,248341
7357,0.001979,74.125.24.0-255,2902,59781,7,248341
7358,0.001983,172.31.36.0-255,66,59847,7,248341
7359,0.002011,74.125.24.0-255,2902,62749,7,248341
7360,0.002014,172.31.36.0-255,66,62815,7,248341
7361,0.002026,172.31.36.0-255,66,62881,7,248341
7362,0.002032,74.125.24.0-255,5738,68619,7,248341
7363,0.002034,172.31.36.0-255,66,68685,7,248341
7364,0.002041,74.125.24.0-255,6797,75482,7,248341
7365,0.002043,172.31.36.0-255,66,75548,7,248341
7366,0.00464,74.125.24.0-255,5738,81286,7,248341
7367,0.004648,172.31.36.0-255,66,81352,7,248341
7368,0.007189,74.125.24.0-255,5738,87090,7,248341
7369,0.007196,172.31.36.0-255,66,87156,7,248341
7370,0.009741,74.125.24.0-255,5738,92894,7,248341
7371,0.009749,172.31.36.0-255,66,92960,7,248341
7372,0.012297,74.125.24.0-255,5738,98698,7,248341
7373,0.012305,172.31.36.0-255,66,98764,7,248341
7374,0.014896,74.125.24.0-255,5738,104502,7,248341
7375,0.014909,172.31.36.0-255,66,104568,7,248341
7376,0.017461,74.125.24.0-255,5738,110306,7,248341
7377,0.017471,172.31.36.0-255,66,110372,7,248341
7378,0.020051,74.125.24.0-255,5738,116110,7,248341
7379,0.02006,172.31.36.0-255,66,116176,7,248341
7380,0.022638,74.125.24.0-255,5738,121914,7,248341
7381,0.022647,172.31.36.0-255,66,121980,7,248341
7382,0.025214,74.125.24.0-255,5738,127718,7,248341
7383,0.025224,172.31.36.0-255,66,127784,7,248341
7384,0.027844,74.125.24.0-255,5738,133522,7,248341
7385,0.027852,172.31.36.0-255,66,133588,7,248341
7386,0.027977,172.31.36.0-255,172,133760,7,248341
7387,0.028004,172.31.36.0-255,1073,134833,7,248341
7388,0.029535,104.244.42.0-255,66,134899,7,248341
7389,0.029574,104.244.42.0-255,66,134965,7,248341
7390,0.030399,74.125.24.0-255,5738,140703,7,248341
7391,0.030408,172.31.36.0-255,66,140769,7,248341
7392,0.032968,74.125.24.0-255,5738,146507,7,248341
7393,0.032972,172.31.36.0-255,66,146573,7,248341
7394,0.035523,74.125.24.0-255,5738,152311,7,248341
7395,0.03553,172.31.36.0-255,66,152377,7,248341
7396,0.038084,74.125.24.0-255,5738,158115,7,248341
7397,0.03809,172.31.36.0-255,66,158181,7,248341
7398,0.040651,74.125.24.0-255,5738,163919,7,248341
7399,0.040657,172.31.36.0-255,66,163985,7,248341
7400,0.043281,74.125.24.0-255,4320,168305,7,248341
7401,0.043304,172.31.36.0-255,66,168371,7,248341
7402,0.043319,74.125.24.0-255,1484,169855,7,248341
7403,0.045882,74.125.24.0-255,4320,174175,7,248341
7404,0.045888,172.31.36.0-255,66,174241,7,248341
7405,0.048446,74.125.24.0-255,5738,179979,7,248341
7406,0.048451,172.31.36.0-255,66,180045,7,248341
7407,0.051038,74.125.24.0-255,5738,185783,7,248341
7408,0.051044,172.31.36.0-255,66,185849,7,248341
7409,0.053615,74.125.24.0-255,5738,191587,7,248341
7410,0.05362,172.31.36.0-255,66,191653,7,248341
7411,0.056164,74.125.24.0-255,5738,197391,7,248341
7412,0.056168,172.31.36.0-255,66,197457,7,248341
7413,0.058773,74.125.24.0-255,4320,201777,7,248341
7414,0.058777,172.31.36.0-255,66,201843,7,248341
7415,0.058805,74.125.24.0-255,1484,203327,7,248341
7416,0.061332,74.125.24.0-255,4320,207647,7,248341
7417,0.061336,172.31.36.0-255,66,207713,7,248341
7418,0.063898,74.125.24.0-255,5738,213451,7,248341
7419,0.063903,172.31.36.0-255,66,213517,7,248341
7420,0.066456,74.125.24.0-255,5738,219255,7,248341
7421,0.066461,172.31.36.0-255,66,219321,7,248341
7422,0.069012,74.125.24.0-255,5738,225059,7,248341
7423,0.069018,172.31.36.0-255,66,225125,7,248341
7424,0.071606,74.125.24.0-255,5738,230863,7,248341
7425,0.071614,172.31.36.0-255,66,230929,7,248341
7426,0.074191,74.125.24.0-255,5738,236667,7,248341
7427,0.074196,172.31.36.0-255,66,236733,7,248341
7428,0.076745,74.125.24.0-255,5738,242471,7,248341
7429,0.07675,172.31.36.0-255,66,242537,7,248341
7430,0.079308,74.125.24.0-255,5738,248275,7,248341
7431,0.079312,172.31.36.0-255,66,248341,7,248341
7432,0.0,74.125.68.0-255,153,153,7,376724
7433,1.6e-05,172.31.36.0-255,66,219,7,376724
7434,2.3e-05,74.125.68.0-255,1484,1703,7,376724
7435,2.8e-05,172.31.36.0-255,66,1769,7,376724
7436,3.9e-05,74.125.68.0-255,1484,3253,7,376724
7437,4.2e-05,172.31.36.0-255,66,3319,7,376724
7438,4.7e-05,74.125.68.0-255,1484,4803,7,376724
7439,4.9e-05,172.31.36.0-255,66,4869,7,376724
7440,6.9e-05,74.125.68.0-255,1484,6353,7,376724
7441,7.6e-05,172.31.36.0-255,66,6419,7,376724
7442,8.2e-05,74.125.68.0-255,2902,9321,7,376724
7443,8.5e-05,172.31.36.0-255,66,9387,7,376724
7444,0.000105,74.125.68.0-255,4320,13707,7,376724
7445,0.000111,172.31.36.0-255,66,13773,7,376724
7446,0.000116,74.125.68.0-255,2028,15801,7,376724
7447,0.000119,172.31.36.0-255,66,15867,7,376724
7448,0.000152,74.125.68.0-255,2902,18769,7,376724
7449,0.000154,172.31.36.0-255,66,18835,7,376724
7450,0.000162,74.125.68.0-255,7156,25991,7,376724
7451,0.000165,172.31.36.0-255,66,26057,7,376724
7452,0.000192,74.125.68.0-255,2902,28959,7,376724
7453,0.000195,172.31.36.0-255,66,29025,7,376724
7454,0.000218,74.125.68.0-255,2543,31568,7,376724
7455,0.000221,172.31.36.0-255,66,31634,7,376724
7456,0.000265,74.125.68.0-255,1484,33118,7,376724
7457,0.000268,172.31.36.0-255,66,33184,7,376724
7458,0.000272,74.125.68.0-255,1484,34668,7,376724
7459,0.000274,172.31.36.0-255,66,34734,7,376724
7460,0.000303,74.125.68.0-255,2902,37636,7,376724
7461,0.000309,74.125.68.0-255,5738,43374,7,376724
7462,0.000315,172.31.36.0-255,66,43440,7,376724
7463,0.000318,172.31.36.0-255,66,43506,7,376724
7464,0.000327,74.125.68.0-255,2902,46408,7,376724
7465,0.000334,172.31.36.0-255,66,46474,7,376724
7466,0.000367,74.125.68.0-255,3961,50435,7,376724
7467,0.00037,172.31.36.0-255,66,50501,7,376724
7468,0.000373,74.125.68.0-255,1484,51985,7,376724
7469,0.000394,74.125.68.0-255,7156,59141,7,376724
7470,0.000397,172.31.36.0-255,66,59207,7,376724
7471,0.000426,74.125.68.0-255,2902,62109,7,376724
7472,0.000428,172.31.36.0-255,66,62175,7,376724
7473,0.000452,74.125.68.0-255,4318,66493,7,376724
7474,0.000455,172.31.36.0-255,66,66559,7,376724
7475,0.000504,74.125.68.0-255,331,66890,7,376724
7476,0.000883,74.125.68.0-255,1484,68374,7,376724
7477,0.000888,172.31.36.0-255,66,68440,7,376724
7478,0.000894,74.125.68.0-255,2902,71342,7,376724
7479,0.000896,172.31.36.0-255,66,71408,7,376724
7480,0.000899,74.125.68.0-255,1484,72892,7,376724
7481,0.000909,74.125.68.0-255,2902,75794,7,376724
7482,0.000912,172.31.36.0-255,66,75860,7,376724
7483,0.000948,74.125.68.0-255,5738,81598,7,376724
7484,0.000951,172.31.36.0-255,66,81664,7,376724
7485,0.000959,74.125.68.0-255,7156,88820,7,376724
7486,0.000962,172.31.36.0-255,66,88886,7,376724
7487,0.000998,74.125.68.0-255,4320,93206,7,376724
7488,0.001001,172.31.36.0-255,66,93272,7,376724
7489,0.001013,172.31.36.0-255,66,93338,7,376724
7490,0.001153,74.125.68.0-255,1484,94822,7,376724
7491,0.00116,74.125.68.0-255,2902,97724,7,376724
7492,0.001163,172.31.36.0-255,66,97790,7,376724
7493,0.001198,74.125.68.0-255,5738,103528,7,376724
7494,0.001201,172.31.36.0-255,66,103594,7,376724
7495,0.001209,74.125.68.0-255,5738,109332,7,376724
7496,0.00121,172.31.36.0-255,66,109398,7,376724
7497,0.001248,74.125.68.0-255,2902,112300,7,376724
7498,0.001251,172.31.36.0-255,66,112366,7,376724
7499,0.001264,172.31.36.0-255,66,112432,7,376724
7500,0.00127,74.125.68.0-255,5020,117452,7,376724
7501,0.001272,172.31.36.0-255,66,117518,7,376724
7502,0.001991,74.125.68.0-255,1484,119002,7,376724
7503,0.002001,74.125.68.0-255,2902,121904,7,376724
7504,0.002005,172.31.36.0-255,66,121970,7,376724
7505,0.00201,74.125.68.0-255,1484,123454,7,376724
7506,0.002014,74.125.68.0-255,2902,126356,7,376724
7507,0.002016,172.31.36.0-255,66,126422,7,376724
7508,0.002047,74.125.68.0-255,5738,132160,7,376724
7509,0.002049,172.31.36.0-255,66,132226,7,376724
7510,0.002088,172.31.36.0-255,66,132292,7,376724
7511,0.002116,74.125.68.0-255,4320,136612,7,376724
7512,0.002118,172.31.36.0-255,66,136678,7,376724
7513,0.002145,74.125.68.0-255,5020,141698,7,376724
7514,0.002148,172.31.36.0-255,66,141764,7,376724
7515,0.002181,74.125.68.0-255,1484,143248,7,376724
7516,0.002186,74.125.68.0-255,2902,146150,7,376724
7517,0.002188,172.31.36.0-255,66,146216,7,376724
7518,0.00222,74.125.68.0-255,4320,150536,7,376724
7519,0.002222,172.31.36.0-255,66,150602,7,376724
7520,0.002229,74.125.68.0-255,5738,156340,7,376724
7521,0.00223,172.31.36.0-255,66,156406,7,376724
7522,0.002255,74.125.68.0-255,5738,162144,7,376724
7523,0.002258,172.31.36.0-255,66,162210,7,376724
7524,0.00228,74.125.68.0-255,5738,167948,7,376724
7525,0.002282,172.31.36.0-255,66,168014,7,376724
7526,0.002285,74.125.68.0-255,1484,169498,7,376724
7527,0.00232,74.125.68.0-255,6438,175936,7,376724
7528,0.002323,172.31.36.0-255,66,176002,7,376724
7529,0.004605,74.125.68.0-255,5738,181740,7,376724
7530,0.004612,172.31.36.0-255,66,181806,7,376724
7531,0.006927,74.125.68.0-255,5738,187544,7,376724
7532,0.006933,172.31.36.0-255,66,187610,7,376724
7533,0.009217,74.125.68.0-255,5738,193348,7,376724
7534,0.009224,172.31.36.0-255,66,193414,7,376724
7535,0.011511,74.125.68.0-255,5738,199152,7,376724
7536,0.011518,172.31.36.0-255,66,199218,7,376724
7537,0.013804,74.125.68.0-255,5738,204956,7,376724
7538,0.01381,172.31.36.0-255,66,205022,7,376724
7539,0.016095,74.125.68.0-255,5738,210760,7,376724
7540,0.016101,172.31.36.0-255,66,210826,7,376724
7541,0.018384,74.125.68.0-255,5738,216564,7,376724
7542,0.018394,172.31.36.0-255,66,216630,7,376724
7543,0.020688,74.125.68.0-255,5738,222368,7,376724
7544,0.020697,172.31.36.0-255,66,222434,7,376724
7545,0.022998,74.125.68.0-255,5738,228172,7,376724
7546,0.023005,172.31.36.0-255,66,228238,7,376724
7547,0.025285,74.125.68.0-255,5738,233976,7,376724
7548,0.025293,172.31.36.0-255,66,234042,7,376724
7549,0.027577,74.125.68.0-255,5738,239780,7,376724
7550,0.027583,172.31.36.0-255,66,239846,7,376724
7551,0.029865,74.125.68.0-255,5738,245584,7,376724
7552,0.02987,172.31.36.0-255,66,245650,7,376724
7553,0.031085,172.31.36.0-255,172,245822,7,376724
7554,0.031117,172.31.36.0-255,1115,246937,7,376724
7555,0.031189,172.31.36.0-255,1514,248451,7,376724
7556,0.031191,172.31.36.0-255,1514,249965,7,376724
7557,0.031196,172.31.36.0-255,1514,251479,7,376724
7558,0.031197,172.31.36.0-255,1514,252993,7,376724
7559,0.031216,172.31.36.0-255,1514,254507,7,376724
7560,0.031217,172.31.36.0-255,69,254576,7,376724
7561,0.032157,74.125.68.0-255,5738,260314,7,376724
7562,0.032164,172.31.36.0-255,66,260380,7,376724
7563,0.032639,104.244.42.0-255,66,260446,7,376724
7564,0.032661,104.244.42.0-255,66,260512,7,376724
7565,0.032765,104.244.42.0-255,66,260578,7,376724
7566,0.032786,104.244.42.0-255,66,260644,7,376724
7567,0.034452,74.125.68.0-255,5738,266382,7,376724
7568,0.034459,172.31.36.0-255,66,266448,7,376724
7569,0.036754,74.125.68.0-255,5738,272186,7,376724
7570,0.036761,172.31.36.0-255,66,272252,7,376724
7571,0.039058,74.125.68.0-255,5738,277990,7,376724
7572,0.039065,172.31.36.0-255,66,278056,7,376724
7573,0.041351,74.125.68.0-255,5738,283794,7,376724
7574,0.041356,172.31.36.0-255,66,283860,7,376724
7575,0.043654,74.125.68.0-255,5738,289598,7,376724
7576,0.043661,172.31.36.0-255,66,289664,7,376724
7577,0.045953,74.125.68.0-255,5738,295402,7,376724
7578,0.04596,172.31.36.0-255,66,295468,7,376724
7579,0.048256,74.125.68.0-255,5738,301206,7,376724
7580,0.048263,172.31.36.0-255,66,301272,7,376724
7581,0.050549,74.125.68.0-255,5738,307010,7,376724
7582,0.050554,172.31.36.0-255,66,307076,7,376724
7583,0.052836,74.125.68.0-255,5738,312814,7,376724
7584,0.052841,172.31.36.0-255,66,312880,7,376724
7585,0.055134,74.125.68.0-255,5738,318618,7,376724
7586,0.05514,172.31.36.0-255,66,318684,7,376724
7587,0.057421,74.125.68.0-255,5738,324422,7,376724
7588,0.057428,172.31.36.0-255,66,324488,7,376724
7589,0.059719,74.125.68.0-255,5738,330226,7,376724
7590,0.059725,172.31.36.0-255,66,330292,7,376724
7591,0.062016,74.125.68.0-255,5738,336030,7,376724
7592,0.062023,172.31.36.0-255,66,336096,7,376724
7593,0.064317,74.125.68.0-255,5738,341834,7,376724
7594,0.064324,172.31.36.0-255,66,341900,7,376724
7595,0.066616,74.125.68.0-255,5738,347638,7,376724
7596,0.066621,172.31.36.0-255,66,347704,7,376724
7597,0.068903,74.125.68.0-255,5738,353442,7,376724
7598,0.06891,172.31.36.0-255,66,353508,7,376724
7599,0.071204,74.125.68.0-255,5738,359246,7,376724
7600,0.071211,172.31.36.0-255,66,359312,7,376724
7601,0.07351,74.125.68.0-255,5738,365050,7,376724
7602,0.073516,172.31.36.0-255,66,365116,7,376724
7603,0.075812,74.125.68.0-255,5738,370854,7,376724
7604,0.075819,172.31.36.0-255,66,370920,7,376724
7605,0.078115,74.125.68.0-255,5738,376658,7,376724
7606,0.078122,172.31.36.0-255,66,376724,7,376724
7607,0.0,172.217.194.0-255,153,153,7,274062
7608,3.3e-05,172.31.36.0-255,66,219,7,274062
7609,4e-05,172.217.194.0-255,1484,1703,7,274062
7610,4.4e-05,172.31.36.0-255,66,1769,7,274062
7611,5e-05,172.217.194.0-255,2902,4671,7,274062
7612,6e-05,172.31.36.0-255,66,4737,7,274062
7613,6.7e-05,172.217.194.0-255,7156,11893,7,274062
7614,7e-05,172.31.36.0-255,66,11959,7,274062
7615,7.4e-05,172.217.194.0-255,1484,13443,7,274062
7616,7.7e-05,172.31.36.0-255,66,13509,7,274062
7617,0.000126,172.31.36.0-255,66,13575,7,274062
7618,0.000131,172.217.194.0-255,2543,16118,7,274062
7619,0.000133,172.31.36.0-255,66,16184,7,274062
7620,0.000325,172.217.194.0-255,1484,17668,7,274062
7621,0.00033,172.31.36.0-255,66,17734,7,274062
7622,0.000336,172.217.194.0-255,2902,20636,7,274062
7623,0.000339,172.31.36.0-255,66,20702,7,274062
7624,0.000371,172.217.194.0-255,5738,26440,7,274062
7625,0.000374,172.31.36.0-255,66,26506,7,274062
7626,0.000405,172.31.36.0-255,66,26572,7,274062
7627,0.000413,172.217.194.0-255,7156,33728,7,274062
7628,0.000416,172.31.36.0-255,66,33794,7,274062
7629,0.000449,172.217.194.0-255,1484,35278,7,274062
7630,0.000452,172.31.36.0-255,66,35344,7,274062
7631,0.000482,172.217.194.0-255,2184,37528,7,274062
7632,0.000485,172.31.36.0-255,66,37594,7,274062
7633,0.001166,172.217.194.0-255,377,37971,7,274062
7634,0.001173,172.31.36.0-255,66,38037,7,274062
7635,0.00118,172.217.194.0-255,99,38136,7,274062
7636,0.001183,172.31.36.0-255,66,38202,7,274062
7637,0.00248,172.217.194.0-255,2902,41104,7,274062
7638,0.002486,172.31.36.0-255,66,41170,7,274062
7639,0.003177,172.217.194.0-255,1484,42654,7,274062
7640,0.003188,172.217.194.0-255,1484,44138,7,274062
7641,0.003191,172.31.36.0-255,66,44204,7,274062
7642,0.004474,172.217.194.0-255,2902,47106,7,274062
7643,0.004477,172.31.36.0-255,66,47172,7,274062
7644,0.005171,172.217.194.0-255,2902,50074,7,274062
7645,0.005174,172.31.36.0-255,66,50140,7,274062
7646,0.006487,172.217.194.0-255,2902,53042,7,274062
7647,0.006494,172.31.36.0-255,66,53108,7,274062
7648,0.007171,172.217.194.0-255,2902,56010,7,274062
7649,0.007177,172.31.36.0-255,66,56076,7,274062
7650,0.008513,172.217.194.0-255,2902,58978,7,274062
7651,0.00852,172.31.36.0-255,66,59044,7,274062
7652,0.009159,172.217.194.0-255,2902,61946,7,274062
7653,0.009167,172.31.36.0-255,66,62012,7,274062
7654,0.010485,172.217.194.0-255,2902,64914,7,274062
7655,0.010491,172.31.36.0-255,66,64980,7,274062
7656,0.011166,172.217.194.0-255,2902,67882,7,274062
7657,0.011172,172.31.36.0-255,66,67948,7,274062
7658,0.012484,172.217.194.0-255,2902,70850,7,274062
7659,0.012492,172.31.36.0-255,66,70916,7,274062
7660,0.013194,172.217.194.0-255,2902,73818,7,274062
7661,0.0132,172.31.36.0-255,66,73884,7,274062
7662,0.01448,172.217.194.0-255,2902,76786,7,274062
7663,0.014487,172.31.36.0-255,66,76852,7,274062
7664,0.015216,172.217.194.0-255,2902,79754,7,274062
7665,0.015223,172.31.36.0-255,66,79820,7,274062
7666,0.016481,172.217.194.0-255,2902,82722,7,274062
7667,0.016488,172.31.36.0-255,66,82788,7,274062
7668,0.01719,172.217.194.0-255,2902,85690,7,274062
7669,0.017194,172.31.36.0-255,66,85756,7,274062
7670,0.018508,172.217.194.0-255,2902,88658,7,274062
7671,0.018519,172.31.36.0-255,66,88724,7,274062
7672,0.019166,172.217.194.0-255,2902,91626,7,274062
7673,0.019173,172.31.36.0-255,66,91692,7,274062
7674,0.020495,172.217.194.0-255,2902,94594,7,274062
7675,0.020503,172.31.36.0-255,66,94660,7,274062
7676,0.021182,172.217.194.0-255,2902,97562,7,274062
7677,0.021188,172.31.36.0-255,66,97628,7,274062
7678,0.022467,172.217.194.0-255,2902,100530,7,274062
7679,0.022474,172.31.36.0-255,66,100596,7,274062
7680,0.023188,172.217.194.0-255,2902,103498,7,274062
7681,0.023194,172.31.36.0-255,66,103564,7,274062
7682,0.02446,172.217.194.0-255,2902,106466,7,274062
7683,0.024466,172.31.36.0-255,66,106532,7,274062
7684,0.024759,172.31.36.0-255,172,106704,7,274062
7685,0.024897,172.31.36.0-255,1114,107818,7,274062
7686,0.024973,172.31.36.0-255,1514,109332,7,274062
7687,0.024976,172.31.36.0-255,1292,110624,7,274062
7688,0.02516,172.217.194.0-255,2902,113526,7,274062
7689,0.025167,172.31.36.0-255,66,113592,7,274062
7690,0.026297,104.244.42.0-255,66,113658,7,274062
7691,0.026441,104.244.42.0-255,66,113724,7,274062
7692,0.02646,172.217.194.0-255,2902,116626,7,274062
7693,0.026463,172.31.36.0-255,66,116692,7,274062
7694,0.026542,104.244.42.0-255,66,116758,7,274062
7695,0.027159,172.217.194.0-255,2902,119660,7,274062
7696,0.027164,172.31.36.0-255,66,119726,7,274062
7697,0.028444,172.217.194.0-255,2902,122628,7,274062
7698,0.028449,172.31.36.0-255,66,122694,7,274062
7699,0.029169,172.217.194.0-255,2902,125596,7,274062
7700,0.029174,172.31.36.0-255,66,125662,7,274062
7701,0.030434,172.217.194.0-255,2902,128564,7,274062
7702,0.03044,172.31.36.0-255,66,128630,7,274062
7703,0.031173,172.217.194.0-255,2902,131532,7,274062
7704,0.031179,172.31.36.0-255,66,131598,7,274062
7705,0.032427,172.217.194.0-255,2902,134500,7,274062
7706,0.032432,172.31.36.0-255,66,134566,7,274062
7707,0.033179,172.217.194.0-255,2902,137468,7,274062
7708,0.033184,172.31.36.0-255,66,137534,7,274062
7709,0.034407,172.217.194.0-255,2902,140436,7,274062
7710,0.034412,172.31.36.0-255,66,140502,7,274062
7711,0.03517,172.217.194.0-255,2902,143404,7,274062
7712,0.035176,172.31.36.0-255,66,143470,7,274062
7713,0.036378,172.217.194.0-255,2902,146372,7,274062
7714,0.036384,172.31.36.0-255,66,146438,7,274062
7715,0.037179,172.217.194.0-255,2902,149340,7,274062
7716,0.037184,172.31.36.0-255,66,149406,7,274062
7717,0.038359,172.217.194.0-255,2902,152308,7,274062
7718,0.038365,172.31.36.0-255,66,152374,7,274062
7719,0.039143,172.217.194.0-255,2902,155276,7,274062
7720,0.039146,172.31.36.0-255,66,155342,7,274062
7721,0.040368,172.217.194.0-255,2902,158244,7,274062
7722,0.040387,172.31.36.0-255,66,158310,7,274062
7723,0.041101,172.217.194.0-255,2902,161212,7,274062
7724,0.041106,172.31.36.0-255,66,161278,7,274062
7725,0.04238,172.217.194.0-255,2902,164180,7,274062
7726,0.042385,172.31.36.0-255,66,164246,7,274062
7727,0.043119,172.217.194.0-255,2902,167148,7,274062
7728,0.043124,172.31.36.0-255,66,167214,7,274062
7729,0.044383,172.217.194.0-255,2902,170116,7,274062
7730,0.044388,172.31.36.0-255,66,170182,7,274062
7731,0.045117,172.217.194.0-255,2902,173084,7,274062
7732,0.045122,172.31.36.0-255,66,173150,7,274062
7733,0.046378,172.217.194.0-255,2902,176052,7,274062
7734,0.046383,172.31.36.0-255,66,176118,7,274062
7735,0.047112,172.217.194.0-255,2902,179020,7,274062
7736,0.047118,172.31.36.0-255,66,179086,7,274062
7737,0.048385,172.217.194.0-255,2902,181988,7,274062
7738,0.048392,172.31.36.0-255,66,182054,7,274062
7739,0.04915,172.217.194.0-255,2902,184956,7,274062
7740,0.049156,172.31.36.0-255,66,185022,7,274062
7741,0.050368,172.217.194.0-255,2902,187924,7,274062
7742,0.050374,172.31.36.0-255,66,187990,7,274062
7743,0.051126,172.217.194.0-255,2902,190892,7,274062
7744,0.051131,172.31.36.0-255,66,190958,7,274062
7745,0.05238,172.217.194.0-255,2902,193860,7,274062
7746,0.052384,172.31.36.0-255,66,193926,7,274062
7747,0.053109,172.217.194.0-255,2902,196828,7,274062
7748,0.053115,172.31.36.0-255,66,196894,7,274062
7749,0.05436,172.217.194.0-255,2902,199796,7,274062
7750,0.054365,172.31.36.0-255,66,199862,7,274062
7751,0.0551,172.217.194.0-255,2902,202764,7,274062
7752,0.055105,172.31.36.0-255,66,202830,7,274062
7753,0.056356,172.217.194.0-255,2902,205732,7,274062
7754,0.056361,172.31.36.0-255,66,205798,7,274062
7755,0.057104,172.217.194.0-255,2902,208700,7,274062
7756,0.057111,172.31.36.0-255,66,208766,7,274062
7757,0.058353,172.217.194.0-255,2902,211668,7,274062
7758,0.058358,172.31.36.0-255,66,211734,7,274062
7759,0.059097,172.217.194.0-255,2902,214636,7,274062
7760,0.059103,172.31.36.0-255,66,214702,7,274062
7761,0.060345,172.217.194.0-255,2902,217604,7,274062
7762,0.060351,172.31.36.0-255,66,217670,7,274062
7763,0.06109,172.217.194.0-255,2902,220572,7,274062
7764,0.061095,172.31.36.0-255,66,220638,7,274062
7765,0.06232,172.217.194.0-255,2902,223540,7,274062
7766,0.062325,172.31.36.0-255,66,223606,7,274062
7767,0.06308,172.217.194.0-255,2902,226508,7,274062
7768,0.063085,172.31.36.0-255,66,226574,7,274062
7769,0.064297,172.217.194.0-255,2902,229476,7,274062
7770,0.064302,172.31.36.0-255,66,229542,7,274062
7771,0.065073,172.217.194.0-255,2902,232444,7,274062
7772,0.065078,172.31.36.0-255,66,232510,7,274062
7773,0.066283,172.217.194.0-255,2902,235412,7,274062
7774,0.066289,172.31.36.0-255,66,235478,7,274062
7775,0.067047,172.217.194.0-255,2902,238380,7,274062
7776,0.067053,172.31.36.0-255,66,238446,7,274062
7777,0.06827,172.217.194.0-255,2902,241348,7,274062
7778,0.068275,172.31.36.0-255,66,241414,7,274062
7779,0.069023,172.217.194.0-255,2902,244316,7,274062
7780,0.069029,172.31.36.0-255,66,244382,7,274062
7781,0.070254,172.217.194.0-255,2902,247284,7,274062
7782,0.070259,172.31.36.0-255,66,247350,7,274062
7783,0.071019,172.217.194.0-255,2902,250252,7,274062
7784,0.071024,172.31.36.0-255,66,250318,7,274062
7785,0.072246,172.217.194.0-255,2902,253220,7,274062
7786,0.072251,172.31.36.0-255,66,253286,7,274062
7787,0.073005,172.217.194.0-255,2902,256188,7,274062
7788,0.073012,172.31.36.0-255,66,256254,7,274062
7789,0.074242,172.217.194.0-255,2902,259156,7,274062
7790,0.074248,172.31.36.0-255,66,259222,7,274062
7791,0.074985,172.217.194.0-255,2902,262124,7,274062
7792,0.07499,172.31.36.0-255,66,262190,7,274062
7793,0.076234,172.217.194.0-255,2902,265092,7,274062
7794,0.07624,172.31.36.0-255,66,265158,7,274062
7795,0.076998,172.217.194.0-255,2902,268060,7,274062
7796,0.077005,172.31.36.0-255,66,268126,7,274062
7797,0.078214,172.217.194.0-255,2902,271028,7,274062
7798,0.078218,172.31.36.0-255,66,271094,7,274062
7799,0.078999,172.217.194.0-255,2902,273996,7,274062
7800,0.079004,172.31.36.0-255,66,274062,7,274062
7801,0.0,216.58.221.0-255,301,301,7,291257
7802,3e-05,172.31.36.0-255,66,367,7,291257
7803,3.6e-05,216.58.221.0-255,1484,1851,7,291257
7804,4.1e-05,172.31.36.0-255,66,1917,7,291257
7805,4.6e-05,216.58.221.0-255,2902,4819,7,291257
7806,4.9e-05,172.31.36.0-255,66,4885,7,291257
7807,6.3e-05,216.58.221.0-255,5738,10623,7,291257
7808,6.6e-05,172.31.36.0-255,66,10689,7,291257
7809,8.2e-05,216.58.221.0-255,3287,13976,7,291257
7810,8.6e-05,172.31.36.0-255,66,14042,7,291257
7811,0.000609,216.58.221.0-255,1484,15526,7,291257
7812,0.000616,172.31.36.0-255,66,15592,7,291257
7813,0.000626,216.58.221.0-255,2902,18494,7,291257
7814,0.000629,172.31.36.0-255,66,18560,7,291257
7815,0.000643,216.58.221.0-255,5738,24298,7,291257
7816,0.000646,172.31.36.0-255,66,24364,7,291257
7817,0.000654,216.58.221.0-255,6797,31161,7,291257
7818,0.000657,172.31.36.0-255,66,31227,7,291257
7819,0.000842,216.58.221.0-255,1484,32711,7,291257
7820,0.000847,172.31.36.0-255,66,32777,7,291257
7821,0.000854,216.58.221.0-255,2902,35679,7,291257
7822,0.000856,172.31.36.0-255,66,35745,7,291257
7823,0.000861,216.58.221.0-255,4320,40065,7,291257
7824,0.00087,172.31.36.0-255,66,40131,7,291257
7825,0.000898,216.58.221.0-255,1484,41615,7,291257
7826,0.000902,172.31.36.0-255,66,41681,7,291257
7827,0.000915,216.58.221.0-255,6797,48478,7,291257
7828,0.000918,172.31.36.0-255,66,48544,7,291257
7829,0.000925,216.58.221.0-255,7156,55700,7,291257
7830,0.000928,172.31.36.0-255,66,55766,7,291257
7831,0.000939,172.31.36.0-255,66,55832,7,291257
7832,0.00099,216.58.221.0-255,393,56225,7,291257
7833,0.002873,216.58.221.0-255,4320,60545,7,291257
7834,0.00288,172.31.36.0-255,66,60611,7,291257
7835,0.004827,216.58.221.0-255,5738,66349,7,291257
7836,0.004834,172.31.36.0-255,66,66415,7,291257
7837,0.006785,216.58.221.0-255,5738,72153,7,291257
7838,0.006792,172.31.36.0-255,66,72219,7,291257
7839,0.008727,216.58.221.0-255,5738,77957,7,291257
7840,0.008733,172.31.36.0-255,66,78023,7,291257
7841,0.010683,216.58.221.0-255,5738,83761,7,291257
7842,0.010694,172.31.36.0-255,66,83827,7,291257
7843,0.012661,216.58.221.0-255,5738,89565,7,291257
7844,0.012669,172.31.36.0-255,66,89631,7,291257
7845,0.014608,216.58.221.0-255,5738,95369,7,291257
7846,0.014617,172.31.36.0-255,66,95435,7,291257
7847,0.016568,216.58.221.0-255,5738,101173,7,291257
7848,0.016576,172.31.36.0-255,66,101239,7,291257
7849,0.018361,172.31.36.0-255,172,101411,7,291257
7850,0.018394,172.31.36.0-255,1114,102525,7,291257
7851,0.01845,172.31.36.0-255,1514,104039,7,291257
7852,0.018451,172.31.36.0-255,1292,105331,7,291257
7853,0.018522,216.58.221.0-255,5738,111069,7,291257
7854,0.018527,172.31.36.0-255,66,111135,7,291257
7855,0.019971,104.244.42.0-255,66,111201,7,291257
7856,0.02,104.244.42.0-255,66,111267,7,291257
7857,0.020051,104.244.42.0-255,66,111333,7,291257
7858,0.020473,216.58.221.0-255,5738,117071,7,291257
7859,0.020479,172.31.36.0-255,66,117137,7,291257
7860,0.022435,216.58.221.0-255,5738,122875,7,291257
7861,0.022442,172.31.36.0-255,66,122941,7,291257
7862,0.024391,216.58.221.0-255,5738,128679,7,291257
7863,0.024399,172.31.36.0-255,66,128745,7,291257
7864,0.02635,216.58.221.0-255,5738,134483,7,291257
7865,0.026357,172.31.36.0-255,66,134549,7,291257
7866,0.02831,216.58.221.0-255,5738,140287,7,291257
7867,0.028316,172.31.36.0-255,66,140353,7,291257
7868,0.030264,216.58.221.0-255,5738,146091,7,291257
7869,0.03027,172.31.36.0-255,66,146157,7,291257
7870,0.032233,216.58.221.0-255,5738,151895,7,291257
7871,0.03224,172.31.36.0-255,66,151961,7,291257
7872,0.034196,216.58.221.0-255,5738,157699,7,291257
7873,0.034203,172.31.36.0-255,66,157765,7,291257
7874,0.036166,216.58.221.0-255,5738,163503,7,291257
7875,0.036173,172.31.36.0-255,66,163569,7,291257
7876,0.038161,216.58.221.0-255,5738,169307,7,291257
7877,0.03817,172.31.36.0-255,66,169373,7,291257
7878,0.040124,216.58.221.0-255,5738,175111,7,291257
7879,0.040131,172.31.36.0-255,66,175177,7,291257
7880,0.042079,216.58.221.0-255,5738,180915,7,291257
7881,0.042086,172.31.36.0-255,66,180981,7,291257
7882,0.044035,216.58.221.0-255,5738,186719,7,291257
7883,0.044041,172.31.36.0-255,66,186785,7,291257
7884,0.045987,216.58.221.0-255,5738,192523,7,291257
7885,0.045994,172.31.36.0-255,66,192589,7,291257
7886,0.047949,216.58.221.0-255,5738,198327,7,291257
7887,0.047956,172.31.36.0-255,66,198393,7,291257
7888,0.04991,216.58.221.0-255,5738,204131,7,291257
7889,0.049917,172.31.36.0-255,66,204197,7,291257
7890,0.051874,216.58.221.0-255,5738,209935,7,291257
7891,0.05188,172.31.36.0-255,66,210001,7,291257
7892,0.053828,216.58.221.0-255,5738,215739,7,291257
7893,0.053835,172.31.36.0-255,66,215805,7,291257
7894,0.055787,216.58.221.0-255,5738,221543,7,291257
7895,0.055793,172.31.36.0-255,66,221609,7,291257
7896,0.057743,216.58.221.0-255,5738,227347,7,291257
7897,0.057751,172.31.36.0-255,66,227413,7,291257
7898,0.059711,216.58.221.0-255,5738,233151,7,291257
7899,0.059718,172.31.36.0-255,66,233217,7,291257
7900,0.061669,216.58.221.0-255,5738,238955,7,291257
7901,0.061674,172.31.36.0-255,66,239021,7,291257
7902,0.06366,216.58.221.0-255,5738,244759,7,291257
7903,0.063666,172.31.36.0-255,66,244825,7,291257
7904,0.065618,216.58.221.0-255,5738,250563,7,291257
7905,0.065626,172.31.36.0-255,66,250629,7,291257
7906,0.067576,216.58.221.0-255,5738,256367,7,291257
7907,0.067583,172.31.36.0-255,66,256433,7,291257
7908,0.069532,216.58.221.0-255,5738,262171,7,291257
7909,0.06954,172.31.36.0-255,66,262237,7,291257
7910,0.071512,216.58.221.0-255,5738,267975,7,291257
7911,0.07152,172.31.36.0-255,66,268041,7,291257
7912,0.073468,216.58.221.0-255,5738,273779,7,291257
7913,0.073475,172.31.36.0-255,66,273845,7,291257
7914,0.075433,216.58.221.0-255,5738,279583,7,291257
7915,0.07544,172.31.36.0-255,66,279649,7,291257
7916,0.077387,216.58.221.0-255,5738,285387,7,291257
7917,0.077394,172.31.36.0-255,66,285453,7,291257
7918,0.079352,216.58.221.0-255,5738,291191,7,291257
7919,0.079359,172.31.36.0-255,66,291257,7,291257
7920,0.0,74.125.200.0-255,150,150,7,352851
7921,3e-05,172.31.36.0-255,66,216,7,352851
7922,3.6e-05,74.125.200.0-255,1484,1700,7,352851
7923,4e-05,172.31.36.0-255,66,1766,7,352851
7924,7e-05,74.125.200.0-255,2902,4668,7,352851
7925,7.4e-05,172.31.36.0-255,66,4734,7,352851
7926,7.9e-05,74.125.200.0-255,4320,9054,7,352851
7927,8.4e-05,172.31.36.0-255,66,9120,7,352851
7928,0.000111,74.125.200.0-255,6292,15412,7,352851
7929,0.000114,172.31.36.0-255,66,15478,7,352851
7930,0.000121,74.125.200.0-255,7156,22634,7,352851
7931,0.000123,172.31.36.0-255,66,22700,7,352851
7932,0.000147,74.125.200.0-255,1484,24184,7,352851
7933,0.00015,172.31.36.0-255,66,24250,7,352851
7934,0.000178,74.125.200.0-255,6797,31047,7,352851
7935,0.000182,172.31.36.0-255,66,31113,7,352851
7936,0.000224,74.125.200.0-255,1484,32597,7,352851
7937,0.000227,172.31.36.0-255,66,32663,7,352851
7938,0.000253,74.125.200.0-255,2902,35565,7,352851
7939,0.000256,172.31.36.0-255,66,35631,7,352851
7940,0.00029,74.125.200.0-255,4320,39951,7,352851
7941,0.000295,172.31.36.0-255,66,40017,7,352851
7942,0.000331,172.31.36.0-255,66,40083,7,352851
7943,0.000369,172.31.36.0-255,66,40149,7,352851
7944,0.000372,74.125.200.0-255,1484,41633,7,352851
7945,0.000374,172.31.36.0-255,66,41699,7,352851
7946,0.000379,74.125.200.0-255,2902,44601,7,352851
7947,0.000381,172.31.36.0-255,66,44667,7,352851
7948,0.000422,74.125.200.0-255,2902,47569,7,352851
7949,0.000426,172.31.36.0-255,66,47635,7,352851
7950,0.000449,74.125.200.0-255,1436,49071,7,352851
7951,0.000467,74.125.200.0-255,110,49181,7,352851
7952,0.000555,74.125.200.0-255,1484,50665,7,352851
7953,0.000559,172.31.36.0-255,66,50731,7,352851
7954,0.000566,74.125.200.0-255,2902,53633,7,352851
7955,0.000568,172.31.36.0-255,66,53699,7,352851
7956,0.000593,74.125.200.0-255,4320,58019,7,352851
7957,0.000597,172.31.36.0-255,66,58085,7,352851
7958,0.000635,74.125.200.0-255,1484,59569,7,352851
7959,0.000641,74.125.200.0-255,2902,62471,7,352851
7960,0.000643,172.31.36.0-255,66,62537,7,352851
7961,0.000648,74.125.200.0-255,4320,66857,7,352851
7962,0.000651,172.31.36.0-255,66,66923,7,352851
7963,0.000654,74.125.200.0-255,1484,68407,7,352851
7964,0.000657,74.125.200.0-255,1484,69891,7,352851
7965,0.000659,172.31.36.0-255,66,69957,7,352851
7966,0.000688,74.125.200.0-255,1484,71441,7,352851
7967,0.000694,74.125.200.0-255,5738,77179,7,352851
7968,0.000697,172.31.36.0-255,66,77245,7,352851
7969,0.0007,74.125.200.0-255,1484,78729,7,352851
7970,0.000732,74.125.200.0-255,5020,83749,7,352851
7971,0.000736,172.31.36.0-255,66,83815,7,352851
7972,0.000739,74.125.200.0-255,331,84146,7,352851
7973,0.000771,74.125.200.0-255,1484,85630,7,352851
7974,0.000774,172.31.36.0-255,66,85696,7,352851
7975,0.000779,74.125.200.0-255,2902,88598,7,352851
7976,0.000782,172.31.36.0-255,66,88664,7,352851
7977,0.000804,74.125.200.0-255,1484,90148,7,352851
7978,0.000811,74.125.200.0-255,5738,95886,7,352851
7979,0.000818,172.31.36.0-255,66,95952,7,352851
7980,0.000822,74.125.200.0-255,1484,97436,7,352851
7981,0.000845,74.125.200.0-255,5738,103174,7,352851
7982,0.000849,172.31.36.0-255,66,103240,7,352851
7983,0.000891,172.31.36.0-255,66,103306,7,352851
7984,0.000919,74.125.200.0-255,3602,106908,7,352851
7985,0.000922,172.31.36.0-255,66,106974,7,352851
7986,0.000976,74.125.200.0-255,1484,108458,7,352851
7987,0.000993,74.125.200.0-255,2902,111360,7,352851
7988,0.000996,172.31.36.0-255,66,111426,7,352851
7989,0.001,74.125.200.0-255,1484,112910,7,352851
7990,0.001022,74.125.200.0-255,2902,115812,7,352851
7991,0.001025,172.31.36.0-255,66,115878,7,352851
7992,0.001056,74.125.200.0-255,5738,121616,7,352851
7993,0.00106,172.31.36.0-255,66,121682,7,352851
7994,0.001064,74.125.200.0-255,1484,123166,7,352851
7995,0.001098,74.125.200.0-255,2902,126068,7,352851
7996,0.001101,172.31.36.0-255,66,126134,7,352851
7997,0.001134,74.125.200.0-255,4320,130454,7,352851
7998,0.001138,172.31.36.0-255,66,130520,7,352851
7999,0.001145,74.125.200.0-255,5738,136258,7,352851
8000,0.001147,172.31.36.0-255,66,136324,7,352851
8001,0.001167,74.125.200.0-255,2902,139226,7,352851
8002,0.001171,172.31.36.0-255,66,139292,7,352851
8003,0.001176,74.125.200.0-255,2184,141476,7,352851
8004,0.001178,172.31.36.0-255,66,141542,7,352851
8005,0.001419,74.125.200.0-255,1484,143026,7,352851
8006,0.001434,74.125.200.0-255,2902,145928,7,352851
8007,0.001438,172.31.36.0-255,66,145994,7,352851
8008,0.001442,74.125.200.0-255,1484,147478,7,352851
8009,0.001477,74.125.200.0-255,4320,151798,7,352851
8010,0.00148,172.31.36.0-255,66,151864,7,352851
8011,0.001486,74.125.200.0-255,2902,154766,7,352851
8012,0.001488,172.31.36.0-255,66,154832,7,352851
8013,0.001493,74.125.200.0-255,4320,159152,7,352851
8014,0.001495,172.31.36.0-255,66,159218,7,352851
8015,0.001513,172.31.36.0-255,66,159284,7,352851
8016,0.001524,172.31.36.0-255,66,159350,7,352851
8017,0.001653,74.125.200.0-255,1484,160834,7,352851
8018,0.001659,74.125.200.0-255,2902,163736,7,352851
8019,0.001663,172.31.36.0-255,66,163802,7,352851
8020,0.001694,74.125.200.0-255,5738,169540,7,352851
8021,0.001698,172.31.36.0-255,66,169606,7,352851
8022,0.001739,172.31.36.0-255,66,169672,7,352851
8023,0.001745,74.125.200.0-255,4320,173992,7,352851
8024,0.001747,172.31.36.0-255,66,174058,7,352851
8025,0.001776,74.125.200.0-255,6438,180496,7,352851
8026,0.00178,172.31.36.0-255,66,180562,7,352851
8027,0.001839,74.125.200.0-255,1484,182046,7,352851
8028,0.001855,74.125.200.0-255,2902,184948,7,352851
8029,0.001858,172.31.36.0-255,66,185014,7,352851
8030,0.001888,74.125.200.0-255,4320,189334,7,352851
8031,0.001891,172.31.36.0-255,66,189400,7,352851
8032,0.001903,74.125.200.0-255,5738,195138,7,352851
8033,0.001906,172.31.36.0-255,66,195204,7,352851
8034,0.001978,172.31.36.0-255,66,195270,7,352851
8035,0.001985,74.125.200.0-255,5738,201008,7,352851
8036,0.001987,172.31.36.0-255,66,201074,7,352851
8037,0.002014,74.125.200.0-255,3602,204676,7,352851
8038,0.002023,172.31.36.0-255,66,204742,7,352851
8039,0.00203,74.125.200.0-255,5738,210480,7,352851
8040,0.002032,172.31.36.0-255,66,210546,7,352851
8041,0.002057,74.125.200.0-255,4320,214866,7,352851
8042,0.00206,172.31.36.0-255,66,214932,7,352851
8043,0.002071,172.31.36.0-255,66,214998,7,352851
8044,0.002099,74.125.200.0-255,2902,217900,7,352851
8045,0.002104,172.31.36.0-255,66,217966,7,352851
8046,0.002109,74.125.200.0-255,2902,220868,7,352851
8047,0.002111,172.31.36.0-255,66,220934,7,352851
8048,0.004117,74.125.200.0-255,5738,226672,7,352851
8049,0.004125,172.31.36.0-255,66,226738,7,352851
8050,0.006143,74.125.200.0-255,5738,232476,7,352851
8051,0.006146,172.31.36.0-255,66,232542,7,352851
8052,0.008157,74.125.200.0-255,5738,238280,7,352851
8053,0.008163,172.31.36.0-255,66,238346,7,352851
8054,0.0102,74.125.200.0-255,5738,244084,7,352851
8055,0.010208,172.31.36.0-255,66,244150,7,352851
8056,0.012233,74.125.200.0-255,5738,249888,7,352851
8057,0.01224,172.31.36.0-255,66,249954,7,352851
8058,0.014267,74.125.200.0-255,5738,255692,7,352851
8059,0.014278,172.31.36.0-255,66,255758,7,352851
8060,0.0163,74.125.200.0-255,5738,261496,7,352851
8061,0.016308,172.31.36.0-255,66,261562,7,352851
8062,0.018328,74.125.200.0-255,5738,267300,7,352851
8063,0.018335,172.31.36.0-255,66,267366,7,352851
8064,0.020359,74.125.200.0-255,5738,273104,7,352851
8065,0.020369,172.31.36.0-255,66,273170,7,352851
8066,0.022395,74.125.200.0-255,5738,278908,7,352851
8067,0.022402,172.31.36.0-255,66,278974,7,352851
8068,0.024428,74.125.200.0-255,5738,284712,7,352851
8069,0.024435,172.31.36.0-255,66,284778,7,352851
8070,0.026458,74.125.200.0-255,5738,290516,7,352851
8071,0.026465,172.31.36.0-255,66,290582,7,352851
8072,0.028507,74.125.200.0-255,5738,296320,7,352851
8073,0.028513,172.31.36.0-255,66,296386,7,352851
8074,0.029208,172.31.36.0-255,172,296558,7,352851
8075,0.029239,172.31.36.0-255,1115,297673,7,352851
8076,0.029277,172.31.36.0-255,1514,299187,7,352851
8077,0.029278,172.31.36.0-255,1293,300480,7,352851
8078,0.030529,74.125.200.0-255,5738,306218,7,352851
8079,0.030535,172.31.36.0-255,66,306284,7,352851
8080,0.030704,104.244.42.0-255,66,306350,7,352851
8081,0.030724,104.244.42.0-255,66,306416,7,352851
8082,0.03078,104.244.42.0-255,66,306482,7,352851
8083,0.032551,74.125.200.0-255,5738,312220,7,352851
8084,0.032556,172.31.36.0-255,66,312286,7,352851
8085,0.034617,74.125.200.0-255,5738,318024,7,352851
8086,0.034623,172.31.36.0-255,66,318090,7,352851
8087,0.036648,74.125.200.0-255,5738,323828,7,352851
8088,0.036654,172.31.36.0-255,66,323894,7,352851
8089,0.038666,74.125.200.0-255,5738,329632,7,352851
8090,0.038672,172.31.36.0-255,66,329698,7,352851
8091,0.040707,74.125.200.0-255,5738,335436,7,352851
8092,0.040741,172.31.36.0-255,66,335502,7,352851
8093,0.042778,74.125.200.0-255,5738,341240,7,352851
8094,0.042784,172.31.36.0-255,66,341306,7,352851
8095,0.044803,74.125.200.0-255,5738,347044,7,352851
8096,0.044808,172.31.36.0-255,66,347110,7,352851
8097,0.046826,74.125.200.0-255,4979,352089,7,352851
8098,0.046832,172.31.36.0-255,66,352155,7,352851
8099,0.047025,172.31.36.0-255,105,352260,7,352851
8100,0.047051,172.31.36.0-255,105,352365,7,352851
8101,0.047278,172.31.36.0-255,90,352455,7,352851
8102,0.047286,172.31.36.0-255,66,352521,7,352851
8103,0.049014,74.125.200.0-255,66,352587,7,352851
8104,0.049021,74.125.200.0-255,66,352653,7,352851
8105,0.049242,74.125.200.0-255,66,352719,7,352851
8106,0.049275,74.125.200.0-255,66,352785,7,352851
8107,0.049279,172.31.36.0-255,66,352851,7,352851
8108,0.0,74.125.24.0-255,150,150,7,273011
8109,1.4e-05,172.31.36.0-255,66,216,7,273011
8110,2.1e-05,74.125.24.0-255,1484,1700,7,273011
8111,2.5e-05,172.31.36.0-255,66,1766,7,273011
8112,3e-05,74.125.24.0-255,2902,4668,7,273011
8113,3.3e-05,172.31.36.0-255,66,4734,7,273011
8114,4.1e-05,74.125.24.0-255,7156,11890,7,273011
8115,4.4e-05,172.31.36.0-255,66,11956,7,273011
8116,6.1e-05,74.125.24.0-255,2012,13968,7,273011
8117,6.4e-05,172.31.36.0-255,66,14034,7,273011
8118,0.0001,74.125.24.0-255,5738,19772,7,273011
8119,0.000103,172.31.36.0-255,66,19838,7,273011
8120,0.000128,74.125.24.0-255,5738,25576,7,273011
8121,0.00013,172.31.36.0-255,66,25642,7,273011
8122,0.000137,74.125.24.0-255,5379,31021,7,273011
8123,0.000139,172.31.36.0-255,66,31087,7,273011
8124,0.000255,74.125.24.0-255,1484,32571,7,273011
8125,0.00026,172.31.36.0-255,66,32637,7,273011
8126,0.000266,74.125.24.0-255,2902,35539,7,273011
8127,0.000268,172.31.36.0-255,66,35605,7,273011
8128,0.000275,74.125.24.0-255,5738,41343,7,273011
8129,0.000277,172.31.36.0-255,66,41409,7,273011
8130,0.000303,74.125.24.0-255,7156,48565,7,273011
8131,0.000305,172.31.36.0-255,66,48631,7,273011
8132,0.000331,74.125.24.0-255,6797,55428,7,273011
8133,0.000333,172.31.36.0-255,66,55494,7,273011
8134,0.000344,172.31.36.0-255,66,55560,7,273011
8135,0.000384,74.125.24.0-255,1455,57015,7,273011
8136,0.000386,172.31.36.0-255,66,57081,7,273011
8137,0.00039,74.125.24.0-255,113,57194,7,273011
8138,0.000392,172.31.36.0-255,66,57260,7,273011
8139,0.000808,74.125.24.0-255,331,57591,7,273011
8140,0.001006,172.31.36.0-255,66,57657,7,273011
8141,0.001158,74.125.24.0-255,1484,59141,7,273011
8142,0.001167,74.125.24.0-255,2902,62043,7,273011
8143,0.001174,74.125.24.0-255,4320,66363,7,273011
8144,0.001188,74.125.24.0-255,1484,67847,7,273011
8145,0.001227,74.125.24.0-255,1484,69331,7,273011
8146,0.001743,74.125.24.0-255,1484,70815,7,273011
8147,0.001751,74.125.24.0-255,2902,73717,7,273011
8148,0.001757,74.125.24.0-255,5738,79455,7,273011
8149,0.001796,74.125.24.0-255,4320,83775,7,273011
8150,0.001802,74.125.24.0-255,7156,90931,7,273011
8151,0.001835,74.125.24.0-255,3602,94533,7,273011
8152,0.005375,172.31.36.0-255,66,94599,7,273011
8153,0.007767,74.125.24.0-255,5738,100337,7,273011
8154,0.007775,172.31.36.0-255,66,100403,7,273011
8155,0.010152,74.125.24.0-255,5738,106141,7,273011
8156,0.01016,172.31.36.0-255,66,106207,7,273011
8157,0.012516,74.125.24.0-255,5738,111945,7,273011
8158,0.012524,172.31.36.0-255,66,112011,7,273011
8159,0.014898,74.125.24.0-255,5738,117749,7,273011
8160,0.017149,172.31.36.0-255,66,117815,7,273011
8161,0.019526,74.125.24.0-255,5738,123553,7,273011
8162,0.019536,172.31.36.0-255,66,123619,7,273011
8163,0.021893,74.125.24.0-255,5738,129357,7,273011
8164,0.021901,172.31.36.0-255,66,129423,7,273011
8165,0.024287,74.125.24.0-255,5738,135161,7,273011
8166,0.024294,172.31.36.0-255,66,135227,7,273011
8167,0.024923,172.31.36.0-255,172,135399,7,273011
8168,0.024963,172.31.36.0-255,1116,136515,7,273011
8169,0.025028,172.31.36.0-255,1514,138029,7,273011
8170,0.02503,172.31.36.0-255,1292,139321,7,273011
8171,0.026505,104.244.42.0-255,66,139387,7,273011
8172,0.026533,104.244.42.0-255,66,139453,7,273011
8173,0.026576,104.244.42.0-255,66,139519,7,273011
8174,0.026639,74.125.24.0-255,5738,145257,7,273011
8175,0.026644,172.31.36.0-255,66,145323,7,273011
8176,0.029004,74.125.24.0-255,5738,151061,7,273011
8177,0.029011,172.31.36.0-255,66,151127,7,273011
8178,0.031387,74.125.24.0-255,5738,156865,7,273011
8179,0.031394,172.31.36.0-255,66,156931,7,273011
8180,0.033758,74.125.24.0-255,5738,162669,7,273011
8181,0.033765,172.31.36.0-255,66,162735,7,273011
8182,0.036141,74.125.24.0-255,5738,168473,7,273011
8183,0.036146,172.31.36.0-255,66,168539,7,273011
8184,0.038504,74.125.24.0-255,5738,174277,7,273011
8185,0.038511,172.31.36.0-255,66,174343,7,273011
8186,0.040879,74.125.24.0-255,5738,180081,7,273011
8187,0.040886,172.31.36.0-255,66,180147,7,273011
8188,0.043227,74.125.24.0-255,5738,185885,7,273011
8189,0.043233,172.31.36.0-255,66,185951,7,273011
8190,0.045632,74.125.24.0-255,5738,191689,7,273011
8191,0.045638,172.31.36.0-255,66,191755,7,273011
8192,0.048006,74.125.24.0-255,5738,197493,7,273011
8193,0.048013,172.31.36.0-255,66,197559,7,273011
8194,0.050378,74.125.24.0-255,5738,203297,7,273011
8195,0.050384,172.31.36.0-255,66,203363,7,273011
8196,0.05278,74.125.24.0-255,5738,209101,7,273011
8197,0.052786,172.31.36.0-255,66,209167,7,273011
8198,0.055133,74.125.24.0-255,5738,214905,7,273011
8199,0.055142,172.31.36.0-255,66,214971,7,273011
8200,0.057487,74.125.24.0-255,5738,220709,7,273011
8201,0.057493,172.31.36.0-255,66,220775,7,273011
8202,0.059855,74.125.24.0-255,5738,226513,7,273011
8203,0.059862,172.31.36.0-255,66,226579,7,273011
8204,0.06224,74.125.24.0-255,5738,232317,7,273011
8205,0.062247,172.31.36.0-255,66,232383,7,273011
8206,0.064619,74.125.24.0-255,5738,238121,7,273011
8207,0.064626,172.31.36.0-255,66,238187,7,273011
8208,0.066995,74.125.24.0-255,5738,243925,7,273011
8209,0.067002,172.31.36.0-255,66,243991,7,273011
8210,0.069368,74.125.24.0-255,5738,249729,7,273011
8211,0.069374,172.31.36.0-255,66,249795,7,273011
8212,0.071737,74.125.24.0-255,5738,255533,7,273011
8213,0.071743,172.31.36.0-255,66,255599,7,273011
8214,0.074086,74.125.24.0-255,5738,261337,7,273011
8215,0.074092,172.31.36.0-255,66,261403,7,273011
8216,0.07644,74.125.24.0-255,5738,267141,7,273011
8217,0.076446,172.31.36.0-255,66,267207,7,273011
8218,0.078834,74.125.24.0-255,5738,272945,7,273011
8219,0.078852,172.31.36.0-255,66,273011,7,273011
8220,0.0,74.125.24.0-255,153,153,7,392045
8221,2e-05,172.31.36.0-255,66,219,7,392045
8222,2.7e-05,74.125.24.0-255,1484,1703,7,392045
8223,3.2e-05,172.31.36.0-255,66,1769,7,392045
8224,7.9e-05,74.125.24.0-255,2902,4671,7,392045
8225,8.2e-05,172.31.36.0-255,66,4737,7,392045
8226,0.000129,74.125.24.0-255,4320,9057,7,392045
8227,0.000131,172.31.36.0-255,66,9123,7,392045
8228,0.000138,74.125.24.0-255,4890,14013,7,392045
8229,0.00014,172.31.36.0-255,66,14079,7,392045
8230,0.000166,74.125.24.0-255,5738,19817,7,392045
8231,0.000169,172.31.36.0-255,66,19883,7,392045
8232,0.000188,74.125.24.0-255,4320,24203,7,392045
8233,0.00019,172.31.36.0-255,66,24269,7,392045
8234,0.000212,74.125.24.0-255,2902,27171,7,392045
8235,0.000214,172.31.36.0-255,66,27237,7,392045
8236,0.000235,74.125.24.0-255,3961,31198,7,392045
8237,0.000238,172.31.36.0-255,66,31264,7,392045
8238,0.000717,74.125.24.0-255,1484,32748,7,392045
8239,0.000723,172.31.36.0-255,66,32814,7,392045
8240,0.000747,74.125.24.0-255,2902,35716,7,392045
8241,0.00075,172.31.36.0-255,66,35782,7,392045
8242,0.000754,74.125.24.0-255,1484,37266,7,392045
8243,0.000755,172.31.36.0-255,66,37332,7,392045
8244,0.000761,74.125.24.0-255,2902,40234,7,392045
8245,0.000763,172.31.36.0-255,66,40300,7,392045
8246,0.000785,74.125.24.0-255,2902,43202,7,392045
8247,0.000787,172.31.36.0-255,66,43268,7,392045
8248,0.000793,74.125.24.0-255,4320,47588,7,392045
8249,0.000795,172.31.36.0-255,66,47654,7,392045
8250,0.000813,74.125.24.0-255,5379,53033,7,392045
8251,0.000815,172.31.36.0-255,66,53099,7,392045
8252,0.00082,74.125.24.0-255,2902,56001,7,392045
8253,0.000822,172.31.36.0-255,66,56067,7,392045
8254,0.000842,74.125.24.0-255,7156,63223,7,392045
8255,0.000845,172.31.36.0-255,66,63289,7,392045
8256,0.000849,74.125.24.0-255,2853,66142,7,392045
8257,0.000851,172.31.36.0-255,66,66208,7,392045
8258,0.000898,74.125.24.0-255,345,66553,7,392045
8259,0.001003,74.125.24.0-255,1484,68037,7,392045
8260,0.001008,172.31.36.0-255,66,68103,7,392045
8261,0.001014,74.125.24.0-255,2902,71005,7,392045
8262,0.001016,172.31.36.0-255,66,71071,7,392045
8263,0.001032,74.125.24.0-255,5738,76809,7,392045
8264,0.001035,172.31.36.0-255,66,76875,7,392045
8265,0.001077,74.125.24.0-255,6797,83672,7,392045
8266,0.001081,172.31.36.0-255,66,83738,7,392045
8267,0.001118,74.125.24.0-255,5738,89476,7,392045
8268,0.001122,172.31.36.0-255,66,89542,7,392045
8269,0.001144,74.125.24.0-255,7156,96698,7,392045
8270,0.001148,172.31.36.0-255,66,96764,7,392045
8271,0.001227,74.125.24.0-255,3961,100725,7,392045
8272,0.001231,172.31.36.0-255,66,100791,7,392045
8273,0.001348,74.125.24.0-255,1484,102275,7,392045
8274,0.001369,74.125.24.0-255,2902,105177,7,392045
8275,0.001373,172.31.36.0-255,66,105243,7,392045
8276,0.001391,74.125.24.0-255,1484,106727,7,392045
8277,0.001406,74.125.24.0-255,4320,111047,7,392045
8278,0.001409,172.31.36.0-255,66,111113,7,392045
8279,0.001412,74.125.24.0-255,1484,112597,7,392045
8280,0.001417,74.125.24.0-255,2902,115499,7,392045
8281,0.001419,172.31.36.0-255,66,115565,7,392045
8282,0.001435,74.125.24.0-255,5738,121303,7,392045
8283,0.001437,172.31.36.0-255,66,121369,7,392045
8284,0.00148,172.31.36.0-255,66,121435,7,392045
8285,0.001503,74.125.24.0-255,2184,123619,7,392045
8286,0.001505,172.31.36.0-255,66,123685,7,392045
8287,0.001809,74.125.24.0-255,1484,125169,7,392045
8288,0.001818,74.125.24.0-255,2902,128071,7,392045
8289,0.001822,172.31.36.0-255,66,128137,7,392045
8290,0.001842,74.125.24.0-255,2902,131039,7,392045
8291,0.001845,172.31.36.0-255,66,131105,7,392045
8292,0.001862,74.125.24.0-255,2902,134007,7,392045
8293,0.001864,172.31.36.0-255,66,134073,7,392045
8294,0.001869,74.125.24.0-255,2902,136975,7,392045
8295,0.001872,172.31.36.0-255,66,137041,7,392045
8296,0.001903,74.125.24.0-255,7156,144197,7,392045
8297,0.001906,172.31.36.0-255,66,144263,7,392045
8298,0.001925,74.125.24.0-255,2902,147165,7,392045
8299,0.001927,172.31.36.0-255,66,147231,7,392045
8300,0.001941,74.125.24.0-255,4320,151551,7,392045
8301,0.001944,172.31.36.0-255,66,151617,7,392045
8302,0.001962,74.125.24.0-255,5738,157355,7,392045
8303,0.001964,172.31.36.0-255,66,157421,7,392045
8304,0.001967,74.125.24.0-255,766,158187,7,392045
8305,0.003886,74.125.24.0-255,4320,162507,7,392045
8306,0.00389,172.31.36.0-255,66,162573,7,392045
8307,0.005823,74.125.24.0-255,4320,166893,7,392045
8308,0.005827,172.31.36.0-255,66,166959,7,392045
8309,0.005842,74.125.24.0-255,1484,168443,7,392045
8310,0.007758,74.125.24.0-255,4320,172763,7,392045
8311,0.007765,172.31.36.0-255,66,172829,7,392045
8312,0.009716,74.125.24.0-255,5738,178567,7,392045
8313,0.009724,172.31.36.0-255,66,178633,7,392045
8314,0.011676,74.125.24.0-255,5738,184371,7,392045
8315,0.011684,172.31.36.0-255,66,184437,7,392045
8316,0.013615,74.125.24.0-255,5738,190175,7,392045
8317,0.013625,172.31.36.0-255,66,190241,7,392045
8318,0.015541,74.125.24.0-255,5738,195979,7,392045
8319,0.015552,172.31.36.0-255,66,196045,7,392045
8320,0.017456,74.125.24.0-255,5738,201783,7,392045
8321,0.017464,172.31.36.0-255,66,201849,7,392045
8322,0.019385,74.125.24.0-255,5738,207587,7,392045
8323,0.019393,172.31.36.0-255,66,207653,7,392045
8324,0.021326,74.125.24.0-255,5738,213391,7,392045
8325,0.021333,172.31.36.0-255,66,213457,7,392045
8326,0.023244,74.125.24.0-255,5738,219195,7,392045
8327,0.023252,172.31.36.0-255,66,219261,7,392045
8328,0.025182,74.125.24.0-255,5738,224999,7,392045
8329,0.02519,172.31.36.0-255,66,225065,7,392045
8330,0.027094,74.125.24.0-255,5738,230803,7,392045
8331,0.027102,172.31.36.0-255,66,230869,7,392045
8332,0.029017,74.125.24.0-255,5738,236607,7,392045
8333,0.029024,172.31.36.0-255,66,236673,7,392045
8334,0.030949,74.125.24.0-255,5738,242411,7,392045
8335,0.030955,172.31.36.0-255,66,242477,7,392045
8336,0.032721,172.31.36.0-255,176,242653,7,392045
8337,0.032753,172.31.36.0-255,1115,243768,7,392045
8338,0.032813,172.31.36.0-255,1514,245282,7,392045
8339,0.032814,172.31.36.0-255,1291,246573,7,392045
8340,0.032875,74.125.24.0-255,5738,252311,7,392045
8341,0.03288,172.31.36.0-255,66,252377,7,392045
8342,0.034257,104.244.42.0-255,66,252443,7,392045
8343,0.034307,104.244.42.0-255,66,252509,7,392045
8344,0.034347,104.244.42.0-255,66,252575,7,392045
8345,0.034836,74.125.24.0-255,5738,258313,7,392045
8346,0.034842,172.31.36.0-255,66,258379,7,392045
8347,0.034932,104.244.42.0-255,108,258487,7,392045
8348,0.034937,172.31.36.0-255,66,258553,7,392045
8349,0.036776,74.125.24.0-255,5738,264291,7,392045
8350,0.036783,172.31.36.0-255,66,264357,7,392045
8351,0.038719,74.125.24.0-255,5738,270095,7,392045
8352,0.038725,172.31.36.0-255,66,270161,7,392045
8353,0.040654,74.125.24.0-255,5738,275899,7,392045
8354,0.04066,172.31.36.0-255,66,275965,7,392045
8355,0.042601,74.125.24.0-255,5738,281703,7,392045
8356,0.042607,172.31.36.0-255,66,281769,7,392045
8357,0.044542,74.125.24.0-255,5738,287507,7,392045
8358,0.044551,172.31.36.0-255,66,287573,7,392045
8359,0.046486,74.125.24.0-255,5738,293311,7,392045
8360,0.046492,172.31.36.0-255,66,293377,7,392045
8361,0.04841,74.125.24.0-255,5738,299115,7,392045
8362,0.048416,172.31.36.0-255,66,299181,7,392045
8363,0.050368,74.125.24.0-255,5738,304919,7,392045
8364,0.050375,172.31.36.0-255,66,304985,7,392045
8365,0.052294,74.125.24.0-255,5738,310723,7,392045
8366,0.052301,172.31.36.0-255,66,310789,7,392045
8367,0.05422,74.125.24.0-255,5738,316527,7,392045
8368,0.054226,172.31.36.0-255,66,316593,7,392045
8369,0.056175,74.125.24.0-255,5738,322331,7,392045
8370,0.056181,172.31.36.0-255,66,322397,7,392045
8371,0.05812,74.125.24.0-255,5738,328135,7,392045
8372,0.058128,172.31.36.0-255,66,328201,7,392045
8373,0.060058,74.125.24.0-255,5738,333939,7,392045
8374,0.060065,172.31.36.0-255,66,334005,7,392045
8375,0.061977,74.125.24.0-255,5738,339743,7,392045
8376,0.061984,172.31.36.0-255,66,339809,7,392045
8377,0.063905,74.125.24.0-255,5738,345547,7,392045
8378,0.063911,172.31.36.0-255,66,345613,7,392045
8379,0.065831,74.125.24.0-255,5738,351351,7,392045
8380,0.065838,172.31.36.0-255,66,351417,7,392045
8381,0.067764,74.125.24.0-255,5738,357155,7,392045
8382,0.067771,172.31.36.0-255,66,357221,7,392045
8383,0.069771,74.125.24.0-255,5738,362959,7,392045
8384,0.069779,172.31.36.0-255,66,363025,7,392045
8385,0.071765,74.125.24.0-255,5738,368763,7,392045
8386,0.071771,172.31.36.0-255,66,368829,7,392045
8387,0.07371,74.125.24.0-255,5738,374567,7,392045
8388,0.073716,172.31.36.0-255,66,374633,7,392045
8389,0.075647,74.125.24.0-255,5738,380371,7,392045
8390,0.075653,172.31.36.0-255,66,380437,7,392045
8391,0.077576,74.125.24.0-255,5738,386175,7,392045
8392,0.077581,172.31.36.0-255,66,386241,7,392045
8393,0.079561,74.125.24.0-255,5738,391979,7,392045
8394,0.079568,172.31.36.0-255,66,392045,7,392045
8395,0.0,74.125.68.0-255,153,153,7,150454
8396,1.5e-05,172.31.36.0-255,66,219,7,150454
8397,2.2e-05,74.125.68.0-255,1484,1703,7,150454
8398,2.7e-05,172.31.36.0-255,66,1769,7,150454
8399,4e-05,74.125.68.0-255,2902,4671,7,150454
8400,4.3e-05,172.31.36.0-255,66,4737,7,150454
8401,4.6e-05,74.125.68.0-255,1484,6221,7,150454
8402,5e-05,172.31.36.0-255,66,6287,7,150454
8403,7.3e-05,74.125.68.0-255,4320,10607,7,150454
8404,7.7e-05,172.31.36.0-255,66,10673,7,150454
8405,0.000109,74.125.68.0-255,4886,15559,7,150454
8406,0.000112,172.31.36.0-255,66,15625,7,150454
8407,0.000169,74.125.68.0-255,4320,19945,7,150454
8408,0.000172,172.31.36.0-255,66,20011,7,150454
8409,0.000195,74.125.68.0-255,1484,21495,7,150454
8410,0.000197,172.31.36.0-255,66,21561,7,150454
8411,0.000241,74.125.68.0-255,5738,27299,7,150454
8412,0.000244,172.31.36.0-255,66,27365,7,150454
8413,0.000271,74.125.68.0-255,3961,31326,7,150454
8414,0.000274,172.31.36.0-255,66,31392,7,150454
8415,0.000358,74.125.68.0-255,1484,32876,7,150454
8416,0.000362,172.31.36.0-255,66,32942,7,150454
8417,0.000401,172.31.36.0-255,66,33008,7,150454
8418,0.000524,74.125.68.0-255,2543,35551,7,150454
8419,0.000529,172.31.36.0-255,66,35617,7,150454
8420,0.000554,74.125.68.0-255,1484,37101,7,150454
8421,0.000557,172.31.36.0-255,66,37167,7,150454
8422,0.000602,172.31.36.0-255,66,37233,7,150454
8423,0.000783,172.31.36.0-255,66,37299,7,150454
8424,0.000837,172.31.36.0-255,66,37365,7,150454
8425,0.001031,74.125.68.0-255,4320,41685,7,150454
8426,0.001035,172.31.36.0-255,66,41751,7,150454
8427,0.001076,172.31.36.0-255,66,41817,7,150454
8428,0.001219,74.125.68.0-255,5738,47555,7,150454
8429,0.001223,172.31.36.0-255,66,47621,7,150454
8430,0.001273,172.31.36.0-255,66,47687,7,150454
8431,0.001448,74.125.68.0-255,7156,54843,7,150454
8432,0.001453,172.31.36.0-255,66,54909,7,150454
8433,0.001546,172.31.36.0-255,66,54975,7,150454
8434,0.001556,74.125.68.0-255,2884,57859,7,150454
8435,0.001563,172.31.36.0-255,66,57925,7,150454
8436,0.00201,172.31.36.0-255,66,57991,7,150454
8437,0.002084,172.31.36.0-255,66,58057,7,150454
8438,0.002647,74.125.68.0-255,7156,65213,7,150454
8439,0.002652,172.31.36.0-255,66,65279,7,150454
8440,0.002683,74.125.68.0-255,6438,71717,7,150454
8441,0.002814,74.125.68.0-255,7156,78873,7,150454
8442,0.002903,74.125.68.0-255,5738,84611,7,150454
8443,0.003685,74.125.68.0-255,7156,91767,7,150454
8444,0.006518,172.31.36.0-255,66,91833,7,150454
8445,0.008787,74.125.68.0-255,5738,97571,7,150454
8446,0.008794,172.31.36.0-255,66,97637,7,150454
8447,0.011085,74.125.68.0-255,5738,103375,7,150454
8448,0.011092,172.31.36.0-255,66,103441,7,150454
8449,0.013369,74.125.68.0-255,5738,109179,7,150454
8450,0.013377,172.31.36.0-255,66,109245,7,150454
8451,0.015633,74.125.68.0-255,5738,114983,7,150454
8452,0.015641,172.31.36.0-255,66,115049,7,150454
8453,0.017916,74.125.68.0-255,5738,120787,7,150454
8454,0.017925,172.31.36.0-255,66,120853,7,150454
8455,0.020199,74.125.68.0-255,5738,126591,7,150454
8456,0.020208,172.31.36.0-255,66,126657,7,150454
8457,0.022468,74.125.68.0-255,5738,132395,7,150454
8458,0.022475,172.31.36.0-255,66,132461,7,150454
8459,0.024732,74.125.68.0-255,5738,138199,7,150454
8460,0.024739,172.31.36.0-255,66,138265,7,150454
8461,0.027002,74.125.68.0-255,4589,142854,7,150454
8462,0.027009,172.31.36.0-255,66,142920,7,150454
8463,0.027198,172.31.36.0-255,105,143025,7,150454
8464,0.029422,74.125.68.0-255,66,143091,7,150454
8465,0.032871,172.31.36.0-255,192,143283,7,150454
8466,0.0329,172.31.36.0-255,1116,144399,7,150454
8467,0.032963,172.31.36.0-255,1514,145913,7,150454
8468,0.032965,172.31.36.0-255,1514,147427,7,150454
8469,0.032966,172.31.36.0-255,1514,148941,7,150454
8470,0.032968,172.31.36.0-255,1075,150016,7,150454
8471,0.034418,104.244.42.0-255,66,150082,7,150454
8472,0.034468,104.244.42.0-255,66,150148,7,150454
8473,0.034514,104.244.42.0-255,66,150214,7,150454
8474,0.034527,104.244.42.0-255,66,150280,7,150454
8475,0.035204,104.244.42.0-255,108,150388,7,150454
8476,0.035212,172.31.36.0-255,66,150454,7,150454
8477,0.0,172.217.160.0-255,153,153,7,361306
8478,2.8e-05,172.31.36.0-255,66,219,7,361306
8479,3.5e-05,172.217.160.0-255,1484,1703,7,361306
8480,3.9e-05,172.31.36.0-255,66,1769,7,361306
8481,4.3e-05,172.217.160.0-255,2902,4671,7,361306
8482,4.6e-05,172.31.36.0-255,66,4737,7,361306
8483,4.8e-05,172.217.160.0-255,1484,6221,7,361306
8484,5.1e-05,172.31.36.0-255,66,6287,7,361306
8485,7.4e-05,172.217.160.0-255,4320,10607,7,361306
8486,7.6e-05,172.31.36.0-255,66,10673,7,361306
8487,9.4e-05,172.217.160.0-255,3433,14106,7,361306
8488,9.6e-05,172.31.36.0-255,66,14172,7,361306
8489,0.000132,172.217.160.0-255,1484,15656,7,361306
8490,0.000135,172.31.36.0-255,66,15722,7,361306
8491,0.00014,172.217.160.0-255,2902,18624,7,361306
8492,0.000142,172.31.36.0-255,66,18690,7,361306
8493,0.000154,172.217.160.0-255,1484,20174,7,361306
8494,0.000157,172.31.36.0-255,66,20240,7,361306
8495,0.000178,172.217.160.0-255,4320,24560,7,361306
8496,0.000181,172.31.36.0-255,66,24626,7,361306
8497,0.000185,172.217.160.0-255,2902,27528,7,361306
8498,0.000186,172.31.36.0-255,66,27594,7,361306
8499,0.000212,172.217.160.0-255,2902,30496,7,361306
8500,0.000215,172.31.36.0-255,66,30562,7,361306
8501,0.000218,172.217.160.0-255,1125,31687,7,361306
8502,0.00022,172.31.36.0-255,66,31753,7,361306
8503,0.000255,172.217.160.0-255,1484,33237,7,361306
8504,0.000258,172.31.36.0-255,66,33303,7,361306
8505,0.000281,172.217.160.0-255,4320,37623,7,361306
8506,0.000284,172.31.36.0-255,66,37689,7,361306
8507,0.000286,172.217.160.0-255,1484,39173,7,361306
8508,0.000288,172.31.36.0-255,66,39239,7,361306
8509,0.000298,172.217.160.0-255,7156,46395,7,361306
8510,0.0003,172.31.36.0-255,66,46461,7,361306
8511,0.000345,172.217.160.0-255,2543,49004,7,361306
8512,0.000348,172.31.36.0-255,66,49070,7,361306
8513,0.0004,172.217.160.0-255,1484,50554,7,361306
8514,0.000423,172.217.160.0-255,2902,53456,7,361306
8515,0.000426,172.31.36.0-255,66,53522,7,361306
8516,0.000432,172.217.160.0-255,4320,57842,7,361306
8517,0.000435,172.31.36.0-255,66,57908,7,361306
8518,0.00048,172.217.160.0-255,5738,63646,7,361306
8519,0.000483,172.31.36.0-255,66,63712,7,361306
8520,0.000503,172.217.160.0-255,2543,66255,7,361306
8521,0.000505,172.31.36.0-255,66,66321,7,361306
8522,0.000577,172.217.160.0-255,333,66654,7,361306
8523,0.000804,172.31.36.0-255,66,66720,7,361306
8524,0.00099,172.217.160.0-255,410,67130,7,361306
8525,0.001035,172.217.160.0-255,1484,68614,7,361306
8526,0.00104,172.31.36.0-255,66,68680,7,361306
8527,0.001045,172.217.160.0-255,1484,70164,7,361306
8528,0.001057,172.217.160.0-255,1484,71648,7,361306
8529,0.00106,172.31.36.0-255,66,71714,7,361306
8530,0.001067,172.217.160.0-255,5738,77452,7,361306
8531,0.001069,172.31.36.0-255,66,77518,7,361306
8532,0.001113,172.217.160.0-255,4320,81838,7,361306
8533,0.001117,172.31.36.0-255,66,81904,7,361306
8534,0.001133,172.217.160.0-255,2543,84447,7,361306
8535,0.001136,172.31.36.0-255,66,84513,7,361306
8536,0.001149,172.217.160.0-255,1484,85997,7,361306
8537,0.001171,172.217.160.0-255,5738,91735,7,361306
8538,0.001174,172.31.36.0-255,66,91801,7,361306
8539,0.001189,172.217.160.0-255,4320,96121,7,361306
8540,0.001192,172.31.36.0-255,66,96187,7,361306
8541,0.001217,172.217.160.0-255,5379,101566,7,361306
8542,0.00122,172.31.36.0-255,66,101632,7,361306
8543,0.001762,172.217.160.0-255,1484,103116,7,361306
8544,0.00177,172.217.160.0-255,2902,106018,7,361306
8545,0.001774,172.31.36.0-255,66,106084,7,361306
8546,0.001781,172.217.160.0-255,5738,111822,7,361306
8547,0.001783,172.31.36.0-255,66,111888,7,361306
8548,0.001786,172.217.160.0-255,1484,113372,7,361306
8549,0.001808,172.31.36.0-255,66,113438,7,361306
8550,0.001814,172.217.160.0-255,5738,119176,7,361306
8551,0.001817,172.31.36.0-255,66,119242,7,361306
8552,0.001894,172.217.160.0-255,4320,123562,7,361306
8553,0.001896,172.31.36.0-255,66,123628,7,361306
8554,0.001906,172.217.160.0-255,766,124394,7,361306
8555,0.003246,172.31.36.0-255,66,124460,7,361306
8556,0.003776,172.217.160.0-255,4320,128780,7,361306
8557,0.003781,172.31.36.0-255,66,128846,7,361306
8558,0.005145,172.217.160.0-255,1484,130330,7,361306
8559,0.005656,172.217.160.0-255,2902,133232,7,361306
8560,0.005659,172.31.36.0-255,66,133298,7,361306
8561,0.005676,172.217.160.0-255,1484,134782,7,361306
8562,0.007548,172.217.160.0-255,4320,139102,7,361306
8563,0.007557,172.31.36.0-255,66,139168,7,361306
8564,0.009471,172.217.160.0-255,5738,144906,7,361306
8565,0.00948,172.31.36.0-255,66,144972,7,361306
8566,0.011381,172.217.160.0-255,5738,150710,7,361306
8567,0.011391,172.31.36.0-255,66,150776,7,361306
8568,0.013291,172.217.160.0-255,5738,156514,7,361306
8569,0.013305,172.31.36.0-255,66,156580,7,361306
8570,0.015216,172.217.160.0-255,5738,162318,7,361306
8571,0.015234,172.31.36.0-255,66,162384,7,361306
8572,0.01713,172.217.160.0-255,5738,168122,7,361306
8573,0.017142,172.31.36.0-255,66,168188,7,361306
8574,0.019043,172.217.160.0-255,5738,173926,7,361306
8575,0.019056,172.31.36.0-255,66,173992,7,361306
8576,0.020943,172.217.160.0-255,5738,179730,7,361306
8577,0.020953,172.31.36.0-255,66,179796,7,361306
8578,0.022864,172.217.160.0-255,5738,185534,7,361306
8579,0.022876,172.31.36.0-255,66,185600,7,361306
8580,0.024782,172.217.160.0-255,5738,191338,7,361306
8581,0.024802,172.31.36.0-255,66,191404,7,361306
8582,0.026702,172.217.160.0-255,5738,197142,7,361306
8583,0.026715,172.31.36.0-255,66,197208,7,361306
8584,0.028058,172.31.36.0-255,172,197380,7,361306
8585,0.028093,172.31.36.0-255,1116,198496,7,361306
8586,0.028125,172.31.36.0-255,1514,200010,7,361306
8587,0.028127,172.31.36.0-255,1290,201300,7,361306
8588,0.028597,172.217.160.0-255,5738,207038,7,361306
8589,0.028605,172.31.36.0-255,66,207104,7,361306
8590,0.029632,104.244.42.0-255,66,207170,7,361306
8591,0.029679,104.244.42.0-255,66,207236,7,361306
8592,0.029683,104.244.42.0-255,66,207302,7,361306
8593,0.030489,172.217.160.0-255,4320,211622,7,361306
8594,0.030498,172.31.36.0-255,66,211688,7,361306
8595,0.03053,172.217.160.0-255,1484,213172,7,361306
8596,0.032403,172.217.160.0-255,4320,217492,7,361306
8597,0.03241,172.31.36.0-255,66,217558,7,361306
8598,0.034299,172.217.160.0-255,5738,223296,7,361306
8599,0.034309,172.31.36.0-255,66,223362,7,361306
8600,0.036191,172.217.160.0-255,5738,229100,7,361306
8601,0.036201,172.31.36.0-255,66,229166,7,361306
8602,0.038094,172.217.160.0-255,5738,234904,7,361306
8603,0.038103,172.31.36.0-255,66,234970,7,361306
8604,0.040014,172.217.160.0-255,5738,240708,7,361306
8605,0.040023,172.31.36.0-255,66,240774,7,361306
8606,0.041928,172.217.160.0-255,5738,246512,7,361306
8607,0.041946,172.31.36.0-255,66,246578,7,361306
8608,0.043844,172.217.160.0-255,5738,252316,7,361306
8609,0.043857,172.31.36.0-255,66,252382,7,361306
8610,0.04575,172.217.160.0-255,5738,258120,7,361306
8611,0.045761,172.31.36.0-255,66,258186,7,361306
8612,0.047653,172.217.160.0-255,5738,263924,7,361306
8613,0.047666,172.31.36.0-255,66,263990,7,361306
8614,0.049548,172.217.160.0-255,5738,269728,7,361306
8615,0.049555,172.31.36.0-255,66,269794,7,361306
8616,0.051446,172.217.160.0-255,5738,275532,7,361306
8617,0.051455,172.31.36.0-255,66,275598,7,361306
8618,0.053343,172.217.160.0-255,5738,281336,7,361306
8619,0.053353,172.31.36.0-255,66,281402,7,361306
8620,0.055254,172.217.160.0-255,5738,287140,7,361306
8621,0.055264,172.31.36.0-255,66,287206,7,361306
8622,0.057152,172.217.160.0-255,5738,292944,7,361306
8623,0.057163,172.31.36.0-255,66,293010,7,361306
8624,0.059075,172.217.160.0-255,5738,298748,7,361306
8625,0.059083,172.31.36.0-255,66,298814,7,361306
8626,0.060969,172.217.160.0-255,5738,304552,7,361306
8627,0.060978,172.31.36.0-255,66,304618,7,361306
8628,0.062866,172.217.160.0-255,5738,310356,7,361306
8629,0.06288,172.31.36.0-255,66,310422,7,361306
8630,0.064761,172.217.160.0-255,5738,316160,7,361306
8631,0.064769,172.31.36.0-255,66,316226,7,361306
8632,0.066662,172.217.160.0-255,5738,321964,7,361306
8633,0.066685,172.31.36.0-255,66,322030,7,361306
8634,0.068561,172.217.160.0-255,5738,327768,7,361306
8635,0.068567,172.31.36.0-255,66,327834,7,361306
8636,0.070443,172.217.160.0-255,5738,333572,7,361306
8637,0.07045,172.31.36.0-255,66,333638,7,361306
8638,0.072328,172.217.160.0-255,5738,339376,7,361306
8639,0.072334,172.31.36.0-255,66,339442,7,361306
8640,0.074217,172.217.160.0-255,5738,345180,7,361306
8641,0.074223,172.31.36.0-255,66,345246,7,361306
8642,0.076107,172.217.160.0-255,4320,349566,7,361306
8643,0.076113,172.31.36.0-255,66,349632,7,361306
8644,0.076144,172.217.160.0-255,1484,351116,7,361306
8645,0.078001,172.217.160.0-255,4320,355436,7,361306
8646,0.078007,172.31.36.0-255,66,355502,7,361306
8647,0.079904,172.217.160.0-255,5738,361240,7,361306
8648,0.079913,172.31.36.0-255,66,361306,7,361306
8649,0.0,172.217.194.0-255,150,150,7,334178
8650,1.7e-05,172.31.36.0-255,66,216,7,334178
8651,2.4e-05,172.217.194.0-255,1484,1700,7,334178
8652,2.9e-05,172.31.36.0-255,66,1766,7,334178
8653,3.5e-05,172.217.194.0-255,2902,4668,7,334178
8654,3.8e-05,172.31.36.0-255,66,4734,7,334178
8655,4.5e-05,172.217.194.0-255,5738,10472,7,334178
8656,4.9e-05,172.31.36.0-255,66,10538,7,334178
8657,7.3e-05,172.217.194.0-255,1484,12022,7,334178
8658,7.5e-05,172.31.36.0-255,66,12088,7,334178
8659,8e-05,172.217.194.0-255,2902,14990,7,334178
8660,8.2e-05,172.31.36.0-255,66,15056,7,334178
8661,0.000113,172.31.36.0-255,66,15122,7,334178
8662,0.000117,172.217.194.0-255,2543,17665,7,334178
8663,0.000121,172.31.36.0-255,66,17731,7,334178
8664,0.00016,172.217.194.0-255,1484,19215,7,334178
8665,0.000162,172.31.36.0-255,66,19281,7,334178
8666,0.000167,172.217.194.0-255,2902,22183,7,334178
8667,0.00017,172.31.36.0-255,66,22249,7,334178
8668,0.000193,172.217.194.0-255,5738,27987,7,334178
8669,0.000196,172.31.36.0-255,66,28053,7,334178
8670,0.000204,172.217.194.0-255,6797,34850,7,334178
8671,0.000206,172.31.36.0-255,66,34916,7,334178
8672,0.000258,172.31.36.0-255,66,34982,7,334178
8673,0.000263,172.217.194.0-255,2833,37815,7,334178
8674,0.000265,172.31.36.0-255,66,37881,7,334178
8675,0.000577,172.217.194.0-255,365,38246,7,334178
8676,0.000582,172.31.36.0-255,66,38312,7,334178
8677,0.000717,172.217.194.0-255,1484,39796,7,334178
8678,0.000721,172.31.36.0-255,66,39862,7,334178
8679,0.000726,172.217.194.0-255,2902,42764,7,334178
8680,0.000728,172.31.36.0-255,66,42830,7,334178
8681,0.000734,172.217.194.0-255,4320,47150,7,334178
8682,0.000736,172.31.36.0-255,66,47216,7,334178
8683,0.000754,172.217.194.0-255,1484,48700,7,334178
8684,0.000777,172.217.194.0-255,6248,54948,7,334178
8685,0.000781,172.31.36.0-255,66,55014,7,334178
8686,0.000838,172.217.194.0-255,1484,56498,7,334178
8687,0.000856,172.217.194.0-255,2902,59400,7,334178
8688,0.000859,172.31.36.0-255,66,59466,7,334178
8689,0.000864,172.217.194.0-255,2902,62368,7,334178
8690,0.000866,172.31.36.0-255,66,62434,7,334178
8691,0.000869,172.217.194.0-255,1484,63918,7,334178
8692,0.000895,172.217.194.0-255,5738,69656,7,334178
8693,0.000898,172.31.36.0-255,66,69722,7,334178
8694,0.000934,172.31.36.0-255,66,69788,7,334178
8695,0.000938,172.217.194.0-255,3602,73390,7,334178
8696,0.00094,172.31.36.0-255,66,73456,7,334178
8697,0.001468,172.217.194.0-255,1484,74940,7,334178
8698,0.001475,172.217.194.0-255,2902,77842,7,334178
8699,0.001478,172.31.36.0-255,66,77908,7,334178
8700,0.001485,172.217.194.0-255,5738,83646,7,334178
8701,0.001487,172.31.36.0-255,66,83712,7,334178
8702,0.001511,172.217.194.0-255,2902,86614,7,334178
8703,0.001514,172.31.36.0-255,66,86680,7,334178
8704,0.001545,172.31.36.0-255,66,86746,7,334178
8705,0.001553,172.217.194.0-255,7156,93902,7,334178
8706,0.001555,172.31.36.0-255,66,93968,7,334178
8707,0.001583,172.217.194.0-255,3602,97570,7,334178
8708,0.001586,172.31.36.0-255,66,97636,7,334178
8709,0.002164,172.217.194.0-255,1484,99120,7,334178
8710,0.002175,172.217.194.0-255,2902,102022,7,334178
8711,0.002179,172.31.36.0-255,66,102088,7,334178
8712,0.002186,172.217.194.0-255,5738,107826,7,334178
8713,0.002189,172.31.36.0-255,66,107892,7,334178
8714,0.002195,172.217.194.0-255,4320,112212,7,334178
8715,0.002197,172.31.36.0-255,66,112278,7,334178
8716,0.002222,172.217.194.0-255,2902,115180,7,334178
8717,0.002224,172.31.36.0-255,66,115246,7,334178
8718,0.002236,172.31.36.0-255,66,115312,7,334178
8719,0.002255,172.217.194.0-255,4320,119632,7,334178
8720,0.002257,172.31.36.0-255,66,119698,7,334178
8721,0.002261,172.217.194.0-255,2184,121882,7,334178
8722,0.002263,172.31.36.0-255,66,121948,7,334178
8723,0.002301,172.217.194.0-255,1484,123432,7,334178
8724,0.002315,172.217.194.0-255,2902,126334,7,334178
8725,0.002317,172.31.36.0-255,66,126400,7,334178
8726,0.002343,172.217.194.0-255,5738,132138,7,334178
8727,0.002345,172.31.36.0-255,66,132204,7,334178
8728,0.002352,172.217.194.0-255,5738,137942,7,334178
8729,0.002355,172.31.36.0-255,66,138008,7,334178
8730,0.002378,172.217.194.0-255,2902,140910,7,334178
8731,0.00238,172.31.36.0-255,66,140976,7,334178
8732,0.002423,172.217.194.0-255,5738,146714,7,334178
8733,0.002425,172.31.36.0-255,66,146780,7,334178
8734,0.002458,172.31.36.0-255,66,146846,7,334178
8735,0.004864,172.217.194.0-255,5738,152584,7,334178
8736,0.004871,172.31.36.0-255,66,152650,7,334178
8737,0.007295,172.217.194.0-255,5738,158388,7,334178
8738,0.007301,172.31.36.0-255,66,158454,7,334178
8739,0.009708,172.217.194.0-255,5738,164192,7,334178
8740,0.009715,172.31.36.0-255,66,164258,7,334178
8741,0.012099,172.217.194.0-255,5738,169996,7,334178
8742,0.012108,172.31.36.0-255,66,170062,7,334178
8743,0.014515,172.217.194.0-255,5738,175800,7,334178
8744,0.014524,172.31.36.0-255,66,175866,7,334178
8745,0.016955,172.217.194.0-255,5738,181604,7,334178
8746,0.016972,172.31.36.0-255,66,181670,7,334178
8747,0.019372,172.217.194.0-255,5738,187408,7,334178
8748,0.019384,172.31.36.0-255,66,187474,7,334178
8749,0.021791,172.217.194.0-255,5738,193212,7,334178
8750,0.021801,172.31.36.0-255,66,193278,7,334178
8751,0.024205,172.217.194.0-255,5738,199016,7,334178
8752,0.024214,172.31.36.0-255,66,199082,7,334178
8753,0.026669,172.217.194.0-255,5738,204820,7,334178
8754,0.026679,172.31.36.0-255,66,204886,7,334178
8755,0.029082,172.217.194.0-255,5738,210624,7,334178
8756,0.029091,172.31.36.0-255,66,210690,7,334178
8757,0.031496,172.217.194.0-255,5738,216428,7,334178
8758,0.031505,172.31.36.0-255,66,216494,7,334178
8759,0.033888,172.217.194.0-255,5738,222232,7,334178
8760,0.033897,172.31.36.0-255,66,222298,7,334178
8761,0.036289,172.217.194.0-255,5738,228036,7,334178
8762,0.036296,172.31.36.0-255,66,228102,7,334178
8763,0.036855,172.31.36.0-255,189,228291,7,334178
8764,0.036886,172.31.36.0-255,1115,229406,7,334178
8765,0.03695,172.31.36.0-255,1514,230920,7,334178
8766,0.036951,172.31.36.0-255,1292,232212,7,334178
8767,0.03841,104.244.42.0-255,66,232278,7,334178
8768,0.038438,104.244.42.0-255,66,232344,7,334178
8769,0.038485,104.244.42.0-255,66,232410,7,334178
8770,0.038726,172.217.194.0-255,5738,238148,7,334178
8771,0.038737,172.31.36.0-255,66,238214,7,334178
8772,0.041139,172.217.194.0-255,5738,243952,7,334178
8773,0.041148,172.31.36.0-255,66,244018,7,334178
8774,0.043562,172.217.194.0-255,5738,249756,7,334178
8775,0.043568,172.31.36.0-255,66,249822,7,334178
8776,0.045972,172.217.194.0-255,5738,255560,7,334178
8777,0.04598,172.31.36.0-255,66,255626,7,334178
8778,0.048384,172.217.194.0-255,5738,261364,7,334178
8779,0.04839,172.31.36.0-255,66,261430,7,334178
8780,0.05079,172.217.194.0-255,5738,267168,7,334178
8781,0.050797,172.31.36.0-255,66,267234,7,334178
8782,0.053209,172.217.194.0-255,5738,272972,7,334178
8783,0.053217,172.31.36.0-255,66,273038,7,334178
8784,0.055619,172.217.194.0-255,4320,277358,7,334178
8785,0.055626,172.31.36.0-255,66,277424,7,334178
8786,0.055643,172.217.194.0-255,1484,278908,7,334178
8787,0.058038,172.217.194.0-255,4320,283228,7,334178
8788,0.058049,172.31.36.0-255,66,283294,7,334178
8789,0.06044,172.217.194.0-255,5738,289032,7,334178
8790,0.060447,172.31.36.0-255,66,289098,7,334178
8791,0.062846,172.217.194.0-255,5738,294836,7,334178
8792,0.062853,172.31.36.0-255,66,294902,7,334178
8793,0.065248,172.217.194.0-255,5738,300640,7,334178
8794,0.065255,172.31.36.0-255,66,300706,7,334178
8795,0.067662,172.217.194.0-255,5738,306444,7,334178
8796,0.06767,172.31.36.0-255,66,306510,7,334178
8797,0.070053,172.217.194.0-255,5738,312248,7,334178
8798,0.07006,172.31.36.0-255,66,312314,7,334178
8799,0.072469,172.217.194.0-255,4320,316634,7,334178
8800,0.072476,172.31.36.0-255,66,316700,7,334178
8801,0.072497,172.217.194.0-255,1484,318184,7,334178
8802,0.07486,172.217.194.0-255,4320,322504,7,334178
8803,0.074868,172.31.36.0-255,66,322570,7,334178
8804,0.077281,172.217.194.0-255,5738,328308,7,334178
8805,0.077288,172.31.36.0-255,66,328374,7,334178
8806,0.079675,172.217.194.0-255,5738,334112,7,334178
8807,0.079687,172.31.36.0-255,66,334178,7,334178
8808,0.0,74.125.24.0-255,155,155,7,276479
8809,2.5e-05,172.31.36.0-255,66,221,7,276479
8810,3.3e-05,74.125.24.0-255,1484,1705,7,276479
8811,3.8e-05,172.31.36.0-255,66,1771,7,276479
8812,5.2e-05,74.125.24.0-255,2902,4673,7,276479
8813,5.7e-05,172.31.36.0-255,66,4739,7,276479
8814,6.2e-05,74.125.24.0-255,4320,9059,7,276479
8815,6.6e-05,172.31.36.0-255,66,9125,7,276479
8816,8.8e-05,74.125.24.0-255,4886,14011,7,276479
8817,9.5e-05,172.31.36.0-255,66,14077,7,276479
8818,0.000125,74.125.24.0-255,5738,19815,7,276479
8819,0.000128,172.31.36.0-255,66,19881,7,276479
8820,0.000134,74.125.24.0-255,2902,22783,7,276479
8821,0.000136,172.31.36.0-255,66,22849,7,276479
8822,0.000154,74.125.24.0-255,1484,24333,7,276479
8823,0.00016,172.31.36.0-255,66,24399,7,276479
8824,0.000191,74.125.24.0-255,6797,31196,7,276479
8825,0.000194,172.31.36.0-255,66,31262,7,276479
8826,0.000262,74.125.24.0-255,1484,32746,7,276479
8827,0.000264,172.31.36.0-255,66,32812,7,276479
8828,0.00029,74.125.24.0-255,2902,35714,7,276479
8829,0.000293,172.31.36.0-255,66,35780,7,276479
8830,0.0003,74.125.24.0-255,4320,40100,7,276479
8831,0.000302,172.31.36.0-255,66,40166,7,276479
8832,0.000333,74.125.24.0-255,4320,44486,7,276479
8833,0.000336,172.31.36.0-255,66,44552,7,276479
8834,0.000361,74.125.24.0-255,5379,49931,7,276479
8835,0.000363,172.31.36.0-255,66,49997,7,276479
8836,0.000375,172.31.36.0-255,66,50063,7,276479
8837,0.000411,74.125.24.0-255,5692,55755,7,276479
8838,0.000413,172.31.36.0-255,66,55821,7,276479
8839,0.000894,74.125.24.0-255,108,55929,7,276479
8840,0.000928,74.125.24.0-255,1484,57413,7,276479
8841,0.000933,172.31.36.0-255,66,57479,7,276479
8842,0.000938,74.125.24.0-255,1484,58963,7,276479
8843,0.00096,74.125.24.0-255,1484,60447,7,276479
8844,0.000962,172.31.36.0-255,66,60513,7,276479
8845,0.000971,74.125.24.0-255,7156,67669,7,276479
8846,0.000974,172.31.36.0-255,66,67735,7,276479
8847,0.001036,172.31.36.0-255,66,67801,7,276479
8848,0.001047,74.125.24.0-255,5738,73539,7,276479
8849,0.001054,172.31.36.0-255,66,73605,7,276479
8850,0.001061,74.125.24.0-255,5738,79343,7,276479
8851,0.001063,172.31.36.0-255,66,79409,7,276479
8852,0.001076,172.31.36.0-255,66,79475,7,276479
8853,0.001082,74.125.24.0-255,7156,86631,7,276479
8854,0.001085,172.31.36.0-255,66,86697,7,276479
8855,0.00111,74.125.24.0-255,2902,89599,7,276479
8856,0.001113,172.31.36.0-255,66,89665,7,276479
8857,0.001131,172.31.36.0-255,66,89731,7,276479
8858,0.001162,74.125.24.0-255,2450,92181,7,276479
8859,0.001166,172.31.36.0-255,66,92247,7,276479
8860,0.001202,74.125.24.0-255,1484,93731,7,276479
8861,0.001206,74.125.24.0-255,1484,95215,7,276479
8862,0.001208,172.31.36.0-255,66,95281,7,276479
8863,0.001235,74.125.24.0-255,1484,96765,7,276479
8864,0.001241,74.125.24.0-255,5738,102503,7,276479
8865,0.001243,172.31.36.0-255,66,102569,7,276479
8866,0.001249,74.125.24.0-255,4320,106889,7,276479
8867,0.001251,172.31.36.0-255,66,106955,7,276479
8868,0.001284,172.31.36.0-255,66,107021,7,276479
8869,0.001291,74.125.24.0-255,7156,114177,7,276479
8870,0.001293,172.31.36.0-255,66,114243,7,276479
8871,0.001317,74.125.24.0-255,3602,117845,7,276479
8872,0.00132,172.31.36.0-255,66,117911,7,276479
8873,0.001355,74.125.24.0-255,2902,120813,7,276479
8874,0.001358,172.31.36.0-255,66,120879,7,276479
8875,0.00139,74.125.24.0-255,1484,122363,7,276479
8876,0.001397,74.125.24.0-255,4320,126683,7,276479
8877,0.001399,172.31.36.0-255,66,126749,7,276479
8878,0.001412,172.31.36.0-255,66,126815,7,276479
8879,0.001446,74.125.24.0-255,5738,132553,7,276479
8880,0.001449,172.31.36.0-255,66,132619,7,276479
8881,0.001474,172.31.36.0-255,66,132685,7,276479
8882,0.001618,74.125.24.0-255,1484,134169,7,276479
8883,0.001626,74.125.24.0-255,2902,137071,7,276479
8884,0.001628,172.31.36.0-255,66,137137,7,276479
8885,0.001636,74.125.24.0-255,5738,142875,7,276479
8886,0.001639,172.31.36.0-255,66,142941,7,276479
8887,0.001692,172.31.36.0-255,66,143007,7,276479
8888,0.001706,172.31.36.0-255,66,143073,7,276479
8889,0.00179,74.125.24.0-255,1484,144557,7,276479
8890,0.001795,74.125.24.0-255,2902,147459,7,276479
8891,0.001798,172.31.36.0-255,66,147525,7,276479
8892,0.001828,74.125.24.0-255,5738,153263,7,276479
8893,0.001831,172.31.36.0-255,66,153329,7,276479
8894,0.001834,74.125.24.0-255,1484,154813,7,276479
8895,0.001861,74.125.24.0-255,4320,159133,7,276479
8896,0.001864,172.31.36.0-255,66,159199,7,276479
8897,0.001877,74.125.24.0-255,5738,164937,7,276479
8898,0.001879,172.31.36.0-255,66,165003,7,276479
8899,0.001912,74.125.24.0-255,7156,172159,7,276479
8900,0.001915,172.31.36.0-255,66,172225,7,276479
8901,0.001921,74.125.24.0-255,5020,177245,7,276479
8902,0.001924,172.31.36.0-255,66,177311,7,276479
8903,0.001976,74.125.24.0-255,1484,178795,7,276479
8904,0.001988,74.125.24.0-255,2902,181697,7,276479
8905,0.001993,172.31.36.0-255,66,181763,7,276479
8906,0.002022,74.125.24.0-255,5738,187501,7,276479
8907,0.002025,172.31.36.0-255,66,187567,7,276479
8908,0.002038,172.31.36.0-255,66,187633,7,276479
8909,0.002061,74.125.24.0-255,4320,191953,7,276479
8910,0.002063,172.31.36.0-255,66,192019,7,276479
8911,0.002072,74.125.24.0-255,4320,196339,7,276479
8912,0.002075,172.31.36.0-255,66,196405,7,276479
8913,0.002113,74.125.24.0-255,6438,202843,7,276479
8914,0.002117,172.31.36.0-255,66,202909,7,276479
8915,0.00212,74.125.24.0-255,1484,204393,7,276479
8916,0.002151,172.31.36.0-255,66,204459,7,276479
8917,0.002183,74.125.24.0-255,1484,205943,7,276479
8918,0.002196,172.31.36.0-255,66,206009,7,276479
8919,0.0022,74.125.24.0-255,1484,207493,7,276479
8920,0.002202,74.125.24.0-255,1484,208977,7,276479
8921,0.002205,172.31.36.0-255,66,209043,7,276479
8922,0.002241,172.31.36.0-255,66,209109,7,276479
8923,0.002244,74.125.24.0-255,766,209875,7,276479
8924,0.002395,74.125.24.0-255,1484,211359,7,276479
8925,0.002399,74.125.24.0-255,2902,214261,7,276479
8926,0.002401,74.125.24.0-255,1484,215745,7,276479
8927,0.002407,172.31.36.0-255,66,215811,7,276479
8928,0.002415,172.31.36.0-255,66,215877,7,276479
8929,0.002422,74.125.24.0-255,4320,220197,7,276479
8930,0.002424,172.31.36.0-255,66,220263,7,276479
8931,0.002429,74.125.24.0-255,2902,223165,7,276479
8932,0.002437,172.31.36.0-255,66,223231,7,276479
8933,0.00247,74.125.24.0-255,4320,227551,7,276479
8934,0.002472,172.31.36.0-255,66,227617,7,276479
8935,0.002475,74.125.24.0-255,1484,229101,7,276479
8936,0.002491,172.31.36.0-255,66,229167,7,276479
8937,0.002499,74.125.24.0-255,6438,235605,7,276479
8938,0.002501,172.31.36.0-255,66,235671,7,276479
8939,0.002602,74.125.24.0-255,1484,237155,7,276479
8940,0.002608,74.125.24.0-255,2902,240057,7,276479
8941,0.002612,172.31.36.0-255,66,240123,7,276479
8942,0.002617,74.125.24.0-255,2902,243025,7,276479
8943,0.00262,172.31.36.0-255,66,243091,7,276479
8944,0.002641,74.125.24.0-255,2902,245993,7,276479
8945,0.002648,74.125.24.0-255,5738,251731,7,276479
8946,0.002652,172.31.36.0-255,66,251797,7,276479
8947,0.002666,172.31.36.0-255,66,251863,7,276479
8948,0.002674,74.125.24.0-255,7156,259019,7,276479
8949,0.002681,172.31.36.0-255,66,259085,7,276479
8950,0.002692,172.31.36.0-255,66,259151,7,276479
8951,0.002722,74.125.24.0-255,4320,263471,7,276479
8952,0.002725,172.31.36.0-255,66,263537,7,276479
8953,0.002751,172.31.36.0-255,66,263603,7,276479
8954,0.002781,74.125.24.0-255,4650,268253,7,276479
8955,0.002784,172.31.36.0-255,66,268319,7,276479
8956,0.002788,74.125.24.0-255,105,268424,7,276479
8957,0.002895,74.125.24.0-255,129,268553,7,276479
8958,0.005288,172.31.36.0-255,105,268658,7,276479
8959,0.005329,172.31.36.0-255,105,268763,7,276479
8960,0.005606,172.31.36.0-255,90,268853,7,276479
8961,0.005624,172.31.36.0-255,66,268919,7,276479
8962,0.007331,74.125.24.0-255,66,268985,7,276479
8963,0.007346,74.125.24.0-255,66,269051,7,276479
8964,0.007609,74.125.24.0-255,66,269117,7,276479
8965,0.00763,74.125.24.0-255,66,269183,7,276479
8966,0.007639,172.31.36.0-255,66,269249,7,276479
8967,0.007674,74.125.24.0-255,66,269315,7,276479
8968,0.034926,172.31.36.0-255,171,269486,7,276479
8969,0.03496,172.31.36.0-255,1138,270624,7,276479
8970,0.035023,172.31.36.0-255,1514,272138,7,276479
8971,0.035025,172.31.36.0-255,1514,273652,7,276479
8972,0.03503,172.31.36.0-255,1514,275166,7,276479
8973,0.035032,172.31.36.0-255,1049,276215,7,276479
8974,0.036457,104.244.42.0-255,66,276281,7,276479
8975,0.036604,104.244.42.0-255,66,276347,7,276479
8976,0.036639,104.244.42.0-255,66,276413,7,276479
8977,0.03666,104.244.42.0-255,66,276479,7,276479
8978,0.0,172.217.194.0-255,143,143,7,205250
8979,3.3e-05,172.31.36.0-255,66,209,7,205250
8980,4e-05,172.217.194.0-255,1484,1693,7,205250
8981,4.5e-05,172.31.36.0-255,66,1759,7,205250
8982,5e-05,172.217.194.0-255,2902,4661,7,205250
8983,5.4e-05,172.31.36.0-255,66,4727,7,205250
8984,6e-05,172.217.194.0-255,5738,10465,7,205250
8985,6.3e-05,172.31.36.0-255,66,10531,7,205250
8986,0.000105,172.217.194.0-255,3481,14012,7,205250
8987,0.000108,172.31.36.0-255,66,14078,7,205250
8988,0.00014,172.217.194.0-255,1484,15562,7,205250
8989,0.000144,172.31.36.0-255,66,15628,7,205250
8990,0.000158,172.217.194.0-255,2902,18530,7,205250
8991,0.000161,172.31.36.0-255,66,18596,7,205250
8992,0.000166,172.217.194.0-255,5738,24334,7,205250
8993,0.000168,172.31.36.0-255,66,24400,7,205250
8994,0.000216,172.31.36.0-255,66,24466,7,205250
8995,0.000229,172.31.36.0-255,66,24532,7,205250
8996,0.000268,172.217.194.0-255,6797,31329,7,205250
8997,0.00027,172.31.36.0-255,66,31395,7,205250
8998,0.000277,172.217.194.0-255,7156,38551,7,205250
8999,0.00028,172.31.36.0-255,66,38617,7,205250
9000,0.000314,172.31.36.0-255,66,38683,7,205250
9001,0.000333,172.217.194.0-255,397,39080,7,205250
9002,0.000335,172.31.36.0-255,66,39146,7,205250
9003,0.000622,172.217.194.0-255,378,39524,7,205250
9004,0.000626,172.31.36.0-255,66,39590,7,205250
9005,0.000894,172.217.194.0-255,1484,41074,7,205250
9006,0.000899,172.31.36.0-255,66,41140,7,205250
9007,0.000907,172.217.194.0-255,2902,44042,7,205250
9008,0.00091,172.31.36.0-255,66,44108,7,205250
9009,0.000914,172.217.194.0-255,1484,45592,7,205250
9010,0.000937,172.217.194.0-255,4320,49912,7,205250
9011,0.00094,172.31.36.0-255,66,49978,7,205250
9012,0.00095,172.31.36.0-255,66,50044,7,205250
9013,0.000973,172.217.194.0-255,4320,54364,7,205250
9014,0.000976,172.31.36.0-255,66,54430,7,205250
9015,0.000988,172.31.36.0-255,66,54496,7,205250
9016,0.000991,172.217.194.0-255,766,55262,7,205250
9017,0.001372,172.217.194.0-255,1484,56746,7,205250
9018,0.001378,172.31.36.0-255,66,56812,7,205250
9019,0.001384,172.217.194.0-255,2902,59714,7,205250
9020,0.001386,172.31.36.0-255,66,59780,7,205250
9021,0.001393,172.217.194.0-255,5738,65518,7,205250
9022,0.001395,172.31.36.0-255,66,65584,7,205250
9023,0.001436,172.31.36.0-255,66,65650,7,205250
9024,0.001469,172.217.194.0-255,5738,71388,7,205250
9025,0.001471,172.31.36.0-255,66,71454,7,205250
9026,0.00149,172.217.194.0-255,5020,76474,7,205250
9027,0.001492,172.31.36.0-255,66,76540,7,205250
9028,0.001516,172.217.194.0-255,1484,78024,7,205250
9029,0.001521,172.217.194.0-255,2902,80926,7,205250
9030,0.001524,172.31.36.0-255,66,80992,7,205250
9031,0.001546,172.217.194.0-255,5738,86730,7,205250
9032,0.001548,172.31.36.0-255,66,86796,7,205250
9033,0.001577,172.31.36.0-255,66,86862,7,205250
9034,0.001614,172.217.194.0-255,5738,92600,7,205250
9035,0.001617,172.31.36.0-255,66,92666,7,205250
9036,0.001638,172.217.194.0-255,5020,97686,7,205250
9037,0.00164,172.31.36.0-255,66,97752,7,205250
9038,0.001764,172.217.194.0-255,1484,99236,7,205250
9039,0.001769,172.217.194.0-255,2902,102138,7,205250
9040,0.001771,172.31.36.0-255,66,102204,7,205250
9041,0.00179,172.217.194.0-255,5738,107942,7,205250
9042,0.001793,172.31.36.0-255,66,108008,7,205250
9043,0.00181,172.217.194.0-255,2902,110910,7,205250
9044,0.001812,172.31.36.0-255,66,110976,7,205250
9045,0.00184,172.31.36.0-255,66,111042,7,205250
9046,0.001851,172.31.36.0-255,66,111108,7,205250
9047,0.001853,172.217.194.0-255,766,111874,7,205250
9048,0.001933,172.217.194.0-255,1484,113358,7,205250
9049,0.001936,172.31.36.0-255,66,113424,7,205250
9050,0.001941,172.217.194.0-255,2902,116326,7,205250
9051,0.001944,172.31.36.0-255,66,116392,7,205250
9052,0.001948,172.217.194.0-255,2902,119294,7,205250
9053,0.001951,172.31.36.0-255,66,119360,7,205250
9054,0.001974,172.217.194.0-255,2902,122262,7,205250
9055,0.001977,172.31.36.0-255,66,122328,7,205250
9056,0.002025,172.31.36.0-255,66,122394,7,205250
9057,0.002054,172.217.194.0-255,2902,125296,7,205250
9058,0.002057,172.31.36.0-255,66,125362,7,205250
9059,0.002071,172.31.36.0-255,66,125428,7,205250
9060,0.002087,172.31.36.0-255,66,125494,7,205250
9061,0.002093,172.217.194.0-255,5738,131232,7,205250
9062,0.002096,172.31.36.0-255,66,131298,7,205250
9063,0.00213,172.31.36.0-255,66,131364,7,205250
9064,0.00224,172.217.194.0-255,1484,132848,7,205250
9065,0.002245,172.217.194.0-255,1484,134332,7,205250
9066,0.002248,172.31.36.0-255,66,134398,7,205250
9067,0.002268,172.217.194.0-255,1484,135882,7,205250
9068,0.002274,172.217.194.0-255,5738,141620,7,205250
9069,0.002277,172.31.36.0-255,66,141686,7,205250
9070,0.002283,172.217.194.0-255,5738,147424,7,205250
9071,0.002285,172.31.36.0-255,66,147490,7,205250
9072,0.002325,172.31.36.0-255,66,147556,7,205250
9073,0.002328,172.217.194.0-255,1484,149040,7,205250
9074,0.002331,172.31.36.0-255,78,149118,7,205250
9075,0.002337,172.217.194.0-255,5738,154856,7,205250
9076,0.00234,172.31.36.0-255,78,154934,7,205250
9077,0.002358,172.217.194.0-255,5020,159954,7,205250
9078,0.002362,172.31.36.0-255,66,160020,7,205250
9079,0.002376,172.31.36.0-255,66,160086,7,205250
9080,0.002383,172.217.194.0-255,7156,167242,7,205250
9081,0.002385,172.31.36.0-255,66,167308,7,205250
9082,0.002403,172.217.194.0-255,2902,170210,7,205250
9083,0.002406,172.31.36.0-255,66,170276,7,205250
9084,0.002411,172.217.194.0-255,2184,172460,7,205250
9085,0.002413,172.31.36.0-255,66,172526,7,205250
9086,0.002431,172.217.194.0-255,2902,175428,7,205250
9087,0.002434,172.31.36.0-255,78,175506,7,205250
9088,0.002457,172.217.194.0-255,2184,177690,7,205250
9089,0.00246,172.31.36.0-255,78,177768,7,205250
9090,0.002485,172.31.36.0-255,66,177834,7,205250
9091,0.002731,172.217.194.0-255,1484,179318,7,205250
9092,0.002748,172.217.194.0-255,2902,182220,7,205250
9093,0.002751,172.31.36.0-255,66,182286,7,205250
9094,0.002758,172.217.194.0-255,5738,188024,7,205250
9095,0.00276,172.31.36.0-255,66,188090,7,205250
9096,0.002784,172.217.194.0-255,2902,190992,7,205250
9097,0.002787,172.31.36.0-255,66,191058,7,205250
9098,0.002809,172.31.36.0-255,66,191124,7,205250
9099,0.002831,172.217.194.0-255,4320,195444,7,205250
9100,0.002834,172.31.36.0-255,66,195510,7,205250
9101,0.002863,172.31.36.0-255,66,195576,7,205250
9102,0.00292,172.31.36.0-255,66,195642,7,205250
9103,0.002923,172.217.194.0-255,105,195747,7,205250
9104,0.004672,172.31.36.0-255,66,195813,7,205250
9105,0.004699,172.31.36.0-255,105,195918,7,205250
9106,0.007018,172.217.194.0-255,66,195984,7,205250
9107,0.040945,172.31.36.0-255,182,196166,7,205250
9108,0.040979,172.31.36.0-255,1115,197281,7,205250
9109,0.041033,172.31.36.0-255,1514,198795,7,205250
9110,0.041034,172.31.36.0-255,1514,200309,7,205250
9111,0.041036,172.31.36.0-255,1514,201823,7,205250
9112,0.041041,172.31.36.0-255,1514,203337,7,205250
9113,0.041042,172.31.36.0-255,1514,204851,7,205250
9114,0.041043,172.31.36.0-255,69,204920,7,205250
9115,0.042485,104.244.42.0-255,66,204986,7,205250
9116,0.042537,104.244.42.0-255,66,205052,7,205250
9117,0.042592,104.244.42.0-255,66,205118,7,205250
9118,0.042643,104.244.42.0-255,66,205184,7,205250
9119,0.042645,104.244.42.0-255,66,205250,7,205250
9120,0.0,172.31.36.0-255,249,249,7,315
9121,0.006602,74.125.24.0-255,66,315,7,315
9122,0.0,74.125.130.0-255,153,153,7,364613
9123,2.9e-05,172.31.36.0-255,66,219,7,364613
9124,3.6e-05,74.125.130.0-255,1484,1703,7,364613
9125,4.1e-05,172.31.36.0-255,66,1769,7,364613
9126,5.4e-05,74.125.130.0-255,2902,4671,7,364613
9127,5.7e-05,172.31.36.0-255,66,4737,7,364613
9128,6.3e-05,74.125.130.0-255,5738,10475,7,364613
9129,6.5e-05,172.31.36.0-255,66,10541,7,364613
9130,9.3e-05,74.125.130.0-255,7156,17697,7,364613
9131,0.000103,172.31.36.0-255,66,17763,7,364613
9132,0.00013,74.125.130.0-255,6308,24071,7,364613
9133,0.000134,172.31.36.0-255,66,24137,7,364613
9134,0.000141,74.125.130.0-255,6797,30934,7,364613
9135,0.000143,172.31.36.0-255,66,31000,7,364613
9136,0.000233,74.125.130.0-255,1484,32484,7,364613
9137,0.000237,172.31.36.0-255,66,32550,7,364613
9138,0.000243,74.125.130.0-255,2902,35452,7,364613
9139,0.000245,172.31.36.0-255,66,35518,7,364613
9140,0.000277,74.125.130.0-255,5738,41256,7,364613
9141,0.000281,172.31.36.0-255,66,41322,7,364613
9142,0.000288,74.125.130.0-255,5738,47060,7,364613
9143,0.000291,172.31.36.0-255,66,47126,7,364613
9144,0.00032,74.125.130.0-255,2543,49669,7,364613
9145,0.000323,172.31.36.0-255,66,49735,7,364613
9146,0.00034,172.31.36.0-255,66,49801,7,364613
9147,0.000372,74.125.130.0-255,6797,56598,7,364613
9148,0.000376,172.31.36.0-255,66,56664,7,364613
9149,0.000378,74.125.130.0-255,380,57044,7,364613
9150,0.00038,172.31.36.0-255,66,57110,7,364613
9151,0.000522,74.125.130.0-255,363,57473,7,364613
9152,0.000526,172.31.36.0-255,66,57539,7,364613
9153,0.000823,74.125.130.0-255,1484,59023,7,364613
9154,0.000834,74.125.130.0-255,2902,61925,7,364613
9155,0.000837,172.31.36.0-255,66,61991,7,364613
9156,0.000841,74.125.130.0-255,1484,63475,7,364613
9157,0.00087,74.125.130.0-255,4320,67795,7,364613
9158,0.000874,172.31.36.0-255,66,67861,7,364613
9159,0.000912,74.125.130.0-255,7156,75017,7,364613
9160,0.000916,172.31.36.0-255,66,75083,7,364613
9161,0.000944,74.125.130.0-255,5738,80821,7,364613
9162,0.000947,172.31.36.0-255,66,80887,7,364613
9163,0.000965,172.31.36.0-255,66,80953,7,364613
9164,0.000968,74.125.130.0-255,217,81170,7,364613
9165,0.001026,74.125.130.0-255,1484,82654,7,364613
9166,0.001029,172.31.36.0-255,66,82720,7,364613
9167,0.001035,74.125.130.0-255,2902,85622,7,364613
9168,0.001037,172.31.36.0-255,66,85688,7,364613
9169,0.001064,74.125.130.0-255,5738,91426,7,364613
9170,0.001068,172.31.36.0-255,66,91492,7,364613
9171,0.001108,172.31.36.0-255,66,91558,7,364613
9172,0.001125,172.31.36.0-255,66,91624,7,364613
9173,0.001659,74.125.130.0-255,1484,93108,7,364613
9174,0.001665,74.125.130.0-255,2902,96010,7,364613
9175,0.001669,172.31.36.0-255,66,96076,7,364613
9176,0.001675,74.125.130.0-255,2902,98978,7,364613
9177,0.001678,172.31.36.0-255,66,99044,7,364613
9178,0.001702,74.125.130.0-255,2902,101946,7,364613
9179,0.001707,172.31.36.0-255,66,102012,7,364613
9180,0.00171,74.125.130.0-255,7156,109168,7,364613
9181,0.001717,172.31.36.0-255,66,109234,7,364613
9182,0.001741,74.125.130.0-255,2902,112136,7,364613
9183,0.001745,172.31.36.0-255,66,112202,7,364613
9184,0.00176,74.125.130.0-255,2184,114386,7,364613
9185,0.00176,172.31.36.0-255,66,114452,7,364613
9186,0.001763,172.31.36.0-255,66,114518,7,364613
9187,0.001872,74.125.130.0-255,1484,116002,7,364613
9188,0.001877,74.125.130.0-255,2902,118904,7,364613
9189,0.001879,74.125.130.0-255,1484,120388,7,364613
9190,0.001881,172.31.36.0-255,66,120454,7,364613
9191,0.00191,74.125.130.0-255,4320,124774,7,364613
9192,0.001914,172.31.36.0-255,66,124840,7,364613
9193,0.001921,74.125.130.0-255,5738,130578,7,364613
9194,0.001923,172.31.36.0-255,66,130644,7,364613
9195,0.001935,74.125.130.0-255,7156,137800,7,364613
9196,0.001938,172.31.36.0-255,66,137866,7,364613
9197,0.001979,172.31.36.0-255,66,137932,7,364613
9198,0.002003,74.125.130.0-255,1484,139416,7,364613
9199,0.003959,74.125.130.0-255,4320,143736,7,364613
9200,0.003965,172.31.36.0-255,66,143802,7,364613
9201,0.005942,74.125.130.0-255,5738,149540,7,364613
9202,0.005946,172.31.36.0-255,66,149606,7,364613
9203,0.007918,74.125.130.0-255,5738,155344,7,364613
9204,0.007924,172.31.36.0-255,66,155410,7,364613
9205,0.0099,74.125.130.0-255,5738,161148,7,364613
9206,0.009906,172.31.36.0-255,66,161214,7,364613
9207,0.011884,74.125.130.0-255,5738,166952,7,364613
9208,0.01189,172.31.36.0-255,66,167018,7,364613
9209,0.013861,74.125.130.0-255,2902,169920,7,364613
9210,0.013868,172.31.36.0-255,66,169986,7,364613
9211,0.013907,74.125.130.0-255,2902,172888,7,364613
9212,0.01391,172.31.36.0-255,66,172954,7,364613
9213,0.015848,74.125.130.0-255,2902,175856,7,364613
9214,0.015855,172.31.36.0-255,66,175922,7,364613
9215,0.015895,74.125.130.0-255,2902,178824,7,364613
9216,0.015899,172.31.36.0-255,66,178890,7,364613
9217,0.017829,74.125.130.0-255,2902,181792,7,364613
9218,0.017835,172.31.36.0-255,66,181858,7,364613
9219,0.017878,74.125.130.0-255,2902,184760,7,364613
9220,0.017882,172.31.36.0-255,66,184826,7,364613
9221,0.019807,74.125.130.0-255,2902,187728,7,364613
9222,0.019815,172.31.36.0-255,66,187794,7,364613
9223,0.019855,74.125.130.0-255,2902,190696,7,364613
9224,0.019858,172.31.36.0-255,66,190762,7,364613
9225,0.02179,74.125.130.0-255,2902,193664,7,364613
9226,0.021798,172.31.36.0-255,66,193730,7,364613
9227,0.021835,74.125.130.0-255,2902,196632,7,364613
9228,0.021839,172.31.36.0-255,66,196698,7,364613
9229,0.023769,74.125.130.0-255,2902,199600,7,364613
9230,0.023777,172.31.36.0-255,66,199666,7,364613
9231,0.023818,74.125.130.0-255,2902,202568,7,364613
9232,0.023821,172.31.36.0-255,66,202634,7,364613
9233,0.025784,74.125.130.0-255,1484,204118,7,364613
9234,0.025818,74.125.130.0-255,4320,208438,7,364613
9235,0.025824,172.31.36.0-255,66,208504,7,364613
9236,0.0278,74.125.130.0-255,5738,214242,7,364613
9237,0.027808,172.31.36.0-255,66,214308,7,364613
9238,0.027821,172.31.36.0-255,172,214480,7,364613
9239,0.027845,172.31.36.0-255,1115,215595,7,364613
9240,0.027947,172.31.36.0-255,1514,217109,7,364613
9241,0.027949,172.31.36.0-255,1293,218402,7,364613
9242,0.029333,104.244.42.0-255,66,218468,7,364613
9243,0.029375,104.244.42.0-255,66,218534,7,364613
9244,0.02947,104.244.42.0-255,66,218600,7,364613
9245,0.029797,74.125.130.0-255,4320,222920,7,364613
9246,0.029802,172.31.36.0-255,66,222986,7,364613
9247,0.029837,74.125.130.0-255,1484,224470,7,364613
9248,0.031768,74.125.130.0-255,4320,228790,7,364613
9249,0.031774,172.31.36.0-255,66,228856,7,364613
9250,0.033749,74.125.130.0-255,5738,234594,7,364613
9251,0.033755,172.31.36.0-255,66,234660,7,364613
9252,0.035731,74.125.130.0-255,2902,237562,7,364613
9253,0.035736,172.31.36.0-255,66,237628,7,364613
9254,0.035782,74.125.130.0-255,2902,240530,7,364613
9255,0.035785,172.31.36.0-255,66,240596,7,364613
9256,0.037706,74.125.130.0-255,2902,243498,7,364613
9257,0.037711,172.31.36.0-255,66,243564,7,364613
9258,0.037746,74.125.130.0-255,2902,246466,7,364613
9259,0.037749,172.31.36.0-255,66,246532,7,364613
9260,0.039675,74.125.130.0-255,2902,249434,7,364613
9261,0.03968,172.31.36.0-255,66,249500,7,364613
9262,0.039714,74.125.130.0-255,2902,252402,7,364613
9263,0.039717,172.31.36.0-255,66,252468,7,364613
9264,0.041655,74.125.130.0-255,2902,255370,7,364613
9265,0.04166,172.31.36.0-255,66,255436,7,364613
9266,0.041707,74.125.130.0-255,2902,258338,7,364613
9267,0.041711,172.31.36.0-255,66,258404,7,364613
9268,0.043623,74.125.130.0-255,2902,261306,7,364613
9269,0.043629,172.31.36.0-255,66,261372,7,364613
9270,0.043666,74.125.130.0-255,1484,262856,7,364613
9271,0.043684,74.125.130.0-255,1484,264340,7,364613
9272,0.043687,172.31.36.0-255,66,264406,7,364613
9273,0.045598,74.125.130.0-255,2902,267308,7,364613
9274,0.045602,172.31.36.0-255,66,267374,7,364613
9275,0.045645,74.125.130.0-255,2902,270276,7,364613
9276,0.045649,172.31.36.0-255,66,270342,7,364613
9277,0.047564,74.125.130.0-255,2902,273244,7,364613
9278,0.047569,172.31.36.0-255,66,273310,7,364613
9279,0.047608,74.125.130.0-255,2902,276212,7,364613
9280,0.047612,172.31.36.0-255,66,276278,7,364613
9281,0.04953,74.125.130.0-255,2902,279180,7,364613
9282,0.049535,172.31.36.0-255,66,279246,7,364613
9283,0.049576,74.125.130.0-255,2902,282148,7,364613
9284,0.04958,172.31.36.0-255,66,282214,7,364613
9285,0.051498,74.125.130.0-255,2902,285116,7,364613
9286,0.051503,172.31.36.0-255,66,285182,7,364613
9287,0.05154,74.125.130.0-255,2902,288084,7,364613
9288,0.051544,172.31.36.0-255,66,288150,7,364613
9289,0.053491,74.125.130.0-255,2902,291052,7,364613
9290,0.053496,172.31.36.0-255,66,291118,7,364613
9291,0.053527,74.125.130.0-255,2902,294020,7,364613
9292,0.05353,172.31.36.0-255,66,294086,7,364613
9293,0.055456,74.125.130.0-255,2902,296988,7,364613
9294,0.055462,172.31.36.0-255,66,297054,7,364613
9295,0.055498,74.125.130.0-255,2902,299956,7,364613
9296,0.055501,172.31.36.0-255,66,300022,7,364613
9297,0.057427,74.125.130.0-255,2902,302924,7,364613
9298,0.057433,172.31.36.0-255,66,302990,7,364613
9299,0.057468,74.125.130.0-255,2902,305892,7,364613
9300,0.057471,172.31.36.0-255,66,305958,7,364613
9301,0.05939,74.125.130.0-255,1484,307442,7,364613
9302,0.05942,74.125.130.0-255,1484,308926,7,364613
9303,0.059425,172.31.36.0-255,66,308992,7,364613
9304,0.059444,74.125.130.0-255,2902,311894,7,364613
9305,0.059446,172.31.36.0-255,66,311960,7,364613
9306,0.061399,74.125.130.0-255,4320,316280,7,364613
9307,0.061405,172.31.36.0-255,66,316346,7,364613
9308,0.061441,74.125.130.0-255,1484,317830,7,364613
9309,0.063368,74.125.130.0-255,4320,322150,7,364613
9310,0.063373,172.31.36.0-255,66,322216,7,364613
9311,0.065351,74.125.130.0-255,5738,327954,7,364613
9312,0.065355,172.31.36.0-255,66,328020,7,364613
9313,0.067322,74.125.130.0-255,5738,333758,7,364613
9314,0.067327,172.31.36.0-255,66,333824,7,364613
9315,0.069296,74.125.130.0-255,5738,339562,7,364613
9316,0.069301,172.31.36.0-255,66,339628,7,364613
9317,0.071273,74.125.130.0-255,5738,345366,7,364613
9318,0.071278,172.31.36.0-255,66,345432,7,364613
9319,0.073258,74.125.130.0-255,4320,349752,7,364613
9320,0.073263,172.31.36.0-255,66,349818,7,364613
9321,0.073293,74.125.130.0-255,1484,351302,7,364613
9322,0.075233,74.125.130.0-255,4320,355622,7,364613
9323,0.075239,172.31.36.0-255,66,355688,7,364613
9324,0.077211,74.125.130.0-255,5738,361426,7,364613
9325,0.077216,172.31.36.0-255,66,361492,7,364613
9326,0.079186,74.125.130.0-255,2950,364442,7,364613
9327,0.079191,172.31.36.0-255,66,364508,7,364613
9328,0.079375,172.31.36.0-255,105,364613,7,364613
9329,0.0,74.125.24.0-255,150,150,7,282479
9330,1.9e-05,172.31.36.0-255,66,216,7,282479
9331,2.6e-05,74.125.24.0-255,1484,1700,7,282479
9332,3.1e-05,172.31.36.0-255,66,1766,7,282479
9333,3.7e-05,74.125.24.0-255,2902,4668,7,282479
9334,4.1e-05,172.31.36.0-255,66,4734,7,282479
9335,4.9e-05,74.125.24.0-255,7156,11890,7,282479
9336,5.2e-05,172.31.36.0-255,66,11956,7,282479
9337,0.000151,74.125.24.0-255,2029,13985,7,282479
9338,0.000155,172.31.36.0-255,66,14051,7,282479
9339,0.000185,74.125.24.0-255,5738,19789,7,282479
9340,0.000188,172.31.36.0-255,66,19855,7,282479
9341,0.000282,172.31.36.0-255,66,19921,7,282479
9342,0.000411,74.125.24.0-255,1125,21046,7,282479
9343,0.000416,172.31.36.0-255,66,21112,7,282479
9344,0.000436,74.125.24.0-255,2902,24014,7,282479
9345,0.000439,172.31.36.0-255,66,24080,7,282479
9346,0.000469,172.31.36.0-255,66,24146,7,282479
9347,0.00066,172.31.36.0-255,66,24212,7,282479
9348,0.000688,172.31.36.0-255,66,24278,7,282479
9349,0.000951,74.125.24.0-255,376,24654,7,282479
9350,0.000955,172.31.36.0-255,66,24720,7,282479
9351,0.000971,74.125.24.0-255,1484,26204,7,282479
9352,0.000973,172.31.36.0-255,66,26270,7,282479
9353,0.001006,74.125.24.0-255,4320,30590,7,282479
9354,0.001009,172.31.36.0-255,66,30656,7,282479
9355,0.001062,74.125.24.0-255,2902,33558,7,282479
9356,0.001065,172.31.36.0-255,66,33624,7,282479
9357,0.001086,74.125.24.0-255,7156,40780,7,282479
9358,0.001093,172.31.36.0-255,66,40846,7,282479
9359,0.001221,74.125.24.0-255,5738,46584,7,282479
9360,0.001226,172.31.36.0-255,66,46650,7,282479
9361,0.001257,172.31.36.0-255,66,46716,7,282479
9362,0.001497,74.125.24.0-255,1484,48200,7,282479
9363,0.001518,74.125.24.0-255,2902,51102,7,282479
9364,0.001522,172.31.36.0-255,66,51168,7,282479
9365,0.001562,74.125.24.0-255,5738,56906,7,282479
9366,0.001577,172.31.36.0-255,66,56972,7,282479
9367,0.001674,74.125.24.0-255,4320,61292,7,282479
9368,0.001678,172.31.36.0-255,66,61358,7,282479
9369,0.001683,172.31.36.0-255,66,61424,7,282479
9370,0.001853,74.125.24.0-255,5738,67162,7,282479
9371,0.001857,172.31.36.0-255,66,67228,7,282479
9372,0.001878,74.125.24.0-255,5020,72248,7,282479
9373,0.002028,74.125.24.0-255,1484,73732,7,282479
9374,0.002047,74.125.24.0-255,2902,76634,7,282479
9375,0.002086,74.125.24.0-255,4320,80954,7,282479
9376,0.002097,74.125.24.0-255,1484,82438,7,282479
9377,0.002205,74.125.24.0-255,7156,89594,7,282479
9378,0.002223,74.125.24.0-255,5738,95332,7,282479
9379,0.002755,74.125.24.0-255,3602,98934,7,282479
9380,0.007419,172.31.36.0-255,66,99000,7,282479
9381,0.009697,74.125.24.0-255,5738,104738,7,282479
9382,0.009705,172.31.36.0-255,66,104804,7,282479
9383,0.011984,74.125.24.0-255,5738,110542,7,282479
9384,0.012308,172.31.36.0-255,66,110608,7,282479
9385,0.014579,74.125.24.0-255,5738,116346,7,282479
9386,0.014593,172.31.36.0-255,66,116412,7,282479
9387,0.016913,74.125.24.0-255,5738,122150,7,282479
9388,0.016923,172.31.36.0-255,66,122216,7,282479
9389,0.019222,74.125.24.0-255,5738,127954,7,282479
9390,0.019233,172.31.36.0-255,66,128020,7,282479
9391,0.021502,74.125.24.0-255,5738,133758,7,282479
9392,0.021509,172.31.36.0-255,66,133824,7,282479
9393,0.023802,74.125.24.0-255,5738,139562,7,282479
9394,0.023809,172.31.36.0-255,66,139628,7,282479
9395,0.026073,74.125.24.0-255,5738,145366,7,282479
9396,0.02608,172.31.36.0-255,66,145432,7,282479
9397,0.028364,74.125.24.0-255,5738,151170,7,282479
9398,0.028373,172.31.36.0-255,66,151236,7,282479
9399,0.030666,74.125.24.0-255,5738,156974,7,282479
9400,0.030675,172.31.36.0-255,66,157040,7,282479
9401,0.032961,74.125.24.0-255,5738,162778,7,282479
9402,0.032971,172.31.36.0-255,66,162844,7,282479
9403,0.034994,172.31.36.0-255,176,163020,7,282479
9404,0.035022,172.31.36.0-255,1073,164093,7,282479
9405,0.035263,74.125.24.0-255,2902,166995,7,282479
9406,0.035269,172.31.36.0-255,66,167061,7,282479
9407,0.035284,74.125.24.0-255,2902,169963,7,282479
9408,0.035311,172.31.36.0-255,66,170029,7,282479
9409,0.036479,104.244.42.0-255,66,170095,7,282479
9410,0.036507,104.244.42.0-255,66,170161,7,282479
9411,0.037545,74.125.24.0-255,2902,173063,7,282479
9412,0.037552,172.31.36.0-255,66,173129,7,282479
9413,0.037594,74.125.24.0-255,2902,176031,7,282479
9414,0.037611,172.31.36.0-255,66,176097,7,282479
9415,0.039835,74.125.24.0-255,2902,178999,7,282479
9416,0.039842,172.31.36.0-255,66,179065,7,282479
9417,0.039881,74.125.24.0-255,2902,181967,7,282479
9418,0.039901,172.31.36.0-255,66,182033,7,282479
9419,0.042123,74.125.24.0-255,2902,184935,7,282479
9420,0.042128,172.31.36.0-255,66,185001,7,282479
9421,0.042166,74.125.24.0-255,2902,187903,7,282479
9422,0.042195,172.31.36.0-255,66,187969,7,282479
9423,0.044412,74.125.24.0-255,2902,190871,7,282479
9424,0.04442,172.31.36.0-255,66,190937,7,282479
9425,0.044461,74.125.24.0-255,2902,193839,7,282479
9426,0.044479,172.31.36.0-255,66,193905,7,282479
9427,0.046703,74.125.24.0-255,2902,196807,7,282479
9428,0.046711,172.31.36.0-255,66,196873,7,282479
9429,0.046798,74.125.24.0-255,2902,199775,7,282479
9430,0.046809,172.31.36.0-255,66,199841,7,282479
9431,0.048995,74.125.24.0-255,2902,202743,7,282479
9432,0.049002,172.31.36.0-255,66,202809,7,282479
9433,0.049082,74.125.24.0-255,2902,205711,7,282479
9434,0.049092,172.31.36.0-255,66,205777,7,282479
9435,0.051342,74.125.24.0-255,2902,208679,7,282479
9436,0.051348,172.31.36.0-255,66,208745,7,282479
9437,0.051368,74.125.24.0-255,2902,211647,7,282479
9438,0.0514,172.31.36.0-255,66,211713,7,282479
9439,0.053627,74.125.24.0-255,2902,214615,7,282479
9440,0.053634,172.31.36.0-255,66,214681,7,282479
9441,0.053663,74.125.24.0-255,2902,217583,7,282479
9442,0.053688,172.31.36.0-255,66,217649,7,282479
9443,0.055908,74.125.24.0-255,2902,220551,7,282479
9444,0.055915,172.31.36.0-255,66,220617,7,282479
9445,0.055972,74.125.24.0-255,2902,223519,7,282479
9446,0.056009,172.31.36.0-255,66,223585,7,282479
9447,0.058185,74.125.24.0-255,2902,226487,7,282479
9448,0.058191,172.31.36.0-255,66,226553,7,282479
9449,0.058289,74.125.24.0-255,2902,229455,7,282479
9450,0.058294,172.31.36.0-255,66,229521,7,282479
9451,0.060498,74.125.24.0-255,2902,232423,7,282479
9452,0.060505,172.31.36.0-255,66,232489,7,282479
9453,0.06058,74.125.24.0-255,2902,235391,7,282479
9454,0.060605,172.31.36.0-255,66,235457,7,282479
9455,0.062769,74.125.24.0-255,2902,238359,7,282479
9456,0.062776,172.31.36.0-255,66,238425,7,282479
9457,0.062847,74.125.24.0-255,2902,241327,7,282479
9458,0.06293,172.31.36.0-255,66,241393,7,282479
9459,0.065073,74.125.24.0-255,2902,244295,7,282479
9460,0.065081,172.31.36.0-255,66,244361,7,282479
9461,0.065246,74.125.24.0-255,2902,247263,7,282479
9462,0.065251,172.31.36.0-255,66,247329,7,282479
9463,0.067396,74.125.24.0-255,2902,250231,7,282479
9464,0.067403,172.31.36.0-255,66,250297,7,282479
9465,0.067529,74.125.24.0-255,2902,253199,7,282479
9466,0.067534,172.31.36.0-255,66,253265,7,282479
9467,0.069693,74.125.24.0-255,2902,256167,7,282479
9468,0.069701,172.31.36.0-255,66,256233,7,282479
9469,0.069803,74.125.24.0-255,2902,259135,7,282479
9470,0.069811,172.31.36.0-255,66,259201,7,282479
9471,0.07199,74.125.24.0-255,2902,262103,7,282479
9472,0.071996,172.31.36.0-255,66,262169,7,282479
9473,0.072085,74.125.24.0-255,2902,265071,7,282479
9474,0.072089,172.31.36.0-255,66,265137,7,282479
9475,0.074288,74.125.24.0-255,2902,268039,7,282479
9476,0.074294,172.31.36.0-255,66,268105,7,282479
9477,0.074352,74.125.24.0-255,2902,271007,7,282479
9478,0.074377,172.31.36.0-255,66,271073,7,282479
9479,0.076569,74.125.24.0-255,2902,273975,7,282479
9480,0.076576,172.31.36.0-255,66,274041,7,282479
9481,0.076645,74.125.24.0-255,2902,276943,7,282479
9482,0.076677,172.31.36.0-255,66,277009,7,282479
9483,0.07885,74.125.24.0-255,2902,279911,7,282479
9484,0.078857,172.31.36.0-255,66,279977,7,282479
9485,0.07896,74.125.24.0-255,2331,282308,7,282479
9486,0.078965,172.31.36.0-255,66,282374,7,282479
9487,0.079101,172.31.36.0-255,105,282479,7,282479
9488,0.0,172.217.194.0-255,148,148,7,235981
9489,3.5e-05,172.31.36.0-255,66,214,7,235981
9490,4.2e-05,172.217.194.0-255,1484,1698,7,235981
9491,4.6e-05,172.31.36.0-255,66,1764,7,235981
9492,5.2e-05,172.217.194.0-255,2902,4666,7,235981
9493,5.5e-05,172.31.36.0-255,66,4732,7,235981
9494,6.9e-05,172.217.194.0-255,7156,11888,7,235981
9495,7.2e-05,172.31.36.0-255,66,11954,7,235981
9496,7.5e-05,172.217.194.0-255,1484,13438,7,235981
9497,7.7e-05,172.31.36.0-255,66,13504,7,235981
9498,0.000112,172.217.194.0-255,669,14173,7,235981
9499,0.000114,172.31.36.0-255,66,14239,7,235981
9500,0.000141,172.217.194.0-255,1484,15723,7,235981
9501,0.000143,172.31.36.0-255,66,15789,7,235981
9502,0.00017,172.217.194.0-255,4320,20109,7,235981
9503,0.000173,172.31.36.0-255,66,20175,7,235981
9504,0.000198,172.217.194.0-255,7156,27331,7,235981
9505,0.000201,172.31.36.0-255,66,27397,7,235981
9506,0.000207,172.217.194.0-255,3961,31358,7,235981
9507,0.00021,172.31.36.0-255,66,31424,7,235981
9508,0.000297,172.217.194.0-255,1484,32908,7,235981
9509,0.0003,172.31.36.0-255,66,32974,7,235981
9510,0.000305,172.217.194.0-255,2902,35876,7,235981
9511,0.000308,172.31.36.0-255,66,35942,7,235981
9512,0.000322,172.217.194.0-255,5738,41680,7,235981
9513,0.000326,172.31.36.0-255,66,41746,7,235981
9514,0.000354,172.217.194.0-255,1484,43230,7,235981
9515,0.000357,172.31.36.0-255,66,43296,7,235981
9516,0.000408,172.31.36.0-255,66,43362,7,235981
9517,0.000427,172.31.36.0-255,66,43428,7,235981
9518,0.000429,172.217.194.0-255,341,43769,7,235981
9519,0.000468,172.217.194.0-255,433,44202,7,235981
9520,0.000719,172.217.194.0-255,1484,45686,7,235981
9521,0.000724,172.31.36.0-255,66,45752,7,235981
9522,0.000729,172.217.194.0-255,2902,48654,7,235981
9523,0.000732,172.31.36.0-255,66,48720,7,235981
9524,0.000738,172.217.194.0-255,5738,54458,7,235981
9525,0.000746,172.31.36.0-255,66,54524,7,235981
9526,0.00079,172.31.36.0-255,66,54590,7,235981
9527,0.000804,172.31.36.0-255,66,54656,7,235981
9528,0.001019,172.217.194.0-255,1484,56140,7,235981
9529,0.001025,172.217.194.0-255,2902,59042,7,235981
9530,0.001028,172.31.36.0-255,66,59108,7,235981
9531,0.001059,172.217.194.0-255,5738,64846,7,235981
9532,0.001062,172.31.36.0-255,66,64912,7,235981
9533,0.001069,172.217.194.0-255,5738,70650,7,235981
9534,0.001072,172.31.36.0-255,66,70716,7,235981
9535,0.001103,172.217.194.0-255,7156,77872,7,235981
9536,0.001107,172.31.36.0-255,66,77938,7,235981
9537,0.001118,172.31.36.0-255,66,78004,7,235981
9538,0.001153,172.31.36.0-255,66,78070,7,235981
9539,0.00116,172.217.194.0-255,5738,83808,7,235981
9540,0.001162,172.31.36.0-255,66,83874,7,235981
9541,0.001192,172.217.194.0-255,2902,86776,7,235981
9542,0.001195,172.31.36.0-255,66,86842,7,235981
9543,0.001218,172.31.36.0-255,66,86908,7,235981
9544,0.001221,172.217.194.0-255,766,87674,7,235981
9545,0.001281,172.217.194.0-255,1484,89158,7,235981
9546,0.001285,172.31.36.0-255,66,89224,7,235981
9547,0.001289,172.217.194.0-255,2902,92126,7,235981
9548,0.001291,172.31.36.0-255,66,92192,7,235981
9549,0.001298,172.217.194.0-255,5738,97930,7,235981
9550,0.001302,172.31.36.0-255,66,97996,7,235981
9551,0.001341,172.217.194.0-255,5738,103734,7,235981
9552,0.001344,172.31.36.0-255,66,103800,7,235981
9553,0.001367,172.217.194.0-255,7156,110956,7,235981
9554,0.001372,172.31.36.0-255,66,111022,7,235981
9555,0.001378,172.31.36.0-255,66,111088,7,235981
9556,0.001411,172.217.194.0-255,6438,117526,7,235981
9557,0.001414,172.31.36.0-255,66,117592,7,235981
9558,0.001419,172.217.194.0-255,4320,121912,7,235981
9559,0.001422,172.31.36.0-255,66,121978,7,235981
9560,0.001451,172.217.194.0-255,2902,124880,7,235981
9561,0.001454,172.31.36.0-255,66,124946,7,235981
9562,0.001469,172.31.36.0-255,66,125012,7,235981
9563,0.001475,172.217.194.0-255,5020,130032,7,235981
9564,0.001477,172.31.36.0-255,66,130098,7,235981
9565,0.001522,172.217.194.0-255,1484,131582,7,235981
9566,0.001526,172.217.194.0-255,2902,134484,7,235981
9567,0.00153,172.31.36.0-255,66,134550,7,235981
9568,0.001535,172.217.194.0-255,5738,140288,7,235981
9569,0.001538,172.31.36.0-255,66,140354,7,235981
9570,0.00154,172.217.194.0-255,1484,141838,7,235981
9571,0.001564,172.217.194.0-255,4320,146158,7,235981
9572,0.001569,172.31.36.0-255,66,146224,7,235981
9573,0.001582,172.217.194.0-255,5738,151962,7,235981
9574,0.001586,172.31.36.0-255,66,152028,7,235981
9575,0.001629,172.217.194.0-255,7156,159184,7,235981
9576,0.001633,172.31.36.0-255,66,159250,7,235981
9577,0.00164,172.217.194.0-255,5020,164270,7,235981
9578,0.001644,172.31.36.0-255,66,164336,7,235981
9579,0.001686,172.217.194.0-255,1484,165820,7,235981
9580,0.001691,172.217.194.0-255,2902,168722,7,235981
9581,0.001694,172.31.36.0-255,66,168788,7,235981
9582,0.001717,172.217.194.0-255,5738,174526,7,235981
9583,0.00172,172.31.36.0-255,66,174592,7,235981
9584,0.001723,172.217.194.0-255,1484,176076,7,235981
9585,0.00175,172.31.36.0-255,66,176142,7,235981
9586,0.001757,172.217.194.0-255,5738,181880,7,235981
9587,0.001761,172.31.36.0-255,66,181946,7,235981
9588,0.001792,172.217.194.0-255,5020,186966,7,235981
9589,0.001796,172.31.36.0-255,66,187032,7,235981
9590,0.001889,172.217.194.0-255,1484,188516,7,235981
9591,0.001894,172.217.194.0-255,2902,191418,7,235981
9592,0.001897,172.31.36.0-255,66,191484,7,235981
9593,0.001903,172.217.194.0-255,5738,197222,7,235981
9594,0.001905,172.31.36.0-255,66,197288,7,235981
9595,0.001955,172.31.36.0-255,66,197354,7,235981
9596,0.001983,172.217.194.0-255,2902,200256,7,235981
9597,0.001987,172.31.36.0-255,66,200322,7,235981
9598,0.001998,172.217.194.0-255,766,201088,7,235981
9599,0.002,172.31.36.0-255,66,201154,7,235981
9600,0.002056,172.217.194.0-255,1484,202638,7,235981
9601,0.00206,172.31.36.0-255,66,202704,7,235981
9602,0.002065,172.217.194.0-255,2902,205606,7,235981
9603,0.002068,172.31.36.0-255,66,205672,7,235981
9604,0.002073,172.217.194.0-255,4320,209992,7,235981
9605,0.002076,172.31.36.0-255,66,210058,7,235981
9606,0.002115,172.217.194.0-255,1484,211542,7,235981
9607,0.002131,172.31.36.0-255,66,211608,7,235981
9608,0.002148,172.31.36.0-255,66,211674,7,235981
9609,0.002151,172.217.194.0-255,766,212440,7,235981
9610,0.002207,172.217.194.0-255,1484,213924,7,235981
9611,0.00221,172.31.36.0-255,66,213990,7,235981
9612,0.002216,172.217.194.0-255,4320,218310,7,235981
9613,0.002218,172.31.36.0-255,66,218376,7,235981
9614,0.002236,172.31.36.0-255,66,218442,7,235981
9615,0.002244,172.217.194.0-255,7156,225598,7,235981
9616,0.002246,172.31.36.0-255,66,225664,7,235981
9617,0.002302,172.31.36.0-255,66,225730,7,235981
9618,0.002308,172.217.194.0-255,5377,231107,7,235981
9619,0.00231,172.31.36.0-255,66,231173,7,235981
9620,0.002313,172.217.194.0-255,105,231278,7,235981
9621,0.003569,172.31.36.0-255,66,231344,7,235981
9622,0.003598,172.31.36.0-255,105,231449,7,235981
9623,0.006101,172.217.194.0-255,66,231515,7,235981
9624,0.026665,172.31.36.0-255,172,231687,7,235981
9625,0.026696,172.31.36.0-255,1114,232801,7,235981
9626,0.026735,172.31.36.0-255,1514,234315,7,235981
9627,0.026737,172.31.36.0-255,1294,235609,7,235981
9628,0.028165,104.244.42.0-255,66,235675,7,235981
9629,0.028232,104.244.42.0-255,66,235741,7,235981
9630,0.028245,104.244.42.0-255,66,235807,7,235981
9631,0.028883,104.244.42.0-255,108,235915,7,235981
9632,0.028888,172.31.36.0-255,66,235981,7,235981
9633,0.0,172.217.194.0-255,153,153,7,172430
9634,2.3e-05,172.31.36.0-255,66,219,7,172430
9635,3e-05,172.217.194.0-255,1484,1703,7,172430
9636,3.5e-05,172.31.36.0-255,66,1769,7,172430
9637,4.8e-05,172.217.194.0-255,2902,4671,7,172430
9638,5.1e-05,172.31.36.0-255,66,4737,7,172430
9639,6e-05,172.217.194.0-255,7156,11893,7,172430
9640,6.4e-05,172.31.36.0-255,66,11959,7,172430
9641,8.1e-05,172.31.36.0-255,66,12025,7,172430
9642,9.7e-05,172.217.194.0-255,2543,14568,7,172430
9643,0.000101,172.31.36.0-255,66,14634,7,172430
9644,0.000122,172.217.194.0-255,2902,17536,7,172430
9645,0.000125,172.31.36.0-255,66,17602,7,172430
9646,0.000132,172.217.194.0-255,5738,23340,7,172430
9647,0.000135,172.31.36.0-255,66,23406,7,172430
9648,0.000161,172.217.194.0-255,1484,24890,7,172430
9649,0.000164,172.31.36.0-255,66,24956,7,172430
9650,0.000177,172.217.194.0-255,6797,31753,7,172430
9651,0.00018,172.31.36.0-255,66,31819,7,172430
9652,0.000684,172.217.194.0-255,1484,33303,7,172430
9653,0.00069,172.31.36.0-255,66,33369,7,172430
9654,0.000696,172.217.194.0-255,2902,36271,7,172430
9655,0.000698,172.31.36.0-255,66,36337,7,172430
9656,0.000703,172.217.194.0-255,2902,39239,7,172430
9657,0.000705,172.31.36.0-255,66,39305,7,172430
9658,0.000741,172.217.194.0-255,2902,42207,7,172430
9659,0.000745,172.31.36.0-255,66,42273,7,172430
9660,0.000755,172.217.194.0-255,6797,49070,7,172430
9661,0.000762,172.31.36.0-255,66,49136,7,172430
9662,0.00077,172.217.194.0-255,7156,56292,7,172430
9663,0.000773,172.31.36.0-255,66,56358,7,172430
9664,0.000779,172.217.194.0-255,5738,62096,7,172430
9665,0.000791,172.31.36.0-255,66,62162,7,172430
9666,0.00081,172.217.194.0-255,3961,66123,7,172430
9667,0.000813,172.217.194.0-255,1484,67607,7,172430
9668,0.000824,172.31.36.0-255,66,67673,7,172430
9669,0.000875,172.31.36.0-255,66,67739,7,172430
9670,0.001011,172.217.194.0-255,1484,69223,7,172430
9671,0.001017,172.217.194.0-255,2902,72125,7,172430
9672,0.00102,172.31.36.0-255,66,72191,7,172430
9673,0.001024,172.217.194.0-255,1484,73675,7,172430
9674,0.001049,172.217.194.0-255,4320,77995,7,172430
9675,0.001052,172.217.194.0-255,1484,79479,7,172430
9676,0.001083,172.31.36.0-255,66,79545,7,172430
9677,0.001088,172.31.36.0-255,66,79611,7,172430
9678,0.001114,172.217.194.0-255,1484,81095,7,172430
9679,0.001131,172.217.194.0-255,766,81861,7,172430
9680,0.001139,172.31.36.0-255,66,81927,7,172430
9681,0.001528,172.217.194.0-255,1484,83411,7,172430
9682,0.001535,172.217.194.0-255,2902,86313,7,172430
9683,0.001538,172.31.36.0-255,66,86379,7,172430
9684,0.001544,172.217.194.0-255,4320,90699,7,172430
9685,0.001546,172.31.36.0-255,66,90765,7,172430
9686,0.001566,172.217.194.0-255,1484,92249,7,172430
9687,0.001571,172.217.194.0-255,2902,95151,7,172430
9688,0.00161,172.31.36.0-255,66,95217,7,172430
9689,0.001639,172.217.194.0-255,2902,98119,7,172430
9690,0.001673,172.31.36.0-255,66,98185,7,172430
9691,0.001709,172.217.194.0-255,1484,99669,7,172430
9692,0.001722,172.217.194.0-255,2902,102571,7,172430
9693,0.001743,172.217.194.0-255,5738,108309,7,172430
9694,0.001782,172.31.36.0-255,66,108375,7,172430
9695,0.001787,172.31.36.0-255,66,108441,7,172430
9696,0.00184,172.217.194.0-255,1484,109925,7,172430
9697,0.001855,172.31.36.0-255,66,109991,7,172430
9698,0.001861,172.217.194.0-255,2902,112893,7,172430
9699,0.001865,172.31.36.0-255,66,112959,7,172430
9700,0.001895,172.217.194.0-255,5738,118697,7,172430
9701,0.001902,172.217.194.0-255,5738,124435,7,172430
9702,0.001905,172.217.194.0-255,1484,125919,7,172430
9703,0.001915,172.31.36.0-255,66,125985,7,172430
9704,0.00195,172.217.194.0-255,5020,131005,7,172430
9705,0.001974,172.31.36.0-255,66,131071,7,172430
9706,0.002013,172.217.194.0-255,1484,132555,7,172430
9707,0.002019,172.217.194.0-255,2902,135457,7,172430
9708,0.002045,172.217.194.0-255,5738,141195,7,172430
9709,0.002048,172.31.36.0-255,66,141261,7,172430
9710,0.002053,172.31.36.0-255,66,141327,7,172430
9711,0.002106,172.217.194.0-255,1484,142811,7,172430
9712,0.00213,172.31.36.0-255,66,142877,7,172430
9713,0.00217,172.217.194.0-255,5738,148615,7,172430
9714,0.002175,172.31.36.0-255,66,148681,7,172430
9715,0.002205,172.217.194.0-255,5738,154419,7,172430
9716,0.002256,172.31.36.0-255,66,154485,7,172430
9717,0.0023,172.217.194.0-255,6438,160923,7,172430
9718,0.002374,172.31.36.0-255,66,160989,7,172430
9719,0.002379,172.31.36.0-255,66,161055,7,172430
9720,0.002403,172.217.194.0-255,1484,162539,7,172430
9721,0.002465,172.217.194.0-255,105,162644,7,172430
9722,0.002474,172.31.36.0-255,66,162710,7,172430
9723,0.010232,172.31.36.0-255,105,162815,7,172430
9724,0.010669,172.31.36.0-255,90,162905,7,172430
9725,0.010681,172.31.36.0-255,66,162971,7,172430
9726,0.012508,172.217.194.0-255,66,163037,7,172430
9727,0.012937,172.217.194.0-255,66,163103,7,172430
9728,0.012954,172.217.194.0-255,66,163169,7,172430
9729,0.01296,172.31.36.0-255,66,163235,7,172430
9730,0.040058,172.31.36.0-255,176,163411,7,172430
9731,0.040105,172.31.36.0-255,1113,164524,7,172430
9732,0.040178,172.31.36.0-255,1514,166038,7,172430
9733,0.04018,172.31.36.0-255,1514,167552,7,172430
9734,0.040182,172.31.36.0-255,1514,169066,7,172430
9735,0.040183,172.31.36.0-255,1514,170580,7,172430
9736,0.040184,172.31.36.0-255,1514,172094,7,172430
9737,0.040213,172.31.36.0-255,72,172166,7,172430
9738,0.041624,104.244.42.0-255,66,172232,7,172430
9739,0.041636,104.244.42.0-255,66,172298,7,172430
9740,0.041735,104.244.42.0-255,66,172364,7,172430
9741,0.04174,104.244.42.0-255,66,172430,7,172430
9742,0.0,172.217.194.0-255,152,152,7,264221
9743,3.5e-05,172.31.36.0-255,66,218,7,264221
9744,4.3e-05,172.217.194.0-255,1484,1702,7,264221
9745,4.7e-05,172.31.36.0-255,66,1768,7,264221
9746,5.9e-05,172.217.194.0-255,2902,4670,7,264221
9747,6.2e-05,172.31.36.0-255,66,4736,7,264221
9748,6.9e-05,172.217.194.0-255,4320,9056,7,264221
9749,7.2e-05,172.31.36.0-255,66,9122,7,264221
9750,9.6e-05,172.217.194.0-255,2902,12024,7,264221
9751,9.9e-05,172.31.36.0-255,66,12090,7,264221
9752,0.000106,172.217.194.0-255,7156,19246,7,264221
9753,0.000114,172.31.36.0-255,66,19312,7,264221
9754,0.000143,172.217.194.0-255,649,19961,7,264221
9755,0.000146,172.31.36.0-255,66,20027,7,264221
9756,0.000149,172.217.194.0-255,1484,21511,7,264221
9757,0.000151,172.31.36.0-255,66,21577,7,264221
9758,0.000189,172.31.36.0-255,66,21643,7,264221
9759,0.000493,172.217.194.0-255,1484,23127,7,264221
9760,0.000497,172.217.194.0-255,1484,24611,7,264221
9761,0.000499,172.31.36.0-255,66,24677,7,264221
9762,0.000504,172.31.36.0-255,66,24743,7,264221
9763,0.000527,172.217.194.0-255,1484,26227,7,264221
9764,0.000534,172.31.36.0-255,66,26293,7,264221
9765,0.000542,172.217.194.0-255,4320,30613,7,264221
9766,0.000544,172.31.36.0-255,66,30679,7,264221
9767,0.000548,172.217.194.0-255,1484,32163,7,264221
9768,0.00055,172.31.36.0-255,66,32229,7,264221
9769,0.000583,172.217.194.0-255,7156,39385,7,264221
9770,0.000587,172.31.36.0-255,66,39451,7,264221
9771,0.000604,172.31.36.0-255,66,39517,7,264221
9772,0.000653,172.31.36.0-255,66,39583,7,264221
9773,0.001985,172.217.194.0-255,360,39943,7,264221
9774,0.002025,172.217.194.0-255,1484,41427,7,264221
9775,0.002031,172.31.36.0-255,66,41493,7,264221
9776,0.002035,172.217.194.0-255,1484,42977,7,264221
9777,0.00206,172.217.194.0-255,4320,47297,7,264221
9778,0.002062,172.31.36.0-255,66,47363,7,264221
9779,0.002093,172.217.194.0-255,2902,50265,7,264221
9780,0.002095,172.31.36.0-255,66,50331,7,264221
9781,0.002123,172.217.194.0-255,4320,54651,7,264221
9782,0.002125,172.31.36.0-255,66,54717,7,264221
9783,0.002148,172.217.194.0-255,4320,59037,7,264221
9784,0.00215,172.31.36.0-255,66,59103,7,264221
9785,0.002174,172.217.194.0-255,2902,62005,7,264221
9786,0.002177,172.31.36.0-255,66,62071,7,264221
9787,0.002202,172.217.194.0-255,1484,63555,7,264221
9788,0.002227,172.31.36.0-255,66,63621,7,264221
9789,0.004529,172.217.194.0-255,2902,66523,7,264221
9790,0.004532,172.31.36.0-255,66,66589,7,264221
9791,0.00456,172.217.194.0-255,2902,69491,7,264221
9792,0.004562,172.31.36.0-255,66,69557,7,264221
9793,0.006802,172.217.194.0-255,2902,72459,7,264221
9794,0.006809,172.31.36.0-255,66,72525,7,264221
9795,0.006839,172.217.194.0-255,2902,75427,7,264221
9796,0.006842,172.31.36.0-255,66,75493,7,264221
9797,0.009093,172.217.194.0-255,2902,78395,7,264221
9798,0.009101,172.31.36.0-255,66,78461,7,264221
9799,0.009129,172.217.194.0-255,2902,81363,7,264221
9800,0.009133,172.31.36.0-255,66,81429,7,264221
9801,0.011397,172.217.194.0-255,5738,87167,7,264221
9802,0.011403,172.31.36.0-255,66,87233,7,264221
9803,0.013678,172.217.194.0-255,5738,92971,7,264221
9804,0.013689,172.31.36.0-255,66,93037,7,264221
9805,0.015995,172.217.194.0-255,5738,98775,7,264221
9806,0.016002,172.31.36.0-255,66,98841,7,264221
9807,0.01834,172.217.194.0-255,5738,104579,7,264221
9808,0.018347,172.31.36.0-255,66,104645,7,264221
9809,0.02063,172.217.194.0-255,5738,110383,7,264221
9810,0.020638,172.31.36.0-255,66,110449,7,264221
9811,0.022947,172.217.194.0-255,5738,116187,7,264221
9812,0.022953,172.31.36.0-255,66,116253,7,264221
9813,0.02524,172.217.194.0-255,5738,121991,7,264221
9814,0.025248,172.31.36.0-255,66,122057,7,264221
9815,0.027537,172.217.194.0-255,5738,127795,7,264221
9816,0.027543,172.31.36.0-255,66,127861,7,264221
9817,0.02936,172.31.36.0-255,172,128033,7,264221
9818,0.029389,172.31.36.0-255,1115,129148,7,264221
9819,0.029422,172.31.36.0-255,1514,130662,7,264221
9820,0.029423,172.31.36.0-255,1514,132176,7,264221
9821,0.029428,172.31.36.0-255,1514,133690,7,264221
9822,0.029429,172.31.36.0-255,1514,135204,7,264221
9823,0.029445,172.31.36.0-255,1514,136718,7,264221
9824,0.029446,172.31.36.0-255,69,136787,7,264221
9825,0.029825,172.217.194.0-255,5738,142525,7,264221
9826,0.029831,172.31.36.0-255,66,142591,7,264221
9827,0.030906,104.244.42.0-255,66,142657,7,264221
9828,0.031098,104.244.42.0-255,66,142723,7,264221
9829,0.031105,104.244.42.0-255,66,142789,7,264221
9830,0.031109,104.244.42.0-255,66,142855,7,264221
9831,0.032093,172.217.194.0-255,5738,148593,7,264221
9832,0.0321,172.31.36.0-255,66,148659,7,264221
9833,0.034371,172.217.194.0-255,5738,154397,7,264221
9834,0.034376,172.31.36.0-255,66,154463,7,264221
9835,0.03542,104.244.42.0-255,108,154571,7,264221
9836,0.035425,172.31.36.0-255,66,154637,7,264221
9837,0.036643,172.217.194.0-255,1484,156121,7,264221
9838,0.036672,172.217.194.0-255,4320,160441,7,264221
9839,0.036676,172.31.36.0-255,66,160507,7,264221
9840,0.038956,172.217.194.0-255,5738,166245,7,264221
9841,0.038962,172.31.36.0-255,66,166311,7,264221
9842,0.041224,172.217.194.0-255,5738,172049,7,264221
9843,0.041229,172.31.36.0-255,66,172115,7,264221
9844,0.043506,172.217.194.0-255,5738,177853,7,264221
9845,0.043511,172.31.36.0-255,66,177919,7,264221
9846,0.04582,172.217.194.0-255,5738,183657,7,264221
9847,0.045826,172.31.36.0-255,66,183723,7,264221
9848,0.048091,172.217.194.0-255,5738,189461,7,264221
9849,0.048098,172.31.36.0-255,66,189527,7,264221
9850,0.050387,172.217.194.0-255,1484,191011,7,264221
9851,0.050412,172.217.194.0-255,4320,195331,7,264221
9852,0.050417,172.31.36.0-255,66,195397,7,264221
9853,0.052676,172.217.194.0-255,2902,198299,7,264221
9854,0.052681,172.31.36.0-255,66,198365,7,264221
9855,0.05271,172.217.194.0-255,2902,201267,7,264221
9856,0.052713,172.31.36.0-255,66,201333,7,264221
9857,0.054954,172.217.194.0-255,2902,204235,7,264221
9858,0.054959,172.31.36.0-255,66,204301,7,264221
9859,0.054992,172.217.194.0-255,2902,207203,7,264221
9860,0.054994,172.31.36.0-255,66,207269,7,264221
9861,0.057236,172.217.194.0-255,2902,210171,7,264221
9862,0.057242,172.31.36.0-255,66,210237,7,264221
9863,0.057275,172.217.194.0-255,2902,213139,7,264221
9864,0.057278,172.31.36.0-255,66,213205,7,264221
9865,0.059524,172.217.194.0-255,2902,216107,7,264221
9866,0.059531,172.31.36.0-255,66,216173,7,264221
9867,0.059557,172.217.194.0-255,2902,219075,7,264221
9868,0.05956,172.31.36.0-255,66,219141,7,264221
9869,0.06182,172.217.194.0-255,5738,224879,7,264221
9870,0.061826,172.31.36.0-255,66,224945,7,264221
9871,0.064107,172.217.194.0-255,5738,230683,7,264221
9872,0.064112,172.31.36.0-255,66,230749,7,264221
9873,0.066394,172.217.194.0-255,5738,236487,7,264221
9874,0.066401,172.31.36.0-255,66,236553,7,264221
9875,0.068685,172.217.194.0-255,5738,242291,7,264221
9876,0.068692,172.31.36.0-255,66,242357,7,264221
9877,0.071001,172.217.194.0-255,5738,248095,7,264221
9878,0.071007,172.31.36.0-255,66,248161,7,264221
9879,0.073284,172.217.194.0-255,5738,253899,7,264221
9880,0.073291,172.31.36.0-255,66,253965,7,264221
9881,0.075579,172.217.194.0-255,4320,258285,7,264221
9882,0.075585,172.31.36.0-255,66,258351,7,264221
9883,0.075616,172.217.194.0-255,1484,259835,7,264221
9884,0.077831,172.217.194.0-255,4320,264155,7,264221
9885,0.077837,172.31.36.0-255,66,264221,7,264221
9886,0.0,74.125.24.0-255,146,146,7,262529
9887,2.8e-05,172.31.36.0-255,66,212,7,262529
9888,3.5e-05,74.125.24.0-255,1484,1696,7,262529
9889,3.9e-05,172.31.36.0-255,66,1762,7,262529
9890,4.4e-05,74.125.24.0-255,2902,4664,7,262529
9891,4.7e-05,172.31.36.0-255,66,4730,7,262529
9892,7.8e-05,74.125.24.0-255,7156,11886,7,262529
9893,8.6e-05,172.31.36.0-255,66,11952,7,262529
9894,9.3e-05,74.125.24.0-255,2002,13954,7,262529
9895,9.4e-05,172.31.36.0-255,66,14020,7,262529
9896,0.000133,74.125.24.0-255,1484,15504,7,262529
9897,0.000136,172.31.36.0-255,66,15570,7,262529
9898,0.000148,74.125.24.0-255,1484,17054,7,262529
9899,0.000154,172.31.36.0-255,66,17120,7,262529
9900,0.000181,74.125.24.0-255,1484,18604,7,262529
9901,0.000184,172.31.36.0-255,66,18670,7,262529
9902,0.00019,74.125.24.0-255,5738,24408,7,262529
9903,0.000193,172.31.36.0-255,66,24474,7,262529
9904,0.000203,74.125.24.0-255,2902,27376,7,262529
9905,0.000205,172.31.36.0-255,66,27442,7,262529
9906,0.000238,74.125.24.0-255,3961,31403,7,262529
9907,0.000242,172.31.36.0-255,66,31469,7,262529
9908,0.00036,74.125.24.0-255,1484,32953,7,262529
9909,0.000365,172.31.36.0-255,66,33019,7,262529
9910,0.00037,74.125.24.0-255,2902,35921,7,262529
9911,0.000372,172.31.36.0-255,66,35987,7,262529
9912,0.000376,74.125.24.0-255,1484,37471,7,262529
9913,0.000384,172.31.36.0-255,66,37537,7,262529
9914,0.000414,74.125.24.0-255,4320,41857,7,262529
9915,0.000418,172.31.36.0-255,66,41923,7,262529
9916,0.000426,74.125.24.0-255,6797,48720,7,262529
9917,0.000429,172.31.36.0-255,66,48786,7,262529
9918,0.000467,172.31.36.0-255,66,48852,7,262529
9919,0.000502,172.31.36.0-255,66,48918,7,262529
9920,0.000524,74.125.24.0-255,111,49029,7,262529
9921,0.000547,74.125.24.0-255,330,49359,7,262529
9922,0.000799,172.31.36.0-255,66,49425,7,262529
9923,0.000895,74.125.24.0-255,1484,50909,7,262529
9924,0.000914,74.125.24.0-255,2902,53811,7,262529
9925,0.000918,172.31.36.0-255,66,53877,7,262529
9926,0.000925,74.125.24.0-255,5738,59615,7,262529
9927,0.000927,172.31.36.0-255,66,59681,7,262529
9928,0.000964,172.31.36.0-255,66,59747,7,262529
9929,0.000969,74.125.24.0-255,2902,62649,7,262529
9930,0.000971,172.31.36.0-255,66,62715,7,262529
9931,0.001011,172.31.36.0-255,66,62781,7,262529
9932,0.001016,74.125.24.0-255,2184,64965,7,262529
9933,0.001018,172.31.36.0-255,66,65031,7,262529
9934,0.001815,74.125.24.0-255,1484,66515,7,262529
9935,0.001823,74.125.24.0-255,2902,69417,7,262529
9936,0.001827,172.31.36.0-255,66,69483,7,262529
9937,0.001834,74.125.24.0-255,5738,75221,7,262529
9938,0.001835,172.31.36.0-255,66,75287,7,262529
9939,0.00187,172.31.36.0-255,66,75353,7,262529
9940,0.001897,74.125.24.0-255,1484,76837,7,262529
9941,0.001903,74.125.24.0-255,5738,82575,7,262529
9942,0.001905,172.31.36.0-255,66,82641,7,262529
9943,0.001932,74.125.24.0-255,5020,87661,7,262529
9944,0.002922,172.31.36.0-255,66,87727,7,262529
9945,0.005509,74.125.24.0-255,4320,92047,7,262529
9946,0.005516,172.31.36.0-255,66,92113,7,262529
9947,0.005553,74.125.24.0-255,1484,93597,7,262529
9948,0.00808,74.125.24.0-255,4320,97917,7,262529
9949,0.008086,172.31.36.0-255,66,97983,7,262529
9950,0.010646,74.125.24.0-255,5738,103721,7,262529
9951,0.010654,172.31.36.0-255,66,103787,7,262529
9952,0.01325,74.125.24.0-255,5738,109525,7,262529
9953,0.013262,172.31.36.0-255,66,109591,7,262529
9954,0.015824,74.125.24.0-255,5738,115329,7,262529
9955,0.015835,172.31.36.0-255,66,115395,7,262529
9956,0.018412,74.125.24.0-255,5738,121133,7,262529
9957,0.01842,172.31.36.0-255,66,121199,7,262529
9958,0.020979,74.125.24.0-255,5738,126937,7,262529
9959,0.020986,172.31.36.0-255,66,127003,7,262529
9960,0.02356,74.125.24.0-255,5738,132741,7,262529
9961,0.023567,172.31.36.0-255,66,132807,7,262529
9962,0.026145,74.125.24.0-255,5738,138545,7,262529
9963,0.026153,172.31.36.0-255,66,138611,7,262529
9964,0.028712,74.125.24.0-255,5738,144349,7,262529
9965,0.02872,172.31.36.0-255,66,144415,7,262529
9966,0.029053,172.31.36.0-255,172,144587,7,262529
9967,0.029087,172.31.36.0-255,1113,145700,7,262529
9968,0.029137,172.31.36.0-255,1514,147214,7,262529
9969,0.029139,172.31.36.0-255,1514,148728,7,262529
9970,0.02914,172.31.36.0-255,1514,150242,7,262529
9971,0.029141,172.31.36.0-255,1514,151756,7,262529
9972,0.029172,172.31.36.0-255,1514,153270,7,262529
9973,0.029174,172.31.36.0-255,71,153341,7,262529
9974,0.030615,104.244.42.0-255,66,153407,7,262529
9975,0.030667,104.244.42.0-255,66,153473,7,262529
9976,0.030705,104.244.42.0-255,66,153539,7,262529
9977,0.030726,104.244.42.0-255,66,153605,7,262529
9978,0.031302,74.125.24.0-255,4320,157925,7,262529
9979,0.031309,172.31.36.0-255,66,157991,7,262529
9980,0.031337,74.125.24.0-255,1484,159475,7,262529
9981,0.033887,74.125.24.0-255,4320,163795,7,262529
9982,0.033894,172.31.36.0-255,66,163861,7,262529
9983,0.036466,74.125.24.0-255,5738,169599,7,262529
9984,0.036473,172.31.36.0-255,66,169665,7,262529
9985,0.039045,74.125.24.0-255,5738,175403,7,262529
9986,0.039051,172.31.36.0-255,66,175469,7,262529
9987,0.041623,74.125.24.0-255,5738,181207,7,262529
9988,0.041628,172.31.36.0-255,66,181273,7,262529
9989,0.04418,74.125.24.0-255,5738,187011,7,262529
9990,0.044186,172.31.36.0-255,66,187077,7,262529
9991,0.046784,74.125.24.0-255,5738,192815,7,262529
9992,0.04679,172.31.36.0-255,66,192881,7,262529
9993,0.049377,74.125.24.0-255,5738,198619,7,262529
9994,0.049384,172.31.36.0-255,66,198685,7,262529
9995,0.051971,74.125.24.0-255,5738,204423,7,262529
9996,0.051977,172.31.36.0-255,66,204489,7,262529
9997,0.054648,74.125.24.0-255,5738,210227,7,262529
9998,0.054655,172.31.36.0-255,66,210293,7,262529
9999,0.057271,74.125.24.0-255,5738,216031,7,262529
10000,0.057277,172.31.36.0-255,66,216097,7,262529
10001,0.059853,74.125.24.0-255,5738,221835,7,262529
10002,0.059859,172.31.36.0-255,66,221901,7,262529
10003,0.062467,74.125.24.0-255,5738,227639,7,262529
10004,0.062474,172.31.36.0-255,66,227705,7,262529
10005,0.065031,74.125.24.0-255,5738,233443,7,262529
10006,0.065038,172.31.36.0-255,66,233509,7,262529
10007,0.067599,74.125.24.0-255,5738,239247,7,262529
10008,0.067605,172.31.36.0-255,66,239313,7,262529
10009,0.070199,74.125.24.0-255,5738,245051,7,262529
10010,0.070206,172.31.36.0-255,66,245117,7,262529
10011,0.072767,74.125.24.0-255,5738,250855,7,262529
10012,0.072776,172.31.36.0-255,66,250921,7,262529
10013,0.075349,74.125.24.0-255,5738,256659,7,262529
10014,0.075356,172.31.36.0-255,66,256725,7,262529
10015,0.077955,74.125.24.0-255,5738,262463,7,262529
10016,0.077961,172.31.36.0-255,66,262529,7,262529
10017,0.0,74.125.24.0-255,290,290,7,274190
10018,3.5e-05,172.31.36.0-255,66,356,7,274190
10019,4.1e-05,74.125.24.0-255,1484,1840,7,274190
10020,4.6e-05,172.31.36.0-255,66,1906,7,274190
10021,5.2e-05,74.125.24.0-255,4320,6226,7,274190
10022,5.5e-05,172.31.36.0-255,66,6292,7,274190
10023,8.8e-05,172.31.36.0-255,66,6358,7,274190
10024,0.000136,74.125.24.0-255,1484,7842,7,274190
10025,0.000139,172.31.36.0-255,66,7908,7,274190
10026,0.000145,74.125.24.0-255,2902,10810,7,274190
10027,0.000148,172.31.36.0-255,66,10876,7,274190
10028,0.000155,74.125.24.0-255,5738,16614,7,274190
10029,0.000157,172.31.36.0-255,66,16680,7,274190
10030,0.000195,74.125.24.0-255,6797,23477,7,274190
10031,0.000198,172.31.36.0-255,66,23543,7,274190
10032,0.000251,74.125.24.0-255,1484,25027,7,274190
10033,0.000254,172.31.36.0-255,66,25093,7,274190
10034,0.000259,74.125.24.0-255,2902,27995,7,274190
10035,0.000262,172.31.36.0-255,66,28061,7,274190
10036,0.000282,74.125.24.0-255,5738,33799,7,274190
10037,0.000286,172.31.36.0-255,66,33865,7,274190
10038,0.00032,74.125.24.0-255,4320,38185,7,274190
10039,0.000324,172.31.36.0-255,66,38251,7,274190
10040,0.000354,172.31.36.0-255,66,38317,7,274190
10041,0.000414,74.125.24.0-255,4320,42637,7,274190
10042,0.000419,172.31.36.0-255,66,42703,7,274190
10043,0.000447,74.125.24.0-255,2902,45605,7,274190
10044,0.00045,172.31.36.0-255,66,45671,7,274190
10045,0.00047,74.125.24.0-255,2878,48549,7,274190
10046,0.000473,172.31.36.0-255,66,48615,7,274190
10047,0.000476,74.125.24.0-255,109,48724,7,274190
10048,0.000546,74.125.24.0-255,332,49056,7,274190
10049,0.000845,172.31.36.0-255,66,49122,7,274190
10050,0.001028,74.125.24.0-255,1484,50606,7,274190
10051,0.001039,74.125.24.0-255,2902,53508,7,274190
10052,0.001043,172.31.36.0-255,66,53574,7,274190
10053,0.001051,74.125.24.0-255,5738,59312,7,274190
10054,0.001053,172.31.36.0-255,66,59378,7,274190
10055,0.001079,74.125.24.0-255,2902,62280,7,274190
10056,0.001082,172.31.36.0-255,66,62346,7,274190
10057,0.001105,172.31.36.0-255,66,62412,7,274190
10058,0.001193,172.31.36.0-255,66,62478,7,274190
10059,0.001333,74.125.24.0-255,1484,63962,7,274190
10060,0.00134,74.125.24.0-255,2902,66864,7,274190
10061,0.001343,172.31.36.0-255,66,66930,7,274190
10062,0.00135,74.125.24.0-255,5738,72668,7,274190
10063,0.001353,172.31.36.0-255,66,72734,7,274190
10064,0.001385,74.125.24.0-255,5738,78472,7,274190
10065,0.001388,172.31.36.0-255,66,78538,7,274190
10066,0.001412,74.125.24.0-255,7156,85694,7,274190
10067,0.001414,172.31.36.0-255,66,85760,7,274190
10068,0.001471,74.125.24.0-255,7156,92916,7,274190
10069,0.001476,172.31.36.0-255,66,92982,7,274190
10070,0.001497,74.125.24.0-255,3602,96584,7,274190
10071,0.001501,172.31.36.0-255,66,96650,7,274190
10072,0.001769,74.125.24.0-255,1484,98134,7,274190
10073,0.001775,74.125.24.0-255,2902,101036,7,274190
10074,0.00178,172.31.36.0-255,66,101102,7,274190
10075,0.001788,74.125.24.0-255,5738,106840,7,274190
10076,0.00179,172.31.36.0-255,66,106906,7,274190
10077,0.001833,74.125.24.0-255,7156,114062,7,274190
10078,0.001837,172.31.36.0-255,66,114128,7,274190
10079,0.001854,74.125.24.0-255,1484,115612,7,274190
10080,0.00188,74.125.24.0-255,5738,121350,7,274190
10081,0.001883,172.31.36.0-255,66,121416,7,274190
10082,0.001904,74.125.24.0-255,4320,125736,7,274190
10083,0.001907,172.31.36.0-255,66,125802,7,274190
10084,0.00195,74.125.24.0-255,2902,128704,7,274190
10085,0.001953,172.31.36.0-255,66,128770,7,274190
10086,0.00197,74.125.24.0-255,1484,130254,7,274190
10087,0.001981,74.125.24.0-255,766,131020,7,274190
10088,0.001983,172.31.36.0-255,66,131086,7,274190
10089,0.002008,74.125.24.0-255,7156,138242,7,274190
10090,0.00201,172.31.36.0-255,66,138308,7,274190
10091,0.002041,74.125.24.0-255,4320,142628,7,274190
10092,0.002044,172.31.36.0-255,66,142694,7,274190
10093,0.002085,172.31.36.0-255,66,142760,7,274190
10094,0.002104,74.125.24.0-255,4320,147080,7,274190
10095,0.002107,172.31.36.0-255,66,147146,7,274190
10096,0.002165,74.125.24.0-255,5738,152884,7,274190
10097,0.002169,172.31.36.0-255,66,152950,7,274190
10098,0.002211,74.125.24.0-255,3602,156552,7,274190
10099,0.002214,172.31.36.0-255,66,156618,7,274190
10100,0.002241,172.31.36.0-255,66,156684,7,274190
10101,0.002323,74.125.24.0-255,7156,163840,7,274190
10102,0.002326,172.31.36.0-255,66,163906,7,274190
10103,0.002357,172.31.36.0-255,66,163972,7,274190
10104,0.002478,74.125.24.0-255,2902,166874,7,274190
10105,0.002481,172.31.36.0-255,66,166940,7,274190
10106,0.002522,172.31.36.0-255,66,167006,7,274190
10107,0.002645,74.125.24.0-255,4320,171326,7,274190
10108,0.002648,172.31.36.0-255,66,171392,7,274190
10109,0.002671,74.125.24.0-255,6438,177830,7,274190
10110,0.002674,172.31.36.0-255,66,177896,7,274190
10111,0.002721,74.125.24.0-255,7156,185052,7,274190
10112,0.002725,172.31.36.0-255,66,185118,7,274190
10113,0.002764,172.31.36.0-255,66,185184,7,274190
10114,0.00297,74.125.24.0-255,5738,190922,7,274190
10115,0.002974,172.31.36.0-255,66,190988,7,274190
10116,0.003004,172.31.36.0-255,66,191054,7,274190
10117,0.003096,74.125.24.0-255,5738,196792,7,274190
10118,0.0031,172.31.36.0-255,66,196858,7,274190
10119,0.003134,172.31.36.0-255,66,196924,7,274190
10120,0.005714,74.125.24.0-255,5738,202662,7,274190
10121,0.005721,172.31.36.0-255,66,202728,7,274190
10122,0.008336,74.125.24.0-255,5738,208466,7,274190
10123,0.008343,172.31.36.0-255,66,208532,7,274190
10124,0.010947,74.125.24.0-255,5738,214270,7,274190
10125,0.010954,172.31.36.0-255,66,214336,7,274190
10126,0.01355,74.125.24.0-255,5738,220074,7,274190
10127,0.013568,172.31.36.0-255,66,220140,7,274190
10128,0.016188,74.125.24.0-255,5738,225878,7,274190
10129,0.016198,172.31.36.0-255,66,225944,7,274190
10130,0.018808,74.125.24.0-255,5738,231682,7,274190
10131,0.018817,172.31.36.0-255,66,231748,7,274190
10132,0.021428,74.125.24.0-255,5738,237486,7,274190
10133,0.021434,172.31.36.0-255,66,237552,7,274190
10134,0.024021,74.125.24.0-255,5738,243290,7,274190
10135,0.024028,172.31.36.0-255,66,243356,7,274190
10136,0.026662,74.125.24.0-255,5738,249094,7,274190
10137,0.026669,172.31.36.0-255,66,249160,7,274190
10138,0.027808,172.31.36.0-255,188,249348,7,274190
10139,0.027851,172.31.36.0-255,958,250306,7,274190
10140,0.027939,172.31.36.0-255,1514,251820,7,274190
10141,0.027942,172.31.36.0-255,1448,253268,7,274190
10142,0.029272,74.125.24.0-255,5738,259006,7,274190
10143,0.029278,172.31.36.0-255,66,259072,7,274190
10144,0.029321,104.244.42.0-255,66,259138,7,274190
10145,0.029369,104.244.42.0-255,66,259204,7,274190
10146,0.029571,104.244.42.0-255,66,259270,7,274190
10147,0.030973,104.244.42.0-255,108,259378,7,274190
10148,0.030978,172.31.36.0-255,66,259444,7,274190
10149,0.031868,74.125.24.0-255,2902,262346,7,274190
10150,0.031872,172.31.36.0-255,66,262412,7,274190
10151,0.031906,74.125.24.0-255,2902,265314,7,274190
10152,0.03191,172.31.36.0-255,66,265380,7,274190
10153,0.034479,74.125.24.0-255,2902,268282,7,274190
10154,0.034485,172.31.36.0-255,66,268348,7,274190
10155,0.034525,74.125.24.0-255,2902,271250,7,274190
10156,0.034529,172.31.36.0-255,66,271316,7,274190
10157,0.037111,74.125.24.0-255,2637,273953,7,274190
10158,0.037117,172.31.36.0-255,66,274019,7,274190
10159,0.037274,172.31.36.0-255,105,274124,7,274190
10160,0.039825,74.125.24.0-255,66,274190,7,274190
10161,0.0,74.125.24.0-255,298,298,7,276930
10162,3.1e-05,172.31.36.0-255,66,364,7,276930
10163,3.7e-05,74.125.24.0-255,1484,1848,7,276930
10164,4.2e-05,172.31.36.0-255,66,1914,7,276930
10165,4.7e-05,74.125.24.0-255,4320,6234,7,276930
10166,5e-05,172.31.36.0-255,66,6300,7,276930
10167,7.2e-05,172.31.36.0-255,66,6366,7,276930
10168,0.000132,74.125.24.0-255,2902,9268,7,276930
10169,0.000137,172.31.36.0-255,66,9334,7,276930
10170,0.000176,172.31.36.0-255,66,9400,7,276930
10171,0.000276,74.125.24.0-255,1484,10884,7,276930
10172,0.00028,172.31.36.0-255,66,10950,7,276930
10173,0.000302,74.125.24.0-255,2902,13852,7,276930
10174,0.000321,172.31.36.0-255,66,13918,7,276930
10175,0.000328,74.125.24.0-255,5738,19656,7,276930
10176,0.000331,172.31.36.0-255,66,19722,7,276930
10177,0.000382,74.125.24.0-255,5738,25460,7,276930
10178,0.000386,172.31.36.0-255,66,25526,7,276930
10179,0.000411,172.31.36.0-255,66,25592,7,276930
10180,0.000521,172.31.36.0-255,66,25658,7,276930
10181,0.000589,74.125.24.0-255,381,26039,7,276930
10182,0.000593,172.31.36.0-255,66,26105,7,276930
10183,0.000622,172.31.36.0-255,66,26171,7,276930
10184,0.000639,74.125.24.0-255,4320,30491,7,276930
10185,0.000645,172.31.36.0-255,66,30557,7,276930
10186,0.000738,172.31.36.0-255,66,30623,7,276930
10187,0.000773,172.31.36.0-255,66,30689,7,276930
10188,0.001096,74.125.24.0-255,1484,32173,7,276930
10189,0.001105,74.125.24.0-255,2902,35075,7,276930
10190,0.001109,172.31.36.0-255,66,35141,7,276930
10191,0.001137,74.125.24.0-255,5738,40879,7,276930
10192,0.001141,172.31.36.0-255,66,40945,7,276930
10193,0.001184,74.125.24.0-255,4320,45265,7,276930
10194,0.001188,172.31.36.0-255,66,45331,7,276930
10195,0.001234,172.31.36.0-255,66,45397,7,276930
10196,0.001344,172.31.36.0-255,66,45463,7,276930
10197,0.001406,74.125.24.0-255,7156,52619,7,276930
10198,0.00141,172.31.36.0-255,66,52685,7,276930
10199,0.001448,172.31.36.0-255,66,52751,7,276930
10200,0.001622,172.31.36.0-255,66,52817,7,276930
10201,0.001807,74.125.24.0-255,1484,54301,7,276930
10202,0.001813,74.125.24.0-255,2902,57203,7,276930
10203,0.001816,172.31.36.0-255,66,57269,7,276930
10204,0.001851,74.125.24.0-255,5738,63007,7,276930
10205,0.001855,172.31.36.0-255,66,63073,7,276930
10206,0.001892,74.125.24.0-255,7156,70229,7,276930
10207,0.001895,172.31.36.0-255,66,70295,7,276930
10208,0.001919,74.125.24.0-255,2902,73197,7,276930
10209,0.001922,172.31.36.0-255,66,73263,7,276930
10210,0.001975,74.125.24.0-255,4320,77583,7,276930
10211,0.001979,172.31.36.0-255,66,77649,7,276930
10212,0.002007,74.125.24.0-255,5738,83387,7,276930
10213,0.00201,172.31.36.0-255,66,83453,7,276930
10214,0.002075,74.125.24.0-255,3602,87055,7,276930
10215,0.002079,172.31.36.0-255,66,87121,7,276930
10216,0.002237,74.125.24.0-255,1484,88605,7,276930
10217,0.002259,74.125.24.0-255,2902,91507,7,276930
10218,0.002263,172.31.36.0-255,66,91573,7,276930
10219,0.00227,74.125.24.0-255,5738,97311,7,276930
10220,0.002271,172.31.36.0-255,66,97377,7,276930
10221,0.002311,74.125.24.0-255,4320,101697,7,276930
10222,0.002315,172.31.36.0-255,66,101763,7,276930
10223,0.002349,172.31.36.0-255,66,101829,7,276930
10224,0.004606,74.125.24.0-255,5738,107567,7,276930
10225,0.004612,172.31.36.0-255,66,107633,7,276930
10226,0.006875,74.125.24.0-255,5738,113371,7,276930
10227,0.00688,172.31.36.0-255,66,113437,7,276930
10228,0.009121,74.125.24.0-255,5738,119175,7,276930
10229,0.009129,172.31.36.0-255,66,119241,7,276930
10230,0.011396,74.125.24.0-255,5738,124979,7,276930
10231,0.011405,172.31.36.0-255,66,125045,7,276930
10232,0.013659,74.125.24.0-255,5738,130783,7,276930
10233,0.013668,172.31.36.0-255,66,130849,7,276930
10234,0.015946,74.125.24.0-255,5738,136587,7,276930
10235,0.015954,172.31.36.0-255,66,136653,7,276930
10236,0.018196,74.125.24.0-255,5738,142391,7,276930
10237,0.018203,172.31.36.0-255,66,142457,7,276930
10238,0.020457,74.125.24.0-255,5738,148195,7,276930
10239,0.020464,172.31.36.0-255,66,148261,7,276930
10240,0.022709,74.125.24.0-255,5738,153999,7,276930
10241,0.022716,172.31.36.0-255,66,154065,7,276930
10242,0.024963,74.125.24.0-255,5738,159803,7,276930
10243,0.024973,172.31.36.0-255,66,159869,7,276930
10244,0.027224,74.125.24.0-255,5738,165607,7,276930
10245,0.027232,172.31.36.0-255,66,165673,7,276930
10246,0.029498,74.125.24.0-255,5738,171411,7,276930
10247,0.029506,172.31.36.0-255,66,171477,7,276930
10248,0.031757,74.125.24.0-255,5738,177215,7,276930
10249,0.031764,172.31.36.0-255,66,177281,7,276930
10250,0.034006,74.125.24.0-255,5738,183019,7,276930
10251,0.034013,172.31.36.0-255,66,183085,7,276930
10252,0.034252,172.31.36.0-255,172,183257,7,276930
10253,0.034298,172.31.36.0-255,1115,184372,7,276930
10254,0.034378,172.31.36.0-255,1514,185886,7,276930
10255,0.03438,172.31.36.0-255,1293,187179,7,276930
10256,0.035798,104.244.42.0-255,66,187245,7,276930
10257,0.035874,104.244.42.0-255,66,187311,7,276930
10258,0.035923,104.244.42.0-255,66,187377,7,276930
10259,0.036268,74.125.24.0-255,1484,188861,7,276930
10260,0.0363,74.125.24.0-255,4320,193181,7,276930
10261,0.036318,172.31.36.0-255,66,193247,7,276930
10262,0.038565,74.125.24.0-255,5738,198985,7,276930
10263,0.038572,172.31.36.0-255,66,199051,7,276930
10264,0.040809,74.125.24.0-255,5738,204789,7,276930
10265,0.040815,172.31.36.0-255,66,204855,7,276930
10266,0.043069,74.125.24.0-255,5738,210593,7,276930
10267,0.043075,172.31.36.0-255,66,210659,7,276930
10268,0.045328,74.125.24.0-255,5738,216397,7,276930
10269,0.045334,172.31.36.0-255,66,216463,7,276930
10270,0.047609,74.125.24.0-255,5738,222201,7,276930
10271,0.047615,172.31.36.0-255,66,222267,7,276930
10272,0.04988,74.125.24.0-255,5738,228005,7,276930
10273,0.049885,172.31.36.0-255,66,228071,7,276930
10274,0.05215,74.125.24.0-255,5738,233809,7,276930
10275,0.052156,172.31.36.0-255,66,233875,7,276930
10276,0.054391,74.125.24.0-255,5738,239613,7,276930
10277,0.054397,172.31.36.0-255,66,239679,7,276930
10278,0.05664,74.125.24.0-255,5738,245417,7,276930
10279,0.056646,172.31.36.0-255,66,245483,7,276930
10280,0.058889,74.125.24.0-255,5738,251221,7,276930
10281,0.058894,172.31.36.0-255,66,251287,7,276930
10282,0.061136,74.125.24.0-255,2902,254189,7,276930
10283,0.061142,172.31.36.0-255,66,254255,7,276930
10284,0.061178,74.125.24.0-255,2902,257157,7,276930
10285,0.061181,172.31.36.0-255,66,257223,7,276930
10286,0.063394,74.125.24.0-255,2902,260125,7,276930
10287,0.0634,172.31.36.0-255,66,260191,7,276930
10288,0.063468,74.125.24.0-255,2902,263093,7,276930
10289,0.063473,172.31.36.0-255,66,263159,7,276930
10290,0.065677,74.125.24.0-255,2902,266061,7,276930
10291,0.065683,172.31.36.0-255,66,266127,7,276930
10292,0.065719,74.125.24.0-255,2902,269029,7,276930
10293,0.065723,172.31.36.0-255,66,269095,7,276930
10294,0.067936,74.125.24.0-255,2902,271997,7,276930
10295,0.067942,172.31.36.0-255,66,272063,7,276930
10296,0.06798,74.125.24.0-255,2902,274965,7,276930
10297,0.067983,172.31.36.0-255,66,275031,7,276930
10298,0.070188,74.125.24.0-255,1662,276693,7,276930
10299,0.070194,172.31.36.0-255,66,276759,7,276930
10300,0.070377,172.31.36.0-255,105,276864,7,276930
10301,0.072619,74.125.24.0-255,66,276930,7,276930
10302,0.0,74.125.24.0-255,150,150,7,341850
10303,2.5e-05,172.31.36.0-255,66,216,7,341850
10304,3.2e-05,74.125.24.0-255,1484,1700,7,341850
10305,3.7e-05,172.31.36.0-255,66,1766,7,341850
10306,4.4e-05,74.125.24.0-255,2902,4668,7,341850
10307,4.8e-05,172.31.36.0-255,66,4734,7,341850
10308,5.5e-05,74.125.24.0-255,5738,10472,7,341850
10309,5.8e-05,172.31.36.0-255,66,10538,7,341850
10310,7.2e-05,172.31.36.0-255,66,10604,7,341850
10311,0.0001,74.125.24.0-255,7156,17760,7,341850
10312,0.000104,172.31.36.0-255,66,17826,7,341850
10313,0.000133,74.125.24.0-255,2543,20369,7,341850
10314,0.000136,172.31.36.0-255,66,20435,7,341850
10315,0.000139,74.125.24.0-255,1484,21919,7,341850
10316,0.000141,172.31.36.0-255,66,21985,7,341850
10317,0.000145,74.125.24.0-255,2902,24887,7,341850
10318,0.000147,172.31.36.0-255,66,24953,7,341850
10319,0.000155,74.125.24.0-255,5738,30691,7,341850
10320,0.000158,172.31.36.0-255,66,30757,7,341850
10321,0.000183,74.125.24.0-255,4320,35077,7,341850
10322,0.000186,172.31.36.0-255,66,35143,7,341850
10323,0.000202,74.125.24.0-255,2543,37686,7,341850
10324,0.000204,172.31.36.0-255,66,37752,7,341850
10325,0.000223,74.125.24.0-255,7156,44908,7,341850
10326,0.000226,172.31.36.0-255,66,44974,7,341850
10327,0.000241,74.125.24.0-255,4320,49294,7,341850
10328,0.000244,172.31.36.0-255,66,49360,7,341850
10329,0.000258,74.125.24.0-255,4320,53680,7,341850
10330,0.00026,172.31.36.0-255,66,53746,7,341850
10331,0.000264,74.125.24.0-255,1420,55166,7,341850
10332,0.000266,172.31.36.0-255,66,55232,7,341850
10333,0.000717,74.125.24.0-255,130,55362,7,341850
10334,0.000721,74.125.24.0-255,348,55710,7,341850
10335,0.001044,172.31.36.0-255,66,55776,7,341850
10336,0.001314,74.125.24.0-255,1484,57260,7,341850
10337,0.001325,74.125.24.0-255,2902,60162,7,341850
10338,0.001329,172.31.36.0-255,66,60228,7,341850
10339,0.001333,74.125.24.0-255,1484,61712,7,341850
10340,0.001353,74.125.24.0-255,4320,66032,7,341850
10341,0.001355,172.31.36.0-255,66,66098,7,341850
10342,0.001378,74.125.24.0-255,1484,67582,7,341850
10343,0.001391,74.125.24.0-255,4320,71902,7,341850
10344,0.001394,172.31.36.0-255,66,71968,7,341850
10345,0.001408,74.125.24.0-255,4320,76288,7,341850
10346,0.00141,172.31.36.0-255,66,76354,7,341850
10347,0.001426,172.31.36.0-255,66,76420,7,341850
10348,0.00193,74.125.24.0-255,1484,77904,7,341850
10349,0.00194,74.125.24.0-255,2902,80806,7,341850
10350,0.001945,172.31.36.0-255,66,80872,7,341850
10351,0.001954,74.125.24.0-255,4320,85192,7,341850
10352,0.001956,172.31.36.0-255,66,85258,7,341850
10353,0.001976,74.125.24.0-255,1484,86742,7,341850
10354,0.001984,74.125.24.0-255,7156,93898,7,341850
10355,0.001986,172.31.36.0-255,66,93964,7,341850
10356,0.001991,74.125.24.0-255,2902,96866,7,341850
10357,0.001993,172.31.36.0-255,66,96932,7,341850
10358,0.002028,172.31.36.0-255,66,96998,7,341850
10359,0.002033,74.125.24.0-255,2184,99182,7,341850
10360,0.002035,172.31.36.0-255,66,99248,7,341850
10361,0.002039,74.125.24.0-255,2902,102150,7,341850
10362,0.002043,172.31.36.0-255,66,102216,7,341850
10363,0.002073,74.125.24.0-255,7156,109372,7,341850
10364,0.002075,172.31.36.0-255,66,109438,7,341850
10365,0.002083,74.125.24.0-255,7156,116594,7,341850
10366,0.002085,172.31.36.0-255,66,116660,7,341850
10367,0.002111,74.125.24.0-255,7156,123816,7,341850
10368,0.002115,172.31.36.0-255,66,123882,7,341850
10369,0.002141,172.31.36.0-255,66,123948,7,341850
10370,0.002143,74.125.24.0-255,766,124714,7,341850
10371,0.00219,74.125.24.0-255,1484,126198,7,341850
10372,0.002192,172.31.36.0-255,66,126264,7,341850
10373,0.002196,74.125.24.0-255,1484,127748,7,341850
10374,0.002207,74.125.24.0-255,1484,129232,7,341850
10375,0.002209,172.31.36.0-255,66,129298,7,341850
10376,0.002217,74.125.24.0-255,5738,135036,7,341850
10377,0.002219,172.31.36.0-255,66,135102,7,341850
10378,0.002244,74.125.24.0-255,2902,138004,7,341850
10379,0.002246,172.31.36.0-255,66,138070,7,341850
10380,0.002268,172.31.36.0-255,66,138136,7,341850
10381,0.002304,74.125.24.0-255,4320,142456,7,341850
10382,0.002307,172.31.36.0-255,66,142522,7,341850
10383,0.00233,74.125.24.0-255,6438,148960,7,341850
10384,0.002333,172.31.36.0-255,66,149026,7,341850
10385,0.002347,172.31.36.0-255,66,149092,7,341850
10386,0.00239,74.125.24.0-255,2902,151994,7,341850
10387,0.003374,172.31.36.0-255,66,152060,7,341850
10388,0.005734,74.125.24.0-255,5738,157798,7,341850
10389,0.005741,172.31.36.0-255,66,157864,7,341850
10390,0.008081,74.125.24.0-255,5738,163602,7,341850
10391,0.008085,172.31.36.0-255,66,163668,7,341850
10392,0.01044,74.125.24.0-255,5738,169406,7,341850
10393,0.010449,172.31.36.0-255,66,169472,7,341850
10394,0.012793,74.125.24.0-255,5738,175210,7,341850
10395,0.012806,172.31.36.0-255,66,175276,7,341850
10396,0.015182,74.125.24.0-255,5738,181014,7,341850
10397,0.015193,172.31.36.0-255,66,181080,7,341850
10398,0.017567,74.125.24.0-255,5738,186818,7,341850
10399,0.017583,172.31.36.0-255,66,186884,7,341850
10400,0.019945,74.125.24.0-255,5738,192622,7,341850
10401,0.019958,172.31.36.0-255,66,192688,7,341850
10402,0.022346,74.125.24.0-255,5738,198426,7,341850
10403,0.022356,172.31.36.0-255,66,198492,7,341850
10404,0.024773,74.125.24.0-255,5738,204230,7,341850
10405,0.024783,172.31.36.0-255,66,204296,7,341850
10406,0.027129,74.125.24.0-255,5738,210034,7,341850
10407,0.027141,172.31.36.0-255,66,210100,7,341850
10408,0.029554,74.125.24.0-255,5738,215838,7,341850
10409,0.029562,172.31.36.0-255,66,215904,7,341850
10410,0.030727,172.31.36.0-255,172,216076,7,341850
10411,0.030763,172.31.36.0-255,1115,217191,7,341850
10412,0.030835,172.31.36.0-255,1514,218705,7,341850
10413,0.030837,172.31.36.0-255,1514,220219,7,341850
10414,0.030838,172.31.36.0-255,1514,221733,7,341850
10415,0.030839,172.31.36.0-255,1072,222805,7,341850
10416,0.031909,74.125.24.0-255,5738,228543,7,341850
10417,0.031919,172.31.36.0-255,66,228609,7,341850
10418,0.03231,104.244.42.0-255,66,228675,7,341850
10419,0.032344,104.244.42.0-255,66,228741,7,341850
10420,0.032395,104.244.42.0-255,66,228807,7,341850
10421,0.032415,104.244.42.0-255,66,228873,7,341850
10422,0.034302,74.125.24.0-255,5738,234611,7,341850
10423,0.034307,172.31.36.0-255,66,234677,7,341850
10424,0.036723,74.125.24.0-255,5738,240415,7,341850
10425,0.036731,172.31.36.0-255,66,240481,7,341850
10426,0.039079,74.125.24.0-255,5738,246219,7,341850
10427,0.039086,172.31.36.0-255,66,246285,7,341850
10428,0.041431,74.125.24.0-255,5738,252023,7,341850
10429,0.041442,172.31.36.0-255,66,252089,7,341850
10430,0.043815,74.125.24.0-255,5738,257827,7,341850
10431,0.043823,172.31.36.0-255,66,257893,7,341850
10432,0.04621,74.125.24.0-255,5738,263631,7,341850
10433,0.046218,172.31.36.0-255,66,263697,7,341850
10434,0.048583,74.125.24.0-255,5738,269435,7,341850
10435,0.048595,172.31.36.0-255,66,269501,7,341850
10436,0.050985,74.125.24.0-255,5738,275239,7,341850
10437,0.050993,172.31.36.0-255,66,275305,7,341850
10438,0.053378,74.125.24.0-255,5738,281043,7,341850
10439,0.053385,172.31.36.0-255,66,281109,7,341850
10440,0.055781,74.125.24.0-255,5738,286847,7,341850
10441,0.055788,172.31.36.0-255,66,286913,7,341850
10442,0.058142,74.125.24.0-255,5738,292651,7,341850
10443,0.05815,172.31.36.0-255,66,292717,7,341850
10444,0.060508,74.125.24.0-255,5738,298455,7,341850
10445,0.060517,172.31.36.0-255,66,298521,7,341850
10446,0.062888,74.125.24.0-255,5738,304259,7,341850
10447,0.062897,172.31.36.0-255,66,304325,7,341850
10448,0.065286,74.125.24.0-255,5738,310063,7,341850
10449,0.065295,172.31.36.0-255,66,310129,7,341850
10450,0.067646,74.125.24.0-255,5738,315867,7,341850
10451,0.067652,172.31.36.0-255,66,315933,7,341850
10452,0.070035,74.125.24.0-255,5738,321671,7,341850
10453,0.070042,172.31.36.0-255,66,321737,7,341850
10454,0.072382,74.125.24.0-255,5738,327475,7,341850
10455,0.072389,172.31.36.0-255,66,327541,7,341850
10456,0.074755,74.125.24.0-255,5738,333279,7,341850
10457,0.074762,172.31.36.0-255,66,333345,7,341850
10458,0.077189,74.125.24.0-255,5738,339083,7,341850
10459,0.077196,172.31.36.0-255,66,339149,7,341850
10460,0.07955,74.125.24.0-255,2530,341679,7,341850
10461,0.079556,172.31.36.0-255,66,341745,7,341850
10462,0.079727,172.31.36.0-255,105,341850,7,341850
10463,0.0,74.125.200.0-255,153,153,7,402346
10464,2.5e-05,172.31.36.0-255,66,219,7,402346
10465,3.2e-05,74.125.200.0-255,1484,1703,7,402346
10466,3.6e-05,172.31.36.0-255,66,1769,7,402346
10467,4.1e-05,74.125.200.0-255,2902,4671,7,402346
10468,4.3e-05,172.31.36.0-255,66,4737,7,402346
10469,4.6e-05,74.125.200.0-255,1484,6221,7,402346
10470,4.9e-05,172.31.36.0-255,66,6287,7,402346
10471,6.8e-05,74.125.200.0-255,2902,9189,7,402346
10472,7e-05,172.31.36.0-255,66,9255,7,402346
10473,7.6e-05,74.125.200.0-255,4909,14164,7,402346
10474,7.9e-05,172.31.36.0-255,66,14230,7,402346
10475,0.000132,74.125.200.0-255,2902,17132,7,402346
10476,0.000136,172.31.36.0-255,66,17198,7,402346
10477,0.000158,74.125.200.0-255,2902,20100,7,402346
10478,0.000161,172.31.36.0-255,66,20166,7,402346
10479,0.000166,74.125.200.0-255,4320,24486,7,402346
10480,0.000168,172.31.36.0-255,66,24552,7,402346
10481,0.000197,74.125.200.0-255,1484,26036,7,402346
10482,0.0002,172.31.36.0-255,66,26102,7,402346
10483,0.000214,74.125.200.0-255,5379,31481,7,402346
10484,0.000217,172.31.36.0-255,66,31547,7,402346
10485,0.00041,74.125.200.0-255,1484,33031,7,402346
10486,0.000414,172.31.36.0-255,66,33097,7,402346
10487,0.000438,74.125.200.0-255,2902,35999,7,402346
10488,0.00044,172.31.36.0-255,66,36065,7,402346
10489,0.000453,74.125.200.0-255,1484,37549,7,402346
10490,0.000456,172.31.36.0-255,66,37615,7,402346
10491,0.000489,74.125.200.0-255,4320,41935,7,402346
10492,0.000492,172.31.36.0-255,66,42001,7,402346
10493,0.0005,74.125.200.0-255,6797,48798,7,402346
10494,0.000502,172.31.36.0-255,66,48864,7,402346
10495,0.000505,74.125.200.0-255,1484,50348,7,402346
10496,0.000528,74.125.200.0-255,2902,53250,7,402346
10497,0.000531,172.31.36.0-255,66,53316,7,402346
10498,0.000539,74.125.200.0-255,5738,59054,7,402346
10499,0.000541,172.31.36.0-255,66,59120,7,402346
10500,0.000565,74.125.200.0-255,1484,60604,7,402346
10501,0.00057,74.125.200.0-255,2902,63506,7,402346
10502,0.000572,172.31.36.0-255,66,63572,7,402346
10503,0.000601,74.125.200.0-255,2819,66391,7,402346
10504,0.000604,172.31.36.0-255,66,66457,7,402346
10505,0.000654,74.125.200.0-255,132,66589,7,402346
10506,0.00078,74.125.200.0-255,1484,68073,7,402346
10507,0.000785,172.31.36.0-255,66,68139,7,402346
10508,0.000805,74.125.200.0-255,2902,71041,7,402346
10509,0.000809,172.31.36.0-255,66,71107,7,402346
10510,0.000815,74.125.200.0-255,4320,75427,7,402346
10511,0.000816,172.31.36.0-255,66,75493,7,402346
10512,0.000845,74.125.200.0-255,7156,82649,7,402346
10513,0.000848,172.31.36.0-255,66,82715,7,402346
10514,0.000862,74.125.200.0-255,1484,84199,7,402346
10515,0.000875,74.125.200.0-255,2902,87101,7,402346
10516,0.000878,172.31.36.0-255,66,87167,7,402346
10517,0.000883,74.125.200.0-255,4320,91487,7,402346
10518,0.000885,172.31.36.0-255,66,91553,7,402346
10519,0.000891,74.125.200.0-255,4320,95873,7,402346
10520,0.000894,172.31.36.0-255,66,95939,7,402346
10521,0.000915,74.125.200.0-255,4320,100259,7,402346
10522,0.000918,172.31.36.0-255,66,100325,7,402346
10523,0.000921,74.125.200.0-255,766,101091,7,402346
10524,0.001049,74.125.200.0-255,1484,102575,7,402346
10525,0.001054,172.31.36.0-255,66,102641,7,402346
10526,0.001059,74.125.200.0-255,1484,104125,7,402346
10527,0.001063,74.125.200.0-255,2902,107027,7,402346
10528,0.001066,172.31.36.0-255,66,107093,7,402346
10529,0.001091,74.125.200.0-255,5738,112831,7,402346
10530,0.001094,172.31.36.0-255,66,112897,7,402346
10531,0.001119,74.125.200.0-255,4320,117217,7,402346
10532,0.001122,172.31.36.0-255,66,117283,7,402346
10533,0.001128,74.125.200.0-255,5738,123021,7,402346
10534,0.001131,172.31.36.0-255,66,123087,7,402346
10535,0.001169,172.31.36.0-255,66,123153,7,402346
10536,0.001187,74.125.200.0-255,2902,126055,7,402346
10537,0.001189,172.31.36.0-255,66,126121,7,402346
10538,0.001192,74.125.200.0-255,464,126585,7,402346
10539,0.001337,74.125.200.0-255,1484,128069,7,402346
10540,0.001339,172.31.36.0-255,66,128135,7,402346
10541,0.001344,74.125.200.0-255,2902,131037,7,402346
10542,0.001346,172.31.36.0-255,66,131103,7,402346
10543,0.001356,74.125.200.0-255,1484,132587,7,402346
10544,0.001389,74.125.200.0-255,2902,135489,7,402346
10545,0.001392,172.31.36.0-255,66,135555,7,402346
10546,0.001412,74.125.200.0-255,2902,138457,7,402346
10547,0.001414,172.31.36.0-255,66,138523,7,402346
10548,0.001437,74.125.200.0-255,4320,142843,7,402346
10549,0.00144,172.31.36.0-255,66,142909,7,402346
10550,0.001468,74.125.200.0-255,7156,150065,7,402346
10551,0.00147,172.31.36.0-255,66,150131,7,402346
10552,0.001496,74.125.200.0-255,1484,151615,7,402346
10553,0.001515,74.125.200.0-255,7156,158771,7,402346
10554,0.001517,172.31.36.0-255,66,158837,7,402346
10555,0.001521,74.125.200.0-255,2184,161021,7,402346
10556,0.001523,172.31.36.0-255,66,161087,7,402346
10557,0.001699,74.125.200.0-255,1484,162571,7,402346
10558,0.001721,74.125.200.0-255,2902,165473,7,402346
10559,0.001723,172.31.36.0-255,66,165539,7,402346
10560,0.001735,74.125.200.0-255,1484,167023,7,402346
10561,0.001756,74.125.200.0-255,2902,169925,7,402346
10562,0.001758,172.31.36.0-255,66,169991,7,402346
10563,0.001777,74.125.200.0-255,5738,175729,7,402346
10564,0.001779,172.31.36.0-255,66,175795,7,402346
10565,0.001784,74.125.200.0-255,4320,180115,7,402346
10566,0.001786,172.31.36.0-255,66,180181,7,402346
10567,0.001807,74.125.200.0-255,4320,184501,7,402346
10568,0.001809,172.31.36.0-255,66,184567,7,402346
10569,0.001819,172.31.36.0-255,66,184633,7,402346
10570,0.001874,74.125.200.0-255,3602,188235,7,402346
10571,0.001876,172.31.36.0-255,66,188301,7,402346
10572,0.001881,74.125.200.0-255,4320,192621,7,402346
10573,0.001883,172.31.36.0-255,66,192687,7,402346
10574,0.001921,74.125.200.0-255,2902,195589,7,402346
10575,0.001924,172.31.36.0-255,66,195655,7,402346
10576,0.001939,74.125.200.0-255,2902,198557,7,402346
10577,0.001941,172.31.36.0-255,66,198623,7,402346
10578,0.001953,74.125.200.0-255,2902,201525,7,402346
10579,0.001954,172.31.36.0-255,66,201591,7,402346
10580,0.001977,74.125.200.0-255,4320,205911,7,402346
10581,0.001979,172.31.36.0-255,66,205977,7,402346
10582,0.001982,74.125.200.0-255,1484,207461,7,402346
10583,0.002002,74.125.200.0-255,4320,211781,7,402346
10584,0.002004,172.31.36.0-255,66,211847,7,402346
10585,0.00201,74.125.200.0-255,7156,219003,7,402346
10586,0.002012,172.31.36.0-255,66,219069,7,402346
10587,0.002015,74.125.200.0-255,766,219835,7,402346
10588,0.00217,74.125.200.0-255,1484,221319,7,402346
10589,0.002172,172.31.36.0-255,66,221385,7,402346
10590,0.002191,74.125.200.0-255,2902,224287,7,402346
10591,0.002193,172.31.36.0-255,66,224353,7,402346
10592,0.002214,74.125.200.0-255,5738,230091,7,402346
10593,0.002216,172.31.36.0-255,66,230157,7,402346
10594,0.002232,74.125.200.0-255,1484,231641,7,402346
10595,0.002248,74.125.200.0-255,2902,234543,7,402346
10596,0.00225,172.31.36.0-255,66,234609,7,402346
10597,0.002272,74.125.200.0-255,4320,238929,7,402346
10598,0.002274,172.31.36.0-255,66,238995,7,402346
10599,0.002284,172.31.36.0-255,66,239061,7,402346
10600,0.00229,74.125.200.0-255,5020,244081,7,402346
10601,0.002292,172.31.36.0-255,66,244147,7,402346
10602,0.004831,74.125.200.0-255,5738,249885,7,402346
10603,0.004839,172.31.36.0-255,66,249951,7,402346
10604,0.00739,74.125.200.0-255,5738,255689,7,402346
10605,0.007396,172.31.36.0-255,66,255755,7,402346
10606,0.009944,74.125.200.0-255,5738,261493,7,402346
10607,0.009952,172.31.36.0-255,66,261559,7,402346
10608,0.012505,74.125.200.0-255,5738,267297,7,402346
10609,0.012515,172.31.36.0-255,66,267363,7,402346
10610,0.015061,74.125.200.0-255,5738,273101,7,402346
10611,0.015068,172.31.36.0-255,66,273167,7,402346
10612,0.017657,74.125.200.0-255,5738,278905,7,402346
10613,0.017668,172.31.36.0-255,66,278971,7,402346
10614,0.020221,74.125.200.0-255,5738,284709,7,402346
10615,0.020229,172.31.36.0-255,66,284775,7,402346
10616,0.022777,74.125.200.0-255,5738,290513,7,402346
10617,0.022786,172.31.36.0-255,66,290579,7,402346
10618,0.0249,172.31.36.0-255,172,290751,7,402346
10619,0.02493,172.31.36.0-255,1114,291865,7,402346
10620,0.024967,172.31.36.0-255,1514,293379,7,402346
10621,0.024969,172.31.36.0-255,1292,294671,7,402346
10622,0.025336,74.125.200.0-255,5738,300409,7,402346
10623,0.025343,172.31.36.0-255,66,300475,7,402346
10624,0.026418,104.244.42.0-255,66,300541,7,402346
10625,0.026464,104.244.42.0-255,66,300607,7,402346
10626,0.026527,104.244.42.0-255,66,300673,7,402346
10627,0.02789,74.125.200.0-255,5738,306411,7,402346
10628,0.027896,172.31.36.0-255,66,306477,7,402346
10629,0.030444,74.125.200.0-255,5738,312215,7,402346
10630,0.03045,172.31.36.0-255,66,312281,7,402346
10631,0.033,74.125.200.0-255,5738,318019,7,402346
10632,0.033006,172.31.36.0-255,66,318085,7,402346
10633,0.035558,74.125.200.0-255,5738,323823,7,402346
10634,0.035564,172.31.36.0-255,66,323889,7,402346
10635,0.038116,74.125.200.0-255,5738,329627,7,402346
10636,0.03812,172.31.36.0-255,66,329693,7,402346
10637,0.040661,74.125.200.0-255,5738,335431,7,402346
10638,0.040681,172.31.36.0-255,66,335497,7,402346
10639,0.043232,74.125.200.0-255,5738,341235,7,402346
10640,0.043237,172.31.36.0-255,66,341301,7,402346
10641,0.045787,74.125.200.0-255,5738,347039,7,402346
10642,0.045793,172.31.36.0-255,66,347105,7,402346
10643,0.048334,74.125.200.0-255,5738,352843,7,402346
10644,0.04834,172.31.36.0-255,66,352909,7,402346
10645,0.050943,74.125.200.0-255,5738,358647,7,402346
10646,0.050949,172.31.36.0-255,66,358713,7,402346
10647,0.053517,74.125.200.0-255,4320,363033,7,402346
10648,0.053523,172.31.36.0-255,66,363099,7,402346
10649,0.053552,74.125.200.0-255,1484,364583,7,402346
10650,0.056069,74.125.200.0-255,4320,368903,7,402346
10651,0.056074,172.31.36.0-255,66,368969,7,402346
10652,0.05864,74.125.200.0-255,5738,374707,7,402346
10653,0.058646,172.31.36.0-255,66,374773,7,402346
10654,0.06118,74.125.200.0-255,1484,376257,7,402346
10655,0.061214,74.125.200.0-255,4320,380577,7,402346
10656,0.061219,172.31.36.0-255,66,380643,7,402346
10657,0.063767,74.125.200.0-255,5738,386381,7,402346
10658,0.063772,172.31.36.0-255,66,386447,7,402346
10659,0.066317,74.125.200.0-255,5738,392185,7,402346
10660,0.066324,172.31.36.0-255,66,392251,7,402346
10661,0.068869,74.125.200.0-255,5738,397989,7,402346
10662,0.068875,172.31.36.0-255,66,398055,7,402346
10663,0.071418,74.125.200.0-255,4054,402109,7,402346
10664,0.071424,172.31.36.0-255,66,402175,7,402346
10665,0.071612,172.31.36.0-255,105,402280,7,402346
10666,0.074187,74.125.200.0-255,66,402346,7,402346
10667,0.0,172.217.27.0-255,146,146,7,378446
10668,3.4e-05,172.31.36.0-255,66,212,7,378446
10669,4.2e-05,172.217.27.0-255,1484,1696,7,378446
10670,4.6e-05,172.31.36.0-255,66,1762,7,378446
10671,5.1e-05,172.217.27.0-255,2902,4664,7,378446
10672,6.2e-05,172.31.36.0-255,66,4730,7,378446
10673,6.9e-05,172.217.27.0-255,7156,11886,7,378446
10674,7.3e-05,172.31.36.0-255,66,11952,7,378446
10675,7.7e-05,172.217.27.0-255,1967,13919,7,378446
10676,8e-05,172.31.36.0-255,66,13985,7,378446
10677,0.000122,172.217.27.0-255,1484,15469,7,378446
10678,0.000125,172.31.36.0-255,66,15535,7,378446
10679,0.00013,172.217.27.0-255,2902,18437,7,378446
10680,0.000133,172.31.36.0-255,66,18503,7,378446
10681,0.000146,172.217.27.0-255,5738,24241,7,378446
10682,0.00015,172.31.36.0-255,66,24307,7,378446
10683,0.000156,172.217.27.0-255,6797,31104,7,378446
10684,0.000159,172.31.36.0-255,66,31170,7,378446
10685,0.000559,172.217.27.0-255,1484,32654,7,378446
10686,0.000564,172.31.36.0-255,66,32720,7,378446
10687,0.000571,172.217.27.0-255,2902,35622,7,378446
10688,0.000574,172.31.36.0-255,66,35688,7,378446
10689,0.000588,172.217.27.0-255,5738,41426,7,378446
10690,0.00059,172.31.36.0-255,66,41492,7,378446
10691,0.00062,172.217.27.0-255,6797,48289,7,378446
10692,0.000629,172.31.36.0-255,66,48355,7,378446
10693,0.000708,172.217.27.0-255,1484,49839,7,378446
10694,0.000713,172.217.27.0-255,2902,52741,7,378446
10695,0.000714,172.31.36.0-255,66,52807,7,378446
10696,0.000719,172.31.36.0-255,66,52873,7,378446
10697,0.000752,172.217.27.0-255,5738,58611,7,378446
10698,0.000756,172.31.36.0-255,66,58677,7,378446
10699,0.000761,172.217.27.0-255,4320,62997,7,378446
10700,0.000764,172.31.36.0-255,66,63063,7,378446
10701,0.000785,172.217.27.0-255,2873,65936,7,378446
10702,0.000788,172.31.36.0-255,66,66002,7,378446
10703,0.001332,172.217.27.0-255,115,66117,7,378446
10704,0.001448,172.217.27.0-255,1484,67601,7,378446
10705,0.001454,172.31.36.0-255,66,67667,7,378446
10706,0.001461,172.217.27.0-255,2902,70569,7,378446
10707,0.001463,172.31.36.0-255,66,70635,7,378446
10708,0.00147,172.217.27.0-255,5738,76373,7,378446
10709,0.001481,172.31.36.0-255,66,76439,7,378446
10710,0.001488,172.217.27.0-255,6797,83236,7,378446
10711,0.001491,172.31.36.0-255,66,83302,7,378446
10712,0.00154,172.217.27.0-255,4320,87622,7,378446
10713,0.001544,172.31.36.0-255,66,87688,7,378446
10714,0.001553,172.217.27.0-255,5738,93426,7,378446
10715,0.001561,172.31.36.0-255,66,93492,7,378446
10716,0.001572,172.217.27.0-255,6797,100289,7,378446
10717,0.001577,172.31.36.0-255,66,100355,7,378446
10718,0.003229,172.217.27.0-255,5738,106093,7,378446
10719,0.003236,172.31.36.0-255,66,106159,7,378446
10720,0.004876,172.217.27.0-255,4320,110479,7,378446
10721,0.00488,172.31.36.0-255,66,110545,7,378446
10722,0.004907,172.217.27.0-255,1484,112029,7,378446
10723,0.006524,172.217.27.0-255,4320,116349,7,378446
10724,0.00653,172.31.36.0-255,66,116415,7,378446
10725,0.00817,172.217.27.0-255,5738,122153,7,378446
10726,0.008178,172.31.36.0-255,66,122219,7,378446
10727,0.009826,172.217.27.0-255,5738,127957,7,378446
10728,0.009833,172.31.36.0-255,66,128023,7,378446
10729,0.011483,172.217.27.0-255,5738,133761,7,378446
10730,0.01149,172.31.36.0-255,66,133827,7,378446
10731,0.013143,172.217.27.0-255,5738,139565,7,378446
10732,0.013154,172.31.36.0-255,66,139631,7,378446
10733,0.014804,172.217.27.0-255,5738,145369,7,378446
10734,0.014811,172.31.36.0-255,66,145435,7,378446
10735,0.016506,172.217.27.0-255,5738,151173,7,378446
10736,0.016513,172.31.36.0-255,66,151239,7,378446
10737,0.01816,172.217.27.0-255,5738,156977,7,378446
10738,0.018167,172.31.36.0-255,66,157043,7,378446
10739,0.01982,172.217.27.0-255,5738,162781,7,378446
10740,0.019827,172.31.36.0-255,66,162847,7,378446
10741,0.021468,172.217.27.0-255,5738,168585,7,378446
10742,0.021476,172.31.36.0-255,66,168651,7,378446
10743,0.023133,172.217.27.0-255,5738,174389,7,378446
10744,0.023139,172.31.36.0-255,66,174455,7,378446
10745,0.024786,172.217.27.0-255,5738,180193,7,378446
10746,0.024794,172.31.36.0-255,66,180259,7,378446
10747,0.025863,172.31.36.0-255,188,180447,7,378446
10748,0.025893,172.31.36.0-255,958,181405,7,378446
10749,0.025933,172.31.36.0-255,1514,182919,7,378446
10750,0.025935,172.31.36.0-255,1514,184433,7,378446
10751,0.02594,172.31.36.0-255,1514,185947,7,378446
10752,0.025941,172.31.36.0-255,1229,187176,7,378446
10753,0.02644,172.217.27.0-255,5738,192914,7,378446
10754,0.026447,172.31.36.0-255,66,192980,7,378446
10755,0.027441,104.244.42.0-255,66,193046,7,378446
10756,0.027448,104.244.42.0-255,66,193112,7,378446
10757,0.027529,104.244.42.0-255,66,193178,7,378446
10758,0.027532,104.244.42.0-255,66,193244,7,378446
10759,0.028096,172.217.27.0-255,5738,198982,7,378446
10760,0.0281,172.31.36.0-255,66,199048,7,378446
10761,0.029748,172.217.27.0-255,5738,204786,7,378446
10762,0.029753,172.31.36.0-255,66,204852,7,378446
10763,0.031397,172.217.27.0-255,5738,210590,7,378446
10764,0.031403,172.31.36.0-255,66,210656,7,378446
10765,0.033076,172.217.27.0-255,5738,216394,7,378446
10766,0.033082,172.31.36.0-255,66,216460,7,378446
10767,0.034767,172.217.27.0-255,4320,220780,7,378446
10768,0.034773,172.31.36.0-255,66,220846,7,378446
10769,0.034809,172.217.27.0-255,1484,222330,7,378446
10770,0.036415,172.217.27.0-255,4320,226650,7,378446
10771,0.036421,172.31.36.0-255,66,226716,7,378446
10772,0.038068,172.217.27.0-255,1484,228200,7,378446
10773,0.038101,172.217.27.0-255,4320,232520,7,378446
10774,0.038105,172.31.36.0-255,66,232586,7,378446
10775,0.039758,172.217.27.0-255,5738,238324,7,378446
10776,0.039764,172.31.36.0-255,66,238390,7,378446
10777,0.041409,172.217.27.0-255,5738,244128,7,378446
10778,0.041414,172.31.36.0-255,66,244194,7,378446
10779,0.043059,172.217.27.0-255,5738,249932,7,378446
10780,0.043064,172.31.36.0-255,66,249998,7,378446
10781,0.044721,172.217.27.0-255,5738,255736,7,378446
10782,0.044727,172.31.36.0-255,66,255802,7,378446
10783,0.046378,172.217.27.0-255,5738,261540,7,378446
10784,0.046385,172.31.36.0-255,66,261606,7,378446
10785,0.048036,172.217.27.0-255,5738,267344,7,378446
10786,0.048042,172.31.36.0-255,66,267410,7,378446
10787,0.049686,172.217.27.0-255,5738,273148,7,378446
10788,0.049692,172.31.36.0-255,66,273214,7,378446
10789,0.051328,172.217.27.0-255,4320,277534,7,378446
10790,0.051334,172.31.36.0-255,66,277600,7,378446
10791,0.051367,172.217.27.0-255,1484,279084,7,378446
10792,0.052977,172.217.27.0-255,4320,283404,7,378446
10793,0.052981,172.31.36.0-255,66,283470,7,378446
10794,0.05462,172.217.27.0-255,2902,286372,7,378446
10795,0.054625,172.31.36.0-255,66,286438,7,378446
10796,0.054657,172.217.27.0-255,2902,289340,7,378446
10797,0.05466,172.31.36.0-255,66,289406,7,378446
10798,0.056264,172.217.27.0-255,2902,292308,7,378446
10799,0.056269,172.31.36.0-255,66,292374,7,378446
10800,0.056303,172.217.27.0-255,2902,295276,7,378446
10801,0.056306,172.31.36.0-255,66,295342,7,378446
10802,0.057911,172.217.27.0-255,2902,298244,7,378446
10803,0.057918,172.31.36.0-255,66,298310,7,378446
10804,0.057948,172.217.27.0-255,2902,301212,7,378446
10805,0.057952,172.31.36.0-255,66,301278,7,378446
10806,0.059566,172.217.27.0-255,2902,304180,7,378446
10807,0.059571,172.31.36.0-255,66,304246,7,378446
10808,0.05961,172.217.27.0-255,2902,307148,7,378446
10809,0.059615,172.31.36.0-255,66,307214,7,378446
10810,0.06121,172.217.27.0-255,2902,310116,7,378446
10811,0.061215,172.31.36.0-255,66,310182,7,378446
10812,0.061252,172.217.27.0-255,2902,313084,7,378446
10813,0.061255,172.31.36.0-255,66,313150,7,378446
10814,0.062861,172.217.27.0-255,2902,316052,7,378446
10815,0.062866,172.31.36.0-255,66,316118,7,378446
10816,0.062897,172.217.27.0-255,2902,319020,7,378446
10817,0.0629,172.31.36.0-255,66,319086,7,378446
10818,0.064513,172.217.27.0-255,2902,321988,7,378446
10819,0.064518,172.31.36.0-255,66,322054,7,378446
10820,0.064557,172.217.27.0-255,2902,324956,7,378446
10821,0.064561,172.31.36.0-255,66,325022,7,378446
10822,0.066158,172.217.27.0-255,2902,327924,7,378446
10823,0.066164,172.31.36.0-255,66,327990,7,378446
10824,0.0662,172.217.27.0-255,2902,330892,7,378446
10825,0.066204,172.31.36.0-255,66,330958,7,378446
10826,0.067803,172.217.27.0-255,2902,333860,7,378446
10827,0.067808,172.31.36.0-255,66,333926,7,378446
10828,0.067839,172.217.27.0-255,2902,336828,7,378446
10829,0.067842,172.31.36.0-255,66,336894,7,378446
10830,0.069447,172.217.27.0-255,2902,339796,7,378446
10831,0.069452,172.31.36.0-255,66,339862,7,378446
10832,0.06949,172.217.27.0-255,2902,342764,7,378446
10833,0.069493,172.31.36.0-255,66,342830,7,378446
10834,0.071097,172.217.27.0-255,2902,345732,7,378446
10835,0.071102,172.31.36.0-255,66,345798,7,378446
10836,0.071136,172.217.27.0-255,2902,348700,7,378446
10837,0.071139,172.31.36.0-255,66,348766,7,378446
10838,0.072746,172.217.27.0-255,2902,351668,7,378446
10839,0.072751,172.31.36.0-255,66,351734,7,378446
10840,0.072784,172.217.27.0-255,2902,354636,7,378446
10841,0.072787,172.31.36.0-255,66,354702,7,378446
10842,0.074402,172.217.27.0-255,2902,357604,7,378446
10843,0.074407,172.31.36.0-255,66,357670,7,378446
10844,0.074442,172.217.27.0-255,2902,360572,7,378446
10845,0.074445,172.31.36.0-255,66,360638,7,378446
10846,0.076061,172.217.27.0-255,2902,363540,7,378446
10847,0.076066,172.31.36.0-255,66,363606,7,378446
10848,0.076106,172.217.27.0-255,2902,366508,7,378446
10849,0.076109,172.31.36.0-255,66,366574,7,378446
10850,0.077701,172.217.27.0-255,2902,369476,7,378446
10851,0.077706,172.31.36.0-255,66,369542,7,378446
10852,0.077744,172.217.27.0-255,2902,372444,7,378446
10853,0.077747,172.31.36.0-255,66,372510,7,378446
10854,0.079355,172.217.27.0-255,2902,375412,7,378446
10855,0.079361,172.31.36.0-255,66,375478,7,378446
10856,0.079398,172.217.27.0-255,2902,378380,7,378446
10857,0.079402,172.31.36.0-255,66,378446,7,378446
10858,0.0,172.217.24.0-255,153,153,7,392605
10859,2.7e-05,172.31.36.0-255,66,219,7,392605
10860,3.3e-05,172.217.24.0-255,1484,1703,7,392605
10861,3.8e-05,172.31.36.0-255,66,1769,7,392605
10862,4.1e-05,172.217.24.0-255,1484,3253,7,392605
10863,4.3e-05,172.31.36.0-255,66,3319,7,392605
10864,6.5e-05,172.217.24.0-255,2902,6221,7,392605
10865,6.7e-05,172.31.36.0-255,66,6287,7,392605
10866,7.3e-05,172.217.24.0-255,5738,12025,7,392605
10867,7.5e-05,172.31.36.0-255,66,12091,7,392605
10868,9.4e-05,172.217.24.0-255,2067,14158,7,392605
10869,9.7e-05,172.31.36.0-255,66,14224,7,392605
10870,0.000138,172.217.24.0-255,1484,15708,7,392605
10871,0.000142,172.31.36.0-255,66,15774,7,392605
10872,0.000166,172.217.24.0-255,1484,17258,7,392605
10873,0.00017,172.31.36.0-255,66,17324,7,392605
10874,0.000185,172.217.24.0-255,1484,18808,7,392605
10875,0.000187,172.31.36.0-255,66,18874,7,392605
10876,0.000193,172.217.24.0-255,5738,24612,7,392605
10877,0.000196,172.31.36.0-255,66,24678,7,392605
10878,0.000203,172.217.24.0-255,6797,31475,7,392605
10879,0.000205,172.31.36.0-255,66,31541,7,392605
10880,0.000359,172.217.24.0-255,1484,33025,7,392605
10881,0.000363,172.31.36.0-255,66,33091,7,392605
10882,0.000367,172.217.24.0-255,1484,34575,7,392605
10883,0.000369,172.31.36.0-255,66,34641,7,392605
10884,0.000381,172.217.24.0-255,1484,36125,7,392605
10885,0.000384,172.31.36.0-255,66,36191,7,392605
10886,0.00039,172.217.24.0-255,5738,41929,7,392605
10887,0.000393,172.31.36.0-255,66,41995,7,392605
10888,0.000396,172.217.24.0-255,1484,43479,7,392605
10889,0.000399,172.31.36.0-255,66,43545,7,392605
10890,0.000417,172.217.24.0-255,4320,47865,7,392605
10891,0.00042,172.31.36.0-255,66,47931,7,392605
10892,0.000423,172.217.24.0-255,1484,49415,7,392605
10893,0.000444,172.217.24.0-255,5379,54794,7,392605
10894,0.000448,172.31.36.0-255,66,54860,7,392605
10895,0.000453,172.217.24.0-255,4320,59180,7,392605
10896,0.000455,172.31.36.0-255,66,59246,7,392605
10897,0.000497,172.217.24.0-255,4320,63566,7,392605
10898,0.000502,172.31.36.0-255,66,63632,7,392605
10899,0.000519,172.217.24.0-255,2543,66175,7,392605
10900,0.000523,172.31.36.0-255,66,66241,7,392605
10901,0.000526,172.217.24.0-255,356,66597,7,392605
10902,0.000818,172.31.36.0-255,66,66663,7,392605
10903,0.00103,172.217.24.0-255,387,67050,7,392605
10904,0.001105,172.217.24.0-255,1484,68534,7,392605
10905,0.001109,172.31.36.0-255,66,68600,7,392605
10906,0.001115,172.217.24.0-255,2902,71502,7,392605
10907,0.001117,172.31.36.0-255,66,71568,7,392605
10908,0.001122,172.217.24.0-255,4320,75888,7,392605
10909,0.001124,172.31.36.0-255,66,75954,7,392605
10910,0.001136,172.217.24.0-255,1484,77438,7,392605
10911,0.00116,172.217.24.0-255,4320,81758,7,392605
10912,0.001163,172.31.36.0-255,66,81824,7,392605
10913,0.001182,172.217.24.0-255,2543,84367,7,392605
10914,0.001185,172.31.36.0-255,66,84433,7,392605
10915,0.001188,172.217.24.0-255,1484,85917,7,392605
10916,0.001207,172.217.24.0-255,5738,91655,7,392605
10917,0.00121,172.31.36.0-255,66,91721,7,392605
10918,0.001216,172.217.24.0-255,7156,98877,7,392605
10919,0.001218,172.31.36.0-255,66,98943,7,392605
10920,0.001236,172.217.24.0-255,1484,100427,7,392605
10921,0.001248,172.217.24.0-255,1125,101552,7,392605
10922,0.001251,172.31.36.0-255,66,101618,7,392605
10923,0.001547,172.217.24.0-255,1484,103102,7,392605
10924,0.001554,172.217.24.0-255,2902,106004,7,392605
10925,0.001558,172.31.36.0-255,66,106070,7,392605
10926,0.001564,172.217.24.0-255,4320,110390,7,392605
10927,0.001566,172.31.36.0-255,66,110456,7,392605
10928,0.001578,172.217.24.0-255,1484,111940,7,392605
10929,0.001583,172.217.24.0-255,5738,117678,7,392605
10930,0.001585,172.31.36.0-255,66,117744,7,392605
10931,0.001609,172.217.24.0-255,1484,119228,7,392605
10932,0.001623,172.31.36.0-255,66,119294,7,392605
10933,0.001627,172.217.24.0-255,2184,121478,7,392605
10934,0.001628,172.31.36.0-255,66,121544,7,392605
10935,0.001693,172.217.24.0-255,1484,123028,7,392605
10936,0.00171,172.217.24.0-255,2902,125930,7,392605
10937,0.001712,172.31.36.0-255,66,125996,7,392605
10938,0.001716,172.217.24.0-255,2902,128898,7,392605
10939,0.001718,172.31.36.0-255,66,128964,7,392605
10940,0.001733,172.217.24.0-255,2902,131866,7,392605
10941,0.001735,172.31.36.0-255,66,131932,7,392605
10942,0.001742,172.217.24.0-255,7156,139088,7,392605
10943,0.001744,172.31.36.0-255,66,139154,7,392605
10944,0.001788,172.31.36.0-255,66,139220,7,392605
10945,0.001791,172.217.24.0-255,2184,141404,7,392605
10946,0.001793,172.31.36.0-255,66,141470,7,392605
10947,0.001876,172.217.24.0-255,1484,142954,7,392605
10948,0.00188,172.217.24.0-255,2902,145856,7,392605
10949,0.001896,172.217.24.0-255,5738,151594,7,392605
10950,0.001911,172.217.24.0-255,1484,153078,7,392605
10951,0.00192,172.217.24.0-255,1484,154562,7,392605
10952,0.001934,172.217.24.0-255,4320,158882,7,392605
10953,0.001947,172.217.24.0-255,5738,164620,7,392605
10954,0.00199,172.217.24.0-255,7156,171776,7,392605
10955,0.002,172.217.24.0-255,1484,173260,7,392605
10956,0.002003,172.217.24.0-255,2184,175444,7,392605
10957,0.002006,172.217.24.0-255,2902,178346,7,392605
10958,0.00474,172.31.36.0-255,66,178412,7,392605
10959,0.006751,172.217.24.0-255,5738,184150,7,392605
10960,0.006757,172.31.36.0-255,66,184216,7,392605
10961,0.008737,172.217.24.0-255,5738,189954,7,392605
10962,0.008743,172.31.36.0-255,66,190020,7,392605
10963,0.010921,172.217.24.0-255,5738,195758,7,392605
10964,0.010957,172.31.36.0-255,66,195824,7,392605
10965,0.012961,172.217.24.0-255,5738,201562,7,392605
10966,0.012968,172.31.36.0-255,66,201628,7,392605
10967,0.014948,172.217.24.0-255,5738,207366,7,392605
10968,0.014956,172.31.36.0-255,66,207432,7,392605
10969,0.016942,172.217.24.0-255,5738,213170,7,392605
10970,0.01695,172.31.36.0-255,66,213236,7,392605
10971,0.018937,172.217.24.0-255,5738,218974,7,392605
10972,0.018944,172.31.36.0-255,66,219040,7,392605
10973,0.020949,172.217.24.0-255,5738,224778,7,392605
10974,0.020957,172.31.36.0-255,66,224844,7,392605
10975,0.022946,172.217.24.0-255,5738,230582,7,392605
10976,0.022956,172.31.36.0-255,66,230648,7,392605
10977,0.024939,172.217.24.0-255,5738,236386,7,392605
10978,0.024945,172.31.36.0-255,66,236452,7,392605
10979,0.026927,172.217.24.0-255,5738,242190,7,392605
10980,0.026935,172.31.36.0-255,66,242256,7,392605
10981,0.028916,172.217.24.0-255,4320,246576,7,392605
10982,0.028923,172.31.36.0-255,66,246642,7,392605
10983,0.028936,172.217.24.0-255,1484,248126,7,392605
10984,0.030897,172.217.24.0-255,4320,252446,7,392605
10985,0.030902,172.31.36.0-255,66,252512,7,392605
10986,0.031746,172.31.36.0-255,172,252684,7,392605
10987,0.031773,172.31.36.0-255,1115,253799,7,392605
10988,0.031811,172.31.36.0-255,564,254363,7,392605
10989,0.032888,172.217.24.0-255,5738,260101,7,392605
10990,0.032895,172.31.36.0-255,66,260167,7,392605
10991,0.033318,104.244.42.0-255,66,260233,7,392605
10992,0.033326,104.244.42.0-255,66,260299,7,392605
10993,0.033356,104.244.42.0-255,66,260365,7,392605
10994,0.03488,172.217.24.0-255,5738,266103,7,392605
10995,0.034884,172.31.36.0-255,66,266169,7,392605
10996,0.036862,172.217.24.0-255,2902,269071,7,392605
10997,0.036867,172.31.36.0-255,66,269137,7,392605
10998,0.036893,172.217.24.0-255,2902,272039,7,392605
10999,0.036896,172.31.36.0-255,66,272105,7,392605
11000,0.038844,172.217.24.0-255,2902,275007,7,392605
11001,0.03885,172.31.36.0-255,66,275073,7,392605
11002,0.038882,172.217.24.0-255,2902,277975,7,392605
11003,0.038885,172.31.36.0-255,66,278041,7,392605
11004,0.040821,172.217.24.0-255,2902,280943,7,392605
11005,0.040828,172.31.36.0-255,66,281009,7,392605
11006,0.040848,172.217.24.0-255,2902,283911,7,392605
11007,0.040851,172.31.36.0-255,66,283977,7,392605
11008,0.042798,172.217.24.0-255,2902,286879,7,392605
11009,0.042804,172.31.36.0-255,66,286945,7,392605
11010,0.042838,172.217.24.0-255,2902,289847,7,392605
11011,0.042841,172.31.36.0-255,66,289913,7,392605
11012,0.044771,172.217.24.0-255,2902,292815,7,392605
11013,0.044777,172.31.36.0-255,66,292881,7,392605
11014,0.04481,172.217.24.0-255,2902,295783,7,392605
11015,0.044814,172.31.36.0-255,66,295849,7,392605
11016,0.046746,172.217.24.0-255,2902,298751,7,392605
11017,0.046751,172.31.36.0-255,66,298817,7,392605
11018,0.046839,172.217.24.0-255,2902,301719,7,392605
11019,0.046841,172.31.36.0-255,66,301785,7,392605
11020,0.048724,172.217.24.0-255,2902,304687,7,392605
11021,0.04873,172.31.36.0-255,66,304753,7,392605
11022,0.048798,172.217.24.0-255,2902,307655,7,392605
11023,0.048803,172.31.36.0-255,66,307721,7,392605
11024,0.050693,172.217.24.0-255,1484,309205,7,392605
11025,0.050774,172.217.24.0-255,4320,313525,7,392605
11026,0.05078,172.31.36.0-255,66,313591,7,392605
11027,0.052758,172.217.24.0-255,4320,317911,7,392605
11028,0.052764,172.31.36.0-255,66,317977,7,392605
11029,0.052789,172.217.24.0-255,1484,319461,7,392605
11030,0.05474,172.217.24.0-255,4320,323781,7,392605
11031,0.054746,172.31.36.0-255,66,323847,7,392605
11032,0.05672,172.217.24.0-255,5738,329585,7,392605
11033,0.056725,172.31.36.0-255,66,329651,7,392605
11034,0.058706,172.217.24.0-255,1484,331135,7,392605
11035,0.058739,172.217.24.0-255,4320,335455,7,392605
11036,0.058743,172.31.36.0-255,66,335521,7,392605
11037,0.06073,172.217.24.0-255,5738,341259,7,392605
11038,0.060735,172.31.36.0-255,66,341325,7,392605
11039,0.062712,172.217.24.0-255,5738,347063,7,392605
11040,0.062717,172.31.36.0-255,66,347129,7,392605
11041,0.06471,172.217.24.0-255,4320,351449,7,392605
11042,0.064716,172.31.36.0-255,66,351515,7,392605
11043,0.064748,172.217.24.0-255,1484,352999,7,392605
11044,0.066743,172.217.24.0-255,4320,357319,7,392605
11045,0.066749,172.31.36.0-255,66,357385,7,392605
11046,0.068716,172.217.24.0-255,5738,363123,7,392605
11047,0.068721,172.31.36.0-255,66,363189,7,392605
11048,0.070701,172.217.24.0-255,5738,368927,7,392605
11049,0.070707,172.31.36.0-255,66,368993,7,392605
11050,0.07268,172.217.24.0-255,5738,374731,7,392605
11051,0.072685,172.31.36.0-255,66,374797,7,392605
11052,0.074656,172.217.24.0-255,2902,377699,7,392605
11053,0.074661,172.31.36.0-255,66,377765,7,392605
11054,0.074694,172.217.24.0-255,2902,380667,7,392605
11055,0.074697,172.31.36.0-255,66,380733,7,392605
11056,0.076632,172.217.24.0-255,2902,383635,7,392605
11057,0.076638,172.31.36.0-255,66,383701,7,392605
11058,0.076669,172.217.24.0-255,2902,386603,7,392605
11059,0.076673,172.31.36.0-255,66,386669,7,392605
11060,0.078613,172.217.24.0-255,2902,389571,7,392605
11061,0.078619,172.31.36.0-255,66,389637,7,392605
11062,0.078649,172.217.24.0-255,2902,392539,7,392605
11063,0.078652,172.31.36.0-255,66,392605,7,392605
11064,0.0,172.217.194.0-255,142,142,7,216434
11065,2.4e-05,172.31.36.0-255,66,208,7,216434
11066,3.1e-05,172.217.194.0-255,1484,1692,7,216434
11067,3.6e-05,172.31.36.0-255,66,1758,7,216434
11068,4.9e-05,172.217.194.0-255,2902,4660,7,216434
11069,5.3e-05,172.31.36.0-255,66,4726,7,216434
11070,6.1e-05,172.217.194.0-255,7156,11882,7,216434
11071,6.4e-05,172.31.36.0-255,66,11948,7,216434
11072,6.8e-05,172.217.194.0-255,2045,13993,7,216434
11073,7e-05,172.31.36.0-255,66,14059,7,216434
11074,7.6e-05,172.217.194.0-255,2902,16961,7,216434
11075,7.8e-05,172.31.36.0-255,66,17027,7,216434
11076,0.0001,172.217.194.0-255,7156,24183,7,216434
11077,0.000109,172.31.36.0-255,66,24249,7,216434
11078,0.000116,172.217.194.0-255,5738,29987,7,216434
11079,0.000118,172.31.36.0-255,66,30053,7,216434
11080,0.000158,172.217.194.0-255,1125,31178,7,216434
11081,0.000161,172.31.36.0-255,66,31244,7,216434
11082,0.000264,172.217.194.0-255,1484,32728,7,216434
11083,0.000268,172.31.36.0-255,66,32794,7,216434
11084,0.000273,172.217.194.0-255,2902,35696,7,216434
11085,0.000275,172.31.36.0-255,66,35762,7,216434
11086,0.000288,172.217.194.0-255,5738,41500,7,216434
11087,0.000291,172.31.36.0-255,66,41566,7,216434
11088,0.000328,172.31.36.0-255,66,41632,7,216434
11089,0.000341,172.31.36.0-255,66,41698,7,216434
11090,0.000375,172.217.194.0-255,4268,45966,7,216434
11091,0.000378,172.31.36.0-255,66,46032,7,216434
11092,0.000455,172.217.194.0-255,1484,47516,7,216434
11093,0.000458,172.31.36.0-255,66,47582,7,216434
11094,0.000485,172.217.194.0-255,2902,50484,7,216434
11095,0.000488,172.31.36.0-255,66,50550,7,216434
11096,0.000495,172.217.194.0-255,5738,56288,7,216434
11097,0.000497,172.31.36.0-255,66,56354,7,216434
11098,0.000543,172.31.36.0-255,66,56420,7,216434
11099,0.00057,172.217.194.0-255,4320,60740,7,216434
11100,0.000573,172.31.36.0-255,66,60806,7,216434
11101,0.000591,172.217.194.0-255,5671,66477,7,216434
11102,0.000594,172.31.36.0-255,66,66543,7,216434
11103,0.000927,172.217.194.0-255,1484,68027,7,216434
11104,0.00095,172.217.194.0-255,2902,70929,7,216434
11105,0.000954,172.31.36.0-255,66,70995,7,216434
11106,0.000986,172.217.194.0-255,5738,76733,7,216434
11107,0.000989,172.31.36.0-255,66,76799,7,216434
11108,0.001028,172.31.36.0-255,66,76865,7,216434
11109,0.001059,172.217.194.0-255,4320,81185,7,216434
11110,0.001062,172.31.36.0-255,66,81251,7,216434
11111,0.001074,172.31.36.0-255,66,81317,7,216434
11112,0.001078,172.217.194.0-255,2184,83501,7,216434
11113,0.00108,172.31.36.0-255,66,83567,7,216434
11114,0.001162,172.217.194.0-255,1484,85051,7,216434
11115,0.001167,172.217.194.0-255,2902,87953,7,216434
11116,0.00117,172.31.36.0-255,66,88019,7,216434
11117,0.001177,172.217.194.0-255,5738,93757,7,216434
11118,0.001179,172.31.36.0-255,66,93823,7,216434
11119,0.001187,172.217.194.0-255,1484,95307,7,216434
11120,0.00121,172.217.194.0-255,7156,102463,7,216434
11121,0.001212,172.31.36.0-255,66,102529,7,216434
11122,0.001241,172.217.194.0-255,2902,105431,7,216434
11123,0.001244,172.31.36.0-255,66,105497,7,216434
11124,0.001285,172.31.36.0-255,66,105563,7,216434
11125,0.001306,172.31.36.0-255,66,105629,7,216434
11126,0.00132,172.31.36.0-255,66,105695,7,216434
11127,0.001348,172.217.194.0-255,1484,107179,7,216434
11128,0.001363,172.217.194.0-255,5738,112917,7,216434
11129,0.001366,172.31.36.0-255,66,112983,7,216434
11130,0.001429,172.31.36.0-255,66,113049,7,216434
11131,0.001447,172.31.36.0-255,66,113115,7,216434
11132,0.001613,172.217.194.0-255,1484,114599,7,216434
11133,0.00162,172.217.194.0-255,2902,117501,7,216434
11134,0.001624,172.31.36.0-255,66,117567,7,216434
11135,0.001629,172.217.194.0-255,2902,120469,7,216434
11136,0.001631,172.31.36.0-255,66,120535,7,216434
11137,0.001664,172.217.194.0-255,2902,123437,7,216434
11138,0.001668,172.31.36.0-255,66,123503,7,216434
11139,0.001688,172.31.36.0-255,66,123569,7,216434
11140,0.001699,172.31.36.0-255,66,123635,7,216434
11141,0.001724,172.217.194.0-255,1484,125119,7,216434
11142,0.001727,172.217.194.0-255,766,125885,7,216434
11143,0.00173,172.31.36.0-255,66,125951,7,216434
11144,0.002325,172.217.194.0-255,1484,127435,7,216434
11145,0.002332,172.217.194.0-255,2902,130337,7,216434
11146,0.002337,172.31.36.0-255,66,130403,7,216434
11147,0.002343,172.217.194.0-255,2902,133305,7,216434
11148,0.002346,172.31.36.0-255,66,133371,7,216434
11149,0.002383,172.217.194.0-255,2902,136273,7,216434
11150,0.002385,172.31.36.0-255,66,136339,7,216434
11151,0.002392,172.217.194.0-255,5738,142077,7,216434
11152,0.002395,172.31.36.0-255,66,142143,7,216434
11153,0.002409,172.31.36.0-255,66,142209,7,216434
11154,0.002415,172.217.194.0-255,5020,147229,7,216434
11155,0.002417,172.31.36.0-255,66,147295,7,216434
11156,0.002476,172.217.194.0-255,1484,148779,7,216434
11157,0.002488,172.217.194.0-255,2902,151681,7,216434
11158,0.002491,172.31.36.0-255,66,151747,7,216434
11159,0.002495,172.217.194.0-255,2902,154649,7,216434
11160,0.002498,172.31.36.0-255,66,154715,7,216434
11161,0.002517,172.217.194.0-255,2902,157617,7,216434
11162,0.002519,172.31.36.0-255,66,157683,7,216434
11163,0.002536,172.31.36.0-255,66,157749,7,216434
11164,0.002558,172.217.194.0-255,4320,162069,7,216434
11165,0.002561,172.31.36.0-255,66,162135,7,216434
11166,0.002572,172.31.36.0-255,66,162201,7,216434
11167,0.002613,172.217.194.0-255,3602,165803,7,216434
11168,0.002616,172.31.36.0-255,66,165869,7,216434
11169,0.002631,172.31.36.0-255,66,165935,7,216434
11170,0.002645,172.31.36.0-255,66,166001,7,216434
11171,0.002651,172.217.194.0-255,4320,170321,7,216434
11172,0.002653,172.31.36.0-255,66,170387,7,216434
11173,0.002689,172.217.194.0-255,6438,176825,7,216434
11174,0.002691,172.31.36.0-255,66,176891,7,216434
11175,0.005288,172.217.194.0-255,4320,181211,7,216434
11176,0.005292,172.31.36.0-255,66,181277,7,216434
11177,0.005319,172.217.194.0-255,1484,182761,7,216434
11178,0.007904,172.217.194.0-255,4320,187081,7,216434
11179,0.007911,172.31.36.0-255,66,187147,7,216434
11180,0.010492,172.217.194.0-255,2902,190049,7,216434
11181,0.0105,172.31.36.0-255,66,190115,7,216434
11182,0.010533,172.217.194.0-255,2902,193017,7,216434
11183,0.010536,172.31.36.0-255,66,193083,7,216434
11184,0.013113,172.217.194.0-255,5738,198821,7,216434
11185,0.013121,172.31.36.0-255,66,198887,7,216434
11186,0.015696,172.217.194.0-255,5738,204625,7,216434
11187,0.015706,172.31.36.0-255,66,204691,7,216434
11188,0.018313,172.217.194.0-255,5738,210429,7,216434
11189,0.018326,172.31.36.0-255,66,210495,7,216434
11190,0.020921,172.217.194.0-255,3652,214147,7,216434
11191,0.020929,172.31.36.0-255,66,214213,7,216434
11192,0.02171,172.31.36.0-255,105,214318,7,216434
11193,0.024279,172.217.194.0-255,66,214384,7,216434
11194,0.038116,172.31.36.0-255,172,214556,7,216434
11195,0.038171,172.31.36.0-255,1113,215669,7,216434
11196,0.038229,172.31.36.0-255,567,216236,7,216434
11197,0.039712,104.244.42.0-255,66,216302,7,216434
11198,0.039749,104.244.42.0-255,66,216368,7,216434
11199,0.039805,104.244.42.0-255,66,216434,7,216434
11200,0.0,172.217.194.0-255,66,66,7,66
11201,0.0,74.125.24.0-255,153,153,7,170423
11202,2.4e-05,172.31.36.0-255,66,219,7,170423
11203,3e-05,74.125.24.0-255,1484,1703,7,170423
11204,3.4e-05,172.31.36.0-255,66,1769,7,170423
11205,3.8e-05,74.125.24.0-255,2902,4671,7,170423
11206,4e-05,172.31.36.0-255,66,4737,7,170423
11207,5.4e-05,74.125.24.0-255,7156,11893,7,170423
11208,5.7e-05,172.31.36.0-255,66,11959,7,170423
11209,6e-05,74.125.24.0-255,1965,13924,7,170423
11210,6.3e-05,172.31.36.0-255,66,13990,7,170423
11211,7.4e-05,172.31.36.0-255,66,14056,7,170423
11212,0.000112,74.125.24.0-255,5379,19435,7,170423
11213,0.000115,172.31.36.0-255,66,19501,7,170423
11214,0.000154,74.125.24.0-255,1484,20985,7,170423
11215,0.000156,172.31.36.0-255,66,21051,7,170423
11216,0.000182,74.125.24.0-255,2902,23953,7,170423
11217,0.000186,172.31.36.0-255,66,24019,7,170423
11218,0.000191,74.125.24.0-255,5738,29757,7,170423
11219,0.000194,172.31.36.0-255,66,29823,7,170423
11220,0.000197,74.125.24.0-255,2902,32725,7,170423
11221,0.000199,172.31.36.0-255,66,32791,7,170423
11222,0.000224,74.125.24.0-255,5738,38529,7,170423
11223,0.00023,172.31.36.0-255,66,38595,7,170423
11224,0.000258,74.125.24.0-255,5379,43974,7,170423
11225,0.000262,172.31.36.0-255,66,44040,7,170423
11226,0.000266,74.125.24.0-255,2902,46942,7,170423
11227,0.000269,172.31.36.0-255,66,47008,7,170423
11228,0.000294,74.125.24.0-255,4320,51328,7,170423
11229,0.000297,172.31.36.0-255,66,51394,7,170423
11230,0.000322,74.125.24.0-255,2921,54315,7,170423
11231,0.000325,172.31.36.0-255,66,54381,7,170423
11232,0.000328,74.125.24.0-255,331,54712,7,170423
11233,0.000514,74.125.24.0-255,1484,56196,7,170423
11234,0.000519,172.31.36.0-255,66,56262,7,170423
11235,0.000523,74.125.24.0-255,2902,59164,7,170423
11236,0.000525,172.31.36.0-255,66,59230,7,170423
11237,0.000529,74.125.24.0-255,2902,62132,7,170423
11238,0.000537,172.31.36.0-255,66,62198,7,170423
11239,0.000563,74.125.24.0-255,2902,65100,7,170423
11240,0.000565,172.31.36.0-255,66,65166,7,170423
11241,0.000568,74.125.24.0-255,1484,66650,7,170423
11242,0.000583,172.31.36.0-255,66,66716,7,170423
11243,0.000586,74.125.24.0-255,1484,68200,7,170423
11244,0.000629,172.31.36.0-255,66,68266,7,170423
11245,0.001026,74.125.24.0-255,1484,69750,7,170423
11246,0.001036,74.125.24.0-255,2902,72652,7,170423
11247,0.00104,172.31.36.0-255,66,72718,7,170423
11248,0.001047,74.125.24.0-255,5738,78456,7,170423
11249,0.001049,172.31.36.0-255,66,78522,7,170423
11250,0.001109,172.31.36.0-255,66,78588,7,170423
11251,0.001126,74.125.24.0-255,2902,81490,7,170423
11252,0.001129,172.31.36.0-255,66,81556,7,170423
11253,0.001167,172.31.36.0-255,66,81622,7,170423
11254,0.00117,74.125.24.0-255,1484,83106,7,170423
11255,0.001173,74.125.24.0-255,2902,86008,7,170423
11256,0.001175,172.31.36.0-255,66,86074,7,170423
11257,0.001208,74.125.24.0-255,5738,91812,7,170423
11258,0.001211,172.31.36.0-255,66,91878,7,170423
11259,0.001218,74.125.24.0-255,7156,99034,7,170423
11260,0.00122,172.31.36.0-255,66,99100,7,170423
11261,0.001238,172.31.36.0-255,66,99166,7,170423
11262,0.001242,74.125.24.0-255,2184,101350,7,170423
11263,0.001244,172.31.36.0-255,66,101416,7,170423
11264,0.001307,74.125.24.0-255,1484,102900,7,170423
11265,0.001313,74.125.24.0-255,2902,105802,7,170423
11266,0.001317,172.31.36.0-255,66,105868,7,170423
11267,0.00132,74.125.24.0-255,1484,107352,7,170423
11268,0.001351,74.125.24.0-255,4320,111672,7,170423
11269,0.001355,172.31.36.0-255,66,111738,7,170423
11270,0.001366,172.31.36.0-255,66,111804,7,170423
11271,0.001376,74.125.24.0-255,5738,117542,7,170423
11272,0.001378,172.31.36.0-255,66,117608,7,170423
11273,0.001416,74.125.24.0-255,5020,122628,7,170423
11274,0.001419,172.31.36.0-255,66,122694,7,170423
11275,0.001737,74.125.24.0-255,1484,124178,7,170423
11276,0.001744,74.125.24.0-255,2902,127080,7,170423
11277,0.001748,172.31.36.0-255,66,127146,7,170423
11278,0.001753,74.125.24.0-255,2902,130048,7,170423
11279,0.001755,172.31.36.0-255,66,130114,7,170423
11280,0.001759,74.125.24.0-255,2902,133016,7,170423
11281,0.001766,172.31.36.0-255,66,133082,7,170423
11282,0.001797,74.125.24.0-255,1484,134566,7,170423
11283,0.001809,172.31.36.0-255,66,134632,7,170423
11284,0.001813,74.125.24.0-255,2902,137534,7,170423
11285,0.001815,172.31.36.0-255,66,137600,7,170423
11286,0.001854,172.31.36.0-255,66,137666,7,170423
11287,0.001983,74.125.24.0-255,1484,139150,7,170423
11288,0.001989,74.125.24.0-255,2902,142052,7,170423
11289,0.001992,172.31.36.0-255,66,142118,7,170423
11290,0.001995,74.125.24.0-255,1484,143602,7,170423
11291,0.002022,74.125.24.0-255,4320,147922,7,170423
11292,0.002025,172.31.36.0-255,66,147988,7,170423
11293,0.002031,74.125.24.0-255,5738,153726,7,170423
11294,0.002033,172.31.36.0-255,66,153792,7,170423
11295,0.002055,172.31.36.0-255,66,153858,7,170423
11296,0.002076,74.125.24.0-255,2902,156760,7,170423
11297,0.002078,172.31.36.0-255,66,156826,7,170423
11298,0.002096,172.31.36.0-255,66,156892,7,170423
11299,0.002111,172.31.36.0-255,66,156958,7,170423
11300,0.00215,74.125.24.0-255,4320,161278,7,170423
11301,0.002152,172.31.36.0-255,66,161344,7,170423
11302,0.00218,74.125.24.0-255,3602,164946,7,170423
11303,0.002183,172.31.36.0-255,66,165012,7,170423
11304,0.002197,172.31.36.0-255,66,165078,7,170423
11305,0.002207,172.31.36.0-255,66,165144,7,170423
11306,0.002217,172.31.36.0-255,66,165210,7,170423
11307,0.002261,172.31.36.0-255,66,165276,7,170423
11308,0.002271,172.31.36.0-255,66,165342,7,170423
11309,0.00229,172.31.36.0-255,66,165408,7,170423
11310,0.002331,172.31.36.0-255,66,165474,7,170423
11311,0.002346,172.31.36.0-255,66,165540,7,170423
11312,0.002368,172.31.36.0-255,66,165606,7,170423
11313,0.002383,172.31.36.0-255,66,165672,7,170423
11314,0.002385,74.125.24.0-255,105,165777,7,170423
11315,0.003669,172.31.36.0-255,101,165878,7,170423
11316,0.004528,172.31.36.0-255,105,165983,7,170423
11317,0.006214,74.125.24.0-255,66,166049,7,170423
11318,0.007092,74.125.24.0-255,66,166115,7,170423
11319,0.026532,172.31.36.0-255,188,166303,7,170423
11320,0.026567,172.31.36.0-255,958,167261,7,170423
11321,0.026626,172.31.36.0-255,1514,168775,7,170423
11322,0.026628,172.31.36.0-255,1450,170225,7,170423
11323,0.028059,104.244.42.0-255,66,170291,7,170423
11324,0.028097,104.244.42.0-255,66,170357,7,170423
11325,0.02819,104.244.42.0-255,66,170423,7,170423
11326,0.0,172.217.27.0-255,153,153,7,356842
11327,2.5e-05,172.31.36.0-255,66,219,7,356842
11328,3.3e-05,172.217.27.0-255,1484,1703,7,356842
11329,3.8e-05,172.31.36.0-255,66,1769,7,356842
11330,4.6e-05,172.217.27.0-255,2902,4671,7,356842
11331,5e-05,172.31.36.0-255,66,4737,7,356842
11332,5.4e-05,172.217.27.0-255,1484,6221,7,356842
11333,5.6e-05,172.31.36.0-255,66,6287,7,356842
11334,6.1e-05,172.217.27.0-255,2902,9189,7,356842
11335,6.4e-05,172.31.36.0-255,66,9255,7,356842
11336,9.6e-05,172.217.27.0-255,6224,15479,7,356842
11337,9.8e-05,172.31.36.0-255,66,15545,7,356842
11338,0.00011,172.31.36.0-255,66,15611,7,356842
11339,0.000126,172.217.27.0-255,2902,18513,7,356842
11340,0.000128,172.31.36.0-255,66,18579,7,356842
11341,0.000143,172.217.27.0-255,3961,22540,7,356842
11342,0.000146,172.31.36.0-255,66,22606,7,356842
11343,0.000215,172.217.27.0-255,1484,24090,7,356842
11344,0.000218,172.31.36.0-255,66,24156,7,356842
11345,0.000223,172.217.27.0-255,2902,27058,7,356842
11346,0.000225,172.31.36.0-255,66,27124,7,356842
11347,0.000254,172.217.27.0-255,5738,32862,7,356842
11348,0.000257,172.31.36.0-255,66,32928,7,356842
11349,0.000264,172.217.27.0-255,6797,39725,7,356842
11350,0.000266,172.31.36.0-255,66,39791,7,356842
11351,0.001057,172.217.27.0-255,1484,41275,7,356842
11352,0.001064,172.31.36.0-255,66,41341,7,356842
11353,0.001072,172.217.27.0-255,2902,44243,7,356842
11354,0.001075,172.31.36.0-255,66,44309,7,356842
11355,0.001082,172.217.27.0-255,5738,50047,7,356842
11356,0.001084,172.31.36.0-255,66,50113,7,356842
11357,0.001099,172.217.27.0-255,2902,53015,7,356842
11358,0.001101,172.31.36.0-255,66,53081,7,356842
11359,0.001121,172.217.27.0-255,3961,57042,7,356842
11360,0.001124,172.31.36.0-255,66,57108,7,356842
11361,0.001131,172.217.27.0-255,7156,64264,7,356842
11362,0.001133,172.31.36.0-255,66,64330,7,356842
11363,0.001167,172.31.36.0-255,66,64396,7,356842
11364,0.001223,172.217.27.0-255,1484,65880,7,356842
11365,0.001228,172.217.27.0-255,1484,67364,7,356842
11366,0.001231,172.31.36.0-255,66,67430,7,356842
11367,0.001247,172.217.27.0-255,1484,68914,7,356842
11368,0.001255,172.217.27.0-255,5738,74652,7,356842
11369,0.001257,172.31.36.0-255,66,74718,7,356842
11370,0.001263,172.217.27.0-255,2902,77620,7,356842
11371,0.001265,172.31.36.0-255,66,77686,7,356842
11372,0.001289,172.217.27.0-255,4320,82006,7,356842
11373,0.001292,172.31.36.0-255,66,82072,7,356842
11374,0.001295,172.217.27.0-255,287,82359,7,356842
11375,0.002928,172.217.27.0-255,4320,86679,7,356842
11376,0.002938,172.31.36.0-255,66,86745,7,356842
11377,0.004565,172.217.27.0-255,4320,91065,7,356842
11378,0.004569,172.31.36.0-255,66,91131,7,356842
11379,0.004586,172.217.27.0-255,1484,92615,7,356842
11380,0.006224,172.217.27.0-255,4320,96935,7,356842
11381,0.006231,172.31.36.0-255,66,97001,7,356842
11382,0.007875,172.217.27.0-255,5738,102739,7,356842
11383,0.007884,172.31.36.0-255,66,102805,7,356842
11384,0.009531,172.217.27.0-255,5738,108543,7,356842
11385,0.00954,172.31.36.0-255,66,108609,7,356842
11386,0.011188,172.217.27.0-255,5738,114347,7,356842
11387,0.011197,172.31.36.0-255,66,114413,7,356842
11388,0.012838,172.217.27.0-255,5738,120151,7,356842
11389,0.012848,172.31.36.0-255,66,120217,7,356842
11390,0.014496,172.217.27.0-255,5738,125955,7,356842
11391,0.014507,172.31.36.0-255,66,126021,7,356842
11392,0.016194,172.217.27.0-255,5738,131759,7,356842
11393,0.016205,172.31.36.0-255,66,131825,7,356842
11394,0.017885,172.217.27.0-255,5738,137563,7,356842
11395,0.017897,172.31.36.0-255,66,137629,7,356842
11396,0.019544,172.217.27.0-255,5738,143367,7,356842
11397,0.019555,172.31.36.0-255,66,143433,7,356842
11398,0.021188,172.217.27.0-255,5738,149171,7,356842
11399,0.021197,172.31.36.0-255,66,149237,7,356842
11400,0.022847,172.217.27.0-255,5738,154975,7,356842
11401,0.022855,172.31.36.0-255,66,155041,7,356842
11402,0.0245,172.217.27.0-255,5738,160779,7,356842
11403,0.024509,172.31.36.0-255,66,160845,7,356842
11404,0.026163,172.217.27.0-255,5738,166583,7,356842
11405,0.026171,172.31.36.0-255,66,166649,7,356842
11406,0.0278,172.217.27.0-255,5738,172387,7,356842
11407,0.027807,172.31.36.0-255,66,172453,7,356842
11408,0.029236,172.31.36.0-255,172,172625,7,356842
11409,0.029278,172.31.36.0-255,1114,173739,7,356842
11410,0.029345,172.31.36.0-255,1514,175253,7,356842
11411,0.029347,172.31.36.0-255,1293,176546,7,356842
11412,0.029435,172.217.27.0-255,5738,182284,7,356842
11413,0.02944,172.31.36.0-255,66,182350,7,356842
11414,0.030783,104.244.42.0-255,66,182416,7,356842
11415,0.030812,104.244.42.0-255,66,182482,7,356842
11416,0.030935,104.244.42.0-255,66,182548,7,356842
11417,0.031098,172.217.27.0-255,5738,188286,7,356842
11418,0.031104,172.31.36.0-255,66,188352,7,356842
11419,0.032782,172.217.27.0-255,5738,194090,7,356842
11420,0.032789,172.31.36.0-255,66,194156,7,356842
11421,0.034428,172.217.27.0-255,5738,199894,7,356842
11422,0.034435,172.31.36.0-255,66,199960,7,356842
11423,0.036079,172.217.27.0-255,5738,205698,7,356842
11424,0.036085,172.31.36.0-255,66,205764,7,356842
11425,0.037729,172.217.27.0-255,5738,211502,7,356842
11426,0.037736,172.31.36.0-255,66,211568,7,356842
11427,0.037792,104.244.42.0-255,108,211676,7,356842
11428,0.037795,172.31.36.0-255,66,211742,7,356842
11429,0.039386,172.217.27.0-255,5738,217480,7,356842
11430,0.039395,172.31.36.0-255,66,217546,7,356842
11431,0.041038,172.217.27.0-255,5738,223284,7,356842
11432,0.041049,172.31.36.0-255,66,223350,7,356842
11433,0.042701,172.217.27.0-255,5738,229088,7,356842
11434,0.042707,172.31.36.0-255,66,229154,7,356842
11435,0.044341,172.217.27.0-255,5738,234892,7,356842
11436,0.044347,172.31.36.0-255,66,234958,7,356842
11437,0.045991,172.217.27.0-255,5738,240696,7,356842
11438,0.046006,172.31.36.0-255,66,240762,7,356842
11439,0.047658,172.217.27.0-255,5738,246500,7,356842
11440,0.047675,172.31.36.0-255,66,246566,7,356842
11441,0.049323,172.217.27.0-255,5738,252304,7,356842
11442,0.049338,172.31.36.0-255,66,252370,7,356842
11443,0.050979,172.217.27.0-255,5738,258108,7,356842
11444,0.05099,172.31.36.0-255,66,258174,7,356842
11445,0.05264,172.217.27.0-255,5738,263912,7,356842
11446,0.052655,172.31.36.0-255,66,263978,7,356842
11447,0.054296,172.217.27.0-255,5738,269716,7,356842
11448,0.054305,172.31.36.0-255,66,269782,7,356842
11449,0.055962,172.217.27.0-255,5738,275520,7,356842
11450,0.055969,172.31.36.0-255,66,275586,7,356842
11451,0.05761,172.217.27.0-255,5738,281324,7,356842
11452,0.057617,172.31.36.0-255,66,281390,7,356842
11453,0.059244,172.217.27.0-255,5738,287128,7,356842
11454,0.059251,172.31.36.0-255,66,287194,7,356842
11455,0.060897,172.217.27.0-255,5738,292932,7,356842
11456,0.060904,172.31.36.0-255,66,292998,7,356842
11457,0.062557,172.217.27.0-255,5738,298736,7,356842
11458,0.062563,172.31.36.0-255,66,298802,7,356842
11459,0.06422,172.217.27.0-255,5738,304540,7,356842
11460,0.064226,172.31.36.0-255,66,304606,7,356842
11461,0.065873,172.217.27.0-255,5738,310344,7,356842
11462,0.06588,172.31.36.0-255,66,310410,7,356842
11463,0.067524,172.217.27.0-255,5738,316148,7,356842
11464,0.06753,172.31.36.0-255,66,316214,7,356842
11465,0.06917,172.217.27.0-255,5738,321952,7,356842
11466,0.069176,172.31.36.0-255,66,322018,7,356842
11467,0.070858,172.217.27.0-255,5738,327756,7,356842
11468,0.070864,172.31.36.0-255,66,327822,7,356842
11469,0.07251,172.217.27.0-255,5738,333560,7,356842
11470,0.072515,172.31.36.0-255,66,333626,7,356842
11471,0.074157,172.217.27.0-255,5738,339364,7,356842
11472,0.074163,172.31.36.0-255,66,339430,7,356842
11473,0.075814,172.217.27.0-255,5738,345168,7,356842
11474,0.07582,172.31.36.0-255,66,345234,7,356842
11475,0.077452,172.217.27.0-255,5738,350972,7,356842
11476,0.077458,172.31.36.0-255,66,351038,7,356842
11477,0.079107,172.217.27.0-255,5738,356776,7,356842
11478,0.079115,172.31.36.0-255,66,356842,7,356842
11479,0.0,74.125.24.0-255,153,153,7,260476
11480,2.1e-05,172.31.36.0-255,66,219,7,260476
11481,5.4e-05,74.125.24.0-255,1484,1703,7,260476
11482,5.8e-05,172.31.36.0-255,66,1769,7,260476
11483,6.3e-05,74.125.24.0-255,2902,4671,7,260476
11484,6.5e-05,172.31.36.0-255,66,4737,7,260476
11485,6.8e-05,74.125.24.0-255,1484,6221,7,260476
11486,7e-05,172.31.36.0-255,66,6287,7,260476
11487,9.7e-05,74.125.24.0-255,4320,10607,7,260476
11488,0.0001,172.31.36.0-255,66,10673,7,260476
11489,0.000105,74.125.24.0-255,3496,14169,7,260476
11490,0.000108,172.31.36.0-255,66,14235,7,260476
11491,0.0006,74.125.24.0-255,1484,15719,7,260476
11492,0.000606,172.31.36.0-255,66,15785,7,260476
11493,0.000616,74.125.24.0-255,2902,18687,7,260476
11494,0.000619,172.31.36.0-255,66,18753,7,260476
11495,0.000625,74.125.24.0-255,5738,24491,7,260476
11496,0.000627,172.31.36.0-255,66,24557,7,260476
11497,0.00067,74.125.24.0-255,7156,31713,7,260476
11498,0.000674,172.31.36.0-255,66,31779,7,260476
11499,0.000693,74.125.24.0-255,3961,35740,7,260476
11500,0.000696,172.31.36.0-255,66,35806,7,260476
11501,0.00071,172.31.36.0-255,66,35872,7,260476
11502,0.000712,74.125.24.0-255,1125,36997,7,260476
11503,0.000714,172.31.36.0-255,66,37063,7,260476
11504,0.000739,74.125.24.0-255,1484,38547,7,260476
11505,0.000743,172.31.36.0-255,66,38613,7,260476
11506,0.000763,74.125.24.0-255,4320,42933,7,260476
11507,0.000767,172.31.36.0-255,66,42999,7,260476
11508,0.000772,74.125.24.0-255,4320,47319,7,260476
11509,0.000774,172.31.36.0-255,66,47385,7,260476
11510,0.00078,74.125.24.0-255,4320,51705,7,260476
11511,0.000792,74.125.24.0-255,1484,53189,7,260476
11512,0.000806,74.125.24.0-255,1397,54586,7,260476
11513,0.000914,74.125.24.0-255,383,54969,7,260476
11514,0.001042,74.125.24.0-255,1484,56453,7,260476
11515,0.001057,74.125.24.0-255,2902,59355,7,260476
11516,0.001084,74.125.24.0-255,4320,63675,7,260476
11517,0.001133,74.125.24.0-255,5738,69413,7,260476
11518,0.001145,74.125.24.0-255,2543,71956,7,260476
11519,0.00117,74.125.24.0-255,4320,76276,7,260476
11520,0.001188,74.125.24.0-255,2902,79178,7,260476
11521,0.001202,74.125.24.0-255,4320,83498,7,260476
11522,0.001218,74.125.24.0-255,4320,87818,7,260476
11523,0.001221,74.125.24.0-255,1125,88943,7,260476
11524,0.001563,74.125.24.0-255,1484,90427,7,260476
11525,0.001579,74.125.24.0-255,2902,93329,7,260476
11526,0.001615,74.125.24.0-255,5738,99067,7,260476
11527,0.001622,74.125.24.0-255,5738,104805,7,260476
11528,0.001641,74.125.24.0-255,7156,111961,7,260476
11529,0.001646,74.125.24.0-255,5738,117699,7,260476
11530,0.001647,172.31.36.0-255,66,117765,7,260476
11531,0.001655,172.31.36.0-255,66,117831,7,260476
11532,0.001699,74.125.24.0-255,5020,122851,7,260476
11533,0.00171,172.31.36.0-255,66,122917,7,260476
11534,0.001721,74.125.24.0-255,4320,127237,7,260476
11535,0.001727,172.31.36.0-255,66,127303,7,260476
11536,0.001746,74.125.24.0-255,1484,128787,7,260476
11537,0.001751,74.125.24.0-255,4320,133107,7,260476
11538,0.001766,172.31.36.0-255,66,133173,7,260476
11539,0.00178,74.125.24.0-255,2902,136075,7,260476
11540,0.001783,74.125.24.0-255,1484,137559,7,260476
11541,0.001795,172.31.36.0-255,66,137625,7,260476
11542,0.001833,172.31.36.0-255,66,137691,7,260476
11543,0.001864,74.125.24.0-255,1484,139175,7,260476
11544,0.001876,74.125.24.0-255,2902,142077,7,260476
11545,0.001894,172.31.36.0-255,66,142143,7,260476
11546,0.001896,74.125.24.0-255,4320,146463,7,260476
11547,0.001899,172.31.36.0-255,66,146529,7,260476
11548,0.001913,74.125.24.0-255,1484,148013,7,260476
11549,0.001949,74.125.24.0-255,5738,153751,7,260476
11550,0.001952,172.31.36.0-255,66,153817,7,260476
11551,0.001958,172.31.36.0-255,66,153883,7,260476
11552,0.001987,74.125.24.0-255,4320,158203,7,260476
11553,0.001999,172.31.36.0-255,66,158269,7,260476
11554,0.002003,74.125.24.0-255,766,159035,7,260476
11555,0.002035,74.125.24.0-255,1484,160519,7,260476
11556,0.002042,172.31.36.0-255,66,160585,7,260476
11557,0.00206,74.125.24.0-255,2902,163487,7,260476
11558,0.002067,74.125.24.0-255,5738,169225,7,260476
11559,0.002072,172.31.36.0-255,66,169291,7,260476
11560,0.002123,172.31.36.0-255,66,169357,7,260476
11561,0.002141,74.125.24.0-255,1484,170841,7,260476
11562,0.002173,172.31.36.0-255,66,170907,7,260476
11563,0.00222,74.125.24.0-255,1484,172391,7,260476
11564,0.002239,74.125.24.0-255,2902,175293,7,260476
11565,0.002251,172.31.36.0-255,66,175359,7,260476
11566,0.002262,74.125.24.0-255,5738,181097,7,260476
11567,0.002267,172.31.36.0-255,66,181163,7,260476
11568,0.002278,74.125.24.0-255,1484,182647,7,260476
11569,0.002324,74.125.24.0-255,5738,188385,7,260476
11570,0.00233,172.31.36.0-255,66,188451,7,260476
11571,0.00235,74.125.24.0-255,5020,193471,7,260476
11572,0.002357,172.31.36.0-255,66,193537,7,260476
11573,0.002401,74.125.24.0-255,1484,195021,7,260476
11574,0.00242,74.125.24.0-255,2902,197923,7,260476
11575,0.002426,74.125.24.0-255,5738,203661,7,260476
11576,0.002427,172.31.36.0-255,66,203727,7,260476
11577,0.002432,172.31.36.0-255,66,203793,7,260476
11578,0.002471,172.31.36.0-255,66,203859,7,260476
11579,0.002519,172.31.36.0-255,66,203925,7,260476
11580,0.002533,74.125.24.0-255,2184,206109,7,260476
11581,0.002537,172.31.36.0-255,66,206175,7,260476
11582,0.00259,74.125.24.0-255,1484,207659,7,260476
11583,0.002595,74.125.24.0-255,2902,210561,7,260476
11584,0.002606,172.31.36.0-255,66,210627,7,260476
11585,0.002607,74.125.24.0-255,1484,212111,7,260476
11586,0.002623,74.125.24.0-255,4320,216431,7,260476
11587,0.00263,172.31.36.0-255,66,216497,7,260476
11588,0.002682,74.125.24.0-255,1484,217981,7,260476
11589,0.002684,172.31.36.0-255,66,218047,7,260476
11590,0.002685,74.125.24.0-255,1484,219531,7,260476
11591,0.00269,172.31.36.0-255,66,219597,7,260476
11592,0.002695,74.125.24.0-255,1484,221081,7,260476
11593,0.002698,74.125.24.0-255,1484,222565,7,260476
11594,0.002705,172.31.36.0-255,66,222631,7,260476
11595,0.002721,74.125.24.0-255,1484,224115,7,260476
11596,0.002727,74.125.24.0-255,4320,228435,7,260476
11597,0.002741,172.31.36.0-255,66,228501,7,260476
11598,0.002764,172.31.36.0-255,66,228567,7,260476
11599,0.002766,74.125.24.0-255,4320,232887,7,260476
11600,0.002771,172.31.36.0-255,66,232953,7,260476
11601,0.00281,74.125.24.0-255,5738,238691,7,260476
11602,0.002823,172.31.36.0-255,66,238757,7,260476
11603,0.002836,74.125.24.0-255,4320,243077,7,260476
11604,0.002839,172.31.36.0-255,66,243143,7,260476
11605,0.002843,172.31.36.0-255,66,243209,7,260476
11606,0.002863,74.125.24.0-255,5738,248947,7,260476
11607,0.002876,172.31.36.0-255,66,249013,7,260476
11608,0.002893,172.31.36.0-255,66,249079,7,260476
11609,0.002932,74.125.24.0-255,6523,255602,7,260476
11610,0.002936,172.31.36.0-255,66,255668,7,260476
11611,0.002947,74.125.24.0-255,105,255773,7,260476
11612,0.005018,172.31.36.0-255,66,255839,7,260476
11613,0.005045,172.31.36.0-255,105,255944,7,260476
11614,0.007625,74.125.24.0-255,66,256010,7,260476
11615,0.026366,172.31.36.0-255,172,256182,7,260476
11616,0.0264,172.31.36.0-255,1115,257297,7,260476
11617,0.026437,172.31.36.0-255,1514,258811,7,260476
11618,0.026438,172.31.36.0-255,1293,260104,7,260476
11619,0.027888,104.244.42.0-255,66,260170,7,260476
11620,0.027944,104.244.42.0-255,66,260236,7,260476
11621,0.027946,104.244.42.0-255,66,260302,7,260476
11622,0.028607,104.244.42.0-255,108,260410,7,260476
11623,0.028612,172.31.36.0-255,66,260476,7,260476
11624,0.0,172.217.194.0-255,297,297,7,175679
11625,3.5e-05,172.31.36.0-255,66,363,7,175679
11626,4.2e-05,172.217.194.0-255,1484,1847,7,175679
11627,4.7e-05,172.31.36.0-255,66,1913,7,175679
11628,5.3e-05,172.217.194.0-255,4320,6233,7,175679
11629,5.5e-05,172.31.36.0-255,66,6299,7,175679
11630,6.6e-05,172.31.36.0-255,66,6365,7,175679
11631,0.00011,172.31.36.0-255,66,6431,7,175679
11632,0.000157,172.31.36.0-255,66,6497,7,175679
11633,0.000186,172.31.36.0-255,66,6563,7,175679
11634,0.000204,172.217.194.0-255,7156,13719,7,175679
11635,0.000207,172.31.36.0-255,66,13785,7,175679
11636,0.000242,172.217.194.0-255,1484,15269,7,175679
11637,0.000245,172.31.36.0-255,66,15335,7,175679
11638,0.000266,172.217.194.0-255,6797,22132,7,175679
11639,0.000269,172.31.36.0-255,66,22198,7,175679
11640,0.000279,172.31.36.0-255,66,22264,7,175679
11641,0.000291,172.217.194.0-255,1402,23666,7,175679
11642,0.000294,172.31.36.0-255,66,23732,7,175679
11643,0.000334,172.217.194.0-255,118,23850,7,175679
11644,0.000338,172.31.36.0-255,66,23916,7,175679
11645,0.000368,172.217.194.0-255,379,24295,7,175679
11646,0.000373,172.31.36.0-255,66,24361,7,175679
11647,0.000568,172.217.194.0-255,1484,25845,7,175679
11648,0.000572,172.31.36.0-255,66,25911,7,175679
11649,0.000577,172.217.194.0-255,2902,28813,7,175679
11650,0.00058,172.31.36.0-255,66,28879,7,175679
11651,0.000585,172.217.194.0-255,4320,33199,7,175679
11652,0.000588,172.31.36.0-255,66,33265,7,175679
11653,0.000605,172.217.194.0-255,1484,34749,7,175679
11654,0.000617,172.31.36.0-255,66,34815,7,175679
11655,0.000661,172.217.194.0-255,7156,41971,7,175679
11656,0.000664,172.31.36.0-255,66,42037,7,175679
11657,0.000688,172.31.36.0-255,66,42103,7,175679
11658,0.00077,172.217.194.0-255,1484,43587,7,175679
11659,0.000775,172.217.194.0-255,2902,46489,7,175679
11660,0.000778,172.31.36.0-255,66,46555,7,175679
11661,0.000783,172.217.194.0-255,1484,48039,7,175679
11662,0.000801,172.217.194.0-255,4320,52359,7,175679
11663,0.000804,172.31.36.0-255,66,52425,7,175679
11664,0.000817,172.31.36.0-255,66,52491,7,175679
11665,0.000861,172.217.194.0-255,5738,58229,7,175679
11666,0.000865,172.31.36.0-255,66,58295,7,175679
11667,0.000891,172.31.36.0-255,66,58361,7,175679
11668,0.00099,172.217.194.0-255,1484,59845,7,175679
11669,0.000994,172.217.194.0-255,1484,61329,7,175679
11670,0.000998,172.31.36.0-255,66,61395,7,175679
11671,0.001019,172.217.194.0-255,1484,62879,7,175679
11672,0.001026,172.217.194.0-255,5738,68617,7,175679
11673,0.001029,172.31.36.0-255,66,68683,7,175679
11674,0.001043,172.217.194.0-255,4320,73003,7,175679
11675,0.001047,172.31.36.0-255,66,73069,7,175679
11676,0.001077,172.31.36.0-255,66,73135,7,175679
11677,0.001088,172.31.36.0-255,66,73201,7,175679
11678,0.001162,172.31.36.0-255,66,73267,7,175679
11679,0.001178,172.31.36.0-255,66,73333,7,175679
11680,0.001181,172.217.194.0-255,766,74099,7,175679
11681,0.001203,172.217.194.0-255,2902,77001,7,175679
11682,0.001206,172.31.36.0-255,66,77067,7,175679
11683,0.001227,172.217.194.0-255,7156,84223,7,175679
11684,0.00123,172.31.36.0-255,66,84289,7,175679
11685,0.001237,172.217.194.0-255,4320,88609,7,175679
11686,0.001239,172.31.36.0-255,66,88675,7,175679
11687,0.001257,172.217.194.0-255,7156,95831,7,175679
11688,0.00126,172.31.36.0-255,66,95897,7,175679
11689,0.001266,172.217.194.0-255,4320,100217,7,175679
11690,0.001269,172.31.36.0-255,66,100283,7,175679
11691,0.001304,172.31.36.0-255,66,100349,7,175679
11692,0.001316,172.31.36.0-255,66,100415,7,175679
11693,0.001331,172.217.194.0-255,2902,103317,7,175679
11694,0.001334,172.31.36.0-255,66,103383,7,175679
11695,0.001352,172.31.36.0-255,66,103449,7,175679
11696,0.001369,172.217.194.0-255,4320,107769,7,175679
11697,0.001372,172.31.36.0-255,66,107835,7,175679
11698,0.001387,172.217.194.0-255,6438,114273,7,175679
11699,0.00139,172.31.36.0-255,66,114339,7,175679
11700,0.001796,172.217.194.0-255,1484,115823,7,175679
11701,0.001802,172.217.194.0-255,2902,118725,7,175679
11702,0.001807,172.31.36.0-255,66,118791,7,175679
11703,0.001831,172.217.194.0-255,5738,124529,7,175679
11704,0.001834,172.31.36.0-255,66,124595,7,175679
11705,0.001842,172.217.194.0-255,7156,131751,7,175679
11706,0.001844,172.31.36.0-255,66,131817,7,175679
11707,0.001878,172.31.36.0-255,66,131883,7,175679
11708,0.001882,172.217.194.0-255,2184,134067,7,175679
11709,0.001884,172.31.36.0-255,66,134133,7,175679
11710,0.001935,172.217.194.0-255,1484,135617,7,175679
11711,0.001956,172.217.194.0-255,2902,138519,7,175679
11712,0.001961,172.31.36.0-255,66,138585,7,175679
11713,0.001979,172.217.194.0-255,5738,144323,7,175679
11714,0.001982,172.31.36.0-255,66,144389,7,175679
11715,0.001989,172.217.194.0-255,5738,150127,7,175679
11716,0.001991,172.31.36.0-255,66,150193,7,175679
11717,0.001998,172.217.194.0-255,5738,155931,7,175679
11718,0.002,172.31.36.0-255,66,155997,7,175679
11719,0.002021,172.217.194.0-255,7156,163153,7,175679
11720,0.002024,172.31.36.0-255,66,163219,7,175679
11721,0.002045,172.217.194.0-255,7156,170375,7,175679
11722,0.002048,172.31.36.0-255,66,170441,7,175679
11723,0.002077,172.31.36.0-255,66,170507,7,175679
11724,0.002098,172.31.36.0-255,66,170573,7,175679
11725,0.002113,172.31.36.0-255,66,170639,7,175679
11726,0.002197,172.31.36.0-255,66,170705,7,175679
11727,0.002199,172.217.194.0-255,340,171045,7,175679
11728,0.002215,172.217.194.0-255,105,171150,7,175679
11729,0.003602,172.31.36.0-255,66,171216,7,175679
11730,0.003631,172.31.36.0-255,105,171321,7,175679
11731,0.00597,172.217.194.0-255,66,171387,7,175679
11732,0.028594,172.31.36.0-255,172,171559,7,175679
11733,0.028648,172.31.36.0-255,1114,172673,7,175679
11734,0.028682,172.31.36.0-255,1514,174187,7,175679
11735,0.028684,172.31.36.0-255,1294,175481,7,175679
11736,0.030106,104.244.42.0-255,66,175547,7,175679
11737,0.030196,104.244.42.0-255,66,175613,7,175679
11738,0.030243,104.244.42.0-255,66,175679,7,175679
11739,0.0,74.125.24.0-255,153,153,7,363722
11740,2.9e-05,172.31.36.0-255,66,219,7,363722
11741,3.6e-05,74.125.24.0-255,1484,1703,7,363722
11742,4e-05,172.31.36.0-255,66,1769,7,363722
11743,4.5e-05,74.125.24.0-255,2902,4671,7,363722
11744,5.5e-05,172.31.36.0-255,66,4737,7,363722
11745,6.2e-05,74.125.24.0-255,7156,11893,7,363722
11746,6.4e-05,172.31.36.0-255,66,11959,7,363722
11747,6.8e-05,74.125.24.0-255,1484,13443,7,363722
11748,6.9e-05,172.31.36.0-255,66,13509,7,363722
11749,9.3e-05,74.125.24.0-255,674,14183,7,363722
11750,9.6e-05,172.31.36.0-255,66,14249,7,363722
11751,0.000127,74.125.24.0-255,1484,15733,7,363722
11752,0.000131,172.31.36.0-255,66,15799,7,363722
11753,0.000136,74.125.24.0-255,2902,18701,7,363722
11754,0.000138,172.31.36.0-255,66,18767,7,363722
11755,0.000172,74.125.24.0-255,5738,24505,7,363722
11756,0.000174,172.31.36.0-255,66,24571,7,363722
11757,0.000212,74.125.24.0-255,6797,31368,7,363722
11758,0.000215,172.31.36.0-255,66,31434,7,363722
11759,0.000222,74.125.24.0-255,7156,38590,7,363722
11760,0.000224,172.31.36.0-255,66,38656,7,363722
11761,0.000227,74.125.24.0-255,1484,40140,7,363722
11762,0.000234,172.31.36.0-255,66,40206,7,363722
11763,0.000276,172.31.36.0-255,66,40272,7,363722
11764,0.00041,74.125.24.0-255,1484,41756,7,363722
11765,0.000414,172.31.36.0-255,66,41822,7,363722
11766,0.000419,74.125.24.0-255,2902,44724,7,363722
11767,0.000422,172.31.36.0-255,66,44790,7,363722
11768,0.000453,74.125.24.0-255,2902,47692,7,363722
11769,0.000457,172.31.36.0-255,66,47758,7,363722
11770,0.000462,74.125.24.0-255,4320,52078,7,363722
11771,0.000474,172.31.36.0-255,66,52144,7,363722
11772,0.000521,74.125.24.0-255,5960,58104,7,363722
11773,0.000534,172.31.36.0-255,66,58170,7,363722
11774,0.000535,74.125.24.0-255,4320,62490,7,363722
11775,0.00054,172.31.36.0-255,66,62556,7,363722
11776,0.000566,74.125.24.0-255,5738,68294,7,363722
11777,0.000576,172.31.36.0-255,66,68360,7,363722
11778,0.000625,74.125.24.0-255,5738,74098,7,363722
11779,0.000627,172.31.36.0-255,66,74164,7,363722
11780,0.000637,172.31.36.0-255,66,74230,7,363722
11781,0.000665,74.125.24.0-255,5738,79968,7,363722
11782,0.000669,74.125.24.0-255,2184,82152,7,363722
11783,0.000672,172.31.36.0-255,66,82218,7,363722
11784,0.000677,172.31.36.0-255,66,82284,7,363722
11785,0.000883,74.125.24.0-255,1484,83768,7,363722
11786,0.000902,74.125.24.0-255,2902,86670,7,363722
11787,0.000906,172.31.36.0-255,66,86736,7,363722
11788,0.000912,74.125.24.0-255,2902,89638,7,363722
11789,0.000916,172.31.36.0-255,66,89704,7,363722
11790,0.000943,74.125.24.0-255,2902,92606,7,363722
11791,0.00095,172.31.36.0-255,66,92672,7,363722
11792,0.000987,74.125.24.0-255,7156,99828,7,363722
11793,0.00099,172.31.36.0-255,66,99894,7,363722
11794,0.001023,74.125.24.0-255,5738,105632,7,363722
11795,0.001034,172.31.36.0-255,66,105698,7,363722
11796,0.001039,172.31.36.0-255,66,105764,7,363722
11797,0.00106,74.125.24.0-255,1484,107248,7,363722
11798,0.001064,74.125.24.0-255,2902,110150,7,363722
11799,0.001084,172.31.36.0-255,66,110216,7,363722
11800,0.00109,74.125.24.0-255,5738,115954,7,363722
11801,0.001096,74.125.24.0-255,5738,121692,7,363722
11802,0.001099,172.31.36.0-255,66,121758,7,363722
11803,0.001112,172.31.36.0-255,66,121824,7,363722
11804,0.001133,74.125.24.0-255,7156,128980,7,363722
11805,0.001138,172.31.36.0-255,66,129046,7,363722
11806,0.001139,74.125.24.0-255,4320,133366,7,363722
11807,0.001143,172.31.36.0-255,66,133432,7,363722
11808,0.001153,74.125.24.0-255,5738,139170,7,363722
11809,0.001157,172.31.36.0-255,66,139236,7,363722
11810,0.001189,74.125.24.0-255,766,140002,7,363722
11811,0.001349,74.125.24.0-255,1484,141486,7,363722
11812,0.001353,172.31.36.0-255,66,141552,7,363722
11813,0.001359,74.125.24.0-255,2902,144454,7,363722
11814,0.001361,74.125.24.0-255,1484,145938,7,363722
11815,0.001362,172.31.36.0-255,66,146004,7,363722
11816,0.001395,74.125.24.0-255,4320,150324,7,363722
11817,0.001411,172.31.36.0-255,66,150390,7,363722
11818,0.001415,172.31.36.0-255,66,150456,7,363722
11819,0.001429,172.31.36.0-255,66,150522,7,363722
11820,0.00145,74.125.24.0-255,766,151288,7,363722
11821,0.001475,74.125.24.0-255,1484,152772,7,363722
11822,0.001483,172.31.36.0-255,66,152838,7,363722
11823,0.001489,74.125.24.0-255,2902,155740,7,363722
11824,0.001503,172.31.36.0-255,66,155806,7,363722
11825,0.00151,74.125.24.0-255,1484,157290,7,363722
11826,0.001522,74.125.24.0-255,5738,163028,7,363722
11827,0.001529,74.125.24.0-255,7156,170184,7,363722
11828,0.00153,172.31.36.0-255,66,170250,7,363722
11829,0.001537,172.31.36.0-255,66,170316,7,363722
11830,0.00155,74.125.24.0-255,4320,174636,7,363722
11831,0.001556,172.31.36.0-255,66,174702,7,363722
11832,0.001567,74.125.24.0-255,4320,179022,7,363722
11833,0.00157,172.31.36.0-255,66,179088,7,363722
11834,0.001606,74.125.24.0-255,6438,185526,7,363722
11835,0.001614,172.31.36.0-255,66,185592,7,363722
11836,0.001872,74.125.24.0-255,1484,187076,7,363722
11837,0.001893,74.125.24.0-255,2902,189978,7,363722
11838,0.001897,172.31.36.0-255,66,190044,7,363722
11839,0.001903,74.125.24.0-255,2902,192946,7,363722
11840,0.001907,172.31.36.0-255,66,193012,7,363722
11841,0.001938,74.125.24.0-255,2902,195914,7,363722
11842,0.00195,74.125.24.0-255,5738,201652,7,363722
11843,0.00195,172.31.36.0-255,66,201718,7,363722
11844,0.001954,74.125.24.0-255,2902,204620,7,363722
11845,0.001955,172.31.36.0-255,66,204686,7,363722
11846,0.001971,172.31.36.0-255,66,204752,7,363722
11847,0.001998,74.125.24.0-255,5020,209772,7,363722
11848,0.002013,172.31.36.0-255,66,209838,7,363722
11849,0.002071,172.31.36.0-255,101,209939,7,363722
11850,0.004038,74.125.24.0-255,5738,215677,7,363722
11851,0.004044,172.31.36.0-255,66,215743,7,363722
11852,0.004047,74.125.24.0-255,66,215809,7,363722
11853,0.00606,74.125.24.0-255,5738,221547,7,363722
11854,0.007808,172.31.36.0-255,66,221613,7,363722
11855,0.009833,74.125.24.0-255,5738,227351,7,363722
11856,0.00984,172.31.36.0-255,66,227417,7,363722
11857,0.011883,74.125.24.0-255,5738,233155,7,363722
11858,0.013233,172.31.36.0-255,66,233221,7,363722
11859,0.015284,74.125.24.0-255,5738,238959,7,363722
11860,0.015297,172.31.36.0-255,66,239025,7,363722
11861,0.01731,74.125.24.0-255,5738,244763,7,363722
11862,0.017318,172.31.36.0-255,66,244829,7,363722
11863,0.01935,74.125.24.0-255,5738,250567,7,363722
11864,0.019357,172.31.36.0-255,66,250633,7,363722
11865,0.021438,74.125.24.0-255,5738,256371,7,363722
11866,0.021444,172.31.36.0-255,66,256437,7,363722
11867,0.02349,74.125.24.0-255,5738,262175,7,363722
11868,0.023497,172.31.36.0-255,66,262241,7,363722
11869,0.025511,74.125.24.0-255,5738,267979,7,363722
11870,0.025519,172.31.36.0-255,66,268045,7,363722
11871,0.027574,74.125.24.0-255,5738,273783,7,363722
11872,0.027581,172.31.36.0-255,66,273849,7,363722
11873,0.028622,172.31.36.0-255,172,274021,7,363722
11874,0.028655,172.31.36.0-255,1115,275136,7,363722
11875,0.028695,172.31.36.0-255,1514,276650,7,363722
11876,0.028696,172.31.36.0-255,1291,277941,7,363722
11877,0.029601,74.125.24.0-255,4320,282261,7,363722
11878,0.029608,172.31.36.0-255,66,282327,7,363722
11879,0.029643,74.125.24.0-255,1484,283811,7,363722
11880,0.030236,104.244.42.0-255,66,283877,7,363722
11881,0.030243,104.244.42.0-255,66,283943,7,363722
11882,0.030267,104.244.42.0-255,66,284009,7,363722
11883,0.031611,74.125.24.0-255,4320,288329,7,363722
11884,0.031616,172.31.36.0-255,66,288395,7,363722
11885,0.033675,74.125.24.0-255,5738,294133,7,363722
11886,0.033729,172.31.36.0-255,66,294199,7,363722
11887,0.035753,74.125.24.0-255,5738,299937,7,363722
11888,0.035758,172.31.36.0-255,66,300003,7,363722
11889,0.037784,74.125.24.0-255,4320,304323,7,363722
11890,0.037789,172.31.36.0-255,66,304389,7,363722
11891,0.037821,74.125.24.0-255,1484,305873,7,363722
11892,0.039842,74.125.24.0-255,4320,310193,7,363722
11893,0.039847,172.31.36.0-255,66,310259,7,363722
11894,0.041871,74.125.24.0-255,4320,314579,7,363722
11895,0.041877,172.31.36.0-255,66,314645,7,363722
11896,0.041906,74.125.24.0-255,1484,316129,7,363722
11897,0.043884,74.125.24.0-255,4320,320449,7,363722
11898,0.04389,172.31.36.0-255,66,320515,7,363722
11899,0.045974,74.125.24.0-255,5738,326253,7,363722
11900,0.04603,172.31.36.0-255,66,326319,7,363722
11901,0.048021,74.125.24.0-255,2902,329221,7,363722
11902,0.048027,172.31.36.0-255,66,329287,7,363722
11903,0.04806,74.125.24.0-255,2902,332189,7,363722
11904,0.048077,172.31.36.0-255,66,332255,7,363722
11905,0.05006,74.125.24.0-255,2902,335157,7,363722
11906,0.050065,172.31.36.0-255,66,335223,7,363722
11907,0.050133,74.125.24.0-255,2902,338125,7,363722
11908,0.050143,172.31.36.0-255,66,338191,7,363722
11909,0.052089,74.125.24.0-255,2902,341093,7,363722
11910,0.052095,172.31.36.0-255,66,341159,7,363722
11911,0.052159,74.125.24.0-255,2902,344061,7,363722
11912,0.052179,172.31.36.0-255,66,344127,7,363722
11913,0.054124,74.125.24.0-255,2902,347029,7,363722
11914,0.054129,172.31.36.0-255,66,347095,7,363722
11915,0.054195,74.125.24.0-255,2902,349997,7,363722
11916,0.054206,172.31.36.0-255,66,350063,7,363722
11917,0.056171,74.125.24.0-255,2902,352965,7,363722
11918,0.056176,172.31.36.0-255,66,353031,7,363722
11919,0.056209,74.125.24.0-255,2902,355933,7,363722
11920,0.056228,172.31.36.0-255,66,355999,7,363722
11921,0.058212,74.125.24.0-255,2902,358901,7,363722
11922,0.058217,172.31.36.0-255,66,358967,7,363722
11923,0.058253,74.125.24.0-255,2902,361869,7,363722
11924,0.058272,172.31.36.0-255,66,361935,7,363722
11925,0.060246,74.125.24.0-255,1550,363485,7,363722
11926,0.060251,172.31.36.0-255,66,363551,7,363722
11927,0.060417,172.31.36.0-255,105,363656,7,363722
11928,0.067361,74.125.24.0-255,66,363722,7,363722
11929,0.0,74.125.24.0-255,153,153,7,306300
11930,1.7e-05,172.31.36.0-255,66,219,7,306300
11931,2.4e-05,74.125.24.0-255,1484,1703,7,306300
11932,2.8e-05,172.31.36.0-255,66,1769,7,306300
11933,3.4e-05,74.125.24.0-255,2902,4671,7,306300
11934,3.7e-05,172.31.36.0-255,66,4737,7,306300
11935,5.3e-05,74.125.24.0-255,7156,11893,7,306300
11936,5.7e-05,172.31.36.0-255,66,11959,7,306300
11937,9.4e-05,172.31.36.0-255,66,12025,7,306300
11938,0.000123,74.125.24.0-255,4892,16917,7,306300
11939,0.000126,172.31.36.0-255,66,16983,7,306300
11940,0.000131,74.125.24.0-255,2543,19526,7,306300
11941,0.000134,172.31.36.0-255,66,19592,7,306300
11942,0.000169,74.125.24.0-255,1484,21076,7,306300
11943,0.000172,172.31.36.0-255,66,21142,7,306300
11944,0.000178,74.125.24.0-255,2902,24044,7,306300
11945,0.000181,172.31.36.0-255,66,24110,7,306300
11946,0.000192,74.125.24.0-255,5738,29848,7,306300
11947,0.000195,172.31.36.0-255,66,29914,7,306300
11948,0.0002,74.125.24.0-255,4320,34234,7,306300
11949,0.000202,172.31.36.0-255,66,34300,7,306300
11950,0.000216,172.31.36.0-255,66,34366,7,306300
11951,0.000222,74.125.24.0-255,4320,38686,7,306300
11952,0.000225,172.31.36.0-255,66,38752,7,306300
11953,0.00025,74.125.24.0-255,2812,41564,7,306300
11954,0.000257,172.31.36.0-255,66,41630,7,306300
11955,0.000386,74.125.24.0-255,135,41765,7,306300
11956,0.000391,172.31.36.0-255,66,41831,7,306300
11957,0.000994,74.125.24.0-255,348,42179,7,306300
11958,0.001,172.31.36.0-255,66,42245,7,306300
11959,0.001142,74.125.24.0-255,1484,43729,7,306300
11960,0.001151,74.125.24.0-255,2902,46631,7,306300
11961,0.001156,172.31.36.0-255,66,46697,7,306300
11962,0.001163,74.125.24.0-255,4320,51017,7,306300
11963,0.001165,172.31.36.0-255,66,51083,7,306300
11964,0.001188,74.125.24.0-255,1484,52567,7,306300
11965,0.001205,172.31.36.0-255,66,52633,7,306300
11966,0.001246,74.125.24.0-255,7156,59789,7,306300
11967,0.001248,172.31.36.0-255,66,59855,7,306300
11968,0.001276,74.125.24.0-255,5020,64875,7,306300
11969,0.001278,172.31.36.0-255,66,64941,7,306300
11970,0.001443,74.125.24.0-255,1484,66425,7,306300
11971,0.001458,74.125.24.0-255,2902,69327,7,306300
11972,0.001462,172.31.36.0-255,66,69393,7,306300
11973,0.001493,74.125.24.0-255,5738,75131,7,306300
11974,0.001496,172.31.36.0-255,66,75197,7,306300
11975,0.001508,172.31.36.0-255,66,75263,7,306300
11976,0.001538,74.125.24.0-255,5738,81001,7,306300
11977,0.00154,172.31.36.0-255,66,81067,7,306300
11978,0.001565,172.31.36.0-255,66,81133,7,306300
11979,0.001715,74.125.24.0-255,1484,82617,7,306300
11980,0.001724,74.125.24.0-255,2902,85519,7,306300
11981,0.001728,172.31.36.0-255,66,85585,7,306300
11982,0.001736,74.125.24.0-255,5738,91323,7,306300
11983,0.001738,172.31.36.0-255,66,91389,7,306300
11984,0.001743,74.125.24.0-255,2902,94291,7,306300
11985,0.001751,172.31.36.0-255,66,94357,7,306300
11986,0.001754,74.125.24.0-255,1484,95841,7,306300
11987,0.001794,172.31.36.0-255,66,95907,7,306300
11988,0.0018,74.125.24.0-255,2902,98809,7,306300
11989,0.001802,172.31.36.0-255,66,98875,7,306300
11990,0.001843,172.31.36.0-255,66,98941,7,306300
11991,0.001857,172.31.36.0-255,66,99007,7,306300
11992,0.001862,74.125.24.0-255,4320,103327,7,306300
11993,0.001864,172.31.36.0-255,66,103393,7,306300
11994,0.001888,74.125.24.0-255,2902,106295,7,306300
11995,0.001891,172.31.36.0-255,66,106361,7,306300
11996,0.00191,172.31.36.0-255,66,106427,7,306300
11997,0.001924,74.125.24.0-255,5020,111447,7,306300
11998,0.001931,172.31.36.0-255,66,111513,7,306300
11999,0.001983,74.125.24.0-255,1484,112997,7,306300
12000,0.002018,74.125.24.0-255,1484,114481,7,306300
12001,0.002021,172.31.36.0-255,66,114547,7,306300
12002,0.002053,74.125.24.0-255,1484,116031,7,306300
12003,0.002061,74.125.24.0-255,5738,121769,7,306300
12004,0.002064,172.31.36.0-255,66,121835,7,306300
12005,0.002083,172.31.36.0-255,66,121901,7,306300
12006,0.002095,172.31.36.0-255,66,121967,7,306300
12007,0.002099,74.125.24.0-255,2184,124151,7,306300
12008,0.0021,172.31.36.0-255,66,124217,7,306300
12009,0.004359,74.125.24.0-255,5738,129955,7,306300
12010,0.004366,172.31.36.0-255,66,130021,7,306300
12011,0.006646,74.125.24.0-255,5738,135759,7,306300
12012,0.00665,172.31.36.0-255,66,135825,7,306300
12013,0.008928,74.125.24.0-255,5738,141563,7,306300
12014,0.008935,172.31.36.0-255,66,141629,7,306300
12015,0.011241,74.125.24.0-255,5738,147367,7,306300
12016,0.01125,172.31.36.0-255,66,147433,7,306300
12017,0.013559,74.125.24.0-255,5738,153171,7,306300
12018,0.013568,172.31.36.0-255,66,153237,7,306300
12019,0.015862,74.125.24.0-255,5738,158975,7,306300
12020,0.015873,172.31.36.0-255,66,159041,7,306300
12021,0.018164,74.125.24.0-255,5738,164779,7,306300
12022,0.018172,172.31.36.0-255,66,164845,7,306300
12023,0.020444,74.125.24.0-255,5738,170583,7,306300
12024,0.020452,172.31.36.0-255,66,170649,7,306300
12025,0.022741,74.125.24.0-255,5738,176387,7,306300
12026,0.022748,172.31.36.0-255,66,176453,7,306300
12027,0.025023,74.125.24.0-255,5738,182191,7,306300
12028,0.02503,172.31.36.0-255,66,182257,7,306300
12029,0.027319,74.125.24.0-255,5738,187995,7,306300
12030,0.027326,172.31.36.0-255,66,188061,7,306300
12031,0.029616,74.125.24.0-255,5738,193799,7,306300
12032,0.029624,172.31.36.0-255,66,193865,7,306300
12033,0.030265,172.31.36.0-255,172,194037,7,306300
12034,0.0303,172.31.36.0-255,1115,195152,7,306300
12035,0.030361,172.31.36.0-255,1514,196666,7,306300
12036,0.030362,172.31.36.0-255,1291,197957,7,306300
12037,0.03181,104.244.42.0-255,66,198023,7,306300
12038,0.031861,104.244.42.0-255,66,198089,7,306300
12039,0.031878,104.244.42.0-255,66,198155,7,306300
12040,0.031905,74.125.24.0-255,5738,203893,7,306300
12041,0.03191,172.31.36.0-255,66,203959,7,306300
12042,0.034203,74.125.24.0-255,5738,209697,7,306300
12043,0.03421,172.31.36.0-255,66,209763,7,306300
12044,0.036469,74.125.24.0-255,5738,215501,7,306300
12045,0.036476,172.31.36.0-255,66,215567,7,306300
12046,0.038749,74.125.24.0-255,5738,221305,7,306300
12047,0.038755,172.31.36.0-255,66,221371,7,306300
12048,0.041069,74.125.24.0-255,5738,227109,7,306300
12049,0.041078,172.31.36.0-255,66,227175,7,306300
12050,0.043364,74.125.24.0-255,5738,232913,7,306300
12051,0.04337,172.31.36.0-255,66,232979,7,306300
12052,0.045671,74.125.24.0-255,5738,238717,7,306300
12053,0.045677,172.31.36.0-255,66,238783,7,306300
12054,0.047947,74.125.24.0-255,5738,244521,7,306300
12055,0.047954,172.31.36.0-255,66,244587,7,306300
12056,0.050218,74.125.24.0-255,5738,250325,7,306300
12057,0.050225,172.31.36.0-255,66,250391,7,306300
12058,0.052486,74.125.24.0-255,5738,256129,7,306300
12059,0.052492,172.31.36.0-255,66,256195,7,306300
12060,0.054763,74.125.24.0-255,5738,261933,7,306300
12061,0.054769,172.31.36.0-255,66,261999,7,306300
12062,0.057049,74.125.24.0-255,5738,267737,7,306300
12063,0.057057,172.31.36.0-255,66,267803,7,306300
12064,0.059315,74.125.24.0-255,5738,273541,7,306300
12065,0.059321,172.31.36.0-255,66,273607,7,306300
12066,0.06166,74.125.24.0-255,5738,279345,7,306300
12067,0.061666,172.31.36.0-255,66,279411,7,306300
12068,0.063966,74.125.24.0-255,5738,285149,7,306300
12069,0.063973,172.31.36.0-255,66,285215,7,306300
12070,0.066234,74.125.24.0-255,5738,290953,7,306300
12071,0.066241,172.31.36.0-255,66,291019,7,306300
12072,0.068547,74.125.24.0-255,5738,296757,7,306300
12073,0.068555,172.31.36.0-255,66,296823,7,306300
12074,0.070863,74.125.24.0-255,5738,302561,7,306300
12075,0.07087,172.31.36.0-255,66,302627,7,306300
12076,0.073171,74.125.24.0-255,3436,306063,7,306300
12077,0.073178,172.31.36.0-255,66,306129,7,306300
12078,0.073355,172.31.36.0-255,105,306234,7,306300
12079,0.075631,74.125.24.0-255,66,306300,7,306300
12080,0.0,172.217.194.0-255,153,153,7,184289
12081,2.4e-05,172.31.36.0-255,66,219,7,184289
12082,3.1e-05,172.217.194.0-255,1484,1703,7,184289
12083,3.5e-05,172.31.36.0-255,66,1769,7,184289
12084,4.1e-05,172.217.194.0-255,2902,4671,7,184289
12085,5.2e-05,172.31.36.0-255,66,4737,7,184289
12086,6e-05,172.217.194.0-255,7156,11893,7,184289
12087,6.3e-05,172.31.36.0-255,66,11959,7,184289
12088,6.7e-05,172.217.194.0-255,2104,14063,7,184289
12089,7.1e-05,172.31.36.0-255,66,14129,7,184289
12090,0.000123,172.31.36.0-255,66,14195,7,184289
12091,0.000129,172.217.194.0-255,5379,19574,7,184289
12092,0.000132,172.31.36.0-255,66,19640,7,184289
12093,0.000199,172.217.194.0-255,1484,21124,7,184289
12094,0.000202,172.31.36.0-255,66,21190,7,184289
12095,0.000207,172.217.194.0-255,2902,24092,7,184289
12096,0.000209,172.31.36.0-255,66,24158,7,184289
12097,0.00023,172.217.194.0-255,4320,28478,7,184289
12098,0.000236,172.31.36.0-255,66,28544,7,184289
12099,0.000263,172.217.194.0-255,1484,30028,7,184289
12100,0.000265,172.31.36.0-255,66,30094,7,184289
12101,0.000286,172.31.36.0-255,66,30160,7,184289
12102,0.000319,172.31.36.0-255,66,30226,7,184289
12103,0.000955,172.217.194.0-255,381,30607,7,184289
12104,0.000961,172.31.36.0-255,66,30673,7,184289
12105,0.001256,172.217.194.0-255,1484,32157,7,184289
12106,0.001262,172.31.36.0-255,66,32223,7,184289
12107,0.001272,172.217.194.0-255,2902,35125,7,184289
12108,0.001274,172.31.36.0-255,66,35191,7,184289
12109,0.001286,172.217.194.0-255,5738,40929,7,184289
12110,0.001288,172.31.36.0-255,66,40995,7,184289
12111,0.001294,172.217.194.0-255,4320,45315,7,184289
12112,0.001297,172.31.36.0-255,66,45381,7,184289
12113,0.001348,172.31.36.0-255,66,45447,7,184289
12114,0.001366,172.31.36.0-255,66,45513,7,184289
12115,0.001507,172.217.194.0-255,1484,46997,7,184289
12116,0.001515,172.217.194.0-255,2902,49899,7,184289
12117,0.001518,172.31.36.0-255,66,49965,7,184289
12118,0.001541,172.217.194.0-255,5738,55703,7,184289
12119,0.001543,172.31.36.0-255,66,55769,7,184289
12120,0.00155,172.217.194.0-255,5738,61507,7,184289
12121,0.001552,172.31.36.0-255,66,61573,7,184289
12122,0.001591,172.217.194.0-255,7156,68729,7,184289
12123,0.001593,172.31.36.0-255,66,68795,7,184289
12124,0.001605,172.31.36.0-255,66,68861,7,184289
12125,0.001613,172.217.194.0-255,1484,70345,7,184289
12126,0.001643,172.217.194.0-255,2902,73247,7,184289
12127,0.001646,172.31.36.0-255,66,73313,7,184289
12128,0.001653,172.217.194.0-255,5738,79051,7,184289
12129,0.001655,172.31.36.0-255,66,79117,7,184289
12130,0.001695,172.217.194.0-255,4320,83437,7,184289
12131,0.001698,172.31.36.0-255,66,83503,7,184289
12132,0.001735,172.31.36.0-255,66,83569,7,184289
12133,0.001747,172.31.36.0-255,66,83635,7,184289
12134,0.001776,172.31.36.0-255,66,83701,7,184289
12135,0.001789,172.31.36.0-255,66,83767,7,184289
12136,0.001829,172.31.36.0-255,66,83833,7,184289
12137,0.001845,172.31.36.0-255,66,83899,7,184289
12138,0.00191,172.31.36.0-255,66,83965,7,184289
12139,0.00193,172.31.36.0-255,66,84031,7,184289
12140,0.001952,172.31.36.0-255,66,84097,7,184289
12141,0.001984,172.217.194.0-255,3602,87699,7,184289
12142,0.001986,172.31.36.0-255,66,87765,7,184289
12143,0.00206,172.217.194.0-255,1484,89249,7,184289
12144,0.002067,172.217.194.0-255,2902,92151,7,184289
12145,0.00207,172.31.36.0-255,66,92217,7,184289
12146,0.002076,172.217.194.0-255,4320,96537,7,184289
12147,0.002078,172.31.36.0-255,66,96603,7,184289
12148,0.002096,172.217.194.0-255,1484,98087,7,184289
12149,0.002102,172.217.194.0-255,4320,102407,7,184289
12150,0.002105,172.31.36.0-255,66,102473,7,184289
12151,0.002139,172.31.36.0-255,66,102539,7,184289
12152,0.002156,172.31.36.0-255,66,102605,7,184289
12153,0.002183,172.217.194.0-255,1484,104089,7,184289
12154,0.002203,172.217.194.0-255,2902,106991,7,184289
12155,0.002206,172.31.36.0-255,66,107057,7,184289
12156,0.002213,172.217.194.0-255,5738,112795,7,184289
12157,0.002215,172.31.36.0-255,66,112861,7,184289
12158,0.00226,172.31.36.0-255,66,112927,7,184289
12159,0.002304,172.31.36.0-255,66,112993,7,184289
12160,0.002398,172.217.194.0-255,1484,114477,7,184289
12161,0.002404,172.217.194.0-255,2902,117379,7,184289
12162,0.002407,172.31.36.0-255,66,117445,7,184289
12163,0.00243,172.217.194.0-255,2902,120347,7,184289
12164,0.002433,172.31.36.0-255,66,120413,7,184289
12165,0.002461,172.217.194.0-255,2902,123315,7,184289
12166,0.002464,172.31.36.0-255,66,123381,7,184289
12167,0.00247,172.217.194.0-255,5738,129119,7,184289
12168,0.002473,172.31.36.0-255,66,129185,7,184289
12169,0.002479,172.217.194.0-255,5738,134923,7,184289
12170,0.002486,172.31.36.0-255,66,134989,7,184289
12171,0.00252,172.217.194.0-255,7156,142145,7,184289
12172,0.002527,172.31.36.0-255,66,142211,7,184289
12173,0.002533,172.217.194.0-255,5020,147231,7,184289
12174,0.002536,172.31.36.0-255,66,147297,7,184289
12175,0.002565,172.217.194.0-255,1484,148781,7,184289
12176,0.00257,172.217.194.0-255,2902,151683,7,184289
12177,0.002572,172.31.36.0-255,66,151749,7,184289
12178,0.002579,172.217.194.0-255,5738,157487,7,184289
12179,0.002581,172.31.36.0-255,66,157553,7,184289
12180,0.002604,172.217.194.0-255,7156,164709,7,184289
12181,0.00261,172.31.36.0-255,66,164775,7,184289
12182,0.002638,172.217.194.0-255,5738,170513,7,184289
12183,0.002641,172.31.36.0-255,66,170579,7,184289
12184,0.002655,172.217.194.0-255,2902,173481,7,184289
12185,0.002661,172.31.36.0-255,66,173547,7,184289
12186,0.002684,172.31.36.0-255,66,173613,7,184289
12187,0.002697,172.31.36.0-255,66,173679,7,184289
12188,0.002723,172.217.194.0-255,1484,175163,7,184289
12189,0.002732,172.217.194.0-255,4148,179311,7,184289
12190,0.002735,172.31.36.0-255,66,179377,7,184289
12191,0.002862,172.217.194.0-255,97,179474,7,184289
12192,0.002933,172.217.194.0-255,105,179579,7,184289
12193,0.011888,172.31.36.0-255,66,179645,7,184289
12194,0.011934,172.31.36.0-255,105,179750,7,184289
12195,0.013349,172.217.194.0-255,105,179855,7,184289
12196,0.01336,172.31.36.0-255,78,179933,7,184289
12197,0.014578,172.217.194.0-255,66,179999,7,184289
12198,0.032252,172.31.36.0-255,172,180171,7,184289
12199,0.032283,172.31.36.0-255,1114,181285,7,184289
12200,0.032344,172.31.36.0-255,1514,182799,7,184289
12201,0.032346,172.31.36.0-255,1292,184091,7,184289
12202,0.033806,104.244.42.0-255,66,184157,7,184289
12203,0.033836,104.244.42.0-255,66,184223,7,184289
12204,0.033912,104.244.42.0-255,66,184289,7,184289
12205,0.0,172.217.194.0-255,146,146,7,235918
12206,2.2e-05,172.31.36.0-255,66,212,7,235918
12207,3e-05,172.217.194.0-255,1484,1696,7,235918
12208,3.5e-05,172.31.36.0-255,66,1762,7,235918
12209,4e-05,172.217.194.0-255,2902,4664,7,235918
12210,4.3e-05,172.31.36.0-255,66,4730,7,235918
12211,5.1e-05,172.217.194.0-255,7156,11886,7,235918
12212,5.3e-05,172.31.36.0-255,66,11952,7,235918
12213,7.8e-05,172.217.194.0-255,1931,13883,7,235918
12214,8.1e-05,172.31.36.0-255,66,13949,7,235918
12215,9.8e-05,172.217.194.0-255,2902,16851,7,235918
12216,0.000101,172.31.36.0-255,66,16917,7,235918
12217,0.000131,172.217.194.0-255,5738,22655,7,235918
12218,0.000135,172.31.36.0-255,66,22721,7,235918
12219,0.000181,172.31.36.0-255,66,22787,7,235918
12220,0.000186,172.217.194.0-255,2902,25689,7,235918
12221,0.000187,172.31.36.0-255,66,25755,7,235918
12222,0.000199,172.217.194.0-255,1484,27239,7,235918
12223,0.000201,172.31.36.0-255,66,27305,7,235918
12224,0.000237,172.217.194.0-255,2902,30207,7,235918
12225,0.00024,172.31.36.0-255,66,30273,7,235918
12226,0.000267,172.217.194.0-255,6797,37070,7,235918
12227,0.000269,172.31.36.0-255,66,37136,7,235918
12228,0.000298,172.217.194.0-255,2902,40038,7,235918
12229,0.0003,172.31.36.0-255,66,40104,7,235918
12230,0.000323,172.217.194.0-255,7156,47260,7,235918
12231,0.000326,172.31.36.0-255,66,47326,7,235918
12232,0.000331,172.217.194.0-255,4320,51646,7,235918
12233,0.000334,172.31.36.0-255,66,51712,7,235918
12234,0.000347,172.217.194.0-255,2543,54255,7,235918
12235,0.000349,172.31.36.0-255,66,54321,7,235918
12236,0.000352,172.217.194.0-255,379,54700,7,235918
12237,0.000628,172.217.194.0-255,364,55064,7,235918
12238,0.000884,172.217.194.0-255,1484,56548,7,235918
12239,0.000889,172.31.36.0-255,66,56614,7,235918
12240,0.000895,172.217.194.0-255,2902,59516,7,235918
12241,0.000897,172.31.36.0-255,66,59582,7,235918
12242,0.000902,172.217.194.0-255,2902,62484,7,235918
12243,0.000904,172.31.36.0-255,66,62550,7,235918
12244,0.000922,172.217.194.0-255,2902,65452,7,235918
12245,0.000924,172.31.36.0-255,66,65518,7,235918
12246,0.000942,172.217.194.0-255,5738,71256,7,235918
12247,0.000951,172.31.36.0-255,66,71322,7,235918
12248,0.000957,172.217.194.0-255,2902,74224,7,235918
12249,0.000958,172.31.36.0-255,66,74290,7,235918
12250,0.000969,172.31.36.0-255,66,74356,7,235918
12251,0.000992,172.217.194.0-255,1484,75840,7,235918
12252,0.000999,172.217.194.0-255,5020,80860,7,235918
12253,0.001001,172.31.36.0-255,66,80926,7,235918
12254,0.00145,172.217.194.0-255,1484,82410,7,235918
12255,0.001456,172.217.194.0-255,2902,85312,7,235918
12256,0.001459,172.31.36.0-255,66,85378,7,235918
12257,0.001466,172.217.194.0-255,5738,91116,7,235918
12258,0.001467,172.31.36.0-255,66,91182,7,235918
12259,0.001486,172.217.194.0-255,5738,96920,7,235918
12260,0.001488,172.31.36.0-255,66,96986,7,235918
12261,0.001519,172.217.194.0-255,7156,104142,7,235918
12262,0.001521,172.31.36.0-255,66,104208,7,235918
12263,0.001535,172.31.36.0-255,66,104274,7,235918
12264,0.00156,172.217.194.0-255,1484,105758,7,235918
12265,0.001565,172.217.194.0-255,2902,108660,7,235918
12266,0.001567,172.31.36.0-255,66,108726,7,235918
12267,0.001574,172.217.194.0-255,5738,114464,7,235918
12268,0.001576,172.31.36.0-255,66,114530,7,235918
12269,0.001601,172.217.194.0-255,7156,121686,7,235918
12270,0.001604,172.31.36.0-255,66,121752,7,235918
12271,0.001628,172.217.194.0-255,5738,127490,7,235918
12272,0.001631,172.31.36.0-255,66,127556,7,235918
12273,0.001643,172.31.36.0-255,66,127622,7,235918
12274,0.001675,172.217.194.0-255,1484,129106,7,235918
12275,0.001679,172.217.194.0-255,2902,132008,7,235918
12276,0.001682,172.31.36.0-255,66,132074,7,235918
12277,0.001688,172.217.194.0-255,5738,137812,7,235918
12278,0.001691,172.31.36.0-255,66,137878,7,235918
12279,0.001736,172.31.36.0-255,66,137944,7,235918
12280,0.001748,172.31.36.0-255,66,138010,7,235918
12281,0.00175,172.217.194.0-255,766,138776,7,235918
12282,0.001965,172.217.194.0-255,1484,140260,7,235918
12283,0.00197,172.31.36.0-255,66,140326,7,235918
12284,0.001976,172.217.194.0-255,2902,143228,7,235918
12285,0.001977,172.31.36.0-255,66,143294,7,235918
12286,0.002037,172.217.194.0-255,5738,149032,7,235918
12287,0.00204,172.31.36.0-255,66,149098,7,235918
12288,0.002052,172.31.36.0-255,66,149164,7,235918
12289,0.002059,172.217.194.0-255,5738,154902,7,235918
12290,0.002062,172.31.36.0-255,66,154968,7,235918
12291,0.002114,172.31.36.0-255,66,155034,7,235918
12292,0.002618,172.217.194.0-255,1484,156518,7,235918
12293,0.002624,172.217.194.0-255,2902,159420,7,235918
12294,0.002628,172.31.36.0-255,66,159486,7,235918
12295,0.002635,172.217.194.0-255,5738,165224,7,235918
12296,0.002637,172.31.36.0-255,66,165290,7,235918
12297,0.002659,172.217.194.0-255,5738,171028,7,235918
12298,0.002662,172.31.36.0-255,66,171094,7,235918
12299,0.002673,172.217.194.0-255,5738,176832,7,235918
12300,0.002676,172.31.36.0-255,66,176898,7,235918
12301,0.002695,172.217.194.0-255,7156,184054,7,235918
12302,0.002697,172.31.36.0-255,66,184120,7,235918
12303,0.002704,172.217.194.0-255,5020,189140,7,235918
12304,0.002706,172.31.36.0-255,66,189206,7,235918
12305,0.003066,172.217.194.0-255,1484,190690,7,235918
12306,0.003088,172.217.194.0-255,2902,193592,7,235918
12307,0.003092,172.31.36.0-255,66,193658,7,235918
12308,0.003099,172.217.194.0-255,5738,199396,7,235918
12309,0.003101,172.31.36.0-255,66,199462,7,235918
12310,0.003118,172.217.194.0-255,1484,200946,7,235918
12311,0.003141,172.31.36.0-255,66,201012,7,235918
12312,0.003197,172.31.36.0-255,66,201078,7,235918
12313,0.003208,172.31.36.0-255,66,201144,7,235918
12314,0.00323,172.217.194.0-255,2902,204046,7,235918
12315,0.003232,172.31.36.0-255,66,204112,7,235918
12316,0.003237,172.217.194.0-255,4320,208432,7,235918
12317,0.003241,172.31.36.0-255,66,208498,7,235918
12318,0.003274,172.31.36.0-255,66,208564,7,235918
12319,0.003276,172.217.194.0-255,1484,210048,7,235918
12320,0.003306,172.217.194.0-255,1484,211532,7,235918
12321,0.003309,172.31.36.0-255,66,211598,7,235918
12322,0.003337,172.31.36.0-255,66,211664,7,235918
12323,0.003361,172.217.194.0-255,4320,215984,7,235918
12324,0.003364,172.31.36.0-255,66,216050,7,235918
12325,0.003375,172.31.36.0-255,66,216116,7,235918
12326,0.003387,172.31.36.0-255,66,216182,7,235918
12327,0.003393,172.217.194.0-255,5738,221920,7,235918
12328,0.003395,172.31.36.0-255,66,221986,7,235918
12329,0.003412,172.31.36.0-255,66,222052,7,235918
12330,0.003452,172.217.194.0-255,2902,224954,7,235918
12331,0.003455,172.31.36.0-255,66,225020,7,235918
12332,0.003484,172.31.36.0-255,66,225086,7,235918
12333,0.003493,172.217.194.0-255,6139,231225,7,235918
12334,0.003496,172.31.36.0-255,66,231291,7,235918
12335,0.003498,172.217.194.0-255,105,231396,7,235918
12336,0.013599,172.31.36.0-255,66,231462,7,235918
12337,0.013654,172.31.36.0-255,105,231567,7,235918
12338,0.01594,172.217.194.0-255,66,231633,7,235918
12339,0.039787,172.31.36.0-255,167,231800,7,235918
12340,0.039819,172.31.36.0-255,1114,232914,7,235918
12341,0.039885,172.31.36.0-255,1514,234428,7,235918
12342,0.039887,172.31.36.0-255,1292,235720,7,235918
12343,0.041343,104.244.42.0-255,66,235786,7,235918
12344,0.041428,104.244.42.0-255,66,235852,7,235918
12345,0.041503,104.244.42.0-255,66,235918,7,235918
12346,0.0,74.125.24.0-255,153,153,7,190370
12347,1.4e-05,172.31.36.0-255,66,219,7,190370
12348,2e-05,74.125.24.0-255,1484,1703,7,190370
12349,2.4e-05,172.31.36.0-255,66,1769,7,190370
12350,2.7e-05,74.125.24.0-255,1484,3253,7,190370
12351,3e-05,172.31.36.0-255,66,3319,7,190370
12352,5.3e-05,74.125.24.0-255,1484,4803,7,190370
12353,5.5e-05,172.31.36.0-255,66,4869,7,190370
12354,6.3e-05,74.125.24.0-255,7156,12025,7,190370
12355,6.6e-05,172.31.36.0-255,66,12091,7,190370
12356,8.7e-05,74.125.24.0-255,2103,14194,7,190370
12357,8.9e-05,172.31.36.0-255,66,14260,7,190370
12358,0.000164,74.125.24.0-255,1484,15744,7,190370
12359,0.000167,172.31.36.0-255,66,15810,7,190370
12360,0.000171,74.125.24.0-255,2902,18712,7,190370
12361,0.000173,172.31.36.0-255,66,18778,7,190370
12362,0.000187,74.125.24.0-255,5738,24516,7,190370
12363,0.00019,172.31.36.0-255,66,24582,7,190370
12364,0.000227,74.125.24.0-255,7156,31738,7,190370
12365,0.00023,172.31.36.0-255,66,31804,7,190370
12366,0.000257,74.125.24.0-255,6797,38601,7,190370
12367,0.000259,172.31.36.0-255,66,38667,7,190370
12368,0.00027,172.31.36.0-255,66,38733,7,190370
12369,0.000313,172.31.36.0-255,66,38799,7,190370
12370,0.000336,74.125.24.0-255,131,38930,7,190370
12371,0.000338,172.31.36.0-255,66,38996,7,190370
12372,0.000502,74.125.24.0-255,1484,40480,7,190370
12373,0.000505,172.31.36.0-255,66,40546,7,190370
12374,0.000523,74.125.24.0-255,2902,43448,7,190370
12375,0.000525,172.31.36.0-255,66,43514,7,190370
12376,0.000531,74.125.24.0-255,5738,49252,7,190370
12377,0.000533,172.31.36.0-255,66,49318,7,190370
12378,0.000563,172.31.36.0-255,66,49384,7,190370
12379,0.000582,74.125.24.0-255,2902,52286,7,190370
12380,0.000584,172.31.36.0-255,66,52352,7,190370
12381,0.000595,172.31.36.0-255,66,52418,7,190370
12382,0.000598,74.125.24.0-255,766,53184,7,190370
12383,0.000672,74.125.24.0-255,1484,54668,7,190370
12384,0.000675,172.31.36.0-255,66,54734,7,190370
12385,0.00068,74.125.24.0-255,2902,57636,7,190370
12386,0.000682,172.31.36.0-255,66,57702,7,190370
12387,0.000701,74.125.24.0-255,5738,63440,7,190370
12388,0.000704,172.31.36.0-255,66,63506,7,190370
12389,0.000721,74.125.24.0-255,5738,69244,7,190370
12390,0.000724,172.31.36.0-255,66,69310,7,190370
12391,0.000745,74.125.24.0-255,2902,72212,7,190370
12392,0.000748,172.31.36.0-255,66,72278,7,190370
12393,0.000785,74.125.24.0-255,7156,79434,7,190370
12394,0.000789,172.31.36.0-255,66,79500,7,190370
12395,0.000811,172.31.36.0-255,66,79566,7,190370
12396,0.000841,74.125.24.0-255,1484,81050,7,190370
12397,0.000845,74.125.24.0-255,2902,83952,7,190370
12398,0.000849,172.31.36.0-255,66,84018,7,190370
12399,0.000871,74.125.24.0-255,5738,89756,7,190370
12400,0.000875,172.31.36.0-255,66,89822,7,190370
12401,0.000881,74.125.24.0-255,5738,95560,7,190370
12402,0.000883,172.31.36.0-255,66,95626,7,190370
12403,0.000898,74.125.24.0-255,4320,99946,7,190370
12404,0.000901,172.31.36.0-255,66,100012,7,190370
12405,0.000918,74.125.24.0-255,1484,101496,7,190370
12406,0.000931,74.125.24.0-255,5738,107234,7,190370
12407,0.000935,172.31.36.0-255,66,107300,7,190370
12408,0.000952,74.125.24.0-255,6438,113738,7,190370
12409,0.000955,172.31.36.0-255,66,113804,7,190370
12410,0.001135,74.125.24.0-255,1484,115288,7,190370
12411,0.001143,74.125.24.0-255,2902,118190,7,190370
12412,0.001146,172.31.36.0-255,66,118256,7,190370
12413,0.001151,74.125.24.0-255,2902,121158,7,190370
12414,0.001153,172.31.36.0-255,66,121224,7,190370
12415,0.001168,74.125.24.0-255,2902,124126,7,190370
12416,0.001171,172.31.36.0-255,66,124192,7,190370
12417,0.001183,172.31.36.0-255,66,124258,7,190370
12418,0.001233,74.125.24.0-255,4320,128578,7,190370
12419,0.001238,172.31.36.0-255,66,128644,7,190370
12420,0.001264,172.31.36.0-255,66,128710,7,190370
12421,0.001326,74.125.24.0-255,1484,130194,7,190370
12422,0.001332,74.125.24.0-255,2902,133096,7,190370
12423,0.001335,172.31.36.0-255,66,133162,7,190370
12424,0.001342,74.125.24.0-255,4320,137482,7,190370
12425,0.001344,172.31.36.0-255,66,137548,7,190370
12426,0.001364,74.125.24.0-255,1484,139032,7,190370
12427,0.001389,172.31.36.0-255,66,139098,7,190370
12428,0.001408,74.125.24.0-255,4320,143418,7,190370
12429,0.001411,172.31.36.0-255,66,143484,7,190370
12430,0.001428,74.125.24.0-255,1484,144968,7,190370
12431,0.001454,172.31.36.0-255,66,145034,7,190370
12432,0.001485,172.31.36.0-255,66,145100,7,190370
12433,0.00152,172.31.36.0-255,66,145166,7,190370
12434,0.001535,74.125.24.0-255,1484,146650,7,190370
12435,0.001549,74.125.24.0-255,1484,148134,7,190370
12436,0.001552,172.31.36.0-255,66,148200,7,190370
12437,0.001583,172.31.36.0-255,66,148266,7,190370
12438,0.001986,74.125.24.0-255,1484,149750,7,190370
12439,0.001993,74.125.24.0-255,2902,152652,7,190370
12440,0.001997,172.31.36.0-255,66,152718,7,190370
12441,0.002,74.125.24.0-255,1484,154202,7,190370
12442,0.00202,74.125.24.0-255,4320,158522,7,190370
12443,0.002023,172.31.36.0-255,66,158588,7,190370
12444,0.002026,74.125.24.0-255,1484,160072,7,190370
12445,0.002049,172.31.36.0-255,66,160138,7,190370
12446,0.002069,74.125.24.0-255,2902,163040,7,190370
12447,0.002072,172.31.36.0-255,66,163106,7,190370
12448,0.002076,74.125.24.0-255,1484,164590,7,190370
12449,0.002083,74.125.24.0-255,5738,170328,7,190370
12450,0.002086,172.31.36.0-255,66,170394,7,190370
12451,0.002103,172.31.36.0-255,66,170460,7,190370
12452,0.002121,74.125.24.0-255,2184,172644,7,190370
12453,0.002124,172.31.36.0-255,66,172710,7,190370
12454,0.002138,172.31.36.0-255,66,172776,7,190370
12455,0.002172,172.31.36.0-255,66,172842,7,190370
12456,0.002212,172.31.36.0-255,66,172908,7,190370
12457,0.002232,172.31.36.0-255,66,172974,7,190370
12458,0.002257,172.31.36.0-255,66,173040,7,190370
12459,0.002315,172.31.36.0-255,66,173106,7,190370
12460,0.002337,74.125.24.0-255,766,173872,7,190370
12461,0.004532,74.125.24.0-255,4320,178192,7,190370
12462,0.00454,172.31.36.0-255,66,178258,7,190370
12463,0.006763,74.125.24.0-255,5738,183996,7,190370
12464,0.006767,172.31.36.0-255,66,184062,7,190370
12465,0.008986,74.125.24.0-255,1779,185841,7,190370
12466,0.008992,172.31.36.0-255,66,185907,7,190370
12467,0.009133,172.31.36.0-255,105,186012,7,190370
12468,0.011275,74.125.24.0-255,66,186078,7,190370
12469,0.03224,172.31.36.0-255,172,186250,7,190370
12470,0.032297,172.31.36.0-255,1114,187364,7,190370
12471,0.032371,172.31.36.0-255,1514,188878,7,190370
12472,0.032374,172.31.36.0-255,1294,190172,7,190370
12473,0.033788,104.244.42.0-255,66,190238,7,190370
12474,0.033832,104.244.42.0-255,66,190304,7,190370
12475,0.03392,104.244.42.0-255,66,190370,7,190370
12476,0.0,172.31.36.0-255,105,105,7,459
12477,0.000165,172.31.36.0-255,90,195,7,459
12478,0.000174,172.31.36.0-255,66,261,7,459
12479,0.002367,74.125.130.0-255,66,327,7,459
12480,0.002382,74.125.130.0-255,66,393,7,459
12481,0.002387,172.31.36.0-255,66,459,7,459
12482,0.0,172.217.194.0-255,153,153,7,326420
12483,2e-05,172.31.36.0-255,66,219,7,326420
12484,2.7e-05,172.217.194.0-255,1484,1703,7,326420
12485,3.1e-05,172.31.36.0-255,66,1769,7,326420
12486,3.6e-05,172.217.194.0-255,2902,4671,7,326420
12487,4.7e-05,172.31.36.0-255,66,4737,7,326420
12488,5.3e-05,172.217.194.0-255,7156,11893,7,326420
12489,5.6e-05,172.31.36.0-255,66,11959,7,326420
12490,9e-05,172.217.194.0-255,1976,13935,7,326420
12491,9.2e-05,172.31.36.0-255,66,14001,7,326420
12492,0.000105,172.31.36.0-255,66,14067,7,326420
12493,0.000131,172.217.194.0-255,5379,19446,7,326420
12494,0.000134,172.31.36.0-255,66,19512,7,326420
12495,0.000278,172.217.194.0-255,1484,20996,7,326420
12496,0.000281,172.31.36.0-255,66,21062,7,326420
12497,0.000308,172.217.194.0-255,2902,23964,7,326420
12498,0.00031,172.31.36.0-255,66,24030,7,326420
12499,0.000315,172.217.194.0-255,2902,26932,7,326420
12500,0.000317,172.31.36.0-255,66,26998,7,326420
12501,0.000333,172.217.194.0-255,2902,29900,7,326420
12502,0.000335,172.31.36.0-255,66,29966,7,326420
12503,0.000341,172.217.194.0-255,1484,31450,7,326420
12504,0.000343,172.31.36.0-255,66,31516,7,326420
12505,0.000373,172.217.194.0-255,5379,36895,7,326420
12506,0.000378,172.31.36.0-255,66,36961,7,326420
12507,0.000813,172.217.194.0-255,1484,38445,7,326420
12508,0.000818,172.31.36.0-255,66,38511,7,326420
12509,0.000823,172.217.194.0-255,2902,41413,7,326420
12510,0.000826,172.31.36.0-255,66,41479,7,326420
12511,0.000836,172.217.194.0-255,5738,47217,7,326420
12512,0.000838,172.31.36.0-255,66,47283,7,326420
12513,0.000843,172.217.194.0-255,4320,51603,7,326420
12514,0.000844,172.31.36.0-255,66,51669,7,326420
12515,0.000884,172.31.36.0-255,66,51735,7,326420
12516,0.000931,172.31.36.0-255,66,51801,7,326420
12517,0.00097,172.31.36.0-255,66,51867,7,326420
12518,0.001223,172.217.194.0-255,1484,53351,7,326420
12519,0.001231,172.217.194.0-255,2902,56253,7,326420
12520,0.001234,172.31.36.0-255,66,56319,7,326420
12521,0.001242,172.217.194.0-255,5738,62057,7,326420
12522,0.001244,172.31.36.0-255,66,62123,7,326420
12523,0.001286,172.31.36.0-255,66,62189,7,326420
12524,0.001325,172.217.194.0-255,4320,66509,7,326420
12525,0.001329,172.31.36.0-255,66,66575,7,326420
12526,0.001362,172.217.194.0-255,6438,73013,7,326420
12527,0.001365,172.31.36.0-255,66,73079,7,326420
12528,0.001472,172.217.194.0-255,1484,74563,7,326420
12529,0.001478,172.217.194.0-255,2902,77465,7,326420
12530,0.001481,172.31.36.0-255,66,77531,7,326420
12531,0.001487,172.217.194.0-255,4320,81851,7,326420
12532,0.001489,172.31.36.0-255,66,81917,7,326420
12533,0.001507,172.217.194.0-255,1484,83401,7,326420
12534,0.001553,172.31.36.0-255,66,83467,7,326420
12535,0.001581,172.217.194.0-255,1484,84951,7,326420
12536,0.001594,172.31.36.0-255,66,85017,7,326420
12537,0.001787,172.217.194.0-255,1484,86501,7,326420
12538,0.001791,172.217.194.0-255,1484,87985,7,326420
12539,0.001794,172.31.36.0-255,66,88051,7,326420
12540,0.001828,172.217.194.0-255,1484,89535,7,326420
12541,0.001834,172.217.194.0-255,5738,95273,7,326420
12542,0.001837,172.31.36.0-255,66,95339,7,326420
12543,0.001845,172.217.194.0-255,7156,102495,7,326420
12544,0.001847,172.31.36.0-255,66,102561,7,326420
12545,0.00187,172.217.194.0-255,5738,108299,7,326420
12546,0.001873,172.31.36.0-255,66,108365,7,326420
12547,0.001914,172.31.36.0-255,66,108431,7,326420
12548,0.003983,172.217.194.0-255,2902,111333,7,326420
12549,0.00399,172.31.36.0-255,66,111399,7,326420
12550,0.004017,172.217.194.0-255,2902,114301,7,326420
12551,0.004019,172.31.36.0-255,66,114367,7,326420
12552,0.006088,172.217.194.0-255,4320,118687,7,326420
12553,0.006091,172.31.36.0-255,66,118753,7,326420
12554,0.006109,172.217.194.0-255,1484,120237,7,326420
12555,0.008155,172.217.194.0-255,4320,124557,7,326420
12556,0.00816,172.31.36.0-255,66,124623,7,326420
12557,0.010273,172.217.194.0-255,5738,130361,7,326420
12558,0.010281,172.31.36.0-255,66,130427,7,326420
12559,0.012384,172.217.194.0-255,5738,136165,7,326420
12560,0.012396,172.31.36.0-255,66,136231,7,326420
12561,0.014523,172.217.194.0-255,5738,141969,7,326420
12562,0.01453,172.31.36.0-255,66,142035,7,326420
12563,0.016576,172.217.194.0-255,4320,146355,7,326420
12564,0.016584,172.31.36.0-255,66,146421,7,326420
12565,0.016612,172.217.194.0-255,1484,147905,7,326420
12566,0.018688,172.217.194.0-255,4320,152225,7,326420
12567,0.018698,172.31.36.0-255,66,152291,7,326420
12568,0.02081,172.217.194.0-255,5738,158029,7,326420
12569,0.020819,172.31.36.0-255,66,158095,7,326420
12570,0.022943,172.217.194.0-255,5738,163833,7,326420
12571,0.022952,172.31.36.0-255,66,163899,7,326420
12572,0.025048,172.217.194.0-255,5738,169637,7,326420
12573,0.025055,172.31.36.0-255,66,169703,7,326420
12574,0.027163,172.217.194.0-255,5738,175441,7,326420
12575,0.027171,172.31.36.0-255,66,175507,7,326420
12576,0.029259,172.217.194.0-255,5738,181245,7,326420
12577,0.029272,172.31.36.0-255,66,181311,7,326420
12578,0.031351,172.217.194.0-255,5738,187049,7,326420
12579,0.03136,172.31.36.0-255,66,187115,7,326420
12580,0.033458,172.217.194.0-255,5738,192853,7,326420
12581,0.033466,172.31.36.0-255,66,192919,7,326420
12582,0.03558,172.217.194.0-255,4320,197239,7,326420
12583,0.035585,172.31.36.0-255,66,197305,7,326420
12584,0.035612,172.217.194.0-255,1484,198789,7,326420
12585,0.03651,172.31.36.0-255,172,198961,7,326420
12586,0.036542,172.31.36.0-255,1116,200077,7,326420
12587,0.036605,172.31.36.0-255,1514,201591,7,326420
12588,0.036607,172.31.36.0-255,1514,203105,7,326420
12589,0.036609,172.31.36.0-255,1514,204619,7,326420
12590,0.036634,172.31.36.0-255,1071,205690,7,326420
12591,0.037702,172.217.194.0-255,4320,210010,7,326420
12592,0.037708,172.31.36.0-255,66,210076,7,326420
12593,0.03808,104.244.42.0-255,66,210142,7,326420
12594,0.038131,104.244.42.0-255,66,210208,7,326420
12595,0.038152,104.244.42.0-255,66,210274,7,326420
12596,0.038163,104.244.42.0-255,66,210340,7,326420
12597,0.039813,172.217.194.0-255,5738,216078,7,326420
12598,0.03982,172.31.36.0-255,66,216144,7,326420
12599,0.041905,172.217.194.0-255,5738,221882,7,326420
12600,0.041912,172.31.36.0-255,66,221948,7,326420
12601,0.044019,172.217.194.0-255,5738,227686,7,326420
12602,0.044027,172.31.36.0-255,66,227752,7,326420
12603,0.046132,172.217.194.0-255,5738,233490,7,326420
12604,0.046139,172.31.36.0-255,66,233556,7,326420
12605,0.048255,172.217.194.0-255,5738,239294,7,326420
12606,0.048262,172.31.36.0-255,66,239360,7,326420
12607,0.050353,172.217.194.0-255,5738,245098,7,326420
12608,0.050361,172.31.36.0-255,66,245164,7,326420
12609,0.052463,172.217.194.0-255,5738,250902,7,326420
12610,0.052469,172.31.36.0-255,66,250968,7,326420
12611,0.054627,172.217.194.0-255,5738,256706,7,326420
12612,0.054633,172.31.36.0-255,66,256772,7,326420
12613,0.056736,172.217.194.0-255,5738,262510,7,326420
12614,0.056742,172.31.36.0-255,66,262576,7,326420
12615,0.058791,172.217.194.0-255,5738,268314,7,326420
12616,0.058798,172.31.36.0-255,66,268380,7,326420
12617,0.060916,172.217.194.0-255,5738,274118,7,326420
12618,0.060924,172.31.36.0-255,66,274184,7,326420
12619,0.06303,172.217.194.0-255,5738,279922,7,326420
12620,0.063036,172.31.36.0-255,66,279988,7,326420
12621,0.065107,172.217.194.0-255,5738,285726,7,326420
12622,0.065114,172.31.36.0-255,66,285792,7,326420
12623,0.067185,172.217.194.0-255,5738,291530,7,326420
12624,0.067191,172.31.36.0-255,66,291596,7,326420
12625,0.069322,172.217.194.0-255,5738,297334,7,326420
12626,0.069329,172.31.36.0-255,66,297400,7,326420
12627,0.071434,172.217.194.0-255,5738,303138,7,326420
12628,0.07144,172.31.36.0-255,66,303204,7,326420
12629,0.073544,172.217.194.0-255,5738,308942,7,326420
12630,0.073554,172.31.36.0-255,66,309008,7,326420
12631,0.075671,172.217.194.0-255,5738,314746,7,326420
12632,0.075678,172.31.36.0-255,66,314812,7,326420
12633,0.077786,172.217.194.0-255,5738,320550,7,326420
12634,0.077796,172.31.36.0-255,66,320616,7,326420
12635,0.079913,172.217.194.0-255,5738,326354,7,326420
12636,0.079919,172.31.36.0-255,66,326420,7,326420
12637,0.0,74.125.130.0-255,153,153,7,271323
12638,2.7e-05,172.31.36.0-255,66,219,7,271323
12639,6.3e-05,74.125.130.0-255,1484,1703,7,271323
12640,6.8e-05,172.31.36.0-255,66,1769,7,271323
12641,8.9e-05,74.125.130.0-255,2902,4671,7,271323
12642,9.3e-05,172.31.36.0-255,66,4737,7,271323
12643,9.7e-05,74.125.130.0-255,2902,7639,7,271323
12644,0.000101,172.31.36.0-255,66,7705,7,271323
12645,0.000123,74.125.130.0-255,4320,12025,7,271323
12646,0.000126,172.31.36.0-255,66,12091,7,271323
12647,0.000142,74.125.130.0-255,1993,14084,7,271323
12648,0.000145,172.31.36.0-255,66,14150,7,271323
12649,0.000148,74.125.130.0-255,1484,15634,7,271323
12650,0.000151,172.31.36.0-255,66,15700,7,271323
12651,0.000168,74.125.130.0-255,1484,17184,7,271323
12652,0.00017,172.31.36.0-255,66,17250,7,271323
12653,0.000178,74.125.130.0-255,7156,24406,7,271323
12654,0.000181,172.31.36.0-255,66,24472,7,271323
12655,0.000184,74.125.130.0-255,1484,25956,7,271323
12656,0.000186,172.31.36.0-255,66,26022,7,271323
12657,0.000203,74.125.130.0-255,1484,27506,7,271323
12658,0.000206,172.31.36.0-255,66,27572,7,271323
12659,0.000212,74.125.130.0-255,3961,31533,7,271323
12660,0.000214,172.31.36.0-255,66,31599,7,271323
12661,0.000821,74.125.130.0-255,1484,33083,7,271323
12662,0.000827,172.31.36.0-255,66,33149,7,271323
12663,0.000837,74.125.130.0-255,2902,36051,7,271323
12664,0.000839,172.31.36.0-255,66,36117,7,271323
12665,0.000844,74.125.130.0-255,2902,39019,7,271323
12666,0.000846,172.31.36.0-255,66,39085,7,271323
12667,0.000851,74.125.130.0-255,4320,43405,7,271323
12668,0.000853,172.31.36.0-255,66,43471,7,271323
12669,0.000879,172.31.36.0-255,66,43537,7,271323
12670,0.000894,74.125.130.0-255,1484,45021,7,271323
12671,0.000924,172.31.36.0-255,66,45087,7,271323
12672,0.000959,74.125.130.0-255,378,45465,7,271323
12673,0.000963,74.125.130.0-255,365,45830,7,271323
12674,0.001116,74.125.130.0-255,1484,47314,7,271323
12675,0.001122,172.31.36.0-255,66,47380,7,271323
12676,0.001127,74.125.130.0-255,2902,50282,7,271323
12677,0.001129,172.31.36.0-255,66,50348,7,271323
12678,0.001135,74.125.130.0-255,4320,54668,7,271323
12679,0.001138,172.31.36.0-255,66,54734,7,271323
12680,0.001156,74.125.130.0-255,1484,56218,7,271323
12681,0.001161,74.125.130.0-255,4320,60538,7,271323
12682,0.001164,172.31.36.0-255,66,60604,7,271323
12683,0.001195,74.125.130.0-255,2902,63506,7,271323
12684,0.001197,172.31.36.0-255,66,63572,7,271323
12685,0.001215,74.125.130.0-255,2902,66474,7,271323
12686,0.001218,172.31.36.0-255,66,66540,7,271323
12687,0.00123,172.31.36.0-255,66,66606,7,271323
12688,0.001233,74.125.130.0-255,2184,68790,7,271323
12689,0.001235,172.31.36.0-255,66,68856,7,271323
12690,0.003449,74.125.130.0-255,2902,71758,7,271323
12691,0.003453,172.31.36.0-255,66,71824,7,271323
12692,0.003472,74.125.130.0-255,2902,74726,7,271323
12693,0.003474,172.31.36.0-255,66,74792,7,271323
12694,0.005708,74.125.130.0-255,4320,79112,7,271323
12695,0.005715,172.31.36.0-255,66,79178,7,271323
12696,0.005734,74.125.130.0-255,1484,80662,7,271323
12697,0.007953,74.125.130.0-255,4320,84982,7,271323
12698,0.00796,172.31.36.0-255,66,85048,7,271323
12699,0.010212,74.125.130.0-255,4320,89368,7,271323
12700,0.010219,172.31.36.0-255,66,89434,7,271323
12701,0.010238,74.125.130.0-255,1484,90918,7,271323
12702,0.012486,74.125.130.0-255,4320,95238,7,271323
12703,0.012495,172.31.36.0-255,66,95304,7,271323
12704,0.014739,74.125.130.0-255,5738,101042,7,271323
12705,0.014747,172.31.36.0-255,66,101108,7,271323
12706,0.016997,74.125.130.0-255,5738,106846,7,271323
12707,0.017004,172.31.36.0-255,66,106912,7,271323
12708,0.019239,74.125.130.0-255,5738,112650,7,271323
12709,0.01925,172.31.36.0-255,66,112716,7,271323
12710,0.021496,74.125.130.0-255,5738,118454,7,271323
12711,0.021505,172.31.36.0-255,66,118520,7,271323
12712,0.02375,74.125.130.0-255,5738,124258,7,271323
12713,0.023755,172.31.36.0-255,66,124324,7,271323
12714,0.023808,172.31.36.0-255,187,124511,7,271323
12715,0.023832,172.31.36.0-255,982,125493,7,271323
12716,0.023869,172.31.36.0-255,1514,127007,7,271323
12717,0.02387,172.31.36.0-255,1424,128431,7,271323
12718,0.025382,104.244.42.0-255,66,128497,7,271323
12719,0.025404,104.244.42.0-255,66,128563,7,271323
12720,0.025496,104.244.42.0-255,66,128629,7,271323
12721,0.025986,74.125.130.0-255,5738,134367,7,271323
12722,0.02599,172.31.36.0-255,66,134433,7,271323
12723,0.028218,74.125.130.0-255,5738,140171,7,271323
12724,0.028223,172.31.36.0-255,66,140237,7,271323
12725,0.030464,74.125.130.0-255,5738,145975,7,271323
12726,0.030469,172.31.36.0-255,66,146041,7,271323
12727,0.032706,74.125.130.0-255,5738,151779,7,271323
12728,0.032712,172.31.36.0-255,66,151845,7,271323
12729,0.034953,74.125.130.0-255,5738,157583,7,271323
12730,0.034959,172.31.36.0-255,66,157649,7,271323
12731,0.037193,74.125.130.0-255,5738,163387,7,271323
12732,0.037198,172.31.36.0-255,66,163453,7,271323
12733,0.039442,74.125.130.0-255,5738,169191,7,271323
12734,0.039448,172.31.36.0-255,66,169257,7,271323
12735,0.041692,74.125.130.0-255,5738,174995,7,271323
12736,0.041698,172.31.36.0-255,66,175061,7,271323
12737,0.043931,74.125.130.0-255,4320,179381,7,271323
12738,0.043937,172.31.36.0-255,66,179447,7,271323
12739,0.043965,74.125.130.0-255,1484,180931,7,271323
12740,0.046176,74.125.130.0-255,4320,185251,7,271323
12741,0.046181,172.31.36.0-255,66,185317,7,271323
12742,0.04841,74.125.130.0-255,4320,189637,7,271323
12743,0.048416,172.31.36.0-255,66,189703,7,271323
12744,0.048444,74.125.130.0-255,1484,191187,7,271323
12745,0.050641,74.125.130.0-255,4320,195507,7,271323
12746,0.050647,172.31.36.0-255,66,195573,7,271323
12747,0.052882,74.125.130.0-255,4320,199893,7,271323
12748,0.052887,172.31.36.0-255,66,199959,7,271323
12749,0.05292,74.125.130.0-255,1484,201443,7,271323
12750,0.055117,74.125.130.0-255,1484,202927,7,271323
12751,0.055122,172.31.36.0-255,66,202993,7,271323
12752,0.05515,74.125.130.0-255,2902,205895,7,271323
12753,0.055153,172.31.36.0-255,66,205961,7,271323
12754,0.057367,74.125.130.0-255,2902,208863,7,271323
12755,0.057372,172.31.36.0-255,66,208929,7,271323
12756,0.057404,74.125.130.0-255,2902,211831,7,271323
12757,0.057408,172.31.36.0-255,66,211897,7,271323
12758,0.059603,74.125.130.0-255,2902,214799,7,271323
12759,0.059608,172.31.36.0-255,66,214865,7,271323
12760,0.059636,74.125.130.0-255,2902,217767,7,271323
12761,0.059639,172.31.36.0-255,66,217833,7,271323
12762,0.061854,74.125.130.0-255,2902,220735,7,271323
12763,0.061863,172.31.36.0-255,66,220801,7,271323
12764,0.061879,74.125.130.0-255,2902,223703,7,271323
12765,0.061882,172.31.36.0-255,66,223769,7,271323
12766,0.064088,74.125.130.0-255,2902,226671,7,271323
12767,0.064094,172.31.36.0-255,66,226737,7,271323
12768,0.064126,74.125.130.0-255,2902,229639,7,271323
12769,0.064129,172.31.36.0-255,66,229705,7,271323
12770,0.066332,74.125.130.0-255,2902,232607,7,271323
12771,0.066338,172.31.36.0-255,66,232673,7,271323
12772,0.066372,74.125.130.0-255,2902,235575,7,271323
12773,0.066375,172.31.36.0-255,66,235641,7,271323
12774,0.068608,74.125.130.0-255,2902,238543,7,271323
12775,0.068613,172.31.36.0-255,66,238609,7,271323
12776,0.068645,74.125.130.0-255,2902,241511,7,271323
12777,0.068649,172.31.36.0-255,66,241577,7,271323
12778,0.070863,74.125.130.0-255,2902,244479,7,271323
12779,0.070869,172.31.36.0-255,66,244545,7,271323
12780,0.0709,74.125.130.0-255,2902,247447,7,271323
12781,0.070903,172.31.36.0-255,66,247513,7,271323
12782,0.07311,74.125.130.0-255,2902,250415,7,271323
12783,0.073116,172.31.36.0-255,66,250481,7,271323
12784,0.07315,74.125.130.0-255,2902,253383,7,271323
12785,0.073153,172.31.36.0-255,66,253449,7,271323
12786,0.075345,74.125.130.0-255,2902,256351,7,271323
12787,0.07535,172.31.36.0-255,66,256417,7,271323
12788,0.075381,74.125.130.0-255,2902,259319,7,271323
12789,0.075384,172.31.36.0-255,66,259385,7,271323
12790,0.077592,74.125.130.0-255,2902,262287,7,271323
12791,0.077598,172.31.36.0-255,66,262353,7,271323
12792,0.077632,74.125.130.0-255,2902,265255,7,271323
12793,0.077635,172.31.36.0-255,66,265321,7,271323
12794,0.079824,74.125.130.0-255,1484,266805,7,271323
12795,0.079857,74.125.130.0-255,1484,268289,7,271323
12796,0.079862,172.31.36.0-255,66,268355,7,271323
12797,0.079881,74.125.130.0-255,2902,271257,7,271323
12798,0.079884,172.31.36.0-255,66,271323,7,271323
12799,0.0,172.217.24.0-255,153,153,7,314024
12800,1.7e-05,172.31.36.0-255,66,219,7,314024
12801,2.5e-05,172.217.24.0-255,1484,1703,7,314024
12802,2.9e-05,172.31.36.0-255,66,1769,7,314024
12803,3.5e-05,172.217.24.0-255,2902,4671,7,314024
12804,4.6e-05,172.31.36.0-255,66,4737,7,314024
12805,5.2e-05,172.217.24.0-255,4320,9057,7,314024
12806,5.5e-05,172.31.36.0-255,66,9123,7,314024
12807,0.000104,172.217.24.0-255,4840,13963,7,314024
12808,0.00011,172.31.36.0-255,66,14029,7,314024
12809,0.000114,172.217.24.0-255,1484,15513,7,314024
12810,0.000116,172.31.36.0-255,66,15579,7,314024
12811,0.000159,172.217.24.0-255,4320,19899,7,314024
12812,0.000161,172.31.36.0-255,66,19965,7,314024
12813,0.000178,172.31.36.0-255,66,20031,7,314024
12814,0.000183,172.217.24.0-255,2543,22574,7,314024
12815,0.000185,172.31.36.0-255,66,22640,7,314024
12816,0.000226,172.217.24.0-255,1484,24124,7,314024
12817,0.000228,172.31.36.0-255,66,24190,7,314024
12818,0.000232,172.217.24.0-255,1484,25674,7,314024
12819,0.000234,172.31.36.0-255,66,25740,7,314024
12820,0.000266,172.217.24.0-255,1484,27224,7,314024
12821,0.000268,172.31.36.0-255,66,27290,7,314024
12822,0.000276,172.217.24.0-255,5738,33028,7,314024
12823,0.000278,172.31.36.0-255,66,33094,7,314024
12824,0.000291,172.217.24.0-255,6797,39891,7,314024
12825,0.000293,172.31.36.0-255,66,39957,7,314024
12826,0.000424,172.217.24.0-255,1484,41441,7,314024
12827,0.000428,172.31.36.0-255,66,41507,7,314024
12828,0.000434,172.217.24.0-255,2902,44409,7,314024
12829,0.000436,172.31.36.0-255,66,44475,7,314024
12830,0.000464,172.217.24.0-255,5738,50213,7,314024
12831,0.000467,172.31.36.0-255,66,50279,7,314024
12832,0.000496,172.217.24.0-255,7091,57370,7,314024
12833,0.000499,172.31.36.0-255,66,57436,7,314024
12834,0.001493,172.217.24.0-255,134,57570,7,314024
12835,0.001627,172.217.24.0-255,1484,59054,7,314024
12836,0.001633,172.31.36.0-255,66,59120,7,314024
12837,0.001641,172.217.24.0-255,2902,62022,7,314024
12838,0.001643,172.31.36.0-255,66,62088,7,314024
12839,0.001657,172.217.24.0-255,5738,67826,7,314024
12840,0.00166,172.31.36.0-255,66,67892,7,314024
12841,0.001663,172.217.24.0-255,1484,69376,7,314024
12842,0.001712,172.31.36.0-255,66,69442,7,314024
12843,0.001719,172.217.24.0-255,7156,76598,7,314024
12844,0.001721,172.31.36.0-255,66,76664,7,314024
12845,0.001757,172.217.24.0-255,2543,79207,7,314024
12846,0.00176,172.31.36.0-255,66,79273,7,314024
12847,0.003652,172.217.24.0-255,2902,82175,7,314024
12848,0.00366,172.31.36.0-255,66,82241,7,314024
12849,0.003691,172.217.24.0-255,2902,85143,7,314024
12850,0.003695,172.31.36.0-255,66,85209,7,314024
12851,0.0056,172.217.24.0-255,2902,88111,7,314024
12852,0.005605,172.31.36.0-255,66,88177,7,314024
12853,0.005636,172.217.24.0-255,2902,91079,7,314024
12854,0.005639,172.31.36.0-255,66,91145,7,314024
12855,0.007541,172.217.24.0-255,2902,94047,7,314024
12856,0.007548,172.31.36.0-255,66,94113,7,314024
12857,0.007594,172.217.24.0-255,2902,97015,7,314024
12858,0.007598,172.31.36.0-255,66,97081,7,314024
12859,0.009484,172.217.24.0-255,2902,99983,7,314024
12860,0.009492,172.31.36.0-255,66,100049,7,314024
12861,0.009525,172.217.24.0-255,2902,102951,7,314024
12862,0.009529,172.31.36.0-255,66,103017,7,314024
12863,0.011423,172.217.24.0-255,2902,105919,7,314024
12864,0.011431,172.31.36.0-255,66,105985,7,314024
12865,0.011459,172.217.24.0-255,2902,108887,7,314024
12866,0.011462,172.31.36.0-255,66,108953,7,314024
12867,0.01337,172.217.24.0-255,2902,111855,7,314024
12868,0.013378,172.31.36.0-255,66,111921,7,314024
12869,0.013412,172.217.24.0-255,2902,114823,7,314024
12870,0.013415,172.31.36.0-255,66,114889,7,314024
12871,0.015319,172.217.24.0-255,2902,117791,7,314024
12872,0.015327,172.31.36.0-255,66,117857,7,314024
12873,0.01536,172.217.24.0-255,2902,120759,7,314024
12874,0.015363,172.31.36.0-255,66,120825,7,314024
12875,0.017271,172.217.24.0-255,4320,125145,7,314024
12876,0.01728,172.31.36.0-255,66,125211,7,314024
12877,0.017311,172.217.24.0-255,1484,126695,7,314024
12878,0.019233,172.217.24.0-255,4320,131015,7,314024
12879,0.019245,172.31.36.0-255,66,131081,7,314024
12880,0.021182,172.217.24.0-255,5738,136819,7,314024
12881,0.02119,172.31.36.0-255,66,136885,7,314024
12882,0.023129,172.217.24.0-255,5738,142623,7,314024
12883,0.023138,172.31.36.0-255,66,142689,7,314024
12884,0.025075,172.217.24.0-255,5738,148427,7,314024
12885,0.025082,172.31.36.0-255,66,148493,7,314024
12886,0.026733,172.31.36.0-255,187,148680,7,314024
12887,0.026763,172.31.36.0-255,982,149662,7,314024
12888,0.026822,172.31.36.0-255,1514,151176,7,314024
12889,0.026824,172.31.36.0-255,1424,152600,7,314024
12890,0.027013,172.217.24.0-255,5738,158338,7,314024
12891,0.027019,172.31.36.0-255,66,158404,7,314024
12892,0.028299,104.244.42.0-255,66,158470,7,314024
12893,0.028332,104.244.42.0-255,66,158536,7,314024
12894,0.02843,104.244.42.0-255,66,158602,7,314024
12895,0.028968,172.217.24.0-255,5738,164340,7,314024
12896,0.028974,172.31.36.0-255,66,164406,7,314024
12897,0.030963,172.217.24.0-255,5738,170144,7,314024
12898,0.030969,172.31.36.0-255,66,170210,7,314024
12899,0.032906,172.217.24.0-255,5738,175948,7,314024
12900,0.032912,172.31.36.0-255,66,176014,7,314024
12901,0.034867,172.217.24.0-255,5738,181752,7,314024
12902,0.034874,172.31.36.0-255,66,181818,7,314024
12903,0.036809,172.217.24.0-255,1484,183302,7,314024
12904,0.036829,172.217.24.0-255,4320,187622,7,314024
12905,0.036835,172.31.36.0-255,66,187688,7,314024
12906,0.03879,172.217.24.0-255,5738,193426,7,314024
12907,0.038798,172.31.36.0-255,66,193492,7,314024
12908,0.040756,172.217.24.0-255,5738,199230,7,314024
12909,0.040763,172.31.36.0-255,66,199296,7,314024
12910,0.042705,172.217.24.0-255,5738,205034,7,314024
12911,0.042711,172.31.36.0-255,66,205100,7,314024
12912,0.044653,172.217.24.0-255,5738,210838,7,314024
12913,0.04466,172.31.36.0-255,66,210904,7,314024
12914,0.046601,172.217.24.0-255,5738,216642,7,314024
12915,0.046607,172.31.36.0-255,66,216708,7,314024
12916,0.048554,172.217.24.0-255,5738,222446,7,314024
12917,0.04856,172.31.36.0-255,66,222512,7,314024
12918,0.050504,172.217.24.0-255,5738,228250,7,314024
12919,0.05051,172.31.36.0-255,66,228316,7,314024
12920,0.052461,172.217.24.0-255,5738,234054,7,314024
12921,0.052467,172.31.36.0-255,66,234120,7,314024
12922,0.054416,172.217.24.0-255,5738,239858,7,314024
12923,0.054422,172.31.36.0-255,66,239924,7,314024
12924,0.05637,172.217.24.0-255,5738,245662,7,314024
12925,0.056377,172.31.36.0-255,66,245728,7,314024
12926,0.058318,172.217.24.0-255,5738,251466,7,314024
12927,0.058324,172.31.36.0-255,66,251532,7,314024
12928,0.060284,172.217.24.0-255,5738,257270,7,314024
12929,0.060289,172.31.36.0-255,66,257336,7,314024
12930,0.062231,172.217.24.0-255,5738,263074,7,314024
12931,0.062237,172.31.36.0-255,66,263140,7,314024
12932,0.064181,172.217.24.0-255,5738,268878,7,314024
12933,0.064188,172.31.36.0-255,66,268944,7,314024
12934,0.066128,172.217.24.0-255,4320,273264,7,314024
12935,0.066135,172.31.36.0-255,66,273330,7,314024
12936,0.066165,172.217.24.0-255,1484,274814,7,314024
12937,0.068081,172.217.24.0-255,4320,279134,7,314024
12938,0.068087,172.31.36.0-255,66,279200,7,314024
12939,0.070048,172.217.24.0-255,5738,284938,7,314024
12940,0.070056,172.31.36.0-255,66,285004,7,314024
12941,0.072003,172.217.24.0-255,5738,290742,7,314024
12942,0.072009,172.31.36.0-255,66,290808,7,314024
12943,0.073985,172.217.24.0-255,5738,296546,7,314024
12944,0.073992,172.31.36.0-255,66,296612,7,314024
12945,0.075961,172.217.24.0-255,5738,302350,7,314024
12946,0.075968,172.31.36.0-255,66,302416,7,314024
12947,0.077918,172.217.24.0-255,5738,308154,7,314024
12948,0.077925,172.31.36.0-255,66,308220,7,314024
12949,0.079867,172.217.24.0-255,5738,313958,7,314024
12950,0.079872,172.31.36.0-255,66,314024,7,314024
12951,0.0,172.217.160.0-255,150,150,7,364947
12952,3.6e-05,172.31.36.0-255,66,216,7,364947
12953,4.3e-05,172.217.160.0-255,1484,1700,7,364947
12954,4.7e-05,172.31.36.0-255,66,1766,7,364947
12955,5.2e-05,172.217.160.0-255,2902,4668,7,364947
12956,5.4e-05,172.31.36.0-255,66,4734,7,364947
12957,6.1e-05,172.217.160.0-255,7156,11890,7,364947
12958,6.4e-05,172.31.36.0-255,66,11956,7,364947
12959,6.9e-05,172.217.160.0-255,3409,15365,7,364947
12960,7.1e-05,172.31.36.0-255,66,15431,7,364947
12961,8.6e-05,172.31.36.0-255,66,15497,7,364947
12962,0.000136,172.217.160.0-255,2543,18040,7,364947
12963,0.00014,172.31.36.0-255,66,18106,7,364947
12964,0.000168,172.217.160.0-255,1484,19590,7,364947
12965,0.000171,172.31.36.0-255,66,19656,7,364947
12966,0.000188,172.217.160.0-255,2902,22558,7,364947
12967,0.00019,172.31.36.0-255,66,22624,7,364947
12968,0.000196,172.217.160.0-255,4320,26944,7,364947
12969,0.000198,172.31.36.0-255,66,27010,7,364947
12970,0.000234,172.217.160.0-255,2902,29912,7,364947
12971,0.000236,172.31.36.0-255,66,29978,7,364947
12972,0.00026,172.217.160.0-255,5379,35357,7,364947
12973,0.000263,172.31.36.0-255,66,35423,7,364947
12974,0.000291,172.217.160.0-255,1484,36907,7,364947
12975,0.000294,172.31.36.0-255,66,36973,7,364947
12976,0.000298,172.217.160.0-255,2902,39875,7,364947
12977,0.000301,172.31.36.0-255,66,39941,7,364947
12978,0.000321,172.217.160.0-255,5738,45679,7,364947
12979,0.000324,172.31.36.0-255,66,45745,7,364947
12980,0.000348,172.217.160.0-255,6797,52542,7,364947
12981,0.000353,172.31.36.0-255,66,52608,7,364947
12982,0.000371,172.217.160.0-255,375,52983,7,364947
12983,0.000795,172.31.36.0-255,66,53049,7,364947
12984,0.000935,172.217.160.0-255,101,53150,7,364947
12985,0.001043,172.217.160.0-255,1484,54634,7,364947
12986,0.001048,172.31.36.0-255,66,54700,7,364947
12987,0.001054,172.217.160.0-255,2902,57602,7,364947
12988,0.001057,172.31.36.0-255,66,57668,7,364947
12989,0.001061,172.217.160.0-255,2902,60570,7,364947
12990,0.001063,172.31.36.0-255,66,60636,7,364947
12991,0.001078,172.217.160.0-255,2902,63538,7,364947
12992,0.001081,172.31.36.0-255,66,63604,7,364947
12993,0.001098,172.217.160.0-255,2902,66506,7,364947
12994,0.0011,172.31.36.0-255,66,66572,7,364947
12995,0.001114,172.217.160.0-255,3961,70533,7,364947
12996,0.001117,172.31.36.0-255,66,70599,7,364947
12997,0.001123,172.217.160.0-255,5738,76337,7,364947
12998,0.001124,172.31.36.0-255,66,76403,7,364947
12999,0.001145,172.217.160.0-255,1484,77887,7,364947
13000,0.001152,172.217.160.0-255,5738,83625,7,364947
13001,0.001154,172.31.36.0-255,66,83691,7,364947
13002,0.001173,172.217.160.0-255,3961,87652,7,364947
13003,0.001175,172.31.36.0-255,66,87718,7,364947
13004,0.001397,172.217.160.0-255,1484,89202,7,364947
13005,0.001404,172.217.160.0-255,2902,92104,7,364947
13006,0.001408,172.31.36.0-255,66,92170,7,364947
13007,0.001414,172.217.160.0-255,4320,96490,7,364947
13008,0.001416,172.31.36.0-255,66,96556,7,364947
13009,0.001429,172.217.160.0-255,1484,98040,7,364947
13010,0.001435,172.217.160.0-255,4320,102360,7,364947
13011,0.001437,172.31.36.0-255,66,102426,7,364947
13012,0.001474,172.31.36.0-255,66,102492,7,364947
13013,0.001486,172.31.36.0-255,66,102558,7,364947
13014,0.001519,172.217.160.0-255,1484,104042,7,364947
13015,0.001523,172.217.160.0-255,1484,105526,7,364947
13016,0.001525,172.31.36.0-255,66,105592,7,364947
13017,0.001544,172.217.160.0-255,1484,107076,7,364947
13018,0.001569,172.217.160.0-255,5738,112814,7,364947
13019,0.001574,172.31.36.0-255,66,112880,7,364947
13020,0.001589,172.31.36.0-255,66,112946,7,364947
13021,0.00161,172.217.160.0-255,4320,117266,7,364947
13022,0.001612,172.31.36.0-255,66,117332,7,364947
13023,0.001635,172.217.160.0-255,6438,123770,7,364947
13024,0.001638,172.31.36.0-255,66,123836,7,364947
13025,0.001652,172.217.160.0-255,4320,128156,7,364947
13026,0.001655,172.31.36.0-255,66,128222,7,364947
13027,0.001683,172.217.160.0-255,5738,133960,7,364947
13028,0.001688,172.31.36.0-255,66,134026,7,364947
13029,0.001693,172.217.160.0-255,4320,138346,7,364947
13030,0.001696,172.31.36.0-255,66,138412,7,364947
13031,0.00172,172.217.160.0-255,7156,145568,7,364947
13032,0.001724,172.31.36.0-255,66,145634,7,364947
13033,0.00173,172.217.160.0-255,5738,151372,7,364947
13034,0.001732,172.31.36.0-255,66,151438,7,364947
13035,0.001764,172.217.160.0-255,6438,157876,7,364947
13036,0.001768,172.31.36.0-255,66,157942,7,364947
13037,0.001906,172.217.160.0-255,1484,159426,7,364947
13038,0.00192,172.217.160.0-255,1484,160910,7,364947
13039,0.001922,172.31.36.0-255,66,160976,7,364947
13040,0.001942,172.217.160.0-255,1484,162460,7,364947
13041,0.001948,172.217.160.0-255,5738,168198,7,364947
13042,0.00195,172.31.36.0-255,66,168264,7,364947
13043,0.002012,172.31.36.0-255,66,168330,7,364947
13044,0.003917,172.217.160.0-255,4320,172650,7,364947
13045,0.00392,172.31.36.0-255,66,172716,7,364947
13046,0.003936,172.217.160.0-255,1484,174200,7,364947
13047,0.005829,172.217.160.0-255,4320,178520,7,364947
13048,0.005836,172.31.36.0-255,66,178586,7,364947
13049,0.007765,172.217.160.0-255,5738,184324,7,364947
13050,0.00777,172.31.36.0-255,66,184390,7,364947
13051,0.009685,172.217.160.0-255,5738,190128,7,364947
13052,0.009692,172.31.36.0-255,66,190194,7,364947
13053,0.011618,172.217.160.0-255,5738,195932,7,364947
13054,0.011625,172.31.36.0-255,66,195998,7,364947
13055,0.013568,172.217.160.0-255,5738,201736,7,364947
13056,0.013575,172.31.36.0-255,66,201802,7,364947
13057,0.015509,172.217.160.0-255,5738,207540,7,364947
13058,0.015517,172.31.36.0-255,66,207606,7,364947
13059,0.017451,172.217.160.0-255,5738,213344,7,364947
13060,0.01746,172.31.36.0-255,66,213410,7,364947
13061,0.01939,172.217.160.0-255,5738,219148,7,364947
13062,0.019398,172.31.36.0-255,66,219214,7,364947
13063,0.021316,172.217.160.0-255,5738,224952,7,364947
13064,0.021322,172.31.36.0-255,66,225018,7,364947
13065,0.023234,172.217.160.0-255,5738,230756,7,364947
13066,0.023239,172.31.36.0-255,66,230822,7,364947
13067,0.025201,172.217.160.0-255,5738,236560,7,364947
13068,0.025208,172.31.36.0-255,66,236626,7,364947
13069,0.027129,172.217.160.0-255,4320,240946,7,364947
13070,0.027135,172.31.36.0-255,66,241012,7,364947
13071,0.027156,172.217.160.0-255,1484,242496,7,364947
13072,0.02905,172.217.160.0-255,4320,246816,7,364947
13073,0.029057,172.31.36.0-255,66,246882,7,364947
13074,0.03048,172.31.36.0-255,172,247054,7,364947
13075,0.030527,172.31.36.0-255,1073,248127,7,364947
13076,0.03098,172.217.160.0-255,5738,253865,7,364947
13077,0.030986,172.31.36.0-255,66,253931,7,364947
13078,0.032022,104.244.42.0-255,66,253997,7,364947
13079,0.032065,104.244.42.0-255,66,254063,7,364947
13080,0.032899,172.217.160.0-255,5738,259801,7,364947
13081,0.032906,172.31.36.0-255,66,259867,7,364947
13082,0.034829,172.217.160.0-255,5738,265605,7,364947
13083,0.034836,172.31.36.0-255,66,265671,7,364947
13084,0.036754,172.217.160.0-255,5738,271409,7,364947
13085,0.03676,172.31.36.0-255,66,271475,7,364947
13086,0.038679,172.217.160.0-255,5738,277213,7,364947
13087,0.038685,172.31.36.0-255,66,277279,7,364947
13088,0.040605,172.217.160.0-255,5738,283017,7,364947
13089,0.040614,172.31.36.0-255,66,283083,7,364947
13090,0.042536,172.217.160.0-255,5738,288821,7,364947
13091,0.042543,172.31.36.0-255,66,288887,7,364947
13092,0.044453,172.217.160.0-255,5738,294625,7,364947
13093,0.044458,172.31.36.0-255,66,294691,7,364947
13094,0.046368,172.217.160.0-255,5738,300429,7,364947
13095,0.046374,172.31.36.0-255,66,300495,7,364947
13096,0.0483,172.217.160.0-255,5738,306233,7,364947
13097,0.048306,172.31.36.0-255,66,306299,7,364947
13098,0.05022,172.217.160.0-255,5738,312037,7,364947
13099,0.050225,172.31.36.0-255,66,312103,7,364947
13100,0.052151,172.217.160.0-255,5738,317841,7,364947
13101,0.052158,172.31.36.0-255,66,317907,7,364947
13102,0.054074,172.217.160.0-255,5738,323645,7,364947
13103,0.05408,172.31.36.0-255,66,323711,7,364947
13104,0.055996,172.217.160.0-255,5738,329449,7,364947
13105,0.056003,172.31.36.0-255,66,329515,7,364947
13106,0.057918,172.217.160.0-255,5738,335253,7,364947
13107,0.057926,172.31.36.0-255,66,335319,7,364947
13108,0.059889,172.217.160.0-255,5738,341057,7,364947
13109,0.059901,172.31.36.0-255,66,341123,7,364947
13110,0.061828,172.217.160.0-255,5738,346861,7,364947
13111,0.061835,172.31.36.0-255,66,346927,7,364947
13112,0.063749,172.217.160.0-255,5738,352665,7,364947
13113,0.063755,172.31.36.0-255,66,352731,7,364947
13114,0.065668,172.217.160.0-255,5738,358469,7,364947
13115,0.065678,172.31.36.0-255,66,358535,7,364947
13116,0.067595,172.217.160.0-255,5650,364185,7,364947
13117,0.0676,172.31.36.0-255,66,364251,7,364947
13118,0.067807,172.31.36.0-255,105,364356,7,364947
13119,0.067837,172.31.36.0-255,105,364461,7,364947
13120,0.068059,172.31.36.0-255,90,364551,7,364947
13121,0.06807,172.31.36.0-255,66,364617,7,364947
13122,0.069686,172.217.160.0-255,66,364683,7,364947
13123,0.069701,172.217.160.0-255,66,364749,7,364947
13124,0.069931,172.217.160.0-255,66,364815,7,364947
13125,0.069953,172.217.160.0-255,66,364881,7,364947
13126,0.069958,172.31.36.0-255,66,364947,7,364947
13127,0.0,172.217.160.0-255,146,146,7,342048
13128,1.9e-05,172.31.36.0-255,66,212,7,342048
13129,2.6e-05,172.217.160.0-255,1484,1696,7,342048
13130,2.9e-05,172.31.36.0-255,66,1762,7,342048
13131,3.5e-05,172.217.160.0-255,2902,4664,7,342048
13132,3.9e-05,172.31.36.0-255,66,4730,7,342048
13133,4.7e-05,172.217.160.0-255,7156,11886,7,342048
13134,5e-05,172.31.36.0-255,66,11952,7,342048
13135,5.4e-05,172.217.160.0-255,1985,13937,7,342048
13136,5.7e-05,172.31.36.0-255,66,14003,7,342048
13137,8.8e-05,172.217.160.0-255,2902,16905,7,342048
13138,9.1e-05,172.31.36.0-255,66,16971,7,342048
13139,9.6e-05,172.217.160.0-255,2902,19873,7,342048
13140,9.8e-05,172.31.36.0-255,66,19939,7,342048
13141,0.000123,172.217.160.0-255,7156,27095,7,342048
13142,0.000126,172.31.36.0-255,66,27161,7,342048
13143,0.000177,172.31.36.0-255,66,27227,7,342048
13144,0.000199,172.217.160.0-255,3961,31188,7,342048
13145,0.000201,172.31.36.0-255,66,31254,7,342048
13146,0.000266,172.31.36.0-255,66,31320,7,342048
13147,0.000319,172.217.160.0-255,4320,35640,7,342048
13148,0.000321,172.31.36.0-255,66,35706,7,342048
13149,0.000338,172.217.160.0-255,4320,40026,7,342048
13150,0.000341,172.31.36.0-255,66,40092,7,342048
13151,0.000386,172.217.160.0-255,5738,45830,7,342048
13152,0.000389,172.31.36.0-255,66,45896,7,342048
13153,0.000407,172.217.160.0-255,2813,48709,7,342048
13154,0.000409,172.31.36.0-255,66,48775,7,342048
13155,0.000821,172.217.160.0-255,407,49182,7,342048
13156,0.000826,172.31.36.0-255,66,49248,7,342048
13157,0.000928,172.217.160.0-255,1484,50732,7,342048
13158,0.000933,172.217.160.0-255,1484,52216,7,342048
13159,0.000936,172.31.36.0-255,66,52282,7,342048
13160,0.000953,172.217.160.0-255,1484,53766,7,342048
13161,0.000958,172.217.160.0-255,2902,56668,7,342048
13162,0.000961,172.31.36.0-255,66,56734,7,342048
13163,0.00098,172.217.160.0-255,2902,59636,7,342048
13164,0.000982,172.31.36.0-255,66,59702,7,342048
13165,0.00099,172.217.160.0-255,7156,66858,7,342048
13166,0.000991,172.31.36.0-255,66,66924,7,342048
13167,0.001008,172.217.160.0-255,1125,68049,7,342048
13168,0.001067,172.31.36.0-255,66,68115,7,342048
13169,0.001086,172.217.160.0-255,5379,73494,7,342048
13170,0.001088,172.31.36.0-255,66,73560,7,342048
13171,0.001266,172.217.160.0-255,1484,75044,7,342048
13172,0.001272,172.217.160.0-255,2902,77946,7,342048
13173,0.001275,172.31.36.0-255,66,78012,7,342048
13174,0.00131,172.217.160.0-255,2902,80914,7,342048
13175,0.001313,172.31.36.0-255,66,80980,7,342048
13176,0.001333,172.217.160.0-255,2902,83882,7,342048
13177,0.001349,172.31.36.0-255,66,83948,7,342048
13178,0.001356,172.31.36.0-255,66,84014,7,342048
13179,0.001425,172.217.160.0-255,1484,85498,7,342048
13180,0.001429,172.217.160.0-255,1484,86982,7,342048
13181,0.001432,172.31.36.0-255,66,87048,7,342048
13182,0.001461,172.31.36.0-255,66,87114,7,342048
13183,0.0015,172.217.160.0-255,7156,94270,7,342048
13184,0.001503,172.31.36.0-255,66,94336,7,342048
13185,0.001522,172.217.160.0-255,5738,100074,7,342048
13186,0.001525,172.31.36.0-255,66,100140,7,342048
13187,0.001598,172.217.160.0-255,7156,107296,7,342048
13188,0.001601,172.31.36.0-255,66,107362,7,342048
13189,0.001637,172.31.36.0-255,66,107428,7,342048
13190,0.001744,172.217.160.0-255,5738,113166,7,342048
13191,0.001749,172.31.36.0-255,66,113232,7,342048
13192,0.001803,172.31.36.0-255,101,113333,7,342048
13193,0.0019,172.217.160.0-255,5738,119071,7,342048
13194,0.001905,172.31.36.0-255,66,119137,7,342048
13195,0.001935,172.31.36.0-255,66,119203,7,342048
13196,0.0034,172.217.160.0-255,66,119269,7,342048
13197,0.003556,172.217.160.0-255,5738,125007,7,342048
13198,0.003562,172.31.36.0-255,66,125073,7,342048
13199,0.005182,172.217.160.0-255,5738,130811,7,342048
13200,0.005185,172.31.36.0-255,66,130877,7,342048
13201,0.006798,172.217.160.0-255,5738,136615,7,342048
13202,0.006803,172.31.36.0-255,66,136681,7,342048
13203,0.008436,172.217.160.0-255,5738,142419,7,342048
13204,0.008443,172.31.36.0-255,66,142485,7,342048
13205,0.010102,172.217.160.0-255,5738,148223,7,342048
13206,0.01011,172.31.36.0-255,66,148289,7,342048
13207,0.011746,172.217.160.0-255,5738,154027,7,342048
13208,0.011754,172.31.36.0-255,66,154093,7,342048
13209,0.013377,172.217.160.0-255,5738,159831,7,342048
13210,0.013383,172.31.36.0-255,66,159897,7,342048
13211,0.015009,172.217.160.0-255,5738,165635,7,342048
13212,0.015019,172.31.36.0-255,66,165701,7,342048
13213,0.016647,172.217.160.0-255,5738,171439,7,342048
13214,0.016656,172.31.36.0-255,66,171505,7,342048
13215,0.018282,172.217.160.0-255,5738,177243,7,342048
13216,0.018288,172.31.36.0-255,66,177309,7,342048
13217,0.019911,172.217.160.0-255,5738,183047,7,342048
13218,0.019918,172.31.36.0-255,66,183113,7,342048
13219,0.021548,172.217.160.0-255,4320,187433,7,342048
13220,0.021556,172.31.36.0-255,66,187499,7,342048
13221,0.021575,172.217.160.0-255,1484,188983,7,342048
13222,0.023179,172.217.160.0-255,4320,193303,7,342048
13223,0.023189,172.31.36.0-255,66,193369,7,342048
13224,0.024822,172.217.160.0-255,5738,199107,7,342048
13225,0.024828,172.31.36.0-255,66,199173,7,342048
13226,0.026464,172.217.160.0-255,5738,204911,7,342048
13227,0.02647,172.31.36.0-255,66,204977,7,342048
13228,0.028093,172.217.160.0-255,5738,210715,7,342048
13229,0.0281,172.31.36.0-255,66,210781,7,342048
13230,0.029458,172.31.36.0-255,172,210953,7,342048
13231,0.029489,172.31.36.0-255,1114,212067,7,342048
13232,0.029549,172.31.36.0-255,1514,213581,7,342048
13233,0.029551,172.31.36.0-255,1292,214873,7,342048
13234,0.029727,172.217.160.0-255,5738,220611,7,342048
13235,0.029733,172.31.36.0-255,66,220677,7,342048
13236,0.031056,104.244.42.0-255,66,220743,7,342048
13237,0.031094,104.244.42.0-255,66,220809,7,342048
13238,0.031117,104.244.42.0-255,66,220875,7,342048
13239,0.03135,172.217.160.0-255,5738,226613,7,342048
13240,0.031356,172.31.36.0-255,66,226679,7,342048
13241,0.032978,172.217.160.0-255,5738,232417,7,342048
13242,0.032985,172.31.36.0-255,66,232483,7,342048
13243,0.03461,172.217.160.0-255,5738,238221,7,342048
13244,0.034617,172.31.36.0-255,66,238287,7,342048
13245,0.036238,172.217.160.0-255,5738,244025,7,342048
13246,0.036244,172.31.36.0-255,66,244091,7,342048
13247,0.037874,172.217.160.0-255,5738,249829,7,342048
13248,0.03788,172.31.36.0-255,66,249895,7,342048
13249,0.039522,172.217.160.0-255,5738,255633,7,342048
13250,0.039529,172.31.36.0-255,66,255699,7,342048
13251,0.041148,172.217.160.0-255,5738,261437,7,342048
13252,0.041154,172.31.36.0-255,66,261503,7,342048
13253,0.042777,172.217.160.0-255,5738,267241,7,342048
13254,0.042784,172.31.36.0-255,66,267307,7,342048
13255,0.044413,172.217.160.0-255,5738,273045,7,342048
13256,0.044418,172.31.36.0-255,66,273111,7,342048
13257,0.046054,172.217.160.0-255,5738,278849,7,342048
13258,0.046061,172.31.36.0-255,66,278915,7,342048
13259,0.047687,172.217.160.0-255,5738,284653,7,342048
13260,0.047693,172.31.36.0-255,66,284719,7,342048
13261,0.049326,172.217.160.0-255,5738,290457,7,342048
13262,0.049332,172.31.36.0-255,66,290523,7,342048
13263,0.050953,172.217.160.0-255,5738,296261,7,342048
13264,0.050959,172.31.36.0-255,66,296327,7,342048
13265,0.052584,172.217.160.0-255,5738,302065,7,342048
13266,0.05259,172.31.36.0-255,66,302131,7,342048
13267,0.054214,172.217.160.0-255,5738,307869,7,342048
13268,0.05422,172.31.36.0-255,66,307935,7,342048
13269,0.055844,172.217.160.0-255,5738,313673,7,342048
13270,0.05585,172.31.36.0-255,66,313739,7,342048
13271,0.057477,172.217.160.0-255,5738,319477,7,342048
13272,0.057484,172.31.36.0-255,66,319543,7,342048
13273,0.059115,172.217.160.0-255,5738,325281,7,342048
13274,0.059123,172.31.36.0-255,66,325347,7,342048
13275,0.060771,172.217.160.0-255,5738,331085,7,342048
13276,0.060777,172.31.36.0-255,66,331151,7,342048
13277,0.062435,172.217.160.0-255,5738,336889,7,342048
13278,0.062443,172.31.36.0-255,66,336955,7,342048
13279,0.064076,172.217.160.0-255,4856,341811,7,342048
13280,0.064083,172.31.36.0-255,66,341877,7,342048
13281,0.064261,172.31.36.0-255,105,341982,7,342048
13282,0.0695,172.217.160.0-255,66,342048,7,342048
13283,0.0,74.125.24.0-255,154,154,7,188947
13284,3.1e-05,172.31.36.0-255,66,220,7,188947
13285,3.8e-05,74.125.24.0-255,1484,1704,7,188947
13286,4.3e-05,172.31.36.0-255,66,1770,7,188947
13287,4.8e-05,74.125.24.0-255,2902,4672,7,188947
13288,5e-05,172.31.36.0-255,66,4738,7,188947
13289,6.8e-05,74.125.24.0-255,7156,11894,7,188947
13290,7.1e-05,172.31.36.0-255,66,11960,7,188947
13291,7.5e-05,74.125.24.0-255,2020,13980,7,188947
13292,7.7e-05,172.31.36.0-255,66,14046,7,188947
13293,9.1e-05,172.31.36.0-255,66,14112,7,188947
13294,9.4e-05,74.125.24.0-255,1484,15596,7,188947
13295,9.6e-05,172.31.36.0-255,66,15662,7,188947
13296,0.000122,74.125.24.0-255,3961,19623,7,188947
13297,0.000125,172.31.36.0-255,66,19689,7,188947
13298,0.000287,74.125.24.0-255,1484,21173,7,188947
13299,0.000292,172.31.36.0-255,66,21239,7,188947
13300,0.000298,74.125.24.0-255,2902,24141,7,188947
13301,0.000301,172.31.36.0-255,66,24207,7,188947
13302,0.000327,74.125.24.0-255,5738,29945,7,188947
13303,0.000331,172.31.36.0-255,66,30011,7,188947
13304,0.000351,74.125.24.0-255,7156,37167,7,188947
13305,0.000355,172.31.36.0-255,66,37233,7,188947
13306,0.000386,74.125.24.0-255,5738,42971,7,188947
13307,0.00039,172.31.36.0-255,66,43037,7,188947
13308,0.000397,74.125.24.0-255,7156,50193,7,188947
13309,0.000399,172.31.36.0-255,66,50259,7,188947
13310,0.000404,74.125.24.0-255,3602,53861,7,188947
13311,0.000406,172.31.36.0-255,66,53927,7,188947
13312,0.000436,74.125.24.0-255,399,54326,7,188947
13313,0.000439,172.31.36.0-255,66,54392,7,188947
13314,0.000479,74.125.24.0-255,111,54503,7,188947
13315,0.000666,74.125.24.0-255,1484,55987,7,188947
13316,0.00067,172.31.36.0-255,66,56053,7,188947
13317,0.000675,74.125.24.0-255,2902,58955,7,188947
13318,0.000677,172.31.36.0-255,66,59021,7,188947
13319,0.000683,74.125.24.0-255,4320,63341,7,188947
13320,0.000692,172.31.36.0-255,66,63407,7,188947
13321,0.000714,74.125.24.0-255,1484,64891,7,188947
13322,0.000726,172.31.36.0-255,66,64957,7,188947
13323,0.000756,74.125.24.0-255,2902,67859,7,188947
13324,0.000759,172.31.36.0-255,66,67925,7,188947
13325,0.000797,172.31.36.0-255,66,67991,7,188947
13326,0.001292,74.125.24.0-255,1484,69475,7,188947
13327,0.001303,74.125.24.0-255,2902,72377,7,188947
13328,0.001307,172.31.36.0-255,66,72443,7,188947
13329,0.001311,74.125.24.0-255,1484,73927,7,188947
13330,0.001315,74.125.24.0-255,2902,76829,7,188947
13331,0.001317,172.31.36.0-255,66,76895,7,188947
13332,0.00132,74.125.24.0-255,1484,78379,7,188947
13333,0.001353,74.125.24.0-255,4320,82699,7,188947
13334,0.001356,172.31.36.0-255,66,82765,7,188947
13335,0.001386,74.125.24.0-255,5738,88503,7,188947
13336,0.001389,172.31.36.0-255,66,88569,7,188947
13337,0.001421,74.125.24.0-255,7156,95725,7,188947
13338,0.001425,172.31.36.0-255,66,95791,7,188947
13339,0.001431,74.125.24.0-255,5738,101529,7,188947
13340,0.001433,172.31.36.0-255,66,101595,7,188947
13341,0.001435,74.125.24.0-255,766,102361,7,188947
13342,0.001592,74.125.24.0-255,1484,103845,7,188947
13343,0.001597,172.31.36.0-255,66,103911,7,188947
13344,0.001602,74.125.24.0-255,2902,106813,7,188947
13345,0.001604,172.31.36.0-255,66,106879,7,188947
13346,0.001608,74.125.24.0-255,2902,109781,7,188947
13347,0.00161,172.31.36.0-255,66,109847,7,188947
13348,0.001641,74.125.24.0-255,2902,112749,7,188947
13349,0.001645,172.31.36.0-255,66,112815,7,188947
13350,0.001656,172.31.36.0-255,66,112881,7,188947
13351,0.001683,172.31.36.0-255,66,112947,7,188947
13352,0.001722,74.125.24.0-255,5020,117967,7,188947
13353,0.001728,172.31.36.0-255,66,118033,7,188947
13354,0.001741,172.31.36.0-255,66,118099,7,188947
13355,0.00175,172.31.36.0-255,66,118165,7,188947
13356,0.001785,74.125.24.0-255,6438,124603,7,188947
13357,0.001791,172.31.36.0-255,66,124669,7,188947
13358,0.001795,74.125.24.0-255,2902,127571,7,188947
13359,0.001797,172.31.36.0-255,66,127637,7,188947
13360,0.001801,74.125.24.0-255,4320,131957,7,188947
13361,0.001802,172.31.36.0-255,66,132023,7,188947
13362,0.001811,172.31.36.0-255,66,132089,7,188947
13363,0.001838,74.125.24.0-255,5738,137827,7,188947
13364,0.001841,172.31.36.0-255,66,137893,7,188947
13365,0.001871,74.125.24.0-255,4320,142213,7,188947
13366,0.001873,172.31.36.0-255,66,142279,7,188947
13367,0.001905,172.31.36.0-255,66,142345,7,188947
13368,0.00193,74.125.24.0-255,5738,148083,7,188947
13369,0.001932,172.31.36.0-255,66,148149,7,188947
13370,0.001937,74.125.24.0-255,5738,153887,7,188947
13371,0.001939,172.31.36.0-255,66,153953,7,188947
13372,0.001963,74.125.24.0-255,1484,155437,7,188947
13373,0.001968,74.125.24.0-255,2902,158339,7,188947
13374,0.00197,172.31.36.0-255,66,158405,7,188947
13375,0.002012,172.31.36.0-255,66,158471,7,188947
13376,0.002041,172.31.36.0-255,66,158537,7,188947
13377,0.002068,74.125.24.0-255,6438,164975,7,188947
13378,0.002071,172.31.36.0-255,66,165041,7,188947
13379,0.002083,172.31.36.0-255,66,165107,7,188947
13380,0.002107,74.125.24.0-255,1484,166591,7,188947
13381,0.002112,74.125.24.0-255,4320,170911,7,188947
13382,0.002115,172.31.36.0-255,66,170977,7,188947
13383,0.002189,172.31.36.0-255,66,171043,7,188947
13384,0.002221,74.125.24.0-255,6438,177481,7,188947
13385,0.002225,172.31.36.0-255,66,177547,7,188947
13386,0.002247,172.31.36.0-255,66,177613,7,188947
13387,0.002259,172.31.36.0-255,66,177679,7,188947
13388,0.0023,172.31.36.0-255,66,177745,7,188947
13389,0.002307,74.125.24.0-255,6438,184183,7,188947
13390,0.002309,172.31.36.0-255,66,184249,7,188947
13391,0.002367,172.31.36.0-255,66,184315,7,188947
13392,0.00237,74.125.24.0-255,105,184420,7,188947
13393,0.00421,172.31.36.0-255,66,184486,7,188947
13394,0.004246,172.31.36.0-255,105,184591,7,188947
13395,0.006828,74.125.24.0-255,66,184657,7,188947
13396,0.030689,172.31.36.0-255,172,184829,7,188947
13397,0.030743,172.31.36.0-255,1115,185944,7,188947
13398,0.030822,172.31.36.0-255,1514,187458,7,188947
13399,0.030824,172.31.36.0-255,1291,188749,7,188947
13400,0.032204,104.244.42.0-255,66,188815,7,188947
13401,0.032333,104.244.42.0-255,66,188881,7,188947
13402,0.032386,104.244.42.0-255,66,188947,7,188947
13403,0.0,172.217.194.0-255,153,153,7,301571
13404,2.3e-05,172.31.36.0-255,66,219,7,301571
13405,3.1e-05,172.217.194.0-255,1484,1703,7,301571
13406,3.5e-05,172.31.36.0-255,66,1769,7,301571
13407,4.1e-05,172.217.194.0-255,2902,4671,7,301571
13408,4.4e-05,172.31.36.0-255,66,4737,7,301571
13409,5.2e-05,172.217.194.0-255,7156,11893,7,301571
13410,5.5e-05,172.31.36.0-255,66,11959,7,301571
13411,5.9e-05,172.217.194.0-255,2019,13978,7,301571
13412,6.1e-05,172.31.36.0-255,66,14044,7,301571
13413,6.6e-05,172.217.194.0-255,1484,15528,7,301571
13414,6.8e-05,172.31.36.0-255,66,15594,7,301571
13415,9.1e-05,172.217.194.0-255,1484,17078,7,301571
13416,9.5e-05,172.31.36.0-255,66,17144,7,301571
13417,0.000102,172.217.194.0-255,7156,24300,7,301571
13418,0.000104,172.31.36.0-255,66,24366,7,301571
13419,0.000116,172.31.36.0-255,66,24432,7,301571
13420,0.000172,172.217.194.0-255,4320,28752,7,301571
13421,0.000175,172.31.36.0-255,66,28818,7,301571
13422,0.000208,172.31.36.0-255,66,28884,7,301571
13423,0.000344,172.217.194.0-255,1484,30368,7,301571
13424,0.000349,172.31.36.0-255,66,30434,7,301571
13425,0.000353,172.217.194.0-255,1484,31918,7,301571
13426,0.000356,172.31.36.0-255,66,31984,7,301571
13427,0.000369,172.217.194.0-255,1484,33468,7,301571
13428,0.000371,172.31.36.0-255,66,33534,7,301571
13429,0.000374,172.217.194.0-255,1484,35018,7,301571
13430,0.000376,172.31.36.0-255,66,35084,7,301571
13431,0.000396,172.217.194.0-255,4320,39404,7,301571
13432,0.000398,172.31.36.0-255,66,39470,7,301571
13433,0.000422,172.217.194.0-255,2902,42372,7,301571
13434,0.000424,172.31.36.0-255,66,42438,7,301571
13435,0.000438,172.217.194.0-255,4550,46988,7,301571
13436,0.000441,172.31.36.0-255,66,47054,7,301571
13437,0.001103,172.217.194.0-255,1484,48538,7,301571
13438,0.001114,172.217.194.0-255,2902,51440,7,301571
13439,0.001117,172.31.36.0-255,66,51506,7,301571
13440,0.001123,172.217.194.0-255,2902,54408,7,301571
13441,0.001125,172.31.36.0-255,66,54474,7,301571
13442,0.001131,172.217.194.0-255,4320,58794,7,301571
13443,0.001133,172.31.36.0-255,66,58860,7,301571
13444,0.001162,172.217.194.0-255,1484,60344,7,301571
13445,0.001184,172.217.194.0-255,7156,67500,7,301571
13446,0.001187,172.31.36.0-255,66,67566,7,301571
13447,0.001198,172.31.36.0-255,66,67632,7,301571
13448,0.001219,172.217.194.0-255,1484,69116,7,301571
13449,0.001243,172.217.194.0-255,3602,72718,7,301571
13450,0.001246,172.31.36.0-255,66,72784,7,301571
13451,0.001638,172.217.194.0-255,1484,74268,7,301571
13452,0.001647,172.217.194.0-255,2902,77170,7,301571
13453,0.001652,172.31.36.0-255,66,77236,7,301571
13454,0.001659,172.217.194.0-255,5738,82974,7,301571
13455,0.001661,172.31.36.0-255,66,83040,7,301571
13456,0.001668,172.217.194.0-255,7156,90196,7,301571
13457,0.00167,172.31.36.0-255,66,90262,7,301571
13458,0.001694,172.217.194.0-255,5738,96000,7,301571
13459,0.001696,172.31.36.0-255,66,96066,7,301571
13460,0.001709,172.31.36.0-255,66,96132,7,301571
13461,0.001738,172.217.194.0-255,2902,99034,7,301571
13462,0.001741,172.31.36.0-255,66,99100,7,301571
13463,0.001789,172.31.36.0-255,66,99166,7,301571
13464,0.001793,172.217.194.0-255,2902,102068,7,301571
13465,0.001795,172.31.36.0-255,66,102134,7,301571
13466,0.001823,172.31.36.0-255,66,102200,7,301571
13467,0.004154,172.217.194.0-255,5738,107938,7,301571
13468,0.004159,172.31.36.0-255,66,108004,7,301571
13469,0.006473,172.217.194.0-255,5738,113742,7,301571
13470,0.006479,172.31.36.0-255,66,113808,7,301571
13471,0.008816,172.217.194.0-255,5738,119546,7,301571
13472,0.008824,172.31.36.0-255,66,119612,7,301571
13473,0.01117,172.217.194.0-255,5738,125350,7,301571
13474,0.011178,172.31.36.0-255,66,125416,7,301571
13475,0.013521,172.217.194.0-255,5738,131154,7,301571
13476,0.01353,172.31.36.0-255,66,131220,7,301571
13477,0.015881,172.217.194.0-255,5738,136958,7,301571
13478,0.015892,172.31.36.0-255,66,137024,7,301571
13479,0.01824,172.217.194.0-255,5738,142762,7,301571
13480,0.018246,172.31.36.0-255,66,142828,7,301571
13481,0.020577,172.217.194.0-255,5738,148566,7,301571
13482,0.020585,172.31.36.0-255,66,148632,7,301571
13483,0.022975,172.217.194.0-255,5738,154370,7,301571
13484,0.022983,172.31.36.0-255,66,154436,7,301571
13485,0.025314,172.217.194.0-255,5738,160174,7,301571
13486,0.025321,172.31.36.0-255,66,160240,7,301571
13487,0.02767,172.217.194.0-255,5738,165978,7,301571
13488,0.027679,172.31.36.0-255,66,166044,7,301571
13489,0.03,172.217.194.0-255,5738,171782,7,301571
13490,0.030008,172.31.36.0-255,66,171848,7,301571
13491,0.032345,172.217.194.0-255,5738,177586,7,301571
13492,0.032352,172.31.36.0-255,66,177652,7,301571
13493,0.034698,172.217.194.0-255,5738,183390,7,301571
13494,0.034707,172.31.36.0-255,66,183456,7,301571
13495,0.037059,172.217.194.0-255,5738,189194,7,301571
13496,0.037067,172.31.36.0-255,66,189260,7,301571
13497,0.039423,172.217.194.0-255,5738,194998,7,301571
13498,0.039434,172.31.36.0-255,66,195064,7,301571
13499,0.041771,172.217.194.0-255,5738,200802,7,301571
13500,0.041785,172.31.36.0-255,66,200868,7,301571
13501,0.044107,172.217.194.0-255,5738,206606,7,301571
13502,0.044116,172.31.36.0-255,66,206672,7,301571
13503,0.046454,172.217.194.0-255,4320,210992,7,301571
13504,0.046462,172.31.36.0-255,66,211058,7,301571
13505,0.046483,172.217.194.0-255,1484,212542,7,301571
13506,0.048804,172.217.194.0-255,4320,216862,7,301571
13507,0.048811,172.31.36.0-255,66,216928,7,301571
13508,0.051168,172.217.194.0-255,5738,222666,7,301571
13509,0.051175,172.31.36.0-255,66,222732,7,301571
13510,0.053517,172.217.194.0-255,5738,228470,7,301571
13511,0.053525,172.31.36.0-255,66,228536,7,301571
13512,0.0559,172.217.194.0-255,5738,234274,7,301571
13513,0.055908,172.31.36.0-255,66,234340,7,301571
13514,0.058233,172.217.194.0-255,5738,240078,7,301571
13515,0.058245,172.31.36.0-255,66,240144,7,301571
13516,0.060589,172.217.194.0-255,5738,245882,7,301571
13517,0.0606,172.31.36.0-255,66,245948,7,301571
13518,0.062508,172.31.36.0-255,172,246120,7,301571
13519,0.062539,172.31.36.0-255,1115,247235,7,301571
13520,0.062601,172.31.36.0-255,1514,248749,7,301571
13521,0.062602,172.31.36.0-255,1514,250263,7,301571
13522,0.062603,172.31.36.0-255,1514,251777,7,301571
13523,0.062608,172.31.36.0-255,1514,253291,7,301571
13524,0.062609,172.31.36.0-255,1514,254805,7,301571
13525,0.06261,172.31.36.0-255,70,254875,7,301571
13526,0.062909,172.217.194.0-255,5738,260613,7,301571
13527,0.062916,172.31.36.0-255,66,260679,7,301571
13528,0.064059,104.244.42.0-255,66,260745,7,301571
13529,0.064106,104.244.42.0-255,66,260811,7,301571
13530,0.064151,104.244.42.0-255,66,260877,7,301571
13531,0.064155,104.244.42.0-255,66,260943,7,301571
13532,0.065244,172.217.194.0-255,5738,266681,7,301571
13533,0.065249,172.31.36.0-255,66,266747,7,301571
13534,0.067586,172.217.194.0-255,5738,272485,7,301571
13535,0.067592,172.31.36.0-255,66,272551,7,301571
13536,0.069939,172.217.194.0-255,5738,278289,7,301571
13537,0.069946,172.31.36.0-255,66,278355,7,301571
13538,0.072289,172.217.194.0-255,5738,284093,7,301571
13539,0.072298,172.31.36.0-255,66,284159,7,301571
13540,0.074629,172.217.194.0-255,5738,289897,7,301571
13541,0.074636,172.31.36.0-255,66,289963,7,301571
13542,0.076966,172.217.194.0-255,5738,295701,7,301571
13543,0.076973,172.31.36.0-255,66,295767,7,301571
13544,0.079325,172.217.194.0-255,5738,301505,7,301571
13545,0.079332,172.31.36.0-255,66,301571,7,301571
13546,0.0,172.217.194.0-255,143,143,7,232520
13547,2.2e-05,172.31.36.0-255,66,209,7,232520
13548,2.9e-05,172.217.194.0-255,1484,1693,7,232520
13549,3.4e-05,172.31.36.0-255,66,1759,7,232520
13550,4.7e-05,172.217.194.0-255,2902,4661,7,232520
13551,5e-05,172.31.36.0-255,66,4727,7,232520
13552,5.7e-05,172.217.194.0-255,7156,11883,7,232520
13553,6e-05,172.31.36.0-255,66,11949,7,232520
13554,6.7e-05,172.217.194.0-255,6249,18198,7,232520
13555,7e-05,172.31.36.0-255,66,18264,7,232520
13556,0.000124,172.31.36.0-255,66,18330,7,232520
13557,0.000142,172.31.36.0-255,66,18396,7,232520
13558,0.000147,172.217.194.0-255,3961,22357,7,232520
13559,0.000149,172.31.36.0-255,66,22423,7,232520
13560,0.000199,172.217.194.0-255,5738,28161,7,232520
13561,0.000202,172.31.36.0-255,66,28227,7,232520
13562,0.000239,172.31.36.0-255,66,28293,7,232520
13563,0.000734,172.217.194.0-255,368,28661,7,232520
13564,0.000739,172.31.36.0-255,66,28727,7,232520
13565,0.001043,172.217.194.0-255,1484,30211,7,232520
13566,0.001047,172.31.36.0-255,66,30277,7,232520
13567,0.001055,172.217.194.0-255,2902,33179,7,232520
13568,0.001057,172.31.36.0-255,66,33245,7,232520
13569,0.001066,172.217.194.0-255,2902,36147,7,232520
13570,0.001068,172.31.36.0-255,66,36213,7,232520
13571,0.001102,172.217.194.0-255,2902,39115,7,232520
13572,0.001105,172.31.36.0-255,66,39181,7,232520
13573,0.001118,172.31.36.0-255,66,39247,7,232520
13574,0.001129,172.31.36.0-255,66,39313,7,232520
13575,0.001246,172.217.194.0-255,1484,40797,7,232520
13576,0.001253,172.217.194.0-255,2902,43699,7,232520
13577,0.001256,172.31.36.0-255,66,43765,7,232520
13578,0.001263,172.217.194.0-255,5738,49503,7,232520
13579,0.001265,172.31.36.0-255,66,49569,7,232520
13580,0.001294,172.217.194.0-255,5738,55307,7,232520
13581,0.001297,172.31.36.0-255,66,55373,7,232520
13582,0.001327,172.217.194.0-255,7156,62529,7,232520
13583,0.001329,172.31.36.0-255,66,62595,7,232520
13584,0.001339,172.31.36.0-255,66,62661,7,232520
13585,0.001346,172.217.194.0-255,766,63427,7,232520
13586,0.001517,172.217.194.0-255,1484,64911,7,232520
13587,0.001522,172.31.36.0-255,66,64977,7,232520
13588,0.001527,172.217.194.0-255,2902,67879,7,232520
13589,0.00153,172.31.36.0-255,66,67945,7,232520
13590,0.001539,172.217.194.0-255,5738,73683,7,232520
13591,0.001541,172.31.36.0-255,66,73749,7,232520
13592,0.001572,172.31.36.0-255,66,73815,7,232520
13593,0.001593,172.217.194.0-255,4320,78135,7,232520
13594,0.001596,172.31.36.0-255,66,78201,7,232520
13595,0.0016,172.217.194.0-255,2902,81103,7,232520
13596,0.001602,172.31.36.0-255,66,81169,7,232520
13597,0.001639,172.31.36.0-255,66,81235,7,232520
13598,0.001696,172.217.194.0-255,1484,82719,7,232520
13599,0.001701,172.217.194.0-255,2902,85621,7,232520
13600,0.001704,172.31.36.0-255,66,85687,7,232520
13601,0.00171,172.217.194.0-255,5738,91425,7,232520
13602,0.001713,172.31.36.0-255,66,91491,7,232520
13603,0.001737,172.217.194.0-255,5738,97229,7,232520
13604,0.001739,172.31.36.0-255,66,97295,7,232520
13605,0.001767,172.217.194.0-255,7156,104451,7,232520
13606,0.00177,172.31.36.0-255,66,104517,7,232520
13607,0.001785,172.31.36.0-255,66,104583,7,232520
13608,0.001924,172.217.194.0-255,1484,106067,7,232520
13609,0.00194,172.217.194.0-255,2902,108969,7,232520
13610,0.001944,172.31.36.0-255,66,109035,7,232520
13611,0.001968,172.217.194.0-255,4320,113355,7,232520
13612,0.001971,172.31.36.0-255,66,113421,7,232520
13613,0.001992,172.217.194.0-255,1484,114905,7,232520
13614,0.001999,172.217.194.0-255,7156,122061,7,232520
13615,0.002003,172.217.194.0-255,2902,124963,7,232520
13616,0.002033,172.217.194.0-255,5738,130701,7,232520
13617,0.00204,172.217.194.0-255,5738,136439,7,232520
13618,0.002071,172.217.194.0-255,2184,138623,7,232520
13619,0.002179,172.217.194.0-255,1484,140107,7,232520
13620,0.002198,172.217.194.0-255,2902,143009,7,232520
13621,0.002204,172.217.194.0-255,4320,147329,7,232520
13622,0.002216,172.217.194.0-255,1484,148813,7,232520
13623,0.002219,172.217.194.0-255,1484,150297,7,232520
13624,0.002293,172.217.194.0-255,2184,152481,7,232520
13625,0.002341,172.217.194.0-255,1484,153965,7,232520
13626,0.002344,172.217.194.0-255,1484,155449,7,232520
13627,0.002363,172.217.194.0-255,1484,156933,7,232520
13628,0.00237,172.217.194.0-255,5738,162671,7,232520
13629,0.002383,172.217.194.0-255,4320,166991,7,232520
13630,0.002413,172.217.194.0-255,2902,169893,7,232520
13631,0.002431,172.217.194.0-255,5738,175631,7,232520
13632,0.002456,172.217.194.0-255,2902,178533,7,232520
13633,0.002472,172.217.194.0-255,7156,185689,7,232520
13634,0.002497,172.217.194.0-255,5738,191427,7,232520
13635,0.002549,172.217.194.0-255,1484,192911,7,232520
13636,0.002598,172.217.194.0-255,3602,196513,7,232520
13637,0.004902,172.31.36.0-255,66,196579,7,232520
13638,0.007458,172.217.194.0-255,5738,202317,7,232520
13639,0.007465,172.31.36.0-255,66,202383,7,232520
13640,0.009963,172.217.194.0-255,5738,208121,7,232520
13641,0.00997,172.31.36.0-255,66,208187,7,232520
13642,0.012468,172.217.194.0-255,5738,213925,7,232520
13643,0.012476,172.31.36.0-255,66,213991,7,232520
13644,0.014988,172.217.194.0-255,5738,219729,7,232520
13645,0.014997,172.31.36.0-255,66,219795,7,232520
13646,0.017527,172.217.194.0-255,5738,225533,7,232520
13647,0.017535,172.31.36.0-255,66,225599,7,232520
13648,0.020057,172.217.194.0-255,5738,231337,7,232520
13649,0.020066,172.31.36.0-255,66,231403,7,232520
13650,0.022562,172.217.194.0-255,880,232283,7,232520
13651,0.02291,172.31.36.0-255,66,232349,7,232520
13652,0.022958,172.31.36.0-255,105,232454,7,232520
13653,0.025413,172.217.194.0-255,66,232520,7,232520
13654,0.0,172.31.36.0-255,105,105,7,276
13655,0.073824,31.13.82.0-255,105,210,7,276
13656,0.073849,172.31.36.0-255,66,276,7,276
13657,0.0,172.217.194.0-255,153,153,7,340996
13658,2.3e-05,172.31.36.0-255,66,219,7,340996
13659,3.1e-05,172.217.194.0-255,1484,1703,7,340996
13660,3.6e-05,172.31.36.0-255,66,1769,7,340996
13661,4.2e-05,172.217.194.0-255,2902,4671,7,340996
13662,5.3e-05,172.31.36.0-255,66,4737,7,340996
13663,6.2e-05,172.217.194.0-255,7156,11893,7,340996
13664,6.5e-05,172.31.36.0-255,66,11959,7,340996
13665,7.9e-05,172.31.36.0-255,66,12025,7,340996
13666,0.000105,172.217.194.0-255,4320,16345,7,340996
13667,0.000112,172.31.36.0-255,66,16411,7,340996
13668,0.00014,172.217.194.0-255,3961,20372,7,340996
13669,0.000144,172.31.36.0-255,66,20438,7,340996
13670,0.000147,172.217.194.0-255,1484,21922,7,340996
13671,0.000149,172.31.36.0-255,66,21988,7,340996
13672,0.000154,172.217.194.0-255,2902,24890,7,340996
13673,0.000157,172.31.36.0-255,66,24956,7,340996
13674,0.00016,172.217.194.0-255,1484,26440,7,340996
13675,0.000163,172.31.36.0-255,66,26506,7,340996
13676,0.000195,172.217.194.0-255,4320,30826,7,340996
13677,0.000198,172.31.36.0-255,66,30892,7,340996
13678,0.000206,172.217.194.0-255,6797,37689,7,340996
13679,0.000208,172.31.36.0-255,66,37755,7,340996
13680,0.000908,172.217.194.0-255,1484,39239,7,340996
13681,0.000914,172.31.36.0-255,66,39305,7,340996
13682,0.000921,172.217.194.0-255,2902,42207,7,340996
13683,0.000923,172.31.36.0-255,66,42273,7,340996
13684,0.000935,172.217.194.0-255,5738,48011,7,340996
13685,0.000938,172.31.36.0-255,66,48077,7,340996
13686,0.000974,172.217.194.0-255,6797,54874,7,340996
13687,0.000977,172.31.36.0-255,66,54940,7,340996
13688,0.001002,172.217.194.0-255,1484,56424,7,340996
13689,0.001024,172.217.194.0-255,5738,62162,7,340996
13690,0.001026,172.31.36.0-255,66,62228,7,340996
13691,0.00103,172.217.194.0-255,1484,63712,7,340996
13692,0.001066,172.31.36.0-255,66,63778,7,340996
13693,0.001074,172.217.194.0-255,7156,70934,7,340996
13694,0.001076,172.31.36.0-255,66,71000,7,340996
13695,0.001132,172.31.36.0-255,66,71066,7,340996
13696,0.001284,172.217.194.0-255,1484,72550,7,340996
13697,0.001289,172.217.194.0-255,1484,74034,7,340996
13698,0.001293,172.31.36.0-255,66,74100,7,340996
13699,0.001317,172.217.194.0-255,1484,75584,7,340996
13700,0.001325,172.217.194.0-255,5738,81322,7,340996
13701,0.001328,172.31.36.0-255,66,81388,7,340996
13702,0.001339,172.31.36.0-255,66,81454,7,340996
13703,0.001385,172.217.194.0-255,5020,86474,7,340996
13704,0.001402,172.31.36.0-255,66,86540,7,340996
13705,0.001612,172.217.194.0-255,1484,88024,7,340996
13706,0.001627,172.217.194.0-255,2902,90926,7,340996
13707,0.001631,172.31.36.0-255,66,90992,7,340996
13708,0.001637,172.217.194.0-255,2902,93894,7,340996
13709,0.001639,172.31.36.0-255,66,93960,7,340996
13710,0.00166,172.217.194.0-255,2902,96862,7,340996
13711,0.001667,172.31.36.0-255,66,96928,7,340996
13712,0.001673,172.217.194.0-255,4320,101248,7,340996
13713,0.001675,172.31.36.0-255,66,101314,7,340996
13714,0.001732,172.217.194.0-255,2184,103498,7,340996
13715,0.001738,172.31.36.0-255,66,103564,7,340996
13716,0.001746,172.31.36.0-255,66,103630,7,340996
13717,0.001756,172.217.194.0-255,2902,106532,7,340996
13718,0.001762,172.31.36.0-255,66,106598,7,340996
13719,0.00179,172.217.194.0-255,7156,113754,7,340996
13720,0.001823,172.31.36.0-255,66,113820,7,340996
13721,0.001832,172.217.194.0-255,2902,116722,7,340996
13722,0.001841,172.31.36.0-255,66,116788,7,340996
13723,0.001895,172.31.36.0-255,66,116854,7,340996
13724,0.001948,172.217.194.0-255,1484,118338,7,340996
13725,0.001952,172.217.194.0-255,1484,119822,7,340996
13726,0.001964,172.217.194.0-255,1484,121306,7,340996
13727,0.001969,172.217.194.0-255,2902,124208,7,340996
13728,0.001973,172.31.36.0-255,66,124274,7,340996
13729,0.001987,172.217.194.0-255,2902,127176,7,340996
13730,0.001997,172.217.194.0-255,5738,132914,7,340996
13731,0.001999,172.217.194.0-255,1484,134398,7,340996
13732,0.002003,172.31.36.0-255,66,134464,7,340996
13733,0.002015,172.217.194.0-255,5738,140202,7,340996
13734,0.002033,172.217.194.0-255,5738,145940,7,340996
13735,0.002039,172.217.194.0-255,5020,150960,7,340996
13736,0.002061,172.31.36.0-255,66,151026,7,340996
13737,0.004063,172.217.194.0-255,5738,156764,7,340996
13738,0.00407,172.31.36.0-255,66,156830,7,340996
13739,0.006139,172.217.194.0-255,5738,162568,7,340996
13740,0.006147,172.31.36.0-255,66,162634,7,340996
13741,0.008177,172.217.194.0-255,5738,168372,7,340996
13742,0.008185,172.31.36.0-255,66,168438,7,340996
13743,0.010208,172.217.194.0-255,5738,174176,7,340996
13744,0.010216,172.31.36.0-255,66,174242,7,340996
13745,0.012222,172.217.194.0-255,5738,179980,7,340996
13746,0.01223,172.31.36.0-255,66,180046,7,340996
13747,0.014302,172.217.194.0-255,5738,185784,7,340996
13748,0.01431,172.31.36.0-255,66,185850,7,340996
13749,0.016363,172.217.194.0-255,5738,191588,7,340996
13750,0.016373,172.31.36.0-255,66,191654,7,340996
13751,0.018389,172.217.194.0-255,5738,197392,7,340996
13752,0.0184,172.31.36.0-255,66,197458,7,340996
13753,0.020422,172.217.194.0-255,5738,203196,7,340996
13754,0.020432,172.31.36.0-255,66,203262,7,340996
13755,0.022486,172.217.194.0-255,5738,209000,7,340996
13756,0.022494,172.31.36.0-255,66,209066,7,340996
13757,0.024517,172.217.194.0-255,5738,214804,7,340996
13758,0.024523,172.31.36.0-255,66,214870,7,340996
13759,0.026546,172.217.194.0-255,2902,217772,7,340996
13760,0.026553,172.31.36.0-255,66,217838,7,340996
13761,0.026582,172.217.194.0-255,2902,220740,7,340996
13762,0.026586,172.31.36.0-255,66,220806,7,340996
13763,0.028588,172.217.194.0-255,2902,223708,7,340996
13764,0.028596,172.31.36.0-255,66,223774,7,340996
13765,0.028625,172.217.194.0-255,2902,226676,7,340996
13766,0.028628,172.31.36.0-255,66,226742,7,340996
13767,0.030629,172.217.194.0-255,5738,232480,7,340996
13768,0.030637,172.31.36.0-255,66,232546,7,340996
13769,0.032669,172.217.194.0-255,5738,238284,7,340996
13770,0.032677,172.31.36.0-255,66,238350,7,340996
13771,0.034698,172.217.194.0-255,5738,244088,7,340996
13772,0.034706,172.31.36.0-255,66,244154,7,340996
13773,0.035257,172.31.36.0-255,172,244326,7,340996
13774,0.035286,172.31.36.0-255,1114,245440,7,340996
13775,0.035343,172.31.36.0-255,1514,246954,7,340996
13776,0.035345,172.31.36.0-255,1293,248247,7,340996
13777,0.036733,172.217.194.0-255,5738,253985,7,340996
13778,0.036745,172.31.36.0-255,66,254051,7,340996
13779,0.036785,104.244.42.0-255,66,254117,7,340996
13780,0.036863,104.244.42.0-255,66,254183,7,340996
13781,0.036867,104.244.42.0-255,66,254249,7,340996
13782,0.038757,172.217.194.0-255,5738,259987,7,340996
13783,0.038765,172.31.36.0-255,66,260053,7,340996
13784,0.040816,172.217.194.0-255,5738,265791,7,340996
13785,0.040826,172.31.36.0-255,66,265857,7,340996
13786,0.042873,172.217.194.0-255,5738,271595,7,340996
13787,0.04288,172.31.36.0-255,66,271661,7,340996
13788,0.044926,172.217.194.0-255,5738,277399,7,340996
13789,0.044934,172.31.36.0-255,66,277465,7,340996
13790,0.046985,172.217.194.0-255,5738,283203,7,340996
13791,0.046992,172.31.36.0-255,66,283269,7,340996
13792,0.049018,172.217.194.0-255,5738,289007,7,340996
13793,0.049025,172.31.36.0-255,66,289073,7,340996
13794,0.051065,172.217.194.0-255,5738,294811,7,340996
13795,0.051072,172.31.36.0-255,66,294877,7,340996
13796,0.053091,172.217.194.0-255,5738,300615,7,340996
13797,0.0531,172.31.36.0-255,66,300681,7,340996
13798,0.055146,172.217.194.0-255,5738,306419,7,340996
13799,0.055155,172.31.36.0-255,66,306485,7,340996
13800,0.057215,172.217.194.0-255,5738,312223,7,340996
13801,0.057222,172.31.36.0-255,66,312289,7,340996
13802,0.059273,172.217.194.0-255,5738,318027,7,340996
13803,0.05928,172.31.36.0-255,66,318093,7,340996
13804,0.061321,172.217.194.0-255,5738,323831,7,340996
13805,0.061328,172.31.36.0-255,66,323897,7,340996
13806,0.063381,172.217.194.0-255,5738,329635,7,340996
13807,0.063388,172.31.36.0-255,66,329701,7,340996
13808,0.065393,172.217.194.0-255,5738,335439,7,340996
13809,0.065401,172.31.36.0-255,66,335505,7,340996
13810,0.06741,172.217.194.0-255,5254,340759,7,340996
13811,0.067416,172.31.36.0-255,66,340825,7,340996
13812,0.067919,172.31.36.0-255,105,340930,7,340996
13813,0.069924,172.217.194.0-255,66,340996,7,340996
13814,0.0,74.125.24.0-255,153,153,7,173816
13815,3.4e-05,172.31.36.0-255,66,219,7,173816
13816,4.1e-05,74.125.24.0-255,1484,1703,7,173816
13817,4.6e-05,172.31.36.0-255,66,1769,7,173816
13818,5.1e-05,74.125.24.0-255,2902,4671,7,173816
13819,6.5e-05,172.31.36.0-255,66,4737,7,173816
13820,7.1e-05,74.125.24.0-255,7156,11893,7,173816
13821,7.4e-05,172.31.36.0-255,66,11959,7,173816
13822,0.000103,74.125.24.0-255,5738,17697,7,173816
13823,0.000112,172.31.36.0-255,66,17763,7,173816
13824,0.000147,172.31.36.0-255,66,17829,7,173816
13825,0.000188,172.31.36.0-255,66,17895,7,173816
13826,0.00022,172.31.36.0-255,66,17961,7,173816
13827,0.000224,74.125.24.0-255,2184,20145,7,173816
13828,0.000227,172.31.36.0-255,66,20211,7,173816
13829,0.000295,74.125.24.0-255,1484,21695,7,173816
13830,0.0003,172.31.36.0-255,66,21761,7,173816
13831,0.000305,74.125.24.0-255,2902,24663,7,173816
13832,0.000308,172.31.36.0-255,66,24729,7,173816
13833,0.000319,74.125.24.0-255,5738,30467,7,173816
13834,0.000322,172.31.36.0-255,66,30533,7,173816
13835,0.000329,74.125.24.0-255,7151,37684,7,173816
13836,0.000332,172.31.36.0-255,66,37750,7,173816
13837,0.000358,74.125.24.0-255,332,38082,7,173816
13838,0.000361,172.31.36.0-255,66,38148,7,173816
13839,0.000521,74.125.24.0-255,1484,39632,7,173816
13840,0.000525,172.31.36.0-255,66,39698,7,173816
13841,0.00053,74.125.24.0-255,2902,42600,7,173816
13842,0.000533,172.31.36.0-255,66,42666,7,173816
13843,0.000561,74.125.24.0-255,5738,48404,7,173816
13844,0.000565,172.31.36.0-255,66,48470,7,173816
13845,0.000569,74.125.24.0-255,2902,51372,7,173816
13846,0.000571,172.31.36.0-255,66,51438,7,173816
13847,0.000579,74.125.24.0-255,7156,58594,7,173816
13848,0.000582,172.31.36.0-255,66,58660,7,173816
13849,0.000615,74.125.24.0-255,2902,61562,7,173816
13850,0.000621,172.31.36.0-255,66,61628,7,173816
13851,0.000648,74.125.24.0-255,5738,67366,7,173816
13852,0.000651,172.31.36.0-255,66,67432,7,173816
13853,0.000679,74.125.24.0-255,5020,72452,7,173816
13854,0.000682,172.31.36.0-255,66,72518,7,173816
13855,0.000766,74.125.24.0-255,1484,74002,7,173816
13856,0.000771,74.125.24.0-255,1484,75486,7,173816
13857,0.000774,172.31.36.0-255,66,75552,7,173816
13858,0.0008,74.125.24.0-255,1484,77036,7,173816
13859,0.000806,74.125.24.0-255,5738,82774,7,173816
13860,0.000809,172.31.36.0-255,66,82840,7,173816
13861,0.000827,172.31.36.0-255,66,82906,7,173816
13862,0.000877,172.31.36.0-255,66,82972,7,173816
13863,0.000906,74.125.24.0-255,6438,89410,7,173816
13864,0.00091,172.31.36.0-255,66,89476,7,173816
13865,0.000916,74.125.24.0-255,5738,95214,7,173816
13866,0.000919,172.31.36.0-255,66,95280,7,173816
13867,0.000951,74.125.24.0-255,4320,99600,7,173816
13868,0.000954,172.31.36.0-255,66,99666,7,173816
13869,0.000973,172.31.36.0-255,66,99732,7,173816
13870,0.000987,172.31.36.0-255,66,99798,7,173816
13871,0.001026,74.125.24.0-255,1484,101282,7,173816
13872,0.001029,74.125.24.0-255,1484,102766,7,173816
13873,0.001032,172.31.36.0-255,66,102832,7,173816
13874,0.001058,74.125.24.0-255,1484,104316,7,173816
13875,0.001064,74.125.24.0-255,5738,110054,7,173816
13876,0.001067,172.31.36.0-255,66,110120,7,173816
13877,0.001075,74.125.24.0-255,7156,117276,7,173816
13878,0.001079,172.31.36.0-255,66,117342,7,173816
13879,0.00109,172.31.36.0-255,66,117408,7,173816
13880,0.001128,172.31.36.0-255,66,117474,7,173816
13881,0.001163,172.31.36.0-255,66,117540,7,173816
13882,0.001193,74.125.24.0-255,4320,121860,7,173816
13883,0.001196,172.31.36.0-255,66,121926,7,173816
13884,0.001232,74.125.24.0-255,7156,129082,7,173816
13885,0.001235,172.31.36.0-255,66,129148,7,173816
13886,0.001314,172.31.36.0-255,66,129214,7,173816
13887,0.001339,172.31.36.0-255,66,129280,7,173816
13888,0.001355,172.31.36.0-255,66,129346,7,173816
13889,0.001377,74.125.24.0-255,7156,136502,7,173816
13890,0.001381,172.31.36.0-255,66,136568,7,173816
13891,0.001398,172.31.36.0-255,66,136634,7,173816
13892,0.001414,172.31.36.0-255,66,136700,7,173816
13893,0.001417,74.125.24.0-255,217,136917,7,173816
13894,0.001462,172.31.36.0-255,66,136983,7,173816
13895,0.001474,172.31.36.0-255,66,137049,7,173816
13896,0.001502,74.125.24.0-255,1484,138533,7,173816
13897,0.001526,172.31.36.0-255,66,138599,7,173816
13898,0.001531,74.125.24.0-255,2902,141501,7,173816
13899,0.001533,172.31.36.0-255,66,141567,7,173816
13900,0.00156,74.125.24.0-255,4320,145887,7,173816
13901,0.001564,172.31.36.0-255,66,145953,7,173816
13902,0.001574,172.31.36.0-255,66,146019,7,173816
13903,0.001583,74.125.24.0-255,2902,148921,7,173816
13904,0.001586,172.31.36.0-255,66,148987,7,173816
13905,0.001627,172.31.36.0-255,66,149053,7,173816
13906,0.00164,172.31.36.0-255,66,149119,7,173816
13907,0.001654,172.31.36.0-255,66,149185,7,173816
13908,0.001831,74.125.24.0-255,1484,150669,7,173816
13909,0.001837,74.125.24.0-255,2902,153571,7,173816
13910,0.00184,172.31.36.0-255,66,153637,7,173816
13911,0.001846,74.125.24.0-255,4320,157957,7,173816
13912,0.001849,172.31.36.0-255,66,158023,7,173816
13913,0.001878,74.125.24.0-255,1484,159507,7,173816
13914,0.001925,172.31.36.0-255,66,159573,7,173816
13915,0.001953,74.125.24.0-255,1484,161057,7,173816
13916,0.00196,74.125.24.0-255,7156,168213,7,173816
13917,0.001963,172.31.36.0-255,66,168279,7,173816
13918,0.001966,74.125.24.0-255,878,169157,7,173816
13919,0.001969,74.125.24.0-255,105,169262,7,173816
13920,0.00358,172.31.36.0-255,66,169328,7,173816
13921,0.003607,172.31.36.0-255,105,169433,7,173816
13922,0.006156,74.125.24.0-255,66,169499,7,173816
13923,0.031861,172.31.36.0-255,199,169698,7,173816
13924,0.03189,172.31.36.0-255,1139,170837,7,173816
13925,0.031933,172.31.36.0-255,1514,172351,7,173816
13926,0.031934,172.31.36.0-255,1267,173618,7,173816
13927,0.03341,104.244.42.0-255,66,173684,7,173816
13928,0.033434,104.244.42.0-255,66,173750,7,173816
13929,0.033512,104.244.42.0-255,66,173816,7,173816
13930,0.0,74.125.24.0-255,153,153,7,272686
13931,2.2e-05,172.31.36.0-255,66,219,7,272686
13932,2.9e-05,74.125.24.0-255,1484,1703,7,272686
13933,3.2e-05,172.31.36.0-255,66,1769,7,272686
13934,3.8e-05,74.125.24.0-255,2902,4671,7,272686
13935,4.1e-05,172.31.36.0-255,66,4737,7,272686
13936,4.7e-05,74.125.24.0-255,7156,11893,7,272686
13937,5e-05,172.31.36.0-255,66,11959,7,272686
13938,5.3e-05,74.125.24.0-255,1484,13443,7,272686
13939,5.5e-05,172.31.36.0-255,66,13509,7,272686
13940,0.000109,172.31.36.0-255,66,13575,7,272686
13941,0.000115,74.125.24.0-255,6797,20372,7,272686
13942,0.000117,172.31.36.0-255,66,20438,7,272686
13943,0.000242,74.125.24.0-255,1484,21922,7,272686
13944,0.000246,172.31.36.0-255,66,21988,7,272686
13945,0.000273,74.125.24.0-255,2902,24890,7,272686
13946,0.000276,172.31.36.0-255,66,24956,7,272686
13947,0.000281,74.125.24.0-255,5738,30694,7,272686
13948,0.000284,172.31.36.0-255,66,30760,7,272686
13949,0.000301,74.125.24.0-255,6797,37557,7,272686
13950,0.000303,172.31.36.0-255,66,37623,7,272686
13951,0.000307,74.125.24.0-255,2902,40525,7,272686
13952,0.000309,172.31.36.0-255,66,40591,7,272686
13953,0.00033,74.125.24.0-255,4320,44911,7,272686
13954,0.000333,172.31.36.0-255,66,44977,7,272686
13955,0.00036,172.31.36.0-255,66,45043,7,272686
13956,0.000363,74.125.24.0-255,130,45173,7,272686
13957,0.000365,172.31.36.0-255,66,45239,7,272686
13958,0.000917,74.125.24.0-255,353,45592,7,272686
13959,0.000921,172.31.36.0-255,66,45658,7,272686
13960,0.001032,74.125.24.0-255,1484,47142,7,272686
13961,0.001041,74.125.24.0-255,2902,50044,7,272686
13962,0.001045,172.31.36.0-255,66,50110,7,272686
13963,0.001051,74.125.24.0-255,5738,55848,7,272686
13964,0.001053,172.31.36.0-255,66,55914,7,272686
13965,0.001056,74.125.24.0-255,1484,57398,7,272686
13966,0.00108,172.31.36.0-255,66,57464,7,272686
13967,0.00109,172.31.36.0-255,66,57530,7,272686
13968,0.001126,74.125.24.0-255,2184,59714,7,272686
13969,0.001129,172.31.36.0-255,66,59780,7,272686
13970,0.001904,74.125.24.0-255,1484,61264,7,272686
13971,0.001912,74.125.24.0-255,2902,64166,7,272686
13972,0.001916,172.31.36.0-255,66,64232,7,272686
13973,0.001923,74.125.24.0-255,5738,69970,7,272686
13974,0.001924,172.31.36.0-255,66,70036,7,272686
13975,0.001927,74.125.24.0-255,1484,71520,7,272686
13976,0.00195,74.125.24.0-255,2902,74422,7,272686
13977,0.001952,172.31.36.0-255,66,74488,7,272686
13978,0.001958,74.125.24.0-255,5738,80226,7,272686
13979,0.00196,172.31.36.0-255,66,80292,7,272686
13980,0.001988,172.31.36.0-255,66,80358,7,272686
13981,0.001993,74.125.24.0-255,3602,83960,7,272686
13982,0.001994,172.31.36.0-255,66,84026,7,272686
13983,0.004405,74.125.24.0-255,4320,88346,7,272686
13984,0.00441,172.31.36.0-255,66,88412,7,272686
13985,0.004421,74.125.24.0-255,1484,89896,7,272686
13986,0.006797,74.125.24.0-255,4320,94216,7,272686
13987,0.006812,172.31.36.0-255,66,94282,7,272686
13988,0.009217,74.125.24.0-255,5738,100020,7,272686
13989,0.009225,172.31.36.0-255,66,100086,7,272686
13990,0.011649,74.125.24.0-255,5738,105824,7,272686
13991,0.01166,172.31.36.0-255,66,105890,7,272686
13992,0.01406,74.125.24.0-255,5738,111628,7,272686
13993,0.014073,172.31.36.0-255,66,111694,7,272686
13994,0.016483,74.125.24.0-255,5738,117432,7,272686
13995,0.016495,172.31.36.0-255,66,117498,7,272686
13996,0.018881,74.125.24.0-255,5738,123236,7,272686
13997,0.018888,172.31.36.0-255,66,123302,7,272686
13998,0.021287,74.125.24.0-255,5738,129040,7,272686
13999,0.021294,172.31.36.0-255,66,129106,7,272686
14000,0.023447,172.31.36.0-255,166,129272,7,272686
14001,0.023483,172.31.36.0-255,1138,130410,7,272686
14002,0.02354,172.31.36.0-255,1514,131924,7,272686
14003,0.023541,172.31.36.0-255,1268,133192,7,272686
14004,0.023699,74.125.24.0-255,5738,138930,7,272686
14005,0.023705,172.31.36.0-255,66,138996,7,272686
14006,0.024994,104.244.42.0-255,66,139062,7,272686
14007,0.025044,104.244.42.0-255,66,139128,7,272686
14008,0.025126,104.244.42.0-255,66,139194,7,272686
14009,0.026097,74.125.24.0-255,5738,144932,7,272686
14010,0.026102,172.31.36.0-255,66,144998,7,272686
14011,0.028523,74.125.24.0-255,5738,150736,7,272686
14012,0.028537,172.31.36.0-255,66,150802,7,272686
14013,0.030934,74.125.24.0-255,5738,156540,7,272686
14014,0.030941,172.31.36.0-255,66,156606,7,272686
14015,0.033364,74.125.24.0-255,5738,162344,7,272686
14016,0.033372,172.31.36.0-255,66,162410,7,272686
14017,0.035745,74.125.24.0-255,5738,168148,7,272686
14018,0.035752,172.31.36.0-255,66,168214,7,272686
14019,0.038139,74.125.24.0-255,5738,173952,7,272686
14020,0.038146,172.31.36.0-255,66,174018,7,272686
14021,0.040532,74.125.24.0-255,5738,179756,7,272686
14022,0.040539,172.31.36.0-255,66,179822,7,272686
14023,0.042947,74.125.24.0-255,5738,185560,7,272686
14024,0.042959,172.31.36.0-255,66,185626,7,272686
14025,0.045341,74.125.24.0-255,5738,191364,7,272686
14026,0.045352,172.31.36.0-255,66,191430,7,272686
14027,0.047749,74.125.24.0-255,5738,197168,7,272686
14028,0.047756,172.31.36.0-255,66,197234,7,272686
14029,0.050142,74.125.24.0-255,5738,202972,7,272686
14030,0.050147,172.31.36.0-255,66,203038,7,272686
14031,0.052622,74.125.24.0-255,5738,208776,7,272686
14032,0.052645,172.31.36.0-255,66,208842,7,272686
14033,0.055092,74.125.24.0-255,5738,214580,7,272686
14034,0.055111,172.31.36.0-255,66,214646,7,272686
14035,0.0575,74.125.24.0-255,5738,220384,7,272686
14036,0.057507,172.31.36.0-255,66,220450,7,272686
14037,0.059869,74.125.24.0-255,5738,226188,7,272686
14038,0.059881,172.31.36.0-255,66,226254,7,272686
14039,0.062323,74.125.24.0-255,5738,231992,7,272686
14040,0.062339,172.31.36.0-255,66,232058,7,272686
14041,0.064767,74.125.24.0-255,5738,237796,7,272686
14042,0.064782,172.31.36.0-255,66,237862,7,272686
14043,0.067152,74.125.24.0-255,5738,243600,7,272686
14044,0.067159,172.31.36.0-255,66,243666,7,272686
14045,0.069585,74.125.24.0-255,5738,249404,7,272686
14046,0.069593,172.31.36.0-255,66,249470,7,272686
14047,0.071997,74.125.24.0-255,5738,255208,7,272686
14048,0.072006,172.31.36.0-255,66,255274,7,272686
14049,0.07443,74.125.24.0-255,5738,261012,7,272686
14050,0.074443,172.31.36.0-255,66,261078,7,272686
14051,0.076867,74.125.24.0-255,5738,266816,7,272686
14052,0.076886,172.31.36.0-255,66,266882,7,272686
14053,0.079311,74.125.24.0-255,5738,272620,7,272686
14054,0.079322,172.31.36.0-255,66,272686,7,272686
14055,0.0,172.217.194.0-255,153,153,7,279639
14056,2.3e-05,172.31.36.0-255,66,219,7,279639
14057,3e-05,172.217.194.0-255,1484,1703,7,279639
14058,3.6e-05,172.31.36.0-255,66,1769,7,279639
14059,4.2e-05,172.217.194.0-255,2902,4671,7,279639
14060,4.5e-05,172.31.36.0-255,66,4737,7,279639
14061,5.2e-05,172.217.194.0-255,5738,10475,7,279639
14062,5.5e-05,172.31.36.0-255,66,10541,7,279639
14063,8.3e-05,172.217.194.0-255,3492,14033,7,279639
14064,8.7e-05,172.31.36.0-255,66,14099,7,279639
14065,0.000124,172.217.194.0-255,4320,18419,7,279639
14066,0.000127,172.31.36.0-255,66,18485,7,279639
14067,0.00015,172.217.194.0-255,7156,25641,7,279639
14068,0.000152,172.31.36.0-255,66,25707,7,279639
14069,0.000158,172.217.194.0-255,4320,30027,7,279639
14070,0.00016,172.31.36.0-255,66,30093,7,279639
14071,0.00018,172.217.194.0-255,1125,31218,7,279639
14072,0.000182,172.31.36.0-255,66,31284,7,279639
14073,0.000592,172.217.194.0-255,1484,32768,7,279639
14074,0.000598,172.31.36.0-255,66,32834,7,279639
14075,0.000604,172.217.194.0-255,2902,35736,7,279639
14076,0.000606,172.31.36.0-255,66,35802,7,279639
14077,0.000636,172.217.194.0-255,5738,41540,7,279639
14078,0.00064,172.31.36.0-255,66,41606,7,279639
14079,0.000688,172.31.36.0-255,66,41672,7,279639
14080,0.000707,172.217.194.0-255,1484,43156,7,279639
14081,0.000711,172.31.36.0-255,66,43222,7,279639
14082,0.000733,172.31.36.0-255,66,43288,7,279639
14083,0.002286,172.217.194.0-255,365,43653,7,279639
14084,0.002293,172.31.36.0-255,66,43719,7,279639
14085,0.002324,172.217.194.0-255,1484,45203,7,279639
14086,0.002329,172.217.194.0-255,1484,46687,7,279639
14087,0.002331,172.31.36.0-255,66,46753,7,279639
14088,0.002368,172.217.194.0-255,7156,53909,7,279639
14089,0.00237,172.31.36.0-255,66,53975,7,279639
14090,0.002376,172.217.194.0-255,4320,58295,7,279639
14091,0.002379,172.31.36.0-255,66,58361,7,279639
14092,0.002393,172.217.194.0-255,4320,62681,7,279639
14093,0.002395,172.31.36.0-255,66,62747,7,279639
14094,0.002402,172.217.194.0-255,5738,68485,7,279639
14095,0.002405,172.31.36.0-255,66,68551,7,279639
14096,0.002434,172.217.194.0-255,5738,74289,7,279639
14097,0.002436,172.31.36.0-255,66,74355,7,279639
14098,0.002477,172.217.194.0-255,3602,77957,7,279639
14099,0.002479,172.31.36.0-255,66,78023,7,279639
14100,0.003744,172.217.194.0-255,1484,79507,7,279639
14101,0.003758,172.217.194.0-255,2902,82409,7,279639
14102,0.00376,172.31.36.0-255,66,82475,7,279639
14103,0.00378,172.217.194.0-255,5738,88213,7,279639
14104,0.003782,172.31.36.0-255,66,88279,7,279639
14105,0.003843,172.217.194.0-255,4320,92599,7,279639
14106,0.003845,172.31.36.0-255,66,92665,7,279639
14107,0.003863,172.217.194.0-255,2902,95567,7,279639
14108,0.003866,172.31.36.0-255,66,95633,7,279639
14109,0.003872,172.217.194.0-255,5738,101371,7,279639
14110,0.003874,172.31.36.0-255,66,101437,7,279639
14111,0.003902,172.217.194.0-255,7156,108593,7,279639
14112,0.003904,172.31.36.0-255,66,108659,7,279639
14113,0.003954,172.217.194.0-255,5020,113679,7,279639
14114,0.003956,172.31.36.0-255,66,113745,7,279639
14115,0.003968,172.217.194.0-255,1484,115229,7,279639
14116,0.003985,172.217.194.0-255,4320,119549,7,279639
14117,0.003988,172.31.36.0-255,66,119615,7,279639
14118,0.004002,172.217.194.0-255,2902,122517,7,279639
14119,0.004005,172.31.36.0-255,66,122583,7,279639
14120,0.004039,172.31.36.0-255,66,122649,7,279639
14121,0.004046,172.217.194.0-255,5738,128387,7,279639
14122,0.004048,172.31.36.0-255,66,128453,7,279639
14123,0.004079,172.31.36.0-255,66,128519,7,279639
14124,0.004151,172.217.194.0-255,1484,130003,7,279639
14125,0.004169,172.217.194.0-255,2902,132905,7,279639
14126,0.004171,172.31.36.0-255,66,132971,7,279639
14127,0.004195,172.217.194.0-255,5738,138709,7,279639
14128,0.004198,172.31.36.0-255,66,138775,7,279639
14129,0.004235,172.217.194.0-255,7156,145931,7,279639
14130,0.004238,172.31.36.0-255,66,145997,7,279639
14131,0.00427,172.217.194.0-255,5738,151735,7,279639
14132,0.004273,172.31.36.0-255,66,151801,7,279639
14133,0.004291,172.217.194.0-255,7156,158957,7,279639
14134,0.004293,172.31.36.0-255,66,159023,7,279639
14135,0.004313,172.217.194.0-255,3602,162625,7,279639
14136,0.004315,172.31.36.0-255,66,162691,7,279639
14137,0.00444,172.217.194.0-255,1484,164175,7,279639
14138,0.004456,172.217.194.0-255,2902,167077,7,279639
14139,0.00446,172.31.36.0-255,66,167143,7,279639
14140,0.004477,172.217.194.0-255,1484,168627,7,279639
14141,0.004495,172.217.194.0-255,5738,174365,7,279639
14142,0.004498,172.31.36.0-255,66,174431,7,279639
14143,0.004544,172.217.194.0-255,2902,177333,7,279639
14144,0.004546,172.31.36.0-255,66,177399,7,279639
14145,0.004567,172.31.36.0-255,66,177465,7,279639
14146,0.004587,172.217.194.0-255,4320,181785,7,279639
14147,0.00459,172.31.36.0-255,66,181851,7,279639
14148,0.004612,172.217.194.0-255,6438,188289,7,279639
14149,0.004614,172.31.36.0-255,66,188355,7,279639
14150,0.004621,172.217.194.0-255,5738,194093,7,279639
14151,0.004624,172.31.36.0-255,66,194159,7,279639
14152,0.004644,172.217.194.0-255,5738,199897,7,279639
14153,0.004646,172.31.36.0-255,66,199963,7,279639
14154,0.004649,172.217.194.0-255,1484,201447,7,279639
14155,0.004685,172.31.36.0-255,66,201513,7,279639
14156,0.004709,172.217.194.0-255,5738,207251,7,279639
14157,0.004711,172.31.36.0-255,66,207317,7,279639
14158,0.004719,172.217.194.0-255,6438,213755,7,279639
14159,0.004722,172.31.36.0-255,66,213821,7,279639
14160,0.004724,172.217.194.0-255,1484,215305,7,279639
14161,0.004743,172.217.194.0-255,1484,216789,7,279639
14162,0.004746,172.31.36.0-255,66,216855,7,279639
14163,0.004752,172.217.194.0-255,4320,221175,7,279639
14164,0.004754,172.31.36.0-255,66,221241,7,279639
14165,0.004768,172.217.194.0-255,1484,222725,7,279639
14166,0.004779,172.217.194.0-255,1484,224209,7,279639
14167,0.004781,172.31.36.0-255,66,224275,7,279639
14168,0.004784,172.217.194.0-255,1484,225759,7,279639
14169,0.004804,172.217.194.0-255,5738,231497,7,279639
14170,0.004807,172.31.36.0-255,66,231563,7,279639
14171,0.004811,172.217.194.0-255,2902,234465,7,279639
14172,0.004813,172.31.36.0-255,66,234531,7,279639
14173,0.004835,172.31.36.0-255,66,234597,7,279639
14174,0.00484,172.217.194.0-255,4320,238917,7,279639
14175,0.004843,172.31.36.0-255,66,238983,7,279639
14176,0.004845,172.217.194.0-255,766,239749,7,279639
14177,0.005017,172.217.194.0-255,1484,241233,7,279639
14178,0.005021,172.31.36.0-255,66,241299,7,279639
14179,0.005036,172.217.194.0-255,2902,244201,7,279639
14180,0.005039,172.31.36.0-255,66,244267,7,279639
14181,0.005042,172.217.194.0-255,1484,245751,7,279639
14182,0.005065,172.217.194.0-255,4320,250071,7,279639
14183,0.005068,172.31.36.0-255,66,250137,7,279639
14184,0.00508,172.31.36.0-255,66,250203,7,279639
14185,0.005099,172.217.194.0-255,1484,251687,7,279639
14186,0.005139,172.31.36.0-255,66,251753,7,279639
14187,0.005153,172.31.36.0-255,66,251819,7,279639
14188,0.00517,172.217.194.0-255,1484,253303,7,279639
14189,0.005182,172.31.36.0-255,66,253369,7,279639
14190,0.005202,172.217.194.0-255,2902,256271,7,279639
14191,0.005205,172.31.36.0-255,66,256337,7,279639
14192,0.005245,172.31.36.0-255,66,256403,7,279639
14193,0.00526,172.31.36.0-255,66,256469,7,279639
14194,0.005287,172.217.194.0-255,2902,259371,7,279639
14195,0.00529,172.31.36.0-255,66,259437,7,279639
14196,0.005302,172.31.36.0-255,66,259503,7,279639
14197,0.005309,172.217.194.0-255,7156,266659,7,279639
14198,0.005312,172.31.36.0-255,66,266725,7,279639
14199,0.005317,172.217.194.0-255,4320,271045,7,279639
14200,0.005319,172.31.36.0-255,66,271111,7,279639
14201,0.005344,172.217.194.0-255,3559,274670,7,279639
14202,0.005347,172.31.36.0-255,66,274736,7,279639
14203,0.00535,172.217.194.0-255,97,274833,7,279639
14204,0.005403,172.217.194.0-255,105,274938,7,279639
14205,0.008236,172.31.36.0-255,66,275004,7,279639
14206,0.008274,172.31.36.0-255,105,275109,7,279639
14207,0.010559,172.217.194.0-255,66,275175,7,279639
14208,0.032521,172.31.36.0-255,172,275347,7,279639
14209,0.03257,172.31.36.0-255,1115,276462,7,279639
14210,0.032646,172.31.36.0-255,1514,277976,7,279639
14211,0.032648,172.31.36.0-255,1291,279267,7,279639
14212,0.034088,104.244.42.0-255,66,279333,7,279639
14213,0.034137,104.244.42.0-255,66,279399,7,279639
14214,0.034237,104.244.42.0-255,66,279465,7,279639
14215,0.034757,104.244.42.0-255,108,279573,7,279639
14216,0.034765,172.31.36.0-255,66,279639,7,279639
14217,0.0,172.217.194.0-255,290,290,7,189732
14218,2.9e-05,172.31.36.0-255,66,356,7,189732
14219,3.5e-05,172.217.194.0-255,1484,1840,7,189732
14220,4e-05,172.31.36.0-255,66,1906,7,189732
14221,4.6e-05,172.217.194.0-255,4320,6226,7,189732
14222,4.8e-05,172.31.36.0-255,66,6292,7,189732
14223,5.1e-05,172.217.194.0-255,1484,7776,7,189732
14224,5.3e-05,172.31.36.0-255,66,7842,7,189732
14225,6.4e-05,172.31.36.0-255,66,7908,7,189732
14226,0.000106,172.31.36.0-255,66,7974,7,189732
14227,0.000131,172.217.194.0-255,1484,9458,7,189732
14228,0.000134,172.31.36.0-255,66,9524,7,189732
14229,0.000139,172.217.194.0-255,2902,12426,7,189732
14230,0.00014,172.31.36.0-255,66,12492,7,189732
14231,0.000144,172.217.194.0-255,1484,13976,7,189732
14232,0.000147,172.31.36.0-255,66,14042,7,189732
14233,0.000167,172.217.194.0-255,4320,18362,7,189732
14234,0.000169,172.31.36.0-255,66,18428,7,189732
14235,0.000176,172.217.194.0-255,4320,22748,7,189732
14236,0.000178,172.31.36.0-255,66,22814,7,189732
14237,0.000211,172.31.36.0-255,66,22880,7,189732
14238,0.000231,172.217.194.0-255,4320,27200,7,189732
14239,0.000234,172.31.36.0-255,66,27266,7,189732
14240,0.00025,172.217.194.0-255,6438,33704,7,189732
14241,0.000253,172.31.36.0-255,66,33770,7,189732
14242,0.000449,172.217.194.0-255,647,34417,7,189732
14243,0.000453,172.31.36.0-255,66,34483,7,189732
14244,0.000838,172.217.194.0-255,1484,35967,7,189732
14245,0.000843,172.31.36.0-255,66,36033,7,189732
14246,0.000849,172.217.194.0-255,1484,37517,7,189732
14247,0.000864,172.217.194.0-255,1484,39001,7,189732
14248,0.000866,172.31.36.0-255,66,39067,7,189732
14249,0.000874,172.217.194.0-255,5738,44805,7,189732
14250,0.000876,172.31.36.0-255,66,44871,7,189732
14251,0.000892,172.217.194.0-255,4320,49191,7,189732
14252,0.000894,172.31.36.0-255,66,49257,7,189732
14253,0.000928,172.31.36.0-255,66,49323,7,189732
14254,0.000943,172.217.194.0-255,4320,53643,7,189732
14255,0.000945,172.31.36.0-255,66,53709,7,189732
14256,0.00097,172.217.194.0-255,6438,60147,7,189732
14257,0.000984,172.31.36.0-255,66,60213,7,189732
14258,0.001033,172.217.194.0-255,1484,61697,7,189732
14259,0.00105,172.217.194.0-255,2902,64599,7,189732
14260,0.001053,172.217.194.0-255,1484,66083,7,189732
14261,0.001061,172.31.36.0-255,66,66149,7,189732
14262,0.001072,172.217.194.0-255,4320,70469,7,189732
14263,0.001076,172.217.194.0-255,2902,73371,7,189732
14264,0.001078,172.31.36.0-255,66,73437,7,189732
14265,0.001082,172.31.36.0-255,66,73503,7,189732
14266,0.001126,172.31.36.0-255,66,73569,7,189732
14267,0.001131,172.31.36.0-255,66,73635,7,189732
14268,0.001134,172.217.194.0-255,1484,75119,7,189732
14269,0.00118,172.31.36.0-255,66,75185,7,189732
14270,0.001216,172.217.194.0-255,7156,82341,7,189732
14271,0.001228,172.31.36.0-255,66,82407,7,189732
14272,0.001236,172.217.194.0-255,5020,87427,7,189732
14273,0.001242,172.31.36.0-255,66,87493,7,189732
14274,0.001256,172.31.36.0-255,66,87559,7,189732
14275,0.001258,172.217.194.0-255,2902,90461,7,189732
14276,0.00126,172.31.36.0-255,66,90527,7,189732
14277,0.001276,172.31.36.0-255,66,90593,7,189732
14278,0.0013,172.31.36.0-255,66,90659,7,189732
14279,0.001302,172.217.194.0-255,2902,93561,7,189732
14280,0.001317,172.217.194.0-255,5738,99299,7,189732
14281,0.001325,172.31.36.0-255,66,99365,7,189732
14282,0.001328,172.217.194.0-255,1484,100849,7,189732
14283,0.001335,172.217.194.0-255,5738,106587,7,189732
14284,0.00134,172.31.36.0-255,66,106653,7,189732
14285,0.001349,172.217.194.0-255,4320,110973,7,189732
14286,0.001358,172.31.36.0-255,66,111039,7,189732
14287,0.001361,172.217.194.0-255,1484,112523,7,189732
14288,0.001366,172.217.194.0-255,4320,116843,7,189732
14289,0.001377,172.217.194.0-255,2902,119745,7,189732
14290,0.001378,172.31.36.0-255,66,119811,7,189732
14291,0.001383,172.31.36.0-255,66,119877,7,189732
14292,0.001399,172.217.194.0-255,5020,124897,7,189732
14293,0.00141,172.31.36.0-255,66,124963,7,189732
14294,0.001483,172.217.194.0-255,1484,126447,7,189732
14295,0.001487,172.217.194.0-255,1484,127931,7,189732
14296,0.00149,172.31.36.0-255,66,127997,7,189732
14297,0.001503,172.217.194.0-255,1484,129481,7,189732
14298,0.00151,172.217.194.0-255,5738,135219,7,189732
14299,0.001519,172.31.36.0-255,66,135285,7,189732
14300,0.001533,172.217.194.0-255,7156,142441,7,189732
14301,0.001547,172.31.36.0-255,66,142507,7,189732
14302,0.001555,172.217.194.0-255,5738,148245,7,189732
14303,0.00156,172.217.194.0-255,2902,151147,7,189732
14304,0.001572,172.31.36.0-255,66,151213,7,189732
14305,0.001586,172.31.36.0-255,66,151279,7,189732
14306,0.001681,172.217.194.0-255,1484,152763,7,189732
14307,0.001686,172.217.194.0-255,2902,155665,7,189732
14308,0.001691,172.217.194.0-255,2902,158567,7,189732
14309,0.001699,172.31.36.0-255,66,158633,7,189732
14310,0.001709,172.217.194.0-255,2902,161535,7,189732
14311,0.001712,172.31.36.0-255,66,161601,7,189732
14312,0.001719,172.217.194.0-255,7156,168757,7,189732
14313,0.00173,172.31.36.0-255,66,168823,7,189732
14314,0.001741,172.217.194.0-255,2902,171725,7,189732
14315,0.001745,172.217.194.0-255,1484,173209,7,189732
14316,0.001747,172.31.36.0-255,66,173275,7,189732
14317,0.001798,172.31.36.0-255,66,173341,7,189732
14318,0.001803,172.31.36.0-255,66,173407,7,189732
14319,0.001834,172.217.194.0-255,5738,179145,7,189732
14320,0.00184,172.31.36.0-255,66,179211,7,189732
14321,0.001895,172.31.36.0-255,66,179277,7,189732
14322,0.001908,172.31.36.0-255,66,179343,7,189732
14323,0.001952,172.31.36.0-255,66,179409,7,189732
14324,0.00198,172.31.36.0-255,66,179475,7,189732
14325,0.001986,172.31.36.0-255,66,179541,7,189732
14326,0.002014,172.217.194.0-255,492,180033,7,189732
14327,0.002016,172.31.36.0-255,101,180134,7,189732
14328,0.002017,172.217.194.0-255,105,180239,7,189732
14329,0.003657,172.31.36.0-255,66,180305,7,189732
14330,0.003675,172.31.36.0-255,105,180410,7,189732
14331,0.004255,172.217.194.0-255,66,180476,7,189732
14332,0.005935,172.217.194.0-255,66,180542,7,189732
14333,0.034186,172.31.36.0-255,172,180714,7,189732
14334,0.034218,172.31.36.0-255,1113,181827,7,189732
14335,0.034263,172.31.36.0-255,1514,183341,7,189732
14336,0.034265,172.31.36.0-255,1514,184855,7,189732
14337,0.034266,172.31.36.0-255,1514,186369,7,189732
14338,0.034272,172.31.36.0-255,1514,187883,7,189732
14339,0.034273,172.31.36.0-255,1514,189397,7,189732
14340,0.034274,172.31.36.0-255,71,189468,7,189732
14341,0.035746,104.244.42.0-255,66,189534,7,189732
14342,0.03579,104.244.42.0-255,66,189600,7,189732
14343,0.035849,104.244.42.0-255,66,189666,7,189732
14344,0.035854,104.244.42.0-255,66,189732,7,189732
14345,0.0,172.217.194.0-255,153,153,7,274255
14346,3.7e-05,172.31.36.0-255,66,219,7,274255
14347,4.5e-05,172.217.194.0-255,1484,1703,7,274255
14348,5e-05,172.31.36.0-255,66,1769,7,274255
14349,5.6e-05,172.217.194.0-255,2902,4671,7,274255
14350,5.8e-05,172.31.36.0-255,66,4737,7,274255
14351,6.6e-05,172.217.194.0-255,7156,11893,7,274255
14352,8.3e-05,172.31.36.0-255,66,11959,7,274255
14353,0.000105,172.217.194.0-255,2082,14041,7,274255
14354,0.000108,172.31.36.0-255,66,14107,7,274255
14355,0.000442,172.217.194.0-255,1484,15591,7,274255
14356,0.000447,172.31.36.0-255,66,15657,7,274255
14357,0.000454,172.217.194.0-255,2902,18559,7,274255
14358,0.000457,172.31.36.0-255,66,18625,7,274255
14359,0.000463,172.217.194.0-255,4320,22945,7,274255
14360,0.000465,172.31.36.0-255,66,23011,7,274255
14361,0.000511,172.217.194.0-255,4320,27331,7,274255
14362,0.000514,172.31.36.0-255,66,27397,7,274255
14363,0.000532,172.217.194.0-255,3961,31358,7,274255
14364,0.000536,172.31.36.0-255,66,31424,7,274255
14365,0.000596,172.217.194.0-255,1484,32908,7,274255
14366,0.000599,172.31.36.0-255,66,32974,7,274255
14367,0.000613,172.217.194.0-255,2902,35876,7,274255
14368,0.000616,172.31.36.0-255,66,35942,7,274255
14369,0.00064,172.217.194.0-255,5738,41680,7,274255
14370,0.000644,172.31.36.0-255,66,41746,7,274255
14371,0.000659,172.217.194.0-255,4320,46066,7,274255
14372,0.000663,172.31.36.0-255,66,46132,7,274255
14373,0.000679,172.217.194.0-255,5738,51870,7,274255
14374,0.000683,172.31.36.0-255,66,51936,7,274255
14375,0.000713,172.217.194.0-255,3961,55897,7,274255
14376,0.000716,172.31.36.0-255,66,55963,7,274255
14377,0.000727,172.31.36.0-255,66,56029,7,274255
14378,0.000983,172.217.194.0-255,365,56394,7,274255
14379,0.001209,172.217.194.0-255,1484,57878,7,274255
14380,0.001214,172.31.36.0-255,66,57944,7,274255
14381,0.001219,172.217.194.0-255,2902,60846,7,274255
14382,0.001221,172.31.36.0-255,66,60912,7,274255
14383,0.001236,172.217.194.0-255,2902,63814,7,274255
14384,0.001238,172.31.36.0-255,66,63880,7,274255
14385,0.001266,172.217.194.0-255,7156,71036,7,274255
14386,0.001269,172.31.36.0-255,66,71102,7,274255
14387,0.001275,172.217.194.0-255,5738,76840,7,274255
14388,0.001277,172.31.36.0-255,66,76906,7,274255
14389,0.001307,172.31.36.0-255,66,76972,7,274255
14390,0.001311,172.217.194.0-255,3602,80574,7,274255
14391,0.001313,172.31.36.0-255,66,80640,7,274255
14392,0.002414,172.217.194.0-255,1484,82124,7,274255
14393,0.002427,172.217.194.0-255,2902,85026,7,274255
14394,0.00243,172.31.36.0-255,66,85092,7,274255
14395,0.002433,172.217.194.0-255,1484,86576,7,274255
14396,0.002455,172.217.194.0-255,4320,90896,7,274255
14397,0.002458,172.31.36.0-255,66,90962,7,274255
14398,0.002464,172.217.194.0-255,5738,96700,7,274255
14399,0.002466,172.31.36.0-255,66,96766,7,274255
14400,0.002469,172.217.194.0-255,1484,98250,7,274255
14401,0.002499,172.31.36.0-255,66,98316,7,274255
14402,0.002504,172.217.194.0-255,5020,103336,7,274255
14403,0.002507,172.31.36.0-255,66,103402,7,274255
14404,0.005135,172.217.194.0-255,5738,109140,7,274255
14405,0.005142,172.31.36.0-255,66,109206,7,274255
14406,0.007791,172.217.194.0-255,5738,114944,7,274255
14407,0.007799,172.31.36.0-255,66,115010,7,274255
14408,0.010455,172.217.194.0-255,5738,120748,7,274255
14409,0.010462,172.31.36.0-255,66,120814,7,274255
14410,0.013056,172.217.194.0-255,5738,126552,7,274255
14411,0.013063,172.31.36.0-255,66,126618,7,274255
14412,0.015722,172.217.194.0-255,5738,132356,7,274255
14413,0.01573,172.31.36.0-255,66,132422,7,274255
14414,0.018324,172.217.194.0-255,5738,138160,7,274255
14415,0.018333,172.31.36.0-255,66,138226,7,274255
14416,0.020948,172.217.194.0-255,5738,143964,7,274255
14417,0.020956,172.31.36.0-255,66,144030,7,274255
14418,0.021315,172.31.36.0-255,164,144194,7,274255
14419,0.021356,172.31.36.0-255,1122,145316,7,274255
14420,0.021387,172.31.36.0-255,1514,146830,7,274255
14421,0.021389,172.31.36.0-255,1514,148344,7,274255
14422,0.021391,172.31.36.0-255,1514,149858,7,274255
14423,0.021392,172.31.36.0-255,105,149963,7,274255
14424,0.022886,104.244.42.0-255,66,150029,7,274255
14425,0.022935,104.244.42.0-255,66,150095,7,274255
14426,0.022982,104.244.42.0-255,66,150161,7,274255
14427,0.022984,104.244.42.0-255,66,150227,7,274255
14428,0.023581,172.217.194.0-255,5738,155965,7,274255
14429,0.023586,172.31.36.0-255,66,156031,7,274255
14430,0.02625,172.217.194.0-255,5738,161769,7,274255
14431,0.026256,172.31.36.0-255,66,161835,7,274255
14432,0.028864,172.217.194.0-255,5738,167573,7,274255
14433,0.02887,172.31.36.0-255,66,167639,7,274255
14434,0.031525,172.217.194.0-255,5738,173377,7,274255
14435,0.03153,172.31.36.0-255,66,173443,7,274255
14436,0.034114,172.217.194.0-255,1484,174927,7,274255
14437,0.034147,172.217.194.0-255,4320,179247,7,274255
14438,0.034152,172.31.36.0-255,66,179313,7,274255
14439,0.036762,172.217.194.0-255,5738,185051,7,274255
14440,0.036768,172.31.36.0-255,66,185117,7,274255
14441,0.039406,172.217.194.0-255,5738,190855,7,274255
14442,0.039411,172.31.36.0-255,66,190921,7,274255
14443,0.042055,172.217.194.0-255,4320,195241,7,274255
14444,0.042059,172.31.36.0-255,66,195307,7,274255
14445,0.042088,172.217.194.0-255,1484,196791,7,274255
14446,0.044704,172.217.194.0-255,4320,201111,7,274255
14447,0.044711,172.31.36.0-255,66,201177,7,274255
14448,0.047319,172.217.194.0-255,4320,205497,7,274255
14449,0.047324,172.31.36.0-255,66,205563,7,274255
14450,0.047356,172.217.194.0-255,1484,207047,7,274255
14451,0.049908,172.217.194.0-255,4320,211367,7,274255
14452,0.049913,172.31.36.0-255,66,211433,7,274255
14453,0.052543,172.217.194.0-255,5738,217171,7,274255
14454,0.052548,172.31.36.0-255,66,217237,7,274255
14455,0.055171,172.217.194.0-255,2902,220139,7,274255
14456,0.055177,172.31.36.0-255,66,220205,7,274255
14457,0.055207,172.217.194.0-255,2902,223107,7,274255
14458,0.05521,172.31.36.0-255,66,223173,7,274255
14459,0.057773,172.217.194.0-255,2902,226075,7,274255
14460,0.057779,172.31.36.0-255,66,226141,7,274255
14461,0.057888,172.217.194.0-255,2902,229043,7,274255
14462,0.057893,172.31.36.0-255,66,229109,7,274255
14463,0.060517,172.217.194.0-255,4320,233429,7,274255
14464,0.060522,172.31.36.0-255,66,233495,7,274255
14465,0.060548,172.217.194.0-255,1484,234979,7,274255
14466,0.063124,172.217.194.0-255,4320,239299,7,274255
14467,0.063129,172.31.36.0-255,66,239365,7,274255
14468,0.065729,172.217.194.0-255,5738,245103,7,274255
14469,0.065735,172.31.36.0-255,66,245169,7,274255
14470,0.068357,172.217.194.0-255,5738,250907,7,274255
14471,0.068362,172.31.36.0-255,66,250973,7,274255
14472,0.070998,172.217.194.0-255,5738,256711,7,274255
14473,0.071005,172.31.36.0-255,66,256777,7,274255
14474,0.073619,172.217.194.0-255,5738,262515,7,274255
14475,0.073624,172.31.36.0-255,66,262581,7,274255
14476,0.076261,172.217.194.0-255,5738,268319,7,274255
14477,0.076266,172.31.36.0-255,66,268385,7,274255
14478,0.078883,172.217.194.0-255,4320,272705,7,274255
14479,0.078888,172.31.36.0-255,66,272771,7,274255
14480,0.078919,172.217.194.0-255,1484,274255,7,274255
14481,0.0,74.125.68.0-255,325,325,7,281600
14482,2.3e-05,172.31.36.0-255,66,391,7,281600
14483,5.2e-05,74.125.68.0-255,1484,1875,7,281600
14484,5.6e-05,172.31.36.0-255,66,1941,7,281600
14485,6.4e-05,74.125.68.0-255,2902,4843,7,281600
14486,6.7e-05,172.31.36.0-255,66,4909,7,281600
14487,7.6e-05,74.125.68.0-255,5738,10647,7,281600
14488,7.8e-05,172.31.36.0-255,66,10713,7,281600
14489,8.4e-05,74.125.68.0-255,3384,14097,7,281600
14490,8.6e-05,172.31.36.0-255,66,14163,7,281600
14491,0.000126,74.125.68.0-255,1484,15647,7,281600
14492,0.000129,172.31.36.0-255,66,15713,7,281600
14493,0.000132,74.125.68.0-255,1484,17197,7,281600
14494,0.000134,172.31.36.0-255,66,17263,7,281600
14495,0.000148,74.125.68.0-255,1484,18747,7,281600
14496,0.000151,172.31.36.0-255,66,18813,7,281600
14497,0.000157,74.125.68.0-255,4320,23133,7,281600
14498,0.000159,172.31.36.0-255,66,23199,7,281600
14499,0.000172,74.125.68.0-255,1484,24683,7,281600
14500,0.000174,172.31.36.0-255,66,24749,7,281600
14501,0.000177,74.125.68.0-255,1484,26233,7,281600
14502,0.00018,172.31.36.0-255,66,26299,7,281600
14503,0.000206,74.125.68.0-255,5379,31678,7,281600
14504,0.000209,172.31.36.0-255,66,31744,7,281600
14505,0.000259,74.125.68.0-255,1484,33228,7,281600
14506,0.000262,172.31.36.0-255,66,33294,7,281600
14507,0.000276,74.125.68.0-255,2902,36196,7,281600
14508,0.000278,172.31.36.0-255,66,36262,7,281600
14509,0.000281,74.125.68.0-255,1484,37746,7,281600
14510,0.000283,172.31.36.0-255,66,37812,7,281600
14511,0.000305,74.125.68.0-255,2902,40714,7,281600
14512,0.000308,172.31.36.0-255,66,40780,7,281600
14513,0.00035,74.125.68.0-255,1484,42264,7,281600
14514,0.000367,74.125.68.0-255,6797,49061,7,281600
14515,0.000371,172.31.36.0-255,66,49127,7,281600
14516,0.000474,74.125.68.0-255,1484,50611,7,281600
14517,0.000478,74.125.68.0-255,1484,52095,7,281600
14518,0.000481,172.31.36.0-255,66,52161,7,281600
14519,0.000486,74.125.68.0-255,2902,55063,7,281600
14520,0.000488,172.31.36.0-255,66,55129,7,281600
14521,0.000517,74.125.68.0-255,5738,60867,7,281600
14522,0.00052,172.31.36.0-255,66,60933,7,281600
14523,0.000543,74.125.68.0-255,5712,66645,7,281600
14524,0.000546,172.31.36.0-255,66,66711,7,281600
14525,0.000549,74.125.68.0-255,345,67056,7,281600
14526,0.00115,74.125.68.0-255,1484,68540,7,281600
14527,0.001155,172.31.36.0-255,66,68606,7,281600
14528,0.001162,74.125.68.0-255,2902,71508,7,281600
14529,0.001164,172.31.36.0-255,66,71574,7,281600
14530,0.001188,74.125.68.0-255,5738,77312,7,281600
14531,0.00119,172.31.36.0-255,66,77378,7,281600
14532,0.001195,74.125.68.0-255,2902,80280,7,281600
14533,0.001197,172.31.36.0-255,66,80346,7,281600
14534,0.00123,172.31.36.0-255,66,80412,7,281600
14535,0.001271,172.31.36.0-255,66,80478,7,281600
14536,0.001274,74.125.68.0-255,766,81244,7,281600
14537,0.00155,172.31.36.0-255,66,81310,7,281600
14538,0.003535,74.125.68.0-255,4320,85630,7,281600
14539,0.003546,172.31.36.0-255,66,85696,7,281600
14540,0.003818,74.125.68.0-255,1484,87180,7,281600
14541,0.005808,74.125.68.0-255,4320,91500,7,281600
14542,0.005815,172.31.36.0-255,66,91566,7,281600
14543,0.008077,74.125.68.0-255,5738,97304,7,281600
14544,0.008085,172.31.36.0-255,66,97370,7,281600
14545,0.01037,74.125.68.0-255,5738,103108,7,281600
14546,0.010384,172.31.36.0-255,66,103174,7,281600
14547,0.012659,74.125.68.0-255,5738,108912,7,281600
14548,0.012675,172.31.36.0-255,66,108978,7,281600
14549,0.014958,74.125.68.0-255,5738,114716,7,281600
14550,0.014972,172.31.36.0-255,66,114782,7,281600
14551,0.017252,74.125.68.0-255,5738,120520,7,281600
14552,0.017268,172.31.36.0-255,66,120586,7,281600
14553,0.019544,74.125.68.0-255,5738,126324,7,281600
14554,0.019556,172.31.36.0-255,66,126390,7,281600
14555,0.021854,74.125.68.0-255,5738,132128,7,281600
14556,0.021873,172.31.36.0-255,66,132194,7,281600
14557,0.024142,74.125.68.0-255,5738,137932,7,281600
14558,0.024158,172.31.36.0-255,66,137998,7,281600
14559,0.026431,74.125.68.0-255,5738,143736,7,281600
14560,0.026445,172.31.36.0-255,66,143802,7,281600
14561,0.028715,74.125.68.0-255,5738,149540,7,281600
14562,0.028728,172.31.36.0-255,66,149606,7,281600
14563,0.030447,172.31.36.0-255,188,149794,7,281600
14564,0.030482,172.31.36.0-255,958,150752,7,281600
14565,0.030546,172.31.36.0-255,1514,152266,7,281600
14566,0.030548,172.31.36.0-255,1448,153714,7,281600
14567,0.031004,74.125.68.0-255,5738,159452,7,281600
14568,0.031013,172.31.36.0-255,66,159518,7,281600
14569,0.031982,104.244.42.0-255,66,159584,7,281600
14570,0.032078,104.244.42.0-255,66,159650,7,281600
14571,0.03213,104.244.42.0-255,66,159716,7,281600
14572,0.03327,74.125.68.0-255,5738,165454,7,281600
14573,0.033279,172.31.36.0-255,66,165520,7,281600
14574,0.035543,74.125.68.0-255,5738,171258,7,281600
14575,0.035552,172.31.36.0-255,66,171324,7,281600
14576,0.037808,74.125.68.0-255,5738,177062,7,281600
14577,0.037815,172.31.36.0-255,66,177128,7,281600
14578,0.040188,74.125.68.0-255,5738,182866,7,281600
14579,0.040197,172.31.36.0-255,66,182932,7,281600
14580,0.042474,74.125.68.0-255,5738,188670,7,281600
14581,0.042488,172.31.36.0-255,66,188736,7,281600
14582,0.044774,74.125.68.0-255,5738,194474,7,281600
14583,0.044787,172.31.36.0-255,66,194540,7,281600
14584,0.047064,74.125.68.0-255,5738,200278,7,281600
14585,0.047075,172.31.36.0-255,66,200344,7,281600
14586,0.049354,74.125.68.0-255,5738,206082,7,281600
14587,0.049364,172.31.36.0-255,66,206148,7,281600
14588,0.051631,74.125.68.0-255,5738,211886,7,281600
14589,0.051639,172.31.36.0-255,66,211952,7,281600
14590,0.053896,74.125.68.0-255,5738,217690,7,281600
14591,0.053906,172.31.36.0-255,66,217756,7,281600
14592,0.056167,74.125.68.0-255,5738,223494,7,281600
14593,0.056179,172.31.36.0-255,66,223560,7,281600
14594,0.058458,74.125.68.0-255,5738,229298,7,281600
14595,0.058468,172.31.36.0-255,66,229364,7,281600
14596,0.060745,74.125.68.0-255,5738,235102,7,281600
14597,0.060758,172.31.36.0-255,66,235168,7,281600
14598,0.063022,74.125.68.0-255,5738,240906,7,281600
14599,0.063031,172.31.36.0-255,66,240972,7,281600
14600,0.065316,74.125.68.0-255,5738,246710,7,281600
14601,0.065328,172.31.36.0-255,66,246776,7,281600
14602,0.067603,74.125.68.0-255,5738,252514,7,281600
14603,0.067614,172.31.36.0-255,66,252580,7,281600
14604,0.069942,74.125.68.0-255,5738,258318,7,281600
14605,0.069958,172.31.36.0-255,66,258384,7,281600
14606,0.072233,74.125.68.0-255,5738,264122,7,281600
14607,0.072242,172.31.36.0-255,66,264188,7,281600
14608,0.0745,74.125.68.0-255,5738,269926,7,281600
14609,0.074509,172.31.36.0-255,66,269992,7,281600
14610,0.076772,74.125.68.0-255,5738,275730,7,281600
14611,0.076783,172.31.36.0-255,66,275796,7,281600
14612,0.079045,74.125.68.0-255,5738,281534,7,281600
14613,0.079052,172.31.36.0-255,66,281600,7,281600
14614,0.0,172.31.36.0-255,105,105,7,525
14615,0.000224,172.31.36.0-255,90,195,7,525
14616,0.000234,172.31.36.0-255,66,261,7,525
14617,0.002516,74.125.24.0-255,66,327,7,525
14618,0.002528,74.125.24.0-255,66,393,7,525
14619,0.002534,172.31.36.0-255,66,459,7,525
14620,0.002547,74.125.24.0-255,66,525,7,525
14621,0.0,74.125.68.0-255,296,296,7,347659
14622,2.4e-05,172.31.36.0-255,66,362,7,347659
14623,3.1e-05,74.125.68.0-255,1484,1846,7,347659
14624,3.6e-05,172.31.36.0-255,66,1912,7,347659
14625,4.2e-05,74.125.68.0-255,2902,4814,7,347659
14626,5.4e-05,172.31.36.0-255,66,4880,7,347659
14627,6.2e-05,74.125.68.0-255,5738,10618,7,347659
14628,6.5e-05,172.31.36.0-255,66,10684,7,347659
14629,7e-05,74.125.68.0-255,3252,13936,7,347659
14630,7.4e-05,172.31.36.0-255,66,14002,7,347659
14631,0.0001,74.125.68.0-255,4320,18322,7,347659
14632,0.000104,172.31.36.0-255,66,18388,7,347659
14633,0.000115,74.125.68.0-255,5738,24126,7,347659
14634,0.000118,172.31.36.0-255,66,24192,7,347659
14635,0.000147,74.125.68.0-255,7156,31348,7,347659
14636,0.00015,172.31.36.0-255,66,31414,7,347659
14637,0.000174,74.125.68.0-255,4320,35734,7,347659
14638,0.000177,172.31.36.0-255,66,35800,7,347659
14639,0.000181,74.125.68.0-255,1484,37284,7,347659
14640,0.000183,172.31.36.0-255,66,37350,7,347659
14641,0.000219,74.125.68.0-255,4320,41670,7,347659
14642,0.000222,172.31.36.0-255,66,41736,7,347659
14643,0.00023,74.125.68.0-255,6438,48174,7,347659
14644,0.000232,172.31.36.0-255,66,48240,7,347659
14645,0.000254,74.125.68.0-255,1484,49724,7,347659
14646,0.000256,172.31.36.0-255,66,49790,7,347659
14647,0.000287,74.125.68.0-255,2902,52692,7,347659
14648,0.000289,172.31.36.0-255,66,52758,7,347659
14649,0.000296,74.125.68.0-255,5738,58496,7,347659
14650,0.000299,172.31.36.0-255,66,58562,7,347659
14651,0.000302,74.125.68.0-255,1484,60046,7,347659
14652,0.000304,172.31.36.0-255,66,60112,7,347659
14653,0.000341,74.125.68.0-255,5379,65491,7,347659
14654,0.000343,172.31.36.0-255,66,65557,7,347659
14655,0.000899,74.125.68.0-255,646,66203,7,347659
14656,0.001083,172.31.36.0-255,66,66269,7,347659
14657,0.001276,74.125.68.0-255,1484,67753,7,347659
14658,0.001282,172.31.36.0-255,66,67819,7,347659
14659,0.001291,74.125.68.0-255,2902,70721,7,347659
14660,0.001293,172.31.36.0-255,66,70787,7,347659
14661,0.001335,74.125.68.0-255,5738,76525,7,347659
14662,0.001341,74.125.68.0-255,2902,79427,7,347659
14663,0.001346,74.125.68.0-255,4320,83747,7,347659
14664,0.001384,74.125.68.0-255,5738,89485,7,347659
14665,0.0014,74.125.68.0-255,1484,90969,7,347659
14666,0.001414,74.125.68.0-255,5738,96707,7,347659
14667,0.001432,74.125.68.0-255,3053,99760,7,347659
14668,0.001527,74.125.68.0-255,1484,101244,7,347659
14669,0.001557,74.125.68.0-255,2902,104146,7,347659
14670,0.001581,74.125.68.0-255,5738,109884,7,347659
14671,0.001609,74.125.68.0-255,4320,114204,7,347659
14672,0.001625,74.125.68.0-255,2902,117106,7,347659
14673,0.00163,74.125.68.0-255,4320,121426,7,347659
14674,0.001684,74.125.68.0-255,2184,123610,7,347659
14675,0.002053,74.125.68.0-255,1484,125094,7,347659
14676,0.002063,74.125.68.0-255,2902,127996,7,347659
14677,0.002069,74.125.68.0-255,5738,133734,7,347659
14678,0.00212,74.125.68.0-255,4320,138054,7,347659
14679,0.002127,74.125.68.0-255,5738,143792,7,347659
14680,0.002141,74.125.68.0-255,2902,146694,7,347659
14681,0.002167,74.125.68.0-255,7156,153850,7,347659
14682,0.002194,74.125.68.0-255,3602,157452,7,347659
14683,0.007073,172.31.36.0-255,66,157518,7,347659
14684,0.009312,74.125.68.0-255,5738,163256,7,347659
14685,0.009319,172.31.36.0-255,66,163322,7,347659
14686,0.011553,74.125.68.0-255,5738,169060,7,347659
14687,0.011563,172.31.36.0-255,66,169126,7,347659
14688,0.013786,74.125.68.0-255,5738,174864,7,347659
14689,0.013795,172.31.36.0-255,66,174930,7,347659
14690,0.016032,74.125.68.0-255,5738,180668,7,347659
14691,0.016043,172.31.36.0-255,66,180734,7,347659
14692,0.01826,74.125.68.0-255,5738,186472,7,347659
14693,0.018266,172.31.36.0-255,66,186538,7,347659
14694,0.020486,74.125.68.0-255,5738,192276,7,347659
14695,0.020495,172.31.36.0-255,66,192342,7,347659
14696,0.022721,74.125.68.0-255,5738,198080,7,347659
14697,0.02273,172.31.36.0-255,66,198146,7,347659
14698,0.024964,74.125.68.0-255,5738,203884,7,347659
14699,0.024975,172.31.36.0-255,66,203950,7,347659
14700,0.027206,74.125.68.0-255,5738,209688,7,347659
14701,0.027213,172.31.36.0-255,66,209754,7,347659
14702,0.027788,172.31.36.0-255,172,209926,7,347659
14703,0.027861,172.31.36.0-255,1073,210999,7,347659
14704,0.029327,104.244.42.0-255,66,211065,7,347659
14705,0.0294,104.244.42.0-255,66,211131,7,347659
14706,0.02941,74.125.68.0-255,2902,214033,7,347659
14707,0.029414,172.31.36.0-255,66,214099,7,347659
14708,0.029447,74.125.68.0-255,2902,217001,7,347659
14709,0.029475,172.31.36.0-255,66,217067,7,347659
14710,0.031615,74.125.68.0-255,2902,219969,7,347659
14711,0.03162,172.31.36.0-255,66,220035,7,347659
14712,0.031666,74.125.68.0-255,2902,222937,7,347659
14713,0.031674,172.31.36.0-255,66,223003,7,347659
14714,0.033823,74.125.68.0-255,2902,225905,7,347659
14715,0.033828,172.31.36.0-255,66,225971,7,347659
14716,0.033885,74.125.68.0-255,2902,228873,7,347659
14717,0.033918,172.31.36.0-255,66,228939,7,347659
14718,0.036039,74.125.68.0-255,2902,231841,7,347659
14719,0.036045,172.31.36.0-255,66,231907,7,347659
14720,0.036159,74.125.68.0-255,2902,234809,7,347659
14721,0.036164,172.31.36.0-255,66,234875,7,347659
14722,0.038253,74.125.68.0-255,2902,237777,7,347659
14723,0.038258,172.31.36.0-255,66,237843,7,347659
14724,0.038383,74.125.68.0-255,2902,240745,7,347659
14725,0.038387,172.31.36.0-255,66,240811,7,347659
14726,0.040535,74.125.68.0-255,2902,243713,7,347659
14727,0.040542,172.31.36.0-255,66,243779,7,347659
14728,0.040612,74.125.68.0-255,2902,246681,7,347659
14729,0.04093,172.31.36.0-255,66,246747,7,347659
14730,0.042753,74.125.68.0-255,2902,249649,7,347659
14731,0.042759,172.31.36.0-255,66,249715,7,347659
14732,0.043138,74.125.68.0-255,2902,252617,7,347659
14733,0.043143,172.31.36.0-255,66,252683,7,347659
14734,0.044963,74.125.68.0-255,2902,255585,7,347659
14735,0.044968,172.31.36.0-255,66,255651,7,347659
14736,0.045353,74.125.68.0-255,2902,258553,7,347659
14737,0.045359,172.31.36.0-255,66,258619,7,347659
14738,0.047183,74.125.68.0-255,2902,261521,7,347659
14739,0.047188,172.31.36.0-255,66,261587,7,347659
14740,0.047564,74.125.68.0-255,2902,264489,7,347659
14741,0.047569,172.31.36.0-255,66,264555,7,347659
14742,0.049435,74.125.68.0-255,2902,267457,7,347659
14743,0.049441,172.31.36.0-255,66,267523,7,347659
14744,0.049777,74.125.68.0-255,2902,270425,7,347659
14745,0.049782,172.31.36.0-255,66,270491,7,347659
14746,0.051646,74.125.68.0-255,2902,273393,7,347659
14747,0.051651,172.31.36.0-255,66,273459,7,347659
14748,0.051982,74.125.68.0-255,2902,276361,7,347659
14749,0.051987,172.31.36.0-255,66,276427,7,347659
14750,0.053863,74.125.68.0-255,2902,279329,7,347659
14751,0.053869,172.31.36.0-255,66,279395,7,347659
14752,0.054186,74.125.68.0-255,2902,282297,7,347659
14753,0.054192,172.31.36.0-255,66,282363,7,347659
14754,0.05611,74.125.68.0-255,2902,285265,7,347659
14755,0.056115,172.31.36.0-255,66,285331,7,347659
14756,0.056396,74.125.68.0-255,2902,288233,7,347659
14757,0.056401,172.31.36.0-255,66,288299,7,347659
14758,0.058327,74.125.68.0-255,2902,291201,7,347659
14759,0.058334,172.31.36.0-255,66,291267,7,347659
14760,0.058616,74.125.68.0-255,2902,294169,7,347659
14761,0.058622,172.31.36.0-255,66,294235,7,347659
14762,0.060541,74.125.68.0-255,2902,297137,7,347659
14763,0.060546,172.31.36.0-255,66,297203,7,347659
14764,0.060832,74.125.68.0-255,2902,300105,7,347659
14765,0.060838,172.31.36.0-255,66,300171,7,347659
14766,0.062749,74.125.68.0-255,2902,303073,7,347659
14767,0.062755,172.31.36.0-255,66,303139,7,347659
14768,0.063053,74.125.68.0-255,2902,306041,7,347659
14769,0.063058,172.31.36.0-255,66,306107,7,347659
14770,0.064954,74.125.68.0-255,2902,309009,7,347659
14771,0.064959,172.31.36.0-255,66,309075,7,347659
14772,0.065297,74.125.68.0-255,2902,311977,7,347659
14773,0.065302,172.31.36.0-255,66,312043,7,347659
14774,0.067157,74.125.68.0-255,2902,314945,7,347659
14775,0.067162,172.31.36.0-255,66,315011,7,347659
14776,0.067515,74.125.68.0-255,2902,317913,7,347659
14777,0.06752,172.31.36.0-255,66,317979,7,347659
14778,0.069406,74.125.68.0-255,2902,320881,7,347659
14779,0.069412,172.31.36.0-255,66,320947,7,347659
14780,0.069768,74.125.68.0-255,2902,323849,7,347659
14781,0.069773,172.31.36.0-255,66,323915,7,347659
14782,0.071618,74.125.68.0-255,2902,326817,7,347659
14783,0.071624,172.31.36.0-255,66,326883,7,347659
14784,0.071977,74.125.68.0-255,2902,329785,7,347659
14785,0.071982,172.31.36.0-255,66,329851,7,347659
14786,0.073827,74.125.68.0-255,2902,332753,7,347659
14787,0.073832,172.31.36.0-255,66,332819,7,347659
14788,0.074188,74.125.68.0-255,2902,335721,7,347659
14789,0.074194,172.31.36.0-255,66,335787,7,347659
14790,0.076042,74.125.68.0-255,2902,338689,7,347659
14791,0.076047,172.31.36.0-255,66,338755,7,347659
14792,0.076397,74.125.68.0-255,2902,341657,7,347659
14793,0.076402,172.31.36.0-255,66,341723,7,347659
14794,0.078262,74.125.68.0-255,2902,344625,7,347659
14795,0.078283,172.31.36.0-255,66,344691,7,347659
14796,0.078612,74.125.68.0-255,2902,347593,7,347659
14797,0.078618,172.31.36.0-255,66,347659,7,347659
14798,0.0,74.125.68.0-255,143,143,7,342834
14799,2.3e-05,172.31.36.0-255,66,209,7,342834
14800,3e-05,74.125.68.0-255,1484,1693,7,342834
14801,3.4e-05,172.31.36.0-255,66,1759,7,342834
14802,3.9e-05,74.125.68.0-255,2902,4661,7,342834
14803,4.2e-05,172.31.36.0-255,66,4727,7,342834
14804,7.8e-05,74.125.68.0-255,7156,11883,7,342834
14805,8.2e-05,172.31.36.0-255,66,11949,7,342834
14806,8.6e-05,74.125.68.0-255,2085,14034,7,342834
14807,8.8e-05,172.31.36.0-255,66,14100,7,342834
14808,0.0002,74.125.68.0-255,1484,15584,7,342834
14809,0.000205,172.31.36.0-255,66,15650,7,342834
14810,0.000212,74.125.68.0-255,2902,18552,7,342834
14811,0.000215,172.31.36.0-255,66,18618,7,342834
14812,0.000219,74.125.68.0-255,1484,20102,7,342834
14813,0.000221,172.31.36.0-255,66,20168,7,342834
14814,0.000226,74.125.68.0-255,2902,23070,7,342834
14815,0.000228,172.31.36.0-255,66,23136,7,342834
14816,0.00025,74.125.68.0-255,5738,28874,7,342834
14817,0.000253,172.31.36.0-255,66,28940,7,342834
14818,0.000281,74.125.68.0-255,2543,31483,7,342834
14819,0.000284,172.31.36.0-255,66,31549,7,342834
14820,0.000289,74.125.68.0-255,2902,34451,7,342834
14821,0.000291,172.31.36.0-255,66,34517,7,342834
14822,0.000294,74.125.68.0-255,1484,36001,7,342834
14823,0.000297,172.31.36.0-255,66,36067,7,342834
14824,0.000325,74.125.68.0-255,5738,41805,7,342834
14825,0.000328,172.31.36.0-255,66,41871,7,342834
14826,0.000336,74.125.68.0-255,7156,49027,7,342834
14827,0.000338,172.31.36.0-255,66,49093,7,342834
14828,0.000344,74.125.68.0-255,4320,53413,7,342834
14829,0.000347,172.31.36.0-255,66,53479,7,342834
14830,0.000374,74.125.68.0-255,4320,57799,7,342834
14831,0.000377,172.31.36.0-255,66,57865,7,342834
14832,0.000388,172.31.36.0-255,66,57931,7,342834
14833,0.000401,74.125.68.0-255,395,58326,7,342834
14834,0.000445,74.125.68.0-255,348,58674,7,342834
14835,0.000531,74.125.68.0-255,1484,60158,7,342834
14836,0.000537,172.31.36.0-255,66,60224,7,342834
14837,0.000543,74.125.68.0-255,2902,63126,7,342834
14838,0.000546,172.31.36.0-255,66,63192,7,342834
14839,0.000579,74.125.68.0-255,5738,68930,7,342834
14840,0.000582,172.31.36.0-255,66,68996,7,342834
14841,0.000588,74.125.68.0-255,4320,73316,7,342834
14842,0.00059,172.31.36.0-255,66,73382,7,342834
14843,0.000597,74.125.68.0-255,5738,79120,7,342834
14844,0.000599,172.31.36.0-255,66,79186,7,342834
14845,0.000636,172.31.36.0-255,66,79252,7,342834
14846,0.000641,74.125.68.0-255,2184,81436,7,342834
14847,0.000644,172.31.36.0-255,66,81502,7,342834
14848,0.000866,74.125.68.0-255,1484,82986,7,342834
14849,0.000889,74.125.68.0-255,2902,85888,7,342834
14850,0.000894,172.31.36.0-255,66,85954,7,342834
14851,0.000899,74.125.68.0-255,2902,88856,7,342834
14852,0.000901,172.31.36.0-255,66,88922,7,342834
14853,0.000906,74.125.68.0-255,4320,93242,7,342834
14854,0.000909,172.31.36.0-255,66,93308,7,342834
14855,0.000945,172.31.36.0-255,66,93374,7,342834
14856,0.000952,74.125.68.0-255,5738,99112,7,342834
14857,0.000954,172.31.36.0-255,66,99178,7,342834
14858,0.000962,74.125.68.0-255,7156,106334,7,342834
14859,0.000964,172.31.36.0-255,66,106400,7,342834
14860,0.000976,74.125.68.0-255,766,107166,7,342834
14861,0.001881,74.125.68.0-255,1484,108650,7,342834
14862,0.001886,172.31.36.0-255,66,108716,7,342834
14863,0.001892,74.125.68.0-255,2902,111618,7,342834
14864,0.001894,172.31.36.0-255,66,111684,7,342834
14865,0.001897,74.125.68.0-255,1484,113168,7,342834
14866,0.001923,74.125.68.0-255,2902,116070,7,342834
14867,0.001926,172.31.36.0-255,66,116136,7,342834
14868,0.001932,74.125.68.0-255,4320,120456,7,342834
14869,0.001935,172.31.36.0-255,66,120522,7,342834
14870,0.001945,74.125.68.0-255,1484,122006,7,342834
14871,0.001974,172.31.36.0-255,66,122072,7,342834
14872,0.001982,74.125.68.0-255,7156,129228,7,342834
14873,0.001984,172.31.36.0-255,66,129294,7,342834
14874,0.002014,74.125.68.0-255,2902,132196,7,342834
14875,0.002017,172.31.36.0-255,66,132262,7,342834
14876,0.00202,74.125.68.0-255,766,133028,7,342834
14877,0.002243,74.125.68.0-255,1484,134512,7,342834
14878,0.002249,172.31.36.0-255,66,134578,7,342834
14879,0.002263,74.125.68.0-255,2902,137480,7,342834
14880,0.002266,172.31.36.0-255,66,137546,7,342834
14881,0.002271,74.125.68.0-255,4320,141866,7,342834
14882,0.002274,172.31.36.0-255,66,141932,7,342834
14883,0.002276,74.125.68.0-255,1484,143416,7,342834
14884,0.004527,74.125.68.0-255,4320,147736,7,342834
14885,0.004534,172.31.36.0-255,66,147802,7,342834
14886,0.006789,74.125.68.0-255,4320,152122,7,342834
14887,0.006791,172.31.36.0-255,66,152188,7,342834
14888,0.006808,74.125.68.0-255,1484,153672,7,342834
14889,0.009045,74.125.68.0-255,4320,157992,7,342834
14890,0.00905,172.31.36.0-255,66,158058,7,342834
14891,0.011321,74.125.68.0-255,5738,163796,7,342834
14892,0.01133,172.31.36.0-255,66,163862,7,342834
14893,0.013595,74.125.68.0-255,5738,169600,7,342834
14894,0.013604,172.31.36.0-255,66,169666,7,342834
14895,0.015868,74.125.68.0-255,5738,175404,7,342834
14896,0.015876,172.31.36.0-255,66,175470,7,342834
14897,0.018152,74.125.68.0-255,5738,181208,7,342834
14898,0.01816,172.31.36.0-255,66,181274,7,342834
14899,0.020422,74.125.68.0-255,5738,187012,7,342834
14900,0.020429,172.31.36.0-255,66,187078,7,342834
14901,0.022694,74.125.68.0-255,5738,192816,7,342834
14902,0.022702,172.31.36.0-255,66,192882,7,342834
14903,0.024971,74.125.68.0-255,5738,198620,7,342834
14904,0.024978,172.31.36.0-255,66,198686,7,342834
14905,0.025984,172.31.36.0-255,164,198850,7,342834
14906,0.026015,172.31.36.0-255,1121,199971,7,342834
14907,0.026073,172.31.36.0-255,1514,201485,7,342834
14908,0.026075,172.31.36.0-255,1285,202770,7,342834
14909,0.027259,74.125.68.0-255,5738,208508,7,342834
14910,0.027266,172.31.36.0-255,66,208574,7,342834
14911,0.027504,104.244.42.0-255,66,208640,7,342834
14912,0.027589,104.244.42.0-255,66,208706,7,342834
14913,0.027629,104.244.42.0-255,66,208772,7,342834
14914,0.028217,104.244.42.0-255,108,208880,7,342834
14915,0.028224,172.31.36.0-255,66,208946,7,342834
14916,0.02954,74.125.68.0-255,5738,214684,7,342834
14917,0.029544,172.31.36.0-255,66,214750,7,342834
14918,0.031833,74.125.68.0-255,5738,220488,7,342834
14919,0.03184,172.31.36.0-255,66,220554,7,342834
14920,0.034132,74.125.68.0-255,5738,226292,7,342834
14921,0.034139,172.31.36.0-255,66,226358,7,342834
14922,0.036407,74.125.68.0-255,5738,232096,7,342834
14923,0.036414,172.31.36.0-255,66,232162,7,342834
14924,0.038687,74.125.68.0-255,5738,237900,7,342834
14925,0.038694,172.31.36.0-255,66,237966,7,342834
14926,0.040969,74.125.68.0-255,5738,243704,7,342834
14927,0.040975,172.31.36.0-255,66,243770,7,342834
14928,0.04326,74.125.68.0-255,5738,249508,7,342834
14929,0.043266,172.31.36.0-255,66,249574,7,342834
14930,0.045536,74.125.68.0-255,5738,255312,7,342834
14931,0.045544,172.31.36.0-255,66,255378,7,342834
14932,0.047808,74.125.68.0-255,5738,261116,7,342834
14933,0.047814,172.31.36.0-255,66,261182,7,342834
14934,0.050079,74.125.68.0-255,5738,266920,7,342834
14935,0.050087,172.31.36.0-255,66,266986,7,342834
14936,0.052356,74.125.68.0-255,5738,272724,7,342834
14937,0.052362,172.31.36.0-255,66,272790,7,342834
14938,0.054625,74.125.68.0-255,5738,278528,7,342834
14939,0.05463,172.31.36.0-255,66,278594,7,342834
14940,0.056903,74.125.68.0-255,5738,284332,7,342834
14941,0.05691,172.31.36.0-255,66,284398,7,342834
14942,0.05918,74.125.68.0-255,5738,290136,7,342834
14943,0.059187,172.31.36.0-255,66,290202,7,342834
14944,0.06158,74.125.68.0-255,2902,293104,7,342834
14945,0.061587,172.31.36.0-255,66,293170,7,342834
14946,0.061606,74.125.68.0-255,2902,296072,7,342834
14947,0.061608,172.31.36.0-255,66,296138,7,342834
14948,0.063846,74.125.68.0-255,2902,299040,7,342834
14949,0.063853,172.31.36.0-255,66,299106,7,342834
14950,0.063872,74.125.68.0-255,2902,302008,7,342834
14951,0.063874,172.31.36.0-255,66,302074,7,342834
14952,0.066159,74.125.68.0-255,5738,307812,7,342834
14953,0.066165,172.31.36.0-255,66,307878,7,342834
14954,0.068466,74.125.68.0-255,5738,313616,7,342834
14955,0.068472,172.31.36.0-255,66,313682,7,342834
14956,0.070745,74.125.68.0-255,5738,319420,7,342834
14957,0.070752,172.31.36.0-255,66,319486,7,342834
14958,0.07303,74.125.68.0-255,5738,325224,7,342834
14959,0.073036,172.31.36.0-255,66,325290,7,342834
14960,0.075351,74.125.68.0-255,5738,331028,7,342834
14961,0.075357,172.31.36.0-255,66,331094,7,342834
14962,0.077631,74.125.68.0-255,5738,336832,7,342834
14963,0.077638,172.31.36.0-255,66,336898,7,342834
14964,0.079909,74.125.68.0-255,2902,339800,7,342834
14965,0.079915,172.31.36.0-255,66,339866,7,342834
14966,0.079923,74.125.68.0-255,2902,342768,7,342834
14967,0.079925,172.31.36.0-255,66,342834,7,342834
14968,0.0,172.217.194.0-255,147,147,7,280963
14969,1.6e-05,172.31.36.0-255,66,213,7,280963
14970,2.3e-05,172.217.194.0-255,1484,1697,7,280963
14971,2.7e-05,172.31.36.0-255,66,1763,7,280963
14972,3.4e-05,172.217.194.0-255,2902,4665,7,280963
14973,3.7e-05,172.31.36.0-255,66,4731,7,280963
14974,4.5e-05,172.217.194.0-255,5738,10469,7,280963
14975,4.8e-05,172.31.36.0-255,66,10535,7,280963
14976,9.7e-05,172.217.194.0-255,3420,13955,7,280963
14977,9.9e-05,172.31.36.0-255,66,14021,7,280963
14978,0.000533,172.217.194.0-255,1484,15505,7,280963
14979,0.000539,172.31.36.0-255,66,15571,7,280963
14980,0.000547,172.217.194.0-255,2902,18473,7,280963
14981,0.00055,172.31.36.0-255,66,18539,7,280963
14982,0.000557,172.217.194.0-255,5738,24277,7,280963
14983,0.000559,172.31.36.0-255,66,24343,7,280963
14984,0.000563,172.217.194.0-255,1484,25827,7,280963
14985,0.000565,172.31.36.0-255,66,25893,7,280963
14986,0.000587,172.217.194.0-255,5379,31272,7,280963
14987,0.000591,172.31.36.0-255,66,31338,7,280963
14988,0.000664,172.217.194.0-255,1484,32822,7,280963
14989,0.000667,172.31.36.0-255,66,32888,7,280963
14990,0.000685,172.217.194.0-255,2902,35790,7,280963
14991,0.000687,172.31.36.0-255,66,35856,7,280963
14992,0.000695,172.217.194.0-255,5738,41594,7,280963
14993,0.000698,172.31.36.0-255,66,41660,7,280963
14994,0.000747,172.31.36.0-255,66,41726,7,280963
14995,0.000807,172.217.194.0-255,7156,48882,7,280963
14996,0.000811,172.31.36.0-255,66,48948,7,280963
14997,0.000827,172.217.194.0-255,2859,51807,7,280963
14998,0.000829,172.31.36.0-255,66,51873,7,280963
14999,0.000938,172.217.194.0-255,364,52237,7,280963
15000,0.001284,172.217.194.0-255,1484,53721,7,280963
15001,0.001292,172.31.36.0-255,66,53787,7,280963
15002,0.001298,172.217.194.0-255,2902,56689,7,280963
15003,0.0013,172.31.36.0-255,66,56755,7,280963
15004,0.001307,172.217.194.0-255,5738,62493,7,280963
15005,0.00131,172.31.36.0-255,66,62559,7,280963
15006,0.001313,172.217.194.0-255,1484,64043,7,280963
15007,0.001341,172.31.36.0-255,66,64109,7,280963
15008,0.001758,172.217.194.0-255,1484,65593,7,280963
15009,0.001764,172.217.194.0-255,2902,68495,7,280963
15010,0.00177,172.217.194.0-255,4320,72815,7,280963
15011,0.001784,172.217.194.0-255,1484,74299,7,280963
15012,0.00179,172.217.194.0-255,5738,80037,7,280963
15013,0.001839,172.217.194.0-255,5020,85057,7,280963
15014,0.002962,172.31.36.0-255,66,85123,7,280963
15015,0.005232,172.217.194.0-255,5738,90861,7,280963
15016,0.005239,172.31.36.0-255,66,90927,7,280963
15017,0.007542,172.217.194.0-255,5738,96665,7,280963
15018,0.007549,172.31.36.0-255,66,96731,7,280963
15019,0.009826,172.217.194.0-255,5738,102469,7,280963
15020,0.009834,172.31.36.0-255,66,102535,7,280963
15021,0.012144,172.217.194.0-255,5738,108273,7,280963
15022,0.012152,172.31.36.0-255,66,108339,7,280963
15023,0.014455,172.217.194.0-255,5738,114077,7,280963
15024,0.014462,172.31.36.0-255,66,114143,7,280963
15025,0.016747,172.217.194.0-255,5738,119881,7,280963
15026,0.016757,172.31.36.0-255,66,119947,7,280963
15027,0.019064,172.217.194.0-255,5738,125685,7,280963
15028,0.019071,172.31.36.0-255,66,125751,7,280963
15029,0.021366,172.217.194.0-255,5738,131489,7,280963
15030,0.021374,172.31.36.0-255,66,131555,7,280963
15031,0.023674,172.217.194.0-255,5738,137293,7,280963
15032,0.023683,172.31.36.0-255,66,137359,7,280963
15033,0.026034,172.217.194.0-255,5738,143097,7,280963
15034,0.026042,172.31.36.0-255,66,143163,7,280963
15035,0.028344,172.217.194.0-255,5738,148901,7,280963
15036,0.02835,172.31.36.0-255,66,148967,7,280963
15037,0.029004,172.31.36.0-255,188,149155,7,280963
15038,0.029037,172.31.36.0-255,958,150113,7,280963
15039,0.029097,172.31.36.0-255,1514,151627,7,280963
15040,0.029099,172.31.36.0-255,1450,153077,7,280963
15041,0.030548,104.244.42.0-255,66,153143,7,280963
15042,0.030613,172.217.194.0-255,5738,158881,7,280963
15043,0.030618,172.31.36.0-255,66,158947,7,280963
15044,0.030626,104.244.42.0-255,66,159013,7,280963
15045,0.03065,104.244.42.0-255,66,159079,7,280963
15046,0.032873,172.217.194.0-255,5738,164817,7,280963
15047,0.03288,172.31.36.0-255,66,164883,7,280963
15048,0.035175,172.217.194.0-255,5738,170621,7,280963
15049,0.035183,172.31.36.0-255,66,170687,7,280963
15050,0.037482,172.217.194.0-255,5738,176425,7,280963
15051,0.037489,172.31.36.0-255,66,176491,7,280963
15052,0.039781,172.217.194.0-255,5738,182229,7,280963
15053,0.039791,172.31.36.0-255,66,182295,7,280963
15054,0.042122,172.217.194.0-255,5738,188033,7,280963
15055,0.042129,172.31.36.0-255,66,188099,7,280963
15056,0.044414,172.217.194.0-255,5738,193837,7,280963
15057,0.044421,172.31.36.0-255,66,193903,7,280963
15058,0.046691,172.217.194.0-255,5738,199641,7,280963
15059,0.046697,172.31.36.0-255,66,199707,7,280963
15060,0.049002,172.217.194.0-255,5738,205445,7,280963
15061,0.049008,172.31.36.0-255,66,205511,7,280963
15062,0.051307,172.217.194.0-255,5738,211249,7,280963
15063,0.051313,172.31.36.0-255,66,211315,7,280963
15064,0.053608,172.217.194.0-255,5738,217053,7,280963
15065,0.053615,172.31.36.0-255,66,217119,7,280963
15066,0.055927,172.217.194.0-255,5738,222857,7,280963
15067,0.055933,172.31.36.0-255,66,222923,7,280963
15068,0.05824,172.217.194.0-255,5738,228661,7,280963
15069,0.058246,172.31.36.0-255,66,228727,7,280963
15070,0.060516,172.217.194.0-255,5738,234465,7,280963
15071,0.060522,172.31.36.0-255,66,234531,7,280963
15072,0.062813,172.217.194.0-255,5738,240269,7,280963
15073,0.062819,172.31.36.0-255,66,240335,7,280963
15074,0.065131,172.217.194.0-255,5738,246073,7,280963
15075,0.065138,172.31.36.0-255,66,246139,7,280963
15076,0.067452,172.217.194.0-255,5738,251877,7,280963
15077,0.067457,172.31.36.0-255,66,251943,7,280963
15078,0.069761,172.217.194.0-255,5738,257681,7,280963
15079,0.069766,172.31.36.0-255,66,257747,7,280963
15080,0.072085,172.217.194.0-255,5738,263485,7,280963
15081,0.072092,172.31.36.0-255,66,263551,7,280963
15082,0.074372,172.217.194.0-255,5738,269289,7,280963
15083,0.074379,172.31.36.0-255,66,269355,7,280963
15084,0.076684,172.217.194.0-255,5738,275093,7,280963
15085,0.076691,172.31.36.0-255,66,275159,7,280963
15086,0.078971,172.217.194.0-255,5738,280897,7,280963
15087,0.078977,172.31.36.0-255,66,280963,7,280963
15088,0.0,172.217.194.0-255,153,153,7,290048
15089,2.7e-05,172.31.36.0-255,66,219,7,290048
15090,3.5e-05,172.217.194.0-255,1484,1703,7,290048
15091,4e-05,172.31.36.0-255,66,1769,7,290048
15092,4.5e-05,172.217.194.0-255,2902,4671,7,290048
15093,4.8e-05,172.31.36.0-255,66,4737,7,290048
15094,5.6e-05,172.217.194.0-255,7156,11893,7,290048
15095,5.9e-05,172.31.36.0-255,66,11959,7,290048
15096,0.0001,172.31.36.0-255,66,12025,7,290048
15097,0.000133,172.217.194.0-255,3961,15986,7,290048
15098,0.000136,172.31.36.0-255,66,16052,7,290048
15099,0.000166,172.217.194.0-255,1484,17536,7,290048
15100,0.000169,172.31.36.0-255,66,17602,7,290048
15101,0.000175,172.217.194.0-255,2902,20504,7,290048
15102,0.000178,172.31.36.0-255,66,20570,7,290048
15103,0.000183,172.217.194.0-255,2902,23472,7,290048
15104,0.000185,172.31.36.0-255,66,23538,7,290048
15105,0.000208,172.217.194.0-255,2902,26440,7,290048
15106,0.000211,172.31.36.0-255,66,26506,7,290048
15107,0.000226,172.31.36.0-255,66,26572,7,290048
15108,0.000251,172.217.194.0-255,2543,29115,7,290048
15109,0.000254,172.31.36.0-255,66,29181,7,290048
15110,0.000264,172.31.36.0-255,66,29247,7,290048
15111,0.000267,172.217.194.0-255,1125,30372,7,290048
15112,0.000269,172.31.36.0-255,66,30438,7,290048
15113,0.000849,172.217.194.0-255,646,31084,7,290048
15114,0.000855,172.31.36.0-255,66,31150,7,290048
15115,0.001772,172.217.194.0-255,1484,32634,7,290048
15116,0.001779,172.31.36.0-255,66,32700,7,290048
15117,0.001784,172.217.194.0-255,2902,35602,7,290048
15118,0.001787,172.31.36.0-255,66,35668,7,290048
15119,0.001805,172.217.194.0-255,5738,41406,7,290048
15120,0.001807,172.31.36.0-255,66,41472,7,290048
15121,0.001831,172.217.194.0-255,5738,47210,7,290048
15122,0.001833,172.31.36.0-255,66,47276,7,290048
15123,0.001854,172.217.194.0-255,7156,54432,7,290048
15124,0.001856,172.31.36.0-255,66,54498,7,290048
15125,0.001859,172.217.194.0-255,1484,55982,7,290048
15126,0.001875,172.217.194.0-255,4320,60302,7,290048
15127,0.001877,172.31.36.0-255,66,60368,7,290048
15128,0.001901,172.217.194.0-255,5020,65388,7,290048
15129,0.001903,172.31.36.0-255,66,65454,7,290048
15130,0.002281,172.217.194.0-255,1484,66938,7,290048
15131,0.002293,172.217.194.0-255,2902,69840,7,290048
15132,0.002296,172.31.36.0-255,66,69906,7,290048
15133,0.002301,172.217.194.0-255,4320,74226,7,290048
15134,0.002303,172.31.36.0-255,66,74292,7,290048
15135,0.002314,172.217.194.0-255,1484,75776,7,290048
15136,0.002326,172.217.194.0-255,4320,80096,7,290048
15137,0.002328,172.31.36.0-255,66,80162,7,290048
15138,0.002353,172.31.36.0-255,66,80228,7,290048
15139,0.00236,172.217.194.0-255,7156,87384,7,290048
15140,0.002361,172.31.36.0-255,66,87450,7,290048
15141,0.002381,172.217.194.0-255,3602,91052,7,290048
15142,0.002383,172.31.36.0-255,66,91118,7,290048
15143,0.002437,172.217.194.0-255,1484,92602,7,290048
15144,0.002451,172.217.194.0-255,2902,95504,7,290048
15145,0.002453,172.31.36.0-255,66,95570,7,290048
15146,0.002475,172.217.194.0-255,5738,101308,7,290048
15147,0.002477,172.31.36.0-255,66,101374,7,290048
15148,0.002482,172.217.194.0-255,4320,105694,7,290048
15149,0.002483,172.31.36.0-255,66,105760,7,290048
15150,0.00251,172.31.36.0-255,66,105826,7,290048
15151,0.002552,172.217.194.0-255,5738,111564,7,290048
15152,0.002554,172.31.36.0-255,66,111630,7,290048
15153,0.002574,172.217.194.0-255,5020,116650,7,290048
15154,0.002577,172.31.36.0-255,66,116716,7,290048
15155,0.002624,172.31.36.0-255,66,116782,7,290048
15156,0.002647,172.217.194.0-255,2902,119684,7,290048
15157,0.002649,172.31.36.0-255,66,119750,7,290048
15158,0.002662,172.31.36.0-255,66,119816,7,290048
15159,0.002664,172.217.194.0-255,1484,121300,7,290048
15160,0.005238,172.217.194.0-255,4320,125620,7,290048
15161,0.005243,172.31.36.0-255,66,125686,7,290048
15162,0.007817,172.217.194.0-255,5738,131424,7,290048
15163,0.007825,172.31.36.0-255,66,131490,7,290048
15164,0.010402,172.217.194.0-255,5738,137228,7,290048
15165,0.010414,172.31.36.0-255,66,137294,7,290048
15166,0.013005,172.217.194.0-255,5738,143032,7,290048
15167,0.013017,172.31.36.0-255,66,143098,7,290048
15168,0.015586,172.217.194.0-255,5738,148836,7,290048
15169,0.015599,172.31.36.0-255,66,148902,7,290048
15170,0.018186,172.217.194.0-255,5738,154640,7,290048
15171,0.018199,172.31.36.0-255,66,154706,7,290048
15172,0.020777,172.217.194.0-255,5738,160444,7,290048
15173,0.020785,172.31.36.0-255,66,160510,7,290048
15174,0.023358,172.217.194.0-255,5738,166248,7,290048
15175,0.023366,172.31.36.0-255,66,166314,7,290048
15176,0.025934,172.217.194.0-255,5738,172052,7,290048
15177,0.025942,172.31.36.0-255,66,172118,7,290048
15178,0.028497,172.217.194.0-255,5738,177856,7,290048
15179,0.028508,172.31.36.0-255,66,177922,7,290048
15180,0.029119,172.31.36.0-255,172,178094,7,290048
15181,0.029408,172.31.36.0-255,1116,179210,7,290048
15182,0.029489,172.31.36.0-255,1514,180724,7,290048
15183,0.029492,172.31.36.0-255,1290,182014,7,290048
15184,0.030685,104.244.42.0-255,66,182080,7,290048
15185,0.030971,104.244.42.0-255,66,182146,7,290048
15186,0.031047,172.217.194.0-255,2902,185048,7,290048
15187,0.031051,172.31.36.0-255,66,185114,7,290048
15188,0.031077,104.244.42.0-255,66,185180,7,290048
15189,0.031092,172.217.194.0-255,2902,188082,7,290048
15190,0.031095,172.31.36.0-255,66,188148,7,290048
15191,0.03363,172.217.194.0-255,2902,191050,7,290048
15192,0.033635,172.31.36.0-255,66,191116,7,290048
15193,0.033663,172.217.194.0-255,2902,194018,7,290048
15194,0.033666,172.31.36.0-255,66,194084,7,290048
15195,0.03621,172.217.194.0-255,4320,198404,7,290048
15196,0.036215,172.31.36.0-255,66,198470,7,290048
15197,0.036244,172.217.194.0-255,1484,199954,7,290048
15198,0.038764,172.217.194.0-255,4320,204274,7,290048
15199,0.03877,172.31.36.0-255,66,204340,7,290048
15200,0.041344,172.217.194.0-255,5738,210078,7,290048
15201,0.041351,172.31.36.0-255,66,210144,7,290048
15202,0.043915,172.217.194.0-255,5738,215882,7,290048
15203,0.043922,172.31.36.0-255,66,215948,7,290048
15204,0.046497,172.217.194.0-255,5738,221686,7,290048
15205,0.046503,172.31.36.0-255,66,221752,7,290048
15206,0.049069,172.217.194.0-255,5738,227490,7,290048
15207,0.049075,172.31.36.0-255,66,227556,7,290048
15208,0.051662,172.217.194.0-255,5738,233294,7,290048
15209,0.051667,172.31.36.0-255,66,233360,7,290048
15210,0.054208,172.217.194.0-255,5738,239098,7,290048
15211,0.054213,172.31.36.0-255,66,239164,7,290048
15212,0.056783,172.217.194.0-255,5738,244902,7,290048
15213,0.056789,172.31.36.0-255,66,244968,7,290048
15214,0.05936,172.217.194.0-255,5738,250706,7,290048
15215,0.059366,172.31.36.0-255,66,250772,7,290048
15216,0.061947,172.217.194.0-255,5738,256510,7,290048
15217,0.061952,172.31.36.0-255,66,256576,7,290048
15218,0.06464,172.217.194.0-255,5738,262314,7,290048
15219,0.064645,172.31.36.0-255,66,262380,7,290048
15220,0.067213,172.217.194.0-255,5738,268118,7,290048
15221,0.067219,172.31.36.0-255,66,268184,7,290048
15222,0.0698,172.217.194.0-255,5738,273922,7,290048
15223,0.069806,172.31.36.0-255,66,273988,7,290048
15224,0.072356,172.217.194.0-255,4320,278308,7,290048
15225,0.07236,172.31.36.0-255,66,278374,7,290048
15226,0.072385,172.217.194.0-255,1484,279858,7,290048
15227,0.074934,172.217.194.0-255,4320,284178,7,290048
15228,0.07494,172.31.36.0-255,66,284244,7,290048
15229,0.077521,172.217.194.0-255,5738,289982,7,290048
15230,0.077526,172.31.36.0-255,66,290048,7,290048
15231,0.0,172.217.194.0-255,169,169,7,187367
15232,2.7e-05,172.31.36.0-255,66,235,7,187367
15233,3.4e-05,172.217.194.0-255,1484,1719,7,187367
15234,3.8e-05,172.31.36.0-255,66,1785,7,187367
15235,4.3e-05,172.217.194.0-255,2902,4687,7,187367
15236,4.5e-05,172.31.36.0-255,66,4753,7,187367
15237,5.8e-05,172.217.194.0-255,7156,11909,7,187367
15238,6.1e-05,172.31.36.0-255,66,11975,7,187367
15239,6.7e-05,172.217.194.0-255,5738,17713,7,187367
15240,7e-05,172.31.36.0-255,66,17779,7,187367
15241,8.4e-05,172.217.194.0-255,2028,19807,7,187367
15242,8.6e-05,172.31.36.0-255,66,19873,7,187367
15243,0.000103,172.31.36.0-255,66,19939,7,187367
15244,0.000106,172.217.194.0-255,2543,22482,7,187367
15245,0.000108,172.31.36.0-255,66,22548,7,187367
15246,0.000206,172.217.194.0-255,1484,24032,7,187367
15247,0.00021,172.31.36.0-255,66,24098,7,187367
15248,0.000215,172.217.194.0-255,2902,27000,7,187367
15249,0.000218,172.31.36.0-255,66,27066,7,187367
15250,0.000223,172.217.194.0-255,5738,32804,7,187367
15251,0.000225,172.31.36.0-255,66,32870,7,187367
15252,0.000253,172.217.194.0-255,7156,40026,7,187367
15253,0.000256,172.31.36.0-255,66,40092,7,187367
15254,0.000286,172.217.194.0-255,6797,46889,7,187367
15255,0.000289,172.31.36.0-255,66,46955,7,187367
15256,0.000298,172.31.36.0-255,66,47021,7,187367
15257,0.000325,172.217.194.0-255,1414,48435,7,187367
15258,0.000328,172.31.36.0-255,66,48501,7,187367
15259,0.0005,172.217.194.0-255,100,48601,7,187367
15260,0.000504,172.31.36.0-255,66,48667,7,187367
15261,0.000585,172.217.194.0-255,1484,50151,7,187367
15262,0.000591,172.217.194.0-255,2902,53053,7,187367
15263,0.000594,172.31.36.0-255,66,53119,7,187367
15264,0.000598,172.217.194.0-255,2902,56021,7,187367
15265,0.000601,172.31.36.0-255,66,56087,7,187367
15266,0.000623,172.217.194.0-255,2902,58989,7,187367
15267,0.000625,172.31.36.0-255,66,59055,7,187367
15268,0.000631,172.217.194.0-255,6797,65852,7,187367
15269,0.000633,172.31.36.0-255,66,65918,7,187367
15270,0.000702,172.31.36.0-255,66,65984,7,187367
15271,0.000724,172.217.194.0-255,1484,67468,7,187367
15272,0.000729,172.217.194.0-255,2543,70011,7,187367
15273,0.000732,172.31.36.0-255,66,70077,7,187367
15274,0.000868,172.217.194.0-255,1484,71561,7,187367
15275,0.00088,172.217.194.0-255,2902,74463,7,187367
15276,0.000883,172.31.36.0-255,66,74529,7,187367
15277,0.000888,172.217.194.0-255,4320,78849,7,187367
15278,0.00089,172.31.36.0-255,66,78915,7,187367
15279,0.000906,172.217.194.0-255,1484,80399,7,187367
15280,0.000924,172.217.194.0-255,7156,87555,7,187367
15281,0.000927,172.31.36.0-255,66,87621,7,187367
15282,0.000954,172.217.194.0-255,5738,93359,7,187367
15283,0.000957,172.31.36.0-255,66,93425,7,187367
15284,0.000966,172.31.36.0-255,66,93491,7,187367
15285,0.000973,172.217.194.0-255,766,94257,7,187367
15286,0.001008,172.217.194.0-255,1484,95741,7,187367
15287,0.00101,172.31.36.0-255,66,95807,7,187367
15288,0.001036,172.217.194.0-255,4320,100127,7,187367
15289,0.001039,172.31.36.0-255,66,100193,7,187367
15290,0.001042,172.217.194.0-255,1484,101677,7,187367
15291,0.001048,172.217.194.0-255,7156,108833,7,187367
15292,0.00105,172.31.36.0-255,66,108899,7,187367
15293,0.001076,172.217.194.0-255,2902,111801,7,187367
15294,0.001078,172.31.36.0-255,66,111867,7,187367
15295,0.001098,172.217.194.0-255,7156,119023,7,187367
15296,0.0011,172.31.36.0-255,66,119089,7,187367
15297,0.001141,172.31.36.0-255,66,119155,7,187367
15298,0.001154,172.31.36.0-255,66,119221,7,187367
15299,0.00118,172.217.194.0-255,1484,120705,7,187367
15300,0.001193,172.31.36.0-255,66,120771,7,187367
15301,0.001196,172.217.194.0-255,1484,122255,7,187367
15302,0.001233,172.31.36.0-255,66,122321,7,187367
15303,0.001258,172.217.194.0-255,5020,127341,7,187367
15304,0.001262,172.31.36.0-255,66,127407,7,187367
15305,0.001264,172.217.194.0-255,1484,128891,7,187367
15306,0.001268,172.217.194.0-255,2902,131793,7,187367
15307,0.00127,172.31.36.0-255,66,131859,7,187367
15308,0.001298,172.217.194.0-255,4320,136179,7,187367
15309,0.001301,172.31.36.0-255,66,136245,7,187367
15310,0.001316,172.217.194.0-255,1484,137729,7,187367
15311,0.001319,172.217.194.0-255,1484,139213,7,187367
15312,0.001321,172.31.36.0-255,66,139279,7,187367
15313,0.001368,172.217.194.0-255,2902,142181,7,187367
15314,0.001371,172.31.36.0-255,66,142247,7,187367
15315,0.001399,172.31.36.0-255,66,142313,7,187367
15316,0.001409,172.31.36.0-255,66,142379,7,187367
15317,0.001435,172.217.194.0-255,1484,143863,7,187367
15318,0.001439,172.217.194.0-255,2902,146765,7,187367
15319,0.001443,172.31.36.0-255,66,146831,7,187367
15320,0.00147,172.217.194.0-255,5738,152569,7,187367
15321,0.001473,172.31.36.0-255,66,152635,7,187367
15322,0.001548,172.31.36.0-255,66,152701,7,187367
15323,0.001558,172.31.36.0-255,66,152767,7,187367
15324,0.001567,172.217.194.0-255,2184,154951,7,187367
15325,0.001569,172.31.36.0-255,66,155017,7,187367
15326,0.001605,172.217.194.0-255,1484,156501,7,187367
15327,0.001618,172.217.194.0-255,2902,159403,7,187367
15328,0.001621,172.31.36.0-255,66,159469,7,187367
15329,0.001626,172.217.194.0-255,4320,163789,7,187367
15330,0.001629,172.31.36.0-255,66,163855,7,187367
15331,0.001644,172.217.194.0-255,1484,165339,7,187367
15332,0.001649,172.217.194.0-255,2902,168241,7,187367
15333,0.001651,172.31.36.0-255,66,168307,7,187367
15334,0.001683,172.31.36.0-255,66,168373,7,187367
15335,0.001725,172.31.36.0-255,66,168439,7,187367
15336,0.001735,172.31.36.0-255,66,168505,7,187367
15337,0.001758,172.217.194.0-255,2902,171407,7,187367
15338,0.00176,172.31.36.0-255,66,171473,7,187367
15339,0.001763,172.217.194.0-255,1484,172957,7,187367
15340,0.001801,172.31.36.0-255,66,173023,7,187367
15341,0.001827,172.31.36.0-255,66,173089,7,187367
15342,0.001838,172.31.36.0-255,66,173155,7,187367
15343,0.001871,172.31.36.0-255,66,173221,7,187367
15344,0.001876,172.217.194.0-255,4546,177767,7,187367
15345,0.001878,172.31.36.0-255,66,177833,7,187367
15346,0.001906,172.217.194.0-255,105,177938,7,187367
15347,0.003271,172.31.36.0-255,66,178004,7,187367
15348,0.003299,172.31.36.0-255,105,178109,7,187367
15349,0.005347,172.217.194.0-255,66,178175,7,187367
15350,0.034698,172.31.36.0-255,172,178347,7,187367
15351,0.034727,172.31.36.0-255,1113,179460,7,187367
15352,0.034771,172.31.36.0-255,1514,180974,7,187367
15353,0.034772,172.31.36.0-255,1514,182488,7,187367
15354,0.034774,172.31.36.0-255,1514,184002,7,187367
15355,0.034779,172.31.36.0-255,1514,185516,7,187367
15356,0.03478,172.31.36.0-255,1514,187030,7,187367
15357,0.034781,172.31.36.0-255,73,187103,7,187367
15358,0.036241,104.244.42.0-255,66,187169,7,187367
15359,0.036308,104.244.42.0-255,66,187235,7,187367
15360,0.03631,104.244.42.0-255,66,187301,7,187367
15361,0.036321,104.244.42.0-255,66,187367,7,187367
15362,0.0,74.125.200.0-255,146,146,7,359188
15363,2.7e-05,172.31.36.0-255,66,212,7,359188
15364,3.6e-05,74.125.200.0-255,1484,1696,7,359188
15365,4.1e-05,172.31.36.0-255,66,1762,7,359188
15366,4.8e-05,74.125.200.0-255,2902,4664,7,359188
15367,5.2e-05,172.31.36.0-255,66,4730,7,359188
15368,6e-05,74.125.200.0-255,5738,10468,7,359188
15369,6.3e-05,172.31.36.0-255,66,10534,7,359188
15370,6.8e-05,74.125.200.0-255,3490,14024,7,359188
15371,7.1e-05,172.31.36.0-255,66,14090,7,359188
15372,9.1e-05,74.125.200.0-255,4320,18410,7,359188
15373,9.5e-05,172.31.36.0-255,66,18476,7,359188
15374,0.000122,74.125.200.0-255,7156,25632,7,359188
15375,0.000124,172.31.36.0-255,66,25698,7,359188
15376,0.000172,74.125.200.0-255,5379,31077,7,359188
15377,0.000174,172.31.36.0-255,66,31143,7,359188
15378,0.000291,74.125.200.0-255,1484,32627,7,359188
15379,0.000295,172.31.36.0-255,66,32693,7,359188
15380,0.000301,74.125.200.0-255,2902,35595,7,359188
15381,0.000303,172.31.36.0-255,66,35661,7,359188
15382,0.000315,74.125.200.0-255,1484,37145,7,359188
15383,0.000318,172.31.36.0-255,66,37211,7,359188
15384,0.000345,74.125.200.0-255,2902,40113,7,359188
15385,0.000348,172.31.36.0-255,66,40179,7,359188
15386,0.000352,74.125.200.0-255,2902,43081,7,359188
15387,0.000354,172.31.36.0-255,66,43147,7,359188
15388,0.000367,74.125.200.0-255,2902,46049,7,359188
15389,0.00037,172.31.36.0-255,66,46115,7,359188
15390,0.000375,74.125.200.0-255,2543,48658,7,359188
15391,0.000377,172.31.36.0-255,66,48724,7,359188
15392,0.000464,74.125.200.0-255,7156,55880,7,359188
15393,0.000469,172.31.36.0-255,66,55946,7,359188
15394,0.000479,74.125.200.0-255,2902,58848,7,359188
15395,0.000481,172.31.36.0-255,66,58914,7,359188
15396,0.000501,74.125.200.0-255,1484,60398,7,359188
15397,0.000503,172.31.36.0-255,66,60464,7,359188
15398,0.00051,74.125.200.0-255,5656,66120,7,359188
15399,0.000512,172.31.36.0-255,66,66186,7,359188
15400,0.000532,74.125.200.0-255,127,66313,7,359188
15401,0.000534,172.31.36.0-255,66,66379,7,359188
15402,0.000616,74.125.200.0-255,347,66726,7,359188
15403,0.00062,172.31.36.0-255,66,66792,7,359188
15404,0.001223,74.125.200.0-255,1484,68276,7,359188
15405,0.00123,172.31.36.0-255,66,68342,7,359188
15406,0.001235,74.125.200.0-255,1484,69826,7,359188
15407,0.001238,172.31.36.0-255,66,69892,7,359188
15408,0.001252,74.125.200.0-255,1484,71376,7,359188
15409,0.001255,172.31.36.0-255,66,71442,7,359188
15410,0.001293,74.125.200.0-255,1484,72926,7,359188
15411,0.001296,172.31.36.0-255,66,72992,7,359188
15412,0.001313,74.125.200.0-255,2902,75894,7,359188
15413,0.001316,172.31.36.0-255,66,75960,7,359188
15414,0.001348,74.125.200.0-255,2902,78862,7,359188
15415,0.001352,172.31.36.0-255,66,78928,7,359188
15416,0.001372,74.125.200.0-255,4320,83248,7,359188
15417,0.001375,74.125.200.0-255,1484,84732,7,359188
15418,0.001378,172.31.36.0-255,66,84798,7,359188
15419,0.001381,172.31.36.0-255,66,84864,7,359188
15420,0.001421,74.125.200.0-255,1484,86348,7,359188
15421,0.001424,172.31.36.0-255,66,86414,7,359188
15422,0.00145,74.125.200.0-255,1484,87898,7,359188
15423,0.001453,172.31.36.0-255,66,87964,7,359188
15424,0.00146,74.125.200.0-255,5738,93702,7,359188
15425,0.001462,172.31.36.0-255,66,93768,7,359188
15426,0.001466,74.125.200.0-255,1484,95252,7,359188
15427,0.001468,172.31.36.0-255,66,95318,7,359188
15428,0.001487,74.125.200.0-255,2902,98220,7,359188
15429,0.001491,172.31.36.0-255,66,98286,7,359188
15430,0.001505,74.125.200.0-255,3602,101888,7,359188
15431,0.001507,172.31.36.0-255,66,101954,7,359188
15432,0.001681,74.125.200.0-255,1484,103438,7,359188
15433,0.001686,74.125.200.0-255,1484,104922,7,359188
15434,0.001689,172.31.36.0-255,66,104988,7,359188
15435,0.001732,74.125.200.0-255,1484,106472,7,359188
15436,0.001748,74.125.200.0-255,1484,107956,7,359188
15437,0.001751,172.31.36.0-255,66,108022,7,359188
15438,0.001754,74.125.200.0-255,1484,109506,7,359188
15439,0.001758,74.125.200.0-255,2902,112408,7,359188
15440,0.00176,172.31.36.0-255,66,112474,7,359188
15441,0.00179,74.125.200.0-255,5738,118212,7,359188
15442,0.001793,74.125.200.0-255,1484,119696,7,359188
15443,0.001796,74.125.200.0-255,1484,121180,7,359188
15444,0.001808,74.125.200.0-255,1484,122664,7,359188
15445,0.00182,172.31.36.0-255,66,122730,7,359188
15446,0.001836,74.125.200.0-255,5738,128468,7,359188
15447,0.001841,74.125.200.0-255,2902,131370,7,359188
15448,0.001856,172.31.36.0-255,66,131436,7,359188
15449,0.00186,74.125.200.0-255,1484,132920,7,359188
15450,0.001895,74.125.200.0-255,1484,134404,7,359188
15451,0.001906,172.31.36.0-255,66,134470,7,359188
15452,0.001912,74.125.200.0-255,2184,136654,7,359188
15453,0.001917,172.31.36.0-255,66,136720,7,359188
15454,0.002171,74.125.200.0-255,1484,138204,7,359188
15455,0.002177,74.125.200.0-255,2902,141106,7,359188
15456,0.002181,172.31.36.0-255,66,141172,7,359188
15457,0.002206,74.125.200.0-255,5738,146910,7,359188
15458,0.002208,172.31.36.0-255,66,146976,7,359188
15459,0.002229,74.125.200.0-255,4320,151296,7,359188
15460,0.002231,172.31.36.0-255,66,151362,7,359188
15461,0.002247,74.125.200.0-255,2902,154264,7,359188
15462,0.002249,172.31.36.0-255,66,154330,7,359188
15463,0.002252,74.125.200.0-255,1484,155814,7,359188
15464,0.002255,74.125.200.0-255,1484,157298,7,359188
15465,0.002257,172.31.36.0-255,66,157364,7,359188
15466,0.002271,74.125.200.0-255,1484,158848,7,359188
15467,0.004504,74.125.200.0-255,4320,163168,7,359188
15468,0.004518,172.31.36.0-255,66,163234,7,359188
15469,0.006772,74.125.200.0-255,5738,168972,7,359188
15470,0.006779,172.31.36.0-255,66,169038,7,359188
15471,0.009023,74.125.200.0-255,5738,174776,7,359188
15472,0.009031,172.31.36.0-255,66,174842,7,359188
15473,0.011293,74.125.200.0-255,5738,180580,7,359188
15474,0.011304,172.31.36.0-255,66,180646,7,359188
15475,0.013574,74.125.200.0-255,5738,186384,7,359188
15476,0.01359,172.31.36.0-255,66,186450,7,359188
15477,0.015868,74.125.200.0-255,5738,192188,7,359188
15478,0.015889,172.31.36.0-255,66,192254,7,359188
15479,0.018167,74.125.200.0-255,5738,197992,7,359188
15480,0.018184,172.31.36.0-255,66,198058,7,359188
15481,0.020482,74.125.200.0-255,5738,203796,7,359188
15482,0.020499,172.31.36.0-255,66,203862,7,359188
15483,0.022761,74.125.200.0-255,5738,209600,7,359188
15484,0.022774,172.31.36.0-255,66,209666,7,359188
15485,0.025026,74.125.200.0-255,5738,215404,7,359188
15486,0.025042,172.31.36.0-255,66,215470,7,359188
15487,0.027302,74.125.200.0-255,5738,221208,7,359188
15488,0.02732,172.31.36.0-255,66,221274,7,359188
15489,0.029418,172.31.36.0-255,172,221446,7,359188
15490,0.02945,172.31.36.0-255,1114,222560,7,359188
15491,0.02951,172.31.36.0-255,1514,224074,7,359188
15492,0.029512,172.31.36.0-255,1292,225366,7,359188
15493,0.029554,74.125.200.0-255,1484,226850,7,359188
15494,0.029576,74.125.200.0-255,4320,231170,7,359188
15495,0.029579,172.31.36.0-255,66,231236,7,359188
15496,0.030979,104.244.42.0-255,66,231302,7,359188
15497,0.031057,104.244.42.0-255,66,231368,7,359188
15498,0.03106,104.244.42.0-255,66,231434,7,359188
15499,0.031821,74.125.200.0-255,1484,232918,7,359188
15500,0.031842,74.125.200.0-255,4320,237238,7,359188
15501,0.031851,172.31.36.0-255,66,237304,7,359188
15502,0.034133,74.125.200.0-255,5738,243042,7,359188
15503,0.03415,172.31.36.0-255,66,243108,7,359188
15504,0.036407,74.125.200.0-255,5738,248846,7,359188
15505,0.036422,172.31.36.0-255,66,248912,7,359188
15506,0.038695,74.125.200.0-255,5738,254650,7,359188
15507,0.038706,172.31.36.0-255,66,254716,7,359188
15508,0.040969,74.125.200.0-255,5738,260454,7,359188
15509,0.040982,172.31.36.0-255,66,260520,7,359188
15510,0.04327,74.125.200.0-255,5738,266258,7,359188
15511,0.04328,172.31.36.0-255,66,266324,7,359188
15512,0.045548,74.125.200.0-255,5738,272062,7,359188
15513,0.045559,172.31.36.0-255,66,272128,7,359188
15514,0.047867,74.125.200.0-255,5738,277866,7,359188
15515,0.04788,172.31.36.0-255,66,277932,7,359188
15516,0.050129,74.125.200.0-255,5738,283670,7,359188
15517,0.050139,172.31.36.0-255,66,283736,7,359188
15518,0.052399,74.125.200.0-255,5738,289474,7,359188
15519,0.052412,172.31.36.0-255,66,289540,7,359188
15520,0.054676,74.125.200.0-255,5738,295278,7,359188
15521,0.054691,172.31.36.0-255,66,295344,7,359188
15522,0.05695,74.125.200.0-255,5738,301082,7,359188
15523,0.056961,172.31.36.0-255,66,301148,7,359188
15524,0.059225,74.125.200.0-255,5738,306886,7,359188
15525,0.059239,172.31.36.0-255,66,306952,7,359188
15526,0.061505,74.125.200.0-255,5738,312690,7,359188
15527,0.061522,172.31.36.0-255,66,312756,7,359188
15528,0.063787,74.125.200.0-255,5738,318494,7,359188
15529,0.0638,172.31.36.0-255,66,318560,7,359188
15530,0.066089,74.125.200.0-255,5738,324298,7,359188
15531,0.066098,172.31.36.0-255,66,324364,7,359188
15532,0.068379,74.125.200.0-255,5738,330102,7,359188
15533,0.068388,172.31.36.0-255,66,330168,7,359188
15534,0.070649,74.125.200.0-255,5738,335906,7,359188
15535,0.070659,172.31.36.0-255,66,335972,7,359188
15536,0.072917,74.125.200.0-255,5738,341710,7,359188
15537,0.072926,172.31.36.0-255,66,341776,7,359188
15538,0.075194,74.125.200.0-255,5738,347514,7,359188
15539,0.075208,172.31.36.0-255,66,347580,7,359188
15540,0.077462,74.125.200.0-255,5738,353318,7,359188
15541,0.077475,172.31.36.0-255,66,353384,7,359188
15542,0.079738,74.125.200.0-255,5738,359122,7,359188
15543,0.07975,172.31.36.0-255,66,359188,7,359188
15544,0.0,74.125.24.0-255,150,150,7,216812
15545,2.4e-05,172.31.36.0-255,66,216,7,216812
15546,3e-05,74.125.24.0-255,1484,1700,7,216812
15547,3.4e-05,172.31.36.0-255,66,1766,7,216812
15548,3.9e-05,74.125.24.0-255,2902,4668,7,216812
15549,4.9e-05,172.31.36.0-255,66,4734,7,216812
15550,5.4e-05,74.125.24.0-255,4320,9054,7,216812
15551,5.6e-05,172.31.36.0-255,66,9120,7,216812
15552,9e-05,74.125.24.0-255,2902,12022,7,216812
15553,9.2e-05,172.31.36.0-255,66,12088,7,216812
15554,9.6e-05,74.125.24.0-255,1985,14073,7,216812
15555,9.8e-05,172.31.36.0-255,66,14139,7,216812
15556,0.000161,74.125.24.0-255,1484,15623,7,216812
15557,0.000164,172.31.36.0-255,66,15689,7,216812
15558,0.000193,74.125.24.0-255,2902,18591,7,216812
15559,0.000197,172.31.36.0-255,66,18657,7,216812
15560,0.000203,74.125.24.0-255,5738,24395,7,216812
15561,0.000205,172.31.36.0-255,66,24461,7,216812
15562,0.000236,74.125.24.0-255,6797,31258,7,216812
15563,0.000239,172.31.36.0-255,66,31324,7,216812
15564,0.000703,74.125.24.0-255,1484,32808,7,216812
15565,0.000709,172.31.36.0-255,66,32874,7,216812
15566,0.000718,74.125.24.0-255,2902,35776,7,216812
15567,0.000727,172.31.36.0-255,66,35842,7,216812
15568,0.000734,74.125.24.0-255,5738,41580,7,216812
15569,0.000738,172.31.36.0-255,66,41646,7,216812
15570,0.000743,74.125.24.0-255,4320,45966,7,216812
15571,0.000745,172.31.36.0-255,66,46032,7,216812
15572,0.000779,74.125.24.0-255,2543,48575,7,216812
15573,0.000782,172.31.36.0-255,66,48641,7,216812
15574,0.000796,172.31.36.0-255,66,48707,7,216812
15575,0.000806,74.125.24.0-255,2543,51250,7,216812
15576,0.000808,172.31.36.0-255,66,51316,7,216812
15577,0.000811,74.125.24.0-255,402,51718,7,216812
15578,0.000861,74.125.24.0-255,343,52061,7,216812
15579,0.001096,74.125.24.0-255,1484,53545,7,216812
15580,0.001104,172.31.36.0-255,66,53611,7,216812
15581,0.00111,74.125.24.0-255,2902,56513,7,216812
15582,0.001112,172.31.36.0-255,66,56579,7,216812
15583,0.001118,74.125.24.0-255,5738,62317,7,216812
15584,0.00112,172.31.36.0-255,66,62383,7,216812
15585,0.001136,172.31.36.0-255,66,62449,7,216812
15586,0.001174,74.125.24.0-255,4320,66769,7,216812
15587,0.001176,172.31.36.0-255,66,66835,7,216812
15588,0.001186,172.31.36.0-255,66,66901,7,216812
15589,0.001195,74.125.24.0-255,2184,69085,7,216812
15590,0.001197,172.31.36.0-255,66,69151,7,216812
15591,0.001854,74.125.24.0-255,1484,70635,7,216812
15592,0.001858,74.125.24.0-255,2902,73537,7,216812
15593,0.001861,172.31.36.0-255,66,73603,7,216812
15594,0.001864,74.125.24.0-255,1484,75087,7,216812
15595,0.001891,74.125.24.0-255,4320,79407,7,216812
15596,0.001893,172.31.36.0-255,66,79473,7,216812
15597,0.001905,172.31.36.0-255,66,79539,7,216812
15598,0.001933,74.125.24.0-255,2902,82441,7,216812
15599,0.001935,172.31.36.0-255,66,82507,7,216812
15600,0.001945,172.31.36.0-255,66,82573,7,216812
15601,0.00197,74.125.24.0-255,2184,84757,7,216812
15602,0.001972,172.31.36.0-255,66,84823,7,216812
15603,0.002197,74.125.24.0-255,1484,86307,7,216812
15604,0.002201,74.125.24.0-255,1484,87791,7,216812
15605,0.002203,172.31.36.0-255,66,87857,7,216812
15606,0.002215,74.125.24.0-255,1484,89341,7,216812
15607,0.002225,74.125.24.0-255,5738,95079,7,216812
15608,0.002229,172.31.36.0-255,66,95145,7,216812
15609,0.002269,172.31.36.0-255,66,95211,7,216812
15610,0.002285,172.31.36.0-255,66,95277,7,216812
15611,0.002402,74.125.24.0-255,1484,96761,7,216812
15612,0.002414,74.125.24.0-255,1484,98245,7,216812
15613,0.002416,172.31.36.0-255,66,98311,7,216812
15614,0.002425,74.125.24.0-255,1484,99795,7,216812
15615,0.002434,74.125.24.0-255,4320,104115,7,216812
15616,0.002436,172.31.36.0-255,66,104181,7,216812
15617,0.002459,74.125.24.0-255,1484,105665,7,216812
15618,0.002469,172.31.36.0-255,66,105731,7,216812
15619,0.002472,74.125.24.0-255,1484,107215,7,216812
15620,0.002504,74.125.24.0-255,4320,111535,7,216812
15621,0.002507,172.31.36.0-255,66,111601,7,216812
15622,0.002541,172.31.36.0-255,66,111667,7,216812
15623,0.002557,74.125.24.0-255,2902,114569,7,216812
15624,0.00256,172.31.36.0-255,66,114635,7,216812
15625,0.002584,74.125.24.0-255,2902,117537,7,216812
15626,0.002586,172.31.36.0-255,66,117603,7,216812
15627,0.002594,74.125.24.0-255,7156,124759,7,216812
15628,0.002596,172.31.36.0-255,66,124825,7,216812
15629,0.002601,74.125.24.0-255,4320,129145,7,216812
15630,0.002603,172.31.36.0-255,66,129211,7,216812
15631,0.002647,172.31.36.0-255,66,129277,7,216812
15632,0.002654,74.125.24.0-255,6438,135715,7,216812
15633,0.002656,172.31.36.0-255,66,135781,7,216812
15634,0.002659,74.125.24.0-255,1484,137265,7,216812
15635,0.002688,74.125.24.0-255,2902,140167,7,216812
15636,0.00269,172.31.36.0-255,66,140233,7,216812
15637,0.002695,74.125.24.0-255,4320,144553,7,216812
15638,0.002697,172.31.36.0-255,66,144619,7,216812
15639,0.002737,74.125.24.0-255,1484,146103,7,216812
15640,0.002754,172.31.36.0-255,66,146169,7,216812
15641,0.00276,74.125.24.0-255,5738,151907,7,216812
15642,0.002763,172.31.36.0-255,66,151973,7,216812
15643,0.0028,74.125.24.0-255,7156,159129,7,216812
15644,0.002804,172.31.36.0-255,66,159195,7,216812
15645,0.002807,74.125.24.0-255,766,159961,7,216812
15646,0.003092,74.125.24.0-255,1484,161445,7,216812
15647,0.003097,172.31.36.0-255,66,161511,7,216812
15648,0.003102,74.125.24.0-255,2902,164413,7,216812
15649,0.003104,172.31.36.0-255,66,164479,7,216812
15650,0.003107,74.125.24.0-255,1484,165963,7,216812
15651,0.003133,74.125.24.0-255,4320,170283,7,216812
15652,0.003137,172.31.36.0-255,66,170349,7,216812
15653,0.003142,74.125.24.0-255,4320,174669,7,216812
15654,0.003144,172.31.36.0-255,66,174735,7,216812
15655,0.003147,74.125.24.0-255,1484,176219,7,216812
15656,0.003194,74.125.24.0-255,1484,177703,7,216812
15657,0.003197,172.31.36.0-255,66,177769,7,216812
15658,0.003241,172.31.36.0-255,66,177835,7,216812
15659,0.003246,74.125.24.0-255,3602,181437,7,216812
15660,0.003248,172.31.36.0-255,66,181503,7,216812
15661,0.003298,74.125.24.0-255,1484,182987,7,216812
15662,0.003304,74.125.24.0-255,2902,185889,7,216812
15663,0.003307,172.31.36.0-255,66,185955,7,216812
15664,0.003311,74.125.24.0-255,2902,188857,7,216812
15665,0.003314,172.31.36.0-255,66,188923,7,216812
15666,0.003345,74.125.24.0-255,2902,191825,7,216812
15667,0.003349,172.31.36.0-255,66,191891,7,216812
15668,0.003352,74.125.24.0-255,1484,193375,7,216812
15669,0.003368,172.31.36.0-255,66,193441,7,216812
15670,0.003373,74.125.24.0-255,2902,196343,7,216812
15671,0.003376,172.31.36.0-255,66,196409,7,216812
15672,0.003418,74.125.24.0-255,5738,202147,7,216812
15673,0.003419,172.31.36.0-255,66,202213,7,216812
15674,0.003423,172.31.36.0-255,66,202279,7,216812
15675,0.003453,172.31.36.0-255,66,202345,7,216812
15676,0.003465,172.31.36.0-255,66,202411,7,216812
15677,0.00349,74.125.24.0-255,2902,205313,7,216812
15678,0.003495,172.31.36.0-255,66,205379,7,216812
15679,0.003538,172.31.36.0-255,66,205445,7,216812
15680,0.003566,74.125.24.0-255,2902,208347,7,216812
15681,0.00357,172.31.36.0-255,66,208413,7,216812
15682,0.003573,74.125.24.0-255,1484,209897,7,216812
15683,0.00359,172.31.36.0-255,66,209963,7,216812
15684,0.003592,74.125.24.0-255,1484,211447,7,216812
15685,0.003595,74.125.24.0-255,554,212001,7,216812
15686,0.003597,172.31.36.0-255,66,212067,7,216812
15687,0.0036,74.125.24.0-255,97,212164,7,216812
15688,0.003602,74.125.24.0-255,105,212269,7,216812
15689,0.006096,172.31.36.0-255,66,212335,7,216812
15690,0.006124,172.31.36.0-255,105,212440,7,216812
15691,0.008445,74.125.24.0-255,66,212506,7,216812
15692,0.027266,172.31.36.0-255,188,212694,7,216812
15693,0.0273,172.31.36.0-255,958,213652,7,216812
15694,0.027341,172.31.36.0-255,1514,215166,7,216812
15695,0.027343,172.31.36.0-255,1448,216614,7,216812
15696,0.028843,104.244.42.0-255,66,216680,7,216812
15697,0.028852,104.244.42.0-255,66,216746,7,216812
15698,0.028921,104.244.42.0-255,66,216812,7,216812
15699,0.0,74.125.24.0-255,431,431,7,99105
15700,2.8e-05,74.125.24.0-255,1484,1915,7,99105
15701,3.8e-05,172.31.36.0-255,66,1981,7,99105
15702,4.6e-05,74.125.24.0-255,2902,4883,7,99105
15703,5e-05,172.31.36.0-255,66,4949,7,99105
15704,6.3e-05,74.125.24.0-255,4320,9269,7,99105
15705,6.6e-05,172.31.36.0-255,66,9335,7,99105
15706,0.000208,74.125.24.0-255,1484,10819,7,99105
15707,0.000229,74.125.24.0-255,3578,14397,7,99105
15708,0.000235,172.31.36.0-255,66,14463,7,99105
15709,0.00042,74.125.24.0-255,1484,15947,7,99105
15710,0.000475,74.125.24.0-255,2902,18849,7,99105
15711,0.00048,172.31.36.0-255,66,18915,7,99105
15712,0.000599,74.125.24.0-255,2902,21817,7,99105
15713,0.000606,172.31.36.0-255,66,21883,7,99105
15714,0.000633,74.125.24.0-255,2902,24785,7,99105
15715,0.000637,172.31.36.0-255,66,24851,7,99105
15716,0.000828,74.125.24.0-255,5521,30372,7,99105
15717,0.00086,172.31.36.0-255,66,30438,7,99105
15718,0.002121,74.125.24.0-255,5738,36176,7,99105
15719,0.002361,74.125.24.0-255,5738,41914,7,99105
15720,0.002954,74.125.24.0-255,4320,46234,7,99105
15721,0.003513,74.125.24.0-255,2902,49136,7,99105
15722,0.003975,74.125.24.0-255,5738,54874,7,99105
15723,0.004366,172.31.36.0-255,66,54940,7,99105
15724,0.004441,172.31.36.0-255,66,55006,7,99105
15725,0.004645,172.31.36.0-255,66,55072,7,99105
15726,0.006373,172.31.36.0-255,66,55138,7,99105
15727,0.006464,172.31.36.0-255,66,55204,7,99105
15728,0.006488,74.125.24.0-255,1484,56688,7,99105
15729,0.006704,74.125.24.0-255,1954,58642,7,99105
15730,0.006741,74.125.24.0-255,1484,60126,7,99105
15731,0.006789,74.125.24.0-255,1014,61140,7,99105
15732,0.006988,74.125.24.0-255,5738,66878,7,99105
15733,0.007019,74.125.24.0-255,5456,72334,7,99105
15734,0.007087,172.31.36.0-255,66,72400,7,99105
15735,0.008376,74.125.24.0-255,1766,74166,7,99105
15736,0.008383,172.31.36.0-255,66,74232,7,99105
15737,0.008394,74.125.24.0-255,7156,81388,7,99105
15738,0.008397,172.31.36.0-255,66,81454,7,99105
15739,0.008448,172.31.36.0-255,66,81520,7,99105
15740,0.009145,74.125.24.0-255,5738,87258,7,99105
15741,0.009151,172.31.36.0-255,66,87324,7,99105
15742,0.009243,172.31.36.0-255,66,87390,7,99105
15743,0.00927,74.125.24.0-255,1484,88874,7,99105
15744,0.00957,172.31.36.0-255,66,88940,7,99105
15745,0.009607,172.31.36.0-255,66,89006,7,99105
15746,0.01046,172.31.36.0-255,66,89072,7,99105
15747,0.010506,172.31.36.0-255,66,89138,7,99105
15748,0.010548,172.31.36.0-255,66,89204,7,99105
15749,0.010817,172.31.36.0-255,66,89270,7,99105
15750,0.010858,172.31.36.0-255,66,89336,7,99105
15751,0.011289,172.31.36.0-255,66,89402,7,99105
15752,0.011475,74.125.24.0-255,4320,93722,7,99105
15753,0.011571,74.125.24.0-255,4320,98042,7,99105
15754,0.011801,74.125.24.0-255,826,98868,7,99105
15755,0.015832,172.31.36.0-255,66,98934,7,99105
15756,0.017082,172.31.36.0-255,105,99039,7,99105
15757,0.019024,74.125.24.0-255,66,99105,7,99105
15758,0.0,172.31.36.0-255,105,105,7,276
15759,0.070404,31.13.82.0-255,105,210,7,276
15760,0.070423,172.31.36.0-255,66,276,7,276
15761,0.0,74.125.68.0-255,143,143,7,274695
15762,2.2e-05,172.31.36.0-255,66,209,7,274695
15763,3e-05,74.125.68.0-255,1484,1693,7,274695
15764,3.4e-05,172.31.36.0-255,66,1759,7,274695
15765,3.9e-05,74.125.68.0-255,2902,4661,7,274695
15766,4.3e-05,172.31.36.0-255,66,4727,7,274695
15767,4.8e-05,74.125.68.0-255,2902,7629,7,274695
15768,5e-05,172.31.36.0-255,66,7695,7,274695
15769,5.7e-05,74.125.68.0-255,4320,12015,7,274695
15770,5.9e-05,172.31.36.0-255,66,12081,7,274695
15771,8.2e-05,74.125.68.0-255,2003,14084,7,274695
15772,8.5e-05,172.31.36.0-255,66,14150,7,274695
15773,0.0002,74.125.68.0-255,1484,15634,7,274695
15774,0.000204,172.31.36.0-255,66,15700,7,274695
15775,0.000223,74.125.68.0-255,2902,18602,7,274695
15776,0.000226,172.31.36.0-255,66,18668,7,274695
15777,0.00023,74.125.68.0-255,1484,20152,7,274695
15778,0.000232,172.31.36.0-255,66,20218,7,274695
15779,0.000245,74.125.68.0-255,1484,21702,7,274695
15780,0.000247,172.31.36.0-255,66,21768,7,274695
15781,0.000264,74.125.68.0-255,4320,26088,7,274695
15782,0.000266,172.31.36.0-255,66,26154,7,274695
15783,0.000295,74.125.68.0-255,4320,30474,7,274695
15784,0.000298,172.31.36.0-255,66,30540,7,274695
15785,0.000322,74.125.68.0-255,3961,34501,7,274695
15786,0.000324,172.31.36.0-255,66,34567,7,274695
15787,0.000335,172.31.36.0-255,66,34633,7,274695
15788,0.000346,172.31.36.0-255,66,34699,7,274695
15789,0.000369,74.125.68.0-255,2902,37601,7,274695
15790,0.000371,172.31.36.0-255,66,37667,7,274695
15791,0.000389,74.125.68.0-255,1484,39151,7,274695
15792,0.000417,172.31.36.0-255,66,39217,7,274695
15793,0.00042,74.125.68.0-255,678,39895,7,274695
15794,0.000747,74.125.68.0-255,1484,41379,7,274695
15795,0.000753,172.31.36.0-255,66,41445,7,274695
15796,0.000759,74.125.68.0-255,2902,44347,7,274695
15797,0.000761,172.31.36.0-255,66,44413,7,274695
15798,0.000781,74.125.68.0-255,5738,50151,7,274695
15799,0.000783,172.31.36.0-255,66,50217,7,274695
15800,0.000807,74.125.68.0-255,7156,57373,7,274695
15801,0.00081,172.31.36.0-255,66,57439,7,274695
15802,0.000832,74.125.68.0-255,2902,60341,7,274695
15803,0.000835,172.31.36.0-255,66,60407,7,274695
15804,0.000863,172.31.36.0-255,66,60473,7,274695
15805,0.000888,74.125.68.0-255,3602,64075,7,274695
15806,0.000891,172.31.36.0-255,66,64141,7,274695
15807,0.00225,74.125.68.0-255,1484,65625,7,274695
15808,0.002262,74.125.68.0-255,2902,68527,7,274695
15809,0.002266,172.31.36.0-255,66,68593,7,274695
15810,0.002275,74.125.68.0-255,5738,74331,7,274695
15811,0.002277,172.31.36.0-255,66,74397,7,274695
15812,0.002333,172.31.36.0-255,66,74463,7,274695
15813,0.002344,172.31.36.0-255,66,74529,7,274695
15814,0.00235,74.125.68.0-255,5020,79549,7,274695
15815,0.002352,172.31.36.0-255,66,79615,7,274695
15816,0.004653,74.125.68.0-255,1484,81099,7,274695
15817,0.00467,74.125.68.0-255,4320,85419,7,274695
15818,0.004672,172.31.36.0-255,66,85485,7,274695
15819,0.006991,74.125.68.0-255,5738,91223,7,274695
15820,0.006998,172.31.36.0-255,66,91289,7,274695
15821,0.009322,74.125.68.0-255,5738,97027,7,274695
15822,0.009331,172.31.36.0-255,66,97093,7,274695
15823,0.011659,74.125.68.0-255,5738,102831,7,274695
15824,0.011667,172.31.36.0-255,66,102897,7,274695
15825,0.013991,74.125.68.0-255,5738,108635,7,274695
15826,0.013999,172.31.36.0-255,66,108701,7,274695
15827,0.016331,74.125.68.0-255,5738,114439,7,274695
15828,0.016338,172.31.36.0-255,66,114505,7,274695
15829,0.018656,74.125.68.0-255,5738,120243,7,274695
15830,0.018666,172.31.36.0-255,66,120309,7,274695
15831,0.020993,74.125.68.0-255,5738,126047,7,274695
15832,0.021002,172.31.36.0-255,66,126113,7,274695
15833,0.023322,74.125.68.0-255,5738,131851,7,274695
15834,0.02333,172.31.36.0-255,66,131917,7,274695
15835,0.025664,74.125.68.0-255,5738,137655,7,274695
15836,0.025671,172.31.36.0-255,66,137721,7,274695
15837,0.028017,74.125.68.0-255,5738,143459,7,274695
15838,0.028032,172.31.36.0-255,66,143525,7,274695
15839,0.030392,74.125.68.0-255,5738,149263,7,274695
15840,0.030406,172.31.36.0-255,66,149329,7,274695
15841,0.032734,74.125.68.0-255,5738,155067,7,274695
15842,0.032743,172.31.36.0-255,66,155133,7,274695
15843,0.03328,172.31.36.0-255,188,155321,7,274695
15844,0.033313,172.31.36.0-255,958,156279,7,274695
15845,0.033376,172.31.36.0-255,1514,157793,7,274695
15846,0.033378,172.31.36.0-255,1448,159241,7,274695
15847,0.034816,104.244.42.0-255,66,159307,7,274695
15848,0.034877,104.244.42.0-255,66,159373,7,274695
15849,0.035005,104.244.42.0-255,66,159439,7,274695
15850,0.035077,74.125.68.0-255,2902,162341,7,274695
15851,0.035082,172.31.36.0-255,66,162407,7,274695
15852,0.035099,74.125.68.0-255,2902,165309,7,274695
15853,0.035102,172.31.36.0-255,66,165375,7,274695
15854,0.037405,74.125.68.0-255,2902,168277,7,274695
15855,0.037411,172.31.36.0-255,66,168343,7,274695
15856,0.037435,74.125.68.0-255,2902,171245,7,274695
15857,0.037438,172.31.36.0-255,66,171311,7,274695
15858,0.039736,74.125.68.0-255,2902,174213,7,274695
15859,0.039743,172.31.36.0-255,66,174279,7,274695
15860,0.039763,74.125.68.0-255,2902,177181,7,274695
15861,0.039766,172.31.36.0-255,66,177247,7,274695
15862,0.042062,74.125.68.0-255,2902,180149,7,274695
15863,0.042071,172.31.36.0-255,66,180215,7,274695
15864,0.042085,74.125.68.0-255,2902,183117,7,274695
15865,0.042089,172.31.36.0-255,66,183183,7,274695
15866,0.044432,74.125.68.0-255,5738,188921,7,274695
15867,0.044444,172.31.36.0-255,66,188987,7,274695
15868,0.046775,74.125.68.0-255,5738,194725,7,274695
15869,0.046782,172.31.36.0-255,66,194791,7,274695
15870,0.049108,74.125.68.0-255,5738,200529,7,274695
15871,0.049115,172.31.36.0-255,66,200595,7,274695
15872,0.051439,74.125.68.0-255,5738,206333,7,274695
15873,0.051446,172.31.36.0-255,66,206399,7,274695
15874,0.053774,74.125.68.0-255,5738,212137,7,274695
15875,0.05378,172.31.36.0-255,66,212203,7,274695
15876,0.056107,74.125.68.0-255,4320,216523,7,274695
15877,0.056114,172.31.36.0-255,66,216589,7,274695
15878,0.056132,74.125.68.0-255,1484,218073,7,274695
15879,0.058443,74.125.68.0-255,4320,222393,7,274695
15880,0.058451,172.31.36.0-255,66,222459,7,274695
15881,0.060774,74.125.68.0-255,5738,228197,7,274695
15882,0.060782,172.31.36.0-255,66,228263,7,274695
15883,0.0631,74.125.68.0-255,5738,234001,7,274695
15884,0.063106,172.31.36.0-255,66,234067,7,274695
15885,0.065432,74.125.68.0-255,5738,239805,7,274695
15886,0.065438,172.31.36.0-255,66,239871,7,274695
15887,0.067756,74.125.68.0-255,5738,245609,7,274695
15888,0.067763,172.31.36.0-255,66,245675,7,274695
15889,0.070128,74.125.68.0-255,5738,251413,7,274695
15890,0.070135,172.31.36.0-255,66,251479,7,274695
15891,0.072465,74.125.68.0-255,5738,257217,7,274695
15892,0.072471,172.31.36.0-255,66,257283,7,274695
15893,0.07482,74.125.68.0-255,5738,263021,7,274695
15894,0.074828,172.31.36.0-255,66,263087,7,274695
15895,0.07716,74.125.68.0-255,5738,268825,7,274695
15896,0.077166,172.31.36.0-255,66,268891,7,274695
15897,0.079511,74.125.68.0-255,5738,274629,7,274695
15898,0.079518,172.31.36.0-255,66,274695,7,274695
15899,0.0,172.217.194.0-255,153,153,7,238781
15900,2.3e-05,172.31.36.0-255,66,219,7,238781
15901,3.1e-05,172.217.194.0-255,1484,1703,7,238781
15902,3.5e-05,172.31.36.0-255,66,1769,7,238781
15903,4.1e-05,172.217.194.0-255,2902,4671,7,238781
15904,4.5e-05,172.31.36.0-255,66,4737,7,238781
15905,5.1e-05,172.217.194.0-255,4320,9057,7,238781
15906,5.4e-05,172.31.36.0-255,66,9123,7,238781
15907,7.9e-05,172.217.194.0-255,4905,14028,7,238781
15908,8.2e-05,172.31.36.0-255,66,14094,7,238781
15909,0.000157,172.217.194.0-255,1484,15578,7,238781
15910,0.000161,172.31.36.0-255,66,15644,7,238781
15911,0.000166,172.217.194.0-255,2902,18546,7,238781
15912,0.000168,172.31.36.0-255,66,18612,7,238781
15913,0.000198,172.217.194.0-255,5738,24350,7,238781
15914,0.000201,172.31.36.0-255,66,24416,7,238781
15915,0.000223,172.217.194.0-255,6797,31213,7,238781
15916,0.000225,172.31.36.0-255,66,31279,7,238781
15917,0.000229,172.217.194.0-255,1484,32763,7,238781
15918,0.000231,172.31.36.0-255,66,32829,7,238781
15919,0.000255,172.217.194.0-255,5738,38567,7,238781
15920,0.000258,172.31.36.0-255,66,38633,7,238781
15921,0.000261,172.217.194.0-255,1484,40117,7,238781
15922,0.000263,172.31.36.0-255,66,40183,7,238781
15923,0.000297,172.31.36.0-255,66,40249,7,238781
15924,0.000314,172.217.194.0-255,1484,41733,7,238781
15925,0.000316,172.31.36.0-255,66,41799,7,238781
15926,0.000334,172.217.194.0-255,2902,44701,7,238781
15927,0.000336,172.31.36.0-255,66,44767,7,238781
15928,0.000343,172.217.194.0-255,5738,50505,7,238781
15929,0.000346,172.31.36.0-255,66,50571,7,238781
15930,0.000375,172.217.194.0-255,4320,54891,7,238781
15931,0.000378,172.31.36.0-255,66,54957,7,238781
15932,0.00039,172.217.194.0-255,2543,57500,7,238781
15933,0.000393,172.31.36.0-255,66,57566,7,238781
15934,0.000404,172.217.194.0-255,377,57943,7,238781
15935,0.000449,172.217.194.0-255,98,58041,7,238781
15936,0.000536,172.217.194.0-255,1484,59525,7,238781
15937,0.00054,172.31.36.0-255,66,59591,7,238781
15938,0.000554,172.217.194.0-255,2902,62493,7,238781
15939,0.000557,172.31.36.0-255,66,62559,7,238781
15940,0.000564,172.217.194.0-255,5738,68297,7,238781
15941,0.000567,172.31.36.0-255,66,68363,7,238781
15942,0.00057,172.217.194.0-255,1484,69847,7,238781
15943,0.000597,172.217.194.0-255,4320,74167,7,238781
15944,0.000601,172.31.36.0-255,66,74233,7,238781
15945,0.000633,172.217.194.0-255,5379,79612,7,238781
15946,0.000637,172.31.36.0-255,66,79678,7,238781
15947,0.000643,172.217.194.0-255,5738,85416,7,238781
15948,0.000645,172.31.36.0-255,66,85482,7,238781
15949,0.000684,172.217.194.0-255,7097,92579,7,238781
15950,0.000687,172.31.36.0-255,66,92645,7,238781
15951,0.000796,172.217.194.0-255,1484,94129,7,238781
15952,0.000802,172.217.194.0-255,2902,97031,7,238781
15953,0.000805,172.31.36.0-255,66,97097,7,238781
15954,0.000811,172.217.194.0-255,5738,102835,7,238781
15955,0.000814,172.31.36.0-255,66,102901,7,238781
15956,0.000868,172.31.36.0-255,66,102967,7,238781
15957,0.000888,172.217.194.0-255,5738,108705,7,238781
15958,0.000891,172.31.36.0-255,66,108771,7,238781
15959,0.000921,172.31.36.0-255,66,108837,7,238781
15960,0.000938,172.217.194.0-255,5738,114575,7,238781
15961,0.00094,172.31.36.0-255,66,114641,7,238781
15962,0.000989,172.31.36.0-255,66,114707,7,238781
15963,0.000996,172.31.36.0-255,66,114773,7,238781
15964,0.001001,172.217.194.0-255,2902,117675,7,238781
15965,0.001003,172.31.36.0-255,66,117741,7,238781
15966,0.001009,172.217.194.0-255,3602,121343,7,238781
15967,0.001011,172.31.36.0-255,66,121409,7,238781
15968,0.001029,172.217.194.0-255,1484,122893,7,238781
15969,0.001049,172.217.194.0-255,2902,125795,7,238781
15970,0.001052,172.31.36.0-255,66,125861,7,238781
15971,0.001059,172.217.194.0-255,5738,131599,7,238781
15972,0.001061,172.31.36.0-255,66,131665,7,238781
15973,0.001085,172.217.194.0-255,5738,137403,7,238781
15974,0.001088,172.31.36.0-255,66,137469,7,238781
15975,0.001111,172.217.194.0-255,7156,144625,7,238781
15976,0.001114,172.31.36.0-255,66,144691,7,238781
15977,0.001126,172.31.36.0-255,66,144757,7,238781
15978,0.001154,172.217.194.0-255,2902,147659,7,238781
15979,0.001156,172.31.36.0-255,66,147725,7,238781
15980,0.001162,172.217.194.0-255,4320,152045,7,238781
15981,0.001164,172.31.36.0-255,66,152111,7,238781
15982,0.001169,172.217.194.0-255,4320,156431,7,238781
15983,0.001171,172.31.36.0-255,66,156497,7,238781
15984,0.001194,172.217.194.0-255,4320,160817,7,238781
15985,0.001197,172.31.36.0-255,66,160883,7,238781
15986,0.001205,172.217.194.0-255,7156,168039,7,238781
15987,0.001208,172.31.36.0-255,66,168105,7,238781
15988,0.001251,172.31.36.0-255,66,168171,7,238781
15989,0.001274,172.217.194.0-255,1484,169655,7,238781
15990,0.001297,172.217.194.0-255,2902,172557,7,238781
15991,0.0013,172.31.36.0-255,66,172623,7,238781
15992,0.001307,172.217.194.0-255,5738,178361,7,238781
15993,0.00131,172.31.36.0-255,66,178427,7,238781
15994,0.001313,172.217.194.0-255,1484,179911,7,238781
15995,0.001356,172.31.36.0-255,66,179977,7,238781
15996,0.001369,172.31.36.0-255,66,180043,7,238781
15997,0.001393,172.217.194.0-255,1484,181527,7,238781
15998,0.001399,172.217.194.0-255,2902,184429,7,238781
15999,0.001402,172.31.36.0-255,66,184495,7,238781
16000,0.001427,172.217.194.0-255,5738,190233,7,238781
16001,0.001431,172.31.36.0-255,66,190299,7,238781
16002,0.001435,172.217.194.0-255,2902,193201,7,238781
16003,0.001437,172.31.36.0-255,66,193267,7,238781
16004,0.00146,172.31.36.0-255,66,193333,7,238781
16005,0.001471,172.31.36.0-255,66,193399,7,238781
16006,0.001519,172.217.194.0-255,2184,195583,7,238781
16007,0.001522,172.31.36.0-255,66,195649,7,238781
16008,0.001604,172.217.194.0-255,1484,197133,7,238781
16009,0.001607,172.217.194.0-255,1484,198617,7,238781
16010,0.001613,172.31.36.0-255,66,198683,7,238781
16011,0.001621,172.217.194.0-255,1484,200167,7,238781
16012,0.001626,172.217.194.0-255,2902,203069,7,238781
16013,0.001629,172.31.36.0-255,66,203135,7,238781
16014,0.001651,172.217.194.0-255,2902,206037,7,238781
16015,0.001658,172.217.194.0-255,7156,213193,7,238781
16016,0.001662,172.31.36.0-255,66,213259,7,238781
16017,0.001669,172.31.36.0-255,66,213325,7,238781
16018,0.001687,172.217.194.0-255,4320,217645,7,238781
16019,0.001689,172.31.36.0-255,66,217711,7,238781
16020,0.001727,172.31.36.0-255,66,217777,7,238781
16021,0.001731,172.217.194.0-255,2184,219961,7,238781
16022,0.001733,172.31.36.0-255,66,220027,7,238781
16023,0.001756,172.31.36.0-255,66,220093,7,238781
16024,0.001804,172.31.36.0-255,66,220159,7,238781
16025,0.001832,172.217.194.0-255,7156,227315,7,238781
16026,0.001847,172.31.36.0-255,66,227381,7,238781
16027,0.00185,172.217.194.0-255,1484,228865,7,238781
16028,0.001853,172.217.194.0-255,1484,230349,7,238781
16029,0.001859,172.31.36.0-255,66,230415,7,238781
16030,0.00189,172.217.194.0-255,3602,234017,7,238781
16031,0.001929,172.31.36.0-255,66,234083,7,238781
16032,0.001946,172.31.36.0-255,66,234149,7,238781
16033,0.001975,172.217.194.0-255,105,234254,7,238781
16034,0.001979,172.31.36.0-255,66,234320,7,238781
16035,0.004747,172.31.36.0-255,105,234425,7,238781
16036,0.007264,172.217.194.0-255,66,234491,7,238781
16037,0.030265,172.31.36.0-255,172,234663,7,238781
16038,0.030298,172.31.36.0-255,1114,235777,7,238781
16039,0.030356,172.31.36.0-255,1514,237291,7,238781
16040,0.030358,172.31.36.0-255,1292,238583,7,238781
16041,0.031824,104.244.42.0-255,66,238649,7,238781
16042,0.031918,104.244.42.0-255,66,238715,7,238781
16043,0.031946,104.244.42.0-255,66,238781,7,238781
16044,0.0,74.125.200.0-255,143,143,7,362001
16045,4.3e-05,172.31.36.0-255,66,209,7,362001
16046,5.2e-05,74.125.200.0-255,1484,1693,7,362001
16047,5.7e-05,172.31.36.0-255,66,1759,7,362001
16048,6.3e-05,74.125.200.0-255,2902,4661,7,362001
16049,6.7e-05,172.31.36.0-255,66,4727,7,362001
16050,7.5e-05,74.125.200.0-255,7156,11883,7,362001
16051,7.9e-05,172.31.36.0-255,66,11949,7,362001
16052,0.000102,74.125.200.0-255,2084,14033,7,362001
16053,0.000104,172.31.36.0-255,66,14099,7,362001
16054,0.000146,74.125.200.0-255,1484,15583,7,362001
16055,0.000149,172.31.36.0-255,66,15649,7,362001
16056,0.000164,74.125.200.0-255,2902,18551,7,362001
16057,0.000167,172.31.36.0-255,66,18617,7,362001
16058,0.000189,74.125.200.0-255,5738,24355,7,362001
16059,0.000192,172.31.36.0-255,66,24421,7,362001
16060,0.0002,74.125.200.0-255,6797,31218,7,362001
16061,0.000202,172.31.36.0-255,66,31284,7,362001
16062,0.00024,74.125.200.0-255,5738,37022,7,362001
16063,0.000244,172.31.36.0-255,66,37088,7,362001
16064,0.000267,74.125.200.0-255,1484,38572,7,362001
16065,0.000269,172.31.36.0-255,66,38638,7,362001
16066,0.000276,74.125.200.0-255,5738,44376,7,362001
16067,0.000279,172.31.36.0-255,66,44442,7,362001
16068,0.000306,74.125.200.0-255,3961,48403,7,362001
16069,0.000308,172.31.36.0-255,66,48469,7,362001
16070,0.000335,74.125.200.0-255,4320,52789,7,362001
16071,0.00034,172.31.36.0-255,66,52855,7,362001
16072,0.000368,74.125.200.0-255,7156,60011,7,362001
16073,0.000372,172.31.36.0-255,66,60077,7,362001
16074,0.000429,74.125.200.0-255,4320,64397,7,362001
16075,0.000433,172.31.36.0-255,66,64463,7,362001
16076,0.000446,74.125.200.0-255,1462,65925,7,362001
16077,0.000451,74.125.200.0-255,349,66274,7,362001
16078,0.000454,172.31.36.0-255,66,66340,7,362001
16079,0.000644,74.125.200.0-255,1484,67824,7,362001
16080,0.000667,74.125.200.0-255,2902,70726,7,362001
16081,0.000671,172.31.36.0-255,66,70792,7,362001
16082,0.000676,74.125.200.0-255,2902,73694,7,362001
16083,0.000678,172.31.36.0-255,66,73760,7,362001
16084,0.000693,74.125.200.0-255,2902,76662,7,362001
16085,0.000696,172.31.36.0-255,66,76728,7,362001
16086,0.000724,172.31.36.0-255,66,76794,7,362001
16087,0.000745,74.125.200.0-255,2902,79696,7,362001
16088,0.000748,172.31.36.0-255,66,79762,7,362001
16089,0.000762,172.31.36.0-255,66,79828,7,362001
16090,0.000992,74.125.200.0-255,1484,81312,7,362001
16091,0.000997,74.125.200.0-255,1484,82796,7,362001
16092,0.001,172.31.36.0-255,66,82862,7,362001
16093,0.001014,74.125.200.0-255,1484,84346,7,362001
16094,0.001017,74.125.200.0-255,1484,85830,7,362001
16095,0.001019,172.31.36.0-255,66,85896,7,362001
16096,0.00104,74.125.200.0-255,5738,91634,7,362001
16097,0.001043,172.31.36.0-255,66,91700,7,362001
16098,0.001059,74.125.200.0-255,1484,93184,7,362001
16099,0.001076,74.125.200.0-255,4320,97504,7,362001
16100,0.001081,74.125.200.0-255,2902,100406,7,362001
16101,0.001081,172.31.36.0-255,66,100472,7,362001
16102,0.001084,172.31.36.0-255,66,100538,7,362001
16103,0.001103,74.125.200.0-255,4320,104858,7,362001
16104,0.001105,172.31.36.0-255,66,104924,7,362001
16105,0.001143,172.31.36.0-255,66,104990,7,362001
16106,0.001159,74.125.200.0-255,1484,106474,7,362001
16107,0.001172,74.125.200.0-255,2902,109376,7,362001
16108,0.001175,172.31.36.0-255,66,109442,7,362001
16109,0.001194,74.125.200.0-255,1484,110926,7,362001
16110,0.001211,74.125.200.0-255,4320,115246,7,362001
16111,0.001214,172.31.36.0-255,66,115312,7,362001
16112,0.001219,74.125.200.0-255,2902,118214,7,362001
16113,0.001221,172.31.36.0-255,66,118280,7,362001
16114,0.001245,74.125.200.0-255,2902,121182,7,362001
16115,0.001248,172.31.36.0-255,66,121248,7,362001
16116,0.001256,74.125.200.0-255,7156,128404,7,362001
16117,0.001258,172.31.36.0-255,66,128470,7,362001
16118,0.001304,172.31.36.0-255,66,128536,7,362001
16119,0.001321,74.125.200.0-255,1484,130020,7,362001
16120,0.001326,74.125.200.0-255,2902,132922,7,362001
16121,0.001328,172.31.36.0-255,66,132988,7,362001
16122,0.00134,74.125.200.0-255,1484,134472,7,362001
16123,0.001358,74.125.200.0-255,4320,138792,7,362001
16124,0.00136,172.31.36.0-255,66,138858,7,362001
16125,0.001366,74.125.200.0-255,2902,141760,7,362001
16126,0.001369,172.31.36.0-255,66,141826,7,362001
16127,0.001384,74.125.200.0-255,4320,146146,7,362001
16128,0.001387,172.31.36.0-255,66,146212,7,362001
16129,0.001398,172.31.36.0-255,66,146278,7,362001
16130,0.00142,74.125.200.0-255,4320,150598,7,362001
16131,0.001423,172.31.36.0-255,66,150664,7,362001
16132,0.001445,74.125.200.0-255,3602,154266,7,362001
16133,0.001448,172.31.36.0-255,66,154332,7,362001
16134,0.001487,74.125.200.0-255,1484,155816,7,362001
16135,0.00149,74.125.200.0-255,1484,157300,7,362001
16136,0.001493,172.31.36.0-255,66,157366,7,362001
16137,0.001507,74.125.200.0-255,1484,158850,7,362001
16138,0.001523,74.125.200.0-255,4320,163170,7,362001
16139,0.001525,172.31.36.0-255,66,163236,7,362001
16140,0.00153,74.125.200.0-255,2902,166138,7,362001
16141,0.001532,172.31.36.0-255,66,166204,7,362001
16142,0.001551,74.125.200.0-255,2902,169106,7,362001
16143,0.001554,172.31.36.0-255,66,169172,7,362001
16144,0.001562,74.125.200.0-255,7156,176328,7,362001
16145,0.001564,172.31.36.0-255,66,176394,7,362001
16146,0.001587,74.125.200.0-255,4320,180714,7,362001
16147,0.001591,172.31.36.0-255,66,180780,7,362001
16148,0.001596,74.125.200.0-255,4320,185100,7,362001
16149,0.001599,172.31.36.0-255,66,185166,7,362001
16150,0.001612,74.125.200.0-255,1484,186650,7,362001
16151,0.001627,74.125.200.0-255,2184,188834,7,362001
16152,0.001631,172.31.36.0-255,66,188900,7,362001
16153,0.001993,74.125.200.0-255,1484,190384,7,362001
16154,0.002,74.125.200.0-255,2902,193286,7,362001
16155,0.002003,172.31.36.0-255,66,193352,7,362001
16156,0.002045,74.125.200.0-255,1484,194836,7,362001
16157,0.002067,74.125.200.0-255,4320,199156,7,362001
16158,0.00207,172.31.36.0-255,66,199222,7,362001
16159,0.002076,74.125.200.0-255,2902,202124,7,362001
16160,0.002105,74.125.200.0-255,4320,206444,7,362001
16161,0.002113,172.31.36.0-255,66,206510,7,362001
16162,0.00212,74.125.200.0-255,7156,213666,7,362001
16163,0.002122,74.125.200.0-255,766,214432,7,362001
16164,0.002253,74.125.200.0-255,1484,215916,7,362001
16165,0.002258,74.125.200.0-255,1484,217400,7,362001
16166,0.002279,74.125.200.0-255,1484,218884,7,362001
16167,0.002287,74.125.200.0-255,5738,224622,7,362001
16168,0.002289,74.125.200.0-255,1484,226106,7,362001
16169,0.002303,74.125.200.0-255,5738,231844,7,362001
16170,0.002336,74.125.200.0-255,4320,236164,7,362001
16171,0.002357,74.125.200.0-255,5738,241902,7,362001
16172,0.002376,74.125.200.0-255,4320,246222,7,362001
16173,0.002394,74.125.200.0-255,6438,252660,7,362001
16174,0.002396,74.125.200.0-255,1484,254144,7,362001
16175,0.002401,74.125.200.0-255,2902,257046,7,362001
16176,0.002412,74.125.200.0-255,1484,258530,7,362001
16177,0.002428,74.125.200.0-255,4320,262850,7,362001
16178,0.002433,74.125.200.0-255,4320,267170,7,362001
16179,0.002446,74.125.200.0-255,1484,268654,7,362001
16180,0.002473,74.125.200.0-255,5738,274392,7,362001
16181,0.002483,74.125.200.0-255,1484,275876,7,362001
16182,0.002495,74.125.200.0-255,1484,277360,7,362001
16183,0.002515,74.125.200.0-255,5020,282380,7,362001
16184,0.002543,74.125.200.0-255,4320,286700,7,362001
16185,0.002557,74.125.200.0-255,2902,289602,7,362001
16186,0.002562,74.125.200.0-255,4320,293922,7,362001
16187,0.002586,74.125.200.0-255,4320,298242,7,362001
16188,0.002614,74.125.200.0-255,4320,302562,7,362001
16189,0.008413,172.31.36.0-255,66,302628,7,362001
16190,0.008423,172.31.36.0-255,66,302694,7,362001
16191,0.008427,172.31.36.0-255,66,302760,7,362001
16192,0.008432,172.31.36.0-255,66,302826,7,362001
16193,0.008437,172.31.36.0-255,66,302892,7,362001
16194,0.00844,172.31.36.0-255,66,302958,7,362001
16195,0.008446,172.31.36.0-255,66,303024,7,362001
16196,0.008449,172.31.36.0-255,66,303090,7,362001
16197,0.008452,172.31.36.0-255,66,303156,7,362001
16198,0.008455,172.31.36.0-255,66,303222,7,362001
16199,0.008459,172.31.36.0-255,66,303288,7,362001
16200,0.008463,172.31.36.0-255,66,303354,7,362001
16201,0.008467,172.31.36.0-255,66,303420,7,362001
16202,0.008471,172.31.36.0-255,66,303486,7,362001
16203,0.008475,172.31.36.0-255,66,303552,7,362001
16204,0.008478,172.31.36.0-255,66,303618,7,362001
16205,0.008482,172.31.36.0-255,66,303684,7,362001
16206,0.008485,172.31.36.0-255,66,303750,7,362001
16207,0.008488,172.31.36.0-255,66,303816,7,362001
16208,0.008491,172.31.36.0-255,66,303882,7,362001
16209,0.008494,172.31.36.0-255,66,303948,7,362001
16210,0.008497,172.31.36.0-255,66,304014,7,362001
16211,0.008501,172.31.36.0-255,66,304080,7,362001
16212,0.011075,74.125.200.0-255,5738,309818,7,362001
16213,0.011091,172.31.36.0-255,66,309884,7,362001
16214,0.013668,74.125.200.0-255,5738,315622,7,362001
16215,0.013686,172.31.36.0-255,66,315688,7,362001
16216,0.016269,74.125.200.0-255,5738,321426,7,362001
16217,0.016287,172.31.36.0-255,66,321492,7,362001
16218,0.018869,74.125.200.0-255,5738,327230,7,362001
16219,0.018887,172.31.36.0-255,66,327296,7,362001
16220,0.019011,172.31.36.0-255,101,327397,7,362001
16221,0.021488,74.125.200.0-255,5738,333135,7,362001
16222,0.021508,172.31.36.0-255,66,333201,7,362001
16223,0.02153,74.125.200.0-255,66,333267,7,362001
16224,0.024115,74.125.200.0-255,5738,339005,7,362001
16225,0.024128,172.31.36.0-255,66,339071,7,362001
16226,0.026713,74.125.200.0-255,5738,344809,7,362001
16227,0.026731,172.31.36.0-255,66,344875,7,362001
16228,0.029312,74.125.200.0-255,5738,350613,7,362001
16229,0.02933,172.31.36.0-255,66,350679,7,362001
16230,0.031909,74.125.200.0-255,5738,356417,7,362001
16231,0.031924,172.31.36.0-255,66,356483,7,362001
16232,0.034494,74.125.200.0-255,1037,357520,7,362001
16233,0.034713,172.31.36.0-255,105,357625,7,362001
16234,0.038396,172.31.36.0-255,192,357817,7,362001
16235,0.038454,172.31.36.0-255,1115,358932,7,362001
16236,0.038533,172.31.36.0-255,1514,360446,7,362001
16237,0.038535,172.31.36.0-255,1291,361737,7,362001
16238,0.039924,104.244.42.0-255,66,361803,7,362001
16239,0.04004,104.244.42.0-255,66,361869,7,362001
16240,0.040082,104.244.42.0-255,66,361935,7,362001
16241,0.042542,74.125.200.0-255,66,362001,7,362001
16242,0.0,74.125.24.0-255,152,152,7,244516
16243,2.3e-05,172.31.36.0-255,66,218,7,244516
16244,3e-05,74.125.24.0-255,1484,1702,7,244516
16245,3.5e-05,172.31.36.0-255,66,1768,7,244516
16246,4e-05,74.125.24.0-255,2902,4670,7,244516
16247,4.4e-05,172.31.36.0-255,66,4736,7,244516
16248,5.1e-05,74.125.24.0-255,5738,10474,7,244516
16249,5.5e-05,172.31.36.0-255,66,10540,7,244516
16250,9.6e-05,172.31.36.0-255,66,10606,7,244516
16251,9.9e-05,74.125.24.0-255,1484,12090,7,244516
16252,0.000102,172.31.36.0-255,66,12156,7,244516
16253,0.000113,172.31.36.0-255,66,12222,7,244516
16254,0.000143,172.31.36.0-255,66,12288,7,244516
16255,0.000149,74.125.24.0-255,5020,17308,7,244516
16256,0.000151,172.31.36.0-255,66,17374,7,244516
16257,0.000165,74.125.24.0-255,2902,20276,7,244516
16258,0.000167,172.31.36.0-255,66,20342,7,244516
16259,0.000183,74.125.24.0-255,2902,23244,7,244516
16260,0.000185,172.31.36.0-255,66,23310,7,244516
16261,0.000195,74.125.24.0-255,7156,30466,7,244516
16262,0.000197,172.31.36.0-255,66,30532,7,244516
16263,0.000243,74.125.24.0-255,4304,34836,7,244516
16264,0.000245,172.31.36.0-255,66,34902,7,244516
16265,0.000511,74.125.24.0-255,1484,36386,7,244516
16266,0.000517,172.31.36.0-255,66,36452,7,244516
16267,0.000523,74.125.24.0-255,2902,39354,7,244516
16268,0.000526,172.31.36.0-255,66,39420,7,244516
16269,0.000531,74.125.24.0-255,4320,43740,7,244516
16270,0.000533,172.31.36.0-255,66,43806,7,244516
16271,0.000557,74.125.24.0-255,1484,45290,7,244516
16272,0.000566,74.125.24.0-255,5738,51028,7,244516
16273,0.000586,74.125.24.0-255,7156,58184,7,244516
16274,0.000591,74.125.24.0-255,2902,61086,7,244516
16275,0.000604,172.31.36.0-255,66,61152,7,244516
16276,0.000619,172.31.36.0-255,66,61218,7,244516
16277,0.001423,74.125.24.0-255,1484,62702,7,244516
16278,0.001448,74.125.24.0-255,2902,65604,7,244516
16279,0.001453,172.31.36.0-255,66,65670,7,244516
16280,0.00146,74.125.24.0-255,5738,71408,7,244516
16281,0.001485,74.125.24.0-255,2902,74310,7,244516
16282,0.001511,74.125.24.0-255,1484,75794,7,244516
16283,0.001532,74.125.24.0-255,7156,82950,7,244516
16284,0.00156,74.125.24.0-255,2184,85134,7,244516
16285,0.001614,74.125.24.0-255,1484,86618,7,244516
16286,0.001618,74.125.24.0-255,1484,88102,7,244516
16287,0.00163,74.125.24.0-255,1484,89586,7,244516
16288,0.001636,74.125.24.0-255,4320,93906,7,244516
16289,0.001656,74.125.24.0-255,1484,95390,7,244516
16290,0.001693,74.125.24.0-255,4320,99710,7,244516
16291,0.001732,74.125.24.0-255,4320,104030,7,244516
16292,0.001747,74.125.24.0-255,5738,109768,7,244516
16293,0.001784,74.125.24.0-255,7156,116924,7,244516
16294,0.001894,74.125.24.0-255,1484,118408,7,244516
16295,0.001909,74.125.24.0-255,2902,121310,7,244516
16296,0.001913,74.125.24.0-255,1484,122794,7,244516
16297,0.001934,74.125.24.0-255,4320,127114,7,244516
16298,0.001975,74.125.24.0-255,2902,130016,7,244516
16299,0.00198,74.125.24.0-255,2902,132918,7,244516
16300,0.002,74.125.24.0-255,5738,138656,7,244516
16301,0.002011,74.125.24.0-255,2184,140840,7,244516
16302,0.002043,74.125.24.0-255,5738,146578,7,244516
16303,0.002057,74.125.24.0-255,1484,148062,7,244516
16304,0.002064,74.125.24.0-255,5738,153800,7,244516
16305,0.002082,74.125.24.0-255,2902,156702,7,244516
16306,0.002102,74.125.24.0-255,2902,159604,7,244516
16307,0.002151,74.125.24.0-255,1484,161088,7,244516
16308,0.002188,74.125.24.0-255,3602,164690,7,244516
16309,0.002205,74.125.24.0-255,6438,171128,7,244516
16310,0.002213,74.125.24.0-255,7156,178284,7,244516
16311,0.002292,74.125.24.0-255,1484,179768,7,244516
16312,0.002296,74.125.24.0-255,2902,182670,7,244516
16313,0.002303,74.125.24.0-255,5738,188408,7,244516
16314,0.002354,74.125.24.0-255,1484,189892,7,244516
16315,0.006914,172.31.36.0-255,66,189958,7,244516
16316,0.009316,74.125.24.0-255,5738,195696,7,244516
16317,0.009323,172.31.36.0-255,66,195762,7,244516
16318,0.011686,74.125.24.0-255,5738,201500,7,244516
16319,0.011693,172.31.36.0-255,66,201566,7,244516
16320,0.01407,74.125.24.0-255,5738,207304,7,244516
16321,0.014078,172.31.36.0-255,66,207370,7,244516
16322,0.016444,74.125.24.0-255,5738,213108,7,244516
16323,0.017676,172.31.36.0-255,66,213174,7,244516
16324,0.020028,74.125.24.0-255,5738,218912,7,244516
16325,0.020039,172.31.36.0-255,66,218978,7,244516
16326,0.022426,74.125.24.0-255,5738,224716,7,244516
16327,0.022435,172.31.36.0-255,66,224782,7,244516
16328,0.024819,74.125.24.0-255,5738,230520,7,244516
16329,0.024828,172.31.36.0-255,66,230586,7,244516
16330,0.027206,74.125.24.0-255,5738,236324,7,244516
16331,0.027214,172.31.36.0-255,66,236390,7,244516
16332,0.029603,74.125.24.0-255,3423,239813,7,244516
16333,0.029611,172.31.36.0-255,66,239879,7,244516
16334,0.029791,172.31.36.0-255,105,239984,7,244516
16335,0.032137,74.125.24.0-255,66,240050,7,244516
16336,0.035198,172.31.36.0-255,172,240222,7,244516
16337,0.035228,172.31.36.0-255,1114,241336,7,244516
16338,0.035288,172.31.36.0-255,1514,242850,7,244516
16339,0.03529,172.31.36.0-255,1294,244144,7,244516
16340,0.036733,104.244.42.0-255,66,244210,7,244516
16341,0.036751,104.244.42.0-255,66,244276,7,244516
16342,0.036828,104.244.42.0-255,66,244342,7,244516
16343,0.037332,104.244.42.0-255,108,244450,7,244516
16344,0.037338,172.31.36.0-255,66,244516,7,244516
16345,0.0,172.217.194.0-255,153,153,7,303140
16346,3.1e-05,172.31.36.0-255,66,219,7,303140
16347,3.8e-05,172.217.194.0-255,1484,1703,7,303140
16348,4.2e-05,172.31.36.0-255,66,1769,7,303140
16349,4.8e-05,172.217.194.0-255,2902,4671,7,303140
16350,5.8e-05,172.31.36.0-255,66,4737,7,303140
16351,6.7e-05,172.217.194.0-255,7156,11893,7,303140
16352,7.2e-05,172.31.36.0-255,66,11959,7,303140
16353,9.1e-05,172.217.194.0-255,2144,14103,7,303140
16354,9.3e-05,172.31.36.0-255,66,14169,7,303140
16355,0.000185,172.217.194.0-255,1484,15653,7,303140
16356,0.00019,172.31.36.0-255,66,15719,7,303140
16357,0.000195,172.217.194.0-255,2902,18621,7,303140
16358,0.000197,172.31.36.0-255,66,18687,7,303140
16359,0.000232,172.217.194.0-255,5738,24425,7,303140
16360,0.000235,172.31.36.0-255,66,24491,7,303140
16361,0.00027,172.217.194.0-255,6797,31288,7,303140
16362,0.000275,172.31.36.0-255,66,31354,7,303140
16363,0.000307,172.217.194.0-255,1484,32838,7,303140
16364,0.00031,172.31.36.0-255,66,32904,7,303140
16365,0.000315,172.217.194.0-255,2902,35806,7,303140
16366,0.000318,172.31.36.0-255,66,35872,7,303140
16367,0.000322,172.217.194.0-255,2902,38774,7,303140
16368,0.000325,172.31.36.0-255,66,38840,7,303140
16369,0.000346,172.217.194.0-255,2902,41742,7,303140
16370,0.00035,172.31.36.0-255,66,41808,7,303140
16371,0.000357,172.217.194.0-255,6797,48605,7,303140
16372,0.00036,172.31.36.0-255,66,48671,7,303140
16373,0.000465,172.217.194.0-255,1484,50155,7,303140
16374,0.000469,172.31.36.0-255,66,50221,7,303140
16375,0.000474,172.217.194.0-255,2902,53123,7,303140
16376,0.000477,172.31.36.0-255,66,53189,7,303140
16377,0.000495,172.217.194.0-255,4320,57509,7,303140
16378,0.000498,172.31.36.0-255,66,57575,7,303140
16379,0.000518,172.217.194.0-255,1484,59059,7,303140
16380,0.000532,172.217.194.0-255,6797,65856,7,303140
16381,0.000535,172.31.36.0-255,66,65922,7,303140
16382,0.000955,172.217.194.0-255,647,66569,7,303140
16383,0.001301,172.217.194.0-255,1484,68053,7,303140
16384,0.001307,172.31.36.0-255,66,68119,7,303140
16385,0.001314,172.217.194.0-255,2902,71021,7,303140
16386,0.001316,172.31.36.0-255,66,71087,7,303140
16387,0.001321,172.217.194.0-255,2902,73989,7,303140
16388,0.00133,172.31.36.0-255,66,74055,7,303140
16389,0.001337,172.217.194.0-255,7156,81211,7,303140
16390,0.00134,172.31.36.0-255,66,81277,7,303140
16391,0.001407,172.31.36.0-255,66,81343,7,303140
16392,0.001412,172.217.194.0-255,3602,84945,7,303140
16393,0.001414,172.31.36.0-255,66,85011,7,303140
16394,0.002362,172.217.194.0-255,1484,86495,7,303140
16395,0.002369,172.217.194.0-255,1484,87979,7,303140
16396,0.002372,172.31.36.0-255,66,88045,7,303140
16397,0.002401,172.217.194.0-255,1484,89529,7,303140
16398,0.002407,172.217.194.0-255,5738,95267,7,303140
16399,0.002409,172.31.36.0-255,66,95333,7,303140
16400,0.002428,172.31.36.0-255,66,95399,7,303140
16401,0.002433,172.217.194.0-255,5738,101137,7,303140
16402,0.002435,172.31.36.0-255,66,101203,7,303140
16403,0.00246,172.217.194.0-255,5020,106223,7,303140
16404,0.002462,172.31.36.0-255,66,106289,7,303140
16405,0.002487,172.217.194.0-255,1484,107773,7,303140
16406,0.002491,172.217.194.0-255,2902,110675,7,303140
16407,0.002493,172.31.36.0-255,66,110741,7,303140
16408,0.002498,172.217.194.0-255,2902,113643,7,303140
16409,0.002499,172.31.36.0-255,66,113709,7,303140
16410,0.002519,172.217.194.0-255,2902,116611,7,303140
16411,0.002521,172.31.36.0-255,66,116677,7,303140
16412,0.002531,172.217.194.0-255,5738,122415,7,303140
16413,0.002533,172.31.36.0-255,66,122481,7,303140
16414,0.002562,172.217.194.0-255,7156,129637,7,303140
16415,0.002565,172.31.36.0-255,66,129703,7,303140
16416,0.002575,172.31.36.0-255,66,129769,7,303140
16417,0.002578,172.217.194.0-255,766,130535,7,303140
16418,0.002639,172.217.194.0-255,1484,132019,7,303140
16419,0.002642,172.31.36.0-255,66,132085,7,303140
16420,0.005175,172.217.194.0-255,2902,134987,7,303140
16421,0.005181,172.31.36.0-255,66,135053,7,303140
16422,0.005244,172.217.194.0-255,2902,137955,7,303140
16423,0.005247,172.31.36.0-255,66,138021,7,303140
16424,0.007765,172.217.194.0-255,2902,140923,7,303140
16425,0.007771,172.31.36.0-255,66,140989,7,303140
16426,0.007835,172.217.194.0-255,2902,143891,7,303140
16427,0.007839,172.31.36.0-255,66,143957,7,303140
16428,0.010355,172.217.194.0-255,2902,146859,7,303140
16429,0.010363,172.31.36.0-255,66,146925,7,303140
16430,0.01043,172.217.194.0-255,2902,149827,7,303140
16431,0.010434,172.31.36.0-255,66,149893,7,303140
16432,0.01296,172.217.194.0-255,2902,152795,7,303140
16433,0.012967,172.31.36.0-255,66,152861,7,303140
16434,0.013008,172.217.194.0-255,1484,154345,7,303140
16435,0.013026,172.217.194.0-255,1484,155829,7,303140
16436,0.01303,172.31.36.0-255,66,155895,7,303140
16437,0.015568,172.217.194.0-255,2902,158797,7,303140
16438,0.015577,172.31.36.0-255,66,158863,7,303140
16439,0.015656,172.217.194.0-255,2902,161765,7,303140
16440,0.015662,172.31.36.0-255,66,161831,7,303140
16441,0.018194,172.217.194.0-255,2902,164733,7,303140
16442,0.018202,172.31.36.0-255,66,164799,7,303140
16443,0.018305,172.217.194.0-255,2902,167701,7,303140
16444,0.018311,172.31.36.0-255,66,167767,7,303140
16445,0.020824,172.217.194.0-255,2902,170669,7,303140
16446,0.02083,172.31.36.0-255,66,170735,7,303140
16447,0.02093,172.217.194.0-255,2902,173637,7,303140
16448,0.020935,172.31.36.0-255,66,173703,7,303140
16449,0.022776,172.31.36.0-255,172,173875,7,303140
16450,0.022804,172.31.36.0-255,1114,174989,7,303140
16451,0.022848,172.31.36.0-255,1514,176503,7,303140
16452,0.02285,172.31.36.0-255,333,176836,7,303140
16453,0.02344,172.217.194.0-255,2902,179738,7,303140
16454,0.023446,172.31.36.0-255,66,179804,7,303140
16455,0.023543,172.217.194.0-255,2902,182706,7,303140
16456,0.023548,172.31.36.0-255,66,182772,7,303140
16457,0.02429,104.244.42.0-255,66,182838,7,303140
16458,0.024345,104.244.42.0-255,66,182904,7,303140
16459,0.0244,104.244.42.0-255,66,182970,7,303140
16460,0.026035,172.217.194.0-255,2902,185872,7,303140
16461,0.026039,172.31.36.0-255,66,185938,7,303140
16462,0.026166,172.217.194.0-255,2902,188840,7,303140
16463,0.026171,172.31.36.0-255,66,188906,7,303140
16464,0.028671,172.217.194.0-255,2902,191808,7,303140
16465,0.028677,172.31.36.0-255,66,191874,7,303140
16466,0.028758,172.217.194.0-255,2902,194776,7,303140
16467,0.028763,172.31.36.0-255,66,194842,7,303140
16468,0.031266,172.217.194.0-255,2902,197744,7,303140
16469,0.031272,172.31.36.0-255,66,197810,7,303140
16470,0.031342,172.217.194.0-255,2902,200712,7,303140
16471,0.031347,172.31.36.0-255,66,200778,7,303140
16472,0.033872,172.217.194.0-255,2902,203680,7,303140
16473,0.033878,172.31.36.0-255,66,203746,7,303140
16474,0.033935,172.217.194.0-255,2902,206648,7,303140
16475,0.033939,172.31.36.0-255,66,206714,7,303140
16476,0.036479,172.217.194.0-255,2902,209616,7,303140
16477,0.036484,172.31.36.0-255,66,209682,7,303140
16478,0.036529,172.217.194.0-255,1484,211166,7,303140
16479,0.036544,172.217.194.0-255,1484,212650,7,303140
16480,0.036547,172.31.36.0-255,66,212716,7,303140
16481,0.039085,172.217.194.0-255,2902,215618,7,303140
16482,0.039091,172.31.36.0-255,66,215684,7,303140
16483,0.039129,172.217.194.0-255,2902,218586,7,303140
16484,0.039132,172.31.36.0-255,66,218652,7,303140
16485,0.041681,172.217.194.0-255,2902,221554,7,303140
16486,0.041685,172.31.36.0-255,66,221620,7,303140
16487,0.041725,172.217.194.0-255,2902,224522,7,303140
16488,0.041728,172.31.36.0-255,66,224588,7,303140
16489,0.044336,172.217.194.0-255,5738,230326,7,303140
16490,0.044341,172.31.36.0-255,66,230392,7,303140
16491,0.046952,172.217.194.0-255,5738,236130,7,303140
16492,0.046957,172.31.36.0-255,66,236196,7,303140
16493,0.049529,172.217.194.0-255,5738,241934,7,303140
16494,0.049534,172.31.36.0-255,66,242000,7,303140
16495,0.05215,172.217.194.0-255,5738,247738,7,303140
16496,0.052156,172.31.36.0-255,66,247804,7,303140
16497,0.054752,172.217.194.0-255,4320,252124,7,303140
16498,0.054757,172.31.36.0-255,66,252190,7,303140
16499,0.05479,172.217.194.0-255,1484,253674,7,303140
16500,0.057359,172.217.194.0-255,4320,257994,7,303140
16501,0.057364,172.31.36.0-255,66,258060,7,303140
16502,0.059965,172.217.194.0-255,5738,263798,7,303140
16503,0.05997,172.31.36.0-255,66,263864,7,303140
16504,0.062571,172.217.194.0-255,5738,269602,7,303140
16505,0.062577,172.31.36.0-255,66,269668,7,303140
16506,0.065167,172.217.194.0-255,4320,273988,7,303140
16507,0.065173,172.31.36.0-255,66,274054,7,303140
16508,0.065206,172.217.194.0-255,1484,275538,7,303140
16509,0.067799,172.217.194.0-255,4320,279858,7,303140
16510,0.067804,172.31.36.0-255,66,279924,7,303140
16511,0.070393,172.217.194.0-255,5738,285662,7,303140
16512,0.070398,172.31.36.0-255,66,285728,7,303140
16513,0.073025,172.217.194.0-255,5738,291466,7,303140
16514,0.07303,172.31.36.0-255,66,291532,7,303140
16515,0.075633,172.217.194.0-255,5738,297270,7,303140
16516,0.075638,172.31.36.0-255,66,297336,7,303140
16517,0.078249,172.217.194.0-255,5738,303074,7,303140
16518,0.078253,172.31.36.0-255,66,303140,7,303140
16519,0.0,74.125.24.0-255,153,153,7,261339
16520,2.9e-05,172.31.36.0-255,66,219,7,261339
16521,3.6e-05,74.125.24.0-255,1484,1703,7,261339
16522,4.1e-05,172.31.36.0-255,66,1769,7,261339
16523,5.3e-05,74.125.24.0-255,2902,4671,7,261339
16524,5.8e-05,172.31.36.0-255,66,4737,7,261339
16525,6.9e-05,74.125.24.0-255,1484,6221,7,261339
16526,7.1e-05,172.31.36.0-255,66,6287,7,261339
16527,7.6e-05,74.125.24.0-255,2902,9189,7,261339
16528,8.4e-05,172.31.36.0-255,66,9255,7,261339
16529,0.000127,74.125.24.0-255,4911,14166,7,261339
16530,0.000131,172.31.36.0-255,66,14232,7,261339
16531,0.000202,74.125.24.0-255,1484,15716,7,261339
16532,0.000205,172.31.36.0-255,66,15782,7,261339
16533,0.00021,74.125.24.0-255,2902,18684,7,261339
16534,0.000212,172.31.36.0-255,66,18750,7,261339
16535,0.000243,74.125.24.0-255,5738,24488,7,261339
16536,0.000247,172.31.36.0-255,66,24554,7,261339
16537,0.000272,172.31.36.0-255,66,24620,7,261339
16538,0.000292,74.125.24.0-255,5379,29999,7,261339
16539,0.000295,172.31.36.0-255,66,30065,7,261339
16540,0.0003,74.125.24.0-255,2902,32967,7,261339
16541,0.000303,172.31.36.0-255,66,33033,7,261339
16542,0.000323,74.125.24.0-255,1484,34517,7,261339
16543,0.000326,172.31.36.0-255,66,34583,7,261339
16544,0.000369,172.31.36.0-255,66,34649,7,261339
16545,0.000375,74.125.24.0-255,5020,39669,7,261339
16546,0.000378,172.31.36.0-255,66,39735,7,261339
16547,0.000381,74.125.24.0-255,427,40162,7,261339
16548,0.000383,172.31.36.0-255,66,40228,7,261339
16549,0.000412,74.125.24.0-255,347,40575,7,261339
16550,0.000622,74.125.24.0-255,1484,42059,7,261339
16551,0.000627,74.125.24.0-255,2902,44961,7,261339
16552,0.000628,172.31.36.0-255,66,45027,7,261339
16553,0.000633,172.31.36.0-255,66,45093,7,261339
16554,0.000653,74.125.24.0-255,5738,50831,7,261339
16555,0.000656,172.31.36.0-255,66,50897,7,261339
16556,0.000659,74.125.24.0-255,1484,52381,7,261339
16557,0.000696,172.31.36.0-255,66,52447,7,261339
16558,0.000717,172.31.36.0-255,66,52513,7,261339
16559,0.000728,74.125.24.0-255,2184,54697,7,261339
16560,0.000733,172.31.36.0-255,66,54763,7,261339
16561,0.000875,74.125.24.0-255,1484,56247,7,261339
16562,0.000881,74.125.24.0-255,2902,59149,7,261339
16563,0.000884,172.31.36.0-255,66,59215,7,261339
16564,0.000902,74.125.24.0-255,2902,62117,7,261339
16565,0.000922,74.125.24.0-255,2902,65019,7,261339
16566,0.000927,172.31.36.0-255,66,65085,7,261339
16567,0.000939,74.125.24.0-255,1484,66569,7,261339
16568,0.000973,172.31.36.0-255,66,66635,7,261339
16569,0.000994,74.125.24.0-255,4320,70955,7,261339
16570,0.000999,172.31.36.0-255,66,71021,7,261339
16571,0.001027,74.125.24.0-255,6438,77459,7,261339
16572,0.00103,74.125.24.0-255,1484,78943,7,261339
16573,0.001033,172.31.36.0-255,66,79009,7,261339
16574,0.001044,74.125.24.0-255,2902,81911,7,261339
16575,0.001055,74.125.24.0-255,5738,87649,7,261339
16576,0.001054,172.31.36.0-255,66,87715,7,261339
16577,0.001059,172.31.36.0-255,66,87781,7,261339
16578,0.001116,172.31.36.0-255,66,87847,7,261339
16579,0.001131,74.125.24.0-255,2902,90749,7,261339
16580,0.001139,172.31.36.0-255,66,90815,7,261339
16581,0.001164,172.31.36.0-255,66,90881,7,261339
16582,0.001188,74.125.24.0-255,1484,92365,7,261339
16583,0.001192,74.125.24.0-255,1484,93849,7,261339
16584,0.001198,172.31.36.0-255,66,93915,7,261339
16585,0.001202,74.125.24.0-255,1484,95399,7,261339
16586,0.001208,74.125.24.0-255,2902,98301,7,261339
16587,0.001215,172.31.36.0-255,66,98367,7,261339
16588,0.001241,74.125.24.0-255,2902,101269,7,261339
16589,0.001249,172.31.36.0-255,66,101335,7,261339
16590,0.001263,172.31.36.0-255,66,101401,7,261339
16591,0.001315,172.31.36.0-255,66,101467,7,261339
16592,0.001342,74.125.24.0-255,1484,102951,7,261339
16593,0.001358,74.125.24.0-255,2902,105853,7,261339
16594,0.001363,74.125.24.0-255,2902,108755,7,261339
16595,0.001363,172.31.36.0-255,66,108821,7,261339
16596,0.001368,172.31.36.0-255,66,108887,7,261339
16597,0.00139,74.125.24.0-255,2902,111789,7,261339
16598,0.001396,172.31.36.0-255,66,111855,7,261339
16599,0.001411,172.31.36.0-255,66,111921,7,261339
16600,0.001423,74.125.24.0-255,4320,116241,7,261339
16601,0.001435,172.31.36.0-255,66,116307,7,261339
16602,0.001496,74.125.24.0-255,1484,117791,7,261339
16603,0.001501,172.31.36.0-255,66,117857,7,261339
16604,0.001509,74.125.24.0-255,2902,120759,7,261339
16605,0.001511,172.31.36.0-255,66,120825,7,261339
16606,0.001561,172.31.36.0-255,66,120891,7,261339
16607,0.001714,74.125.24.0-255,1484,122375,7,261339
16608,0.00173,74.125.24.0-255,2902,125277,7,261339
16609,0.001735,172.31.36.0-255,66,125343,7,261339
16610,0.001741,74.125.24.0-255,5738,131081,7,261339
16611,0.001747,74.125.24.0-255,4320,135401,7,261339
16612,0.001748,172.31.36.0-255,66,135467,7,261339
16613,0.001765,172.31.36.0-255,66,135533,7,261339
16614,0.001774,74.125.24.0-255,1484,137017,7,261339
16615,0.001821,172.31.36.0-255,66,137083,7,261339
16616,0.002089,74.125.24.0-255,1484,138567,7,261339
16617,0.002096,74.125.24.0-255,2902,141469,7,261339
16618,0.002101,172.31.36.0-255,66,141535,7,261339
16619,0.002125,74.125.24.0-255,5738,147273,7,261339
16620,0.002138,172.31.36.0-255,66,147339,7,261339
16621,0.004212,74.125.24.0-255,5738,153077,7,261339
16622,0.004219,172.31.36.0-255,66,153143,7,261339
16623,0.006313,74.125.24.0-255,5738,158881,7,261339
16624,0.00836,172.31.36.0-255,66,158947,7,261339
16625,0.010487,74.125.24.0-255,5738,164685,7,261339
16626,0.010495,172.31.36.0-255,66,164751,7,261339
16627,0.012554,74.125.24.0-255,5738,170489,7,261339
16628,0.016563,172.31.36.0-255,66,170555,7,261339
16629,0.01869,74.125.24.0-255,5738,176293,7,261339
16630,0.018703,172.31.36.0-255,66,176359,7,261339
16631,0.020759,74.125.24.0-255,5738,182097,7,261339
16632,0.020767,172.31.36.0-255,66,182163,7,261339
16633,0.022856,74.125.24.0-255,5738,187901,7,261339
16634,0.022862,172.31.36.0-255,66,187967,7,261339
16635,0.024942,74.125.24.0-255,5738,193705,7,261339
16636,0.024949,172.31.36.0-255,66,193771,7,261339
16637,0.027036,74.125.24.0-255,5738,199509,7,261339
16638,0.027042,172.31.36.0-255,66,199575,7,261339
16639,0.027897,172.31.36.0-255,171,199746,7,261339
16640,0.027927,172.31.36.0-255,1139,200885,7,261339
16641,0.027967,172.31.36.0-255,1514,202399,7,261339
16642,0.027969,172.31.36.0-255,1267,203666,7,261339
16643,0.029117,74.125.24.0-255,5738,209404,7,261339
16644,0.029124,172.31.36.0-255,66,209470,7,261339
16645,0.029469,104.244.42.0-255,66,209536,7,261339
16646,0.029477,104.244.42.0-255,66,209602,7,261339
16647,0.029553,104.244.42.0-255,66,209668,7,261339
16648,0.030217,104.244.42.0-255,108,209776,7,261339
16649,0.030238,172.31.36.0-255,66,209842,7,261339
16650,0.031211,74.125.24.0-255,4320,214162,7,261339
16651,0.031215,172.31.36.0-255,66,214228,7,261339
16652,0.03125,74.125.24.0-255,1484,215712,7,261339
16653,0.033318,74.125.24.0-255,2902,218614,7,261339
16654,0.033325,172.31.36.0-255,66,218680,7,261339
16655,0.035387,74.125.24.0-255,5738,224418,7,261339
16656,0.035441,172.31.36.0-255,66,224484,7,261339
16657,0.037532,74.125.24.0-255,5738,230222,7,261339
16658,0.037537,172.31.36.0-255,66,230288,7,261339
16659,0.039629,74.125.24.0-255,5738,236026,7,261339
16660,0.039635,172.31.36.0-255,66,236092,7,261339
16661,0.041698,74.125.24.0-255,5738,241830,7,261339
16662,0.041704,172.31.36.0-255,66,241896,7,261339
16663,0.043824,74.125.24.0-255,5738,247634,7,261339
16664,0.04383,172.31.36.0-255,66,247700,7,261339
16665,0.045909,74.125.24.0-255,5738,253438,7,261339
16666,0.045915,172.31.36.0-255,66,253504,7,261339
16667,0.047995,74.125.24.0-255,5738,259242,7,261339
16668,0.048001,172.31.36.0-255,66,259308,7,261339
16669,0.050069,74.125.24.0-255,1794,261102,7,261339
16670,0.050074,172.31.36.0-255,66,261168,7,261339
16671,0.050243,172.31.36.0-255,105,261273,7,261339
16672,0.052293,74.125.24.0-255,66,261339,7,261339
16673,0.0,172.217.194.0-255,156,156,7,73506
16674,2.4e-05,172.31.36.0-255,66,222,7,73506
16675,3.1e-05,172.217.194.0-255,1484,1706,7,73506
16676,3.7e-05,172.31.36.0-255,66,1772,7,73506
16677,5.1e-05,172.217.194.0-255,2902,4674,7,73506
16678,5.5e-05,172.31.36.0-255,66,4740,7,73506
16679,0.000102,172.217.194.0-255,5738,10478,7,73506
16680,0.000105,172.31.36.0-255,66,10544,7,73506
16681,0.000128,172.217.194.0-255,1484,12028,7,73506
16682,0.000131,172.31.36.0-255,66,12094,7,73506
16683,0.000281,172.217.194.0-255,2039,14133,7,73506
16684,0.000286,172.31.36.0-255,66,14199,7,73506
16685,0.000335,172.217.194.0-255,4320,18519,7,73506
16686,0.000339,172.31.36.0-255,66,18585,7,73506
16687,0.000361,172.217.194.0-255,7156,25741,7,73506
16688,0.000364,172.31.36.0-255,66,25807,7,73506
16689,0.000639,172.217.194.0-255,5379,31186,7,73506
16690,0.000645,172.31.36.0-255,66,31252,7,73506
16691,0.000784,172.31.36.0-255,66,31318,7,73506
16692,0.000823,172.31.36.0-255,66,31384,7,73506
16693,0.001412,172.31.36.0-255,66,31450,7,73506
16694,0.001692,172.31.36.0-255,66,31516,7,73506
16695,0.001741,172.31.36.0-255,66,31582,7,73506
16696,0.002569,172.31.36.0-255,66,31648,7,73506
16697,0.002618,172.31.36.0-255,66,31714,7,73506
16698,0.004513,172.217.194.0-255,1484,33198,7,73506
16699,0.00455,172.217.194.0-255,7156,40354,7,73506
16700,0.005794,172.31.36.0-255,66,40420,7,73506
16701,0.005953,172.217.194.0-255,1484,41904,7,73506
16702,0.006002,172.31.36.0-255,66,41970,7,73506
16703,0.006071,172.31.36.0-255,66,42036,7,73506
16704,0.007001,172.217.194.0-255,7156,49192,7,73506
16705,0.007007,172.31.36.0-255,66,49258,7,73506
16706,0.007052,172.31.36.0-255,66,49324,7,73506
16707,0.007742,172.31.36.0-255,66,49390,7,73506
16708,0.007777,172.217.194.0-255,7156,56546,7,73506
16709,0.007779,172.31.36.0-255,66,56612,7,73506
16710,0.008446,172.31.36.0-255,66,56678,7,73506
16711,0.008496,172.31.36.0-255,66,56744,7,73506
16712,0.009406,172.31.36.0-255,66,56810,7,73506
16713,0.009656,172.217.194.0-255,5738,62548,7,73506
16714,0.009659,172.31.36.0-255,66,62614,7,73506
16715,0.009694,172.31.36.0-255,66,62680,7,73506
16716,0.009711,172.217.194.0-255,2902,65582,7,73506
16717,0.009713,172.31.36.0-255,66,65648,7,73506
16718,0.010628,172.31.36.0-255,66,65714,7,73506
16719,0.010657,172.217.194.0-255,3247,68961,7,73506
16720,0.010659,172.31.36.0-255,66,69027,7,73506
16721,0.011521,172.31.36.0-255,105,69132,7,73506
16722,0.013495,172.217.194.0-255,66,69198,7,73506
16723,0.03465,172.31.36.0-255,188,69386,7,73506
16724,0.0347,172.31.36.0-255,958,70344,7,73506
16725,0.034759,172.31.36.0-255,1514,71858,7,73506
16726,0.034761,172.31.36.0-255,1450,73308,7,73506
16727,0.0362,104.244.42.0-255,66,73374,7,73506
16728,0.036229,104.244.42.0-255,66,73440,7,73506
16729,0.036344,104.244.42.0-255,66,73506,7,73506
16730,0.0,74.125.200.0-255,143,143,7,338592
16731,2.6e-05,172.31.36.0-255,66,209,7,338592
16732,3.1e-05,74.125.200.0-255,1484,1693,7,338592
16733,3.5e-05,172.31.36.0-255,66,1759,7,338592
16734,5.4e-05,74.125.200.0-255,2902,4661,7,338592
16735,5.7e-05,172.31.36.0-255,66,4727,7,338592
16736,6.1e-05,74.125.200.0-255,4320,9047,7,338592
16737,6.4e-05,172.31.36.0-255,66,9113,7,338592
16738,0.000101,74.125.200.0-255,4855,13968,7,338592
16739,0.000104,172.31.36.0-255,66,14034,7,338592
16740,0.000138,74.125.200.0-255,2902,16936,7,338592
16741,0.000142,172.31.36.0-255,66,17002,7,338592
16742,0.00016,74.125.200.0-255,2902,19904,7,338592
16743,0.000163,172.31.36.0-255,66,19970,7,338592
16744,0.000168,74.125.200.0-255,2902,22872,7,338592
16745,0.00017,172.31.36.0-255,66,22938,7,338592
16746,0.000203,74.125.200.0-255,4320,27258,7,338592
16747,0.000206,172.31.36.0-255,66,27324,7,338592
16748,0.000224,74.125.200.0-255,3961,31285,7,338592
16749,0.000227,172.31.36.0-255,66,31351,7,338592
16750,0.000386,74.125.200.0-255,1484,32835,7,338592
16751,0.000391,172.31.36.0-255,66,32901,7,338592
16752,0.000395,74.125.200.0-255,1484,34385,7,338592
16753,0.000398,172.31.36.0-255,66,34451,7,338592
16754,0.000418,74.125.200.0-255,2902,37353,7,338592
16755,0.000421,172.31.36.0-255,66,37419,7,338592
16756,0.000428,74.125.200.0-255,5738,43157,7,338592
16757,0.000431,172.31.36.0-255,66,43223,7,338592
16758,0.000454,74.125.200.0-255,4320,47543,7,338592
16759,0.000458,172.31.36.0-255,66,47609,7,338592
16760,0.000485,74.125.200.0-255,3961,51570,7,338592
16761,0.000488,172.31.36.0-255,66,51636,7,338592
16762,0.000499,172.31.36.0-255,66,51702,7,338592
16763,0.000502,74.125.200.0-255,1484,53186,7,338592
16764,0.000518,74.125.200.0-255,4271,57457,7,338592
16765,0.000521,172.31.36.0-255,66,57523,7,338592
16766,0.000545,74.125.200.0-255,109,57632,7,338592
16767,0.000603,74.125.200.0-255,333,57965,7,338592
16768,0.000856,74.125.200.0-255,1484,59449,7,338592
16769,0.000862,172.31.36.0-255,66,59515,7,338592
16770,0.000868,74.125.200.0-255,2902,62417,7,338592
16771,0.00087,172.31.36.0-255,66,62483,7,338592
16772,0.000873,74.125.200.0-255,1484,63967,7,338592
16773,0.000893,74.125.200.0-255,4320,68287,7,338592
16774,0.000897,172.31.36.0-255,66,68353,7,338592
16775,0.000902,74.125.200.0-255,2902,71255,7,338592
16776,0.000904,172.31.36.0-255,66,71321,7,338592
16777,0.000932,74.125.200.0-255,5738,77059,7,338592
16778,0.000936,172.31.36.0-255,66,77125,7,338592
16779,0.000949,172.31.36.0-255,66,77191,7,338592
16780,0.000956,74.125.200.0-255,5020,82211,7,338592
16781,0.000958,172.31.36.0-255,66,82277,7,338592
16782,0.001601,74.125.200.0-255,1484,83761,7,338592
16783,0.001616,74.125.200.0-255,2902,86663,7,338592
16784,0.001621,172.31.36.0-255,66,86729,7,338592
16785,0.001636,74.125.200.0-255,2902,89631,7,338592
16786,0.001638,172.31.36.0-255,66,89697,7,338592
16787,0.001652,74.125.200.0-255,2902,92599,7,338592
16788,0.001654,172.31.36.0-255,66,92665,7,338592
16789,0.00169,172.31.36.0-255,66,92731,7,338592
16790,0.001718,74.125.200.0-255,5738,98469,7,338592
16791,0.00172,172.31.36.0-255,66,98535,7,338592
16792,0.00174,74.125.200.0-255,5020,103555,7,338592
16793,0.001742,172.31.36.0-255,66,103621,7,338592
16794,0.001772,74.125.200.0-255,1484,105105,7,338592
16795,0.001787,74.125.200.0-255,2902,108007,7,338592
16796,0.001789,172.31.36.0-255,66,108073,7,338592
16797,0.001799,74.125.200.0-255,1484,109557,7,338592
16798,0.001813,74.125.200.0-255,4320,113877,7,338592
16799,0.001815,172.31.36.0-255,66,113943,7,338592
16800,0.00182,74.125.200.0-255,4320,118263,7,338592
16801,0.001822,172.31.36.0-255,66,118329,7,338592
16802,0.001833,74.125.200.0-255,2902,121231,7,338592
16803,0.001835,172.31.36.0-255,66,121297,7,338592
16804,0.001856,172.31.36.0-255,66,121363,7,338592
16805,0.001882,172.31.36.0-255,66,121429,7,338592
16806,0.002046,74.125.200.0-255,1484,122913,7,338592
16807,0.002098,74.125.200.0-255,1484,124397,7,338592
16808,0.002101,172.31.36.0-255,66,124463,7,338592
16809,0.002121,74.125.200.0-255,1484,125947,7,338592
16810,0.002126,74.125.200.0-255,4320,130267,7,338592
16811,0.002128,172.31.36.0-255,66,130333,7,338592
16812,0.002138,172.31.36.0-255,66,130399,7,338592
16813,0.002142,74.125.200.0-255,4320,134719,7,338592
16814,0.002144,172.31.36.0-255,66,134785,7,338592
16815,0.00218,74.125.200.0-255,7156,141941,7,338592
16816,0.002195,74.125.200.0-255,5020,146961,7,338592
16817,0.004803,172.31.36.0-255,66,147027,7,338592
16818,0.007077,74.125.200.0-255,5738,152765,7,338592
16819,0.007083,172.31.36.0-255,66,152831,7,338592
16820,0.009352,74.125.200.0-255,5738,158569,7,338592
16821,0.009361,172.31.36.0-255,66,158635,7,338592
16822,0.011632,74.125.200.0-255,5738,164373,7,338592
16823,0.01164,172.31.36.0-255,66,164439,7,338592
16824,0.013924,74.125.200.0-255,5738,170177,7,338592
16825,0.013935,172.31.36.0-255,66,170243,7,338592
16826,0.016219,74.125.200.0-255,5738,175981,7,338592
16827,0.016226,172.31.36.0-255,66,176047,7,338592
16828,0.018505,74.125.200.0-255,5738,181785,7,338592
16829,0.018511,172.31.36.0-255,66,181851,7,338592
16830,0.020792,74.125.200.0-255,5738,187589,7,338592
16831,0.020799,172.31.36.0-255,66,187655,7,338592
16832,0.023079,74.125.200.0-255,5738,193393,7,338592
16833,0.023087,172.31.36.0-255,66,193459,7,338592
16834,0.023163,172.31.36.0-255,167,193626,7,338592
16835,0.023185,172.31.36.0-255,1115,194741,7,338592
16836,0.02325,172.31.36.0-255,1514,196255,7,338592
16837,0.023252,172.31.36.0-255,1291,197546,7,338592
16838,0.024698,104.244.42.0-255,66,197612,7,338592
16839,0.024737,104.244.42.0-255,66,197678,7,338592
16840,0.02479,104.244.42.0-255,66,197744,7,338592
16841,0.025368,74.125.200.0-255,2902,200646,7,338592
16842,0.025376,172.31.36.0-255,66,200712,7,338592
16843,0.025407,74.125.200.0-255,2902,203614,7,338592
16844,0.025411,172.31.36.0-255,66,203680,7,338592
16845,0.027651,74.125.200.0-255,2902,206582,7,338592
16846,0.02766,172.31.36.0-255,66,206648,7,338592
16847,0.027699,74.125.200.0-255,2902,209550,7,338592
16848,0.027702,172.31.36.0-255,66,209616,7,338592
16849,0.02993,74.125.200.0-255,2902,212518,7,338592
16850,0.029935,172.31.36.0-255,66,212584,7,338592
16851,0.029965,74.125.200.0-255,2902,215486,7,338592
16852,0.029969,172.31.36.0-255,66,215552,7,338592
16853,0.032219,74.125.200.0-255,2902,218454,7,338592
16854,0.032225,172.31.36.0-255,66,218520,7,338592
16855,0.032272,74.125.200.0-255,2902,221422,7,338592
16856,0.032276,172.31.36.0-255,66,221488,7,338592
16857,0.034488,74.125.200.0-255,2902,224390,7,338592
16858,0.034494,172.31.36.0-255,66,224456,7,338592
16859,0.034538,74.125.200.0-255,2902,227358,7,338592
16860,0.034544,172.31.36.0-255,66,227424,7,338592
16861,0.036787,74.125.200.0-255,2902,230326,7,338592
16862,0.036793,172.31.36.0-255,66,230392,7,338592
16863,0.036822,74.125.200.0-255,2902,233294,7,338592
16864,0.036826,172.31.36.0-255,66,233360,7,338592
16865,0.039059,74.125.200.0-255,2902,236262,7,338592
16866,0.039064,172.31.36.0-255,66,236328,7,338592
16867,0.039099,74.125.200.0-255,2902,239230,7,338592
16868,0.039102,172.31.36.0-255,66,239296,7,338592
16869,0.041329,74.125.200.0-255,2902,242198,7,338592
16870,0.04135,172.31.36.0-255,66,242264,7,338592
16871,0.041372,74.125.200.0-255,2902,245166,7,338592
16872,0.041379,172.31.36.0-255,66,245232,7,338592
16873,0.043622,74.125.200.0-255,2902,248134,7,338592
16874,0.043628,172.31.36.0-255,66,248200,7,338592
16875,0.043664,74.125.200.0-255,2902,251102,7,338592
16876,0.043667,172.31.36.0-255,66,251168,7,338592
16877,0.045897,74.125.200.0-255,2902,254070,7,338592
16878,0.045903,172.31.36.0-255,66,254136,7,338592
16879,0.045935,74.125.200.0-255,2902,257038,7,338592
16880,0.045938,172.31.36.0-255,66,257104,7,338592
16881,0.04817,74.125.200.0-255,2902,260006,7,338592
16882,0.048175,172.31.36.0-255,66,260072,7,338592
16883,0.048213,74.125.200.0-255,2902,262974,7,338592
16884,0.048216,172.31.36.0-255,66,263040,7,338592
16885,0.050436,74.125.200.0-255,2902,265942,7,338592
16886,0.050442,172.31.36.0-255,66,266008,7,338592
16887,0.050471,74.125.200.0-255,1484,267492,7,338592
16888,0.050487,74.125.200.0-255,1484,268976,7,338592
16889,0.05049,172.31.36.0-255,66,269042,7,338592
16890,0.052714,74.125.200.0-255,2902,271944,7,338592
16891,0.052719,172.31.36.0-255,66,272010,7,338592
16892,0.052749,74.125.200.0-255,2902,274912,7,338592
16893,0.052752,172.31.36.0-255,66,274978,7,338592
16894,0.054993,74.125.200.0-255,2902,277880,7,338592
16895,0.054999,172.31.36.0-255,66,277946,7,338592
16896,0.055035,74.125.200.0-255,2902,280848,7,338592
16897,0.055039,172.31.36.0-255,66,280914,7,338592
16898,0.057275,74.125.200.0-255,2902,283816,7,338592
16899,0.05728,172.31.36.0-255,66,283882,7,338592
16900,0.057308,74.125.200.0-255,2902,286784,7,338592
16901,0.057311,172.31.36.0-255,66,286850,7,338592
16902,0.059541,74.125.200.0-255,2902,289752,7,338592
16903,0.059547,172.31.36.0-255,66,289818,7,338592
16904,0.059578,74.125.200.0-255,2902,292720,7,338592
16905,0.059581,172.31.36.0-255,66,292786,7,338592
16906,0.061816,74.125.200.0-255,2902,295688,7,338592
16907,0.061821,172.31.36.0-255,66,295754,7,338592
16908,0.061847,74.125.200.0-255,2902,298656,7,338592
16909,0.06185,172.31.36.0-255,66,298722,7,338592
16910,0.06408,74.125.200.0-255,2902,301624,7,338592
16911,0.064086,172.31.36.0-255,66,301690,7,338592
16912,0.064115,74.125.200.0-255,2902,304592,7,338592
16913,0.064119,172.31.36.0-255,66,304658,7,338592
16914,0.06638,74.125.200.0-255,2902,307560,7,338592
16915,0.066385,172.31.36.0-255,66,307626,7,338592
16916,0.066418,74.125.200.0-255,2902,310528,7,338592
16917,0.066421,172.31.36.0-255,66,310594,7,338592
16918,0.068652,74.125.200.0-255,2902,313496,7,338592
16919,0.068657,172.31.36.0-255,66,313562,7,338592
16920,0.068681,74.125.200.0-255,2902,316464,7,338592
16921,0.068684,172.31.36.0-255,66,316530,7,338592
16922,0.070921,74.125.200.0-255,2902,319432,7,338592
16923,0.070926,172.31.36.0-255,66,319498,7,338592
16924,0.070947,74.125.200.0-255,2902,322400,7,338592
16925,0.07095,172.31.36.0-255,66,322466,7,338592
16926,0.073205,74.125.200.0-255,4320,326786,7,338592
16927,0.073211,172.31.36.0-255,66,326852,7,338592
16928,0.073241,74.125.200.0-255,1484,328336,7,338592
16929,0.075504,74.125.200.0-255,4320,332656,7,338592
16930,0.075512,172.31.36.0-255,66,332722,7,338592
16931,0.077787,74.125.200.0-255,4320,337042,7,338592
16932,0.077793,172.31.36.0-255,66,337108,7,338592
16933,0.077821,74.125.200.0-255,1484,338592,7,338592
16934,0.0,74.125.24.0-255,318,318,7,283418
16935,2e-05,172.31.36.0-255,66,384,7,283418
16936,2.7e-05,74.125.24.0-255,1484,1868,7,283418
16937,3.2e-05,172.31.36.0-255,66,1934,7,283418
16938,4.6e-05,74.125.24.0-255,4320,6254,7,283418
16939,5e-05,172.31.36.0-255,66,6320,7,283418
16940,5.8e-05,74.125.24.0-255,7156,13476,7,283418
16941,6.1e-05,172.31.36.0-255,66,13542,7,283418
16942,6.4e-05,74.125.24.0-255,522,14064,7,283418
16943,6.7e-05,172.31.36.0-255,66,14130,7,283418
16944,0.001119,74.125.24.0-255,1484,15614,7,283418
16945,0.001127,172.31.36.0-255,66,15680,7,283418
16946,0.001138,74.125.24.0-255,2902,18582,7,283418
16947,0.00114,172.31.36.0-255,66,18648,7,283418
16948,0.001153,74.125.24.0-255,5738,24386,7,283418
16949,0.001155,172.31.36.0-255,66,24452,7,283418
16950,0.001163,74.125.24.0-255,6797,31249,7,283418
16951,0.001165,172.31.36.0-255,66,31315,7,283418
16952,0.001173,74.125.24.0-255,7156,38471,7,283418
16953,0.001176,172.31.36.0-255,66,38537,7,283418
16954,0.001218,172.31.36.0-255,66,38603,7,283418
16955,0.00123,172.31.36.0-255,66,38669,7,283418
16956,0.001284,172.31.36.0-255,66,38735,7,283418
16957,0.001318,74.125.24.0-255,398,39133,7,283418
16958,0.001322,172.31.36.0-255,66,39199,7,283418
16959,0.001372,74.125.24.0-255,112,39311,7,283418
16960,0.001375,172.31.36.0-255,66,39377,7,283418
16961,0.001974,74.125.24.0-255,1484,40861,7,283418
16962,0.00198,172.31.36.0-255,66,40927,7,283418
16963,0.001986,74.125.24.0-255,2902,43829,7,283418
16964,0.001989,172.31.36.0-255,66,43895,7,283418
16965,0.002,74.125.24.0-255,5738,49633,7,283418
16966,0.002004,172.31.36.0-255,66,49699,7,283418
16967,0.002008,74.125.24.0-255,2902,52601,7,283418
16968,0.00201,172.31.36.0-255,66,52667,7,283418
16969,0.002026,74.125.24.0-255,4320,56987,7,283418
16970,0.002029,172.31.36.0-255,66,57053,7,283418
16971,0.004039,74.125.24.0-255,4320,61373,7,283418
16972,0.004046,172.31.36.0-255,66,61439,7,283418
16973,0.004075,74.125.24.0-255,1484,62923,7,283418
16974,0.006051,74.125.24.0-255,4320,67243,7,283418
16975,0.006058,172.31.36.0-255,66,67309,7,283418
16976,0.00807,74.125.24.0-255,5738,73047,7,283418
16977,0.008078,172.31.36.0-255,66,73113,7,283418
16978,0.0101,74.125.24.0-255,5738,78851,7,283418
16979,0.010108,172.31.36.0-255,66,78917,7,283418
16980,0.01215,74.125.24.0-255,5738,84655,7,283418
16981,0.012159,172.31.36.0-255,66,84721,7,283418
16982,0.014201,74.125.24.0-255,5738,90459,7,283418
16983,0.014208,172.31.36.0-255,66,90525,7,283418
16984,0.016244,74.125.24.0-255,5738,96263,7,283418
16985,0.016253,172.31.36.0-255,66,96329,7,283418
16986,0.018268,74.125.24.0-255,5738,102067,7,283418
16987,0.018277,172.31.36.0-255,66,102133,7,283418
16988,0.020304,74.125.24.0-255,5738,107871,7,283418
16989,0.020312,172.31.36.0-255,66,107937,7,283418
16990,0.022327,74.125.24.0-255,5738,113675,7,283418
16991,0.022336,172.31.36.0-255,66,113741,7,283418
16992,0.024369,74.125.24.0-255,5738,119479,7,283418
16993,0.024377,172.31.36.0-255,66,119545,7,283418
16994,0.02643,74.125.24.0-255,5738,125283,7,283418
16995,0.026437,172.31.36.0-255,66,125349,7,283418
16996,0.028461,74.125.24.0-255,5738,131087,7,283418
16997,0.028473,172.31.36.0-255,66,131153,7,283418
16998,0.030493,74.125.24.0-255,5738,136891,7,283418
16999,0.030509,172.31.36.0-255,66,136957,7,283418
17000,0.032536,74.125.24.0-255,5738,142695,7,283418
17001,0.032551,172.31.36.0-255,66,142761,7,283418
17002,0.034602,74.125.24.0-255,5738,148499,7,283418
17003,0.034612,172.31.36.0-255,66,148565,7,283418
17004,0.036619,74.125.24.0-255,5738,154303,7,283418
17005,0.036628,172.31.36.0-255,66,154369,7,283418
17006,0.038636,74.125.24.0-255,5738,160107,7,283418
17007,0.038646,172.31.36.0-255,66,160173,7,283418
17008,0.040626,172.31.36.0-255,172,160345,7,283418
17009,0.040666,74.125.24.0-255,5738,166083,7,283418
17010,0.04067,172.31.36.0-255,66,166149,7,283418
17011,0.040675,172.31.36.0-255,1114,167263,7,283418
17012,0.040802,172.31.36.0-255,1514,168777,7,283418
17013,0.040803,172.31.36.0-255,1514,170291,7,283418
17014,0.040804,172.31.36.0-255,1514,171805,7,283418
17015,0.04083,172.31.36.0-255,1073,172878,7,283418
17016,0.042148,104.244.42.0-255,66,172944,7,283418
17017,0.042226,104.244.42.0-255,66,173010,7,283418
17018,0.04237,104.244.42.0-255,66,173076,7,283418
17019,0.042377,104.244.42.0-255,66,173142,7,283418
17020,0.042689,74.125.24.0-255,5738,178880,7,283418
17021,0.042698,172.31.36.0-255,66,178946,7,283418
17022,0.044717,74.125.24.0-255,5738,184684,7,283418
17023,0.044727,172.31.36.0-255,66,184750,7,283418
17024,0.046752,74.125.24.0-255,5738,190488,7,283418
17025,0.046761,172.31.36.0-255,66,190554,7,283418
17026,0.048789,74.125.24.0-255,5738,196292,7,283418
17027,0.0488,172.31.36.0-255,66,196358,7,283418
17028,0.050844,74.125.24.0-255,5738,202096,7,283418
17029,0.050855,172.31.36.0-255,66,202162,7,283418
17030,0.05286,74.125.24.0-255,5738,207900,7,283418
17031,0.052869,172.31.36.0-255,66,207966,7,283418
17032,0.054896,74.125.24.0-255,5738,213704,7,283418
17033,0.054902,172.31.36.0-255,66,213770,7,283418
17034,0.056976,74.125.24.0-255,5738,219508,7,283418
17035,0.056983,172.31.36.0-255,66,219574,7,283418
17036,0.059052,74.125.24.0-255,5738,225312,7,283418
17037,0.059061,172.31.36.0-255,66,225378,7,283418
17038,0.061089,74.125.24.0-255,5738,231116,7,283418
17039,0.061099,172.31.36.0-255,66,231182,7,283418
17040,0.063118,74.125.24.0-255,5738,236920,7,283418
17041,0.063132,172.31.36.0-255,66,236986,7,283418
17042,0.065177,74.125.24.0-255,5738,242724,7,283418
17043,0.065196,172.31.36.0-255,66,242790,7,283418
17044,0.067213,74.125.24.0-255,5738,248528,7,283418
17045,0.067231,172.31.36.0-255,66,248594,7,283418
17046,0.069262,74.125.24.0-255,5738,254332,7,283418
17047,0.069278,172.31.36.0-255,66,254398,7,283418
17048,0.071328,74.125.24.0-255,5738,260136,7,283418
17049,0.071343,172.31.36.0-255,66,260202,7,283418
17050,0.073381,74.125.24.0-255,5738,265940,7,283418
17051,0.073389,172.31.36.0-255,66,266006,7,283418
17052,0.075392,74.125.24.0-255,5738,271744,7,283418
17053,0.075399,172.31.36.0-255,66,271810,7,283418
17054,0.077422,74.125.24.0-255,5738,277548,7,283418
17055,0.07743,172.31.36.0-255,66,277614,7,283418
17056,0.079457,74.125.24.0-255,5738,283352,7,283418
17057,0.079469,172.31.36.0-255,66,283418,7,283418
17058,0.0,74.125.68.0-255,142,142,7,328211
17059,2.2e-05,172.31.36.0-255,66,208,7,328211
17060,3e-05,74.125.68.0-255,1484,1692,7,328211
17061,3.4e-05,172.31.36.0-255,66,1758,7,328211
17062,4.1e-05,74.125.68.0-255,2902,4660,7,328211
17063,4.4e-05,172.31.36.0-255,66,4726,7,328211
17064,4.8e-05,74.125.68.0-255,1484,6210,7,328211
17065,5e-05,172.31.36.0-255,66,6276,7,328211
17066,5.4e-05,74.125.68.0-255,1484,7760,7,328211
17067,5.7e-05,172.31.36.0-255,66,7826,7,328211
17068,9e-05,74.125.68.0-255,4320,12146,7,328211
17069,9.2e-05,172.31.36.0-255,66,12212,7,328211
17070,0.000106,172.31.36.0-255,66,12278,7,328211
17071,0.000117,172.31.36.0-255,66,12344,7,328211
17072,0.000182,74.125.68.0-255,1484,13828,7,328211
17073,0.000185,172.31.36.0-255,66,13894,7,328211
17074,0.000213,74.125.68.0-255,2902,16796,7,328211
17075,0.000215,172.31.36.0-255,66,16862,7,328211
17076,0.00024,74.125.68.0-255,5738,22600,7,328211
17077,0.000242,172.31.36.0-255,66,22666,7,328211
17078,0.000246,74.125.68.0-255,2902,25568,7,328211
17079,0.000248,172.31.36.0-255,66,25634,7,328211
17080,0.000254,74.125.68.0-255,3961,29595,7,328211
17081,0.000257,172.31.36.0-255,66,29661,7,328211
17082,0.000268,172.31.36.0-255,66,29727,7,328211
17083,0.000272,74.125.68.0-255,4320,34047,7,328211
17084,0.000276,172.31.36.0-255,66,34113,7,328211
17085,0.000319,74.125.68.0-255,1484,35597,7,328211
17086,0.000321,172.31.36.0-255,66,35663,7,328211
17087,0.000333,74.125.68.0-255,2881,38544,7,328211
17088,0.000336,172.31.36.0-255,66,38610,7,328211
17089,0.000395,74.125.68.0-255,1484,40094,7,328211
17090,0.00041,74.125.68.0-255,2902,42996,7,328211
17091,0.000413,172.31.36.0-255,66,43062,7,328211
17092,0.000432,74.125.68.0-255,1484,44546,7,328211
17093,0.000437,74.125.68.0-255,2902,47448,7,328211
17094,0.000439,172.31.36.0-255,66,47514,7,328211
17095,0.000456,74.125.68.0-255,4320,51834,7,328211
17096,0.000458,172.31.36.0-255,66,51900,7,328211
17097,0.00048,74.125.68.0-255,1484,53384,7,328211
17098,0.000483,74.125.68.0-255,1484,54868,7,328211
17099,0.000485,172.31.36.0-255,66,54934,7,328211
17100,0.000538,74.125.68.0-255,827,55761,7,328211
17101,0.000556,74.125.68.0-255,1484,57245,7,328211
17102,0.00056,172.31.36.0-255,66,57311,7,328211
17103,0.00058,74.125.68.0-255,4320,61631,7,328211
17104,0.000583,172.31.36.0-255,66,61697,7,328211
17105,0.000587,74.125.68.0-255,1484,63181,7,328211
17106,0.000616,172.31.36.0-255,66,63247,7,328211
17107,0.000619,74.125.68.0-255,1125,64372,7,328211
17108,0.00144,172.31.36.0-255,66,64438,7,328211
17109,0.001578,74.125.68.0-255,1484,65922,7,328211
17110,0.001586,74.125.68.0-255,2902,68824,7,328211
17111,0.00159,172.31.36.0-255,66,68890,7,328211
17112,0.001594,74.125.68.0-255,1484,70374,7,328211
17113,0.001599,74.125.68.0-255,2902,73276,7,328211
17114,0.001601,172.31.36.0-255,66,73342,7,328211
17115,0.001643,74.125.68.0-255,4320,77662,7,328211
17116,0.001646,172.31.36.0-255,66,77728,7,328211
17117,0.001661,74.125.68.0-255,1484,79212,7,328211
17118,0.001678,74.125.68.0-255,4320,83532,7,328211
17119,0.00168,172.31.36.0-255,66,83598,7,328211
17120,0.001705,74.125.68.0-255,4320,87918,7,328211
17121,0.001707,172.31.36.0-255,66,87984,7,328211
17122,0.001713,74.125.68.0-255,5738,93722,7,328211
17123,0.001716,172.31.36.0-255,66,93788,7,328211
17124,0.001762,74.125.68.0-255,5020,98808,7,328211
17125,0.001764,172.31.36.0-255,66,98874,7,328211
17126,0.003735,74.125.68.0-255,5738,104612,7,328211
17127,0.003745,172.31.36.0-255,66,104678,7,328211
17128,0.005736,74.125.68.0-255,5738,110416,7,328211
17129,0.005742,172.31.36.0-255,66,110482,7,328211
17130,0.007708,74.125.68.0-255,5738,116220,7,328211
17131,0.007715,172.31.36.0-255,66,116286,7,328211
17132,0.009693,74.125.68.0-255,5738,122024,7,328211
17133,0.0097,172.31.36.0-255,66,122090,7,328211
17134,0.011679,74.125.68.0-255,5738,127828,7,328211
17135,0.011692,172.31.36.0-255,66,127894,7,328211
17136,0.013671,74.125.68.0-255,5738,133632,7,328211
17137,0.013678,172.31.36.0-255,66,133698,7,328211
17138,0.015655,74.125.68.0-255,5738,139436,7,328211
17139,0.015666,172.31.36.0-255,66,139502,7,328211
17140,0.017642,74.125.68.0-255,5738,145240,7,328211
17141,0.017652,172.31.36.0-255,66,145306,7,328211
17142,0.019653,74.125.68.0-255,5738,151044,7,328211
17143,0.019661,172.31.36.0-255,66,151110,7,328211
17144,0.02164,74.125.68.0-255,5738,156848,7,328211
17145,0.021649,172.31.36.0-255,66,156914,7,328211
17146,0.023629,74.125.68.0-255,5738,162652,7,328211
17147,0.023638,172.31.36.0-255,66,162718,7,328211
17148,0.025617,74.125.68.0-255,5738,168456,7,328211
17149,0.025624,172.31.36.0-255,66,168522,7,328211
17150,0.027591,74.125.68.0-255,5738,174260,7,328211
17151,0.027596,172.31.36.0-255,66,174326,7,328211
17152,0.028299,172.31.36.0-255,215,174541,7,328211
17153,0.028328,172.31.36.0-255,958,175499,7,328211
17154,0.028389,172.31.36.0-255,1514,177013,7,328211
17155,0.028391,172.31.36.0-255,1448,178461,7,328211
17156,0.029571,74.125.68.0-255,5738,184199,7,328211
17157,0.029578,172.31.36.0-255,66,184265,7,328211
17158,0.029879,104.244.42.0-255,66,184331,7,328211
17159,0.029905,104.244.42.0-255,66,184397,7,328211
17160,0.029989,104.244.42.0-255,66,184463,7,328211
17161,0.031563,74.125.68.0-255,5738,190201,7,328211
17162,0.03157,172.31.36.0-255,66,190267,7,328211
17163,0.033562,74.125.68.0-255,5738,196005,7,328211
17164,0.033569,172.31.36.0-255,66,196071,7,328211
17165,0.035547,74.125.68.0-255,5738,201809,7,328211
17166,0.035554,172.31.36.0-255,66,201875,7,328211
17167,0.037531,74.125.68.0-255,5738,207613,7,328211
17168,0.037538,172.31.36.0-255,66,207679,7,328211
17169,0.039514,74.125.68.0-255,5738,213417,7,328211
17170,0.03952,172.31.36.0-255,66,213483,7,328211
17171,0.041494,74.125.68.0-255,5738,219221,7,328211
17172,0.041503,172.31.36.0-255,66,219287,7,328211
17173,0.043483,74.125.68.0-255,5738,225025,7,328211
17174,0.043489,172.31.36.0-255,66,225091,7,328211
17175,0.045474,74.125.68.0-255,5738,230829,7,328211
17176,0.04548,172.31.36.0-255,66,230895,7,328211
17177,0.047464,74.125.68.0-255,5738,236633,7,328211
17178,0.047471,172.31.36.0-255,66,236699,7,328211
17179,0.049471,74.125.68.0-255,5738,242437,7,328211
17180,0.049478,172.31.36.0-255,66,242503,7,328211
17181,0.051467,74.125.68.0-255,5738,248241,7,328211
17182,0.051474,172.31.36.0-255,66,248307,7,328211
17183,0.053481,74.125.68.0-255,5738,254045,7,328211
17184,0.053488,172.31.36.0-255,66,254111,7,328211
17185,0.055472,74.125.68.0-255,5738,259849,7,328211
17186,0.055478,172.31.36.0-255,66,259915,7,328211
17187,0.057464,74.125.68.0-255,5738,265653,7,328211
17188,0.05747,172.31.36.0-255,66,265719,7,328211
17189,0.059464,74.125.68.0-255,5738,271457,7,328211
17190,0.059471,172.31.36.0-255,66,271523,7,328211
17191,0.061463,74.125.68.0-255,5738,277261,7,328211
17192,0.061469,172.31.36.0-255,66,277327,7,328211
17193,0.06345,74.125.68.0-255,5738,283065,7,328211
17194,0.063456,172.31.36.0-255,66,283131,7,328211
17195,0.065459,74.125.68.0-255,5738,288869,7,328211
17196,0.065466,172.31.36.0-255,66,288935,7,328211
17197,0.067454,74.125.68.0-255,4320,293255,7,328211
17198,0.06746,172.31.36.0-255,66,293321,7,328211
17199,0.067511,74.125.68.0-255,1484,294805,7,328211
17200,0.069477,74.125.68.0-255,4320,299125,7,328211
17201,0.069483,172.31.36.0-255,66,299191,7,328211
17202,0.071463,74.125.68.0-255,5738,304929,7,328211
17203,0.071469,172.31.36.0-255,66,304995,7,328211
17204,0.073453,74.125.68.0-255,5738,310733,7,328211
17205,0.07346,172.31.36.0-255,66,310799,7,328211
17206,0.075449,74.125.68.0-255,5738,316537,7,328211
17207,0.075455,172.31.36.0-255,66,316603,7,328211
17208,0.077433,74.125.68.0-255,5738,322341,7,328211
17209,0.077438,172.31.36.0-255,66,322407,7,328211
17210,0.079416,74.125.68.0-255,5738,328145,7,328211
17211,0.079423,172.31.36.0-255,66,328211,7,328211
17212,0.0,74.125.24.0-255,153,153,7,281305
17213,3.4e-05,172.31.36.0-255,66,219,7,281305
17214,4.1e-05,74.125.24.0-255,1484,1703,7,281305
17215,4.5e-05,172.31.36.0-255,66,1769,7,281305
17216,5e-05,74.125.24.0-255,2902,4671,7,281305
17217,5.3e-05,172.31.36.0-255,66,4737,7,281305
17218,6.7e-05,74.125.24.0-255,7156,11893,7,281305
17219,7e-05,172.31.36.0-255,66,11959,7,281305
17220,7.3e-05,74.125.24.0-255,2049,14008,7,281305
17221,7.6e-05,172.31.36.0-255,66,14074,7,281305
17222,0.000129,74.125.24.0-255,7156,21230,7,281305
17223,0.000132,172.31.36.0-255,66,21296,7,281305
17224,0.000142,172.31.36.0-255,66,21362,7,281305
17225,0.000162,74.125.24.0-255,1125,22487,7,281305
17226,0.000165,172.31.36.0-255,66,22553,7,281305
17227,0.000278,74.125.24.0-255,1484,24037,7,281305
17228,0.000284,74.125.24.0-255,2902,26939,7,281305
17229,0.000284,172.31.36.0-255,66,27005,7,281305
17230,0.00029,172.31.36.0-255,66,27071,7,281305
17231,0.000338,74.125.24.0-255,5738,32809,7,281305
17232,0.000342,172.31.36.0-255,66,32875,7,281305
17233,0.00035,74.125.24.0-255,6797,39672,7,281305
17234,0.000353,172.31.36.0-255,66,39738,7,281305
17235,0.000787,74.125.24.0-255,1484,41222,7,281305
17236,0.000792,172.31.36.0-255,66,41288,7,281305
17237,0.000802,74.125.24.0-255,2902,44190,7,281305
17238,0.000811,172.31.36.0-255,66,44256,7,281305
17239,0.000818,74.125.24.0-255,5738,49994,7,281305
17240,0.00082,172.31.36.0-255,66,50060,7,281305
17241,0.000824,74.125.24.0-255,1484,51544,7,281305
17242,0.000826,172.31.36.0-255,66,51610,7,281305
17243,0.00086,74.125.24.0-255,2902,54512,7,281305
17244,0.000876,74.125.24.0-255,2543,57055,7,281305
17245,0.001092,74.125.24.0-255,646,57701,7,281305
17246,0.001411,74.125.24.0-255,1484,59185,7,281305
17247,0.001419,74.125.24.0-255,2902,62087,7,281305
17248,0.001421,74.125.24.0-255,1484,63571,7,281305
17249,0.001434,74.125.24.0-255,4320,67891,7,281305
17250,0.001437,74.125.24.0-255,1484,69375,7,281305
17251,0.001457,74.125.24.0-255,4320,73695,7,281305
17252,0.001507,74.125.24.0-255,5020,78715,7,281305
17253,0.001961,74.125.24.0-255,1484,80199,7,281305
17254,0.001976,74.125.24.0-255,2902,83101,7,281305
17255,0.001999,74.125.24.0-255,1484,84585,7,281305
17256,0.002036,74.125.24.0-255,4320,88905,7,281305
17257,0.002094,74.125.24.0-255,2184,91089,7,281305
17258,0.002108,74.125.24.0-255,2902,93991,7,281305
17259,0.002127,74.125.24.0-255,4320,98311,7,281305
17260,0.002143,74.125.24.0-255,2902,101213,7,281305
17261,0.002161,74.125.24.0-255,4320,105533,7,281305
17262,0.002178,74.125.24.0-255,2902,108435,7,281305
17263,0.002191,74.125.24.0-255,4320,112755,7,281305
17264,0.002209,74.125.24.0-255,2902,115657,7,281305
17265,0.002211,74.125.24.0-255,1484,117141,7,281305
17266,0.006519,172.31.36.0-255,66,117207,7,281305
17267,0.009101,74.125.24.0-255,5738,122945,7,281305
17268,0.009107,172.31.36.0-255,66,123011,7,281305
17269,0.011716,74.125.24.0-255,5738,128749,7,281305
17270,0.011724,172.31.36.0-255,66,128815,7,281305
17271,0.014337,74.125.24.0-255,5738,134553,7,281305
17272,0.014347,172.31.36.0-255,66,134619,7,281305
17273,0.016937,74.125.24.0-255,5738,140357,7,281305
17274,0.016946,172.31.36.0-255,66,140423,7,281305
17275,0.019563,74.125.24.0-255,5738,146161,7,281305
17276,0.01957,172.31.36.0-255,66,146227,7,281305
17277,0.022166,74.125.24.0-255,4320,150547,7,281305
17278,0.022174,172.31.36.0-255,66,150613,7,281305
17279,0.022205,74.125.24.0-255,1484,152097,7,281305
17280,0.024764,74.125.24.0-255,4320,156417,7,281305
17281,0.02477,172.31.36.0-255,66,156483,7,281305
17282,0.02546,172.31.36.0-255,172,156655,7,281305
17283,0.025501,172.31.36.0-255,1114,157769,7,281305
17284,0.025571,172.31.36.0-255,1514,159283,7,281305
17285,0.025573,172.31.36.0-255,1292,160575,7,281305
17286,0.027001,104.244.42.0-255,66,160641,7,281305
17287,0.027042,104.244.42.0-255,66,160707,7,281305
17288,0.027136,104.244.42.0-255,66,160773,7,281305
17289,0.027355,74.125.24.0-255,5738,166511,7,281305
17290,0.027405,172.31.36.0-255,66,166577,7,281305
17291,0.030057,74.125.24.0-255,5738,172315,7,281305
17292,0.030065,172.31.36.0-255,66,172381,7,281305
17293,0.032656,74.125.24.0-255,5738,178119,7,281305
17294,0.032663,172.31.36.0-255,66,178185,7,281305
17295,0.035252,74.125.24.0-255,5738,183923,7,281305
17296,0.03526,172.31.36.0-255,66,183989,7,281305
17297,0.037827,74.125.24.0-255,5738,189727,7,281305
17298,0.037833,172.31.36.0-255,66,189793,7,281305
17299,0.04046,74.125.24.0-255,5738,195531,7,281305
17300,0.040465,172.31.36.0-255,66,195597,7,281305
17301,0.043058,74.125.24.0-255,4320,199917,7,281305
17302,0.043063,172.31.36.0-255,66,199983,7,281305
17303,0.043092,74.125.24.0-255,1484,201467,7,281305
17304,0.045668,74.125.24.0-255,4320,205787,7,281305
17305,0.045675,172.31.36.0-255,66,205853,7,281305
17306,0.048298,74.125.24.0-255,5738,211591,7,281305
17307,0.04835,172.31.36.0-255,66,211657,7,281305
17308,0.050926,74.125.24.0-255,5738,217395,7,281305
17309,0.050933,172.31.36.0-255,66,217461,7,281305
17310,0.053501,74.125.24.0-255,5738,223199,7,281305
17311,0.053507,172.31.36.0-255,66,223265,7,281305
17312,0.056086,74.125.24.0-255,5738,229003,7,281305
17313,0.056092,172.31.36.0-255,66,229069,7,281305
17314,0.058673,74.125.24.0-255,5738,234807,7,281305
17315,0.058678,172.31.36.0-255,66,234873,7,281305
17316,0.06129,74.125.24.0-255,5738,240611,7,281305
17317,0.061295,172.31.36.0-255,66,240677,7,281305
17318,0.063857,74.125.24.0-255,5738,246415,7,281305
17319,0.063863,172.31.36.0-255,66,246481,7,281305
17320,0.066441,74.125.24.0-255,5738,252219,7,281305
17321,0.066449,172.31.36.0-255,66,252285,7,281305
17322,0.069062,74.125.24.0-255,5738,258023,7,281305
17323,0.06907,172.31.36.0-255,66,258089,7,281305
17324,0.071663,74.125.24.0-255,5738,263827,7,281305
17325,0.071675,172.31.36.0-255,66,263893,7,281305
17326,0.074237,74.125.24.0-255,5738,269631,7,281305
17327,0.074243,172.31.36.0-255,66,269697,7,281305
17328,0.076813,74.125.24.0-255,5738,275435,7,281305
17329,0.076818,172.31.36.0-255,66,275501,7,281305
17330,0.079397,74.125.24.0-255,5738,281239,7,281305
17331,0.079402,172.31.36.0-255,66,281305,7,281305
17332,0.0,172.217.26.0-255,66,66,7,66
17333,0.0,172.217.194.0-255,153,153,7,222023
17334,2.2e-05,172.31.36.0-255,66,219,7,222023
17335,3e-05,172.217.194.0-255,1484,1703,7,222023
17336,3.4e-05,172.31.36.0-255,66,1769,7,222023
17337,4e-05,172.217.194.0-255,2902,4671,7,222023
17338,4.3e-05,172.31.36.0-255,66,4737,7,222023
17339,6.4e-05,172.217.194.0-255,1484,6221,7,222023
17340,6.6e-05,172.31.36.0-255,66,6287,7,222023
17341,0.000109,172.217.194.0-255,2902,9189,7,222023
17342,0.000111,172.31.36.0-255,66,9255,7,222023
17343,0.000189,172.217.194.0-255,6306,15561,7,222023
17344,0.000193,172.31.36.0-255,66,15627,7,222023
17345,0.000334,172.217.194.0-255,5738,21365,7,222023
17346,0.00034,172.31.36.0-255,66,21431,7,222023
17347,0.000369,172.31.36.0-255,66,21497,7,222023
17348,0.000698,172.31.36.0-255,66,21563,7,222023
17349,0.000725,172.31.36.0-255,66,21629,7,222023
17350,0.00111,172.217.194.0-255,4320,25949,7,222023
17351,0.001116,172.31.36.0-255,66,26015,7,222023
17352,0.001142,172.31.36.0-255,66,26081,7,222023
17353,0.001524,172.31.36.0-255,66,26147,7,222023
17354,0.001558,172.31.36.0-255,66,26213,7,222023
17355,0.002332,172.217.194.0-255,5738,31951,7,222023
17356,0.002337,172.31.36.0-255,66,32017,7,222023
17357,0.002378,172.31.36.0-255,66,32083,7,222023
17358,0.006692,172.31.36.0-255,66,32149,7,222023
17359,0.008973,172.217.194.0-255,5738,37887,7,222023
17360,0.008981,172.31.36.0-255,66,37953,7,222023
17361,0.011277,172.217.194.0-255,5738,43691,7,222023
17362,0.011286,172.31.36.0-255,66,43757,7,222023
17363,0.013594,172.217.194.0-255,5738,49495,7,222023
17364,0.013605,172.31.36.0-255,66,49561,7,222023
17365,0.016048,172.217.194.0-255,4320,53881,7,222023
17366,0.016057,172.31.36.0-255,66,53947,7,222023
17367,0.016079,172.217.194.0-255,1484,55431,7,222023
17368,0.018344,172.217.194.0-255,4320,59751,7,222023
17369,0.01835,172.31.36.0-255,66,59817,7,222023
17370,0.020633,172.217.194.0-255,5738,65555,7,222023
17371,0.02068,172.31.36.0-255,66,65621,7,222023
17372,0.023001,172.217.194.0-255,5738,71359,7,222023
17373,0.02302,172.31.36.0-255,66,71425,7,222023
17374,0.025298,172.217.194.0-255,5738,77163,7,222023
17375,0.025305,172.31.36.0-255,66,77229,7,222023
17376,0.027622,172.217.194.0-255,5738,82967,7,222023
17377,0.02763,172.31.36.0-255,66,83033,7,222023
17378,0.029917,172.217.194.0-255,5738,88771,7,222023
17379,0.029925,172.31.36.0-255,66,88837,7,222023
17380,0.032203,172.217.194.0-255,5738,94575,7,222023
17381,0.032211,172.31.36.0-255,66,94641,7,222023
17382,0.034494,172.217.194.0-255,5738,100379,7,222023
17383,0.034503,172.31.36.0-255,66,100445,7,222023
17384,0.036783,172.217.194.0-255,5738,106183,7,222023
17385,0.03679,172.31.36.0-255,66,106249,7,222023
17386,0.039089,172.217.194.0-255,5738,111987,7,222023
17387,0.039097,172.31.36.0-255,66,112053,7,222023
17388,0.040796,172.31.36.0-255,172,112225,7,222023
17389,0.040829,172.31.36.0-255,1115,113340,7,222023
17390,0.04092,172.31.36.0-255,1514,114854,7,222023
17391,0.040922,172.31.36.0-255,1514,116368,7,222023
17392,0.040923,172.31.36.0-255,1514,117882,7,222023
17393,0.040929,172.31.36.0-255,1514,119396,7,222023
17394,0.04093,172.31.36.0-255,1514,120910,7,222023
17395,0.040931,172.31.36.0-255,69,120979,7,222023
17396,0.041368,172.217.194.0-255,5738,126717,7,222023
17397,0.041377,172.31.36.0-255,66,126783,7,222023
17398,0.042326,104.244.42.0-255,66,126849,7,222023
17399,0.042362,104.244.42.0-255,66,126915,7,222023
17400,0.042563,104.244.42.0-255,66,126981,7,222023
17401,0.04257,104.244.42.0-255,66,127047,7,222023
17402,0.043643,172.217.194.0-255,2902,129949,7,222023
17403,0.043649,172.31.36.0-255,66,130015,7,222023
17404,0.043673,172.217.194.0-255,2902,132917,7,222023
17405,0.043698,172.31.36.0-255,66,132983,7,222023
17406,0.045935,172.217.194.0-255,2902,135885,7,222023
17407,0.045942,172.31.36.0-255,66,135951,7,222023
17408,0.045976,172.217.194.0-255,2902,138853,7,222023
17409,0.045999,172.31.36.0-255,66,138919,7,222023
17410,0.048227,172.217.194.0-255,2902,141821,7,222023
17411,0.048234,172.31.36.0-255,66,141887,7,222023
17412,0.048279,172.217.194.0-255,2902,144789,7,222023
17413,0.048321,172.31.36.0-255,66,144855,7,222023
17414,0.050531,172.217.194.0-255,2902,147757,7,222023
17415,0.05054,172.31.36.0-255,66,147823,7,222023
17416,0.050595,172.217.194.0-255,2902,150725,7,222023
17417,0.050754,172.31.36.0-255,66,150791,7,222023
17418,0.052825,172.217.194.0-255,2902,153693,7,222023
17419,0.052831,172.31.36.0-255,66,153759,7,222023
17420,0.053034,172.217.194.0-255,2902,156661,7,222023
17421,0.053039,172.31.36.0-255,66,156727,7,222023
17422,0.055114,172.217.194.0-255,2902,159629,7,222023
17423,0.055119,172.31.36.0-255,66,159695,7,222023
17424,0.055323,172.217.194.0-255,2902,162597,7,222023
17425,0.055328,172.31.36.0-255,66,162663,7,222023
17426,0.057417,172.217.194.0-255,2902,165565,7,222023
17427,0.057423,172.31.36.0-255,66,165631,7,222023
17428,0.05759,172.217.194.0-255,2902,168533,7,222023
17429,0.057596,172.31.36.0-255,66,168599,7,222023
17430,0.059712,172.217.194.0-255,2902,171501,7,222023
17431,0.059719,172.31.36.0-255,66,171567,7,222023
17432,0.059879,172.217.194.0-255,2902,174469,7,222023
17433,0.059885,172.31.36.0-255,66,174535,7,222023
17434,0.061997,172.217.194.0-255,2902,177437,7,222023
17435,0.062004,172.31.36.0-255,66,177503,7,222023
17436,0.062179,172.217.194.0-255,2902,180405,7,222023
17437,0.062198,172.31.36.0-255,66,180471,7,222023
17438,0.064282,172.217.194.0-255,2902,183373,7,222023
17439,0.064287,172.31.36.0-255,66,183439,7,222023
17440,0.064466,172.217.194.0-255,2902,186341,7,222023
17441,0.064471,172.31.36.0-255,66,186407,7,222023
17442,0.066568,172.217.194.0-255,2902,189309,7,222023
17443,0.066574,172.31.36.0-255,66,189375,7,222023
17444,0.066755,172.217.194.0-255,2902,192277,7,222023
17445,0.066761,172.31.36.0-255,66,192343,7,222023
17446,0.068853,172.217.194.0-255,2902,195245,7,222023
17447,0.068859,172.31.36.0-255,66,195311,7,222023
17448,0.069028,172.217.194.0-255,2902,198213,7,222023
17449,0.069033,172.31.36.0-255,66,198279,7,222023
17450,0.071143,172.217.194.0-255,2902,201181,7,222023
17451,0.07115,172.31.36.0-255,66,201247,7,222023
17452,0.07128,172.217.194.0-255,2902,204149,7,222023
17453,0.071732,172.31.36.0-255,66,204215,7,222023
17454,0.073451,172.217.194.0-255,2902,207117,7,222023
17455,0.073458,172.31.36.0-255,66,207183,7,222023
17456,0.074014,172.217.194.0-255,2902,210085,7,222023
17457,0.07402,172.31.36.0-255,66,210151,7,222023
17458,0.075747,172.217.194.0-255,2902,213053,7,222023
17459,0.075754,172.31.36.0-255,66,213119,7,222023
17460,0.076311,172.217.194.0-255,2902,216021,7,222023
17461,0.076317,172.31.36.0-255,66,216087,7,222023
17462,0.078044,172.217.194.0-255,2902,218989,7,222023
17463,0.07805,172.31.36.0-255,66,219055,7,222023
17464,0.0786,172.217.194.0-255,2902,221957,7,222023
17465,0.078606,172.31.36.0-255,66,222023,7,222023
17466,0.0,172.217.194.0-255,159,159,7,224381
17467,2.4e-05,172.31.36.0-255,66,225,7,224381
17468,3.1e-05,172.217.194.0-255,1484,1709,7,224381
17469,3.6e-05,172.31.36.0-255,66,1775,7,224381
17470,4.2e-05,172.217.194.0-255,2902,4677,7,224381
17471,4.6e-05,172.31.36.0-255,66,4743,7,224381
17472,5.2e-05,172.217.194.0-255,5738,10481,7,224381
17473,5.5e-05,172.31.36.0-255,66,10547,7,224381
17474,6.7e-05,172.31.36.0-255,66,10613,7,224381
17475,0.000102,172.217.194.0-255,2037,12650,7,224381
17476,0.000105,172.31.36.0-255,66,12716,7,224381
17477,0.000122,172.31.36.0-255,66,12782,7,224381
17478,0.000154,172.217.194.0-255,7156,19938,7,224381
17479,0.000157,172.31.36.0-255,66,20004,7,224381
17480,0.000179,172.217.194.0-255,3602,23606,7,224381
17481,0.000181,172.31.36.0-255,66,23672,7,224381
17482,0.000344,172.217.194.0-255,1484,25156,7,224381
17483,0.000349,172.31.36.0-255,66,25222,7,224381
17484,0.000353,172.217.194.0-255,1484,26706,7,224381
17485,0.000355,172.31.36.0-255,66,26772,7,224381
17486,0.000371,172.217.194.0-255,1484,28256,7,224381
17487,0.000373,172.31.36.0-255,66,28322,7,224381
17488,0.000379,172.217.194.0-255,4320,32642,7,224381
17489,0.000382,172.31.36.0-255,66,32708,7,224381
17490,0.000387,172.217.194.0-255,4320,37028,7,224381
17491,0.00039,172.31.36.0-255,66,37094,7,224381
17492,0.000415,172.217.194.0-255,4249,41343,7,224381
17493,0.000419,172.31.36.0-255,66,41409,7,224381
17494,0.000422,172.217.194.0-255,98,41507,7,224381
17495,0.000424,172.31.36.0-255,66,41573,7,224381
17496,0.000475,172.217.194.0-255,1484,43057,7,224381
17497,0.000479,172.217.194.0-255,1484,44541,7,224381
17498,0.000481,172.31.36.0-255,66,44607,7,224381
17499,0.000498,172.217.194.0-255,1484,46091,7,224381
17500,0.000506,172.217.194.0-255,5738,51829,7,224381
17501,0.000508,172.31.36.0-255,66,51895,7,224381
17502,0.000513,172.217.194.0-255,4320,56215,7,224381
17503,0.000516,172.31.36.0-255,66,56281,7,224381
17504,0.000542,172.31.36.0-255,66,56347,7,224381
17505,0.000555,172.31.36.0-255,66,56413,7,224381
17506,0.00059,172.217.194.0-255,4320,60733,7,224381
17507,0.000593,172.31.36.0-255,66,60799,7,224381
17508,0.000623,172.31.36.0-255,66,60865,7,224381
17509,0.000751,172.217.194.0-255,1484,62349,7,224381
17510,0.000757,172.217.194.0-255,2902,65251,7,224381
17511,0.00076,172.31.36.0-255,66,65317,7,224381
17512,0.000767,172.217.194.0-255,5738,71055,7,224381
17513,0.000769,172.31.36.0-255,66,71121,7,224381
17514,0.000797,172.217.194.0-255,7156,78277,7,224381
17515,0.0008,172.31.36.0-255,66,78343,7,224381
17516,0.00082,172.217.194.0-255,5738,84081,7,224381
17517,0.000823,172.31.36.0-255,66,84147,7,224381
17518,0.000845,172.217.194.0-255,5738,89885,7,224381
17519,0.000848,172.31.36.0-255,66,89951,7,224381
17520,0.000865,172.217.194.0-255,5020,94971,7,224381
17521,0.000868,172.31.36.0-255,66,95037,7,224381
17522,0.001441,172.217.194.0-255,1484,96521,7,224381
17523,0.001448,172.217.194.0-255,2902,99423,7,224381
17524,0.001452,172.31.36.0-255,66,99489,7,224381
17525,0.001476,172.217.194.0-255,5738,105227,7,224381
17526,0.001479,172.31.36.0-255,66,105293,7,224381
17527,0.001516,172.217.194.0-255,2902,108195,7,224381
17528,0.001518,172.31.36.0-255,66,108261,7,224381
17529,0.001538,172.31.36.0-255,66,108327,7,224381
17530,0.00155,172.31.36.0-255,66,108393,7,224381
17531,0.001633,172.217.194.0-255,1484,109877,7,224381
17532,0.001637,172.217.194.0-255,1484,111361,7,224381
17533,0.00164,172.31.36.0-255,66,111427,7,224381
17534,0.001654,172.217.194.0-255,1484,112911,7,224381
17535,0.001666,172.217.194.0-255,1484,114395,7,224381
17536,0.001669,172.31.36.0-255,66,114461,7,224381
17537,0.001692,172.217.194.0-255,4320,118781,7,224381
17538,0.001695,172.31.36.0-255,66,118847,7,224381
17539,0.001709,172.31.36.0-255,66,118913,7,224381
17540,0.001722,172.31.36.0-255,66,118979,7,224381
17541,0.002014,172.217.194.0-255,1484,120463,7,224381
17542,0.00202,172.217.194.0-255,2902,123365,7,224381
17543,0.002024,172.31.36.0-255,66,123431,7,224381
17544,0.002058,172.217.194.0-255,4320,127751,7,224381
17545,0.002062,172.31.36.0-255,66,127817,7,224381
17546,0.002075,172.217.194.0-255,1484,129301,7,224381
17547,0.002083,172.217.194.0-255,7156,136457,7,224381
17548,0.002085,172.31.36.0-255,66,136523,7,224381
17549,0.002088,172.217.194.0-255,1484,138007,7,224381
17550,0.002107,172.217.194.0-255,7156,145163,7,224381
17551,0.002109,172.31.36.0-255,66,145229,7,224381
17552,0.002136,172.217.194.0-255,5738,150967,7,224381
17553,0.002139,172.31.36.0-255,66,151033,7,224381
17554,0.002143,172.217.194.0-255,2184,153217,7,224381
17555,0.002145,172.31.36.0-255,66,153283,7,224381
17556,0.002168,172.217.194.0-255,4320,157603,7,224381
17557,0.00217,172.31.36.0-255,66,157669,7,224381
17558,0.002198,172.217.194.0-255,5738,163407,7,224381
17559,0.002201,172.31.36.0-255,66,163473,7,224381
17560,0.002204,172.217.194.0-255,1484,164957,7,224381
17561,0.002229,172.31.36.0-255,66,165023,7,224381
17562,0.002273,172.31.36.0-255,66,165089,7,224381
17563,0.002291,172.217.194.0-255,2184,167273,7,224381
17564,0.002294,172.31.36.0-255,66,167339,7,224381
17565,0.002373,172.217.194.0-255,1484,168823,7,224381
17566,0.002391,172.217.194.0-255,2902,171725,7,224381
17567,0.002394,172.31.36.0-255,66,171791,7,224381
17568,0.002418,172.217.194.0-255,5738,177529,7,224381
17569,0.002422,172.31.36.0-255,66,177595,7,224381
17570,0.002433,172.31.36.0-255,66,177661,7,224381
17571,0.002465,172.217.194.0-255,4320,181981,7,224381
17572,0.002468,172.31.36.0-255,66,182047,7,224381
17573,0.002501,172.31.36.0-255,66,182113,7,224381
17574,0.002534,172.31.36.0-255,66,182179,7,224381
17575,0.002537,172.217.194.0-255,1484,183663,7,224381
17576,0.00254,172.217.194.0-255,1484,185147,7,224381
17577,0.002542,172.31.36.0-255,66,185213,7,224381
17578,0.00257,172.31.36.0-255,66,185279,7,224381
17579,0.002573,172.217.194.0-255,766,186045,7,224381
17580,0.002955,172.217.194.0-255,1484,187529,7,224381
17581,0.002961,172.31.36.0-255,66,187595,7,224381
17582,0.002967,172.217.194.0-255,2902,190497,7,224381
17583,0.00297,172.31.36.0-255,66,190563,7,224381
17584,0.002973,172.217.194.0-255,1484,192047,7,224381
17585,0.002993,172.217.194.0-255,4320,196367,7,224381
17586,0.002997,172.31.36.0-255,66,196433,7,224381
17587,0.003002,172.217.194.0-255,4320,200753,7,224381
17588,0.003005,172.31.36.0-255,66,200819,7,224381
17589,0.003041,172.31.36.0-255,66,200885,7,224381
17590,0.003044,172.217.194.0-255,1484,202369,7,224381
17591,0.003047,172.31.36.0-255,78,202447,7,224381
17592,0.003062,172.31.36.0-255,66,202513,7,224381
17593,0.003073,172.31.36.0-255,66,202579,7,224381
17594,0.003076,172.217.194.0-255,1484,204063,7,224381
17595,0.003083,172.217.194.0-255,5738,209801,7,224381
17596,0.003085,172.31.36.0-255,66,209867,7,224381
17597,0.003109,172.217.194.0-255,2902,212769,7,224381
17598,0.003112,172.31.36.0-255,66,212835,7,224381
17599,0.003118,172.217.194.0-255,6830,219665,7,224381
17600,0.00312,172.31.36.0-255,66,219731,7,224381
17601,0.003161,172.217.194.0-255,105,219836,7,224381
17602,0.010884,172.31.36.0-255,66,219902,7,224381
17603,0.01093,172.31.36.0-255,105,220007,7,224381
17604,0.013564,172.217.194.0-255,66,220073,7,224381
17605,0.029907,172.31.36.0-255,190,220263,7,224381
17606,0.02994,172.31.36.0-255,1115,221378,7,224381
17607,0.030003,172.31.36.0-255,1514,222892,7,224381
17608,0.030004,172.31.36.0-255,1291,224183,7,224381
17609,0.031454,104.244.42.0-255,66,224249,7,224381
17610,0.031554,104.244.42.0-255,66,224315,7,224381
17611,0.031612,104.244.42.0-255,66,224381,7,224381
17612,0.0,74.125.24.0-255,153,153,7,315342
17613,3.6e-05,172.31.36.0-255,66,219,7,315342
17614,4.4e-05,74.125.24.0-255,1484,1703,7,315342
17615,4.8e-05,172.31.36.0-255,66,1769,7,315342
17616,5.3e-05,74.125.24.0-255,2902,4671,7,315342
17617,5.5e-05,172.31.36.0-255,66,4737,7,315342
17618,6.1e-05,74.125.24.0-255,7156,11893,7,315342
17619,6.3e-05,172.31.36.0-255,66,11959,7,315342
17620,6.7e-05,74.125.24.0-255,2020,13979,7,315342
17621,7e-05,172.31.36.0-255,66,14045,7,315342
17622,0.000113,74.125.24.0-255,1484,15529,7,315342
17623,0.000117,172.31.36.0-255,66,15595,7,315342
17624,0.000123,74.125.24.0-255,2902,18497,7,315342
17625,0.000127,172.31.36.0-255,66,18563,7,315342
17626,0.000148,74.125.24.0-255,5738,24301,7,315342
17627,0.000151,172.31.36.0-255,66,24367,7,315342
17628,0.000179,74.125.24.0-255,6797,31164,7,315342
17629,0.000181,172.31.36.0-255,66,31230,7,315342
17630,0.000187,74.125.24.0-255,7156,38386,7,315342
17631,0.000189,172.31.36.0-255,66,38452,7,315342
17632,0.000238,172.31.36.0-255,66,38518,7,315342
17633,0.000255,74.125.24.0-255,1484,40002,7,315342
17634,0.000258,172.31.36.0-255,66,40068,7,315342
17635,0.000282,74.125.24.0-255,1484,41552,7,315342
17636,0.000284,172.31.36.0-255,66,41618,7,315342
17637,0.000289,74.125.24.0-255,4320,45938,7,315342
17638,0.000291,172.31.36.0-255,66,46004,7,315342
17639,0.000305,74.125.24.0-255,2902,48906,7,315342
17640,0.000307,172.31.36.0-255,66,48972,7,315342
17641,0.000334,74.125.24.0-255,5738,54710,7,315342
17642,0.000336,172.31.36.0-255,66,54776,7,315342
17643,0.000339,74.125.24.0-255,1125,55901,7,315342
17644,0.000351,74.125.24.0-255,646,56547,7,315342
17645,0.000353,172.31.36.0-255,66,56613,7,315342
17646,0.000599,74.125.24.0-255,1484,58097,7,315342
17647,0.000615,74.125.24.0-255,2902,60999,7,315342
17648,0.000618,172.31.36.0-255,66,61065,7,315342
17649,0.000623,74.125.24.0-255,2902,63967,7,315342
17650,0.000624,172.31.36.0-255,66,64033,7,315342
17651,0.000637,74.125.24.0-255,2902,66935,7,315342
17652,0.00064,172.31.36.0-255,66,67001,7,315342
17653,0.000662,74.125.24.0-255,4320,71321,7,315342
17654,0.000665,172.31.36.0-255,66,71387,7,315342
17655,0.000683,74.125.24.0-255,1994,73381,7,315342
17656,0.000685,172.31.36.0-255,66,73447,7,315342
17657,0.001262,74.125.24.0-255,1484,74931,7,315342
17658,0.001273,74.125.24.0-255,2902,77833,7,315342
17659,0.001277,172.31.36.0-255,66,77899,7,315342
17660,0.001302,74.125.24.0-255,5738,83637,7,315342
17661,0.001305,172.31.36.0-255,66,83703,7,315342
17662,0.00134,172.31.36.0-255,66,83769,7,315342
17663,0.001362,74.125.24.0-255,4320,88089,7,315342
17664,0.001366,172.31.36.0-255,66,88155,7,315342
17665,0.001372,74.125.24.0-255,5738,93893,7,315342
17666,0.001374,172.31.36.0-255,66,93959,7,315342
17667,0.00139,74.125.24.0-255,5020,98979,7,315342
17668,0.001393,172.31.36.0-255,66,99045,7,315342
17669,0.001479,74.125.24.0-255,1484,100529,7,315342
17670,0.001485,74.125.24.0-255,2902,103431,7,315342
17671,0.001489,172.31.36.0-255,66,103497,7,315342
17672,0.001492,74.125.24.0-255,1484,104981,7,315342
17673,0.001512,74.125.24.0-255,4320,109301,7,315342
17674,0.001515,172.31.36.0-255,66,109367,7,315342
17675,0.001521,74.125.24.0-255,4320,113687,7,315342
17676,0.001524,172.31.36.0-255,66,113753,7,315342
17677,0.001567,172.31.36.0-255,66,113819,7,315342
17678,0.00158,172.31.36.0-255,66,113885,7,315342
17679,0.001648,74.125.24.0-255,1484,115369,7,315342
17680,0.001653,74.125.24.0-255,2902,118271,7,315342
17681,0.001656,172.31.36.0-255,66,118337,7,315342
17682,0.001683,74.125.24.0-255,5738,124075,7,315342
17683,0.001685,172.31.36.0-255,66,124141,7,315342
17684,0.001689,74.125.24.0-255,1484,125625,7,315342
17685,0.001723,172.31.36.0-255,66,125691,7,315342
17686,0.001735,172.31.36.0-255,66,125757,7,315342
17687,0.001855,74.125.24.0-255,1484,127241,7,315342
17688,0.001861,74.125.24.0-255,2902,130143,7,315342
17689,0.001864,172.31.36.0-255,66,130209,7,315342
17690,0.00187,74.125.24.0-255,4320,134529,7,315342
17691,0.001871,172.31.36.0-255,66,134595,7,315342
17692,0.001884,74.125.24.0-255,1484,136079,7,315342
17693,0.001916,172.31.36.0-255,66,136145,7,315342
17694,0.001928,172.31.36.0-255,66,136211,7,315342
17695,0.001943,74.125.24.0-255,2184,138395,7,315342
17696,0.001945,172.31.36.0-255,66,138461,7,315342
17697,0.00201,74.125.24.0-255,1484,139945,7,315342
17698,0.002022,74.125.24.0-255,2902,142847,7,315342
17699,0.002024,172.31.36.0-255,66,142913,7,315342
17700,0.002028,74.125.24.0-255,1484,144397,7,315342
17701,0.002046,74.125.24.0-255,4320,148717,7,315342
17702,0.002049,172.31.36.0-255,66,148783,7,315342
17703,0.002051,74.125.24.0-255,1484,150267,7,315342
17704,0.002058,74.125.24.0-255,4320,154587,7,315342
17705,0.002059,172.31.36.0-255,66,154653,7,315342
17706,0.002073,74.125.24.0-255,4320,158973,7,315342
17707,0.002075,172.31.36.0-255,66,159039,7,315342
17708,0.002105,74.125.24.0-255,7156,166195,7,315342
17709,0.002108,172.31.36.0-255,66,166261,7,315342
17710,0.002137,74.125.24.0-255,6438,172699,7,315342
17711,0.002141,172.31.36.0-255,66,172765,7,315342
17712,0.002205,172.31.36.0-255,66,172831,7,315342
17713,0.002219,172.31.36.0-255,66,172897,7,315342
17714,0.002224,74.125.24.0-255,3602,176499,7,315342
17715,0.002226,172.31.36.0-255,66,176565,7,315342
17716,0.002248,74.125.24.0-255,1484,178049,7,315342
17717,0.002264,74.125.24.0-255,2902,180951,7,315342
17718,0.002267,172.31.36.0-255,66,181017,7,315342
17719,0.004466,74.125.24.0-255,1484,182501,7,315342
17720,0.004494,74.125.24.0-255,4320,186821,7,315342
17721,0.004502,172.31.36.0-255,66,186887,7,315342
17722,0.006739,74.125.24.0-255,5738,192625,7,315342
17723,0.006748,172.31.36.0-255,66,192691,7,315342
17724,0.008993,74.125.24.0-255,5738,198429,7,315342
17725,0.009007,172.31.36.0-255,66,198495,7,315342
17726,0.011249,74.125.24.0-255,5738,204233,7,315342
17727,0.011263,172.31.36.0-255,66,204299,7,315342
17728,0.013503,74.125.24.0-255,5738,210037,7,315342
17729,0.013518,172.31.36.0-255,66,210103,7,315342
17730,0.01577,74.125.24.0-255,5738,215841,7,315342
17731,0.015789,172.31.36.0-255,66,215907,7,315342
17732,0.018041,74.125.24.0-255,5738,221645,7,315342
17733,0.018055,172.31.36.0-255,66,221711,7,315342
17734,0.020314,74.125.24.0-255,5738,227449,7,315342
17735,0.020329,172.31.36.0-255,66,227515,7,315342
17736,0.022568,74.125.24.0-255,5738,233253,7,315342
17737,0.022582,172.31.36.0-255,66,233319,7,315342
17738,0.024836,74.125.24.0-255,5738,239057,7,315342
17739,0.024846,172.31.36.0-255,66,239123,7,315342
17740,0.027085,74.125.24.0-255,5738,244861,7,315342
17741,0.027102,172.31.36.0-255,66,244927,7,315342
17742,0.029391,74.125.24.0-255,5738,250665,7,315342
17743,0.029412,172.31.36.0-255,66,250731,7,315342
17744,0.031671,74.125.24.0-255,5738,256469,7,315342
17745,0.031689,172.31.36.0-255,66,256535,7,315342
17746,0.033033,172.31.36.0-255,172,256707,7,315342
17747,0.033184,172.31.36.0-255,1115,257822,7,315342
17748,0.03327,172.31.36.0-255,1514,259336,7,315342
17749,0.033272,172.31.36.0-255,1514,260850,7,315342
17750,0.033273,172.31.36.0-255,1514,262364,7,315342
17751,0.033274,172.31.36.0-255,1514,263878,7,315342
17752,0.033313,172.31.36.0-255,1514,265392,7,315342
17753,0.033319,172.31.36.0-255,69,265461,7,315342
17754,0.033932,74.125.24.0-255,5738,271199,7,315342
17755,0.033943,172.31.36.0-255,66,271265,7,315342
17756,0.034588,104.244.42.0-255,66,271331,7,315342
17757,0.034705,104.244.42.0-255,66,271397,7,315342
17758,0.034862,104.244.42.0-255,66,271463,7,315342
17759,0.034869,104.244.42.0-255,66,271529,7,315342
17760,0.0362,74.125.24.0-255,5738,277267,7,315342
17761,0.036238,172.31.36.0-255,66,277333,7,315342
17762,0.038545,74.125.24.0-255,5738,283071,7,315342
17763,0.038559,172.31.36.0-255,66,283137,7,315342
17764,0.040788,74.125.24.0-255,5738,288875,7,315342
17765,0.040799,172.31.36.0-255,66,288941,7,315342
17766,0.043034,74.125.24.0-255,5738,294679,7,315342
17767,0.043048,172.31.36.0-255,66,294745,7,315342
17768,0.04528,74.125.24.0-255,5738,300483,7,315342
17769,0.045309,172.31.36.0-255,66,300549,7,315342
17770,0.047554,74.125.24.0-255,5738,306287,7,315342
17771,0.047564,172.31.36.0-255,66,306353,7,315342
17772,0.049801,74.125.24.0-255,5738,312091,7,315342
17773,0.049809,172.31.36.0-255,66,312157,7,315342
17774,0.052042,74.125.24.0-255,2948,315105,7,315342
17775,0.052056,172.31.36.0-255,66,315171,7,315342
17776,0.053568,172.31.36.0-255,105,315276,7,315342
17777,0.05579,74.125.24.0-255,66,315342,7,315342
17778,0.0,74.125.68.0-255,152,152,7,333952
17779,2.8e-05,172.31.36.0-255,66,218,7,333952
17780,3.5e-05,74.125.68.0-255,1484,1702,7,333952
17781,3.9e-05,172.31.36.0-255,66,1768,7,333952
17782,4.2e-05,74.125.68.0-255,1484,3252,7,333952
17783,4.4e-05,172.31.36.0-255,66,3318,7,333952
17784,5.7e-05,74.125.68.0-255,2902,6220,7,333952
17785,5.9e-05,172.31.36.0-255,66,6286,7,333952
17786,8.9e-05,74.125.68.0-255,5738,12024,7,333952
17787,9.4e-05,172.31.36.0-255,66,12090,7,333952
17788,9.8e-05,74.125.68.0-255,1976,14066,7,333952
17789,0.0001,172.31.36.0-255,66,14132,7,333952
17790,0.000139,74.125.68.0-255,1484,15616,7,333952
17791,0.000142,172.31.36.0-255,66,15682,7,333952
17792,0.000167,74.125.68.0-255,2902,18584,7,333952
17793,0.000173,172.31.36.0-255,66,18650,7,333952
17794,0.000198,74.125.68.0-255,2902,21552,7,333952
17795,0.000201,172.31.36.0-255,66,21618,7,333952
17796,0.000226,74.125.68.0-255,2902,24520,7,333952
17797,0.000229,172.31.36.0-255,66,24586,7,333952
17798,0.000234,74.125.68.0-255,4320,28906,7,333952
17799,0.000237,172.31.36.0-255,66,28972,7,333952
17800,0.000241,74.125.68.0-255,2543,31515,7,333952
17801,0.000248,172.31.36.0-255,66,31581,7,333952
17802,0.00031,74.125.68.0-255,1484,33065,7,333952
17803,0.000315,172.31.36.0-255,66,33131,7,333952
17804,0.000321,74.125.68.0-255,2902,36033,7,333952
17805,0.000323,172.31.36.0-255,66,36099,7,333952
17806,0.000326,74.125.68.0-255,1484,37583,7,333952
17807,0.000333,172.31.36.0-255,66,37649,7,333952
17808,0.000361,74.125.68.0-255,4320,41969,7,333952
17809,0.000369,172.31.36.0-255,66,42035,7,333952
17810,0.000376,74.125.68.0-255,4320,46355,7,333952
17811,0.000378,172.31.36.0-255,66,46421,7,333952
17812,0.00041,74.125.68.0-255,2543,48964,7,333952
17813,0.000413,172.31.36.0-255,66,49030,7,333952
17814,0.000485,74.125.68.0-255,1484,50514,7,333952
17815,0.000488,74.125.68.0-255,1484,51998,7,333952
17816,0.000494,172.31.36.0-255,66,52064,7,333952
17817,0.000511,74.125.68.0-255,1484,53548,7,333952
17818,0.000516,74.125.68.0-255,2902,56450,7,333952
17819,0.000519,172.31.36.0-255,66,56516,7,333952
17820,0.000542,74.125.68.0-255,1484,58000,7,333952
17821,0.000556,172.31.36.0-255,66,58066,7,333952
17822,0.000648,74.125.68.0-255,332,58398,7,333952
17823,0.000851,172.31.36.0-255,66,58464,7,333952
17824,0.001208,74.125.68.0-255,1484,59948,7,333952
17825,0.001217,74.125.68.0-255,1484,61432,7,333952
17826,0.001221,172.31.36.0-255,66,61498,7,333952
17827,0.001253,74.125.68.0-255,1484,62982,7,333952
17828,0.001256,74.125.68.0-255,1484,64466,7,333952
17829,0.001258,172.31.36.0-255,66,64532,7,333952
17830,0.001263,74.125.68.0-255,2902,67434,7,333952
17831,0.001266,172.31.36.0-255,66,67500,7,333952
17832,0.001278,74.125.68.0-255,5738,73238,7,333952
17833,0.00128,172.31.36.0-255,66,73304,7,333952
17834,0.00131,74.125.68.0-255,5738,79042,7,333952
17835,0.001313,172.31.36.0-255,66,79108,7,333952
17836,0.001345,74.125.68.0-255,4320,83428,7,333952
17837,0.001347,172.31.36.0-255,66,83494,7,333952
17838,0.001358,172.31.36.0-255,66,83560,7,333952
17839,0.001795,74.125.68.0-255,1484,85044,7,333952
17840,0.001812,74.125.68.0-255,1484,86528,7,333952
17841,0.001814,172.31.36.0-255,66,86594,7,333952
17842,0.001834,74.125.68.0-255,1484,88078,7,333952
17843,0.001839,74.125.68.0-255,4320,92398,7,333952
17844,0.001841,172.31.36.0-255,66,92464,7,333952
17845,0.00187,172.31.36.0-255,66,92530,7,333952
17846,0.001874,74.125.68.0-255,2902,95432,7,333952
17847,0.001875,172.31.36.0-255,66,95498,7,333952
17848,0.001912,74.125.68.0-255,2902,98400,7,333952
17849,0.001914,172.31.36.0-255,66,98466,7,333952
17850,0.00192,74.125.68.0-255,7156,105622,7,333952
17851,0.001923,172.31.36.0-255,66,105688,7,333952
17852,0.001932,74.125.68.0-255,3602,109290,7,333952
17853,0.001934,172.31.36.0-255,66,109356,7,333952
17854,0.003897,74.125.68.0-255,1484,110840,7,333952
17855,0.003919,74.125.68.0-255,4320,115160,7,333952
17856,0.003923,172.31.36.0-255,66,115226,7,333952
17857,0.005915,74.125.68.0-255,5738,120964,7,333952
17858,0.005921,172.31.36.0-255,66,121030,7,333952
17859,0.00792,74.125.68.0-255,5738,126768,7,333952
17860,0.007926,172.31.36.0-255,66,126834,7,333952
17861,0.009933,74.125.68.0-255,5738,132572,7,333952
17862,0.009942,172.31.36.0-255,66,132638,7,333952
17863,0.01206,74.125.68.0-255,5738,138376,7,333952
17864,0.012066,172.31.36.0-255,66,138442,7,333952
17865,0.014066,74.125.68.0-255,5738,144180,7,333952
17866,0.014073,172.31.36.0-255,66,144246,7,333952
17867,0.016068,74.125.68.0-255,5738,149984,7,333952
17868,0.016077,172.31.36.0-255,66,150050,7,333952
17869,0.01807,74.125.68.0-255,5738,155788,7,333952
17870,0.018078,172.31.36.0-255,66,155854,7,333952
17871,0.020073,74.125.68.0-255,5738,161592,7,333952
17872,0.02008,172.31.36.0-255,66,161658,7,333952
17873,0.022076,74.125.68.0-255,4320,165978,7,333952
17874,0.022082,172.31.36.0-255,66,166044,7,333952
17875,0.022111,74.125.68.0-255,1484,167528,7,333952
17876,0.022945,172.31.36.0-255,188,167716,7,333952
17877,0.022987,172.31.36.0-255,958,168674,7,333952
17878,0.023059,172.31.36.0-255,1514,170188,7,333952
17879,0.023062,172.31.36.0-255,1448,171636,7,333952
17880,0.024088,74.125.68.0-255,4320,175956,7,333952
17881,0.024094,172.31.36.0-255,66,176022,7,333952
17882,0.024486,104.244.42.0-255,66,176088,7,333952
17883,0.024523,104.244.42.0-255,66,176154,7,333952
17884,0.024672,104.244.42.0-255,66,176220,7,333952
17885,0.026063,74.125.68.0-255,1484,177704,7,333952
17886,0.026093,74.125.68.0-255,4320,182024,7,333952
17887,0.026098,172.31.36.0-255,66,182090,7,333952
17888,0.028094,74.125.68.0-255,5738,187828,7,333952
17889,0.028102,172.31.36.0-255,66,187894,7,333952
17890,0.030106,74.125.68.0-255,4320,192214,7,333952
17891,0.030115,172.31.36.0-255,66,192280,7,333952
17892,0.030155,74.125.68.0-255,1484,193764,7,333952
17893,0.032096,74.125.68.0-255,4320,198084,7,333952
17894,0.032103,172.31.36.0-255,66,198150,7,333952
17895,0.034098,74.125.68.0-255,5738,203888,7,333952
17896,0.034105,172.31.36.0-255,66,203954,7,333952
17897,0.036172,74.125.68.0-255,5738,209692,7,333952
17898,0.03618,172.31.36.0-255,66,209758,7,333952
17899,0.038203,74.125.68.0-255,5738,215496,7,333952
17900,0.038213,172.31.36.0-255,66,215562,7,333952
17901,0.040192,74.125.68.0-255,5738,221300,7,333952
17902,0.040201,172.31.36.0-255,66,221366,7,333952
17903,0.04222,74.125.68.0-255,5738,227104,7,333952
17904,0.042232,172.31.36.0-255,66,227170,7,333952
17905,0.044237,74.125.68.0-255,5738,232908,7,333952
17906,0.044245,172.31.36.0-255,66,232974,7,333952
17907,0.04624,74.125.68.0-255,2902,235876,7,333952
17908,0.046246,172.31.36.0-255,66,235942,7,333952
17909,0.046282,74.125.68.0-255,2902,238844,7,333952
17910,0.046286,172.31.36.0-255,66,238910,7,333952
17911,0.048234,74.125.68.0-255,2902,241812,7,333952
17912,0.048239,172.31.36.0-255,66,241878,7,333952
17913,0.04831,74.125.68.0-255,2902,244780,7,333952
17914,0.048315,172.31.36.0-255,66,244846,7,333952
17915,0.050225,74.125.68.0-255,1484,246330,7,333952
17916,0.050255,74.125.68.0-255,1484,247814,7,333952
17917,0.05026,172.31.36.0-255,66,247880,7,333952
17918,0.050287,74.125.68.0-255,1484,249364,7,333952
17919,0.050298,74.125.68.0-255,1484,250848,7,333952
17920,0.050302,172.31.36.0-255,66,250914,7,333952
17921,0.052233,74.125.68.0-255,2902,253816,7,333952
17922,0.052238,172.31.36.0-255,66,253882,7,333952
17923,0.052278,74.125.68.0-255,2902,256784,7,333952
17924,0.052282,172.31.36.0-255,66,256850,7,333952
17925,0.054224,74.125.68.0-255,2902,259752,7,333952
17926,0.05423,172.31.36.0-255,66,259818,7,333952
17927,0.054267,74.125.68.0-255,2902,262720,7,333952
17928,0.05427,172.31.36.0-255,66,262786,7,333952
17929,0.056212,74.125.68.0-255,2902,265688,7,333952
17930,0.056217,172.31.36.0-255,66,265754,7,333952
17931,0.056252,74.125.68.0-255,2902,268656,7,333952
17932,0.056255,172.31.36.0-255,66,268722,7,333952
17933,0.058196,74.125.68.0-255,2902,271624,7,333952
17934,0.058202,172.31.36.0-255,66,271690,7,333952
17935,0.058236,74.125.68.0-255,2902,274592,7,333952
17936,0.058239,172.31.36.0-255,66,274658,7,333952
17937,0.060184,74.125.68.0-255,2902,277560,7,333952
17938,0.060189,172.31.36.0-255,66,277626,7,333952
17939,0.060225,74.125.68.0-255,2902,280528,7,333952
17940,0.060228,172.31.36.0-255,66,280594,7,333952
17941,0.062163,74.125.68.0-255,2902,283496,7,333952
17942,0.062168,172.31.36.0-255,66,283562,7,333952
17943,0.062201,74.125.68.0-255,2902,286464,7,333952
17944,0.062204,172.31.36.0-255,66,286530,7,333952
17945,0.064164,74.125.68.0-255,2902,289432,7,333952
17946,0.064169,172.31.36.0-255,66,289498,7,333952
17947,0.064201,74.125.68.0-255,2902,292400,7,333952
17948,0.064204,172.31.36.0-255,66,292466,7,333952
17949,0.066156,74.125.68.0-255,2902,295368,7,333952
17950,0.066161,172.31.36.0-255,66,295434,7,333952
17951,0.066194,74.125.68.0-255,2902,298336,7,333952
17952,0.066197,172.31.36.0-255,66,298402,7,333952
17953,0.068153,74.125.68.0-255,2902,301304,7,333952
17954,0.068159,172.31.36.0-255,66,301370,7,333952
17955,0.068192,74.125.68.0-255,2902,304272,7,333952
17956,0.068196,172.31.36.0-255,66,304338,7,333952
17957,0.070139,74.125.68.0-255,2902,307240,7,333952
17958,0.070144,172.31.36.0-255,66,307306,7,333952
17959,0.070182,74.125.68.0-255,2902,310208,7,333952
17960,0.070185,172.31.36.0-255,66,310274,7,333952
17961,0.07212,74.125.68.0-255,2902,313176,7,333952
17962,0.072124,172.31.36.0-255,66,313242,7,333952
17963,0.072162,74.125.68.0-255,2902,316144,7,333952
17964,0.072165,172.31.36.0-255,66,316210,7,333952
17965,0.074129,74.125.68.0-255,2902,319112,7,333952
17966,0.074134,172.31.36.0-255,66,319178,7,333952
17967,0.07417,74.125.68.0-255,2902,322080,7,333952
17968,0.074173,172.31.36.0-255,66,322146,7,333952
17969,0.076117,74.125.68.0-255,1484,323630,7,333952
17970,0.076149,74.125.68.0-255,1484,325114,7,333952
17971,0.076154,172.31.36.0-255,66,325180,7,333952
17972,0.076173,74.125.68.0-255,2902,328082,7,333952
17973,0.076176,172.31.36.0-255,66,328148,7,333952
17974,0.078163,74.125.68.0-255,5738,333886,7,333952
17975,0.078168,172.31.36.0-255,66,333952,7,333952
17976,0.0,172.217.194.0-255,153,153,7,271345
17977,2.7e-05,172.31.36.0-255,66,219,7,271345
17978,3.4e-05,172.217.194.0-255,1484,1703,7,271345
17979,4e-05,172.31.36.0-255,66,1769,7,271345
17980,4.5e-05,172.217.194.0-255,2902,4671,7,271345
17981,4.8e-05,172.31.36.0-255,66,4737,7,271345
17982,6.3e-05,172.217.194.0-255,7156,11893,7,271345
17983,6.6e-05,172.31.36.0-255,66,11959,7,271345
17984,6.9e-05,172.217.194.0-255,1484,13443,7,271345
17985,7.1e-05,172.31.36.0-255,66,13509,7,271345
17986,0.000118,172.31.36.0-255,66,13575,7,271345
17987,0.000125,172.217.194.0-255,5738,19313,7,271345
17988,0.000127,172.31.36.0-255,66,19379,7,271345
17989,0.000144,172.217.194.0-255,1125,20504,7,271345
17990,0.000146,172.31.36.0-255,66,20570,7,271345
17991,0.0002,172.217.194.0-255,1484,22054,7,271345
17992,0.000203,172.31.36.0-255,66,22120,7,271345
17993,0.000208,172.217.194.0-255,2902,25022,7,271345
17994,0.00021,172.31.36.0-255,66,25088,7,271345
17995,0.000222,172.217.194.0-255,5738,30826,7,271345
17996,0.000225,172.31.36.0-255,66,30892,7,271345
17997,0.000269,172.31.36.0-255,66,30958,7,271345
17998,0.000273,172.217.194.0-255,1484,32442,7,271345
17999,0.000275,172.31.36.0-255,66,32508,7,271345
18000,0.000341,172.31.36.0-255,66,32574,7,271345
18001,0.000469,172.217.194.0-255,1484,34058,7,271345
18002,0.000473,172.31.36.0-255,66,34124,7,271345
18003,0.000478,172.217.194.0-255,2902,37026,7,271345
18004,0.000481,172.31.36.0-255,66,37092,7,271345
18005,0.000493,172.217.194.0-255,5738,42830,7,271345
18006,0.000497,172.217.194.0-255,1484,44314,7,271345
18007,0.0005,172.31.36.0-255,66,44380,7,271345
18008,0.000523,172.31.36.0-255,66,44446,7,271345
18009,0.000539,172.217.194.0-255,2902,47348,7,271345
18010,0.000553,172.31.36.0-255,66,47414,7,271345
18011,0.000578,172.31.36.0-255,66,47480,7,271345
18012,0.000604,172.217.194.0-255,2184,49664,7,271345
18013,0.000621,172.31.36.0-255,66,49730,7,271345
18014,0.00073,172.217.194.0-255,1484,51214,7,271345
18015,0.000744,172.217.194.0-255,1484,52698,7,271345
18016,0.000749,172.31.36.0-255,66,52764,7,271345
18017,0.000754,172.217.194.0-255,2902,55666,7,271345
18018,0.000764,172.31.36.0-255,66,55732,7,271345
18019,0.000776,172.217.194.0-255,5738,61470,7,271345
18020,0.000789,172.31.36.0-255,66,61536,7,271345
18021,0.000808,172.217.194.0-255,5738,67274,7,271345
18022,0.000811,172.31.36.0-255,66,67340,7,271345
18023,0.000834,172.217.194.0-255,7156,74496,7,271345
18024,0.000846,172.31.36.0-255,66,74562,7,271345
18025,0.000851,172.31.36.0-255,66,74628,7,271345
18026,0.000902,172.31.36.0-255,66,74694,7,271345
18027,0.000908,172.217.194.0-255,1484,76178,7,271345
18028,0.000942,172.31.36.0-255,66,76244,7,271345
18029,0.000989,172.217.194.0-255,1484,77728,7,271345
18030,0.000994,172.217.194.0-255,2902,80630,7,271345
18031,0.000998,172.31.36.0-255,66,80696,7,271345
18032,0.001029,172.217.194.0-255,5738,86434,7,271345
18033,0.001036,172.31.36.0-255,66,86500,7,271345
18034,0.001063,172.217.194.0-255,4320,90820,7,271345
18035,0.001071,172.31.36.0-255,66,90886,7,271345
18036,0.001078,172.217.194.0-255,2543,93429,7,271345
18037,0.001086,172.31.36.0-255,66,93495,7,271345
18038,0.001144,172.217.194.0-255,1484,94979,7,271345
18039,0.001161,172.217.194.0-255,2902,97881,7,271345
18040,0.001164,172.31.36.0-255,66,97947,7,271345
18041,0.001171,172.217.194.0-255,4320,102267,7,271345
18042,0.001191,172.31.36.0-255,66,102333,7,271345
18043,0.001194,172.217.194.0-255,1484,103817,7,271345
18044,0.001201,172.217.194.0-255,5738,109555,7,271345
18045,0.001207,172.31.36.0-255,66,109621,7,271345
18046,0.001225,172.217.194.0-255,7156,116777,7,271345
18047,0.001244,172.31.36.0-255,66,116843,7,271345
18048,0.001248,172.31.36.0-255,66,116909,7,271345
18049,0.001525,172.217.194.0-255,1484,118393,7,271345
18050,0.001529,172.217.194.0-255,1484,119877,7,271345
18051,0.001532,172.31.36.0-255,66,119943,7,271345
18052,0.001554,172.217.194.0-255,1484,121427,7,271345
18053,0.001561,172.217.194.0-255,5738,127165,7,271345
18054,0.001571,172.31.36.0-255,66,127231,7,271345
18055,0.001606,172.31.36.0-255,66,127297,7,271345
18056,0.001673,172.31.36.0-255,66,127363,7,271345
18057,0.001824,172.217.194.0-255,1484,128847,7,271345
18058,0.00183,172.217.194.0-255,2902,131749,7,271345
18059,0.001833,172.31.36.0-255,66,131815,7,271345
18060,0.00184,172.217.194.0-255,5738,137553,7,271345
18061,0.001844,172.31.36.0-255,66,137619,7,271345
18062,0.001886,172.31.36.0-255,66,137685,7,271345
18063,0.0019,172.31.36.0-255,66,137751,7,271345
18064,0.001913,172.217.194.0-255,766,138517,7,271345
18065,0.002557,172.31.36.0-255,66,138583,7,271345
18066,0.004255,172.217.194.0-255,4320,142903,7,271345
18067,0.004893,172.217.194.0-255,1484,144387,7,271345
18068,0.008416,172.31.36.0-255,66,144453,7,271345
18069,0.01078,172.217.194.0-255,5738,150191,7,271345
18070,0.01084,172.31.36.0-255,66,150257,7,271345
18071,0.013203,172.217.194.0-255,5738,155995,7,271345
18072,0.013211,172.31.36.0-255,66,156061,7,271345
18073,0.015569,172.217.194.0-255,5738,161799,7,271345
18074,0.015576,172.31.36.0-255,66,161865,7,271345
18075,0.017931,172.217.194.0-255,5738,167603,7,271345
18076,0.017937,172.31.36.0-255,66,167669,7,271345
18077,0.020336,172.217.194.0-255,5738,173407,7,271345
18078,0.020345,172.31.36.0-255,66,173473,7,271345
18079,0.022709,172.217.194.0-255,5738,179211,7,271345
18080,0.022717,172.31.36.0-255,66,179277,7,271345
18081,0.025087,172.217.194.0-255,5738,185015,7,271345
18082,0.025096,172.31.36.0-255,66,185081,7,271345
18083,0.026641,172.31.36.0-255,164,185245,7,271345
18084,0.026671,172.31.36.0-255,1125,186370,7,271345
18085,0.026709,172.31.36.0-255,1514,187884,7,271345
18086,0.026711,172.31.36.0-255,1281,189165,7,271345
18087,0.027462,172.217.194.0-255,5738,194903,7,271345
18088,0.02747,172.31.36.0-255,66,194969,7,271345
18089,0.028217,104.244.42.0-255,66,195035,7,271345
18090,0.028225,104.244.42.0-255,66,195101,7,271345
18091,0.028246,104.244.42.0-255,66,195167,7,271345
18092,0.02982,172.217.194.0-255,5738,200905,7,271345
18093,0.029826,172.31.36.0-255,66,200971,7,271345
18094,0.032189,172.217.194.0-255,5738,206709,7,271345
18095,0.032195,172.31.36.0-255,66,206775,7,271345
18096,0.034539,172.217.194.0-255,5738,212513,7,271345
18097,0.034545,172.31.36.0-255,66,212579,7,271345
18098,0.03691,172.217.194.0-255,5738,218317,7,271345
18099,0.036914,172.31.36.0-255,66,218383,7,271345
18100,0.039272,172.217.194.0-255,5738,224121,7,271345
18101,0.039277,172.31.36.0-255,66,224187,7,271345
18102,0.041643,172.217.194.0-255,5738,229925,7,271345
18103,0.041648,172.31.36.0-255,66,229991,7,271345
18104,0.043994,172.217.194.0-255,4320,234311,7,271345
18105,0.044,172.31.36.0-255,66,234377,7,271345
18106,0.044031,172.217.194.0-255,1484,235861,7,271345
18107,0.046339,172.217.194.0-255,4320,240181,7,271345
18108,0.046346,172.31.36.0-255,66,240247,7,271345
18109,0.04869,172.217.194.0-255,5738,245985,7,271345
18110,0.048747,172.31.36.0-255,66,246051,7,271345
18111,0.051103,172.217.194.0-255,5738,251789,7,271345
18112,0.051109,172.31.36.0-255,66,251855,7,271345
18113,0.053485,172.217.194.0-255,5738,257593,7,271345
18114,0.053491,172.31.36.0-255,66,257659,7,271345
18115,0.055878,172.217.194.0-255,4320,261979,7,271345
18116,0.055883,172.31.36.0-255,66,262045,7,271345
18117,0.055917,172.217.194.0-255,1484,263529,7,271345
18118,0.058243,172.217.194.0-255,4320,267849,7,271345
18119,0.058248,172.31.36.0-255,66,267915,7,271345
18120,0.060591,172.217.194.0-255,3193,271108,7,271345
18121,0.060596,172.31.36.0-255,66,271174,7,271345
18122,0.060768,172.31.36.0-255,105,271279,7,271345
18123,0.063079,172.217.194.0-255,66,271345,7,271345
18124,0.0,74.125.24.0-255,297,297,7,297932
18125,1.6e-05,172.31.36.0-255,66,363,7,297932
18126,2.3e-05,74.125.24.0-255,1484,1847,7,297932
18127,2.7e-05,172.31.36.0-255,66,1913,7,297932
18128,3.4e-05,74.125.24.0-255,4320,6233,7,297932
18129,4.6e-05,172.31.36.0-255,66,6299,7,297932
18130,5.2e-05,74.125.24.0-255,4320,10619,7,297932
18131,5.5e-05,172.31.36.0-255,66,10685,7,297932
18132,8e-05,74.125.24.0-255,3235,13920,7,297932
18133,8.3e-05,172.31.36.0-255,66,13986,7,297932
18134,0.000103,172.31.36.0-255,66,14052,7,297932
18135,0.00011,74.125.24.0-255,2543,16595,7,297932
18136,0.000113,172.31.36.0-255,66,16661,7,297932
18137,0.000147,74.125.24.0-255,2902,19563,7,297932
18138,0.00015,172.31.36.0-255,66,19629,7,297932
18139,0.000201,74.125.24.0-255,4320,23949,7,297932
18140,0.000206,172.31.36.0-255,66,24015,7,297932
18141,0.000216,172.31.36.0-255,66,24081,7,297932
18142,0.000219,74.125.24.0-255,1125,25206,7,297932
18143,0.000221,172.31.36.0-255,66,25272,7,297932
18144,0.001032,74.125.24.0-255,1484,26756,7,297932
18145,0.00104,172.31.36.0-255,66,26822,7,297932
18146,0.001049,74.125.24.0-255,2902,29724,7,297932
18147,0.001051,172.31.36.0-255,66,29790,7,297932
18148,0.001064,74.125.24.0-255,5738,35528,7,297932
18149,0.001066,172.31.36.0-255,66,35594,7,297932
18150,0.001073,74.125.24.0-255,6797,42391,7,297932
18151,0.001075,172.31.36.0-255,66,42457,7,297932
18152,0.001129,172.31.36.0-255,66,42523,7,297932
18153,0.001134,74.125.24.0-255,2543,45066,7,297932
18154,0.001136,172.31.36.0-255,66,45132,7,297932
18155,0.001161,74.125.24.0-255,1484,46616,7,297932
18156,0.001166,74.125.24.0-255,1484,48100,7,297932
18157,0.001169,172.31.36.0-255,66,48166,7,297932
18158,0.001194,74.125.24.0-255,1484,49650,7,297932
18159,0.0012,74.125.24.0-255,5738,55388,7,297932
18160,0.001203,172.31.36.0-255,66,55454,7,297932
18161,0.001208,74.125.24.0-255,2902,58356,7,297932
18162,0.00121,172.31.36.0-255,66,58422,7,297932
18163,0.001233,74.125.24.0-255,4542,62964,7,297932
18164,0.001241,172.31.36.0-255,66,63030,7,297932
18165,0.001464,74.125.24.0-255,1484,64514,7,297932
18166,0.001472,74.125.24.0-255,2902,67416,7,297932
18167,0.001476,172.31.36.0-255,66,67482,7,297932
18168,0.001522,74.125.24.0-255,5738,73220,7,297932
18169,0.001525,172.31.36.0-255,66,73286,7,297932
18170,0.001531,74.125.24.0-255,4320,77606,7,297932
18171,0.001533,172.31.36.0-255,66,77672,7,297932
18172,0.001537,74.125.24.0-255,2902,80574,7,297932
18173,0.001539,172.31.36.0-255,66,80640,7,297932
18174,0.001574,172.31.36.0-255,66,80706,7,297932
18175,0.00158,74.125.24.0-255,5738,86444,7,297932
18176,0.001583,172.31.36.0-255,66,86510,7,297932
18177,0.001616,74.125.24.0-255,5738,92248,7,297932
18178,0.001619,172.31.36.0-255,66,92314,7,297932
18179,0.001657,172.31.36.0-255,66,92380,7,297932
18180,0.001663,74.125.24.0-255,5738,98118,7,297932
18181,0.001665,172.31.36.0-255,66,98184,7,297932
18182,0.001692,74.125.24.0-255,7156,105340,7,297932
18183,0.001695,172.31.36.0-255,66,105406,7,297932
18184,0.001709,172.31.36.0-255,66,105472,7,297932
18185,0.001714,74.125.24.0-255,2902,108374,7,297932
18186,0.001716,172.31.36.0-255,66,108440,7,297932
18187,0.001754,172.31.36.0-255,66,108506,7,297932
18188,0.001788,74.125.24.0-255,7156,115662,7,297932
18189,0.001791,172.31.36.0-255,66,115728,7,297932
18190,0.001818,74.125.24.0-255,3602,119330,7,297932
18191,0.001821,172.31.36.0-255,66,119396,7,297932
18192,0.001844,74.125.24.0-255,1484,120880,7,297932
18193,0.001863,74.125.24.0-255,2902,123782,7,297932
18194,0.001866,172.31.36.0-255,66,123848,7,297932
18195,0.001872,74.125.24.0-255,5738,129586,7,297932
18196,0.001875,172.31.36.0-255,66,129652,7,297932
18197,0.001914,74.125.24.0-255,1484,131136,7,297932
18198,0.001943,172.31.36.0-255,66,131202,7,297932
18199,0.001986,172.31.36.0-255,66,131268,7,297932
18200,0.002098,74.125.24.0-255,1484,132752,7,297932
18201,0.002104,74.125.24.0-255,2902,135654,7,297932
18202,0.002107,172.31.36.0-255,66,135720,7,297932
18203,0.002114,74.125.24.0-255,4320,140040,7,297932
18204,0.002117,172.31.36.0-255,66,140106,7,297932
18205,0.002136,74.125.24.0-255,1484,141590,7,297932
18206,0.002175,172.31.36.0-255,66,141656,7,297932
18207,0.002186,172.31.36.0-255,66,141722,7,297932
18208,0.00219,74.125.24.0-255,2184,143906,7,297932
18209,0.002192,172.31.36.0-255,66,143972,7,297932
18210,0.004341,74.125.24.0-255,5738,149710,7,297932
18211,0.004349,172.31.36.0-255,66,149776,7,297932
18212,0.006508,74.125.24.0-255,5738,155514,7,297932
18213,0.006515,172.31.36.0-255,66,155580,7,297932
18214,0.008658,74.125.24.0-255,5738,161318,7,297932
18215,0.008665,172.31.36.0-255,66,161384,7,297932
18216,0.010787,74.125.24.0-255,5738,167122,7,297932
18217,0.010794,172.31.36.0-255,66,167188,7,297932
18218,0.012959,74.125.24.0-255,5738,172926,7,297932
18219,0.012967,172.31.36.0-255,66,172992,7,297932
18220,0.015104,74.125.24.0-255,5738,178730,7,297932
18221,0.015114,172.31.36.0-255,66,178796,7,297932
18222,0.017259,74.125.24.0-255,5738,184534,7,297932
18223,0.01727,172.31.36.0-255,66,184600,7,297932
18224,0.019396,74.125.24.0-255,5738,190338,7,297932
18225,0.019404,172.31.36.0-255,66,190404,7,297932
18226,0.021526,74.125.24.0-255,5738,196142,7,297932
18227,0.021534,172.31.36.0-255,66,196208,7,297932
18228,0.023664,74.125.24.0-255,5738,201946,7,297932
18229,0.023672,172.31.36.0-255,66,202012,7,297932
18230,0.025835,74.125.24.0-255,5738,207750,7,297932
18231,0.025842,172.31.36.0-255,66,207816,7,297932
18232,0.027999,74.125.24.0-255,5738,213554,7,297932
18233,0.028007,172.31.36.0-255,66,213620,7,297932
18234,0.030168,74.125.24.0-255,5738,219358,7,297932
18235,0.030176,172.31.36.0-255,66,219424,7,297932
18236,0.030292,172.31.36.0-255,172,219596,7,297932
18237,0.030321,172.31.36.0-255,1116,220712,7,297932
18238,0.030378,172.31.36.0-255,1514,222226,7,297932
18239,0.03038,172.31.36.0-255,1290,223516,7,297932
18240,0.03187,104.244.42.0-255,66,223582,7,297932
18241,0.031879,104.244.42.0-255,66,223648,7,297932
18242,0.031959,104.244.42.0-255,66,223714,7,297932
18243,0.032334,74.125.24.0-255,5738,229452,7,297932
18244,0.03234,172.31.36.0-255,66,229518,7,297932
18245,0.034501,74.125.24.0-255,5738,235256,7,297932
18246,0.034508,172.31.36.0-255,66,235322,7,297932
18247,0.036669,74.125.24.0-255,5738,241060,7,297932
18248,0.036676,172.31.36.0-255,66,241126,7,297932
18249,0.038829,74.125.24.0-255,5738,246864,7,297932
18250,0.038835,172.31.36.0-255,66,246930,7,297932
18251,0.040992,74.125.24.0-255,5738,252668,7,297932
18252,0.041001,172.31.36.0-255,66,252734,7,297932
18253,0.043134,74.125.24.0-255,5738,258472,7,297932
18254,0.043141,172.31.36.0-255,66,258538,7,297932
18255,0.045284,74.125.24.0-255,5738,264276,7,297932
18256,0.045291,172.31.36.0-255,66,264342,7,297932
18257,0.047474,74.125.24.0-255,5738,270080,7,297932
18258,0.047481,172.31.36.0-255,66,270146,7,297932
18259,0.049674,74.125.24.0-255,5738,275884,7,297932
18260,0.049681,172.31.36.0-255,66,275950,7,297932
18261,0.051849,74.125.24.0-255,5738,281688,7,297932
18262,0.051856,172.31.36.0-255,66,281754,7,297932
18263,0.053989,74.125.24.0-255,5738,287492,7,297932
18264,0.053998,172.31.36.0-255,66,287558,7,297932
18265,0.056144,74.125.24.0-255,5738,293296,7,297932
18266,0.05615,172.31.36.0-255,66,293362,7,297932
18267,0.058333,74.125.24.0-255,4333,297695,7,297932
18268,0.05834,172.31.36.0-255,66,297761,7,297932
18269,0.05853,172.31.36.0-255,105,297866,7,297932
18270,0.060664,74.125.24.0-255,66,297932,7,297932
18271,0.0,172.217.194.0-255,150,150,7,182972
18272,2.4e-05,172.31.36.0-255,66,216,7,182972
18273,3.1e-05,172.217.194.0-255,1484,1700,7,182972
18274,3.6e-05,172.31.36.0-255,66,1766,7,182972
18275,4.2e-05,172.217.194.0-255,2902,4668,7,182972
18276,4.5e-05,172.31.36.0-255,66,4734,7,182972
18277,5.3e-05,172.217.194.0-255,7156,11890,7,182972
18278,5.6e-05,172.31.36.0-255,66,11956,7,182972
18279,6.8e-05,172.31.36.0-255,66,12022,7,182972
18280,9.5e-05,172.31.36.0-255,66,12088,7,182972
18281,0.000144,172.31.36.0-255,66,12154,7,182972
18282,0.000155,172.31.36.0-255,66,12220,7,182972
18283,0.0002,172.217.194.0-255,7156,19376,7,182972
18284,0.000204,172.31.36.0-255,66,19442,7,182972
18285,0.000232,172.31.36.0-255,66,19508,7,182972
18286,0.000256,172.217.194.0-255,98,19606,7,182972
18287,0.00026,172.31.36.0-255,66,19672,7,182972
18288,0.000284,172.217.194.0-255,366,20038,7,182972
18289,0.000287,172.31.36.0-255,66,20104,7,182972
18290,0.000375,172.217.194.0-255,1484,21588,7,182972
18291,0.000379,172.31.36.0-255,66,21654,7,182972
18292,0.000384,172.217.194.0-255,2902,24556,7,182972
18293,0.000387,172.31.36.0-255,66,24622,7,182972
18294,0.000402,172.217.194.0-255,5738,30360,7,182972
18295,0.000405,172.31.36.0-255,66,30426,7,182972
18296,0.000456,172.217.194.0-255,5738,36164,7,182972
18297,0.00046,172.31.36.0-255,66,36230,7,182972
18298,0.000481,172.217.194.0-255,6797,43027,7,182972
18299,0.000485,172.31.36.0-255,66,43093,7,182972
18300,0.000502,172.217.194.0-255,7156,50249,7,182972
18301,0.000505,172.31.36.0-255,66,50315,7,182972
18302,0.000531,172.217.194.0-255,3961,54276,7,182972
18303,0.000536,172.31.36.0-255,66,54342,7,182972
18304,0.000947,172.217.194.0-255,1484,55826,7,182972
18305,0.000954,172.217.194.0-255,2902,58728,7,182972
18306,0.000957,172.31.36.0-255,66,58794,7,182972
18307,0.000963,172.217.194.0-255,4320,63114,7,182972
18308,0.000966,172.31.36.0-255,66,63180,7,182972
18309,0.000993,172.217.194.0-255,1484,64664,7,182972
18310,0.001006,172.31.36.0-255,66,64730,7,182972
18311,0.001012,172.217.194.0-255,5738,70468,7,182972
18312,0.001014,172.31.36.0-255,66,70534,7,182972
18313,0.001032,172.217.194.0-255,5020,75554,7,182972
18314,0.001035,172.31.36.0-255,66,75620,7,182972
18315,0.001071,172.31.36.0-255,66,75686,7,182972
18316,0.001078,172.217.194.0-255,5738,81424,7,182972
18317,0.00108,172.31.36.0-255,66,81490,7,182972
18318,0.001096,172.217.194.0-255,7156,88646,7,182972
18319,0.001099,172.31.36.0-255,66,88712,7,182972
18320,0.001155,172.31.36.0-255,66,88778,7,182972
18321,0.001158,172.217.194.0-255,1484,90262,7,182972
18322,0.001175,172.217.194.0-255,2902,93164,7,182972
18323,0.001178,172.31.36.0-255,66,93230,7,182972
18324,0.001183,172.217.194.0-255,2902,96132,7,182972
18325,0.001185,172.31.36.0-255,66,96198,7,182972
18326,0.001202,172.217.194.0-255,2902,99100,7,182972
18327,0.001205,172.31.36.0-255,66,99166,7,182972
18328,0.001242,172.31.36.0-255,66,99232,7,182972
18329,0.001255,172.31.36.0-255,66,99298,7,182972
18330,0.001259,172.217.194.0-255,2184,101482,7,182972
18331,0.00126,172.31.36.0-255,66,101548,7,182972
18332,0.001323,172.217.194.0-255,1484,103032,7,182972
18333,0.001328,172.217.194.0-255,1484,104516,7,182972
18334,0.001331,172.31.36.0-255,66,104582,7,182972
18335,0.001348,172.217.194.0-255,1484,106066,7,182972
18336,0.001354,172.217.194.0-255,5738,111804,7,182972
18337,0.001357,172.31.36.0-255,66,111870,7,182972
18338,0.001362,172.217.194.0-255,4320,116190,7,182972
18339,0.001364,172.31.36.0-255,66,116256,7,182972
18340,0.00138,172.217.194.0-255,1484,117740,7,182972
18341,0.001385,172.217.194.0-255,2902,120642,7,182972
18342,0.001389,172.31.36.0-255,66,120708,7,182972
18343,0.001424,172.217.194.0-255,5020,125728,7,182972
18344,0.001424,172.31.36.0-255,66,125794,7,182972
18345,0.001427,172.31.36.0-255,66,125860,7,182972
18346,0.001471,172.217.194.0-255,7156,133016,7,182972
18347,0.001475,172.31.36.0-255,66,133082,7,182972
18348,0.001495,172.217.194.0-255,1484,134566,7,182972
18349,0.001512,172.31.36.0-255,66,134632,7,182972
18350,0.001528,172.217.194.0-255,2902,137534,7,182972
18351,0.001531,172.31.36.0-255,66,137600,7,182972
18352,0.00156,172.31.36.0-255,66,137666,7,182972
18353,0.001575,172.31.36.0-255,66,137732,7,182972
18354,0.001597,172.217.194.0-255,7156,144888,7,182972
18355,0.0016,172.31.36.0-255,66,144954,7,182972
18356,0.001611,172.31.36.0-255,66,145020,7,182972
18357,0.001641,172.217.194.0-255,1484,146504,7,182972
18358,0.001646,172.217.194.0-255,2902,149406,7,182972
18359,0.001648,172.31.36.0-255,66,149472,7,182972
18360,0.001654,172.217.194.0-255,5738,155210,7,182972
18361,0.001657,172.31.36.0-255,66,155276,7,182972
18362,0.001691,172.31.36.0-255,66,155342,7,182972
18363,0.00173,172.217.194.0-255,2902,158244,7,182972
18364,0.001734,172.31.36.0-255,66,158310,7,182972
18365,0.001764,172.31.36.0-255,66,158376,7,182972
18366,0.001828,172.31.36.0-255,66,158442,7,182972
18367,0.001855,172.217.194.0-255,7156,165598,7,182972
18368,0.001859,172.31.36.0-255,66,165664,7,182972
18369,0.001876,172.31.36.0-255,66,165730,7,182972
18370,0.001895,172.31.36.0-255,66,165796,7,182972
18371,0.0019,172.31.36.0-255,66,165862,7,182972
18372,0.001902,172.217.194.0-255,7156,173018,7,182972
18373,0.001911,172.31.36.0-255,66,173084,7,182972
18374,0.001942,172.217.194.0-255,2121,175205,7,182972
18375,0.001945,172.31.36.0-255,66,175271,7,182972
18376,0.001962,172.217.194.0-255,105,175376,7,182972
18377,0.003688,172.31.36.0-255,66,175442,7,182972
18378,0.003715,172.31.36.0-255,105,175547,7,182972
18379,0.005945,172.217.194.0-255,66,175613,7,182972
18380,0.032791,172.31.36.0-255,188,175801,7,182972
18381,0.032818,172.31.36.0-255,958,176759,7,182972
18382,0.03287,172.31.36.0-255,1514,178273,7,182972
18383,0.032872,172.31.36.0-255,1514,179787,7,182972
18384,0.032873,172.31.36.0-255,1514,181301,7,182972
18385,0.032874,172.31.36.0-255,1233,182534,7,182972
18386,0.03432,104.244.42.0-255,66,182600,7,182972
18387,0.034365,104.244.42.0-255,66,182666,7,182972
18388,0.034412,104.244.42.0-255,66,182732,7,182972
18389,0.034416,104.244.42.0-255,66,182798,7,182972
18390,0.035202,104.244.42.0-255,108,182906,7,182972
18391,0.035212,172.31.36.0-255,66,182972,7,182972
18392,0.0,74.125.24.0-255,152,152,7,317357
18393,3.4e-05,172.31.36.0-255,66,218,7,317357
18394,4e-05,74.125.24.0-255,1484,1702,7,317357
18395,4.5e-05,172.31.36.0-255,66,1768,7,317357
18396,5.1e-05,74.125.24.0-255,2902,4670,7,317357
18397,6.2e-05,172.31.36.0-255,66,4736,7,317357
18398,6.9e-05,74.125.24.0-255,7156,11892,7,317357
18399,7.3e-05,172.31.36.0-255,66,11958,7,317357
18400,7.7e-05,74.125.24.0-255,2048,14006,7,317357
18401,8e-05,172.31.36.0-255,66,14072,7,317357
18402,0.000337,74.125.24.0-255,1484,15556,7,317357
18403,0.000343,172.31.36.0-255,66,15622,7,317357
18404,0.000349,74.125.24.0-255,2902,18524,7,317357
18405,0.000352,172.31.36.0-255,66,18590,7,317357
18406,0.000366,74.125.24.0-255,5738,24328,7,317357
18407,0.00037,172.31.36.0-255,66,24394,7,317357
18408,0.000378,74.125.24.0-255,6797,31191,7,317357
18409,0.00038,172.31.36.0-255,66,31257,7,317357
18410,0.000527,74.125.24.0-255,1484,32741,7,317357
18411,0.000532,172.31.36.0-255,66,32807,7,317357
18412,0.000538,74.125.24.0-255,2902,35709,7,317357
18413,0.00054,172.31.36.0-255,66,35775,7,317357
18414,0.000578,74.125.24.0-255,5738,41513,7,317357
18415,0.000582,172.31.36.0-255,66,41579,7,317357
18416,0.00059,74.125.24.0-255,6797,48376,7,317357
18417,0.000593,172.31.36.0-255,66,48442,7,317357
18418,0.000623,74.125.24.0-255,1484,49926,7,317357
18419,0.000626,172.31.36.0-255,66,49992,7,317357
18420,0.000658,172.31.36.0-255,66,50058,7,317357
18421,0.000662,74.125.24.0-255,2543,52601,7,317357
18422,0.000664,172.31.36.0-255,66,52667,7,317357
18423,0.000703,74.125.24.0-255,413,53080,7,317357
18424,0.0008,172.31.36.0-255,66,53146,7,317357
18425,0.000848,74.125.24.0-255,330,53476,7,317357
18426,0.000865,172.31.36.0-255,66,53542,7,317357
18427,0.001251,74.125.24.0-255,1484,55026,7,317357
18428,0.001261,74.125.24.0-255,2902,57928,7,317357
18429,0.001266,172.31.36.0-255,66,57994,7,317357
18430,0.001295,74.125.24.0-255,5738,63732,7,317357
18431,0.001298,172.31.36.0-255,66,63798,7,317357
18432,0.001303,74.125.24.0-255,2902,66700,7,317357
18433,0.001305,172.31.36.0-255,66,66766,7,317357
18434,0.001338,74.125.24.0-255,2902,69668,7,317357
18435,0.001342,172.31.36.0-255,66,69734,7,317357
18436,0.001356,172.31.36.0-255,66,69800,7,317357
18437,0.001362,74.125.24.0-255,5020,74820,7,317357
18438,0.001364,172.31.36.0-255,66,74886,7,317357
18439,0.001592,74.125.24.0-255,1484,76370,7,317357
18440,0.001599,74.125.24.0-255,2902,79272,7,317357
18441,0.001603,172.31.36.0-255,66,79338,7,317357
18442,0.001632,74.125.24.0-255,5738,85076,7,317357
18443,0.001634,172.31.36.0-255,66,85142,7,317357
18444,0.001655,74.125.24.0-255,7156,92298,7,317357
18445,0.001658,172.31.36.0-255,66,92364,7,317357
18446,0.001688,74.125.24.0-255,4320,96684,7,317357
18447,0.001691,172.31.36.0-255,66,96750,7,317357
18448,0.001704,172.31.36.0-255,66,96816,7,317357
18449,0.001807,74.125.24.0-255,1484,98300,7,317357
18450,0.001821,74.125.24.0-255,2902,101202,7,317357
18451,0.001824,172.31.36.0-255,66,101268,7,317357
18452,0.001852,74.125.24.0-255,5738,107006,7,317357
18453,0.001854,172.31.36.0-255,66,107072,7,317357
18454,0.001861,74.125.24.0-255,7156,114228,7,317357
18455,0.001863,172.31.36.0-255,66,114294,7,317357
18456,0.001868,74.125.24.0-255,4320,118614,7,317357
18457,0.001871,172.31.36.0-255,66,118680,7,317357
18458,0.001912,172.31.36.0-255,66,118746,7,317357
18459,0.001916,74.125.24.0-255,2184,120930,7,317357
18460,0.001918,172.31.36.0-255,66,120996,7,317357
18461,0.00423,74.125.24.0-255,2902,123898,7,317357
18462,0.004234,172.31.36.0-255,66,123964,7,317357
18463,0.004253,74.125.24.0-255,2902,126866,7,317357
18464,0.004256,172.31.36.0-255,66,126932,7,317357
18465,0.006537,74.125.24.0-255,2902,129834,7,317357
18466,0.006544,172.31.36.0-255,66,129900,7,317357
18467,0.006572,74.125.24.0-255,2902,132802,7,317357
18468,0.006576,172.31.36.0-255,66,132868,7,317357
18469,0.008884,74.125.24.0-255,5738,138606,7,317357
18470,0.008892,172.31.36.0-255,66,138672,7,317357
18471,0.011262,74.125.24.0-255,4320,142992,7,317357
18472,0.01127,172.31.36.0-255,66,143058,7,317357
18473,0.011299,74.125.24.0-255,1484,144542,7,317357
18474,0.013592,74.125.24.0-255,4320,148862,7,317357
18475,0.013603,172.31.36.0-255,66,148928,7,317357
18476,0.015899,74.125.24.0-255,5738,154666,7,317357
18477,0.015906,172.31.36.0-255,66,154732,7,317357
18478,0.018191,74.125.24.0-255,5738,160470,7,317357
18479,0.018198,172.31.36.0-255,66,160536,7,317357
18480,0.020498,74.125.24.0-255,5738,166274,7,317357
18481,0.020506,172.31.36.0-255,66,166340,7,317357
18482,0.022846,74.125.24.0-255,5738,172078,7,317357
18483,0.022854,172.31.36.0-255,66,172144,7,317357
18484,0.024956,172.31.36.0-255,176,172320,7,317357
18485,0.024986,172.31.36.0-255,1114,173434,7,317357
18486,0.025028,172.31.36.0-255,1514,174948,7,317357
18487,0.02503,172.31.36.0-255,1514,176462,7,317357
18488,0.025032,172.31.36.0-255,1514,177976,7,317357
18489,0.025033,172.31.36.0-255,1073,179049,7,317357
18490,0.025155,74.125.24.0-255,5738,184787,7,317357
18491,0.025161,172.31.36.0-255,66,184853,7,317357
18492,0.026481,104.244.42.0-255,66,184919,7,317357
18493,0.026516,104.244.42.0-255,66,184985,7,317357
18494,0.026569,104.244.42.0-255,66,185051,7,317357
18495,0.026574,104.244.42.0-255,66,185117,7,317357
18496,0.027502,74.125.24.0-255,5738,190855,7,317357
18497,0.027508,172.31.36.0-255,66,190921,7,317357
18498,0.029824,74.125.24.0-255,5738,196659,7,317357
18499,0.029837,172.31.36.0-255,66,196725,7,317357
18500,0.032164,74.125.24.0-255,5738,202463,7,317357
18501,0.032172,172.31.36.0-255,66,202529,7,317357
18502,0.034501,74.125.24.0-255,5738,208267,7,317357
18503,0.034508,172.31.36.0-255,66,208333,7,317357
18504,0.036822,74.125.24.0-255,5738,214071,7,317357
18505,0.036828,172.31.36.0-255,66,214137,7,317357
18506,0.039171,74.125.24.0-255,5738,219875,7,317357
18507,0.039177,172.31.36.0-255,66,219941,7,317357
18508,0.041481,74.125.24.0-255,5738,225679,7,317357
18509,0.041488,172.31.36.0-255,66,225745,7,317357
18510,0.043807,74.125.24.0-255,4320,230065,7,317357
18511,0.043812,172.31.36.0-255,66,230131,7,317357
18512,0.043845,74.125.24.0-255,1484,231615,7,317357
18513,0.046123,74.125.24.0-255,4320,235935,7,317357
18514,0.046131,172.31.36.0-255,66,236001,7,317357
18515,0.048418,74.125.24.0-255,5738,241739,7,317357
18516,0.048424,172.31.36.0-255,66,241805,7,317357
18517,0.050741,74.125.24.0-255,4320,246125,7,317357
18518,0.050746,172.31.36.0-255,66,246191,7,317357
18519,0.050779,74.125.24.0-255,1484,247675,7,317357
18520,0.053082,74.125.24.0-255,4320,251995,7,317357
18521,0.053086,172.31.36.0-255,66,252061,7,317357
18522,0.055396,74.125.24.0-255,2902,254963,7,317357
18523,0.055401,172.31.36.0-255,66,255029,7,317357
18524,0.055444,74.125.24.0-255,2902,257931,7,317357
18525,0.055448,172.31.36.0-255,66,257997,7,317357
18526,0.057711,74.125.24.0-255,2902,260899,7,317357
18527,0.057716,172.31.36.0-255,66,260965,7,317357
18528,0.057753,74.125.24.0-255,2902,263867,7,317357
18529,0.057757,172.31.36.0-255,66,263933,7,317357
18530,0.060032,74.125.24.0-255,2902,266835,7,317357
18531,0.060039,172.31.36.0-255,66,266901,7,317357
18532,0.060071,74.125.24.0-255,2902,269803,7,317357
18533,0.060074,172.31.36.0-255,66,269869,7,317357
18534,0.062338,74.125.24.0-255,2902,272771,7,317357
18535,0.062347,172.31.36.0-255,66,272837,7,317357
18536,0.062387,74.125.24.0-255,2902,275739,7,317357
18537,0.062391,172.31.36.0-255,66,275805,7,317357
18538,0.064646,74.125.24.0-255,2902,278707,7,317357
18539,0.064651,172.31.36.0-255,66,278773,7,317357
18540,0.064695,74.125.24.0-255,2902,281675,7,317357
18541,0.064698,172.31.36.0-255,66,281741,7,317357
18542,0.066973,74.125.24.0-255,2902,284643,7,317357
18543,0.066979,172.31.36.0-255,66,284709,7,317357
18544,0.067011,74.125.24.0-255,2902,287611,7,317357
18545,0.067014,172.31.36.0-255,66,287677,7,317357
18546,0.069289,74.125.24.0-255,2902,290579,7,317357
18547,0.069297,172.31.36.0-255,66,290645,7,317357
18548,0.069333,74.125.24.0-255,2902,293547,7,317357
18549,0.069336,172.31.36.0-255,66,293613,7,317357
18550,0.071598,74.125.24.0-255,2902,296515,7,317357
18551,0.071608,172.31.36.0-255,66,296581,7,317357
18552,0.071667,74.125.24.0-255,2902,299483,7,317357
18553,0.071671,172.31.36.0-255,66,299549,7,317357
18554,0.073897,74.125.24.0-255,2902,302451,7,317357
18555,0.073904,172.31.36.0-255,66,302517,7,317357
18556,0.073976,74.125.24.0-255,2902,305419,7,317357
18557,0.073981,172.31.36.0-255,66,305485,7,317357
18558,0.076216,74.125.24.0-255,2902,308387,7,317357
18559,0.076223,172.31.36.0-255,66,308453,7,317357
18560,0.076331,74.125.24.0-255,2902,311355,7,317357
18561,0.076335,172.31.36.0-255,66,311421,7,317357
18562,0.078536,74.125.24.0-255,2902,314323,7,317357
18563,0.078542,172.31.36.0-255,66,314389,7,317357
18564,0.078642,74.125.24.0-255,2902,317291,7,317357
18565,0.078647,172.31.36.0-255,66,317357,7,317357
18566,0.0,172.217.194.0-255,297,297,7,300609
18567,2.4e-05,172.31.36.0-255,66,363,7,300609
18568,3.1e-05,172.217.194.0-255,1484,1847,7,300609
18569,3.6e-05,172.31.36.0-255,66,1913,7,300609
18570,4.4e-05,172.217.194.0-255,4320,6233,7,300609
18571,4.7e-05,172.31.36.0-255,66,6299,7,300609
18572,5e-05,172.217.194.0-255,1484,7783,7,300609
18573,5.3e-05,172.31.36.0-255,66,7849,7,300609
18574,8.9e-05,172.31.36.0-255,66,7915,7,300609
18575,0.000101,172.31.36.0-255,66,7981,7,300609
18576,0.000118,172.217.194.0-255,6797,14778,7,300609
18577,0.000122,172.31.36.0-255,66,14844,7,300609
18578,0.000399,172.217.194.0-255,1484,16328,7,300609
18579,0.000405,172.217.194.0-255,2902,19230,7,300609
18580,0.000411,172.31.36.0-255,66,19296,7,300609
18581,0.00042,172.31.36.0-255,66,19362,7,300609
18582,0.000455,172.217.194.0-255,2902,22264,7,300609
18583,0.000459,172.31.36.0-255,66,22330,7,300609
18584,0.000491,172.217.194.0-255,2902,25232,7,300609
18585,0.000493,172.31.36.0-255,66,25298,7,300609
18586,0.000506,172.217.194.0-255,1484,26782,7,300609
18587,0.000509,172.31.36.0-255,66,26848,7,300609
18588,0.000521,172.31.36.0-255,66,26914,7,300609
18589,0.000525,172.217.194.0-255,2902,29816,7,300609
18590,0.000528,172.31.36.0-255,66,29882,7,300609
18591,0.000568,172.31.36.0-255,66,29948,7,300609
18592,0.00071,172.217.194.0-255,380,30328,7,300609
18593,0.000714,172.31.36.0-255,66,30394,7,300609
18594,0.000745,172.217.194.0-255,98,30492,7,300609
18595,0.001119,172.31.36.0-255,66,30558,7,300609
18596,0.001345,172.217.194.0-255,1484,32042,7,300609
18597,0.001354,172.217.194.0-255,2902,34944,7,300609
18598,0.001358,172.31.36.0-255,66,35010,7,300609
18599,0.001363,172.217.194.0-255,2902,37912,7,300609
18600,0.001365,172.31.36.0-255,66,37978,7,300609
18601,0.001379,172.217.194.0-255,2902,40880,7,300609
18602,0.001381,172.31.36.0-255,66,40946,7,300609
18603,0.001405,172.217.194.0-255,4320,45266,7,300609
18604,0.001407,172.31.36.0-255,66,45332,7,300609
18605,0.001422,172.217.194.0-255,4320,49652,7,300609
18606,0.001424,172.31.36.0-255,66,49718,7,300609
18607,0.001461,172.31.36.0-255,66,49784,7,300609
18608,0.001536,172.217.194.0-255,5020,54804,7,300609
18609,0.00154,172.31.36.0-255,66,54870,7,300609
18610,0.001808,172.217.194.0-255,1484,56354,7,300609
18611,0.001829,172.217.194.0-255,2902,59256,7,300609
18612,0.001833,172.31.36.0-255,66,59322,7,300609
18613,0.001863,172.217.194.0-255,5738,65060,7,300609
18614,0.001866,172.31.36.0-255,66,65126,7,300609
18615,0.001899,172.217.194.0-255,1484,66610,7,300609
18616,0.001919,172.217.194.0-255,5738,72348,7,300609
18617,0.001922,172.31.36.0-255,66,72414,7,300609
18618,0.001927,172.217.194.0-255,2902,75316,7,300609
18619,0.001928,172.31.36.0-255,66,75382,7,300609
18620,0.001976,172.31.36.0-255,66,75448,7,300609
18621,0.002013,172.217.194.0-255,2902,78350,7,300609
18622,0.002016,172.31.36.0-255,66,78416,7,300609
18623,0.003966,172.217.194.0-255,2902,81318,7,300609
18624,0.003977,172.31.36.0-255,66,81384,7,300609
18625,0.004018,172.217.194.0-255,2902,84286,7,300609
18626,0.004023,172.31.36.0-255,66,84352,7,300609
18627,0.005962,172.217.194.0-255,2902,87254,7,300609
18628,0.005971,172.31.36.0-255,66,87320,7,300609
18629,0.006002,172.217.194.0-255,2902,90222,7,300609
18630,0.006004,172.31.36.0-255,66,90288,7,300609
18631,0.007964,172.217.194.0-255,5738,96026,7,300609
18632,0.007968,172.31.36.0-255,66,96092,7,300609
18633,0.009974,172.217.194.0-255,5738,101830,7,300609
18634,0.009984,172.31.36.0-255,66,101896,7,300609
18635,0.012013,172.217.194.0-255,5738,107634,7,300609
18636,0.012027,172.31.36.0-255,66,107700,7,300609
18637,0.014012,172.217.194.0-255,5738,113438,7,300609
18638,0.01403,172.31.36.0-255,66,113504,7,300609
18639,0.01604,172.217.194.0-255,5738,119242,7,300609
18640,0.016059,172.31.36.0-255,66,119308,7,300609
18641,0.018067,172.217.194.0-255,5738,125046,7,300609
18642,0.018086,172.31.36.0-255,66,125112,7,300609
18643,0.020063,172.217.194.0-255,5738,130850,7,300609
18644,0.020075,172.31.36.0-255,66,130916,7,300609
18645,0.022094,172.217.194.0-255,5738,136654,7,300609
18646,0.022107,172.31.36.0-255,66,136720,7,300609
18647,0.024108,172.217.194.0-255,5738,142458,7,300609
18648,0.024121,172.31.36.0-255,66,142524,7,300609
18649,0.026118,172.217.194.0-255,5738,148262,7,300609
18650,0.02613,172.31.36.0-255,66,148328,7,300609
18651,0.028125,172.217.194.0-255,5738,154066,7,300609
18652,0.028139,172.31.36.0-255,66,154132,7,300609
18653,0.030145,172.217.194.0-255,5738,159870,7,300609
18654,0.030156,172.31.36.0-255,66,159936,7,300609
18655,0.032173,172.217.194.0-255,5738,165674,7,300609
18656,0.032186,172.31.36.0-255,66,165740,7,300609
18657,0.034219,172.217.194.0-255,5738,171478,7,300609
18658,0.034233,172.31.36.0-255,66,171544,7,300609
18659,0.036227,172.217.194.0-255,5738,177282,7,300609
18660,0.036238,172.31.36.0-255,66,177348,7,300609
18661,0.036727,172.31.36.0-255,172,177520,7,300609
18662,0.036766,172.31.36.0-255,1073,178593,7,300609
18663,0.038247,172.217.194.0-255,5738,184331,7,300609
18664,0.038263,172.31.36.0-255,66,184397,7,300609
18665,0.038285,104.244.42.0-255,66,184463,7,300609
18666,0.038293,104.244.42.0-255,66,184529,7,300609
18667,0.040265,172.217.194.0-255,5738,190267,7,300609
18668,0.040281,172.31.36.0-255,66,190333,7,300609
18669,0.042283,172.217.194.0-255,5738,196071,7,300609
18670,0.042295,172.31.36.0-255,66,196137,7,300609
18671,0.044286,172.217.194.0-255,5738,201875,7,300609
18672,0.044299,172.31.36.0-255,66,201941,7,300609
18673,0.046284,172.217.194.0-255,5738,207679,7,300609
18674,0.046293,172.31.36.0-255,66,207745,7,300609
18675,0.048313,172.217.194.0-255,5738,213483,7,300609
18676,0.048325,172.31.36.0-255,66,213549,7,300609
18677,0.050299,172.217.194.0-255,5738,219287,7,300609
18678,0.050307,172.31.36.0-255,66,219353,7,300609
18679,0.052286,172.217.194.0-255,5738,225091,7,300609
18680,0.052299,172.31.36.0-255,66,225157,7,300609
18681,0.054293,172.217.194.0-255,5738,230895,7,300609
18682,0.0543,172.31.36.0-255,66,230961,7,300609
18683,0.056267,172.217.194.0-255,5738,236699,7,300609
18684,0.056275,172.31.36.0-255,66,236765,7,300609
18685,0.058321,172.217.194.0-255,5738,242503,7,300609
18686,0.05833,172.31.36.0-255,66,242569,7,300609
18687,0.060313,172.217.194.0-255,5738,248307,7,300609
18688,0.060321,172.31.36.0-255,66,248373,7,300609
18689,0.062315,172.217.194.0-255,5738,254111,7,300609
18690,0.062323,172.31.36.0-255,66,254177,7,300609
18691,0.064313,172.217.194.0-255,5738,259915,7,300609
18692,0.064323,172.31.36.0-255,66,259981,7,300609
18693,0.066356,172.217.194.0-255,5738,265719,7,300609
18694,0.066367,172.31.36.0-255,66,265785,7,300609
18695,0.068354,172.217.194.0-255,5738,271523,7,300609
18696,0.068365,172.31.36.0-255,66,271589,7,300609
18697,0.070359,172.217.194.0-255,5738,277327,7,300609
18698,0.070374,172.31.36.0-255,66,277393,7,300609
18699,0.072365,172.217.194.0-255,5738,283131,7,300609
18700,0.07238,172.31.36.0-255,66,283197,7,300609
18701,0.074393,172.217.194.0-255,5738,288935,7,300609
18702,0.074404,172.31.36.0-255,66,289001,7,300609
18703,0.076399,172.217.194.0-255,5738,294739,7,300609
18704,0.076409,172.31.36.0-255,66,294805,7,300609
18705,0.078415,172.217.194.0-255,5738,300543,7,300609
18706,0.078425,172.31.36.0-255,66,300609,7,300609
18707,0.0,74.125.200.0-255,153,153,7,399274
18708,2.2e-05,172.31.36.0-255,66,219,7,399274
18709,2.9e-05,74.125.200.0-255,1484,1703,7,399274
18710,3.4e-05,172.31.36.0-255,66,1769,7,399274
18711,3.7e-05,74.125.200.0-255,1484,3253,7,399274
18712,4e-05,172.31.36.0-255,66,3319,7,399274
18713,4.5e-05,74.125.200.0-255,2902,6221,7,399274
18714,4.8e-05,172.31.36.0-255,66,6287,7,399274
18715,8.2e-05,74.125.200.0-255,2902,9189,7,399274
18716,8.5e-05,172.31.36.0-255,66,9255,7,399274
18717,0.0001,74.125.200.0-255,1484,10739,7,399274
18718,0.000102,172.31.36.0-255,66,10805,7,399274
18719,0.000119,74.125.200.0-255,1484,12289,7,399274
18720,0.000121,172.31.36.0-255,66,12355,7,399274
18721,0.000145,74.125.200.0-255,1948,14303,7,399274
18722,0.000147,172.31.36.0-255,66,14369,7,399274
18723,0.000283,74.125.200.0-255,1484,15853,7,399274
18724,0.000287,172.31.36.0-255,66,15919,7,399274
18725,0.000291,74.125.200.0-255,1484,17403,7,399274
18726,0.000294,172.31.36.0-255,66,17469,7,399274
18727,0.000309,74.125.200.0-255,1484,18953,7,399274
18728,0.000311,172.31.36.0-255,66,19019,7,399274
18729,0.000332,74.125.200.0-255,2902,21921,7,399274
18730,0.000335,172.31.36.0-255,66,21987,7,399274
18731,0.000355,74.125.200.0-255,1484,23471,7,399274
18732,0.000357,172.31.36.0-255,66,23537,7,399274
18733,0.000363,74.125.200.0-255,5738,29275,7,399274
18734,0.000366,172.31.36.0-255,66,29341,7,399274
18735,0.000369,74.125.200.0-255,1484,30825,7,399274
18736,0.000371,172.31.36.0-255,66,30891,7,399274
18737,0.000387,74.125.200.0-255,6797,37688,7,399274
18738,0.00039,172.31.36.0-255,66,37754,7,399274
18739,0.000407,74.125.200.0-255,1484,39238,7,399274
18740,0.000433,74.125.200.0-255,7156,46394,7,399274
18741,0.000436,172.31.36.0-255,66,46460,7,399274
18742,0.000442,74.125.200.0-255,4320,50780,7,399274
18743,0.000444,172.31.36.0-255,66,50846,7,399274
18744,0.000473,74.125.200.0-255,5738,56584,7,399274
18745,0.000476,172.31.36.0-255,66,56650,7,399274
18746,0.000482,74.125.200.0-255,4320,60970,7,399274
18747,0.000484,172.31.36.0-255,66,61036,7,399274
18748,0.000489,74.125.200.0-255,2902,63938,7,399274
18749,0.000491,172.31.36.0-255,66,64004,7,399274
18750,0.00051,74.125.200.0-255,2184,66188,7,399274
18751,0.000512,172.31.36.0-255,66,66254,7,399274
18752,0.000515,74.125.200.0-255,397,66651,7,399274
18753,0.000536,74.125.200.0-255,111,66762,7,399274
18754,0.000665,74.125.200.0-255,1484,68246,7,399274
18755,0.000671,172.31.36.0-255,66,68312,7,399274
18756,0.000689,74.125.200.0-255,2902,71214,7,399274
18757,0.000692,172.31.36.0-255,66,71280,7,399274
18758,0.000719,74.125.200.0-255,5738,77018,7,399274
18759,0.000738,172.31.36.0-255,66,77084,7,399274
18760,0.000743,74.125.200.0-255,2902,79986,7,399274
18761,0.000745,172.31.36.0-255,66,80052,7,399274
18762,0.000751,74.125.200.0-255,4320,84372,7,399274
18763,0.000754,172.31.36.0-255,66,84438,7,399274
18764,0.000774,74.125.200.0-255,1484,85922,7,399274
18765,0.000803,74.125.200.0-255,2902,88824,7,399274
18766,0.000806,172.31.36.0-255,66,88890,7,399274
18767,0.000813,74.125.200.0-255,5738,94628,7,399274
18768,0.000815,172.31.36.0-255,66,94694,7,399274
18769,0.000839,74.125.200.0-255,6438,101132,7,399274
18770,0.000841,172.31.36.0-255,66,101198,7,399274
18771,0.001398,74.125.200.0-255,1484,102682,7,399274
18772,0.001406,74.125.200.0-255,2902,105584,7,399274
18773,0.001411,172.31.36.0-255,66,105650,7,399274
18774,0.00143,74.125.200.0-255,1484,107134,7,399274
18775,0.001449,74.125.200.0-255,2902,110036,7,399274
18776,0.001452,172.31.36.0-255,66,110102,7,399274
18777,0.001459,74.125.200.0-255,5738,115840,7,399274
18778,0.001462,172.31.36.0-255,66,115906,7,399274
18779,0.00149,74.125.200.0-255,5738,121644,7,399274
18780,0.001492,172.31.36.0-255,66,121710,7,399274
18781,0.0015,74.125.200.0-255,7156,128866,7,399274
18782,0.001502,172.31.36.0-255,66,128932,7,399274
18783,0.001536,74.125.200.0-255,6438,135370,7,399274
18784,0.001539,172.31.36.0-255,66,135436,7,399274
18785,0.001564,74.125.200.0-255,7156,142592,7,399274
18786,0.001567,172.31.36.0-255,66,142658,7,399274
18787,0.00157,74.125.200.0-255,1484,144142,7,399274
18788,0.00159,74.125.200.0-255,5738,149880,7,399274
18789,0.001593,172.31.36.0-255,66,149946,7,399274
18790,0.001596,74.125.200.0-255,1484,151430,7,399274
18791,0.001611,74.125.200.0-255,4320,155750,7,399274
18792,0.001614,172.31.36.0-255,66,155816,7,399274
18793,0.001636,74.125.200.0-255,2902,158718,7,399274
18794,0.001639,172.31.36.0-255,66,158784,7,399274
18795,0.001646,74.125.200.0-255,5738,164522,7,399274
18796,0.001648,172.31.36.0-255,66,164588,7,399274
18797,0.001667,74.125.200.0-255,5020,169608,7,399274
18798,0.001669,172.31.36.0-255,66,169674,7,399274
18799,0.003648,74.125.200.0-255,2902,172576,7,399274
18800,0.003654,172.31.36.0-255,66,172642,7,399274
18801,0.003668,74.125.200.0-255,2902,175544,7,399274
18802,0.003671,172.31.36.0-255,66,175610,7,399274
18803,0.005648,74.125.200.0-255,5738,181348,7,399274
18804,0.005656,172.31.36.0-255,66,181414,7,399274
18805,0.007649,74.125.200.0-255,5738,187152,7,399274
18806,0.007659,172.31.36.0-255,66,187218,7,399274
18807,0.009647,74.125.200.0-255,5738,192956,7,399274
18808,0.009657,172.31.36.0-255,66,193022,7,399274
18809,0.011696,74.125.200.0-255,5738,198760,7,399274
18810,0.011709,172.31.36.0-255,66,198826,7,399274
18811,0.013699,74.125.200.0-255,4320,203146,7,399274
18812,0.013708,172.31.36.0-255,66,203212,7,399274
18813,0.01373,74.125.200.0-255,1484,204696,7,399274
18814,0.015693,74.125.200.0-255,4320,209016,7,399274
18815,0.0157,172.31.36.0-255,66,209082,7,399274
18816,0.017686,74.125.200.0-255,5738,214820,7,399274
18817,0.017693,172.31.36.0-255,66,214886,7,399274
18818,0.01969,74.125.200.0-255,5738,220624,7,399274
18819,0.019698,172.31.36.0-255,66,220690,7,399274
18820,0.021691,74.125.200.0-255,5738,226428,7,399274
18821,0.021698,172.31.36.0-255,66,226494,7,399274
18822,0.022467,172.31.36.0-255,172,226666,7,399274
18823,0.022498,172.31.36.0-255,1114,227780,7,399274
18824,0.022559,172.31.36.0-255,1514,229294,7,399274
18825,0.022561,172.31.36.0-255,1292,230586,7,399274
18826,0.023698,74.125.200.0-255,5738,236324,7,399274
18827,0.023704,172.31.36.0-255,66,236390,7,399274
18828,0.023988,104.244.42.0-255,66,236456,7,399274
18829,0.02411,104.244.42.0-255,66,236522,7,399274
18830,0.024134,104.244.42.0-255,66,236588,7,399274
18831,0.024636,104.244.42.0-255,108,236696,7,399274
18832,0.024641,172.31.36.0-255,66,236762,7,399274
18833,0.025694,74.125.200.0-255,5738,242500,7,399274
18834,0.025699,172.31.36.0-255,66,242566,7,399274
18835,0.027699,74.125.200.0-255,5738,248304,7,399274
18836,0.027706,172.31.36.0-255,66,248370,7,399274
18837,0.029689,74.125.200.0-255,5738,254108,7,399274
18838,0.029696,172.31.36.0-255,66,254174,7,399274
18839,0.031678,74.125.200.0-255,5738,259912,7,399274
18840,0.031685,172.31.36.0-255,66,259978,7,399274
18841,0.03369,74.125.200.0-255,5738,265716,7,399274
18842,0.033703,172.31.36.0-255,66,265782,7,399274
18843,0.035712,74.125.200.0-255,5738,271520,7,399274
18844,0.035721,172.31.36.0-255,66,271586,7,399274
18845,0.037708,74.125.200.0-255,5738,277324,7,399274
18846,0.037715,172.31.36.0-255,66,277390,7,399274
18847,0.039708,74.125.200.0-255,5738,283128,7,399274
18848,0.039717,172.31.36.0-255,66,283194,7,399274
18849,0.041762,74.125.200.0-255,5738,288932,7,399274
18850,0.041772,172.31.36.0-255,66,288998,7,399274
18851,0.04377,74.125.200.0-255,5738,294736,7,399274
18852,0.043777,172.31.36.0-255,66,294802,7,399274
18853,0.045772,74.125.200.0-255,5738,300540,7,399274
18854,0.045779,172.31.36.0-255,66,300606,7,399274
18855,0.04778,74.125.200.0-255,5738,306344,7,399274
18856,0.047789,172.31.36.0-255,66,306410,7,399274
18857,0.049784,74.125.200.0-255,5738,312148,7,399274
18858,0.049794,172.31.36.0-255,66,312214,7,399274
18859,0.051793,74.125.200.0-255,5738,317952,7,399274
18860,0.051802,172.31.36.0-255,66,318018,7,399274
18861,0.053797,74.125.200.0-255,5738,323756,7,399274
18862,0.053809,172.31.36.0-255,66,323822,7,399274
18863,0.055805,74.125.200.0-255,5738,329560,7,399274
18864,0.055812,172.31.36.0-255,66,329626,7,399274
18865,0.057804,74.125.200.0-255,5738,335364,7,399274
18866,0.057813,172.31.36.0-255,66,335430,7,399274
18867,0.059809,74.125.200.0-255,5738,341168,7,399274
18868,0.059817,172.31.36.0-255,66,341234,7,399274
18869,0.06181,74.125.200.0-255,5738,346972,7,399274
18870,0.061817,172.31.36.0-255,66,347038,7,399274
18871,0.063813,74.125.200.0-255,5738,352776,7,399274
18872,0.063823,172.31.36.0-255,66,352842,7,399274
18873,0.06581,74.125.200.0-255,5738,358580,7,399274
18874,0.065821,172.31.36.0-255,66,358646,7,399274
18875,0.06782,74.125.200.0-255,5738,364384,7,399274
18876,0.06783,172.31.36.0-255,66,364450,7,399274
18877,0.069808,74.125.200.0-255,5738,370188,7,399274
18878,0.069817,172.31.36.0-255,66,370254,7,399274
18879,0.071814,74.125.200.0-255,5738,375992,7,399274
18880,0.071822,172.31.36.0-255,66,376058,7,399274
18881,0.073815,74.125.200.0-255,5738,381796,7,399274
18882,0.073824,172.31.36.0-255,66,381862,7,399274
18883,0.075817,74.125.200.0-255,5738,387600,7,399274
18884,0.075825,172.31.36.0-255,66,387666,7,399274
18885,0.077869,74.125.200.0-255,5738,393404,7,399274
18886,0.077877,172.31.36.0-255,66,393470,7,399274
18887,0.079873,74.125.200.0-255,5738,399208,7,399274
18888,0.079881,172.31.36.0-255,66,399274,7,399274
18889,0.0,172.31.36.0-255,105,105,7,276
18890,0.002087,157.240.13.0-255,105,210,7,276
18891,0.002103,172.31.36.0-255,66,276,7,276
18892,0.0,172.217.194.0-255,153,153,7,276812
18893,1.7e-05,172.31.36.0-255,66,219,7,276812
18894,2.4e-05,172.217.194.0-255,1484,1703,7,276812
18895,2.9e-05,172.31.36.0-255,66,1769,7,276812
18896,4.3e-05,172.217.194.0-255,2902,4671,7,276812
18897,4.7e-05,172.31.36.0-255,66,4737,7,276812
18898,5.4e-05,172.217.194.0-255,7156,11893,7,276812
18899,5.7e-05,172.31.36.0-255,66,11959,7,276812
18900,6e-05,172.217.194.0-255,1484,13443,7,276812
18901,6.2e-05,172.31.36.0-255,66,13509,7,276812
18902,9.6e-05,172.217.194.0-255,3483,16992,7,276812
18903,9.9e-05,172.31.36.0-255,66,17058,7,276812
18904,0.000139,172.31.36.0-255,66,17124,7,276812
18905,0.000183,172.217.194.0-255,1484,18608,7,276812
18906,0.000185,172.31.36.0-255,66,18674,7,276812
18907,0.00019,172.217.194.0-255,2902,21576,7,276812
18908,0.000192,172.31.36.0-255,66,21642,7,276812
18909,0.000212,172.217.194.0-255,2902,24544,7,276812
18910,0.000215,172.31.36.0-255,66,24610,7,276812
18911,0.00024,172.217.194.0-255,2902,27512,7,276812
18912,0.000242,172.31.36.0-255,66,27578,7,276812
18913,0.00025,172.217.194.0-255,6797,34375,7,276812
18914,0.000252,172.31.36.0-255,66,34441,7,276812
18915,0.000298,172.31.36.0-255,66,34507,7,276812
18916,0.000303,172.217.194.0-255,2543,37050,7,276812
18917,0.000305,172.31.36.0-255,66,37116,7,276812
18918,0.000699,172.217.194.0-255,646,37762,7,276812
18919,0.000705,172.31.36.0-255,66,37828,7,276812
18920,0.00126,172.217.194.0-255,1484,39312,7,276812
18921,0.001266,172.31.36.0-255,66,39378,7,276812
18922,0.001275,172.217.194.0-255,2902,42280,7,276812
18923,0.001278,172.31.36.0-255,66,42346,7,276812
18924,0.001291,172.217.194.0-255,5738,48084,7,276812
18925,0.001293,172.31.36.0-255,66,48150,7,276812
18926,0.0013,172.217.194.0-255,6248,54398,7,276812
18927,0.001302,172.31.36.0-255,66,54464,7,276812
18928,0.001675,172.217.194.0-255,1484,55948,7,276812
18929,0.001684,172.217.194.0-255,2902,58850,7,276812
18930,0.001688,172.31.36.0-255,66,58916,7,276812
18931,0.001718,172.217.194.0-255,4320,63236,7,276812
18932,0.00172,172.31.36.0-255,66,63302,7,276812
18933,0.001732,172.31.36.0-255,66,63368,7,276812
18934,0.001762,172.31.36.0-255,66,63434,7,276812
18935,0.001785,172.217.194.0-255,1484,64918,7,276812
18936,0.001808,172.217.194.0-255,3602,68520,7,276812
18937,0.00181,172.31.36.0-255,66,68586,7,276812
18938,0.002167,172.217.194.0-255,1484,70070,7,276812
18939,0.002176,172.217.194.0-255,2902,72972,7,276812
18940,0.002179,172.31.36.0-255,66,73038,7,276812
18941,0.002207,172.217.194.0-255,5738,78776,7,276812
18942,0.002209,172.31.36.0-255,66,78842,7,276812
18943,0.002246,172.31.36.0-255,66,78908,7,276812
18944,0.002297,172.31.36.0-255,66,78974,7,276812
18945,0.002335,172.31.36.0-255,66,79040,7,276812
18946,0.002344,172.217.194.0-255,7156,86196,7,276812
18947,0.002346,172.31.36.0-255,66,86262,7,276812
18948,0.002375,172.217.194.0-255,1484,87746,7,276812
18949,0.002378,172.217.194.0-255,1484,89230,7,276812
18950,0.002381,172.31.36.0-255,66,89296,7,276812
18951,0.002416,172.31.36.0-255,66,89362,7,276812
18952,0.004781,172.217.194.0-255,5738,95100,7,276812
18953,0.004788,172.31.36.0-255,66,95166,7,276812
18954,0.00715,172.217.194.0-255,5738,100904,7,276812
18955,0.007155,172.31.36.0-255,66,100970,7,276812
18956,0.009567,172.217.194.0-255,5738,106708,7,276812
18957,0.009576,172.31.36.0-255,66,106774,7,276812
18958,0.011968,172.217.194.0-255,5738,112512,7,276812
18959,0.011977,172.31.36.0-255,66,112578,7,276812
18960,0.014358,172.217.194.0-255,5738,118316,7,276812
18961,0.014368,172.31.36.0-255,66,118382,7,276812
18962,0.016718,172.217.194.0-255,5738,124120,7,276812
18963,0.016728,172.31.36.0-255,66,124186,7,276812
18964,0.01911,172.217.194.0-255,5738,129924,7,276812
18965,0.019123,172.31.36.0-255,66,129990,7,276812
18966,0.021486,172.217.194.0-255,5738,135728,7,276812
18967,0.021495,172.31.36.0-255,66,135794,7,276812
18968,0.02388,172.217.194.0-255,5738,141532,7,276812
18969,0.023889,172.31.36.0-255,66,141598,7,276812
18970,0.026305,172.217.194.0-255,4320,145918,7,276812
18971,0.026312,172.31.36.0-255,66,145984,7,276812
18972,0.02634,172.217.194.0-255,1484,147468,7,276812
18973,0.028697,172.217.194.0-255,4320,151788,7,276812
18974,0.028705,172.31.36.0-255,66,151854,7,276812
18975,0.031076,172.217.194.0-255,5738,157592,7,276812
18976,0.031084,172.31.36.0-255,66,157658,7,276812
18977,0.032414,172.31.36.0-255,176,157834,7,276812
18978,0.032452,172.31.36.0-255,1114,158948,7,276812
18979,0.03251,172.31.36.0-255,1514,160462,7,276812
18980,0.032512,172.31.36.0-255,1292,161754,7,276812
18981,0.033464,172.217.194.0-255,5738,167492,7,276812
18982,0.033472,172.31.36.0-255,66,167558,7,276812
18983,0.033936,104.244.42.0-255,66,167624,7,276812
18984,0.034007,104.244.42.0-255,66,167690,7,276812
18985,0.034069,104.244.42.0-255,66,167756,7,276812
18986,0.035883,172.217.194.0-255,5738,173494,7,276812
18987,0.03589,172.31.36.0-255,66,173560,7,276812
18988,0.038276,172.217.194.0-255,5738,179298,7,276812
18989,0.038284,172.31.36.0-255,66,179364,7,276812
18990,0.040649,172.217.194.0-255,5738,185102,7,276812
18991,0.040655,172.31.36.0-255,66,185168,7,276812
18992,0.043008,172.217.194.0-255,5738,190906,7,276812
18993,0.043014,172.31.36.0-255,66,190972,7,276812
18994,0.045387,172.217.194.0-255,2902,193874,7,276812
18995,0.045394,172.31.36.0-255,66,193940,7,276812
18996,0.045421,172.217.194.0-255,2902,196842,7,276812
18997,0.045425,172.31.36.0-255,66,196908,7,276812
18998,0.047782,172.217.194.0-255,4320,201228,7,276812
18999,0.047789,172.31.36.0-255,66,201294,7,276812
19000,0.047814,172.217.194.0-255,1484,202778,7,276812
19001,0.050152,172.217.194.0-255,4320,207098,7,276812
19002,0.050159,172.31.36.0-255,66,207164,7,276812
19003,0.052527,172.217.194.0-255,5738,212902,7,276812
19004,0.052534,172.31.36.0-255,66,212968,7,276812
19005,0.054904,172.217.194.0-255,5738,218706,7,276812
19006,0.05491,172.31.36.0-255,66,218772,7,276812
19007,0.057266,172.217.194.0-255,5738,224510,7,276812
19008,0.057272,172.31.36.0-255,66,224576,7,276812
19009,0.059648,172.217.194.0-255,5738,230314,7,276812
19010,0.059654,172.31.36.0-255,66,230380,7,276812
19011,0.06202,172.217.194.0-255,5738,236118,7,276812
19012,0.062026,172.31.36.0-255,66,236184,7,276812
19013,0.064389,172.217.194.0-255,5738,241922,7,276812
19014,0.064396,172.31.36.0-255,66,241988,7,276812
19015,0.066779,172.217.194.0-255,5738,247726,7,276812
19016,0.066785,172.31.36.0-255,66,247792,7,276812
19017,0.069162,172.217.194.0-255,5738,253530,7,276812
19018,0.069169,172.31.36.0-255,66,253596,7,276812
19019,0.071556,172.217.194.0-255,5738,259334,7,276812
19020,0.071563,172.31.36.0-255,66,259400,7,276812
19021,0.073954,172.217.194.0-255,5738,265138,7,276812
19022,0.07396,172.31.36.0-255,66,265204,7,276812
19023,0.07638,172.217.194.0-255,5738,270942,7,276812
19024,0.076386,172.31.36.0-255,66,271008,7,276812
19025,0.078771,172.217.194.0-255,5738,276746,7,276812
19026,0.078781,172.31.36.0-255,66,276812,7,276812
19027,0.0,172.217.194.0-255,66,66,7,66
19028,0.0,172.31.36.0-255,105,105,7,276
19029,0.068351,31.13.82.0-255,105,210,7,276
19030,0.068371,172.31.36.0-255,66,276,7,276
19031,0.0,74.125.24.0-255,155,155,7,302494
19032,3e-05,172.31.36.0-255,66,221,7,302494
19033,3.7e-05,74.125.24.0-255,1484,1705,7,302494
19034,4e-05,172.31.36.0-255,66,1771,7,302494
19035,4.5e-05,74.125.24.0-255,2902,4673,7,302494
19036,4.7e-05,172.31.36.0-255,66,4739,7,302494
19037,6.1e-05,74.125.24.0-255,5738,10477,7,302494
19038,6.3e-05,172.31.36.0-255,66,10543,7,302494
19039,9.2e-05,74.125.24.0-255,3464,14007,7,302494
19040,9.4e-05,172.31.36.0-255,66,14073,7,302494
19041,0.000188,74.125.24.0-255,1484,15557,7,302494
19042,0.000193,172.31.36.0-255,66,15623,7,302494
19043,0.000198,74.125.24.0-255,2902,18525,7,302494
19044,0.0002,172.31.36.0-255,66,18591,7,302494
19045,0.000237,74.125.24.0-255,5738,24329,7,302494
19046,0.00024,172.31.36.0-255,66,24395,7,302494
19047,0.000248,74.125.24.0-255,7156,31551,7,302494
19048,0.00025,172.31.36.0-255,66,31617,7,302494
19049,0.000282,74.125.24.0-255,2543,34160,7,302494
19050,0.000286,172.31.36.0-255,66,34226,7,302494
19051,0.000298,172.31.36.0-255,66,34292,7,302494
19052,0.00032,172.31.36.0-255,66,34358,7,302494
19053,0.000372,172.31.36.0-255,66,34424,7,302494
19054,0.000443,74.125.24.0-255,130,34554,7,302494
19055,0.000447,172.31.36.0-255,66,34620,7,302494
19056,0.000451,74.125.24.0-255,347,34967,7,302494
19057,0.000455,172.31.36.0-255,66,35033,7,302494
19058,0.000818,74.125.24.0-255,1484,36517,7,302494
19059,0.000823,172.31.36.0-255,66,36583,7,302494
19060,0.000856,74.125.24.0-255,2902,39485,7,302494
19061,0.00086,172.31.36.0-255,66,39551,7,302494
19062,0.000868,74.125.24.0-255,5738,45289,7,302494
19063,0.000872,172.31.36.0-255,66,45355,7,302494
19064,0.000886,172.31.36.0-255,66,45421,7,302494
19065,0.000891,74.125.24.0-255,4320,49741,7,302494
19066,0.000893,172.31.36.0-255,66,49807,7,302494
19067,0.000929,74.125.24.0-255,1484,51291,7,302494
19068,0.000937,74.125.24.0-255,7156,58447,7,302494
19069,0.00094,172.31.36.0-255,66,58513,7,302494
19070,0.000943,74.125.24.0-255,766,59279,7,302494
19071,0.001148,172.31.36.0-255,66,59345,7,302494
19072,0.001368,74.125.24.0-255,1484,60829,7,302494
19073,0.001378,74.125.24.0-255,2902,63731,7,302494
19074,0.001382,172.31.36.0-255,66,63797,7,302494
19075,0.001389,74.125.24.0-255,5738,69535,7,302494
19076,0.001391,172.31.36.0-255,66,69601,7,302494
19077,0.001413,172.31.36.0-255,66,69667,7,302494
19078,0.001482,172.31.36.0-255,66,69733,7,302494
19079,0.001942,74.125.24.0-255,1484,71217,7,302494
19080,0.00195,74.125.24.0-255,2902,74119,7,302494
19081,0.001955,172.31.36.0-255,66,74185,7,302494
19082,0.001961,74.125.24.0-255,4320,78505,7,302494
19083,0.001963,172.31.36.0-255,66,78571,7,302494
19084,0.001984,74.125.24.0-255,1484,80055,7,302494
19085,0.002012,172.31.36.0-255,66,80121,7,302494
19086,0.002018,74.125.24.0-255,4320,84441,7,302494
19087,0.002019,172.31.36.0-255,66,84507,7,302494
19088,0.00206,74.125.24.0-255,4320,88827,7,302494
19089,0.002063,172.31.36.0-255,66,88893,7,302494
19090,0.002086,74.125.24.0-255,2184,91077,7,302494
19091,0.002088,172.31.36.0-255,66,91143,7,302494
19092,0.002196,74.125.24.0-255,1484,92627,7,302494
19093,0.002201,74.125.24.0-255,2902,95529,7,302494
19094,0.002205,172.31.36.0-255,66,95595,7,302494
19095,0.002212,74.125.24.0-255,5738,101333,7,302494
19096,0.002214,172.31.36.0-255,66,101399,7,302494
19097,0.002249,172.31.36.0-255,66,101465,7,302494
19098,0.00228,172.31.36.0-255,66,101531,7,302494
19099,0.002291,172.31.36.0-255,66,101597,7,302494
19100,0.00231,74.125.24.0-255,1484,103081,7,302494
19101,0.002318,74.125.24.0-255,7156,110237,7,302494
19102,0.002321,172.31.36.0-255,66,110303,7,302494
19103,0.002358,172.31.36.0-255,66,110369,7,302494
19104,0.002363,74.125.24.0-255,5020,115389,7,302494
19105,0.002365,172.31.36.0-255,66,115455,7,302494
19106,0.00466,74.125.24.0-255,4320,119775,7,302494
19107,0.004663,172.31.36.0-255,66,119841,7,302494
19108,0.004691,74.125.24.0-255,1484,121325,7,302494
19109,0.006956,74.125.24.0-255,4320,125645,7,302494
19110,0.006962,172.31.36.0-255,66,125711,7,302494
19111,0.009251,74.125.24.0-255,5738,131449,7,302494
19112,0.009258,172.31.36.0-255,66,131515,7,302494
19113,0.011555,74.125.24.0-255,5738,137253,7,302494
19114,0.01156,172.31.36.0-255,66,137319,7,302494
19115,0.013896,74.125.24.0-255,5738,143057,7,302494
19116,0.013919,172.31.36.0-255,66,143123,7,302494
19117,0.016232,74.125.24.0-255,5738,148861,7,302494
19118,0.016251,172.31.36.0-255,66,148927,7,302494
19119,0.018563,74.125.24.0-255,5738,154665,7,302494
19120,0.018575,172.31.36.0-255,105,154770,7,302494
19121,0.01858,172.31.36.0-255,66,154836,7,302494
19122,0.02008,157.240.13.0-255,105,154941,7,302494
19123,0.020099,172.31.36.0-255,66,155007,7,302494
19124,0.020886,74.125.24.0-255,5738,160745,7,302494
19125,0.020895,172.31.36.0-255,66,160811,7,302494
19126,0.023206,74.125.24.0-255,5738,166549,7,302494
19127,0.02322,172.31.36.0-255,66,166615,7,302494
19128,0.025526,74.125.24.0-255,5738,172353,7,302494
19129,0.025535,172.31.36.0-255,66,172419,7,302494
19130,0.027847,74.125.24.0-255,5738,178157,7,302494
19131,0.027857,172.31.36.0-255,66,178223,7,302494
19132,0.030173,74.125.24.0-255,5738,183961,7,302494
19133,0.030181,172.31.36.0-255,66,184027,7,302494
19134,0.032519,74.125.24.0-255,5738,189765,7,302494
19135,0.032526,172.31.36.0-255,66,189831,7,302494
19136,0.034833,74.125.24.0-255,5738,195569,7,302494
19137,0.034843,172.31.36.0-255,66,195635,7,302494
19138,0.037158,74.125.24.0-255,5738,201373,7,302494
19139,0.037168,172.31.36.0-255,66,201439,7,302494
19140,0.039496,74.125.24.0-255,5738,207177,7,302494
19141,0.039502,172.31.36.0-255,66,207243,7,302494
19142,0.041774,172.31.36.0-255,172,207415,7,302494
19143,0.041808,74.125.24.0-255,5738,213153,7,302494
19144,0.041817,172.31.36.0-255,66,213219,7,302494
19145,0.041823,172.31.36.0-255,1114,214333,7,302494
19146,0.041916,172.31.36.0-255,1514,215847,7,302494
19147,0.041918,172.31.36.0-255,1294,217141,7,302494
19148,0.043261,104.244.42.0-255,66,217207,7,302494
19149,0.043309,104.244.42.0-255,66,217273,7,302494
19150,0.043413,104.244.42.0-255,66,217339,7,302494
19151,0.043969,104.244.42.0-255,108,217447,7,302494
19152,0.043975,172.31.36.0-255,66,217513,7,302494
19153,0.0441,74.125.24.0-255,5738,223251,7,302494
19154,0.04412,172.31.36.0-255,66,223317,7,302494
19155,0.046409,74.125.24.0-255,5738,229055,7,302494
19156,0.046415,172.31.36.0-255,66,229121,7,302494
19157,0.048691,74.125.24.0-255,5738,234859,7,302494
19158,0.048696,172.31.36.0-255,66,234925,7,302494
19159,0.050972,74.125.24.0-255,5738,240663,7,302494
19160,0.050978,172.31.36.0-255,66,240729,7,302494
19161,0.053264,74.125.24.0-255,5738,246467,7,302494
19162,0.053272,172.31.36.0-255,66,246533,7,302494
19163,0.055603,74.125.24.0-255,5738,252271,7,302494
19164,0.055609,172.31.36.0-255,66,252337,7,302494
19165,0.057907,74.125.24.0-255,5738,258075,7,302494
19166,0.057914,172.31.36.0-255,66,258141,7,302494
19167,0.060215,74.125.24.0-255,5738,263879,7,302494
19168,0.060222,172.31.36.0-255,66,263945,7,302494
19169,0.062511,74.125.24.0-255,4320,268265,7,302494
19170,0.062517,172.31.36.0-255,66,268331,7,302494
19171,0.062549,74.125.24.0-255,1484,269815,7,302494
19172,0.06481,74.125.24.0-255,4320,274135,7,302494
19173,0.064815,172.31.36.0-255,66,274201,7,302494
19174,0.067114,74.125.24.0-255,5738,279939,7,302494
19175,0.06712,172.31.36.0-255,66,280005,7,302494
19176,0.069425,74.125.24.0-255,4320,284325,7,302494
19177,0.069431,172.31.36.0-255,66,284391,7,302494
19178,0.069462,74.125.24.0-255,1484,285875,7,302494
19179,0.071754,74.125.24.0-255,4320,290195,7,302494
19180,0.071761,172.31.36.0-255,66,290261,7,302494
19181,0.074068,74.125.24.0-255,5738,295999,7,302494
19182,0.074074,172.31.36.0-255,66,296065,7,302494
19183,0.076377,74.125.24.0-255,5667,301732,7,302494
19184,0.076383,172.31.36.0-255,66,301798,7,302494
19185,0.076619,172.31.36.0-255,105,301903,7,302494
19186,0.076647,172.31.36.0-255,105,302008,7,302494
19187,0.076861,172.31.36.0-255,90,302098,7,302494
19188,0.076871,172.31.36.0-255,66,302164,7,302494
19189,0.078887,74.125.24.0-255,66,302230,7,302494
19190,0.078902,74.125.24.0-255,66,302296,7,302494
19191,0.07914,74.125.24.0-255,66,302362,7,302494
19192,0.079162,74.125.24.0-255,66,302428,7,302494
19193,0.079167,172.31.36.0-255,66,302494,7,302494
19194,0.0,74.125.68.0-255,153,153,7,302615
19195,2.7e-05,172.31.36.0-255,66,219,7,302615
19196,3.4e-05,74.125.68.0-255,1484,1703,7,302615
19197,3.9e-05,172.31.36.0-255,66,1769,7,302615
19198,4.4e-05,74.125.68.0-255,2902,4671,7,302615
19199,4.7e-05,172.31.36.0-255,66,4737,7,302615
19200,5.3e-05,74.125.68.0-255,5738,10475,7,302615
19201,5.6e-05,172.31.36.0-255,66,10541,7,302615
19202,8.2e-05,74.125.68.0-255,3466,14007,7,302615
19203,8.4e-05,172.31.36.0-255,66,14073,7,302615
19204,0.000151,74.125.68.0-255,1484,15557,7,302615
19205,0.000157,172.31.36.0-255,66,15623,7,302615
19206,0.000162,74.125.68.0-255,2902,18525,7,302615
19207,0.000165,172.31.36.0-255,66,18591,7,302615
19208,0.000171,74.125.68.0-255,5738,24329,7,302615
19209,0.000173,172.31.36.0-255,66,24395,7,302615
19210,0.000197,74.125.68.0-255,2902,27297,7,302615
19211,0.000199,172.31.36.0-255,66,27363,7,302615
19212,0.000218,74.125.68.0-255,3961,31324,7,302615
19213,0.000221,172.31.36.0-255,66,31390,7,302615
19214,0.000398,74.125.68.0-255,1484,32874,7,302615
19215,0.000404,172.31.36.0-255,66,32940,7,302615
19216,0.000415,74.125.68.0-255,2902,35842,7,302615
19217,0.000418,172.31.36.0-255,66,35908,7,302615
19218,0.000421,74.125.68.0-255,1484,37392,7,302615
19219,0.000423,172.31.36.0-255,66,37458,7,302615
19220,0.000428,74.125.68.0-255,2902,40360,7,302615
19221,0.000431,172.31.36.0-255,66,40426,7,302615
19222,0.000485,74.125.68.0-255,5738,46164,7,302615
19223,0.000489,172.31.36.0-255,66,46230,7,302615
19224,0.000496,74.125.68.0-255,5379,51609,7,302615
19225,0.000499,172.31.36.0-255,66,51675,7,302615
19226,0.000501,74.125.68.0-255,5738,57413,7,302615
19227,0.000504,172.31.36.0-255,66,57479,7,302615
19228,0.000535,172.31.36.0-255,66,57545,7,302615
19229,0.000538,74.125.68.0-255,127,57672,7,302615
19230,0.000667,74.125.68.0-255,1484,59156,7,302615
19231,0.00067,172.31.36.0-255,66,59222,7,302615
19232,0.000687,74.125.68.0-255,2902,62124,7,302615
19233,0.00069,172.31.36.0-255,66,62190,7,302615
19234,0.00071,74.125.68.0-255,5738,67928,7,302615
19235,0.000714,172.31.36.0-255,66,67994,7,302615
19236,0.000729,74.125.68.0-255,5738,73732,7,302615
19237,0.000732,172.31.36.0-255,66,73798,7,302615
19238,0.000753,74.125.68.0-255,1125,74923,7,302615
19239,0.000774,74.125.68.0-255,2902,77825,7,302615
19240,0.000777,172.31.36.0-255,66,77891,7,302615
19241,0.000799,74.125.68.0-255,4320,82211,7,302615
19242,0.000802,172.31.36.0-255,66,82277,7,302615
19243,0.000806,74.125.68.0-255,1484,83761,7,302615
19244,0.000825,74.125.68.0-255,7156,90917,7,302615
19245,0.000828,172.31.36.0-255,66,90983,7,302615
19246,0.000831,74.125.68.0-255,1125,92108,7,302615
19247,0.000852,74.125.68.0-255,351,92459,7,302615
19248,0.001101,172.31.36.0-255,66,92525,7,302615
19249,0.00547,74.125.68.0-255,1484,94009,7,302615
19250,0.005488,74.125.68.0-255,1484,95493,7,302615
19251,0.005492,172.31.36.0-255,66,95559,7,302615
19252,0.005498,74.125.68.0-255,2902,98461,7,302615
19253,0.005499,172.31.36.0-255,66,98527,7,302615
19254,0.007722,74.125.68.0-255,2902,101429,7,302615
19255,0.00773,172.31.36.0-255,66,101495,7,302615
19256,0.00775,74.125.68.0-255,2902,104397,7,302615
19257,0.007753,172.31.36.0-255,66,104463,7,302615
19258,0.009961,74.125.68.0-255,2902,107365,7,302615
19259,0.009968,172.31.36.0-255,66,107431,7,302615
19260,0.009989,74.125.68.0-255,2902,110333,7,302615
19261,0.009992,172.31.36.0-255,66,110399,7,302615
19262,0.012202,74.125.68.0-255,2902,113301,7,302615
19263,0.012209,172.31.36.0-255,66,113367,7,302615
19264,0.012229,74.125.68.0-255,2902,116269,7,302615
19265,0.012233,172.31.36.0-255,66,116335,7,302615
19266,0.014493,74.125.68.0-255,5738,122073,7,302615
19267,0.014502,172.31.36.0-255,66,122139,7,302615
19268,0.016753,74.125.68.0-255,5738,127877,7,302615
19269,0.016761,172.31.36.0-255,66,127943,7,302615
19270,0.019021,74.125.68.0-255,5738,133681,7,302615
19271,0.019027,172.31.36.0-255,66,133747,7,302615
19272,0.021269,74.125.68.0-255,5738,139485,7,302615
19273,0.021276,172.31.36.0-255,66,139551,7,302615
19274,0.023518,74.125.68.0-255,5738,145289,7,302615
19275,0.023526,172.31.36.0-255,66,145355,7,302615
19276,0.025781,74.125.68.0-255,5738,151093,7,302615
19277,0.025791,172.31.36.0-255,66,151159,7,302615
19278,0.028044,74.125.68.0-255,5738,156897,7,302615
19279,0.028051,172.31.36.0-255,66,156963,7,302615
19280,0.028803,172.31.36.0-255,172,157135,7,302615
19281,0.028847,172.31.36.0-255,1113,158248,7,302615
19282,0.028948,172.31.36.0-255,1514,159762,7,302615
19283,0.028951,172.31.36.0-255,1514,161276,7,302615
19284,0.028954,172.31.36.0-255,1514,162790,7,302615
19285,0.028961,172.31.36.0-255,1514,164304,7,302615
19286,0.028962,172.31.36.0-255,1514,165818,7,302615
19287,0.028963,172.31.36.0-255,71,165889,7,302615
19288,0.030293,74.125.68.0-255,2902,168791,7,302615
19289,0.030299,172.31.36.0-255,66,168857,7,302615
19290,0.030342,104.244.42.0-255,66,168923,7,302615
19291,0.030349,74.125.68.0-255,2902,171825,7,302615
19292,0.030352,172.31.36.0-255,66,171891,7,302615
19293,0.030433,104.244.42.0-255,66,171957,7,302615
19294,0.030507,104.244.42.0-255,66,172023,7,302615
19295,0.032519,74.125.68.0-255,2902,174925,7,302615
19296,0.032524,172.31.36.0-255,66,174991,7,302615
19297,0.032569,74.125.68.0-255,2902,177893,7,302615
19298,0.032572,172.31.36.0-255,66,177959,7,302615
19299,0.03475,74.125.68.0-255,2902,180861,7,302615
19300,0.034755,172.31.36.0-255,66,180927,7,302615
19301,0.034788,74.125.68.0-255,2902,183829,7,302615
19302,0.034791,172.31.36.0-255,66,183895,7,302615
19303,0.036992,74.125.68.0-255,2902,186797,7,302615
19304,0.036997,172.31.36.0-255,66,186863,7,302615
19305,0.037033,74.125.68.0-255,2902,189765,7,302615
19306,0.037036,172.31.36.0-255,66,189831,7,302615
19307,0.039239,74.125.68.0-255,2902,192733,7,302615
19308,0.039245,172.31.36.0-255,66,192799,7,302615
19309,0.039272,74.125.68.0-255,2902,195701,7,302615
19310,0.039274,172.31.36.0-255,66,195767,7,302615
19311,0.04147,74.125.68.0-255,2902,198669,7,302615
19312,0.041476,172.31.36.0-255,66,198735,7,302615
19313,0.041507,74.125.68.0-255,2902,201637,7,302615
19314,0.041511,172.31.36.0-255,66,201703,7,302615
19315,0.043723,74.125.68.0-255,2902,204605,7,302615
19316,0.043728,172.31.36.0-255,66,204671,7,302615
19317,0.043763,74.125.68.0-255,2902,207573,7,302615
19318,0.043766,172.31.36.0-255,66,207639,7,302615
19319,0.045952,74.125.68.0-255,2902,210541,7,302615
19320,0.045972,172.31.36.0-255,66,210607,7,302615
19321,0.045992,74.125.68.0-255,2902,213509,7,302615
19322,0.045996,172.31.36.0-255,66,213575,7,302615
19323,0.048192,74.125.68.0-255,2902,216477,7,302615
19324,0.048198,172.31.36.0-255,66,216543,7,302615
19325,0.048224,74.125.68.0-255,2902,219445,7,302615
19326,0.048226,172.31.36.0-255,66,219511,7,302615
19327,0.050454,74.125.68.0-255,2902,222413,7,302615
19328,0.050459,172.31.36.0-255,66,222479,7,302615
19329,0.050492,74.125.68.0-255,2902,225381,7,302615
19330,0.050495,172.31.36.0-255,66,225447,7,302615
19331,0.0527,74.125.68.0-255,2902,228349,7,302615
19332,0.052706,172.31.36.0-255,66,228415,7,302615
19333,0.052736,74.125.68.0-255,2902,231317,7,302615
19334,0.052739,172.31.36.0-255,66,231383,7,302615
19335,0.054936,74.125.68.0-255,2902,234285,7,302615
19336,0.054941,172.31.36.0-255,66,234351,7,302615
19337,0.054973,74.125.68.0-255,2902,237253,7,302615
19338,0.054975,172.31.36.0-255,66,237319,7,302615
19339,0.05717,74.125.68.0-255,2902,240221,7,302615
19340,0.057177,172.31.36.0-255,66,240287,7,302615
19341,0.057221,74.125.68.0-255,2902,243189,7,302615
19342,0.057226,172.31.36.0-255,66,243255,7,302615
19343,0.059397,74.125.68.0-255,2902,246157,7,302615
19344,0.059402,172.31.36.0-255,66,246223,7,302615
19345,0.059465,74.125.68.0-255,2902,249125,7,302615
19346,0.059469,172.31.36.0-255,66,249191,7,302615
19347,0.061643,74.125.68.0-255,2902,252093,7,302615
19348,0.061648,172.31.36.0-255,66,252159,7,302615
19349,0.061692,74.125.68.0-255,2902,255061,7,302615
19350,0.061696,172.31.36.0-255,66,255127,7,302615
19351,0.063877,74.125.68.0-255,2902,258029,7,302615
19352,0.063882,172.31.36.0-255,66,258095,7,302615
19353,0.063923,74.125.68.0-255,2902,260997,7,302615
19354,0.063927,172.31.36.0-255,66,261063,7,302615
19355,0.066118,74.125.68.0-255,2902,263965,7,302615
19356,0.066123,172.31.36.0-255,66,264031,7,302615
19357,0.066156,74.125.68.0-255,2902,266933,7,302615
19358,0.06616,172.31.36.0-255,66,266999,7,302615
19359,0.068351,74.125.68.0-255,2902,269901,7,302615
19360,0.068356,172.31.36.0-255,66,269967,7,302615
19361,0.068385,74.125.68.0-255,2902,272869,7,302615
19362,0.068388,172.31.36.0-255,66,272935,7,302615
19363,0.070596,74.125.68.0-255,2902,275837,7,302615
19364,0.070601,172.31.36.0-255,66,275903,7,302615
19365,0.070634,74.125.68.0-255,2902,278805,7,302615
19366,0.070637,172.31.36.0-255,66,278871,7,302615
19367,0.072834,74.125.68.0-255,2902,281773,7,302615
19368,0.072841,172.31.36.0-255,66,281839,7,302615
19369,0.072864,74.125.68.0-255,2902,284741,7,302615
19370,0.072868,172.31.36.0-255,66,284807,7,302615
19371,0.075076,74.125.68.0-255,2902,287709,7,302615
19372,0.075081,172.31.36.0-255,66,287775,7,302615
19373,0.075113,74.125.68.0-255,2902,290677,7,302615
19374,0.075116,172.31.36.0-255,66,290743,7,302615
19375,0.077306,74.125.68.0-255,2902,293645,7,302615
19376,0.077312,172.31.36.0-255,66,293711,7,302615
19377,0.077344,74.125.68.0-255,2902,296613,7,302615
19378,0.077347,172.31.36.0-255,66,296679,7,302615
19379,0.079535,74.125.68.0-255,2902,299581,7,302615
19380,0.079541,172.31.36.0-255,66,299647,7,302615
19381,0.079576,74.125.68.0-255,2902,302549,7,302615
19382,0.079578,172.31.36.0-255,66,302615,7,302615
19383,0.0,74.125.24.0-255,147,147,7,296700
19384,1.7e-05,172.31.36.0-255,66,213,7,296700
19385,2.3e-05,74.125.24.0-255,1484,1697,7,296700
19386,2.8e-05,172.31.36.0-255,66,1763,7,296700
19387,3.3e-05,74.125.24.0-255,2902,4665,7,296700
19388,4.5e-05,172.31.36.0-255,66,4731,7,296700
19389,5.3e-05,74.125.24.0-255,7156,11887,7,296700
19390,5.7e-05,172.31.36.0-255,66,11953,7,296700
19391,6.1e-05,74.125.24.0-255,2080,14033,7,296700
19392,6.3e-05,172.31.36.0-255,66,14099,7,296700
19393,6.8e-05,74.125.24.0-255,1484,15583,7,296700
19394,7e-05,172.31.36.0-255,66,15649,7,296700
19395,0.000119,172.31.36.0-255,66,15715,7,296700
19396,0.000125,74.125.24.0-255,5379,21094,7,296700
19397,0.000128,172.31.36.0-255,66,21160,7,296700
19398,0.000162,74.125.24.0-255,1484,22644,7,296700
19399,0.000164,172.31.36.0-255,66,22710,7,296700
19400,0.00017,74.125.24.0-255,2902,25612,7,296700
19401,0.000172,172.31.36.0-255,66,25678,7,296700
19402,0.000184,74.125.24.0-255,5738,31416,7,296700
19403,0.000186,172.31.36.0-255,66,31482,7,296700
19404,0.000207,74.125.24.0-255,1484,32966,7,296700
19405,0.000209,172.31.36.0-255,66,33032,7,296700
19406,0.000253,172.31.36.0-255,66,33098,7,296700
19407,0.00031,74.125.24.0-255,4320,37418,7,296700
19408,0.000312,172.31.36.0-255,66,37484,7,296700
19409,0.000341,74.125.24.0-255,5655,43139,7,296700
19410,0.000343,172.31.36.0-255,66,43205,7,296700
19411,0.000346,74.125.24.0-255,379,43584,7,296700
19412,0.000348,172.31.36.0-255,66,43650,7,296700
19413,0.00038,74.125.24.0-255,1484,45134,7,296700
19414,0.000387,74.125.24.0-255,4320,49454,7,296700
19415,0.000389,172.31.36.0-255,66,49520,7,296700
19416,0.000392,74.125.24.0-255,1484,51004,7,296700
19417,0.000423,172.31.36.0-255,66,51070,7,296700
19418,0.000426,74.125.24.0-255,1125,52195,7,296700
19419,0.000532,74.125.24.0-255,1484,53679,7,296700
19420,0.000535,172.31.36.0-255,66,53745,7,296700
19421,0.000592,74.125.24.0-255,2902,56647,7,296700
19422,0.000595,172.31.36.0-255,66,56713,7,296700
19423,0.000602,74.125.24.0-255,5738,62451,7,296700
19424,0.000605,172.31.36.0-255,66,62517,7,296700
19425,0.000615,74.125.24.0-255,4320,66837,7,296700
19426,0.000617,172.31.36.0-255,66,66903,7,296700
19427,0.000659,74.125.24.0-255,6797,73700,7,296700
19428,0.000662,172.31.36.0-255,66,73766,7,296700
19429,0.000675,172.31.36.0-255,66,73832,7,296700
19430,0.000678,74.125.24.0-255,1484,75316,7,296700
19431,0.000698,74.125.24.0-255,2902,78218,7,296700
19432,0.0007,172.31.36.0-255,66,78284,7,296700
19433,0.000736,74.125.24.0-255,5738,84022,7,296700
19434,0.000739,172.31.36.0-255,66,84088,7,296700
19435,0.000751,172.31.36.0-255,66,84154,7,296700
19436,0.000794,74.125.24.0-255,7156,91310,7,296700
19437,0.000797,172.31.36.0-255,66,91376,7,296700
19438,0.000828,74.125.24.0-255,4320,95696,7,296700
19439,0.00083,172.31.36.0-255,66,95762,7,296700
19440,0.000848,172.31.36.0-255,66,95828,7,296700
19441,0.000851,74.125.24.0-255,1125,96953,7,296700
19442,0.000913,74.125.24.0-255,1484,98437,7,296700
19443,0.000916,172.31.36.0-255,66,98503,7,296700
19444,0.000939,74.125.24.0-255,2902,101405,7,296700
19445,0.000942,172.31.36.0-255,66,101471,7,296700
19446,0.000945,74.125.24.0-255,1484,102955,7,296700
19447,0.000974,74.125.24.0-255,4320,107275,7,296700
19448,0.000977,172.31.36.0-255,66,107341,7,296700
19449,0.000983,74.125.24.0-255,4320,111661,7,296700
19450,0.000986,172.31.36.0-255,66,111727,7,296700
19451,0.001024,172.31.36.0-255,66,111793,7,296700
19452,0.001027,74.125.24.0-255,1484,113277,7,296700
19453,0.001032,74.125.24.0-255,2902,116179,7,296700
19454,0.001035,172.31.36.0-255,66,116245,7,296700
19455,0.001039,74.125.24.0-255,2902,119147,7,296700
19456,0.001042,172.31.36.0-255,66,119213,7,296700
19457,0.001067,74.125.24.0-255,2902,122115,7,296700
19458,0.00107,172.31.36.0-255,66,122181,7,296700
19459,0.001073,74.125.24.0-255,766,122947,7,296700
19460,0.001115,74.125.24.0-255,1484,124431,7,296700
19461,0.001118,172.31.36.0-255,66,124497,7,296700
19462,0.001137,74.125.24.0-255,4320,128817,7,296700
19463,0.001141,172.31.36.0-255,66,128883,7,296700
19464,0.001168,74.125.24.0-255,7156,136039,7,296700
19465,0.001172,172.31.36.0-255,66,136105,7,296700
19466,0.001176,74.125.24.0-255,2902,139007,7,296700
19467,0.001178,172.31.36.0-255,66,139073,7,296700
19468,0.001226,172.31.36.0-255,66,139139,7,296700
19469,0.001262,172.31.36.0-255,66,139205,7,296700
19470,0.001324,172.31.36.0-255,66,139271,7,296700
19471,0.001327,172.31.36.0-255,66,139337,7,296700
19472,0.001344,74.125.24.0-255,2184,141521,7,296700
19473,0.001348,172.31.36.0-255,66,141587,7,296700
19474,0.003319,74.125.24.0-255,4320,145907,7,296700
19475,0.003326,172.31.36.0-255,66,145973,7,296700
19476,0.003359,74.125.24.0-255,1484,147457,7,296700
19477,0.005277,74.125.24.0-255,4320,151777,7,296700
19478,0.005285,172.31.36.0-255,66,151843,7,296700
19479,0.007249,74.125.24.0-255,5738,157581,7,296700
19480,0.007256,172.31.36.0-255,66,157647,7,296700
19481,0.009227,74.125.24.0-255,5738,163385,7,296700
19482,0.00923,172.31.36.0-255,66,163451,7,296700
19483,0.011201,74.125.24.0-255,5738,169189,7,296700
19484,0.011209,172.31.36.0-255,66,169255,7,296700
19485,0.013176,74.125.24.0-255,5738,174993,7,296700
19486,0.013185,172.31.36.0-255,66,175059,7,296700
19487,0.015174,74.125.24.0-255,5738,180797,7,296700
19488,0.015183,172.31.36.0-255,66,180863,7,296700
19489,0.017165,74.125.24.0-255,5738,186601,7,296700
19490,0.017172,172.31.36.0-255,66,186667,7,296700
19491,0.019138,74.125.24.0-255,5738,192405,7,296700
19492,0.019144,172.31.36.0-255,66,192471,7,296700
19493,0.021114,74.125.24.0-255,5738,198209,7,296700
19494,0.021122,172.31.36.0-255,66,198275,7,296700
19495,0.023124,74.125.24.0-255,5738,204013,7,296700
19496,0.023132,172.31.36.0-255,66,204079,7,296700
19497,0.025107,74.125.24.0-255,5738,209817,7,296700
19498,0.025115,172.31.36.0-255,66,209883,7,296700
19499,0.027116,74.125.24.0-255,5738,215621,7,296700
19500,0.027123,172.31.36.0-255,66,215687,7,296700
19501,0.028408,172.31.36.0-255,164,215851,7,296700
19502,0.028442,172.31.36.0-255,1121,216972,7,296700
19503,0.028496,172.31.36.0-255,1514,218486,7,296700
19504,0.028498,172.31.36.0-255,1285,219771,7,296700
19505,0.029115,74.125.24.0-255,5738,225509,7,296700
19506,0.029121,172.31.36.0-255,66,225575,7,296700
19507,0.029953,104.244.42.0-255,66,225641,7,296700
19508,0.029994,104.244.42.0-255,66,225707,7,296700
19509,0.030044,104.244.42.0-255,66,225773,7,296700
19510,0.031087,74.125.24.0-255,5738,231511,7,296700
19511,0.031093,172.31.36.0-255,66,231577,7,296700
19512,0.033087,74.125.24.0-255,5738,237315,7,296700
19513,0.033094,172.31.36.0-255,66,237381,7,296700
19514,0.035076,74.125.24.0-255,5738,243119,7,296700
19515,0.035087,172.31.36.0-255,66,243185,7,296700
19516,0.037063,74.125.24.0-255,5738,248923,7,296700
19517,0.03707,172.31.36.0-255,66,248989,7,296700
19518,0.039044,74.125.24.0-255,5738,254727,7,296700
19519,0.039052,172.31.36.0-255,66,254793,7,296700
19520,0.04101,74.125.24.0-255,5738,260531,7,296700
19521,0.041016,172.31.36.0-255,66,260597,7,296700
19522,0.04299,74.125.24.0-255,5738,266335,7,296700
19523,0.042998,172.31.36.0-255,66,266401,7,296700
19524,0.045001,74.125.24.0-255,5738,272139,7,296700
19525,0.045007,172.31.36.0-255,66,272205,7,296700
19526,0.046982,74.125.24.0-255,5738,277943,7,296700
19527,0.046987,172.31.36.0-255,66,278009,7,296700
19528,0.048954,74.125.24.0-255,5738,283747,7,296700
19529,0.048962,172.31.36.0-255,66,283813,7,296700
19530,0.050922,74.125.24.0-255,5738,289551,7,296700
19531,0.05093,172.31.36.0-255,66,289617,7,296700
19532,0.052902,74.125.24.0-255,5738,295355,7,296700
19533,0.052909,172.31.36.0-255,66,295421,7,296700
19534,0.054887,74.125.24.0-255,1042,296463,7,296700
19535,0.054998,172.31.36.0-255,66,296529,7,296700
19536,0.055033,172.31.36.0-255,105,296634,7,296700
19537,0.056958,74.125.24.0-255,66,296700,7,296700
19538,0.0,172.217.194.0-255,157,157,7,233642
19539,2.6e-05,172.31.36.0-255,66,223,7,233642
19540,5.7e-05,172.217.194.0-255,1484,1707,7,233642
19541,6.2e-05,172.31.36.0-255,66,1773,7,233642
19542,6.7e-05,172.217.194.0-255,2902,4675,7,233642
19543,7e-05,172.31.36.0-255,66,4741,7,233642
19544,8.4e-05,172.217.194.0-255,7156,11897,7,233642
19545,8.7e-05,172.31.36.0-255,66,11963,7,233642
19546,9.4e-05,172.217.194.0-255,4830,16793,7,233642
19547,9.6e-05,172.31.36.0-255,66,16859,7,233642
19548,0.000102,172.217.194.0-255,5738,22597,7,233642
19549,0.000105,172.31.36.0-255,66,22663,7,233642
19550,0.000146,172.31.36.0-255,66,22729,7,233642
19551,0.000227,172.217.194.0-255,1484,24213,7,233642
19552,0.000231,172.31.36.0-255,66,24279,7,233642
19553,0.000236,172.217.194.0-255,2902,27181,7,233642
19554,0.000239,172.31.36.0-255,66,27247,7,233642
19555,0.000267,172.217.194.0-255,5738,32985,7,233642
19556,0.000272,172.31.36.0-255,66,33051,7,233642
19557,0.000305,172.217.194.0-255,6797,39848,7,233642
19558,0.000309,172.31.36.0-255,66,39914,7,233642
19559,0.002479,172.217.194.0-255,1484,41398,7,233642
19560,0.002485,172.31.36.0-255,66,41464,7,233642
19561,0.002511,172.217.194.0-255,2902,44366,7,233642
19562,0.002514,172.31.36.0-255,66,44432,7,233642
19563,0.002519,172.217.194.0-255,2902,47334,7,233642
19564,0.002521,172.31.36.0-255,66,47400,7,233642
19565,0.002528,172.217.194.0-255,5738,53138,7,233642
19566,0.002529,172.31.36.0-255,66,53204,7,233642
19567,0.002553,172.217.194.0-255,1484,54688,7,233642
19568,0.002556,172.31.36.0-255,66,54754,7,233642
19569,0.002566,172.217.194.0-255,2543,57297,7,233642
19570,0.002568,172.31.36.0-255,66,57363,7,233642
19571,0.002573,172.217.194.0-255,2902,60265,7,233642
19572,0.002575,172.31.36.0-255,66,60331,7,233642
19573,0.002611,172.217.194.0-255,7156,67487,7,233642
19574,0.002615,172.31.36.0-255,66,67553,7,233642
19575,0.002622,172.217.194.0-255,6797,74350,7,233642
19576,0.002624,172.31.36.0-255,66,74416,7,233642
19577,0.002662,172.217.194.0-255,1484,75900,7,233642
19578,0.002668,172.217.194.0-255,2902,78802,7,233642
19579,0.002671,172.31.36.0-255,66,78868,7,233642
19580,0.002704,172.217.194.0-255,5738,84606,7,233642
19581,0.002707,172.31.36.0-255,66,84672,7,233642
19582,0.002715,172.217.194.0-255,6797,91469,7,233642
19583,0.002718,172.31.36.0-255,66,91535,7,233642
19584,0.002756,172.31.36.0-255,66,91601,7,233642
19585,0.002787,172.217.194.0-255,5738,97339,7,233642
19586,0.002791,172.31.36.0-255,66,97405,7,233642
19587,0.002796,172.217.194.0-255,2428,99833,7,233642
19588,0.0028,172.31.36.0-255,66,99899,7,233642
19589,0.002831,172.217.194.0-255,1484,101383,7,233642
19590,0.002883,172.31.36.0-255,66,101449,7,233642
19591,0.00301,172.217.194.0-255,1484,102933,7,233642
19592,0.003017,172.217.194.0-255,2902,105835,7,233642
19593,0.00302,172.31.36.0-255,66,105901,7,233642
19594,0.003043,172.217.194.0-255,5738,111639,7,233642
19595,0.003046,172.31.36.0-255,66,111705,7,233642
19596,0.003085,172.31.36.0-255,66,111771,7,233642
19597,0.003125,172.217.194.0-255,7156,118927,7,233642
19598,0.003128,172.31.36.0-255,66,118993,7,233642
19599,0.003163,172.31.36.0-255,66,119059,7,233642
19600,0.003167,172.217.194.0-255,1484,120543,7,233642
19601,0.003172,172.217.194.0-255,2902,123445,7,233642
19602,0.003174,172.31.36.0-255,66,123511,7,233642
19603,0.003201,172.217.194.0-255,5738,129249,7,233642
19604,0.003204,172.31.36.0-255,66,129315,7,233642
19605,0.003223,172.217.194.0-255,5738,135053,7,233642
19606,0.003232,172.31.36.0-255,66,135119,7,233642
19607,0.003261,172.217.194.0-255,7156,142275,7,233642
19608,0.003264,172.31.36.0-255,66,142341,7,233642
19609,0.003314,172.31.36.0-255,66,142407,7,233642
19610,0.003321,172.217.194.0-255,7156,149563,7,233642
19611,0.003323,172.31.36.0-255,66,149629,7,233642
19612,0.003359,172.217.194.0-255,4320,153949,7,233642
19613,0.003362,172.31.36.0-255,66,154015,7,233642
19614,0.00338,172.31.36.0-255,66,154081,7,233642
19615,0.00341,172.31.36.0-255,66,154147,7,233642
19616,0.003441,172.217.194.0-255,3602,157749,7,233642
19617,0.003444,172.31.36.0-255,66,157815,7,233642
19618,0.003464,172.31.36.0-255,66,157881,7,233642
19619,0.003476,172.31.36.0-255,66,157947,7,233642
19620,0.003488,172.31.36.0-255,66,158013,7,233642
19621,0.003502,172.31.36.0-255,66,158079,7,233642
19622,0.003558,172.217.194.0-255,1484,159563,7,233642
19623,0.003563,172.217.194.0-255,2902,162465,7,233642
19624,0.003566,172.31.36.0-255,66,162531,7,233642
19625,0.003573,172.217.194.0-255,5738,168269,7,233642
19626,0.003575,172.31.36.0-255,66,168335,7,233642
19627,0.003578,172.217.194.0-255,1484,169819,7,233642
19628,0.00361,172.217.194.0-255,2902,172721,7,233642
19629,0.003614,172.31.36.0-255,66,172787,7,233642
19630,0.003632,172.31.36.0-255,66,172853,7,233642
19631,0.003635,172.217.194.0-255,1484,174337,7,233642
19632,0.003665,172.217.194.0-255,6438,180775,7,233642
19633,0.003669,172.31.36.0-255,66,180841,7,233642
19634,0.003756,172.217.194.0-255,1484,182325,7,233642
19635,0.003774,172.217.194.0-255,2902,185227,7,233642
19636,0.003777,172.31.36.0-255,66,185293,7,233642
19637,0.003783,172.217.194.0-255,4320,189613,7,233642
19638,0.003786,172.31.36.0-255,66,189679,7,233642
19639,0.003808,172.217.194.0-255,1484,191163,7,233642
19640,0.003813,172.217.194.0-255,2902,194065,7,233642
19641,0.003816,172.31.36.0-255,66,194131,7,233642
19642,0.003821,172.217.194.0-255,4320,198451,7,233642
19643,0.003825,172.31.36.0-255,66,198517,7,233642
19644,0.003829,172.217.194.0-255,2902,201419,7,233642
19645,0.003833,172.31.36.0-255,66,201485,7,233642
19646,0.003869,172.217.194.0-255,5738,207223,7,233642
19647,0.003878,172.31.36.0-255,66,207289,7,233642
19648,0.003889,172.31.36.0-255,66,207355,7,233642
19649,0.004364,172.217.194.0-255,1484,208839,7,233642
19650,0.004371,172.217.194.0-255,2902,211741,7,233642
19651,0.004374,172.31.36.0-255,66,211807,7,233642
19652,0.004405,172.217.194.0-255,5738,217545,7,233642
19653,0.004409,172.31.36.0-255,66,217611,7,233642
19654,0.004415,172.217.194.0-255,7156,224767,7,233642
19655,0.004417,172.31.36.0-255,66,224833,7,233642
19656,0.004454,172.31.36.0-255,66,224899,7,233642
19657,0.004485,172.217.194.0-255,1484,226383,7,233642
19658,0.004501,172.31.36.0-255,66,226449,7,233642
19659,0.004506,172.217.194.0-255,2480,228929,7,233642
19660,0.004508,172.31.36.0-255,66,228995,7,233642
19661,0.004537,172.217.194.0-255,105,229100,7,233642
19662,0.005493,172.31.36.0-255,66,229166,7,233642
19663,0.00552,172.31.36.0-255,105,229271,7,233642
19664,0.007541,172.217.194.0-255,66,229337,7,233642
19665,0.027272,172.31.36.0-255,187,229524,7,233642
19666,0.027305,172.31.36.0-255,982,230506,7,233642
19667,0.027356,172.31.36.0-255,1514,232020,7,233642
19668,0.027358,172.31.36.0-255,1424,233444,7,233642
19669,0.028831,104.244.42.0-255,66,233510,7,233642
19670,0.028861,104.244.42.0-255,66,233576,7,233642
19671,0.02891,104.244.42.0-255,66,233642,7,233642
19672,0.0,31.13.82.0-255,105,105,7,171
19673,1.9e-05,172.31.36.0-255,66,171,7,171
19674,0.0,172.217.194.0-255,153,153,7,223707
19675,3.8e-05,172.31.36.0-255,66,219,7,223707
19676,4.6e-05,172.217.194.0-255,1484,1703,7,223707
19677,5e-05,172.31.36.0-255,66,1769,7,223707
19678,5.6e-05,172.217.194.0-255,2902,4671,7,223707
19679,5.8e-05,172.31.36.0-255,66,4737,7,223707
19680,6.5e-05,172.217.194.0-255,7156,11893,7,223707
19681,6.8e-05,172.31.36.0-255,66,11959,7,223707
19682,8.4e-05,172.31.36.0-255,66,12025,7,223707
19683,8.8e-05,172.217.194.0-255,2543,14568,7,223707
19684,9e-05,172.31.36.0-255,66,14634,7,223707
19685,0.000112,172.217.194.0-255,1484,16118,7,223707
19686,0.000114,172.31.36.0-255,66,16184,7,223707
19687,0.000137,172.217.194.0-255,2902,19086,7,223707
19688,0.000139,172.31.36.0-255,66,19152,7,223707
19689,0.000145,172.217.194.0-255,5738,24890,7,223707
19690,0.000148,172.31.36.0-255,66,24956,7,223707
19691,0.000169,172.217.194.0-255,4320,29276,7,223707
19692,0.000172,172.31.36.0-255,66,29342,7,223707
19693,0.000189,172.217.194.0-255,2543,31885,7,223707
19694,0.000194,172.31.36.0-255,66,31951,7,223707
19695,0.000331,172.217.194.0-255,1484,33435,7,223707
19696,0.000336,172.31.36.0-255,66,33501,7,223707
19697,0.000343,172.217.194.0-255,2902,36403,7,223707
19698,0.000345,172.31.36.0-255,66,36469,7,223707
19699,0.000351,172.217.194.0-255,5738,42207,7,223707
19700,0.000354,172.31.36.0-255,66,42273,7,223707
19701,0.000402,172.31.36.0-255,66,42339,7,223707
19702,0.000422,172.217.194.0-255,4320,46659,7,223707
19703,0.000425,172.31.36.0-255,66,46725,7,223707
19704,0.000442,172.217.194.0-255,4320,51045,7,223707
19705,0.000448,172.31.36.0-255,66,51111,7,223707
19706,0.000479,172.217.194.0-255,4320,55431,7,223707
19707,0.000481,172.31.36.0-255,66,55497,7,223707
19708,0.000512,172.217.194.0-255,3961,59458,7,223707
19709,0.000515,172.31.36.0-255,66,59524,7,223707
19710,0.000526,172.31.36.0-255,66,59590,7,223707
19711,0.000538,172.31.36.0-255,66,59656,7,223707
19712,0.001105,172.217.194.0-255,1484,61140,7,223707
19713,0.001113,172.217.194.0-255,2902,64042,7,223707
19714,0.001116,172.31.36.0-255,66,64108,7,223707
19715,0.001135,172.217.194.0-255,4320,68428,7,223707
19716,0.001138,172.31.36.0-255,66,68494,7,223707
19717,0.001171,172.31.36.0-255,66,68560,7,223707
19718,0.001205,172.31.36.0-255,66,68626,7,223707
19719,0.001222,172.217.194.0-255,766,69392,7,223707
19720,0.001237,172.217.194.0-255,1484,70876,7,223707
19721,0.001241,172.31.36.0-255,66,70942,7,223707
19722,0.001254,172.217.194.0-255,4320,75262,7,223707
19723,0.001257,172.31.36.0-255,66,75328,7,223707
19724,0.001294,172.31.36.0-255,66,75394,7,223707
19725,0.0013,172.217.194.0-255,5738,81132,7,223707
19726,0.001302,172.31.36.0-255,66,81198,7,223707
19727,0.001357,172.217.194.0-255,2902,84100,7,223707
19728,0.001361,172.31.36.0-255,66,84166,7,223707
19729,0.001397,172.31.36.0-255,66,84232,7,223707
19730,0.001466,172.217.194.0-255,1484,85716,7,223707
19731,0.001481,172.217.194.0-255,2902,88618,7,223707
19732,0.001484,172.31.36.0-255,66,88684,7,223707
19733,0.001502,172.217.194.0-255,5738,94422,7,223707
19734,0.001505,172.31.36.0-255,66,94488,7,223707
19735,0.00153,172.217.194.0-255,2902,97390,7,223707
19736,0.001532,172.31.36.0-255,66,97456,7,223707
19737,0.001562,172.31.36.0-255,66,97522,7,223707
19738,0.00157,172.217.194.0-255,7156,104678,7,223707
19739,0.001572,172.31.36.0-255,66,104744,7,223707
19740,0.001596,172.217.194.0-255,3602,108346,7,223707
19741,0.001598,172.31.36.0-255,66,108412,7,223707
19742,0.001657,172.217.194.0-255,1484,109896,7,223707
19743,0.00166,172.217.194.0-255,1484,111380,7,223707
19744,0.001664,172.31.36.0-255,66,111446,7,223707
19745,0.001686,172.217.194.0-255,1484,112930,7,223707
19746,0.001693,172.217.194.0-255,5738,118668,7,223707
19747,0.001695,172.31.36.0-255,66,118734,7,223707
19748,0.001706,172.31.36.0-255,66,118800,7,223707
19749,0.001746,172.217.194.0-255,4320,123120,7,223707
19750,0.001749,172.31.36.0-255,66,123186,7,223707
19751,0.00178,172.31.36.0-255,66,123252,7,223707
19752,0.001795,172.31.36.0-255,66,123318,7,223707
19753,0.001852,172.31.36.0-255,66,123384,7,223707
19754,0.001872,172.217.194.0-255,2902,126286,7,223707
19755,0.001875,172.31.36.0-255,66,126352,7,223707
19756,0.001882,172.217.194.0-255,6438,132790,7,223707
19757,0.001884,172.31.36.0-255,66,132856,7,223707
19758,0.001899,172.217.194.0-255,1484,134340,7,223707
19759,0.001912,172.217.194.0-255,2902,137242,7,223707
19760,0.001914,172.31.36.0-255,66,137308,7,223707
19761,0.001937,172.217.194.0-255,5738,143046,7,223707
19762,0.00194,172.31.36.0-255,66,143112,7,223707
19763,0.001944,172.217.194.0-255,1484,144596,7,223707
19764,0.001971,172.31.36.0-255,66,144662,7,223707
19765,0.002001,172.217.194.0-255,7156,151818,7,223707
19766,0.002005,172.31.36.0-255,66,151884,7,223707
19767,0.002014,172.217.194.0-255,3602,155486,7,223707
19768,0.002017,172.31.36.0-255,66,155552,7,223707
19769,0.00214,172.217.194.0-255,1484,157036,7,223707
19770,0.002145,172.217.194.0-255,2902,159938,7,223707
19771,0.002147,172.31.36.0-255,66,160004,7,223707
19772,0.002151,172.217.194.0-255,1484,161488,7,223707
19773,0.002166,172.217.194.0-255,4320,165808,7,223707
19774,0.002168,172.31.36.0-255,66,165874,7,223707
19775,0.002197,172.31.36.0-255,66,165940,7,223707
19776,0.00222,172.217.194.0-255,4320,170260,7,223707
19777,0.002223,172.31.36.0-255,66,170326,7,223707
19778,0.002234,172.31.36.0-255,66,170392,7,223707
19779,0.002264,172.31.36.0-255,66,170458,7,223707
19780,0.002276,172.31.36.0-255,66,170524,7,223707
19781,0.00229,172.217.194.0-255,4320,174844,7,223707
19782,0.002293,172.31.36.0-255,66,174910,7,223707
19783,0.002328,172.31.36.0-255,66,174976,7,223707
19784,0.002353,172.217.194.0-255,5738,180714,7,223707
19785,0.002356,172.31.36.0-255,66,180780,7,223707
19786,0.002373,172.217.194.0-255,1484,182264,7,223707
19787,0.002377,172.217.194.0-255,1484,183748,7,223707
19788,0.002379,172.31.36.0-255,66,183814,7,223707
19789,0.004742,172.217.194.0-255,5738,189552,7,223707
19790,0.004757,172.31.36.0-255,66,189618,7,223707
19791,0.007063,172.217.194.0-255,5738,195356,7,223707
19792,0.007066,172.31.36.0-255,66,195422,7,223707
19793,0.009377,172.217.194.0-255,5738,201160,7,223707
19794,0.009384,172.31.36.0-255,66,201226,7,223707
19795,0.011777,172.217.194.0-255,5738,206964,7,223707
19796,0.011793,172.31.36.0-255,66,207030,7,223707
19797,0.014134,172.217.194.0-255,5738,212768,7,223707
19798,0.014149,172.31.36.0-255,66,212834,7,223707
19799,0.016496,172.217.194.0-255,5738,218572,7,223707
19800,0.016512,172.31.36.0-255,66,218638,7,223707
19801,0.018849,172.217.194.0-255,368,219006,7,223707
19802,0.019191,172.31.36.0-255,66,219072,7,223707
19803,0.019222,172.31.36.0-255,105,219177,7,223707
19804,0.021492,172.217.194.0-255,66,219243,7,223707
19805,0.037627,172.31.36.0-255,172,219415,7,223707
19806,0.037659,172.31.36.0-255,1115,220530,7,223707
19807,0.037698,172.31.36.0-255,1514,222044,7,223707
19808,0.0377,172.31.36.0-255,1291,223335,7,223707
19809,0.039186,104.244.42.0-255,66,223401,7,223707
19810,0.039197,104.244.42.0-255,66,223467,7,223707
19811,0.039259,104.244.42.0-255,66,223533,7,223707
19812,0.039879,104.244.42.0-255,108,223641,7,223707
19813,0.039885,172.31.36.0-255,66,223707,7,223707
19814,0.0,172.31.36.0-255,66,66,7,66
19815,0.0,74.125.24.0-255,298,298,7,316780
19816,2.4e-05,172.31.36.0-255,66,364,7,316780
19817,3.2e-05,74.125.24.0-255,1484,1848,7,316780
19818,3.6e-05,172.31.36.0-255,66,1914,7,316780
19819,4.3e-05,74.125.24.0-255,4320,6234,7,316780
19820,5.6e-05,172.31.36.0-255,66,6300,7,316780
19821,6.9e-05,172.31.36.0-255,66,6366,7,316780
19822,8.1e-05,172.31.36.0-255,66,6432,7,316780
19823,8.6e-05,74.125.24.0-255,2902,9334,7,316780
19824,8.9e-05,172.31.36.0-255,66,9400,7,316780
19825,0.000119,74.125.24.0-255,2543,11943,7,316780
19826,0.000122,172.31.36.0-255,66,12009,7,316780
19827,0.000153,74.125.24.0-255,1484,13493,7,316780
19828,0.000156,172.31.36.0-255,66,13559,7,316780
19829,0.000176,74.125.24.0-255,2902,16461,7,316780
19830,0.000179,172.31.36.0-255,66,16527,7,316780
19831,0.000185,74.125.24.0-255,5738,22265,7,316780
19832,0.000187,172.31.36.0-255,66,22331,7,316780
19833,0.000247,74.125.24.0-255,7156,29487,7,316780
19834,0.000251,172.31.36.0-255,66,29553,7,316780
19835,0.000256,74.125.24.0-255,4320,33873,7,316780
19836,0.000258,172.31.36.0-255,66,33939,7,316780
19837,0.000302,172.31.36.0-255,66,34005,7,316780
19838,0.000306,74.125.24.0-255,2184,36189,7,316780
19839,0.000309,172.31.36.0-255,66,36255,7,316780
19840,0.000311,74.125.24.0-255,420,36675,7,316780
19841,0.000313,172.31.36.0-255,66,36741,7,316780
19842,0.000316,74.125.24.0-255,1484,38225,7,316780
19843,0.000318,172.31.36.0-255,66,38291,7,316780
19844,0.000341,74.125.24.0-255,4320,42611,7,316780
19845,0.000344,172.31.36.0-255,66,42677,7,316780
19846,0.000347,74.125.24.0-255,1484,44161,7,316780
19847,0.000374,74.125.24.0-255,4320,48481,7,316780
19848,0.00038,172.31.36.0-255,66,48547,7,316780
19849,0.00041,74.125.24.0-255,5087,53634,7,316780
19850,0.000413,172.31.36.0-255,66,53700,7,316780
19851,0.000482,74.125.24.0-255,1484,55184,7,316780
19852,0.000499,74.125.24.0-255,2902,58086,7,316780
19853,0.000503,172.31.36.0-255,66,58152,7,316780
19854,0.000509,74.125.24.0-255,4320,62472,7,316780
19855,0.000512,172.31.36.0-255,66,62538,7,316780
19856,0.000543,74.125.24.0-255,1484,64022,7,316780
19857,0.000557,172.31.36.0-255,66,64088,7,316780
19858,0.000563,74.125.24.0-255,5738,69826,7,316780
19859,0.000566,172.31.36.0-255,66,69892,7,316780
19860,0.000592,74.125.24.0-255,5020,74912,7,316780
19861,0.000594,172.31.36.0-255,66,74978,7,316780
19862,0.001276,74.125.24.0-255,1484,76462,7,316780
19863,0.001283,74.125.24.0-255,2902,79364,7,316780
19864,0.001287,172.31.36.0-255,66,79430,7,316780
19865,0.001321,74.125.24.0-255,5738,85168,7,316780
19866,0.001324,172.31.36.0-255,66,85234,7,316780
19867,0.001332,74.125.24.0-255,7156,92390,7,316780
19868,0.001334,172.31.36.0-255,66,92456,7,316780
19869,0.001349,74.125.24.0-255,4320,96776,7,316780
19870,0.001356,172.31.36.0-255,66,96842,7,316780
19871,0.001387,74.125.24.0-255,4320,101162,7,316780
19872,0.001389,172.31.36.0-255,66,101228,7,316780
19873,0.001429,172.31.36.0-255,66,101294,7,316780
19874,0.002113,74.125.24.0-255,1484,102778,7,316780
19875,0.002118,74.125.24.0-255,2902,105680,7,316780
19876,0.002122,172.31.36.0-255,66,105746,7,316780
19877,0.002128,74.125.24.0-255,2902,108648,7,316780
19878,0.00213,172.31.36.0-255,66,108714,7,316780
19879,0.002164,74.125.24.0-255,2902,111616,7,316780
19880,0.002166,172.31.36.0-255,66,111682,7,316780
19881,0.00218,172.31.36.0-255,66,111748,7,316780
19882,0.00219,172.31.36.0-255,66,111814,7,316780
19883,0.002204,74.125.24.0-255,2184,113998,7,316780
19884,0.002206,172.31.36.0-255,66,114064,7,316780
19885,0.004437,74.125.24.0-255,2902,116966,7,316780
19886,0.004445,172.31.36.0-255,66,117032,7,316780
19887,0.004472,74.125.24.0-255,1484,118516,7,316780
19888,0.004487,74.125.24.0-255,1484,120000,7,316780
19889,0.00449,172.31.36.0-255,66,120066,7,316780
19890,0.006703,74.125.24.0-255,2902,122968,7,316780
19891,0.006711,172.31.36.0-255,66,123034,7,316780
19892,0.00674,74.125.24.0-255,2902,125936,7,316780
19893,0.006743,172.31.36.0-255,66,126002,7,316780
19894,0.008952,74.125.24.0-255,2902,128904,7,316780
19895,0.008958,172.31.36.0-255,66,128970,7,316780
19896,0.008983,74.125.24.0-255,2902,131872,7,316780
19897,0.008985,172.31.36.0-255,66,131938,7,316780
19898,0.011205,74.125.24.0-255,2902,134840,7,316780
19899,0.011213,172.31.36.0-255,66,134906,7,316780
19900,0.011247,74.125.24.0-255,2902,137808,7,316780
19901,0.01125,172.31.36.0-255,66,137874,7,316780
19902,0.013471,74.125.24.0-255,2902,140776,7,316780
19903,0.013481,172.31.36.0-255,66,140842,7,316780
19904,0.01351,74.125.24.0-255,1484,142326,7,316780
19905,0.013527,74.125.24.0-255,1484,143810,7,316780
19906,0.01353,172.31.36.0-255,66,143876,7,316780
19907,0.01572,74.125.24.0-255,2902,146778,7,316780
19908,0.015728,172.31.36.0-255,66,146844,7,316780
19909,0.01577,74.125.24.0-255,2902,149746,7,316780
19910,0.015774,172.31.36.0-255,66,149812,7,316780
19911,0.017974,74.125.24.0-255,2902,152714,7,316780
19912,0.017984,172.31.36.0-255,66,152780,7,316780
19913,0.018072,74.125.24.0-255,2902,155682,7,316780
19914,0.018075,172.31.36.0-255,66,155748,7,316780
19915,0.020223,74.125.24.0-255,2902,158650,7,316780
19916,0.02023,172.31.36.0-255,66,158716,7,316780
19917,0.020341,74.125.24.0-255,2902,161618,7,316780
19918,0.020346,172.31.36.0-255,66,161684,7,316780
19919,0.022476,74.125.24.0-255,2902,164586,7,316780
19920,0.022483,172.31.36.0-255,66,164652,7,316780
19921,0.022583,74.125.24.0-255,1484,166136,7,316780
19922,0.022601,74.125.24.0-255,1484,167620,7,316780
19923,0.022604,172.31.36.0-255,66,167686,7,316780
19924,0.024735,74.125.24.0-255,2902,170588,7,316780
19925,0.024747,172.31.36.0-255,66,170654,7,316780
19926,0.02485,74.125.24.0-255,2902,173556,7,316780
19927,0.024855,172.31.36.0-255,66,173622,7,316780
19928,0.027007,74.125.24.0-255,2902,176524,7,316780
19929,0.027017,172.31.36.0-255,66,176590,7,316780
19930,0.027098,74.125.24.0-255,2902,179492,7,316780
19931,0.027102,172.31.36.0-255,66,179558,7,316780
19932,0.029289,74.125.24.0-255,2902,182460,7,316780
19933,0.029297,172.31.36.0-255,66,182526,7,316780
19934,0.02934,74.125.24.0-255,2902,185428,7,316780
19935,0.029343,172.31.36.0-255,66,185494,7,316780
19936,0.031546,74.125.24.0-255,2902,188396,7,316780
19937,0.031553,172.31.36.0-255,66,188462,7,316780
19938,0.031594,74.125.24.0-255,2902,191364,7,316780
19939,0.031597,172.31.36.0-255,66,191430,7,316780
19940,0.033036,172.31.36.0-255,171,191601,7,316780
19941,0.033068,172.31.36.0-255,1138,192739,7,316780
19942,0.033129,172.31.36.0-255,1514,194253,7,316780
19943,0.033131,172.31.36.0-255,1269,195522,7,316780
19944,0.033824,74.125.24.0-255,2902,198424,7,316780
19945,0.03383,172.31.36.0-255,66,198490,7,316780
19946,0.033871,74.125.24.0-255,2902,201392,7,316780
19947,0.033874,172.31.36.0-255,66,201458,7,316780
19948,0.034582,104.244.42.0-255,66,201524,7,316780
19949,0.034621,104.244.42.0-255,66,201590,7,316780
19950,0.03467,104.244.42.0-255,66,201656,7,316780
19951,0.036079,74.125.24.0-255,2902,204558,7,316780
19952,0.036085,172.31.36.0-255,66,204624,7,316780
19953,0.036143,74.125.24.0-255,2902,207526,7,316780
19954,0.036147,172.31.36.0-255,66,207592,7,316780
19955,0.038357,74.125.24.0-255,2902,210494,7,316780
19956,0.038364,172.31.36.0-255,66,210560,7,316780
19957,0.038392,74.125.24.0-255,2902,213462,7,316780
19958,0.038395,172.31.36.0-255,66,213528,7,316780
19959,0.040616,74.125.24.0-255,2902,216430,7,316780
19960,0.040623,172.31.36.0-255,66,216496,7,316780
19961,0.040654,74.125.24.0-255,2902,219398,7,316780
19962,0.040657,172.31.36.0-255,66,219464,7,316780
19963,0.042898,74.125.24.0-255,4320,223784,7,316780
19964,0.042905,172.31.36.0-255,66,223850,7,316780
19965,0.042931,74.125.24.0-255,1484,225334,7,316780
19966,0.045157,74.125.24.0-255,4320,229654,7,316780
19967,0.045163,172.31.36.0-255,66,229720,7,316780
19968,0.047422,74.125.24.0-255,5738,235458,7,316780
19969,0.047428,172.31.36.0-255,66,235524,7,316780
19970,0.049692,74.125.24.0-255,5738,241262,7,316780
19971,0.0497,172.31.36.0-255,66,241328,7,316780
19972,0.05196,74.125.24.0-255,5738,247066,7,316780
19973,0.051967,172.31.36.0-255,66,247132,7,316780
19974,0.054225,74.125.24.0-255,5738,252870,7,316780
19975,0.054233,172.31.36.0-255,66,252936,7,316780
19976,0.056537,74.125.24.0-255,5738,258674,7,316780
19977,0.056546,172.31.36.0-255,66,258740,7,316780
19978,0.058796,74.125.24.0-255,5738,264478,7,316780
19979,0.058803,172.31.36.0-255,66,264544,7,316780
19980,0.061056,74.125.24.0-255,5738,270282,7,316780
19981,0.061063,172.31.36.0-255,66,270348,7,316780
19982,0.063384,74.125.24.0-255,5738,276086,7,316780
19983,0.063392,172.31.36.0-255,66,276152,7,316780
19984,0.065666,74.125.24.0-255,5738,281890,7,316780
19985,0.065673,172.31.36.0-255,66,281956,7,316780
19986,0.067945,74.125.24.0-255,5738,287694,7,316780
19987,0.067952,172.31.36.0-255,66,287760,7,316780
19988,0.070188,74.125.24.0-255,5738,293498,7,316780
19989,0.070195,172.31.36.0-255,66,293564,7,316780
19990,0.072489,74.125.24.0-255,5738,299302,7,316780
19991,0.072496,172.31.36.0-255,66,299368,7,316780
19992,0.074788,74.125.24.0-255,5738,305106,7,316780
19993,0.074795,172.31.36.0-255,66,305172,7,316780
19994,0.077057,74.125.24.0-255,5738,310910,7,316780
19995,0.077064,172.31.36.0-255,66,310976,7,316780
19996,0.079327,74.125.24.0-255,5738,316714,7,316780
19997,0.079347,172.31.36.0-255,66,316780,7,316780
19998,0.0,172.217.194.0-255,66,66,7,66
19999,0.0,172.217.194.0-255,153,153,7,287261
20000,3e-05,172.31.36.0-255,66,219,7,287261
20001,3.7e-05,172.217.194.0-255,1484,1703,7,287261
20002,4.2e-05,172.31.36.0-255,66,1769,7,287261
20003,4.8e-05,172.217.194.0-255,2902,4671,7,287261
20004,5.1e-05,172.31.36.0-255,66,4737,7,287261
20005,5.8e-05,172.217.194.0-255,7156,11893,7,287261
20006,6.1e-05,172.31.36.0-255,66,11959,7,287261
20007,0.000111,172.31.36.0-255,66,12025,7,287261
20008,0.00013,172.217.194.0-255,2046,14071,7,287261
20009,0.000133,172.31.36.0-255,66,14137,7,287261
20010,0.000137,172.217.194.0-255,2543,16680,7,287261
20011,0.000139,172.31.36.0-255,66,16746,7,287261
20012,0.000203,172.217.194.0-255,1484,18230,7,287261
20013,0.000207,172.31.36.0-255,66,18296,7,287261
20014,0.000212,172.217.194.0-255,2902,21198,7,287261
20015,0.000214,172.31.36.0-255,66,21264,7,287261
20016,0.000217,172.217.194.0-255,1484,22748,7,287261
20017,0.000219,172.31.36.0-255,66,22814,7,287261
20018,0.000235,172.217.194.0-255,4320,27134,7,287261
20019,0.000238,172.31.36.0-255,66,27200,7,287261
20020,0.000242,172.217.194.0-255,2902,30102,7,287261
20021,0.000244,172.31.36.0-255,66,30168,7,287261
20022,0.000268,172.217.194.0-255,3961,34129,7,287261
20023,0.000272,172.31.36.0-255,66,34195,7,287261
20024,0.000284,172.31.36.0-255,66,34261,7,287261
20025,0.000296,172.217.194.0-255,2902,37163,7,287261
20026,0.000299,172.31.36.0-255,66,37229,7,287261
20027,0.000317,172.217.194.0-255,2833,40062,7,287261
20028,0.000322,172.31.36.0-255,66,40128,7,287261
20029,0.000331,172.217.194.0-255,101,40229,7,287261
20030,0.000474,172.217.194.0-255,1484,41713,7,287261
20031,0.000478,172.31.36.0-255,66,41779,7,287261
20032,0.000485,172.217.194.0-255,2902,44681,7,287261
20033,0.000487,172.31.36.0-255,66,44747,7,287261
20034,0.000519,172.217.194.0-255,5738,50485,7,287261
20035,0.000523,172.31.36.0-255,66,50551,7,287261
20036,0.00053,172.217.194.0-255,6797,57348,7,287261
20037,0.000535,172.31.36.0-255,66,57414,7,287261
20038,0.000544,172.31.36.0-255,66,57480,7,287261
20039,0.000566,172.217.194.0-255,1484,58964,7,287261
20040,0.000595,172.217.194.0-255,2816,61780,7,287261
20041,0.000599,172.31.36.0-255,66,61846,7,287261
20042,0.000857,172.217.194.0-255,1484,63330,7,287261
20043,0.000863,172.217.194.0-255,2902,66232,7,287261
20044,0.000867,172.31.36.0-255,66,66298,7,287261
20045,0.000871,172.217.194.0-255,1484,67782,7,287261
20046,0.000889,172.217.194.0-255,4320,72102,7,287261
20047,0.000892,172.31.36.0-255,66,72168,7,287261
20048,0.000897,172.217.194.0-255,2902,75070,7,287261
20049,0.0009,172.31.36.0-255,66,75136,7,287261
20050,0.000922,172.31.36.0-255,66,75202,7,287261
20051,0.00093,172.217.194.0-255,7156,82358,7,287261
20052,0.000932,172.31.36.0-255,66,82424,7,287261
20053,0.000957,172.217.194.0-255,2902,85326,7,287261
20054,0.00096,172.31.36.0-255,66,85392,7,287261
20055,0.000962,172.217.194.0-255,766,86158,7,287261
20056,0.000995,172.217.194.0-255,1484,87642,7,287261
20057,0.000998,172.31.36.0-255,66,87708,7,287261
20058,0.001019,172.217.194.0-255,4320,92028,7,287261
20059,0.001022,172.31.36.0-255,66,92094,7,287261
20060,0.00103,172.217.194.0-255,7156,99250,7,287261
20061,0.001032,172.31.36.0-255,66,99316,7,287261
20062,0.001058,172.217.194.0-255,5738,105054,7,287261
20063,0.001062,172.31.36.0-255,66,105120,7,287261
20064,0.001096,172.31.36.0-255,66,105186,7,287261
20065,0.001102,172.217.194.0-255,5020,110206,7,287261
20066,0.001105,172.31.36.0-255,66,110272,7,287261
20067,0.00112,172.217.194.0-255,5738,116010,7,287261
20068,0.001122,172.31.36.0-255,66,116076,7,287261
20069,0.001125,172.217.194.0-255,1484,117560,7,287261
20070,0.001144,172.217.194.0-255,5738,123298,7,287261
20071,0.001147,172.31.36.0-255,66,123364,7,287261
20072,0.001187,172.217.194.0-255,4320,127684,7,287261
20073,0.001192,172.31.36.0-255,66,127750,7,287261
20074,0.001222,172.31.36.0-255,66,127816,7,287261
20075,0.001229,172.217.194.0-255,6438,134254,7,287261
20076,0.001231,172.31.36.0-255,66,134320,7,287261
20077,0.001788,172.217.194.0-255,1484,135804,7,287261
20078,0.001809,172.217.194.0-255,2902,138706,7,287261
20079,0.001813,172.31.36.0-255,66,138772,7,287261
20080,0.001819,172.217.194.0-255,5738,144510,7,287261
20081,0.001822,172.31.36.0-255,66,144576,7,287261
20082,0.001859,172.31.36.0-255,66,144642,7,287261
20083,0.001889,172.217.194.0-255,7156,151798,7,287261
20084,0.001892,172.31.36.0-255,66,151864,7,287261
20085,0.001915,172.217.194.0-255,5020,156884,7,287261
20086,0.001918,172.31.36.0-255,66,156950,7,287261
20087,0.002001,172.217.194.0-255,1484,158434,7,287261
20088,0.002006,172.217.194.0-255,2902,161336,7,287261
20089,0.00201,172.31.36.0-255,66,161402,7,287261
20090,0.002018,172.217.194.0-255,2902,164304,7,287261
20091,0.002021,172.31.36.0-255,66,164370,7,287261
20092,0.002033,172.217.194.0-255,2902,167272,7,287261
20093,0.002037,172.217.194.0-255,2902,170174,7,287261
20094,0.002037,172.31.36.0-255,66,170240,7,287261
20095,0.002041,172.31.36.0-255,66,170306,7,287261
20096,0.002079,172.217.194.0-255,4320,174626,7,287261
20097,0.002083,172.31.36.0-255,66,174692,7,287261
20098,0.002102,172.217.194.0-255,5738,180430,7,287261
20099,0.002104,172.31.36.0-255,66,180496,7,287261
20100,0.002116,172.31.36.0-255,66,180562,7,287261
20101,0.002232,172.217.194.0-255,1484,182046,7,287261
20102,0.002238,172.217.194.0-255,2902,184948,7,287261
20103,0.002241,172.31.36.0-255,66,185014,7,287261
20104,0.002246,172.217.194.0-255,2902,187916,7,287261
20105,0.002248,172.31.36.0-255,66,187982,7,287261
20106,0.002268,172.217.194.0-255,2902,190884,7,287261
20107,0.002271,172.31.36.0-255,66,190950,7,287261
20108,0.002277,172.217.194.0-255,5738,196688,7,287261
20109,0.00228,172.31.36.0-255,66,196754,7,287261
20110,0.002308,172.217.194.0-255,7156,203910,7,287261
20111,0.002311,172.31.36.0-255,66,203976,7,287261
20112,0.002323,172.31.36.0-255,66,204042,7,287261
20113,0.002368,172.31.36.0-255,66,204108,7,287261
20114,0.00239,172.217.194.0-255,5738,209846,7,287261
20115,0.002392,172.31.36.0-255,66,209912,7,287261
20116,0.002403,172.31.36.0-255,66,209978,7,287261
20117,0.002417,172.31.36.0-255,66,210044,7,287261
20118,0.004765,172.217.194.0-255,5738,215782,7,287261
20119,0.004775,172.31.36.0-255,66,215848,7,287261
20120,0.007103,172.217.194.0-255,5738,221586,7,287261
20121,0.007109,172.31.36.0-255,66,221652,7,287261
20122,0.009463,172.217.194.0-255,5738,227390,7,287261
20123,0.009469,172.31.36.0-255,66,227456,7,287261
20124,0.011846,172.217.194.0-255,5738,233194,7,287261
20125,0.011854,172.31.36.0-255,66,233260,7,287261
20126,0.014216,172.217.194.0-255,5738,238998,7,287261
20127,0.014227,172.31.36.0-255,66,239064,7,287261
20128,0.016555,172.217.194.0-255,5738,244802,7,287261
20129,0.016562,172.31.36.0-255,66,244868,7,287261
20130,0.018905,172.217.194.0-255,5738,250606,7,287261
20131,0.018913,172.31.36.0-255,66,250672,7,287261
20132,0.021228,172.217.194.0-255,5738,256410,7,287261
20133,0.021235,172.31.36.0-255,66,256476,7,287261
20134,0.023548,172.217.194.0-255,5738,262214,7,287261
20135,0.023554,172.31.36.0-255,66,262280,7,287261
20136,0.025915,172.217.194.0-255,5738,268018,7,287261
20137,0.025923,172.31.36.0-255,66,268084,7,287261
20138,0.027928,172.31.36.0-255,172,268256,7,287261
20139,0.027958,172.31.36.0-255,1114,269370,7,287261
20140,0.027996,172.31.36.0-255,1514,270884,7,287261
20141,0.027998,172.31.36.0-255,1294,272178,7,287261
20142,0.028255,172.217.194.0-255,5738,277916,7,287261
20143,0.028262,172.31.36.0-255,66,277982,7,287261
20144,0.029439,104.244.42.0-255,66,278048,7,287261
20145,0.02951,104.244.42.0-255,66,278114,7,287261
20146,0.029515,104.244.42.0-255,66,278180,7,287261
20147,0.030572,172.217.194.0-255,5738,283918,7,287261
20148,0.030577,172.31.36.0-255,66,283984,7,287261
20149,0.032924,172.217.194.0-255,3040,287024,7,287261
20150,0.03293,172.31.36.0-255,66,287090,7,287261
20151,0.033126,172.31.36.0-255,105,287195,7,287261
20152,0.035417,172.217.194.0-255,66,287261,7,287261
20153,0.0,74.125.68.0-255,152,152,7,302446
20154,2.7e-05,172.31.36.0-255,66,218,7,302446
20155,3.3e-05,74.125.68.0-255,1484,1702,7,302446
20156,3.8e-05,172.31.36.0-255,66,1768,7,302446
20157,4.2e-05,74.125.68.0-255,2902,4670,7,302446
20158,4.5e-05,172.31.36.0-255,66,4736,7,302446
20159,6.3e-05,74.125.68.0-255,1484,6220,7,302446
20160,6.5e-05,172.31.36.0-255,66,6286,7,302446
20161,9.1e-05,74.125.68.0-255,5738,12024,7,302446
20162,9.4e-05,172.31.36.0-255,66,12090,7,302446
20163,9.7e-05,74.125.68.0-255,1484,13574,7,302446
20164,9.8e-05,172.31.36.0-255,66,13640,7,302446
20165,0.000101,74.125.68.0-255,549,14189,7,302446
20166,0.000103,172.31.36.0-255,66,14255,7,302446
20167,0.00075,74.125.68.0-255,1484,15739,7,302446
20168,0.000756,172.31.36.0-255,66,15805,7,302446
20169,0.000767,74.125.68.0-255,2902,18707,7,302446
20170,0.000769,172.31.36.0-255,66,18773,7,302446
20171,0.000799,74.125.68.0-255,5738,24511,7,302446
20172,0.000802,172.31.36.0-255,66,24577,7,302446
20173,0.000807,74.125.68.0-255,2902,27479,7,302446
20174,0.000809,172.31.36.0-255,66,27545,7,302446
20175,0.000815,74.125.68.0-255,3961,31506,7,302446
20176,0.000818,172.31.36.0-255,66,31572,7,302446
20177,0.00086,172.31.36.0-255,66,31638,7,302446
20178,0.000891,172.31.36.0-255,66,31704,7,302446
20179,0.000894,74.125.68.0-255,1484,33188,7,302446
20180,0.000896,172.31.36.0-255,66,33254,7,302446
20181,0.0009,74.125.68.0-255,2902,36156,7,302446
20182,0.000902,172.31.36.0-255,66,36222,7,302446
20183,0.000906,74.125.68.0-255,2902,39124,7,302446
20184,0.000908,172.31.36.0-255,66,39190,7,302446
20185,0.000933,74.125.68.0-255,2902,42092,7,302446
20186,0.000936,172.31.36.0-255,66,42158,7,302446
20187,0.000941,74.125.68.0-255,4320,46478,7,302446
20188,0.000943,172.31.36.0-255,66,46544,7,302446
20189,0.000982,74.125.68.0-255,766,47310,7,302446
20190,0.001024,74.125.68.0-255,443,47753,7,302446
20191,0.001181,74.125.68.0-255,1484,49237,7,302446
20192,0.001187,172.31.36.0-255,66,49303,7,302446
20193,0.001192,74.125.68.0-255,2902,52205,7,302446
20194,0.001194,172.31.36.0-255,66,52271,7,302446
20195,0.001222,74.125.68.0-255,5738,58009,7,302446
20196,0.001224,172.31.36.0-255,66,58075,7,302446
20197,0.001238,74.125.68.0-255,4320,62395,7,302446
20198,0.00124,172.31.36.0-255,66,62461,7,302446
20199,0.001276,172.31.36.0-255,66,62527,7,302446
20200,0.001282,74.125.68.0-255,5738,68265,7,302446
20201,0.001285,172.31.36.0-255,66,68331,7,302446
20202,0.001299,74.125.68.0-255,1484,69815,7,302446
20203,0.001318,74.125.68.0-255,3602,73417,7,302446
20204,0.001321,172.31.36.0-255,66,73483,7,302446
20205,0.001998,74.125.68.0-255,1484,74967,7,302446
20206,0.002006,74.125.68.0-255,2902,77869,7,302446
20207,0.00201,172.31.36.0-255,66,77935,7,302446
20208,0.002032,74.125.68.0-255,5738,83673,7,302446
20209,0.002034,172.31.36.0-255,66,83739,7,302446
20210,0.002077,172.31.36.0-255,66,83805,7,302446
20211,0.002119,74.125.68.0-255,2902,86707,7,302446
20212,0.002123,172.31.36.0-255,66,86773,7,302446
20213,0.002152,172.31.36.0-255,66,86839,7,302446
20214,0.002342,74.125.68.0-255,1484,88323,7,302446
20215,0.002346,74.125.68.0-255,1484,89807,7,302446
20216,0.002349,172.31.36.0-255,66,89873,7,302446
20217,0.002368,74.125.68.0-255,1484,91357,7,302446
20218,0.00237,74.125.68.0-255,1484,92841,7,302446
20219,0.002374,172.31.36.0-255,66,92907,7,302446
20220,0.002386,74.125.68.0-255,5738,98645,7,302446
20221,0.002388,172.31.36.0-255,66,98711,7,302446
20222,0.002421,74.125.68.0-255,2902,101613,7,302446
20223,0.002424,172.31.36.0-255,66,101679,7,302446
20224,0.002447,74.125.68.0-255,7156,108835,7,302446
20225,0.002451,172.31.36.0-255,66,108901,7,302446
20226,0.002459,74.125.68.0-255,2902,111803,7,302446
20227,0.002461,172.31.36.0-255,66,111869,7,302446
20228,0.00249,74.125.68.0-255,766,112635,7,302446
20229,0.002521,172.31.36.0-255,66,112701,7,302446
20230,0.002534,74.125.68.0-255,5738,118439,7,302446
20231,0.002536,172.31.36.0-255,66,118505,7,302446
20232,0.002554,74.125.68.0-255,1484,119989,7,302446
20233,0.002569,74.125.68.0-255,1484,121473,7,302446
20234,0.002572,172.31.36.0-255,66,121539,7,302446
20235,0.002594,74.125.68.0-255,5738,127277,7,302446
20236,0.002597,172.31.36.0-255,66,127343,7,302446
20237,0.002606,172.31.36.0-255,66,127409,7,302446
20238,0.00261,74.125.68.0-255,2902,130311,7,302446
20239,0.002611,172.31.36.0-255,66,130377,7,302446
20240,0.00284,172.31.36.0-255,101,130478,7,302446
20241,0.005179,74.125.68.0-255,5738,136216,7,302446
20242,0.005186,172.31.36.0-255,66,136282,7,302446
20243,0.00538,74.125.68.0-255,66,136348,7,302446
20244,0.007766,74.125.68.0-255,5738,142086,7,302446
20245,0.007774,172.31.36.0-255,66,142152,7,302446
20246,0.010368,74.125.68.0-255,5738,147890,7,302446
20247,0.010376,172.31.36.0-255,66,147956,7,302446
20248,0.012965,74.125.68.0-255,5738,153694,7,302446
20249,0.012974,172.31.36.0-255,66,153760,7,302446
20250,0.015565,74.125.68.0-255,5738,159498,7,302446
20251,0.015576,172.31.36.0-255,66,159564,7,302446
20252,0.018173,74.125.68.0-255,5738,165302,7,302446
20253,0.018182,172.31.36.0-255,66,165368,7,302446
20254,0.020767,74.125.68.0-255,5738,171106,7,302446
20255,0.020774,172.31.36.0-255,66,171172,7,302446
20256,0.020808,172.31.36.0-255,192,171364,7,302446
20257,0.020848,172.31.36.0-255,958,172322,7,302446
20258,0.020934,172.31.36.0-255,1514,173836,7,302446
20259,0.020936,172.31.36.0-255,1448,175284,7,302446
20260,0.022389,104.244.42.0-255,66,175350,7,302446
20261,0.022398,104.244.42.0-255,66,175416,7,302446
20262,0.022487,104.244.42.0-255,66,175482,7,302446
20263,0.023353,74.125.68.0-255,5738,181220,7,302446
20264,0.02336,172.31.36.0-255,66,181286,7,302446
20265,0.025958,74.125.68.0-255,5738,187024,7,302446
20266,0.025965,172.31.36.0-255,66,187090,7,302446
20267,0.028551,74.125.68.0-255,4320,191410,7,302446
20268,0.028556,172.31.36.0-255,66,191476,7,302446
20269,0.028587,74.125.68.0-255,1484,192960,7,302446
20270,0.03113,74.125.68.0-255,4320,197280,7,302446
20271,0.031136,172.31.36.0-255,66,197346,7,302446
20272,0.033719,74.125.68.0-255,4320,201666,7,302446
20273,0.033724,172.31.36.0-255,66,201732,7,302446
20274,0.033758,74.125.68.0-255,1484,203216,7,302446
20275,0.036314,74.125.68.0-255,4320,207536,7,302446
20276,0.03632,172.31.36.0-255,66,207602,7,302446
20277,0.038907,74.125.68.0-255,5738,213340,7,302446
20278,0.038912,172.31.36.0-255,66,213406,7,302446
20279,0.041485,74.125.68.0-255,2902,216308,7,302446
20280,0.041491,172.31.36.0-255,66,216374,7,302446
20281,0.041518,74.125.68.0-255,2902,219276,7,302446
20282,0.041522,172.31.36.0-255,66,219342,7,302446
20283,0.044058,74.125.68.0-255,2902,222244,7,302446
20284,0.044064,172.31.36.0-255,66,222310,7,302446
20285,0.044099,74.125.68.0-255,2902,225212,7,302446
20286,0.044103,172.31.36.0-255,66,225278,7,302446
20287,0.046648,74.125.68.0-255,2902,228180,7,302446
20288,0.046654,172.31.36.0-255,66,228246,7,302446
20289,0.046691,74.125.68.0-255,2902,231148,7,302446
20290,0.046694,172.31.36.0-255,66,231214,7,302446
20291,0.049233,74.125.68.0-255,2902,234116,7,302446
20292,0.049238,172.31.36.0-255,66,234182,7,302446
20293,0.049269,74.125.68.0-255,2902,237084,7,302446
20294,0.049272,172.31.36.0-255,66,237150,7,302446
20295,0.051817,74.125.68.0-255,2902,240052,7,302446
20296,0.051823,172.31.36.0-255,66,240118,7,302446
20297,0.051852,74.125.68.0-255,2902,243020,7,302446
20298,0.051856,172.31.36.0-255,66,243086,7,302446
20299,0.054395,74.125.68.0-255,2902,245988,7,302446
20300,0.054402,172.31.36.0-255,66,246054,7,302446
20301,0.05443,74.125.68.0-255,2902,248956,7,302446
20302,0.054433,172.31.36.0-255,66,249022,7,302446
20303,0.056978,74.125.68.0-255,2902,251924,7,302446
20304,0.056983,172.31.36.0-255,66,251990,7,302446
20305,0.057015,74.125.68.0-255,2902,254892,7,302446
20306,0.057018,172.31.36.0-255,66,254958,7,302446
20307,0.059557,74.125.68.0-255,2902,257860,7,302446
20308,0.059562,172.31.36.0-255,66,257926,7,302446
20309,0.059596,74.125.68.0-255,2902,260828,7,302446
20310,0.059599,172.31.36.0-255,66,260894,7,302446
20311,0.062139,74.125.68.0-255,2902,263796,7,302446
20312,0.062144,172.31.36.0-255,66,263862,7,302446
20313,0.062177,74.125.68.0-255,2902,266764,7,302446
20314,0.06218,172.31.36.0-255,66,266830,7,302446
20315,0.064728,74.125.68.0-255,2902,269732,7,302446
20316,0.064733,172.31.36.0-255,66,269798,7,302446
20317,0.064767,74.125.68.0-255,2902,272700,7,302446
20318,0.06477,172.31.36.0-255,66,272766,7,302446
20319,0.067313,74.125.68.0-255,2902,275668,7,302446
20320,0.067319,172.31.36.0-255,66,275734,7,302446
20321,0.067347,74.125.68.0-255,2902,278636,7,302446
20322,0.06735,172.31.36.0-255,66,278702,7,302446
20323,0.069903,74.125.68.0-255,2902,281604,7,302446
20324,0.069909,172.31.36.0-255,66,281670,7,302446
20325,0.069942,74.125.68.0-255,2902,284572,7,302446
20326,0.069945,172.31.36.0-255,66,284638,7,302446
20327,0.072476,74.125.68.0-255,2902,287540,7,302446
20328,0.072499,172.31.36.0-255,66,287606,7,302446
20329,0.072518,74.125.68.0-255,2902,290508,7,302446
20330,0.072522,172.31.36.0-255,66,290574,7,302446
20331,0.075083,74.125.68.0-255,2902,293476,7,302446
20332,0.075088,172.31.36.0-255,66,293542,7,302446
20333,0.075149,74.125.68.0-255,2902,296444,7,302446
20334,0.075153,172.31.36.0-255,66,296510,7,302446
20335,0.077671,74.125.68.0-255,2902,299412,7,302446
20336,0.077676,172.31.36.0-255,66,299478,7,302446
20337,0.077721,74.125.68.0-255,2902,302380,7,302446
20338,0.077724,172.31.36.0-255,66,302446,7,302446
20339,0.0,74.125.68.0-255,152,152,7,371881
20340,3.1e-05,172.31.36.0-255,66,218,7,371881
20341,3.8e-05,74.125.68.0-255,1484,1702,7,371881
20342,4.2e-05,172.31.36.0-255,66,1768,7,371881
20343,9.1e-05,74.125.68.0-255,1484,3252,7,371881
20344,9.5e-05,172.31.36.0-255,66,3318,7,371881
20345,0.000102,74.125.68.0-255,2902,6220,7,371881
20346,0.000104,172.31.36.0-255,66,6286,7,371881
20347,0.00014,74.125.68.0-255,5738,12024,7,371881
20348,0.000143,172.31.36.0-255,66,12090,7,371881
20349,0.000148,74.125.68.0-255,2075,14165,7,371881
20350,0.000151,172.31.36.0-255,66,14231,7,371881
20351,0.000203,74.125.68.0-255,1484,15715,7,371881
20352,0.000207,172.31.36.0-255,66,15781,7,371881
20353,0.000249,74.125.68.0-255,2902,18683,7,371881
20354,0.000252,172.31.36.0-255,66,18749,7,371881
20355,0.000297,74.125.68.0-255,1484,20233,7,371881
20356,0.000301,172.31.36.0-255,66,20299,7,371881
20357,0.000338,74.125.68.0-255,1484,21783,7,371881
20358,0.000342,172.31.36.0-255,66,21849,7,371881
20359,0.000368,74.125.68.0-255,1484,23333,7,371881
20360,0.000373,172.31.36.0-255,66,23399,7,371881
20361,0.000376,74.125.68.0-255,1484,24883,7,371881
20362,0.000378,172.31.36.0-255,66,24949,7,371881
20363,0.000389,74.125.68.0-255,2902,27851,7,371881
20364,0.000393,172.31.36.0-255,66,27917,7,371881
20365,0.00043,74.125.68.0-255,3961,31878,7,371881
20366,0.000434,172.31.36.0-255,66,31944,7,371881
20367,0.000528,74.125.68.0-255,1484,33428,7,371881
20368,0.000531,172.31.36.0-255,66,33494,7,371881
20369,0.000538,74.125.68.0-255,2902,36396,7,371881
20370,0.00054,172.31.36.0-255,66,36462,7,371881
20371,0.000572,74.125.68.0-255,5738,42200,7,371881
20372,0.000575,172.31.36.0-255,66,42266,7,371881
20373,0.00058,74.125.68.0-255,2902,45168,7,371881
20374,0.000583,172.31.36.0-255,66,45234,7,371881
20375,0.000604,74.125.68.0-255,4320,49554,7,371881
20376,0.000607,172.31.36.0-255,66,49620,7,371881
20377,0.000619,74.125.68.0-255,5738,55358,7,371881
20378,0.000622,172.31.36.0-255,66,55424,7,371881
20379,0.000628,74.125.68.0-255,4320,59744,7,371881
20380,0.000631,172.31.36.0-255,66,59810,7,371881
20381,0.000659,74.125.68.0-255,2902,62712,7,371881
20382,0.000664,172.31.36.0-255,66,62778,7,371881
20383,0.000669,74.125.68.0-255,3602,66380,7,371881
20384,0.000671,172.31.36.0-255,66,66446,7,371881
20385,0.000697,74.125.68.0-255,363,66809,7,371881
20386,0.000731,74.125.68.0-255,125,66934,7,371881
20387,0.00082,74.125.68.0-255,1484,68418,7,371881
20388,0.000824,172.31.36.0-255,66,68484,7,371881
20389,0.000852,74.125.68.0-255,2902,71386,7,371881
20390,0.000856,172.31.36.0-255,66,71452,7,371881
20391,0.000885,74.125.68.0-255,5738,77190,7,371881
20392,0.000889,172.31.36.0-255,66,77256,7,371881
20393,0.000922,74.125.68.0-255,7156,84412,7,371881
20394,0.000925,172.31.36.0-255,66,84478,7,371881
20395,0.000952,74.125.68.0-255,2902,87380,7,371881
20396,0.000955,172.31.36.0-255,66,87446,7,371881
20397,0.00097,172.31.36.0-255,66,87512,7,371881
20398,0.001007,74.125.68.0-255,3888,91400,7,371881
20399,0.001011,172.31.36.0-255,66,91466,7,371881
20400,0.001378,74.125.68.0-255,1484,92950,7,371881
20401,0.001387,74.125.68.0-255,2902,95852,7,371881
20402,0.001391,172.31.36.0-255,66,95918,7,371881
20403,0.001396,74.125.68.0-255,1484,97402,7,371881
20404,0.001427,74.125.68.0-255,4320,101722,7,371881
20405,0.001431,172.31.36.0-255,66,101788,7,371881
20406,0.001442,172.31.36.0-255,66,101854,7,371881
20407,0.001484,172.31.36.0-255,66,101920,7,371881
20408,0.001489,74.125.68.0-255,4320,106240,7,371881
20409,0.001491,172.31.36.0-255,66,106306,7,371881
20410,0.001525,74.125.68.0-255,766,107072,7,371881
20411,0.001572,74.125.68.0-255,1484,108556,7,371881
20412,0.001577,172.31.36.0-255,66,108622,7,371881
20413,0.001599,74.125.68.0-255,2902,111524,7,371881
20414,0.001603,172.31.36.0-255,66,111590,7,371881
20415,0.001608,74.125.68.0-255,4320,115910,7,371881
20416,0.001611,172.31.36.0-255,66,115976,7,371881
20417,0.001637,74.125.68.0-255,1484,117460,7,371881
20418,0.001642,74.125.68.0-255,2902,120362,7,371881
20419,0.001647,74.125.68.0-255,4320,124682,7,371881
20420,0.001697,74.125.68.0-255,5738,130420,7,371881
20421,0.001718,74.125.68.0-255,4320,134740,7,371881
20422,0.001736,74.125.68.0-255,2902,137642,7,371881
20423,0.001771,74.125.68.0-255,1484,139126,7,371881
20424,0.001784,74.125.68.0-255,2184,141310,7,371881
20425,0.001808,74.125.68.0-255,1484,142794,7,371881
20426,0.001826,74.125.68.0-255,2902,145696,7,371881
20427,0.00184,74.125.68.0-255,2902,148598,7,371881
20428,0.001853,74.125.68.0-255,1484,150082,7,371881
20429,0.001861,74.125.68.0-255,4320,154402,7,371881
20430,0.001877,74.125.68.0-255,4320,158722,7,371881
20431,0.001944,74.125.68.0-255,7156,165878,7,371881
20432,0.001964,74.125.68.0-255,3602,169480,7,371881
20433,0.001969,74.125.68.0-255,5738,175218,7,371881
20434,0.001998,74.125.68.0-255,1484,176702,7,371881
20435,0.00203,74.125.68.0-255,4320,181022,7,371881
20436,0.002042,74.125.68.0-255,766,181788,7,371881
20437,0.002074,74.125.68.0-255,1484,183272,7,371881
20438,0.00212,74.125.68.0-255,1484,184756,7,371881
20439,0.002134,74.125.68.0-255,2902,187658,7,371881
20440,0.002151,74.125.68.0-255,2902,190560,7,371881
20441,0.002164,74.125.68.0-255,2902,193462,7,371881
20442,0.002173,74.125.68.0-255,4320,197782,7,371881
20443,0.002178,74.125.68.0-255,4320,202102,7,371881
20444,0.002194,74.125.68.0-255,1484,203586,7,371881
20445,0.002213,74.125.68.0-255,1484,205070,7,371881
20446,0.002234,74.125.68.0-255,7156,212226,7,371881
20447,0.002264,74.125.68.0-255,3602,215828,7,371881
20448,0.002318,74.125.68.0-255,1484,217312,7,371881
20449,0.002332,74.125.68.0-255,2902,220214,7,371881
20450,0.002355,74.125.68.0-255,4320,224534,7,371881
20451,0.002371,74.125.68.0-255,1484,226018,7,371881
20452,0.002383,74.125.68.0-255,4320,230338,7,371881
20453,0.002391,74.125.68.0-255,1484,231822,7,371881
20454,0.002413,74.125.68.0-255,4320,236142,7,371881
20455,0.002433,74.125.68.0-255,2902,239044,7,371881
20456,0.002438,74.125.68.0-255,5738,244782,7,371881
20457,0.002468,74.125.68.0-255,4320,249102,7,371881
20458,0.002479,74.125.68.0-255,766,249868,7,371881
20459,0.006177,172.31.36.0-255,66,249934,7,371881
20460,0.00871,74.125.68.0-255,5738,255672,7,371881
20461,0.008716,172.31.36.0-255,66,255738,7,371881
20462,0.01125,74.125.68.0-255,5738,261476,7,371881
20463,0.011259,172.31.36.0-255,66,261542,7,371881
20464,0.013766,74.125.68.0-255,5738,267280,7,371881
20465,0.013775,172.31.36.0-255,66,267346,7,371881
20466,0.016287,74.125.68.0-255,5738,273084,7,371881
20467,0.016296,172.31.36.0-255,66,273150,7,371881
20468,0.018827,74.125.68.0-255,5738,278888,7,371881
20469,0.018842,172.31.36.0-255,66,278954,7,371881
20470,0.021358,74.125.68.0-255,5738,284692,7,371881
20471,0.021368,172.31.36.0-255,66,284758,7,371881
20472,0.023879,74.125.68.0-255,5738,290496,7,371881
20473,0.023887,172.31.36.0-255,66,290562,7,371881
20474,0.02645,74.125.68.0-255,5738,296300,7,371881
20475,0.026458,172.31.36.0-255,66,296366,7,371881
20476,0.028965,74.125.68.0-255,5738,302104,7,371881
20477,0.028973,172.31.36.0-255,66,302170,7,371881
20478,0.031487,74.125.68.0-255,4320,306490,7,371881
20479,0.031495,172.31.36.0-255,66,306556,7,371881
20480,0.031533,74.125.68.0-255,1484,308040,7,371881
20481,0.034007,74.125.68.0-255,4320,312360,7,371881
20482,0.034014,172.31.36.0-255,66,312426,7,371881
20483,0.034638,172.31.36.0-255,172,312598,7,371881
20484,0.034668,172.31.36.0-255,1115,313713,7,371881
20485,0.034702,172.31.36.0-255,1514,315227,7,371881
20486,0.034704,172.31.36.0-255,1291,316518,7,371881
20487,0.036194,104.244.42.0-255,66,316584,7,371881
20488,0.036233,104.244.42.0-255,66,316650,7,371881
20489,0.036282,104.244.42.0-255,66,316716,7,371881
20490,0.036504,74.125.68.0-255,1484,318200,7,371881
20491,0.036536,74.125.68.0-255,4320,322520,7,371881
20492,0.036541,172.31.36.0-255,66,322586,7,371881
20493,0.039053,74.125.68.0-255,5738,328324,7,371881
20494,0.039058,172.31.36.0-255,66,328390,7,371881
20495,0.041567,74.125.68.0-255,5738,334128,7,371881
20496,0.041574,172.31.36.0-255,66,334194,7,371881
20497,0.044077,74.125.68.0-255,5738,339932,7,371881
20498,0.044082,172.31.36.0-255,66,339998,7,371881
20499,0.046594,74.125.68.0-255,5738,345736,7,371881
20500,0.0466,172.31.36.0-255,66,345802,7,371881
20501,0.049176,74.125.68.0-255,5738,351540,7,371881
20502,0.049181,172.31.36.0-255,66,351606,7,371881
20503,0.0517,74.125.68.0-255,5738,357344,7,371881
20504,0.051705,172.31.36.0-255,66,357410,7,371881
20505,0.054215,74.125.68.0-255,5738,363148,7,371881
20506,0.05422,172.31.36.0-255,66,363214,7,371881
20507,0.056728,74.125.68.0-255,5738,368952,7,371881
20508,0.056733,172.31.36.0-255,66,369018,7,371881
20509,0.059251,74.125.68.0-255,2626,371644,7,371881
20510,0.059258,172.31.36.0-255,66,371710,7,371881
20511,0.059458,172.31.36.0-255,105,371815,7,371881
20512,0.061929,74.125.68.0-255,66,371881,7,371881
20513,0.0,172.217.194.0-255,150,150,7,321119
20514,2.8e-05,172.31.36.0-255,66,216,7,321119
20515,3.5e-05,172.217.194.0-255,1484,1700,7,321119
20516,4e-05,172.31.36.0-255,66,1766,7,321119
20517,4.6e-05,172.217.194.0-255,2902,4668,7,321119
20518,4.9e-05,172.31.36.0-255,66,4734,7,321119
20519,5.5e-05,172.217.194.0-255,5738,10472,7,321119
20520,5.7e-05,172.31.36.0-255,66,10538,7,321119
20521,7.4e-05,172.217.194.0-255,1484,12022,7,321119
20522,7.6e-05,172.31.36.0-255,66,12088,7,321119
20523,9.9e-05,172.217.194.0-255,2010,14098,7,321119
20524,0.000102,172.31.36.0-255,66,14164,7,321119
20525,0.000226,172.217.194.0-255,1484,15648,7,321119
20526,0.000231,172.31.36.0-255,66,15714,7,321119
20527,0.000236,172.217.194.0-255,2902,18616,7,321119
20528,0.000239,172.31.36.0-255,66,18682,7,321119
20529,0.000246,172.217.194.0-255,5738,24420,7,321119
20530,0.000249,172.31.36.0-255,66,24486,7,321119
20531,0.000286,172.217.194.0-255,4320,28806,7,321119
20532,0.00029,172.31.36.0-255,66,28872,7,321119
20533,0.00031,172.217.194.0-255,2543,31415,7,321119
20534,0.000314,172.31.36.0-255,66,31481,7,321119
20535,0.00033,172.217.194.0-255,5738,37219,7,321119
20536,0.000333,172.31.36.0-255,66,37285,7,321119
20537,0.000338,172.217.194.0-255,2902,40187,7,321119
20538,0.00034,172.31.36.0-255,66,40253,7,321119
20539,0.000363,172.217.194.0-255,4320,44573,7,321119
20540,0.000366,172.31.36.0-255,66,44639,7,321119
20541,0.000389,172.217.194.0-255,3961,48600,7,321119
20542,0.000392,172.31.36.0-255,66,48666,7,321119
20543,0.000806,172.217.194.0-255,1484,50150,7,321119
20544,0.000812,172.31.36.0-255,66,50216,7,321119
20545,0.000819,172.217.194.0-255,2902,53118,7,321119
20546,0.000822,172.31.36.0-255,66,53184,7,321119
20547,0.000828,172.217.194.0-255,4320,57504,7,321119
20548,0.00083,172.31.36.0-255,66,57570,7,321119
20549,0.000854,172.217.194.0-255,1484,59054,7,321119
20550,0.000861,172.217.194.0-255,4320,63374,7,321119
20551,0.000865,172.31.36.0-255,66,63440,7,321119
20552,0.000884,172.217.194.0-255,2543,65983,7,321119
20553,0.000887,172.31.36.0-255,66,66049,7,321119
20554,0.000974,172.217.194.0-255,1484,67533,7,321119
20555,0.00098,172.217.194.0-255,2902,70435,7,321119
20556,0.000984,172.217.194.0-255,4320,74755,7,321119
20557,0.000995,172.217.194.0-255,1484,76239,7,321119
20558,0.001036,172.217.194.0-255,4320,80559,7,321119
20559,0.001903,172.217.194.0-255,1484,82043,7,321119
20560,0.001911,172.217.194.0-255,2902,84945,7,321119
20561,0.001914,172.217.194.0-255,1484,86429,7,321119
20562,0.001927,172.217.194.0-255,4320,90749,7,321119
20563,0.001962,172.217.194.0-255,2902,93651,7,321119
20564,0.001977,172.217.194.0-255,3846,97497,7,321119
20565,0.002012,172.217.194.0-255,7156,104653,7,321119
20566,0.00203,172.217.194.0-255,7156,111809,7,321119
20567,0.002046,172.217.194.0-255,5738,117547,7,321119
20568,0.00207,172.217.194.0-255,3602,121149,7,321119
20569,0.006236,172.31.36.0-255,66,121215,7,321119
20570,0.008326,172.217.194.0-255,5738,126953,7,321119
20571,0.008334,172.31.36.0-255,66,127019,7,321119
20572,0.010419,172.217.194.0-255,5738,132757,7,321119
20573,0.010428,172.31.36.0-255,66,132823,7,321119
20574,0.012475,172.217.194.0-255,5738,138561,7,321119
20575,0.012482,172.31.36.0-255,66,138627,7,321119
20576,0.014544,172.217.194.0-255,5738,144365,7,321119
20577,0.014553,172.31.36.0-255,66,144431,7,321119
20578,0.016638,172.217.194.0-255,5738,150169,7,321119
20579,0.016645,172.31.36.0-255,66,150235,7,321119
20580,0.018717,172.217.194.0-255,5738,155973,7,321119
20581,0.018724,172.31.36.0-255,66,156039,7,321119
20582,0.020787,172.217.194.0-255,4320,160359,7,321119
20583,0.020794,172.31.36.0-255,66,160425,7,321119
20584,0.020829,172.217.194.0-255,1484,161909,7,321119
20585,0.022885,172.217.194.0-255,4320,166229,7,321119
20586,0.022892,172.31.36.0-255,66,166295,7,321119
20587,0.024953,172.217.194.0-255,5738,172033,7,321119
20588,0.024961,172.31.36.0-255,66,172099,7,321119
20589,0.027048,172.217.194.0-255,5738,177837,7,321119
20590,0.027055,172.31.36.0-255,66,177903,7,321119
20591,0.028339,172.31.36.0-255,188,178091,7,321119
20592,0.028366,172.31.36.0-255,958,179049,7,321119
20593,0.028411,172.31.36.0-255,1514,180563,7,321119
20594,0.028413,172.31.36.0-255,1448,182011,7,321119
20595,0.029102,172.217.194.0-255,5738,187749,7,321119
20596,0.029109,172.31.36.0-255,66,187815,7,321119
20597,0.029895,104.244.42.0-255,66,187881,7,321119
20598,0.029903,104.244.42.0-255,66,187947,7,321119
20599,0.03001,104.244.42.0-255,66,188013,7,321119
20600,0.030601,104.244.42.0-255,108,188121,7,321119
20601,0.030606,172.31.36.0-255,66,188187,7,321119
20602,0.031156,172.217.194.0-255,5738,193925,7,321119
20603,0.03116,172.31.36.0-255,66,193991,7,321119
20604,0.033216,172.217.194.0-255,2902,196893,7,321119
20605,0.033221,172.31.36.0-255,66,196959,7,321119
20606,0.033256,172.217.194.0-255,2902,199861,7,321119
20607,0.033259,172.31.36.0-255,66,199927,7,321119
20608,0.035319,172.217.194.0-255,5738,205665,7,321119
20609,0.035326,172.31.36.0-255,66,205731,7,321119
20610,0.037394,172.217.194.0-255,2902,208633,7,321119
20611,0.037397,172.31.36.0-255,66,208699,7,321119
20612,0.037428,172.217.194.0-255,2902,211601,7,321119
20613,0.037431,172.31.36.0-255,66,211667,7,321119
20614,0.039461,172.217.194.0-255,2902,214569,7,321119
20615,0.039466,172.31.36.0-255,66,214635,7,321119
20616,0.039497,172.217.194.0-255,2902,217537,7,321119
20617,0.039501,172.31.36.0-255,66,217603,7,321119
20618,0.041565,172.217.194.0-255,5738,223341,7,321119
20619,0.04157,172.31.36.0-255,66,223407,7,321119
20620,0.043627,172.217.194.0-255,4320,227727,7,321119
20621,0.043632,172.31.36.0-255,66,227793,7,321119
20622,0.043658,172.217.194.0-255,1484,229277,7,321119
20623,0.045687,172.217.194.0-255,4320,233597,7,321119
20624,0.045692,172.31.36.0-255,66,233663,7,321119
20625,0.04776,172.217.194.0-255,5738,239401,7,321119
20626,0.047765,172.31.36.0-255,66,239467,7,321119
20627,0.049857,172.217.194.0-255,4320,243787,7,321119
20628,0.049862,172.31.36.0-255,66,243853,7,321119
20629,0.049891,172.217.194.0-255,1484,245337,7,321119
20630,0.051939,172.217.194.0-255,4320,249657,7,321119
20631,0.051944,172.31.36.0-255,66,249723,7,321119
20632,0.053984,172.217.194.0-255,5738,255461,7,321119
20633,0.054002,172.31.36.0-255,66,255527,7,321119
20634,0.056062,172.217.194.0-255,4320,259847,7,321119
20635,0.056068,172.31.36.0-255,66,259913,7,321119
20636,0.056095,172.217.194.0-255,1484,261397,7,321119
20637,0.058163,172.217.194.0-255,2902,264299,7,321119
20638,0.058168,172.31.36.0-255,66,264365,7,321119
20639,0.058197,172.217.194.0-255,1484,265849,7,321119
20640,0.060233,172.217.194.0-255,4320,270169,7,321119
20641,0.060238,172.31.36.0-255,66,270235,7,321119
20642,0.062349,172.217.194.0-255,5738,275973,7,321119
20643,0.062354,172.31.36.0-255,66,276039,7,321119
20644,0.064406,172.217.194.0-255,5738,281777,7,321119
20645,0.064411,172.31.36.0-255,66,281843,7,321119
20646,0.066454,172.217.194.0-255,5738,287581,7,321119
20647,0.066458,172.31.36.0-255,66,287647,7,321119
20648,0.06853,172.217.194.0-255,4320,291967,7,321119
20649,0.068535,172.31.36.0-255,66,292033,7,321119
20650,0.068561,172.217.194.0-255,1484,293517,7,321119
20651,0.07063,172.217.194.0-255,4320,297837,7,321119
20652,0.070634,172.31.36.0-255,66,297903,7,321119
20653,0.072697,172.217.194.0-255,5738,303641,7,321119
20654,0.072704,172.31.36.0-255,66,303707,7,321119
20655,0.074814,172.217.194.0-255,5738,309445,7,321119
20656,0.074818,172.31.36.0-255,66,309511,7,321119
20657,0.076893,172.217.194.0-255,5738,315249,7,321119
20658,0.076898,172.31.36.0-255,66,315315,7,321119
20659,0.078964,172.217.194.0-255,5738,321053,7,321119
20660,0.07897,172.31.36.0-255,66,321119,7,321119
20661,0.0,74.125.24.0-255,143,143,7,294659
20662,1.3e-05,172.31.36.0-255,66,209,7,294659
20663,2e-05,74.125.24.0-255,1484,1693,7,294659
20664,2.4e-05,172.31.36.0-255,66,1759,7,294659
20665,3e-05,74.125.24.0-255,2902,4661,7,294659
20666,3.4e-05,172.31.36.0-255,66,4727,7,294659
20667,4e-05,74.125.24.0-255,4320,9047,7,294659
20668,4.3e-05,172.31.36.0-255,66,9113,7,294659
20669,7.1e-05,74.125.24.0-255,2902,12015,7,294659
20670,7.4e-05,172.31.36.0-255,66,12081,7,294659
20671,7.9e-05,74.125.24.0-255,2019,14100,7,294659
20672,8.1e-05,172.31.36.0-255,66,14166,7,294659
20673,0.00014,74.125.24.0-255,2902,17068,7,294659
20674,0.000143,74.125.24.0-255,1484,18552,7,294659
20675,0.000146,172.31.36.0-255,66,18618,7,294659
20676,0.000149,172.31.36.0-255,66,18684,7,294659
20677,0.000164,74.125.24.0-255,2902,21586,7,294659
20678,0.000166,172.31.36.0-255,66,21652,7,294659
20679,0.00017,74.125.24.0-255,1484,23136,7,294659
20680,0.000172,172.31.36.0-255,66,23202,7,294659
20681,0.000198,74.125.24.0-255,4320,27522,7,294659
20682,0.000201,172.31.36.0-255,66,27588,7,294659
20683,0.000244,74.125.24.0-255,3961,31549,7,294659
20684,0.000247,172.31.36.0-255,66,31615,7,294659
20685,0.000349,74.125.24.0-255,1484,33099,7,294659
20686,0.000353,172.31.36.0-255,66,33165,7,294659
20687,0.00036,74.125.24.0-255,2902,36067,7,294659
20688,0.000362,172.31.36.0-255,66,36133,7,294659
20689,0.000368,74.125.24.0-255,4320,40453,7,294659
20690,0.00037,172.31.36.0-255,66,40519,7,294659
20691,0.000394,74.125.24.0-255,1484,42003,7,294659
20692,0.000396,172.31.36.0-255,66,42069,7,294659
20693,0.000428,74.125.24.0-255,4320,46389,7,294659
20694,0.000431,172.31.36.0-255,66,46455,7,294659
20695,0.000454,74.125.24.0-255,2543,48998,7,294659
20696,0.000456,172.31.36.0-255,66,49064,7,294659
20697,0.000463,74.125.24.0-255,7156,56220,7,294659
20698,0.000465,172.31.36.0-255,66,56286,7,294659
20699,0.000504,172.31.36.0-255,66,56352,7,294659
20700,0.000537,74.125.24.0-255,112,56464,7,294659
20701,0.000577,74.125.24.0-255,330,56794,7,294659
20702,0.000972,74.125.24.0-255,1484,58278,7,294659
20703,0.000977,172.31.36.0-255,66,58344,7,294659
20704,0.000982,74.125.24.0-255,2902,61246,7,294659
20705,0.000985,172.31.36.0-255,66,61312,7,294659
20706,0.000992,74.125.24.0-255,5738,67050,7,294659
20707,0.000994,172.31.36.0-255,66,67116,7,294659
20708,0.001032,172.31.36.0-255,66,67182,7,294659
20709,0.001039,74.125.24.0-255,5738,72920,7,294659
20710,0.001042,172.31.36.0-255,66,72986,7,294659
20711,0.001057,74.125.24.0-255,4320,77306,7,294659
20712,0.001059,172.31.36.0-255,66,77372,7,294659
20713,0.001071,74.125.24.0-255,766,78138,7,294659
20714,0.001455,172.31.36.0-255,66,78204,7,294659
20715,0.001931,74.125.24.0-255,1484,79688,7,294659
20716,0.001942,74.125.24.0-255,2902,82590,7,294659
20717,0.001947,172.31.36.0-255,66,82656,7,294659
20718,0.001975,74.125.24.0-255,5738,88394,7,294659
20719,0.001977,172.31.36.0-255,66,88460,7,294659
20720,0.001994,74.125.24.0-255,4320,92780,7,294659
20721,0.001996,172.31.36.0-255,66,92846,7,294659
20722,0.002024,172.31.36.0-255,66,92912,7,294659
20723,0.002043,74.125.24.0-255,2902,95814,7,294659
20724,0.002045,172.31.36.0-255,66,95880,7,294659
20725,0.002065,172.31.36.0-255,66,95946,7,294659
20726,0.004305,74.125.24.0-255,5738,101684,7,294659
20727,0.004312,172.31.36.0-255,66,101750,7,294659
20728,0.006545,74.125.24.0-255,5738,107488,7,294659
20729,0.006551,172.31.36.0-255,66,107554,7,294659
20730,0.008808,74.125.24.0-255,5738,113292,7,294659
20731,0.008815,172.31.36.0-255,66,113358,7,294659
20732,0.011062,74.125.24.0-255,5738,119096,7,294659
20733,0.011067,172.31.36.0-255,66,119162,7,294659
20734,0.013344,74.125.24.0-255,5738,124900,7,294659
20735,0.013351,172.31.36.0-255,66,124966,7,294659
20736,0.015611,74.125.24.0-255,5738,130704,7,294659
20737,0.015618,172.31.36.0-255,66,130770,7,294659
20738,0.017866,74.125.24.0-255,5738,136508,7,294659
20739,0.017875,172.31.36.0-255,66,136574,7,294659
20740,0.020118,74.125.24.0-255,5738,142312,7,294659
20741,0.020127,172.31.36.0-255,66,142378,7,294659
20742,0.022396,74.125.24.0-255,5738,148116,7,294659
20743,0.022403,172.31.36.0-255,66,148182,7,294659
20744,0.024654,74.125.24.0-255,5738,153920,7,294659
20745,0.024662,172.31.36.0-255,66,153986,7,294659
20746,0.026938,74.125.24.0-255,5738,159724,7,294659
20747,0.026946,172.31.36.0-255,66,159790,7,294659
20748,0.029208,74.125.24.0-255,5738,165528,7,294659
20749,0.029215,172.31.36.0-255,66,165594,7,294659
20750,0.031514,74.125.24.0-255,5738,171332,7,294659
20751,0.031519,172.31.36.0-255,66,171398,7,294659
20752,0.032365,172.31.36.0-255,172,171570,7,294659
20753,0.032392,172.31.36.0-255,1073,172643,7,294659
20754,0.033788,74.125.24.0-255,5738,178381,7,294659
20755,0.033794,172.31.36.0-255,66,178447,7,294659
20756,0.033902,104.244.42.0-255,66,178513,7,294659
20757,0.033931,104.244.42.0-255,66,178579,7,294659
20758,0.036053,74.125.24.0-255,5738,184317,7,294659
20759,0.03606,172.31.36.0-255,66,184383,7,294659
20760,0.038319,74.125.24.0-255,5738,190121,7,294659
20761,0.038326,172.31.36.0-255,66,190187,7,294659
20762,0.040598,74.125.24.0-255,5738,195925,7,294659
20763,0.040608,172.31.36.0-255,66,195991,7,294659
20764,0.042862,74.125.24.0-255,5738,201729,7,294659
20765,0.042869,172.31.36.0-255,66,201795,7,294659
20766,0.045114,74.125.24.0-255,5738,207533,7,294659
20767,0.045119,172.31.36.0-255,66,207599,7,294659
20768,0.047378,74.125.24.0-255,5738,213337,7,294659
20769,0.047385,172.31.36.0-255,66,213403,7,294659
20770,0.049675,74.125.24.0-255,5738,219141,7,294659
20771,0.049681,172.31.36.0-255,66,219207,7,294659
20772,0.051975,74.125.24.0-255,5738,224945,7,294659
20773,0.051981,172.31.36.0-255,66,225011,7,294659
20774,0.054249,74.125.24.0-255,5738,230749,7,294659
20775,0.054255,172.31.36.0-255,66,230815,7,294659
20776,0.056514,74.125.24.0-255,5738,236553,7,294659
20777,0.05652,172.31.36.0-255,66,236619,7,294659
20778,0.058782,74.125.24.0-255,5738,242357,7,294659
20779,0.058788,172.31.36.0-255,66,242423,7,294659
20780,0.061046,74.125.24.0-255,5738,248161,7,294659
20781,0.061052,172.31.36.0-255,66,248227,7,294659
20782,0.063311,74.125.24.0-255,5738,253965,7,294659
20783,0.063317,172.31.36.0-255,66,254031,7,294659
20784,0.065564,74.125.24.0-255,5738,259769,7,294659
20785,0.06557,172.31.36.0-255,66,259835,7,294659
20786,0.067837,74.125.24.0-255,5738,265573,7,294659
20787,0.067844,172.31.36.0-255,66,265639,7,294659
20788,0.070102,74.125.24.0-255,5738,271377,7,294659
20789,0.070107,172.31.36.0-255,66,271443,7,294659
20790,0.072387,74.125.24.0-255,5738,277181,7,294659
20791,0.072394,172.31.36.0-255,66,277247,7,294659
20792,0.074667,74.125.24.0-255,5738,282985,7,294659
20793,0.074674,172.31.36.0-255,66,283051,7,294659
20794,0.076922,74.125.24.0-255,5738,288789,7,294659
20795,0.076928,172.31.36.0-255,66,288855,7,294659
20796,0.079183,74.125.24.0-255,5738,294593,7,294659
20797,0.079189,172.31.36.0-255,66,294659,7,294659
20798,0.0,74.125.24.0-255,297,297,7,288110
20799,3.5e-05,172.31.36.0-255,66,363,7,288110
20800,4.2e-05,74.125.24.0-255,1484,1847,7,288110
20801,4.5e-05,172.31.36.0-255,66,1913,7,288110
20802,5.2e-05,74.125.24.0-255,4320,6233,7,288110
20803,5.5e-05,172.31.36.0-255,66,6299,7,288110
20804,7.4e-05,172.31.36.0-255,66,6365,7,288110
20805,0.000146,172.31.36.0-255,66,6431,7,288110
20806,0.000219,74.125.24.0-255,5738,12169,7,288110
20807,0.000222,172.31.36.0-255,66,12235,7,288110
20808,0.000251,74.125.24.0-255,2543,14778,7,288110
20809,0.000254,172.31.36.0-255,66,14844,7,288110
20810,0.000322,74.125.24.0-255,1484,16328,7,288110
20811,0.000326,172.31.36.0-255,66,16394,7,288110
20812,0.000331,74.125.24.0-255,2902,19296,7,288110
20813,0.000334,172.31.36.0-255,66,19362,7,288110
20814,0.000339,74.125.24.0-255,4320,23682,7,288110
20815,0.000342,172.31.36.0-255,66,23748,7,288110
20816,0.000374,74.125.24.0-255,1484,25232,7,288110
20817,0.000377,172.31.36.0-255,66,25298,7,288110
20818,0.000413,172.31.36.0-255,66,25364,7,288110
20819,0.00044,74.125.24.0-255,2543,27907,7,288110
20820,0.000443,172.31.36.0-255,66,27973,7,288110
20821,0.000525,74.125.24.0-255,7156,35129,7,288110
20822,0.000531,172.31.36.0-255,66,35195,7,288110
20823,0.000542,74.125.24.0-255,2543,37738,7,288110
20824,0.000549,172.31.36.0-255,66,37804,7,288110
20825,0.000606,74.125.24.0-255,400,38204,7,288110
20826,0.000609,74.125.24.0-255,111,38315,7,288110
20827,0.00061,172.31.36.0-255,66,38381,7,288110
20828,0.000641,74.125.24.0-255,2902,41283,7,288110
20829,0.000645,172.31.36.0-255,66,41349,7,288110
20830,0.000681,74.125.24.0-255,7156,48505,7,288110
20831,0.000684,172.31.36.0-255,66,48571,7,288110
20832,0.000726,74.125.24.0-255,7156,55727,7,288110
20833,0.00073,172.31.36.0-255,66,55793,7,288110
20834,0.000764,172.31.36.0-255,66,55859,7,288110
20835,0.000877,74.125.24.0-255,4320,60179,7,288110
20836,0.000881,172.31.36.0-255,66,60245,7,288110
20837,0.00091,74.125.24.0-255,3961,64206,7,288110
20838,0.000914,172.31.36.0-255,66,64272,7,288110
20839,0.001621,74.125.24.0-255,1484,65756,7,288110
20840,0.001632,74.125.24.0-255,2902,68658,7,288110
20841,0.001636,172.31.36.0-255,66,68724,7,288110
20842,0.001642,74.125.24.0-255,2902,71626,7,288110
20843,0.001645,172.31.36.0-255,66,71692,7,288110
20844,0.001675,74.125.24.0-255,2902,74594,7,288110
20845,0.001678,172.31.36.0-255,66,74660,7,288110
20846,0.001705,74.125.24.0-255,7156,81816,7,288110
20847,0.001708,172.31.36.0-255,66,81882,7,288110
20848,0.00177,74.125.24.0-255,4320,86202,7,288110
20849,0.001773,172.31.36.0-255,66,86268,7,288110
20850,0.001803,172.31.36.0-255,66,86334,7,288110
20851,0.001907,74.125.24.0-255,1484,87818,7,288110
20852,0.001931,74.125.24.0-255,766,88584,7,288110
20853,0.001937,172.31.36.0-255,66,88650,7,288110
20854,0.001943,74.125.24.0-255,2902,91552,7,288110
20855,0.001945,172.31.36.0-255,66,91618,7,288110
20856,0.001996,172.31.36.0-255,66,91684,7,288110
20857,0.002137,172.31.36.0-255,66,91750,7,288110
20858,0.002222,172.31.36.0-255,66,91816,7,288110
20859,0.00228,172.31.36.0-255,66,91882,7,288110
20860,0.002553,74.125.24.0-255,3602,95484,7,288110
20861,0.002557,172.31.36.0-255,66,95550,7,288110
20862,0.002615,172.31.36.0-255,66,95616,7,288110
20863,0.002689,74.125.24.0-255,4320,99936,7,288110
20864,0.002692,172.31.36.0-255,66,100002,7,288110
20865,0.002722,172.31.36.0-255,66,100068,7,288110
20866,0.00475,74.125.24.0-255,5738,105806,7,288110
20867,0.004757,172.31.36.0-255,66,105872,7,288110
20868,0.006789,74.125.24.0-255,5738,111610,7,288110
20869,0.006794,172.31.36.0-255,66,111676,7,288110
20870,0.008818,74.125.24.0-255,5738,117414,7,288110
20871,0.008824,172.31.36.0-255,66,117480,7,288110
20872,0.01085,74.125.24.0-255,5738,123218,7,288110
20873,0.010857,172.31.36.0-255,66,123284,7,288110
20874,0.012917,74.125.24.0-255,5738,129022,7,288110
20875,0.012937,172.31.36.0-255,66,129088,7,288110
20876,0.014974,74.125.24.0-255,5738,134826,7,288110
20877,0.014991,172.31.36.0-255,66,134892,7,288110
20878,0.017055,74.125.24.0-255,5738,140630,7,288110
20879,0.017072,172.31.36.0-255,66,140696,7,288110
20880,0.019097,74.125.24.0-255,5738,146434,7,288110
20881,0.019108,172.31.36.0-255,66,146500,7,288110
20882,0.021155,74.125.24.0-255,5738,152238,7,288110
20883,0.021162,172.31.36.0-255,66,152304,7,288110
20884,0.023203,74.125.24.0-255,5738,158042,7,288110
20885,0.023209,172.31.36.0-255,66,158108,7,288110
20886,0.025252,74.125.24.0-255,5738,163846,7,288110
20887,0.025258,172.31.36.0-255,66,163912,7,288110
20888,0.027298,74.125.24.0-255,5738,169650,7,288110
20889,0.027305,172.31.36.0-255,66,169716,7,288110
20890,0.029337,74.125.24.0-255,5738,175454,7,288110
20891,0.029344,172.31.36.0-255,66,175520,7,288110
20892,0.031387,74.125.24.0-255,5738,181258,7,288110
20893,0.031396,172.31.36.0-255,66,181324,7,288110
20894,0.033419,74.125.24.0-255,5738,187062,7,288110
20895,0.033427,172.31.36.0-255,66,187128,7,288110
20896,0.035485,74.125.24.0-255,5738,192866,7,288110
20897,0.035491,172.31.36.0-255,66,192932,7,288110
20898,0.037551,74.125.24.0-255,5738,198670,7,288110
20899,0.037559,172.31.36.0-255,66,198736,7,288110
20900,0.039591,74.125.24.0-255,5738,204474,7,288110
20901,0.0396,172.31.36.0-255,66,204540,7,288110
20902,0.039607,172.31.36.0-255,172,204712,7,288110
20903,0.03966,172.31.36.0-255,1114,205826,7,288110
20904,0.039852,172.31.36.0-255,1514,207340,7,288110
20905,0.039854,172.31.36.0-255,1294,208634,7,288110
20906,0.041126,104.244.42.0-255,66,208700,7,288110
20907,0.041188,104.244.42.0-255,66,208766,7,288110
20908,0.041409,104.244.42.0-255,66,208832,7,288110
20909,0.04165,74.125.24.0-255,5738,214570,7,288110
20910,0.041654,172.31.36.0-255,66,214636,7,288110
20911,0.041843,104.244.42.0-255,108,214744,7,288110
20912,0.041848,172.31.36.0-255,66,214810,7,288110
20913,0.043686,74.125.24.0-255,5738,220548,7,288110
20914,0.043694,172.31.36.0-255,66,220614,7,288110
20915,0.045735,74.125.24.0-255,5738,226352,7,288110
20916,0.045741,172.31.36.0-255,66,226418,7,288110
20917,0.047782,74.125.24.0-255,5738,232156,7,288110
20918,0.047788,172.31.36.0-255,66,232222,7,288110
20919,0.049845,74.125.24.0-255,5738,237960,7,288110
20920,0.04985,172.31.36.0-255,66,238026,7,288110
20921,0.051904,74.125.24.0-255,5738,243764,7,288110
20922,0.05191,172.31.36.0-255,66,243830,7,288110
20923,0.053955,74.125.24.0-255,5738,249568,7,288110
20924,0.053962,172.31.36.0-255,66,249634,7,288110
20925,0.056033,74.125.24.0-255,5738,255372,7,288110
20926,0.056038,172.31.36.0-255,66,255438,7,288110
20927,0.058079,74.125.24.0-255,5738,261176,7,288110
20928,0.058085,172.31.36.0-255,66,261242,7,288110
20929,0.060135,74.125.24.0-255,5738,266980,7,288110
20930,0.060141,172.31.36.0-255,66,267046,7,288110
20931,0.062188,74.125.24.0-255,5738,272784,7,288110
20932,0.062193,172.31.36.0-255,66,272850,7,288110
20933,0.064279,74.125.24.0-255,5738,278588,7,288110
20934,0.064285,172.31.36.0-255,66,278654,7,288110
20935,0.066317,74.125.24.0-255,5738,284392,7,288110
20936,0.066322,172.31.36.0-255,66,284458,7,288110
20937,0.068363,74.125.24.0-255,3415,287873,7,288110
20938,0.068369,172.31.36.0-255,66,287939,7,288110
20939,0.068548,172.31.36.0-255,105,288044,7,288110
20940,0.070536,74.125.24.0-255,66,288110,7,288110
20941,0.0,172.217.194.0-255,153,153,7,306133
20942,2.4e-05,172.31.36.0-255,66,219,7,306133
20943,3.2e-05,172.217.194.0-255,1484,1703,7,306133
20944,3.6e-05,172.31.36.0-255,66,1769,7,306133
20945,4.2e-05,172.217.194.0-255,2902,4671,7,306133
20946,4.5e-05,172.31.36.0-255,66,4737,7,306133
20947,5.3e-05,172.217.194.0-255,7156,11893,7,306133
20948,5.7e-05,172.31.36.0-255,66,11959,7,306133
20949,6.8e-05,172.31.36.0-255,66,12025,7,306133
20950,0.000107,172.217.194.0-255,5738,17763,7,306133
20951,0.00011,172.31.36.0-255,66,17829,7,306133
20952,0.000131,172.217.194.0-255,5379,23208,7,306133
20953,0.000134,172.31.36.0-255,66,23274,7,306133
20954,0.000155,172.217.194.0-255,5738,29012,7,306133
20955,0.000158,172.31.36.0-255,66,29078,7,306133
20956,0.000175,172.217.194.0-255,5738,34816,7,306133
20957,0.000178,172.31.36.0-255,66,34882,7,306133
20958,0.000181,172.217.194.0-255,1484,36366,7,306133
20959,0.000183,172.31.36.0-255,66,36432,7,306133
20960,0.000189,172.217.194.0-255,4320,40752,7,306133
20961,0.000191,172.31.36.0-255,66,40818,7,306133
20962,0.00023,172.31.36.0-255,66,40884,7,306133
20963,0.000236,172.217.194.0-255,5379,46263,7,306133
20964,0.000239,172.31.36.0-255,66,46329,7,306133
20965,0.000241,172.217.194.0-255,677,47006,7,306133
20966,0.000244,172.31.36.0-255,66,47072,7,306133
20967,0.000293,172.217.194.0-255,1484,48556,7,306133
20968,0.000296,172.31.36.0-255,66,48622,7,306133
20969,0.000301,172.217.194.0-255,2902,51524,7,306133
20970,0.000303,172.31.36.0-255,66,51590,7,306133
20971,0.000317,172.217.194.0-255,1484,53074,7,306133
20972,0.000334,172.217.194.0-255,4320,57394,7,306133
20973,0.000337,172.31.36.0-255,66,57460,7,306133
20974,0.000353,172.217.194.0-255,6248,63708,7,306133
20975,0.000355,172.31.36.0-255,66,63774,7,306133
20976,0.000384,172.217.194.0-255,2902,66676,7,306133
20977,0.000387,172.31.36.0-255,66,66742,7,306133
20978,0.00041,172.217.194.0-255,4320,71062,7,306133
20979,0.000413,172.31.36.0-255,66,71128,7,306133
20980,0.000419,172.217.194.0-255,5738,76866,7,306133
20981,0.000421,172.31.36.0-255,66,76932,7,306133
20982,0.000457,172.217.194.0-255,3961,80893,7,306133
20983,0.00046,172.31.36.0-255,66,80959,7,306133
20984,0.000805,172.217.194.0-255,1484,82443,7,306133
20985,0.000812,172.217.194.0-255,2902,85345,7,306133
20986,0.000815,172.31.36.0-255,66,85411,7,306133
20987,0.00084,172.217.194.0-255,5738,91149,7,306133
20988,0.000842,172.31.36.0-255,66,91215,7,306133
20989,0.000857,172.217.194.0-255,5738,96953,7,306133
20990,0.000859,172.31.36.0-255,66,97019,7,306133
20991,0.000882,172.217.194.0-255,7156,104175,7,306133
20992,0.000885,172.31.36.0-255,66,104241,7,306133
20993,0.000888,172.217.194.0-255,1484,105725,7,306133
20994,0.000919,172.217.194.0-255,5738,111463,7,306133
20995,0.000927,172.31.36.0-255,66,111529,7,306133
20996,0.000933,172.217.194.0-255,3602,115131,7,306133
20997,0.000936,172.31.36.0-255,66,115197,7,306133
20998,0.000942,172.217.194.0-255,4320,119517,7,306133
20999,0.000944,172.31.36.0-255,66,119583,7,306133
21000,0.00097,172.217.194.0-255,5738,125321,7,306133
21001,0.000973,172.31.36.0-255,66,125387,7,306133
21002,0.000984,172.31.36.0-255,66,125453,7,306133
21003,0.001061,172.31.36.0-255,66,125519,7,306133
21004,0.001078,172.217.194.0-255,6438,131957,7,306133
21005,0.001081,172.31.36.0-255,66,132023,7,306133
21006,0.001093,172.31.36.0-255,66,132089,7,306133
21007,0.00111,172.31.36.0-255,66,132155,7,306133
21008,0.001282,172.217.194.0-255,1484,133639,7,306133
21009,0.001287,172.217.194.0-255,1484,135123,7,306133
21010,0.00129,172.31.36.0-255,66,135189,7,306133
21011,0.001309,172.217.194.0-255,1484,136673,7,306133
21012,0.001316,172.217.194.0-255,5738,142411,7,306133
21013,0.001323,172.217.194.0-255,7156,149567,7,306133
21014,0.001327,172.31.36.0-255,66,149633,7,306133
21015,0.001336,172.31.36.0-255,66,149699,7,306133
21016,0.001342,172.217.194.0-255,2902,152601,7,306133
21017,0.001344,172.31.36.0-255,66,152667,7,306133
21018,0.001386,172.31.36.0-255,66,152733,7,306133
21019,0.001402,172.217.194.0-255,2184,154917,7,306133
21020,0.001405,172.31.36.0-255,66,154983,7,306133
21021,0.00157,172.217.194.0-255,1484,156467,7,306133
21022,0.001576,172.217.194.0-255,2902,159369,7,306133
21023,0.001579,172.31.36.0-255,66,159435,7,306133
21024,0.001603,172.217.194.0-255,5738,165173,7,306133
21025,0.001605,172.31.36.0-255,66,165239,7,306133
21026,0.001659,172.31.36.0-255,66,165305,7,306133
21027,0.001663,172.31.36.0-255,66,165371,7,306133
21028,0.001713,172.217.194.0-255,2184,167555,7,306133
21029,0.001716,172.31.36.0-255,66,167621,7,306133
21030,0.001752,172.217.194.0-255,1484,169105,7,306133
21031,0.001769,172.217.194.0-255,2902,172007,7,306133
21032,0.001771,172.31.36.0-255,66,172073,7,306133
21033,0.001789,172.217.194.0-255,5738,177811,7,306133
21034,0.001793,172.217.194.0-255,2902,180713,7,306133
21035,0.001797,172.31.36.0-255,66,180779,7,306133
21036,0.001802,172.31.36.0-255,66,180845,7,306133
21037,0.001812,172.217.194.0-255,1484,182329,7,306133
21038,0.001849,172.217.194.0-255,2902,185231,7,306133
21039,0.001862,172.31.36.0-255,66,185297,7,306133
21040,0.002193,172.217.194.0-255,1484,186781,7,306133
21041,0.002215,172.217.194.0-255,2902,189683,7,306133
21042,0.002218,172.31.36.0-255,66,189749,7,306133
21043,0.002223,172.217.194.0-255,2902,192651,7,306133
21044,0.002226,172.31.36.0-255,66,192717,7,306133
21045,0.002239,172.217.194.0-255,2902,195619,7,306133
21046,0.002244,172.217.194.0-255,5738,201357,7,306133
21047,0.002248,172.31.36.0-255,66,201423,7,306133
21048,0.002256,172.31.36.0-255,66,201489,7,306133
21049,0.002263,172.217.194.0-255,7156,208645,7,306133
21050,0.00227,172.217.194.0-255,7156,215801,7,306133
21051,0.002297,172.31.36.0-255,66,215867,7,306133
21052,0.002312,172.217.194.0-255,3602,219469,7,306133
21053,0.00233,172.31.36.0-255,66,219535,7,306133
21054,0.004631,172.217.194.0-255,1484,221019,7,306133
21055,0.004689,172.217.194.0-255,4320,225339,7,306133
21056,0.004693,172.31.36.0-255,66,225405,7,306133
21057,0.007047,172.217.194.0-255,5738,231143,7,306133
21058,0.007055,172.31.36.0-255,66,231209,7,306133
21059,0.009419,172.217.194.0-255,5738,236947,7,306133
21060,0.009422,172.31.36.0-255,66,237013,7,306133
21061,0.011756,172.217.194.0-255,5738,242751,7,306133
21062,0.011763,172.31.36.0-255,66,242817,7,306133
21063,0.014082,172.217.194.0-255,5738,248555,7,306133
21064,0.014093,172.31.36.0-255,66,248621,7,306133
21065,0.016442,172.217.194.0-255,5738,254359,7,306133
21066,0.016453,172.31.36.0-255,66,254425,7,306133
21067,0.018798,172.217.194.0-255,5738,260163,7,306133
21068,0.01881,172.31.36.0-255,66,260229,7,306133
21069,0.021153,172.217.194.0-255,5738,265967,7,306133
21070,0.021163,172.31.36.0-255,66,266033,7,306133
21071,0.023478,172.217.194.0-255,5738,271771,7,306133
21072,0.023487,172.31.36.0-255,66,271837,7,306133
21073,0.025848,172.217.194.0-255,5738,277575,7,306133
21074,0.025855,172.31.36.0-255,66,277641,7,306133
21075,0.028179,172.217.194.0-255,5738,283379,7,306133
21076,0.028186,172.31.36.0-255,66,283445,7,306133
21077,0.030533,172.217.194.0-255,5738,289183,7,306133
21078,0.030543,172.31.36.0-255,66,289249,7,306133
21079,0.0329,172.217.194.0-255,5738,294987,7,306133
21080,0.032906,172.31.36.0-255,66,295053,7,306133
21081,0.034001,172.31.36.0-255,172,295225,7,306133
21082,0.034032,172.31.36.0-255,1112,296337,7,306133
21083,0.034093,172.31.36.0-255,1514,297851,7,306133
21084,0.034096,172.31.36.0-255,1294,299145,7,306133
21085,0.03527,172.217.194.0-255,5738,304883,7,306133
21086,0.035277,172.31.36.0-255,66,304949,7,306133
21087,0.035549,104.244.42.0-255,66,305015,7,306133
21088,0.035585,104.244.42.0-255,66,305081,7,306133
21089,0.035634,104.244.42.0-255,66,305147,7,306133
21090,0.037584,172.217.194.0-255,749,305896,7,306133
21091,0.037711,172.31.36.0-255,66,305962,7,306133
21092,0.037747,172.31.36.0-255,105,306067,7,306133
21093,0.040036,172.217.194.0-255,66,306133,7,306133
21094,0.0,172.253.118.0-255,153,153,7,321647
21095,2.8e-05,172.31.36.0-255,66,219,7,321647
21096,3.6e-05,172.253.118.0-255,1484,1703,7,321647
21097,4.2e-05,172.31.36.0-255,66,1769,7,321647
21098,4.7e-05,172.253.118.0-255,2902,4671,7,321647
21099,5e-05,172.31.36.0-255,66,4737,7,321647
21100,5.7e-05,172.253.118.0-255,5738,10475,7,321647
21101,6e-05,172.31.36.0-255,66,10541,7,321647
21102,7.3e-05,172.31.36.0-255,66,10607,7,321647
21103,8.9e-05,172.31.36.0-255,66,10673,7,321647
21104,0.00013,172.253.118.0-255,4320,14993,7,321647
21105,0.000133,172.31.36.0-255,66,15059,7,321647
21106,0.000162,172.31.36.0-255,66,15125,7,321647
21107,0.000193,172.253.118.0-255,3602,18727,7,321647
21108,0.000196,172.31.36.0-255,66,18793,7,321647
21109,0.000202,172.253.118.0-255,5691,24484,7,321647
21110,0.000205,172.31.36.0-255,66,24550,7,321647
21111,0.000207,172.253.118.0-255,108,24658,7,321647
21112,0.000209,172.31.36.0-255,66,24724,7,321647
21113,0.000407,172.253.118.0-255,1484,26208,7,321647
21114,0.000414,172.31.36.0-255,66,26274,7,321647
21115,0.00042,172.253.118.0-255,2902,29176,7,321647
21116,0.000423,172.31.36.0-255,66,29242,7,321647
21117,0.000456,172.253.118.0-255,1484,30726,7,321647
21118,0.000458,172.31.36.0-255,66,30792,7,321647
21119,0.000481,172.253.118.0-255,4320,35112,7,321647
21120,0.000483,172.31.36.0-255,66,35178,7,321647
21121,0.000498,172.31.36.0-255,66,35244,7,321647
21122,0.000511,172.31.36.0-255,66,35310,7,321647
21123,0.000513,172.253.118.0-255,332,35642,7,321647
21124,0.000848,172.253.118.0-255,1484,37126,7,321647
21125,0.000853,172.31.36.0-255,66,37192,7,321647
21126,0.000871,172.253.118.0-255,2902,40094,7,321647
21127,0.000873,172.31.36.0-255,66,40160,7,321647
21128,0.000878,172.253.118.0-255,2902,43062,7,321647
21129,0.00088,172.31.36.0-255,66,43128,7,321647
21130,0.000911,172.253.118.0-255,7156,50284,7,321647
21131,0.000914,172.31.36.0-255,66,50350,7,321647
21132,0.000917,172.253.118.0-255,1484,51834,7,321647
21133,0.000939,172.253.118.0-255,7156,58990,7,321647
21134,0.000941,172.31.36.0-255,66,59056,7,321647
21135,0.000969,172.253.118.0-255,7156,66212,7,321647
21136,0.000973,172.253.118.0-255,3602,69814,7,321647
21137,0.000978,172.31.36.0-255,66,69880,7,321647
21138,0.000981,172.31.36.0-255,66,69946,7,321647
21139,0.001769,172.253.118.0-255,1484,71430,7,321647
21140,0.001794,172.253.118.0-255,2902,74332,7,321647
21141,0.001798,172.31.36.0-255,66,74398,7,321647
21142,0.001807,172.253.118.0-255,5738,80136,7,321647
21143,0.001809,172.31.36.0-255,66,80202,7,321647
21144,0.001816,172.253.118.0-255,7156,87358,7,321647
21145,0.001818,172.31.36.0-255,66,87424,7,321647
21146,0.001841,172.253.118.0-255,7156,94580,7,321647
21147,0.001843,172.31.36.0-255,66,94646,7,321647
21148,0.001868,172.253.118.0-255,7156,101802,7,321647
21149,0.001871,172.31.36.0-255,66,101868,7,321647
21150,0.001875,172.253.118.0-255,2184,104052,7,321647
21151,0.001877,172.31.36.0-255,66,104118,7,321647
21152,0.002283,172.253.118.0-255,1484,105602,7,321647
21153,0.002291,172.253.118.0-255,1484,107086,7,321647
21154,0.002295,172.31.36.0-255,66,107152,7,321647
21155,0.00231,172.253.118.0-255,1484,108636,7,321647
21156,0.002315,172.253.118.0-255,4320,112956,7,321647
21157,0.002318,172.31.36.0-255,66,113022,7,321647
21158,0.002338,172.253.118.0-255,1484,114506,7,321647
21159,0.002342,172.253.118.0-255,1484,115990,7,321647
21160,0.002344,172.31.36.0-255,66,116056,7,321647
21161,0.002369,172.31.36.0-255,66,116122,7,321647
21162,0.002374,172.253.118.0-255,4320,120442,7,321647
21163,0.002376,172.31.36.0-255,66,120508,7,321647
21164,0.002383,172.253.118.0-255,5738,126246,7,321647
21165,0.002384,172.31.36.0-255,66,126312,7,321647
21166,0.004757,172.253.118.0-255,5738,132050,7,321647
21167,0.004769,172.31.36.0-255,66,132116,7,321647
21168,0.00711,172.253.118.0-255,5738,137854,7,321647
21169,0.007116,172.31.36.0-255,66,137920,7,321647
21170,0.00946,172.253.118.0-255,5738,143658,7,321647
21171,0.009472,172.31.36.0-255,66,143724,7,321647
21172,0.011825,172.253.118.0-255,5738,149462,7,321647
21173,0.011837,172.31.36.0-255,66,149528,7,321647
21174,0.014189,172.253.118.0-255,5738,155266,7,321647
21175,0.014202,172.31.36.0-255,66,155332,7,321647
21176,0.016547,172.253.118.0-255,5738,161070,7,321647
21177,0.016557,172.31.36.0-255,66,161136,7,321647
21178,0.01891,172.253.118.0-255,5738,166874,7,321647
21179,0.018918,172.31.36.0-255,66,166940,7,321647
21180,0.021265,172.253.118.0-255,5738,172678,7,321647
21181,0.021276,172.31.36.0-255,66,172744,7,321647
21182,0.023624,172.253.118.0-255,5738,178482,7,321647
21183,0.023635,172.31.36.0-255,66,178548,7,321647
21184,0.026047,172.253.118.0-255,5738,184286,7,321647
21185,0.026055,172.31.36.0-255,66,184352,7,321647
21186,0.028408,172.253.118.0-255,5738,190090,7,321647
21187,0.028417,172.31.36.0-255,66,190156,7,321647
21188,0.030768,172.253.118.0-255,5738,195894,7,321647
21189,0.030777,172.31.36.0-255,66,195960,7,321647
21190,0.033151,172.253.118.0-255,5738,201698,7,321647
21191,0.033161,172.31.36.0-255,66,201764,7,321647
21192,0.035507,172.253.118.0-255,5738,207502,7,321647
21193,0.035517,172.31.36.0-255,66,207568,7,321647
21194,0.037882,172.253.118.0-255,5738,213306,7,321647
21195,0.037891,172.31.36.0-255,66,213372,7,321647
21196,0.0381,172.31.36.0-255,171,213543,7,321647
21197,0.038131,172.31.36.0-255,1137,214680,7,321647
21198,0.038269,172.31.36.0-255,1514,216194,7,321647
21199,0.038271,172.31.36.0-255,1514,217708,7,321647
21200,0.038273,172.31.36.0-255,1514,219222,7,321647
21201,0.038274,172.31.36.0-255,1514,220736,7,321647
21202,0.038303,172.31.36.0-255,1514,222250,7,321647
21203,0.038308,172.31.36.0-255,189,222439,7,321647
21204,0.039654,104.244.42.0-255,66,222505,7,321647
21205,0.039699,104.244.42.0-255,66,222571,7,321647
21206,0.039852,104.244.42.0-255,66,222637,7,321647
21207,0.039858,104.244.42.0-255,66,222703,7,321647
21208,0.040239,172.253.118.0-255,5738,228441,7,321647
21209,0.040247,172.31.36.0-255,66,228507,7,321647
21210,0.042591,172.253.118.0-255,5738,234245,7,321647
21211,0.0426,172.31.36.0-255,66,234311,7,321647
21212,0.044946,172.253.118.0-255,5738,240049,7,321647
21213,0.044953,172.31.36.0-255,66,240115,7,321647
21214,0.047294,172.253.118.0-255,5738,245853,7,321647
21215,0.047301,172.31.36.0-255,66,245919,7,321647
21216,0.049658,172.253.118.0-255,5738,251657,7,321647
21217,0.049664,172.31.36.0-255,66,251723,7,321647
21218,0.052035,172.253.118.0-255,5738,257461,7,321647
21219,0.052041,172.31.36.0-255,66,257527,7,321647
21220,0.054391,172.253.118.0-255,5738,263265,7,321647
21221,0.054397,172.31.36.0-255,66,263331,7,321647
21222,0.056748,172.253.118.0-255,5738,269069,7,321647
21223,0.056756,172.31.36.0-255,66,269135,7,321647
21224,0.059118,172.253.118.0-255,5738,274873,7,321647
21225,0.059125,172.31.36.0-255,66,274939,7,321647
21226,0.059368,172.31.36.0-255,105,275044,7,321647
21227,0.061135,157.240.13.0-255,105,275149,7,321647
21228,0.061145,172.31.36.0-255,66,275215,7,321647
21229,0.061465,172.253.118.0-255,5738,280953,7,321647
21230,0.06147,172.31.36.0-255,66,281019,7,321647
21231,0.063818,172.253.118.0-255,5738,286757,7,321647
21232,0.063824,172.31.36.0-255,66,286823,7,321647
21233,0.066181,172.253.118.0-255,5738,292561,7,321647
21234,0.066187,172.31.36.0-255,66,292627,7,321647
21235,0.068545,172.253.118.0-255,5738,298365,7,321647
21236,0.068551,172.31.36.0-255,66,298431,7,321647
21237,0.070885,172.253.118.0-255,5738,304169,7,321647
21238,0.070892,172.31.36.0-255,66,304235,7,321647
21239,0.073232,172.253.118.0-255,5738,309973,7,321647
21240,0.073239,172.31.36.0-255,66,310039,7,321647
21241,0.075568,172.253.118.0-255,5738,315777,7,321647
21242,0.075575,172.31.36.0-255,66,315843,7,321647
21243,0.077919,172.253.118.0-255,5738,321581,7,321647
21244,0.077926,172.31.36.0-255,66,321647,7,321647
21245,0.0,74.125.68.0-255,153,153,7,301760
21246,1.5e-05,172.31.36.0-255,66,219,7,301760
21247,3.6e-05,74.125.68.0-255,1484,1703,7,301760
21248,4e-05,172.31.36.0-255,66,1769,7,301760
21249,5.7e-05,74.125.68.0-255,2902,4671,7,301760
21250,6e-05,172.31.36.0-255,66,4737,7,301760
21251,8.6e-05,74.125.68.0-255,4320,9057,7,301760
21252,8.9e-05,172.31.36.0-255,66,9123,7,301760
21253,9.5e-05,74.125.68.0-255,4837,13960,7,301760
21254,9.8e-05,172.31.36.0-255,66,14026,7,301760
21255,0.000207,74.125.68.0-255,1484,15510,7,301760
21256,0.000211,172.31.36.0-255,66,15576,7,301760
21257,0.000218,74.125.68.0-255,2902,18478,7,301760
21258,0.00022,172.31.36.0-255,66,18544,7,301760
21259,0.000223,74.125.68.0-255,1484,20028,7,301760
21260,0.000225,172.31.36.0-255,66,20094,7,301760
21261,0.00025,74.125.68.0-255,2902,22996,7,301760
21262,0.000253,172.31.36.0-255,66,23062,7,301760
21263,0.000279,74.125.68.0-255,5738,28800,7,301760
21264,0.000281,172.31.36.0-255,66,28866,7,301760
21265,0.000286,74.125.68.0-255,2543,31409,7,301760
21266,0.000288,172.31.36.0-255,66,31475,7,301760
21267,0.000291,74.125.68.0-255,1484,32959,7,301760
21268,0.000294,172.31.36.0-255,66,33025,7,301760
21269,0.000315,74.125.68.0-255,1484,34509,7,301760
21270,0.000317,172.31.36.0-255,66,34575,7,301760
21271,0.000335,74.125.68.0-255,5738,40313,7,301760
21272,0.000338,172.31.36.0-255,66,40379,7,301760
21273,0.000355,74.125.68.0-255,1484,41863,7,301760
21274,0.000358,172.31.36.0-255,66,41929,7,301760
21275,0.000364,74.125.68.0-255,5738,47667,7,301760
21276,0.000367,172.31.36.0-255,66,47733,7,301760
21277,0.000386,74.125.68.0-255,4320,52053,7,301760
21278,0.000389,172.31.36.0-255,66,52119,7,301760
21279,0.000421,172.31.36.0-255,66,52185,7,301760
21280,0.000427,74.125.68.0-255,3602,55787,7,301760
21281,0.000428,172.31.36.0-255,66,55853,7,301760
21282,0.000474,74.125.68.0-255,401,56254,7,301760
21283,0.000605,74.125.68.0-255,342,56596,7,301760
21284,0.000867,74.125.68.0-255,1484,58080,7,301760
21285,0.000872,172.31.36.0-255,66,58146,7,301760
21286,0.000891,74.125.68.0-255,2902,61048,7,301760
21287,0.000894,172.31.36.0-255,66,61114,7,301760
21288,0.000897,74.125.68.0-255,1484,62598,7,301760
21289,0.000916,74.125.68.0-255,2902,65500,7,301760
21290,0.00092,172.31.36.0-255,66,65566,7,301760
21291,0.000954,74.125.68.0-255,5738,71304,7,301760
21292,0.000957,172.31.36.0-255,66,71370,7,301760
21293,0.000974,74.125.68.0-255,2902,74272,7,301760
21294,0.000977,172.31.36.0-255,66,74338,7,301760
21295,0.001003,74.125.68.0-255,4320,78658,7,301760
21296,0.001005,172.31.36.0-255,66,78724,7,301760
21297,0.001013,74.125.68.0-255,7156,85880,7,301760
21298,0.001015,172.31.36.0-255,66,85946,7,301760
21299,0.001047,74.125.68.0-255,1484,87430,7,301760
21300,0.001076,74.125.68.0-255,3602,91032,7,301760
21301,0.00108,172.31.36.0-255,66,91098,7,301760
21302,0.001551,74.125.68.0-255,1484,92582,7,301760
21303,0.001571,74.125.68.0-255,2902,95484,7,301760
21304,0.001576,172.31.36.0-255,66,95550,7,301760
21305,0.001584,74.125.68.0-255,5738,101288,7,301760
21306,0.001586,172.31.36.0-255,66,101354,7,301760
21307,0.001618,74.125.68.0-255,2902,104256,7,301760
21308,0.001621,172.31.36.0-255,66,104322,7,301760
21309,0.001653,172.31.36.0-255,66,104388,7,301760
21310,0.00167,74.125.68.0-255,1484,105872,7,301760
21311,0.001706,172.31.36.0-255,66,105938,7,301760
21312,0.003996,74.125.68.0-255,5738,111676,7,301760
21313,0.004002,172.31.36.0-255,66,111742,7,301760
21314,0.006315,74.125.68.0-255,5738,117480,7,301760
21315,0.00632,172.31.36.0-255,66,117546,7,301760
21316,0.008604,74.125.68.0-255,5738,123284,7,301760
21317,0.00861,172.31.36.0-255,66,123350,7,301760
21318,0.010902,74.125.68.0-255,5738,129088,7,301760
21319,0.01091,172.31.36.0-255,66,129154,7,301760
21320,0.01323,74.125.68.0-255,5738,134892,7,301760
21321,0.013238,172.31.36.0-255,66,134958,7,301760
21322,0.015531,74.125.68.0-255,5738,140696,7,301760
21323,0.015542,172.31.36.0-255,66,140762,7,301760
21324,0.017832,74.125.68.0-255,5738,146500,7,301760
21325,0.017844,172.31.36.0-255,66,146566,7,301760
21326,0.020161,74.125.68.0-255,5738,152304,7,301760
21327,0.020172,172.31.36.0-255,66,152370,7,301760
21328,0.022475,74.125.68.0-255,5738,158108,7,301760
21329,0.022484,172.31.36.0-255,66,158174,7,301760
21330,0.024772,74.125.68.0-255,5738,163912,7,301760
21331,0.024779,172.31.36.0-255,66,163978,7,301760
21332,0.025925,172.31.36.0-255,172,164150,7,301760
21333,0.02596,172.31.36.0-255,1114,165264,7,301760
21334,0.026018,172.31.36.0-255,1514,166778,7,301760
21335,0.026019,172.31.36.0-255,1292,168070,7,301760
21336,0.027068,74.125.68.0-255,5738,173808,7,301760
21337,0.027075,172.31.36.0-255,66,173874,7,301760
21338,0.027455,104.244.42.0-255,66,173940,7,301760
21339,0.027483,104.244.42.0-255,66,174006,7,301760
21340,0.027561,104.244.42.0-255,66,174072,7,301760
21341,0.029369,74.125.68.0-255,5738,179810,7,301760
21342,0.029375,172.31.36.0-255,66,179876,7,301760
21343,0.031684,74.125.68.0-255,5738,185614,7,301760
21344,0.03169,172.31.36.0-255,66,185680,7,301760
21345,0.03399,74.125.68.0-255,5738,191418,7,301760
21346,0.033997,172.31.36.0-255,66,191484,7,301760
21347,0.036304,74.125.68.0-255,5738,197222,7,301760
21348,0.03631,172.31.36.0-255,66,197288,7,301760
21349,0.03861,74.125.68.0-255,5738,203026,7,301760
21350,0.038617,172.31.36.0-255,66,203092,7,301760
21351,0.04092,74.125.68.0-255,5738,208830,7,301760
21352,0.040926,172.31.36.0-255,66,208896,7,301760
21353,0.043234,74.125.68.0-255,5738,214634,7,301760
21354,0.043244,172.31.36.0-255,66,214700,7,301760
21355,0.045528,74.125.68.0-255,5738,220438,7,301760
21356,0.045535,172.31.36.0-255,66,220504,7,301760
21357,0.047838,74.125.68.0-255,5738,226242,7,301760
21358,0.047844,172.31.36.0-255,66,226308,7,301760
21359,0.050128,74.125.68.0-255,5738,232046,7,301760
21360,0.050134,172.31.36.0-255,66,232112,7,301760
21361,0.052425,74.125.68.0-255,5738,237850,7,301760
21362,0.05243,172.31.36.0-255,66,237916,7,301760
21363,0.054723,74.125.68.0-255,5738,243654,7,301760
21364,0.054729,172.31.36.0-255,66,243720,7,301760
21365,0.057021,74.125.68.0-255,5738,249458,7,301760
21366,0.057026,172.31.36.0-255,66,249524,7,301760
21367,0.059324,74.125.68.0-255,5738,255262,7,301760
21368,0.059329,172.31.36.0-255,66,255328,7,301760
21369,0.061627,74.125.68.0-255,5738,261066,7,301760
21370,0.061632,172.31.36.0-255,66,261132,7,301760
21371,0.063908,74.125.68.0-255,5738,266870,7,301760
21372,0.063914,172.31.36.0-255,66,266936,7,301760
21373,0.06627,74.125.68.0-255,5738,272674,7,301760
21374,0.066275,172.31.36.0-255,66,272740,7,301760
21375,0.068567,74.125.68.0-255,5738,278478,7,301760
21376,0.068573,172.31.36.0-255,66,278544,7,301760
21377,0.070851,74.125.68.0-255,5738,284282,7,301760
21378,0.070857,172.31.36.0-255,66,284348,7,301760
21379,0.073159,74.125.68.0-255,5738,290086,7,301760
21380,0.073165,172.31.36.0-255,66,290152,7,301760
21381,0.075437,74.125.68.0-255,5738,295890,7,301760
21382,0.075442,172.31.36.0-255,66,295956,7,301760
21383,0.077749,74.125.68.0-255,5738,301694,7,301760
21384,0.077755,172.31.36.0-255,66,301760,7,301760
21385,0.0,74.125.24.0-255,153,153,7,231598
21386,2e-05,172.31.36.0-255,66,219,7,231598
21387,2.8e-05,74.125.24.0-255,1484,1703,7,231598
21388,3.2e-05,172.31.36.0-255,66,1769,7,231598
21389,3.8e-05,74.125.24.0-255,2902,4671,7,231598
21390,4.2e-05,172.31.36.0-255,66,4737,7,231598
21391,4.5e-05,74.125.24.0-255,1484,6221,7,231598
21392,4.8e-05,172.31.36.0-255,66,6287,7,231598
21393,5.5e-05,74.125.24.0-255,5738,12025,7,231598
21394,5.9e-05,172.31.36.0-255,66,12091,7,231598
21395,7.9e-05,74.125.24.0-255,1974,14065,7,231598
21396,8.1e-05,172.31.36.0-255,66,14131,7,231598
21397,0.000141,74.125.24.0-255,1484,15615,7,231598
21398,0.000144,172.31.36.0-255,66,15681,7,231598
21399,0.000149,74.125.24.0-255,2902,18583,7,231598
21400,0.000152,172.31.36.0-255,66,18649,7,231598
21401,0.00018,74.125.24.0-255,4320,22969,7,231598
21402,0.000183,172.31.36.0-255,66,23035,7,231598
21403,0.000205,74.125.24.0-255,1484,24519,7,231598
21404,0.000207,172.31.36.0-255,66,24585,7,231598
21405,0.000215,74.125.24.0-255,6797,31382,7,231598
21406,0.000217,172.31.36.0-255,66,31448,7,231598
21407,0.000249,74.125.24.0-255,1484,32932,7,231598
21408,0.000252,172.31.36.0-255,66,32998,7,231598
21409,0.000274,74.125.24.0-255,2902,35900,7,231598
21410,0.000277,172.31.36.0-255,66,35966,7,231598
21411,0.000282,74.125.24.0-255,5738,41704,7,231598
21412,0.000284,172.31.36.0-255,66,41770,7,231598
21413,0.000319,74.125.24.0-255,7156,48926,7,231598
21414,0.000322,172.31.36.0-255,66,48992,7,231598
21415,0.000343,74.125.24.0-255,3961,52953,7,231598
21416,0.000346,172.31.36.0-255,66,53019,7,231598
21417,0.000357,172.31.36.0-255,66,53085,7,231598
21418,0.000388,74.125.24.0-255,2846,55931,7,231598
21419,0.000391,172.31.36.0-255,66,55997,7,231598
21420,0.000407,74.125.24.0-255,407,56404,7,231598
21421,0.000409,172.31.36.0-255,66,56470,7,231598
21422,0.000611,74.125.24.0-255,1484,57954,7,231598
21423,0.000615,172.31.36.0-255,66,58020,7,231598
21424,0.000622,74.125.24.0-255,2902,60922,7,231598
21425,0.000625,172.31.36.0-255,66,60988,7,231598
21426,0.000631,74.125.24.0-255,5738,66726,7,231598
21427,0.000633,172.31.36.0-255,66,66792,7,231598
21428,0.000657,74.125.24.0-255,5738,72530,7,231598
21429,0.00066,172.31.36.0-255,66,72596,7,231598
21430,0.000699,172.31.36.0-255,66,72662,7,231598
21431,0.000705,74.125.24.0-255,5020,77682,7,231598
21432,0.000708,172.31.36.0-255,66,77748,7,231598
21433,0.000918,74.125.24.0-255,1484,79232,7,231598
21434,0.000924,172.31.36.0-255,66,79298,7,231598
21435,0.00093,74.125.24.0-255,2902,82200,7,231598
21436,0.000932,172.31.36.0-255,66,82266,7,231598
21437,0.000939,74.125.24.0-255,5738,88004,7,231598
21438,0.000941,172.31.36.0-255,66,88070,7,231598
21439,0.000946,74.125.24.0-255,2902,90972,7,231598
21440,0.000948,172.31.36.0-255,66,91038,7,231598
21441,0.000967,74.125.24.0-255,1484,92522,7,231598
21442,0.00097,172.31.36.0-255,66,92588,7,231598
21443,0.000981,172.31.36.0-255,66,92654,7,231598
21444,0.000998,74.125.24.0-255,2902,95556,7,231598
21445,0.001,172.31.36.0-255,66,95622,7,231598
21446,0.001011,172.31.36.0-255,66,95688,7,231598
21447,0.001051,172.31.36.0-255,66,95754,7,231598
21448,0.001056,74.125.24.0-255,2902,98656,7,231598
21449,0.001058,172.31.36.0-255,66,98722,7,231598
21450,0.001077,74.125.24.0-255,7156,105878,7,231598
21451,0.00108,172.31.36.0-255,66,105944,7,231598
21452,0.001111,172.31.36.0-255,66,106010,7,231598
21453,0.001136,74.125.24.0-255,6438,112448,7,231598
21454,0.00114,172.31.36.0-255,66,112514,7,231598
21455,0.001197,74.125.24.0-255,1484,113998,7,231598
21456,0.0012,172.31.36.0-255,66,114064,7,231598
21457,0.001206,74.125.24.0-255,2902,116966,7,231598
21458,0.001208,172.31.36.0-255,66,117032,7,231598
21459,0.001213,74.125.24.0-255,4320,121352,7,231598
21460,0.001216,172.31.36.0-255,66,121418,7,231598
21461,0.001236,74.125.24.0-255,1484,122902,7,231598
21462,0.001239,172.31.36.0-255,66,122968,7,231598
21463,0.001253,172.31.36.0-255,66,123034,7,231598
21464,0.001259,74.125.24.0-255,5738,128772,7,231598
21465,0.001262,172.31.36.0-255,66,128838,7,231598
21466,0.001282,74.125.24.0-255,5020,133858,7,231598
21467,0.001284,172.31.36.0-255,66,133924,7,231598
21468,0.001388,74.125.24.0-255,1484,135408,7,231598
21469,0.001392,74.125.24.0-255,2902,138310,7,231598
21470,0.001432,172.31.36.0-255,66,138376,7,231598
21471,0.001435,172.31.36.0-255,66,138442,7,231598
21472,0.001451,74.125.24.0-255,5738,144180,7,231598
21473,0.001454,172.31.36.0-255,66,144246,7,231598
21474,0.001469,172.31.36.0-255,66,144312,7,231598
21475,0.001482,172.31.36.0-255,66,144378,7,231598
21476,0.001527,74.125.24.0-255,1484,145862,7,231598
21477,0.001532,74.125.24.0-255,2902,148764,7,231598
21478,0.001548,74.125.24.0-255,5738,154502,7,231598
21479,0.001562,172.31.36.0-255,66,154568,7,231598
21480,0.001568,74.125.24.0-255,4320,158888,7,231598
21481,0.001572,172.31.36.0-255,66,158954,7,231598
21482,0.001586,74.125.24.0-255,4320,163274,7,231598
21483,0.001593,74.125.24.0-255,5738,169012,7,231598
21484,0.001615,74.125.24.0-255,4320,173332,7,231598
21485,0.001623,172.31.36.0-255,66,173398,7,231598
21486,0.001634,74.125.24.0-255,5020,178418,7,231598
21487,0.00164,172.31.36.0-255,66,178484,7,231598
21488,0.001667,74.125.24.0-255,1484,179968,7,231598
21489,0.001692,74.125.24.0-255,2902,182870,7,231598
21490,0.001698,74.125.24.0-255,4320,187190,7,231598
21491,0.001713,74.125.24.0-255,1484,188674,7,231598
21492,0.001718,74.125.24.0-255,4320,192994,7,231598
21493,0.001721,172.31.36.0-255,66,193060,7,231598
21494,0.001726,172.31.36.0-255,66,193126,7,231598
21495,0.001762,74.125.24.0-255,1484,194610,7,231598
21496,0.001772,172.31.36.0-255,66,194676,7,231598
21497,0.001786,74.125.24.0-255,6438,201114,7,231598
21498,0.001811,172.31.36.0-255,66,201180,7,231598
21499,0.001899,74.125.24.0-255,1484,202664,7,231598
21500,0.001905,74.125.24.0-255,2902,205566,7,231598
21501,0.001913,172.31.36.0-255,66,205632,7,231598
21502,0.001933,74.125.24.0-255,4320,209952,7,231598
21503,0.001946,172.31.36.0-255,66,210018,7,231598
21504,0.002017,74.125.24.0-255,1484,211502,7,231598
21505,0.002031,74.125.24.0-255,5738,217240,7,231598
21506,0.002037,172.31.36.0-255,66,217306,7,231598
21507,0.002054,74.125.24.0-255,1484,218790,7,231598
21508,0.002058,172.31.36.0-255,66,218856,7,231598
21509,0.002125,172.31.36.0-255,66,218922,7,231598
21510,0.002165,74.125.24.0-255,4320,223242,7,231598
21511,0.00217,172.31.36.0-255,66,223308,7,231598
21512,0.002218,74.125.24.0-255,3658,226966,7,231598
21513,0.00222,74.125.24.0-255,105,227071,7,231598
21514,0.002232,172.31.36.0-255,66,227137,7,231598
21515,0.00893,172.31.36.0-255,105,227242,7,231598
21516,0.011219,74.125.24.0-255,66,227308,7,231598
21517,0.034966,172.31.36.0-255,172,227480,7,231598
21518,0.034998,172.31.36.0-255,1114,228594,7,231598
21519,0.035058,172.31.36.0-255,1514,230108,7,231598
21520,0.03506,172.31.36.0-255,1292,231400,7,231598
21521,0.036514,104.244.42.0-255,66,231466,7,231598
21522,0.036544,104.244.42.0-255,66,231532,7,231598
21523,0.036644,104.244.42.0-255,66,231598,7,231598
21524,0.0,74.125.130.0-255,153,153,7,409455
21525,2.7e-05,172.31.36.0-255,66,219,7,409455
21526,3.4e-05,74.125.130.0-255,1484,1703,7,409455
21527,3.9e-05,172.31.36.0-255,66,1769,7,409455
21528,4.5e-05,74.125.130.0-255,2902,4671,7,409455
21529,5.6e-05,172.31.36.0-255,66,4737,7,409455
21530,6e-05,74.125.130.0-255,1484,6221,7,409455
21531,6.2e-05,172.31.36.0-255,66,6287,7,409455
21532,6.7e-05,74.125.130.0-255,2902,9189,7,409455
21533,6.9e-05,172.31.36.0-255,66,9255,7,409455
21534,0.000122,74.125.130.0-255,4811,14066,7,409455
21535,0.000127,172.31.36.0-255,66,14132,7,409455
21536,0.000403,74.125.130.0-255,1484,15616,7,409455
21537,0.000409,172.31.36.0-255,66,15682,7,409455
21538,0.000438,74.125.130.0-255,1484,17166,7,409455
21539,0.000441,172.31.36.0-255,66,17232,7,409455
21540,0.000464,74.125.130.0-255,1484,18716,7,409455
21541,0.000467,172.31.36.0-255,66,18782,7,409455
21542,0.000474,74.125.130.0-255,5738,24520,7,409455
21543,0.000476,172.31.36.0-255,66,24586,7,409455
21544,0.00051,74.125.130.0-255,6797,31383,7,409455
21545,0.000513,172.31.36.0-255,66,31449,7,409455
21546,0.000944,74.125.130.0-255,1484,32933,7,409455
21547,0.00095,172.31.36.0-255,66,32999,7,409455
21548,0.000959,74.125.130.0-255,2902,35901,7,409455
21549,0.000961,172.31.36.0-255,66,35967,7,409455
21550,0.000971,74.125.130.0-255,1484,37451,7,409455
21551,0.000974,172.31.36.0-255,66,37517,7,409455
21552,0.000991,74.125.130.0-255,1484,39001,7,409455
21553,0.000994,172.31.36.0-255,66,39067,7,409455
21554,0.001021,74.125.130.0-255,1484,40551,7,409455
21555,0.001024,172.31.36.0-255,66,40617,7,409455
21556,0.001036,74.125.130.0-255,5738,46355,7,409455
21557,0.001038,172.31.36.0-255,66,46421,7,409455
21558,0.001042,74.125.130.0-255,2543,48964,7,409455
21559,0.001044,172.31.36.0-255,66,49030,7,409455
21560,0.00105,74.125.130.0-255,2902,51932,7,409455
21561,0.001053,172.31.36.0-255,66,51998,7,409455
21562,0.001058,74.125.130.0-255,2902,54900,7,409455
21563,0.00106,172.31.36.0-255,66,54966,7,409455
21564,0.0011,74.125.130.0-255,4320,59286,7,409455
21565,0.001104,172.31.36.0-255,66,59352,7,409455
21566,0.001107,74.125.130.0-255,1484,60836,7,409455
21567,0.001109,172.31.36.0-255,66,60902,7,409455
21568,0.001114,74.125.130.0-255,2902,63804,7,409455
21569,0.001128,74.125.130.0-255,2832,66636,7,409455
21570,0.001155,74.125.130.0-255,366,67002,7,409455
21571,0.001361,74.125.130.0-255,1484,68486,7,409455
21572,0.00138,74.125.130.0-255,2902,71388,7,409455
21573,0.001397,74.125.130.0-255,5738,77126,7,409455
21574,0.001423,74.125.130.0-255,1484,78610,7,409455
21575,0.001437,74.125.130.0-255,2902,81512,7,409455
21576,0.001452,74.125.130.0-255,2902,84414,7,409455
21577,0.001465,74.125.130.0-255,2543,86957,7,409455
21578,0.001487,74.125.130.0-255,7156,94113,7,409455
21579,0.001529,74.125.130.0-255,6797,100910,7,409455
21580,0.001869,74.125.130.0-255,1484,102394,7,409455
21581,0.001884,74.125.130.0-255,2902,105296,7,409455
21582,0.001895,74.125.130.0-255,1484,106780,7,409455
21583,0.001915,74.125.130.0-255,4320,111100,7,409455
21584,0.001935,74.125.130.0-255,4320,115420,7,409455
21585,0.001952,74.125.130.0-255,2902,118322,7,409455
21586,0.001973,74.125.130.0-255,5738,124060,7,409455
21587,0.001995,74.125.130.0-255,2902,126962,7,409455
21588,0.001997,74.125.130.0-255,1484,128446,7,409455
21589,0.002036,74.125.130.0-255,6438,134884,7,409455
21590,0.002129,74.125.130.0-255,1484,136368,7,409455
21591,0.002142,74.125.130.0-255,2902,139270,7,409455
21592,0.002171,74.125.130.0-255,5738,145008,7,409455
21593,0.002186,74.125.130.0-255,2902,147910,7,409455
21594,0.002197,74.125.130.0-255,1484,149394,7,409455
21595,0.00221,74.125.130.0-255,2902,152296,7,409455
21596,0.002224,74.125.130.0-255,2902,155198,7,409455
21597,0.002227,74.125.130.0-255,1484,156682,7,409455
21598,0.002245,74.125.130.0-255,2902,159584,7,409455
21599,0.002256,74.125.130.0-255,2902,162486,7,409455
21600,0.002272,74.125.130.0-255,2902,165388,7,409455
21601,0.002285,74.125.130.0-255,3602,168990,7,409455
21602,0.002615,74.125.130.0-255,1484,170474,7,409455
21603,0.002639,74.125.130.0-255,1484,171958,7,409455
21604,0.002657,74.125.130.0-255,2902,174860,7,409455
21605,0.002682,74.125.130.0-255,1484,176344,7,409455
21606,0.002696,74.125.130.0-255,4320,180664,7,409455
21607,0.002716,74.125.130.0-255,2902,183566,7,409455
21608,0.002729,74.125.130.0-255,4320,187886,7,409455
21609,0.002751,74.125.130.0-255,5738,193624,7,409455
21610,0.002756,74.125.130.0-255,4320,197944,7,409455
21611,0.002774,74.125.130.0-255,2902,200846,7,409455
21612,0.002788,74.125.130.0-255,2184,203030,7,409455
21613,0.003327,74.125.130.0-255,1484,204514,7,409455
21614,0.00334,74.125.130.0-255,1484,205998,7,409455
21615,0.00336,74.125.130.0-255,2902,208900,7,409455
21616,0.003398,74.125.130.0-255,5738,214638,7,409455
21617,0.003434,74.125.130.0-255,1484,216122,7,409455
21618,0.003445,74.125.130.0-255,1484,217606,7,409455
21619,0.003448,74.125.130.0-255,1484,219090,7,409455
21620,0.003465,74.125.130.0-255,1484,220574,7,409455
21621,0.003482,74.125.130.0-255,1484,222058,7,409455
21622,0.003537,74.125.130.0-255,1484,223542,7,409455
21623,0.00354,74.125.130.0-255,1484,225026,7,409455
21624,0.003544,74.125.130.0-255,2902,227928,7,409455
21625,0.003562,74.125.130.0-255,1484,229412,7,409455
21626,0.003575,74.125.130.0-255,1484,230896,7,409455
21627,0.00359,74.125.130.0-255,1484,232380,7,409455
21628,0.003617,74.125.130.0-255,4320,236700,7,409455
21629,0.003641,74.125.130.0-255,766,237466,7,409455
21630,0.003659,74.125.130.0-255,1484,238950,7,409455
21631,0.003678,74.125.130.0-255,2902,241852,7,409455
21632,0.003688,74.125.130.0-255,1484,243336,7,409455
21633,0.003697,74.125.130.0-255,1484,244820,7,409455
21634,0.003714,74.125.130.0-255,1484,246304,7,409455
21635,0.003727,74.125.130.0-255,1484,247788,7,409455
21636,0.003756,74.125.130.0-255,5738,253526,7,409455
21637,0.003773,74.125.130.0-255,5738,259264,7,409455
21638,0.003789,74.125.130.0-255,1484,260748,7,409455
21639,0.003801,74.125.130.0-255,2902,263650,7,409455
21640,0.003817,74.125.130.0-255,2902,266552,7,409455
21641,0.003861,74.125.130.0-255,5020,271572,7,409455
21642,0.00389,74.125.130.0-255,5738,277310,7,409455
21643,0.003904,74.125.130.0-255,1484,278794,7,409455
21644,0.003929,74.125.130.0-255,2902,281696,7,409455
21645,0.003933,172.31.36.0-255,66,281762,7,409455
21646,0.00394,172.31.36.0-255,66,281828,7,409455
21647,0.003969,74.125.130.0-255,5738,287566,7,409455
21648,0.00398,74.125.130.0-255,4320,291886,7,409455
21649,0.003986,74.125.130.0-255,5738,297624,7,409455
21650,0.003989,172.31.36.0-255,66,297690,7,409455
21651,0.003994,172.31.36.0-255,66,297756,7,409455
21652,0.004035,172.31.36.0-255,66,297822,7,409455
21653,0.004218,74.125.130.0-255,1484,299306,7,409455
21654,0.004225,74.125.130.0-255,2902,302208,7,409455
21655,0.00423,172.31.36.0-255,66,302274,7,409455
21656,0.00426,74.125.130.0-255,5738,308012,7,409455
21657,0.004275,172.31.36.0-255,66,308078,7,409455
21658,0.004281,74.125.130.0-255,2902,310980,7,409455
21659,0.004294,172.31.36.0-255,66,311046,7,409455
21660,0.004305,74.125.130.0-255,4320,315366,7,409455
21661,0.004315,172.31.36.0-255,66,315432,7,409455
21662,0.004315,74.125.130.0-255,4320,319752,7,409455
21663,0.004318,172.31.36.0-255,66,319818,7,409455
21664,0.004358,74.125.130.0-255,5738,325556,7,409455
21665,0.004364,172.31.36.0-255,66,325622,7,409455
21666,0.004365,74.125.130.0-255,4320,329942,7,409455
21667,0.004382,172.31.36.0-255,66,330008,7,409455
21668,0.004412,74.125.130.0-255,5020,335028,7,409455
21669,0.004422,172.31.36.0-255,66,335094,7,409455
21670,0.00445,74.125.130.0-255,4320,339414,7,409455
21671,0.004457,172.31.36.0-255,66,339480,7,409455
21672,0.004481,74.125.130.0-255,1484,340964,7,409455
21673,0.004488,74.125.130.0-255,7156,348120,7,409455
21674,0.004497,172.31.36.0-255,66,348186,7,409455
21675,0.004501,74.125.130.0-255,1484,349670,7,409455
21676,0.004529,74.125.130.0-255,5738,355408,7,409455
21677,0.004538,172.31.36.0-255,66,355474,7,409455
21678,0.004544,172.31.36.0-255,66,355540,7,409455
21679,0.004576,74.125.130.0-255,2184,357724,7,409455
21680,0.004582,74.125.130.0-255,2902,360626,7,409455
21681,0.004588,172.31.36.0-255,66,360692,7,409455
21682,0.004616,74.125.130.0-255,4320,365012,7,409455
21683,0.004627,172.31.36.0-255,66,365078,7,409455
21684,0.004646,74.125.130.0-255,5738,370816,7,409455
21685,0.00465,74.125.130.0-255,1484,372300,7,409455
21686,0.004657,172.31.36.0-255,66,372366,7,409455
21687,0.004684,74.125.130.0-255,2902,375268,7,409455
21688,0.00469,74.125.130.0-255,5738,381006,7,409455
21689,0.00469,172.31.36.0-255,66,381072,7,409455
21690,0.004694,172.31.36.0-255,66,381138,7,409455
21691,0.004724,74.125.130.0-255,4320,385458,7,409455
21692,0.004729,74.125.130.0-255,2902,388360,7,409455
21693,0.00473,172.31.36.0-255,66,388426,7,409455
21694,0.004746,172.31.36.0-255,66,388492,7,409455
21695,0.004761,74.125.130.0-255,2902,391394,7,409455
21696,0.004768,74.125.130.0-255,766,392160,7,409455
21697,0.004778,172.31.36.0-255,66,392226,7,409455
21698,0.004825,74.125.130.0-255,1484,393710,7,409455
21699,0.00484,74.125.130.0-255,2902,396612,7,409455
21700,0.004848,172.31.36.0-255,66,396678,7,409455
21701,0.004874,74.125.130.0-255,2902,399580,7,409455
21702,0.004879,74.125.130.0-255,4320,403900,7,409455
21703,0.004885,172.31.36.0-255,66,403966,7,409455
21704,0.004893,74.125.130.0-255,858,404824,7,409455
21705,0.004959,74.125.130.0-255,105,404929,7,409455
21706,0.007102,172.31.36.0-255,66,404995,7,409455
21707,0.007129,172.31.36.0-255,105,405100,7,409455
21708,0.009551,74.125.130.0-255,66,405166,7,409455
21709,0.025902,172.31.36.0-255,171,405337,7,409455
21710,0.025946,172.31.36.0-255,1140,406477,7,409455
21711,0.026024,172.31.36.0-255,1514,407991,7,409455
21712,0.026026,172.31.36.0-255,1266,409257,7,409455
21713,0.02747,104.244.42.0-255,66,409323,7,409455
21714,0.027653,104.244.42.0-255,66,409389,7,409455
21715,0.027706,104.244.42.0-255,66,409455,7,409455
21716,0.0,172.217.194.0-255,143,143,7,218215
21717,1.7e-05,172.31.36.0-255,66,209,7,218215
21718,2.5e-05,172.217.194.0-255,1484,1693,7,218215
21719,3e-05,172.31.36.0-255,66,1759,7,218215
21720,3.5e-05,172.217.194.0-255,2902,4661,7,218215
21721,3.8e-05,172.31.36.0-255,66,4727,7,218215
21722,4.6e-05,172.217.194.0-255,7156,11883,7,218215
21723,4.9e-05,172.31.36.0-255,66,11949,7,218215
21724,7.5e-05,172.31.36.0-255,66,12015,7,218215
21725,0.000101,172.217.194.0-255,3564,15579,7,218215
21726,0.000104,172.31.36.0-255,66,15645,7,218215
21727,0.000109,172.217.194.0-255,2543,18188,7,218215
21728,0.000111,172.31.36.0-255,66,18254,7,218215
21729,0.000133,172.217.194.0-255,1484,19738,7,218215
21730,0.000136,172.31.36.0-255,66,19804,7,218215
21731,0.000152,172.217.194.0-255,2902,22706,7,218215
21732,0.000155,172.31.36.0-255,66,22772,7,218215
21733,0.000158,172.217.194.0-255,1484,24256,7,218215
21734,0.00016,172.31.36.0-255,66,24322,7,218215
21735,0.00018,172.217.194.0-255,2902,27224,7,218215
21736,0.000182,172.31.36.0-255,66,27290,7,218215
21737,0.0002,172.217.194.0-255,7156,34446,7,218215
21738,0.000203,172.31.36.0-255,66,34512,7,218215
21739,0.000228,172.217.194.0-255,2543,37055,7,218215
21740,0.000231,172.31.36.0-255,66,37121,7,218215
21741,0.000244,172.31.36.0-255,66,37187,7,218215
21742,0.000263,172.217.194.0-255,1484,38671,7,218215
21743,0.000265,172.31.36.0-255,66,38737,7,218215
21744,0.000284,172.217.194.0-255,2795,41532,7,218215
21745,0.000287,172.31.36.0-255,66,41598,7,218215
21746,0.000289,172.217.194.0-255,120,41718,7,218215
21747,0.00032,172.217.194.0-255,1484,43202,7,218215
21748,0.000323,172.31.36.0-255,66,43268,7,218215
21749,0.000342,172.217.194.0-255,2902,46170,7,218215
21750,0.000345,172.31.36.0-255,66,46236,7,218215
21751,0.000354,172.217.194.0-255,7156,53392,7,218215
21752,0.000356,172.31.36.0-255,66,53458,7,218215
21753,0.000383,172.217.194.0-255,7156,60614,7,218215
21754,0.000385,172.31.36.0-255,66,60680,7,218215
21755,0.000409,172.31.36.0-255,66,60746,7,218215
21756,0.000412,172.217.194.0-255,1484,62230,7,218215
21757,0.00043,172.217.194.0-255,1484,63714,7,218215
21758,0.000432,172.31.36.0-255,66,63780,7,218215
21759,0.000454,172.217.194.0-255,3917,67697,7,218215
21760,0.000457,172.31.36.0-255,66,67763,7,218215
21761,0.000692,172.217.194.0-255,1484,69247,7,218215
21762,0.000699,172.217.194.0-255,2902,72149,7,218215
21763,0.000702,172.31.36.0-255,66,72215,7,218215
21764,0.000711,172.217.194.0-255,5738,77953,7,218215
21765,0.000713,172.31.36.0-255,66,78019,7,218215
21766,0.000753,172.31.36.0-255,66,78085,7,218215
21767,0.000785,172.217.194.0-255,5738,83823,7,218215
21768,0.000788,172.31.36.0-255,66,83889,7,218215
21769,0.000814,172.31.36.0-255,66,83955,7,218215
21770,0.000837,172.217.194.0-255,4320,88275,7,218215
21771,0.00084,172.31.36.0-255,66,88341,7,218215
21772,0.000862,172.31.36.0-255,66,88407,7,218215
21773,0.000865,172.217.194.0-255,1484,89891,7,218215
21774,0.000883,172.217.194.0-255,4320,94211,7,218215
21775,0.000886,172.31.36.0-255,66,94277,7,218215
21776,0.000919,172.31.36.0-255,66,94343,7,218215
21777,0.000921,172.217.194.0-255,766,95109,7,218215
21778,0.000956,172.31.36.0-255,66,95175,7,218215
21779,0.000976,172.217.194.0-255,2543,97718,7,218215
21780,0.000979,172.31.36.0-255,66,97784,7,218215
21781,0.000984,172.217.194.0-255,2902,100686,7,218215
21782,0.000986,172.31.36.0-255,66,100752,7,218215
21783,0.001018,172.217.194.0-255,7156,107908,7,218215
21784,0.001022,172.31.36.0-255,66,107974,7,218215
21785,0.001041,172.217.194.0-255,2902,110876,7,218215
21786,0.001044,172.31.36.0-255,66,110942,7,218215
21787,0.001065,172.217.194.0-255,3961,114903,7,218215
21788,0.001067,172.31.36.0-255,66,114969,7,218215
21789,0.001116,172.217.194.0-255,1484,116453,7,218215
21790,0.001121,172.217.194.0-255,1484,117937,7,218215
21791,0.001124,172.31.36.0-255,66,118003,7,218215
21792,0.001135,172.217.194.0-255,1484,119487,7,218215
21793,0.00118,172.217.194.0-255,4320,123807,7,218215
21794,0.001189,172.31.36.0-255,66,123873,7,218215
21795,0.001193,172.217.194.0-255,1484,125357,7,218215
21796,0.001206,172.31.36.0-255,66,125423,7,218215
21797,0.001219,172.31.36.0-255,66,125489,7,218215
21798,0.00145,172.217.194.0-255,1484,126973,7,218215
21799,0.001455,172.217.194.0-255,2902,129875,7,218215
21800,0.001459,172.31.36.0-255,66,129941,7,218215
21801,0.001463,172.217.194.0-255,1484,131425,7,218215
21802,0.001497,172.217.194.0-255,4320,135745,7,218215
21803,0.0015,172.31.36.0-255,66,135811,7,218215
21804,0.001519,172.31.36.0-255,66,135877,7,218215
21805,0.001526,172.217.194.0-255,5738,141615,7,218215
21806,0.001529,172.31.36.0-255,66,141681,7,218215
21807,0.001552,172.217.194.0-255,2902,144583,7,218215
21808,0.001555,172.31.36.0-255,66,144649,7,218215
21809,0.001559,172.217.194.0-255,2184,146833,7,218215
21810,0.001632,172.217.194.0-255,1484,148317,7,218215
21811,0.001646,172.217.194.0-255,2902,151219,7,218215
21812,0.001662,172.217.194.0-255,2902,154121,7,218215
21813,0.001675,172.217.194.0-255,2902,157023,7,218215
21814,0.001719,172.217.194.0-255,7156,164179,7,218215
21815,0.001733,172.217.194.0-255,3602,167781,7,218215
21816,0.001793,172.217.194.0-255,1484,169265,7,218215
21817,0.001813,172.217.194.0-255,2902,172167,7,218215
21818,0.00182,172.217.194.0-255,5738,177905,7,218215
21819,0.00184,172.217.194.0-255,2902,180807,7,218215
21820,0.001872,172.217.194.0-255,4320,185127,7,218215
21821,0.001888,172.217.194.0-255,6438,191565,7,218215
21822,0.001946,172.217.194.0-255,7156,198721,7,218215
21823,0.001991,172.217.194.0-255,7156,205877,7,218215
21824,0.002029,172.217.194.0-255,5020,210897,7,218215
21825,0.002056,172.217.194.0-255,3647,214544,7,218215
21826,0.002106,172.217.194.0-255,105,214649,7,218215
21827,0.005543,172.31.36.0-255,66,214715,7,218215
21828,0.008381,172.31.36.0-255,105,214820,7,218215
21829,0.010635,172.217.194.0-255,66,214886,7,218215
21830,0.032231,172.31.36.0-255,172,215058,7,218215
21831,0.032273,172.31.36.0-255,1114,216172,7,218215
21832,0.032334,172.31.36.0-255,1514,217686,7,218215
21833,0.032336,172.31.36.0-255,331,218017,7,218215
21834,0.033782,104.244.42.0-255,66,218083,7,218215
21835,0.03382,104.244.42.0-255,66,218149,7,218215
21836,0.033867,104.244.42.0-255,66,218215,7,218215
21837,0.0,74.125.68.0-255,153,153,7,368054
21838,3.4e-05,172.31.36.0-255,66,219,7,368054
21839,4.1e-05,74.125.68.0-255,1484,1703,7,368054
21840,4.6e-05,172.31.36.0-255,66,1769,7,368054
21841,5.1e-05,74.125.68.0-255,2902,4671,7,368054
21842,5.4e-05,172.31.36.0-255,66,4737,7,368054
21843,6e-05,74.125.68.0-255,5738,10475,7,368054
21844,6.3e-05,172.31.36.0-255,66,10541,7,368054
21845,6.6e-05,74.125.68.0-255,1484,12025,7,368054
21846,6.8e-05,172.31.36.0-255,66,12091,7,368054
21847,9.1e-05,74.125.68.0-255,2086,14177,7,368054
21848,9.3e-05,172.31.36.0-255,66,14243,7,368054
21849,0.000142,74.125.68.0-255,1484,15727,7,368054
21850,0.000146,172.31.36.0-255,66,15793,7,368054
21851,0.00015,74.125.68.0-255,1484,17277,7,368054
21852,0.000152,172.31.36.0-255,66,17343,7,368054
21853,0.000166,74.125.68.0-255,1484,18827,7,368054
21854,0.000171,172.31.36.0-255,66,18893,7,368054
21855,0.000174,74.125.68.0-255,1484,20377,7,368054
21856,0.000177,172.31.36.0-255,66,20443,7,368054
21857,0.000181,74.125.68.0-255,2902,23345,7,368054
21858,0.000184,172.31.36.0-255,66,23411,7,368054
21859,0.00021,74.125.68.0-255,5738,29149,7,368054
21860,0.000212,172.31.36.0-255,66,29215,7,368054
21861,0.000217,74.125.68.0-255,2543,31758,7,368054
21862,0.000219,172.31.36.0-255,66,31824,7,368054
21863,0.000357,74.125.68.0-255,1484,33308,7,368054
21864,0.000362,172.31.36.0-255,66,33374,7,368054
21865,0.000378,74.125.68.0-255,2902,36276,7,368054
21866,0.000381,172.31.36.0-255,66,36342,7,368054
21867,0.000385,74.125.68.0-255,1484,37826,7,368054
21868,0.000387,172.31.36.0-255,66,37892,7,368054
21869,0.000408,74.125.68.0-255,2902,40794,7,368054
21870,0.000412,172.31.36.0-255,66,40860,7,368054
21871,0.000433,74.125.68.0-255,5738,46598,7,368054
21872,0.000442,172.31.36.0-255,66,46664,7,368054
21873,0.000448,74.125.68.0-255,3961,50625,7,368054
21874,0.00045,172.31.36.0-255,66,50691,7,368054
21875,0.000484,172.31.36.0-255,66,50757,7,368054
21876,0.000488,74.125.68.0-255,2902,53659,7,368054
21877,0.000491,172.31.36.0-255,66,53725,7,368054
21878,0.000507,74.125.68.0-255,2814,56539,7,368054
21879,0.000509,172.31.36.0-255,66,56605,7,368054
21880,0.000513,74.125.68.0-255,126,56731,7,368054
21881,0.000669,74.125.68.0-255,1484,58215,7,368054
21882,0.000674,172.31.36.0-255,66,58281,7,368054
21883,0.00069,74.125.68.0-255,2902,61183,7,368054
21884,0.000693,172.31.36.0-255,66,61249,7,368054
21885,0.000696,74.125.68.0-255,1484,62733,7,368054
21886,0.000716,74.125.68.0-255,4320,67053,7,368054
21887,0.000719,172.31.36.0-255,66,67119,7,368054
21888,0.000737,74.125.68.0-255,6797,73916,7,368054
21889,0.00074,172.31.36.0-255,66,73982,7,368054
21890,0.000759,74.125.68.0-255,4320,78302,7,368054
21891,0.000762,172.31.36.0-255,66,78368,7,368054
21892,0.000785,74.125.68.0-255,2902,81270,7,368054
21893,0.00079,172.31.36.0-255,66,81336,7,368054
21894,0.000795,172.31.36.0-255,66,81402,7,368054
21895,0.001227,74.125.68.0-255,1484,82886,7,368054
21896,0.001235,74.125.68.0-255,1484,84370,7,368054
21897,0.001239,172.31.36.0-255,66,84436,7,368054
21898,0.001245,74.125.68.0-255,2902,87338,7,368054
21899,0.001247,172.31.36.0-255,66,87404,7,368054
21900,0.001266,74.125.68.0-255,5738,93142,7,368054
21901,0.001269,172.31.36.0-255,66,93208,7,368054
21902,0.001317,74.125.68.0-255,5738,98946,7,368054
21903,0.001321,172.31.36.0-255,66,99012,7,368054
21904,0.001349,74.125.68.0-255,4320,103332,7,368054
21905,0.001352,172.31.36.0-255,66,103398,7,368054
21906,0.001364,172.31.36.0-255,66,103464,7,368054
21907,0.001367,74.125.68.0-255,766,104230,7,368054
21908,0.001398,74.125.68.0-255,1484,105714,7,368054
21909,0.001401,172.31.36.0-255,66,105780,7,368054
21910,0.001405,74.125.68.0-255,1484,107264,7,368054
21911,0.00142,74.125.68.0-255,1484,108748,7,368054
21912,0.001422,172.31.36.0-255,66,108814,7,368054
21913,0.00143,74.125.68.0-255,5738,114552,7,368054
21914,0.001432,172.31.36.0-255,66,114618,7,368054
21915,0.001436,74.125.68.0-255,2902,117520,7,368054
21916,0.001438,172.31.36.0-255,66,117586,7,368054
21917,0.001441,74.125.68.0-255,1484,119070,7,368054
21918,0.001465,74.125.68.0-255,2902,121972,7,368054
21919,0.001467,172.31.36.0-255,66,122038,7,368054
21920,0.001488,74.125.68.0-255,4320,126358,7,368054
21921,0.00149,172.31.36.0-255,66,126424,7,368054
21922,0.001509,74.125.68.0-255,4320,130744,7,368054
21923,0.001512,172.31.36.0-255,66,130810,7,368054
21924,0.001518,74.125.68.0-255,4320,135130,7,368054
21925,0.00152,172.31.36.0-255,66,135196,7,368054
21926,0.00155,74.125.68.0-255,3602,138798,7,368054
21927,0.001554,172.31.36.0-255,66,138864,7,368054
21928,0.001706,74.125.68.0-255,1484,140348,7,368054
21929,0.001712,74.125.68.0-255,2902,143250,7,368054
21930,0.001717,172.31.36.0-255,66,143316,7,368054
21931,0.001731,74.125.68.0-255,4320,147636,7,368054
21932,0.001734,172.31.36.0-255,66,147702,7,368054
21933,0.001756,74.125.68.0-255,1484,149186,7,368054
21934,0.001763,74.125.68.0-255,7156,156342,7,368054
21935,0.001766,172.31.36.0-255,66,156408,7,368054
21936,0.001771,74.125.68.0-255,2902,159310,7,368054
21937,0.001773,172.31.36.0-255,66,159376,7,368054
21938,0.001791,74.125.68.0-255,5738,165114,7,368054
21939,0.001794,172.31.36.0-255,66,165180,7,368054
21940,0.001797,74.125.68.0-255,1484,166664,7,368054
21941,0.001819,74.125.68.0-255,6438,173102,7,368054
21942,0.001821,172.31.36.0-255,66,173168,7,368054
21943,0.001994,74.125.68.0-255,1484,174652,7,368054
21944,0.002013,74.125.68.0-255,2902,177554,7,368054
21945,0.002015,172.31.36.0-255,66,177620,7,368054
21946,0.002038,74.125.68.0-255,5738,183358,7,368054
21947,0.00204,172.31.36.0-255,66,183424,7,368054
21948,0.002057,74.125.68.0-255,2902,186326,7,368054
21949,0.002059,172.31.36.0-255,66,186392,7,368054
21950,0.002091,172.31.36.0-255,66,186458,7,368054
21951,0.002108,74.125.68.0-255,1484,187942,7,368054
21952,0.002136,172.31.36.0-255,66,188008,7,368054
21953,0.002203,74.125.68.0-255,1484,189492,7,368054
21954,0.002222,74.125.68.0-255,2902,192394,7,368054
21955,0.002224,172.31.36.0-255,66,192460,7,368054
21956,0.002245,74.125.68.0-255,5738,198198,7,368054
21957,0.002247,172.31.36.0-255,66,198264,7,368054
21958,0.00228,74.125.68.0-255,5738,204002,7,368054
21959,0.002282,172.31.36.0-255,66,204068,7,368054
21960,0.002305,74.125.68.0-255,2902,206970,7,368054
21961,0.002307,172.31.36.0-255,66,207036,7,368054
21962,0.002318,172.31.36.0-255,66,207102,7,368054
21963,0.002346,74.125.68.0-255,5020,212122,7,368054
21964,0.002349,172.31.36.0-255,66,212188,7,368054
21965,0.004647,74.125.68.0-255,5738,217926,7,368054
21966,0.004655,172.31.36.0-255,66,217992,7,368054
21967,0.006935,74.125.68.0-255,5738,223730,7,368054
21968,0.006941,172.31.36.0-255,66,223796,7,368054
21969,0.009216,74.125.68.0-255,5738,229534,7,368054
21970,0.009222,172.31.36.0-255,66,229600,7,368054
21971,0.011505,74.125.68.0-255,5738,235338,7,368054
21972,0.011512,172.31.36.0-255,66,235404,7,368054
21973,0.013792,74.125.68.0-255,5738,241142,7,368054
21974,0.0138,172.31.36.0-255,66,241208,7,368054
21975,0.016116,74.125.68.0-255,5738,246946,7,368054
21976,0.016124,172.31.36.0-255,66,247012,7,368054
21977,0.018397,74.125.68.0-255,5738,252750,7,368054
21978,0.018404,172.31.36.0-255,66,252816,7,368054
21979,0.020684,74.125.68.0-255,5738,258554,7,368054
21980,0.020694,172.31.36.0-255,66,258620,7,368054
21981,0.022972,74.125.68.0-255,4320,262940,7,368054
21982,0.022981,172.31.36.0-255,66,263006,7,368054
21983,0.023013,74.125.68.0-255,1484,264490,7,368054
21984,0.025267,74.125.68.0-255,4320,268810,7,368054
21985,0.025275,172.31.36.0-255,66,268876,7,368054
21986,0.027554,74.125.68.0-255,5738,274614,7,368054
21987,0.027562,172.31.36.0-255,66,274680,7,368054
21988,0.029826,74.125.68.0-255,5738,280418,7,368054
21989,0.029835,172.31.36.0-255,66,280484,7,368054
21990,0.030198,172.31.36.0-255,172,280656,7,368054
21991,0.030227,172.31.36.0-255,1112,281768,7,368054
21992,0.030268,172.31.36.0-255,1514,283282,7,368054
21993,0.03027,172.31.36.0-255,1294,284576,7,368054
21994,0.031745,104.244.42.0-255,66,284642,7,368054
21995,0.031803,104.244.42.0-255,66,284708,7,368054
21996,0.031855,104.244.42.0-255,66,284774,7,368054
21997,0.032098,74.125.68.0-255,2902,287676,7,368054
21998,0.032102,172.31.36.0-255,66,287742,7,368054
21999,0.032137,74.125.68.0-255,2902,290644,7,368054
22000,0.032141,172.31.36.0-255,66,290710,7,368054
22001,0.034369,74.125.68.0-255,2902,293612,7,368054
22002,0.034374,172.31.36.0-255,66,293678,7,368054
22003,0.034409,74.125.68.0-255,2902,296580,7,368054
22004,0.034412,172.31.36.0-255,66,296646,7,368054
22005,0.036648,74.125.68.0-255,2902,299548,7,368054
22006,0.036653,172.31.36.0-255,66,299614,7,368054
22007,0.036683,74.125.68.0-255,2902,302516,7,368054
22008,0.036686,172.31.36.0-255,66,302582,7,368054
22009,0.038911,74.125.68.0-255,2902,305484,7,368054
22010,0.038916,172.31.36.0-255,66,305550,7,368054
22011,0.038946,74.125.68.0-255,2902,308452,7,368054
22012,0.038949,172.31.36.0-255,66,308518,7,368054
22013,0.041197,74.125.68.0-255,2902,311420,7,368054
22014,0.041203,172.31.36.0-255,66,311486,7,368054
22015,0.041236,74.125.68.0-255,2902,314388,7,368054
22016,0.04124,172.31.36.0-255,66,314454,7,368054
22017,0.043467,74.125.68.0-255,2902,317356,7,368054
22018,0.043472,172.31.36.0-255,66,317422,7,368054
22019,0.043507,74.125.68.0-255,2902,320324,7,368054
22020,0.04351,172.31.36.0-255,66,320390,7,368054
22021,0.045738,74.125.68.0-255,2902,323292,7,368054
22022,0.045743,172.31.36.0-255,66,323358,7,368054
22023,0.045776,74.125.68.0-255,2902,326260,7,368054
22024,0.04578,172.31.36.0-255,66,326326,7,368054
22025,0.047999,74.125.68.0-255,2902,329228,7,368054
22026,0.048004,172.31.36.0-255,66,329294,7,368054
22027,0.048033,74.125.68.0-255,2902,332196,7,368054
22028,0.048037,172.31.36.0-255,66,332262,7,368054
22029,0.050274,74.125.68.0-255,2902,335164,7,368054
22030,0.050279,172.31.36.0-255,66,335230,7,368054
22031,0.050312,74.125.68.0-255,2902,338132,7,368054
22032,0.050315,172.31.36.0-255,66,338198,7,368054
22033,0.052555,74.125.68.0-255,2902,341100,7,368054
22034,0.05256,172.31.36.0-255,66,341166,7,368054
22035,0.052595,74.125.68.0-255,2902,344068,7,368054
22036,0.052599,172.31.36.0-255,66,344134,7,368054
22037,0.05482,74.125.68.0-255,1484,345618,7,368054
22038,0.054858,74.125.68.0-255,2902,348520,7,368054
22039,0.054862,172.31.36.0-255,66,348586,7,368054
22040,0.054882,74.125.68.0-255,1484,350070,7,368054
22041,0.057144,74.125.68.0-255,4320,354390,7,368054
22042,0.057149,172.31.36.0-255,66,354456,7,368054
22043,0.059419,74.125.68.0-255,5738,360194,7,368054
22044,0.059429,172.31.36.0-255,66,360260,7,368054
22045,0.0617,74.125.68.0-255,5738,365998,7,368054
22046,0.061705,172.31.36.0-255,66,366064,7,368054
22047,0.063961,74.125.68.0-255,1753,367817,7,368054
22048,0.063966,172.31.36.0-255,66,367883,7,368054
22049,0.064132,172.31.36.0-255,105,367988,7,368054
22050,0.066364,74.125.68.0-255,66,368054,7,368054
22051,0.0,172.253.118.0-255,153,153,7,206608
22052,1.9e-05,172.31.36.0-255,66,219,7,206608
22053,2.6e-05,172.253.118.0-255,1484,1703,7,206608
22054,3e-05,172.31.36.0-255,66,1769,7,206608
22055,3.6e-05,172.253.118.0-255,2902,4671,7,206608
22056,4.5e-05,172.31.36.0-255,66,4737,7,206608
22057,5.3e-05,172.253.118.0-255,7156,11893,7,206608
22058,5.5e-05,172.31.36.0-255,66,11959,7,206608
22059,9e-05,172.253.118.0-255,2037,13996,7,206608
22060,9.4e-05,172.31.36.0-255,66,14062,7,206608
22061,0.000119,172.253.118.0-255,2902,16964,7,206608
22062,0.000122,172.31.36.0-255,66,17030,7,206608
22063,0.000125,172.253.118.0-255,1484,18514,7,206608
22064,0.000127,172.31.36.0-255,66,18580,7,206608
22065,0.000163,172.253.118.0-255,5738,24318,7,206608
22066,0.000166,172.31.36.0-255,66,24384,7,206608
22067,0.000191,172.253.118.0-255,6797,31181,7,206608
22068,0.000193,172.31.36.0-255,66,31247,7,206608
22069,0.000431,172.253.118.0-255,1484,32731,7,206608
22070,0.000437,172.31.36.0-255,66,32797,7,206608
22071,0.000443,172.253.118.0-255,2902,35699,7,206608
22072,0.000445,172.31.36.0-255,66,35765,7,206608
22073,0.000468,172.253.118.0-255,5738,41503,7,206608
22074,0.000471,172.31.36.0-255,66,41569,7,206608
22075,0.000477,172.253.118.0-255,4320,45889,7,206608
22076,0.000479,172.31.36.0-255,66,45955,7,206608
22077,0.000544,172.253.118.0-255,7156,53111,7,206608
22078,0.000548,172.31.36.0-255,66,53177,7,206608
22079,0.000568,172.253.118.0-255,5379,58556,7,206608
22080,0.00057,172.31.36.0-255,66,58622,7,206608
22081,0.000575,172.253.118.0-255,4320,62942,7,206608
22082,0.000579,172.31.36.0-255,66,63008,7,206608
22083,0.000584,172.253.118.0-255,2879,65887,7,206608
22084,0.000586,172.31.36.0-255,66,65953,7,206608
22085,0.000702,172.253.118.0-255,109,66062,7,206608
22086,0.000742,172.253.118.0-255,331,66393,7,206608
22087,0.001147,172.31.36.0-255,66,66459,7,206608
22088,0.001625,172.253.118.0-255,1484,67943,7,206608
22089,0.001637,172.253.118.0-255,2902,70845,7,206608
22090,0.001642,172.31.36.0-255,66,70911,7,206608
22091,0.001675,172.253.118.0-255,5738,76649,7,206608
22092,0.001678,172.31.36.0-255,66,76715,7,206608
22093,0.001704,172.31.36.0-255,66,76781,7,206608
22094,0.001709,172.253.118.0-255,2902,79683,7,206608
22095,0.001711,172.31.36.0-255,66,79749,7,206608
22096,0.00173,172.31.36.0-255,66,79815,7,206608
22097,0.001739,172.253.118.0-255,2184,81999,7,206608
22098,0.001742,172.31.36.0-255,66,82065,7,206608
22099,0.002212,172.253.118.0-255,1484,83549,7,206608
22100,0.002221,172.253.118.0-255,2902,86451,7,206608
22101,0.002225,172.31.36.0-255,66,86517,7,206608
22102,0.002229,172.253.118.0-255,1484,88001,7,206608
22103,0.002254,172.253.118.0-255,2902,90903,7,206608
22104,0.002256,172.31.36.0-255,66,90969,7,206608
22105,0.002276,172.253.118.0-255,5738,96707,7,206608
22106,0.002278,172.31.36.0-255,66,96773,7,206608
22107,0.002281,172.253.118.0-255,1484,98257,7,206608
22108,0.002307,172.253.118.0-255,2902,101159,7,206608
22109,0.002309,172.31.36.0-255,66,101225,7,206608
22110,0.002322,172.31.36.0-255,66,101291,7,206608
22111,0.002347,172.253.118.0-255,3602,104893,7,206608
22112,0.00235,172.31.36.0-255,66,104959,7,206608
22113,0.0024,172.253.118.0-255,1484,106443,7,206608
22114,0.002405,172.253.118.0-255,2902,109345,7,206608
22115,0.002408,172.31.36.0-255,66,109411,7,206608
22116,0.002434,172.253.118.0-255,5738,115149,7,206608
22117,0.002437,172.31.36.0-255,66,115215,7,206608
22118,0.002467,172.253.118.0-255,7156,122371,7,206608
22119,0.00247,172.31.36.0-255,66,122437,7,206608
22120,0.002501,172.31.36.0-255,66,122503,7,206608
22121,0.002528,172.253.118.0-255,4320,126823,7,206608
22122,0.002531,172.31.36.0-255,66,126889,7,206608
22123,0.002537,172.253.118.0-255,3602,130491,7,206608
22124,0.002539,172.31.36.0-255,66,130557,7,206608
22125,0.002605,172.253.118.0-255,1484,132041,7,206608
22126,0.002618,172.253.118.0-255,2902,134943,7,206608
22127,0.002621,172.31.36.0-255,66,135009,7,206608
22128,0.002627,172.253.118.0-255,5738,140747,7,206608
22129,0.00263,172.31.36.0-255,66,140813,7,206608
22130,0.002639,172.253.118.0-255,2902,143715,7,206608
22131,0.002641,172.31.36.0-255,66,143781,7,206608
22132,0.002644,172.253.118.0-255,1484,145265,7,206608
22133,0.002666,172.253.118.0-255,1484,146749,7,206608
22134,0.002669,172.31.36.0-255,66,146815,7,206608
22135,0.002673,172.253.118.0-255,1484,148299,7,206608
22136,0.002716,172.31.36.0-255,66,148365,7,206608
22137,0.002745,172.253.118.0-255,2184,150549,7,206608
22138,0.002748,172.31.36.0-255,66,150615,7,206608
22139,0.002853,172.253.118.0-255,1484,152099,7,206608
22140,0.002866,172.253.118.0-255,2902,155001,7,206608
22141,0.002868,172.31.36.0-255,66,155067,7,206608
22142,0.002896,172.253.118.0-255,5738,160805,7,206608
22143,0.002899,172.31.36.0-255,66,160871,7,206608
22144,0.002905,172.253.118.0-255,4320,165191,7,206608
22145,0.002907,172.31.36.0-255,66,165257,7,206608
22146,0.00296,172.31.36.0-255,66,165323,7,206608
22147,0.002971,172.31.36.0-255,66,165389,7,206608
22148,0.003224,172.253.118.0-255,1484,166873,7,206608
22149,0.00323,172.253.118.0-255,2902,169775,7,206608
22150,0.003232,172.31.36.0-255,66,169841,7,206608
22151,0.003252,172.253.118.0-255,4320,174161,7,206608
22152,0.003255,172.31.36.0-255,66,174227,7,206608
22153,0.003262,172.253.118.0-255,5738,179965,7,206608
22154,0.003264,172.31.36.0-255,66,180031,7,206608
22155,0.003303,172.31.36.0-255,66,180097,7,206608
22156,0.003315,172.31.36.0-255,66,180163,7,206608
22157,0.003317,172.253.118.0-255,1484,181647,7,206608
22158,0.00335,172.253.118.0-255,7156,188803,7,206608
22159,0.003353,172.31.36.0-255,66,188869,7,206608
22160,0.003361,172.253.118.0-255,7156,196025,7,206608
22161,0.003364,172.31.36.0-255,66,196091,7,206608
22162,0.003408,172.31.36.0-255,66,196157,7,206608
22163,0.003427,172.31.36.0-255,66,196223,7,206608
22164,0.003439,172.31.36.0-255,66,196289,7,206608
22165,0.003486,172.253.118.0-255,4320,200609,7,206608
22166,0.003489,172.31.36.0-255,66,200675,7,206608
22167,0.003538,172.31.36.0-255,66,200741,7,206608
22168,0.003557,172.31.36.0-255,66,200807,7,206608
22169,0.003577,172.31.36.0-255,66,200873,7,206608
22170,0.003589,172.31.36.0-255,66,200939,7,206608
22171,0.003636,172.31.36.0-255,66,201005,7,206608
22172,0.003687,172.253.118.0-255,105,201110,7,206608
22173,0.003691,172.253.118.0-255,129,201239,7,206608
22174,0.010699,172.31.36.0-255,105,201344,7,206608
22175,0.01076,172.31.36.0-255,105,201449,7,206608
22176,0.010983,172.31.36.0-255,90,201539,7,206608
22177,0.010994,172.31.36.0-255,66,201605,7,206608
22178,0.01227,172.253.118.0-255,129,201734,7,206608
22179,0.012284,172.31.36.0-255,78,201812,7,206608
22180,0.012744,172.253.118.0-255,66,201878,7,206608
22181,0.012808,172.253.118.0-255,66,201944,7,206608
22182,0.013006,172.253.118.0-255,66,202010,7,206608
22183,0.013046,172.253.118.0-255,66,202076,7,206608
22184,0.013051,172.31.36.0-255,66,202142,7,206608
22185,0.040488,172.31.36.0-255,172,202314,7,206608
22186,0.040523,172.31.36.0-255,1114,203428,7,206608
22187,0.040584,172.31.36.0-255,1514,204942,7,206608
22188,0.040586,172.31.36.0-255,1294,206236,7,206608
22189,0.042045,104.244.42.0-255,66,206302,7,206608
22190,0.042114,104.244.42.0-255,66,206368,7,206608
22191,0.04213,104.244.42.0-255,66,206434,7,206608
22192,0.043859,104.244.42.0-255,108,206542,7,206608
22193,0.043866,172.31.36.0-255,66,206608,7,206608
22194,0.0,172.31.36.0-255,105,105,7,276
22195,0.072629,31.13.82.0-255,105,210,7,276
22196,0.072651,172.31.36.0-255,66,276,7,276
22197,0.0,172.217.194.0-255,66,66,7,66
22198,0.0,172.217.26.0-255,153,153,7,277316
22199,1.3e-05,172.31.36.0-255,66,219,7,277316
22200,2e-05,172.217.26.0-255,1484,1703,7,277316
22201,2.4e-05,172.31.36.0-255,66,1769,7,277316
22202,3e-05,172.217.26.0-255,2902,4671,7,277316
22203,4.3e-05,172.31.36.0-255,66,4737,7,277316
22204,8e-05,172.217.26.0-255,5738,10475,7,277316
22205,8.3e-05,172.31.36.0-255,66,10541,7,277316
22206,0.000176,172.217.26.0-255,5738,16279,7,277316
22207,0.00018,172.31.36.0-255,66,16345,7,277316
22208,0.000199,172.217.26.0-255,2012,18357,7,277316
22209,0.000201,172.31.36.0-255,66,18423,7,277316
22210,0.000322,172.217.26.0-255,4320,22743,7,277316
22211,0.000328,172.31.36.0-255,66,22809,7,277316
22212,0.000364,172.31.36.0-255,66,22875,7,277316
22213,0.00053,172.217.26.0-255,5738,28613,7,277316
22214,0.000534,172.31.36.0-255,66,28679,7,277316
22215,0.000558,172.217.26.0-255,7156,35835,7,277316
22216,0.000561,172.31.36.0-255,66,35901,7,277316
22217,0.000761,172.217.26.0-255,4320,40221,7,277316
22218,0.000765,172.31.36.0-255,66,40287,7,277316
22219,0.000813,172.31.36.0-255,66,40353,7,277316
22220,0.001098,172.217.26.0-255,116,40469,7,277316
22221,0.001103,172.31.36.0-255,66,40535,7,277316
22222,0.00113,172.217.26.0-255,1484,42019,7,277316
22223,0.001133,172.31.36.0-255,66,42085,7,277316
22224,0.00115,172.217.26.0-255,2902,44987,7,277316
22225,0.001153,172.31.36.0-255,66,45053,7,277316
22226,0.0012,172.217.26.0-255,5738,50791,7,277316
22227,0.001203,172.31.36.0-255,66,50857,7,277316
22228,0.001228,172.217.26.0-255,1484,52341,7,277316
22229,0.001346,172.217.26.0-255,5379,57720,7,277316
22230,0.001607,172.217.26.0-255,6797,64517,7,277316
22231,0.001721,172.217.26.0-255,7156,71673,7,277316
22232,0.001888,172.217.26.0-255,5738,77411,7,277316
22233,0.002165,172.217.26.0-255,2184,79595,7,277316
22234,0.003218,172.217.26.0-255,5738,85333,7,277316
22235,0.003487,172.31.36.0-255,66,85399,7,277316
22236,0.005425,172.217.26.0-255,5738,91137,7,277316
22237,0.005431,172.31.36.0-255,66,91203,7,277316
22238,0.00735,172.217.26.0-255,5738,96941,7,277316
22239,0.007816,172.31.36.0-255,66,97007,7,277316
22240,0.009754,172.217.26.0-255,5738,102745,7,277316
22241,0.009761,172.31.36.0-255,66,102811,7,277316
22242,0.011692,172.217.26.0-255,5738,108549,7,277316
22243,0.011701,172.31.36.0-255,66,108615,7,277316
22244,0.013635,172.217.26.0-255,5738,114353,7,277316
22245,0.013643,172.31.36.0-255,66,114419,7,277316
22246,0.015588,172.217.26.0-255,5738,120157,7,277316
22247,0.015598,172.31.36.0-255,66,120223,7,277316
22248,0.017531,172.217.26.0-255,5738,125961,7,277316
22249,0.01754,172.31.36.0-255,66,126027,7,277316
22250,0.019469,172.217.26.0-255,5738,131765,7,277316
22251,0.019477,172.31.36.0-255,66,131831,7,277316
22252,0.02141,172.217.26.0-255,5738,137569,7,277316
22253,0.021417,172.31.36.0-255,66,137635,7,277316
22254,0.023343,172.217.26.0-255,5738,143373,7,277316
22255,0.023349,172.31.36.0-255,66,143439,7,277316
22256,0.025303,172.217.26.0-255,5738,149177,7,277316
22257,0.025309,172.31.36.0-255,66,149243,7,277316
22258,0.027241,172.217.26.0-255,5738,154981,7,277316
22259,0.027247,172.31.36.0-255,66,155047,7,277316
22260,0.029116,172.31.36.0-255,172,155219,7,277316
22261,0.029148,172.31.36.0-255,1116,156335,7,277316
22262,0.02922,172.217.26.0-255,5738,162073,7,277316
22263,0.029225,172.31.36.0-255,66,162139,7,277316
22264,0.029338,172.31.36.0-255,1514,163653,7,277316
22265,0.02934,172.31.36.0-255,1292,164945,7,277316
22266,0.030673,104.244.42.0-255,66,165011,7,277316
22267,0.030702,104.244.42.0-255,66,165077,7,277316
22268,0.030876,104.244.42.0-255,66,165143,7,277316
22269,0.031151,172.217.26.0-255,5738,170881,7,277316
22270,0.031157,172.31.36.0-255,66,170947,7,277316
22271,0.033091,172.217.26.0-255,5738,176685,7,277316
22272,0.033097,172.31.36.0-255,66,176751,7,277316
22273,0.035035,172.217.26.0-255,5738,182489,7,277316
22274,0.035041,172.31.36.0-255,66,182555,7,277316
22275,0.036991,172.217.26.0-255,5738,188293,7,277316
22276,0.036997,172.31.36.0-255,66,188359,7,277316
22277,0.038945,172.217.26.0-255,5738,194097,7,277316
22278,0.038952,172.31.36.0-255,66,194163,7,277316
22279,0.040883,172.217.26.0-255,5738,199901,7,277316
22280,0.040889,172.31.36.0-255,66,199967,7,277316
22281,0.042816,172.217.26.0-255,5738,205705,7,277316
22282,0.042823,172.31.36.0-255,66,205771,7,277316
22283,0.044766,172.217.26.0-255,5738,211509,7,277316
22284,0.044774,172.31.36.0-255,66,211575,7,277316
22285,0.046703,172.217.26.0-255,5738,217313,7,277316
22286,0.046709,172.31.36.0-255,66,217379,7,277316
22287,0.048643,172.217.26.0-255,5738,223117,7,277316
22288,0.048648,172.31.36.0-255,66,223183,7,277316
22289,0.050585,172.217.26.0-255,5738,228921,7,277316
22290,0.050592,172.31.36.0-255,66,228987,7,277316
22291,0.052527,172.217.26.0-255,5738,234725,7,277316
22292,0.052532,172.31.36.0-255,66,234791,7,277316
22293,0.054469,172.217.26.0-255,5738,240529,7,277316
22294,0.054475,172.31.36.0-255,66,240595,7,277316
22295,0.056411,172.217.26.0-255,5738,246333,7,277316
22296,0.056417,172.31.36.0-255,66,246399,7,277316
22297,0.058352,172.217.26.0-255,5738,252137,7,277316
22298,0.058357,172.31.36.0-255,66,252203,7,277316
22299,0.060288,172.217.26.0-255,5738,257941,7,277316
22300,0.060294,172.31.36.0-255,66,258007,7,277316
22301,0.06224,172.217.26.0-255,5738,263745,7,277316
22302,0.062246,172.31.36.0-255,66,263811,7,277316
22303,0.064177,172.217.26.0-255,5738,269549,7,277316
22304,0.064183,172.31.36.0-255,66,269615,7,277316
22305,0.066125,172.217.26.0-255,5738,275353,7,277316
22306,0.066132,172.31.36.0-255,66,275419,7,277316
22307,0.068065,172.217.26.0-255,1660,277079,7,277316
22308,0.068071,172.31.36.0-255,66,277145,7,277316
22309,0.06822,172.31.36.0-255,105,277250,7,277316
22310,0.070128,172.217.26.0-255,66,277316,7,277316
22311,0.0,172.217.194.0-255,185,185,7,282266
22312,3.5e-05,172.31.36.0-255,66,251,7,282266
22313,4.3e-05,172.217.194.0-255,1484,1735,7,282266
22314,4.7e-05,172.31.36.0-255,66,1801,7,282266
22315,5.2e-05,172.217.194.0-255,2902,4703,7,282266
22316,6.3e-05,172.31.36.0-255,66,4769,7,282266
22317,7e-05,172.217.194.0-255,7156,11925,7,282266
22318,7.2e-05,172.31.36.0-255,66,11991,7,282266
22319,8.7e-05,172.217.194.0-255,2103,14094,7,282266
22320,8.9e-05,172.31.36.0-255,66,14160,7,282266
22321,0.000135,172.217.194.0-255,2902,17062,7,282266
22322,0.000139,172.31.36.0-255,66,17128,7,282266
22323,0.000149,172.217.194.0-255,1484,18612,7,282266
22324,0.000151,172.31.36.0-255,66,18678,7,282266
22325,0.000184,172.217.194.0-255,2902,21580,7,282266
22326,0.000187,172.31.36.0-255,66,21646,7,282266
22327,0.000197,172.31.36.0-255,66,21712,7,282266
22328,0.000204,172.217.194.0-255,1125,22837,7,282266
22329,0.000206,172.31.36.0-255,66,22903,7,282266
22330,0.000243,172.217.194.0-255,1484,24387,7,282266
22331,0.000246,172.31.36.0-255,66,24453,7,282266
22332,0.00025,172.217.194.0-255,2902,27355,7,282266
22333,0.000252,172.31.36.0-255,66,27421,7,282266
22334,0.000282,172.217.194.0-255,5738,33159,7,282266
22335,0.000285,172.31.36.0-255,66,33225,7,282266
22336,0.000293,172.217.194.0-255,6797,40022,7,282266
22337,0.000295,172.31.36.0-255,66,40088,7,282266
22338,0.00034,172.217.194.0-255,1484,41572,7,282266
22339,0.000344,172.31.36.0-255,66,41638,7,282266
22340,0.00038,172.217.194.0-255,2902,44540,7,282266
22341,0.000385,172.31.36.0-255,66,44606,7,282266
22342,0.000391,172.217.194.0-255,5738,50344,7,282266
22343,0.000394,172.31.36.0-255,66,50410,7,282266
22344,0.000399,172.217.194.0-255,7090,57500,7,282266
22345,0.000408,172.31.36.0-255,66,57566,7,282266
22346,0.00127,172.217.194.0-255,384,57950,7,282266
22347,0.001296,172.217.194.0-255,1484,59434,7,282266
22348,0.001301,172.31.36.0-255,66,59500,7,282266
22349,0.001309,172.217.194.0-255,4320,63820,7,282266
22350,0.00131,172.31.36.0-255,66,63886,7,282266
22351,0.001338,172.217.194.0-255,7156,71042,7,282266
22352,0.001341,172.31.36.0-255,66,71108,7,282266
22353,0.001364,172.217.194.0-255,2902,74010,7,282266
22354,0.001368,172.31.36.0-255,66,74076,7,282266
22355,0.001383,172.217.194.0-255,7156,81232,7,282266
22356,0.001385,172.31.36.0-255,66,81298,7,282266
22357,0.001435,172.31.36.0-255,66,81364,7,282266
22358,0.001449,172.31.36.0-255,66,81430,7,282266
22359,0.001463,172.217.194.0-255,7156,88586,7,282266
22360,0.001465,172.31.36.0-255,66,88652,7,282266
22361,0.001503,172.217.194.0-255,1484,90136,7,282266
22362,0.001528,172.31.36.0-255,66,90202,7,282266
22363,0.001554,172.217.194.0-255,3602,93804,7,282266
22364,0.001556,172.31.36.0-255,66,93870,7,282266
22365,0.003881,172.217.194.0-255,1484,95354,7,282266
22366,0.003946,172.217.194.0-255,4320,99674,7,282266
22367,0.003951,172.31.36.0-255,66,99740,7,282266
22368,0.006361,172.217.194.0-255,5738,105478,7,282266
22369,0.006367,172.31.36.0-255,66,105544,7,282266
22370,0.008709,172.217.194.0-255,5738,111282,7,282266
22371,0.008716,172.31.36.0-255,66,111348,7,282266
22372,0.01108,172.217.194.0-255,5738,117086,7,282266
22373,0.011088,172.31.36.0-255,66,117152,7,282266
22374,0.013503,172.217.194.0-255,5738,122890,7,282266
22375,0.013513,172.31.36.0-255,66,122956,7,282266
22376,0.015898,172.217.194.0-255,5738,128694,7,282266
22377,0.015906,172.31.36.0-255,66,128760,7,282266
22378,0.018263,172.217.194.0-255,5738,134498,7,282266
22379,0.01827,172.31.36.0-255,66,134564,7,282266
22380,0.020632,172.217.194.0-255,5738,140302,7,282266
22381,0.020638,172.31.36.0-255,66,140368,7,282266
22382,0.023018,172.217.194.0-255,4320,144688,7,282266
22383,0.023024,172.31.36.0-255,66,144754,7,282266
22384,0.023057,172.217.194.0-255,1484,146238,7,282266
22385,0.025443,172.217.194.0-255,4320,150558,7,282266
22386,0.025454,172.31.36.0-255,66,150624,7,282266
22387,0.027837,172.217.194.0-255,5738,156362,7,282266
22388,0.027845,172.31.36.0-255,66,156428,7,282266
22389,0.029558,172.31.36.0-255,164,156592,7,282266
22390,0.029603,172.31.36.0-255,1123,157715,7,282266
22391,0.029667,172.31.36.0-255,1514,159229,7,282266
22392,0.029669,172.31.36.0-255,1283,160512,7,282266
22393,0.030271,172.217.194.0-255,5738,166250,7,282266
22394,0.030278,172.31.36.0-255,66,166316,7,282266
22395,0.03107,104.244.42.0-255,66,166382,7,282266
22396,0.031153,104.244.42.0-255,66,166448,7,282266
22397,0.031229,104.244.42.0-255,66,166514,7,282266
22398,0.032711,172.217.194.0-255,2902,169416,7,282266
22399,0.032717,172.31.36.0-255,66,169482,7,282266
22400,0.032747,172.217.194.0-255,2902,172384,7,282266
22401,0.03275,172.31.36.0-255,66,172450,7,282266
22402,0.035084,172.217.194.0-255,2902,175352,7,282266
22403,0.035093,172.31.36.0-255,66,175418,7,282266
22404,0.035132,172.217.194.0-255,2902,178320,7,282266
22405,0.035135,172.31.36.0-255,66,178386,7,282266
22406,0.037449,172.217.194.0-255,2902,181288,7,282266
22407,0.037454,172.31.36.0-255,66,181354,7,282266
22408,0.037494,172.217.194.0-255,2902,184256,7,282266
22409,0.037498,172.31.36.0-255,66,184322,7,282266
22410,0.039811,172.217.194.0-255,2902,187224,7,282266
22411,0.039816,172.31.36.0-255,66,187290,7,282266
22412,0.039855,172.217.194.0-255,2902,190192,7,282266
22413,0.039858,172.31.36.0-255,66,190258,7,282266
22414,0.04217,172.217.194.0-255,2902,193160,7,282266
22415,0.042176,172.31.36.0-255,66,193226,7,282266
22416,0.042255,172.217.194.0-255,2902,196128,7,282266
22417,0.042259,172.31.36.0-255,66,196194,7,282266
22418,0.044541,172.217.194.0-255,2902,199096,7,282266
22419,0.044546,172.31.36.0-255,66,199162,7,282266
22420,0.044615,172.217.194.0-255,1484,200646,7,282266
22421,0.044634,172.217.194.0-255,1484,202130,7,282266
22422,0.044638,172.31.36.0-255,66,202196,7,282266
22423,0.0469,172.217.194.0-255,2902,205098,7,282266
22424,0.046906,172.31.36.0-255,66,205164,7,282266
22425,0.046969,172.217.194.0-255,2902,208066,7,282266
22426,0.046973,172.31.36.0-255,66,208132,7,282266
22427,0.049291,172.217.194.0-255,2902,211034,7,282266
22428,0.0493,172.31.36.0-255,66,211100,7,282266
22429,0.04933,172.217.194.0-255,2902,214002,7,282266
22430,0.049334,172.31.36.0-255,66,214068,7,282266
22431,0.051676,172.217.194.0-255,2902,216970,7,282266
22432,0.051682,172.31.36.0-255,66,217036,7,282266
22433,0.051721,172.217.194.0-255,2902,219938,7,282266
22434,0.051724,172.31.36.0-255,66,220004,7,282266
22435,0.054034,172.217.194.0-255,2902,222906,7,282266
22436,0.054038,172.31.36.0-255,66,222972,7,282266
22437,0.054076,172.217.194.0-255,2902,225874,7,282266
22438,0.05408,172.31.36.0-255,66,225940,7,282266
22439,0.056406,172.217.194.0-255,2902,228842,7,282266
22440,0.05641,172.31.36.0-255,66,228908,7,282266
22441,0.056439,172.217.194.0-255,2902,231810,7,282266
22442,0.056442,172.31.36.0-255,66,231876,7,282266
22443,0.058766,172.217.194.0-255,1484,233360,7,282266
22444,0.058803,172.217.194.0-255,2902,236262,7,282266
22445,0.058807,172.31.36.0-255,66,236328,7,282266
22446,0.058835,172.217.194.0-255,1484,237812,7,282266
22447,0.061147,172.217.194.0-255,4320,242132,7,282266
22448,0.061153,172.31.36.0-255,66,242198,7,282266
22449,0.063524,172.217.194.0-255,4320,246518,7,282266
22450,0.063529,172.31.36.0-255,66,246584,7,282266
22451,0.063564,172.217.194.0-255,1484,248068,7,282266
22452,0.065889,172.217.194.0-255,1484,249552,7,282266
22453,0.065895,172.31.36.0-255,66,249618,7,282266
22454,0.065932,172.217.194.0-255,2902,252520,7,282266
22455,0.065935,172.31.36.0-255,66,252586,7,282266
22456,0.068259,172.217.194.0-255,2902,255488,7,282266
22457,0.068265,172.31.36.0-255,66,255554,7,282266
22458,0.068297,172.217.194.0-255,2902,258456,7,282266
22459,0.0683,172.31.36.0-255,66,258522,7,282266
22460,0.070618,172.217.194.0-255,2902,261424,7,282266
22461,0.070623,172.31.36.0-255,66,261490,7,282266
22462,0.070659,172.217.194.0-255,2902,264392,7,282266
22463,0.070663,172.31.36.0-255,66,264458,7,282266
22464,0.072973,172.217.194.0-255,2902,267360,7,282266
22465,0.072979,172.31.36.0-255,66,267426,7,282266
22466,0.073026,172.217.194.0-255,2902,270328,7,282266
22467,0.073029,172.31.36.0-255,66,270394,7,282266
22468,0.075357,172.217.194.0-255,2902,273296,7,282266
22469,0.075362,172.31.36.0-255,66,273362,7,282266
22470,0.075398,172.217.194.0-255,2902,276264,7,282266
22471,0.075402,172.31.36.0-255,66,276330,7,282266
22472,0.077716,172.217.194.0-255,2902,279232,7,282266
22473,0.077721,172.31.36.0-255,66,279298,7,282266
22474,0.077756,172.217.194.0-255,2902,282200,7,282266
22475,0.077759,172.31.36.0-255,66,282266,7,282266
22476,0.0,74.125.24.0-255,226,226,7,206736
22477,2.2e-05,172.31.36.0-255,66,292,7,206736
22478,3e-05,74.125.24.0-255,1484,1776,7,206736
22479,3.4e-05,172.31.36.0-255,66,1842,7,206736
22480,7.2e-05,74.125.24.0-255,4320,6162,7,206736
22481,7.6e-05,172.31.36.0-255,66,6228,7,206736
22482,0.000241,172.31.36.0-255,66,6294,7,206736
22483,0.000558,172.31.36.0-255,66,6360,7,206736
22484,0.000919,172.31.36.0-255,66,6426,7,206736
22485,0.003233,74.125.24.0-255,5738,12164,7,206736
22486,0.003244,172.31.36.0-255,66,12230,7,206736
22487,0.005598,74.125.24.0-255,5738,17968,7,206736
22488,0.005607,172.31.36.0-255,66,18034,7,206736
22489,0.007969,74.125.24.0-255,2902,20936,7,206736
22490,0.007982,172.31.36.0-255,66,21002,7,206736
22491,0.007993,74.125.24.0-255,2902,23904,7,206736
22492,0.008003,172.31.36.0-255,66,23970,7,206736
22493,0.010359,74.125.24.0-255,2902,26872,7,206736
22494,0.010375,172.31.36.0-255,66,26938,7,206736
22495,0.010406,74.125.24.0-255,2902,29840,7,206736
22496,0.01041,172.31.36.0-255,66,29906,7,206736
22497,0.012729,74.125.24.0-255,2902,32808,7,206736
22498,0.012744,172.31.36.0-255,66,32874,7,206736
22499,0.012775,74.125.24.0-255,2902,35776,7,206736
22500,0.012777,172.31.36.0-255,66,35842,7,206736
22501,0.015103,74.125.24.0-255,2902,38744,7,206736
22502,0.015118,172.31.36.0-255,66,38810,7,206736
22503,0.015152,74.125.24.0-255,2902,41712,7,206736
22504,0.015156,172.31.36.0-255,66,41778,7,206736
22505,0.017482,74.125.24.0-255,2902,44680,7,206736
22506,0.017498,172.31.36.0-255,66,44746,7,206736
22507,0.017533,74.125.24.0-255,2902,47648,7,206736
22508,0.017536,172.31.36.0-255,66,47714,7,206736
22509,0.019834,74.125.24.0-255,2902,50616,7,206736
22510,0.019844,172.31.36.0-255,66,50682,7,206736
22511,0.019875,74.125.24.0-255,2902,53584,7,206736
22512,0.019878,172.31.36.0-255,66,53650,7,206736
22513,0.022171,74.125.24.0-255,2902,56552,7,206736
22514,0.022182,172.31.36.0-255,66,56618,7,206736
22515,0.022213,74.125.24.0-255,2902,59520,7,206736
22516,0.022218,172.31.36.0-255,66,59586,7,206736
22517,0.022433,172.31.36.0-255,172,59758,7,206736
22518,0.022463,172.31.36.0-255,1114,60872,7,206736
22519,0.022524,172.31.36.0-255,1514,62386,7,206736
22520,0.022526,172.31.36.0-255,1292,63678,7,206736
22521,0.023975,104.244.42.0-255,66,63744,7,206736
22522,0.024003,104.244.42.0-255,66,63810,7,206736
22523,0.024058,104.244.42.0-255,66,63876,7,206736
22524,0.024501,74.125.24.0-255,2902,66778,7,206736
22525,0.024509,172.31.36.0-255,66,66844,7,206736
22526,0.024545,74.125.24.0-255,2902,69746,7,206736
22527,0.024548,172.31.36.0-255,66,69812,7,206736
22528,0.026846,74.125.24.0-255,2902,72714,7,206736
22529,0.026855,172.31.36.0-255,66,72780,7,206736
22530,0.026897,74.125.24.0-255,2902,75682,7,206736
22531,0.026901,172.31.36.0-255,66,75748,7,206736
22532,0.029203,74.125.24.0-255,2902,78650,7,206736
22533,0.029213,172.31.36.0-255,66,78716,7,206736
22534,0.029241,74.125.24.0-255,2902,81618,7,206736
22535,0.029244,172.31.36.0-255,66,81684,7,206736
22536,0.031535,74.125.24.0-255,2902,84586,7,206736
22537,0.031543,172.31.36.0-255,66,84652,7,206736
22538,0.031582,74.125.24.0-255,2902,87554,7,206736
22539,0.031586,172.31.36.0-255,66,87620,7,206736
22540,0.033867,74.125.24.0-255,2902,90522,7,206736
22541,0.033876,172.31.36.0-255,66,90588,7,206736
22542,0.033904,74.125.24.0-255,2902,93490,7,206736
22543,0.033907,172.31.36.0-255,66,93556,7,206736
22544,0.036193,74.125.24.0-255,2902,96458,7,206736
22545,0.036203,172.31.36.0-255,66,96524,7,206736
22546,0.036231,74.125.24.0-255,2902,99426,7,206736
22547,0.036234,172.31.36.0-255,66,99492,7,206736
22548,0.038529,74.125.24.0-255,2902,102394,7,206736
22549,0.038535,172.31.36.0-255,66,102460,7,206736
22550,0.03857,74.125.24.0-255,2902,105362,7,206736
22551,0.038574,172.31.36.0-255,66,105428,7,206736
22552,0.04088,74.125.24.0-255,2902,108330,7,206736
22553,0.040887,172.31.36.0-255,66,108396,7,206736
22554,0.040916,74.125.24.0-255,1484,109880,7,206736
22555,0.040919,172.31.36.0-255,66,109946,7,206736
22556,0.040943,74.125.24.0-255,1484,111430,7,206736
22557,0.040945,172.31.36.0-255,66,111496,7,206736
22558,0.04322,74.125.24.0-255,2902,114398,7,206736
22559,0.043228,172.31.36.0-255,66,114464,7,206736
22560,0.043256,74.125.24.0-255,2902,117366,7,206736
22561,0.043259,172.31.36.0-255,66,117432,7,206736
22562,0.045576,74.125.24.0-255,2902,120334,7,206736
22563,0.045584,172.31.36.0-255,66,120400,7,206736
22564,0.045616,74.125.24.0-255,2902,123302,7,206736
22565,0.045619,172.31.36.0-255,66,123368,7,206736
22566,0.047936,74.125.24.0-255,2902,126270,7,206736
22567,0.047943,172.31.36.0-255,66,126336,7,206736
22568,0.047998,74.125.24.0-255,2902,129238,7,206736
22569,0.048001,172.31.36.0-255,66,129304,7,206736
22570,0.05028,74.125.24.0-255,2902,132206,7,206736
22571,0.050286,172.31.36.0-255,66,132272,7,206736
22572,0.050328,74.125.24.0-255,1484,133756,7,206736
22573,0.050331,172.31.36.0-255,66,133822,7,206736
22574,0.050355,74.125.24.0-255,1484,135306,7,206736
22575,0.050358,172.31.36.0-255,66,135372,7,206736
22576,0.052636,74.125.24.0-255,2902,138274,7,206736
22577,0.052652,172.31.36.0-255,66,138340,7,206736
22578,0.052691,74.125.24.0-255,2902,141242,7,206736
22579,0.052694,172.31.36.0-255,66,141308,7,206736
22580,0.05498,74.125.24.0-255,2902,144210,7,206736
22581,0.05499,172.31.36.0-255,66,144276,7,206736
22582,0.055031,74.125.24.0-255,2902,147178,7,206736
22583,0.055035,172.31.36.0-255,66,147244,7,206736
22584,0.057321,74.125.24.0-255,2902,150146,7,206736
22585,0.057329,172.31.36.0-255,66,150212,7,206736
22586,0.057355,74.125.24.0-255,1484,151696,7,206736
22587,0.057358,172.31.36.0-255,66,151762,7,206736
22588,0.057381,74.125.24.0-255,1484,153246,7,206736
22589,0.057383,172.31.36.0-255,66,153312,7,206736
22590,0.059656,74.125.24.0-255,2902,156214,7,206736
22591,0.059666,172.31.36.0-255,66,156280,7,206736
22592,0.05971,74.125.24.0-255,2902,159182,7,206736
22593,0.059713,172.31.36.0-255,66,159248,7,206736
22594,0.06199,74.125.24.0-255,2902,162150,7,206736
22595,0.061998,172.31.36.0-255,66,162216,7,206736
22596,0.062078,74.125.24.0-255,2902,165118,7,206736
22597,0.062082,172.31.36.0-255,66,165184,7,206736
22598,0.064318,74.125.24.0-255,2902,168086,7,206736
22599,0.064324,172.31.36.0-255,66,168152,7,206736
22600,0.064443,74.125.24.0-255,2902,171054,7,206736
22601,0.064448,172.31.36.0-255,66,171120,7,206736
22602,0.066692,74.125.24.0-255,2902,174022,7,206736
22603,0.066701,172.31.36.0-255,66,174088,7,206736
22604,0.066755,74.125.24.0-255,2902,176990,7,206736
22605,0.066759,172.31.36.0-255,66,177056,7,206736
22606,0.069028,74.125.24.0-255,2902,179958,7,206736
22607,0.069038,172.31.36.0-255,66,180024,7,206736
22608,0.069067,74.125.24.0-255,2902,182926,7,206736
22609,0.06907,172.31.36.0-255,66,182992,7,206736
22610,0.07136,74.125.24.0-255,2902,185894,7,206736
22611,0.07137,172.31.36.0-255,66,185960,7,206736
22612,0.0714,74.125.24.0-255,2902,188862,7,206736
22613,0.071403,172.31.36.0-255,66,188928,7,206736
22614,0.073742,74.125.24.0-255,2902,191830,7,206736
22615,0.073754,172.31.36.0-255,66,191896,7,206736
22616,0.073785,74.125.24.0-255,2902,194798,7,206736
22617,0.073788,172.31.36.0-255,66,194864,7,206736
22618,0.076088,74.125.24.0-255,2902,197766,7,206736
22619,0.076104,172.31.36.0-255,66,197832,7,206736
22620,0.076136,74.125.24.0-255,2902,200734,7,206736
22621,0.076139,172.31.36.0-255,66,200800,7,206736
22622,0.078468,74.125.24.0-255,2902,203702,7,206736
22623,0.078484,172.31.36.0-255,66,203768,7,206736
22624,0.078516,74.125.24.0-255,2902,206670,7,206736
22625,0.078519,172.31.36.0-255,66,206736,7,206736
22626,0.0,172.217.194.0-255,146,146,7,278509
22627,2e-05,172.31.36.0-255,66,212,7,278509
22628,2.8e-05,172.217.194.0-255,1484,1696,7,278509
22629,3.3e-05,172.31.36.0-255,66,1762,7,278509
22630,3.9e-05,172.217.194.0-255,2902,4664,7,278509
22631,5.6e-05,172.31.36.0-255,66,4730,7,278509
22632,6.5e-05,172.217.194.0-255,7156,11886,7,278509
22633,6.8e-05,172.31.36.0-255,66,11952,7,278509
22634,9.8e-05,172.217.194.0-255,5738,17690,7,278509
22635,0.000102,172.31.36.0-255,66,17756,7,278509
22636,0.000133,172.31.36.0-255,66,17822,7,278509
22637,0.000202,172.217.194.0-255,2543,20365,7,278509
22638,0.000205,172.31.36.0-255,66,20431,7,278509
22639,0.000353,172.217.194.0-255,1484,21915,7,278509
22640,0.000358,172.31.36.0-255,66,21981,7,278509
22641,0.000364,172.217.194.0-255,2902,24883,7,278509
22642,0.000366,172.31.36.0-255,66,24949,7,278509
22643,0.000396,172.217.194.0-255,5738,30687,7,278509
22644,0.000399,172.31.36.0-255,66,30753,7,278509
22645,0.000425,172.217.194.0-255,4320,35073,7,278509
22646,0.000429,172.31.36.0-255,66,35139,7,278509
22647,0.000446,172.217.194.0-255,2902,38041,7,278509
22648,0.000448,172.31.36.0-255,66,38107,7,278509
22649,0.000492,172.31.36.0-255,66,38173,7,278509
22650,0.000549,172.217.194.0-255,4320,42493,7,278509
22651,0.000553,172.31.36.0-255,66,42559,7,278509
22652,0.000572,172.217.194.0-255,2543,45102,7,278509
22653,0.000576,172.31.36.0-255,66,45168,7,278509
22654,0.000593,172.217.194.0-255,645,45813,7,278509
22655,0.000596,172.31.36.0-255,66,45879,7,278509
22656,0.000631,172.217.194.0-255,1484,47363,7,278509
22657,0.000648,172.217.194.0-255,4320,51683,7,278509
22658,0.000651,172.31.36.0-255,66,51749,7,278509
22659,0.000656,172.217.194.0-255,2902,54651,7,278509
22660,0.000658,172.31.36.0-255,66,54717,7,278509
22661,0.000681,172.217.194.0-255,7156,61873,7,278509
22662,0.000684,172.31.36.0-255,66,61939,7,278509
22663,0.000735,172.217.194.0-255,7156,69095,7,278509
22664,0.000739,172.31.36.0-255,66,69161,7,278509
22665,0.000755,172.217.194.0-255,1484,70645,7,278509
22666,0.000803,172.217.194.0-255,4320,74965,7,278509
22667,0.000808,172.31.36.0-255,66,75031,7,278509
22668,0.000827,172.217.194.0-255,5020,80051,7,278509
22669,0.00083,172.31.36.0-255,66,80117,7,278509
22670,0.00143,172.217.194.0-255,1484,81601,7,278509
22671,0.001439,172.217.194.0-255,2902,84503,7,278509
22672,0.001443,172.31.36.0-255,66,84569,7,278509
22673,0.001451,172.217.194.0-255,5738,90307,7,278509
22674,0.001453,172.31.36.0-255,66,90373,7,278509
22675,0.001487,172.217.194.0-255,1484,91857,7,278509
22676,0.001515,172.31.36.0-255,66,91923,7,278509
22677,0.001588,172.217.194.0-255,2902,94825,7,278509
22678,0.001591,172.31.36.0-255,66,94891,7,278509
22679,0.001607,172.217.194.0-255,4320,99211,7,278509
22680,0.00161,172.31.36.0-255,66,99277,7,278509
22681,0.001633,172.217.194.0-255,3602,102879,7,278509
22682,0.001636,172.31.36.0-255,66,102945,7,278509
22683,0.001668,172.217.194.0-255,2902,105847,7,278509
22684,0.001671,172.31.36.0-255,66,105913,7,278509
22685,0.0017,172.31.36.0-255,66,105979,7,278509
22686,0.001772,172.31.36.0-255,66,106045,7,278509
22687,0.001805,172.31.36.0-255,66,106111,7,278509
22688,0.001934,172.217.194.0-255,1484,107595,7,278509
22689,0.001941,172.217.194.0-255,2902,110497,7,278509
22690,0.001944,172.31.36.0-255,66,110563,7,278509
22691,0.001963,172.217.194.0-255,2902,113465,7,278509
22692,0.001966,172.31.36.0-255,66,113531,7,278509
22693,0.001987,172.217.194.0-255,2902,116433,7,278509
22694,0.001989,172.31.36.0-255,66,116499,7,278509
22695,0.002007,172.217.194.0-255,7156,123655,7,278509
22696,0.00201,172.31.36.0-255,66,123721,7,278509
22697,0.002025,172.217.194.0-255,5738,129459,7,278509
22698,0.002027,172.31.36.0-255,66,129525,7,278509
22699,0.002107,172.217.194.0-255,7156,136681,7,278509
22700,0.002111,172.31.36.0-255,66,136747,7,278509
22701,0.002124,172.217.194.0-255,3602,140349,7,278509
22702,0.002126,172.31.36.0-255,66,140415,7,278509
22703,0.002188,172.217.194.0-255,4320,144735,7,278509
22704,0.00219,172.31.36.0-255,66,144801,7,278509
22705,0.002211,172.31.36.0-255,66,144867,7,278509
22706,0.002234,172.31.36.0-255,66,144933,7,278509
22707,0.002386,172.217.194.0-255,1484,146417,7,278509
22708,0.002437,172.31.36.0-255,66,146483,7,278509
22709,0.002469,172.31.36.0-255,66,146549,7,278509
22710,0.002675,172.217.194.0-255,5738,152287,7,278509
22711,0.002678,172.31.36.0-255,66,152353,7,278509
22712,0.002709,172.31.36.0-255,66,152419,7,278509
22713,0.002795,172.217.194.0-255,4320,156739,7,278509
22714,0.002798,172.31.36.0-255,66,156805,7,278509
22715,0.002828,172.31.36.0-255,66,156871,7,278509
22716,0.002839,172.217.194.0-255,766,157637,7,278509
22717,0.005104,172.217.194.0-255,4320,161957,7,278509
22718,0.00511,172.31.36.0-255,66,162023,7,278509
22719,0.007381,172.217.194.0-255,2902,164925,7,278509
22720,0.007387,172.31.36.0-255,66,164991,7,278509
22721,0.007406,172.217.194.0-255,2902,167893,7,278509
22722,0.007409,172.31.36.0-255,66,167959,7,278509
22723,0.009636,172.217.194.0-255,5738,173697,7,278509
22724,0.009644,172.31.36.0-255,66,173763,7,278509
22725,0.011922,172.217.194.0-255,5738,179501,7,278509
22726,0.011933,172.31.36.0-255,66,179567,7,278509
22727,0.014234,172.217.194.0-255,5738,185305,7,278509
22728,0.014247,172.31.36.0-255,66,185371,7,278509
22729,0.016505,172.217.194.0-255,5738,191109,7,278509
22730,0.016523,172.31.36.0-255,66,191175,7,278509
22731,0.018809,172.217.194.0-255,5738,196913,7,278509
22732,0.018825,172.31.36.0-255,66,196979,7,278509
22733,0.021082,172.217.194.0-255,5738,202717,7,278509
22734,0.021095,172.31.36.0-255,66,202783,7,278509
22735,0.02338,172.217.194.0-255,5738,208521,7,278509
22736,0.023391,172.31.36.0-255,66,208587,7,278509
22737,0.025672,172.217.194.0-255,5738,214325,7,278509
22738,0.025683,172.31.36.0-255,66,214391,7,278509
22739,0.027969,172.217.194.0-255,5738,220129,7,278509
22740,0.027978,172.31.36.0-255,66,220195,7,278509
22741,0.03022,172.217.194.0-255,5738,225933,7,278509
22742,0.030233,172.31.36.0-255,66,225999,7,278509
22743,0.031501,172.31.36.0-255,192,226191,7,278509
22744,0.031532,172.31.36.0-255,1115,227306,7,278509
22745,0.031597,172.31.36.0-255,1514,228820,7,278509
22746,0.031598,172.31.36.0-255,1291,230111,7,278509
22747,0.032479,172.217.194.0-255,5738,235849,7,278509
22748,0.032488,172.31.36.0-255,66,235915,7,278509
22749,0.033093,104.244.42.0-255,66,235981,7,278509
22750,0.033102,104.244.42.0-255,66,236047,7,278509
22751,0.033144,104.244.42.0-255,66,236113,7,278509
22752,0.033743,104.244.42.0-255,108,236221,7,278509
22753,0.033749,172.31.36.0-255,66,236287,7,278509
22754,0.034773,172.217.194.0-255,5738,242025,7,278509
22755,0.03478,172.31.36.0-255,66,242091,7,278509
22756,0.037062,172.217.194.0-255,5738,247829,7,278509
22757,0.037069,172.31.36.0-255,66,247895,7,278509
22758,0.039349,172.217.194.0-255,5738,253633,7,278509
22759,0.039356,172.31.36.0-255,66,253699,7,278509
22760,0.041659,172.217.194.0-255,5738,259437,7,278509
22761,0.041669,172.31.36.0-255,66,259503,7,278509
22762,0.043974,172.217.194.0-255,5738,265241,7,278509
22763,0.043981,172.31.36.0-255,66,265307,7,278509
22764,0.046285,172.217.194.0-255,5738,271045,7,278509
22765,0.046294,172.31.36.0-255,66,271111,7,278509
22766,0.048614,172.217.194.0-255,5738,276849,7,278509
22767,0.048623,172.31.36.0-255,66,276915,7,278509
22768,0.050904,172.217.194.0-255,1357,278272,7,278509
22769,0.051051,172.31.36.0-255,66,278338,7,278509
22770,0.05109,172.31.36.0-255,105,278443,7,278509
22771,0.053345,172.217.194.0-255,66,278509,7,278509
22772,0.0,172.217.194.0-255,153,153,7,342159
22773,3.4e-05,172.31.36.0-255,66,219,7,342159
22774,4.2e-05,172.217.194.0-255,1484,1703,7,342159
22775,4.7e-05,172.31.36.0-255,66,1769,7,342159
22776,5.3e-05,172.217.194.0-255,2902,4671,7,342159
22777,5.5e-05,172.31.36.0-255,66,4737,7,342159
22778,6.4e-05,172.217.194.0-255,7156,11893,7,342159
22779,6.6e-05,172.31.36.0-255,66,11959,7,342159
22780,6.9e-05,172.217.194.0-255,1484,13443,7,342159
22781,7.1e-05,172.31.36.0-255,66,13509,7,342159
22782,0.000108,172.217.194.0-255,639,14148,7,342159
22783,0.000111,172.31.36.0-255,66,14214,7,342159
22784,0.000127,172.217.194.0-255,1484,15698,7,342159
22785,0.00013,172.31.36.0-255,66,15764,7,342159
22786,0.000135,172.217.194.0-255,4320,20084,7,342159
22787,0.000138,172.31.36.0-255,66,20150,7,342159
22788,0.000171,172.217.194.0-255,7156,27306,7,342159
22789,0.000174,172.31.36.0-255,66,27372,7,342159
22790,0.000195,172.217.194.0-255,3961,31333,7,342159
22791,0.000198,172.31.36.0-255,66,31399,7,342159
22792,0.000304,172.217.194.0-255,1484,32883,7,342159
22793,0.000309,172.31.36.0-255,66,32949,7,342159
22794,0.000315,172.217.194.0-255,2902,35851,7,342159
22795,0.000317,172.31.36.0-255,66,35917,7,342159
22796,0.000344,172.217.194.0-255,5738,41655,7,342159
22797,0.000347,172.31.36.0-255,66,41721,7,342159
22798,0.000352,172.217.194.0-255,2902,44623,7,342159
22799,0.000354,172.31.36.0-255,66,44689,7,342159
22800,0.000369,172.217.194.0-255,3961,48650,7,342159
22801,0.000374,172.31.36.0-255,66,48716,7,342159
22802,0.000417,172.217.194.0-255,7156,55872,7,342159
22803,0.00042,172.31.36.0-255,66,55938,7,342159
22804,0.000442,172.217.194.0-255,7156,63094,7,342159
22805,0.000446,172.31.36.0-255,66,63160,7,342159
22806,0.000461,172.217.194.0-255,2818,65978,7,342159
22807,0.000464,172.31.36.0-255,66,66044,7,342159
22808,0.000482,172.217.194.0-255,117,66161,7,342159
22809,0.000486,172.217.194.0-255,382,66543,7,342159
22810,0.000831,172.31.36.0-255,66,66609,7,342159
22811,0.000894,172.217.194.0-255,1484,68093,7,342159
22812,0.000902,172.217.194.0-255,1484,69577,7,342159
22813,0.000905,172.31.36.0-255,66,69643,7,342159
22814,0.00093,172.217.194.0-255,1484,71127,7,342159
22815,0.000936,172.217.194.0-255,5738,76865,7,342159
22816,0.000938,172.31.36.0-255,66,76931,7,342159
22817,0.000958,172.217.194.0-255,4320,81251,7,342159
22818,0.00096,172.31.36.0-255,66,81317,7,342159
22819,0.000977,172.217.194.0-255,1994,83311,7,342159
22820,0.00098,172.31.36.0-255,66,83377,7,342159
22821,0.001219,172.217.194.0-255,1484,84861,7,342159
22822,0.001226,172.217.194.0-255,2902,87763,7,342159
22823,0.00123,172.31.36.0-255,66,87829,7,342159
22824,0.001237,172.217.194.0-255,5738,93567,7,342159
22825,0.001239,172.31.36.0-255,66,93633,7,342159
22826,0.001261,172.217.194.0-255,7156,100789,7,342159
22827,0.001263,172.31.36.0-255,66,100855,7,342159
22828,0.001281,172.217.194.0-255,5738,106593,7,342159
22829,0.001284,172.31.36.0-255,66,106659,7,342159
22830,0.001294,172.31.36.0-255,66,106725,7,342159
22831,0.001316,172.217.194.0-255,2184,108909,7,342159
22832,0.001319,172.31.36.0-255,66,108975,7,342159
22833,0.002218,172.217.194.0-255,1484,110459,7,342159
22834,0.002226,172.217.194.0-255,2902,113361,7,342159
22835,0.002231,172.31.36.0-255,66,113427,7,342159
22836,0.002247,172.217.194.0-255,4320,117747,7,342159
22837,0.002249,172.31.36.0-255,66,117813,7,342159
22838,0.002269,172.217.194.0-255,1484,119297,7,342159
22839,0.002279,172.31.36.0-255,66,119363,7,342159
22840,0.002302,172.217.194.0-255,4320,123683,7,342159
22841,0.002305,172.31.36.0-255,66,123749,7,342159
22842,0.002312,172.217.194.0-255,7156,130905,7,342159
22843,0.002314,172.31.36.0-255,66,130971,7,342159
22844,0.002317,172.217.194.0-255,1484,132455,7,342159
22845,0.002321,172.217.194.0-255,2184,134639,7,342159
22846,0.002323,172.31.36.0-255,66,134705,7,342159
22847,0.004573,172.217.194.0-255,2902,137607,7,342159
22848,0.004578,172.31.36.0-255,66,137673,7,342159
22849,0.004596,172.217.194.0-255,2902,140575,7,342159
22850,0.004598,172.31.36.0-255,66,140641,7,342159
22851,0.006826,172.217.194.0-255,2902,143543,7,342159
22852,0.006832,172.31.36.0-255,66,143609,7,342159
22853,0.006866,172.217.194.0-255,2902,146511,7,342159
22854,0.006869,172.31.36.0-255,66,146577,7,342159
22855,0.009096,172.217.194.0-255,2902,149479,7,342159
22856,0.009103,172.31.36.0-255,66,149545,7,342159
22857,0.009126,172.217.194.0-255,2902,152447,7,342159
22858,0.009128,172.31.36.0-255,66,152513,7,342159
22859,0.011384,172.217.194.0-255,5738,158251,7,342159
22860,0.01139,172.31.36.0-255,66,158317,7,342159
22861,0.013675,172.217.194.0-255,5738,164055,7,342159
22862,0.01369,172.31.36.0-255,66,164121,7,342159
22863,0.015945,172.217.194.0-255,5738,169859,7,342159
22864,0.015953,172.31.36.0-255,66,169925,7,342159
22865,0.018238,172.217.194.0-255,5738,175663,7,342159
22866,0.01825,172.31.36.0-255,66,175729,7,342159
22867,0.02055,172.217.194.0-255,5738,181467,7,342159
22868,0.020561,172.31.36.0-255,66,181533,7,342159
22869,0.022866,172.217.194.0-255,5738,187271,7,342159
22870,0.022874,172.31.36.0-255,66,187337,7,342159
22871,0.02514,172.217.194.0-255,5738,193075,7,342159
22872,0.025149,172.31.36.0-255,66,193141,7,342159
22873,0.027417,172.217.194.0-255,5738,198879,7,342159
22874,0.027426,172.31.36.0-255,66,198945,7,342159
22875,0.029704,172.217.194.0-255,5738,204683,7,342159
22876,0.029711,172.31.36.0-255,66,204749,7,342159
22877,0.031318,172.31.36.0-255,176,204925,7,342159
22878,0.031348,172.31.36.0-255,1115,206040,7,342159
22879,0.031391,172.31.36.0-255,1514,207554,7,342159
22880,0.031393,172.31.36.0-255,1514,209068,7,342159
22881,0.031398,172.31.36.0-255,1514,210582,7,342159
22882,0.0314,172.31.36.0-255,1514,212096,7,342159
22883,0.031418,172.31.36.0-255,1514,213610,7,342159
22884,0.031425,172.31.36.0-255,69,213679,7,342159
22885,0.032006,172.217.194.0-255,5738,219417,7,342159
22886,0.032012,172.31.36.0-255,66,219483,7,342159
22887,0.032869,104.244.42.0-255,66,219549,7,342159
22888,0.032923,104.244.42.0-255,66,219615,7,342159
22889,0.032979,104.244.42.0-255,66,219681,7,342159
22890,0.032985,104.244.42.0-255,66,219747,7,342159
22891,0.034283,172.217.194.0-255,5738,225485,7,342159
22892,0.034288,172.31.36.0-255,66,225551,7,342159
22893,0.036571,172.217.194.0-255,5738,231289,7,342159
22894,0.036577,172.31.36.0-255,66,231355,7,342159
22895,0.03885,172.217.194.0-255,5738,237093,7,342159
22896,0.038855,172.31.36.0-255,66,237159,7,342159
22897,0.041109,172.217.194.0-255,5738,242897,7,342159
22898,0.041115,172.31.36.0-255,66,242963,7,342159
22899,0.043399,172.217.194.0-255,5738,248701,7,342159
22900,0.043421,172.31.36.0-255,66,248767,7,342159
22901,0.045679,172.217.194.0-255,5738,254505,7,342159
22902,0.045684,172.31.36.0-255,66,254571,7,342159
22903,0.047946,172.217.194.0-255,5738,260309,7,342159
22904,0.047952,172.31.36.0-255,66,260375,7,342159
22905,0.050197,172.217.194.0-255,2902,263277,7,342159
22906,0.050203,172.31.36.0-255,66,263343,7,342159
22907,0.050222,172.217.194.0-255,2902,266245,7,342159
22908,0.050225,172.31.36.0-255,66,266311,7,342159
22909,0.052469,172.217.194.0-255,2902,269213,7,342159
22910,0.05248,172.31.36.0-255,66,269279,7,342159
22911,0.052512,172.217.194.0-255,2902,272181,7,342159
22912,0.052515,172.31.36.0-255,66,272247,7,342159
22913,0.054754,172.217.194.0-255,5738,277985,7,342159
22914,0.05476,172.31.36.0-255,66,278051,7,342159
22915,0.057028,172.217.194.0-255,5738,283789,7,342159
22916,0.057034,172.31.36.0-255,66,283855,7,342159
22917,0.059302,172.217.194.0-255,5738,289593,7,342159
22918,0.059307,172.31.36.0-255,66,289659,7,342159
22919,0.061607,172.217.194.0-255,2902,292561,7,342159
22920,0.061613,172.31.36.0-255,66,292627,7,342159
22921,0.06164,172.217.194.0-255,2902,295529,7,342159
22922,0.061642,172.31.36.0-255,66,295595,7,342159
22923,0.063863,172.217.194.0-255,2902,298497,7,342159
22924,0.06387,172.31.36.0-255,66,298563,7,342159
22925,0.063899,172.217.194.0-255,2902,301465,7,342159
22926,0.063902,172.31.36.0-255,66,301531,7,342159
22927,0.066149,172.217.194.0-255,5738,307269,7,342159
22928,0.066154,172.31.36.0-255,66,307335,7,342159
22929,0.06843,172.217.194.0-255,5738,313073,7,342159
22930,0.068436,172.31.36.0-255,66,313139,7,342159
22931,0.070709,172.217.194.0-255,5738,318877,7,342159
22932,0.07072,172.31.36.0-255,66,318943,7,342159
22933,0.072984,172.217.194.0-255,5738,324681,7,342159
22934,0.072993,172.31.36.0-255,66,324747,7,342159
22935,0.075265,172.217.194.0-255,5738,330485,7,342159
22936,0.075272,172.31.36.0-255,66,330551,7,342159
22937,0.077567,172.217.194.0-255,5738,336289,7,342159
22938,0.077574,172.31.36.0-255,66,336355,7,342159
22939,0.079833,172.217.194.0-255,5738,342093,7,342159
22940,0.079841,172.31.36.0-255,66,342159,7,342159
22941,0.0,172.31.36.0-255,105,105,7,276
22942,0.067542,31.13.82.0-255,105,210,7,276
22943,0.06756,172.31.36.0-255,66,276,7,276
22944,0.0,74.125.24.0-255,146,146,7,384863
22945,2.2e-05,172.31.36.0-255,66,212,7,384863
22946,3e-05,74.125.24.0-255,1484,1696,7,384863
22947,3.4e-05,172.31.36.0-255,66,1762,7,384863
22948,4e-05,74.125.24.0-255,2902,4664,7,384863
22949,4.2e-05,172.31.36.0-255,66,4730,7,384863
22950,4.7e-05,74.125.24.0-255,2902,7632,7,384863
22951,5.1e-05,172.31.36.0-255,66,7698,7,384863
22952,7.8e-05,74.125.24.0-255,4320,12018,7,384863
22953,8.2e-05,172.31.36.0-255,66,12084,7,384863
22954,8.6e-05,74.125.24.0-255,2049,14133,7,384863
22955,8.9e-05,172.31.36.0-255,66,14199,7,384863
22956,0.000125,74.125.24.0-255,1484,15683,7,384863
22957,0.000127,172.31.36.0-255,66,15749,7,384863
22958,0.000133,74.125.24.0-255,2902,18651,7,384863
22959,0.000136,172.31.36.0-255,66,18717,7,384863
22960,0.000142,74.125.24.0-255,5738,24455,7,384863
22961,0.000144,172.31.36.0-255,66,24521,7,384863
22962,0.000173,74.125.24.0-255,5738,30259,7,384863
22963,0.000175,172.31.36.0-255,66,30325,7,384863
22964,0.000205,74.125.24.0-255,1125,31450,7,384863
22965,0.000208,172.31.36.0-255,66,31516,7,384863
22966,0.000304,74.125.24.0-255,1484,33000,7,384863
22967,0.000306,172.31.36.0-255,66,33066,7,384863
22968,0.000312,74.125.24.0-255,2902,35968,7,384863
22969,0.000314,172.31.36.0-255,66,36034,7,384863
22970,0.000317,74.125.24.0-255,1484,37518,7,384863
22971,0.00032,172.31.36.0-255,66,37584,7,384863
22972,0.000347,74.125.24.0-255,5738,43322,7,384863
22973,0.000349,172.31.36.0-255,66,43388,7,384863
22974,0.000379,74.125.24.0-255,5379,48767,7,384863
22975,0.000382,172.31.36.0-255,66,48833,7,384863
22976,0.000431,74.125.24.0-255,1484,50317,7,384863
22977,0.000437,74.125.24.0-255,2902,53219,7,384863
22978,0.000453,74.125.24.0-255,5738,58957,7,384863
22979,0.000475,74.125.24.0-255,5738,64695,7,384863
22980,0.000515,74.125.24.0-255,1737,66432,7,384863
22981,0.000591,172.31.36.0-255,66,66498,7,384863
22982,0.000619,74.125.24.0-255,1484,67982,7,384863
22983,0.000624,74.125.24.0-255,1484,69466,7,384863
22984,0.000636,74.125.24.0-255,1484,70950,7,384863
22985,0.000641,74.125.24.0-255,2902,73852,7,384863
22986,0.000657,74.125.24.0-255,2902,76754,7,384863
22987,0.000661,74.125.24.0-255,1484,78238,7,384863
22988,0.000667,172.31.36.0-255,66,78304,7,384863
22989,0.000682,74.125.24.0-255,5379,83683,7,384863
22990,0.000704,172.31.36.0-255,66,83749,7,384863
22991,0.000716,74.125.24.0-255,5738,89487,7,384863
22992,0.000731,74.125.24.0-255,1484,90971,7,384863
22993,0.000738,74.125.24.0-255,7156,98127,7,384863
22994,0.000762,172.31.36.0-255,66,98193,7,384863
22995,0.000774,74.125.24.0-255,2543,100736,7,384863
22996,0.000793,172.31.36.0-255,66,100802,7,384863
22997,0.001018,74.125.24.0-255,1484,102286,7,384863
22998,0.001037,74.125.24.0-255,2902,105188,7,384863
22999,0.001044,74.125.24.0-255,5738,110926,7,384863
23000,0.001058,74.125.24.0-255,5738,116664,7,384863
23001,0.001075,74.125.24.0-255,7156,123820,7,384863
23002,0.001091,172.31.36.0-255,66,123886,7,384863
23003,0.001115,172.31.36.0-255,66,123952,7,384863
23004,0.001202,74.125.24.0-255,1484,125436,7,384863
23005,0.001208,74.125.24.0-255,2902,128338,7,384863
23006,0.001227,172.31.36.0-255,66,128404,7,384863
23007,0.001233,74.125.24.0-255,4320,132724,7,384863
23008,0.001235,74.125.24.0-255,1484,134208,7,384863
23009,0.00124,172.31.36.0-255,66,134274,7,384863
23010,0.001253,74.125.24.0-255,4320,138594,7,384863
23011,0.001257,74.125.24.0-255,1484,140078,7,384863
23012,0.001273,74.125.24.0-255,5738,145816,7,384863
23013,0.001292,74.125.24.0-255,4320,150136,7,384863
23014,0.001295,74.125.24.0-255,1484,151620,7,384863
23015,0.001298,172.31.36.0-255,66,151686,7,384863
23016,0.001303,172.31.36.0-255,66,151752,7,384863
23017,0.001325,74.125.24.0-255,6438,158190,7,384863
23018,0.001341,172.31.36.0-255,66,158256,7,384863
23019,0.001523,74.125.24.0-255,1484,159740,7,384863
23020,0.00153,74.125.24.0-255,2902,162642,7,384863
23021,0.001535,172.31.36.0-255,66,162708,7,384863
23022,0.00156,74.125.24.0-255,5738,168446,7,384863
23023,0.001567,74.125.24.0-255,5738,174184,7,384863
23024,0.001573,172.31.36.0-255,66,174250,7,384863
23025,0.001586,74.125.24.0-255,7156,181406,7,384863
23026,0.00159,74.125.24.0-255,2902,184308,7,384863
23027,0.001656,172.31.36.0-255,66,184374,7,384863
23028,0.001805,74.125.24.0-255,1484,185858,7,384863
23029,0.001819,74.125.24.0-255,2902,188760,7,384863
23030,0.001823,172.31.36.0-255,66,188826,7,384863
23031,0.001831,74.125.24.0-255,5738,194564,7,384863
23032,0.001841,172.31.36.0-255,66,194630,7,384863
23033,0.001864,74.125.24.0-255,5738,200368,7,384863
23034,0.001871,74.125.24.0-255,7156,207524,7,384863
23035,0.001885,172.31.36.0-255,66,207590,7,384863
23036,0.001925,172.31.36.0-255,66,207656,7,384863
23037,0.00196,74.125.24.0-255,1484,209140,7,384863
23038,0.001964,74.125.24.0-255,1484,210624,7,384863
23039,0.001966,172.31.36.0-255,66,210690,7,384863
23040,0.001985,74.125.24.0-255,1484,212174,7,384863
23041,0.001991,74.125.24.0-255,5738,217912,7,384863
23042,0.002004,74.125.24.0-255,7156,225068,7,384863
23043,0.002009,172.31.36.0-255,66,225134,7,384863
23044,0.002024,74.125.24.0-255,5738,230872,7,384863
23045,0.002058,74.125.24.0-255,2184,233056,7,384863
23046,0.002064,172.31.36.0-255,66,233122,7,384863
23047,0.002117,74.125.24.0-255,1484,234606,7,384863
23048,0.002123,74.125.24.0-255,2902,237508,7,384863
23049,0.002126,74.125.24.0-255,1484,238992,7,384863
23050,0.00214,74.125.24.0-255,4320,243312,7,384863
23051,0.002153,74.125.24.0-255,1484,244796,7,384863
23052,0.002169,74.125.24.0-255,7156,251952,7,384863
23053,0.002172,172.31.36.0-255,66,252018,7,384863
23054,0.002177,172.31.36.0-255,66,252084,7,384863
23055,0.002197,74.125.24.0-255,4320,256404,7,384863
23056,0.002224,74.125.24.0-255,7156,263560,7,384863
23057,0.002226,172.31.36.0-255,66,263626,7,384863
23058,0.002231,172.31.36.0-255,66,263692,7,384863
23059,0.002247,74.125.24.0-255,3602,267294,7,384863
23060,0.002263,172.31.36.0-255,66,267360,7,384863
23061,0.00228,74.125.24.0-255,1484,268844,7,384863
23062,0.004526,74.125.24.0-255,4320,273164,7,384863
23063,0.004534,172.31.36.0-255,66,273230,7,384863
23064,0.006799,74.125.24.0-255,5738,278968,7,384863
23065,0.01438,74.125.24.0-255,1484,280452,7,384863
23066,0.016369,172.31.36.0-255,66,280518,7,384863
23067,0.01865,74.125.24.0-255,5738,286256,7,384863
23068,0.018663,172.31.36.0-255,66,286322,7,384863
23069,0.020946,74.125.24.0-255,5738,292060,7,384863
23070,0.020955,172.31.36.0-255,66,292126,7,384863
23071,0.023241,74.125.24.0-255,5738,297864,7,384863
23072,0.02325,172.31.36.0-255,66,297930,7,384863
23073,0.025507,74.125.24.0-255,5738,303668,7,384863
23074,0.025519,172.31.36.0-255,66,303734,7,384863
23075,0.027788,74.125.24.0-255,5738,309472,7,384863
23076,0.027798,172.31.36.0-255,66,309538,7,384863
23077,0.030075,74.125.24.0-255,5738,315276,7,384863
23078,0.030084,172.31.36.0-255,66,315342,7,384863
23079,0.032363,74.125.24.0-255,5738,321080,7,384863
23080,0.032371,172.31.36.0-255,66,321146,7,384863
23081,0.034642,74.125.24.0-255,5738,326884,7,384863
23082,0.034651,172.31.36.0-255,66,326950,7,384863
23083,0.036897,74.125.24.0-255,5738,332688,7,384863
23084,0.036905,172.31.36.0-255,66,332754,7,384863
23085,0.039175,74.125.24.0-255,5738,338492,7,384863
23086,0.039183,172.31.36.0-255,66,338558,7,384863
23087,0.040786,172.31.36.0-255,172,338730,7,384863
23088,0.040816,172.31.36.0-255,1114,339844,7,384863
23089,0.040879,172.31.36.0-255,1514,341358,7,384863
23090,0.040881,172.31.36.0-255,1292,342650,7,384863
23091,0.041434,74.125.24.0-255,5738,348388,7,384863
23092,0.041441,172.31.36.0-255,66,348454,7,384863
23093,0.042338,104.244.42.0-255,66,348520,7,384863
23094,0.042386,104.244.42.0-255,66,348586,7,384863
23095,0.042406,104.244.42.0-255,66,348652,7,384863
23096,0.042985,104.244.42.0-255,108,348760,7,384863
23097,0.04299,172.31.36.0-255,66,348826,7,384863
23098,0.04375,74.125.24.0-255,5738,354564,7,384863
23099,0.043755,172.31.36.0-255,66,354630,7,384863
23100,0.046019,74.125.24.0-255,5738,360368,7,384863
23101,0.046028,172.31.36.0-255,66,360434,7,384863
23102,0.048298,74.125.24.0-255,5738,366172,7,384863
23103,0.048305,172.31.36.0-255,66,366238,7,384863
23104,0.050559,74.125.24.0-255,5738,371976,7,384863
23105,0.050566,172.31.36.0-255,66,372042,7,384863
23106,0.052842,74.125.24.0-255,5738,377780,7,384863
23107,0.052849,172.31.36.0-255,66,377846,7,384863
23108,0.055134,74.125.24.0-255,5738,383584,7,384863
23109,0.055142,172.31.36.0-255,66,383650,7,384863
23110,0.057402,74.125.24.0-255,976,384626,7,384863
23111,0.057548,172.31.36.0-255,66,384692,7,384863
23112,0.057586,172.31.36.0-255,105,384797,7,384863
23113,0.059816,74.125.24.0-255,66,384863,7,384863
23114,0.0,74.125.68.0-255,150,150,7,389761
23115,3.3e-05,172.31.36.0-255,66,216,7,389761
23116,4e-05,74.125.68.0-255,1484,1700,7,389761
23117,4.5e-05,172.31.36.0-255,66,1766,7,389761
23118,5e-05,74.125.68.0-255,2902,4668,7,389761
23119,5.3e-05,172.31.36.0-255,66,4734,7,389761
23120,5.7e-05,74.125.68.0-255,2902,7636,7,389761
23121,5.9e-05,172.31.36.0-255,66,7702,7,389761
23122,7.8e-05,74.125.68.0-255,2902,10604,7,389761
23123,8e-05,172.31.36.0-255,66,10670,7,389761
23124,8.5e-05,74.125.68.0-255,3505,14175,7,389761
23125,9e-05,172.31.36.0-255,66,14241,7,389761
23126,0.000179,74.125.68.0-255,1484,15725,7,389761
23127,0.000183,172.31.36.0-255,66,15791,7,389761
23128,0.000189,74.125.68.0-255,2902,18693,7,389761
23129,0.000192,172.31.36.0-255,66,18759,7,389761
23130,0.000195,74.125.68.0-255,1484,20243,7,389761
23131,0.000197,172.31.36.0-255,66,20309,7,389761
23132,0.000212,74.125.68.0-255,4320,24629,7,389761
23133,0.000215,172.31.36.0-255,66,24695,7,389761
23134,0.000246,74.125.68.0-255,6797,31492,7,389761
23135,0.000249,172.31.36.0-255,66,31558,7,389761
23136,0.000273,74.125.68.0-255,7156,38714,7,389761
23137,0.000276,172.31.36.0-255,66,38780,7,389761
23138,0.000297,74.125.68.0-255,5738,44518,7,389761
23139,0.0003,172.31.36.0-255,66,44584,7,389761
23140,0.000316,74.125.68.0-255,3961,48545,7,389761
23141,0.00032,172.31.36.0-255,66,48611,7,389761
23142,0.000343,74.125.68.0-255,1484,50095,7,389761
23143,0.000346,172.31.36.0-255,66,50161,7,389761
23144,0.000349,74.125.68.0-255,1484,51645,7,389761
23145,0.000352,172.31.36.0-255,66,51711,7,389761
23146,0.000365,74.125.68.0-255,1484,53195,7,389761
23147,0.000394,74.125.68.0-255,5738,58933,7,389761
23148,0.000398,172.31.36.0-255,66,58999,7,389761
23149,0.000405,74.125.68.0-255,5738,64737,7,389761
23150,0.000408,172.31.36.0-255,66,64803,7,389761
23151,0.000439,74.125.68.0-255,1422,66225,7,389761
23152,0.000762,172.31.36.0-255,66,66291,7,389761
23153,0.001032,74.125.68.0-255,380,66671,7,389761
23154,0.001156,74.125.68.0-255,1484,68155,7,389761
23155,0.001162,172.31.36.0-255,66,68221,7,389761
23156,0.001169,74.125.68.0-255,2902,71123,7,389761
23157,0.001171,172.31.36.0-255,66,71189,7,389761
23158,0.001196,74.125.68.0-255,5738,76927,7,389761
23159,0.001198,172.31.36.0-255,66,76993,7,389761
23160,0.001205,74.125.68.0-255,5738,82731,7,389761
23161,0.001207,172.31.36.0-255,66,82797,7,389761
23162,0.00123,74.125.68.0-255,4320,87117,7,389761
23163,0.001233,172.31.36.0-255,66,87183,7,389761
23164,0.001245,74.125.68.0-255,2543,89726,7,389761
23165,0.001247,172.31.36.0-255,66,89792,7,389761
23166,0.001251,74.125.68.0-255,1484,91276,7,389761
23167,0.001279,74.125.68.0-255,7156,98432,7,389761
23168,0.001282,172.31.36.0-255,66,98498,7,389761
23169,0.0013,74.125.68.0-255,2543,101041,7,389761
23170,0.001303,172.31.36.0-255,66,101107,7,389761
23171,0.001563,74.125.68.0-255,1484,102591,7,389761
23172,0.001577,74.125.68.0-255,2902,105493,7,389761
23173,0.00158,172.31.36.0-255,66,105559,7,389761
23174,0.001583,74.125.68.0-255,1484,107043,7,389761
23175,0.0016,74.125.68.0-255,4320,111363,7,389761
23176,0.001602,172.31.36.0-255,66,111429,7,389761
23177,0.001606,74.125.68.0-255,2902,114331,7,389761
23178,0.001608,172.31.36.0-255,66,114397,7,389761
23179,0.001632,74.125.68.0-255,4320,118717,7,389761
23180,0.001634,172.31.36.0-255,66,118783,7,389761
23181,0.001648,74.125.68.0-255,4320,123103,7,389761
23182,0.001651,172.31.36.0-255,66,123169,7,389761
23183,0.00167,74.125.68.0-255,4320,127489,7,389761
23184,0.001672,172.31.36.0-255,66,127555,7,389761
23185,0.001678,74.125.68.0-255,5738,133293,7,389761
23186,0.00168,172.31.36.0-255,66,133359,7,389761
23187,0.001712,74.125.68.0-255,2184,135543,7,389761
23188,0.001715,172.31.36.0-255,66,135609,7,389761
23189,0.002019,74.125.68.0-255,1484,137093,7,389761
23190,0.002029,74.125.68.0-255,1484,138577,7,389761
23191,0.002032,172.31.36.0-255,66,138643,7,389761
23192,0.002048,74.125.68.0-255,1484,140127,7,389761
23193,0.002053,74.125.68.0-255,5738,145865,7,389761
23194,0.002056,172.31.36.0-255,66,145931,7,389761
23195,0.00206,74.125.68.0-255,2902,148833,7,389761
23196,0.002062,172.31.36.0-255,66,148899,7,389761
23197,0.002076,74.125.68.0-255,2902,151801,7,389761
23198,0.002078,172.31.36.0-255,66,151867,7,389761
23199,0.002087,74.125.68.0-255,1484,153351,7,389761
23200,0.002119,74.125.68.0-255,2902,156253,7,389761
23201,0.002122,172.31.36.0-255,66,156319,7,389761
23202,0.002142,74.125.68.0-255,4320,160639,7,389761
23203,0.002144,172.31.36.0-255,66,160705,7,389761
23204,0.002165,74.125.68.0-255,5738,166443,7,389761
23205,0.002167,172.31.36.0-255,66,166509,7,389761
23206,0.002184,74.125.68.0-255,2902,169411,7,389761
23207,0.002186,172.31.36.0-255,66,169477,7,389761
23208,0.002189,74.125.68.0-255,766,170243,7,389761
23209,0.002191,74.125.68.0-255,1484,171727,7,389761
23210,0.002193,172.31.36.0-255,66,171793,7,389761
23211,0.002196,74.125.68.0-255,1484,173277,7,389761
23212,0.002212,74.125.68.0-255,2902,176179,7,389761
23213,0.002214,172.31.36.0-255,66,176245,7,389761
23214,0.002219,74.125.68.0-255,4320,180565,7,389761
23215,0.002221,172.31.36.0-255,66,180631,7,389761
23216,0.002243,74.125.68.0-255,4320,184951,7,389761
23217,0.002245,172.31.36.0-255,66,185017,7,389761
23218,0.002256,172.31.36.0-255,66,185083,7,389761
23219,0.002314,74.125.68.0-255,7156,192239,7,389761
23220,0.002316,172.31.36.0-255,66,192305,7,389761
23221,0.002332,74.125.68.0-255,2184,194489,7,389761
23222,0.002334,172.31.36.0-255,66,194555,7,389761
23223,0.004586,74.125.68.0-255,2902,197457,7,389761
23224,0.00459,172.31.36.0-255,66,197523,7,389761
23225,0.004608,74.125.68.0-255,2902,200425,7,389761
23226,0.00461,172.31.36.0-255,66,200491,7,389761
23227,0.006855,74.125.68.0-255,2902,203393,7,389761
23228,0.006862,172.31.36.0-255,66,203459,7,389761
23229,0.006887,74.125.68.0-255,2902,206361,7,389761
23230,0.006892,172.31.36.0-255,66,206427,7,389761
23231,0.009147,74.125.68.0-255,5738,212165,7,389761
23232,0.009154,172.31.36.0-255,66,212231,7,389761
23233,0.011448,74.125.68.0-255,5738,217969,7,389761
23234,0.011455,172.31.36.0-255,66,218035,7,389761
23235,0.013745,74.125.68.0-255,5738,223773,7,389761
23236,0.013754,172.31.36.0-255,66,223839,7,389761
23237,0.016047,74.125.68.0-255,5738,229577,7,389761
23238,0.016055,172.31.36.0-255,66,229643,7,389761
23239,0.018349,74.125.68.0-255,5738,235381,7,389761
23240,0.018357,172.31.36.0-255,66,235447,7,389761
23241,0.020634,74.125.68.0-255,5738,241185,7,389761
23242,0.020641,172.31.36.0-255,66,241251,7,389761
23243,0.022931,74.125.68.0-255,4320,245571,7,389761
23244,0.022939,172.31.36.0-255,66,245637,7,389761
23245,0.022972,74.125.68.0-255,1484,247121,7,389761
23246,0.025222,74.125.68.0-255,4320,251441,7,389761
23247,0.025228,172.31.36.0-255,66,251507,7,389761
23248,0.025646,172.31.36.0-255,172,251679,7,389761
23249,0.025674,172.31.36.0-255,1114,252793,7,389761
23250,0.025711,172.31.36.0-255,1514,254307,7,389761
23251,0.025713,172.31.36.0-255,1292,255599,7,389761
23252,0.027185,104.244.42.0-255,66,255665,7,389761
23253,0.027218,104.244.42.0-255,66,255731,7,389761
23254,0.027261,104.244.42.0-255,66,255797,7,389761
23255,0.027515,74.125.68.0-255,5738,261535,7,389761
23256,0.027522,172.31.36.0-255,66,261601,7,389761
23257,0.027902,104.244.42.0-255,108,261709,7,389761
23258,0.02791,172.31.36.0-255,66,261775,7,389761
23259,0.029795,74.125.68.0-255,2902,264677,7,389761
23260,0.029799,172.31.36.0-255,66,264743,7,389761
23261,0.029831,74.125.68.0-255,2902,267645,7,389761
23262,0.029834,172.31.36.0-255,66,267711,7,389761
23263,0.032063,74.125.68.0-255,2902,270613,7,389761
23264,0.032068,172.31.36.0-255,66,270679,7,389761
23265,0.032105,74.125.68.0-255,2902,273581,7,389761
23266,0.032109,172.31.36.0-255,66,273647,7,389761
23267,0.03434,74.125.68.0-255,2902,276549,7,389761
23268,0.034345,172.31.36.0-255,66,276615,7,389761
23269,0.034385,74.125.68.0-255,2902,279517,7,389761
23270,0.034388,172.31.36.0-255,66,279583,7,389761
23271,0.036622,74.125.68.0-255,2902,282485,7,389761
23272,0.036627,172.31.36.0-255,66,282551,7,389761
23273,0.036656,74.125.68.0-255,2902,285453,7,389761
23274,0.036659,172.31.36.0-255,66,285519,7,389761
23275,0.038906,74.125.68.0-255,2902,288421,7,389761
23276,0.038911,172.31.36.0-255,66,288487,7,389761
23277,0.038941,74.125.68.0-255,2902,291389,7,389761
23278,0.038944,172.31.36.0-255,66,291455,7,389761
23279,0.041194,74.125.68.0-255,2902,294357,7,389761
23280,0.0412,172.31.36.0-255,66,294423,7,389761
23281,0.041232,74.125.68.0-255,2902,297325,7,389761
23282,0.041235,172.31.36.0-255,66,297391,7,389761
23283,0.043477,74.125.68.0-255,2902,300293,7,389761
23284,0.043484,172.31.36.0-255,66,300359,7,389761
23285,0.043518,74.125.68.0-255,2902,303261,7,389761
23286,0.043521,172.31.36.0-255,66,303327,7,389761
23287,0.045753,74.125.68.0-255,2902,306229,7,389761
23288,0.045758,172.31.36.0-255,66,306295,7,389761
23289,0.045791,74.125.68.0-255,1484,307779,7,389761
23290,0.045807,74.125.68.0-255,1484,309263,7,389761
23291,0.04581,172.31.36.0-255,66,309329,7,389761
23292,0.048045,74.125.68.0-255,2902,312231,7,389761
23293,0.04805,172.31.36.0-255,66,312297,7,389761
23294,0.048088,74.125.68.0-255,2902,315199,7,389761
23295,0.048091,172.31.36.0-255,66,315265,7,389761
23296,0.050316,74.125.68.0-255,2902,318167,7,389761
23297,0.050322,172.31.36.0-255,66,318233,7,389761
23298,0.050364,74.125.68.0-255,2902,321135,7,389761
23299,0.050368,172.31.36.0-255,66,321201,7,389761
23300,0.052602,74.125.68.0-255,2902,324103,7,389761
23301,0.052608,172.31.36.0-255,66,324169,7,389761
23302,0.052637,74.125.68.0-255,1484,325653,7,389761
23303,0.052653,74.125.68.0-255,1484,327137,7,389761
23304,0.052656,172.31.36.0-255,66,327203,7,389761
23305,0.054877,74.125.68.0-255,1484,328687,7,389761
23306,0.054943,74.125.68.0-255,4320,333007,7,389761
23307,0.054949,172.31.36.0-255,66,333073,7,389761
23308,0.057238,74.125.68.0-255,5738,338811,7,389761
23309,0.057242,172.31.36.0-255,66,338877,7,389761
23310,0.059524,74.125.68.0-255,5738,344615,7,389761
23311,0.059531,172.31.36.0-255,66,344681,7,389761
23312,0.061806,74.125.68.0-255,5738,350419,7,389761
23313,0.061811,172.31.36.0-255,66,350485,7,389761
23314,0.064103,74.125.68.0-255,5738,356223,7,389761
23315,0.064108,172.31.36.0-255,66,356289,7,389761
23316,0.066394,74.125.68.0-255,5738,362027,7,389761
23317,0.066399,172.31.36.0-255,66,362093,7,389761
23318,0.068687,74.125.68.0-255,5738,367831,7,389761
23319,0.068692,172.31.36.0-255,66,367897,7,389761
23320,0.070969,74.125.68.0-255,5738,373635,7,389761
23321,0.070975,172.31.36.0-255,66,373701,7,389761
23322,0.073266,74.125.68.0-255,5738,379439,7,389761
23323,0.073271,172.31.36.0-255,66,379505,7,389761
23324,0.075578,74.125.68.0-255,4320,383825,7,389761
23325,0.075584,172.31.36.0-255,66,383891,7,389761
23326,0.075616,74.125.68.0-255,1484,385375,7,389761
23327,0.077872,74.125.68.0-255,4320,389695,7,389761
23328,0.077878,172.31.36.0-255,66,389761,7,389761
23329,0.0,172.217.194.0-255,153,153,7,222752
23330,2.2e-05,172.31.36.0-255,66,219,7,222752
23331,2.7e-05,172.217.194.0-255,1484,1703,7,222752
23332,3.1e-05,172.31.36.0-255,66,1769,7,222752
23333,3.6e-05,172.217.194.0-255,2902,4671,7,222752
23334,4.4e-05,172.31.36.0-255,66,4737,7,222752
23335,5.1e-05,172.217.194.0-255,7156,11893,7,222752
23336,5.3e-05,172.31.36.0-255,66,11959,7,222752
23337,9.4e-05,172.217.194.0-255,2054,14013,7,222752
23338,9.6e-05,172.31.36.0-255,66,14079,7,222752
23339,0.000196,172.217.194.0-255,1484,15563,7,222752
23340,0.0002,172.31.36.0-255,66,15629,7,222752
23341,0.000206,172.217.194.0-255,2902,18531,7,222752
23342,0.000209,172.31.36.0-255,66,18597,7,222752
23343,0.000214,172.217.194.0-255,5738,24335,7,222752
23344,0.000222,172.31.36.0-255,66,24401,7,222752
23345,0.000227,172.217.194.0-255,4320,28721,7,222752
23346,0.000229,172.31.36.0-255,66,28787,7,222752
23347,0.000279,172.217.194.0-255,2543,31330,7,222752
23348,0.000283,172.31.36.0-255,66,31396,7,222752
23349,0.000306,172.217.194.0-255,2902,34298,7,222752
23350,0.000309,172.31.36.0-255,66,34364,7,222752
23351,0.000333,172.217.194.0-255,5738,40102,7,222752
23352,0.000336,172.31.36.0-255,66,40168,7,222752
23353,0.000347,172.217.194.0-255,1484,41652,7,222752
23354,0.000354,172.31.36.0-255,66,41718,7,222752
23355,0.000385,172.217.194.0-255,6797,48515,7,222752
23356,0.000388,172.31.36.0-255,66,48581,7,222752
23357,0.0007,172.217.194.0-255,1484,50065,7,222752
23358,0.000705,172.31.36.0-255,66,50131,7,222752
23359,0.000709,172.217.194.0-255,1484,51615,7,222752
23360,0.000711,172.31.36.0-255,66,51681,7,222752
23361,0.00075,172.217.194.0-255,1484,53165,7,222752
23362,0.000757,172.217.194.0-255,5738,58903,7,222752
23363,0.00076,172.31.36.0-255,66,58969,7,222752
23364,0.000766,172.217.194.0-255,6797,65766,7,222752
23365,0.000768,172.31.36.0-255,66,65832,7,222752
23366,0.000792,172.217.194.0-255,4320,70152,7,222752
23367,0.000794,172.31.36.0-255,66,70218,7,222752
23368,0.000797,172.217.194.0-255,1484,71702,7,222752
23369,0.000826,172.217.194.0-255,4320,76022,7,222752
23370,0.000829,172.31.36.0-255,66,76088,7,222752
23371,0.000833,172.217.194.0-255,2902,78990,7,222752
23372,0.000835,172.31.36.0-255,66,79056,7,222752
23373,0.000861,172.217.194.0-255,3961,83017,7,222752
23374,0.000864,172.31.36.0-255,66,83083,7,222752
23375,0.000887,172.217.194.0-255,5738,88821,7,222752
23376,0.000891,172.31.36.0-255,66,88887,7,222752
23377,0.000912,172.217.194.0-255,2065,90952,7,222752
23378,0.000915,172.31.36.0-255,66,91018,7,222752
23379,0.000924,172.31.36.0-255,66,91084,7,222752
23380,0.000931,172.217.194.0-255,1125,92209,7,222752
23381,0.001079,172.31.36.0-255,66,92275,7,222752
23382,0.001206,172.217.194.0-255,1484,93759,7,222752
23383,0.001214,172.217.194.0-255,2902,96661,7,222752
23384,0.001217,172.31.36.0-255,66,96727,7,222752
23385,0.001221,172.217.194.0-255,1484,98211,7,222752
23386,0.001244,172.217.194.0-255,4320,102531,7,222752
23387,0.001247,172.31.36.0-255,66,102597,7,222752
23388,0.001253,172.217.194.0-255,5738,108335,7,222752
23389,0.001255,172.31.36.0-255,66,108401,7,222752
23390,0.001274,172.217.194.0-255,4320,112721,7,222752
23391,0.001276,172.31.36.0-255,66,112787,7,222752
23392,0.001317,172.31.36.0-255,66,112853,7,222752
23393,0.001322,172.217.194.0-255,5020,117873,7,222752
23394,0.001324,172.31.36.0-255,66,117939,7,222752
23395,0.001335,172.217.194.0-255,5738,123677,7,222752
23396,0.001337,172.31.36.0-255,66,123743,7,222752
23397,0.001365,172.217.194.0-255,1484,125227,7,222752
23398,0.001389,172.31.36.0-255,66,125293,7,222752
23399,0.001392,172.217.194.0-255,1484,126777,7,222752
23400,0.0014,172.217.194.0-255,7156,133933,7,222752
23401,0.001402,172.31.36.0-255,66,133999,7,222752
23402,0.001439,172.217.194.0-255,6438,140437,7,222752
23403,0.001442,172.31.36.0-255,66,140503,7,222752
23404,0.001454,172.31.36.0-255,66,140569,7,222752
23405,0.001471,172.31.36.0-255,66,140635,7,222752
23406,0.001493,172.217.194.0-255,3602,144237,7,222752
23407,0.001496,172.31.36.0-255,66,144303,7,222752
23408,0.001503,172.217.194.0-255,1484,145787,7,222752
23409,0.001507,172.217.194.0-255,2902,148689,7,222752
23410,0.001509,172.31.36.0-255,66,148755,7,222752
23411,0.001544,172.217.194.0-255,5738,154493,7,222752
23412,0.001547,172.31.36.0-255,66,154559,7,222752
23413,0.001561,172.31.36.0-255,66,154625,7,222752
23414,0.001587,172.217.194.0-255,1484,156109,7,222752
23415,0.001598,172.31.36.0-255,66,156175,7,222752
23416,0.001601,172.217.194.0-255,1484,157659,7,222752
23417,0.001633,172.217.194.0-255,5738,163397,7,222752
23418,0.001637,172.31.36.0-255,66,163463,7,222752
23419,0.001645,172.31.36.0-255,66,163529,7,222752
23420,0.00166,172.217.194.0-255,7156,170685,7,222752
23421,0.001663,172.31.36.0-255,66,170751,7,222752
23422,0.001698,172.31.36.0-255,66,170817,7,222752
23423,0.001701,172.217.194.0-255,766,171583,7,222752
23424,0.001726,172.31.36.0-255,66,171649,7,222752
23425,0.001773,172.31.36.0-255,66,171715,7,222752
23426,0.001782,172.31.36.0-255,66,171781,7,222752
23427,0.00182,172.217.194.0-255,6438,178219,7,222752
23428,0.001823,172.31.36.0-255,66,178285,7,222752
23429,0.001871,172.217.194.0-255,7156,185441,7,222752
23430,0.001874,172.31.36.0-255,66,185507,7,222752
23431,0.001877,172.217.194.0-255,1484,186991,7,222752
23432,0.00188,172.217.194.0-255,2902,189893,7,222752
23433,0.001882,172.31.36.0-255,66,189959,7,222752
23434,0.001909,172.217.194.0-255,7156,197115,7,222752
23435,0.001912,172.31.36.0-255,66,197181,7,222752
23436,0.001945,172.31.36.0-255,66,197247,7,222752
23437,0.002013,172.31.36.0-255,66,197313,7,222752
23438,0.002022,172.31.36.0-255,66,197379,7,222752
23439,0.002031,172.217.194.0-255,5738,203117,7,222752
23440,0.002033,172.31.36.0-255,66,203183,7,222752
23441,0.002072,172.31.36.0-255,66,203249,7,222752
23442,0.002161,172.217.194.0-255,1484,204733,7,222752
23443,0.002165,172.217.194.0-255,1484,206217,7,222752
23444,0.002167,172.31.36.0-255,66,206283,7,222752
23445,0.002191,172.217.194.0-255,1484,207767,7,222752
23446,0.002197,172.217.194.0-255,5738,213505,7,222752
23447,0.002199,172.31.36.0-255,66,213571,7,222752
23448,0.002229,172.217.194.0-255,4320,217891,7,222752
23449,0.002232,172.31.36.0-255,66,217957,7,222752
23450,0.002268,172.31.36.0-255,66,218023,7,222752
23451,0.002271,172.217.194.0-255,97,218120,7,222752
23452,0.002274,172.217.194.0-255,105,218225,7,222752
23453,0.006314,172.31.36.0-255,66,218291,7,222752
23454,0.00634,172.31.36.0-255,105,218396,7,222752
23455,0.008359,172.217.194.0-255,66,218462,7,222752
23456,0.029009,172.31.36.0-255,172,218634,7,222752
23457,0.02904,172.31.36.0-255,1115,219749,7,222752
23458,0.029083,172.31.36.0-255,1514,221263,7,222752
23459,0.029085,172.31.36.0-255,1291,222554,7,222752
23460,0.030565,104.244.42.0-255,66,222620,7,222752
23461,0.030598,104.244.42.0-255,66,222686,7,222752
23462,0.030648,104.244.42.0-255,66,222752,7,222752
23463,0.0,74.125.24.0-255,153,153,7,311778
23464,3.3e-05,172.31.36.0-255,66,219,7,311778
23465,4e-05,74.125.24.0-255,1484,1703,7,311778
23466,4.5e-05,172.31.36.0-255,66,1769,7,311778
23467,5e-05,74.125.24.0-255,2902,4671,7,311778
23468,5.3e-05,172.31.36.0-255,66,4737,7,311778
23469,6e-05,74.125.24.0-255,7156,11893,7,311778
23470,6.2e-05,172.31.36.0-255,66,11959,7,311778
23471,6.8e-05,74.125.24.0-255,2039,13998,7,311778
23472,7.1e-05,172.31.36.0-255,66,14064,7,311778
23473,0.000148,74.125.24.0-255,1484,15548,7,311778
23474,0.000152,172.31.36.0-255,66,15614,7,311778
23475,0.000156,74.125.24.0-255,1484,17098,7,311778
23476,0.000158,172.31.36.0-255,66,17164,7,311778
23477,0.000171,74.125.24.0-255,1484,18648,7,311778
23478,0.000174,172.31.36.0-255,66,18714,7,311778
23479,0.000182,74.125.24.0-255,5738,24452,7,311778
23480,0.000184,172.31.36.0-255,66,24518,7,311778
23481,0.000204,74.125.24.0-255,2902,27420,7,311778
23482,0.000207,172.31.36.0-255,66,27486,7,311778
23483,0.000228,74.125.24.0-255,3961,31447,7,311778
23484,0.000231,172.31.36.0-255,66,31513,7,311778
23485,0.000672,74.125.24.0-255,1484,32997,7,311778
23486,0.000678,172.31.36.0-255,66,33063,7,311778
23487,0.000688,74.125.24.0-255,2902,35965,7,311778
23488,0.00069,172.31.36.0-255,66,36031,7,311778
23489,0.000695,74.125.24.0-255,2902,38933,7,311778
23490,0.000698,172.31.36.0-255,66,38999,7,311778
23491,0.000721,74.125.24.0-255,2902,41901,7,311778
23492,0.000725,172.31.36.0-255,66,41967,7,311778
23493,0.000732,74.125.24.0-255,6797,48764,7,311778
23494,0.000734,172.31.36.0-255,66,48830,7,311778
23495,0.000973,74.125.24.0-255,1484,50314,7,311778
23496,0.000981,74.125.24.0-255,2902,53216,7,311778
23497,0.000984,172.31.36.0-255,66,53282,7,311778
23498,0.000991,74.125.24.0-255,5738,59020,7,311778
23499,0.000993,172.31.36.0-255,66,59086,7,311778
23500,0.001041,74.125.24.0-255,6797,65883,7,311778
23501,0.001045,172.31.36.0-255,66,65949,7,311778
23502,0.001534,74.125.24.0-255,1484,67433,7,311778
23503,0.001543,74.125.24.0-255,2902,70335,7,311778
23504,0.001547,172.31.36.0-255,66,70401,7,311778
23505,0.001554,74.125.24.0-255,4320,74721,7,311778
23506,0.001556,172.31.36.0-255,66,74787,7,311778
23507,0.001579,74.125.24.0-255,1484,76271,7,311778
23508,0.001613,172.31.36.0-255,66,76337,7,311778
23509,0.001624,172.31.36.0-255,66,76403,7,311778
23510,0.001647,74.125.24.0-255,2902,79305,7,311778
23511,0.00165,74.125.24.0-255,1125,80430,7,311778
23512,0.001654,172.31.36.0-255,66,80496,7,311778
23513,0.00167,74.125.24.0-255,646,81142,7,311778
23514,0.001673,172.31.36.0-255,66,81208,7,311778
23515,0.003609,74.125.24.0-255,4320,85528,7,311778
23516,0.003614,172.31.36.0-255,66,85594,7,311778
23517,0.003655,74.125.24.0-255,1484,87078,7,311778
23518,0.005566,74.125.24.0-255,4320,91398,7,311778
23519,0.005571,172.31.36.0-255,66,91464,7,311778
23520,0.007523,74.125.24.0-255,5738,97202,7,311778
23521,0.00753,172.31.36.0-255,66,97268,7,311778
23522,0.009481,74.125.24.0-255,5738,103006,7,311778
23523,0.00949,172.31.36.0-255,66,103072,7,311778
23524,0.011441,74.125.24.0-255,5738,108810,7,311778
23525,0.01145,172.31.36.0-255,66,108876,7,311778
23526,0.013416,74.125.24.0-255,5738,114614,7,311778
23527,0.013422,172.31.36.0-255,66,114680,7,311778
23528,0.015369,74.125.24.0-255,5738,120418,7,311778
23529,0.015378,172.31.36.0-255,66,120484,7,311778
23530,0.017339,74.125.24.0-255,5738,126222,7,311778
23531,0.017347,172.31.36.0-255,66,126288,7,311778
23532,0.019328,74.125.24.0-255,5738,132026,7,311778
23533,0.01934,172.31.36.0-255,66,132092,7,311778
23534,0.021298,74.125.24.0-255,5738,137830,7,311778
23535,0.021306,172.31.36.0-255,66,137896,7,311778
23536,0.023255,74.125.24.0-255,5738,143634,7,311778
23537,0.023263,172.31.36.0-255,66,143700,7,311778
23538,0.025237,74.125.24.0-255,5738,149438,7,311778
23539,0.025246,172.31.36.0-255,66,149504,7,311778
23540,0.027209,74.125.24.0-255,5738,155242,7,311778
23541,0.027217,172.31.36.0-255,66,155308,7,311778
23542,0.029168,74.125.24.0-255,5738,161046,7,311778
23543,0.029179,172.31.36.0-255,66,161112,7,311778
23544,0.029694,172.31.36.0-255,172,161284,7,311778
23545,0.029741,172.31.36.0-255,1113,162397,7,311778
23546,0.029829,172.31.36.0-255,1514,163911,7,311778
23547,0.029832,172.31.36.0-255,1514,165425,7,311778
23548,0.029833,172.31.36.0-255,1514,166939,7,311778
23549,0.029834,172.31.36.0-255,1514,168453,7,311778
23550,0.029888,172.31.36.0-255,1514,169967,7,311778
23551,0.02989,172.31.36.0-255,72,170039,7,311778
23552,0.031134,74.125.24.0-255,5738,175777,7,311778
23553,0.031141,172.31.36.0-255,66,175843,7,311778
23554,0.031234,104.244.42.0-255,66,175909,7,311778
23555,0.031351,104.244.42.0-255,66,175975,7,311778
23556,0.031393,104.244.42.0-255,66,176041,7,311778
23557,0.031541,104.244.42.0-255,66,176107,7,311778
23558,0.033115,74.125.24.0-255,5738,181845,7,311778
23559,0.033121,172.31.36.0-255,66,181911,7,311778
23560,0.035083,74.125.24.0-255,5738,187649,7,311778
23561,0.035088,172.31.36.0-255,66,187715,7,311778
23562,0.037067,74.125.24.0-255,5738,193453,7,311778
23563,0.037073,172.31.36.0-255,66,193519,7,311778
23564,0.039025,74.125.24.0-255,5738,199257,7,311778
23565,0.039031,172.31.36.0-255,66,199323,7,311778
23566,0.039111,172.31.36.0-255,101,199424,7,311778
23567,0.040993,74.125.24.0-255,5738,205162,7,311778
23568,0.041013,172.31.36.0-255,66,205228,7,311778
23569,0.041032,74.125.24.0-255,66,205294,7,311778
23570,0.042992,74.125.24.0-255,5738,211032,7,311778
23571,0.042997,172.31.36.0-255,66,211098,7,311778
23572,0.044968,74.125.24.0-255,5738,216836,7,311778
23573,0.044974,172.31.36.0-255,66,216902,7,311778
23574,0.046924,74.125.24.0-255,2902,219804,7,311778
23575,0.04693,172.31.36.0-255,66,219870,7,311778
23576,0.046962,74.125.24.0-255,2902,222772,7,311778
23577,0.046965,172.31.36.0-255,66,222838,7,311778
23578,0.04888,74.125.24.0-255,1484,224322,7,311778
23579,0.048907,74.125.24.0-255,4320,228642,7,311778
23580,0.048911,172.31.36.0-255,66,228708,7,311778
23581,0.050895,74.125.24.0-255,5738,234446,7,311778
23582,0.050902,172.31.36.0-255,66,234512,7,311778
23583,0.05285,74.125.24.0-255,5738,240250,7,311778
23584,0.052868,172.31.36.0-255,66,240316,7,311778
23585,0.054834,74.125.24.0-255,4320,244636,7,311778
23586,0.054841,172.31.36.0-255,66,244702,7,311778
23587,0.054859,74.125.24.0-255,1484,246186,7,311778
23588,0.056787,74.125.24.0-255,4320,250506,7,311778
23589,0.056792,172.31.36.0-255,66,250572,7,311778
23590,0.058749,74.125.24.0-255,5738,256310,7,311778
23591,0.058754,172.31.36.0-255,66,256376,7,311778
23592,0.060697,74.125.24.0-255,1484,257860,7,311778
23593,0.06073,74.125.24.0-255,4320,262180,7,311778
23594,0.060735,172.31.36.0-255,66,262246,7,311778
23595,0.062685,74.125.24.0-255,5738,267984,7,311778
23596,0.062691,172.31.36.0-255,66,268050,7,311778
23597,0.06464,74.125.24.0-255,5738,273788,7,311778
23598,0.064645,172.31.36.0-255,66,273854,7,311778
23599,0.066611,74.125.24.0-255,4320,278174,7,311778
23600,0.066616,172.31.36.0-255,66,278240,7,311778
23601,0.066643,74.125.24.0-255,1484,279724,7,311778
23602,0.068586,74.125.24.0-255,4320,284044,7,311778
23603,0.068591,172.31.36.0-255,66,284110,7,311778
23604,0.070542,74.125.24.0-255,5738,289848,7,311778
23605,0.070547,172.31.36.0-255,66,289914,7,311778
23606,0.072492,74.125.24.0-255,4320,294234,7,311778
23607,0.072498,172.31.36.0-255,66,294300,7,311778
23608,0.072538,74.125.24.0-255,1484,295784,7,311778
23609,0.074454,74.125.24.0-255,4320,300104,7,311778
23610,0.07446,172.31.36.0-255,66,300170,7,311778
23611,0.076436,74.125.24.0-255,5738,305908,7,311778
23612,0.076445,172.31.36.0-255,66,305974,7,311778
23613,0.078439,74.125.24.0-255,5738,311712,7,311778
23614,0.078447,172.31.36.0-255,66,311778,7,311778
23615,0.0,74.125.24.0-255,146,146,7,238744
23616,2.7e-05,172.31.36.0-255,66,212,7,238744
23617,3.4e-05,74.125.24.0-255,1484,1696,7,238744
23618,3.8e-05,172.31.36.0-255,66,1762,7,238744
23619,4.4e-05,74.125.24.0-255,2902,4664,7,238744
23620,4.7e-05,172.31.36.0-255,66,4730,7,238744
23621,6.2e-05,74.125.24.0-255,7156,11886,7,238744
23622,6.5e-05,172.31.36.0-255,66,11952,7,238744
23623,7.9e-05,172.31.36.0-255,66,12018,7,238744
23624,8.4e-05,74.125.24.0-255,4320,16338,7,238744
23625,8.6e-05,172.31.36.0-255,66,16404,7,238744
23626,0.000116,74.125.24.0-255,2543,18947,7,238744
23627,0.00012,172.31.36.0-255,66,19013,7,238744
23628,0.000187,74.125.24.0-255,1484,20497,7,238744
23629,0.000191,172.31.36.0-255,66,20563,7,238744
23630,0.000197,74.125.24.0-255,2902,23465,7,238744
23631,0.000199,172.31.36.0-255,66,23531,7,238744
23632,0.000202,74.125.24.0-255,1484,25015,7,238744
23633,0.00021,172.31.36.0-255,66,25081,7,238744
23634,0.000242,74.125.24.0-255,4320,29401,7,238744
23635,0.000246,172.31.36.0-255,66,29467,7,238744
23636,0.000261,172.31.36.0-255,66,29533,7,238744
23637,0.000279,172.31.36.0-255,66,29599,7,238744
23638,0.000295,74.125.24.0-255,1434,31033,7,238744
23639,0.000299,172.31.36.0-255,66,31099,7,238744
23640,0.000837,74.125.24.0-255,113,31212,7,238744
23641,0.000844,172.31.36.0-255,66,31278,7,238744
23642,0.000872,74.125.24.0-255,1484,32762,7,238744
23643,0.000875,172.31.36.0-255,66,32828,7,238744
23644,0.000896,74.125.24.0-255,2902,35730,7,238744
23645,0.0009,172.31.36.0-255,66,35796,7,238744
23646,0.000906,74.125.24.0-255,5738,41534,7,238744
23647,0.000909,172.31.36.0-255,66,41600,7,238744
23648,0.00096,172.31.36.0-255,66,41666,7,238744
23649,0.000991,74.125.24.0-255,3961,45627,7,238744
23650,0.000995,172.31.36.0-255,66,45693,7,238744
23651,0.001004,74.125.24.0-255,7156,52849,7,238744
23652,0.001006,172.31.36.0-255,66,52915,7,238744
23653,0.001034,74.125.24.0-255,2543,55458,7,238744
23654,0.001038,172.31.36.0-255,66,55524,7,238744
23655,0.001428,74.125.24.0-255,1484,57008,7,238744
23656,0.001446,74.125.24.0-255,2902,59910,7,238744
23657,0.001451,172.31.36.0-255,66,59976,7,238744
23658,0.001457,74.125.24.0-255,4320,64296,7,238744
23659,0.001459,172.31.36.0-255,66,64362,7,238744
23660,0.001464,74.125.24.0-255,2902,67264,7,238744
23661,0.001473,172.31.36.0-255,66,67330,7,238744
23662,0.001505,74.125.24.0-255,5738,73068,7,238744
23663,0.001509,172.31.36.0-255,66,73134,7,238744
23664,0.001515,74.125.24.0-255,5738,78872,7,238744
23665,0.001518,172.31.36.0-255,66,78938,7,238744
23666,0.001531,74.125.24.0-255,7156,86094,7,238744
23667,0.001534,172.31.36.0-255,66,86160,7,238744
23668,0.001562,74.125.24.0-255,3602,89762,7,238744
23669,0.00157,172.31.36.0-255,66,89828,7,238744
23670,0.001871,74.125.24.0-255,1484,91312,7,238744
23671,0.00188,74.125.24.0-255,2902,94214,7,238744
23672,0.001883,172.31.36.0-255,66,94280,7,238744
23673,0.001891,74.125.24.0-255,5738,100018,7,238744
23674,0.001893,172.31.36.0-255,66,100084,7,238744
23675,0.001897,74.125.24.0-255,2902,102986,7,238744
23676,0.001899,172.31.36.0-255,66,103052,7,238744
23677,0.001954,172.31.36.0-255,66,103118,7,238744
23678,0.001961,74.125.24.0-255,7156,110274,7,238744
23679,0.001964,172.31.36.0-255,66,110340,7,238744
23680,0.002005,74.125.24.0-255,2902,113242,7,238744
23681,0.002008,172.31.36.0-255,66,113308,7,238744
23682,0.00206,172.31.36.0-255,66,113374,7,238744
23683,0.002078,172.31.36.0-255,66,113440,7,238744
23684,0.002081,74.125.24.0-255,1484,114924,7,238744
23685,0.002087,74.125.24.0-255,2902,117826,7,238744
23686,0.002089,172.31.36.0-255,66,117892,7,238744
23687,0.002095,74.125.24.0-255,4320,122212,7,238744
23688,0.002098,172.31.36.0-255,66,122278,7,238744
23689,0.002124,74.125.24.0-255,1484,123762,7,238744
23690,0.002144,172.31.36.0-255,66,123828,7,238744
23691,0.002173,172.31.36.0-255,66,123894,7,238744
23692,0.002204,74.125.24.0-255,6438,130332,7,238744
23693,0.002207,172.31.36.0-255,66,130398,7,238744
23694,0.002219,172.31.36.0-255,66,130464,7,238744
23695,0.002254,74.125.24.0-255,4320,134784,7,238744
23696,0.002257,172.31.36.0-255,66,134850,7,238744
23697,0.002263,74.125.24.0-255,5738,140588,7,238744
23698,0.002265,172.31.36.0-255,66,140654,7,238744
23699,0.002271,74.125.24.0-255,7156,147810,7,238744
23700,0.002274,172.31.36.0-255,66,147876,7,238744
23701,0.002321,172.31.36.0-255,66,147942,7,238744
23702,0.002326,74.125.24.0-255,4320,152262,7,238744
23703,0.002328,172.31.36.0-255,66,152328,7,238744
23704,0.002379,172.31.36.0-255,66,152394,7,238744
23705,0.002408,172.31.36.0-255,66,152460,7,238744
23706,0.002419,172.31.36.0-255,66,152526,7,238744
23707,0.004717,74.125.24.0-255,1484,154010,7,238744
23708,0.004737,74.125.24.0-255,4320,158330,7,238744
23709,0.004741,172.31.36.0-255,66,158396,7,238744
23710,0.007089,74.125.24.0-255,5738,164134,7,238744
23711,0.007097,172.31.36.0-255,66,164200,7,238744
23712,0.009427,74.125.24.0-255,5738,169938,7,238744
23713,0.009438,172.31.36.0-255,66,170004,7,238744
23714,0.011758,74.125.24.0-255,5738,175742,7,238744
23715,0.011766,172.31.36.0-255,66,175808,7,238744
23716,0.014108,74.125.24.0-255,5738,181546,7,238744
23717,0.014115,172.31.36.0-255,66,181612,7,238744
23718,0.016437,74.125.24.0-255,5738,187350,7,238744
23719,0.016446,172.31.36.0-255,66,187416,7,238744
23720,0.018775,74.125.24.0-255,5738,193154,7,238744
23721,0.018783,172.31.36.0-255,66,193220,7,238744
23722,0.021087,74.125.24.0-255,5738,198958,7,238744
23723,0.021095,172.31.36.0-255,66,199024,7,238744
23724,0.02342,74.125.24.0-255,5738,204762,7,238744
23725,0.023427,172.31.36.0-255,66,204828,7,238744
23726,0.025726,74.125.24.0-255,5738,210566,7,238744
23727,0.025732,172.31.36.0-255,66,210632,7,238744
23728,0.028054,74.125.24.0-255,5738,216370,7,238744
23729,0.028061,172.31.36.0-255,66,216436,7,238744
23730,0.030373,74.125.24.0-255,5738,222174,7,238744
23731,0.03038,172.31.36.0-255,66,222240,7,238744
23732,0.03081,172.31.36.0-255,188,222428,7,238744
23733,0.030838,172.31.36.0-255,958,223386,7,238744
23734,0.030879,172.31.36.0-255,1514,224900,7,238744
23735,0.030881,172.31.36.0-255,1448,226348,7,238744
23736,0.032329,104.244.42.0-255,66,226414,7,238744
23737,0.032392,104.244.42.0-255,66,226480,7,238744
23738,0.032443,104.244.42.0-255,66,226546,7,238744
23739,0.032696,74.125.24.0-255,1484,228030,7,238744
23740,0.032723,74.125.24.0-255,4320,232350,7,238744
23741,0.032728,172.31.36.0-255,66,232416,7,238744
23742,0.035041,74.125.24.0-255,5738,238154,7,238744
23743,0.035047,172.31.36.0-255,66,238220,7,238744
23744,0.037334,74.125.24.0-255,287,238507,7,238744
23745,0.03747,172.31.36.0-255,66,238573,7,238744
23746,0.037494,172.31.36.0-255,105,238678,7,238744
23747,0.039742,74.125.24.0-255,66,238744,7,238744
23748,0.0,74.125.24.0-255,143,143,7,255523
23749,3.9e-05,172.31.36.0-255,66,209,7,255523
23750,4.7e-05,74.125.24.0-255,1484,1693,7,255523
23751,5.2e-05,172.31.36.0-255,66,1759,7,255523
23752,5.7e-05,74.125.24.0-255,2902,4661,7,255523
23753,6.8e-05,172.31.36.0-255,66,4727,7,255523
23754,0.000136,74.125.24.0-255,2902,7629,7,255523
23755,0.00014,172.31.36.0-255,66,7695,7,255523
23756,0.000168,74.125.24.0-255,4320,12015,7,255523
23757,0.000172,172.31.36.0-255,66,12081,7,255523
23758,0.00042,172.31.36.0-255,66,12147,7,255523
23759,0.000449,74.125.24.0-255,594,12741,7,255523
23760,0.000453,172.31.36.0-255,66,12807,7,255523
23761,0.000853,74.125.24.0-255,5738,18545,7,255523
23762,0.000859,172.31.36.0-255,66,18611,7,255523
23763,0.001081,172.31.36.0-255,66,18677,7,255523
23764,0.001114,74.125.24.0-255,5020,23697,7,255523
23765,0.001117,172.31.36.0-255,66,23763,7,255523
23766,0.001718,74.125.24.0-255,4320,28083,7,255523
23767,0.001722,172.31.36.0-255,66,28149,7,255523
23768,0.001749,172.31.36.0-255,66,28215,7,255523
23769,0.002296,74.125.24.0-255,4320,32535,7,255523
23770,0.002925,74.125.24.0-255,1484,34019,7,255523
23771,0.003551,172.31.36.0-255,66,34085,7,255523
23772,0.005559,74.125.24.0-255,5738,39823,7,255523
23773,0.005565,172.31.36.0-255,66,39889,7,255523
23774,0.007549,74.125.24.0-255,5738,45627,7,255523
23775,0.007557,172.31.36.0-255,66,45693,7,255523
23776,0.009583,74.125.24.0-255,5738,51431,7,255523
23777,0.00959,172.31.36.0-255,66,51497,7,255523
23778,0.011581,74.125.24.0-255,5738,57235,7,255523
23779,0.011591,172.31.36.0-255,66,57301,7,255523
23780,0.01363,74.125.24.0-255,5738,63039,7,255523
23781,0.013639,172.31.36.0-255,66,63105,7,255523
23782,0.015649,74.125.24.0-255,5738,68843,7,255523
23783,0.015656,172.31.36.0-255,66,68909,7,255523
23784,0.017677,74.125.24.0-255,5738,74647,7,255523
23785,0.017684,172.31.36.0-255,66,74713,7,255523
23786,0.019699,74.125.24.0-255,5738,80451,7,255523
23787,0.019706,172.31.36.0-255,66,80517,7,255523
23788,0.021731,74.125.24.0-255,5738,86255,7,255523
23789,0.021738,172.31.36.0-255,66,86321,7,255523
23790,0.023042,172.31.36.0-255,228,86549,7,255523
23791,0.023071,172.31.36.0-255,1140,87689,7,255523
23792,0.023107,172.31.36.0-255,1514,89203,7,255523
23793,0.023108,172.31.36.0-255,1266,90469,7,255523
23794,0.023721,74.125.24.0-255,4320,94789,7,255523
23795,0.023727,172.31.36.0-255,66,94855,7,255523
23796,0.02377,74.125.24.0-255,1484,96339,7,255523
23797,0.024603,104.244.42.0-255,66,96405,7,255523
23798,0.024611,104.244.42.0-255,66,96471,7,255523
23799,0.024666,104.244.42.0-255,66,96537,7,255523
23800,0.025738,74.125.24.0-255,4320,100857,7,255523
23801,0.025745,172.31.36.0-255,66,100923,7,255523
23802,0.027758,74.125.24.0-255,5738,106661,7,255523
23803,0.027764,172.31.36.0-255,66,106727,7,255523
23804,0.029768,74.125.24.0-255,5738,112465,7,255523
23805,0.029775,172.31.36.0-255,66,112531,7,255523
23806,0.031774,74.125.24.0-255,4320,116851,7,255523
23807,0.031781,172.31.36.0-255,66,116917,7,255523
23808,0.031811,74.125.24.0-255,1484,118401,7,255523
23809,0.031814,172.31.36.0-255,66,118467,7,255523
23810,0.033778,74.125.24.0-255,4320,122787,7,255523
23811,0.033787,172.31.36.0-255,66,122853,7,255523
23812,0.033825,74.125.24.0-255,1484,124337,7,255523
23813,0.033828,172.31.36.0-255,66,124403,7,255523
23814,0.035796,74.125.24.0-255,4320,128723,7,255523
23815,0.035801,172.31.36.0-255,66,128789,7,255523
23816,0.035854,74.125.24.0-255,1484,130273,7,255523
23817,0.035857,172.31.36.0-255,66,130339,7,255523
23818,0.037778,74.125.24.0-255,2902,133241,7,255523
23819,0.037784,172.31.36.0-255,66,133307,7,255523
23820,0.037817,74.125.24.0-255,1484,134791,7,255523
23821,0.03782,172.31.36.0-255,66,134857,7,255523
23822,0.037843,74.125.24.0-255,1484,136341,7,255523
23823,0.037846,172.31.36.0-255,66,136407,7,255523
23824,0.039777,74.125.24.0-255,2902,139309,7,255523
23825,0.039783,172.31.36.0-255,66,139375,7,255523
23826,0.039824,74.125.24.0-255,2902,142277,7,255523
23827,0.039827,172.31.36.0-255,66,142343,7,255523
23828,0.041796,74.125.24.0-255,2902,145245,7,255523
23829,0.041802,172.31.36.0-255,66,145311,7,255523
23830,0.041838,74.125.24.0-255,2902,148213,7,255523
23831,0.041842,172.31.36.0-255,66,148279,7,255523
23832,0.043784,74.125.24.0-255,2902,151181,7,255523
23833,0.043791,172.31.36.0-255,66,151247,7,255523
23834,0.043837,74.125.24.0-255,2902,154149,7,255523
23835,0.043843,172.31.36.0-255,66,154215,7,255523
23836,0.045824,74.125.24.0-255,2902,157117,7,255523
23837,0.045831,172.31.36.0-255,66,157183,7,255523
23838,0.045871,74.125.24.0-255,2902,160085,7,255523
23839,0.045874,172.31.36.0-255,66,160151,7,255523
23840,0.047824,74.125.24.0-255,2902,163053,7,255523
23841,0.047831,172.31.36.0-255,66,163119,7,255523
23842,0.047869,74.125.24.0-255,2902,166021,7,255523
23843,0.047872,172.31.36.0-255,66,166087,7,255523
23844,0.049846,74.125.24.0-255,2902,168989,7,255523
23845,0.049852,172.31.36.0-255,66,169055,7,255523
23846,0.049883,74.125.24.0-255,2902,171957,7,255523
23847,0.049886,172.31.36.0-255,66,172023,7,255523
23848,0.05187,74.125.24.0-255,2902,174925,7,255523
23849,0.051875,172.31.36.0-255,66,174991,7,255523
23850,0.051909,74.125.24.0-255,2902,177893,7,255523
23851,0.051911,172.31.36.0-255,66,177959,7,255523
23852,0.05387,74.125.24.0-255,2902,180861,7,255523
23853,0.053875,172.31.36.0-255,66,180927,7,255523
23854,0.053916,74.125.24.0-255,2902,183829,7,255523
23855,0.053919,172.31.36.0-255,66,183895,7,255523
23856,0.055861,74.125.24.0-255,2902,186797,7,255523
23857,0.055865,172.31.36.0-255,66,186863,7,255523
23858,0.055915,74.125.24.0-255,2902,189765,7,255523
23859,0.055918,172.31.36.0-255,66,189831,7,255523
23860,0.057875,74.125.24.0-255,2902,192733,7,255523
23861,0.05788,172.31.36.0-255,66,192799,7,255523
23862,0.057909,74.125.24.0-255,2902,195701,7,255523
23863,0.057912,172.31.36.0-255,66,195767,7,255523
23864,0.059887,74.125.24.0-255,2902,198669,7,255523
23865,0.059892,172.31.36.0-255,66,198735,7,255523
23866,0.059926,74.125.24.0-255,2902,201637,7,255523
23867,0.059929,172.31.36.0-255,66,201703,7,255523
23868,0.061903,74.125.24.0-255,2902,204605,7,255523
23869,0.061912,172.31.36.0-255,66,204671,7,255523
23870,0.061931,74.125.24.0-255,2902,207573,7,255523
23871,0.061936,172.31.36.0-255,66,207639,7,255523
23872,0.063939,74.125.24.0-255,2902,210541,7,255523
23873,0.063945,172.31.36.0-255,66,210607,7,255523
23874,0.063972,74.125.24.0-255,2902,213509,7,255523
23875,0.063975,172.31.36.0-255,66,213575,7,255523
23876,0.065954,74.125.24.0-255,1484,215059,7,255523
23877,0.065959,172.31.36.0-255,66,215125,7,255523
23878,0.065994,74.125.24.0-255,2902,218027,7,255523
23879,0.065997,172.31.36.0-255,66,218093,7,255523
23880,0.066019,74.125.24.0-255,1484,219577,7,255523
23881,0.066022,172.31.36.0-255,66,219643,7,255523
23882,0.067962,74.125.24.0-255,1484,221127,7,255523
23883,0.067967,172.31.36.0-255,66,221193,7,255523
23884,0.067992,74.125.24.0-255,2902,224095,7,255523
23885,0.067995,172.31.36.0-255,66,224161,7,255523
23886,0.068085,74.125.24.0-255,1484,225645,7,255523
23887,0.068089,172.31.36.0-255,66,225711,7,255523
23888,0.069964,74.125.24.0-255,1484,227195,7,255523
23889,0.06997,172.31.36.0-255,66,227261,7,255523
23890,0.07,74.125.24.0-255,2902,230163,7,255523
23891,0.070004,172.31.36.0-255,66,230229,7,255523
23892,0.070077,74.125.24.0-255,1484,231713,7,255523
23893,0.070081,172.31.36.0-255,66,231779,7,255523
23894,0.071989,74.125.24.0-255,4320,236099,7,255523
23895,0.071996,172.31.36.0-255,66,236165,7,255523
23896,0.072095,74.125.24.0-255,1484,237649,7,255523
23897,0.0721,172.31.36.0-255,66,237715,7,255523
23898,0.074046,74.125.24.0-255,4320,242035,7,255523
23899,0.074052,172.31.36.0-255,66,242101,7,255523
23900,0.074089,74.125.24.0-255,1484,243585,7,255523
23901,0.074092,172.31.36.0-255,66,243651,7,255523
23902,0.076086,74.125.24.0-255,4320,247971,7,255523
23903,0.076092,172.31.36.0-255,66,248037,7,255523
23904,0.076145,74.125.24.0-255,1484,249521,7,255523
23905,0.076149,172.31.36.0-255,66,249587,7,255523
23906,0.078104,74.125.24.0-255,4320,253907,7,255523
23907,0.07811,172.31.36.0-255,66,253973,7,255523
23908,0.078157,74.125.24.0-255,1484,255457,7,255523
23909,0.07816,172.31.36.0-255,66,255523,7,255523
23910,0.0,172.217.194.0-255,156,156,7,317160
23911,2.4e-05,172.31.36.0-255,66,222,7,317160
23912,3.1e-05,172.217.194.0-255,1484,1706,7,317160
23913,3.6e-05,172.31.36.0-255,66,1772,7,317160
23914,4.2e-05,172.217.194.0-255,2902,4674,7,317160
23915,4.6e-05,172.31.36.0-255,66,4740,7,317160
23916,5.4e-05,172.217.194.0-255,7156,11896,7,317160
23917,5.6e-05,172.31.36.0-255,66,11962,7,317160
23918,0.000106,172.31.36.0-255,66,12028,7,317160
23919,0.000111,172.217.194.0-255,3961,15989,7,317160
23920,0.000114,172.31.36.0-255,66,16055,7,317160
23921,0.000154,172.217.194.0-255,4320,20375,7,317160
23922,0.000157,172.31.36.0-255,66,20441,7,317160
23923,0.00016,172.217.194.0-255,1484,21925,7,317160
23924,0.000162,172.31.36.0-255,66,21991,7,317160
23925,0.000167,172.217.194.0-255,2902,24893,7,317160
23926,0.00017,172.31.36.0-255,66,24959,7,317160
23927,0.000191,172.217.194.0-255,4320,29279,7,317160
23928,0.000193,172.31.36.0-255,66,29345,7,317160
23929,0.000201,172.217.194.0-255,7156,36501,7,317160
23930,0.000203,172.31.36.0-255,66,36567,7,317160
23931,0.000231,172.31.36.0-255,66,36633,7,317160
23932,0.000237,172.217.194.0-255,4253,40886,7,317160
23933,0.00024,172.31.36.0-255,66,40952,7,317160
23934,0.000261,172.217.194.0-255,98,41050,7,317160
23935,0.000264,172.31.36.0-255,66,41116,7,317160
23936,0.000335,172.217.194.0-255,1484,42600,7,317160
23937,0.000338,172.31.36.0-255,66,42666,7,317160
23938,0.000356,172.217.194.0-255,2902,45568,7,317160
23939,0.000358,172.31.36.0-255,66,45634,7,317160
23940,0.000365,172.217.194.0-255,5738,51372,7,317160
23941,0.000367,172.31.36.0-255,66,51438,7,317160
23942,0.000372,172.217.194.0-255,4320,55758,7,317160
23943,0.000375,172.31.36.0-255,66,55824,7,317160
23944,0.000392,172.217.194.0-255,2543,58367,7,317160
23945,0.000394,172.31.36.0-255,66,58433,7,317160
23946,0.000432,172.217.194.0-255,1484,59917,7,317160
23947,0.000438,172.217.194.0-255,2902,62819,7,317160
23948,0.000441,172.31.36.0-255,66,62885,7,317160
23949,0.00047,172.217.194.0-255,4320,67205,7,317160
23950,0.000473,172.31.36.0-255,66,67271,7,317160
23951,0.000504,172.217.194.0-255,1484,68755,7,317160
23952,0.00052,172.217.194.0-255,4320,73075,7,317160
23953,0.000522,172.31.36.0-255,66,73141,7,317160
23954,0.000536,172.31.36.0-255,66,73207,7,317160
23955,0.000548,172.31.36.0-255,66,73273,7,317160
23956,0.000576,172.217.194.0-255,4320,77593,7,317160
23957,0.000578,172.31.36.0-255,66,77659,7,317160
23958,0.000607,172.31.36.0-255,66,77725,7,317160
23959,0.00062,172.31.36.0-255,66,77791,7,317160
23960,0.000661,172.31.36.0-255,66,77857,7,317160
23961,0.000679,172.217.194.0-255,3602,81459,7,317160
23962,0.000682,172.31.36.0-255,66,81525,7,317160
23963,0.000995,172.217.194.0-255,1484,83009,7,317160
23964,0.001,172.217.194.0-255,2902,85911,7,317160
23965,0.001006,172.217.194.0-255,5738,91649,7,317160
23966,0.001017,172.31.36.0-255,66,91715,7,317160
23967,0.001021,172.31.36.0-255,66,91781,7,317160
23968,0.001025,172.217.194.0-255,1484,93265,7,317160
23969,0.00105,172.31.36.0-255,66,93331,7,317160
23970,0.001053,172.217.194.0-255,1484,94815,7,317160
23971,0.001078,172.217.194.0-255,2902,97717,7,317160
23972,0.001082,172.31.36.0-255,66,97783,7,317160
23973,0.001103,172.217.194.0-255,6438,104221,7,317160
23974,0.001106,172.31.36.0-255,66,104287,7,317160
23975,0.001911,172.217.194.0-255,1484,105771,7,317160
23976,0.00193,172.217.194.0-255,2902,108673,7,317160
23977,0.001934,172.31.36.0-255,66,108739,7,317160
23978,0.00194,172.217.194.0-255,5738,114477,7,317160
23979,0.001942,172.31.36.0-255,66,114543,7,317160
23980,0.001949,172.217.194.0-255,7156,121699,7,317160
23981,0.001952,172.31.36.0-255,66,121765,7,317160
23982,0.001983,172.217.194.0-255,2902,124667,7,317160
23983,0.001986,172.31.36.0-255,66,124733,7,317160
23984,0.001998,172.31.36.0-255,66,124799,7,317160
23985,0.002002,172.217.194.0-255,2184,126983,7,317160
23986,0.002004,172.31.36.0-255,66,127049,7,317160
23987,0.003996,172.217.194.0-255,5738,132787,7,317160
23988,0.004004,172.31.36.0-255,66,132853,7,317160
23989,0.006075,172.217.194.0-255,2902,135755,7,317160
23990,0.006079,172.31.36.0-255,66,135821,7,317160
23991,0.006096,172.217.194.0-255,2902,138723,7,317160
23992,0.006098,172.31.36.0-255,66,138789,7,317160
23993,0.008088,172.217.194.0-255,5738,144527,7,317160
23994,0.008094,172.31.36.0-255,66,144593,7,317160
23995,0.010091,172.217.194.0-255,5738,150331,7,317160
23996,0.010097,172.31.36.0-255,66,150397,7,317160
23997,0.012076,172.217.194.0-255,5738,156135,7,317160
23998,0.012085,172.31.36.0-255,66,156201,7,317160
23999,0.014089,172.217.194.0-255,5738,161939,7,317160
24000,0.014097,172.31.36.0-255,66,162005,7,317160
24001,0.016156,172.217.194.0-255,5738,167743,7,317160
24002,0.016168,172.31.36.0-255,66,167809,7,317160
24003,0.018154,172.217.194.0-255,5738,173547,7,317160
24004,0.018163,172.31.36.0-255,66,173613,7,317160
24005,0.020268,172.217.194.0-255,5738,179351,7,317160
24006,0.020277,172.31.36.0-255,66,179417,7,317160
24007,0.022336,172.217.194.0-255,5738,185155,7,317160
24008,0.022343,172.31.36.0-255,66,185221,7,317160
24009,0.024319,172.217.194.0-255,5738,190959,7,317160
24010,0.024329,172.31.36.0-255,66,191025,7,317160
24011,0.026385,172.217.194.0-255,5738,196763,7,317160
24012,0.026395,172.31.36.0-255,66,196829,7,317160
24013,0.028426,172.217.194.0-255,5738,202567,7,317160
24014,0.028433,172.31.36.0-255,66,202633,7,317160
24015,0.030188,172.31.36.0-255,171,202804,7,317160
24016,0.030217,172.31.36.0-255,1138,203942,7,317160
24017,0.030274,172.31.36.0-255,1514,205456,7,317160
24018,0.030275,172.31.36.0-255,1268,206724,7,317160
24019,0.030408,172.217.194.0-255,4320,211044,7,317160
24020,0.030414,172.31.36.0-255,66,211110,7,317160
24021,0.030425,172.217.194.0-255,1484,212594,7,317160
24022,0.031718,104.244.42.0-255,66,212660,7,317160
24023,0.031754,104.244.42.0-255,66,212726,7,317160
24024,0.031879,104.244.42.0-255,66,212792,7,317160
24025,0.032417,172.217.194.0-255,4320,217112,7,317160
24026,0.032423,172.31.36.0-255,66,217178,7,317160
24027,0.034438,172.217.194.0-255,5738,222916,7,317160
24028,0.034445,172.31.36.0-255,66,222982,7,317160
24029,0.036462,172.217.194.0-255,5738,228720,7,317160
24030,0.036469,172.31.36.0-255,66,228786,7,317160
24031,0.038455,172.217.194.0-255,5738,234524,7,317160
24032,0.038462,172.31.36.0-255,66,234590,7,317160
24033,0.040489,172.217.194.0-255,5738,240328,7,317160
24034,0.040496,172.31.36.0-255,66,240394,7,317160
24035,0.042508,172.217.194.0-255,5738,246132,7,317160
24036,0.042515,172.31.36.0-255,66,246198,7,317160
24037,0.04452,172.217.194.0-255,5738,251936,7,317160
24038,0.044526,172.31.36.0-255,66,252002,7,317160
24039,0.04657,172.217.194.0-255,5738,257740,7,317160
24040,0.046577,172.31.36.0-255,66,257806,7,317160
24041,0.048581,172.217.194.0-255,5738,263544,7,317160
24042,0.048588,172.31.36.0-255,66,263610,7,317160
24043,0.050582,172.217.194.0-255,5738,269348,7,317160
24044,0.050588,172.31.36.0-255,66,269414,7,317160
24045,0.052645,172.217.194.0-255,5738,275152,7,317160
24046,0.052653,172.31.36.0-255,66,275218,7,317160
24047,0.054692,172.217.194.0-255,5738,280956,7,317160
24048,0.054698,172.31.36.0-255,66,281022,7,317160
24049,0.056729,172.217.194.0-255,5738,286760,7,317160
24050,0.056736,172.31.36.0-255,66,286826,7,317160
24051,0.058763,172.217.194.0-255,5738,292564,7,317160
24052,0.05877,172.31.36.0-255,66,292630,7,317160
24053,0.060763,172.217.194.0-255,5738,298368,7,317160
24054,0.060769,172.31.36.0-255,66,298434,7,317160
24055,0.062808,172.217.194.0-255,5738,304172,7,317160
24056,0.062814,172.31.36.0-255,66,304238,7,317160
24057,0.064833,172.217.194.0-255,5738,309976,7,317160
24058,0.06484,172.31.36.0-255,66,310042,7,317160
24059,0.06686,172.217.194.0-255,5738,315780,7,317160
24060,0.066866,172.31.36.0-255,66,315846,7,317160
24061,0.068904,172.217.194.0-255,1077,316923,7,317160
24062,0.069045,172.31.36.0-255,66,316989,7,317160
24063,0.069083,172.31.36.0-255,105,317094,7,317160
24064,0.071071,172.217.194.0-255,66,317160,7,317160
24065,0.0,74.125.200.0-255,153,153,7,383616
24066,3e-05,172.31.36.0-255,66,219,7,383616
24067,3.7e-05,74.125.200.0-255,1484,1703,7,383616
24068,4.2e-05,172.31.36.0-255,66,1769,7,383616
24069,4.7e-05,74.125.200.0-255,2902,4671,7,383616
24070,5e-05,172.31.36.0-255,66,4737,7,383616
24071,7.7e-05,74.125.200.0-255,5738,10475,7,383616
24072,8e-05,172.31.36.0-255,66,10541,7,383616
24073,0.000109,74.125.200.0-255,3471,14012,7,383616
24074,0.000113,172.31.36.0-255,66,14078,7,383616
24075,0.000117,74.125.200.0-255,1484,15562,7,383616
24076,0.000119,172.31.36.0-255,66,15628,7,383616
24077,0.000133,74.125.200.0-255,2902,18530,7,383616
24078,0.000136,172.31.36.0-255,66,18596,7,383616
24079,0.000149,74.125.200.0-255,2902,21498,7,383616
24080,0.000151,172.31.36.0-255,66,21564,7,383616
24081,0.00018,74.125.200.0-255,7156,28720,7,383616
24082,0.000183,172.31.36.0-255,66,28786,7,383616
24083,0.000187,74.125.200.0-255,2543,31329,7,383616
24084,0.00019,172.31.36.0-255,66,31395,7,383616
24085,0.000293,74.125.200.0-255,1484,32879,7,383616
24086,0.000297,172.31.36.0-255,66,32945,7,383616
24087,0.000302,74.125.200.0-255,2902,35847,7,383616
24088,0.000306,172.31.36.0-255,66,35913,7,383616
24089,0.000333,74.125.200.0-255,4320,40233,7,383616
24090,0.000339,74.125.200.0-255,5738,45971,7,383616
24091,0.000339,172.31.36.0-255,66,46037,7,383616
24092,0.000343,172.31.36.0-255,66,46103,7,383616
24093,0.000374,74.125.200.0-255,5738,51841,7,383616
24094,0.000377,172.31.36.0-255,66,51907,7,383616
24095,0.000399,74.125.200.0-255,5379,57286,7,383616
24096,0.000403,172.31.36.0-255,66,57352,7,383616
24097,0.00042,74.125.200.0-255,4320,61672,7,383616
24098,0.000424,172.31.36.0-255,66,61738,7,383616
24099,0.000445,74.125.200.0-255,4264,66002,7,383616
24100,0.000447,172.31.36.0-255,66,66068,7,383616
24101,0.000511,74.125.200.0-255,130,66198,7,383616
24102,0.000614,74.125.200.0-255,1484,67682,7,383616
24103,0.000618,172.31.36.0-255,66,67748,7,383616
24104,0.000621,74.125.200.0-255,1484,69232,7,383616
24105,0.000638,74.125.200.0-255,1484,70716,7,383616
24106,0.000641,172.31.36.0-255,66,70782,7,383616
24107,0.000648,74.125.200.0-255,5738,76520,7,383616
24108,0.000651,172.31.36.0-255,66,76586,7,383616
24109,0.000671,74.125.200.0-255,4320,80906,7,383616
24110,0.000673,172.31.36.0-255,66,80972,7,383616
24111,0.000694,74.125.200.0-255,2543,83515,7,383616
24112,0.000697,172.31.36.0-255,66,83581,7,383616
24113,0.000732,74.125.200.0-255,5738,89319,7,383616
24114,0.000736,172.31.36.0-255,66,89385,7,383616
24115,0.000745,74.125.200.0-255,4320,93705,7,383616
24116,0.000747,172.31.36.0-255,66,93771,7,383616
24117,0.000765,74.125.200.0-255,2902,96673,7,383616
24118,0.000767,172.31.36.0-255,66,96739,7,383616
24119,0.000772,74.125.200.0-255,3656,100395,7,383616
24120,0.000775,172.31.36.0-255,66,100461,7,383616
24121,0.000814,74.125.200.0-255,2902,103363,7,383616
24122,0.000818,172.31.36.0-255,66,103429,7,383616
24123,0.000836,74.125.200.0-255,1484,104913,7,383616
24124,0.000841,74.125.200.0-255,4320,109233,7,383616
24125,0.000846,172.31.36.0-255,66,109299,7,383616
24126,0.000857,74.125.200.0-255,1484,110783,7,383616
24127,0.000885,74.125.200.0-255,6797,117580,7,383616
24128,0.000888,172.31.36.0-255,66,117646,7,383616
24129,0.001092,74.125.200.0-255,1484,119130,7,383616
24130,0.00111,74.125.200.0-255,2902,122032,7,383616
24131,0.001114,172.31.36.0-255,66,122098,7,383616
24132,0.001131,74.125.200.0-255,1484,123582,7,383616
24133,0.001147,74.125.200.0-255,2902,126484,7,383616
24134,0.00115,172.31.36.0-255,66,126550,7,383616
24135,0.001169,74.125.200.0-255,2902,129452,7,383616
24136,0.001172,172.31.36.0-255,66,129518,7,383616
24137,0.001198,74.125.200.0-255,2902,132420,7,383616
24138,0.001201,172.31.36.0-255,66,132486,7,383616
24139,0.001212,172.31.36.0-255,66,132552,7,383616
24140,0.001224,172.31.36.0-255,66,132618,7,383616
24141,0.001226,74.125.200.0-255,766,133384,7,383616
24142,0.001275,74.125.200.0-255,1484,134868,7,383616
24143,0.001278,172.31.36.0-255,66,134934,7,383616
24144,0.001284,74.125.200.0-255,4320,139254,7,383616
24145,0.001286,172.31.36.0-255,66,139320,7,383616
24146,0.001292,74.125.200.0-255,5738,145058,7,383616
24147,0.001295,172.31.36.0-255,66,145124,7,383616
24148,0.001335,172.31.36.0-255,66,145190,7,383616
24149,0.00134,74.125.200.0-255,4320,149510,7,383616
24150,0.001342,172.31.36.0-255,66,149576,7,383616
24151,0.001383,74.125.200.0-255,2902,152478,7,383616
24152,0.001386,172.31.36.0-255,66,152544,7,383616
24153,0.001404,74.125.200.0-255,3602,156146,7,383616
24154,0.001407,172.31.36.0-255,66,156212,7,383616
24155,0.001498,74.125.200.0-255,1484,157696,7,383616
24156,0.001517,74.125.200.0-255,2902,160598,7,383616
24157,0.00152,172.31.36.0-255,66,160664,7,383616
24158,0.001524,74.125.200.0-255,1484,162148,7,383616
24159,0.001541,74.125.200.0-255,2902,165050,7,383616
24160,0.001543,172.31.36.0-255,66,165116,7,383616
24161,0.001563,74.125.200.0-255,2902,168018,7,383616
24162,0.001566,172.31.36.0-255,66,168084,7,383616
24163,0.001581,74.125.200.0-255,2902,170986,7,383616
24164,0.001583,172.31.36.0-255,66,171052,7,383616
24165,0.001587,74.125.200.0-255,1484,172536,7,383616
24166,0.001592,74.125.200.0-255,2902,175438,7,383616
24167,0.001594,172.31.36.0-255,66,175504,7,383616
24168,0.001623,74.125.200.0-255,5738,181242,7,383616
24169,0.001626,172.31.36.0-255,66,181308,7,383616
24170,0.00163,74.125.200.0-255,2902,184210,7,383616
24171,0.001632,172.31.36.0-255,66,184276,7,383616
24172,0.001655,74.125.200.0-255,4320,188596,7,383616
24173,0.001658,172.31.36.0-255,66,188662,7,383616
24174,0.001679,74.125.200.0-255,2184,190846,7,383616
24175,0.001682,172.31.36.0-255,66,190912,7,383616
24176,0.001759,74.125.200.0-255,1484,192396,7,383616
24177,0.001778,74.125.200.0-255,2902,195298,7,383616
24178,0.001781,172.31.36.0-255,66,195364,7,383616
24179,0.001803,74.125.200.0-255,4320,199684,7,383616
24180,0.001806,172.31.36.0-255,66,199750,7,383616
24181,0.001829,74.125.200.0-255,2902,202652,7,383616
24182,0.001833,172.31.36.0-255,66,202718,7,383616
24183,0.001861,74.125.200.0-255,4320,207038,7,383616
24184,0.001863,74.125.200.0-255,1484,208522,7,383616
24185,0.001865,172.31.36.0-255,66,208588,7,383616
24186,0.001891,74.125.200.0-255,7156,215744,7,383616
24187,0.001894,172.31.36.0-255,66,215810,7,383616
24188,0.001899,74.125.200.0-255,2902,218712,7,383616
24189,0.001901,172.31.36.0-255,66,218778,7,383616
24190,0.001911,74.125.200.0-255,4320,223098,7,383616
24191,0.001914,172.31.36.0-255,66,223164,7,383616
24192,0.001933,74.125.200.0-255,2184,225348,7,383616
24193,0.001937,172.31.36.0-255,66,225414,7,383616
24194,0.001942,74.125.200.0-255,2902,228316,7,383616
24195,0.001944,172.31.36.0-255,66,228382,7,383616
24196,0.001981,74.125.200.0-255,4320,232702,7,383616
24197,0.001985,172.31.36.0-255,66,232768,7,383616
24198,0.001998,74.125.200.0-255,2902,235670,7,383616
24199,0.002001,172.31.36.0-255,66,235736,7,383616
24200,0.002031,172.31.36.0-255,66,235802,7,383616
24201,0.00205,74.125.200.0-255,5738,241540,7,383616
24202,0.002053,172.31.36.0-255,66,241606,7,383616
24203,0.002081,74.125.200.0-255,4320,245926,7,383616
24204,0.002084,172.31.36.0-255,66,245992,7,383616
24205,0.002089,74.125.200.0-255,2902,248894,7,383616
24206,0.002092,172.31.36.0-255,66,248960,7,383616
24207,0.004095,74.125.200.0-255,2902,251862,7,383616
24208,0.004102,172.31.36.0-255,66,251928,7,383616
24209,0.00411,74.125.200.0-255,2902,254830,7,383616
24210,0.004112,172.31.36.0-255,66,254896,7,383616
24211,0.006104,74.125.200.0-255,5738,260634,7,383616
24212,0.006109,172.31.36.0-255,66,260700,7,383616
24213,0.008132,74.125.200.0-255,5738,266438,7,383616
24214,0.008139,172.31.36.0-255,66,266504,7,383616
24215,0.010156,74.125.200.0-255,5738,272242,7,383616
24216,0.010164,172.31.36.0-255,66,272308,7,383616
24217,0.012182,74.125.200.0-255,5738,278046,7,383616
24218,0.012189,172.31.36.0-255,66,278112,7,383616
24219,0.014215,74.125.200.0-255,5738,283850,7,383616
24220,0.014222,172.31.36.0-255,66,283916,7,383616
24221,0.016244,74.125.200.0-255,4320,288236,7,383616
24222,0.016251,172.31.36.0-255,66,288302,7,383616
24223,0.016272,74.125.200.0-255,1484,289786,7,383616
24224,0.018273,74.125.200.0-255,4320,294106,7,383616
24225,0.018281,172.31.36.0-255,66,294172,7,383616
24226,0.020345,74.125.200.0-255,5738,299910,7,383616
24227,0.020352,172.31.36.0-255,66,299976,7,383616
24228,0.022356,74.125.200.0-255,2902,302878,7,383616
24229,0.02236,172.31.36.0-255,66,302944,7,383616
24230,0.022377,74.125.200.0-255,2902,305846,7,383616
24231,0.02238,172.31.36.0-255,66,305912,7,383616
24232,0.024385,74.125.200.0-255,5738,311650,7,383616
24233,0.024392,172.31.36.0-255,66,311716,7,383616
24234,0.026412,74.125.200.0-255,5738,317454,7,383616
24235,0.026419,172.31.36.0-255,66,317520,7,383616
24236,0.02845,74.125.200.0-255,5738,323258,7,383616
24237,0.028457,172.31.36.0-255,66,323324,7,383616
24238,0.030475,74.125.200.0-255,5738,329062,7,383616
24239,0.030482,172.31.36.0-255,66,329128,7,383616
24240,0.032518,74.125.200.0-255,5738,334866,7,383616
24241,0.032525,172.31.36.0-255,66,334932,7,383616
24242,0.034546,74.125.200.0-255,5738,340670,7,383616
24243,0.034553,172.31.36.0-255,66,340736,7,383616
24244,0.036579,74.125.200.0-255,5738,346474,7,383616
24245,0.036587,172.31.36.0-255,66,346540,7,383616
24246,0.038612,74.125.200.0-255,5738,352278,7,383616
24247,0.03862,172.31.36.0-255,66,352344,7,383616
24248,0.04007,172.31.36.0-255,172,352516,7,383616
24249,0.0401,172.31.36.0-255,1073,353589,7,383616
24250,0.040646,74.125.200.0-255,5738,359327,7,383616
24251,0.040655,172.31.36.0-255,66,359393,7,383616
24252,0.041558,104.244.42.0-255,66,359459,7,383616
24253,0.041643,104.244.42.0-255,66,359525,7,383616
24254,0.042664,74.125.200.0-255,5738,365263,7,383616
24255,0.042671,172.31.36.0-255,66,365329,7,383616
24256,0.044687,74.125.200.0-255,5738,371067,7,383616
24257,0.044693,172.31.36.0-255,66,371133,7,383616
24258,0.046718,74.125.200.0-255,5738,376871,7,383616
24259,0.046723,172.31.36.0-255,66,376937,7,383616
24260,0.048729,74.125.200.0-255,4320,381257,7,383616
24261,0.048734,172.31.36.0-255,66,381323,7,383616
24262,0.048765,74.125.200.0-255,1484,382807,7,383616
24263,0.05073,74.125.200.0-255,572,383379,7,383616
24264,0.050735,172.31.36.0-255,66,383445,7,383616
24265,0.050906,172.31.36.0-255,105,383550,7,383616
24266,0.052873,74.125.200.0-255,66,383616,7,383616
24267,0.0,74.125.68.0-255,152,152,7,359213
24268,1.9e-05,172.31.36.0-255,66,218,7,359213
24269,3.7e-05,74.125.68.0-255,1484,1702,7,359213
24270,5.1e-05,172.31.36.0-255,66,1768,7,359213
24271,5.7e-05,74.125.68.0-255,2902,4670,7,359213
24272,6e-05,172.31.36.0-255,66,4736,7,359213
24273,6.6e-05,74.125.68.0-255,5738,10474,7,359213
24274,6.9e-05,172.31.36.0-255,66,10540,7,359213
24275,7.3e-05,74.125.68.0-255,2902,13442,7,359213
24276,7.5e-05,172.31.36.0-255,66,13508,7,359213
24277,9.7e-05,74.125.68.0-255,3453,16961,7,359213
24278,0.000103,172.31.36.0-255,66,17027,7,359213
24279,0.000134,74.125.68.0-255,4320,21347,7,359213
24280,0.000137,172.31.36.0-255,66,21413,7,359213
24281,0.000181,74.125.68.0-255,1484,22897,7,359213
24282,0.000184,172.31.36.0-255,66,22963,7,359213
24283,0.000209,74.125.68.0-255,2902,25865,7,359213
24284,0.000213,172.31.36.0-255,66,25931,7,359213
24285,0.000233,74.125.68.0-255,2902,28833,7,359213
24286,0.000236,172.31.36.0-255,66,28899,7,359213
24287,0.000253,74.125.68.0-255,2543,31442,7,359213
24288,0.000256,172.31.36.0-255,66,31508,7,359213
24289,0.000384,74.125.68.0-255,1484,32992,7,359213
24290,0.000388,172.31.36.0-255,66,33058,7,359213
24291,0.000411,74.125.68.0-255,2902,35960,7,359213
24292,0.000414,172.31.36.0-255,66,36026,7,359213
24293,0.00042,74.125.68.0-255,5738,41764,7,359213
24294,0.000422,172.31.36.0-255,66,41830,7,359213
24295,0.000425,74.125.68.0-255,2902,44732,7,359213
24296,0.000427,172.31.36.0-255,66,44798,7,359213
24297,0.000454,74.125.68.0-255,3961,48759,7,359213
24298,0.000458,172.31.36.0-255,66,48825,7,359213
24299,0.000481,74.125.68.0-255,7156,55981,7,359213
24300,0.000485,172.31.36.0-255,66,56047,7,359213
24301,0.000508,74.125.68.0-255,1484,57531,7,359213
24302,0.000515,74.125.68.0-255,2902,60433,7,359213
24303,0.000517,172.31.36.0-255,66,60499,7,359213
24304,0.000546,74.125.68.0-255,5659,66158,7,359213
24305,0.00055,172.31.36.0-255,66,66224,7,359213
24306,0.000553,74.125.68.0-255,131,66355,7,359213
24307,0.000642,74.125.68.0-255,1484,67839,7,359213
24308,0.000649,172.31.36.0-255,66,67905,7,359213
24309,0.000654,74.125.68.0-255,2902,70807,7,359213
24310,0.000656,172.31.36.0-255,66,70873,7,359213
24311,0.000685,74.125.68.0-255,5738,76611,7,359213
24312,0.000689,172.31.36.0-255,66,76677,7,359213
24313,0.000696,74.125.68.0-255,5738,82415,7,359213
24314,0.000699,172.31.36.0-255,66,82481,7,359213
24315,0.00071,74.125.68.0-255,5738,88219,7,359213
24316,0.000713,172.31.36.0-255,66,88285,7,359213
24317,0.00074,74.125.68.0-255,1484,89769,7,359213
24318,0.000748,74.125.68.0-255,4320,94089,7,359213
24319,0.000751,172.31.36.0-255,66,94155,7,359213
24320,0.000776,74.125.68.0-255,6438,100593,7,359213
24321,0.00078,74.125.68.0-255,342,100935,7,359213
24322,0.000792,172.31.36.0-255,66,101001,7,359213
24323,0.000937,74.125.68.0-255,1484,102485,7,359213
24324,0.000951,74.125.68.0-255,2902,105387,7,359213
24325,0.000955,172.31.36.0-255,66,105453,7,359213
24326,0.000982,74.125.68.0-255,5738,111191,7,359213
24327,0.000986,172.31.36.0-255,66,111257,7,359213
24328,0.000991,74.125.68.0-255,2902,114159,7,359213
24329,0.000994,172.31.36.0-255,66,114225,7,359213
24330,0.001029,74.125.68.0-255,7156,121381,7,359213
24331,0.001032,172.31.36.0-255,66,121447,7,359213
24332,0.001048,74.125.68.0-255,2184,123631,7,359213
24333,0.001052,172.31.36.0-255,66,123697,7,359213
24334,0.001105,74.125.68.0-255,1484,125181,7,359213
24335,0.001112,74.125.68.0-255,2902,128083,7,359213
24336,0.001117,74.125.68.0-255,4320,132403,7,359213
24337,0.001117,172.31.36.0-255,66,132469,7,359213
24338,0.001122,172.31.36.0-255,66,132535,7,359213
24339,0.001147,74.125.68.0-255,1484,134019,7,359213
24340,0.001154,74.125.68.0-255,5738,139757,7,359213
24341,0.001163,172.31.36.0-255,66,139823,7,359213
24342,0.001167,74.125.68.0-255,1484,141307,7,359213
24343,0.001196,74.125.68.0-255,5738,147045,7,359213
24344,0.001203,74.125.68.0-255,7156,154201,7,359213
24345,0.001205,172.31.36.0-255,66,154267,7,359213
24346,0.00121,172.31.36.0-255,66,154333,7,359213
24347,0.001249,74.125.68.0-255,3602,157935,7,359213
24348,0.001257,172.31.36.0-255,66,158001,7,359213
24349,0.001311,74.125.68.0-255,4320,162321,7,359213
24350,0.001316,172.31.36.0-255,66,162387,7,359213
24351,0.001346,74.125.68.0-255,5738,168125,7,359213
24352,0.001351,172.31.36.0-255,66,168191,7,359213
24353,0.001353,74.125.68.0-255,7156,175347,7,359213
24354,0.001368,172.31.36.0-255,66,175413,7,359213
24355,0.00138,74.125.68.0-255,4320,179733,7,359213
24356,0.001383,172.31.36.0-255,66,179799,7,359213
24357,0.001389,74.125.68.0-255,4320,184119,7,359213
24358,0.001399,172.31.36.0-255,66,184185,7,359213
24359,0.001436,172.31.36.0-255,66,184251,7,359213
24360,0.001468,74.125.68.0-255,1484,185735,7,359213
24361,0.001482,74.125.68.0-255,2902,188637,7,359213
24362,0.001494,172.31.36.0-255,66,188703,7,359213
24363,0.001508,74.125.68.0-255,5738,194441,7,359213
24364,0.001517,74.125.68.0-255,2902,197343,7,359213
24365,0.001521,172.31.36.0-255,66,197409,7,359213
24366,0.001538,74.125.68.0-255,4320,201729,7,359213
24367,0.001542,172.31.36.0-255,66,201795,7,359213
24368,0.001582,172.31.36.0-255,66,201861,7,359213
24369,0.001606,74.125.68.0-255,3602,205463,7,359213
24370,0.00161,172.31.36.0-255,66,205529,7,359213
24371,0.001714,74.125.68.0-255,1484,207013,7,359213
24372,0.001736,74.125.68.0-255,2902,209915,7,359213
24373,0.00174,74.125.68.0-255,2902,212817,7,359213
24374,0.001744,172.31.36.0-255,66,212883,7,359213
24375,0.001749,172.31.36.0-255,66,212949,7,359213
24376,0.001755,74.125.68.0-255,1484,214433,7,359213
24377,0.001791,172.31.36.0-255,66,214499,7,359213
24378,0.001797,74.125.68.0-255,5738,220237,7,359213
24379,0.001803,172.31.36.0-255,66,220303,7,359213
24380,0.001835,74.125.68.0-255,7156,227459,7,359213
24381,0.00184,74.125.68.0-255,3602,231061,7,359213
24382,0.00184,172.31.36.0-255,66,231127,7,359213
24383,0.001844,172.31.36.0-255,66,231193,7,359213
24384,0.002057,74.125.68.0-255,1484,232677,7,359213
24385,0.002075,74.125.68.0-255,2902,235579,7,359213
24386,0.002078,172.31.36.0-255,66,235645,7,359213
24387,0.002082,74.125.68.0-255,1484,237129,7,359213
24388,0.002106,74.125.68.0-255,2902,240031,7,359213
24389,0.002112,74.125.68.0-255,2902,242933,7,359213
24390,0.002122,172.31.36.0-255,66,242999,7,359213
24391,0.002128,74.125.68.0-255,2902,245901,7,359213
24392,0.002131,74.125.68.0-255,1484,247385,7,359213
24393,0.002137,172.31.36.0-255,66,247451,7,359213
24394,0.00216,74.125.68.0-255,2902,250353,7,359213
24395,0.002165,172.31.36.0-255,66,250419,7,359213
24396,0.002182,74.125.68.0-255,2902,253321,7,359213
24397,0.002185,172.31.36.0-255,66,253387,7,359213
24398,0.002226,172.31.36.0-255,66,253453,7,359213
24399,0.002237,74.125.68.0-255,3602,257055,7,359213
24400,0.002242,172.31.36.0-255,66,257121,7,359213
24401,0.002255,74.125.68.0-255,5738,262859,7,359213
24402,0.002257,172.31.36.0-255,66,262925,7,359213
24403,0.002262,172.31.36.0-255,66,262991,7,359213
24404,0.002804,172.31.36.0-255,101,263092,7,359213
24405,0.004499,74.125.68.0-255,5738,268830,7,359213
24406,0.004506,172.31.36.0-255,66,268896,7,359213
24407,0.004989,74.125.68.0-255,66,268962,7,359213
24408,0.006725,74.125.68.0-255,4320,273282,7,359213
24409,0.006728,172.31.36.0-255,66,273348,7,359213
24410,0.00675,74.125.68.0-255,1484,274832,7,359213
24411,0.00896,74.125.68.0-255,4320,279152,7,359213
24412,0.008966,172.31.36.0-255,66,279218,7,359213
24413,0.011195,74.125.68.0-255,5738,284956,7,359213
24414,0.011201,172.31.36.0-255,66,285022,7,359213
24415,0.013432,74.125.68.0-255,5738,290760,7,359213
24416,0.013437,172.31.36.0-255,66,290826,7,359213
24417,0.015684,74.125.68.0-255,5738,296564,7,359213
24418,0.015695,172.31.36.0-255,66,296630,7,359213
24419,0.01794,74.125.68.0-255,5738,302368,7,359213
24420,0.01795,172.31.36.0-255,66,302434,7,359213
24421,0.020178,74.125.68.0-255,5738,308172,7,359213
24422,0.020185,172.31.36.0-255,66,308238,7,359213
24423,0.022418,74.125.68.0-255,5738,313976,7,359213
24424,0.022423,172.31.36.0-255,66,314042,7,359213
24425,0.024667,74.125.68.0-255,5738,319780,7,359213
24426,0.024674,172.31.36.0-255,66,319846,7,359213
24427,0.026926,74.125.68.0-255,5738,325584,7,359213
24428,0.026933,172.31.36.0-255,66,325650,7,359213
24429,0.029164,74.125.68.0-255,5738,331388,7,359213
24430,0.02917,172.31.36.0-255,66,331454,7,359213
24431,0.031394,74.125.68.0-255,5738,337192,7,359213
24432,0.031402,172.31.36.0-255,66,337258,7,359213
24433,0.033638,74.125.68.0-255,5738,342996,7,359213
24434,0.033646,172.31.36.0-255,66,343062,7,359213
24435,0.035886,74.125.68.0-255,5738,348800,7,359213
24436,0.035893,172.31.36.0-255,66,348866,7,359213
24437,0.038114,74.125.68.0-255,811,349677,7,359213
24438,0.038312,172.31.36.0-255,105,349782,7,359213
24439,0.039307,172.31.36.0-255,172,349954,7,359213
24440,0.039349,172.31.36.0-255,1113,351067,7,359213
24441,0.039427,172.31.36.0-255,1514,352581,7,359213
24442,0.03943,172.31.36.0-255,1514,354095,7,359213
24443,0.039431,172.31.36.0-255,1514,355609,7,359213
24444,0.039432,172.31.36.0-255,1514,357123,7,359213
24445,0.039468,172.31.36.0-255,1514,358637,7,359213
24446,0.039469,172.31.36.0-255,72,358709,7,359213
24447,0.040916,104.244.42.0-255,66,358775,7,359213
24448,0.040929,104.244.42.0-255,66,358841,7,359213
24449,0.041047,104.244.42.0-255,66,358907,7,359213
24450,0.041074,104.244.42.0-255,66,358973,7,359213
24451,0.042071,104.244.42.0-255,108,359081,7,359213
24452,0.042086,172.31.36.0-255,66,359147,7,359213
24453,0.045181,74.125.68.0-255,66,359213,7,359213
24454,0.0,74.125.24.0-255,66,66,7,66
24455,0.0,172.217.194.0-255,151,151,7,272718
24456,2.3e-05,172.31.36.0-255,66,217,7,272718
24457,3.1e-05,172.217.194.0-255,1484,1701,7,272718
24458,3.6e-05,172.31.36.0-255,66,1767,7,272718
24459,5.1e-05,172.217.194.0-255,2902,4669,7,272718
24460,5.4e-05,172.31.36.0-255,66,4735,7,272718
24461,6.2e-05,172.217.194.0-255,7156,11891,7,272718
24462,6.5e-05,172.31.36.0-255,66,11957,7,272718
24463,6.9e-05,172.217.194.0-255,2076,14033,7,272718
24464,7.3e-05,172.31.36.0-255,66,14099,7,272718
24465,9.9e-05,172.217.194.0-255,2902,17001,7,272718
24466,0.000106,172.31.36.0-255,66,17067,7,272718
24467,0.000114,172.217.194.0-255,7156,24223,7,272718
24468,0.000116,172.31.36.0-255,66,24289,7,272718
24469,0.000154,172.217.194.0-255,6797,31086,7,272718
24470,0.000157,172.31.36.0-255,66,31152,7,272718
24471,0.00024,172.217.194.0-255,1484,32636,7,272718
24472,0.000244,172.31.36.0-255,66,32702,7,272718
24473,0.000249,172.217.194.0-255,2902,35604,7,272718
24474,0.000251,172.31.36.0-255,66,35670,7,272718
24475,0.000257,172.217.194.0-255,5738,41408,7,272718
24476,0.000264,172.31.36.0-255,66,41474,7,272718
24477,0.000299,172.217.194.0-255,6797,48271,7,272718
24478,0.000302,172.31.36.0-255,66,48337,7,272718
24479,0.00031,172.217.194.0-255,7156,55493,7,272718
24480,0.000312,172.31.36.0-255,66,55559,7,272718
24481,0.000353,172.217.194.0-255,7156,62715,7,272718
24482,0.000356,172.31.36.0-255,66,62781,7,272718
24483,0.000361,172.217.194.0-255,2794,65575,7,272718
24484,0.000363,172.31.36.0-255,66,65641,7,272718
24485,0.000404,172.217.194.0-255,119,65760,7,272718
24486,0.000416,172.31.36.0-255,66,65826,7,272718
24487,0.000419,172.217.194.0-255,381,66207,7,272718
24488,0.000421,172.31.36.0-255,66,66273,7,272718
24489,0.001077,172.217.194.0-255,1484,67757,7,272718
24490,0.001083,172.217.194.0-255,2902,70659,7,272718
24491,0.001088,172.31.36.0-255,66,70725,7,272718
24492,0.001095,172.31.36.0-255,66,70791,7,272718
24493,0.001117,172.217.194.0-255,5738,76529,7,272718
24494,0.001152,172.217.194.0-255,1484,78013,7,272718
24495,0.00118,172.31.36.0-255,66,78079,7,272718
24496,0.003494,172.217.194.0-255,5738,83817,7,272718
24497,0.003502,172.31.36.0-255,66,83883,7,272718
24498,0.005829,172.217.194.0-255,5738,89621,7,272718
24499,0.006155,172.31.36.0-255,66,89687,7,272718
24500,0.008494,172.217.194.0-255,5738,95425,7,272718
24501,0.0085,172.31.36.0-255,66,95491,7,272718
24502,0.010846,172.217.194.0-255,5738,101229,7,272718
24503,0.010854,172.31.36.0-255,66,101295,7,272718
24504,0.013183,172.217.194.0-255,5738,107033,7,272718
24505,0.013192,172.31.36.0-255,66,107099,7,272718
24506,0.015546,172.217.194.0-255,5738,112837,7,272718
24507,0.015556,172.31.36.0-255,66,112903,7,272718
24508,0.017916,172.217.194.0-255,5738,118641,7,272718
24509,0.017925,172.31.36.0-255,66,118707,7,272718
24510,0.020265,172.217.194.0-255,5738,124445,7,272718
24511,0.020273,172.31.36.0-255,66,124511,7,272718
24512,0.022623,172.217.194.0-255,5738,130249,7,272718
24513,0.022634,172.31.36.0-255,66,130315,7,272718
24514,0.024969,172.217.194.0-255,5738,136053,7,272718
24515,0.024977,172.31.36.0-255,66,136119,7,272718
24516,0.027337,172.217.194.0-255,5738,141857,7,272718
24517,0.027345,172.31.36.0-255,66,141923,7,272718
24518,0.029676,172.217.194.0-255,5738,147661,7,272718
24519,0.029736,172.31.36.0-255,167,147828,7,272718
24520,0.029765,172.31.36.0-255,1114,148942,7,272718
24521,0.029828,172.31.36.0-255,1514,150456,7,272718
24522,0.02983,172.31.36.0-255,1292,151748,7,272718
24523,0.029869,172.31.36.0-255,66,151814,7,272718
24524,0.031286,104.244.42.0-255,66,151880,7,272718
24525,0.031321,104.244.42.0-255,66,151946,7,272718
24526,0.031374,104.244.42.0-255,66,152012,7,272718
24527,0.032063,104.244.42.0-255,108,152120,7,272718
24528,0.032069,172.31.36.0-255,66,152186,7,272718
24529,0.032227,172.217.194.0-255,5738,157924,7,272718
24530,0.032232,172.31.36.0-255,66,157990,7,272718
24531,0.03456,172.217.194.0-255,5738,163728,7,272718
24532,0.034568,172.31.36.0-255,66,163794,7,272718
24533,0.036913,172.217.194.0-255,5738,169532,7,272718
24534,0.036928,172.31.36.0-255,66,169598,7,272718
24535,0.039319,172.217.194.0-255,5738,175336,7,272718
24536,0.039325,172.31.36.0-255,66,175402,7,272718
24537,0.041682,172.217.194.0-255,5738,181140,7,272718
24538,0.041689,172.31.36.0-255,66,181206,7,272718
24539,0.044039,172.217.194.0-255,5738,186944,7,272718
24540,0.044045,172.31.36.0-255,66,187010,7,272718
24541,0.046366,172.217.194.0-255,5738,192748,7,272718
24542,0.046372,172.31.36.0-255,66,192814,7,272718
24543,0.048687,172.217.194.0-255,5738,198552,7,272718
24544,0.048694,172.31.36.0-255,66,198618,7,272718
24545,0.051042,172.217.194.0-255,4320,202938,7,272718
24546,0.051049,172.31.36.0-255,66,203004,7,272718
24547,0.05108,172.217.194.0-255,1484,204488,7,272718
24548,0.053385,172.217.194.0-255,4320,208808,7,272718
24549,0.053393,172.31.36.0-255,66,208874,7,272718
24550,0.05574,172.217.194.0-255,5738,214612,7,272718
24551,0.055796,172.31.36.0-255,66,214678,7,272718
24552,0.058136,172.217.194.0-255,5738,220416,7,272718
24553,0.058147,172.31.36.0-255,66,220482,7,272718
24554,0.06051,172.217.194.0-255,5738,226220,7,272718
24555,0.060517,172.31.36.0-255,66,226286,7,272718
24556,0.062848,172.217.194.0-255,5738,232024,7,272718
24557,0.062854,172.31.36.0-255,66,232090,7,272718
24558,0.065185,172.217.194.0-255,5738,237828,7,272718
24559,0.065189,172.31.36.0-255,66,237894,7,272718
24560,0.067532,172.217.194.0-255,5738,243632,7,272718
24561,0.067538,172.31.36.0-255,66,243698,7,272718
24562,0.069858,172.217.194.0-255,5738,249436,7,272718
24563,0.069865,172.31.36.0-255,66,249502,7,272718
24564,0.072196,172.217.194.0-255,5738,255240,7,272718
24565,0.072203,172.31.36.0-255,66,255306,7,272718
24566,0.074541,172.217.194.0-255,5738,261044,7,272718
24567,0.074548,172.31.36.0-255,66,261110,7,272718
24568,0.076888,172.217.194.0-255,5738,266848,7,272718
24569,0.0769,172.31.36.0-255,66,266914,7,272718
24570,0.079244,172.217.194.0-255,5738,272652,7,272718
24571,0.079252,172.31.36.0-255,66,272718,7,272718
24572,0.0,172.217.194.0-255,153,153,7,269152
24573,2.1e-05,172.31.36.0-255,66,219,7,269152
24574,2.7e-05,172.217.194.0-255,1484,1703,7,269152
24575,3.2e-05,172.31.36.0-255,66,1769,7,269152
24576,4.7e-05,172.217.194.0-255,2902,4671,7,269152
24577,5e-05,172.31.36.0-255,66,4737,7,269152
24578,5.8e-05,172.217.194.0-255,7156,11893,7,269152
24579,6.1e-05,172.31.36.0-255,66,11959,7,269152
24580,6.6e-05,172.217.194.0-255,2104,14063,7,269152
24581,6.9e-05,172.31.36.0-255,66,14129,7,269152
24582,8.2e-05,172.31.36.0-255,66,14195,7,269152
24583,8.8e-05,172.217.194.0-255,5379,19574,7,269152
24584,9.2e-05,172.31.36.0-255,66,19640,7,269152
24585,0.000539,172.217.194.0-255,1484,21124,7,269152
24586,0.000545,172.31.36.0-255,66,21190,7,269152
24587,0.000551,172.217.194.0-255,1484,22674,7,269152
24588,0.000553,172.31.36.0-255,66,22740,7,269152
24589,0.000576,172.217.194.0-255,1484,24224,7,269152
24590,0.000582,172.31.36.0-255,66,24290,7,269152
24591,0.000589,172.217.194.0-255,5738,30028,7,269152
24592,0.000592,172.31.36.0-255,66,30094,7,269152
24593,0.0006,172.217.194.0-255,7156,37250,7,269152
24594,0.000603,172.31.36.0-255,66,37316,7,269152
24595,0.000644,172.217.194.0-255,6797,44113,7,269152
24596,0.000648,172.31.36.0-255,66,44179,7,269152
24597,0.000665,172.31.36.0-255,66,44245,7,269152
24598,0.000668,172.217.194.0-255,341,44586,7,269152
24599,0.00067,172.31.36.0-255,66,44652,7,269152
24600,0.000961,172.217.194.0-255,113,44765,7,269152
24601,0.000966,172.31.36.0-255,66,44831,7,269152
24602,0.000995,172.217.194.0-255,1484,46315,7,269152
24603,0.001,172.217.194.0-255,2902,49217,7,269152
24604,0.001003,172.31.36.0-255,66,49283,7,269152
24605,0.001006,172.217.194.0-255,1484,50767,7,269152
24606,0.00104,172.31.36.0-255,66,50833,7,269152
24607,0.001067,172.217.194.0-255,2543,53376,7,269152
24608,0.00107,172.31.36.0-255,66,53442,7,269152
24609,0.001254,172.217.194.0-255,1484,54926,7,269152
24610,0.001261,172.217.194.0-255,2902,57828,7,269152
24611,0.001265,172.31.36.0-255,66,57894,7,269152
24612,0.001272,172.217.194.0-255,5738,63632,7,269152
24613,0.001273,172.31.36.0-255,66,63698,7,269152
24614,0.001328,172.217.194.0-255,6797,70495,7,269152
24615,0.001331,172.31.36.0-255,66,70561,7,269152
24616,0.001911,172.217.194.0-255,1484,72045,7,269152
24617,0.001931,172.217.194.0-255,1484,73529,7,269152
24618,0.001936,172.31.36.0-255,66,73595,7,269152
24619,0.001942,172.217.194.0-255,2902,76497,7,269152
24620,0.001945,172.31.36.0-255,66,76563,7,269152
24621,0.001976,172.217.194.0-255,5738,82301,7,269152
24622,0.001979,172.31.36.0-255,66,82367,7,269152
24623,0.001986,172.217.194.0-255,5738,88105,7,269152
24624,0.001988,172.31.36.0-255,66,88171,7,269152
24625,0.00202,172.217.194.0-255,7156,95327,7,269152
24626,0.002022,172.31.36.0-255,66,95393,7,269152
24627,0.002026,172.217.194.0-255,1484,96877,7,269152
24628,0.002059,172.31.36.0-255,66,96943,7,269152
24629,0.002276,172.217.194.0-255,1484,98427,7,269152
24630,0.002284,172.217.194.0-255,2902,101329,7,269152
24631,0.002289,172.31.36.0-255,66,101395,7,269152
24632,0.002295,172.217.194.0-255,4320,105715,7,269152
24633,0.002297,172.31.36.0-255,66,105781,7,269152
24634,0.002329,172.217.194.0-255,1484,107265,7,269152
24635,0.002344,172.31.36.0-255,66,107331,7,269152
24636,0.002356,172.31.36.0-255,66,107397,7,269152
24637,0.0024,172.31.36.0-255,66,107463,7,269152
24638,0.002452,172.31.36.0-255,66,107529,7,269152
24639,0.002455,172.217.194.0-255,1484,109013,7,269152
24640,0.002475,172.31.36.0-255,66,109079,7,269152
24641,0.002488,172.31.36.0-255,66,109145,7,269152
24642,0.002491,172.217.194.0-255,1484,110629,7,269152
24643,0.002551,172.31.36.0-255,66,110695,7,269152
24644,0.002571,172.31.36.0-255,66,110761,7,269152
24645,0.002603,172.31.36.0-255,66,110827,7,269152
24646,0.005108,172.217.194.0-255,4320,115147,7,269152
24647,0.005114,172.31.36.0-255,66,115213,7,269152
24648,0.00514,172.217.194.0-255,1484,116697,7,269152
24649,0.007616,172.217.194.0-255,4320,121017,7,269152
24650,0.007624,172.31.36.0-255,66,121083,7,269152
24651,0.010112,172.217.194.0-255,5738,126821,7,269152
24652,0.010118,172.31.36.0-255,66,126887,7,269152
24653,0.012596,172.217.194.0-255,5738,132625,7,269152
24654,0.012605,172.31.36.0-255,66,132691,7,269152
24655,0.015119,172.217.194.0-255,5738,138429,7,269152
24656,0.015128,172.31.36.0-255,66,138495,7,269152
24657,0.017663,172.217.194.0-255,5738,144233,7,269152
24658,0.017674,172.31.36.0-255,66,144299,7,269152
24659,0.020155,172.217.194.0-255,5738,150037,7,269152
24660,0.020164,172.31.36.0-255,66,150103,7,269152
24661,0.022668,172.217.194.0-255,5738,155841,7,269152
24662,0.022678,172.31.36.0-255,66,155907,7,269152
24663,0.025195,172.217.194.0-255,5738,161645,7,269152
24664,0.025202,172.31.36.0-255,66,161711,7,269152
24665,0.027725,172.217.194.0-255,5738,167449,7,269152
24666,0.027734,172.31.36.0-255,66,167515,7,269152
24667,0.030221,172.217.194.0-255,5738,173253,7,269152
24668,0.03023,172.31.36.0-255,66,173319,7,269152
24669,0.030476,172.31.36.0-255,172,173491,7,269152
24670,0.030508,172.31.36.0-255,1114,174605,7,269152
24671,0.030565,172.31.36.0-255,1514,176119,7,269152
24672,0.030567,172.31.36.0-255,1292,177411,7,269152
24673,0.032035,104.244.42.0-255,66,177477,7,269152
24674,0.032088,104.244.42.0-255,66,177543,7,269152
24675,0.032149,104.244.42.0-255,66,177609,7,269152
24676,0.032724,172.217.194.0-255,5738,183347,7,269152
24677,0.032729,172.31.36.0-255,66,183413,7,269152
24678,0.035205,172.217.194.0-255,5738,189151,7,269152
24679,0.035212,172.31.36.0-255,66,189217,7,269152
24680,0.037716,172.217.194.0-255,5738,194955,7,269152
24681,0.037723,172.31.36.0-255,66,195021,7,269152
24682,0.040252,172.217.194.0-255,5738,200759,7,269152
24683,0.040259,172.31.36.0-255,66,200825,7,269152
24684,0.042773,172.217.194.0-255,5738,206563,7,269152
24685,0.042793,172.31.36.0-255,66,206629,7,269152
24686,0.045306,172.217.194.0-255,5738,212367,7,269152
24687,0.045313,172.31.36.0-255,66,212433,7,269152
24688,0.047821,172.217.194.0-255,5738,218171,7,269152
24689,0.047827,172.31.36.0-255,66,218237,7,269152
24690,0.050352,172.217.194.0-255,5738,223975,7,269152
24691,0.050358,172.31.36.0-255,66,224041,7,269152
24692,0.052855,172.217.194.0-255,5738,229779,7,269152
24693,0.052862,172.31.36.0-255,66,229845,7,269152
24694,0.055388,172.217.194.0-255,5738,235583,7,269152
24695,0.055394,172.31.36.0-255,66,235649,7,269152
24696,0.057899,172.217.194.0-255,5738,241387,7,269152
24697,0.057906,172.31.36.0-255,66,241453,7,269152
24698,0.060445,172.217.194.0-255,5738,247191,7,269152
24699,0.060452,172.31.36.0-255,66,247257,7,269152
24700,0.062956,172.217.194.0-255,2902,250159,7,269152
24701,0.062963,172.31.36.0-255,66,250225,7,269152
24702,0.06299,172.217.194.0-255,2902,253127,7,269152
24703,0.062993,172.31.36.0-255,66,253193,7,269152
24704,0.065502,172.217.194.0-255,5738,258931,7,269152
24705,0.065509,172.31.36.0-255,66,258997,7,269152
24706,0.068027,172.217.194.0-255,5738,264735,7,269152
24707,0.068034,172.31.36.0-255,66,264801,7,269152
24708,0.070543,172.217.194.0-255,4114,268915,7,269152
24709,0.07055,172.31.36.0-255,66,268981,7,269152
24710,0.070748,172.31.36.0-255,105,269086,7,269152
24711,0.073209,172.217.194.0-255,66,269152,7,269152
24712,0.0,172.31.36.0-255,105,105,7,105
24713,0.0,74.125.68.0-255,158,158,7,397957
24714,2.2e-05,172.31.36.0-255,66,224,7,397957
24715,3e-05,74.125.68.0-255,1484,1708,7,397957
24716,3.6e-05,172.31.36.0-255,66,1774,7,397957
24717,4.3e-05,74.125.68.0-255,2902,4676,7,397957
24718,4.7e-05,172.31.36.0-255,66,4742,7,397957
24719,5.3e-05,74.125.68.0-255,4320,9062,7,397957
24720,5.6e-05,172.31.36.0-255,66,9128,7,397957
24721,8.2e-05,74.125.68.0-255,7156,16284,7,397957
24722,8.5e-05,172.31.36.0-255,66,16350,7,397957
24723,0.000103,74.125.68.0-255,2018,18368,7,397957
24724,0.000106,172.31.36.0-255,66,18434,7,397957
24725,0.000112,74.125.68.0-255,4320,22754,7,397957
24726,0.000115,172.31.36.0-255,66,22820,7,397957
24727,0.000137,74.125.68.0-255,5738,28558,7,397957
24728,0.00014,172.31.36.0-255,66,28624,7,397957
24729,0.000157,74.125.68.0-255,2543,31167,7,397957
24730,0.000159,172.31.36.0-255,66,31233,7,397957
24731,0.000243,74.125.68.0-255,1484,32717,7,397957
24732,0.000247,172.31.36.0-255,66,32783,7,397957
24733,0.000252,74.125.68.0-255,2902,35685,7,397957
24734,0.000255,172.31.36.0-255,66,35751,7,397957
24735,0.000314,74.125.68.0-255,5738,41489,7,397957
24736,0.000318,172.31.36.0-255,66,41555,7,397957
24737,0.000325,74.125.68.0-255,6797,48352,7,397957
24738,0.000328,172.31.36.0-255,66,48418,7,397957
24739,0.000406,74.125.68.0-255,1484,49902,7,397957
24740,0.000409,172.31.36.0-255,66,49968,7,397957
24741,0.000413,74.125.68.0-255,1484,51452,7,397957
24742,0.000415,172.31.36.0-255,66,51518,7,397957
24743,0.000428,74.125.68.0-255,1484,53002,7,397957
24744,0.00043,172.31.36.0-255,66,53068,7,397957
24745,0.000435,74.125.68.0-255,2902,55970,7,397957
24746,0.000438,172.31.36.0-255,66,56036,7,397957
24747,0.000464,74.125.68.0-255,1484,57520,7,397957
24748,0.000473,74.125.68.0-255,5738,63258,7,397957
24749,0.000475,172.31.36.0-255,66,63324,7,397957
24750,0.000489,74.125.68.0-255,2543,65867,7,397957
24751,0.000491,172.31.36.0-255,66,65933,7,397957
24752,0.000588,74.125.68.0-255,1484,67417,7,397957
24753,0.000608,74.125.68.0-255,2902,70319,7,397957
24754,0.000612,172.31.36.0-255,66,70385,7,397957
24755,0.000631,74.125.68.0-255,1484,71869,7,397957
24756,0.000647,74.125.68.0-255,2902,74771,7,397957
24757,0.00065,172.31.36.0-255,66,74837,7,397957
24758,0.000657,74.125.68.0-255,5738,80575,7,397957
24759,0.000659,172.31.36.0-255,66,80641,7,397957
24760,0.000686,74.125.68.0-255,3124,83765,7,397957
24761,0.000689,172.31.36.0-255,66,83831,7,397957
24762,0.000846,74.125.68.0-255,1484,85315,7,397957
24763,0.000862,74.125.68.0-255,2902,88217,7,397957
24764,0.000865,172.31.36.0-255,66,88283,7,397957
24765,0.000891,74.125.68.0-255,5738,94021,7,397957
24766,0.000894,172.31.36.0-255,66,94087,7,397957
24767,0.000905,74.125.68.0-255,1484,95571,7,397957
24768,0.000921,74.125.68.0-255,5738,101309,7,397957
24769,0.000923,172.31.36.0-255,66,101375,7,397957
24770,0.000944,74.125.68.0-255,5738,107113,7,397957
24771,0.000946,172.31.36.0-255,66,107179,7,397957
24772,0.000962,74.125.68.0-255,1484,108663,7,397957
24773,0.000968,74.125.68.0-255,5738,114401,7,397957
24774,0.000971,172.31.36.0-255,66,114467,7,397957
24775,0.000993,74.125.68.0-255,2902,117369,7,397957
24776,0.000996,172.31.36.0-255,66,117435,7,397957
24777,0.000999,74.125.68.0-255,102,117537,7,397957
24778,0.001189,74.125.68.0-255,1484,119021,7,397957
24779,0.001193,172.31.36.0-255,66,119087,7,397957
24780,0.001199,74.125.68.0-255,2902,121989,7,397957
24781,0.001201,172.31.36.0-255,66,122055,7,397957
24782,0.00123,74.125.68.0-255,5738,127793,7,397957
24783,0.001232,172.31.36.0-255,66,127859,7,397957
24784,0.001237,74.125.68.0-255,2902,130761,7,397957
24785,0.001239,172.31.36.0-255,66,130827,7,397957
24786,0.001261,74.125.68.0-255,5738,136565,7,397957
24787,0.001263,172.31.36.0-255,66,136631,7,397957
24788,0.001284,74.125.68.0-255,1484,138115,7,397957
24789,0.001307,74.125.68.0-255,5738,143853,7,397957
24790,0.001312,172.31.36.0-255,66,143919,7,397957
24791,0.001327,74.125.68.0-255,2902,146821,7,397957
24792,0.00133,172.31.36.0-255,66,146887,7,397957
24793,0.001345,74.125.68.0-255,2902,149789,7,397957
24794,0.001348,172.31.36.0-255,66,149855,7,397957
24795,0.001362,74.125.68.0-255,2184,152039,7,397957
24796,0.001366,172.31.36.0-255,66,152105,7,397957
24797,0.001808,74.125.68.0-255,1484,153589,7,397957
24798,0.001815,74.125.68.0-255,2902,156491,7,397957
24799,0.001818,172.31.36.0-255,66,156557,7,397957
24800,0.001852,74.125.68.0-255,4320,160877,7,397957
24801,0.001856,172.31.36.0-255,66,160943,7,397957
24802,0.001863,74.125.68.0-255,4320,165263,7,397957
24803,0.001865,172.31.36.0-255,66,165329,7,397957
24804,0.001885,74.125.68.0-255,1484,166813,7,397957
24805,0.001906,74.125.68.0-255,4320,171133,7,397957
24806,0.001911,172.31.36.0-255,66,171199,7,397957
24807,0.001923,74.125.68.0-255,5738,176937,7,397957
24808,0.001925,172.31.36.0-255,66,177003,7,397957
24809,0.001961,172.31.36.0-255,66,177069,7,397957
24810,0.001974,74.125.68.0-255,766,177835,7,397957
24811,0.002449,172.31.36.0-255,66,177901,7,397957
24812,0.004008,74.125.68.0-255,4320,182221,7,397957
24813,0.004016,172.31.36.0-255,66,182287,7,397957
24814,0.004477,74.125.68.0-255,1484,183771,7,397957
24815,0.006061,74.125.68.0-255,4320,188091,7,397957
24816,0.006063,172.31.36.0-255,66,188157,7,397957
24817,0.008111,74.125.68.0-255,5738,193895,7,397957
24818,0.008118,172.31.36.0-255,66,193961,7,397957
24819,0.010158,74.125.68.0-255,5738,199699,7,397957
24820,0.010166,172.31.36.0-255,66,199765,7,397957
24821,0.012202,74.125.68.0-255,5738,205503,7,397957
24822,0.012209,172.31.36.0-255,66,205569,7,397957
24823,0.014305,74.125.68.0-255,5738,211307,7,397957
24824,0.014312,172.31.36.0-255,66,211373,7,397957
24825,0.016355,74.125.68.0-255,5738,217111,7,397957
24826,0.016366,172.31.36.0-255,66,217177,7,397957
24827,0.018436,74.125.68.0-255,5738,222915,7,397957
24828,0.018444,172.31.36.0-255,66,222981,7,397957
24829,0.02048,74.125.68.0-255,5738,228719,7,397957
24830,0.020489,172.31.36.0-255,66,228785,7,397957
24831,0.022531,74.125.68.0-255,5738,234523,7,397957
24832,0.022538,172.31.36.0-255,66,234589,7,397957
24833,0.024595,74.125.68.0-255,5738,240327,7,397957
24834,0.024602,172.31.36.0-255,66,240393,7,397957
24835,0.02666,74.125.68.0-255,5738,246131,7,397957
24836,0.02667,172.31.36.0-255,66,246197,7,397957
24837,0.028735,74.125.68.0-255,5738,251935,7,397957
24838,0.028752,172.31.36.0-255,66,252001,7,397957
24839,0.030901,74.125.68.0-255,5738,257739,7,397957
24840,0.030917,172.31.36.0-255,66,257805,7,397957
24841,0.033004,74.125.68.0-255,5738,263543,7,397957
24842,0.033013,172.31.36.0-255,66,263609,7,397957
24843,0.035055,74.125.68.0-255,5738,269347,7,397957
24844,0.035064,172.31.36.0-255,66,269413,7,397957
24845,0.03711,74.125.68.0-255,5738,275151,7,397957
24846,0.037119,172.31.36.0-255,66,275217,7,397957
24847,0.039163,74.125.68.0-255,5738,280955,7,397957
24848,0.039169,172.31.36.0-255,66,281021,7,397957
24849,0.039521,172.31.36.0-255,172,281193,7,397957
24850,0.039546,172.31.36.0-255,1115,282308,7,397957
24851,0.039606,172.31.36.0-255,1514,283822,7,397957
24852,0.039608,172.31.36.0-255,1514,285336,7,397957
24853,0.039609,172.31.36.0-255,1514,286850,7,397957
24854,0.03961,172.31.36.0-255,1514,288364,7,397957
24855,0.039645,172.31.36.0-255,1514,289878,7,397957
24856,0.039646,172.31.36.0-255,69,289947,7,397957
24857,0.041082,104.244.42.0-255,66,290013,7,397957
24858,0.041107,104.244.42.0-255,66,290079,7,397957
24859,0.041178,104.244.42.0-255,66,290145,7,397957
24860,0.041183,104.244.42.0-255,66,290211,7,397957
24861,0.041199,74.125.68.0-255,4320,294531,7,397957
24862,0.041204,172.31.36.0-255,66,294597,7,397957
24863,0.041224,74.125.68.0-255,1484,296081,7,397957
24864,0.041949,104.244.42.0-255,108,296189,7,397957
24865,0.041956,172.31.36.0-255,66,296255,7,397957
24866,0.043255,74.125.68.0-255,4320,300575,7,397957
24867,0.043262,172.31.36.0-255,66,300641,7,397957
24868,0.045321,74.125.68.0-255,5738,306379,7,397957
24869,0.045327,172.31.36.0-255,66,306445,7,397957
24870,0.047371,74.125.68.0-255,5738,312183,7,397957
24871,0.047378,172.31.36.0-255,66,312249,7,397957
24872,0.049434,74.125.68.0-255,5738,317987,7,397957
24873,0.049439,172.31.36.0-255,66,318053,7,397957
24874,0.051497,74.125.68.0-255,5738,323791,7,397957
24875,0.051504,172.31.36.0-255,66,323857,7,397957
24876,0.053539,74.125.68.0-255,5738,329595,7,397957
24877,0.053546,172.31.36.0-255,66,329661,7,397957
24878,0.055589,74.125.68.0-255,5738,335399,7,397957
24879,0.055595,172.31.36.0-255,66,335465,7,397957
24880,0.057651,74.125.68.0-255,5738,341203,7,397957
24881,0.057658,172.31.36.0-255,66,341269,7,397957
24882,0.059693,74.125.68.0-255,5738,347007,7,397957
24883,0.059702,172.31.36.0-255,66,347073,7,397957
24884,0.061751,74.125.68.0-255,5738,352811,7,397957
24885,0.061758,172.31.36.0-255,66,352877,7,397957
24886,0.063814,74.125.68.0-255,5738,358615,7,397957
24887,0.06382,172.31.36.0-255,66,358681,7,397957
24888,0.065865,74.125.68.0-255,5738,364419,7,397957
24889,0.065871,172.31.36.0-255,66,364485,7,397957
24890,0.067933,74.125.68.0-255,5738,370223,7,397957
24891,0.06794,172.31.36.0-255,66,370289,7,397957
24892,0.06998,74.125.68.0-255,5738,376027,7,397957
24893,0.069985,172.31.36.0-255,66,376093,7,397957
24894,0.07201,74.125.68.0-255,4320,380413,7,397957
24895,0.072016,172.31.36.0-255,66,380479,7,397957
24896,0.072031,74.125.68.0-255,1484,381963,7,397957
24897,0.074073,74.125.68.0-255,4320,386283,7,397957
24898,0.07408,172.31.36.0-255,66,386349,7,397957
24899,0.076131,74.125.68.0-255,5738,392087,7,397957
24900,0.076137,172.31.36.0-255,66,392153,7,397957
24901,0.078201,74.125.68.0-255,5738,397891,7,397957
24902,0.078208,172.31.36.0-255,66,397957,7,397957
24903,0.0,74.125.24.0-255,145,145,7,360008
24904,2.3e-05,172.31.36.0-255,66,211,7,360008
24905,3.1e-05,74.125.24.0-255,1484,1695,7,360008
24906,3.6e-05,172.31.36.0-255,66,1761,7,360008
24907,3.9e-05,74.125.24.0-255,1484,3245,7,360008
24908,4.2e-05,172.31.36.0-255,66,3311,7,360008
24909,5.8e-05,74.125.24.0-255,4320,7631,7,360008
24910,6e-05,172.31.36.0-255,66,7697,7,360008
24911,8.9e-05,172.31.36.0-255,66,7763,7,360008
24912,0.000121,74.125.24.0-255,1971,9734,7,360008
24913,0.000124,172.31.36.0-255,66,9800,7,360008
24914,0.000138,172.31.36.0-255,66,9866,7,360008
24915,0.000141,74.125.24.0-255,1125,10991,7,360008
24916,0.000143,172.31.36.0-255,66,11057,7,360008
24917,0.000187,74.125.24.0-255,1484,12541,7,360008
24918,0.00019,172.31.36.0-255,66,12607,7,360008
24919,0.000194,74.125.24.0-255,2902,15509,7,360008
24920,0.000196,172.31.36.0-255,66,15575,7,360008
24921,0.000232,74.125.24.0-255,5738,21313,7,360008
24922,0.000235,172.31.36.0-255,66,21379,7,360008
24923,0.000267,74.125.24.0-255,4320,25699,7,360008
24924,0.000269,172.31.36.0-255,66,25765,7,360008
24925,0.000293,74.125.24.0-255,2543,28308,7,360008
24926,0.000298,172.31.36.0-255,66,28374,7,360008
24927,0.000323,74.125.24.0-255,1484,29858,7,360008
24928,0.000325,172.31.36.0-255,66,29924,7,360008
24929,0.000351,74.125.24.0-255,2902,32826,7,360008
24930,0.000353,172.31.36.0-255,66,32892,7,360008
24931,0.000358,74.125.24.0-255,2902,35794,7,360008
24932,0.00036,172.31.36.0-255,66,35860,7,360008
24933,0.000381,74.125.24.0-255,2902,38762,7,360008
24934,0.000392,74.125.24.0-255,2902,41664,7,360008
24935,0.000422,74.125.24.0-255,4289,45953,7,360008
24936,0.000449,74.125.24.0-255,349,46302,7,360008
24937,0.000591,172.31.36.0-255,66,46368,7,360008
24938,0.000617,74.125.24.0-255,1484,47852,7,360008
24939,0.000624,74.125.24.0-255,2902,50754,7,360008
24940,0.000645,74.125.24.0-255,5738,56492,7,360008
24941,0.00067,74.125.24.0-255,2902,59394,7,360008
24942,0.000675,172.31.36.0-255,66,59460,7,360008
24943,0.000701,74.125.24.0-255,3961,63421,7,360008
24944,0.000713,74.125.24.0-255,1484,64905,7,360008
24945,0.000726,74.125.24.0-255,2902,67807,7,360008
24946,0.00074,172.31.36.0-255,66,67873,7,360008
24947,0.000759,74.125.24.0-255,5738,73611,7,360008
24948,0.000763,74.125.24.0-255,1484,75095,7,360008
24949,0.000779,74.125.24.0-255,5379,80474,7,360008
24950,0.000798,172.31.36.0-255,66,80540,7,360008
24951,0.001421,74.125.24.0-255,1484,82024,7,360008
24952,0.001437,74.125.24.0-255,2902,84926,7,360008
24953,0.00144,172.31.36.0-255,66,84992,7,360008
24954,0.001444,74.125.24.0-255,1484,86476,7,360008
24955,0.001478,74.125.24.0-255,4320,90796,7,360008
24956,0.001483,74.125.24.0-255,4320,95116,7,360008
24957,0.001491,172.31.36.0-255,66,95182,7,360008
24958,0.001507,74.125.24.0-255,7156,102338,7,360008
24959,0.001509,74.125.24.0-255,1484,103822,7,360008
24960,0.001552,172.31.36.0-255,66,103888,7,360008
24961,0.001599,74.125.24.0-255,1484,105372,7,360008
24962,0.001614,74.125.24.0-255,1484,106856,7,360008
24963,0.001617,172.31.36.0-255,66,106922,7,360008
24964,0.001645,74.125.24.0-255,1484,108406,7,360008
24965,0.001649,74.125.24.0-255,2902,111308,7,360008
24966,0.001651,74.125.24.0-255,1484,112792,7,360008
24967,0.001655,172.31.36.0-255,66,112858,7,360008
24968,0.001687,74.125.24.0-255,5738,118596,7,360008
24969,0.001691,74.125.24.0-255,1484,120080,7,360008
24970,0.001695,172.31.36.0-255,66,120146,7,360008
24971,0.001706,74.125.24.0-255,5738,125884,7,360008
24972,0.001724,74.125.24.0-255,7156,133040,7,360008
24973,0.001727,172.31.36.0-255,66,133106,7,360008
24974,0.001752,74.125.24.0-255,2902,136008,7,360008
24975,0.00177,74.125.24.0-255,2184,138192,7,360008
24976,0.001775,172.31.36.0-255,66,138258,7,360008
24977,0.001811,74.125.24.0-255,1484,139742,7,360008
24978,0.001827,74.125.24.0-255,2902,142644,7,360008
24979,0.001839,172.31.36.0-255,66,142710,7,360008
24980,0.001852,74.125.24.0-255,5738,148448,7,360008
24981,0.001854,74.125.24.0-255,1484,149932,7,360008
24982,0.001859,172.31.36.0-255,66,149998,7,360008
24983,0.001874,74.125.24.0-255,5738,155736,7,360008
24984,0.001952,172.31.36.0-255,66,155802,7,360008
24985,0.001957,74.125.24.0-255,2184,157986,7,360008
24986,0.001962,172.31.36.0-255,66,158052,7,360008
24987,0.002032,74.125.24.0-255,1484,159536,7,360008
24988,0.002036,74.125.24.0-255,1484,161020,7,360008
24989,0.002041,172.31.36.0-255,66,161086,7,360008
24990,0.002053,74.125.24.0-255,1484,162570,7,360008
24991,0.002063,74.125.24.0-255,5738,168308,7,360008
24992,0.002085,74.125.24.0-255,2902,171210,7,360008
24993,0.002106,172.31.36.0-255,66,171276,7,360008
24994,0.002111,172.31.36.0-255,66,171342,7,360008
24995,0.002125,74.125.24.0-255,4320,175662,7,360008
24996,0.002171,172.31.36.0-255,66,175728,7,360008
24997,0.004503,74.125.24.0-255,5738,181466,7,360008
24998,0.004511,172.31.36.0-255,66,181532,7,360008
24999,0.006824,74.125.24.0-255,4320,185852,7,360008
25000,0.006842,74.125.24.0-255,1484,187336,7,360008
25001,0.007427,172.31.36.0-255,66,187402,7,360008
25002,0.009821,74.125.24.0-255,5738,193140,7,360008
25003,0.009829,172.31.36.0-255,66,193206,7,360008
25004,0.012144,74.125.24.0-255,5738,198944,7,360008
25005,0.014735,172.31.36.0-255,66,199010,7,360008
25006,0.017056,74.125.24.0-255,5738,204748,7,360008
25007,0.017074,172.31.36.0-255,66,204814,7,360008
25008,0.019374,74.125.24.0-255,5738,210552,7,360008
25009,0.019383,172.31.36.0-255,66,210618,7,360008
25010,0.021731,74.125.24.0-255,5738,216356,7,360008
25011,0.022461,172.31.36.0-255,66,216422,7,360008
25012,0.024785,74.125.24.0-255,5738,222160,7,360008
25013,0.024794,172.31.36.0-255,66,222226,7,360008
25014,0.02712,74.125.24.0-255,5738,227964,7,360008
25015,0.027138,172.31.36.0-255,66,228030,7,360008
25016,0.029454,74.125.24.0-255,5738,233768,7,360008
25017,0.02946,172.31.36.0-255,66,233834,7,360008
25018,0.031767,74.125.24.0-255,5738,239572,7,360008
25019,0.031774,172.31.36.0-255,66,239638,7,360008
25020,0.034097,74.125.24.0-255,5738,245376,7,360008
25021,0.034106,172.31.36.0-255,66,245442,7,360008
25022,0.036419,74.125.24.0-255,5738,251180,7,360008
25023,0.036425,172.31.36.0-255,66,251246,7,360008
25024,0.037545,172.31.36.0-255,172,251418,7,360008
25025,0.037577,172.31.36.0-255,1114,252532,7,360008
25026,0.037638,172.31.36.0-255,1514,254046,7,360008
25027,0.03764,172.31.36.0-255,1292,255338,7,360008
25028,0.038724,74.125.24.0-255,5738,261076,7,360008
25029,0.038731,172.31.36.0-255,66,261142,7,360008
25030,0.03912,104.244.42.0-255,66,261208,7,360008
25031,0.039128,104.244.42.0-255,66,261274,7,360008
25032,0.039218,104.244.42.0-255,66,261340,7,360008
25033,0.041029,74.125.24.0-255,5738,267078,7,360008
25034,0.041037,172.31.36.0-255,66,267144,7,360008
25035,0.043347,74.125.24.0-255,5738,272882,7,360008
25036,0.043354,172.31.36.0-255,66,272948,7,360008
25037,0.045674,74.125.24.0-255,5738,278686,7,360008
25038,0.04568,172.31.36.0-255,66,278752,7,360008
25039,0.048012,74.125.24.0-255,5738,284490,7,360008
25040,0.048019,172.31.36.0-255,66,284556,7,360008
25041,0.050327,74.125.24.0-255,5738,290294,7,360008
25042,0.050334,172.31.36.0-255,66,290360,7,360008
25043,0.052639,74.125.24.0-255,5738,296098,7,360008
25044,0.052646,172.31.36.0-255,66,296164,7,360008
25045,0.054966,74.125.24.0-255,5738,301902,7,360008
25046,0.054972,172.31.36.0-255,66,301968,7,360008
25047,0.057293,74.125.24.0-255,5738,307706,7,360008
25048,0.057299,172.31.36.0-255,66,307772,7,360008
25049,0.059609,74.125.24.0-255,5738,313510,7,360008
25050,0.059619,172.31.36.0-255,66,313576,7,360008
25051,0.061952,74.125.24.0-255,5738,319314,7,360008
25052,0.061961,172.31.36.0-255,66,319380,7,360008
25053,0.06426,74.125.24.0-255,5738,325118,7,360008
25054,0.064268,172.31.36.0-255,66,325184,7,360008
25055,0.06664,74.125.24.0-255,5738,330922,7,360008
25056,0.066648,172.31.36.0-255,66,330988,7,360008
25057,0.068998,74.125.24.0-255,5738,336726,7,360008
25058,0.069006,172.31.36.0-255,66,336792,7,360008
25059,0.071309,74.125.24.0-255,5738,342530,7,360008
25060,0.071316,172.31.36.0-255,66,342596,7,360008
25061,0.073625,74.125.24.0-255,5738,348334,7,360008
25062,0.073632,172.31.36.0-255,66,348400,7,360008
25063,0.075964,74.125.24.0-255,5738,354138,7,360008
25064,0.075972,172.31.36.0-255,66,354204,7,360008
25065,0.078275,74.125.24.0-255,5738,359942,7,360008
25066,0.078282,172.31.36.0-255,66,360008,7,360008
25067,0.0,74.125.68.0-255,146,146,7,374689
25068,3.4e-05,172.31.36.0-255,66,212,7,374689
25069,4e-05,74.125.68.0-255,1484,1696,7,374689
25070,4.5e-05,172.31.36.0-255,66,1762,7,374689
25071,4.9e-05,74.125.68.0-255,2902,4664,7,374689
25072,5.2e-05,172.31.36.0-255,66,4730,7,374689
25073,6e-05,74.125.68.0-255,7156,11886,7,374689
25074,6.3e-05,172.31.36.0-255,66,11952,7,374689
25075,6.7e-05,74.125.68.0-255,2064,14016,7,374689
25076,7e-05,172.31.36.0-255,66,14082,7,374689
25077,7.4e-05,74.125.68.0-255,2902,16984,7,374689
25078,7.8e-05,172.31.36.0-255,66,17050,7,374689
25079,8.4e-05,74.125.68.0-255,7156,24206,7,374689
25080,8.7e-05,172.31.36.0-255,66,24272,7,374689
25081,0.000115,74.125.68.0-255,2902,27174,7,374689
25082,0.000118,172.31.36.0-255,66,27240,7,374689
25083,0.000124,74.125.68.0-255,3961,31201,7,374689
25084,0.000127,172.31.36.0-255,66,31267,7,374689
25085,0.000251,74.125.68.0-255,1484,32751,7,374689
25086,0.000256,172.31.36.0-255,66,32817,7,374689
25087,0.000279,74.125.68.0-255,2902,35719,7,374689
25088,0.000283,172.31.36.0-255,66,35785,7,374689
25089,0.000289,74.125.68.0-255,5738,41523,7,374689
25090,0.000292,172.31.36.0-255,66,41589,7,374689
25091,0.000296,74.125.68.0-255,2902,44491,7,374689
25092,0.000298,172.31.36.0-255,66,44557,7,374689
25093,0.000325,74.125.68.0-255,4320,48877,7,374689
25094,0.000328,172.31.36.0-255,66,48943,7,374689
25095,0.000355,74.125.68.0-255,2902,51845,7,374689
25096,0.000358,172.31.36.0-255,66,51911,7,374689
25097,0.000398,74.125.68.0-255,2902,54813,7,374689
25098,0.000403,172.31.36.0-255,66,54879,7,374689
25099,0.000406,74.125.68.0-255,1484,56363,7,374689
25100,0.000425,74.125.68.0-255,2902,59265,7,374689
25101,0.000428,172.31.36.0-255,66,59331,7,374689
25102,0.000454,74.125.68.0-255,5738,65069,7,374689
25103,0.000458,172.31.36.0-255,66,65135,7,374689
25104,0.00047,74.125.68.0-255,766,65901,7,374689
25105,0.000509,74.125.68.0-255,361,66262,7,374689
25106,0.000549,74.125.68.0-255,132,66394,7,374689
25107,0.000726,74.125.68.0-255,1484,67878,7,374689
25108,0.000731,172.31.36.0-255,66,67944,7,374689
25109,0.000767,74.125.68.0-255,1484,69428,7,374689
25110,0.000772,74.125.68.0-255,2902,72330,7,374689
25111,0.000775,172.31.36.0-255,66,72396,7,374689
25112,0.000805,74.125.68.0-255,4320,76716,7,374689
25113,0.000809,172.31.36.0-255,66,76782,7,374689
25114,0.000833,74.125.68.0-255,5738,82520,7,374689
25115,0.000837,172.31.36.0-255,66,82586,7,374689
25116,0.000859,74.125.68.0-255,7156,89742,7,374689
25117,0.000862,172.31.36.0-255,66,89808,7,374689
25118,0.000896,74.125.68.0-255,4320,94128,7,374689
25119,0.000899,172.31.36.0-255,66,94194,7,374689
25120,0.000904,74.125.68.0-255,4320,98514,7,374689
25121,0.000906,172.31.36.0-255,66,98580,7,374689
25122,0.000909,74.125.68.0-255,1484,100064,7,374689
25123,0.000931,74.125.68.0-255,766,100830,7,374689
25124,0.000934,172.31.36.0-255,66,100896,7,374689
25125,0.000981,74.125.68.0-255,1484,102380,7,374689
25126,0.000998,74.125.68.0-255,2902,105282,7,374689
25127,0.001002,172.31.36.0-255,66,105348,7,374689
25128,0.001047,74.125.68.0-255,5738,111086,7,374689
25129,0.001053,74.125.68.0-255,7156,118242,7,374689
25130,0.001053,172.31.36.0-255,66,118308,7,374689
25131,0.001058,172.31.36.0-255,66,118374,7,374689
25132,0.00108,172.31.36.0-255,66,118440,7,374689
25133,0.001103,74.125.68.0-255,2902,121342,7,374689
25134,0.001106,172.31.36.0-255,66,121408,7,374689
25135,0.001121,74.125.68.0-255,2902,124310,7,374689
25136,0.001124,172.31.36.0-255,66,124376,7,374689
25137,0.001161,172.31.36.0-255,66,124442,7,374689
25138,0.001194,172.31.36.0-255,66,124508,7,374689
25139,0.001199,74.125.68.0-255,2902,127410,7,374689
25140,0.001201,172.31.36.0-255,66,127476,7,374689
25141,0.001222,74.125.68.0-255,7156,134632,7,374689
25142,0.001226,172.31.36.0-255,66,134698,7,374689
25143,0.00123,74.125.68.0-255,2184,136882,7,374689
25144,0.001233,172.31.36.0-255,66,136948,7,374689
25145,0.001523,74.125.68.0-255,1484,138432,7,374689
25146,0.00153,74.125.68.0-255,2902,141334,7,374689
25147,0.001533,172.31.36.0-255,66,141400,7,374689
25148,0.001555,74.125.68.0-255,5738,147138,7,374689
25149,0.001558,172.31.36.0-255,66,147204,7,374689
25150,0.001575,74.125.68.0-255,2902,150106,7,374689
25151,0.001578,172.31.36.0-255,66,150172,7,374689
25152,0.001605,74.125.68.0-255,5738,155910,7,374689
25153,0.001608,172.31.36.0-255,66,155976,7,374689
25154,0.00162,172.31.36.0-255,66,156042,7,374689
25155,0.001625,74.125.68.0-255,5020,161062,7,374689
25156,0.001628,172.31.36.0-255,66,161128,7,374689
25157,0.001904,74.125.68.0-255,1484,162612,7,374689
25158,0.00191,74.125.68.0-255,2902,165514,7,374689
25159,0.001913,172.31.36.0-255,66,165580,7,374689
25160,0.001938,74.125.68.0-255,4320,169900,7,374689
25161,0.00194,172.31.36.0-255,66,169966,7,374689
25162,0.001943,74.125.68.0-255,1484,171450,7,374689
25163,0.001963,74.125.68.0-255,4320,175770,7,374689
25164,0.001966,172.31.36.0-255,66,175836,7,374689
25165,0.001971,74.125.68.0-255,2902,178738,7,374689
25166,0.001974,172.31.36.0-255,66,178804,7,374689
25167,0.002005,74.125.68.0-255,4320,183124,7,374689
25168,0.002005,172.31.36.0-255,66,183190,7,374689
25169,0.002008,172.31.36.0-255,66,183256,7,374689
25170,0.002056,74.125.68.0-255,7156,190412,7,374689
25171,0.00206,172.31.36.0-255,66,190478,7,374689
25172,0.00209,172.31.36.0-255,66,190544,7,374689
25173,0.002101,74.125.68.0-255,5738,196282,7,374689
25174,0.002104,172.31.36.0-255,66,196348,7,374689
25175,0.004143,74.125.68.0-255,5738,202086,7,374689
25176,0.004151,172.31.36.0-255,66,202152,7,374689
25177,0.006206,74.125.68.0-255,5738,207890,7,374689
25178,0.006218,172.31.36.0-255,66,207956,7,374689
25179,0.008242,74.125.68.0-255,4320,212276,7,374689
25180,0.008249,172.31.36.0-255,66,212342,7,374689
25181,0.008268,74.125.68.0-255,1484,213826,7,374689
25182,0.010276,74.125.68.0-255,4320,218146,7,374689
25183,0.010282,172.31.36.0-255,66,218212,7,374689
25184,0.012305,74.125.68.0-255,5738,223950,7,374689
25185,0.012311,172.31.36.0-255,66,224016,7,374689
25186,0.014336,74.125.68.0-255,5738,229754,7,374689
25187,0.014345,172.31.36.0-255,66,229820,7,374689
25188,0.016459,74.125.68.0-255,5738,235558,7,374689
25189,0.016469,172.31.36.0-255,66,235624,7,374689
25190,0.018493,74.125.68.0-255,5738,241362,7,374689
25191,0.018502,172.31.36.0-255,66,241428,7,374689
25192,0.020539,74.125.68.0-255,5738,247166,7,374689
25193,0.020545,172.31.36.0-255,66,247232,7,374689
25194,0.022578,74.125.68.0-255,5738,252970,7,374689
25195,0.022586,172.31.36.0-255,66,253036,7,374689
25196,0.024622,74.125.68.0-255,4320,257356,7,374689
25197,0.02463,172.31.36.0-255,66,257422,7,374689
25198,0.024651,74.125.68.0-255,1484,258906,7,374689
25199,0.026651,74.125.68.0-255,4320,263226,7,374689
25200,0.026658,172.31.36.0-255,66,263292,7,374689
25201,0.028701,74.125.68.0-255,5738,269030,7,374689
25202,0.028709,172.31.36.0-255,66,269096,7,374689
25203,0.030746,74.125.68.0-255,5738,274834,7,374689
25204,0.030754,172.31.36.0-255,66,274900,7,374689
25205,0.032801,74.125.68.0-255,5738,280638,7,374689
25206,0.032808,172.31.36.0-255,66,280704,7,374689
25207,0.033983,172.31.36.0-255,172,280876,7,374689
25208,0.034013,172.31.36.0-255,1115,281991,7,374689
25209,0.034095,172.31.36.0-255,1514,283505,7,374689
25210,0.034097,172.31.36.0-255,1514,285019,7,374689
25211,0.034103,172.31.36.0-255,1514,286533,7,374689
25212,0.034104,172.31.36.0-255,1514,288047,7,374689
25213,0.03413,172.31.36.0-255,1514,289561,7,374689
25214,0.034131,172.31.36.0-255,70,289631,7,374689
25215,0.034837,74.125.68.0-255,5738,295369,7,374689
25216,0.034843,172.31.36.0-255,66,295435,7,374689
25217,0.035534,104.244.42.0-255,66,295501,7,374689
25218,0.035541,104.244.42.0-255,66,295567,7,374689
25219,0.035663,104.244.42.0-255,66,295633,7,374689
25220,0.035667,104.244.42.0-255,66,295699,7,374689
25221,0.036866,74.125.68.0-255,5738,301437,7,374689
25222,0.036871,172.31.36.0-255,66,301503,7,374689
25223,0.038907,74.125.68.0-255,5738,307241,7,374689
25224,0.038914,172.31.36.0-255,66,307307,7,374689
25225,0.04096,74.125.68.0-255,5738,313045,7,374689
25226,0.040969,172.31.36.0-255,66,313111,7,374689
25227,0.043001,74.125.68.0-255,5738,318849,7,374689
25228,0.043008,172.31.36.0-255,66,318915,7,374689
25229,0.045059,74.125.68.0-255,5738,324653,7,374689
25230,0.045069,172.31.36.0-255,66,324719,7,374689
25231,0.047109,74.125.68.0-255,5738,330457,7,374689
25232,0.047116,172.31.36.0-255,66,330523,7,374689
25233,0.049157,74.125.68.0-255,5738,336261,7,374689
25234,0.049164,172.31.36.0-255,66,336327,7,374689
25235,0.0512,74.125.68.0-255,5738,342065,7,374689
25236,0.051207,172.31.36.0-255,66,342131,7,374689
25237,0.053249,74.125.68.0-255,5738,347869,7,374689
25238,0.053256,172.31.36.0-255,66,347935,7,374689
25239,0.055289,74.125.68.0-255,5738,353673,7,374689
25240,0.055296,172.31.36.0-255,66,353739,7,374689
25241,0.057335,74.125.68.0-255,5738,359477,7,374689
25242,0.057342,172.31.36.0-255,66,359543,7,374689
25243,0.059368,74.125.68.0-255,5738,365281,7,374689
25244,0.059375,172.31.36.0-255,66,365347,7,374689
25245,0.061405,74.125.68.0-255,5738,371085,7,374689
25246,0.061412,172.31.36.0-255,66,371151,7,374689
25247,0.06344,74.125.68.0-255,3301,374452,7,374689
25248,0.063447,172.31.36.0-255,66,374518,7,374689
25249,0.064128,172.31.36.0-255,105,374623,7,374689
25250,0.066166,74.125.68.0-255,66,374689,7,374689
25251,0.0,74.125.68.0-255,153,153,7,317949
25252,1.7e-05,172.31.36.0-255,66,219,7,317949
25253,2.3e-05,74.125.68.0-255,1484,1703,7,317949
25254,2.7e-05,172.31.36.0-255,66,1769,7,317949
25255,3.3e-05,74.125.68.0-255,2902,4671,7,317949
25256,3.6e-05,172.31.36.0-255,66,4737,7,317949
25257,8.7e-05,74.125.68.0-255,7156,11893,7,317949
25258,9.1e-05,172.31.36.0-255,66,11959,7,317949
25259,0.000229,74.125.68.0-255,2018,13977,7,317949
25260,0.000235,172.31.36.0-255,66,14043,7,317949
25261,0.000261,74.125.68.0-255,2902,16945,7,317949
25262,0.000264,172.31.36.0-255,66,17011,7,317949
25263,0.000332,74.125.68.0-255,4320,21331,7,317949
25264,0.000337,172.31.36.0-255,66,21397,7,317949
25265,0.000364,74.125.68.0-255,2902,24299,7,317949
25266,0.000367,172.31.36.0-255,66,24365,7,317949
25267,0.000467,74.125.68.0-255,6797,31162,7,317949
25268,0.000473,172.31.36.0-255,66,31228,7,317949
25269,0.000604,74.125.68.0-255,4320,35548,7,317949
25270,0.00061,172.31.36.0-255,66,35614,7,317949
25271,0.000633,74.125.68.0-255,2902,38516,7,317949
25272,0.000639,172.31.36.0-255,66,38582,7,317949
25273,0.000745,74.125.68.0-255,1484,40066,7,317949
25274,0.000749,172.31.36.0-255,66,40132,7,317949
25275,0.000783,74.125.68.0-255,4320,44452,7,317949
25276,0.000787,172.31.36.0-255,66,44518,7,317949
25277,0.000816,74.125.68.0-255,6797,51315,7,317949
25278,0.00082,172.31.36.0-255,66,51381,7,317949
25279,0.001014,172.31.36.0-255,66,51447,7,317949
25280,0.001041,74.125.68.0-255,5691,57138,7,317949
25281,0.001044,172.31.36.0-255,66,57204,7,317949
25282,0.001261,74.125.68.0-255,111,57315,7,317949
25283,0.001267,74.125.68.0-255,329,57644,7,317949
25284,0.001295,74.125.68.0-255,1484,59128,7,317949
25285,0.001299,172.31.36.0-255,66,59194,7,317949
25286,0.001321,74.125.68.0-255,1484,60678,7,317949
25287,0.001363,74.125.68.0-255,5738,66416,7,317949
25288,0.001366,172.31.36.0-255,66,66482,7,317949
25289,0.001389,74.125.68.0-255,1484,67966,7,317949
25290,0.001516,74.125.68.0-255,4320,72286,7,317949
25291,0.001519,172.31.36.0-255,66,72352,7,317949
25292,0.001541,74.125.68.0-255,5738,78090,7,317949
25293,0.001543,172.31.36.0-255,66,78156,7,317949
25294,0.001567,74.125.68.0-255,4320,82476,7,317949
25295,0.001569,172.31.36.0-255,66,82542,7,317949
25296,0.001798,74.125.68.0-255,5738,88280,7,317949
25297,0.001803,172.31.36.0-255,66,88346,7,317949
25298,0.001832,74.125.68.0-255,3602,91948,7,317949
25299,0.001835,172.31.36.0-255,66,92014,7,317949
25300,0.001983,74.125.68.0-255,4320,96334,7,317949
25301,0.001987,172.31.36.0-255,66,96400,7,317949
25302,0.002008,74.125.68.0-255,5738,102138,7,317949
25303,0.00201,172.31.36.0-255,66,102204,7,317949
25304,0.002189,74.125.68.0-255,2902,105106,7,317949
25305,0.002193,172.31.36.0-255,66,105172,7,317949
25306,0.002234,172.31.36.0-255,66,105238,7,317949
25307,0.002623,74.125.68.0-255,2184,107422,7,317949
25308,0.002628,172.31.36.0-255,66,107488,7,317949
25309,0.00268,172.31.36.0-255,66,107554,7,317949
25310,0.002719,172.31.36.0-255,66,107620,7,317949
25311,0.003135,74.125.68.0-255,7156,114776,7,317949
25312,0.00314,172.31.36.0-255,66,114842,7,317949
25313,0.003173,74.125.68.0-255,4320,119162,7,317949
25314,0.003178,172.31.36.0-255,66,119228,7,317949
25315,0.005352,74.125.68.0-255,1484,120712,7,317949
25316,0.005396,74.125.68.0-255,2902,123614,7,317949
25317,0.005401,172.31.36.0-255,66,123680,7,317949
25318,0.005429,74.125.68.0-255,1484,125164,7,317949
25319,0.007634,74.125.68.0-255,4320,129484,7,317949
25320,0.007641,172.31.36.0-255,66,129550,7,317949
25321,0.009865,74.125.68.0-255,5738,135288,7,317949
25322,0.009875,172.31.36.0-255,66,135354,7,317949
25323,0.012104,74.125.68.0-255,5738,141092,7,317949
25324,0.012111,172.31.36.0-255,66,141158,7,317949
25325,0.014347,74.125.68.0-255,5738,146896,7,317949
25326,0.014357,172.31.36.0-255,66,146962,7,317949
25327,0.016589,74.125.68.0-255,5738,152700,7,317949
25328,0.016599,172.31.36.0-255,66,152766,7,317949
25329,0.018828,74.125.68.0-255,5738,158504,7,317949
25330,0.018836,172.31.36.0-255,66,158570,7,317949
25331,0.021103,74.125.68.0-255,5738,164308,7,317949
25332,0.02111,172.31.36.0-255,66,164374,7,317949
25333,0.023368,74.125.68.0-255,2902,167276,7,317949
25334,0.023374,172.31.36.0-255,66,167342,7,317949
25335,0.023402,74.125.68.0-255,2902,170244,7,317949
25336,0.023405,172.31.36.0-255,66,170310,7,317949
25337,0.02561,74.125.68.0-255,5738,176048,7,317949
25338,0.025618,172.31.36.0-255,66,176114,7,317949
25339,0.027854,74.125.68.0-255,4320,180434,7,317949
25340,0.027861,172.31.36.0-255,66,180500,7,317949
25341,0.027891,74.125.68.0-255,1484,181984,7,317949
25342,0.028783,172.31.36.0-255,167,182151,7,317949
25343,0.028825,172.31.36.0-255,1115,183266,7,317949
25344,0.028898,172.31.36.0-255,1514,184780,7,317949
25345,0.0289,172.31.36.0-255,1291,186071,7,317949
25346,0.030091,74.125.68.0-255,1484,187555,7,317949
25347,0.030099,172.31.36.0-255,66,187621,7,317949
25348,0.030106,74.125.68.0-255,2902,190523,7,317949
25349,0.030109,172.31.36.0-255,66,190589,7,317949
25350,0.030347,104.244.42.0-255,66,190655,7,317949
25351,0.030409,104.244.42.0-255,66,190721,7,317949
25352,0.030462,104.244.42.0-255,66,190787,7,317949
25353,0.032334,74.125.68.0-255,2902,193689,7,317949
25354,0.032341,172.31.36.0-255,66,193755,7,317949
25355,0.032368,74.125.68.0-255,2902,196657,7,317949
25356,0.032372,172.31.36.0-255,66,196723,7,317949
25357,0.034572,74.125.68.0-255,2902,199625,7,317949
25358,0.034585,172.31.36.0-255,66,199691,7,317949
25359,0.034619,74.125.68.0-255,2902,202593,7,317949
25360,0.034623,172.31.36.0-255,66,202659,7,317949
25361,0.036833,74.125.68.0-255,2902,205561,7,317949
25362,0.036849,172.31.36.0-255,66,205627,7,317949
25363,0.03688,74.125.68.0-255,2902,208529,7,317949
25364,0.036885,172.31.36.0-255,66,208595,7,317949
25365,0.039069,74.125.68.0-255,2902,211497,7,317949
25366,0.039077,172.31.36.0-255,66,211563,7,317949
25367,0.039121,74.125.68.0-255,2902,214465,7,317949
25368,0.039124,172.31.36.0-255,66,214531,7,317949
25369,0.0413,74.125.68.0-255,2902,217433,7,317949
25370,0.041306,172.31.36.0-255,66,217499,7,317949
25371,0.041339,74.125.68.0-255,1484,218983,7,317949
25372,0.041351,74.125.68.0-255,1484,220467,7,317949
25373,0.041354,172.31.36.0-255,66,220533,7,317949
25374,0.043528,74.125.68.0-255,2902,223435,7,317949
25375,0.043534,172.31.36.0-255,66,223501,7,317949
25376,0.043576,74.125.68.0-255,2902,226403,7,317949
25377,0.04358,172.31.36.0-255,66,226469,7,317949
25378,0.045758,74.125.68.0-255,2902,229371,7,317949
25379,0.045764,172.31.36.0-255,66,229437,7,317949
25380,0.0458,74.125.68.0-255,1484,230921,7,317949
25381,0.045818,74.125.68.0-255,1484,232405,7,317949
25382,0.045821,172.31.36.0-255,66,232471,7,317949
25383,0.047984,74.125.68.0-255,2902,235373,7,317949
25384,0.047989,172.31.36.0-255,66,235439,7,317949
25385,0.048026,74.125.68.0-255,1484,236923,7,317949
25386,0.04804,74.125.68.0-255,1484,238407,7,317949
25387,0.048043,172.31.36.0-255,66,238473,7,317949
25388,0.050214,74.125.68.0-255,2902,241375,7,317949
25389,0.05022,172.31.36.0-255,66,241441,7,317949
25390,0.050256,74.125.68.0-255,2902,244343,7,317949
25391,0.05026,172.31.36.0-255,66,244409,7,317949
25392,0.052436,74.125.68.0-255,2902,247311,7,317949
25393,0.052443,172.31.36.0-255,66,247377,7,317949
25394,0.052478,74.125.68.0-255,2902,250279,7,317949
25395,0.052481,172.31.36.0-255,66,250345,7,317949
25396,0.054673,74.125.68.0-255,2902,253247,7,317949
25397,0.054679,172.31.36.0-255,66,253313,7,317949
25398,0.054705,74.125.68.0-255,2902,256215,7,317949
25399,0.054709,172.31.36.0-255,66,256281,7,317949
25400,0.056912,74.125.68.0-255,2902,259183,7,317949
25401,0.056919,172.31.36.0-255,66,259249,7,317949
25402,0.05695,74.125.68.0-255,2902,262151,7,317949
25403,0.056954,172.31.36.0-255,66,262217,7,317949
25404,0.059152,74.125.68.0-255,2902,265119,7,317949
25405,0.059166,172.31.36.0-255,66,265185,7,317949
25406,0.059209,74.125.68.0-255,2902,268087,7,317949
25407,0.059213,172.31.36.0-255,66,268153,7,317949
25408,0.061397,74.125.68.0-255,2902,271055,7,317949
25409,0.061403,172.31.36.0-255,66,271121,7,317949
25410,0.061448,74.125.68.0-255,2902,274023,7,317949
25411,0.061451,172.31.36.0-255,66,274089,7,317949
25412,0.063668,74.125.68.0-255,1484,275573,7,317949
25413,0.063702,74.125.68.0-255,4320,279893,7,317949
25414,0.063707,172.31.36.0-255,66,279959,7,317949
25415,0.066047,74.125.68.0-255,1484,281443,7,317949
25416,0.06608,74.125.68.0-255,2902,284345,7,317949
25417,0.066086,172.31.36.0-255,66,284411,7,317949
25418,0.066112,74.125.68.0-255,1484,285895,7,317949
25419,0.068316,74.125.68.0-255,4320,290215,7,317949
25420,0.068322,172.31.36.0-255,66,290281,7,317949
25421,0.070541,74.125.68.0-255,5738,296019,7,317949
25422,0.070547,172.31.36.0-255,66,296085,7,317949
25423,0.072763,74.125.68.0-255,5738,301823,7,317949
25424,0.072769,172.31.36.0-255,66,301889,7,317949
25425,0.074993,74.125.68.0-255,4320,306209,7,317949
25426,0.074998,172.31.36.0-255,66,306275,7,317949
25427,0.075023,74.125.68.0-255,1484,307759,7,317949
25428,0.077262,74.125.68.0-255,4320,312079,7,317949
25429,0.077271,172.31.36.0-255,66,312145,7,317949
25430,0.079493,74.125.68.0-255,5738,317883,7,317949
25431,0.079497,172.31.36.0-255,66,317949,7,317949
25432,0.0,74.125.24.0-255,152,152,7,314763
25433,3.5e-05,172.31.36.0-255,66,218,7,314763
25434,4.3e-05,74.125.24.0-255,1484,1702,7,314763
25435,4.7e-05,172.31.36.0-255,66,1768,7,314763
25436,5.1e-05,74.125.24.0-255,2902,4670,7,314763
25437,5.4e-05,172.31.36.0-255,66,4736,7,314763
25438,5.6e-05,74.125.24.0-255,1484,6220,7,314763
25439,5.8e-05,172.31.36.0-255,66,6286,7,314763
25440,8.8e-05,74.125.24.0-255,5738,12024,7,314763
25441,9.3e-05,172.31.36.0-255,66,12090,7,314763
25442,0.000101,74.125.24.0-255,4828,16918,7,314763
25443,0.000104,172.31.36.0-255,66,16984,7,314763
25444,0.000129,74.125.24.0-255,1484,18468,7,314763
25445,0.000131,172.31.36.0-255,66,18534,7,314763
25446,0.000155,74.125.24.0-255,4320,22854,7,314763
25447,0.000159,172.31.36.0-255,66,22920,7,314763
25448,0.000169,172.31.36.0-255,66,22986,7,314763
25449,0.000224,74.125.24.0-255,1484,24470,7,314763
25450,0.000227,172.31.36.0-255,66,24536,7,314763
25451,0.00023,74.125.24.0-255,1484,26020,7,314763
25452,0.000232,172.31.36.0-255,66,26086,7,314763
25453,0.000247,74.125.24.0-255,1484,27570,7,314763
25454,0.000249,172.31.36.0-255,66,27636,7,314763
25455,0.000254,74.125.24.0-255,4320,31956,7,314763
25456,0.000256,172.31.36.0-255,66,32022,7,314763
25457,0.000259,74.125.24.0-255,1484,33506,7,314763
25458,0.00026,172.31.36.0-255,66,33572,7,314763
25459,0.000287,74.125.24.0-255,4320,37892,7,314763
25460,0.00029,172.31.36.0-255,66,37958,7,314763
25461,0.000293,74.125.24.0-255,1484,39442,7,314763
25462,0.000295,172.31.36.0-255,66,39508,7,314763
25463,0.00031,74.125.24.0-255,1125,40633,7,314763
25464,0.000314,74.125.24.0-255,1484,42117,7,314763
25465,0.000317,172.31.36.0-255,66,42183,7,314763
25466,0.000343,74.125.24.0-255,1484,43667,7,314763
25467,0.00035,74.125.24.0-255,7156,50823,7,314763
25468,0.000353,172.31.36.0-255,66,50889,7,314763
25469,0.00036,74.125.24.0-255,5738,56627,7,314763
25470,0.000362,172.31.36.0-255,66,56693,7,314763
25471,0.000379,74.125.24.0-255,1459,58152,7,314763
25472,0.000414,74.125.24.0-255,109,58261,7,314763
25473,0.000417,172.31.36.0-255,66,58327,7,314763
25474,0.000603,74.125.24.0-255,332,58659,7,314763
25475,0.000851,172.31.36.0-255,66,58725,7,314763
25476,0.001339,74.125.24.0-255,1484,60209,7,314763
25477,0.00135,74.125.24.0-255,2902,63111,7,314763
25478,0.001354,172.31.36.0-255,66,63177,7,314763
25479,0.001362,74.125.24.0-255,5738,68915,7,314763
25480,0.001364,172.31.36.0-255,66,68981,7,314763
25481,0.001409,74.125.24.0-255,4320,73301,7,314763
25482,0.001413,172.31.36.0-255,66,73367,7,314763
25483,0.001435,74.125.24.0-255,5738,79105,7,314763
25484,0.001438,172.31.36.0-255,66,79171,7,314763
25485,0.00145,172.31.36.0-255,66,79237,7,314763
25486,0.001453,74.125.24.0-255,2184,81421,7,314763
25487,0.001455,172.31.36.0-255,66,81487,7,314763
25488,0.001834,74.125.24.0-255,1484,82971,7,314763
25489,0.001838,74.125.24.0-255,2902,85873,7,314763
25490,0.00184,172.31.36.0-255,66,85939,7,314763
25491,0.001846,74.125.24.0-255,5738,91677,7,314763
25492,0.001848,172.31.36.0-255,66,91743,7,314763
25493,0.001859,172.31.36.0-255,66,91809,7,314763
25494,0.001897,172.31.36.0-255,66,91875,7,314763
25495,0.003848,74.125.24.0-255,4320,96195,7,314763
25496,0.003852,172.31.36.0-255,66,96261,7,314763
25497,0.003867,74.125.24.0-255,1484,97745,7,314763
25498,0.005823,74.125.24.0-255,4320,102065,7,314763
25499,0.005828,172.31.36.0-255,66,102131,7,314763
25500,0.007805,74.125.24.0-255,5738,107869,7,314763
25501,0.007811,172.31.36.0-255,66,107935,7,314763
25502,0.009769,74.125.24.0-255,5738,113673,7,314763
25503,0.009777,172.31.36.0-255,66,113739,7,314763
25504,0.011735,74.125.24.0-255,5738,119477,7,314763
25505,0.011742,172.31.36.0-255,66,119543,7,314763
25506,0.013719,74.125.24.0-255,5738,125281,7,314763
25507,0.01373,172.31.36.0-255,66,125347,7,314763
25508,0.015698,74.125.24.0-255,5738,131085,7,314763
25509,0.015706,172.31.36.0-255,66,131151,7,314763
25510,0.015807,172.31.36.0-255,101,131252,7,314763
25511,0.01766,74.125.24.0-255,4320,135572,7,314763
25512,0.017667,172.31.36.0-255,66,135638,7,314763
25513,0.017687,74.125.24.0-255,1484,137122,7,314763
25514,0.017739,74.125.24.0-255,66,137188,7,314763
25515,0.019657,74.125.24.0-255,4320,141508,7,314763
25516,0.019665,172.31.36.0-255,66,141574,7,314763
25517,0.021635,74.125.24.0-255,5738,147312,7,314763
25518,0.021643,172.31.36.0-255,66,147378,7,314763
25519,0.023634,74.125.24.0-255,5738,153116,7,314763
25520,0.023642,172.31.36.0-255,66,153182,7,314763
25521,0.025656,74.125.24.0-255,5738,158920,7,314763
25522,0.025665,172.31.36.0-255,66,158986,7,314763
25523,0.027635,74.125.24.0-255,2902,161888,7,314763
25524,0.027641,172.31.36.0-255,66,161954,7,314763
25525,0.027662,74.125.24.0-255,2902,164856,7,314763
25526,0.027666,172.31.36.0-255,66,164922,7,314763
25527,0.029577,74.125.24.0-255,2902,167824,7,314763
25528,0.029584,172.31.36.0-255,66,167890,7,314763
25529,0.029638,74.125.24.0-255,2902,170792,7,314763
25530,0.029641,172.31.36.0-255,66,170858,7,314763
25531,0.029678,172.31.36.0-255,172,171030,7,314763
25532,0.029707,172.31.36.0-255,1073,172103,7,314763
25533,0.031178,104.244.42.0-255,66,172169,7,314763
25534,0.031288,104.244.42.0-255,66,172235,7,314763
25535,0.031553,74.125.24.0-255,2902,175137,7,314763
25536,0.031557,172.31.36.0-255,66,175203,7,314763
25537,0.031592,74.125.24.0-255,2902,178105,7,314763
25538,0.031595,172.31.36.0-255,66,178171,7,314763
25539,0.033539,74.125.24.0-255,5738,183909,7,314763
25540,0.033544,172.31.36.0-255,66,183975,7,314763
25541,0.035504,74.125.24.0-255,5738,189713,7,314763
25542,0.03551,172.31.36.0-255,66,189779,7,314763
25543,0.037499,74.125.24.0-255,5738,195517,7,314763
25544,0.037505,172.31.36.0-255,66,195583,7,314763
25545,0.03949,74.125.24.0-255,5738,201321,7,314763
25546,0.039494,172.31.36.0-255,66,201387,7,314763
25547,0.04148,74.125.24.0-255,5738,207125,7,314763
25548,0.041485,172.31.36.0-255,66,207191,7,314763
25549,0.043466,74.125.24.0-255,5738,212929,7,314763
25550,0.043473,172.31.36.0-255,66,212995,7,314763
25551,0.045465,74.125.24.0-255,5738,218733,7,314763
25552,0.045472,172.31.36.0-255,66,218799,7,314763
25553,0.047468,74.125.24.0-255,5738,224537,7,314763
25554,0.047473,172.31.36.0-255,66,224603,7,314763
25555,0.049431,74.125.24.0-255,5738,230341,7,314763
25556,0.049436,172.31.36.0-255,66,230407,7,314763
25557,0.051425,74.125.24.0-255,5738,236145,7,314763
25558,0.051431,172.31.36.0-255,66,236211,7,314763
25559,0.053406,74.125.24.0-255,5738,241949,7,314763
25560,0.053411,172.31.36.0-255,66,242015,7,314763
25561,0.055434,74.125.24.0-255,5738,247753,7,314763
25562,0.055439,172.31.36.0-255,66,247819,7,314763
25563,0.057398,74.125.24.0-255,4320,252139,7,314763
25564,0.057419,172.31.36.0-255,66,252205,7,314763
25565,0.057437,74.125.24.0-255,1484,253689,7,314763
25566,0.059396,74.125.24.0-255,4320,258009,7,314763
25567,0.059402,172.31.36.0-255,66,258075,7,314763
25568,0.061444,74.125.24.0-255,5738,263813,7,314763
25569,0.06145,172.31.36.0-255,66,263879,7,314763
25570,0.063402,74.125.24.0-255,5738,269617,7,314763
25571,0.063407,172.31.36.0-255,66,269683,7,314763
25572,0.065391,74.125.24.0-255,5738,275421,7,314763
25573,0.065397,172.31.36.0-255,66,275487,7,314763
25574,0.067362,74.125.24.0-255,5738,281225,7,314763
25575,0.067367,172.31.36.0-255,66,281291,7,314763
25576,0.06932,74.125.24.0-255,5738,287029,7,314763
25577,0.069325,172.31.36.0-255,66,287095,7,314763
25578,0.071357,74.125.24.0-255,5738,292833,7,314763
25579,0.071363,172.31.36.0-255,66,292899,7,314763
25580,0.073355,74.125.24.0-255,5738,298637,7,314763
25581,0.073361,172.31.36.0-255,66,298703,7,314763
25582,0.075315,74.125.24.0-255,4320,303023,7,314763
25583,0.075322,172.31.36.0-255,66,303089,7,314763
25584,0.07535,74.125.24.0-255,1484,304573,7,314763
25585,0.077264,74.125.24.0-255,4320,308893,7,314763
25586,0.077272,172.31.36.0-255,66,308959,7,314763
25587,0.079247,74.125.24.0-255,5738,314697,7,314763
25588,0.079256,172.31.36.0-255,66,314763,7,314763
25589,0.0,74.125.24.0-255,152,152,7,328785
25590,3.3e-05,172.31.36.0-255,66,218,7,328785
25591,4e-05,74.125.24.0-255,1484,1702,7,328785
25592,4.4e-05,172.31.36.0-255,66,1768,7,328785
25593,5e-05,74.125.24.0-255,2902,4670,7,328785
25594,5.3e-05,172.31.36.0-255,66,4736,7,328785
25595,6.7e-05,74.125.24.0-255,5738,10474,7,328785
25596,6.9e-05,172.31.36.0-255,66,10540,7,328785
25597,0.000105,74.125.24.0-255,3394,13934,7,328785
25598,0.000108,172.31.36.0-255,66,14000,7,328785
25599,0.000145,74.125.24.0-255,1484,15484,7,328785
25600,0.000148,172.31.36.0-255,66,15550,7,328785
25601,0.000169,74.125.24.0-255,2902,18452,7,328785
25602,0.000171,172.31.36.0-255,66,18518,7,328785
25603,0.000174,74.125.24.0-255,1484,20002,7,328785
25604,0.000176,172.31.36.0-255,66,20068,7,328785
25605,0.000212,74.125.24.0-255,4320,24388,7,328785
25606,0.000215,172.31.36.0-255,66,24454,7,328785
25607,0.000218,74.125.24.0-255,1484,25938,7,328785
25608,0.00022,172.31.36.0-255,66,26004,7,328785
25609,0.00025,74.125.24.0-255,5379,31383,7,328785
25610,0.000253,172.31.36.0-255,66,31449,7,328785
25611,0.000638,74.125.24.0-255,1484,32933,7,328785
25612,0.000643,172.31.36.0-255,66,32999,7,328785
25613,0.000653,74.125.24.0-255,2902,35901,7,328785
25614,0.000664,172.31.36.0-255,66,35967,7,328785
25615,0.000671,74.125.24.0-255,5738,41705,7,328785
25616,0.000674,172.31.36.0-255,66,41771,7,328785
25617,0.000696,74.125.24.0-255,2902,44673,7,328785
25618,0.000699,172.31.36.0-255,66,44739,7,328785
25619,0.000739,172.31.36.0-255,66,44805,7,328785
25620,0.000751,172.31.36.0-255,66,44871,7,328785
25621,0.000753,74.125.24.0-255,410,45281,7,328785
25622,0.000785,74.125.24.0-255,334,45615,7,328785
25623,0.001128,172.31.36.0-255,66,45681,7,328785
25624,0.0014,74.125.24.0-255,1484,47165,7,328785
25625,0.001425,74.125.24.0-255,2902,50067,7,328785
25626,0.001428,172.31.36.0-255,66,50133,7,328785
25627,0.001435,74.125.24.0-255,4320,54453,7,328785
25628,0.001437,172.31.36.0-255,66,54519,7,328785
25629,0.001441,74.125.24.0-255,1484,56003,7,328785
25630,0.001469,74.125.24.0-255,4320,60323,7,328785
25631,0.001471,172.31.36.0-255,66,60389,7,328785
25632,0.001502,172.31.36.0-255,66,60455,7,328785
25633,0.001515,74.125.24.0-255,1484,61939,7,328785
25634,0.001526,74.125.24.0-255,7156,69095,7,328785
25635,0.001528,172.31.36.0-255,66,69161,7,328785
25636,0.001531,74.125.24.0-255,766,69927,7,328785
25637,0.001602,74.125.24.0-255,1484,71411,7,328785
25638,0.001608,172.31.36.0-255,66,71477,7,328785
25639,0.001618,74.125.24.0-255,2902,74379,7,328785
25640,0.001621,172.31.36.0-255,66,74445,7,328785
25641,0.00163,74.125.24.0-255,5738,80183,7,328785
25642,0.001632,172.31.36.0-255,66,80249,7,328785
25643,0.001637,74.125.24.0-255,2902,83151,7,328785
25644,0.001639,172.31.36.0-255,66,83217,7,328785
25645,0.001663,74.125.24.0-255,4320,87537,7,328785
25646,0.001667,172.31.36.0-255,66,87603,7,328785
25647,0.001689,74.125.24.0-255,5738,93341,7,328785
25648,0.001692,172.31.36.0-255,66,93407,7,328785
25649,0.001703,172.31.36.0-255,66,93473,7,328785
25650,0.001731,74.125.24.0-255,766,94239,7,328785
25651,0.001865,74.125.24.0-255,1484,95723,7,328785
25652,0.001869,172.31.36.0-255,66,95789,7,328785
25653,0.001874,74.125.24.0-255,2902,98691,7,328785
25654,0.001876,172.31.36.0-255,66,98757,7,328785
25655,0.001943,74.125.24.0-255,2902,101659,7,328785
25656,0.001946,172.31.36.0-255,66,101725,7,328785
25657,0.001951,74.125.24.0-255,4320,106045,7,328785
25658,0.001953,172.31.36.0-255,66,106111,7,328785
25659,0.001963,172.31.36.0-255,66,106177,7,328785
25660,0.00197,74.125.24.0-255,7156,113333,7,328785
25661,0.001972,172.31.36.0-255,66,113399,7,328785
25662,0.001998,74.125.24.0-255,6438,119837,7,328785
25663,0.002001,172.31.36.0-255,66,119903,7,328785
25664,0.00217,74.125.24.0-255,1484,121387,7,328785
25665,0.00219,74.125.24.0-255,2902,124289,7,328785
25666,0.002193,172.31.36.0-255,66,124355,7,328785
25667,0.002197,74.125.24.0-255,2902,127257,7,328785
25668,0.002199,172.31.36.0-255,66,127323,7,328785
25669,0.002231,74.125.24.0-255,2902,130225,7,328785
25670,0.002233,172.31.36.0-255,66,130291,7,328785
25671,0.00224,74.125.24.0-255,7156,137447,7,328785
25672,0.002242,172.31.36.0-255,66,137513,7,328785
25673,0.002268,74.125.24.0-255,5738,143251,7,328785
25674,0.002271,172.31.36.0-255,66,143317,7,328785
25675,0.002297,74.125.24.0-255,1484,144801,7,328785
25676,0.002318,172.31.36.0-255,66,144867,7,328785
25677,0.004646,74.125.24.0-255,5738,150605,7,328785
25678,0.004651,172.31.36.0-255,66,150671,7,328785
25679,0.006987,74.125.24.0-255,5738,156409,7,328785
25680,0.006993,172.31.36.0-255,66,156475,7,328785
25681,0.00935,74.125.24.0-255,5738,162213,7,328785
25682,0.009357,172.31.36.0-255,66,162279,7,328785
25683,0.011698,74.125.24.0-255,5738,168017,7,328785
25684,0.011706,172.31.36.0-255,66,168083,7,328785
25685,0.014061,74.125.24.0-255,5738,173821,7,328785
25686,0.014071,172.31.36.0-255,66,173887,7,328785
25687,0.016419,74.125.24.0-255,5738,179625,7,328785
25688,0.016431,172.31.36.0-255,66,179691,7,328785
25689,0.018796,74.125.24.0-255,5738,185429,7,328785
25690,0.018805,172.31.36.0-255,66,185495,7,328785
25691,0.021171,74.125.24.0-255,5738,191233,7,328785
25692,0.02118,172.31.36.0-255,66,191299,7,328785
25693,0.023562,74.125.24.0-255,5738,197037,7,328785
25694,0.02357,172.31.36.0-255,66,197103,7,328785
25695,0.025956,74.125.24.0-255,5738,202841,7,328785
25696,0.025963,172.31.36.0-255,66,202907,7,328785
25697,0.028309,74.125.24.0-255,5738,208645,7,328785
25698,0.028317,172.31.36.0-255,66,208711,7,328785
25699,0.030373,172.31.36.0-255,172,208883,7,328785
25700,0.030415,172.31.36.0-255,1116,209999,7,328785
25701,0.030482,172.31.36.0-255,1514,211513,7,328785
25702,0.030484,172.31.36.0-255,1290,212803,7,328785
25703,0.030642,74.125.24.0-255,4320,217123,7,328785
25704,0.03065,172.31.36.0-255,66,217189,7,328785
25705,0.030664,74.125.24.0-255,1484,218673,7,328785
25706,0.031942,104.244.42.0-255,66,218739,7,328785
25707,0.031971,104.244.42.0-255,66,218805,7,328785
25708,0.03204,104.244.42.0-255,66,218871,7,328785
25709,0.032988,74.125.24.0-255,2902,221773,7,328785
25710,0.032995,172.31.36.0-255,66,221839,7,328785
25711,0.033021,74.125.24.0-255,1484,223323,7,328785
25712,0.035342,74.125.24.0-255,4320,227643,7,328785
25713,0.035352,172.31.36.0-255,66,227709,7,328785
25714,0.037687,74.125.24.0-255,5738,233447,7,328785
25715,0.037693,172.31.36.0-255,66,233513,7,328785
25716,0.040032,74.125.24.0-255,5738,239251,7,328785
25717,0.040038,172.31.36.0-255,66,239317,7,328785
25718,0.042365,74.125.24.0-255,4320,243637,7,328785
25719,0.04237,172.31.36.0-255,66,243703,7,328785
25720,0.042401,74.125.24.0-255,1484,245187,7,328785
25721,0.044701,74.125.24.0-255,4320,249507,7,328785
25722,0.044707,172.31.36.0-255,66,249573,7,328785
25723,0.047056,74.125.24.0-255,4320,253893,7,328785
25724,0.047061,172.31.36.0-255,66,253959,7,328785
25725,0.047086,74.125.24.0-255,1484,255443,7,328785
25726,0.049416,74.125.24.0-255,4320,259763,7,328785
25727,0.049423,172.31.36.0-255,66,259829,7,328785
25728,0.051785,74.125.24.0-255,5738,265567,7,328785
25729,0.051794,172.31.36.0-255,66,265633,7,328785
25730,0.054193,74.125.24.0-255,5738,271371,7,328785
25731,0.054198,172.31.36.0-255,66,271437,7,328785
25732,0.056541,74.125.24.0-255,4320,275757,7,328785
25733,0.056547,172.31.36.0-255,66,275823,7,328785
25734,0.056578,74.125.24.0-255,1484,277307,7,328785
25735,0.05889,74.125.24.0-255,4320,281627,7,328785
25736,0.058896,172.31.36.0-255,66,281693,7,328785
25737,0.061229,74.125.24.0-255,2902,284595,7,328785
25738,0.061235,172.31.36.0-255,66,284661,7,328785
25739,0.061268,74.125.24.0-255,2902,287563,7,328785
25740,0.061272,172.31.36.0-255,66,287629,7,328785
25741,0.06359,74.125.24.0-255,2902,290531,7,328785
25742,0.063597,172.31.36.0-255,66,290597,7,328785
25743,0.063623,74.125.24.0-255,2902,293499,7,328785
25744,0.063626,172.31.36.0-255,66,293565,7,328785
25745,0.065954,74.125.24.0-255,2902,296467,7,328785
25746,0.065967,172.31.36.0-255,66,296533,7,328785
25747,0.065997,74.125.24.0-255,2902,299435,7,328785
25748,0.066001,172.31.36.0-255,66,299501,7,328785
25749,0.068345,74.125.24.0-255,5738,305239,7,328785
25750,0.068361,172.31.36.0-255,66,305305,7,328785
25751,0.070761,74.125.24.0-255,5738,311043,7,328785
25752,0.070775,172.31.36.0-255,66,311109,7,328785
25753,0.073112,74.125.24.0-255,5738,316847,7,328785
25754,0.073123,172.31.36.0-255,66,316913,7,328785
25755,0.075501,74.125.24.0-255,2902,319815,7,328785
25756,0.075508,172.31.36.0-255,66,319881,7,328785
25757,0.075545,74.125.24.0-255,2902,322783,7,328785
25758,0.075548,172.31.36.0-255,66,322849,7,328785
25759,0.077828,74.125.24.0-255,2902,325751,7,328785
25760,0.077833,172.31.36.0-255,66,325817,7,328785
25761,0.077865,74.125.24.0-255,2902,328719,7,328785
25762,0.077869,172.31.36.0-255,66,328785,7,328785
25763,0.0,74.125.24.0-255,297,297,7,290177
25764,2.3e-05,172.31.36.0-255,66,363,7,290177
25765,3e-05,74.125.24.0-255,1484,1847,7,290177
25766,3.4e-05,172.31.36.0-255,66,1913,7,290177
25767,4.1e-05,74.125.24.0-255,4320,6233,7,290177
25768,4.4e-05,172.31.36.0-255,66,6299,7,290177
25769,4.7e-05,74.125.24.0-255,1484,7783,7,290177
25770,5e-05,172.31.36.0-255,66,7849,7,290177
25771,7.7e-05,74.125.24.0-255,6082,13931,7,290177
25772,8.1e-05,172.31.36.0-255,66,13997,7,290177
25773,0.000115,74.125.24.0-255,1484,15481,7,290177
25774,0.000118,172.31.36.0-255,66,15547,7,290177
25775,0.000123,74.125.24.0-255,2902,18449,7,290177
25776,0.000126,172.31.36.0-255,66,18515,7,290177
25777,0.000133,74.125.24.0-255,5738,24253,7,290177
25778,0.000135,172.31.36.0-255,66,24319,7,290177
25779,0.000175,74.125.24.0-255,6797,31116,7,290177
25780,0.000177,172.31.36.0-255,66,31182,7,290177
25781,0.000217,74.125.24.0-255,1484,32666,7,290177
25782,0.00022,172.31.36.0-255,66,32732,7,290177
25783,0.000242,74.125.24.0-255,1484,34216,7,290177
25784,0.000244,172.31.36.0-255,66,34282,7,290177
25785,0.000262,74.125.24.0-255,1484,35766,7,290177
25786,0.000264,172.31.36.0-255,66,35832,7,290177
25787,0.000272,74.125.24.0-255,5738,41570,7,290177
25788,0.000274,172.31.36.0-255,66,41636,7,290177
25789,0.000279,74.125.24.0-255,4320,45956,7,290177
25790,0.000281,172.31.36.0-255,66,46022,7,290177
25791,0.000316,74.125.24.0-255,2543,48565,7,290177
25792,0.000318,172.31.36.0-255,66,48631,7,290177
25793,0.000337,74.125.24.0-255,2902,51533,7,290177
25794,0.00034,172.31.36.0-255,66,51599,7,290177
25795,0.00036,74.125.24.0-255,5738,57337,7,290177
25796,0.000378,74.125.24.0-255,1484,58821,7,290177
25797,0.000383,74.125.24.0-255,4320,63141,7,290177
25798,0.000421,74.125.24.0-255,2543,65684,7,290177
25799,0.000513,172.31.36.0-255,66,65750,7,290177
25800,0.000534,74.125.24.0-255,647,66397,7,290177
25801,0.000602,74.125.24.0-255,1484,67881,7,290177
25802,0.000611,172.31.36.0-255,66,67947,7,290177
25803,0.000622,74.125.24.0-255,2902,70849,7,290177
25804,0.000627,74.125.24.0-255,2902,73751,7,290177
25805,0.000638,74.125.24.0-255,2902,76653,7,290177
25806,0.000647,172.31.36.0-255,66,76719,7,290177
25807,0.000669,74.125.24.0-255,6797,83516,7,290177
25808,0.000689,172.31.36.0-255,66,83582,7,290177
25809,0.000745,74.125.24.0-255,1484,85066,7,290177
25810,0.000751,74.125.24.0-255,2902,87968,7,290177
25811,0.000753,74.125.24.0-255,1484,89452,7,290177
25812,0.000762,172.31.36.0-255,66,89518,7,290177
25813,0.000776,74.125.24.0-255,4320,93838,7,290177
25814,0.00078,74.125.24.0-255,2902,96740,7,290177
25815,0.000796,172.31.36.0-255,66,96806,7,290177
25816,0.000823,74.125.24.0-255,2902,99708,7,290177
25817,0.000835,74.125.24.0-255,1125,100833,7,290177
25818,0.000842,172.31.36.0-255,66,100899,7,290177
25819,0.001334,74.125.24.0-255,1484,102383,7,290177
25820,0.001339,74.125.24.0-255,2902,105285,7,290177
25821,0.001342,172.31.36.0-255,66,105351,7,290177
25822,0.001345,74.125.24.0-255,1484,106835,7,290177
25823,0.001362,74.125.24.0-255,4320,111155,7,290177
25824,0.001364,172.31.36.0-255,66,111221,7,290177
25825,0.001366,74.125.24.0-255,1484,112705,7,290177
25826,0.001398,74.125.24.0-255,2902,115607,7,290177
25827,0.00142,74.125.24.0-255,766,116373,7,290177
25828,0.00143,172.31.36.0-255,66,116439,7,290177
25829,0.001469,74.125.24.0-255,1484,117923,7,290177
25830,0.001488,74.125.24.0-255,4320,122243,7,290177
25831,0.001518,74.125.24.0-255,5738,127981,7,290177
25832,0.001532,172.31.36.0-255,66,128047,7,290177
25833,0.001572,172.31.36.0-255,66,128113,7,290177
25834,0.001601,74.125.24.0-255,1484,129597,7,290177
25835,0.001607,74.125.24.0-255,2902,132499,7,290177
25836,0.001621,172.31.36.0-255,66,132565,7,290177
25837,0.001632,74.125.24.0-255,5738,138303,7,290177
25838,0.001647,74.125.24.0-255,4320,142623,7,290177
25839,0.00165,172.31.36.0-255,66,142689,7,290177
25840,0.001674,74.125.24.0-255,1484,144173,7,290177
25841,0.001704,172.31.36.0-255,66,144239,7,290177
25842,0.001709,172.31.36.0-255,66,144305,7,290177
25843,0.002139,74.125.24.0-255,1484,145789,7,290177
25844,0.002145,74.125.24.0-255,2902,148691,7,290177
25845,0.002148,172.31.36.0-255,66,148757,7,290177
25846,0.002155,74.125.24.0-255,5738,154495,7,290177
25847,0.002168,74.125.24.0-255,1484,155979,7,290177
25848,0.002175,172.31.36.0-255,66,156045,7,290177
25849,0.002205,172.31.36.0-255,66,156111,7,290177
25850,0.002256,74.125.24.0-255,2184,158295,7,290177
25851,0.002269,172.31.36.0-255,66,158361,7,290177
25852,0.002317,74.125.24.0-255,1484,159845,7,290177
25853,0.002322,74.125.24.0-255,1484,161329,7,290177
25854,0.002328,172.31.36.0-255,66,161395,7,290177
25855,0.002348,74.125.24.0-255,1484,162879,7,290177
25856,0.002355,74.125.24.0-255,5738,168617,7,290177
25857,0.00238,74.125.24.0-255,2902,171519,7,290177
25858,0.002384,172.31.36.0-255,66,171585,7,290177
25859,0.00239,172.31.36.0-255,66,171651,7,290177
25860,0.002414,74.125.24.0-255,1484,173135,7,290177
25861,0.002418,74.125.24.0-255,2184,175319,7,290177
25862,0.002436,172.31.36.0-255,66,175385,7,290177
25863,0.00248,74.125.24.0-255,1484,176869,7,290177
25864,0.002485,74.125.24.0-255,2902,179771,7,290177
25865,0.002499,74.125.24.0-255,1484,181255,7,290177
25866,0.002502,74.125.24.0-255,1484,182739,7,290177
25867,0.002517,172.31.36.0-255,66,182805,7,290177
25868,0.002521,74.125.24.0-255,1484,184289,7,290177
25869,0.002527,74.125.24.0-255,5738,190027,7,290177
25870,0.002532,74.125.24.0-255,2902,192929,7,290177
25871,0.002541,172.31.36.0-255,66,192995,7,290177
25872,0.002562,74.125.24.0-255,6438,199433,7,290177
25873,0.002593,172.31.36.0-255,66,199499,7,290177
25874,0.002603,74.125.24.0-255,1484,200983,7,290177
25875,0.002609,74.125.24.0-255,2902,203885,7,290177
25876,0.002615,172.31.36.0-255,66,203951,7,290177
25877,0.00263,74.125.24.0-255,1484,205435,7,290177
25878,0.002634,74.125.24.0-255,1484,206919,7,290177
25879,0.002652,172.31.36.0-255,66,206985,7,290177
25880,0.002662,74.125.24.0-255,7156,214141,7,290177
25881,0.002669,74.125.24.0-255,7156,221297,7,290177
25882,0.002683,74.125.24.0-255,4320,225617,7,290177
25883,0.002694,172.31.36.0-255,66,225683,7,290177
25884,0.002728,172.31.36.0-255,66,225749,7,290177
25885,0.002785,74.125.24.0-255,1484,227233,7,290177
25886,0.00279,74.125.24.0-255,1484,228717,7,290177
25887,0.002808,74.125.24.0-255,1484,230201,7,290177
25888,0.002815,74.125.24.0-255,5738,235939,7,290177
25889,0.002823,172.31.36.0-255,66,236005,7,290177
25890,0.002841,74.125.24.0-255,7156,243161,7,290177
25891,0.002844,172.31.36.0-255,66,243227,7,290177
25892,0.002853,74.125.24.0-255,2902,246129,7,290177
25893,0.002855,74.125.24.0-255,1484,247613,7,290177
25894,0.002875,74.125.24.0-255,1484,249097,7,290177
25895,0.002902,74.125.24.0-255,5020,254117,7,290177
25896,0.002909,74.125.24.0-255,5738,259855,7,290177
25897,0.002927,172.31.36.0-255,66,259921,7,290177
25898,0.002932,74.125.24.0-255,4320,264241,7,290177
25899,0.002937,172.31.36.0-255,66,264307,7,290177
25900,0.002996,74.125.24.0-255,2184,266491,7,290177
25901,0.002998,74.125.24.0-255,1484,267975,7,290177
25902,0.003001,74.125.24.0-255,1484,269459,7,290177
25903,0.003007,172.31.36.0-255,66,269525,7,290177
25904,0.003019,74.125.24.0-255,4320,273845,7,290177
25905,0.003049,74.125.24.0-255,6492,280337,7,290177
25906,0.003095,74.125.24.0-255,105,280442,7,290177
25907,0.003106,172.31.36.0-255,66,280508,7,290177
25908,0.00482,172.31.36.0-255,105,280613,7,290177
25909,0.007128,74.125.24.0-255,66,280679,7,290177
25910,0.039875,172.31.36.0-255,172,280851,7,290177
25911,0.03992,172.31.36.0-255,1115,281966,7,290177
25912,0.039998,172.31.36.0-255,1514,283480,7,290177
25913,0.04,172.31.36.0-255,1514,284994,7,290177
25914,0.040001,172.31.36.0-255,1514,286508,7,290177
25915,0.040002,172.31.36.0-255,1514,288022,7,290177
25916,0.040039,172.31.36.0-255,1514,289536,7,290177
25917,0.04004,172.31.36.0-255,71,289607,7,290177
25918,0.041413,104.244.42.0-255,66,289673,7,290177
25919,0.041433,104.244.42.0-255,66,289739,7,290177
25920,0.041524,104.244.42.0-255,66,289805,7,290177
25921,0.041574,104.244.42.0-255,66,289871,7,290177
25922,0.041578,104.244.42.0-255,66,289937,7,290177
25923,0.04158,104.244.42.0-255,66,290003,7,290177
25924,0.042035,104.244.42.0-255,108,290111,7,290177
25925,0.042041,172.31.36.0-255,66,290177,7,290177
25926,0.0,172.217.194.0-255,143,143,7,283400
25927,3.9e-05,172.31.36.0-255,66,209,7,283400
25928,4.8e-05,172.217.194.0-255,1484,1693,7,283400
25929,5.2e-05,172.31.36.0-255,66,1759,7,283400
25930,6.6e-05,172.217.194.0-255,2902,4661,7,283400
25931,7e-05,172.31.36.0-255,66,4727,7,283400
25932,7.7e-05,172.217.194.0-255,5738,10465,7,283400
25933,7.9e-05,172.31.36.0-255,66,10531,7,283400
25934,9.5e-05,172.31.36.0-255,66,10597,7,283400
25935,0.000102,172.217.194.0-255,6797,17394,7,283400
25936,0.000105,172.31.36.0-255,66,17460,7,283400
25937,0.000151,172.217.194.0-255,1484,18944,7,283400
25938,0.000154,172.31.36.0-255,66,19010,7,283400
25939,0.00016,172.217.194.0-255,2902,21912,7,283400
25940,0.000161,172.31.36.0-255,66,21978,7,283400
25941,0.000168,172.217.194.0-255,5738,27716,7,283400
25942,0.000171,172.31.36.0-255,66,27782,7,283400
25943,0.000202,172.217.194.0-255,6797,34579,7,283400
25944,0.000206,172.31.36.0-255,66,34645,7,283400
25945,0.000281,172.217.194.0-255,1484,36129,7,283400
25946,0.000285,172.31.36.0-255,66,36195,7,283400
25947,0.00029,172.217.194.0-255,2902,39097,7,283400
25948,0.000293,172.31.36.0-255,66,39163,7,283400
25949,0.000308,172.217.194.0-255,5738,44901,7,283400
25950,0.000311,172.31.36.0-255,66,44967,7,283400
25951,0.000338,172.217.194.0-255,2902,47869,7,283400
25952,0.000341,172.31.36.0-255,66,47935,7,283400
25953,0.000362,172.217.194.0-255,4540,52475,7,283400
25954,0.000366,172.31.36.0-255,66,52541,7,283400
25955,0.000854,172.217.194.0-255,1484,54025,7,283400
25956,0.000858,172.31.36.0-255,66,54091,7,283400
25957,0.000864,172.217.194.0-255,2902,56993,7,283400
25958,0.000867,172.31.36.0-255,66,57059,7,283400
25959,0.000885,172.217.194.0-255,5738,62797,7,283400
25960,0.000887,172.31.36.0-255,66,62863,7,283400
25961,0.000891,172.217.194.0-255,2902,65765,7,283400
25962,0.000893,172.31.36.0-255,66,65831,7,283400
25963,0.000919,172.217.194.0-255,2902,68733,7,283400
25964,0.000922,172.31.36.0-255,66,68799,7,283400
25965,0.000936,172.31.36.0-255,66,68865,7,283400
25966,0.000941,172.217.194.0-255,2902,71767,7,283400
25967,0.000944,172.31.36.0-255,66,71833,7,283400
25968,0.000968,172.217.194.0-255,2184,74017,7,283400
25969,0.000971,172.31.36.0-255,66,74083,7,283400
25970,0.00156,172.217.194.0-255,1484,75567,7,283400
25971,0.001572,172.217.194.0-255,2902,78469,7,283400
25972,0.001577,172.31.36.0-255,66,78535,7,283400
25973,0.001606,172.217.194.0-255,5738,84273,7,283400
25974,0.00161,172.31.36.0-255,66,84339,7,283400
25975,0.001663,172.31.36.0-255,66,84405,7,283400
25976,0.00167,172.217.194.0-255,4320,88725,7,283400
25977,0.001672,172.31.36.0-255,66,88791,7,283400
25978,0.001697,172.217.194.0-255,6438,95229,7,283400
25979,0.0017,172.31.36.0-255,66,95295,7,283400
25980,0.004102,172.217.194.0-255,5738,101033,7,283400
25981,0.004113,172.31.36.0-255,66,101099,7,283400
25982,0.006455,172.217.194.0-255,5738,106837,7,283400
25983,0.006466,172.31.36.0-255,66,106903,7,283400
25984,0.008833,172.217.194.0-255,5738,112641,7,283400
25985,0.008846,172.31.36.0-255,66,112707,7,283400
25986,0.011197,172.217.194.0-255,5738,118445,7,283400
25987,0.011215,172.31.36.0-255,66,118511,7,283400
25988,0.013568,172.217.194.0-255,5738,124249,7,283400
25989,0.013579,172.31.36.0-255,66,124315,7,283400
25990,0.015929,172.217.194.0-255,5738,130053,7,283400
25991,0.01594,172.31.36.0-255,66,130119,7,283400
25992,0.018281,172.217.194.0-255,5738,135857,7,283400
25993,0.018289,172.31.36.0-255,66,135923,7,283400
25994,0.020636,172.217.194.0-255,5738,141661,7,283400
25995,0.020645,172.31.36.0-255,66,141727,7,283400
25996,0.022971,172.217.194.0-255,5738,147465,7,283400
25997,0.02298,172.31.36.0-255,66,147531,7,283400
25998,0.025359,172.217.194.0-255,5738,153269,7,283400
25999,0.025371,172.31.36.0-255,66,153335,7,283400
26000,0.027736,172.217.194.0-255,5738,159073,7,283400
26001,0.027744,172.31.36.0-255,66,159139,7,283400
26002,0.029102,172.31.36.0-255,171,159310,7,283400
26003,0.029132,172.31.36.0-255,1139,160449,7,283400
26004,0.029172,172.31.36.0-255,1514,161963,7,283400
26005,0.029174,172.31.36.0-255,1267,163230,7,283400
26006,0.030076,172.217.194.0-255,4320,167550,7,283400
26007,0.030082,172.31.36.0-255,66,167616,7,283400
26008,0.030117,172.217.194.0-255,1484,169100,7,283400
26009,0.030665,104.244.42.0-255,66,169166,7,283400
26010,0.030715,104.244.42.0-255,66,169232,7,283400
26011,0.030717,104.244.42.0-255,66,169298,7,283400
26012,0.032423,172.217.194.0-255,4320,173618,7,283400
26013,0.032429,172.31.36.0-255,66,173684,7,283400
26014,0.034749,172.217.194.0-255,5738,179422,7,283400
26015,0.034754,172.31.36.0-255,66,179488,7,283400
26016,0.037079,172.217.194.0-255,5738,185226,7,283400
26017,0.037085,172.31.36.0-255,66,185292,7,283400
26018,0.039434,172.217.194.0-255,5738,191030,7,283400
26019,0.03944,172.31.36.0-255,66,191096,7,283400
26020,0.041799,172.217.194.0-255,5738,196834,7,283400
26021,0.041804,172.31.36.0-255,66,196900,7,283400
26022,0.044126,172.217.194.0-255,4320,201220,7,283400
26023,0.044132,172.31.36.0-255,66,201286,7,283400
26024,0.044169,172.217.194.0-255,1484,202770,7,283400
26025,0.046471,172.217.194.0-255,4320,207090,7,283400
26026,0.046477,172.31.36.0-255,66,207156,7,283400
26027,0.048808,172.217.194.0-255,4320,211476,7,283400
26028,0.048813,172.31.36.0-255,66,211542,7,283400
26029,0.04885,172.217.194.0-255,1484,213026,7,283400
26030,0.051181,172.217.194.0-255,4320,217346,7,283400
26031,0.051188,172.31.36.0-255,66,217412,7,283400
26032,0.053562,172.217.194.0-255,5738,223150,7,283400
26033,0.053569,172.31.36.0-255,66,223216,7,283400
26034,0.055905,172.217.194.0-255,4320,227536,7,283400
26035,0.055912,172.31.36.0-255,66,227602,7,283400
26036,0.055946,172.217.194.0-255,1484,229086,7,283400
26037,0.05826,172.217.194.0-255,4320,233406,7,283400
26038,0.058265,172.31.36.0-255,66,233472,7,283400
26039,0.060605,172.217.194.0-255,4320,237792,7,283400
26040,0.060611,172.31.36.0-255,66,237858,7,283400
26041,0.060642,172.217.194.0-255,1484,239342,7,283400
26042,0.062935,172.217.194.0-255,4320,243662,7,283400
26043,0.06294,172.31.36.0-255,66,243728,7,283400
26044,0.065277,172.217.194.0-255,5738,249466,7,283400
26045,0.065282,172.31.36.0-255,66,249532,7,283400
26046,0.067603,172.217.194.0-255,4320,253852,7,283400
26047,0.067608,172.31.36.0-255,66,253918,7,283400
26048,0.06765,172.217.194.0-255,1484,255402,7,283400
26049,0.069937,172.217.194.0-255,4320,259722,7,283400
26050,0.069941,172.31.36.0-255,66,259788,7,283400
26051,0.072282,172.217.194.0-255,5738,265526,7,283400
26052,0.072288,172.31.36.0-255,66,265592,7,283400
26053,0.074634,172.217.194.0-255,2902,268494,7,283400
26054,0.07464,172.31.36.0-255,66,268560,7,283400
26055,0.074673,172.217.194.0-255,2902,271462,7,283400
26056,0.074676,172.31.36.0-255,66,271528,7,283400
26057,0.076971,172.217.194.0-255,2902,274430,7,283400
26058,0.076977,172.31.36.0-255,66,274496,7,283400
26059,0.077004,172.217.194.0-255,2902,277398,7,283400
26060,0.077008,172.31.36.0-255,66,277464,7,283400
26061,0.079308,172.217.194.0-255,2902,280366,7,283400
26062,0.079314,172.31.36.0-255,66,280432,7,283400
26063,0.079352,172.217.194.0-255,2902,283334,7,283400
26064,0.079356,172.31.36.0-255,66,283400,7,283400
26065,0.0,172.217.194.0-255,153,153,7,242738
26066,2.5e-05,172.31.36.0-255,66,219,7,242738
26067,3.2e-05,172.217.194.0-255,1484,1703,7,242738
26068,3.6e-05,172.31.36.0-255,66,1769,7,242738
26069,4e-05,172.217.194.0-255,2902,4671,7,242738
26070,4.2e-05,172.31.36.0-255,66,4737,7,242738
26071,5.1e-05,172.217.194.0-255,5738,10475,7,242738
26072,5.3e-05,172.31.36.0-255,66,10541,7,242738
26073,7.9e-05,172.217.194.0-255,1484,12025,7,242738
26074,8.1e-05,172.31.36.0-255,66,12091,7,242738
26075,8.7e-05,172.217.194.0-255,2068,14159,7,242738
26076,8.9e-05,172.31.36.0-255,66,14225,7,242738
26077,9.3e-05,172.217.194.0-255,2902,17127,7,242738
26078,9.5e-05,172.31.36.0-255,66,17193,7,242738
26079,0.00012,172.217.194.0-255,1484,18677,7,242738
26080,0.000122,172.31.36.0-255,66,18743,7,242738
26081,0.000136,172.217.194.0-255,4320,23063,7,242738
26082,0.000138,172.31.36.0-255,66,23129,7,242738
26083,0.000195,172.31.36.0-255,66,23195,7,242738
26084,0.000198,172.217.194.0-255,1484,24679,7,242738
26085,0.0002,172.31.36.0-255,66,24745,7,242738
26086,0.000225,172.217.194.0-255,7156,31901,7,242738
26087,0.000228,172.31.36.0-255,66,31967,7,242738
26088,0.000233,172.217.194.0-255,4320,36287,7,242738
26089,0.000235,172.31.36.0-255,66,36353,7,242738
26090,0.000283,172.217.194.0-255,4320,40673,7,242738
26091,0.000287,172.31.36.0-255,66,40739,7,242738
26092,0.000313,172.217.194.0-255,3961,44700,7,242738
26093,0.000319,172.31.36.0-255,66,44766,7,242738
26094,0.000323,172.31.36.0-255,66,44832,7,242738
26095,0.000327,172.217.194.0-255,1484,46316,7,242738
26096,0.000341,172.217.194.0-255,2853,49169,7,242738
26097,0.000344,172.31.36.0-255,66,49235,7,242738
26098,0.000347,172.217.194.0-255,398,49633,7,242738
26099,0.000499,172.217.194.0-255,1484,51117,7,242738
26100,0.000503,172.31.36.0-255,66,51183,7,242738
26101,0.000509,172.217.194.0-255,2902,54085,7,242738
26102,0.000511,172.31.36.0-255,66,54151,7,242738
26103,0.000516,172.217.194.0-255,4320,58471,7,242738
26104,0.000521,172.31.36.0-255,66,58537,7,242738
26105,0.000548,172.217.194.0-255,1484,60021,7,242738
26106,0.000556,172.217.194.0-255,7156,67177,7,242738
26107,0.000559,172.31.36.0-255,66,67243,7,242738
26108,0.000586,172.31.36.0-255,66,67309,7,242738
26109,0.00059,172.217.194.0-255,2184,69493,7,242738
26110,0.000593,172.31.36.0-255,66,69559,7,242738
26111,0.000778,172.217.194.0-255,1484,71043,7,242738
26112,0.000784,172.217.194.0-255,2902,73945,7,242738
26113,0.000788,172.31.36.0-255,66,74011,7,242738
26114,0.000803,172.217.194.0-255,1484,75495,7,242738
26115,0.000818,172.217.194.0-255,4320,79815,7,242738
26116,0.000821,172.31.36.0-255,66,79881,7,242738
26117,0.000825,172.217.194.0-255,1484,81365,7,242738
26118,0.000854,172.31.36.0-255,66,81431,7,242738
26119,0.000867,172.31.36.0-255,66,81497,7,242738
26120,0.000883,172.217.194.0-255,217,81714,7,242738
26121,0.000952,172.217.194.0-255,1484,83198,7,242738
26122,0.000955,172.31.36.0-255,66,83264,7,242738
26123,0.00096,172.217.194.0-255,2902,86166,7,242738
26124,0.000962,172.31.36.0-255,66,86232,7,242738
26125,0.000975,172.217.194.0-255,2902,89134,7,242738
26126,0.000978,172.31.36.0-255,66,89200,7,242738
26127,0.000995,172.217.194.0-255,2902,92102,7,242738
26128,0.000997,172.31.36.0-255,66,92168,7,242738
26129,0.001004,172.217.194.0-255,5738,97906,7,242738
26130,0.001007,172.31.36.0-255,66,97972,7,242738
26131,0.001031,172.217.194.0-255,7156,105128,7,242738
26132,0.001034,172.31.36.0-255,66,105194,7,242738
26133,0.00105,172.31.36.0-255,66,105260,7,242738
26134,0.001164,172.217.194.0-255,1484,106744,7,242738
26135,0.001169,172.217.194.0-255,2902,109646,7,242738
26136,0.001172,172.31.36.0-255,66,109712,7,242738
26137,0.001195,172.217.194.0-255,5738,115450,7,242738
26138,0.001198,172.31.36.0-255,66,115516,7,242738
26139,0.001205,172.217.194.0-255,5738,121254,7,242738
26140,0.001207,172.31.36.0-255,66,121320,7,242738
26141,0.001225,172.217.194.0-255,1484,122804,7,242738
26142,0.001256,172.31.36.0-255,66,122870,7,242738
26143,0.001261,172.217.194.0-255,2184,125054,7,242738
26144,0.001263,172.31.36.0-255,66,125120,7,242738
26145,0.001296,172.217.194.0-255,1484,126604,7,242738
26146,0.001312,172.217.194.0-255,2902,129506,7,242738
26147,0.001315,172.31.36.0-255,66,129572,7,242738
26148,0.001322,172.217.194.0-255,5738,135310,7,242738
26149,0.001329,172.31.36.0-255,66,135376,7,242738
26150,0.001388,172.217.194.0-255,7156,142532,7,242738
26151,0.001389,172.31.36.0-255,66,142598,7,242738
26152,0.001394,172.31.36.0-255,66,142664,7,242738
26153,0.001408,172.217.194.0-255,3602,146266,7,242738
26154,0.001416,172.31.36.0-255,66,146332,7,242738
26155,0.001539,172.217.194.0-255,1484,147816,7,242738
26156,0.001555,172.217.194.0-255,2902,150718,7,242738
26157,0.001558,172.31.36.0-255,66,150784,7,242738
26158,0.001564,172.217.194.0-255,4320,155104,7,242738
26159,0.001579,172.217.194.0-255,4320,159424,7,242738
26160,0.001579,172.31.36.0-255,66,159490,7,242738
26161,0.001584,172.31.36.0-255,66,159556,7,242738
26162,0.001598,172.217.194.0-255,4320,163876,7,242738
26163,0.001609,172.31.36.0-255,66,163942,7,242738
26164,0.001644,172.31.36.0-255,66,164008,7,242738
26165,0.001647,172.217.194.0-255,766,164774,7,242738
26166,0.001724,172.217.194.0-255,1484,166258,7,242738
26167,0.001734,172.31.36.0-255,66,166324,7,242738
26168,0.001741,172.217.194.0-255,2902,169226,7,242738
26169,0.001748,172.31.36.0-255,66,169292,7,242738
26170,0.001756,172.217.194.0-255,5738,175030,7,242738
26171,0.001762,172.31.36.0-255,66,175096,7,242738
26172,0.001772,172.217.194.0-255,5738,180834,7,242738
26173,0.001775,172.31.36.0-255,66,180900,7,242738
26174,0.001796,172.217.194.0-255,7156,188056,7,242738
26175,0.001805,172.31.36.0-255,66,188122,7,242738
26176,0.001822,172.217.194.0-255,2902,191024,7,242738
26177,0.00183,172.31.36.0-255,66,191090,7,242738
26178,0.001856,172.31.36.0-255,66,191156,7,242738
26179,0.001862,172.217.194.0-255,1484,192640,7,242738
26180,0.001866,172.217.194.0-255,2902,195542,7,242738
26181,0.00187,172.31.36.0-255,66,195608,7,242738
26182,0.001888,172.217.194.0-255,4320,199928,7,242738
26183,0.001895,172.31.36.0-255,66,199994,7,242738
26184,0.001902,172.217.194.0-255,1484,201478,7,242738
26185,0.001907,172.217.194.0-255,4320,205798,7,242738
26186,0.001911,172.31.36.0-255,66,205864,7,242738
26187,0.001932,172.217.194.0-255,7156,213020,7,242738
26188,0.001932,172.31.36.0-255,66,213086,7,242738
26189,0.001946,172.31.36.0-255,66,213152,7,242738
26190,0.001947,172.217.194.0-255,3602,216754,7,242738
26191,0.00195,172.31.36.0-255,66,216820,7,242738
26192,0.001974,172.217.194.0-255,1484,218304,7,242738
26193,0.002008,172.217.194.0-255,4320,222624,7,242738
26194,0.002012,172.31.36.0-255,66,222690,7,242738
26195,0.002039,172.31.36.0-255,66,222756,7,242738
26196,0.002042,172.217.194.0-255,3602,226358,7,242738
26197,0.002048,172.217.194.0-255,4320,230678,7,242738
26198,0.002053,172.31.36.0-255,66,230744,7,242738
26199,0.002079,172.31.36.0-255,66,230810,7,242738
26200,0.002083,172.217.194.0-255,1484,232294,7,242738
26201,0.002161,172.31.36.0-255,66,232360,7,242738
26202,0.002169,172.217.194.0-255,5020,237380,7,242738
26203,0.002171,172.217.194.0-255,658,238038,7,242738
26204,0.002174,172.217.194.0-255,105,238143,7,242738
26205,0.002175,172.31.36.0-255,66,238209,7,242738
26206,0.009532,172.31.36.0-255,66,238275,7,242738
26207,0.009557,172.31.36.0-255,105,238380,7,242738
26208,0.011801,172.217.194.0-255,66,238446,7,242738
26209,0.028563,172.31.36.0-255,172,238618,7,242738
26210,0.028593,172.31.36.0-255,1114,239732,7,242738
26211,0.028637,172.31.36.0-255,1514,241246,7,242738
26212,0.028639,172.31.36.0-255,1294,242540,7,242738
26213,0.030083,104.244.42.0-255,66,242606,7,242738
26214,0.030134,104.244.42.0-255,66,242672,7,242738
26215,0.03021,104.244.42.0-255,66,242738,7,242738
26216,0.0,172.31.36.0-255,105,105,7,105
26217,0.0,172.217.194.0-255,153,153,7,310356
26218,3.4e-05,172.31.36.0-255,66,219,7,310356
26219,4.1e-05,172.217.194.0-255,1484,1703,7,310356
26220,4.7e-05,172.31.36.0-255,66,1769,7,310356
26221,6e-05,172.217.194.0-255,2902,4671,7,310356
26222,6.3e-05,172.31.36.0-255,66,4737,7,310356
26223,7.1e-05,172.217.194.0-255,7156,11893,7,310356
26224,7.3e-05,172.31.36.0-255,66,11959,7,310356
26225,7.8e-05,172.217.194.0-255,1994,13953,7,310356
26226,8.1e-05,172.31.36.0-255,66,14019,7,310356
26227,0.000278,172.217.194.0-255,1484,15503,7,310356
26228,0.000283,172.31.36.0-255,66,15569,7,310356
26229,0.00029,172.217.194.0-255,2902,18471,7,310356
26230,0.000294,172.31.36.0-255,66,18537,7,310356
26231,0.000306,172.217.194.0-255,5738,24275,7,310356
26232,0.000309,172.31.36.0-255,66,24341,7,310356
26233,0.000372,172.31.36.0-255,66,24407,7,310356
26234,0.000399,172.217.194.0-255,3961,28368,7,310356
26235,0.000403,172.31.36.0-255,66,28434,7,310356
26236,0.00041,172.217.194.0-255,5738,34172,7,310356
26237,0.000412,172.31.36.0-255,66,34238,7,310356
26238,0.000445,172.217.194.0-255,5379,39617,7,310356
26239,0.00045,172.31.36.0-255,66,39683,7,310356
26240,0.001291,172.217.194.0-255,1484,41167,7,310356
26241,0.001297,172.31.36.0-255,66,41233,7,310356
26242,0.001307,172.217.194.0-255,2902,44135,7,310356
26243,0.00131,172.31.36.0-255,66,44201,7,310356
26244,0.001323,172.217.194.0-255,5738,49939,7,310356
26245,0.001325,172.31.36.0-255,66,50005,7,310356
26246,0.001332,172.217.194.0-255,5738,55743,7,310356
26247,0.001334,172.31.36.0-255,66,55809,7,310356
26248,0.001354,172.217.194.0-255,1125,56934,7,310356
26249,0.001386,172.217.194.0-255,1484,58418,7,310356
26250,0.00139,172.31.36.0-255,66,58484,7,310356
26251,0.001396,172.217.194.0-255,4320,62804,7,310356
26252,0.001398,172.31.36.0-255,66,62870,7,310356
26253,0.001419,172.31.36.0-255,66,62936,7,310356
26254,0.001426,172.217.194.0-255,6797,69733,7,310356
26255,0.001428,172.31.36.0-255,66,69799,7,310356
26256,0.001504,172.31.36.0-255,66,69865,7,310356
26257,0.001606,172.217.194.0-255,1484,71349,7,310356
26258,0.001613,172.217.194.0-255,2902,74251,7,310356
26259,0.001616,172.31.36.0-255,66,74317,7,310356
26260,0.001641,172.217.194.0-255,5738,80055,7,310356
26261,0.001643,172.31.36.0-255,66,80121,7,310356
26262,0.00165,172.217.194.0-255,5738,85859,7,310356
26263,0.001652,172.31.36.0-255,66,85925,7,310356
26264,0.001675,172.217.194.0-255,4320,90245,7,310356
26265,0.001678,172.31.36.0-255,66,90311,7,310356
26266,0.001684,172.217.194.0-255,5738,96049,7,310356
26267,0.001686,172.31.36.0-255,66,96115,7,310356
26268,0.001723,172.31.36.0-255,66,96181,7,310356
26269,0.001889,172.217.194.0-255,1484,97665,7,310356
26270,0.001893,172.217.194.0-255,1484,99149,7,310356
26271,0.001898,172.31.36.0-255,66,99215,7,310356
26272,0.001918,172.217.194.0-255,1484,100699,7,310356
26273,0.001925,172.217.194.0-255,5738,106437,7,310356
26274,0.001927,172.31.36.0-255,66,106503,7,310356
26275,0.001934,172.217.194.0-255,5738,112241,7,310356
26276,0.001936,172.31.36.0-255,66,112307,7,310356
26277,0.001972,172.217.194.0-255,7156,119463,7,310356
26278,0.001975,172.31.36.0-255,66,119529,7,310356
26279,0.001978,172.217.194.0-255,1484,121013,7,310356
26280,0.00198,172.217.194.0-255,1484,122497,7,310356
26281,0.001982,172.31.36.0-255,66,122563,7,310356
26282,0.002019,172.31.36.0-255,66,122629,7,310356
26283,0.004327,172.217.194.0-255,5738,128367,7,310356
26284,0.004331,172.31.36.0-255,66,128433,7,310356
26285,0.006622,172.217.194.0-255,5738,134171,7,310356
26286,0.006628,172.31.36.0-255,66,134237,7,310356
26287,0.008929,172.217.194.0-255,5738,139975,7,310356
26288,0.008935,172.31.36.0-255,66,140041,7,310356
26289,0.01123,172.217.194.0-255,5738,145779,7,310356
26290,0.011238,172.31.36.0-255,66,145845,7,310356
26291,0.013514,172.217.194.0-255,5738,151583,7,310356
26292,0.013521,172.31.36.0-255,66,151649,7,310356
26293,0.01579,172.217.194.0-255,5738,157387,7,310356
26294,0.015797,172.31.36.0-255,66,157453,7,310356
26295,0.018107,172.217.194.0-255,5738,163191,7,310356
26296,0.018118,172.31.36.0-255,66,163257,7,310356
26297,0.020411,172.217.194.0-255,5738,168995,7,310356
26298,0.020418,172.31.36.0-255,66,169061,7,310356
26299,0.022706,172.217.194.0-255,5738,174799,7,310356
26300,0.022713,172.31.36.0-255,66,174865,7,310356
26301,0.02402,172.31.36.0-255,188,175053,7,310356
26302,0.024063,172.31.36.0-255,958,176011,7,310356
26303,0.024142,172.31.36.0-255,1514,177525,7,310356
26304,0.024144,172.31.36.0-255,1449,178974,7,310356
26305,0.025008,172.217.194.0-255,5738,184712,7,310356
26306,0.025015,172.31.36.0-255,66,184778,7,310356
26307,0.0256,104.244.42.0-255,66,184844,7,310356
26308,0.025645,104.244.42.0-255,66,184910,7,310356
26309,0.025747,104.244.42.0-255,66,184976,7,310356
26310,0.027322,172.217.194.0-255,4320,189296,7,310356
26311,0.027327,172.31.36.0-255,66,189362,7,310356
26312,0.027361,172.217.194.0-255,1484,190846,7,310356
26313,0.029613,172.217.194.0-255,2902,193748,7,310356
26314,0.029619,172.31.36.0-255,66,193814,7,310356
26315,0.031903,172.217.194.0-255,4320,198134,7,310356
26316,0.031909,172.31.36.0-255,66,198200,7,310356
26317,0.031946,172.217.194.0-255,1484,199684,7,310356
26318,0.034197,172.217.194.0-255,4320,204004,7,310356
26319,0.034203,172.31.36.0-255,66,204070,7,310356
26320,0.036543,172.217.194.0-255,5738,209808,7,310356
26321,0.03655,172.31.36.0-255,66,209874,7,310356
26322,0.038849,172.217.194.0-255,5738,215612,7,310356
26323,0.038854,172.31.36.0-255,66,215678,7,310356
26324,0.041134,172.217.194.0-255,5738,221416,7,310356
26325,0.041139,172.31.36.0-255,66,221482,7,310356
26326,0.043475,172.217.194.0-255,5738,227220,7,310356
26327,0.043478,172.31.36.0-255,66,227286,7,310356
26328,0.045787,172.217.194.0-255,5738,233024,7,310356
26329,0.045791,172.31.36.0-255,66,233090,7,310356
26330,0.048086,172.217.194.0-255,5738,238828,7,310356
26331,0.048092,172.31.36.0-255,66,238894,7,310356
26332,0.050416,172.217.194.0-255,5738,244632,7,310356
26333,0.050423,172.31.36.0-255,66,244698,7,310356
26334,0.05272,172.217.194.0-255,5738,250436,7,310356
26335,0.052725,172.31.36.0-255,66,250502,7,310356
26336,0.055084,172.217.194.0-255,5738,256240,7,310356
26337,0.055089,172.31.36.0-255,66,256306,7,310356
26338,0.057376,172.217.194.0-255,5738,262044,7,310356
26339,0.05738,172.31.36.0-255,66,262110,7,310356
26340,0.059702,172.217.194.0-255,5738,267848,7,310356
26341,0.059708,172.31.36.0-255,66,267914,7,310356
26342,0.06199,172.217.194.0-255,4320,272234,7,310356
26343,0.061995,172.31.36.0-255,66,272300,7,310356
26344,0.062029,172.217.194.0-255,1484,273784,7,310356
26345,0.064283,172.217.194.0-255,4320,278104,7,310356
26346,0.064289,172.31.36.0-255,66,278170,7,310356
26347,0.066566,172.217.194.0-255,5738,283908,7,310356
26348,0.066572,172.31.36.0-255,66,283974,7,310356
26349,0.068886,172.217.194.0-255,5738,289712,7,310356
26350,0.068892,172.31.36.0-255,66,289778,7,310356
26351,0.071174,172.217.194.0-255,4320,294098,7,310356
26352,0.07118,172.31.36.0-255,66,294164,7,310356
26353,0.071212,172.217.194.0-255,1484,295648,7,310356
26354,0.07348,172.217.194.0-255,2902,298550,7,310356
26355,0.073485,172.31.36.0-255,66,298616,7,310356
26356,0.073513,172.217.194.0-255,1484,300100,7,310356
26357,0.07575,172.217.194.0-255,4320,304420,7,310356
26358,0.075755,172.31.36.0-255,66,304486,7,310356
26359,0.078046,172.217.194.0-255,4320,308806,7,310356
26360,0.078051,172.31.36.0-255,66,308872,7,310356
26361,0.078085,172.217.194.0-255,1484,310356,7,310356
26362,0.0,74.125.24.0-255,146,146,7,331931
26363,3.5e-05,172.31.36.0-255,66,212,7,331931
26364,4.3e-05,74.125.24.0-255,1484,1696,7,331931
26365,4.7e-05,172.31.36.0-255,66,1762,7,331931
26366,5.3e-05,74.125.24.0-255,2902,4664,7,331931
26367,5.6e-05,172.31.36.0-255,66,4730,7,331931
26368,6.3e-05,74.125.24.0-255,7156,11886,7,331931
26369,6.5e-05,172.31.36.0-255,66,11952,7,331931
26370,7e-05,74.125.24.0-255,2100,14052,7,331931
26371,7.2e-05,172.31.36.0-255,66,14118,7,331931
26372,0.000126,172.31.36.0-255,66,14184,7,331931
26373,0.000132,74.125.24.0-255,5379,19563,7,331931
26374,0.000135,172.31.36.0-255,66,19629,7,331931
26375,0.000335,74.125.24.0-255,1484,21113,7,331931
26376,0.00034,172.31.36.0-255,66,21179,7,331931
26377,0.000348,74.125.24.0-255,2902,24081,7,331931
26378,0.000351,172.31.36.0-255,66,24147,7,331931
26379,0.000358,74.125.24.0-255,5738,29885,7,331931
26380,0.000361,172.31.36.0-255,66,29951,7,331931
26381,0.000375,74.125.24.0-255,1484,31435,7,331931
26382,0.000379,172.31.36.0-255,66,31501,7,331931
26383,0.000399,74.125.24.0-255,2902,34403,7,331931
26384,0.000403,172.31.36.0-255,66,34469,7,331931
26385,0.000425,74.125.24.0-255,5379,39848,7,331931
26386,0.000428,172.31.36.0-255,66,39914,7,331931
26387,0.00047,74.125.24.0-255,5738,45652,7,331931
26388,0.000473,172.31.36.0-255,66,45718,7,331931
26389,0.000479,74.125.24.0-255,2902,48620,7,331931
26390,0.000481,172.31.36.0-255,66,48686,7,331931
26391,0.000503,74.125.24.0-255,5655,54341,7,331931
26392,0.000507,172.31.36.0-255,66,54407,7,331931
26393,0.000547,74.125.24.0-255,133,54540,7,331931
26394,0.000791,172.31.36.0-255,66,54606,7,331931
26395,0.000804,74.125.24.0-255,1484,56090,7,331931
26396,0.000808,74.125.24.0-255,1484,57574,7,331931
26397,0.00082,74.125.24.0-255,1484,59058,7,331931
26398,0.00084,74.125.24.0-255,5738,64796,7,331931
26399,0.000846,172.31.36.0-255,66,64862,7,331931
26400,0.000875,172.31.36.0-255,66,64928,7,331931
26401,0.00089,74.125.24.0-255,5379,70307,7,331931
26402,0.0009,172.31.36.0-255,66,70373,7,331931
26403,0.000905,172.31.36.0-255,66,70439,7,331931
26404,0.000916,74.125.24.0-255,1125,71564,7,331931
26405,0.001112,172.31.36.0-255,66,71630,7,331931
26406,0.00168,74.125.24.0-255,1484,73114,7,331931
26407,0.00169,74.125.24.0-255,2902,76016,7,331931
26408,0.001697,74.125.24.0-255,4320,80336,7,331931
26409,0.001711,74.125.24.0-255,1484,81820,7,331931
26410,0.001734,74.125.24.0-255,7156,88976,7,331931
26411,0.001755,74.125.24.0-255,5738,94714,7,331931
26412,0.001759,74.125.24.0-255,4320,99034,7,331931
26413,0.001794,74.125.24.0-255,1484,100518,7,331931
26414,0.001812,74.125.24.0-255,5020,105538,7,331931
26415,0.001927,74.125.24.0-255,1484,107022,7,331931
26416,0.00194,74.125.24.0-255,2902,109924,7,331931
26417,0.001966,74.125.24.0-255,5738,115662,7,331931
26418,0.00197,74.125.24.0-255,2902,118564,7,331931
26419,0.006614,172.31.36.0-255,66,118630,7,331931
26420,0.008613,74.125.24.0-255,5738,124368,7,331931
26421,0.00862,172.31.36.0-255,66,124434,7,331931
26422,0.010596,74.125.24.0-255,5738,130172,7,331931
26423,0.011631,172.31.36.0-255,66,130238,7,331931
26424,0.013613,74.125.24.0-255,5738,135976,7,331931
26425,0.013623,172.31.36.0-255,66,136042,7,331931
26426,0.015603,74.125.24.0-255,5738,141780,7,331931
26427,0.015611,172.31.36.0-255,66,141846,7,331931
26428,0.017609,74.125.24.0-255,5738,147584,7,331931
26429,0.017617,172.31.36.0-255,66,147650,7,331931
26430,0.01961,74.125.24.0-255,5738,153388,7,331931
26431,0.019616,172.31.36.0-255,66,153454,7,331931
26432,0.021616,74.125.24.0-255,5738,159192,7,331931
26433,0.021623,172.31.36.0-255,66,159258,7,331931
26434,0.023555,74.125.24.0-255,5738,164996,7,331931
26435,0.023561,172.31.36.0-255,66,165062,7,331931
26436,0.025538,74.125.24.0-255,5738,170800,7,331931
26437,0.025545,172.31.36.0-255,66,170866,7,331931
26438,0.027505,74.125.24.0-255,5738,176604,7,331931
26439,0.027511,172.31.36.0-255,66,176670,7,331931
26440,0.027833,172.31.36.0-255,172,176842,7,331931
26441,0.027884,172.31.36.0-255,1114,177956,7,331931
26442,0.02795,172.31.36.0-255,1514,179470,7,331931
26443,0.027975,172.31.36.0-255,1293,180763,7,331931
26444,0.029359,104.244.42.0-255,66,180829,7,331931
26445,0.029452,104.244.42.0-255,66,180895,7,331931
26446,0.029529,74.125.24.0-255,5738,186633,7,331931
26447,0.029539,172.31.36.0-255,66,186699,7,331931
26448,0.029558,104.244.42.0-255,66,186765,7,331931
26449,0.029563,104.244.42.0-255,66,186831,7,331931
26450,0.031471,74.125.24.0-255,5738,192569,7,331931
26451,0.03148,172.31.36.0-255,66,192635,7,331931
26452,0.033432,74.125.24.0-255,5738,198373,7,331931
26453,0.033438,172.31.36.0-255,66,198439,7,331931
26454,0.035387,74.125.24.0-255,5738,204177,7,331931
26455,0.035408,172.31.36.0-255,66,204243,7,331931
26456,0.037384,74.125.24.0-255,5738,209981,7,331931
26457,0.03739,172.31.36.0-255,66,210047,7,331931
26458,0.039315,74.125.24.0-255,5738,215785,7,331931
26459,0.039321,172.31.36.0-255,66,215851,7,331931
26460,0.041283,74.125.24.0-255,5738,221589,7,331931
26461,0.041289,172.31.36.0-255,66,221655,7,331931
26462,0.04331,74.125.24.0-255,5738,227393,7,331931
26463,0.043316,172.31.36.0-255,66,227459,7,331931
26464,0.045252,74.125.24.0-255,5738,233197,7,331931
26465,0.045258,172.31.36.0-255,66,233263,7,331931
26466,0.047304,74.125.24.0-255,5738,239001,7,331931
26467,0.047311,172.31.36.0-255,66,239067,7,331931
26468,0.049289,74.125.24.0-255,5738,244805,7,331931
26469,0.049295,172.31.36.0-255,66,244871,7,331931
26470,0.051218,74.125.24.0-255,5738,250609,7,331931
26471,0.05124,172.31.36.0-255,66,250675,7,331931
26472,0.053202,74.125.24.0-255,5738,256413,7,331931
26473,0.053207,172.31.36.0-255,66,256479,7,331931
26474,0.055137,74.125.24.0-255,5738,262217,7,331931
26475,0.055142,172.31.36.0-255,66,262283,7,331931
26476,0.057087,74.125.24.0-255,5738,268021,7,331931
26477,0.057094,172.31.36.0-255,66,268087,7,331931
26478,0.059061,74.125.24.0-255,5738,273825,7,331931
26479,0.059067,172.31.36.0-255,66,273891,7,331931
26480,0.061075,74.125.24.0-255,5738,279629,7,331931
26481,0.061082,172.31.36.0-255,66,279695,7,331931
26482,0.063022,74.125.24.0-255,5738,285433,7,331931
26483,0.063027,172.31.36.0-255,66,285499,7,331931
26484,0.064979,74.125.24.0-255,5738,291237,7,331931
26485,0.064985,172.31.36.0-255,66,291303,7,331931
26486,0.066937,74.125.24.0-255,5738,297041,7,331931
26487,0.066943,172.31.36.0-255,66,297107,7,331931
26488,0.068925,74.125.24.0-255,5738,302845,7,331931
26489,0.068931,172.31.36.0-255,66,302911,7,331931
26490,0.070887,74.125.24.0-255,5738,308649,7,331931
26491,0.070892,172.31.36.0-255,66,308715,7,331931
26492,0.072846,74.125.24.0-255,5738,314453,7,331931
26493,0.072854,172.31.36.0-255,66,314519,7,331931
26494,0.074831,74.125.24.0-255,5738,320257,7,331931
26495,0.074838,172.31.36.0-255,66,320323,7,331931
26496,0.076795,74.125.24.0-255,5738,326061,7,331931
26497,0.076801,172.31.36.0-255,66,326127,7,331931
26498,0.078743,74.125.24.0-255,5738,331865,7,331931
26499,0.078749,172.31.36.0-255,66,331931,7,331931
26500,0.0,74.125.200.0-255,146,146,7,341762
26501,2.7e-05,172.31.36.0-255,66,212,7,341762
26502,3.5e-05,74.125.200.0-255,1484,1696,7,341762
26503,3.9e-05,172.31.36.0-255,66,1762,7,341762
26504,4.5e-05,74.125.200.0-255,2902,4664,7,341762
26505,4.8e-05,172.31.36.0-255,66,4730,7,341762
26506,6.5e-05,74.125.200.0-255,7156,11886,7,341762
26507,6.8e-05,172.31.36.0-255,66,11952,7,341762
26508,0.0001,74.125.200.0-255,2029,13981,7,341762
26509,0.000103,172.31.36.0-255,66,14047,7,341762
26510,0.000218,74.125.200.0-255,1484,15531,7,341762
26511,0.000222,172.31.36.0-255,66,15597,7,341762
26512,0.000227,74.125.200.0-255,2902,18499,7,341762
26513,0.00023,172.31.36.0-255,66,18565,7,341762
26514,0.000259,74.125.200.0-255,5738,24303,7,341762
26515,0.000261,172.31.36.0-255,66,24369,7,341762
26516,0.000266,74.125.200.0-255,2902,27271,7,341762
26517,0.000269,172.31.36.0-255,66,27337,7,341762
26518,0.000303,74.125.200.0-255,3961,31298,7,341762
26519,0.000306,172.31.36.0-255,66,31364,7,341762
26520,0.000443,74.125.200.0-255,1484,32848,7,341762
26521,0.000447,172.31.36.0-255,66,32914,7,341762
26522,0.000477,74.125.200.0-255,1484,34398,7,341762
26523,0.00048,172.31.36.0-255,66,34464,7,341762
26524,0.000485,74.125.200.0-255,2902,37366,7,341762
26525,0.000487,172.31.36.0-255,66,37432,7,341762
26526,0.000494,74.125.200.0-255,5738,43170,7,341762
26527,0.000496,172.31.36.0-255,66,43236,7,341762
26528,0.000499,74.125.200.0-255,1484,44720,7,341762
26529,0.000501,172.31.36.0-255,66,44786,7,341762
26530,0.000539,74.125.200.0-255,3961,48747,7,341762
26531,0.000542,172.31.36.0-255,66,48813,7,341762
26532,0.000549,74.125.200.0-255,5738,54551,7,341762
26533,0.000604,74.125.200.0-255,401,54952,7,341762
26534,0.00062,172.31.36.0-255,66,55018,7,341762
26535,0.000646,74.125.200.0-255,110,55128,7,341762
26536,0.000717,74.125.200.0-255,331,55459,7,341762
26537,0.001048,74.125.200.0-255,1484,56943,7,341762
26538,0.001053,172.31.36.0-255,66,57009,7,341762
26539,0.001059,74.125.200.0-255,2902,59911,7,341762
26540,0.001081,74.125.200.0-255,4320,64231,7,341762
26541,0.00109,172.31.36.0-255,66,64297,7,341762
26542,0.001142,172.31.36.0-255,66,64363,7,341762
26543,0.001179,172.31.36.0-255,66,64429,7,341762
26544,0.001311,74.125.200.0-255,1484,65913,7,341762
26545,0.001317,74.125.200.0-255,2902,68815,7,341762
26546,0.001323,74.125.200.0-255,4320,73135,7,341762
26547,0.001347,74.125.200.0-255,5738,78873,7,341762
26548,0.001352,172.31.36.0-255,66,78939,7,341762
26549,0.001357,172.31.36.0-255,66,79005,7,341762
26550,0.001384,74.125.200.0-255,2902,81907,7,341762
26551,0.00141,172.31.36.0-255,66,81973,7,341762
26552,0.00142,74.125.200.0-255,5738,87711,7,341762
26553,0.001425,172.31.36.0-255,66,87777,7,341762
26554,0.001442,74.125.200.0-255,2184,89961,7,341762
26555,0.001465,172.31.36.0-255,66,90027,7,341762
26556,0.00183,74.125.200.0-255,1484,91511,7,341762
26557,0.001852,74.125.200.0-255,2902,94413,7,341762
26558,0.001855,172.31.36.0-255,66,94479,7,341762
26559,0.001861,74.125.200.0-255,2902,97381,7,341762
26560,0.001867,172.31.36.0-255,66,97447,7,341762
26561,0.001886,74.125.200.0-255,2902,100349,7,341762
26562,0.001888,74.125.200.0-255,1484,101833,7,341762
26563,0.001918,74.125.200.0-255,1484,103317,7,341762
26564,0.00193,74.125.200.0-255,2902,106219,7,341762
26565,0.001941,172.31.36.0-255,66,106285,7,341762
26566,0.001952,74.125.200.0-255,5738,112023,7,341762
26567,0.001962,172.31.36.0-255,66,112089,7,341762
26568,0.001996,74.125.200.0-255,3602,115691,7,341762
26569,0.002004,172.31.36.0-255,66,115757,7,341762
26570,0.002054,74.125.200.0-255,1484,117241,7,341762
26571,0.002059,74.125.200.0-255,2902,120143,7,341762
26572,0.002062,172.31.36.0-255,66,120209,7,341762
26573,0.00209,74.125.200.0-255,5738,125947,7,341762
26574,0.002102,74.125.200.0-255,4320,130267,7,341762
26575,0.002116,74.125.200.0-255,2902,133169,7,341762
26576,0.002126,172.31.36.0-255,66,133235,7,341762
26577,0.002186,74.125.200.0-255,5020,138255,7,341762
26578,0.002201,172.31.36.0-255,66,138321,7,341762
26579,0.002259,74.125.200.0-255,1484,139805,7,341762
26580,0.002273,74.125.200.0-255,2902,142707,7,341762
26581,0.002296,74.125.200.0-255,4320,147027,7,341762
26582,0.002303,74.125.200.0-255,5738,152765,7,341762
26583,0.002308,172.31.36.0-255,66,152831,7,341762
26584,0.002347,74.125.200.0-255,4320,157151,7,341762
26585,0.002361,172.31.36.0-255,66,157217,7,341762
26586,0.002391,74.125.200.0-255,3602,160819,7,341762
26587,0.002446,172.31.36.0-255,66,160885,7,341762
26588,0.002512,74.125.200.0-255,1484,162369,7,341762
26589,0.002528,74.125.200.0-255,2902,165271,7,341762
26590,0.002546,74.125.200.0-255,4320,169591,7,341762
26591,0.002554,74.125.200.0-255,5738,175329,7,341762
26592,0.002575,172.31.36.0-255,66,175395,7,341762
26593,0.002593,74.125.200.0-255,4320,179715,7,341762
26594,0.002614,74.125.200.0-255,5738,185453,7,341762
26595,0.007543,172.31.36.0-255,66,185519,7,341762
26596,0.010104,74.125.200.0-255,5738,191257,7,341762
26597,0.010112,172.31.36.0-255,66,191323,7,341762
26598,0.012674,74.125.200.0-255,5738,197061,7,341762
26599,0.012701,172.31.36.0-255,66,197127,7,341762
26600,0.015258,74.125.200.0-255,5738,202865,7,341762
26601,0.015267,172.31.36.0-255,66,202931,7,341762
26602,0.017835,74.125.200.0-255,5738,208669,7,341762
26603,0.017847,172.31.36.0-255,66,208735,7,341762
26604,0.020414,74.125.200.0-255,5738,214473,7,341762
26605,0.020423,172.31.36.0-255,66,214539,7,341762
26606,0.022975,74.125.200.0-255,5738,220277,7,341762
26607,0.022982,172.31.36.0-255,66,220343,7,341762
26608,0.025535,74.125.200.0-255,5738,226081,7,341762
26609,0.025543,172.31.36.0-255,66,226147,7,341762
26610,0.028098,74.125.200.0-255,5738,231885,7,341762
26611,0.028105,172.31.36.0-255,66,231951,7,341762
26612,0.030667,74.125.200.0-255,5738,237689,7,341762
26613,0.030676,172.31.36.0-255,66,237755,7,341762
26614,0.03324,74.125.200.0-255,5738,243493,7,341762
26615,0.033247,172.31.36.0-255,66,243559,7,341762
26616,0.035805,74.125.200.0-255,5738,249297,7,341762
26617,0.035813,172.31.36.0-255,66,249363,7,341762
26618,0.037081,172.31.36.0-255,172,249535,7,341762
26619,0.037108,172.31.36.0-255,1073,250608,7,341762
26620,0.038372,74.125.200.0-255,5738,256346,7,341762
26621,0.038379,172.31.36.0-255,66,256412,7,341762
26622,0.038608,104.244.42.0-255,66,256478,7,341762
26623,0.038646,104.244.42.0-255,66,256544,7,341762
26624,0.040938,74.125.200.0-255,5738,262282,7,341762
26625,0.040948,172.31.36.0-255,66,262348,7,341762
26626,0.043521,74.125.200.0-255,5738,268086,7,341762
26627,0.043531,172.31.36.0-255,66,268152,7,341762
26628,0.0461,74.125.200.0-255,5738,273890,7,341762
26629,0.046108,172.31.36.0-255,66,273956,7,341762
26630,0.048671,74.125.200.0-255,5738,279694,7,341762
26631,0.048693,172.31.36.0-255,66,279760,7,341762
26632,0.051254,74.125.200.0-255,5738,285498,7,341762
26633,0.051261,172.31.36.0-255,66,285564,7,341762
26634,0.053823,74.125.200.0-255,5738,291302,7,341762
26635,0.053834,172.31.36.0-255,66,291368,7,341762
26636,0.056403,74.125.200.0-255,5738,297106,7,341762
26637,0.056415,172.31.36.0-255,66,297172,7,341762
26638,0.058996,74.125.200.0-255,5738,302910,7,341762
26639,0.059012,172.31.36.0-255,66,302976,7,341762
26640,0.061579,74.125.200.0-255,5738,308714,7,341762
26641,0.061595,172.31.36.0-255,66,308780,7,341762
26642,0.064147,74.125.200.0-255,5738,314518,7,341762
26643,0.064154,172.31.36.0-255,66,314584,7,341762
26644,0.06671,74.125.200.0-255,5738,320322,7,341762
26645,0.066718,172.31.36.0-255,66,320388,7,341762
26646,0.06928,74.125.200.0-255,5738,326126,7,341762
26647,0.069287,172.31.36.0-255,66,326192,7,341762
26648,0.071834,74.125.200.0-255,5738,331930,7,341762
26649,0.07184,172.31.36.0-255,66,331996,7,341762
26650,0.074413,74.125.200.0-255,5738,337734,7,341762
26651,0.07442,172.31.36.0-255,66,337800,7,341762
26652,0.076978,74.125.200.0-255,3725,341525,7,341762
26653,0.076983,172.31.36.0-255,66,341591,7,341762
26654,0.07715,172.31.36.0-255,105,341696,7,341762
26655,0.079665,74.125.200.0-255,66,341762,7,341762
26656,0.0,74.125.24.0-255,152,152,7,275445
26657,2.6e-05,172.31.36.0-255,66,218,7,275445
26658,3.3e-05,74.125.24.0-255,1484,1702,7,275445
26659,3.7e-05,172.31.36.0-255,66,1768,7,275445
26660,4.2e-05,74.125.24.0-255,2902,4670,7,275445
26661,4.5e-05,172.31.36.0-255,66,4736,7,275445
26662,5.4e-05,74.125.24.0-255,1484,6220,7,275445
26663,5.6e-05,172.31.36.0-255,66,6286,7,275445
26664,7.9e-05,74.125.24.0-255,4320,10606,7,275445
26665,8.2e-05,172.31.36.0-255,66,10672,7,275445
26666,0.0001,74.125.24.0-255,1484,12156,7,275445
26667,0.000102,172.31.36.0-255,66,12222,7,275445
26668,0.000116,74.125.24.0-255,2108,14330,7,275445
26669,0.000119,172.31.36.0-255,66,14396,7,275445
26670,0.000194,74.125.24.0-255,1484,15880,7,275445
26671,0.000198,172.31.36.0-255,66,15946,7,275445
26672,0.000203,74.125.24.0-255,2902,18848,7,275445
26673,0.000205,172.31.36.0-255,66,18914,7,275445
26674,0.000232,74.125.24.0-255,5738,24652,7,275445
26675,0.000234,172.31.36.0-255,66,24718,7,275445
26676,0.000256,74.125.24.0-255,4320,29038,7,275445
26677,0.00026,172.31.36.0-255,66,29104,7,275445
26678,0.00029,172.31.36.0-255,66,29170,7,275445
26679,0.000305,172.31.36.0-255,66,29236,7,275445
26680,0.00031,74.125.24.0-255,4320,33556,7,275445
26681,0.000313,172.31.36.0-255,66,33622,7,275445
26682,0.000352,172.31.36.0-255,66,33688,7,275445
26683,0.000355,74.125.24.0-255,414,34102,7,275445
26684,0.000358,172.31.36.0-255,66,34168,7,275445
26685,0.00039,74.125.24.0-255,329,34497,7,275445
26686,0.000804,172.31.36.0-255,66,34563,7,275445
26687,0.000814,74.125.24.0-255,1484,36047,7,275445
26688,0.00082,74.125.24.0-255,2902,38949,7,275445
26689,0.000823,172.31.36.0-255,66,39015,7,275445
26690,0.000829,74.125.24.0-255,4320,43335,7,275445
26691,0.000832,172.31.36.0-255,66,43401,7,275445
26692,0.000842,74.125.24.0-255,1484,44885,7,275445
26693,0.000845,74.125.24.0-255,1484,46369,7,275445
26694,0.000848,172.31.36.0-255,66,46435,7,275445
26695,0.000864,74.125.24.0-255,7156,53591,7,275445
26696,0.000867,172.31.36.0-255,66,53657,7,275445
26697,0.000879,74.125.24.0-255,4320,57977,7,275445
26698,0.000883,172.31.36.0-255,66,58043,7,275445
26699,0.000889,74.125.24.0-255,7156,65199,7,275445
26700,0.000891,172.31.36.0-255,66,65265,7,275445
26701,0.000914,74.125.24.0-255,3602,68867,7,275445
26702,0.000917,172.31.36.0-255,66,68933,7,275445
26703,0.001304,74.125.24.0-255,1484,70417,7,275445
26704,0.001313,74.125.24.0-255,2902,73319,7,275445
26705,0.001319,172.31.36.0-255,66,73385,7,275445
26706,0.001327,74.125.24.0-255,5738,79123,7,275445
26707,0.001329,172.31.36.0-255,66,79189,7,275445
26708,0.001363,172.31.36.0-255,66,79255,7,275445
26709,0.00139,172.31.36.0-255,66,79321,7,275445
26710,0.002278,74.125.24.0-255,1484,80805,7,275445
26711,0.002297,74.125.24.0-255,2902,83707,7,275445
26712,0.002302,172.31.36.0-255,66,83773,7,275445
26713,0.002309,74.125.24.0-255,5738,89511,7,275445
26714,0.002311,172.31.36.0-255,66,89577,7,275445
26715,0.002342,172.31.36.0-255,66,89643,7,275445
26716,0.002386,74.125.24.0-255,5738,95381,7,275445
26717,0.002389,172.31.36.0-255,66,95447,7,275445
26718,0.002409,74.125.24.0-255,5020,100467,7,275445
26719,0.002412,172.31.36.0-255,66,100533,7,275445
26720,0.004935,74.125.24.0-255,5738,106271,7,275445
26721,0.004939,172.31.36.0-255,66,106337,7,275445
26722,0.007485,74.125.24.0-255,5738,112075,7,275445
26723,0.007492,172.31.36.0-255,66,112141,7,275445
26724,0.010061,74.125.24.0-255,5738,117879,7,275445
26725,0.010069,172.31.36.0-255,66,117945,7,275445
26726,0.012645,74.125.24.0-255,5738,123683,7,275445
26727,0.012653,172.31.36.0-255,66,123749,7,275445
26728,0.01519,74.125.24.0-255,5738,129487,7,275445
26729,0.015198,172.31.36.0-255,66,129553,7,275445
26730,0.017716,74.125.24.0-255,5738,135291,7,275445
26731,0.017722,172.31.36.0-255,66,135357,7,275445
26732,0.020242,74.125.24.0-255,5738,141095,7,275445
26733,0.020249,172.31.36.0-255,66,141161,7,275445
26734,0.022772,74.125.24.0-255,5738,146899,7,275445
26735,0.022779,172.31.36.0-255,66,146965,7,275445
26736,0.024057,172.31.36.0-255,172,147137,7,275445
26737,0.024089,172.31.36.0-255,1114,148251,7,275445
26738,0.024129,172.31.36.0-255,1514,149765,7,275445
26739,0.024131,172.31.36.0-255,331,150096,7,275445
26740,0.025365,74.125.24.0-255,5738,155834,7,275445
26741,0.025373,172.31.36.0-255,66,155900,7,275445
26742,0.025617,104.244.42.0-255,66,155966,7,275445
26743,0.025662,104.244.42.0-255,66,156032,7,275445
26744,0.025709,104.244.42.0-255,66,156098,7,275445
26745,0.027891,74.125.24.0-255,5738,161836,7,275445
26746,0.027897,172.31.36.0-255,66,161902,7,275445
26747,0.030429,74.125.24.0-255,5738,167640,7,275445
26748,0.030436,172.31.36.0-255,66,167706,7,275445
26749,0.032948,74.125.24.0-255,5738,173444,7,275445
26750,0.032955,172.31.36.0-255,66,173510,7,275445
26751,0.035526,74.125.24.0-255,5738,179248,7,275445
26752,0.035532,172.31.36.0-255,66,179314,7,275445
26753,0.038072,74.125.24.0-255,5738,185052,7,275445
26754,0.038078,172.31.36.0-255,66,185118,7,275445
26755,0.040598,74.125.24.0-255,5738,190856,7,275445
26756,0.040604,172.31.36.0-255,66,190922,7,275445
26757,0.043148,74.125.24.0-255,5738,196660,7,275445
26758,0.043156,172.31.36.0-255,66,196726,7,275445
26759,0.045665,74.125.24.0-255,5738,202464,7,275445
26760,0.045671,172.31.36.0-255,66,202530,7,275445
26761,0.048223,74.125.24.0-255,5738,208268,7,275445
26762,0.048229,172.31.36.0-255,66,208334,7,275445
26763,0.050743,74.125.24.0-255,5738,214072,7,275445
26764,0.050749,172.31.36.0-255,66,214138,7,275445
26765,0.053269,74.125.24.0-255,5738,219876,7,275445
26766,0.053274,172.31.36.0-255,66,219942,7,275445
26767,0.055803,74.125.24.0-255,4320,224262,7,275445
26768,0.055809,172.31.36.0-255,66,224328,7,275445
26769,0.055835,74.125.24.0-255,1484,225812,7,275445
26770,0.058322,74.125.24.0-255,4320,230132,7,275445
26771,0.058327,172.31.36.0-255,66,230198,7,275445
26772,0.060834,74.125.24.0-255,5738,235936,7,275445
26773,0.06084,172.31.36.0-255,66,236002,7,275445
26774,0.063399,74.125.24.0-255,4320,240322,7,275445
26775,0.063405,172.31.36.0-255,66,240388,7,275445
26776,0.063434,74.125.24.0-255,1484,241872,7,275445
26777,0.06354,172.31.36.0-255,101,241973,7,275445
26778,0.06592,74.125.24.0-255,4320,246293,7,275445
26779,0.065925,172.31.36.0-255,66,246359,7,275445
26780,0.066046,74.125.24.0-255,1484,247843,7,275445
26781,0.068469,74.125.24.0-255,4320,252163,7,275445
26782,0.068474,172.31.36.0-255,66,252229,7,275445
26783,0.071031,74.125.24.0-255,5738,257967,7,275445
26784,0.071036,172.31.36.0-255,66,258033,7,275445
26785,0.073546,74.125.24.0-255,5738,263771,7,275445
26786,0.073551,172.31.36.0-255,66,263837,7,275445
26787,0.076077,74.125.24.0-255,5738,269575,7,275445
26788,0.076082,172.31.36.0-255,66,269641,7,275445
26789,0.078616,74.125.24.0-255,5738,275379,7,275445
26790,0.078622,172.31.36.0-255,66,275445,7,275445
26791,0.0,172.217.194.0-255,150,150,7,318744
26792,3e-05,172.31.36.0-255,66,216,7,318744
26793,3.7e-05,172.217.194.0-255,1484,1700,7,318744
26794,4.2e-05,172.31.36.0-255,66,1766,7,318744
26795,4.6e-05,172.217.194.0-255,2902,4668,7,318744
26796,4.9e-05,172.31.36.0-255,66,4734,7,318744
26797,5.2e-05,172.217.194.0-255,1484,6218,7,318744
26798,5.4e-05,172.31.36.0-255,66,6284,7,318744
26799,0.000109,172.217.194.0-255,2902,9186,7,318744
26800,0.000112,172.31.36.0-255,66,9252,7,318744
26801,0.000134,172.217.194.0-255,4875,14127,7,318744
26802,0.000138,172.31.36.0-255,66,14193,7,318744
26803,0.000242,172.217.194.0-255,1484,15677,7,318744
26804,0.000245,172.31.36.0-255,66,15743,7,318744
26805,0.000252,172.217.194.0-255,2902,18645,7,318744
26806,0.000254,172.31.36.0-255,66,18711,7,318744
26807,0.000281,172.217.194.0-255,5738,24449,7,318744
26808,0.000286,172.31.36.0-255,66,24515,7,318744
26809,0.000305,172.217.194.0-255,4320,28835,7,318744
26810,0.000308,172.31.36.0-255,66,28901,7,318744
26811,0.00034,172.31.36.0-255,66,28967,7,318744
26812,0.000357,172.217.194.0-255,2902,31869,7,318744
26813,0.000362,172.31.36.0-255,66,31935,7,318744
26814,0.000379,172.31.36.0-255,66,32001,7,318744
26815,0.00069,172.217.194.0-255,1484,33485,7,318744
26816,0.000695,172.31.36.0-255,66,33551,7,318744
26817,0.000702,172.217.194.0-255,2902,36453,7,318744
26818,0.000704,172.31.36.0-255,66,36519,7,318744
26819,0.000712,172.217.194.0-255,5738,42257,7,318744
26820,0.000714,172.31.36.0-255,66,42323,7,318744
26821,0.000756,172.217.194.0-255,4320,46643,7,318744
26822,0.000759,172.31.36.0-255,66,46709,7,318744
26823,0.000782,172.217.194.0-255,3122,49831,7,318744
26824,0.000784,172.31.36.0-255,66,49897,7,318744
26825,0.000795,172.31.36.0-255,66,49963,7,318744
26826,0.000821,172.31.36.0-255,66,50029,7,318744
26827,0.000849,172.217.194.0-255,4320,54349,7,318744
26828,0.000852,172.31.36.0-255,66,54415,7,318744
26829,0.000859,172.217.194.0-255,6438,60853,7,318744
26830,0.000862,172.31.36.0-255,66,60919,7,318744
26831,0.000961,172.217.194.0-255,1484,62403,7,318744
26832,0.000967,172.217.194.0-255,2902,65305,7,318744
26833,0.000971,172.31.36.0-255,66,65371,7,318744
26834,0.000975,172.217.194.0-255,1484,66855,7,318744
26835,0.000992,172.217.194.0-255,4320,71175,7,318744
26836,0.000995,172.31.36.0-255,66,71241,7,318744
26837,0.000998,172.217.194.0-255,1484,72725,7,318744
26838,0.001034,172.31.36.0-255,66,72791,7,318744
26839,0.001039,172.217.194.0-255,4320,77111,7,318744
26840,0.001042,172.31.36.0-255,66,77177,7,318744
26841,0.001059,172.217.194.0-255,5738,82915,7,318744
26842,0.001062,172.31.36.0-255,66,82981,7,318744
26843,0.001065,172.217.194.0-255,766,83747,7,318744
26844,0.001097,172.217.194.0-255,1484,85231,7,318744
26845,0.0011,172.31.36.0-255,66,85297,7,318744
26846,0.001121,172.217.194.0-255,4320,89617,7,318744
26847,0.001124,172.31.36.0-255,66,89683,7,318744
26848,0.001134,172.31.36.0-255,66,89749,7,318744
26849,0.001153,172.217.194.0-255,4320,94069,7,318744
26850,0.001156,172.31.36.0-255,66,94135,7,318744
26851,0.001198,172.217.194.0-255,2184,96319,7,318744
26852,0.0012,172.31.36.0-255,66,96385,7,318744
26853,0.001204,172.31.36.0-255,66,96451,7,318744
26854,0.001643,172.217.194.0-255,1484,97935,7,318744
26855,0.001649,172.217.194.0-255,2902,100837,7,318744
26856,0.001652,172.31.36.0-255,66,100903,7,318744
26857,0.001658,172.217.194.0-255,2902,103805,7,318744
26858,0.00166,172.31.36.0-255,66,103871,7,318744
26859,0.001674,172.217.194.0-255,2902,106773,7,318744
26860,0.001677,172.31.36.0-255,66,106839,7,318744
26861,0.001711,172.31.36.0-255,66,106905,7,318744
26862,0.001724,172.217.194.0-255,2902,109807,7,318744
26863,0.001727,172.31.36.0-255,66,109873,7,318744
26864,0.001747,172.217.194.0-255,7156,117029,7,318744
26865,0.001749,172.31.36.0-255,66,117095,7,318744
26866,0.001764,172.217.194.0-255,3602,120697,7,318744
26867,0.001767,172.31.36.0-255,66,120763,7,318744
26868,0.002016,172.217.194.0-255,1484,122247,7,318744
26869,0.002025,172.217.194.0-255,2902,125149,7,318744
26870,0.002028,172.31.36.0-255,66,125215,7,318744
26871,0.002033,172.217.194.0-255,1484,126699,7,318744
26872,0.002051,172.217.194.0-255,2902,129601,7,318744
26873,0.002054,172.31.36.0-255,66,129667,7,318744
26874,0.002061,172.217.194.0-255,5738,135405,7,318744
26875,0.002063,172.31.36.0-255,66,135471,7,318744
26876,0.002101,172.31.36.0-255,66,135537,7,318744
26877,0.002105,172.217.194.0-255,1484,137021,7,318744
26878,0.002123,172.217.194.0-255,5738,142759,7,318744
26879,0.002126,172.31.36.0-255,66,142825,7,318744
26880,0.002142,172.217.194.0-255,766,143591,7,318744
26881,0.002181,172.217.194.0-255,1484,145075,7,318744
26882,0.002185,172.31.36.0-255,66,145141,7,318744
26883,0.002202,172.217.194.0-255,4320,149461,7,318744
26884,0.002205,172.31.36.0-255,66,149527,7,318744
26885,0.002213,172.217.194.0-255,7156,156683,7,318744
26886,0.002215,172.31.36.0-255,66,156749,7,318744
26887,0.002232,172.217.194.0-255,1484,158233,7,318744
26888,0.002258,172.31.36.0-255,66,158299,7,318744
26889,0.002279,172.217.194.0-255,5738,164037,7,318744
26890,0.002281,172.31.36.0-255,66,164103,7,318744
26891,0.002288,172.217.194.0-255,5020,169123,7,318744
26892,0.00229,172.31.36.0-255,66,169189,7,318744
26893,0.002374,172.217.194.0-255,1484,170673,7,318744
26894,0.002379,172.217.194.0-255,1484,172157,7,318744
26895,0.002383,172.31.36.0-255,66,172223,7,318744
26896,0.002395,172.217.194.0-255,1484,173707,7,318744
26897,0.0024,172.217.194.0-255,4320,178027,7,318744
26898,0.002402,172.31.36.0-255,66,178093,7,318744
26899,0.00242,172.217.194.0-255,1484,179577,7,318744
26900,0.002452,172.31.36.0-255,66,179643,7,318744
26901,0.00246,172.217.194.0-255,7156,186799,7,318744
26902,0.002463,172.31.36.0-255,66,186865,7,318744
26903,0.002486,172.217.194.0-255,3602,190467,7,318744
26904,0.002489,172.31.36.0-255,66,190533,7,318744
26905,0.002517,172.217.194.0-255,1484,192017,7,318744
26906,0.005037,172.217.194.0-255,4320,196337,7,318744
26907,0.005044,172.31.36.0-255,66,196403,7,318744
26908,0.007575,172.217.194.0-255,5738,202141,7,318744
26909,0.00758,172.31.36.0-255,66,202207,7,318744
26910,0.010122,172.217.194.0-255,5738,207945,7,318744
26911,0.010132,172.31.36.0-255,66,208011,7,318744
26912,0.012675,172.217.194.0-255,5738,213749,7,318744
26913,0.01269,172.31.36.0-255,66,213815,7,318744
26914,0.015228,172.217.194.0-255,5738,219553,7,318744
26915,0.015246,172.31.36.0-255,66,219619,7,318744
26916,0.017787,172.217.194.0-255,5738,225357,7,318744
26917,0.017801,172.31.36.0-255,66,225423,7,318744
26918,0.020326,172.217.194.0-255,5738,231161,7,318744
26919,0.020335,172.31.36.0-255,66,231227,7,318744
26920,0.022864,172.217.194.0-255,5738,236965,7,318744
26921,0.022876,172.31.36.0-255,66,237031,7,318744
26922,0.02543,172.217.194.0-255,5738,242769,7,318744
26923,0.025438,172.31.36.0-255,66,242835,7,318744
26924,0.027976,172.217.194.0-255,5738,248573,7,318744
26925,0.027982,172.31.36.0-255,66,248639,7,318744
26926,0.028046,172.31.36.0-255,171,248810,7,318744
26927,0.028093,172.31.36.0-255,1139,249949,7,318744
26928,0.02823,172.31.36.0-255,1514,251463,7,318744
26929,0.028232,172.31.36.0-255,1514,252977,7,318744
26930,0.028233,172.31.36.0-255,1514,254491,7,318744
26931,0.028234,172.31.36.0-255,1048,255539,7,318744
26932,0.029605,104.244.42.0-255,66,255605,7,318744
26933,0.029642,104.244.42.0-255,66,255671,7,318744
26934,0.029799,104.244.42.0-255,66,255737,7,318744
26935,0.029802,104.244.42.0-255,66,255803,7,318744
26936,0.03049,172.217.194.0-255,1484,257287,7,318744
26937,0.030544,172.217.194.0-255,4320,261607,7,318744
26938,0.030549,172.31.36.0-255,66,261673,7,318744
26939,0.031117,104.244.42.0-255,108,261781,7,318744
26940,0.031138,172.31.36.0-255,66,261847,7,318744
26941,0.033074,172.217.194.0-255,4320,266167,7,318744
26942,0.033078,172.31.36.0-255,66,266233,7,318744
26943,0.033108,172.217.194.0-255,1484,267717,7,318744
26944,0.035571,172.217.194.0-255,4320,272037,7,318744
26945,0.035576,172.31.36.0-255,66,272103,7,318744
26946,0.038101,172.217.194.0-255,5738,277841,7,318744
26947,0.038108,172.31.36.0-255,66,277907,7,318744
26948,0.040632,172.217.194.0-255,5738,283645,7,318744
26949,0.040637,172.31.36.0-255,66,283711,7,318744
26950,0.043139,172.217.194.0-255,4320,288031,7,318744
26951,0.043145,172.31.36.0-255,66,288097,7,318744
26952,0.043173,172.217.194.0-255,1484,289581,7,318744
26953,0.045657,172.217.194.0-255,4320,293901,7,318744
26954,0.045663,172.31.36.0-255,66,293967,7,318744
26955,0.048196,172.217.194.0-255,5738,299705,7,318744
26956,0.048201,172.31.36.0-255,66,299771,7,318744
26957,0.050707,172.217.194.0-255,5738,305509,7,318744
26958,0.050713,172.31.36.0-255,66,305575,7,318744
26959,0.053219,172.217.194.0-255,5738,311313,7,318744
26960,0.053224,172.31.36.0-255,66,311379,7,318744
26961,0.055742,172.217.194.0-255,5738,317117,7,318744
26962,0.055747,172.31.36.0-255,66,317183,7,318744
26963,0.058241,172.217.194.0-255,865,318048,7,318744
26964,0.058466,172.31.36.0-255,105,318153,7,318744
26965,0.058491,172.31.36.0-255,105,318258,7,318744
26966,0.058786,172.31.36.0-255,90,318348,7,318744
26967,0.058797,172.31.36.0-255,66,318414,7,318744
26968,0.060958,172.217.194.0-255,66,318480,7,318744
26969,0.060966,172.217.194.0-255,66,318546,7,318744
26970,0.061261,172.217.194.0-255,66,318612,7,318744
26971,0.061301,172.217.194.0-255,66,318678,7,318744
26972,0.061305,172.31.36.0-255,66,318744,7,318744
26973,0.0,172.217.194.0-255,297,297,7,312270
26974,1.9e-05,172.31.36.0-255,66,363,7,312270
26975,2.6e-05,172.217.194.0-255,1484,1847,7,312270
26976,3e-05,172.31.36.0-255,66,1913,7,312270
26977,3.7e-05,172.217.194.0-255,4320,6233,7,312270
26978,4.1e-05,172.31.36.0-255,66,6299,7,312270
26979,9.1e-05,172.217.194.0-255,5738,12037,7,312270
26980,9.5e-05,172.31.36.0-255,66,12103,7,312270
26981,0.000113,172.217.194.0-255,1859,13962,7,312270
26982,0.000116,172.31.36.0-255,66,14028,7,312270
26983,0.000385,172.217.194.0-255,1484,15512,7,312270
26984,0.000392,172.31.36.0-255,66,15578,7,312270
26985,0.000399,172.217.194.0-255,2902,18480,7,312270
26986,0.000402,172.31.36.0-255,66,18546,7,312270
26987,0.000434,172.217.194.0-255,5738,24284,7,312270
26988,0.000437,172.31.36.0-255,66,24350,7,312270
26989,0.000441,172.217.194.0-255,1484,25834,7,312270
26990,0.000443,172.31.36.0-255,66,25900,7,312270
26991,0.000462,172.217.194.0-255,5379,31279,7,312270
26992,0.000465,172.31.36.0-255,66,31345,7,312270
26993,0.000473,172.217.194.0-255,7156,38501,7,312270
26994,0.000475,172.31.36.0-255,66,38567,7,312270
26995,0.00049,172.217.194.0-255,1484,40051,7,312270
26996,0.000492,172.31.36.0-255,66,40117,7,312270
26997,0.000513,172.31.36.0-255,66,40183,7,312270
26998,0.000545,172.217.194.0-255,2902,43085,7,312270
26999,0.000549,172.31.36.0-255,66,43151,7,312270
27000,0.000573,172.217.194.0-255,7156,50307,7,312270
27001,0.000577,172.31.36.0-255,66,50373,7,312270
27002,0.000626,172.217.194.0-255,5738,56111,7,312270
27003,0.00063,172.31.36.0-255,66,56177,7,312270
27004,0.00064,172.217.194.0-255,1452,57629,7,312270
27005,0.000934,172.217.194.0-255,380,58009,7,312270
27006,0.000956,172.31.36.0-255,66,58075,7,312270
27007,0.00113,172.217.194.0-255,1484,59559,7,312270
27008,0.001136,172.217.194.0-255,2902,62461,7,312270
27009,0.001142,172.31.36.0-255,66,62527,7,312270
27010,0.001157,172.217.194.0-255,5738,68265,7,312270
27011,0.00116,172.217.194.0-255,1484,69749,7,312270
27012,0.001179,172.31.36.0-255,66,69815,7,312270
27013,0.001198,172.217.194.0-255,1484,71299,7,312270
27014,0.00122,172.217.194.0-255,3961,75260,7,312270
27015,0.001231,172.31.36.0-255,66,75326,7,312270
27016,0.00125,172.217.194.0-255,1484,76810,7,312270
27017,0.001254,172.217.194.0-255,1484,78294,7,312270
27018,0.001257,172.31.36.0-255,66,78360,7,312270
27019,0.001265,172.217.194.0-255,1484,79844,7,312270
27020,0.001292,172.217.194.0-255,5738,85582,7,312270
27021,0.001298,172.31.36.0-255,66,85648,7,312270
27022,0.001309,172.217.194.0-255,4320,89968,7,312270
27023,0.001318,172.31.36.0-255,66,90034,7,312270
27024,0.001323,172.217.194.0-255,2543,92577,7,312270
27025,0.001348,172.31.36.0-255,66,92643,7,312270
27026,0.003325,172.217.194.0-255,2902,95545,7,312270
27027,0.003333,172.31.36.0-255,66,95611,7,312270
27028,0.003354,172.217.194.0-255,2902,98513,7,312270
27029,0.005027,172.31.36.0-255,66,98579,7,312270
27030,0.005367,172.217.194.0-255,2902,101481,7,312270
27031,0.005372,172.31.36.0-255,66,101547,7,312270
27032,0.007003,172.217.194.0-255,2902,104449,7,312270
27033,0.00701,172.31.36.0-255,66,104515,7,312270
27034,0.007353,172.217.194.0-255,2902,107417,7,312270
27035,0.007456,172.31.36.0-255,66,107483,7,312270
27036,0.009002,172.217.194.0-255,2902,110385,7,312270
27037,0.009008,172.31.36.0-255,66,110451,7,312270
27038,0.009432,172.217.194.0-255,2902,113353,7,312270
27039,0.009438,172.31.36.0-255,66,113419,7,312270
27040,0.010995,172.217.194.0-255,2902,116321,7,312270
27041,0.011002,172.31.36.0-255,66,116387,7,312270
27042,0.011435,172.217.194.0-255,2902,119289,7,312270
27043,0.013006,172.217.194.0-255,2902,122191,7,312270
27044,0.014133,172.31.36.0-255,66,122257,7,312270
27045,0.016158,172.217.194.0-255,5738,127995,7,312270
27046,0.016167,172.31.36.0-255,66,128061,7,312270
27047,0.018179,172.217.194.0-255,5738,133799,7,312270
27048,0.018187,172.31.36.0-255,66,133865,7,312270
27049,0.020182,172.217.194.0-255,5738,139603,7,312270
27050,0.020205,172.31.36.0-255,66,139669,7,312270
27051,0.022211,172.217.194.0-255,5738,145407,7,312270
27052,0.022219,172.31.36.0-255,66,145473,7,312270
27053,0.024224,172.217.194.0-255,5738,151211,7,312270
27054,0.024234,172.31.36.0-255,66,151277,7,312270
27055,0.026227,172.217.194.0-255,5738,157015,7,312270
27056,0.026234,172.31.36.0-255,66,157081,7,312270
27057,0.02823,172.217.194.0-255,5738,162819,7,312270
27058,0.028237,172.31.36.0-255,66,162885,7,312270
27059,0.028787,172.31.36.0-255,167,163052,7,312270
27060,0.028818,172.31.36.0-255,1115,164167,7,312270
27061,0.028877,172.31.36.0-255,1514,165681,7,312270
27062,0.028879,172.31.36.0-255,1291,166972,7,312270
27063,0.030233,172.217.194.0-255,5738,172710,7,312270
27064,0.030241,172.31.36.0-255,66,172776,7,312270
27065,0.030355,104.244.42.0-255,66,172842,7,312270
27066,0.030362,104.244.42.0-255,66,172908,7,312270
27067,0.030435,104.244.42.0-255,66,172974,7,312270
27068,0.032224,172.217.194.0-255,5738,178712,7,312270
27069,0.032264,172.31.36.0-255,66,178778,7,312270
27070,0.034274,172.217.194.0-255,5738,184516,7,312270
27071,0.034281,172.31.36.0-255,66,184582,7,312270
27072,0.036273,172.217.194.0-255,5738,190320,7,312270
27073,0.03628,172.31.36.0-255,66,190386,7,312270
27074,0.038272,172.217.194.0-255,5738,196124,7,312270
27075,0.038279,172.31.36.0-255,66,196190,7,312270
27076,0.040269,172.217.194.0-255,5738,201928,7,312270
27077,0.040277,172.31.36.0-255,66,201994,7,312270
27078,0.042268,172.217.194.0-255,5738,207732,7,312270
27079,0.042274,172.31.36.0-255,66,207798,7,312270
27080,0.044297,172.217.194.0-255,5738,213536,7,312270
27081,0.044304,172.31.36.0-255,66,213602,7,312270
27082,0.046321,172.217.194.0-255,5738,219340,7,312270
27083,0.046326,172.31.36.0-255,66,219406,7,312270
27084,0.048304,172.217.194.0-255,5738,225144,7,312270
27085,0.048309,172.31.36.0-255,66,225210,7,312270
27086,0.050339,172.217.194.0-255,5738,230948,7,312270
27087,0.050344,172.31.36.0-255,66,231014,7,312270
27088,0.052352,172.217.194.0-255,5738,236752,7,312270
27089,0.052358,172.31.36.0-255,66,236818,7,312270
27090,0.054364,172.217.194.0-255,5738,242556,7,312270
27091,0.05437,172.31.36.0-255,66,242622,7,312270
27092,0.056373,172.217.194.0-255,5738,248360,7,312270
27093,0.05638,172.31.36.0-255,66,248426,7,312270
27094,0.058376,172.217.194.0-255,5738,254164,7,312270
27095,0.058384,172.31.36.0-255,66,254230,7,312270
27096,0.060395,172.217.194.0-255,5738,259968,7,312270
27097,0.060402,172.31.36.0-255,66,260034,7,312270
27098,0.06239,172.217.194.0-255,5738,265772,7,312270
27099,0.062396,172.31.36.0-255,66,265838,7,312270
27100,0.064413,172.217.194.0-255,5738,271576,7,312270
27101,0.06442,172.31.36.0-255,66,271642,7,312270
27102,0.066435,172.217.194.0-255,5738,277380,7,312270
27103,0.066441,172.31.36.0-255,66,277446,7,312270
27104,0.068453,172.217.194.0-255,5738,283184,7,312270
27105,0.06846,172.31.36.0-255,66,283250,7,312270
27106,0.070446,172.217.194.0-255,5738,288988,7,312270
27107,0.070453,172.31.36.0-255,66,289054,7,312270
27108,0.072464,172.217.194.0-255,5738,294792,7,312270
27109,0.072473,172.31.36.0-255,66,294858,7,312270
27110,0.074468,172.217.194.0-255,5738,300596,7,312270
27111,0.074474,172.31.36.0-255,66,300662,7,312270
27112,0.076499,172.217.194.0-255,5738,306400,7,312270
27113,0.076506,172.31.36.0-255,66,306466,7,312270
27114,0.078542,172.217.194.0-255,5738,312204,7,312270
27115,0.078549,172.31.36.0-255,66,312270,7,312270
27116,0.0,172.217.194.0-255,146,146,7,329279
27117,2.6e-05,172.31.36.0-255,66,212,7,329279
27118,3.3e-05,172.217.194.0-255,1484,1696,7,329279
27119,3.7e-05,172.31.36.0-255,66,1762,7,329279
27120,4.2e-05,172.217.194.0-255,2902,4664,7,329279
27121,4.4e-05,172.31.36.0-255,66,4730,7,329279
27122,5e-05,172.217.194.0-255,4320,9050,7,329279
27123,5.2e-05,172.31.36.0-255,66,9116,7,329279
27124,7.5e-05,172.217.194.0-255,1484,10600,7,329279
27125,7.7e-05,172.31.36.0-255,66,10666,7,329279
27126,0.000102,172.31.36.0-255,66,10732,7,329279
27127,0.000125,172.217.194.0-255,4904,15636,7,329279
27128,0.000128,172.31.36.0-255,66,15702,7,329279
27129,0.000135,172.217.194.0-255,6797,22499,7,329279
27130,0.000138,172.31.36.0-255,66,22565,7,329279
27131,0.000141,172.217.194.0-255,1484,24049,7,329279
27132,0.000143,172.31.36.0-255,66,24115,7,329279
27133,0.000147,172.217.194.0-255,2902,27017,7,329279
27134,0.000149,172.31.36.0-255,66,27083,7,329279
27135,0.000173,172.217.194.0-255,5738,32821,7,329279
27136,0.000176,172.31.36.0-255,66,32887,7,329279
27137,0.000205,172.217.194.0-255,6797,39684,7,329279
27138,0.000208,172.31.36.0-255,66,39750,7,329279
27139,0.000562,172.217.194.0-255,1484,41234,7,329279
27140,0.000567,172.31.36.0-255,66,41300,7,329279
27141,0.000573,172.217.194.0-255,2902,44202,7,329279
27142,0.000576,172.31.36.0-255,66,44268,7,329279
27143,0.00058,172.217.194.0-255,2902,47170,7,329279
27144,0.000582,172.31.36.0-255,66,47236,7,329279
27145,0.000599,172.217.194.0-255,2902,50138,7,329279
27146,0.000602,172.31.36.0-255,66,50204,7,329279
27147,0.000626,172.217.194.0-255,6797,57001,7,329279
27148,0.00063,172.31.36.0-255,66,57067,7,329279
27149,0.000649,172.217.194.0-255,647,57714,7,329279
27150,0.000727,172.217.194.0-255,1484,59198,7,329279
27151,0.000731,172.31.36.0-255,66,59264,7,329279
27152,0.000746,172.217.194.0-255,1484,60748,7,329279
27153,0.000761,172.217.194.0-255,2902,63650,7,329279
27154,0.000763,172.31.36.0-255,66,63716,7,329279
27155,0.00077,172.217.194.0-255,4320,68036,7,329279
27156,0.000772,172.31.36.0-255,66,68102,7,329279
27157,0.000791,172.217.194.0-255,1484,69586,7,329279
27158,0.00081,172.217.194.0-255,5738,75324,7,329279
27159,0.000813,172.31.36.0-255,66,75390,7,329279
27160,0.000836,172.217.194.0-255,6797,82187,7,329279
27161,0.000839,172.31.36.0-255,66,82253,7,329279
27162,0.000879,172.217.194.0-255,2902,85155,7,329279
27163,0.000882,172.31.36.0-255,66,85221,7,329279
27164,0.000901,172.217.194.0-255,6797,92018,7,329279
27165,0.000904,172.31.36.0-255,66,92084,7,329279
27166,0.00093,172.217.194.0-255,2902,94986,7,329279
27167,0.000932,172.31.36.0-255,66,95052,7,329279
27168,0.000938,172.217.194.0-255,4320,99372,7,329279
27169,0.000943,172.31.36.0-255,66,99438,7,329279
27170,0.000948,172.31.36.0-255,66,99504,7,329279
27171,0.00095,172.217.194.0-255,561,100065,7,329279
27172,0.001084,172.217.194.0-255,1484,101549,7,329279
27173,0.001088,172.31.36.0-255,66,101615,7,329279
27174,0.00111,172.217.194.0-255,2902,104517,7,329279
27175,0.001113,172.31.36.0-255,66,104583,7,329279
27176,0.001119,172.217.194.0-255,5738,110321,7,329279
27177,0.001121,172.31.36.0-255,66,110387,7,329279
27178,0.001147,172.31.36.0-255,66,110453,7,329279
27179,0.001166,172.217.194.0-255,2902,113355,7,329279
27180,0.001169,172.31.36.0-255,66,113421,7,329279
27181,0.001181,172.31.36.0-255,66,113487,7,329279
27182,0.001531,172.217.194.0-255,1484,114971,7,329279
27183,0.001541,172.217.194.0-255,2902,117873,7,329279
27184,0.001545,172.31.36.0-255,66,117939,7,329279
27185,0.001551,172.217.194.0-255,2902,120841,7,329279
27186,0.001552,172.31.36.0-255,66,120907,7,329279
27187,0.001576,172.217.194.0-255,2902,123809,7,329279
27188,0.001579,172.31.36.0-255,66,123875,7,329279
27189,0.001585,172.217.194.0-255,5738,129613,7,329279
27190,0.001587,172.31.36.0-255,66,129679,7,329279
27191,0.001592,172.217.194.0-255,2902,132581,7,329279
27192,0.001594,172.31.36.0-255,66,132647,7,329279
27193,0.001639,172.31.36.0-255,66,132713,7,329279
27194,0.001645,172.217.194.0-255,5020,137733,7,329279
27195,0.001647,172.31.36.0-255,66,137799,7,329279
27196,0.001672,172.217.194.0-255,1484,139283,7,329279
27197,0.001677,172.217.194.0-255,2902,142185,7,329279
27198,0.001681,172.31.36.0-255,66,142251,7,329279
27199,0.001684,172.217.194.0-255,1484,143735,7,329279
27200,0.001702,172.217.194.0-255,4320,148055,7,329279
27201,0.001706,172.31.36.0-255,66,148121,7,329279
27202,0.00171,172.217.194.0-255,1484,149605,7,329279
27203,0.001736,172.31.36.0-255,66,149671,7,329279
27204,0.001747,172.31.36.0-255,66,149737,7,329279
27205,0.001807,172.217.194.0-255,2184,151921,7,329279
27206,0.001812,172.31.36.0-255,66,151987,7,329279
27207,0.001816,172.217.194.0-255,2902,154889,7,329279
27208,0.001818,172.31.36.0-255,66,154955,7,329279
27209,0.001825,172.217.194.0-255,7156,162111,7,329279
27210,0.001828,172.31.36.0-255,66,162177,7,329279
27211,0.001851,172.217.194.0-255,4320,166497,7,329279
27212,0.001853,172.31.36.0-255,66,166563,7,329279
27213,0.001887,172.31.36.0-255,66,166629,7,329279
27214,0.001907,172.217.194.0-255,4320,170949,7,329279
27215,0.00191,172.31.36.0-255,66,171015,7,329279
27216,0.001935,172.217.194.0-255,2184,173199,7,329279
27217,0.001938,172.31.36.0-255,66,173265,7,329279
27218,0.002208,172.217.194.0-255,1484,174749,7,329279
27219,0.002214,172.217.194.0-255,2902,177651,7,329279
27220,0.002219,172.31.36.0-255,66,177717,7,329279
27221,0.002244,172.217.194.0-255,5738,183455,7,329279
27222,0.002247,172.31.36.0-255,66,183521,7,329279
27223,0.00225,172.217.194.0-255,1484,185005,7,329279
27224,0.00226,172.31.36.0-255,66,185071,7,329279
27225,0.002286,172.217.194.0-255,1484,186555,7,329279
27226,0.002321,172.31.36.0-255,66,186621,7,329279
27227,0.004608,172.217.194.0-255,5738,192359,7,329279
27228,0.004614,172.31.36.0-255,66,192425,7,329279
27229,0.006874,172.217.194.0-255,5738,198163,7,329279
27230,0.00688,172.31.36.0-255,66,198229,7,329279
27231,0.00918,172.217.194.0-255,5738,203967,7,329279
27232,0.009186,172.31.36.0-255,66,204033,7,329279
27233,0.011464,172.217.194.0-255,5738,209771,7,329279
27234,0.011472,172.31.36.0-255,66,209837,7,329279
27235,0.013778,172.217.194.0-255,5738,215575,7,329279
27236,0.013785,172.31.36.0-255,66,215641,7,329279
27237,0.016087,172.217.194.0-255,5738,221379,7,329279
27238,0.016097,172.31.36.0-255,66,221445,7,329279
27239,0.018384,172.217.194.0-255,5738,227183,7,329279
27240,0.018391,172.31.36.0-255,66,227249,7,329279
27241,0.020676,172.217.194.0-255,5738,232987,7,329279
27242,0.020685,172.31.36.0-255,66,233053,7,329279
27243,0.023003,172.217.194.0-255,5738,238791,7,329279
27244,0.02301,172.31.36.0-255,66,238857,7,329279
27245,0.025289,172.217.194.0-255,5738,244595,7,329279
27246,0.025296,172.31.36.0-255,66,244661,7,329279
27247,0.027593,172.217.194.0-255,5738,250399,7,329279
27248,0.0276,172.31.36.0-255,66,250465,7,329279
27249,0.029533,172.31.36.0-255,172,250637,7,329279
27250,0.029563,172.31.36.0-255,1114,251751,7,329279
27251,0.029602,172.31.36.0-255,1514,253265,7,329279
27252,0.029604,172.31.36.0-255,1292,254557,7,329279
27253,0.029855,172.217.194.0-255,5738,260295,7,329279
27254,0.029861,172.31.36.0-255,66,260361,7,329279
27255,0.031087,104.244.42.0-255,66,260427,7,329279
27256,0.031181,104.244.42.0-255,66,260493,7,329279
27257,0.031183,104.244.42.0-255,66,260559,7,329279
27258,0.031799,104.244.42.0-255,108,260667,7,329279
27259,0.031803,172.31.36.0-255,66,260733,7,329279
27260,0.032143,172.217.194.0-255,5738,266471,7,329279
27261,0.032147,172.31.36.0-255,66,266537,7,329279
27262,0.034446,172.217.194.0-255,5738,272275,7,329279
27263,0.034452,172.31.36.0-255,66,272341,7,329279
27264,0.036769,172.217.194.0-255,5738,278079,7,329279
27265,0.036777,172.31.36.0-255,66,278145,7,329279
27266,0.03905,172.217.194.0-255,5738,283883,7,329279
27267,0.039074,172.31.36.0-255,66,283949,7,329279
27268,0.041323,172.217.194.0-255,5738,289687,7,329279
27269,0.041329,172.31.36.0-255,66,289753,7,329279
27270,0.043613,172.217.194.0-255,5738,295491,7,329279
27271,0.043618,172.31.36.0-255,66,295557,7,329279
27272,0.045888,172.217.194.0-255,4320,299877,7,329279
27273,0.045893,172.31.36.0-255,66,299943,7,329279
27274,0.045921,172.217.194.0-255,1484,301427,7,329279
27275,0.04819,172.217.194.0-255,4320,305747,7,329279
27276,0.048194,172.31.36.0-255,66,305813,7,329279
27277,0.050473,172.217.194.0-255,5738,311551,7,329279
27278,0.050478,172.31.36.0-255,66,311617,7,329279
27279,0.052769,172.217.194.0-255,5738,317355,7,329279
27280,0.052774,172.31.36.0-255,66,317421,7,329279
27281,0.055027,172.217.194.0-255,5738,323159,7,329279
27282,0.055033,172.31.36.0-255,66,323225,7,329279
27283,0.057313,172.217.194.0-255,4320,327545,7,329279
27284,0.057318,172.31.36.0-255,66,327611,7,329279
27285,0.057345,172.217.194.0-255,1431,329042,7,329279
27286,0.057474,172.31.36.0-255,66,329108,7,329279
27287,0.057496,172.31.36.0-255,105,329213,7,329279
27288,0.059731,172.217.194.0-255,66,329279,7,329279
27289,0.0,74.125.24.0-255,152,152,7,343262
27290,1.6e-05,172.31.36.0-255,66,218,7,343262
27291,2.2e-05,74.125.24.0-255,1484,1702,7,343262
27292,2.7e-05,172.31.36.0-255,66,1768,7,343262
27293,3.3e-05,74.125.24.0-255,2902,4670,7,343262
27294,4.4e-05,172.31.36.0-255,66,4736,7,343262
27295,5.2e-05,74.125.24.0-255,7156,11892,7,343262
27296,5.5e-05,172.31.36.0-255,66,11958,7,343262
27297,6e-05,74.125.24.0-255,2019,13977,7,343262
27298,6.3e-05,172.31.36.0-255,66,14043,7,343262
27299,9.4e-05,74.125.24.0-255,2902,16945,7,343262
27300,9.7e-05,172.31.36.0-255,66,17011,7,343262
27301,0.000105,74.125.24.0-255,7156,24167,7,343262
27302,0.000107,172.31.36.0-255,66,24233,7,343262
27303,0.000117,74.125.24.0-255,2902,27135,7,343262
27304,0.000119,172.31.36.0-255,66,27201,7,343262
27305,0.00016,74.125.24.0-255,3961,31162,7,343262
27306,0.000164,172.31.36.0-255,66,31228,7,343262
27307,0.000338,74.125.24.0-255,1484,32712,7,343262
27308,0.000343,172.31.36.0-255,66,32778,7,343262
27309,0.00035,74.125.24.0-255,2902,35680,7,343262
27310,0.000353,172.31.36.0-255,66,35746,7,343262
27311,0.000388,74.125.24.0-255,5738,41484,7,343262
27312,0.000391,172.31.36.0-255,66,41550,7,343262
27313,0.000399,74.125.24.0-255,6797,48347,7,343262
27314,0.000402,172.31.36.0-255,66,48413,7,343262
27315,0.000413,74.125.24.0-255,5738,54151,7,343262
27316,0.000415,172.31.36.0-255,66,54217,7,343262
27317,0.000438,74.125.24.0-255,2902,57119,7,343262
27318,0.000445,172.31.36.0-255,66,57185,7,343262
27319,0.000473,74.125.24.0-255,1484,58669,7,343262
27320,0.000476,172.31.36.0-255,66,58735,7,343262
27321,0.00051,74.125.24.0-255,7109,65844,7,343262
27322,0.000537,172.31.36.0-255,66,65910,7,343262
27323,0.00057,74.125.24.0-255,110,66020,7,343262
27324,0.000684,74.125.24.0-255,1484,67504,7,343262
27325,0.000689,74.125.24.0-255,2902,70406,7,343262
27326,0.000702,172.31.36.0-255,66,70472,7,343262
27327,0.000709,74.125.24.0-255,5738,76210,7,343262
27328,0.000711,74.125.24.0-255,1484,77694,7,343262
27329,0.000732,74.125.24.0-255,2902,80596,7,343262
27330,0.000735,74.125.24.0-255,1484,82080,7,343262
27331,0.000771,74.125.24.0-255,5738,87818,7,343262
27332,0.000778,172.31.36.0-255,66,87884,7,343262
27333,0.00079,74.125.24.0-255,2184,90068,7,343262
27334,0.00081,172.31.36.0-255,66,90134,7,343262
27335,0.001269,74.125.24.0-255,1484,91618,7,343262
27336,0.001295,74.125.24.0-255,2902,94520,7,343262
27337,0.0013,172.31.36.0-255,66,94586,7,343262
27338,0.001338,74.125.24.0-255,5738,100324,7,343262
27339,0.001343,74.125.24.0-255,2902,103226,7,343262
27340,0.001348,74.125.24.0-255,4320,107546,7,343262
27341,0.001371,74.125.24.0-255,5738,113284,7,343262
27342,0.00138,172.31.36.0-255,66,113350,7,343262
27343,0.001397,74.125.24.0-255,2902,116252,7,343262
27344,0.0014,74.125.24.0-255,1484,117736,7,343262
27345,0.001417,74.125.24.0-255,1484,119220,7,343262
27346,0.001424,172.31.36.0-255,66,119286,7,343262
27347,0.001457,74.125.24.0-255,5020,124306,7,343262
27348,0.001474,172.31.36.0-255,66,124372,7,343262
27349,0.001978,74.125.24.0-255,1484,125856,7,343262
27350,0.001987,74.125.24.0-255,2902,128758,7,343262
27351,0.001991,172.31.36.0-255,66,128824,7,343262
27352,0.001998,74.125.24.0-255,2902,131726,7,343262
27353,0.002,172.31.36.0-255,66,131792,7,343262
27354,0.002028,74.125.24.0-255,2902,134694,7,343262
27355,0.002034,172.31.36.0-255,66,134760,7,343262
27356,0.00206,172.31.36.0-255,66,134826,7,343262
27357,0.002072,74.125.24.0-255,766,135592,7,343262
27358,0.00652,172.31.36.0-255,66,135658,7,343262
27359,0.008603,74.125.24.0-255,5738,141396,7,343262
27360,0.008611,172.31.36.0-255,66,141462,7,343262
27361,0.010663,74.125.24.0-255,5738,147200,7,343262
27362,0.010673,172.31.36.0-255,66,147266,7,343262
27363,0.012768,74.125.24.0-255,5738,153004,7,343262
27364,0.012777,172.31.36.0-255,66,153070,7,343262
27365,0.014826,74.125.24.0-255,5738,158808,7,343262
27366,0.014838,172.31.36.0-255,66,158874,7,343262
27367,0.016896,74.125.24.0-255,5738,164612,7,343262
27368,0.016908,172.31.36.0-255,66,164678,7,343262
27369,0.01897,74.125.24.0-255,5738,170416,7,343262
27370,0.018981,172.31.36.0-255,66,170482,7,343262
27371,0.02084,172.31.36.0-255,172,170654,7,343262
27372,0.020873,172.31.36.0-255,1115,171769,7,343262
27373,0.020931,172.31.36.0-255,1514,173283,7,343262
27374,0.020933,172.31.36.0-255,1291,174574,7,343262
27375,0.021044,74.125.24.0-255,5738,180312,7,343262
27376,0.021051,172.31.36.0-255,66,180378,7,343262
27377,0.022419,104.244.42.0-255,66,180444,7,343262
27378,0.022444,104.244.42.0-255,66,180510,7,343262
27379,0.02249,104.244.42.0-255,66,180576,7,343262
27380,0.023116,74.125.24.0-255,5738,186314,7,343262
27381,0.023122,172.31.36.0-255,66,186380,7,343262
27382,0.02337,104.244.42.0-255,108,186488,7,343262
27383,0.023375,172.31.36.0-255,66,186554,7,343262
27384,0.025191,74.125.24.0-255,5738,192292,7,343262
27385,0.025199,172.31.36.0-255,66,192358,7,343262
27386,0.027305,74.125.24.0-255,5738,198096,7,343262
27387,0.027311,172.31.36.0-255,66,198162,7,343262
27388,0.029374,74.125.24.0-255,5738,203900,7,343262
27389,0.02938,172.31.36.0-255,66,203966,7,343262
27390,0.031445,74.125.24.0-255,5738,209704,7,343262
27391,0.031452,172.31.36.0-255,66,209770,7,343262
27392,0.033578,74.125.24.0-255,5738,215508,7,343262
27393,0.033585,172.31.36.0-255,66,215574,7,343262
27394,0.035663,74.125.24.0-255,5738,221312,7,343262
27395,0.035669,172.31.36.0-255,66,221378,7,343262
27396,0.037724,74.125.24.0-255,5738,227116,7,343262
27397,0.03773,172.31.36.0-255,66,227182,7,343262
27398,0.039786,74.125.24.0-255,5738,232920,7,343262
27399,0.039795,172.31.36.0-255,66,232986,7,343262
27400,0.041865,74.125.24.0-255,5738,238724,7,343262
27401,0.041871,172.31.36.0-255,66,238790,7,343262
27402,0.043958,74.125.24.0-255,5738,244528,7,343262
27403,0.043965,172.31.36.0-255,66,244594,7,343262
27404,0.04604,74.125.24.0-255,5738,250332,7,343262
27405,0.046047,172.31.36.0-255,66,250398,7,343262
27406,0.048122,74.125.24.0-255,5738,256136,7,343262
27407,0.048129,172.31.36.0-255,66,256202,7,343262
27408,0.050204,74.125.24.0-255,5738,261940,7,343262
27409,0.050211,172.31.36.0-255,66,262006,7,343262
27410,0.052273,74.125.24.0-255,5738,267744,7,343262
27411,0.052281,172.31.36.0-255,66,267810,7,343262
27412,0.05435,74.125.24.0-255,5738,273548,7,343262
27413,0.054359,172.31.36.0-255,66,273614,7,343262
27414,0.056401,74.125.24.0-255,5738,279352,7,343262
27415,0.056408,172.31.36.0-255,66,279418,7,343262
27416,0.058484,74.125.24.0-255,5738,285156,7,343262
27417,0.058496,172.31.36.0-255,66,285222,7,343262
27418,0.06054,74.125.24.0-255,5738,290960,7,343262
27419,0.060548,172.31.36.0-255,66,291026,7,343262
27420,0.062663,74.125.24.0-255,5738,296764,7,343262
27421,0.062672,172.31.36.0-255,66,296830,7,343262
27422,0.06478,74.125.24.0-255,5738,302568,7,343262
27423,0.064789,172.31.36.0-255,66,302634,7,343262
27424,0.066838,74.125.24.0-255,5738,308372,7,343262
27425,0.066845,172.31.36.0-255,66,308438,7,343262
27426,0.068928,74.125.24.0-255,5738,314176,7,343262
27427,0.068935,172.31.36.0-255,66,314242,7,343262
27428,0.071004,74.125.24.0-255,5738,319980,7,343262
27429,0.071011,172.31.36.0-255,66,320046,7,343262
27430,0.07312,74.125.24.0-255,5738,325784,7,343262
27431,0.073126,172.31.36.0-255,66,325850,7,343262
27432,0.075189,74.125.24.0-255,5738,331588,7,343262
27433,0.075197,172.31.36.0-255,66,331654,7,343262
27434,0.077268,74.125.24.0-255,5738,337392,7,343262
27435,0.077276,172.31.36.0-255,66,337458,7,343262
27436,0.079319,74.125.24.0-255,5738,343196,7,343262
27437,0.079327,172.31.36.0-255,66,343262,7,343262
27438,0.0,172.31.36.0-255,105,105,7,276
27439,0.067417,31.13.82.0-255,105,210,7,276
27440,0.067429,172.31.36.0-255,66,276,7,276
27441,0.0,172.31.36.0-255,105,105,7,105
27442,0.0,74.125.130.0-255,153,153,7,324798
27443,2.3e-05,172.31.36.0-255,66,219,7,324798
27444,3e-05,74.125.130.0-255,1484,1703,7,324798
27445,3.3e-05,172.31.36.0-255,66,1769,7,324798
27446,6.3e-05,74.125.130.0-255,2902,4671,7,324798
27447,6.7e-05,172.31.36.0-255,66,4737,7,324798
27448,7.1e-05,74.125.130.0-255,1484,6221,7,324798
27449,7.3e-05,172.31.36.0-255,66,6287,7,324798
27450,9.8e-05,74.125.130.0-255,2902,9189,7,324798
27451,0.0001,172.31.36.0-255,66,9255,7,324798
27452,0.000138,74.125.130.0-255,4884,14139,7,324798
27453,0.000142,172.31.36.0-255,66,14205,7,324798
27454,0.000251,74.125.130.0-255,1484,15689,7,324798
27455,0.000254,172.31.36.0-255,66,15755,7,324798
27456,0.000267,74.125.130.0-255,2902,18657,7,324798
27457,0.000271,172.31.36.0-255,66,18723,7,324798
27458,0.000293,74.125.130.0-255,1484,20207,7,324798
27459,0.000296,172.31.36.0-255,66,20273,7,324798
27460,0.0003,74.125.130.0-255,2902,23175,7,324798
27461,0.000303,172.31.36.0-255,66,23241,7,324798
27462,0.000306,74.125.130.0-255,1484,24725,7,324798
27463,0.000308,172.31.36.0-255,66,24791,7,324798
27464,0.000334,74.125.130.0-255,4320,29111,7,324798
27465,0.000337,172.31.36.0-255,66,29177,7,324798
27466,0.000341,74.125.130.0-255,2543,31720,7,324798
27467,0.000343,172.31.36.0-255,66,31786,7,324798
27468,0.000506,74.125.130.0-255,1484,33270,7,324798
27469,0.00051,172.31.36.0-255,66,33336,7,324798
27470,0.000513,74.125.130.0-255,1484,34820,7,324798
27471,0.000515,172.31.36.0-255,66,34886,7,324798
27472,0.000532,74.125.130.0-255,1484,36370,7,324798
27473,0.000535,172.31.36.0-255,66,36436,7,324798
27474,0.000538,74.125.130.0-255,1484,37920,7,324798
27475,0.000544,74.125.130.0-255,2902,40822,7,324798
27476,0.000575,74.125.130.0-255,5738,46560,7,324798
27477,0.000591,74.125.130.0-255,2543,49103,7,324798
27478,0.000723,172.31.36.0-255,66,49169,7,324798
27479,0.001126,74.125.130.0-255,1484,50653,7,324798
27480,0.001148,74.125.130.0-255,2902,53555,7,324798
27481,0.001153,172.31.36.0-255,66,53621,7,324798
27482,0.001158,74.125.130.0-255,1484,55105,7,324798
27483,0.001177,74.125.130.0-255,2902,58007,7,324798
27484,0.00119,172.31.36.0-255,66,58073,7,324798
27485,0.001199,74.125.130.0-255,2902,60975,7,324798
27486,0.001209,172.31.36.0-255,66,61041,7,324798
27487,0.001214,74.125.130.0-255,2902,63943,7,324798
27488,0.001236,172.31.36.0-255,66,64009,7,324798
27489,0.001269,74.125.130.0-255,2543,66552,7,324798
27490,0.001285,172.31.36.0-255,66,66618,7,324798
27491,0.00134,74.125.130.0-255,1484,68102,7,324798
27492,0.001355,74.125.130.0-255,2902,71004,7,324798
27493,0.001368,172.31.36.0-255,66,71070,7,324798
27494,0.001382,74.125.130.0-255,2902,73972,7,324798
27495,0.001399,74.125.130.0-255,2902,76874,7,324798
27496,0.001405,74.125.130.0-255,4320,81194,7,324798
27497,0.001409,172.31.36.0-255,66,81260,7,324798
27498,0.001439,74.125.130.0-255,5379,86639,7,324798
27499,0.001456,74.125.130.0-255,1484,88123,7,324798
27500,0.00146,74.125.130.0-255,2902,91025,7,324798
27501,0.001466,172.31.36.0-255,66,91091,7,324798
27502,0.001487,74.125.130.0-255,4320,95411,7,324798
27503,0.001499,74.125.130.0-255,1484,96895,7,324798
27504,0.001502,74.125.130.0-255,1484,98379,7,324798
27505,0.001517,172.31.36.0-255,66,98445,7,324798
27506,0.001528,74.125.130.0-255,2902,101347,7,324798
27507,0.001531,74.125.130.0-255,288,101635,7,324798
27508,0.001552,172.31.36.0-255,66,101701,7,324798
27509,0.001826,74.125.130.0-255,1484,103185,7,324798
27510,0.001846,74.125.130.0-255,2902,106087,7,324798
27511,0.001849,172.31.36.0-255,66,106153,7,324798
27512,0.001858,74.125.130.0-255,5738,111891,7,324798
27513,0.00187,74.125.130.0-255,1484,113375,7,324798
27514,0.001873,172.31.36.0-255,66,113441,7,324798
27515,0.001897,74.125.130.0-255,5738,119179,7,324798
27516,0.001927,172.31.36.0-255,66,119245,7,324798
27517,0.001958,172.31.36.0-255,66,119311,7,324798
27518,0.001966,74.125.130.0-255,1484,120795,7,324798
27519,0.001981,74.125.130.0-255,3602,124397,7,324798
27520,0.002002,172.31.36.0-255,66,124463,7,324798
27521,0.002283,74.125.130.0-255,1484,125947,7,324798
27522,0.002289,74.125.130.0-255,2902,128849,7,324798
27523,0.002292,172.31.36.0-255,66,128915,7,324798
27524,0.002296,74.125.130.0-255,1484,130399,7,324798
27525,0.004579,74.125.130.0-255,4320,134719,7,324798
27526,0.004587,172.31.36.0-255,66,134785,7,324798
27527,0.006876,74.125.130.0-255,5738,140523,7,324798
27528,0.007661,172.31.36.0-255,66,140589,7,324798
27529,0.009956,74.125.130.0-255,5738,146327,7,324798
27530,0.009963,172.31.36.0-255,66,146393,7,324798
27531,0.012258,74.125.130.0-255,5738,152131,7,324798
27532,0.012265,172.31.36.0-255,66,152197,7,324798
27533,0.014573,74.125.130.0-255,5738,157935,7,324798
27534,0.014582,172.31.36.0-255,66,158001,7,324798
27535,0.01687,74.125.130.0-255,5738,163739,7,324798
27536,0.016878,172.31.36.0-255,66,163805,7,324798
27537,0.019166,74.125.130.0-255,5738,169543,7,324798
27538,0.019173,172.31.36.0-255,66,169609,7,324798
27539,0.021469,74.125.130.0-255,5738,175347,7,324798
27540,0.021476,172.31.36.0-255,66,175413,7,324798
27541,0.023764,74.125.130.0-255,5738,181151,7,324798
27542,0.023771,172.31.36.0-255,66,181217,7,324798
27543,0.026066,74.125.130.0-255,5738,186955,7,324798
27544,0.026073,172.31.36.0-255,66,187021,7,324798
27545,0.028363,74.125.130.0-255,5738,192759,7,324798
27546,0.02837,172.31.36.0-255,66,192825,7,324798
27547,0.030169,172.31.36.0-255,167,192992,7,324798
27548,0.030199,172.31.36.0-255,1112,194104,7,324798
27549,0.030259,172.31.36.0-255,1514,195618,7,324798
27550,0.030261,172.31.36.0-255,1294,196912,7,324798
27551,0.030663,74.125.130.0-255,5738,202650,7,324798
27552,0.03067,172.31.36.0-255,66,202716,7,324798
27553,0.031757,104.244.42.0-255,66,202782,7,324798
27554,0.031794,104.244.42.0-255,66,202848,7,324798
27555,0.031821,104.244.42.0-255,66,202914,7,324798
27556,0.032971,74.125.130.0-255,5738,208652,7,324798
27557,0.032977,172.31.36.0-255,66,208718,7,324798
27558,0.035284,74.125.130.0-255,5738,214456,7,324798
27559,0.03529,172.31.36.0-255,66,214522,7,324798
27560,0.037582,74.125.130.0-255,5738,220260,7,324798
27561,0.037589,172.31.36.0-255,66,220326,7,324798
27562,0.039878,74.125.130.0-255,5738,226064,7,324798
27563,0.039886,172.31.36.0-255,66,226130,7,324798
27564,0.042182,74.125.130.0-255,5738,231868,7,324798
27565,0.04219,172.31.36.0-255,66,231934,7,324798
27566,0.044486,74.125.130.0-255,5738,237672,7,324798
27567,0.044496,172.31.36.0-255,66,237738,7,324798
27568,0.046807,74.125.130.0-255,5738,243476,7,324798
27569,0.046813,172.31.36.0-255,66,243542,7,324798
27570,0.049104,74.125.130.0-255,5738,249280,7,324798
27571,0.049112,172.31.36.0-255,66,249346,7,324798
27572,0.051405,74.125.130.0-255,5738,255084,7,324798
27573,0.051411,172.31.36.0-255,66,255150,7,324798
27574,0.053716,74.125.130.0-255,5738,260888,7,324798
27575,0.053722,172.31.36.0-255,66,260954,7,324798
27576,0.056012,74.125.130.0-255,5738,266692,7,324798
27577,0.056018,172.31.36.0-255,66,266758,7,324798
27578,0.058315,74.125.130.0-255,5738,272496,7,324798
27579,0.058321,172.31.36.0-255,66,272562,7,324798
27580,0.060616,74.125.130.0-255,5738,278300,7,324798
27581,0.060622,172.31.36.0-255,66,278366,7,324798
27582,0.062909,74.125.130.0-255,5738,284104,7,324798
27583,0.062916,172.31.36.0-255,66,284170,7,324798
27584,0.065212,74.125.130.0-255,5738,289908,7,324798
27585,0.065218,172.31.36.0-255,66,289974,7,324798
27586,0.067559,74.125.130.0-255,5738,295712,7,324798
27587,0.067567,172.31.36.0-255,66,295778,7,324798
27588,0.069859,74.125.130.0-255,5738,301516,7,324798
27589,0.069866,172.31.36.0-255,66,301582,7,324798
27590,0.07216,74.125.130.0-255,5738,307320,7,324798
27591,0.072166,172.31.36.0-255,66,307386,7,324798
27592,0.074462,74.125.130.0-255,5738,313124,7,324798
27593,0.074468,172.31.36.0-255,66,313190,7,324798
27594,0.076769,74.125.130.0-255,5738,318928,7,324798
27595,0.076776,172.31.36.0-255,66,318994,7,324798
27596,0.079064,74.125.130.0-255,5738,324732,7,324798
27597,0.079071,172.31.36.0-255,66,324798,7,324798
27598,0.0,74.125.24.0-255,153,153,7,392605
27599,3.2e-05,172.31.36.0-255,66,219,7,392605
27600,3.9e-05,74.125.24.0-255,1484,1703,7,392605
27601,4.3e-05,172.31.36.0-255,66,1769,7,392605
27602,4.9e-05,74.125.24.0-255,2902,4671,7,392605
27603,5.1e-05,172.31.36.0-255,66,4737,7,392605
27604,5.8e-05,74.125.24.0-255,7156,11893,7,392605
27605,6.1e-05,172.31.36.0-255,66,11959,7,392605
27606,6.6e-05,74.125.24.0-255,2067,14026,7,392605
27607,6.8e-05,172.31.36.0-255,66,14092,7,392605
27608,0.000265,74.125.24.0-255,1484,15576,7,392605
27609,0.000271,172.31.36.0-255,66,15642,7,392605
27610,0.000276,74.125.24.0-255,2902,18544,7,392605
27611,0.000279,172.31.36.0-255,66,18610,7,392605
27612,0.000305,74.125.24.0-255,5738,24348,7,392605
27613,0.000308,172.31.36.0-255,66,24414,7,392605
27614,0.000311,74.125.24.0-255,1484,25898,7,392605
27615,0.000313,172.31.36.0-255,66,25964,7,392605
27616,0.000336,74.125.24.0-255,5379,31343,7,392605
27617,0.00034,172.31.36.0-255,66,31409,7,392605
27618,0.000374,74.125.24.0-255,2902,34311,7,392605
27619,0.000377,172.31.36.0-255,66,34377,7,392605
27620,0.0004,74.125.24.0-255,5738,40115,7,392605
27621,0.000404,172.31.36.0-255,66,40181,7,392605
27622,0.000429,74.125.24.0-255,5738,45919,7,392605
27623,0.000433,74.125.24.0-255,2543,48462,7,392605
27624,0.000436,172.31.36.0-255,66,48528,7,392605
27625,0.000439,172.31.36.0-255,66,48594,7,392605
27626,0.000701,74.125.24.0-255,1484,50078,7,392605
27627,0.000708,172.31.36.0-255,66,50144,7,392605
27628,0.000713,74.125.24.0-255,2902,53046,7,392605
27629,0.000715,172.31.36.0-255,66,53112,7,392605
27630,0.000743,74.125.24.0-255,4320,57432,7,392605
27631,0.000753,172.31.36.0-255,66,57498,7,392605
27632,0.000771,74.125.24.0-255,2902,60400,7,392605
27633,0.000781,172.31.36.0-255,66,60466,7,392605
27634,0.000795,74.125.24.0-255,6797,67263,7,392605
27635,0.000798,74.125.24.0-255,1484,68747,7,392605
27636,0.00081,172.31.36.0-255,66,68813,7,392605
27637,0.000821,74.125.24.0-255,2902,71715,7,392605
27638,0.000824,74.125.24.0-255,1125,72840,7,392605
27639,0.000824,172.31.36.0-255,66,72906,7,392605
27640,0.000868,74.125.24.0-255,2064,74970,7,392605
27641,0.000873,74.125.24.0-255,2902,77872,7,392605
27642,0.000873,172.31.36.0-255,66,77938,7,392605
27643,0.000878,172.31.36.0-255,66,78004,7,392605
27644,0.000895,74.125.24.0-255,7156,85160,7,392605
27645,0.000908,172.31.36.0-255,66,85226,7,392605
27646,0.000927,74.125.24.0-255,2902,88128,7,392605
27647,0.00093,172.31.36.0-255,66,88194,7,392605
27648,0.000949,74.125.24.0-255,2543,90737,7,392605
27649,0.000956,172.31.36.0-255,66,90803,7,392605
27650,0.001114,74.125.24.0-255,1484,92287,7,392605
27651,0.001138,74.125.24.0-255,2902,95189,7,392605
27652,0.001141,172.31.36.0-255,66,95255,7,392605
27653,0.001148,74.125.24.0-255,5738,100993,7,392605
27654,0.001155,172.31.36.0-255,66,101059,7,392605
27655,0.001172,74.125.24.0-255,1484,102543,7,392605
27656,0.001193,74.125.24.0-255,4816,107359,7,392605
27657,0.001205,172.31.36.0-255,66,107425,7,392605
27658,0.00132,74.125.24.0-255,1484,108909,7,392605
27659,0.001326,74.125.24.0-255,2902,111811,7,392605
27660,0.001328,172.31.36.0-255,66,111877,7,392605
27661,0.001351,74.125.24.0-255,5738,117615,7,392605
27662,0.001355,172.31.36.0-255,66,117681,7,392605
27663,0.001364,74.125.24.0-255,1484,119165,7,392605
27664,0.001386,74.125.24.0-255,2902,122067,7,392605
27665,0.00139,172.31.36.0-255,66,122133,7,392605
27666,0.001403,74.125.24.0-255,7156,129289,7,392605
27667,0.001407,172.31.36.0-255,66,129355,7,392605
27668,0.001415,74.125.24.0-255,1484,130839,7,392605
27669,0.001419,74.125.24.0-255,4320,135159,7,392605
27670,0.00143,172.31.36.0-255,66,135225,7,392605
27671,0.001436,74.125.24.0-255,1484,136709,7,392605
27672,0.001447,74.125.24.0-255,1484,138193,7,392605
27673,0.001457,172.31.36.0-255,66,138259,7,392605
27674,0.001463,74.125.24.0-255,3602,141861,7,392605
27675,0.001473,172.31.36.0-255,66,141927,7,392605
27676,0.001777,74.125.24.0-255,1484,143411,7,392605
27677,0.001788,74.125.24.0-255,2902,146313,7,392605
27678,0.001791,172.31.36.0-255,66,146379,7,392605
27679,0.00182,74.125.24.0-255,5738,152117,7,392605
27680,0.001855,74.125.24.0-255,4320,156437,7,392605
27681,0.001862,74.125.24.0-255,5738,162175,7,392605
27682,0.001868,172.31.36.0-255,66,162241,7,392605
27683,0.001881,74.125.24.0-255,3988,166229,7,392605
27684,0.001887,172.31.36.0-255,66,166295,7,392605
27685,0.001932,74.125.24.0-255,4320,170615,7,392605
27686,0.001936,74.125.24.0-255,1484,172099,7,392605
27687,0.001951,74.125.24.0-255,2902,175001,7,392605
27688,0.001957,74.125.24.0-255,5738,180739,7,392605
27689,0.001975,74.125.24.0-255,4320,185059,7,392605
27690,0.001983,172.31.36.0-255,66,185125,7,392605
27691,0.002005,172.31.36.0-255,66,185191,7,392605
27692,0.002015,74.125.24.0-255,3602,188793,7,392605
27693,0.002049,172.31.36.0-255,66,188859,7,392605
27694,0.004053,74.125.24.0-255,1484,190343,7,392605
27695,0.004099,74.125.24.0-255,4320,194663,7,392605
27696,0.004104,172.31.36.0-255,66,194729,7,392605
27697,0.00611,74.125.24.0-255,4320,199049,7,392605
27698,0.006114,172.31.36.0-255,66,199115,7,392605
27699,0.006134,74.125.24.0-255,1484,200599,7,392605
27700,0.008153,74.125.24.0-255,4320,204919,7,392605
27701,0.00816,172.31.36.0-255,66,204985,7,392605
27702,0.010202,74.125.24.0-255,5738,210723,7,392605
27703,0.010209,172.31.36.0-255,66,210789,7,392605
27704,0.012234,74.125.24.0-255,5738,216527,7,392605
27705,0.012241,172.31.36.0-255,66,216593,7,392605
27706,0.014306,74.125.24.0-255,5738,222331,7,392605
27707,0.014315,172.31.36.0-255,66,222397,7,392605
27708,0.016318,74.125.24.0-255,5738,228135,7,392605
27709,0.016325,172.31.36.0-255,66,228201,7,392605
27710,0.018325,74.125.24.0-255,5738,233939,7,392605
27711,0.018332,172.31.36.0-255,66,234005,7,392605
27712,0.020377,74.125.24.0-255,5738,239743,7,392605
27713,0.020383,172.31.36.0-255,66,239809,7,392605
27714,0.022387,74.125.24.0-255,5738,245547,7,392605
27715,0.022394,172.31.36.0-255,66,245613,7,392605
27716,0.024429,74.125.24.0-255,5738,251351,7,392605
27717,0.024436,172.31.36.0-255,66,251417,7,392605
27718,0.026426,74.125.24.0-255,2902,254319,7,392605
27719,0.026433,172.31.36.0-255,66,254385,7,392605
27720,0.026492,74.125.24.0-255,2902,257287,7,392605
27721,0.026497,172.31.36.0-255,66,257353,7,392605
27722,0.028441,74.125.24.0-255,2902,260255,7,392605
27723,0.028448,172.31.36.0-255,66,260321,7,392605
27724,0.028473,74.125.24.0-255,2902,263223,7,392605
27725,0.028476,172.31.36.0-255,66,263289,7,392605
27726,0.030456,74.125.24.0-255,2902,266191,7,392605
27727,0.030458,172.31.36.0-255,176,266367,7,392605
27728,0.030461,172.31.36.0-255,66,266433,7,392605
27729,0.030489,74.125.24.0-255,2902,269335,7,392605
27730,0.030492,172.31.36.0-255,66,269401,7,392605
27731,0.030496,172.31.36.0-255,1113,270514,7,392605
27732,0.030536,172.31.36.0-255,566,271080,7,392605
27733,0.032017,104.244.42.0-255,66,271146,7,392605
27734,0.032025,104.244.42.0-255,66,271212,7,392605
27735,0.032074,104.244.42.0-255,66,271278,7,392605
27736,0.032473,74.125.24.0-255,2902,274180,7,392605
27737,0.032479,172.31.36.0-255,66,274246,7,392605
27738,0.032501,74.125.24.0-255,2902,277148,7,392605
27739,0.032504,172.31.36.0-255,66,277214,7,392605
27740,0.034501,74.125.24.0-255,5738,282952,7,392605
27741,0.034507,172.31.36.0-255,66,283018,7,392605
27742,0.036557,74.125.24.0-255,5738,288756,7,392605
27743,0.036563,172.31.36.0-255,66,288822,7,392605
27744,0.038641,74.125.24.0-255,5738,294560,7,392605
27745,0.038646,172.31.36.0-255,66,294626,7,392605
27746,0.040667,74.125.24.0-255,5738,300364,7,392605
27747,0.040673,172.31.36.0-255,66,300430,7,392605
27748,0.042804,74.125.24.0-255,5738,306168,7,392605
27749,0.042809,172.31.36.0-255,66,306234,7,392605
27750,0.044859,74.125.24.0-255,4320,310554,7,392605
27751,0.044881,172.31.36.0-255,66,310620,7,392605
27752,0.044896,74.125.24.0-255,1484,312104,7,392605
27753,0.046909,74.125.24.0-255,4320,316424,7,392605
27754,0.046914,172.31.36.0-255,66,316490,7,392605
27755,0.048925,74.125.24.0-255,5738,322228,7,392605
27756,0.048931,172.31.36.0-255,66,322294,7,392605
27757,0.050945,74.125.24.0-255,4320,326614,7,392605
27758,0.050951,172.31.36.0-255,66,326680,7,392605
27759,0.050973,74.125.24.0-255,1484,328164,7,392605
27760,0.052978,74.125.24.0-255,4320,332484,7,392605
27761,0.052984,172.31.36.0-255,66,332550,7,392605
27762,0.054985,74.125.24.0-255,5738,338288,7,392605
27763,0.054991,172.31.36.0-255,66,338354,7,392605
27764,0.057018,74.125.24.0-255,5738,344092,7,392605
27765,0.057023,172.31.36.0-255,66,344158,7,392605
27766,0.059049,74.125.24.0-255,5738,349896,7,392605
27767,0.059055,172.31.36.0-255,66,349962,7,392605
27768,0.061065,74.125.24.0-255,5738,355700,7,392605
27769,0.06107,172.31.36.0-255,66,355766,7,392605
27770,0.063081,74.125.24.0-255,5738,361504,7,392605
27771,0.063086,172.31.36.0-255,66,361570,7,392605
27772,0.0651,74.125.24.0-255,5738,367308,7,392605
27773,0.065105,172.31.36.0-255,66,367374,7,392605
27774,0.067118,74.125.24.0-255,1484,368858,7,392605
27775,0.067145,74.125.24.0-255,4320,373178,7,392605
27776,0.067148,172.31.36.0-255,66,373244,7,392605
27777,0.069144,74.125.24.0-255,5738,378982,7,392605
27778,0.069148,172.31.36.0-255,66,379048,7,392605
27779,0.071172,74.125.24.0-255,2902,381950,7,392605
27780,0.071176,172.31.36.0-255,66,382016,7,392605
27781,0.071209,74.125.24.0-255,2902,384918,7,392605
27782,0.071211,172.31.36.0-255,66,384984,7,392605
27783,0.073177,74.125.24.0-255,2902,387886,7,392605
27784,0.073182,172.31.36.0-255,66,387952,7,392605
27785,0.073211,74.125.24.0-255,2902,390854,7,392605
27786,0.073214,172.31.36.0-255,66,390920,7,392605
27787,0.075175,74.125.24.0-255,1448,392368,7,392605
27788,0.075306,172.31.36.0-255,66,392434,7,392605
27789,0.07533,172.31.36.0-255,105,392539,7,392605
27790,0.077294,74.125.24.0-255,66,392605,7,392605
27791,0.0,74.125.24.0-255,153,153,7,244749
27792,2.5e-05,172.31.36.0-255,66,219,7,244749
27793,3.3e-05,74.125.24.0-255,1484,1703,7,244749
27794,3.7e-05,172.31.36.0-255,66,1769,7,244749
27795,4.3e-05,74.125.24.0-255,2902,4671,7,244749
27796,4.7e-05,172.31.36.0-255,66,4737,7,244749
27797,5.4e-05,74.125.24.0-255,7156,11893,7,244749
27798,5.8e-05,172.31.36.0-255,66,11959,7,244749
27799,6.2e-05,74.125.24.0-255,2121,14080,7,244749
27800,6.5e-05,172.31.36.0-255,66,14146,7,244749
27801,0.000108,172.31.36.0-255,66,14212,7,244749
27802,0.000115,74.125.24.0-255,5379,19591,7,244749
27803,0.000117,172.31.36.0-255,66,19657,7,244749
27804,0.000202,74.125.24.0-255,1484,21141,7,244749
27805,0.000205,172.31.36.0-255,66,21207,7,244749
27806,0.000226,74.125.24.0-255,2902,24109,7,244749
27807,0.000228,172.31.36.0-255,66,24175,7,244749
27808,0.000235,74.125.24.0-255,5738,29913,7,244749
27809,0.000238,172.31.36.0-255,66,29979,7,244749
27810,0.00026,172.31.36.0-255,66,30045,7,244749
27811,0.000279,74.125.24.0-255,4320,34365,7,244749
27812,0.000281,172.31.36.0-255,66,34431,7,244749
27813,0.000284,74.125.24.0-255,1484,35915,7,244749
27814,0.000286,172.31.36.0-255,66,35981,7,244749
27815,0.000326,74.125.24.0-255,4320,40301,7,244749
27816,0.000329,172.31.36.0-255,66,40367,7,244749
27817,0.000353,74.125.24.0-255,5311,45678,7,244749
27818,0.000356,172.31.36.0-255,66,45744,7,244749
27819,0.000359,74.125.24.0-255,134,45878,7,244749
27820,0.000362,172.31.36.0-255,66,45944,7,244749
27821,0.000514,74.125.24.0-255,1484,47428,7,244749
27822,0.00053,74.125.24.0-255,2902,50330,7,244749
27823,0.000559,74.125.24.0-255,4320,54650,7,244749
27824,0.000565,172.31.36.0-255,66,54716,7,244749
27825,0.000573,74.125.24.0-255,1484,56200,7,244749
27826,0.000579,172.31.36.0-255,66,56266,7,244749
27827,0.000605,74.125.24.0-255,7156,63422,7,244749
27828,0.000619,172.31.36.0-255,66,63488,7,244749
27829,0.000625,74.125.24.0-255,5738,69226,7,244749
27830,0.000641,172.31.36.0-255,66,69292,7,244749
27831,0.0008,74.125.24.0-255,1484,70776,7,244749
27832,0.000806,74.125.24.0-255,2902,73678,7,244749
27833,0.000814,172.31.36.0-255,66,73744,7,244749
27834,0.000826,74.125.24.0-255,5738,79482,7,244749
27835,0.000831,172.31.36.0-255,66,79548,7,244749
27836,0.00088,74.125.24.0-255,5738,85286,7,244749
27837,0.000889,172.31.36.0-255,66,85352,7,244749
27838,0.000925,74.125.24.0-255,4320,89672,7,244749
27839,0.000933,172.31.36.0-255,66,89738,7,244749
27840,0.001064,74.125.24.0-255,7156,96894,7,244749
27841,0.001074,172.31.36.0-255,66,96960,7,244749
27842,0.001086,74.125.24.0-255,5020,101980,7,244749
27843,0.001107,172.31.36.0-255,66,102046,7,244749
27844,0.001116,74.125.24.0-255,2902,104948,7,244749
27845,0.001121,172.31.36.0-255,66,105014,7,244749
27846,0.001131,74.125.24.0-255,2902,107916,7,244749
27847,0.001136,74.125.24.0-255,4320,112236,7,244749
27848,0.001152,74.125.24.0-255,2902,115138,7,244749
27849,0.001157,74.125.24.0-255,4320,119458,7,244749
27850,0.001167,172.31.36.0-255,66,119524,7,244749
27851,0.001194,74.125.24.0-255,4320,123844,7,244749
27852,0.001212,74.125.24.0-255,2184,126028,7,244749
27853,0.001221,172.31.36.0-255,66,126094,7,244749
27854,0.001247,74.125.24.0-255,1484,127578,7,244749
27855,0.001252,74.125.24.0-255,2902,130480,7,244749
27856,0.00126,172.31.36.0-255,66,130546,7,244749
27857,0.001294,74.125.24.0-255,5738,136284,7,244749
27858,0.001339,74.125.24.0-255,2902,139186,7,244749
27859,0.00144,74.125.24.0-255,1484,140670,7,244749
27860,0.001445,74.125.24.0-255,2902,143572,7,244749
27861,0.001466,74.125.24.0-255,5738,149310,7,244749
27862,0.001469,74.125.24.0-255,1484,150794,7,244749
27863,0.001509,74.125.24.0-255,1484,152278,7,244749
27864,0.001531,74.125.24.0-255,766,153044,7,244749
27865,0.001608,74.125.24.0-255,1484,154528,7,244749
27866,0.001612,74.125.24.0-255,1484,156012,7,244749
27867,0.001628,74.125.24.0-255,1484,157496,7,244749
27868,0.001636,74.125.24.0-255,5738,163234,7,244749
27869,0.001641,74.125.24.0-255,4320,167554,7,244749
27870,0.001657,74.125.24.0-255,1484,169038,7,244749
27871,0.001663,74.125.24.0-255,4320,173358,7,244749
27872,0.001693,74.125.24.0-255,5020,178378,7,244749
27873,0.001802,74.125.24.0-255,1484,179862,7,244749
27874,0.001845,74.125.24.0-255,1484,181346,7,244749
27875,0.001863,74.125.24.0-255,1484,182830,7,244749
27876,0.00187,74.125.24.0-255,5738,188568,7,244749
27877,0.001894,74.125.24.0-255,4320,192888,7,244749
27878,0.005236,172.31.36.0-255,66,192954,7,244749
27879,0.007343,74.125.24.0-255,5738,198692,7,244749
27880,0.007351,172.31.36.0-255,66,198758,7,244749
27881,0.009394,74.125.24.0-255,5738,204496,7,244749
27882,0.009401,172.31.36.0-255,66,204562,7,244749
27883,0.011484,74.125.24.0-255,4320,208882,7,244749
27884,0.011503,74.125.24.0-255,1484,210366,7,244749
27885,0.01175,172.31.36.0-255,66,210432,7,244749
27886,0.013803,74.125.24.0-255,5738,216170,7,244749
27887,0.01381,172.31.36.0-255,66,216236,7,244749
27888,0.015889,74.125.24.0-255,5738,221974,7,244749
27889,0.017399,172.31.36.0-255,66,222040,7,244749
27890,0.019463,74.125.24.0-255,5738,227778,7,244749
27891,0.019476,172.31.36.0-255,66,227844,7,244749
27892,0.021535,74.125.24.0-255,5738,233582,7,244749
27893,0.021546,172.31.36.0-255,66,233648,7,244749
27894,0.023614,74.125.24.0-255,4667,238315,7,244749
27895,0.023626,172.31.36.0-255,66,238381,7,244749
27896,0.023827,172.31.36.0-255,105,238486,7,244749
27897,0.025847,74.125.24.0-255,66,238552,7,244749
27898,0.035086,172.31.36.0-255,164,238716,7,244749
27899,0.03512,172.31.36.0-255,1122,239838,7,244749
27900,0.035185,172.31.36.0-255,1514,241352,7,244749
27901,0.035187,172.31.36.0-255,1514,242866,7,244749
27902,0.035188,172.31.36.0-255,1514,244380,7,244749
27903,0.035189,172.31.36.0-255,105,244485,7,244749
27904,0.036626,104.244.42.0-255,66,244551,7,244749
27905,0.036678,104.244.42.0-255,66,244617,7,244749
27906,0.036772,104.244.42.0-255,66,244683,7,244749
27907,0.036776,104.244.42.0-255,66,244749,7,244749
27908,0.0,31.13.82.0-255,105,105,7,171
27909,2.5e-05,172.31.36.0-255,66,171,7,171
27910,0.0,172.217.194.0-255,153,153,7,247037
27911,2.5e-05,172.31.36.0-255,66,219,7,247037
27912,3.2e-05,172.217.194.0-255,1484,1703,7,247037
27913,3.6e-05,172.31.36.0-255,66,1769,7,247037
27914,4.1e-05,172.217.194.0-255,2902,4671,7,247037
27915,4.3e-05,172.31.36.0-255,66,4737,7,247037
27916,4.9e-05,172.217.194.0-255,4320,9057,7,247037
27917,5.1e-05,172.31.36.0-255,66,9123,7,247037
27918,7.4e-05,172.217.194.0-255,5738,14861,7,247037
27919,7.7e-05,172.31.36.0-255,66,14927,7,247037
27920,0.0001,172.217.194.0-255,3477,18404,7,247037
27921,0.000102,172.31.36.0-255,66,18470,7,247037
27922,0.000115,172.31.36.0-255,66,18536,7,247037
27923,0.000155,172.217.194.0-255,1484,20020,7,247037
27924,0.000158,172.31.36.0-255,66,20086,7,247037
27925,0.000164,172.217.194.0-255,2902,22988,7,247037
27926,0.000166,172.31.36.0-255,66,23054,7,247037
27927,0.000192,172.217.194.0-255,5738,28792,7,247037
27928,0.000195,172.31.36.0-255,66,28858,7,247037
27929,0.000203,172.217.194.0-255,6797,35655,7,247037
27930,0.000206,172.31.36.0-255,66,35721,7,247037
27931,0.000238,172.31.36.0-255,66,35787,7,247037
27932,0.00027,172.217.194.0-255,2902,38689,7,247037
27933,0.000274,172.31.36.0-255,66,38755,7,247037
27934,0.000278,172.217.194.0-255,2847,41602,7,247037
27935,0.00028,172.31.36.0-255,66,41668,7,247037
27936,0.000577,172.217.194.0-255,383,42051,7,247037
27937,0.000581,172.31.36.0-255,66,42117,7,247037
27938,0.000723,172.217.194.0-255,1484,43601,7,247037
27939,0.000727,172.31.36.0-255,66,43667,7,247037
27940,0.000733,172.217.194.0-255,2902,46569,7,247037
27941,0.000735,172.31.36.0-255,66,46635,7,247037
27942,0.000738,172.217.194.0-255,1484,48119,7,247037
27943,0.000764,172.217.194.0-255,4320,52439,7,247037
27944,0.000767,172.31.36.0-255,66,52505,7,247037
27945,0.000773,172.217.194.0-255,5738,58243,7,247037
27946,0.000778,172.31.36.0-255,66,58309,7,247037
27947,0.00078,172.217.194.0-255,5738,64047,7,247037
27948,0.000782,172.31.36.0-255,66,64113,7,247037
27949,0.000808,172.217.194.0-255,7156,71269,7,247037
27950,0.000812,172.31.36.0-255,66,71335,7,247037
27951,0.000825,172.217.194.0-255,2902,74237,7,247037
27952,0.000827,172.31.36.0-255,66,74303,7,247037
27953,0.000845,172.217.194.0-255,2184,76487,7,247037
27954,0.000848,172.31.36.0-255,66,76553,7,247037
27955,0.001309,172.217.194.0-255,1484,78037,7,247037
27956,0.001319,172.217.194.0-255,2902,80939,7,247037
27957,0.001323,172.31.36.0-255,66,81005,7,247037
27958,0.001331,172.217.194.0-255,5738,86743,7,247037
27959,0.001334,172.31.36.0-255,66,86809,7,247037
27960,0.001351,172.217.194.0-255,7156,93965,7,247037
27961,0.001354,172.31.36.0-255,66,94031,7,247037
27962,0.001379,172.217.194.0-255,5738,99769,7,247037
27963,0.001382,172.31.36.0-255,66,99835,7,247037
27964,0.001394,172.31.36.0-255,66,99901,7,247037
27965,0.001835,172.217.194.0-255,1484,101385,7,247037
27966,0.001844,172.217.194.0-255,2902,104287,7,247037
27967,0.001848,172.31.36.0-255,66,104353,7,247037
27968,0.001857,172.217.194.0-255,5738,110091,7,247037
27969,0.001861,172.31.36.0-255,66,110157,7,247037
27970,0.001866,172.217.194.0-255,2902,113059,7,247037
27971,0.001868,172.31.36.0-255,66,113125,7,247037
27972,0.001902,172.31.36.0-255,66,113191,7,247037
27973,0.001919,172.217.194.0-255,2902,116093,7,247037
27974,0.001922,172.31.36.0-255,66,116159,7,247037
27975,0.001941,172.31.36.0-255,66,116225,7,247037
27976,0.002024,172.217.194.0-255,1484,117709,7,247037
27977,0.002027,172.217.194.0-255,1484,119193,7,247037
27978,0.00203,172.31.36.0-255,66,119259,7,247037
27979,0.002049,172.217.194.0-255,1484,120743,7,247037
27980,0.002055,172.217.194.0-255,5738,126481,7,247037
27981,0.002058,172.31.36.0-255,66,126547,7,247037
27982,0.002062,172.217.194.0-255,2902,129449,7,247037
27983,0.002063,172.31.36.0-255,66,129515,7,247037
27984,0.002085,172.31.36.0-255,66,129581,7,247037
27985,0.002096,172.31.36.0-255,66,129647,7,247037
27986,0.002114,172.217.194.0-255,766,130413,7,247037
27987,0.002144,172.217.194.0-255,1484,131897,7,247037
27988,0.002146,172.31.36.0-255,66,131963,7,247037
27989,0.00215,172.217.194.0-255,1484,133447,7,247037
27990,0.002165,172.217.194.0-255,2902,136349,7,247037
27991,0.002168,172.31.36.0-255,66,136415,7,247037
27992,0.002173,172.217.194.0-255,4320,140735,7,247037
27993,0.002175,172.31.36.0-255,66,140801,7,247037
27994,0.002191,172.217.194.0-255,5738,146539,7,247037
27995,0.002194,172.31.36.0-255,66,146605,7,247037
27996,0.002196,172.217.194.0-255,1484,148089,7,247037
27997,0.002202,172.217.194.0-255,5738,153827,7,247037
27998,0.002204,172.31.36.0-255,66,153893,7,247037
27999,0.002223,172.217.194.0-255,7156,161049,7,247037
28000,0.002225,172.31.36.0-255,66,161115,7,247037
28001,0.002229,172.217.194.0-255,3602,164717,7,247037
28002,0.002231,172.31.36.0-255,66,164783,7,247037
28003,0.00233,172.217.194.0-255,1484,166267,7,247037
28004,0.002333,172.217.194.0-255,1484,167751,7,247037
28005,0.002335,172.31.36.0-255,66,167817,7,247037
28006,0.002353,172.217.194.0-255,1484,169301,7,247037
28007,0.002358,172.217.194.0-255,5738,175039,7,247037
28008,0.002361,172.31.36.0-255,66,175105,7,247037
28009,0.002383,172.217.194.0-255,5738,180843,7,247037
28010,0.002385,172.31.36.0-255,66,180909,7,247037
28011,0.002388,172.217.194.0-255,1484,182393,7,247037
28012,0.002391,172.217.194.0-255,1484,183877,7,247037
28013,0.002392,172.31.36.0-255,66,183943,7,247037
28014,0.002419,172.217.194.0-255,7156,191099,7,247037
28015,0.002422,172.31.36.0-255,66,191165,7,247037
28016,0.002434,172.217.194.0-255,4320,195485,7,247037
28017,0.002436,172.31.36.0-255,66,195551,7,247037
28018,0.002451,172.217.194.0-255,3602,199153,7,247037
28019,0.002453,172.31.36.0-255,66,199219,7,247037
28020,0.00247,172.217.194.0-255,4320,203539,7,247037
28021,0.002472,172.31.36.0-255,66,203605,7,247037
28022,0.002493,172.217.194.0-255,4320,207925,7,247037
28023,0.002495,172.31.36.0-255,66,207991,7,247037
28024,0.0025,172.217.194.0-255,4320,212311,7,247037
28025,0.002502,172.31.36.0-255,66,212377,7,247037
28026,0.002505,172.217.194.0-255,1484,213861,7,247037
28027,0.00252,172.217.194.0-255,5738,219599,7,247037
28028,0.002522,172.31.36.0-255,66,219665,7,247037
28029,0.002552,172.31.36.0-255,66,219731,7,247037
28030,0.002558,172.217.194.0-255,6438,226169,7,247037
28031,0.002561,172.31.36.0-255,66,226235,7,247037
28032,0.002575,172.217.194.0-255,1484,227719,7,247037
28033,0.002611,172.31.36.0-255,66,227785,7,247037
28034,0.002622,172.31.36.0-255,66,227851,7,247037
28035,0.002695,172.31.36.0-255,66,227917,7,247037
28036,0.0027,172.217.194.0-255,4320,232237,7,247037
28037,0.002702,172.31.36.0-255,66,232303,7,247037
28038,0.002726,172.31.36.0-255,66,232369,7,247037
28039,0.002742,172.31.36.0-255,66,232435,7,247037
28040,0.002757,172.31.36.0-255,66,232501,7,247037
28041,0.002761,172.217.194.0-255,4320,236821,7,247037
28042,0.002763,172.31.36.0-255,66,236887,7,247037
28043,0.002787,172.217.194.0-255,5452,242339,7,247037
28044,0.002789,172.31.36.0-255,66,242405,7,247037
28045,0.002792,172.217.194.0-255,105,242510,7,247037
28046,0.00697,172.31.36.0-255,66,242576,7,247037
28047,0.006996,172.31.36.0-255,105,242681,7,247037
28048,0.009224,172.217.194.0-255,66,242747,7,247037
28049,0.03271,172.31.36.0-255,172,242919,7,247037
28050,0.032741,172.31.36.0-255,1115,244034,7,247037
28051,0.032781,172.31.36.0-255,1514,245548,7,247037
28052,0.032783,172.31.36.0-255,1291,246839,7,247037
28053,0.034206,104.244.42.0-255,66,246905,7,247037
28054,0.034242,104.244.42.0-255,66,246971,7,247037
28055,0.034313,104.244.42.0-255,66,247037,7,247037
28056,0.0,172.217.194.0-255,153,153,7,314051
28057,3.6e-05,172.31.36.0-255,66,219,7,314051
28058,4.5e-05,172.217.194.0-255,1484,1703,7,314051
28059,4.9e-05,172.31.36.0-255,66,1769,7,314051
28060,5.4e-05,172.217.194.0-255,2902,4671,7,314051
28061,5.6e-05,172.31.36.0-255,66,4737,7,314051
28062,6.3e-05,172.217.194.0-255,4320,9057,7,314051
28063,6.8e-05,172.31.36.0-255,66,9123,7,314051
28064,7.4e-05,172.217.194.0-255,4808,13931,7,314051
28065,7.6e-05,172.31.36.0-255,66,13997,7,314051
28066,0.000107,172.217.194.0-255,4320,18317,7,314051
28067,0.00011,172.31.36.0-255,66,18383,7,314051
28068,0.000126,172.217.194.0-255,5738,24121,7,314051
28069,0.000129,172.31.36.0-255,66,24187,7,314051
28070,0.000158,172.217.194.0-255,6797,30984,7,314051
28071,0.000161,172.31.36.0-255,66,31050,7,314051
28072,0.000311,172.217.194.0-255,1484,32534,7,314051
28073,0.000315,172.31.36.0-255,66,32600,7,314051
28074,0.000321,172.217.194.0-255,2902,35502,7,314051
28075,0.000323,172.31.36.0-255,66,35568,7,314051
28076,0.000329,172.217.194.0-255,2902,38470,7,314051
28077,0.000331,172.31.36.0-255,66,38536,7,314051
28078,0.000347,172.217.194.0-255,2902,41438,7,314051
28079,0.00035,172.31.36.0-255,66,41504,7,314051
28080,0.000356,172.217.194.0-255,4320,45824,7,314051
28081,0.000359,172.31.36.0-255,66,45890,7,314051
28082,0.000377,172.217.194.0-255,2543,48433,7,314051
28083,0.000379,172.31.36.0-255,66,48499,7,314051
28084,0.000392,172.217.194.0-255,1484,49983,7,314051
28085,0.000394,172.31.36.0-255,66,50049,7,314051
28086,0.000435,172.31.36.0-255,66,50115,7,314051
28087,0.00044,172.217.194.0-255,2811,52926,7,314051
28088,0.000443,172.31.36.0-255,66,52992,7,314051
28089,0.00071,172.217.194.0-255,387,53379,7,314051
28090,0.000714,172.31.36.0-255,66,53445,7,314051
28091,0.00087,172.217.194.0-255,1484,54929,7,314051
28092,0.000874,172.31.36.0-255,66,54995,7,314051
28093,0.00089,172.217.194.0-255,2902,57897,7,314051
28094,0.000896,172.31.36.0-255,66,57963,7,314051
28095,0.00092,172.217.194.0-255,5738,63701,7,314051
28096,0.000923,172.31.36.0-255,66,63767,7,314051
28097,0.000952,172.31.36.0-255,66,63833,7,314051
28098,0.00097,172.217.194.0-255,1484,65317,7,314051
28099,0.000973,172.31.36.0-255,66,65383,7,314051
28100,0.000988,172.31.36.0-255,66,65449,7,314051
28101,0.001979,172.217.194.0-255,1484,66933,7,314051
28102,0.001986,172.31.36.0-255,66,66999,7,314051
28103,0.001995,172.217.194.0-255,2902,69901,7,314051
28104,0.001998,172.31.36.0-255,66,69967,7,314051
28105,0.002001,172.217.194.0-255,1484,71451,7,314051
28106,0.002003,172.31.36.0-255,66,71517,7,314051
28107,0.002024,172.217.194.0-255,4320,75837,7,314051
28108,0.002027,172.31.36.0-255,66,75903,7,314051
28109,0.002032,172.217.194.0-255,5738,81641,7,314051
28110,0.002034,172.31.36.0-255,66,81707,7,314051
28111,0.002053,172.217.194.0-255,7156,88863,7,314051
28112,0.002054,172.31.36.0-255,66,88929,7,314051
28113,0.00208,172.217.194.0-255,5738,94667,7,314051
28114,0.002082,172.31.36.0-255,66,94733,7,314051
28115,0.002088,172.217.194.0-255,5020,99753,7,314051
28116,0.00209,172.31.36.0-255,66,99819,7,314051
28117,0.002264,172.217.194.0-255,1484,101303,7,314051
28118,0.002266,172.31.36.0-255,66,101369,7,314051
28119,0.002293,172.217.194.0-255,2902,104271,7,314051
28120,0.002295,172.31.36.0-255,66,104337,7,314051
28121,0.002313,172.217.194.0-255,1484,105821,7,314051
28122,0.002314,172.31.36.0-255,66,105887,7,314051
28123,0.002328,172.217.194.0-255,4320,110207,7,314051
28124,0.00233,172.31.36.0-255,66,110273,7,314051
28125,0.002361,172.31.36.0-255,66,110339,7,314051
28126,0.00238,172.217.194.0-255,1484,111823,7,314051
28127,0.002382,172.31.36.0-255,66,111889,7,314051
28128,0.00241,172.31.36.0-255,66,111955,7,314051
28129,0.002431,172.217.194.0-255,5738,117693,7,314051
28130,0.002433,172.31.36.0-255,66,117759,7,314051
28131,0.002457,172.31.36.0-255,66,117825,7,314051
28132,0.002462,172.217.194.0-255,4320,122145,7,314051
28133,0.002464,172.31.36.0-255,66,122211,7,314051
28134,0.002498,172.31.36.0-255,66,122277,7,314051
28135,0.002501,172.217.194.0-255,766,123043,7,314051
28136,0.002503,172.31.36.0-255,66,123109,7,314051
28137,0.002525,172.217.194.0-255,1484,124593,7,314051
28138,0.002527,172.31.36.0-255,66,124659,7,314051
28139,0.002547,172.217.194.0-255,2902,127561,7,314051
28140,0.002549,172.31.36.0-255,66,127627,7,314051
28141,0.002555,172.217.194.0-255,5738,133365,7,314051
28142,0.002557,172.31.36.0-255,66,133431,7,314051
28143,0.00256,172.217.194.0-255,1484,134915,7,314051
28144,0.002561,172.31.36.0-255,66,134981,7,314051
28145,0.005059,172.217.194.0-255,4320,139301,7,314051
28146,0.005063,172.31.36.0-255,66,139367,7,314051
28147,0.005078,172.217.194.0-255,1484,140851,7,314051
28148,0.00508,172.31.36.0-255,66,140917,7,314051
28149,0.007542,172.217.194.0-255,4320,145237,7,314051
28150,0.007549,172.31.36.0-255,66,145303,7,314051
28151,0.007602,172.217.194.0-255,1484,146787,7,314051
28152,0.007606,172.31.36.0-255,66,146853,7,314051
28153,0.010051,172.217.194.0-255,4320,151173,7,314051
28154,0.010058,172.31.36.0-255,66,151239,7,314051
28155,0.010085,172.217.194.0-255,1484,152723,7,314051
28156,0.010088,172.31.36.0-255,66,152789,7,314051
28157,0.012638,172.217.194.0-255,4320,157109,7,314051
28158,0.012647,172.31.36.0-255,66,157175,7,314051
28159,0.012678,172.217.194.0-255,1484,158659,7,314051
28160,0.012682,172.31.36.0-255,66,158725,7,314051
28161,0.015236,172.217.194.0-255,5738,164463,7,314051
28162,0.015268,172.31.36.0-255,66,164529,7,314051
28163,0.017814,172.217.194.0-255,5738,170267,7,314051
28164,0.017822,172.31.36.0-255,66,170333,7,314051
28165,0.020335,172.217.194.0-255,5738,176071,7,314051
28166,0.020343,172.31.36.0-255,66,176137,7,314051
28167,0.022879,172.217.194.0-255,5738,181875,7,314051
28168,0.0229,172.31.36.0-255,66,181941,7,314051
28169,0.025444,172.217.194.0-255,5738,187679,7,314051
28170,0.025461,172.31.36.0-255,66,187745,7,314051
28171,0.027959,172.217.194.0-255,5738,193483,7,314051
28172,0.027975,172.31.36.0-255,66,193549,7,314051
28173,0.030539,172.217.194.0-255,5738,199287,7,314051
28174,0.030551,172.31.36.0-255,66,199353,7,314051
28175,0.033079,172.217.194.0-255,5738,205091,7,314051
28176,0.03309,172.31.36.0-255,66,205157,7,314051
28177,0.035591,172.217.194.0-255,5738,210895,7,314051
28178,0.035597,172.31.36.0-255,66,210961,7,314051
28179,0.038088,172.217.194.0-255,5738,216699,7,314051
28180,0.038094,172.31.36.0-255,66,216765,7,314051
28181,0.040669,172.217.194.0-255,5738,222503,7,314051
28182,0.040676,172.31.36.0-255,66,222569,7,314051
28183,0.042633,172.31.36.0-255,172,222741,7,314051
28184,0.042682,172.31.36.0-255,1114,223855,7,314051
28185,0.042703,172.31.36.0-255,1514,225369,7,314051
28186,0.042704,172.31.36.0-255,1292,226661,7,314051
28187,0.043181,172.217.194.0-255,5738,232399,7,314051
28188,0.043193,172.31.36.0-255,66,232465,7,314051
28189,0.044209,104.244.42.0-255,66,232531,7,314051
28190,0.04425,104.244.42.0-255,66,232597,7,314051
28191,0.044275,104.244.42.0-255,66,232663,7,314051
28192,0.045731,172.217.194.0-255,5738,238401,7,314051
28193,0.04574,172.31.36.0-255,66,238467,7,314051
28194,0.048247,172.217.194.0-255,5738,244205,7,314051
28195,0.048259,172.31.36.0-255,66,244271,7,314051
28196,0.050761,172.217.194.0-255,5738,250009,7,314051
28197,0.050774,172.31.36.0-255,66,250075,7,314051
28198,0.05331,172.217.194.0-255,5738,255813,7,314051
28199,0.053325,172.31.36.0-255,66,255879,7,314051
28200,0.055864,172.217.194.0-255,5738,261617,7,314051
28201,0.055884,172.31.36.0-255,66,261683,7,314051
28202,0.058417,172.217.194.0-255,5738,267421,7,314051
28203,0.058433,172.31.36.0-255,66,267487,7,314051
28204,0.060974,172.217.194.0-255,5738,273225,7,314051
28205,0.06099,172.31.36.0-255,66,273291,7,314051
28206,0.06351,172.217.194.0-255,2902,276193,7,314051
28207,0.063518,172.31.36.0-255,66,276259,7,314051
28208,0.063549,172.217.194.0-255,2902,279161,7,314051
28209,0.063552,172.31.36.0-255,66,279227,7,314051
28210,0.066075,172.217.194.0-255,5738,284965,7,314051
28211,0.066082,172.31.36.0-255,66,285031,7,314051
28212,0.06868,172.217.194.0-255,5738,290769,7,314051
28213,0.068688,172.31.36.0-255,66,290835,7,314051
28214,0.071233,172.217.194.0-255,5738,296573,7,314051
28215,0.07126,172.31.36.0-255,66,296639,7,314051
28216,0.073772,172.217.194.0-255,5738,302377,7,314051
28217,0.073782,172.31.36.0-255,66,302443,7,314051
28218,0.076293,172.217.194.0-255,5738,308181,7,314051
28219,0.076306,172.31.36.0-255,66,308247,7,314051
28220,0.078839,172.217.194.0-255,5738,313985,7,314051
28221,0.078854,172.31.36.0-255,66,314051,7,314051
28222,0.0,172.217.194.0-255,154,154,7,245290
28223,2.2e-05,172.31.36.0-255,66,220,7,245290
28224,3e-05,172.217.194.0-255,1484,1704,7,245290
28225,3.4e-05,172.31.36.0-255,66,1770,7,245290
28226,3.9e-05,172.217.194.0-255,2902,4672,7,245290
28227,4.2e-05,172.31.36.0-255,66,4738,7,245290
28228,5.7e-05,172.217.194.0-255,7156,11894,7,245290
28229,6e-05,172.31.36.0-255,66,11960,7,245290
28230,8.7e-05,172.217.194.0-255,2058,14018,7,245290
28231,9.4e-05,172.31.36.0-255,66,14084,7,245290
28232,0.000122,172.217.194.0-255,2902,16986,7,245290
28233,0.000124,172.31.36.0-255,66,17052,7,245290
28234,0.00013,172.217.194.0-255,4320,21372,7,245290
28235,0.000132,172.31.36.0-255,66,21438,7,245290
28236,0.000145,172.217.194.0-255,7156,28594,7,245290
28237,0.000147,172.31.36.0-255,66,28660,7,245290
28238,0.000175,172.217.194.0-255,1484,30144,7,245290
28239,0.000178,172.31.36.0-255,66,30210,7,245290
28240,0.000181,172.217.194.0-255,1125,31335,7,245290
28241,0.000184,172.31.36.0-255,66,31401,7,245290
28242,0.00021,172.217.194.0-255,5738,37139,7,245290
28243,0.000213,172.31.36.0-255,66,37205,7,245290
28244,0.000244,172.217.194.0-255,5738,42943,7,245290
28245,0.000247,172.31.36.0-255,66,43009,7,245290
28246,0.000289,172.217.194.0-255,5379,48388,7,245290
28247,0.000291,172.31.36.0-255,66,48454,7,245290
28248,0.000323,172.217.194.0-255,7156,55610,7,245290
28249,0.000325,172.31.36.0-255,66,55676,7,245290
28250,0.000351,172.31.36.0-255,66,55742,7,245290
28251,0.000445,172.217.194.0-255,647,56389,7,245290
28252,0.000449,172.31.36.0-255,66,56455,7,245290
28253,0.00062,172.217.194.0-255,1484,57939,7,245290
28254,0.000626,172.217.194.0-255,2902,60841,7,245290
28255,0.000633,172.217.194.0-255,5738,66579,7,245290
28256,0.000659,172.31.36.0-255,66,66645,7,245290
28257,0.000671,172.217.194.0-255,4320,70965,7,245290
28258,0.000681,172.31.36.0-255,66,71031,7,245290
28259,0.000689,172.217.194.0-255,2543,73574,7,245290
28260,0.000714,172.31.36.0-255,66,73640,7,245290
28261,0.000736,172.217.194.0-255,7156,80796,7,245290
28262,0.00076,172.31.36.0-255,66,80862,7,245290
28263,0.000806,172.31.36.0-255,66,80928,7,245290
28264,0.001145,172.217.194.0-255,1484,82412,7,245290
28265,0.001152,172.217.194.0-255,2902,85314,7,245290
28266,0.001155,172.31.36.0-255,66,85380,7,245290
28267,0.001159,172.217.194.0-255,1484,86864,7,245290
28268,0.001189,172.217.194.0-255,4320,91184,7,245290
28269,0.001208,172.217.194.0-255,5738,96922,7,245290
28270,0.001213,172.31.36.0-255,66,96988,7,245290
28271,0.001269,172.217.194.0-255,5738,102726,7,245290
28272,0.001284,172.217.194.0-255,7156,109882,7,245290
28273,0.001293,172.31.36.0-255,66,109948,7,245290
28274,0.001334,172.217.194.0-255,2902,112850,7,245290
28275,0.001345,172.31.36.0-255,66,112916,7,245290
28276,0.001355,172.217.194.0-255,2184,115100,7,245290
28277,0.00136,172.31.36.0-255,66,115166,7,245290
28278,0.001406,172.217.194.0-255,4320,119486,7,245290
28279,0.001416,172.31.36.0-255,66,119552,7,245290
28280,0.001504,172.31.36.0-255,66,119618,7,245290
28281,0.001649,172.217.194.0-255,7156,126774,7,245290
28282,0.00181,172.217.194.0-255,6438,133212,7,245290
28283,0.001928,172.217.194.0-255,2184,135396,7,245290
28284,0.00206,172.217.194.0-255,1484,136880,7,245290
28285,0.002068,172.217.194.0-255,2902,139782,7,245290
28286,0.002082,172.217.194.0-255,2902,142684,7,245290
28287,0.002102,172.217.194.0-255,2902,145586,7,245290
28288,0.00213,172.217.194.0-255,4320,149906,7,245290
28289,0.002212,172.217.194.0-255,2902,152808,7,245290
28290,0.002288,172.217.194.0-255,7156,159964,7,245290
28291,0.002643,172.217.194.0-255,4320,164284,7,245290
28292,0.004711,172.31.36.0-255,66,164350,7,245290
28293,0.00698,172.217.194.0-255,5738,170088,7,245290
28294,0.006987,172.31.36.0-255,66,170154,7,245290
28295,0.009239,172.217.194.0-255,5738,175892,7,245290
28296,0.009246,172.31.36.0-255,66,175958,7,245290
28297,0.011503,172.217.194.0-255,5738,181696,7,245290
28298,0.01151,172.31.36.0-255,66,181762,7,245290
28299,0.013781,172.217.194.0-255,5738,187500,7,245290
28300,0.013791,172.31.36.0-255,66,187566,7,245290
28301,0.016019,172.217.194.0-255,5738,193304,7,245290
28302,0.016151,172.31.36.0-255,66,193370,7,245290
28303,0.018379,172.217.194.0-255,5738,199108,7,245290
28304,0.018387,172.31.36.0-255,66,199174,7,245290
28305,0.020665,172.217.194.0-255,5738,204912,7,245290
28306,0.020677,172.31.36.0-255,66,204978,7,245290
28307,0.022924,172.217.194.0-255,5738,210716,7,245290
28308,0.022932,172.31.36.0-255,66,210782,7,245290
28309,0.025196,172.217.194.0-255,5738,216520,7,245290
28310,0.025204,172.31.36.0-255,66,216586,7,245290
28311,0.027478,172.217.194.0-255,5738,222324,7,245290
28312,0.027487,172.31.36.0-255,66,222390,7,245290
28313,0.029726,172.217.194.0-255,5738,228128,7,245290
28314,0.029734,172.31.36.0-255,66,228194,7,245290
28315,0.031987,172.217.194.0-255,5738,233932,7,245290
28316,0.031996,172.31.36.0-255,66,233998,7,245290
28317,0.034274,172.217.194.0-255,5738,239736,7,245290
28318,0.034284,172.31.36.0-255,66,239802,7,245290
28319,0.036499,172.217.194.0-255,500,240302,7,245290
28320,0.037105,172.31.36.0-255,105,240407,7,245290
28321,0.037147,172.31.36.0-255,105,240512,7,245290
28322,0.037408,172.31.36.0-255,90,240602,7,245290
28323,0.037419,172.31.36.0-255,66,240668,7,245290
28324,0.039299,172.217.194.0-255,66,240734,7,245290
28325,0.03938,172.217.194.0-255,66,240800,7,245290
28326,0.039643,172.217.194.0-255,66,240866,7,245290
28327,0.039669,172.217.194.0-255,66,240932,7,245290
28328,0.039676,172.31.36.0-255,66,240998,7,245290
28329,0.041986,172.31.36.0-255,172,241170,7,245290
28330,0.042014,172.31.36.0-255,1115,242285,7,245290
28331,0.042066,172.31.36.0-255,1514,243799,7,245290
28332,0.042068,172.31.36.0-255,1293,245092,7,245290
28333,0.043511,104.244.42.0-255,66,245158,7,245290
28334,0.04365,104.244.42.0-255,66,245224,7,245290
28335,0.043671,104.244.42.0-255,66,245290,7,245290
28336,0.0,74.125.24.0-255,153,153,7,226256
28337,2.8e-05,172.31.36.0-255,66,219,7,226256
28338,3.5e-05,74.125.24.0-255,1484,1703,7,226256
28339,4e-05,172.31.36.0-255,66,1769,7,226256
28340,4.5e-05,74.125.24.0-255,2902,4671,7,226256
28341,4.7e-05,172.31.36.0-255,66,4737,7,226256
28342,5.3e-05,74.125.24.0-255,7156,11893,7,226256
28343,5.5e-05,172.31.36.0-255,66,11959,7,226256
28344,6.2e-05,74.125.24.0-255,6321,18280,7,226256
28345,6.4e-05,172.31.36.0-255,66,18346,7,226256
28346,6.8e-05,74.125.24.0-255,1484,19830,7,226256
28347,7.1e-05,172.31.36.0-255,66,19896,7,226256
28348,0.0001,74.125.24.0-255,5738,25634,7,226256
28349,0.000103,172.31.36.0-255,66,25700,7,226256
28350,0.000108,74.125.24.0-255,4320,30020,7,226256
28351,0.000109,172.31.36.0-255,66,30086,7,226256
28352,0.000121,74.125.24.0-255,1125,31211,7,226256
28353,0.000123,172.31.36.0-255,66,31277,7,226256
28354,0.000163,74.125.24.0-255,4320,35597,7,226256
28355,0.000167,172.31.36.0-255,66,35663,7,226256
28356,0.000173,74.125.24.0-255,5738,41401,7,226256
28357,0.000175,172.31.36.0-255,66,41467,7,226256
28358,0.000195,74.125.24.0-255,4320,45787,7,226256
28359,0.000198,172.31.36.0-255,66,45853,7,226256
28360,0.000222,172.31.36.0-255,66,45919,7,226256
28361,0.000228,74.125.24.0-255,5738,51657,7,226256
28362,0.00023,172.31.36.0-255,66,51723,7,226256
28363,0.000256,74.125.24.0-255,1484,53207,7,226256
28364,0.000259,172.31.36.0-255,66,53273,7,226256
28365,0.000275,74.125.24.0-255,4235,57508,7,226256
28366,0.000278,172.31.36.0-255,66,57574,7,226256
28367,0.000351,74.125.24.0-255,131,57705,7,226256
28368,0.000387,74.125.24.0-255,1484,59189,7,226256
28369,0.000391,172.31.36.0-255,66,59255,7,226256
28370,0.000394,74.125.24.0-255,1484,60739,7,226256
28371,0.000407,74.125.24.0-255,1484,62223,7,226256
28372,0.000411,74.125.24.0-255,2902,65125,7,226256
28373,0.000411,172.31.36.0-255,66,65191,7,226256
28374,0.000415,172.31.36.0-255,66,65257,7,226256
28375,0.000464,74.125.24.0-255,2902,68159,7,226256
28376,0.000468,172.31.36.0-255,66,68225,7,226256
28377,0.000488,74.125.24.0-255,6498,74723,7,226256
28378,0.000491,172.31.36.0-255,66,74789,7,226256
28379,0.000703,74.125.24.0-255,1484,76273,7,226256
28380,0.000708,74.125.24.0-255,2902,79175,7,226256
28381,0.000712,172.31.36.0-255,66,79241,7,226256
28382,0.000735,74.125.24.0-255,5738,84979,7,226256
28383,0.000738,172.31.36.0-255,66,85045,7,226256
28384,0.000796,172.31.36.0-255,66,85111,7,226256
28385,0.000802,74.125.24.0-255,5738,90849,7,226256
28386,0.000804,172.31.36.0-255,66,90915,7,226256
28387,0.000831,74.125.24.0-255,1484,92399,7,226256
28388,0.000848,74.125.24.0-255,3602,96001,7,226256
28389,0.000852,172.31.36.0-255,66,96067,7,226256
28390,0.001045,74.125.24.0-255,1484,97551,7,226256
28391,0.001051,74.125.24.0-255,2902,100453,7,226256
28392,0.001054,172.31.36.0-255,66,100519,7,226256
28393,0.001076,74.125.24.0-255,5738,106257,7,226256
28394,0.001079,172.31.36.0-255,66,106323,7,226256
28395,0.001085,74.125.24.0-255,5738,112061,7,226256
28396,0.001087,172.31.36.0-255,66,112127,7,226256
28397,0.001091,74.125.24.0-255,2902,115029,7,226256
28398,0.001094,172.31.36.0-255,66,115095,7,226256
28399,0.001124,172.31.36.0-255,66,115161,7,226256
28400,0.00116,74.125.24.0-255,5020,120181,7,226256
28401,0.001163,172.31.36.0-255,66,120247,7,226256
28402,0.001212,74.125.24.0-255,4320,124567,7,226256
28403,0.001216,172.31.36.0-255,66,124633,7,226256
28404,0.001233,74.125.24.0-255,1484,126117,7,226256
28405,0.001244,172.31.36.0-255,66,126183,7,226256
28406,0.001258,74.125.24.0-255,1484,127667,7,226256
28407,0.001291,172.31.36.0-255,66,127733,7,226256
28408,0.001297,74.125.24.0-255,3602,131335,7,226256
28409,0.001299,172.31.36.0-255,66,131401,7,226256
28410,0.001346,74.125.24.0-255,1484,132885,7,226256
28411,0.001352,74.125.24.0-255,2902,135787,7,226256
28412,0.001354,172.31.36.0-255,66,135853,7,226256
28413,0.001359,74.125.24.0-255,2902,138755,7,226256
28414,0.001362,172.31.36.0-255,66,138821,7,226256
28415,0.001378,74.125.24.0-255,2902,141723,7,226256
28416,0.001381,172.31.36.0-255,66,141789,7,226256
28417,0.001387,74.125.24.0-255,5738,147527,7,226256
28418,0.001389,172.31.36.0-255,66,147593,7,226256
28419,0.001411,74.125.24.0-255,1484,149077,7,226256
28420,0.001421,172.31.36.0-255,66,149143,7,226256
28421,0.001444,74.125.24.0-255,5738,154881,7,226256
28422,0.001447,172.31.36.0-255,66,154947,7,226256
28423,0.00145,74.125.24.0-255,2184,157131,7,226256
28424,0.001452,172.31.36.0-255,66,157197,7,226256
28425,0.001634,74.125.24.0-255,1484,158681,7,226256
28426,0.001654,172.31.36.0-255,101,158782,7,226256
28427,0.001655,74.125.24.0-255,2902,161684,7,226256
28428,0.001659,74.125.24.0-255,4320,166004,7,226256
28429,0.001659,172.31.36.0-255,66,166070,7,226256
28430,0.001662,172.31.36.0-255,66,166136,7,226256
28431,0.00168,74.125.24.0-255,1484,167620,7,226256
28432,0.001686,74.125.24.0-255,4320,171940,7,226256
28433,0.001689,172.31.36.0-255,66,172006,7,226256
28434,0.001695,74.125.24.0-255,5738,177744,7,226256
28435,0.001698,172.31.36.0-255,66,177810,7,226256
28436,0.001727,74.125.24.0-255,7156,184966,7,226256
28437,0.00173,172.31.36.0-255,66,185032,7,226256
28438,0.001751,74.125.24.0-255,4320,189352,7,226256
28439,0.001753,172.31.36.0-255,66,189418,7,226256
28440,0.001762,74.125.24.0-255,2184,191602,7,226256
28441,0.001765,172.31.36.0-255,66,191668,7,226256
28442,0.001854,74.125.24.0-255,1484,193152,7,226256
28443,0.00186,74.125.24.0-255,2902,196054,7,226256
28444,0.001862,172.31.36.0-255,66,196120,7,226256
28445,0.001888,74.125.24.0-255,5738,201858,7,226256
28446,0.001891,172.31.36.0-255,66,201924,7,226256
28447,0.001895,74.125.24.0-255,2902,204826,7,226256
28448,0.001897,172.31.36.0-255,66,204892,7,226256
28449,0.001908,74.125.24.0-255,1484,206376,7,226256
28450,0.001953,172.31.36.0-255,66,206442,7,226256
28451,0.002014,172.31.36.0-255,66,206508,7,226256
28452,0.00203,172.31.36.0-255,66,206574,7,226256
28453,0.00204,172.31.36.0-255,66,206640,7,226256
28454,0.002051,172.31.36.0-255,66,206706,7,226256
28455,0.00207,172.31.36.0-255,66,206772,7,226256
28456,0.002075,74.125.24.0-255,5738,212510,7,226256
28457,0.002078,172.31.36.0-255,66,212576,7,226256
28458,0.00211,172.31.36.0-255,66,212642,7,226256
28459,0.002139,172.31.36.0-255,66,212708,7,226256
28460,0.002163,74.125.24.0-255,3602,216310,7,226256
28461,0.002166,172.31.36.0-255,66,216376,7,226256
28462,0.002176,172.31.36.0-255,66,216442,7,226256
28463,0.002191,172.31.36.0-255,66,216508,7,226256
28464,0.002221,172.31.36.0-255,66,216574,7,226256
28465,0.002246,74.125.24.0-255,105,216679,7,226256
28466,0.003486,172.31.36.0-255,105,216784,7,226256
28467,0.004171,74.125.24.0-255,66,216850,7,226256
28468,0.006011,74.125.24.0-255,66,216916,7,226256
28469,0.031313,172.31.36.0-255,322,217238,7,226256
28470,0.031344,172.31.36.0-255,1115,218353,7,226256
28471,0.03141,172.31.36.0-255,1514,219867,7,226256
28472,0.031412,172.31.36.0-255,1514,221381,7,226256
28473,0.031413,172.31.36.0-255,1514,222895,7,226256
28474,0.031419,172.31.36.0-255,1514,224409,7,226256
28475,0.03142,172.31.36.0-255,1514,225923,7,226256
28476,0.031421,172.31.36.0-255,69,225992,7,226256
28477,0.032838,104.244.42.0-255,66,226058,7,226256
28478,0.032849,104.244.42.0-255,66,226124,7,226256
28479,0.032939,104.244.42.0-255,66,226190,7,226256
28480,0.032945,104.244.42.0-255,66,226256,7,226256
28481,0.0,74.125.24.0-255,297,297,7,213209
28482,2.6e-05,172.31.36.0-255,66,363,7,213209
28483,3.2e-05,74.125.24.0-255,1484,1847,7,213209
28484,3.6e-05,172.31.36.0-255,66,1913,7,213209
28485,4.4e-05,74.125.24.0-255,4320,6233,7,213209
28486,4.7e-05,172.31.36.0-255,66,6299,7,213209
28487,5.4e-05,74.125.24.0-255,7156,13455,7,213209
28488,5.8e-05,172.31.36.0-255,66,13521,7,213209
28489,7.4e-05,172.31.36.0-255,66,13587,7,213209
28490,7.9e-05,74.125.24.0-255,3961,17548,7,213209
28491,8.2e-05,172.31.36.0-255,66,17614,7,213209
28492,0.00013,74.125.24.0-255,1484,19098,7,213209
28493,0.000133,172.31.36.0-255,66,19164,7,213209
28494,0.00014,74.125.24.0-255,2902,22066,7,213209
28495,0.000143,172.31.36.0-255,66,22132,7,213209
28496,0.000146,74.125.24.0-255,1484,23616,7,213209
28497,0.000148,172.31.36.0-255,66,23682,7,213209
28498,0.000176,74.125.24.0-255,4320,28002,7,213209
28499,0.000179,172.31.36.0-255,66,28068,7,213209
28500,0.000187,74.125.24.0-255,6797,34865,7,213209
28501,0.000189,172.31.36.0-255,66,34931,7,213209
28502,0.000225,172.31.36.0-255,66,34997,7,213209
28503,0.000262,74.125.24.0-255,2857,37854,7,213209
28504,0.000266,172.31.36.0-255,66,37920,7,213209
28505,0.000354,74.125.24.0-255,109,38029,7,213209
28506,0.000358,172.31.36.0-255,66,38095,7,213209
28507,0.000377,74.125.24.0-255,332,38427,7,213209
28508,0.00038,172.31.36.0-255,66,38493,7,213209
28509,0.000719,74.125.24.0-255,1484,39977,7,213209
28510,0.000723,172.31.36.0-255,66,40043,7,213209
28511,0.00073,74.125.24.0-255,2902,42945,7,213209
28512,0.000732,172.31.36.0-255,66,43011,7,213209
28513,0.000739,74.125.24.0-255,5738,48749,7,213209
28514,0.000741,172.31.36.0-255,66,48815,7,213209
28515,0.000756,74.125.24.0-255,2902,51717,7,213209
28516,0.000759,172.31.36.0-255,66,51783,7,213209
28517,0.000784,172.31.36.0-255,66,51849,7,213209
28518,0.000797,172.31.36.0-255,66,51915,7,213209
28519,0.000969,74.125.24.0-255,1484,53399,7,213209
28520,0.000974,74.125.24.0-255,2902,56301,7,213209
28521,0.00098,172.31.36.0-255,66,56367,7,213209
28522,0.000999,74.125.24.0-255,5738,62105,7,213209
28523,0.001002,172.31.36.0-255,66,62171,7,213209
28524,0.001007,74.125.24.0-255,4320,66491,7,213209
28525,0.001009,172.31.36.0-255,66,66557,7,213209
28526,0.001038,172.31.36.0-255,66,66623,7,213209
28527,0.001052,172.31.36.0-255,66,66689,7,213209
28528,0.001297,74.125.24.0-255,1484,68173,7,213209
28529,0.001303,74.125.24.0-255,2902,71075,7,213209
28530,0.001306,172.31.36.0-255,66,71141,7,213209
28531,0.001314,74.125.24.0-255,5738,76879,7,213209
28532,0.001316,172.31.36.0-255,66,76945,7,213209
28533,0.001387,172.31.36.0-255,66,77011,7,213209
28534,0.001394,74.125.24.0-255,5738,82749,7,213209
28535,0.001396,172.31.36.0-255,66,82815,7,213209
28536,0.001402,74.125.24.0-255,5020,87835,7,213209
28537,0.001404,172.31.36.0-255,66,87901,7,213209
28538,0.001466,74.125.24.0-255,1484,89385,7,213209
28539,0.00147,74.125.24.0-255,1484,90869,7,213209
28540,0.001472,172.31.36.0-255,66,90935,7,213209
28541,0.00149,74.125.24.0-255,1484,92419,7,213209
28542,0.001497,74.125.24.0-255,5738,98157,7,213209
28543,0.0015,172.31.36.0-255,66,98223,7,213209
28544,0.001507,74.125.24.0-255,5738,103961,7,213209
28545,0.001509,172.31.36.0-255,66,104027,7,213209
28546,0.001516,74.125.24.0-255,7156,111183,7,213209
28547,0.001519,172.31.36.0-255,66,111249,7,213209
28548,0.001553,74.125.24.0-255,5738,116987,7,213209
28549,0.001556,172.31.36.0-255,66,117053,7,213209
28550,0.001571,74.125.24.0-255,5020,122073,7,213209
28551,0.001574,172.31.36.0-255,66,122139,7,213209
28552,0.001767,74.125.24.0-255,1484,123623,7,213209
28553,0.001773,74.125.24.0-255,2902,126525,7,213209
28554,0.001776,172.31.36.0-255,66,126591,7,213209
28555,0.001784,74.125.24.0-255,5738,132329,7,213209
28556,0.001786,172.31.36.0-255,66,132395,7,213209
28557,0.001819,172.31.36.0-255,66,132461,7,213209
28558,0.001854,74.125.24.0-255,1484,133945,7,213209
28559,0.001891,172.31.36.0-255,66,134011,7,213209
28560,0.001907,172.31.36.0-255,66,134077,7,213209
28561,0.001925,172.31.36.0-255,66,134143,7,213209
28562,0.001945,74.125.24.0-255,4320,138463,7,213209
28563,0.001947,172.31.36.0-255,66,138529,7,213209
28564,0.001989,172.31.36.0-255,66,138595,7,213209
28565,0.002002,172.31.36.0-255,66,138661,7,213209
28566,0.002016,172.31.36.0-255,66,138727,7,213209
28567,0.002044,74.125.24.0-255,1484,140211,7,213209
28568,0.002058,74.125.24.0-255,2902,143113,7,213209
28569,0.002061,172.31.36.0-255,66,143179,7,213209
28570,0.002066,74.125.24.0-255,2902,146081,7,213209
28571,0.002068,172.31.36.0-255,66,146147,7,213209
28572,0.002081,74.125.24.0-255,2902,149049,7,213209
28573,0.002083,172.31.36.0-255,66,149115,7,213209
28574,0.002087,74.125.24.0-255,1484,150599,7,213209
28575,0.002125,172.31.36.0-255,66,150665,7,213209
28576,0.002128,74.125.24.0-255,1484,152149,7,213209
28577,0.002135,74.125.24.0-255,7156,159305,7,213209
28578,0.002138,172.31.36.0-255,66,159371,7,213209
28579,0.002141,74.125.24.0-255,1484,160855,7,213209
28580,0.002145,74.125.24.0-255,2184,163039,7,213209
28581,0.002147,172.31.36.0-255,66,163105,7,213209
28582,0.002213,74.125.24.0-255,1484,164589,7,213209
28583,0.002238,74.125.24.0-255,2902,167491,7,213209
28584,0.002242,172.31.36.0-255,66,167557,7,213209
28585,0.002249,74.125.24.0-255,5738,173295,7,213209
28586,0.002251,172.31.36.0-255,66,173361,7,213209
28587,0.002259,74.125.24.0-255,7156,180517,7,213209
28588,0.002261,172.31.36.0-255,66,180583,7,213209
28589,0.002293,74.125.24.0-255,2902,183485,7,213209
28590,0.002296,172.31.36.0-255,66,183551,7,213209
28591,0.002326,172.31.36.0-255,66,183617,7,213209
28592,0.00233,74.125.24.0-255,2184,185801,7,213209
28593,0.002332,172.31.36.0-255,66,185867,7,213209
28594,0.002335,74.125.24.0-255,1484,187351,7,213209
28595,0.002348,74.125.24.0-255,1484,188835,7,213209
28596,0.00235,172.31.36.0-255,66,188901,7,213209
28597,0.002356,74.125.24.0-255,4320,193221,7,213209
28598,0.002358,172.31.36.0-255,66,193287,7,213209
28599,0.002365,74.125.24.0-255,5738,199025,7,213209
28600,0.002367,172.31.36.0-255,66,199091,7,213209
28601,0.002384,74.125.24.0-255,2902,201993,7,213209
28602,0.002386,172.31.36.0-255,66,202059,7,213209
28603,0.002408,172.31.36.0-255,66,202125,7,213209
28604,0.002437,172.31.36.0-255,66,202191,7,213209
28605,0.002449,172.31.36.0-255,66,202257,7,213209
28606,0.002477,74.125.24.0-255,6062,208319,7,213209
28607,0.002479,74.125.24.0-255,105,208424,7,213209
28608,0.002483,172.31.36.0-255,66,208490,7,213209
28609,0.012279,172.31.36.0-255,66,208556,7,213209
28610,0.012331,172.31.36.0-255,105,208661,7,213209
28611,0.014239,74.125.24.0-255,66,208727,7,213209
28612,0.033968,172.31.36.0-255,188,208915,7,213209
28613,0.034001,172.31.36.0-255,958,209873,7,213209
28614,0.034064,172.31.36.0-255,1514,211387,7,213209
28615,0.034067,172.31.36.0-255,1450,212837,7,213209
28616,0.035522,104.244.42.0-255,66,212903,7,213209
28617,0.035552,104.244.42.0-255,66,212969,7,213209
28618,0.035672,104.244.42.0-255,66,213035,7,213209
28619,0.0367,104.244.42.0-255,108,213143,7,213209
28620,0.036706,172.31.36.0-255,66,213209,7,213209
28621,0.0,74.125.24.0-255,153,153,7,317599
28622,1.5e-05,172.31.36.0-255,66,219,7,317599
28623,2.2e-05,74.125.24.0-255,1484,1703,7,317599
28624,2.7e-05,172.31.36.0-255,66,1769,7,317599
28625,3.3e-05,74.125.24.0-255,2902,4671,7,317599
28626,3.6e-05,172.31.36.0-255,66,4737,7,317599
28627,3.9e-05,74.125.24.0-255,1484,6221,7,317599
28628,4.2e-05,172.31.36.0-255,66,6287,7,317599
28629,6.1e-05,74.125.24.0-255,5738,12025,7,317599
28630,6.5e-05,172.31.36.0-255,66,12091,7,317599
28631,6.8e-05,74.125.24.0-255,1484,13575,7,317599
28632,7e-05,172.31.36.0-255,66,13641,7,317599
28633,8.6e-05,74.125.24.0-255,4320,17961,7,317599
28634,8.9e-05,172.31.36.0-255,66,18027,7,317599
28635,0.000113,74.125.24.0-255,6264,24291,7,317599
28636,0.000117,172.31.36.0-255,66,24357,7,317599
28637,0.000129,172.31.36.0-255,66,24423,7,317599
28638,0.000142,74.125.24.0-255,2902,27325,7,317599
28639,0.000144,172.31.36.0-255,66,27391,7,317599
28640,0.000158,172.31.36.0-255,66,27457,7,317599
28641,0.000179,74.125.24.0-255,2184,29641,7,317599
28642,0.000182,172.31.36.0-255,66,29707,7,317599
28643,0.000189,74.125.24.0-255,7156,36863,7,317599
28644,0.000191,172.31.36.0-255,66,36929,7,317599
28645,0.000204,74.125.24.0-255,1484,38413,7,317599
28646,0.000207,172.31.36.0-255,66,38479,7,317599
28647,0.000223,74.125.24.0-255,2817,41296,7,317599
28648,0.000226,172.31.36.0-255,66,41362,7,317599
28649,0.000432,74.125.24.0-255,131,41493,7,317599
28650,0.000438,172.31.36.0-255,66,41559,7,317599
28651,0.000609,74.125.24.0-255,1484,43043,7,317599
28652,0.000632,74.125.24.0-255,2902,45945,7,317599
28653,0.000636,172.31.36.0-255,66,46011,7,317599
28654,0.000643,74.125.24.0-255,5738,51749,7,317599
28655,0.000645,172.31.36.0-255,66,51815,7,317599
28656,0.000676,172.31.36.0-255,66,51881,7,317599
28657,0.000682,74.125.24.0-255,5738,57619,7,317599
28658,0.000686,172.31.36.0-255,66,57685,7,317599
28659,0.000714,74.125.24.0-255,5738,63423,7,317599
28660,0.000718,74.125.24.0-255,2184,65607,7,317599
28661,0.000719,172.31.36.0-255,66,65673,7,317599
28662,0.000723,172.31.36.0-255,66,65739,7,317599
28663,0.001234,74.125.24.0-255,1484,67223,7,317599
28664,0.001242,74.125.24.0-255,2902,70125,7,317599
28665,0.001246,172.31.36.0-255,66,70191,7,317599
28666,0.001262,74.125.24.0-255,4320,74511,7,317599
28667,0.001265,172.31.36.0-255,66,74577,7,317599
28668,0.001289,74.125.24.0-255,1484,76061,7,317599
28669,0.001294,74.125.24.0-255,2902,78963,7,317599
28670,0.001297,172.31.36.0-255,66,79029,7,317599
28671,0.001308,172.31.36.0-255,66,79095,7,317599
28672,0.001311,74.125.24.0-255,1484,80579,7,317599
28673,0.001337,172.31.36.0-255,66,80645,7,317599
28674,0.001348,74.125.24.0-255,766,81411,7,317599
28675,0.001473,74.125.24.0-255,1484,82895,7,317599
28676,0.001478,172.31.36.0-255,66,82961,7,317599
28677,0.001483,74.125.24.0-255,2902,85863,7,317599
28678,0.001485,172.31.36.0-255,66,85929,7,317599
28679,0.001492,74.125.24.0-255,5738,91667,7,317599
28680,0.001494,172.31.36.0-255,66,91733,7,317599
28681,0.001512,74.125.24.0-255,4320,96053,7,317599
28682,0.001515,172.31.36.0-255,66,96119,7,317599
28683,0.001553,172.31.36.0-255,66,96185,7,317599
28684,0.00156,74.125.24.0-255,5738,101923,7,317599
28685,0.001563,172.31.36.0-255,66,101989,7,317599
28686,0.001585,74.125.24.0-255,5020,107009,7,317599
28687,0.001588,172.31.36.0-255,66,107075,7,317599
28688,0.001755,74.125.24.0-255,1484,108559,7,317599
28689,0.001762,74.125.24.0-255,1484,110043,7,317599
28690,0.001767,172.31.36.0-255,66,110109,7,317599
28691,0.001787,74.125.24.0-255,1484,111593,7,317599
28692,0.001794,74.125.24.0-255,5738,117331,7,317599
28693,0.001797,172.31.36.0-255,66,117397,7,317599
28694,0.001802,74.125.24.0-255,4320,121717,7,317599
28695,0.001804,172.31.36.0-255,66,121783,7,317599
28696,0.00181,74.125.24.0-255,5738,127521,7,317599
28697,0.001813,172.31.36.0-255,66,127587,7,317599
28698,0.001826,172.31.36.0-255,66,127653,7,317599
28699,0.001851,74.125.24.0-255,1484,129137,7,317599
28700,0.001855,74.125.24.0-255,2184,131321,7,317599
28701,0.001857,172.31.36.0-255,66,131387,7,317599
28702,0.002223,74.125.24.0-255,1484,132871,7,317599
28703,0.002237,74.125.24.0-255,2902,135773,7,317599
28704,0.00224,172.31.36.0-255,66,135839,7,317599
28705,0.002243,74.125.24.0-255,1484,137323,7,317599
28706,0.002261,74.125.24.0-255,4320,141643,7,317599
28707,0.002264,172.31.36.0-255,66,141709,7,317599
28708,0.002293,172.31.36.0-255,66,141775,7,317599
28709,0.002298,74.125.24.0-255,5738,147513,7,317599
28710,0.0023,172.31.36.0-255,66,147579,7,317599
28711,0.002335,74.125.24.0-255,2902,150481,7,317599
28712,0.002337,172.31.36.0-255,66,150547,7,317599
28713,0.002364,172.31.36.0-255,66,150613,7,317599
28714,0.002373,74.125.24.0-255,5738,156351,7,317599
28715,0.002376,172.31.36.0-255,66,156417,7,317599
28716,0.0024,172.31.36.0-255,66,156483,7,317599
28717,0.002406,74.125.24.0-255,5020,161503,7,317599
28718,0.002408,172.31.36.0-255,66,161569,7,317599
28719,0.004761,74.125.24.0-255,5738,167307,7,317599
28720,0.004765,172.31.36.0-255,66,167373,7,317599
28721,0.007134,74.125.24.0-255,5738,173111,7,317599
28722,0.007141,172.31.36.0-255,66,173177,7,317599
28723,0.009549,74.125.24.0-255,5738,178915,7,317599
28724,0.009555,172.31.36.0-255,66,178981,7,317599
28725,0.011911,74.125.24.0-255,5738,184719,7,317599
28726,0.011918,172.31.36.0-255,66,184785,7,317599
28727,0.014257,74.125.24.0-255,5738,190523,7,317599
28728,0.014265,172.31.36.0-255,66,190589,7,317599
28729,0.016621,74.125.24.0-255,5738,196327,7,317599
28730,0.016627,172.31.36.0-255,66,196393,7,317599
28731,0.019001,74.125.24.0-255,5738,202131,7,317599
28732,0.019011,172.31.36.0-255,66,202197,7,317599
28733,0.021388,74.125.24.0-255,5738,207935,7,317599
28734,0.021397,172.31.36.0-255,66,208001,7,317599
28735,0.023771,74.125.24.0-255,5738,213739,7,317599
28736,0.023778,172.31.36.0-255,66,213805,7,317599
28737,0.026143,74.125.24.0-255,4320,218125,7,317599
28738,0.026149,172.31.36.0-255,66,218191,7,317599
28739,0.026175,74.125.24.0-255,1484,219675,7,317599
28740,0.028517,74.125.24.0-255,4320,223995,7,317599
28741,0.028524,172.31.36.0-255,66,224061,7,317599
28742,0.030895,74.125.24.0-255,5738,229799,7,317599
28743,0.030906,172.31.36.0-255,66,229865,7,317599
28744,0.03287,172.31.36.0-255,188,230053,7,317599
28745,0.032901,172.31.36.0-255,958,231011,7,317599
28746,0.032949,172.31.36.0-255,1514,232525,7,317599
28747,0.032951,172.31.36.0-255,1514,234039,7,317599
28748,0.032956,172.31.36.0-255,1514,235553,7,317599
28749,0.032957,172.31.36.0-255,1229,236782,7,317599
28750,0.033275,74.125.24.0-255,5738,242520,7,317599
28751,0.033284,172.31.36.0-255,66,242586,7,317599
28752,0.034395,104.244.42.0-255,66,242652,7,317599
28753,0.034415,104.244.42.0-255,66,242718,7,317599
28754,0.034538,104.244.42.0-255,66,242784,7,317599
28755,0.034545,104.244.42.0-255,66,242850,7,317599
28756,0.035647,74.125.24.0-255,5738,248588,7,317599
28757,0.035655,172.31.36.0-255,66,248654,7,317599
28758,0.037998,74.125.24.0-255,4320,252974,7,317599
28759,0.038005,172.31.36.0-255,66,253040,7,317599
28760,0.038031,74.125.24.0-255,1484,254524,7,317599
28761,0.040371,74.125.24.0-255,4320,258844,7,317599
28762,0.040377,172.31.36.0-255,66,258910,7,317599
28763,0.042741,74.125.24.0-255,5738,264648,7,317599
28764,0.042747,172.31.36.0-255,66,264714,7,317599
28765,0.045116,74.125.24.0-255,2902,267616,7,317599
28766,0.045121,172.31.36.0-255,66,267682,7,317599
28767,0.045154,74.125.24.0-255,2902,270584,7,317599
28768,0.045157,172.31.36.0-255,66,270650,7,317599
28769,0.047464,74.125.24.0-255,2902,273552,7,317599
28770,0.047469,172.31.36.0-255,66,273618,7,317599
28771,0.047518,74.125.24.0-255,2902,276520,7,317599
28772,0.047521,172.31.36.0-255,66,276586,7,317599
28773,0.049848,74.125.24.0-255,2902,279488,7,317599
28774,0.049853,172.31.36.0-255,66,279554,7,317599
28775,0.049883,74.125.24.0-255,2902,282456,7,317599
28776,0.049886,172.31.36.0-255,66,282522,7,317599
28777,0.052227,74.125.24.0-255,4320,286842,7,317599
28778,0.052233,172.31.36.0-255,66,286908,7,317599
28779,0.052265,74.125.24.0-255,1484,288392,7,317599
28780,0.054581,74.125.24.0-255,4320,292712,7,317599
28781,0.054586,172.31.36.0-255,66,292778,7,317599
28782,0.056947,74.125.24.0-255,5738,298516,7,317599
28783,0.056953,172.31.36.0-255,66,298582,7,317599
28784,0.059326,74.125.24.0-255,5738,304320,7,317599
28785,0.059331,172.31.36.0-255,66,304386,7,317599
28786,0.061675,74.125.24.0-255,4320,308706,7,317599
28787,0.06168,172.31.36.0-255,66,308772,7,317599
28788,0.061708,74.125.24.0-255,1484,310256,7,317599
28789,0.064044,74.125.24.0-255,4320,314576,7,317599
28790,0.064049,172.31.36.0-255,66,314642,7,317599
28791,0.06642,74.125.24.0-255,2720,317362,7,317599
28792,0.066427,172.31.36.0-255,66,317428,7,317599
28793,0.067013,172.31.36.0-255,105,317533,7,317599
28794,0.06933,74.125.24.0-255,66,317599,7,317599
28795,0.0,172.31.36.0-255,105,105,7,105
28796,0.0,74.125.200.0-255,298,298,7,372630
28797,2.7e-05,172.31.36.0-255,66,364,7,372630
28798,3.3e-05,74.125.200.0-255,1484,1848,7,372630
28799,3.7e-05,172.31.36.0-255,66,1914,7,372630
28800,4.2e-05,74.125.200.0-255,4320,6234,7,372630
28801,4.4e-05,172.31.36.0-255,66,6300,7,372630
28802,4.8e-05,74.125.200.0-255,2902,9202,7,372630
28803,5e-05,172.31.36.0-255,66,9268,7,372630
28804,5.6e-05,74.125.200.0-255,4320,13588,7,372630
28805,5.8e-05,172.31.36.0-255,66,13654,7,372630
28806,7.4e-05,74.125.200.0-255,403,14057,7,372630
28807,7.5e-05,172.31.36.0-255,66,14123,7,372630
28808,9.9e-05,74.125.200.0-255,1484,15607,7,372630
28809,0.000116,172.31.36.0-255,66,15673,7,372630
28810,0.000147,74.125.200.0-255,4320,19993,7,372630
28811,0.000149,172.31.36.0-255,66,20059,7,372630
28812,0.000173,74.125.200.0-255,4320,24379,7,372630
28813,0.000175,172.31.36.0-255,66,24445,7,372630
28814,0.000188,74.125.200.0-255,1484,25929,7,372630
28815,0.00019,172.31.36.0-255,66,25995,7,372630
28816,0.000197,74.125.200.0-255,5379,31374,7,372630
28817,0.000199,172.31.36.0-255,66,31440,7,372630
28818,0.00027,74.125.200.0-255,1484,32924,7,372630
28819,0.000274,172.31.36.0-255,66,32990,7,372630
28820,0.000298,74.125.200.0-255,1484,34474,7,372630
28821,0.000301,172.31.36.0-255,66,34540,7,372630
28822,0.00032,74.125.200.0-255,2902,37442,7,372630
28823,0.000324,172.31.36.0-255,66,37508,7,372630
28824,0.000339,74.125.200.0-255,5738,43246,7,372630
28825,0.000342,172.31.36.0-255,66,43312,7,372630
28826,0.000347,74.125.200.0-255,2902,46214,7,372630
28827,0.000349,172.31.36.0-255,66,46280,7,372630
28828,0.000388,74.125.200.0-255,3961,50241,7,372630
28829,0.000392,172.31.36.0-255,66,50307,7,372630
28830,0.000398,74.125.200.0-255,5738,56045,7,372630
28831,0.000401,172.31.36.0-255,66,56111,7,372630
28832,0.000404,74.125.200.0-255,1484,57595,7,372630
28833,0.00043,74.125.200.0-255,5738,63333,7,372630
28834,0.000433,172.31.36.0-255,66,63399,7,372630
28835,0.000437,74.125.200.0-255,2849,66248,7,372630
28836,0.000442,172.31.36.0-255,66,66314,7,372630
28837,0.000474,74.125.200.0-255,380,66694,7,372630
28838,0.000711,74.125.200.0-255,1484,68178,7,372630
28839,0.000716,172.31.36.0-255,66,68244,7,372630
28840,0.000722,74.125.200.0-255,2902,71146,7,372630
28841,0.000725,172.31.36.0-255,66,71212,7,372630
28842,0.000736,74.125.200.0-255,4320,75532,7,372630
28843,0.00074,172.31.36.0-255,66,75598,7,372630
28844,0.000748,74.125.200.0-255,1484,77082,7,372630
28845,0.000755,74.125.200.0-255,5738,82820,7,372630
28846,0.000757,172.31.36.0-255,66,82886,7,372630
28847,0.000789,74.125.200.0-255,7156,90042,7,372630
28848,0.000792,172.31.36.0-255,66,90108,7,372630
28849,0.000799,74.125.200.0-255,5738,95846,7,372630
28850,0.000802,172.31.36.0-255,66,95912,7,372630
28851,0.000825,74.125.200.0-255,5020,100932,7,372630
28852,0.000829,172.31.36.0-255,66,100998,7,372630
28853,0.000969,74.125.200.0-255,1484,102482,7,372630
28854,0.000988,74.125.200.0-255,2902,105384,7,372630
28855,0.000992,172.31.36.0-255,66,105450,7,372630
28856,0.000995,74.125.200.0-255,1484,106934,7,372630
28857,0.001012,74.125.200.0-255,4320,111254,7,372630
28858,0.001014,172.31.36.0-255,66,111320,7,372630
28859,0.001021,74.125.200.0-255,7156,118476,7,372630
28860,0.001024,172.31.36.0-255,66,118542,7,372630
28861,0.001071,172.31.36.0-255,66,118608,7,372630
28862,0.001093,74.125.200.0-255,1484,120092,7,372630
28863,0.001107,74.125.200.0-255,3602,123694,7,372630
28864,0.00111,172.31.36.0-255,66,123760,7,372630
28865,0.00115,74.125.200.0-255,1484,125244,7,372630
28866,0.001164,74.125.200.0-255,1484,126728,7,372630
28867,0.001167,172.31.36.0-255,66,126794,7,372630
28868,0.001179,74.125.200.0-255,1484,128278,7,372630
28869,0.001196,74.125.200.0-255,5738,134016,7,372630
28870,0.001199,172.31.36.0-255,66,134082,7,372630
28871,0.001204,74.125.200.0-255,2902,136984,7,372630
28872,0.001206,172.31.36.0-255,66,137050,7,372630
28873,0.00121,74.125.200.0-255,1484,138534,7,372630
28874,0.001234,74.125.200.0-255,2902,141436,7,372630
28875,0.001237,172.31.36.0-255,66,141502,7,372630
28876,0.001247,172.31.36.0-255,66,141568,7,372630
28877,0.001259,172.31.36.0-255,66,141634,7,372630
28878,0.002157,74.125.200.0-255,1484,143118,7,372630
28879,0.002164,74.125.200.0-255,1484,144602,7,372630
28880,0.002167,172.31.36.0-255,66,144668,7,372630
28881,0.00218,74.125.200.0-255,1484,146152,7,372630
28882,0.002193,74.125.200.0-255,1484,147636,7,372630
28883,0.002195,172.31.36.0-255,66,147702,7,372630
28884,0.0022,74.125.200.0-255,2902,150604,7,372630
28885,0.002201,172.31.36.0-255,66,150670,7,372630
28886,0.002216,74.125.200.0-255,2902,153572,7,372630
28887,0.002218,172.31.36.0-255,66,153638,7,372630
28888,0.002224,74.125.200.0-255,5738,159376,7,372630
28889,0.002225,172.31.36.0-255,66,159442,7,372630
28890,0.002253,74.125.200.0-255,5738,165180,7,372630
28891,0.002256,172.31.36.0-255,66,165246,7,372630
28892,0.004456,74.125.200.0-255,5738,170984,7,372630
28893,0.00446,172.31.36.0-255,66,171050,7,372630
28894,0.006756,74.125.200.0-255,5738,176788,7,372630
28895,0.006762,172.31.36.0-255,66,176854,7,372630
28896,0.00901,74.125.200.0-255,5738,182592,7,372630
28897,0.009018,172.31.36.0-255,66,182658,7,372630
28898,0.011246,74.125.200.0-255,5738,188396,7,372630
28899,0.011254,172.31.36.0-255,66,188462,7,372630
28900,0.013481,74.125.200.0-255,5738,194200,7,372630
28901,0.013489,172.31.36.0-255,66,194266,7,372630
28902,0.015718,74.125.200.0-255,5738,200004,7,372630
28903,0.015728,172.31.36.0-255,66,200070,7,372630
28904,0.01795,74.125.200.0-255,5738,205808,7,372630
28905,0.017959,172.31.36.0-255,66,205874,7,372630
28906,0.020186,74.125.200.0-255,5738,211612,7,372630
28907,0.020194,172.31.36.0-255,66,211678,7,372630
28908,0.022415,74.125.200.0-255,5738,217416,7,372630
28909,0.022421,172.31.36.0-255,66,217482,7,372630
28910,0.024649,74.125.200.0-255,5738,223220,7,372630
28911,0.024658,172.31.36.0-255,66,223286,7,372630
28912,0.026909,74.125.200.0-255,5738,229024,7,372630
28913,0.026917,172.31.36.0-255,66,229090,7,372630
28914,0.029138,74.125.200.0-255,5738,234828,7,372630
28915,0.029145,172.31.36.0-255,66,234894,7,372630
28916,0.031377,74.125.200.0-255,5738,240632,7,372630
28917,0.031385,172.31.36.0-255,66,240698,7,372630
28918,0.033116,172.31.36.0-255,172,240870,7,372630
28919,0.033232,172.31.36.0-255,1115,241985,7,372630
28920,0.0333,172.31.36.0-255,1514,243499,7,372630
28921,0.033302,172.31.36.0-255,1514,245013,7,372630
28922,0.033307,172.31.36.0-255,1514,246527,7,372630
28923,0.033309,172.31.36.0-255,1514,248041,7,372630
28924,0.033328,172.31.36.0-255,1514,249555,7,372630
28925,0.033329,172.31.36.0-255,69,249624,7,372630
28926,0.033603,74.125.200.0-255,5738,255362,7,372630
28927,0.033612,172.31.36.0-255,66,255428,7,372630
28928,0.034647,104.244.42.0-255,66,255494,7,372630
28929,0.034769,104.244.42.0-255,66,255560,7,372630
28930,0.034868,104.244.42.0-255,66,255626,7,372630
28931,0.034874,104.244.42.0-255,66,255692,7,372630
28932,0.035844,74.125.200.0-255,5738,261430,7,372630
28933,0.035849,172.31.36.0-255,66,261496,7,372630
28934,0.03806,74.125.200.0-255,5738,267234,7,372630
28935,0.038066,172.31.36.0-255,66,267300,7,372630
28936,0.040283,74.125.200.0-255,5738,273038,7,372630
28937,0.040288,172.31.36.0-255,66,273104,7,372630
28938,0.042507,74.125.200.0-255,5738,278842,7,372630
28939,0.042527,172.31.36.0-255,66,278908,7,372630
28940,0.044745,74.125.200.0-255,5738,284646,7,372630
28941,0.04475,172.31.36.0-255,66,284712,7,372630
28942,0.046983,74.125.200.0-255,5738,290450,7,372630
28943,0.046989,172.31.36.0-255,66,290516,7,372630
28944,0.04921,74.125.200.0-255,5738,296254,7,372630
28945,0.049216,172.31.36.0-255,66,296320,7,372630
28946,0.051449,74.125.200.0-255,5738,302058,7,372630
28947,0.051456,172.31.36.0-255,66,302124,7,372630
28948,0.053667,74.125.200.0-255,5738,307862,7,372630
28949,0.053675,172.31.36.0-255,66,307928,7,372630
28950,0.055889,74.125.200.0-255,5738,313666,7,372630
28951,0.055895,172.31.36.0-255,66,313732,7,372630
28952,0.058119,74.125.200.0-255,5738,319470,7,372630
28953,0.058125,172.31.36.0-255,66,319536,7,372630
28954,0.060339,74.125.200.0-255,5738,325274,7,372630
28955,0.060345,172.31.36.0-255,66,325340,7,372630
28956,0.062563,74.125.200.0-255,5738,331078,7,372630
28957,0.062569,172.31.36.0-255,66,331144,7,372630
28958,0.064784,74.125.200.0-255,2902,334046,7,372630
28959,0.06479,172.31.36.0-255,66,334112,7,372630
28960,0.064822,74.125.200.0-255,2902,337014,7,372630
28961,0.064826,172.31.36.0-255,66,337080,7,372630
28962,0.066998,74.125.200.0-255,2902,339982,7,372630
28963,0.067004,172.31.36.0-255,66,340048,7,372630
28964,0.067043,74.125.200.0-255,2902,342950,7,372630
28965,0.067046,172.31.36.0-255,66,343016,7,372630
28966,0.06921,74.125.200.0-255,2902,345918,7,372630
28967,0.069216,172.31.36.0-255,66,345984,7,372630
28968,0.069254,74.125.200.0-255,2902,348886,7,372630
28969,0.069257,172.31.36.0-255,66,348952,7,372630
28970,0.071435,74.125.200.0-255,2902,351854,7,372630
28971,0.07144,172.31.36.0-255,66,351920,7,372630
28972,0.071474,74.125.200.0-255,2902,354822,7,372630
28973,0.071478,172.31.36.0-255,66,354888,7,372630
28974,0.073653,74.125.200.0-255,2902,357790,7,372630
28975,0.073658,172.31.36.0-255,66,357856,7,372630
28976,0.073693,74.125.200.0-255,2902,360758,7,372630
28977,0.073697,172.31.36.0-255,66,360824,7,372630
28978,0.075869,74.125.200.0-255,2902,363726,7,372630
28979,0.075874,172.31.36.0-255,66,363792,7,372630
28980,0.075904,74.125.200.0-255,2902,366694,7,372630
28981,0.075908,172.31.36.0-255,66,366760,7,372630
28982,0.078095,74.125.200.0-255,1484,368244,7,372630
28983,0.07813,74.125.200.0-255,4320,372564,7,372630
28984,0.078135,172.31.36.0-255,66,372630,7,372630
28985,0.0,172.217.194.0-255,153,153,7,281978
28986,2e-05,172.31.36.0-255,66,219,7,281978
28987,2.7e-05,172.217.194.0-255,1484,1703,7,281978
28988,3.2e-05,172.31.36.0-255,66,1769,7,281978
28989,3.6e-05,172.217.194.0-255,2902,4671,7,281978
28990,3.9e-05,172.31.36.0-255,66,4737,7,281978
28991,4.3e-05,172.217.194.0-255,2902,7639,7,281978
28992,4.6e-05,172.31.36.0-255,66,7705,7,281978
28993,9.1e-05,172.217.194.0-255,6241,13946,7,281978
28994,9.4e-05,172.31.36.0-255,66,14012,7,281978
28995,0.000183,172.217.194.0-255,1484,15496,7,281978
28996,0.000186,172.31.36.0-255,66,15562,7,281978
28997,0.00019,172.217.194.0-255,1484,17046,7,281978
28998,0.000192,172.31.36.0-255,66,17112,7,281978
28999,0.00021,172.217.194.0-255,1484,18596,7,281978
29000,0.000212,172.31.36.0-255,66,18662,7,281978
29001,0.000218,172.217.194.0-255,5738,24400,7,281978
29002,0.00022,172.31.36.0-255,66,24466,7,281978
29003,0.000249,172.217.194.0-255,6797,31263,7,281978
29004,0.000251,172.31.36.0-255,66,31329,7,281978
29005,0.000291,172.217.194.0-255,2902,34231,7,281978
29006,0.000294,172.31.36.0-255,66,34297,7,281978
29007,0.000299,172.217.194.0-255,2902,37199,7,281978
29008,0.000301,172.31.36.0-255,66,37265,7,281978
29009,0.000313,172.217.194.0-255,1484,38749,7,281978
29010,0.000315,172.31.36.0-255,66,38815,7,281978
29011,0.000321,172.217.194.0-255,4320,43135,7,281978
29012,0.000323,172.31.36.0-255,66,43201,7,281978
29013,0.000344,172.217.194.0-255,4320,47521,7,281978
29014,0.000347,172.31.36.0-255,66,47587,7,281978
29015,0.000352,172.217.194.0-255,5738,53325,7,281978
29016,0.000354,172.31.36.0-255,66,53391,7,281978
29017,0.000394,172.217.194.0-255,4320,57711,7,281978
29018,0.000397,172.31.36.0-255,66,57777,7,281978
29019,0.000427,172.31.36.0-255,66,57843,7,281978
29020,0.000429,172.217.194.0-255,342,58185,7,281978
29021,0.000935,172.31.36.0-255,66,58251,7,281978
29022,0.001268,172.217.194.0-255,111,58362,7,281978
29023,0.00132,172.217.194.0-255,1484,59846,7,281978
29024,0.001324,172.31.36.0-255,66,59912,7,281978
29025,0.001356,172.217.194.0-255,2902,62814,7,281978
29026,0.001358,172.31.36.0-255,66,62880,7,281978
29027,0.001365,172.217.194.0-255,7156,70036,7,281978
29028,0.001367,172.31.36.0-255,66,70102,7,281978
29029,0.001377,172.31.36.0-255,66,70168,7,281978
29030,0.001431,172.31.36.0-255,66,70234,7,281978
29031,0.001494,172.217.194.0-255,1484,71718,7,281978
29032,0.001499,172.217.194.0-255,2902,74620,7,281978
29033,0.001502,172.31.36.0-255,66,74686,7,281978
29034,0.001507,172.217.194.0-255,4320,79006,7,281978
29035,0.001509,172.31.36.0-255,66,79072,7,281978
29036,0.001521,172.217.194.0-255,1484,80556,7,281978
29037,0.001525,172.217.194.0-255,2902,83458,7,281978
29038,0.001527,172.31.36.0-255,66,83524,7,281978
29039,0.001547,172.31.36.0-255,66,83590,7,281978
29040,0.001577,172.31.36.0-255,66,83656,7,281978
29041,0.001581,172.217.194.0-255,4320,87976,7,281978
29042,0.001583,172.31.36.0-255,66,88042,7,281978
29043,0.001598,172.217.194.0-255,5738,93780,7,281978
29044,0.0016,172.31.36.0-255,66,93846,7,281978
29045,0.001617,172.217.194.0-255,1484,95330,7,281978
29046,0.001627,172.31.36.0-255,66,95396,7,281978
29047,0.001653,172.31.36.0-255,66,95462,7,281978
29048,0.001657,172.217.194.0-255,3602,99064,7,281978
29049,0.001659,172.31.36.0-255,66,99130,7,281978
29050,0.001794,172.217.194.0-255,1484,100614,7,281978
29051,0.001819,172.217.194.0-255,2902,103516,7,281978
29052,0.001822,172.31.36.0-255,66,103582,7,281978
29053,0.001828,172.217.194.0-255,5738,109320,7,281978
29054,0.001831,172.31.36.0-255,66,109386,7,281978
29055,0.001865,172.217.194.0-255,4320,113706,7,281978
29056,0.001867,172.31.36.0-255,66,113772,7,281978
29057,0.001887,172.217.194.0-255,5738,119510,7,281978
29058,0.00189,172.31.36.0-255,66,119576,7,281978
29059,0.001895,172.217.194.0-255,4320,123896,7,281978
29060,0.001897,172.31.36.0-255,66,123962,7,281978
29061,0.001922,172.217.194.0-255,7156,131118,7,281978
29062,0.001924,172.31.36.0-255,66,131184,7,281978
29063,0.001928,172.217.194.0-255,2184,133368,7,281978
29064,0.00193,172.31.36.0-255,66,133434,7,281978
29065,0.002046,172.217.194.0-255,387,133821,7,281978
29066,0.002075,172.217.194.0-255,1484,135305,7,281978
29067,0.002078,172.31.36.0-255,66,135371,7,281978
29068,0.002091,172.217.194.0-255,4320,139691,7,281978
29069,0.002093,172.31.36.0-255,66,139757,7,281978
29070,0.002116,172.217.194.0-255,4320,144077,7,281978
29071,0.002118,172.31.36.0-255,66,144143,7,281978
29072,0.002137,172.217.194.0-255,5738,149881,7,281978
29073,0.002139,172.31.36.0-255,66,149947,7,281978
29074,0.002159,172.217.194.0-255,1484,151431,7,281978
29075,0.002185,172.31.36.0-255,66,151497,7,281978
29076,0.002202,172.217.194.0-255,1484,152981,7,281978
29077,0.002206,172.217.194.0-255,2184,155165,7,281978
29078,0.002207,172.31.36.0-255,66,155231,7,281978
29079,0.002322,172.217.194.0-255,1484,156715,7,281978
29080,0.002347,172.217.194.0-255,2902,159617,7,281978
29081,0.00235,172.31.36.0-255,66,159683,7,281978
29082,0.002372,172.217.194.0-255,5738,165421,7,281978
29083,0.002374,172.31.36.0-255,66,165487,7,281978
29084,0.00239,172.217.194.0-255,2902,168389,7,281978
29085,0.002393,172.31.36.0-255,66,168455,7,281978
29086,0.002414,172.217.194.0-255,5738,174193,7,281978
29087,0.002417,172.31.36.0-255,66,174259,7,281978
29088,0.002427,172.31.36.0-255,66,174325,7,281978
29089,0.00243,172.217.194.0-255,1484,175809,7,281978
29090,0.002444,172.217.194.0-255,3602,179411,7,281978
29091,0.002447,172.31.36.0-255,66,179477,7,281978
29092,0.002567,172.217.194.0-255,1484,180961,7,281978
29093,0.002584,172.217.194.0-255,2902,183863,7,281978
29094,0.002587,172.31.36.0-255,66,183929,7,281978
29095,0.002606,172.217.194.0-255,5738,189667,7,281978
29096,0.002609,172.31.36.0-255,66,189733,7,281978
29097,0.002611,172.217.194.0-255,1484,191217,7,281978
29098,0.002639,172.217.194.0-255,5738,196955,7,281978
29099,0.002642,172.31.36.0-255,66,197021,7,281978
29100,0.002667,172.31.36.0-255,66,197087,7,281978
29101,0.00267,172.217.194.0-255,1484,198571,7,281978
29102,0.002697,172.217.194.0-255,4320,202891,7,281978
29103,0.0027,172.31.36.0-255,66,202957,7,281978
29104,0.002717,172.217.194.0-255,3602,206559,7,281978
29105,0.002719,172.31.36.0-255,66,206625,7,281978
29106,0.002725,172.217.194.0-255,5738,212363,7,281978
29107,0.002728,172.31.36.0-255,66,212429,7,281978
29108,0.002747,172.217.194.0-255,1484,213913,7,281978
29109,0.002758,172.31.36.0-255,66,213979,7,281978
29110,0.002774,172.217.194.0-255,1484,215463,7,281978
29111,0.002783,172.31.36.0-255,66,215529,7,281978
29112,0.0028,172.217.194.0-255,2902,218431,7,281978
29113,0.002802,172.31.36.0-255,66,218497,7,281978
29114,0.002805,172.217.194.0-255,766,219263,7,281978
29115,0.002807,172.217.194.0-255,1484,220747,7,281978
29116,0.002809,172.31.36.0-255,66,220813,7,281978
29117,0.002835,172.217.194.0-255,4320,225133,7,281978
29118,0.002837,172.31.36.0-255,66,225199,7,281978
29119,0.002856,172.217.194.0-255,4320,229519,7,281978
29120,0.002858,172.31.36.0-255,66,229585,7,281978
29121,0.002874,172.217.194.0-255,1484,231069,7,281978
29122,0.002896,172.31.36.0-255,66,231135,7,281978
29123,0.002914,172.217.194.0-255,2902,234037,7,281978
29124,0.002916,172.31.36.0-255,66,234103,7,281978
29125,0.002921,172.217.194.0-255,5738,239841,7,281978
29126,0.002923,172.31.36.0-255,66,239907,7,281978
29127,0.002929,172.217.194.0-255,5020,244927,7,281978
29128,0.002932,172.31.36.0-255,66,244993,7,281978
29129,0.002951,172.217.194.0-255,1484,246477,7,281978
29130,0.002967,172.217.194.0-255,4320,250797,7,281978
29131,0.00297,172.31.36.0-255,66,250863,7,281978
29132,0.002985,172.217.194.0-255,4320,255183,7,281978
29133,0.002988,172.31.36.0-255,66,255249,7,281978
29134,0.002997,172.31.36.0-255,66,255315,7,281978
29135,0.003014,172.217.194.0-255,1484,256799,7,281978
29136,0.003027,172.217.194.0-255,2902,259701,7,281978
29137,0.00303,172.31.36.0-255,66,259767,7,281978
29138,0.003032,172.217.194.0-255,1484,261251,7,281978
29139,0.003049,172.217.194.0-255,4320,265571,7,281978
29140,0.003052,172.31.36.0-255,66,265637,7,281978
29141,0.003089,172.217.194.0-255,6438,272075,7,281978
29142,0.003091,172.31.36.0-255,66,272141,7,281978
29143,0.003117,172.31.36.0-255,66,272207,7,281978
29144,0.00314,172.217.194.0-255,1484,273691,7,281978
29145,0.003153,172.217.194.0-255,3388,277079,7,281978
29146,0.003156,172.31.36.0-255,66,277145,7,281978
29147,0.003186,172.217.194.0-255,105,277250,7,281978
29148,0.006638,172.31.36.0-255,66,277316,7,281978
29149,0.006684,172.31.36.0-255,105,277421,7,281978
29150,0.009285,172.217.194.0-255,66,277487,7,281978
29151,0.037592,172.31.36.0-255,199,277686,7,281978
29152,0.037627,172.31.36.0-255,1114,278800,7,281978
29153,0.037692,172.31.36.0-255,1514,280314,7,281978
29154,0.037693,172.31.36.0-255,1292,281606,7,281978
29155,0.039129,104.244.42.0-255,66,281672,7,281978
29156,0.039174,104.244.42.0-255,66,281738,7,281978
29157,0.039264,104.244.42.0-255,66,281804,7,281978
29158,0.039968,104.244.42.0-255,108,281912,7,281978
29159,0.039974,172.31.36.0-255,66,281978,7,281978
29160,0.0,172.217.194.0-255,153,153,7,286575
29161,3.5e-05,172.31.36.0-255,66,219,7,286575
29162,4.2e-05,172.217.194.0-255,1484,1703,7,286575
29163,4.5e-05,172.31.36.0-255,66,1769,7,286575
29164,5e-05,172.217.194.0-255,2902,4671,7,286575
29165,5.3e-05,172.31.36.0-255,66,4737,7,286575
29166,6.9e-05,172.217.194.0-255,7156,11893,7,286575
29167,7.3e-05,172.31.36.0-255,66,11959,7,286575
29168,0.000176,172.217.194.0-255,2048,14007,7,286575
29169,0.000183,172.31.36.0-255,66,14073,7,286575
29170,0.000202,172.217.194.0-255,2902,16975,7,286575
29171,0.000206,172.31.36.0-255,66,17041,7,286575
29172,0.00024,172.217.194.0-255,5738,22779,7,286575
29173,0.000244,172.31.36.0-255,66,22845,7,286575
29174,0.000269,172.217.194.0-255,1484,24329,7,286575
29175,0.000273,172.31.36.0-255,66,24395,7,286575
29176,0.000363,172.217.194.0-255,2902,27297,7,286575
29177,0.000367,172.31.36.0-255,66,27363,7,286575
29178,0.000389,172.217.194.0-255,3961,31324,7,286575
29179,0.000393,172.31.36.0-255,66,31390,7,286575
29180,0.000473,172.217.194.0-255,2902,34292,7,286575
29181,0.000478,172.31.36.0-255,66,34358,7,286575
29182,0.000512,172.217.194.0-255,4320,38678,7,286575
29183,0.000515,172.31.36.0-255,66,38744,7,286575
29184,0.000567,172.217.194.0-255,7156,45900,7,286575
29185,0.000572,172.31.36.0-255,66,45966,7,286575
29186,0.000696,172.217.194.0-255,5738,51704,7,286575
29187,0.0007,172.31.36.0-255,66,51770,7,286575
29188,0.000749,172.31.36.0-255,66,51836,7,286575
29189,0.000986,172.217.194.0-255,646,52482,7,286575
29190,0.000992,172.31.36.0-255,66,52548,7,286575
29191,0.001127,172.217.194.0-255,1484,54032,7,286575
29192,0.001138,172.217.194.0-255,2902,56934,7,286575
29193,0.001173,172.217.194.0-255,4320,61254,7,286575
29194,0.001182,172.217.194.0-255,1484,62738,7,286575
29195,0.001243,172.31.36.0-255,66,62804,7,286575
29196,0.001315,172.31.36.0-255,66,62870,7,286575
29197,0.001435,172.217.194.0-255,6438,69308,7,286575
29198,0.001439,172.31.36.0-255,66,69374,7,286575
29199,0.001446,172.31.36.0-255,66,69440,7,286575
29200,0.001704,172.217.194.0-255,1484,70924,7,286575
29201,0.001711,172.217.194.0-255,2902,73826,7,286575
29202,0.001714,172.31.36.0-255,66,73892,7,286575
29203,0.001747,172.217.194.0-255,5738,79630,7,286575
29204,0.001789,172.31.36.0-255,66,79696,7,286575
29205,0.001837,172.217.194.0-255,4320,84016,7,286575
29206,0.001867,172.31.36.0-255,66,84082,7,286575
29207,0.002064,172.217.194.0-255,5738,89820,7,286575
29208,0.002068,172.31.36.0-255,66,89886,7,286575
29209,0.0021,172.217.194.0-255,5020,94906,7,286575
29210,0.002129,172.31.36.0-255,66,94972,7,286575
29211,0.00224,172.217.194.0-255,4320,99292,7,286575
29212,0.002254,172.217.194.0-255,4320,103612,7,286575
29213,0.002259,172.31.36.0-255,66,103678,7,286575
29214,0.002353,172.217.194.0-255,7156,110834,7,286575
29215,0.002356,172.31.36.0-255,66,110900,7,286575
29216,0.002414,172.31.36.0-255,66,110966,7,286575
29217,0.002716,172.31.36.0-255,66,111032,7,286575
29218,0.002782,172.31.36.0-255,66,111098,7,286575
29219,0.003411,172.217.194.0-255,7156,118254,7,286575
29220,0.003415,172.31.36.0-255,66,118320,7,286575
29221,0.003436,172.217.194.0-255,7156,125476,7,286575
29222,0.003489,172.31.36.0-255,66,125542,7,286575
29223,0.003834,172.31.36.0-255,66,125608,7,286575
29224,0.006209,172.217.194.0-255,5738,131346,7,286575
29225,0.006218,172.31.36.0-255,66,131412,7,286575
29226,0.008591,172.217.194.0-255,5738,137150,7,286575
29227,0.0086,172.31.36.0-255,66,137216,7,286575
29228,0.010985,172.217.194.0-255,5738,142954,7,286575
29229,0.010994,172.31.36.0-255,66,143020,7,286575
29230,0.013351,172.217.194.0-255,5738,148758,7,286575
29231,0.013367,172.31.36.0-255,66,148824,7,286575
29232,0.015761,172.217.194.0-255,5738,154562,7,286575
29233,0.015777,172.31.36.0-255,66,154628,7,286575
29234,0.01814,172.217.194.0-255,5738,160366,7,286575
29235,0.018153,172.31.36.0-255,66,160432,7,286575
29236,0.020537,172.217.194.0-255,5738,166170,7,286575
29237,0.020545,172.31.36.0-255,66,166236,7,286575
29238,0.02294,172.217.194.0-255,5738,171974,7,286575
29239,0.022948,172.31.36.0-255,66,172040,7,286575
29240,0.023856,172.31.36.0-255,192,172232,7,286575
29241,0.023883,172.31.36.0-255,1115,173347,7,286575
29242,0.023929,172.31.36.0-255,1514,174861,7,286575
29243,0.023931,172.31.36.0-255,1514,176375,7,286575
29244,0.023936,172.31.36.0-255,1514,177889,7,286575
29245,0.023937,172.31.36.0-255,1072,178961,7,286575
29246,0.025325,172.217.194.0-255,5738,184699,7,286575
29247,0.025333,172.31.36.0-255,66,184765,7,286575
29248,0.025394,104.244.42.0-255,66,184831,7,286575
29249,0.025445,104.244.42.0-255,66,184897,7,286575
29250,0.025524,104.244.42.0-255,66,184963,7,286575
29251,0.025542,104.244.42.0-255,66,185029,7,286575
29252,0.027783,172.217.194.0-255,5738,190767,7,286575
29253,0.02779,172.31.36.0-255,66,190833,7,286575
29254,0.03022,172.217.194.0-255,5738,196571,7,286575
29255,0.030232,172.31.36.0-255,66,196637,7,286575
29256,0.032584,172.217.194.0-255,2902,199539,7,286575
29257,0.032591,172.31.36.0-255,66,199605,7,286575
29258,0.032622,172.217.194.0-255,2902,202507,7,286575
29259,0.032694,172.31.36.0-255,66,202573,7,286575
29260,0.034974,172.217.194.0-255,2902,205475,7,286575
29261,0.034981,172.31.36.0-255,66,205541,7,286575
29262,0.035086,172.217.194.0-255,2902,208443,7,286575
29263,0.035093,172.31.36.0-255,66,208509,7,286575
29264,0.037401,172.217.194.0-255,2902,211411,7,286575
29265,0.03741,172.31.36.0-255,66,211477,7,286575
29266,0.037459,172.217.194.0-255,2902,214379,7,286575
29267,0.037484,172.31.36.0-255,66,214445,7,286575
29268,0.039776,172.217.194.0-255,2902,217347,7,286575
29269,0.039789,172.31.36.0-255,66,217413,7,286575
29270,0.039843,172.217.194.0-255,2902,220315,7,286575
29271,0.039884,172.31.36.0-255,66,220381,7,286575
29272,0.042186,172.217.194.0-255,2902,223283,7,286575
29273,0.042193,172.31.36.0-255,66,223349,7,286575
29274,0.042247,172.217.194.0-255,2902,226251,7,286575
29275,0.042269,172.31.36.0-255,66,226317,7,286575
29276,0.044553,172.217.194.0-255,2902,229219,7,286575
29277,0.044559,172.31.36.0-255,66,229285,7,286575
29278,0.044625,172.217.194.0-255,2902,232187,7,286575
29279,0.044662,172.31.36.0-255,66,232253,7,286575
29280,0.04693,172.217.194.0-255,1484,233737,7,286575
29281,0.047067,172.217.194.0-255,4320,238057,7,286575
29282,0.047074,172.31.36.0-255,66,238123,7,286575
29283,0.049431,172.217.194.0-255,5738,243861,7,286575
29284,0.049496,172.31.36.0-255,66,243927,7,286575
29285,0.051862,172.217.194.0-255,5738,249665,7,286575
29286,0.05187,172.31.36.0-255,66,249731,7,286575
29287,0.054242,172.217.194.0-255,5738,255469,7,286575
29288,0.054249,172.31.36.0-255,66,255535,7,286575
29289,0.056613,172.217.194.0-255,5738,261273,7,286575
29290,0.056624,172.31.36.0-255,66,261339,7,286575
29291,0.058991,172.217.194.0-255,5738,267077,7,286575
29292,0.058999,172.31.36.0-255,66,267143,7,286575
29293,0.06136,172.217.194.0-255,5738,272881,7,286575
29294,0.061368,172.31.36.0-255,66,272947,7,286575
29295,0.063755,172.217.194.0-255,5738,278685,7,286575
29296,0.063764,172.31.36.0-255,66,278751,7,286575
29297,0.066159,172.217.194.0-255,5738,284489,7,286575
29298,0.066168,172.31.36.0-255,66,284555,7,286575
29299,0.068558,172.217.194.0-255,1783,286338,7,286575
29300,0.068564,172.31.36.0-255,66,286404,7,286575
29301,0.06874,172.31.36.0-255,105,286509,7,286575
29302,0.071096,172.217.194.0-255,66,286575,7,286575
29303,0.0,172.217.194.0-255,147,147,7,267021
29304,2.6e-05,172.31.36.0-255,66,213,7,267021
29305,3.9e-05,172.217.194.0-255,1484,1697,7,267021
29306,4.4e-05,172.31.36.0-255,66,1763,7,267021
29307,4.8e-05,172.217.194.0-255,2902,4665,7,267021
29308,5.1e-05,172.31.36.0-255,66,4731,7,267021
29309,7e-05,172.217.194.0-255,4320,9051,7,267021
29310,7.2e-05,172.31.36.0-255,66,9117,7,267021
29311,9.2e-05,172.217.194.0-255,2902,12019,7,267021
29312,9.6e-05,172.31.36.0-255,66,12085,7,267021
29313,0.000134,172.217.194.0-255,6300,18385,7,267021
29314,0.000137,172.31.36.0-255,66,18451,7,267021
29315,0.000145,172.217.194.0-255,7156,25607,7,267021
29316,0.000148,172.31.36.0-255,66,25673,7,267021
29317,0.000195,172.217.194.0-255,2902,28575,7,267021
29318,0.000199,172.31.36.0-255,66,28641,7,267021
29319,0.000216,172.217.194.0-255,2543,31184,7,267021
29320,0.000219,172.31.36.0-255,66,31250,7,267021
29321,0.00025,172.217.194.0-255,1484,32734,7,267021
29322,0.000254,172.31.36.0-255,66,32800,7,267021
29323,0.000258,172.217.194.0-255,2902,35702,7,267021
29324,0.000261,172.31.36.0-255,66,35768,7,267021
29325,0.000286,172.217.194.0-255,5738,41506,7,267021
29326,0.00029,172.31.36.0-255,66,41572,7,267021
29327,0.000295,172.217.194.0-255,4320,45892,7,267021
29328,0.000297,172.31.36.0-255,66,45958,7,267021
29329,0.000313,172.217.194.0-255,2543,48501,7,267021
29330,0.000317,172.31.36.0-255,66,48567,7,267021
29331,0.000328,172.217.194.0-255,1484,50051,7,267021
29332,0.000331,172.31.36.0-255,66,50117,7,267021
29333,0.000362,172.31.36.0-255,66,50183,7,267021
29334,0.000366,172.217.194.0-255,2543,52726,7,267021
29335,0.000368,172.31.36.0-255,66,52792,7,267021
29336,0.000663,172.217.194.0-255,365,53157,7,267021
29337,0.000696,172.217.194.0-255,379,53536,7,267021
29338,0.000867,172.31.36.0-255,66,53602,7,267021
29339,0.00112,172.217.194.0-255,1484,55086,7,267021
29340,0.00113,172.217.194.0-255,2902,57988,7,267021
29341,0.001135,172.31.36.0-255,66,58054,7,267021
29342,0.001142,172.217.194.0-255,5738,63792,7,267021
29343,0.001144,172.31.36.0-255,66,63858,7,267021
29344,0.001184,172.31.36.0-255,66,63924,7,267021
29345,0.001196,172.31.36.0-255,66,63990,7,267021
29346,0.001242,172.217.194.0-255,766,64756,7,267021
29347,0.002022,172.217.194.0-255,1484,66240,7,267021
29348,0.002028,172.31.36.0-255,66,66306,7,267021
29349,0.002035,172.217.194.0-255,2902,69208,7,267021
29350,0.002037,172.31.36.0-255,66,69274,7,267021
29351,0.002059,172.217.194.0-255,2902,72176,7,267021
29352,0.002061,172.31.36.0-255,66,72242,7,267021
29353,0.002083,172.217.194.0-255,2902,75144,7,267021
29354,0.002085,172.31.36.0-255,66,75210,7,267021
29355,0.002096,172.31.36.0-255,66,75276,7,267021
29356,0.002101,172.217.194.0-255,4320,79596,7,267021
29357,0.002103,172.31.36.0-255,66,79662,7,267021
29358,0.002118,172.217.194.0-255,4320,83982,7,267021
29359,0.00212,172.31.36.0-255,66,84048,7,267021
29360,0.002138,172.217.194.0-255,5020,89068,7,267021
29361,0.00214,172.31.36.0-255,66,89134,7,267021
29362,0.002279,172.217.194.0-255,1484,90618,7,267021
29363,0.002284,172.217.194.0-255,2902,93520,7,267021
29364,0.002286,172.31.36.0-255,66,93586,7,267021
29365,0.002305,172.217.194.0-255,2902,96488,7,267021
29366,0.002308,172.31.36.0-255,66,96554,7,267021
29367,0.002322,172.217.194.0-255,2902,99456,7,267021
29368,0.002324,172.31.36.0-255,66,99522,7,267021
29369,0.002329,172.217.194.0-255,4320,103842,7,267021
29370,0.002332,172.31.36.0-255,66,103908,7,267021
29371,0.002352,172.217.194.0-255,2902,106810,7,267021
29372,0.002354,172.31.36.0-255,66,106876,7,267021
29373,0.00237,172.217.194.0-255,1484,108360,7,267021
29374,0.002389,172.217.194.0-255,4320,112680,7,267021
29375,0.002392,172.31.36.0-255,66,112746,7,267021
29376,0.002413,172.217.194.0-255,7156,119902,7,267021
29377,0.002416,172.31.36.0-255,66,119968,7,267021
29378,0.002419,172.217.194.0-255,1484,121452,7,267021
29379,0.002423,172.217.194.0-255,2184,123636,7,267021
29380,0.002425,172.31.36.0-255,66,123702,7,267021
29381,0.00243,172.217.194.0-255,5738,129440,7,267021
29382,0.002433,172.31.36.0-255,66,129506,7,267021
29383,0.002435,172.217.194.0-255,1484,130990,7,267021
29384,0.002438,172.217.194.0-255,1484,132474,7,267021
29385,0.00244,172.31.36.0-255,66,132540,7,267021
29386,0.00246,172.217.194.0-255,2902,135442,7,267021
29387,0.002462,172.31.36.0-255,66,135508,7,267021
29388,0.002485,172.31.36.0-255,66,135574,7,267021
29389,0.00249,172.217.194.0-255,4320,139894,7,267021
29390,0.002492,172.31.36.0-255,66,139960,7,267021
29391,0.002519,172.31.36.0-255,66,140026,7,267021
29392,0.002522,172.217.194.0-255,2184,142210,7,267021
29393,0.002524,172.31.36.0-255,66,142276,7,267021
29394,0.002528,172.217.194.0-255,2902,145178,7,267021
29395,0.00253,172.31.36.0-255,66,145244,7,267021
29396,0.002558,172.217.194.0-255,7156,152400,7,267021
29397,0.00256,172.31.36.0-255,66,152466,7,267021
29398,0.002586,172.31.36.0-255,66,152532,7,267021
29399,0.002602,172.217.194.0-255,1484,154016,7,267021
29400,0.00263,172.31.36.0-255,66,154082,7,267021
29401,0.002633,172.217.194.0-255,766,154848,7,267021
29402,0.002674,172.217.194.0-255,4320,159168,7,267021
29403,0.002676,172.31.36.0-255,66,159234,7,267021
29404,0.002695,172.217.194.0-255,2902,162136,7,267021
29405,0.002698,172.31.36.0-255,66,162202,7,267021
29406,0.002724,172.31.36.0-255,66,162268,7,267021
29407,0.002731,172.217.194.0-255,7156,169424,7,267021
29408,0.002733,172.31.36.0-255,66,169490,7,267021
29409,0.002758,172.217.194.0-255,5738,175228,7,267021
29410,0.002761,172.31.36.0-255,66,175294,7,267021
29411,0.002767,172.217.194.0-255,5738,181032,7,267021
29412,0.002769,172.31.36.0-255,66,181098,7,267021
29413,0.00279,172.31.36.0-255,66,181164,7,267021
29414,0.002796,172.217.194.0-255,5738,186902,7,267021
29415,0.002798,172.31.36.0-255,66,186968,7,267021
29416,0.00287,172.31.36.0-255,66,187034,7,267021
29417,0.002891,172.217.194.0-255,6438,193472,7,267021
29418,0.002894,172.31.36.0-255,66,193538,7,267021
29419,0.003311,172.217.194.0-255,1484,195022,7,267021
29420,0.003316,172.217.194.0-255,1484,196506,7,267021
29421,0.003319,172.31.36.0-255,66,196572,7,267021
29422,0.003337,172.217.194.0-255,1484,198056,7,267021
29423,0.003341,172.217.194.0-255,2902,200958,7,267021
29424,0.003343,172.31.36.0-255,66,201024,7,267021
29425,0.003366,172.217.194.0-255,7156,208180,7,267021
29426,0.003369,172.31.36.0-255,66,208246,7,267021
29427,0.0034,172.31.36.0-255,66,208312,7,267021
29428,0.00342,172.217.194.0-255,7156,215468,7,267021
29429,0.003423,172.31.36.0-255,66,215534,7,267021
29430,0.003447,172.217.194.0-255,3602,219136,7,267021
29431,0.003452,172.31.36.0-255,66,219202,7,267021
29432,0.003587,172.217.194.0-255,1484,220686,7,267021
29433,0.003593,172.217.194.0-255,2902,223588,7,267021
29434,0.003595,172.31.36.0-255,66,223654,7,267021
29435,0.003619,172.217.194.0-255,5738,229392,7,267021
29436,0.003621,172.31.36.0-255,66,229458,7,267021
29437,0.003639,172.217.194.0-255,1484,230942,7,267021
29438,0.003666,172.31.36.0-255,66,231008,7,267021
29439,0.003685,172.217.194.0-255,2902,233910,7,267021
29440,0.003688,172.31.36.0-255,66,233976,7,267021
29441,0.003717,172.217.194.0-255,1484,235460,7,267021
29442,0.003718,172.31.36.0-255,66,235526,7,267021
29443,0.003739,172.217.194.0-255,4320,239846,7,267021
29444,0.003742,172.31.36.0-255,66,239912,7,267021
29445,0.003771,172.217.194.0-255,4320,244232,7,267021
29446,0.003775,172.31.36.0-255,66,244298,7,267021
29447,0.003809,172.31.36.0-255,66,244364,7,267021
29448,0.003815,172.217.194.0-255,3602,247966,7,267021
29449,0.003817,172.31.36.0-255,66,248032,7,267021
29450,0.003821,172.217.194.0-255,2902,250934,7,267021
29451,0.003824,172.31.36.0-255,66,251000,7,267021
29452,0.003847,172.217.194.0-255,6357,257357,7,267021
29453,0.00385,172.31.36.0-255,66,257423,7,267021
29454,0.003869,172.217.194.0-255,105,257528,7,267021
29455,0.005851,172.31.36.0-255,66,257594,7,267021
29456,0.00588,172.31.36.0-255,105,257699,7,267021
29457,0.007897,172.217.194.0-255,66,257765,7,267021
29458,0.034393,172.31.36.0-255,172,257937,7,267021
29459,0.034422,172.31.36.0-255,1113,259050,7,267021
29460,0.034497,172.31.36.0-255,1514,260564,7,267021
29461,0.034499,172.31.36.0-255,1514,262078,7,267021
29462,0.034501,172.31.36.0-255,1514,263592,7,267021
29463,0.034507,172.31.36.0-255,1514,265106,7,267021
29464,0.034508,172.31.36.0-255,1514,266620,7,267021
29465,0.034509,172.31.36.0-255,71,266691,7,267021
29466,0.035948,104.244.42.0-255,66,266757,7,267021
29467,0.03599,104.244.42.0-255,66,266823,7,267021
29468,0.036065,104.244.42.0-255,66,266889,7,267021
29469,0.036071,104.244.42.0-255,66,266955,7,267021
29470,0.036074,104.244.42.0-255,66,267021,7,267021
29471,0.0,172.217.194.0-255,144,144,7,209709
29472,2.5e-05,172.31.36.0-255,66,210,7,209709
29473,3.2e-05,172.217.194.0-255,1484,1694,7,209709
29474,3.7e-05,172.31.36.0-255,66,1760,7,209709
29475,4.2e-05,172.217.194.0-255,2902,4662,7,209709
29476,5.3e-05,172.31.36.0-255,66,4728,7,209709
29477,6e-05,172.217.194.0-255,7156,11884,7,209709
29478,6.3e-05,172.31.36.0-255,66,11950,7,209709
29479,6.8e-05,172.217.194.0-255,2038,13988,7,209709
29480,7e-05,172.31.36.0-255,66,14054,7,209709
29481,7.7e-05,172.217.194.0-255,7156,21210,7,209709
29482,8e-05,172.31.36.0-255,66,21276,7,209709
29483,0.000112,172.217.194.0-255,4320,25596,7,209709
29484,0.000116,172.31.36.0-255,66,25662,7,209709
29485,0.000122,172.217.194.0-255,5379,31041,7,209709
29486,0.000125,172.31.36.0-255,66,31107,7,209709
29487,0.000154,172.217.194.0-255,4320,35427,7,209709
29488,0.000156,172.31.36.0-255,66,35493,7,209709
29489,0.000163,172.217.194.0-255,5738,41231,7,209709
29490,0.000166,172.31.36.0-255,66,41297,7,209709
29491,0.000198,172.217.194.0-255,1484,42781,7,209709
29492,0.0002,172.31.36.0-255,66,42847,7,209709
29493,0.000235,172.217.194.0-255,5379,48226,7,209709
29494,0.000238,172.31.36.0-255,66,48292,7,209709
29495,0.000433,172.217.194.0-255,1484,49776,7,209709
29496,0.000438,172.31.36.0-255,66,49842,7,209709
29497,0.000443,172.217.194.0-255,2902,52744,7,209709
29498,0.000446,172.31.36.0-255,66,52810,7,209709
29499,0.000449,172.217.194.0-255,1484,54294,7,209709
29500,0.000458,172.31.36.0-255,66,54360,7,209709
29501,0.000492,172.217.194.0-255,4320,58680,7,209709
29502,0.000497,172.31.36.0-255,66,58746,7,209709
29503,0.000503,172.217.194.0-255,5738,64484,7,209709
29504,0.000506,172.31.36.0-255,66,64550,7,209709
29505,0.000515,172.217.194.0-255,1125,65675,7,209709
29506,0.000731,172.217.194.0-255,1484,67159,7,209709
29507,0.000736,172.31.36.0-255,66,67225,7,209709
29508,0.000742,172.217.194.0-255,2902,70127,7,209709
29509,0.000744,172.31.36.0-255,66,70193,7,209709
29510,0.000758,172.217.194.0-255,5738,75931,7,209709
29511,0.000761,172.31.36.0-255,66,75997,7,209709
29512,0.000766,172.217.194.0-255,2902,78899,7,209709
29513,0.000768,172.31.36.0-255,66,78965,7,209709
29514,0.000814,172.31.36.0-255,66,79031,7,209709
29515,0.000819,172.217.194.0-255,2902,81933,7,209709
29516,0.000821,172.31.36.0-255,66,81999,7,209709
29517,0.000862,172.31.36.0-255,66,82065,7,209709
29518,0.000866,172.217.194.0-255,1484,83549,7,209709
29519,0.00087,172.217.194.0-255,2902,86451,7,209709
29520,0.000872,172.31.36.0-255,66,86517,7,209709
29521,0.000877,172.217.194.0-255,2902,89419,7,209709
29522,0.000879,172.31.36.0-255,66,89485,7,209709
29523,0.000918,172.217.194.0-255,2902,92387,7,209709
29524,0.000923,172.31.36.0-255,66,92453,7,209709
29525,0.000924,172.217.194.0-255,6797,99250,7,209709
29526,0.000926,172.31.36.0-255,66,99316,7,209709
29527,0.000984,172.217.194.0-255,1484,100800,7,209709
29528,0.000998,172.217.194.0-255,1484,102284,7,209709
29529,0.001001,172.31.36.0-255,66,102350,7,209709
29530,0.001022,172.217.194.0-255,1484,103834,7,209709
29531,0.001028,172.217.194.0-255,5738,109572,7,209709
29532,0.001031,172.31.36.0-255,66,109638,7,209709
29533,0.001083,172.217.194.0-255,4320,113958,7,209709
29534,0.001088,172.31.36.0-255,66,114024,7,209709
29535,0.001111,172.31.36.0-255,66,114090,7,209709
29536,0.001121,172.31.36.0-255,66,114156,7,209709
29537,0.001127,172.217.194.0-255,2184,116340,7,209709
29538,0.001128,172.31.36.0-255,66,116406,7,209709
29539,0.001132,172.217.194.0-255,2902,119308,7,209709
29540,0.001135,172.31.36.0-255,66,119374,7,209709
29541,0.001142,172.217.194.0-255,7156,126530,7,209709
29542,0.001144,172.31.36.0-255,66,126596,7,209709
29543,0.001186,172.31.36.0-255,66,126662,7,209709
29544,0.001229,172.31.36.0-255,66,126728,7,209709
29545,0.001236,172.217.194.0-255,7156,133884,7,209709
29546,0.001239,172.31.36.0-255,66,133950,7,209709
29547,0.001286,172.31.36.0-255,66,134016,7,209709
29548,0.001289,172.217.194.0-255,766,134782,7,209709
29549,0.001329,172.217.194.0-255,7156,141938,7,209709
29550,0.001333,172.31.36.0-255,66,142004,7,209709
29551,0.001364,172.31.36.0-255,66,142070,7,209709
29552,0.001375,172.31.36.0-255,66,142136,7,209709
29553,0.001407,172.217.194.0-255,2184,144320,7,209709
29554,0.001411,172.31.36.0-255,66,144386,7,209709
29555,0.001659,172.217.194.0-255,1484,145870,7,209709
29556,0.001665,172.217.194.0-255,2902,148772,7,209709
29557,0.001668,172.31.36.0-255,66,148838,7,209709
29558,0.001674,172.217.194.0-255,4320,153158,7,209709
29559,0.001677,172.31.36.0-255,66,153224,7,209709
29560,0.001709,172.217.194.0-255,1484,154708,7,209709
29561,0.001725,172.217.194.0-255,4320,159028,7,209709
29562,0.001728,172.31.36.0-255,66,159094,7,209709
29563,0.001757,172.31.36.0-255,66,159160,7,209709
29564,0.001793,172.31.36.0-255,66,159226,7,209709
29565,0.001896,172.217.194.0-255,1484,160710,7,209709
29566,0.001901,172.217.194.0-255,1484,162194,7,209709
29567,0.001904,172.31.36.0-255,66,162260,7,209709
29568,0.001939,172.217.194.0-255,1484,163744,7,209709
29569,0.001946,172.217.194.0-255,4320,168064,7,209709
29570,0.001949,172.31.36.0-255,66,168130,7,209709
29571,0.001959,172.31.36.0-255,66,168196,7,209709
29572,0.001992,172.217.194.0-255,4320,172516,7,209709
29573,0.001996,172.31.36.0-255,66,172582,7,209709
29574,0.002023,172.31.36.0-255,66,172648,7,209709
29575,0.002084,172.217.194.0-255,2184,174832,7,209709
29576,0.002089,172.31.36.0-255,66,174898,7,209709
29577,0.002093,172.217.194.0-255,2902,177800,7,209709
29578,0.002095,172.31.36.0-255,66,177866,7,209709
29579,0.002108,172.217.194.0-255,7156,185022,7,209709
29580,0.002111,172.31.36.0-255,66,185088,7,209709
29581,0.002123,172.31.36.0-255,66,185154,7,209709
29582,0.002137,172.31.36.0-255,66,185220,7,209709
29583,0.002171,172.217.194.0-255,766,185986,7,209709
29584,0.002178,172.217.194.0-255,5738,191724,7,209709
29585,0.002182,172.31.36.0-255,66,191790,7,209709
29586,0.002197,172.31.36.0-255,66,191856,7,209709
29587,0.002223,172.217.194.0-255,5738,197594,7,209709
29588,0.002231,172.31.36.0-255,66,197660,7,209709
29589,0.002238,172.217.194.0-255,6438,204098,7,209709
29590,0.002241,172.31.36.0-255,66,204164,7,209709
29591,0.002296,172.31.36.0-255,66,204230,7,209709
29592,0.002319,172.31.36.0-255,66,204296,7,209709
29593,0.002322,172.217.194.0-255,97,204393,7,209709
29594,0.00355,172.31.36.0-255,101,204494,7,209709
29595,0.004544,172.217.194.0-255,168,204662,7,209709
29596,0.005776,172.217.194.0-255,66,204728,7,209709
29597,0.008417,172.31.36.0-255,105,204833,7,209709
29598,0.008441,172.31.36.0-255,105,204938,7,209709
29599,0.009476,172.31.36.0-255,90,205028,7,209709
29600,0.009488,172.31.36.0-255,66,205094,7,209709
29601,0.0107,172.217.194.0-255,66,205160,7,209709
29602,0.010708,172.217.194.0-255,66,205226,7,209709
29603,0.011714,172.217.194.0-255,66,205292,7,209709
29604,0.01174,172.217.194.0-255,66,205358,7,209709
29605,0.011746,172.31.36.0-255,66,205424,7,209709
29606,0.026506,172.31.36.0-255,167,205591,7,209709
29607,0.026557,172.31.36.0-255,1114,206705,7,209709
29608,0.026574,172.31.36.0-255,1514,208219,7,209709
29609,0.026576,172.31.36.0-255,1292,209511,7,209709
29610,0.028045,104.244.42.0-255,66,209577,7,209709
29611,0.028122,104.244.42.0-255,66,209643,7,209709
29612,0.028125,104.244.42.0-255,66,209709,7,209709
29613,0.0,172.217.194.0-255,152,152,7,180887
29614,2.3e-05,172.31.36.0-255,66,218,7,180887
29615,2.9e-05,172.217.194.0-255,1484,1702,7,180887
29616,3.3e-05,172.31.36.0-255,66,1768,7,180887
29617,3.8e-05,172.217.194.0-255,2902,4670,7,180887
29618,4e-05,172.31.36.0-255,66,4736,7,180887
29619,5.5e-05,172.217.194.0-255,4320,9056,7,180887
29620,5.8e-05,172.31.36.0-255,66,9122,7,180887
29621,7.8e-05,172.217.194.0-255,2902,12024,7,180887
29622,8e-05,172.31.36.0-255,66,12090,7,180887
29623,0.000119,172.217.194.0-255,5738,17828,7,180887
29624,0.000121,172.31.36.0-255,66,17894,7,180887
29625,0.000139,172.217.194.0-255,6299,24193,7,180887
29626,0.000142,172.31.36.0-255,66,24259,7,180887
29627,0.000157,172.217.194.0-255,2902,27161,7,180887
29628,0.00016,172.31.36.0-255,66,27227,7,180887
29629,0.000185,172.217.194.0-255,3961,31188,7,180887
29630,0.000188,172.31.36.0-255,66,31254,7,180887
29631,0.000215,172.217.194.0-255,1484,32738,7,180887
29632,0.000217,172.31.36.0-255,66,32804,7,180887
29633,0.000236,172.217.194.0-255,2902,35706,7,180887
29634,0.000239,172.31.36.0-255,66,35772,7,180887
29635,0.00026,172.217.194.0-255,5738,41510,7,180887
29636,0.000263,172.31.36.0-255,66,41576,7,180887
29637,0.000266,172.217.194.0-255,1484,43060,7,180887
29638,0.000268,172.31.36.0-255,66,43126,7,180887
29639,0.000293,172.217.194.0-255,4320,47446,7,180887
29640,0.000296,172.31.36.0-255,66,47512,7,180887
29641,0.00031,172.31.36.0-255,66,47578,7,180887
29642,0.000316,172.217.194.0-255,5331,52909,7,180887
29643,0.000319,172.31.36.0-255,66,52975,7,180887
29644,0.00049,172.217.194.0-255,100,53075,7,180887
29645,0.000735,172.217.194.0-255,1484,54559,7,180887
29646,0.000739,172.217.194.0-255,2902,57461,7,180887
29647,0.000745,172.31.36.0-255,66,57527,7,180887
29648,0.000755,172.31.36.0-255,66,57593,7,180887
29649,0.000759,172.217.194.0-255,1484,59077,7,180887
29650,0.000774,172.217.194.0-255,4320,63397,7,180887
29651,0.000776,172.31.36.0-255,66,63463,7,180887
29652,0.000784,172.217.194.0-255,4320,67783,7,180887
29653,0.000786,172.31.36.0-255,66,67849,7,180887
29654,0.000822,172.31.36.0-255,66,67915,7,180887
29655,0.000834,172.31.36.0-255,66,67981,7,180887
29656,0.000837,172.217.194.0-255,766,68747,7,180887
29657,0.000858,172.217.194.0-255,1484,70231,7,180887
29658,0.000876,172.217.194.0-255,4320,74551,7,180887
29659,0.000881,172.31.36.0-255,66,74617,7,180887
29660,0.000884,172.31.36.0-255,66,74683,7,180887
29661,0.000923,172.31.36.0-255,66,74749,7,180887
29662,0.00093,172.217.194.0-255,5738,80487,7,180887
29663,0.000932,172.31.36.0-255,66,80553,7,180887
29664,0.00097,172.31.36.0-255,66,80619,7,180887
29665,0.000974,172.217.194.0-255,2184,82803,7,180887
29666,0.000976,172.31.36.0-255,66,82869,7,180887
29667,0.001021,172.217.194.0-255,1484,84353,7,180887
29668,0.001025,172.217.194.0-255,1484,85837,7,180887
29669,0.001028,172.31.36.0-255,66,85903,7,180887
29670,0.001046,172.217.194.0-255,1484,87387,7,180887
29671,0.001051,172.217.194.0-255,4320,91707,7,180887
29672,0.001054,172.31.36.0-255,66,91773,7,180887
29673,0.001059,172.217.194.0-255,2902,94675,7,180887
29674,0.001062,172.31.36.0-255,66,94741,7,180887
29675,0.001082,172.217.194.0-255,2902,97643,7,180887
29676,0.001084,172.31.36.0-255,66,97709,7,180887
29677,0.001096,172.31.36.0-255,66,97775,7,180887
29678,0.001113,172.217.194.0-255,1484,99259,7,180887
29679,0.001124,172.31.36.0-255,66,99325,7,180887
29680,0.001154,172.217.194.0-255,1484,100809,7,180887
29681,0.001194,172.31.36.0-255,66,100875,7,180887
29682,0.001222,172.217.194.0-255,1484,102359,7,180887
29683,0.001227,172.217.194.0-255,2902,105261,7,180887
29684,0.001292,172.217.194.0-255,2902,108163,7,180887
29685,0.001295,172.31.36.0-255,66,108229,7,180887
29686,0.001301,172.31.36.0-255,66,108295,7,180887
29687,0.001319,172.217.194.0-255,2902,111197,7,180887
29688,0.001356,172.31.36.0-255,66,111263,7,180887
29689,0.00215,172.217.194.0-255,1484,112747,7,180887
29690,0.002155,172.217.194.0-255,1484,114231,7,180887
29691,0.002158,172.31.36.0-255,66,114297,7,180887
29692,0.002178,172.217.194.0-255,1484,115781,7,180887
29693,0.002183,172.217.194.0-255,4320,120101,7,180887
29694,0.002185,172.31.36.0-255,66,120167,7,180887
29695,0.002204,172.217.194.0-255,1484,121651,7,180887
29696,0.002211,172.217.194.0-255,5738,127389,7,180887
29697,0.002213,172.31.36.0-255,66,127455,7,180887
29698,0.002236,172.217.194.0-255,7156,134611,7,180887
29699,0.002238,172.31.36.0-255,66,134677,7,180887
29700,0.002251,172.31.36.0-255,66,134743,7,180887
29701,0.002286,172.217.194.0-255,1484,136227,7,180887
29702,0.002308,172.217.194.0-255,5738,141965,7,180887
29703,0.002311,172.31.36.0-255,66,142031,7,180887
29704,0.002319,172.217.194.0-255,7156,149187,7,180887
29705,0.002322,172.31.36.0-255,66,149253,7,180887
29706,0.002344,172.217.194.0-255,1484,150737,7,180887
29707,0.002358,172.31.36.0-255,66,150803,7,180887
29708,0.002377,172.217.194.0-255,4320,155123,7,180887
29709,0.002379,172.31.36.0-255,66,155189,7,180887
29710,0.002385,172.217.194.0-255,5020,160209,7,180887
29711,0.002387,172.31.36.0-255,66,160275,7,180887
29712,0.002392,172.217.194.0-255,4320,164595,7,180887
29713,0.002394,172.31.36.0-255,66,164661,7,180887
29714,0.002446,172.217.194.0-255,5020,169681,7,180887
29715,0.002506,172.217.194.0-255,1484,171165,7,180887
29716,0.002601,172.217.194.0-255,5020,176185,7,180887
29717,0.009011,172.31.36.0-255,66,176251,7,180887
29718,0.011554,172.217.194.0-255,105,176356,7,180887
29719,0.011953,172.31.36.0-255,66,176422,7,180887
29720,0.01199,172.31.36.0-255,105,176527,7,180887
29721,0.014527,172.217.194.0-255,66,176593,7,180887
29722,0.034842,172.31.36.0-255,176,176769,7,180887
29723,0.034876,172.31.36.0-255,1112,177881,7,180887
29724,0.034928,172.31.36.0-255,1514,179395,7,180887
29725,0.034929,172.31.36.0-255,1294,180689,7,180887
29726,0.036428,104.244.42.0-255,66,180755,7,180887
29727,0.036454,104.244.42.0-255,66,180821,7,180887
29728,0.036516,104.244.42.0-255,66,180887,7,180887
29729,0.0,172.31.36.0-255,66,66,7,66
29730,0.0,74.125.24.0-255,152,152,7,370076
29731,4e-05,172.31.36.0-255,66,218,7,370076
29732,4.8e-05,74.125.24.0-255,1484,1702,7,370076
29733,5.3e-05,172.31.36.0-255,66,1768,7,370076
29734,5.9e-05,74.125.24.0-255,2902,4670,7,370076
29735,6.1e-05,172.31.36.0-255,66,4736,7,370076
29736,6.6e-05,74.125.24.0-255,4320,9056,7,370076
29737,6.9e-05,172.31.36.0-255,66,9122,7,370076
29738,0.000102,74.125.24.0-255,4839,13961,7,370076
29739,0.000105,172.31.36.0-255,66,14027,7,370076
29740,0.000109,74.125.24.0-255,2902,16929,7,370076
29741,0.000111,172.31.36.0-255,66,16995,7,370076
29742,0.000129,74.125.24.0-255,2902,19897,7,370076
29743,0.000132,172.31.36.0-255,66,19963,7,370076
29744,0.000162,74.125.24.0-255,7156,27119,7,370076
29745,0.000165,172.31.36.0-255,66,27185,7,370076
29746,0.000188,74.125.24.0-255,5738,32923,7,370076
29747,0.000191,172.31.36.0-255,66,32989,7,370076
29748,0.000198,74.125.24.0-255,4320,37309,7,370076
29749,0.000201,172.31.36.0-255,66,37375,7,370076
29750,0.000216,74.125.24.0-255,4320,41695,7,370076
29751,0.000218,172.31.36.0-255,66,41761,7,370076
29752,0.000249,74.125.24.0-255,5738,47499,7,370076
29753,0.000253,172.31.36.0-255,66,47565,7,370076
29754,0.000256,74.125.24.0-255,766,48331,7,370076
29755,0.000258,172.31.36.0-255,66,48397,7,370076
29756,0.000287,74.125.24.0-255,4320,52717,7,370076
29757,0.00029,172.31.36.0-255,66,52783,7,370076
29758,0.000319,74.125.24.0-255,5738,58521,7,370076
29759,0.000322,172.31.36.0-255,66,58587,7,370076
29760,0.000329,74.125.24.0-255,6797,65384,7,370076
29761,0.000331,172.31.36.0-255,66,65450,7,370076
29762,0.000353,74.125.24.0-255,5738,71188,7,370076
29763,0.000355,172.31.36.0-255,66,71254,7,370076
29764,0.000378,74.125.24.0-255,2065,73319,7,370076
29765,0.000381,172.31.36.0-255,66,73385,7,370076
29766,0.000386,74.125.24.0-255,4320,77705,7,370076
29767,0.000388,172.31.36.0-255,66,77771,7,370076
29768,0.000405,74.125.24.0-255,4829,82600,7,370076
29769,0.000408,172.31.36.0-255,66,82666,7,370076
29770,0.000464,74.125.24.0-255,1484,84150,7,370076
29771,0.000483,74.125.24.0-255,2902,87052,7,370076
29772,0.000487,172.31.36.0-255,66,87118,7,370076
29773,0.000507,74.125.24.0-255,2902,90020,7,370076
29774,0.00051,172.31.36.0-255,66,90086,7,370076
29775,0.000518,74.125.24.0-255,7156,97242,7,370076
29776,0.000521,172.31.36.0-255,66,97308,7,370076
29777,0.000557,74.125.24.0-255,2543,99851,7,370076
29778,0.000563,172.31.36.0-255,66,99917,7,370076
29779,0.000576,74.125.24.0-255,1484,101401,7,370076
29780,0.000588,74.125.24.0-255,1484,102885,7,370076
29781,0.000591,172.31.36.0-255,66,102951,7,370076
29782,0.000597,74.125.24.0-255,4320,107271,7,370076
29783,0.000599,172.31.36.0-255,66,107337,7,370076
29784,0.000618,74.125.24.0-255,1484,108821,7,370076
29785,0.000625,74.125.24.0-255,5738,114559,7,370076
29786,0.000628,172.31.36.0-255,66,114625,7,370076
29787,0.000647,74.125.24.0-255,4320,118945,7,370076
29788,0.00065,172.31.36.0-255,66,119011,7,370076
29789,0.000693,172.31.36.0-255,66,119077,7,370076
29790,0.000715,74.125.24.0-255,3602,122679,7,370076
29791,0.000718,172.31.36.0-255,66,122745,7,370076
29792,0.000881,74.125.24.0-255,1484,124229,7,370076
29793,0.000885,74.125.24.0-255,1484,125713,7,370076
29794,0.000888,172.31.36.0-255,66,125779,7,370076
29795,0.000903,74.125.24.0-255,1484,127263,7,370076
29796,0.000906,74.125.24.0-255,1484,128747,7,370076
29797,0.000908,172.31.36.0-255,66,128813,7,370076
29798,0.000914,74.125.24.0-255,5738,134551,7,370076
29799,0.000916,172.31.36.0-255,66,134617,7,370076
29800,0.000941,74.125.24.0-255,5738,140355,7,370076
29801,0.000943,172.31.36.0-255,66,140421,7,370076
29802,0.000968,74.125.24.0-255,7156,147577,7,370076
29803,0.00097,172.31.36.0-255,66,147643,7,370076
29804,0.000977,74.125.24.0-255,7156,154799,7,370076
29805,0.000979,172.31.36.0-255,66,154865,7,370076
29806,0.000995,74.125.24.0-255,2184,157049,7,370076
29807,0.000997,172.31.36.0-255,66,157115,7,370076
29808,0.001397,74.125.24.0-255,1484,158599,7,370076
29809,0.001413,74.125.24.0-255,2902,161501,7,370076
29810,0.001417,172.31.36.0-255,66,161567,7,370076
29811,0.00142,74.125.24.0-255,1484,163051,7,370076
29812,0.001439,74.125.24.0-255,4320,167371,7,370076
29813,0.001441,172.31.36.0-255,66,167437,7,370076
29814,0.001445,74.125.24.0-255,1484,168921,7,370076
29815,0.001461,74.125.24.0-255,2902,171823,7,370076
29816,0.001464,172.31.36.0-255,66,171889,7,370076
29817,0.00148,74.125.24.0-255,2902,174791,7,370076
29818,0.001482,172.31.36.0-255,66,174857,7,370076
29819,0.001486,74.125.24.0-255,1484,176341,7,370076
29820,0.001514,172.31.36.0-255,66,176407,7,370076
29821,0.001532,74.125.24.0-255,4320,180727,7,370076
29822,0.001535,172.31.36.0-255,66,180793,7,370076
29823,0.001539,74.125.24.0-255,2184,182977,7,370076
29824,0.001541,172.31.36.0-255,66,183043,7,370076
29825,0.001637,74.125.24.0-255,1484,184527,7,370076
29826,0.001643,74.125.24.0-255,2902,187429,7,370076
29827,0.001645,172.31.36.0-255,66,187495,7,370076
29828,0.001669,74.125.24.0-255,5738,193233,7,370076
29829,0.001674,172.31.36.0-255,66,193299,7,370076
29830,0.001684,74.125.24.0-255,7156,200455,7,370076
29831,0.001687,172.31.36.0-255,66,200521,7,370076
29832,0.001704,74.125.24.0-255,2902,203423,7,370076
29833,0.001707,172.31.36.0-255,66,203489,7,370076
29834,0.001751,74.125.24.0-255,7156,210645,7,370076
29835,0.001754,172.31.36.0-255,66,210711,7,370076
29836,0.001779,74.125.24.0-255,6438,217149,7,370076
29837,0.001782,172.31.36.0-255,66,217215,7,370076
29838,0.001835,74.125.24.0-255,1484,218699,7,370076
29839,0.00184,74.125.24.0-255,2902,221601,7,370076
29840,0.001843,172.31.36.0-255,66,221667,7,370076
29841,0.001847,74.125.24.0-255,2902,224569,7,370076
29842,0.001849,172.31.36.0-255,66,224635,7,370076
29843,0.001863,74.125.24.0-255,2902,227537,7,370076
29844,0.001866,172.31.36.0-255,66,227603,7,370076
29845,0.001869,74.125.24.0-255,1484,229087,7,370076
29846,0.001924,172.31.36.0-255,66,229153,7,370076
29847,0.001936,172.31.36.0-255,66,229219,7,370076
29848,0.001961,74.125.24.0-255,4320,233539,7,370076
29849,0.001963,172.31.36.0-255,66,233605,7,370076
29850,0.001969,74.125.24.0-255,4320,237925,7,370076
29851,0.001971,172.31.36.0-255,66,237991,7,370076
29852,0.001985,74.125.24.0-255,1484,239475,7,370076
29853,0.002016,172.31.36.0-255,66,239541,7,370076
29854,0.002026,74.125.24.0-255,1484,241025,7,370076
29855,0.002043,74.125.24.0-255,1484,242509,7,370076
29856,0.002046,172.31.36.0-255,66,242575,7,370076
29857,0.002051,74.125.24.0-255,4320,246895,7,370076
29858,0.002054,172.31.36.0-255,66,246961,7,370076
29859,0.002069,74.125.24.0-255,2902,249863,7,370076
29860,0.002071,172.31.36.0-255,66,249929,7,370076
29861,0.002092,74.125.24.0-255,2184,252113,7,370076
29862,0.002095,172.31.36.0-255,66,252179,7,370076
29863,0.004061,74.125.24.0-255,2902,255081,7,370076
29864,0.004077,172.31.36.0-255,66,255147,7,370076
29865,0.004096,74.125.24.0-255,2902,258049,7,370076
29866,0.004099,172.31.36.0-255,66,258115,7,370076
29867,0.006094,74.125.24.0-255,2902,261017,7,370076
29868,0.006099,172.31.36.0-255,66,261083,7,370076
29869,0.006111,74.125.24.0-255,2902,263985,7,370076
29870,0.006114,172.31.36.0-255,66,264051,7,370076
29871,0.008124,74.125.24.0-255,5738,269789,7,370076
29872,0.008131,172.31.36.0-255,66,269855,7,370076
29873,0.010135,74.125.24.0-255,5738,275593,7,370076
29874,0.010142,172.31.36.0-255,66,275659,7,370076
29875,0.012166,74.125.24.0-255,5738,281397,7,370076
29876,0.012174,172.31.36.0-255,66,281463,7,370076
29877,0.014174,74.125.24.0-255,4320,285783,7,370076
29878,0.014181,172.31.36.0-255,66,285849,7,370076
29879,0.014198,74.125.24.0-255,1484,287333,7,370076
29880,0.016285,74.125.24.0-255,4320,291653,7,370076
29881,0.016294,172.31.36.0-255,66,291719,7,370076
29882,0.018279,74.125.24.0-255,5738,297457,7,370076
29883,0.018287,172.31.36.0-255,66,297523,7,370076
29884,0.020266,74.125.24.0-255,5738,303261,7,370076
29885,0.020272,172.31.36.0-255,66,303327,7,370076
29886,0.022274,74.125.24.0-255,5738,309065,7,370076
29887,0.022281,172.31.36.0-255,66,309131,7,370076
29888,0.024299,74.125.24.0-255,5738,314869,7,370076
29889,0.024305,172.31.36.0-255,66,314935,7,370076
29890,0.026317,74.125.24.0-255,5738,320673,7,370076
29891,0.026325,172.31.36.0-255,66,320739,7,370076
29892,0.028317,74.125.24.0-255,5738,326477,7,370076
29893,0.028325,172.31.36.0-255,66,326543,7,370076
29894,0.030324,74.125.24.0-255,5738,332281,7,370076
29895,0.030331,172.31.36.0-255,66,332347,7,370076
29896,0.032335,74.125.24.0-255,4320,336667,7,370076
29897,0.032343,172.31.36.0-255,66,336733,7,370076
29898,0.032374,74.125.24.0-255,1484,338217,7,370076
29899,0.034325,74.125.24.0-255,4320,342537,7,370076
29900,0.034334,172.31.36.0-255,66,342603,7,370076
29901,0.035602,172.31.36.0-255,172,342775,7,370076
29902,0.035634,172.31.36.0-255,1113,343888,7,370076
29903,0.035663,172.31.36.0-255,566,344454,7,370076
29904,0.03633,74.125.24.0-255,5738,350192,7,370076
29905,0.036338,172.31.36.0-255,66,350258,7,370076
29906,0.037149,104.244.42.0-255,66,350324,7,370076
29907,0.037186,104.244.42.0-255,66,350390,7,370076
29908,0.037189,104.244.42.0-255,66,350456,7,370076
29909,0.038345,74.125.24.0-255,5738,356194,7,370076
29910,0.038352,172.31.36.0-255,66,356260,7,370076
29911,0.040359,74.125.24.0-255,2902,359162,7,370076
29912,0.040365,172.31.36.0-255,66,359228,7,370076
29913,0.040395,74.125.24.0-255,2902,362130,7,370076
29914,0.040398,172.31.36.0-255,66,362196,7,370076
29915,0.04241,74.125.24.0-255,2902,365098,7,370076
29916,0.042415,172.31.36.0-255,66,365164,7,370076
29917,0.042445,74.125.24.0-255,2902,368066,7,370076
29918,0.042447,172.31.36.0-255,66,368132,7,370076
29919,0.044394,74.125.24.0-255,1707,369839,7,370076
29920,0.0444,172.31.36.0-255,66,369905,7,370076
29921,0.044562,172.31.36.0-255,105,370010,7,370076
29922,0.046522,74.125.24.0-255,66,370076,7,370076
29923,0.0,172.31.36.0-255,178,178,7,244
29924,0.007104,172.217.194.0-255,66,244,7,244
29925,0.0,172.31.36.0-255,105,105,7,459
29926,0.000202,172.31.36.0-255,90,195,7,459
29927,0.000212,172.31.36.0-255,66,261,7,459
29928,0.002419,74.125.200.0-255,66,327,7,459
29929,0.002434,74.125.200.0-255,66,393,7,459
29930,0.002447,172.31.36.0-255,66,459,7,459
29931,0.0,74.125.24.0-255,153,153,7,222187
29932,1.5e-05,172.31.36.0-255,66,219,7,222187
29933,2.3e-05,74.125.24.0-255,1484,1703,7,222187
29934,2.7e-05,172.31.36.0-255,66,1769,7,222187
29935,3.4e-05,74.125.24.0-255,2902,4671,7,222187
29936,3.7e-05,172.31.36.0-255,66,4737,7,222187
29937,4.5e-05,74.125.24.0-255,7156,11893,7,222187
29938,4.8e-05,172.31.36.0-255,66,11959,7,222187
29939,5.6e-05,74.125.24.0-255,7156,19115,7,222187
29940,5.9e-05,172.31.36.0-255,66,19181,7,222187
29941,8.2e-05,74.125.24.0-255,4940,24121,7,222187
29942,8.5e-05,172.31.36.0-255,66,24187,7,222187
29943,0.000101,172.31.36.0-255,66,24253,7,222187
29944,0.000144,172.31.36.0-255,66,24319,7,222187
29945,0.000165,74.125.24.0-255,2184,26503,7,222187
29946,0.000167,172.31.36.0-255,66,26569,7,222187
29947,0.000181,172.31.36.0-255,66,26635,7,222187
29948,0.000188,74.125.24.0-255,5651,32286,7,222187
29949,0.00019,172.31.36.0-255,66,32352,7,222187
29950,0.000239,74.125.24.0-255,128,32480,7,222187
29951,0.000241,172.31.36.0-255,66,32546,7,222187
29952,0.000405,74.125.24.0-255,1484,34030,7,222187
29953,0.00041,172.31.36.0-255,66,34096,7,222187
29954,0.000424,74.125.24.0-255,1484,35580,7,222187
29955,0.000427,172.31.36.0-255,66,35646,7,222187
29956,0.00045,74.125.24.0-255,1484,37130,7,222187
29957,0.000453,172.31.36.0-255,66,37196,7,222187
29958,0.000461,74.125.24.0-255,5738,42934,7,222187
29959,0.000463,172.31.36.0-255,66,43000,7,222187
29960,0.000467,74.125.24.0-255,2902,45902,7,222187
29961,0.000491,74.125.24.0-255,7156,53058,7,222187
29962,0.000494,74.125.24.0-255,1484,54542,7,222187
29963,0.000524,74.125.24.0-255,2184,56726,7,222187
29964,0.000557,172.31.36.0-255,66,56792,7,222187
29965,0.000657,74.125.24.0-255,1484,58276,7,222187
29966,0.000682,74.125.24.0-255,2902,61178,7,222187
29967,0.000689,74.125.24.0-255,5738,66916,7,222187
29968,0.000696,172.31.36.0-255,66,66982,7,222187
29969,0.000718,74.125.24.0-255,5738,72720,7,222187
29970,0.000735,74.125.24.0-255,5738,78458,7,222187
29971,0.000741,172.31.36.0-255,66,78524,7,222187
29972,0.000751,74.125.24.0-255,1484,80008,7,222187
29973,0.000773,74.125.24.0-255,2902,82910,7,222187
29974,0.000785,172.31.36.0-255,66,82976,7,222187
29975,0.000801,74.125.24.0-255,7156,90132,7,222187
29976,0.000804,74.125.24.0-255,766,90898,7,222187
29977,0.000824,172.31.36.0-255,66,90964,7,222187
29978,0.000871,74.125.24.0-255,1484,92448,7,222187
29979,0.000885,74.125.24.0-255,2902,95350,7,222187
29980,0.000895,172.31.36.0-255,66,95416,7,222187
29981,0.000907,74.125.24.0-255,5738,101154,7,222187
29982,0.00092,172.31.36.0-255,66,101220,7,222187
29983,0.000933,74.125.24.0-255,4320,105540,7,222187
29984,0.000949,74.125.24.0-255,4320,109860,7,222187
29985,0.000957,172.31.36.0-255,66,109926,7,222187
29986,0.001023,74.125.24.0-255,3602,113528,7,222187
29987,0.001026,74.125.24.0-255,1484,115012,7,222187
29988,0.00104,74.125.24.0-255,2902,117914,7,222187
29989,0.001047,172.31.36.0-255,66,117980,7,222187
29990,0.001057,74.125.24.0-255,4320,122300,7,222187
29991,0.00107,172.31.36.0-255,66,122366,7,222187
29992,0.001073,74.125.24.0-255,1484,123850,7,222187
29993,0.001075,74.125.24.0-255,1484,125334,7,222187
29994,0.001089,74.125.24.0-255,2902,128236,7,222187
29995,0.0011,74.125.24.0-255,1484,129720,7,222187
29996,0.001112,172.31.36.0-255,66,129786,7,222187
29997,0.001145,74.125.24.0-255,5738,135524,7,222187
29998,0.001161,172.31.36.0-255,66,135590,7,222187
29999,0.001175,74.125.24.0-255,7156,142746,7,222187
30000,0.001181,74.125.24.0-255,5020,147766,7,222187
30001,0.001186,172.31.36.0-255,66,147832,7,222187
30002,0.001248,172.31.36.0-255,66,147898,7,222187
30003,0.001258,74.125.24.0-255,2902,150800,7,222187
30004,0.001262,74.125.24.0-255,2902,153702,7,222187
30005,0.001268,172.31.36.0-255,66,153768,7,222187
30006,0.001328,74.125.24.0-255,2184,155952,7,222187
30007,0.001354,172.31.36.0-255,66,156018,7,222187
30008,0.001619,74.125.24.0-255,1484,157502,7,222187
30009,0.00164,74.125.24.0-255,2902,160404,7,222187
30010,0.001654,74.125.24.0-255,4320,164724,7,222187
30011,0.001662,172.31.36.0-255,66,164790,7,222187
30012,0.001681,74.125.24.0-255,1484,166274,7,222187
30013,0.001689,74.125.24.0-255,5738,172012,7,222187
30014,0.001711,74.125.24.0-255,5020,177032,7,222187
30015,0.001728,172.31.36.0-255,66,177098,7,222187
30016,0.001778,74.125.24.0-255,1484,178582,7,222187
30017,0.001784,74.125.24.0-255,2902,181484,7,222187
30018,0.001806,172.31.36.0-255,66,181550,7,222187
30019,0.001813,74.125.24.0-255,5738,187288,7,222187
30020,0.001815,74.125.24.0-255,1484,188772,7,222187
30021,0.00182,172.31.36.0-255,66,188838,7,222187
30022,0.001854,74.125.24.0-255,2902,191740,7,222187
30023,0.00187,172.31.36.0-255,66,191806,7,222187
30024,0.001893,74.125.24.0-255,1484,193290,7,222187
30025,0.00193,172.31.36.0-255,66,193356,7,222187
30026,0.001951,74.125.24.0-255,2902,196258,7,222187
30027,0.001958,172.31.36.0-255,66,196324,7,222187
30028,0.001989,172.31.36.0-255,66,196390,7,222187
30029,0.002003,74.125.24.0-255,3602,199992,7,222187
30030,0.002016,172.31.36.0-255,66,200058,7,222187
30031,0.002094,74.125.24.0-255,6438,206496,7,222187
30032,0.002097,74.125.24.0-255,1484,207980,7,222187
30033,0.002113,172.31.36.0-255,66,208046,7,222187
30034,0.004175,74.125.24.0-255,5738,213784,7,222187
30035,0.004181,172.31.36.0-255,66,213850,7,222187
30036,0.006244,74.125.24.0-255,3810,217660,7,222187
30037,0.010451,172.31.36.0-255,66,217726,7,222187
30038,0.011231,172.31.36.0-255,105,217831,7,222187
30039,0.01328,74.125.24.0-255,66,217897,7,222187
30040,0.031816,172.31.36.0-255,172,218069,7,222187
30041,0.031872,172.31.36.0-255,1114,219183,7,222187
30042,0.031938,172.31.36.0-255,1514,220697,7,222187
30043,0.031939,172.31.36.0-255,1292,221989,7,222187
30044,0.033438,104.244.42.0-255,66,222055,7,222187
30045,0.033474,104.244.42.0-255,66,222121,7,222187
30046,0.03353,104.244.42.0-255,66,222187,7,222187
30047,0.0,74.125.24.0-255,153,153,7,339002
30048,3.4e-05,172.31.36.0-255,66,219,7,339002
30049,4.2e-05,74.125.24.0-255,1484,1703,7,339002
30050,4.6e-05,172.31.36.0-255,66,1769,7,339002
30051,5.1e-05,74.125.24.0-255,2902,4671,7,339002
30052,5.5e-05,172.31.36.0-255,66,4737,7,339002
30053,6e-05,74.125.24.0-255,4320,9057,7,339002
30054,6.3e-05,172.31.36.0-255,66,9123,7,339002
30055,8e-05,74.125.24.0-255,1484,10607,7,339002
30056,8.2e-05,172.31.36.0-255,66,10673,7,339002
30057,9.7e-05,74.125.24.0-255,5738,16411,7,339002
30058,0.000101,172.31.36.0-255,66,16477,7,339002
30059,0.000123,74.125.24.0-255,4885,21362,7,339002
30060,0.000126,172.31.36.0-255,66,21428,7,339002
30061,0.000143,74.125.24.0-255,5738,27166,7,339002
30062,0.000146,172.31.36.0-255,66,27232,7,339002
30063,0.000167,74.125.24.0-255,3961,31193,7,339002
30064,0.000172,172.31.36.0-255,66,31259,7,339002
30065,0.000541,74.125.24.0-255,1484,32743,7,339002
30066,0.000547,172.31.36.0-255,66,32809,7,339002
30067,0.000552,74.125.24.0-255,2902,35711,7,339002
30068,0.000554,172.31.36.0-255,66,35777,7,339002
30069,0.000579,74.125.24.0-255,5738,41515,7,339002
30070,0.000582,172.31.36.0-255,66,41581,7,339002
30071,0.000613,172.31.36.0-255,66,41647,7,339002
30072,0.000626,74.125.24.0-255,1484,43131,7,339002
30073,0.000628,172.31.36.0-255,66,43197,7,339002
30074,0.000649,74.125.24.0-255,2902,46099,7,339002
30075,0.000652,172.31.36.0-255,66,46165,7,339002
30076,0.00068,172.31.36.0-255,66,46231,7,339002
30077,0.000696,74.125.24.0-255,411,46642,7,339002
30078,0.000728,74.125.24.0-255,1484,48126,7,339002
30079,0.000731,172.31.36.0-255,66,48192,7,339002
30080,0.000753,74.125.24.0-255,4320,52512,7,339002
30081,0.000756,172.31.36.0-255,66,52578,7,339002
30082,0.00076,74.125.24.0-255,2902,55480,7,339002
30083,0.000762,172.31.36.0-255,66,55546,7,339002
30084,0.000778,74.125.24.0-255,4320,59866,7,339002
30085,0.00078,172.31.36.0-255,66,59932,7,339002
30086,0.000795,172.31.36.0-255,66,59998,7,339002
30087,0.000806,74.125.24.0-255,1484,61482,7,339002
30088,0.000812,74.125.24.0-255,4706,66188,7,339002
30089,0.000821,172.31.36.0-255,66,66254,7,339002
30090,0.001599,74.125.24.0-255,1484,67738,7,339002
30091,0.00161,74.125.24.0-255,2902,70640,7,339002
30092,0.001615,172.31.36.0-255,66,70706,7,339002
30093,0.001622,74.125.24.0-255,4320,75026,7,339002
30094,0.001624,172.31.36.0-255,66,75092,7,339002
30095,0.001638,74.125.24.0-255,1484,76576,7,339002
30096,0.001663,74.125.24.0-255,6797,83373,7,339002
30097,0.001666,172.31.36.0-255,66,83439,7,339002
30098,0.001901,74.125.24.0-255,1484,84923,7,339002
30099,0.001915,74.125.24.0-255,2902,87825,7,339002
30100,0.001917,172.31.36.0-255,66,87891,7,339002
30101,0.00192,74.125.24.0-255,1484,89375,7,339002
30102,0.001938,74.125.24.0-255,4320,93695,7,339002
30103,0.00194,172.31.36.0-255,66,93761,7,339002
30104,0.00196,74.125.24.0-255,5738,99499,7,339002
30105,0.001963,172.31.36.0-255,66,99565,7,339002
30106,0.001994,74.125.24.0-255,7156,106721,7,339002
30107,0.001996,172.31.36.0-255,66,106787,7,339002
30108,0.002015,74.125.24.0-255,2184,108971,7,339002
30109,0.002038,74.125.24.0-255,2902,111873,7,339002
30110,0.002087,74.125.24.0-255,5738,117611,7,339002
30111,0.002098,74.125.24.0-255,1484,119095,7,339002
30112,0.002102,74.125.24.0-255,4320,123415,7,339002
30113,0.002119,74.125.24.0-255,2543,125958,7,339002
30114,0.002147,74.125.24.0-255,2902,128860,7,339002
30115,0.002169,74.125.24.0-255,7156,136016,7,339002
30116,0.002174,74.125.24.0-255,4320,140336,7,339002
30117,0.002204,74.125.24.0-255,4320,144656,7,339002
30118,0.002239,74.125.24.0-255,6438,151094,7,339002
30119,0.006596,172.31.36.0-255,66,151160,7,339002
30120,0.008872,74.125.24.0-255,5738,156898,7,339002
30121,0.00888,172.31.36.0-255,66,156964,7,339002
30122,0.011167,74.125.24.0-255,5738,162702,7,339002
30123,0.011176,172.31.36.0-255,66,162768,7,339002
30124,0.013454,74.125.24.0-255,5738,168506,7,339002
30125,0.013464,172.31.36.0-255,66,168572,7,339002
30126,0.015707,74.125.24.0-255,5738,174310,7,339002
30127,0.015714,172.31.36.0-255,66,174376,7,339002
30128,0.018003,74.125.24.0-255,5738,180114,7,339002
30129,0.018012,172.31.36.0-255,66,180180,7,339002
30130,0.020327,74.125.24.0-255,5738,185918,7,339002
30131,0.02034,172.31.36.0-255,66,185984,7,339002
30132,0.022607,74.125.24.0-255,5738,191722,7,339002
30133,0.022617,172.31.36.0-255,66,191788,7,339002
30134,0.024899,74.125.24.0-255,5738,197526,7,339002
30135,0.024907,172.31.36.0-255,66,197592,7,339002
30136,0.025805,172.31.36.0-255,172,197764,7,339002
30137,0.025846,172.31.36.0-255,1114,198878,7,339002
30138,0.025915,172.31.36.0-255,1514,200392,7,339002
30139,0.025917,172.31.36.0-255,1292,201684,7,339002
30140,0.027174,74.125.24.0-255,5738,207422,7,339002
30141,0.027182,172.31.36.0-255,66,207488,7,339002
30142,0.027327,104.244.42.0-255,66,207554,7,339002
30143,0.027381,104.244.42.0-255,66,207620,7,339002
30144,0.027499,104.244.42.0-255,66,207686,7,339002
30145,0.029456,74.125.24.0-255,5738,213424,7,339002
30146,0.029461,172.31.36.0-255,66,213490,7,339002
30147,0.031727,74.125.24.0-255,5738,219228,7,339002
30148,0.031733,172.31.36.0-255,66,219294,7,339002
30149,0.033993,74.125.24.0-255,5738,225032,7,339002
30150,0.033998,172.31.36.0-255,66,225098,7,339002
30151,0.036256,74.125.24.0-255,5738,230836,7,339002
30152,0.036262,172.31.36.0-255,66,230902,7,339002
30153,0.038529,74.125.24.0-255,5738,236640,7,339002
30154,0.038534,172.31.36.0-255,66,236706,7,339002
30155,0.040773,74.125.24.0-255,4320,241026,7,339002
30156,0.040793,172.31.36.0-255,66,241092,7,339002
30157,0.04081,74.125.24.0-255,1484,242576,7,339002
30158,0.043035,74.125.24.0-255,4320,246896,7,339002
30159,0.04304,172.31.36.0-255,66,246962,7,339002
30160,0.045309,74.125.24.0-255,5738,252700,7,339002
30161,0.045317,172.31.36.0-255,66,252766,7,339002
30162,0.047561,74.125.24.0-255,5738,258504,7,339002
30163,0.047566,172.31.36.0-255,66,258570,7,339002
30164,0.049888,74.125.24.0-255,5738,264308,7,339002
30165,0.049893,172.31.36.0-255,66,264374,7,339002
30166,0.052179,74.125.24.0-255,5738,270112,7,339002
30167,0.052184,172.31.36.0-255,66,270178,7,339002
30168,0.054467,74.125.24.0-255,5738,275916,7,339002
30169,0.054472,172.31.36.0-255,66,275982,7,339002
30170,0.056753,74.125.24.0-255,5738,281720,7,339002
30171,0.056759,172.31.36.0-255,66,281786,7,339002
30172,0.059027,74.125.24.0-255,5738,287524,7,339002
30173,0.059033,172.31.36.0-255,66,287590,7,339002
30174,0.061292,74.125.24.0-255,2902,290492,7,339002
30175,0.0613,172.31.36.0-255,66,290558,7,339002
30176,0.061331,74.125.24.0-255,2902,293460,7,339002
30177,0.061334,172.31.36.0-255,66,293526,7,339002
30178,0.063567,74.125.24.0-255,2902,296428,7,339002
30179,0.063573,172.31.36.0-255,66,296494,7,339002
30180,0.063606,74.125.24.0-255,2902,299396,7,339002
30181,0.063609,172.31.36.0-255,66,299462,7,339002
30182,0.06584,74.125.24.0-255,2902,302364,7,339002
30183,0.065846,172.31.36.0-255,66,302430,7,339002
30184,0.06588,74.125.24.0-255,2902,305332,7,339002
30185,0.065883,172.31.36.0-255,66,305398,7,339002
30186,0.06812,74.125.24.0-255,2902,308300,7,339002
30187,0.068126,172.31.36.0-255,66,308366,7,339002
30188,0.068154,74.125.24.0-255,2902,311268,7,339002
30189,0.068157,172.31.36.0-255,66,311334,7,339002
30190,0.070408,74.125.24.0-255,4320,315654,7,339002
30191,0.070413,172.31.36.0-255,66,315720,7,339002
30192,0.070452,74.125.24.0-255,1484,317204,7,339002
30193,0.072701,74.125.24.0-255,4320,321524,7,339002
30194,0.072706,172.31.36.0-255,66,321590,7,339002
30195,0.074984,74.125.24.0-255,5738,327328,7,339002
30196,0.07499,172.31.36.0-255,66,327394,7,339002
30197,0.077263,74.125.24.0-255,5738,333132,7,339002
30198,0.077268,172.31.36.0-255,66,333198,7,339002
30199,0.079517,74.125.24.0-255,5738,338936,7,339002
30200,0.079524,172.31.36.0-255,66,339002,7,339002
30201,0.0,74.125.24.0-255,152,152,7,357709
30202,2e-05,172.31.36.0-255,66,218,7,357709
30203,2.7e-05,74.125.24.0-255,1484,1702,7,357709
30204,3.2e-05,172.31.36.0-255,66,1768,7,357709
30205,3.7e-05,74.125.24.0-255,2902,4670,7,357709
30206,4e-05,172.31.36.0-255,66,4736,7,357709
30207,4.8e-05,74.125.24.0-255,7156,11892,7,357709
30208,5.1e-05,172.31.36.0-255,66,11958,7,357709
30209,5.6e-05,74.125.24.0-255,2066,14024,7,357709
30210,5.9e-05,172.31.36.0-255,66,14090,7,357709
30211,0.000146,74.125.24.0-255,1484,15574,7,357709
30212,0.000149,172.31.36.0-255,66,15640,7,357709
30213,0.000171,74.125.24.0-255,2902,18542,7,357709
30214,0.000174,172.31.36.0-255,66,18608,7,357709
30215,0.000195,74.125.24.0-255,5738,24346,7,357709
30216,0.000198,172.31.36.0-255,66,24412,7,357709
30217,0.000231,74.125.24.0-255,4320,28732,7,357709
30218,0.000234,172.31.36.0-255,66,28798,7,357709
30219,0.000253,74.125.24.0-255,2543,31341,7,357709
30220,0.000255,172.31.36.0-255,66,31407,7,357709
30221,0.000722,74.125.24.0-255,1484,32891,7,357709
30222,0.000729,172.31.36.0-255,66,32957,7,357709
30223,0.000738,74.125.24.0-255,2902,35859,7,357709
30224,0.00074,172.31.36.0-255,66,35925,7,357709
30225,0.000744,74.125.24.0-255,1484,37409,7,357709
30226,0.000746,172.31.36.0-255,66,37475,7,357709
30227,0.000771,74.125.24.0-255,4320,41795,7,357709
30228,0.000773,172.31.36.0-255,66,41861,7,357709
30229,0.000805,172.31.36.0-255,66,41927,7,357709
30230,0.000812,74.125.24.0-255,5738,47665,7,357709
30231,0.000814,172.31.36.0-255,66,47731,7,357709
30232,0.000833,74.125.24.0-255,2902,50633,7,357709
30233,0.000836,172.31.36.0-255,66,50699,7,357709
30234,0.000849,74.125.24.0-255,1437,52136,7,357709
30235,0.000915,74.125.24.0-255,111,52247,7,357709
30236,0.001073,74.125.24.0-255,1484,53731,7,357709
30237,0.001077,172.31.36.0-255,66,53797,7,357709
30238,0.001084,74.125.24.0-255,2902,56699,7,357709
30239,0.001087,172.31.36.0-255,66,56765,7,357709
30240,0.001092,74.125.24.0-255,2902,59667,7,357709
30241,0.001095,172.31.36.0-255,66,59733,7,357709
30242,0.001117,74.125.24.0-255,2902,62635,7,357709
30243,0.001119,172.31.36.0-255,66,62701,7,357709
30244,0.001126,74.125.24.0-255,4320,67021,7,357709
30245,0.001128,172.31.36.0-255,66,67087,7,357709
30246,0.001154,74.125.24.0-255,2543,69630,7,357709
30247,0.001157,172.31.36.0-255,66,69696,7,357709
30248,0.001177,74.125.24.0-255,2902,72598,7,357709
30249,0.00118,172.31.36.0-255,66,72664,7,357709
30250,0.001183,74.125.24.0-255,1484,74148,7,357709
30251,0.001204,74.125.24.0-255,5738,79886,7,357709
30252,0.001206,172.31.36.0-255,66,79952,7,357709
30253,0.001214,74.125.24.0-255,6797,86749,7,357709
30254,0.001216,172.31.36.0-255,66,86815,7,357709
30255,0.001677,74.125.24.0-255,1484,88299,7,357709
30256,0.001718,74.125.24.0-255,1484,89783,7,357709
30257,0.001722,172.31.36.0-255,66,89849,7,357709
30258,0.001729,74.125.24.0-255,2902,92751,7,357709
30259,0.001732,172.31.36.0-255,66,92817,7,357709
30260,0.001759,74.125.24.0-255,5738,98555,7,357709
30261,0.001762,172.31.36.0-255,66,98621,7,357709
30262,0.001768,74.125.24.0-255,5738,104359,7,357709
30263,0.001771,172.31.36.0-255,66,104425,7,357709
30264,0.001795,74.125.24.0-255,7156,111581,7,357709
30265,0.001798,172.31.36.0-255,66,111647,7,357709
30266,0.001809,172.31.36.0-255,66,111713,7,357709
30267,0.001811,74.125.24.0-255,766,112479,7,357709
30268,0.001994,74.125.24.0-255,1484,113963,7,357709
30269,0.001997,172.31.36.0-255,66,114029,7,357709
30270,0.002002,74.125.24.0-255,2902,116931,7,357709
30271,0.002005,172.31.36.0-255,66,116997,7,357709
30272,0.002029,74.125.24.0-255,5738,122735,7,357709
30273,0.002032,172.31.36.0-255,66,122801,7,357709
30274,0.002054,74.125.24.0-255,7156,129957,7,357709
30275,0.002056,172.31.36.0-255,66,130023,7,357709
30276,0.002076,74.125.24.0-255,5738,135761,7,357709
30277,0.002078,172.31.36.0-255,66,135827,7,357709
30278,0.00211,172.31.36.0-255,66,135893,7,357709
30279,0.002113,74.125.24.0-255,2184,138077,7,357709
30280,0.002115,172.31.36.0-255,66,138143,7,357709
30281,0.004126,74.125.24.0-255,2902,141045,7,357709
30282,0.004131,172.31.36.0-255,66,141111,7,357709
30283,0.004152,74.125.24.0-255,2902,144013,7,357709
30284,0.004156,172.31.36.0-255,66,144079,7,357709
30285,0.006146,74.125.24.0-255,2902,146981,7,357709
30286,0.006154,172.31.36.0-255,66,147047,7,357709
30287,0.006177,74.125.24.0-255,2902,149949,7,357709
30288,0.00618,172.31.36.0-255,66,150015,7,357709
30289,0.00817,74.125.24.0-255,2902,152917,7,357709
30290,0.008176,172.31.36.0-255,66,152983,7,357709
30291,0.008202,74.125.24.0-255,2902,155885,7,357709
30292,0.008205,172.31.36.0-255,66,155951,7,357709
30293,0.010197,74.125.24.0-255,2902,158853,7,357709
30294,0.010204,172.31.36.0-255,66,158919,7,357709
30295,0.010225,74.125.24.0-255,2902,161821,7,357709
30296,0.010228,172.31.36.0-255,66,161887,7,357709
30297,0.01226,74.125.24.0-255,5738,167625,7,357709
30298,0.012268,172.31.36.0-255,66,167691,7,357709
30299,0.014321,74.125.24.0-255,5738,173429,7,357709
30300,0.014329,172.31.36.0-255,66,173495,7,357709
30301,0.016388,74.125.24.0-255,5738,179233,7,357709
30302,0.016402,172.31.36.0-255,66,179299,7,357709
30303,0.018463,74.125.24.0-255,5738,185037,7,357709
30304,0.018472,172.31.36.0-255,66,185103,7,357709
30305,0.020511,74.125.24.0-255,5738,190841,7,357709
30306,0.020518,172.31.36.0-255,66,190907,7,357709
30307,0.022552,74.125.24.0-255,5738,196645,7,357709
30308,0.02256,172.31.36.0-255,66,196711,7,357709
30309,0.024595,74.125.24.0-255,5738,202449,7,357709
30310,0.024605,172.31.36.0-255,66,202515,7,357709
30311,0.026646,74.125.24.0-255,5738,208253,7,357709
30312,0.026653,172.31.36.0-255,66,208319,7,357709
30313,0.028688,74.125.24.0-255,5738,214057,7,357709
30314,0.028696,172.31.36.0-255,66,214123,7,357709
30315,0.030731,74.125.24.0-255,5738,219861,7,357709
30316,0.030739,172.31.36.0-255,66,219927,7,357709
30317,0.031432,172.31.36.0-255,172,220099,7,357709
30318,0.03147,172.31.36.0-255,1114,221213,7,357709
30319,0.031528,172.31.36.0-255,1514,222727,7,357709
30320,0.03153,172.31.36.0-255,1292,224019,7,357709
30321,0.032787,74.125.24.0-255,5738,229757,7,357709
30322,0.032795,172.31.36.0-255,66,229823,7,357709
30323,0.032964,104.244.42.0-255,66,229889,7,357709
30324,0.033009,104.244.42.0-255,66,229955,7,357709
30325,0.03311,104.244.42.0-255,66,230021,7,357709
30326,0.034841,74.125.24.0-255,5738,235759,7,357709
30327,0.034849,172.31.36.0-255,66,235825,7,357709
30328,0.036908,74.125.24.0-255,5738,241563,7,357709
30329,0.036915,172.31.36.0-255,66,241629,7,357709
30330,0.038957,74.125.24.0-255,5738,247367,7,357709
30331,0.038964,172.31.36.0-255,66,247433,7,357709
30332,0.041004,74.125.24.0-255,5738,253171,7,357709
30333,0.041013,172.31.36.0-255,66,253237,7,357709
30334,0.043031,74.125.24.0-255,5738,258975,7,357709
30335,0.043038,172.31.36.0-255,66,259041,7,357709
30336,0.045074,74.125.24.0-255,5738,264779,7,357709
30337,0.045082,172.31.36.0-255,66,264845,7,357709
30338,0.047104,74.125.24.0-255,5738,270583,7,357709
30339,0.047111,172.31.36.0-255,66,270649,7,357709
30340,0.049155,74.125.24.0-255,5738,276387,7,357709
30341,0.049162,172.31.36.0-255,66,276453,7,357709
30342,0.051221,74.125.24.0-255,5738,282191,7,357709
30343,0.051228,172.31.36.0-255,66,282257,7,357709
30344,0.053285,74.125.24.0-255,5738,287995,7,357709
30345,0.053292,172.31.36.0-255,66,288061,7,357709
30346,0.055352,74.125.24.0-255,5738,293799,7,357709
30347,0.05536,172.31.36.0-255,66,293865,7,357709
30348,0.057438,74.125.24.0-255,5738,299603,7,357709
30349,0.057445,172.31.36.0-255,66,299669,7,357709
30350,0.059515,74.125.24.0-255,5738,305407,7,357709
30351,0.059522,172.31.36.0-255,66,305473,7,357709
30352,0.061569,74.125.24.0-255,5738,311211,7,357709
30353,0.061576,172.31.36.0-255,66,311277,7,357709
30354,0.0636,74.125.24.0-255,5738,317015,7,357709
30355,0.063607,172.31.36.0-255,66,317081,7,357709
30356,0.065679,74.125.24.0-255,5738,322819,7,357709
30357,0.065686,172.31.36.0-255,66,322885,7,357709
30358,0.067747,74.125.24.0-255,5738,328623,7,357709
30359,0.067755,172.31.36.0-255,66,328689,7,357709
30360,0.069798,74.125.24.0-255,5738,334427,7,357709
30361,0.069805,172.31.36.0-255,66,334493,7,357709
30362,0.07186,74.125.24.0-255,5738,340231,7,357709
30363,0.071868,172.31.36.0-255,66,340297,7,357709
30364,0.073921,74.125.24.0-255,5738,346035,7,357709
30365,0.073928,172.31.36.0-255,66,346101,7,357709
30366,0.075952,74.125.24.0-255,5738,351839,7,357709
30367,0.075959,172.31.36.0-255,66,351905,7,357709
30368,0.078018,74.125.24.0-255,5738,357643,7,357709
30369,0.078025,172.31.36.0-255,66,357709,7,357709
30370,0.0,172.253.118.0-255,297,297,7,237259
30371,2.5e-05,172.31.36.0-255,66,363,7,237259
30372,3.1e-05,172.253.118.0-255,1484,1847,7,237259
30373,3.5e-05,172.31.36.0-255,66,1913,7,237259
30374,4.2e-05,172.253.118.0-255,4320,6233,7,237259
30375,4.6e-05,172.31.36.0-255,66,6299,7,237259
30376,5e-05,172.253.118.0-255,1484,7783,7,237259
30377,5.2e-05,172.31.36.0-255,66,7849,7,237259
30378,7.7e-05,172.253.118.0-255,6122,13971,7,237259
30379,8e-05,172.31.36.0-255,66,14037,7,237259
30380,0.00012,172.253.118.0-255,1484,15521,7,237259
30381,0.000122,172.31.36.0-255,66,15587,7,237259
30382,0.000128,172.253.118.0-255,2902,18489,7,237259
30383,0.00013,172.31.36.0-255,66,18555,7,237259
30384,0.00015,172.253.118.0-255,5738,24293,7,237259
30385,0.000152,172.31.36.0-255,66,24359,7,237259
30386,0.000158,172.253.118.0-255,4320,28679,7,237259
30387,0.000161,172.31.36.0-255,66,28745,7,237259
30388,0.000175,172.253.118.0-255,1484,30229,7,237259
30389,0.000178,172.31.36.0-255,66,30295,7,237259
30390,0.000221,172.253.118.0-255,3961,34256,7,237259
30391,0.000225,172.31.36.0-255,66,34322,7,237259
30392,0.000232,172.31.36.0-255,66,34388,7,237259
30393,0.000257,172.253.118.0-255,2902,37290,7,237259
30394,0.000259,172.31.36.0-255,66,37356,7,237259
30395,0.000278,172.253.118.0-255,4320,41676,7,237259
30396,0.00028,172.31.36.0-255,66,41742,7,237259
30397,0.000285,172.253.118.0-255,2902,44644,7,237259
30398,0.000287,172.31.36.0-255,66,44710,7,237259
30399,0.000306,172.253.118.0-255,5738,50448,7,237259
30400,0.000309,172.31.36.0-255,66,50514,7,237259
30401,0.000326,172.253.118.0-255,1125,51639,7,237259
30402,0.000354,172.253.118.0-255,677,52316,7,237259
30403,0.000356,172.31.36.0-255,66,52382,7,237259
30404,0.000644,172.253.118.0-255,1484,53866,7,237259
30405,0.000652,172.253.118.0-255,2902,56768,7,237259
30406,0.000656,172.31.36.0-255,66,56834,7,237259
30407,0.000664,172.253.118.0-255,5738,62572,7,237259
30408,0.000666,172.31.36.0-255,66,62638,7,237259
30409,0.000672,172.253.118.0-255,4320,66958,7,237259
30410,0.000675,172.31.36.0-255,66,67024,7,237259
30411,0.00071,172.31.36.0-255,66,67090,7,237259
30412,0.000722,172.253.118.0-255,1484,68574,7,237259
30413,0.000734,172.31.36.0-255,66,68640,7,237259
30414,0.001194,172.253.118.0-255,1484,70124,7,237259
30415,0.001201,172.253.118.0-255,2902,73026,7,237259
30416,0.001204,172.31.36.0-255,66,73092,7,237259
30417,0.001212,172.253.118.0-255,5738,78830,7,237259
30418,0.001215,172.31.36.0-255,66,78896,7,237259
30419,0.001249,172.31.36.0-255,66,78962,7,237259
30420,0.00126,172.31.36.0-255,66,79028,7,237259
30421,0.001287,172.253.118.0-255,5020,84048,7,237259
30422,0.00129,172.31.36.0-255,66,84114,7,237259
30423,0.001328,172.253.118.0-255,1484,85598,7,237259
30424,0.001332,172.253.118.0-255,1484,87082,7,237259
30425,0.001334,172.31.36.0-255,66,87148,7,237259
30426,0.001353,172.253.118.0-255,1484,88632,7,237259
30427,0.001359,172.253.118.0-255,5738,94370,7,237259
30428,0.001361,172.31.36.0-255,66,94436,7,237259
30429,0.001413,172.31.36.0-255,66,94502,7,237259
30430,0.001426,172.31.36.0-255,66,94568,7,237259
30431,0.001429,172.253.118.0-255,1484,96052,7,237259
30432,0.001459,172.31.36.0-255,66,96118,7,237259
30433,0.001472,172.31.36.0-255,66,96184,7,237259
30434,0.001507,172.31.36.0-255,66,96250,7,237259
30435,0.001523,172.253.118.0-255,1484,97734,7,237259
30436,0.001537,172.253.118.0-255,2902,100636,7,237259
30437,0.00154,172.31.36.0-255,66,100702,7,237259
30438,0.001546,172.253.118.0-255,4320,105022,7,237259
30439,0.001548,172.31.36.0-255,66,105088,7,237259
30440,0.00156,172.253.118.0-255,1484,106572,7,237259
30441,0.001572,172.253.118.0-255,2902,109474,7,237259
30442,0.001575,172.31.36.0-255,66,109540,7,237259
30443,0.001606,172.31.36.0-255,66,109606,7,237259
30444,0.001613,172.253.118.0-255,7156,116762,7,237259
30445,0.001615,172.31.36.0-255,66,116828,7,237259
30446,0.001636,172.253.118.0-255,1484,118312,7,237259
30447,0.001649,172.253.118.0-255,2184,120496,7,237259
30448,0.001651,172.31.36.0-255,66,120562,7,237259
30449,0.001656,172.253.118.0-255,2902,123464,7,237259
30450,0.001658,172.31.36.0-255,66,123530,7,237259
30451,0.001669,172.253.118.0-255,1484,125014,7,237259
30452,0.001699,172.31.36.0-255,66,125080,7,237259
30453,0.001711,172.253.118.0-255,7156,132236,7,237259
30454,0.001714,172.31.36.0-255,66,132302,7,237259
30455,0.001735,172.253.118.0-255,5738,138040,7,237259
30456,0.001738,172.31.36.0-255,66,138106,7,237259
30457,0.001786,172.31.36.0-255,66,138172,7,237259
30458,0.001798,172.31.36.0-255,66,138238,7,237259
30459,0.001813,172.31.36.0-255,66,138304,7,237259
30460,0.001829,172.253.118.0-255,2184,140488,7,237259
30461,0.001831,172.31.36.0-255,66,140554,7,237259
30462,0.00187,172.31.36.0-255,66,140620,7,237259
30463,0.001881,172.31.36.0-255,66,140686,7,237259
30464,0.001936,172.253.118.0-255,4320,145006,7,237259
30465,0.001939,172.31.36.0-255,66,145072,7,237259
30466,0.001962,172.31.36.0-255,66,145138,7,237259
30467,0.001965,172.253.118.0-255,766,145904,7,237259
30468,0.001993,172.253.118.0-255,1484,147388,7,237259
30469,0.001996,172.31.36.0-255,66,147454,7,237259
30470,0.002029,172.253.118.0-255,2902,150356,7,237259
30471,0.002032,172.31.36.0-255,66,150422,7,237259
30472,0.002038,172.253.118.0-255,4320,154742,7,237259
30473,0.00204,172.31.36.0-255,66,154808,7,237259
30474,0.002054,172.253.118.0-255,1484,156292,7,237259
30475,0.002058,172.253.118.0-255,1484,157776,7,237259
30476,0.00206,172.31.36.0-255,66,157842,7,237259
30477,0.004053,172.253.118.0-255,2902,160744,7,237259
30478,0.00406,172.31.36.0-255,66,160810,7,237259
30479,0.004083,172.253.118.0-255,2902,163712,7,237259
30480,0.004085,172.31.36.0-255,66,163778,7,237259
30481,0.006093,172.253.118.0-255,5738,169516,7,237259
30482,0.006098,172.31.36.0-255,66,169582,7,237259
30483,0.00812,172.253.118.0-255,5738,175320,7,237259
30484,0.008123,172.31.36.0-255,66,175386,7,237259
30485,0.010158,172.253.118.0-255,5738,181124,7,237259
30486,0.010166,172.31.36.0-255,66,181190,7,237259
30487,0.012202,172.253.118.0-255,5738,186928,7,237259
30488,0.012209,172.31.36.0-255,66,186994,7,237259
30489,0.014248,172.253.118.0-255,5738,192732,7,237259
30490,0.014256,172.31.36.0-255,66,192798,7,237259
30491,0.016283,172.253.118.0-255,5738,198536,7,237259
30492,0.016291,172.31.36.0-255,66,198602,7,237259
30493,0.018326,172.253.118.0-255,5738,204340,7,237259
30494,0.018336,172.31.36.0-255,66,204406,7,237259
30495,0.020358,172.253.118.0-255,5738,210144,7,237259
30496,0.020366,172.31.36.0-255,66,210210,7,237259
30497,0.022413,172.253.118.0-255,5738,215948,7,237259
30498,0.022425,172.31.36.0-255,66,216014,7,237259
30499,0.024462,172.253.118.0-255,5738,221752,7,237259
30500,0.024469,172.31.36.0-255,66,221818,7,237259
30501,0.026498,172.253.118.0-255,5738,227556,7,237259
30502,0.026505,172.31.36.0-255,66,227622,7,237259
30503,0.028551,172.253.118.0-255,5108,232730,7,237259
30504,0.028558,172.31.36.0-255,66,232796,7,237259
30505,0.028745,172.31.36.0-255,105,232901,7,237259
30506,0.030732,172.253.118.0-255,66,232967,7,237259
30507,0.034031,172.31.36.0-255,172,233139,7,237259
30508,0.034064,172.31.36.0-255,1114,234253,7,237259
30509,0.034122,172.31.36.0-255,1514,235767,7,237259
30510,0.034123,172.31.36.0-255,1294,237061,7,237259
30511,0.035529,104.244.42.0-255,66,237127,7,237259
30512,0.035559,104.244.42.0-255,66,237193,7,237259
30513,0.035631,104.244.42.0-255,66,237259,7,237259
30514,0.0,74.125.24.0-255,143,143,7,237581
30515,2.4e-05,172.31.36.0-255,66,209,7,237581
30516,3.1e-05,74.125.24.0-255,1484,1693,7,237581
30517,3.6e-05,172.31.36.0-255,66,1759,7,237581
30518,4.2e-05,74.125.24.0-255,2902,4661,7,237581
30519,4.6e-05,172.31.36.0-255,66,4727,7,237581
30520,5.4e-05,74.125.24.0-255,7156,11883,7,237581
30521,5.7e-05,172.31.36.0-255,66,11949,7,237581
30522,6e-05,74.125.24.0-255,1484,13433,7,237581
30523,6.3e-05,172.31.36.0-255,66,13499,7,237581
30524,6.6e-05,74.125.24.0-255,654,14153,7,237581
30525,6.8e-05,172.31.36.0-255,66,14219,7,237581
30526,0.000138,74.125.24.0-255,1484,15703,7,237581
30527,0.000141,172.31.36.0-255,66,15769,7,237581
30528,0.000145,74.125.24.0-255,1484,17253,7,237581
30529,0.000148,172.31.36.0-255,66,17319,7,237581
30530,0.000162,74.125.24.0-255,1484,18803,7,237581
30531,0.000164,172.31.36.0-255,66,18869,7,237581
30532,0.00017,74.125.24.0-255,4320,23189,7,237581
30533,0.000173,172.31.36.0-255,66,23255,7,237581
30534,0.000188,74.125.24.0-255,1484,24739,7,237581
30535,0.000191,172.31.36.0-255,66,24805,7,237581
30536,0.000193,74.125.24.0-255,1484,26289,7,237581
30537,0.000195,172.31.36.0-255,66,26355,7,237581
30538,0.000222,74.125.24.0-255,4320,30675,7,237581
30539,0.000226,172.31.36.0-255,66,30741,7,237581
30540,0.000247,74.125.24.0-255,2543,33284,7,237581
30541,0.00025,172.31.36.0-255,66,33350,7,237581
30542,0.000257,74.125.24.0-255,7156,40506,7,237581
30543,0.000259,172.31.36.0-255,66,40572,7,237581
30544,0.000299,172.31.36.0-255,66,40638,7,237581
30545,0.000318,74.125.24.0-255,4320,44958,7,237581
30546,0.00032,172.31.36.0-255,66,45024,7,237581
30547,0.000335,74.125.24.0-255,4320,49344,7,237581
30548,0.000338,172.31.36.0-255,66,49410,7,237581
30549,0.000341,74.125.24.0-255,1484,50894,7,237581
30550,0.000381,74.125.24.0-255,4320,55214,7,237581
30551,0.000384,172.31.36.0-255,66,55280,7,237581
30552,0.000402,74.125.24.0-255,2820,58100,7,237581
30553,0.000404,172.31.36.0-255,66,58166,7,237581
30554,0.001064,74.125.24.0-255,377,58543,7,237581
30555,0.001113,172.31.36.0-255,66,58609,7,237581
30556,0.001219,74.125.24.0-255,1484,60093,7,237581
30557,0.001227,74.125.24.0-255,2902,62995,7,237581
30558,0.001231,172.31.36.0-255,66,63061,7,237581
30559,0.001237,74.125.24.0-255,2902,65963,7,237581
30560,0.00124,172.31.36.0-255,66,66029,7,237581
30561,0.001254,74.125.24.0-255,2902,68931,7,237581
30562,0.001256,172.31.36.0-255,66,68997,7,237581
30563,0.001288,172.31.36.0-255,66,69063,7,237581
30564,0.001311,74.125.24.0-255,1484,70547,7,237581
30565,0.001332,172.31.36.0-255,66,70613,7,237581
30566,0.001519,74.125.24.0-255,1484,72097,7,237581
30567,0.001534,74.125.24.0-255,2902,74999,7,237581
30568,0.001538,172.31.36.0-255,66,75065,7,237581
30569,0.001545,74.125.24.0-255,5738,80803,7,237581
30570,0.001547,172.31.36.0-255,66,80869,7,237581
30571,0.001584,172.31.36.0-255,66,80935,7,237581
30572,0.001601,74.125.24.0-255,2902,83837,7,237581
30573,0.001604,172.31.36.0-255,66,83903,7,237581
30574,0.001642,172.31.36.0-255,66,83969,7,237581
30575,0.001646,74.125.24.0-255,2902,86871,7,237581
30576,0.001648,172.31.36.0-255,66,86937,7,237581
30577,0.001672,172.31.36.0-255,66,87003,7,237581
30578,0.001682,172.31.36.0-255,66,87069,7,237581
30579,0.001702,74.125.24.0-255,5738,92807,7,237581
30580,0.001704,172.31.36.0-255,66,92873,7,237581
30581,0.001712,74.125.24.0-255,6438,99311,7,237581
30582,0.001715,172.31.36.0-255,66,99377,7,237581
30583,0.001737,74.125.24.0-255,1484,100861,7,237581
30584,0.001741,74.125.24.0-255,1484,102345,7,237581
30585,0.001743,172.31.36.0-255,66,102411,7,237581
30586,0.001756,74.125.24.0-255,1484,103895,7,237581
30587,0.001762,74.125.24.0-255,5738,109633,7,237581
30588,0.001765,172.31.36.0-255,66,109699,7,237581
30589,0.001781,74.125.24.0-255,2902,112601,7,237581
30590,0.001784,172.31.36.0-255,66,112667,7,237581
30591,0.001823,172.31.36.0-255,66,112733,7,237581
30592,0.001834,172.31.36.0-255,66,112799,7,237581
30593,0.001837,74.125.24.0-255,766,113565,7,237581
30594,0.001857,74.125.24.0-255,1484,115049,7,237581
30595,0.001859,172.31.36.0-255,66,115115,7,237581
30596,0.001865,74.125.24.0-255,4320,119435,7,237581
30597,0.001868,172.31.36.0-255,66,119501,7,237581
30598,0.001909,172.31.36.0-255,66,119567,7,237581
30599,0.00192,172.31.36.0-255,66,119633,7,237581
30600,0.001936,74.125.24.0-255,4320,123953,7,237581
30601,0.001939,172.31.36.0-255,66,124019,7,237581
30602,0.001958,74.125.24.0-255,5020,129039,7,237581
30603,0.001961,172.31.36.0-255,66,129105,7,237581
30604,0.001978,74.125.24.0-255,4320,133425,7,237581
30605,0.001981,172.31.36.0-255,66,133491,7,237581
30606,0.001999,74.125.24.0-255,1484,134975,7,237581
30607,0.002019,74.125.24.0-255,7156,142131,7,237581
30608,0.002023,172.31.36.0-255,66,142197,7,237581
30609,0.002055,74.125.24.0-255,5738,147935,7,237581
30610,0.00206,172.31.36.0-255,66,148001,7,237581
30611,0.002075,172.31.36.0-255,66,148067,7,237581
30612,0.002077,74.125.24.0-255,766,148833,7,237581
30613,0.0021,74.125.24.0-255,1484,150317,7,237581
30614,0.002103,172.31.36.0-255,66,150383,7,237581
30615,0.002109,74.125.24.0-255,2902,153285,7,237581
30616,0.002111,172.31.36.0-255,66,153351,7,237581
30617,0.002175,74.125.24.0-255,5738,159089,7,237581
30618,0.002179,172.31.36.0-255,66,159155,7,237581
30619,0.002193,172.31.36.0-255,66,159221,7,237581
30620,0.002205,172.31.36.0-255,66,159287,7,237581
30621,0.002208,74.125.24.0-255,1484,160771,7,237581
30622,0.002247,172.31.36.0-255,66,160837,7,237581
30623,0.002275,172.31.36.0-255,66,160903,7,237581
30624,0.002285,172.31.36.0-255,66,160969,7,237581
30625,0.002337,74.125.24.0-255,1484,162453,7,237581
30626,0.002343,74.125.24.0-255,2902,165355,7,237581
30627,0.002345,172.31.36.0-255,66,165421,7,237581
30628,0.002364,74.125.24.0-255,1484,166905,7,237581
30629,0.002378,74.125.24.0-255,4320,171225,7,237581
30630,0.002381,172.31.36.0-255,66,171291,7,237581
30631,0.002388,74.125.24.0-255,5738,177029,7,237581
30632,0.00239,172.31.36.0-255,66,177095,7,237581
30633,0.002405,74.125.24.0-255,4320,181415,7,237581
30634,0.002409,172.31.36.0-255,66,181481,7,237581
30635,0.002421,172.31.36.0-255,66,181547,7,237581
30636,0.002443,74.125.24.0-255,1484,183031,7,237581
30637,0.002448,74.125.24.0-255,2184,185215,7,237581
30638,0.002451,172.31.36.0-255,66,185281,7,237581
30639,0.002484,74.125.24.0-255,1484,186765,7,237581
30640,0.002503,74.125.24.0-255,2902,189667,7,237581
30641,0.002507,172.31.36.0-255,66,189733,7,237581
30642,0.002512,74.125.24.0-255,2902,192635,7,237581
30643,0.002515,172.31.36.0-255,66,192701,7,237581
30644,0.002529,74.125.24.0-255,2902,195603,7,237581
30645,0.002534,74.125.24.0-255,4320,199923,7,237581
30646,0.002552,74.125.24.0-255,1484,201407,7,237581
30647,0.002571,74.125.24.0-255,2902,204309,7,237581
30648,0.002592,74.125.24.0-255,7156,211465,7,237581
30649,0.002601,74.125.24.0-255,7156,218621,7,237581
30650,0.002614,74.125.24.0-255,766,219387,7,237581
30651,0.004191,172.31.36.0-255,66,219453,7,237581
30652,0.006774,74.125.24.0-255,5738,225191,7,237581
30653,0.006788,172.31.36.0-255,66,225257,7,237581
30654,0.009333,74.125.24.0-255,5738,230995,7,237581
30655,0.009338,172.31.36.0-255,66,231061,7,237581
30656,0.011898,74.125.24.0-255,1993,233054,7,237581
30657,0.011906,172.31.36.0-255,66,233120,7,237581
30658,0.020084,172.31.36.0-255,105,233225,7,237581
30659,0.022658,74.125.24.0-255,66,233291,7,237581
30660,0.034632,172.31.36.0-255,172,233463,7,237581
30661,0.034673,172.31.36.0-255,1115,234578,7,237581
30662,0.034765,172.31.36.0-255,1514,236092,7,237581
30663,0.034767,172.31.36.0-255,1291,237383,7,237581
30664,0.036201,104.244.42.0-255,66,237449,7,237581
30665,0.036227,104.244.42.0-255,66,237515,7,237581
30666,0.03635,104.244.42.0-255,66,237581,7,237581
30667,0.0,172.217.194.0-255,157,157,7,169414
30668,3.8e-05,172.31.36.0-255,66,223,7,169414
30669,4.5e-05,172.217.194.0-255,1484,1707,7,169414
30670,5e-05,172.31.36.0-255,66,1773,7,169414
30671,5.5e-05,172.217.194.0-255,2902,4675,7,169414
30672,6.6e-05,172.31.36.0-255,66,4741,7,169414
30673,7.3e-05,172.217.194.0-255,7156,11897,7,169414
30674,7.6e-05,172.31.36.0-255,66,11963,7,169414
30675,9.2e-05,172.31.36.0-255,66,12029,7,169414
30676,0.000126,172.217.194.0-255,2543,14572,7,169414
30677,0.000129,172.31.36.0-255,66,14638,7,169414
30678,0.000134,172.217.194.0-255,2902,17540,7,169414
30679,0.000136,172.31.36.0-255,66,17606,7,169414
30680,0.000173,172.217.194.0-255,7156,24762,7,169414
30681,0.000176,172.31.36.0-255,66,24828,7,169414
30682,0.000184,172.217.194.0-255,5738,30566,7,169414
30683,0.000187,172.31.36.0-255,66,30632,7,169414
30684,0.000211,172.31.36.0-255,66,30698,7,169414
30685,0.000215,172.217.194.0-255,2802,33500,7,169414
30686,0.000218,172.31.36.0-255,66,33566,7,169414
30687,0.000267,172.217.194.0-255,116,33682,7,169414
30688,0.000271,172.31.36.0-255,66,33748,7,169414
30689,0.000298,172.217.194.0-255,377,34125,7,169414
30690,0.000302,172.31.36.0-255,66,34191,7,169414
30691,0.000492,172.217.194.0-255,1484,35675,7,169414
30692,0.000496,172.31.36.0-255,66,35741,7,169414
30693,0.000501,172.217.194.0-255,1484,37225,7,169414
30694,0.000503,172.31.36.0-255,66,37291,7,169414
30695,0.000526,172.217.194.0-255,1484,38775,7,169414
30696,0.000529,172.31.36.0-255,66,38841,7,169414
30697,0.000541,172.217.194.0-255,5738,44579,7,169414
30698,0.000544,172.31.36.0-255,66,44645,7,169414
30699,0.000555,172.31.36.0-255,66,44711,7,169414
30700,0.000586,172.217.194.0-255,4320,49031,7,169414
30701,0.00059,172.31.36.0-255,66,49097,7,169414
30702,0.00061,172.31.36.0-255,66,49163,7,169414
30703,0.000722,172.217.194.0-255,1484,50647,7,169414
30704,0.000727,172.217.194.0-255,2902,53549,7,169414
30705,0.00073,172.31.36.0-255,66,53615,7,169414
30706,0.000763,172.217.194.0-255,5738,59353,7,169414
30707,0.000767,172.31.36.0-255,66,59419,7,169414
30708,0.000779,172.31.36.0-255,66,59485,7,169414
30709,0.000807,172.217.194.0-255,2902,62387,7,169414
30710,0.00081,172.31.36.0-255,66,62453,7,169414
30711,0.000829,172.31.36.0-255,66,62519,7,169414
30712,0.000832,172.217.194.0-255,766,63285,7,169414
30713,0.000852,172.217.194.0-255,1484,64769,7,169414
30714,0.000855,172.31.36.0-255,66,64835,7,169414
30715,0.000861,172.217.194.0-255,4320,69155,7,169414
30716,0.000863,172.31.36.0-255,66,69221,7,169414
30717,0.000891,172.217.194.0-255,5738,74959,7,169414
30718,0.000896,172.31.36.0-255,66,75025,7,169414
30719,0.000903,172.31.36.0-255,66,75091,7,169414
30720,0.000921,172.217.194.0-255,2902,77993,7,169414
30721,0.000925,172.31.36.0-255,66,78059,7,169414
30722,0.000937,172.217.194.0-255,4320,82379,7,169414
30723,0.00094,172.31.36.0-255,66,82445,7,169414
30724,0.00097,172.217.194.0-255,6438,88883,7,169414
30725,0.000974,172.31.36.0-255,66,88949,7,169414
30726,0.001147,172.217.194.0-255,1484,90433,7,169414
30727,0.001163,172.217.194.0-255,2902,93335,7,169414
30728,0.001166,172.31.36.0-255,66,93401,7,169414
30729,0.001174,172.217.194.0-255,5738,99139,7,169414
30730,0.001176,172.31.36.0-255,66,99205,7,169414
30731,0.001203,172.217.194.0-255,4320,103525,7,169414
30732,0.001207,172.31.36.0-255,66,103591,7,169414
30733,0.001254,172.217.194.0-255,5738,109329,7,169414
30734,0.001257,172.31.36.0-255,66,109395,7,169414
30735,0.001288,172.217.194.0-255,5738,115133,7,169414
30736,0.001297,172.31.36.0-255,66,115199,7,169414
30737,0.001305,172.217.194.0-255,7156,122355,7,169414
30738,0.001307,172.31.36.0-255,66,122421,7,169414
30739,0.001318,172.31.36.0-255,66,122487,7,169414
30740,0.001329,172.31.36.0-255,66,122553,7,169414
30741,0.001362,172.31.36.0-255,66,122619,7,169414
30742,0.001393,172.217.194.0-255,7156,129775,7,169414
30743,0.001396,172.31.36.0-255,66,129841,7,169414
30744,0.0014,172.217.194.0-255,766,130607,7,169414
30745,0.001606,172.217.194.0-255,1484,132091,7,169414
30746,0.001611,172.31.36.0-255,66,132157,7,169414
30747,0.001616,172.217.194.0-255,2902,135059,7,169414
30748,0.001618,172.31.36.0-255,66,135125,7,169414
30749,0.001648,172.217.194.0-255,5738,140863,7,169414
30750,0.001652,172.31.36.0-255,66,140929,7,169414
30751,0.001658,172.217.194.0-255,5738,146667,7,169414
30752,0.001661,172.31.36.0-255,66,146733,7,169414
30753,0.001711,172.217.194.0-255,7156,153889,7,169414
30754,0.001715,172.31.36.0-255,66,153955,7,169414
30755,0.001719,172.217.194.0-255,1484,155439,7,169414
30756,0.001738,172.31.36.0-255,66,155505,7,169414
30757,0.001777,172.217.194.0-255,2184,157689,7,169414
30758,0.00178,172.31.36.0-255,66,157755,7,169414
30759,0.001803,172.31.36.0-255,66,157821,7,169414
30760,0.001814,172.31.36.0-255,66,157887,7,169414
30761,0.001838,172.31.36.0-255,66,157953,7,169414
30762,0.001845,172.217.194.0-255,6438,164391,7,169414
30763,0.001848,172.31.36.0-255,66,164457,7,169414
30764,0.001898,172.31.36.0-255,66,164523,7,169414
30765,0.001943,172.31.36.0-255,66,164589,7,169414
30766,0.002005,172.31.36.0-255,66,164655,7,169414
30767,0.002041,172.31.36.0-255,66,164721,7,169414
30768,0.002063,172.31.36.0-255,66,164787,7,169414
30769,0.002066,172.217.194.0-255,105,164892,7,169414
30770,0.008616,172.31.36.0-255,66,164958,7,169414
30771,0.008643,172.31.36.0-255,105,165063,7,169414
30772,0.010616,172.217.194.0-255,66,165129,7,169414
30773,0.030881,172.31.36.0-255,167,165296,7,169414
30774,0.030909,172.31.36.0-255,1115,166411,7,169414
30775,0.030958,172.31.36.0-255,1514,167925,7,169414
30776,0.03096,172.31.36.0-255,1291,169216,7,169414
30777,0.032415,104.244.42.0-255,66,169282,7,169414
30778,0.032575,104.244.42.0-255,66,169348,7,169414
30779,0.032577,104.244.42.0-255,66,169414,7,169414
30780,0.0,172.217.194.0-255,153,153,7,297193
30781,3e-05,172.31.36.0-255,66,219,7,297193
30782,3.6e-05,172.217.194.0-255,1484,1703,7,297193
30783,4.1e-05,172.31.36.0-255,66,1769,7,297193
30784,4.5e-05,172.217.194.0-255,2902,4671,7,297193
30785,4.9e-05,172.31.36.0-255,66,4737,7,297193
30786,5.5e-05,172.217.194.0-255,5738,10475,7,297193
30787,5.8e-05,172.31.36.0-255,66,10541,7,297193
30788,7.3e-05,172.217.194.0-255,1484,12025,7,297193
30789,7.6e-05,172.31.36.0-255,66,12091,7,297193
30790,9.5e-05,172.217.194.0-255,2902,14993,7,297193
30791,9.7e-05,172.31.36.0-255,66,15059,7,297193
30792,0.000125,172.217.194.0-255,2014,17073,7,297193
30793,0.000129,172.31.36.0-255,66,17139,7,297193
30794,0.000135,172.217.194.0-255,5738,22877,7,297193
30795,0.000138,172.31.36.0-255,66,22943,7,297193
30796,0.000162,172.31.36.0-255,66,23009,7,297193
30797,0.000203,172.217.194.0-255,7156,30165,7,297193
30798,0.000207,172.31.36.0-255,66,30231,7,297193
30799,0.000224,172.217.194.0-255,1484,31715,7,297193
30800,0.000227,172.31.36.0-255,66,31781,7,297193
30801,0.000238,172.31.36.0-255,66,31847,7,297193
30802,0.00027,172.31.36.0-255,66,31913,7,297193
30803,0.000284,172.217.194.0-255,1484,33397,7,297193
30804,0.000287,172.31.36.0-255,66,33463,7,297193
30805,0.000305,172.217.194.0-255,1484,34947,7,297193
30806,0.000307,172.31.36.0-255,66,35013,7,297193
30807,0.000334,172.217.194.0-255,5379,40392,7,297193
30808,0.000337,172.31.36.0-255,66,40458,7,297193
30809,0.000573,172.217.194.0-255,360,40818,7,297193
30810,0.000578,172.217.194.0-255,383,41201,7,297193
30811,0.000866,172.217.194.0-255,1484,42685,7,297193
30812,0.000871,172.31.36.0-255,66,42751,7,297193
30813,0.000878,172.217.194.0-255,2902,45653,7,297193
30814,0.00088,172.31.36.0-255,66,45719,7,297193
30815,0.000885,172.217.194.0-255,2902,48621,7,297193
30816,0.000888,172.31.36.0-255,66,48687,7,297193
30817,0.000908,172.217.194.0-255,2902,51589,7,297193
30818,0.000911,172.31.36.0-255,66,51655,7,297193
30819,0.00092,172.217.194.0-255,7156,58811,7,297193
30820,0.000922,172.31.36.0-255,66,58877,7,297193
30821,0.000948,172.217.194.0-255,5738,64615,7,297193
30822,0.000951,172.31.36.0-255,66,64681,7,297193
30823,0.000959,172.217.194.0-255,7156,71837,7,297193
30824,0.000961,172.31.36.0-255,66,71903,7,297193
30825,0.000987,172.217.194.0-255,3602,75505,7,297193
30826,0.000989,172.31.36.0-255,66,75571,7,297193
30827,0.001192,172.217.194.0-255,1484,77055,7,297193
30828,0.001209,172.217.194.0-255,2902,79957,7,297193
30829,0.001213,172.31.36.0-255,66,80023,7,297193
30830,0.001221,172.217.194.0-255,5738,85761,7,297193
30831,0.001223,172.31.36.0-255,66,85827,7,297193
30832,0.001226,172.217.194.0-255,1484,87311,7,297193
30833,0.001252,172.217.194.0-255,4320,91631,7,297193
30834,0.001255,172.31.36.0-255,66,91697,7,297193
30835,0.001259,172.217.194.0-255,2902,94599,7,297193
30836,0.001261,172.31.36.0-255,66,94665,7,297193
30837,0.001283,172.31.36.0-255,66,94731,7,297193
30838,0.001289,172.217.194.0-255,5020,99751,7,297193
30839,0.001292,172.31.36.0-255,66,99817,7,297193
30840,0.001344,172.217.194.0-255,1484,101301,7,297193
30841,0.001347,172.217.194.0-255,1484,102785,7,297193
30842,0.001349,172.31.36.0-255,66,102851,7,297193
30843,0.001361,172.217.194.0-255,1484,104335,7,297193
30844,0.001365,172.217.194.0-255,2902,107237,7,297193
30845,0.001368,172.31.36.0-255,66,107303,7,297193
30846,0.001394,172.217.194.0-255,2902,110205,7,297193
30847,0.001397,172.31.36.0-255,66,110271,7,297193
30848,0.001403,172.217.194.0-255,7156,117427,7,297193
30849,0.001405,172.31.36.0-255,66,117493,7,297193
30850,0.001419,172.217.194.0-255,2902,120395,7,297193
30851,0.001422,172.31.36.0-255,66,120461,7,297193
30852,0.001454,172.31.36.0-255,66,120527,7,297193
30853,0.001458,172.217.194.0-255,2184,122711,7,297193
30854,0.00146,172.31.36.0-255,66,122777,7,297193
30855,0.001513,172.217.194.0-255,1484,124261,7,297193
30856,0.001535,172.217.194.0-255,2902,127163,7,297193
30857,0.001539,172.31.36.0-255,66,127229,7,297193
30858,0.001543,172.217.194.0-255,4320,131549,7,297193
30859,0.001545,172.31.36.0-255,66,131615,7,297193
30860,0.001557,172.217.194.0-255,1484,133099,7,297193
30861,0.001571,172.217.194.0-255,2902,136001,7,297193
30862,0.001573,172.31.36.0-255,66,136067,7,297193
30863,0.001595,172.31.36.0-255,66,136133,7,297193
30864,0.001619,172.217.194.0-255,4320,140453,7,297193
30865,0.001621,172.31.36.0-255,66,140519,7,297193
30866,0.001655,172.31.36.0-255,66,140585,7,297193
30867,0.0017,172.31.36.0-255,66,140651,7,297193
30868,0.001731,172.31.36.0-255,66,140717,7,297193
30869,0.001929,172.217.194.0-255,1484,142201,7,297193
30870,0.00194,172.217.194.0-255,2902,145103,7,297193
30871,0.001943,172.31.36.0-255,66,145169,7,297193
30872,0.001963,172.217.194.0-255,5738,150907,7,297193
30873,0.001965,172.31.36.0-255,66,150973,7,297193
30874,0.001992,172.217.194.0-255,7156,158129,7,297193
30875,0.001995,172.31.36.0-255,66,158195,7,297193
30876,0.00202,172.31.36.0-255,66,158261,7,297193
30877,0.002038,172.217.194.0-255,1484,159745,7,297193
30878,0.002042,172.217.194.0-255,2184,161929,7,297193
30879,0.002044,172.31.36.0-255,66,161995,7,297193
30880,0.002077,172.217.194.0-255,1484,163479,7,297193
30881,0.00209,172.217.194.0-255,2902,166381,7,297193
30882,0.002092,172.31.36.0-255,66,166447,7,297193
30883,0.002096,172.217.194.0-255,2902,169349,7,297193
30884,0.002099,172.31.36.0-255,66,169415,7,297193
30885,0.002111,172.217.194.0-255,2902,172317,7,297193
30886,0.002113,172.31.36.0-255,66,172383,7,297193
30887,0.002135,172.31.36.0-255,66,172449,7,297193
30888,0.002147,172.217.194.0-255,2902,175351,7,297193
30889,0.002149,172.31.36.0-255,66,175417,7,297193
30890,0.002161,172.31.36.0-255,66,175483,7,297193
30891,0.004623,172.217.194.0-255,5738,181221,7,297193
30892,0.004627,172.31.36.0-255,66,181287,7,297193
30893,0.007116,172.217.194.0-255,5738,187025,7,297193
30894,0.007122,172.31.36.0-255,66,187091,7,297193
30895,0.009624,172.217.194.0-255,5738,192829,7,297193
30896,0.009631,172.31.36.0-255,66,192895,7,297193
30897,0.012153,172.217.194.0-255,5738,198633,7,297193
30898,0.012162,172.31.36.0-255,66,198699,7,297193
30899,0.014638,172.217.194.0-255,4320,203019,7,297193
30900,0.014646,172.31.36.0-255,66,203085,7,297193
30901,0.014676,172.217.194.0-255,1484,204569,7,297193
30902,0.017133,172.217.194.0-255,4320,208889,7,297193
30903,0.017145,172.31.36.0-255,66,208955,7,297193
30904,0.019654,172.217.194.0-255,5738,214693,7,297193
30905,0.019671,172.31.36.0-255,66,214759,7,297193
30906,0.022134,172.217.194.0-255,5738,220497,7,297193
30907,0.022147,172.31.36.0-255,66,220563,7,297193
30908,0.02467,172.217.194.0-255,5738,226301,7,297193
30909,0.024682,172.31.36.0-255,66,226367,7,297193
30910,0.027185,172.217.194.0-255,5738,232105,7,297193
30911,0.027199,172.31.36.0-255,66,232171,7,297193
30912,0.028372,172.31.36.0-255,188,232359,7,297193
30913,0.028417,172.31.36.0-255,958,233317,7,297193
30914,0.028486,172.31.36.0-255,1514,234831,7,297193
30915,0.028488,172.31.36.0-255,1448,236279,7,297193
30916,0.029675,172.217.194.0-255,5738,242017,7,297193
30917,0.029681,172.31.36.0-255,66,242083,7,297193
30918,0.029929,104.244.42.0-255,66,242149,7,297193
30919,0.029968,104.244.42.0-255,66,242215,7,297193
30920,0.030107,104.244.42.0-255,66,242281,7,297193
30921,0.032136,172.217.194.0-255,5738,248019,7,297193
30922,0.032141,172.31.36.0-255,66,248085,7,297193
30923,0.03463,172.217.194.0-255,4320,252405,7,297193
30924,0.034636,172.31.36.0-255,66,252471,7,297193
30925,0.034658,172.217.194.0-255,1484,253955,7,297193
30926,0.037145,172.217.194.0-255,4320,258275,7,297193
30927,0.037154,172.31.36.0-255,66,258341,7,297193
30928,0.039614,172.217.194.0-255,2902,261243,7,297193
30929,0.03962,172.31.36.0-255,66,261309,7,297193
30930,0.039652,172.217.194.0-255,2902,264211,7,297193
30931,0.039655,172.31.36.0-255,66,264277,7,297193
30932,0.04207,172.217.194.0-255,2902,267179,7,297193
30933,0.042076,172.31.36.0-255,66,267245,7,297193
30934,0.042104,172.217.194.0-255,1484,268729,7,297193
30935,0.042121,172.217.194.0-255,1484,270213,7,297193
30936,0.042124,172.31.36.0-255,66,270279,7,297193
30937,0.044532,172.217.194.0-255,2902,273181,7,297193
30938,0.044538,172.31.36.0-255,66,273247,7,297193
30939,0.044589,172.217.194.0-255,2902,276149,7,297193
30940,0.044594,172.31.36.0-255,66,276215,7,297193
30941,0.047044,172.217.194.0-255,2902,279117,7,297193
30942,0.047049,172.31.36.0-255,66,279183,7,297193
30943,0.047075,172.217.194.0-255,2902,282085,7,297193
30944,0.047078,172.31.36.0-255,66,282151,7,297193
30945,0.049529,172.217.194.0-255,5738,287889,7,297193
30946,0.049534,172.31.36.0-255,66,287955,7,297193
30947,0.049643,172.31.36.0-255,101,288056,7,297193
30948,0.052005,172.217.194.0-255,5738,293794,7,297193
30949,0.05201,172.31.36.0-255,66,293860,7,297193
30950,0.052113,172.217.194.0-255,66,293926,7,297193
30951,0.054472,172.217.194.0-255,2637,296563,7,297193
30952,0.054477,172.31.36.0-255,66,296629,7,297193
30953,0.054668,172.31.36.0-255,105,296734,7,297193
30954,0.054693,172.31.36.0-255,105,296839,7,297193
30955,0.054934,172.31.36.0-255,90,296929,7,297193
30956,0.054944,172.31.36.0-255,66,296995,7,297193
30957,0.057147,172.217.194.0-255,66,297061,7,297193
30958,0.057586,172.217.194.0-255,66,297127,7,297193
30959,0.05759,172.31.36.0-255,66,297193,7,297193
30960,0.0,74.125.24.0-255,291,291,7,259040
30961,3.1e-05,172.31.36.0-255,66,357,7,259040
30962,3.7e-05,74.125.24.0-255,1484,1841,7,259040
30963,4.2e-05,172.31.36.0-255,66,1907,7,259040
30964,4.8e-05,74.125.24.0-255,4320,6227,7,259040
30965,5e-05,172.31.36.0-255,66,6293,7,259040
30966,5.7e-05,74.125.24.0-255,5738,12031,7,259040
30967,6e-05,172.31.36.0-255,66,12097,7,259040
30968,8e-05,74.125.24.0-255,1484,13581,7,259040
30969,8.4e-05,172.31.36.0-255,66,13647,7,259040
30970,9.4e-05,74.125.24.0-255,2902,16549,7,259040
30971,9.7e-05,172.31.36.0-255,66,16615,7,259040
30972,0.000118,172.31.36.0-255,66,16681,7,259040
30973,0.000131,74.125.24.0-255,1866,18547,7,259040
30974,0.000133,172.31.36.0-255,66,18613,7,259040
30975,0.000145,172.31.36.0-255,66,18679,7,259040
30976,0.000148,74.125.24.0-255,1484,20163,7,259040
30977,0.00015,172.31.36.0-255,66,20229,7,259040
30978,0.000189,172.31.36.0-255,66,20295,7,259040
30979,0.000253,74.125.24.0-255,1484,21779,7,259040
30980,0.000256,172.31.36.0-255,66,21845,7,259040
30981,0.000261,74.125.24.0-255,2902,24747,7,259040
30982,0.000263,172.31.36.0-255,66,24813,7,259040
30983,0.000278,74.125.24.0-255,5738,30551,7,259040
30984,0.000281,172.31.36.0-255,66,30617,7,259040
30985,0.000292,74.125.24.0-255,1484,32101,7,259040
30986,0.000296,172.31.36.0-255,66,32167,7,259040
30987,0.000313,74.125.24.0-255,5726,37893,7,259040
30988,0.000316,172.31.36.0-255,66,37959,7,259040
30989,0.000352,74.125.24.0-255,1484,39443,7,259040
30990,0.000367,74.125.24.0-255,2902,42345,7,259040
30991,0.000371,74.125.24.0-255,1484,43829,7,259040
30992,0.000374,172.31.36.0-255,66,43895,7,259040
30993,0.000388,74.125.24.0-255,4320,48215,7,259040
30994,0.000392,172.31.36.0-255,66,48281,7,259040
30995,0.000433,74.125.24.0-255,7156,55437,7,259040
30996,0.000437,172.31.36.0-255,66,55503,7,259040
30997,0.00047,74.125.24.0-255,3865,59368,7,259040
30998,0.000475,172.31.36.0-255,66,59434,7,259040
30999,0.00082,74.125.24.0-255,1484,60918,7,259040
31000,0.000841,74.125.24.0-255,2902,63820,7,259040
31001,0.000844,172.31.36.0-255,66,63886,7,259040
31002,0.000852,74.125.24.0-255,5738,69624,7,259040
31003,0.00086,172.31.36.0-255,66,69690,7,259040
31004,0.000898,172.31.36.0-255,66,69756,7,259040
31005,0.000912,172.31.36.0-255,66,69822,7,259040
31006,0.000957,74.125.24.0-255,2184,72006,7,259040
31007,0.000967,172.31.36.0-255,66,72072,7,259040
31008,0.001408,74.125.24.0-255,1484,73556,7,259040
31009,0.001423,74.125.24.0-255,2902,76458,7,259040
31010,0.001428,172.31.36.0-255,66,76524,7,259040
31011,0.001435,74.125.24.0-255,5738,82262,7,259040
31012,0.001464,74.125.24.0-255,4320,86582,7,259040
31013,0.001535,74.125.24.0-255,2184,88766,7,259040
31014,0.001901,74.125.24.0-255,1484,90250,7,259040
31015,0.001918,74.125.24.0-255,2902,93152,7,259040
31016,0.001929,74.125.24.0-255,1484,94636,7,259040
31017,0.001949,74.125.24.0-255,4320,98956,7,259040
31018,0.001953,74.125.24.0-255,2902,101858,7,259040
31019,0.002133,74.125.24.0-255,1484,103342,7,259040
31020,0.00214,74.125.24.0-255,2902,106244,7,259040
31021,0.002152,74.125.24.0-255,5738,111982,7,259040
31022,0.00218,74.125.24.0-255,2902,114884,7,259040
31023,0.002216,74.125.24.0-255,1484,116368,7,259040
31024,0.002253,74.125.24.0-255,2902,119270,7,259040
31025,0.002308,74.125.24.0-255,7156,126426,7,259040
31026,0.00233,74.125.24.0-255,2902,129328,7,259040
31027,0.006167,172.31.36.0-255,66,129394,7,259040
31028,0.008476,74.125.24.0-255,5738,135132,7,259040
31029,0.008486,172.31.36.0-255,66,135198,7,259040
31030,0.010805,74.125.24.0-255,5738,140936,7,259040
31031,0.010814,172.31.36.0-255,66,141002,7,259040
31032,0.013107,74.125.24.0-255,5738,146740,7,259040
31033,0.013117,172.31.36.0-255,66,146806,7,259040
31034,0.015456,74.125.24.0-255,5738,152544,7,259040
31035,0.015466,172.31.36.0-255,66,152610,7,259040
31036,0.017739,74.125.24.0-255,5738,158348,7,259040
31037,0.017746,172.31.36.0-255,66,158414,7,259040
31038,0.020046,74.125.24.0-255,5738,164152,7,259040
31039,0.020053,172.31.36.0-255,66,164218,7,259040
31040,0.02234,74.125.24.0-255,5738,169956,7,259040
31041,0.022352,172.31.36.0-255,66,170022,7,259040
31042,0.024643,74.125.24.0-255,5738,175760,7,259040
31043,0.024651,172.31.36.0-255,66,175826,7,259040
31044,0.026942,74.125.24.0-255,5738,181564,7,259040
31045,0.02695,172.31.36.0-255,66,181630,7,259040
31046,0.029213,74.125.24.0-255,5738,187368,7,259040
31047,0.029221,172.31.36.0-255,66,187434,7,259040
31048,0.031505,74.125.24.0-255,5738,193172,7,259040
31049,0.031515,172.31.36.0-255,66,193238,7,259040
31050,0.033784,74.125.24.0-255,5738,198976,7,259040
31051,0.033792,172.31.36.0-255,66,199042,7,259040
31052,0.036113,74.125.24.0-255,5738,204780,7,259040
31053,0.036121,172.31.36.0-255,66,204846,7,259040
31054,0.038435,74.125.24.0-255,5738,210584,7,259040
31055,0.038444,172.31.36.0-255,66,210650,7,259040
31056,0.040747,74.125.24.0-255,5738,216388,7,259040
31057,0.040754,172.31.36.0-255,66,216454,7,259040
31058,0.042362,172.31.36.0-255,194,216648,7,259040
31059,0.042392,172.31.36.0-255,1114,217762,7,259040
31060,0.042435,172.31.36.0-255,1514,219276,7,259040
31061,0.042436,172.31.36.0-255,1292,220568,7,259040
31062,0.043032,74.125.24.0-255,5738,226306,7,259040
31063,0.043042,172.31.36.0-255,66,226372,7,259040
31064,0.043901,104.244.42.0-255,66,226438,7,259040
31065,0.043919,104.244.42.0-255,66,226504,7,259040
31066,0.043985,104.244.42.0-255,66,226570,7,259040
31067,0.045336,74.125.24.0-255,5738,232308,7,259040
31068,0.045343,172.31.36.0-255,66,232374,7,259040
31069,0.047634,74.125.24.0-255,5738,238112,7,259040
31070,0.047641,172.31.36.0-255,66,238178,7,259040
31071,0.049928,74.125.24.0-255,5738,243916,7,259040
31072,0.049937,172.31.36.0-255,66,243982,7,259040
31073,0.052229,74.125.24.0-255,5738,249720,7,259040
31074,0.052234,172.31.36.0-255,66,249786,7,259040
31075,0.054511,74.125.24.0-255,5738,255524,7,259040
31076,0.054517,172.31.36.0-255,66,255590,7,259040
31077,0.056806,74.125.24.0-255,3213,258803,7,259040
31078,0.056813,172.31.36.0-255,66,258869,7,259040
31079,0.056995,172.31.36.0-255,105,258974,7,259040
31080,0.059253,74.125.24.0-255,66,259040,7,259040
31081,0.0,74.125.68.0-255,153,153,7,359434
31082,2.4e-05,172.31.36.0-255,66,219,7,359434
31083,3e-05,74.125.68.0-255,1484,1703,7,359434
31084,3.4e-05,172.31.36.0-255,66,1769,7,359434
31085,6e-05,74.125.68.0-255,1484,3253,7,359434
31086,6.7e-05,172.31.36.0-255,66,3319,7,359434
31087,7.4e-05,74.125.68.0-255,2902,6221,7,359434
31088,7.6e-05,172.31.36.0-255,66,6287,7,359434
31089,0.000102,74.125.68.0-255,4320,10607,7,359434
31090,0.000105,172.31.36.0-255,66,10673,7,359434
31091,0.000134,74.125.68.0-255,4864,15537,7,359434
31092,0.000136,172.31.36.0-255,66,15603,7,359434
31093,0.000162,74.125.68.0-255,7156,22759,7,359434
31094,0.000164,172.31.36.0-255,66,22825,7,359434
31095,0.000191,74.125.68.0-255,4320,27145,7,359434
31096,0.000194,172.31.36.0-255,66,27211,7,359434
31097,0.00022,74.125.68.0-255,3961,31172,7,359434
31098,0.000222,172.31.36.0-255,66,31238,7,359434
31099,0.000263,74.125.68.0-255,1484,32722,7,359434
31100,0.000266,172.31.36.0-255,66,32788,7,359434
31101,0.000269,74.125.68.0-255,1484,34272,7,359434
31102,0.000271,172.31.36.0-255,66,34338,7,359434
31103,0.0003,74.125.68.0-255,1484,35822,7,359434
31104,0.000302,172.31.36.0-255,66,35888,7,359434
31105,0.000307,74.125.68.0-255,4320,40208,7,359434
31106,0.000309,172.31.36.0-255,66,40274,7,359434
31107,0.000337,74.125.68.0-255,5738,46012,7,359434
31108,0.000339,172.31.36.0-255,66,46078,7,359434
31109,0.000365,74.125.68.0-255,5738,51816,7,359434
31110,0.000368,172.31.36.0-255,66,51882,7,359434
31111,0.000393,74.125.68.0-255,3961,55843,7,359434
31112,0.000396,172.31.36.0-255,66,55909,7,359434
31113,0.000416,74.125.68.0-255,1484,57393,7,359434
31114,0.000439,172.31.36.0-255,66,57459,7,359434
31115,0.000678,74.125.68.0-255,646,58105,7,359434
31116,0.000846,74.125.68.0-255,1484,59589,7,359434
31117,0.00085,172.31.36.0-255,66,59655,7,359434
31118,0.000869,74.125.68.0-255,2902,62557,7,359434
31119,0.000874,172.31.36.0-255,66,62623,7,359434
31120,0.000904,74.125.68.0-255,5738,68361,7,359434
31121,0.000907,172.31.36.0-255,66,68427,7,359434
31122,0.000915,74.125.68.0-255,7156,75583,7,359434
31123,0.000917,172.31.36.0-255,66,75649,7,359434
31124,0.000942,74.125.68.0-255,1484,77133,7,359434
31125,0.000953,172.31.36.0-255,66,77199,7,359434
31126,0.000958,74.125.68.0-255,5020,82219,7,359434
31127,0.000961,172.31.36.0-255,66,82285,7,359434
31128,0.001216,74.125.68.0-255,1484,83769,7,359434
31129,0.00123,74.125.68.0-255,2902,86671,7,359434
31130,0.001233,172.31.36.0-255,66,86737,7,359434
31131,0.001263,74.125.68.0-255,5738,92475,7,359434
31132,0.001266,172.31.36.0-255,66,92541,7,359434
31133,0.00127,74.125.68.0-255,2902,95443,7,359434
31134,0.001272,172.31.36.0-255,66,95509,7,359434
31135,0.001277,74.125.68.0-255,4320,99829,7,359434
31136,0.001283,172.31.36.0-255,66,99895,7,359434
31137,0.001286,74.125.68.0-255,1484,101379,7,359434
31138,0.00132,74.125.68.0-255,7156,108535,7,359434
31139,0.001323,172.31.36.0-255,66,108601,7,359434
31140,0.001329,74.125.68.0-255,5738,114339,7,359434
31141,0.001331,172.31.36.0-255,66,114405,7,359434
31142,0.001367,74.125.68.0-255,2184,116589,7,359434
31143,0.00137,172.31.36.0-255,66,116655,7,359434
31144,0.001637,74.125.68.0-255,1484,118139,7,359434
31145,0.001642,74.125.68.0-255,2902,121041,7,359434
31146,0.001645,172.31.36.0-255,66,121107,7,359434
31147,0.001674,74.125.68.0-255,4320,125427,7,359434
31148,0.001676,172.31.36.0-255,66,125493,7,359434
31149,0.001682,74.125.68.0-255,5738,131231,7,359434
31150,0.001684,172.31.36.0-255,66,131297,7,359434
31151,0.001711,74.125.68.0-255,4320,135617,7,359434
31152,0.001714,172.31.36.0-255,66,135683,7,359434
31153,0.001748,74.125.68.0-255,7156,142839,7,359434
31154,0.001753,74.125.68.0-255,5738,148577,7,359434
31155,0.001757,172.31.36.0-255,66,148643,7,359434
31156,0.001763,172.31.36.0-255,66,148709,7,359434
31157,0.001788,74.125.68.0-255,2184,150893,7,359434
31158,0.001791,172.31.36.0-255,66,150959,7,359434
31159,0.004004,74.125.68.0-255,2902,153861,7,359434
31160,0.004011,172.31.36.0-255,66,153927,7,359434
31161,0.004041,74.125.68.0-255,2902,156829,7,359434
31162,0.004044,172.31.36.0-255,66,156895,7,359434
31163,0.006255,74.125.68.0-255,2902,159797,7,359434
31164,0.006259,172.31.36.0-255,66,159863,7,359434
31165,0.006295,74.125.68.0-255,2902,162765,7,359434
31166,0.0063,172.31.36.0-255,66,162831,7,359434
31167,0.008503,74.125.68.0-255,2902,165733,7,359434
31168,0.00851,172.31.36.0-255,66,165799,7,359434
31169,0.008546,74.125.68.0-255,2902,168701,7,359434
31170,0.00855,172.31.36.0-255,66,168767,7,359434
31171,0.010764,74.125.68.0-255,2902,171669,7,359434
31172,0.010772,172.31.36.0-255,66,171735,7,359434
31173,0.010809,74.125.68.0-255,2902,174637,7,359434
31174,0.010814,172.31.36.0-255,66,174703,7,359434
31175,0.013032,74.125.68.0-255,2902,177605,7,359434
31176,0.013039,172.31.36.0-255,66,177671,7,359434
31177,0.01307,74.125.68.0-255,2902,180573,7,359434
31178,0.013074,172.31.36.0-255,66,180639,7,359434
31179,0.015333,74.125.68.0-255,2902,183541,7,359434
31180,0.015342,172.31.36.0-255,66,183607,7,359434
31181,0.015379,74.125.68.0-255,2902,186509,7,359434
31182,0.015383,172.31.36.0-255,66,186575,7,359434
31183,0.017624,74.125.68.0-255,2902,189477,7,359434
31184,0.017631,172.31.36.0-255,66,189543,7,359434
31185,0.017667,74.125.68.0-255,2902,192445,7,359434
31186,0.017671,172.31.36.0-255,66,192511,7,359434
31187,0.019924,74.125.68.0-255,2902,195413,7,359434
31188,0.019933,172.31.36.0-255,66,195479,7,359434
31189,0.019968,74.125.68.0-255,2902,198381,7,359434
31190,0.019972,172.31.36.0-255,66,198447,7,359434
31191,0.022182,74.125.68.0-255,2902,201349,7,359434
31192,0.022189,172.31.36.0-255,66,201415,7,359434
31193,0.022229,74.125.68.0-255,2902,204317,7,359434
31194,0.022233,172.31.36.0-255,66,204383,7,359434
31195,0.024441,74.125.68.0-255,2902,207285,7,359434
31196,0.024448,172.31.36.0-255,66,207351,7,359434
31197,0.024478,74.125.68.0-255,2902,210253,7,359434
31198,0.024481,172.31.36.0-255,66,210319,7,359434
31199,0.026696,74.125.68.0-255,2902,213221,7,359434
31200,0.026704,172.31.36.0-255,66,213287,7,359434
31201,0.026737,74.125.68.0-255,2902,216189,7,359434
31202,0.026741,172.31.36.0-255,66,216255,7,359434
31203,0.028956,74.125.68.0-255,2902,219157,7,359434
31204,0.028965,172.31.36.0-255,66,219223,7,359434
31205,0.029001,74.125.68.0-255,2902,222125,7,359434
31206,0.029006,172.31.36.0-255,66,222191,7,359434
31207,0.029734,172.31.36.0-255,172,222363,7,359434
31208,0.029765,172.31.36.0-255,1113,223476,7,359434
31209,0.029817,172.31.36.0-255,1514,224990,7,359434
31210,0.029819,172.31.36.0-255,1514,226504,7,359434
31211,0.029826,172.31.36.0-255,1514,228018,7,359434
31212,0.029827,172.31.36.0-255,1514,229532,7,359434
31213,0.029856,172.31.36.0-255,1514,231046,7,359434
31214,0.029857,172.31.36.0-255,72,231118,7,359434
31215,0.031324,74.125.68.0-255,5738,236856,7,359434
31216,0.031332,172.31.36.0-255,66,236922,7,359434
31217,0.031339,104.244.42.0-255,66,236988,7,359434
31218,0.031344,104.244.42.0-255,66,237054,7,359434
31219,0.031376,104.244.42.0-255,66,237120,7,359434
31220,0.031414,104.244.42.0-255,66,237186,7,359434
31221,0.0336,74.125.68.0-255,5738,242924,7,359434
31222,0.033614,172.31.36.0-255,66,242990,7,359434
31223,0.035872,74.125.68.0-255,5738,248728,7,359434
31224,0.035879,172.31.36.0-255,66,248794,7,359434
31225,0.038124,74.125.68.0-255,5738,254532,7,359434
31226,0.03813,172.31.36.0-255,66,254598,7,359434
31227,0.040381,74.125.68.0-255,5738,260336,7,359434
31228,0.040391,172.31.36.0-255,66,260402,7,359434
31229,0.042642,74.125.68.0-255,5738,266140,7,359434
31230,0.042647,172.31.36.0-255,66,266206,7,359434
31231,0.044889,74.125.68.0-255,4320,270526,7,359434
31232,0.044895,172.31.36.0-255,66,270592,7,359434
31233,0.044921,74.125.68.0-255,1484,272076,7,359434
31234,0.047142,74.125.68.0-255,4320,276396,7,359434
31235,0.047148,172.31.36.0-255,66,276462,7,359434
31236,0.049416,74.125.68.0-255,5738,282200,7,359434
31237,0.049426,172.31.36.0-255,66,282266,7,359434
31238,0.051681,74.125.68.0-255,5738,288004,7,359434
31239,0.051687,172.31.36.0-255,66,288070,7,359434
31240,0.053927,74.125.68.0-255,2902,290972,7,359434
31241,0.053933,172.31.36.0-255,66,291038,7,359434
31242,0.05397,74.125.68.0-255,2902,293940,7,359434
31243,0.053974,172.31.36.0-255,66,294006,7,359434
31244,0.056166,74.125.68.0-255,2902,296908,7,359434
31245,0.056172,172.31.36.0-255,66,296974,7,359434
31246,0.056204,74.125.68.0-255,1484,298458,7,359434
31247,0.056225,74.125.68.0-255,1484,299942,7,359434
31248,0.056228,172.31.36.0-255,66,300008,7,359434
31249,0.058417,74.125.68.0-255,2902,302910,7,359434
31250,0.058423,172.31.36.0-255,66,302976,7,359434
31251,0.058477,74.125.68.0-255,2902,305878,7,359434
31252,0.058482,172.31.36.0-255,66,305944,7,359434
31253,0.060679,74.125.68.0-255,2902,308846,7,359434
31254,0.060685,172.31.36.0-255,66,308912,7,359434
31255,0.060713,74.125.68.0-255,1484,310396,7,359434
31256,0.060729,74.125.68.0-255,1484,311880,7,359434
31257,0.060732,172.31.36.0-255,66,311946,7,359434
31258,0.062966,74.125.68.0-255,2902,314848,7,359434
31259,0.062972,172.31.36.0-255,66,314914,7,359434
31260,0.063052,74.125.68.0-255,2902,317816,7,359434
31261,0.063056,172.31.36.0-255,66,317882,7,359434
31262,0.065228,74.125.68.0-255,2902,320784,7,359434
31263,0.065235,172.31.36.0-255,66,320850,7,359434
31264,0.065299,74.125.68.0-255,2902,323752,7,359434
31265,0.065303,172.31.36.0-255,66,323818,7,359434
31266,0.067479,74.125.68.0-255,2902,326720,7,359434
31267,0.067484,172.31.36.0-255,66,326786,7,359434
31268,0.067536,74.125.68.0-255,2902,329688,7,359434
31269,0.06754,172.31.36.0-255,66,329754,7,359434
31270,0.069729,74.125.68.0-255,2902,332656,7,359434
31271,0.069736,172.31.36.0-255,66,332722,7,359434
31272,0.069775,74.125.68.0-255,2902,335624,7,359434
31273,0.069778,172.31.36.0-255,66,335690,7,359434
31274,0.071983,74.125.68.0-255,2902,338592,7,359434
31275,0.071989,172.31.36.0-255,66,338658,7,359434
31276,0.072035,74.125.68.0-255,1484,340142,7,359434
31277,0.072048,74.125.68.0-255,1484,341626,7,359434
31278,0.072051,172.31.36.0-255,66,341692,7,359434
31279,0.074262,74.125.68.0-255,2902,344594,7,359434
31280,0.074268,172.31.36.0-255,66,344660,7,359434
31281,0.07432,74.125.68.0-255,2902,347562,7,359434
31282,0.074323,172.31.36.0-255,66,347628,7,359434
31283,0.076521,74.125.68.0-255,2902,350530,7,359434
31284,0.076526,172.31.36.0-255,66,350596,7,359434
31285,0.076597,74.125.68.0-255,2902,353498,7,359434
31286,0.076601,172.31.36.0-255,66,353564,7,359434
31287,0.078774,74.125.68.0-255,1484,355048,7,359434
31288,0.078849,74.125.68.0-255,4320,359368,7,359434
31289,0.078855,172.31.36.0-255,66,359434,7,359434
31290,0.0,172.217.160.0-255,152,152,7,338433
31291,2.9e-05,172.31.36.0-255,66,218,7,338433
31292,3.5e-05,172.217.160.0-255,1484,1702,7,338433
31293,3.9e-05,172.31.36.0-255,66,1768,7,338433
31294,4.3e-05,172.217.160.0-255,2902,4670,7,338433
31295,4.6e-05,172.31.36.0-255,66,4736,7,338433
31296,7.8e-05,172.217.160.0-255,7156,11892,7,338433
31297,8e-05,172.31.36.0-255,66,11958,7,338433
31298,9.4e-05,172.31.36.0-255,66,12024,7,338433
31299,0.000121,172.217.160.0-255,4320,16344,7,338433
31300,0.000124,172.31.36.0-255,66,16410,7,338433
31301,0.000158,172.217.160.0-255,2543,18953,7,338433
31302,0.000161,172.31.36.0-255,66,19019,7,338433
31303,0.000223,172.217.160.0-255,1484,20503,7,338433
31304,0.000227,172.31.36.0-255,66,20569,7,338433
31305,0.000231,172.217.160.0-255,2902,23471,7,338433
31306,0.000233,172.31.36.0-255,66,23537,7,338433
31307,0.000263,172.217.160.0-255,5738,29275,7,338433
31308,0.000267,172.31.36.0-255,66,29341,7,338433
31309,0.000269,172.217.160.0-255,1484,30825,7,338433
31310,0.000272,172.31.36.0-255,66,30891,7,338433
31311,0.000276,172.217.160.0-255,1484,32375,7,338433
31312,0.000277,172.31.36.0-255,66,32441,7,338433
31313,0.000316,172.31.36.0-255,66,32507,7,338433
31314,0.000321,172.217.160.0-255,2902,35409,7,338433
31315,0.000324,172.31.36.0-255,66,35475,7,338433
31316,0.000349,172.31.36.0-255,66,35541,7,338433
31317,0.001196,172.217.160.0-255,645,36186,7,338433
31318,0.001202,172.31.36.0-255,66,36252,7,338433
31319,0.001221,172.217.160.0-255,1484,37736,7,338433
31320,0.001226,172.217.160.0-255,1484,39220,7,338433
31321,0.001228,172.31.36.0-255,66,39286,7,338433
31322,0.001247,172.217.160.0-255,2902,42188,7,338433
31323,0.00125,172.31.36.0-255,66,42254,7,338433
31324,0.001255,172.217.160.0-255,2902,45156,7,338433
31325,0.001256,172.31.36.0-255,66,45222,7,338433
31326,0.001282,172.217.160.0-255,4320,49542,7,338433
31327,0.001284,172.31.36.0-255,66,49608,7,338433
31328,0.001289,172.217.160.0-255,3961,53569,7,338433
31329,0.001291,172.31.36.0-255,66,53635,7,338433
31330,0.001308,172.217.160.0-255,4320,57955,7,338433
31331,0.001309,172.31.36.0-255,66,58021,7,338433
31332,0.001344,172.31.36.0-255,66,58087,7,338433
31333,0.001348,172.217.160.0-255,2543,60630,7,338433
31334,0.00135,172.31.36.0-255,66,60696,7,338433
31335,0.002958,172.217.160.0-255,2902,63598,7,338433
31336,0.002961,172.31.36.0-255,66,63664,7,338433
31337,0.002972,172.217.160.0-255,2902,66566,7,338433
31338,0.002974,172.31.36.0-255,66,66632,7,338433
31339,0.004589,172.217.160.0-255,2902,69534,7,338433
31340,0.004592,172.31.36.0-255,66,69600,7,338433
31341,0.004619,172.217.160.0-255,2902,72502,7,338433
31342,0.004621,172.31.36.0-255,66,72568,7,338433
31343,0.006207,172.217.160.0-255,2902,75470,7,338433
31344,0.006213,172.31.36.0-255,66,75536,7,338433
31345,0.006236,172.217.160.0-255,2902,78438,7,338433
31346,0.006239,172.31.36.0-255,66,78504,7,338433
31347,0.007841,172.217.160.0-255,2902,81406,7,338433
31348,0.007848,172.31.36.0-255,66,81472,7,338433
31349,0.007871,172.217.160.0-255,2902,84374,7,338433
31350,0.007875,172.31.36.0-255,66,84440,7,338433
31351,0.009472,172.217.160.0-255,2902,87342,7,338433
31352,0.00948,172.31.36.0-255,66,87408,7,338433
31353,0.009502,172.217.160.0-255,2902,90310,7,338433
31354,0.009504,172.31.36.0-255,66,90376,7,338433
31355,0.011111,172.217.160.0-255,5738,96114,7,338433
31356,0.011119,172.31.36.0-255,66,96180,7,338433
31357,0.012751,172.217.160.0-255,5738,101918,7,338433
31358,0.012759,172.31.36.0-255,66,101984,7,338433
31359,0.014397,172.217.160.0-255,5738,107722,7,338433
31360,0.014404,172.31.36.0-255,66,107788,7,338433
31361,0.01603,172.217.160.0-255,5738,113526,7,338433
31362,0.016036,172.31.36.0-255,66,113592,7,338433
31363,0.017698,172.217.160.0-255,5738,119330,7,338433
31364,0.017706,172.31.36.0-255,66,119396,7,338433
31365,0.019341,172.217.160.0-255,5738,125134,7,338433
31366,0.019348,172.31.36.0-255,66,125200,7,338433
31367,0.020973,172.217.160.0-255,5738,130938,7,338433
31368,0.020979,172.31.36.0-255,66,131004,7,338433
31369,0.021789,172.31.36.0-255,171,131175,7,338433
31370,0.021817,172.31.36.0-255,1139,132314,7,338433
31371,0.021876,172.31.36.0-255,1514,133828,7,338433
31372,0.021878,172.31.36.0-255,1267,135095,7,338433
31373,0.022608,172.217.160.0-255,5738,140833,7,338433
31374,0.022615,172.31.36.0-255,66,140899,7,338433
31375,0.023331,104.244.42.0-255,66,140965,7,338433
31376,0.023367,104.244.42.0-255,66,141031,7,338433
31377,0.023475,104.244.42.0-255,66,141097,7,338433
31378,0.024239,172.217.160.0-255,5738,146835,7,338433
31379,0.024246,172.31.36.0-255,66,146901,7,338433
31380,0.025891,172.217.160.0-255,5738,152639,7,338433
31381,0.025898,172.31.36.0-255,66,152705,7,338433
31382,0.027524,172.217.160.0-255,5738,158443,7,338433
31383,0.02753,172.31.36.0-255,66,158509,7,338433
31384,0.029175,172.217.160.0-255,5738,164247,7,338433
31385,0.029182,172.31.36.0-255,66,164313,7,338433
31386,0.030808,172.217.160.0-255,5738,170051,7,338433
31387,0.030815,172.31.36.0-255,66,170117,7,338433
31388,0.032449,172.217.160.0-255,5738,175855,7,338433
31389,0.032456,172.31.36.0-255,66,175921,7,338433
31390,0.034101,172.217.160.0-255,5738,181659,7,338433
31391,0.034108,172.31.36.0-255,66,181725,7,338433
31392,0.035777,172.217.160.0-255,5738,187463,7,338433
31393,0.035785,172.31.36.0-255,66,187529,7,338433
31394,0.037419,172.217.160.0-255,5738,193267,7,338433
31395,0.037425,172.31.36.0-255,66,193333,7,338433
31396,0.039061,172.217.160.0-255,5738,199071,7,338433
31397,0.039067,172.31.36.0-255,66,199137,7,338433
31398,0.040697,172.217.160.0-255,5738,204875,7,338433
31399,0.040706,172.31.36.0-255,66,204941,7,338433
31400,0.042328,172.217.160.0-255,5738,210679,7,338433
31401,0.042334,172.31.36.0-255,66,210745,7,338433
31402,0.043965,172.217.160.0-255,5738,216483,7,338433
31403,0.043973,172.31.36.0-255,66,216549,7,338433
31404,0.045602,172.217.160.0-255,5738,222287,7,338433
31405,0.045609,172.31.36.0-255,66,222353,7,338433
31406,0.047236,172.217.160.0-255,5738,228091,7,338433
31407,0.047242,172.31.36.0-255,66,228157,7,338433
31408,0.048882,172.217.160.0-255,5738,233895,7,338433
31409,0.048888,172.31.36.0-255,66,233961,7,338433
31410,0.050517,172.217.160.0-255,5738,239699,7,338433
31411,0.050524,172.31.36.0-255,66,239765,7,338433
31412,0.052169,172.217.160.0-255,5738,245503,7,338433
31413,0.052175,172.31.36.0-255,66,245569,7,338433
31414,0.053813,172.217.160.0-255,5738,251307,7,338433
31415,0.05382,172.31.36.0-255,66,251373,7,338433
31416,0.055712,172.217.160.0-255,5738,257111,7,338433
31417,0.055719,172.31.36.0-255,66,257177,7,338433
31418,0.057357,172.217.160.0-255,5738,262915,7,338433
31419,0.057364,172.31.36.0-255,66,262981,7,338433
31420,0.059025,172.217.160.0-255,5738,268719,7,338433
31421,0.059032,172.31.36.0-255,66,268785,7,338433
31422,0.060665,172.217.160.0-255,5738,274523,7,338433
31423,0.060673,172.31.36.0-255,66,274589,7,338433
31424,0.062301,172.217.160.0-255,5738,280327,7,338433
31425,0.062308,172.31.36.0-255,66,280393,7,338433
31426,0.063934,172.217.160.0-255,5738,286131,7,338433
31427,0.063941,172.31.36.0-255,66,286197,7,338433
31428,0.065565,172.217.160.0-255,5738,291935,7,338433
31429,0.065572,172.31.36.0-255,66,292001,7,338433
31430,0.067197,172.217.160.0-255,5738,297739,7,338433
31431,0.067203,172.31.36.0-255,66,297805,7,338433
31432,0.068828,172.217.160.0-255,5738,303543,7,338433
31433,0.068835,172.31.36.0-255,66,303609,7,338433
31434,0.070488,172.217.160.0-255,5738,309347,7,338433
31435,0.070494,172.31.36.0-255,66,309413,7,338433
31436,0.072116,172.217.160.0-255,5738,315151,7,338433
31437,0.072123,172.31.36.0-255,66,315217,7,338433
31438,0.073753,172.217.160.0-255,5738,320955,7,338433
31439,0.07376,172.31.36.0-255,66,321021,7,338433
31440,0.075393,172.217.160.0-255,5738,326759,7,338433
31441,0.075399,172.31.36.0-255,66,326825,7,338433
31442,0.077033,172.217.160.0-255,5738,332563,7,338433
31443,0.077039,172.31.36.0-255,66,332629,7,338433
31444,0.07866,172.217.160.0-255,5738,338367,7,338433
31445,0.078664,172.31.36.0-255,66,338433,7,338433
31446,0.0,74.125.24.0-255,143,143,7,301474
31447,3e-05,172.31.36.0-255,66,209,7,301474
31448,3.7e-05,74.125.24.0-255,1484,1693,7,301474
31449,4.2e-05,172.31.36.0-255,66,1759,7,301474
31450,4.7e-05,74.125.24.0-255,2902,4661,7,301474
31451,4.9e-05,172.31.36.0-255,66,4727,7,301474
31452,5.2e-05,74.125.24.0-255,1484,6211,7,301474
31453,5.5e-05,172.31.36.0-255,66,6277,7,301474
31454,6e-05,74.125.24.0-255,2902,9179,7,301474
31455,6.3e-05,172.31.36.0-255,66,9245,7,301474
31456,8.6e-05,74.125.24.0-255,1484,10729,7,301474
31457,8.8e-05,172.31.36.0-255,66,10795,7,301474
31458,0.000109,74.125.24.0-255,3520,14315,7,301474
31459,0.000112,172.31.36.0-255,66,14381,7,301474
31460,0.000547,74.125.24.0-255,1484,15865,7,301474
31461,0.000553,172.31.36.0-255,66,15931,7,301474
31462,0.000575,74.125.24.0-255,2902,18833,7,301474
31463,0.000579,172.31.36.0-255,66,18899,7,301474
31464,0.000585,74.125.24.0-255,5738,24637,7,301474
31465,0.000588,172.31.36.0-255,66,24703,7,301474
31466,0.000611,74.125.24.0-255,6797,31500,7,301474
31467,0.000614,172.31.36.0-255,66,31566,7,301474
31468,0.000727,74.125.24.0-255,1484,33050,7,301474
31469,0.000731,172.31.36.0-255,66,33116,7,301474
31470,0.000736,74.125.24.0-255,2902,36018,7,301474
31471,0.000738,172.31.36.0-255,66,36084,7,301474
31472,0.000759,74.125.24.0-255,5738,41822,7,301474
31473,0.000764,172.31.36.0-255,66,41888,7,301474
31474,0.000774,74.125.24.0-255,1484,43372,7,301474
31475,0.000777,172.31.36.0-255,66,43438,7,301474
31476,0.000811,172.31.36.0-255,66,43504,7,301474
31477,0.000828,74.125.24.0-255,2902,46406,7,301474
31478,0.000836,172.31.36.0-255,66,46472,7,301474
31479,0.000844,74.125.24.0-255,6797,53269,7,301474
31480,0.000856,172.31.36.0-255,66,53335,7,301474
31481,0.000881,74.125.24.0-255,448,53783,7,301474
31482,0.000893,74.125.24.0-255,330,54113,7,301474
31483,0.001073,172.31.36.0-255,66,54179,7,301474
31484,0.001201,74.125.24.0-255,1484,55663,7,301474
31485,0.001211,74.125.24.0-255,2902,58565,7,301474
31486,0.001217,74.125.24.0-255,5738,64303,7,301474
31487,0.001243,74.125.24.0-255,5738,70041,7,301474
31488,0.001258,172.31.36.0-255,66,70107,7,301474
31489,0.001267,74.125.24.0-255,7156,77263,7,301474
31490,0.001272,74.125.24.0-255,2902,80165,7,301474
31491,0.001284,172.31.36.0-255,66,80231,7,301474
31492,0.001309,172.31.36.0-255,66,80297,7,301474
31493,0.00327,74.125.24.0-255,5738,86035,7,301474
31494,0.003277,172.31.36.0-255,66,86101,7,301474
31495,0.005243,74.125.24.0-255,5738,91839,7,301474
31496,0.005247,172.31.36.0-255,66,91905,7,301474
31497,0.007251,74.125.24.0-255,5738,97643,7,301474
31498,0.007257,172.31.36.0-255,66,97709,7,301474
31499,0.009257,74.125.24.0-255,5738,103447,7,301474
31500,0.009264,172.31.36.0-255,66,103513,7,301474
31501,0.011265,74.125.24.0-255,5738,109251,7,301474
31502,0.013279,172.31.36.0-255,66,109317,7,301474
31503,0.015265,74.125.24.0-255,5738,115055,7,301474
31504,0.015274,172.31.36.0-255,66,115121,7,301474
31505,0.017234,74.125.24.0-255,5738,120859,7,301474
31506,0.017241,172.31.36.0-255,66,120925,7,301474
31507,0.019219,74.125.24.0-255,5738,126663,7,301474
31508,0.019225,172.31.36.0-255,66,126729,7,301474
31509,0.019919,172.31.36.0-255,172,126901,7,301474
31510,0.019946,172.31.36.0-255,1114,128015,7,301474
31511,0.019989,172.31.36.0-255,1514,129529,7,301474
31512,0.019991,172.31.36.0-255,331,129860,7,301474
31513,0.021222,74.125.24.0-255,5738,135598,7,301474
31514,0.021227,172.31.36.0-255,66,135664,7,301474
31515,0.02144,104.244.42.0-255,66,135730,7,301474
31516,0.021477,104.244.42.0-255,66,135796,7,301474
31517,0.021527,104.244.42.0-255,66,135862,7,301474
31518,0.023185,74.125.24.0-255,4320,140182,7,301474
31519,0.023191,172.31.36.0-255,66,140248,7,301474
31520,0.023223,74.125.24.0-255,1484,141732,7,301474
31521,0.025184,74.125.24.0-255,4320,146052,7,301474
31522,0.025188,172.31.36.0-255,66,146118,7,301474
31523,0.027165,74.125.24.0-255,5738,151856,7,301474
31524,0.027219,172.31.36.0-255,66,151922,7,301474
31525,0.029173,74.125.24.0-255,5738,157660,7,301474
31526,0.029179,172.31.36.0-255,66,157726,7,301474
31527,0.031148,74.125.24.0-255,5738,163464,7,301474
31528,0.031153,172.31.36.0-255,66,163530,7,301474
31529,0.033111,74.125.24.0-255,5738,169268,7,301474
31530,0.033116,172.31.36.0-255,66,169334,7,301474
31531,0.035066,74.125.24.0-255,5738,175072,7,301474
31532,0.035073,172.31.36.0-255,66,175138,7,301474
31533,0.037027,74.125.24.0-255,5738,180876,7,301474
31534,0.037032,172.31.36.0-255,66,180942,7,301474
31535,0.03903,74.125.24.0-255,5738,186680,7,301474
31536,0.039035,172.31.36.0-255,66,186746,7,301474
31537,0.041046,74.125.24.0-255,5738,192484,7,301474
31538,0.041052,172.31.36.0-255,66,192550,7,301474
31539,0.043024,74.125.24.0-255,5738,198288,7,301474
31540,0.043029,172.31.36.0-255,66,198354,7,301474
31541,0.044999,74.125.24.0-255,5738,204092,7,301474
31542,0.045004,172.31.36.0-255,66,204158,7,301474
31543,0.04697,74.125.24.0-255,4320,208478,7,301474
31544,0.046975,172.31.36.0-255,66,208544,7,301474
31545,0.047004,74.125.24.0-255,1484,210028,7,301474
31546,0.048932,74.125.24.0-255,4320,214348,7,301474
31547,0.048936,172.31.36.0-255,66,214414,7,301474
31548,0.050919,74.125.24.0-255,5738,220152,7,301474
31549,0.050962,172.31.36.0-255,66,220218,7,301474
31550,0.052942,74.125.24.0-255,5738,225956,7,301474
31551,0.052948,172.31.36.0-255,66,226022,7,301474
31552,0.054932,74.125.24.0-255,5738,231760,7,301474
31553,0.054938,172.31.36.0-255,66,231826,7,301474
31554,0.05694,74.125.24.0-255,5738,237564,7,301474
31555,0.056947,172.31.36.0-255,66,237630,7,301474
31556,0.058923,74.125.24.0-255,5738,243368,7,301474
31557,0.058928,172.31.36.0-255,66,243434,7,301474
31558,0.060888,74.125.24.0-255,5738,249172,7,301474
31559,0.060893,172.31.36.0-255,66,249238,7,301474
31560,0.062855,74.125.24.0-255,5738,254976,7,301474
31561,0.06286,172.31.36.0-255,66,255042,7,301474
31562,0.06484,74.125.24.0-255,5738,260780,7,301474
31563,0.064846,172.31.36.0-255,66,260846,7,301474
31564,0.066789,74.125.24.0-255,5738,266584,7,301474
31565,0.066797,172.31.36.0-255,66,266650,7,301474
31566,0.06876,74.125.24.0-255,5738,272388,7,301474
31567,0.068767,172.31.36.0-255,66,272454,7,301474
31568,0.070761,74.125.24.0-255,5738,278192,7,301474
31569,0.070769,172.31.36.0-255,66,278258,7,301474
31570,0.072737,74.125.24.0-255,5738,283996,7,301474
31571,0.072743,172.31.36.0-255,66,284062,7,301474
31572,0.074722,74.125.24.0-255,5738,289800,7,301474
31573,0.074728,172.31.36.0-255,66,289866,7,301474
31574,0.076738,74.125.24.0-255,5738,295604,7,301474
31575,0.076744,172.31.36.0-255,66,295670,7,301474
31576,0.078733,74.125.24.0-255,5738,301408,7,301474
31577,0.078741,172.31.36.0-255,66,301474,7,301474
31578,0.0,74.125.24.0-255,299,299,7,216497
31579,1.5e-05,172.31.36.0-255,66,365,7,216497
31580,2.1e-05,74.125.24.0-255,1484,1849,7,216497
31581,2.5e-05,172.31.36.0-255,66,1915,7,216497
31582,3.2e-05,74.125.24.0-255,4320,6235,7,216497
31583,4.6e-05,172.31.36.0-255,66,6301,7,216497
31584,5.7e-05,172.31.36.0-255,66,6367,7,216497
31585,6.8e-05,172.31.36.0-255,66,6433,7,216497
31586,9.6e-05,74.125.24.0-255,5379,11812,7,216497
31587,9.9e-05,172.31.36.0-255,66,11878,7,216497
31588,0.000162,74.125.24.0-255,1484,13362,7,216497
31589,0.000167,172.31.36.0-255,66,13428,7,216497
31590,0.000172,74.125.24.0-255,2902,16330,7,216497
31591,0.000174,172.31.36.0-255,66,16396,7,216497
31592,0.000179,74.125.24.0-255,4320,20716,7,216497
31593,0.000187,172.31.36.0-255,66,20782,7,216497
31594,0.000215,74.125.24.0-255,1484,22266,7,216497
31595,0.000218,172.31.36.0-255,66,22332,7,216497
31596,0.000223,74.125.24.0-255,4320,26652,7,216497
31597,0.000226,172.31.36.0-255,66,26718,7,216497
31598,0.000237,172.31.36.0-255,66,26784,7,216497
31599,0.000274,74.125.24.0-255,3961,30745,7,216497
31600,0.000277,172.31.36.0-255,66,30811,7,216497
31601,0.000285,74.125.24.0-255,7108,37919,7,216497
31602,0.000287,172.31.36.0-255,66,37985,7,216497
31603,0.000322,74.125.24.0-255,110,38095,7,216497
31604,0.000326,172.31.36.0-255,66,38161,7,216497
31605,0.000439,74.125.24.0-255,1484,39645,7,216497
31606,0.000444,172.31.36.0-255,66,39711,7,216497
31607,0.000449,74.125.24.0-255,2902,42613,7,216497
31608,0.000451,172.31.36.0-255,66,42679,7,216497
31609,0.000458,74.125.24.0-255,5738,48417,7,216497
31610,0.000462,172.31.36.0-255,66,48483,7,216497
31611,0.000494,74.125.24.0-255,4320,52803,7,216497
31612,0.000497,172.31.36.0-255,66,52869,7,216497
31613,0.00052,74.125.24.0-255,2811,55680,7,216497
31614,0.000524,172.31.36.0-255,66,55746,7,216497
31615,0.000527,74.125.24.0-255,7156,62902,7,216497
31616,0.00053,172.31.36.0-255,66,62968,7,216497
31617,0.000572,172.31.36.0-255,66,63034,7,216497
31618,0.000761,74.125.24.0-255,1484,64518,7,216497
31619,0.000768,74.125.24.0-255,2902,67420,7,216497
31620,0.000771,172.31.36.0-255,66,67486,7,216497
31621,0.000777,74.125.24.0-255,4320,71806,7,216497
31622,0.00078,172.31.36.0-255,66,71872,7,216497
31623,0.000808,74.125.24.0-255,1484,73356,7,216497
31624,0.00082,172.31.36.0-255,66,73422,7,216497
31625,0.00089,172.31.36.0-255,66,73488,7,216497
31626,0.000905,172.31.36.0-255,66,73554,7,216497
31627,0.000908,74.125.24.0-255,1484,75038,7,216497
31628,0.000948,172.31.36.0-255,66,75104,7,216497
31629,0.000966,74.125.24.0-255,4320,79424,7,216497
31630,0.000969,172.31.36.0-255,66,79490,7,216497
31631,0.000972,74.125.24.0-255,766,80256,7,216497
31632,0.000975,74.125.24.0-255,1484,81740,7,216497
31633,0.000977,172.31.36.0-255,66,81806,7,216497
31634,0.000983,74.125.24.0-255,4320,86126,7,216497
31635,0.000986,172.31.36.0-255,66,86192,7,216497
31636,0.001034,172.31.36.0-255,66,86258,7,216497
31637,0.001042,74.125.24.0-255,1484,87742,7,216497
31638,0.001048,172.31.36.0-255,66,87808,7,216497
31639,0.001075,172.31.36.0-255,66,87874,7,216497
31640,0.001099,74.125.24.0-255,4320,92194,7,216497
31641,0.001105,172.31.36.0-255,66,92260,7,216497
31642,0.00112,74.125.24.0-255,1484,93744,7,216497
31643,0.001128,74.125.24.0-255,7156,100900,7,216497
31644,0.001133,172.31.36.0-255,66,100966,7,216497
31645,0.001134,74.125.24.0-255,7156,108122,7,216497
31646,0.001146,172.31.36.0-255,66,108188,7,216497
31647,0.001164,74.125.24.0-255,7156,115344,7,216497
31648,0.001171,74.125.24.0-255,6438,121782,7,216497
31649,0.001171,172.31.36.0-255,66,121848,7,216497
31650,0.001178,172.31.36.0-255,66,121914,7,216497
31651,0.001281,74.125.24.0-255,1484,123398,7,216497
31652,0.001288,74.125.24.0-255,2902,126300,7,216497
31653,0.001299,172.31.36.0-255,66,126366,7,216497
31654,0.001317,74.125.24.0-255,5738,132104,7,216497
31655,0.001333,172.31.36.0-255,66,132170,7,216497
31656,0.001334,74.125.24.0-255,7156,139326,7,216497
31657,0.001337,172.31.36.0-255,66,139392,7,216497
31658,0.001359,74.125.24.0-255,5738,145130,7,216497
31659,0.001362,172.31.36.0-255,66,145196,7,216497
31660,0.001378,172.31.36.0-255,66,145262,7,216497
31661,0.00146,74.125.24.0-255,1484,146746,7,216497
31662,0.001464,74.125.24.0-255,1484,148230,7,216497
31663,0.001468,172.31.36.0-255,66,148296,7,216497
31664,0.001475,74.125.24.0-255,1484,149780,7,216497
31665,0.001478,74.125.24.0-255,1484,151264,7,216497
31666,0.001482,172.31.36.0-255,66,151330,7,216497
31667,0.001504,74.125.24.0-255,4320,155650,7,216497
31668,0.001508,172.31.36.0-255,66,155716,7,216497
31669,0.001534,172.31.36.0-255,66,155782,7,216497
31670,0.00156,74.125.24.0-255,4320,160102,7,216497
31671,0.001569,172.31.36.0-255,66,160168,7,216497
31672,0.001604,172.31.36.0-255,66,160234,7,216497
31673,0.001687,74.125.24.0-255,1484,161718,7,216497
31674,0.001691,74.125.24.0-255,1484,163202,7,216497
31675,0.001694,172.31.36.0-255,66,163268,7,216497
31676,0.001722,74.125.24.0-255,1484,164752,7,216497
31677,0.001725,74.125.24.0-255,1484,166236,7,216497
31678,0.001731,74.125.24.0-255,5738,171974,7,216497
31679,0.001731,172.31.36.0-255,66,172040,7,216497
31680,0.001736,172.31.36.0-255,66,172106,7,216497
31681,0.001743,74.125.24.0-255,1484,173590,7,216497
31682,0.001792,172.31.36.0-255,66,173656,7,216497
31683,0.001806,172.31.36.0-255,66,173722,7,216497
31684,0.001817,74.125.24.0-255,1484,175206,7,216497
31685,0.001827,74.125.24.0-255,2902,178108,7,216497
31686,0.001834,172.31.36.0-255,66,178174,7,216497
31687,0.001853,74.125.24.0-255,5738,183912,7,216497
31688,0.001857,74.125.24.0-255,2902,186814,7,216497
31689,0.001858,172.31.36.0-255,66,186880,7,216497
31690,0.001863,172.31.36.0-255,66,186946,7,216497
31691,0.001884,74.125.24.0-255,7156,194102,7,216497
31692,0.001892,172.31.36.0-255,66,194168,7,216497
31693,0.001914,74.125.24.0-255,7156,201324,7,216497
31694,0.001923,172.31.36.0-255,66,201390,7,216497
31695,0.001968,74.125.24.0-255,2902,204292,7,216497
31696,0.001968,172.31.36.0-255,66,204358,7,216497
31697,0.001972,172.31.36.0-255,66,204424,7,216497
31698,0.002033,74.125.24.0-255,2539,206963,7,216497
31699,0.002036,74.125.24.0-255,105,207068,7,216497
31700,0.002046,172.31.36.0-255,66,207134,7,216497
31701,0.004285,172.31.36.0-255,105,207239,7,216497
31702,0.006504,74.125.24.0-255,66,207305,7,216497
31703,0.031807,172.31.36.0-255,172,207477,7,216497
31704,0.031837,172.31.36.0-255,1113,208590,7,216497
31705,0.031884,172.31.36.0-255,1514,210104,7,216497
31706,0.031886,172.31.36.0-255,1514,211618,7,216497
31707,0.031887,172.31.36.0-255,1514,213132,7,216497
31708,0.031893,172.31.36.0-255,1514,214646,7,216497
31709,0.031894,172.31.36.0-255,1514,216160,7,216497
31710,0.031895,172.31.36.0-255,73,216233,7,216497
31711,0.033364,104.244.42.0-255,66,216299,7,216497
31712,0.033396,104.244.42.0-255,66,216365,7,216497
31713,0.033456,104.244.42.0-255,66,216431,7,216497
31714,0.033462,104.244.42.0-255,66,216497,7,216497
31715,0.0,74.125.24.0-255,153,153,7,316641
31716,3.3e-05,172.31.36.0-255,66,219,7,316641
31717,4.3e-05,74.125.24.0-255,1484,1703,7,316641
31718,4.7e-05,172.31.36.0-255,66,1769,7,316641
31719,6e-05,74.125.24.0-255,2902,4671,7,316641
31720,6.3e-05,172.31.36.0-255,66,4737,7,316641
31721,7.1e-05,74.125.24.0-255,7156,11893,7,316641
31722,7.3e-05,172.31.36.0-255,66,11959,7,316641
31723,7.7e-05,74.125.24.0-255,2041,14000,7,316641
31724,8.1e-05,172.31.36.0-255,66,14066,7,316641
31725,0.000159,74.125.24.0-255,1484,15550,7,316641
31726,0.000162,172.31.36.0-255,66,15616,7,316641
31727,0.000167,74.125.24.0-255,2902,18518,7,316641
31728,0.00017,172.31.36.0-255,66,18584,7,316641
31729,0.000206,74.125.24.0-255,5738,24322,7,316641
31730,0.000209,172.31.36.0-255,66,24388,7,316641
31731,0.000215,74.125.24.0-255,4320,28708,7,316641
31732,0.000217,172.31.36.0-255,66,28774,7,316641
31733,0.000245,74.125.24.0-255,2543,31317,7,316641
31734,0.000249,172.31.36.0-255,66,31383,7,316641
31735,0.000258,74.125.24.0-255,7156,38539,7,316641
31736,0.000261,172.31.36.0-255,66,38605,7,316641
31737,0.000268,74.125.24.0-255,7156,45761,7,316641
31738,0.00027,172.31.36.0-255,66,45827,7,316641
31739,0.000301,74.125.24.0-255,2543,48370,7,316641
31740,0.000303,172.31.36.0-255,66,48436,7,316641
31741,0.000413,74.125.24.0-255,1484,49920,7,316641
31742,0.000418,172.31.36.0-255,66,49986,7,316641
31743,0.000439,74.125.24.0-255,2902,52888,7,316641
31744,0.000442,172.31.36.0-255,66,52954,7,316641
31745,0.000449,74.125.24.0-255,5738,58692,7,316641
31746,0.000451,172.31.36.0-255,66,58758,7,316641
31747,0.00049,74.125.24.0-255,6797,65555,7,316641
31748,0.000494,172.31.36.0-255,66,65621,7,316641
31749,0.00068,74.125.24.0-255,1484,67105,7,316641
31750,0.000687,74.125.24.0-255,2902,70007,7,316641
31751,0.00069,172.31.36.0-255,66,70073,7,316641
31752,0.000694,74.125.24.0-255,1484,71557,7,316641
31753,0.000724,74.125.24.0-255,4320,75877,7,316641
31754,0.000727,172.31.36.0-255,66,75943,7,316641
31755,0.000735,74.125.24.0-255,7072,83015,7,316641
31756,0.000738,172.31.36.0-255,66,83081,7,316641
31757,0.000751,74.125.24.0-255,7156,90237,7,316641
31758,0.000757,172.31.36.0-255,66,90303,7,316641
31759,0.000785,172.31.36.0-255,66,90369,7,316641
31760,0.00081,74.125.24.0-255,1484,91853,7,316641
31761,0.000819,172.31.36.0-255,66,91919,7,316641
31762,0.000824,74.125.24.0-255,1935,93854,7,316641
31763,0.000827,172.31.36.0-255,66,93920,7,316641
31764,0.00103,74.125.24.0-255,1484,95404,7,316641
31765,0.001036,74.125.24.0-255,2902,98306,7,316641
31766,0.001039,172.31.36.0-255,66,98372,7,316641
31767,0.001045,74.125.24.0-255,4320,102692,7,316641
31768,0.001047,172.31.36.0-255,66,102758,7,316641
31769,0.001073,74.125.24.0-255,1484,104242,7,316641
31770,0.001079,74.125.24.0-255,4320,108562,7,316641
31771,0.001082,172.31.36.0-255,66,108628,7,316641
31772,0.001096,172.31.36.0-255,66,108694,7,316641
31773,0.001139,172.31.36.0-255,66,108760,7,316641
31774,0.002067,74.125.24.0-255,1484,110244,7,316641
31775,0.002078,74.125.24.0-255,2902,113146,7,316641
31776,0.002082,172.31.36.0-255,66,113212,7,316641
31777,0.002087,74.125.24.0-255,1484,114696,7,316641
31778,0.002119,74.125.24.0-255,4320,119016,7,316641
31779,0.002122,172.31.36.0-255,66,119082,7,316641
31780,0.002158,172.31.36.0-255,66,119148,7,316641
31781,0.002172,172.31.36.0-255,66,119214,7,316641
31782,0.004499,74.125.24.0-255,5738,124952,7,316641
31783,0.004509,172.31.36.0-255,66,125018,7,316641
31784,0.006864,74.125.24.0-255,5738,130756,7,316641
31785,0.00687,172.31.36.0-255,66,130822,7,316641
31786,0.009224,74.125.24.0-255,5738,136560,7,316641
31787,0.009233,172.31.36.0-255,66,136626,7,316641
31788,0.009444,172.31.36.0-255,101,136727,7,316641
31789,0.011566,74.125.24.0-255,5738,142465,7,316641
31790,0.011576,172.31.36.0-255,66,142531,7,316641
31791,0.011768,74.125.24.0-255,66,142597,7,316641
31792,0.013912,74.125.24.0-255,5738,148335,7,316641
31793,0.013924,172.31.36.0-255,66,148401,7,316641
31794,0.016278,74.125.24.0-255,5738,154139,7,316641
31795,0.016287,172.31.36.0-255,66,154205,7,316641
31796,0.018599,74.125.24.0-255,5738,159943,7,316641
31797,0.018606,172.31.36.0-255,66,160009,7,316641
31798,0.020946,74.125.24.0-255,5738,165747,7,316641
31799,0.020956,172.31.36.0-255,66,165813,7,316641
31800,0.023288,74.125.24.0-255,5738,171551,7,316641
31801,0.023294,172.31.36.0-255,66,171617,7,316641
31802,0.025621,74.125.24.0-255,5738,177355,7,316641
31803,0.025629,172.31.36.0-255,66,177421,7,316641
31804,0.027945,74.125.24.0-255,5738,183159,7,316641
31805,0.027952,172.31.36.0-255,66,183225,7,316641
31806,0.030281,74.125.24.0-255,5738,188963,7,316641
31807,0.030287,172.31.36.0-255,66,189029,7,316641
31808,0.032494,172.31.36.0-255,172,189201,7,316641
31809,0.032525,172.31.36.0-255,1113,190314,7,316641
31810,0.032574,172.31.36.0-255,1514,191828,7,316641
31811,0.032576,172.31.36.0-255,1514,193342,7,316641
31812,0.032581,172.31.36.0-255,1514,194856,7,316641
31813,0.032582,172.31.36.0-255,1514,196370,7,316641
31814,0.032601,172.31.36.0-255,1514,197884,7,316641
31815,0.032607,172.31.36.0-255,71,197955,7,316641
31816,0.032632,74.125.24.0-255,4320,202275,7,316641
31817,0.032637,172.31.36.0-255,66,202341,7,316641
31818,0.032674,74.125.24.0-255,1484,203825,7,316641
31819,0.034038,104.244.42.0-255,66,203891,7,316641
31820,0.034086,104.244.42.0-255,66,203957,7,316641
31821,0.034131,104.244.42.0-255,66,204023,7,316641
31822,0.034194,104.244.42.0-255,66,204089,7,316641
31823,0.034954,74.125.24.0-255,4320,208409,7,316641
31824,0.03496,172.31.36.0-255,66,208475,7,316641
31825,0.037279,74.125.24.0-255,5738,214213,7,316641
31826,0.037289,172.31.36.0-255,66,214279,7,316641
31827,0.039615,74.125.24.0-255,5738,220017,7,316641
31828,0.039623,172.31.36.0-255,66,220083,7,316641
31829,0.041956,74.125.24.0-255,5738,225821,7,316641
31830,0.041963,172.31.36.0-255,66,225887,7,316641
31831,0.044288,74.125.24.0-255,5738,231625,7,316641
31832,0.044296,172.31.36.0-255,66,231691,7,316641
31833,0.046672,74.125.24.0-255,5738,237429,7,316641
31834,0.046685,172.31.36.0-255,66,237495,7,316641
31835,0.048998,74.125.24.0-255,5738,243233,7,316641
31836,0.049004,172.31.36.0-255,66,243299,7,316641
31837,0.051334,74.125.24.0-255,5738,249037,7,316641
31838,0.051339,172.31.36.0-255,66,249103,7,316641
31839,0.053673,74.125.24.0-255,4320,253423,7,316641
31840,0.053678,172.31.36.0-255,66,253489,7,316641
31841,0.053714,74.125.24.0-255,1484,254973,7,316641
31842,0.055995,74.125.24.0-255,4320,259293,7,316641
31843,0.056,172.31.36.0-255,66,259359,7,316641
31844,0.058339,74.125.24.0-255,4320,263679,7,316641
31845,0.058344,172.31.36.0-255,66,263745,7,316641
31846,0.058376,74.125.24.0-255,1484,265229,7,316641
31847,0.060681,74.125.24.0-255,4320,269549,7,316641
31848,0.060686,172.31.36.0-255,66,269615,7,316641
31849,0.062998,74.125.24.0-255,2902,272517,7,316641
31850,0.063004,172.31.36.0-255,66,272583,7,316641
31851,0.063039,74.125.24.0-255,2902,275485,7,316641
31852,0.063042,172.31.36.0-255,66,275551,7,316641
31853,0.065335,74.125.24.0-255,2902,278453,7,316641
31854,0.06534,172.31.36.0-255,66,278519,7,316641
31855,0.065372,74.125.24.0-255,2902,281421,7,316641
31856,0.065375,172.31.36.0-255,66,281487,7,316641
31857,0.067663,74.125.24.0-255,2902,284389,7,316641
31858,0.067668,172.31.36.0-255,66,284455,7,316641
31859,0.0677,74.125.24.0-255,2902,287357,7,316641
31860,0.067704,172.31.36.0-255,66,287423,7,316641
31861,0.069974,74.125.24.0-255,2902,290325,7,316641
31862,0.069981,172.31.36.0-255,66,290391,7,316641
31863,0.07002,74.125.24.0-255,2902,293293,7,316641
31864,0.070024,172.31.36.0-255,66,293359,7,316641
31865,0.072324,74.125.24.0-255,5738,299097,7,316641
31866,0.07233,172.31.36.0-255,66,299163,7,316641
31867,0.07466,74.125.24.0-255,5738,304901,7,316641
31868,0.074665,172.31.36.0-255,66,304967,7,316641
31869,0.077024,74.125.24.0-255,5738,310705,7,316641
31870,0.077029,172.31.36.0-255,66,310771,7,316641
31871,0.079367,74.125.24.0-255,4320,315091,7,316641
31872,0.079373,172.31.36.0-255,66,315157,7,316641
31873,0.079408,74.125.24.0-255,1484,316641,7,316641
31874,0.0,74.125.24.0-255,146,146,7,358693
31875,1.6e-05,172.31.36.0-255,66,212,7,358693
31876,2.4e-05,74.125.24.0-255,1484,1696,7,358693
31877,2.8e-05,172.31.36.0-255,66,1762,7,358693
31878,3.4e-05,74.125.24.0-255,2902,4664,7,358693
31879,4.6e-05,172.31.36.0-255,66,4730,7,358693
31880,5.4e-05,74.125.24.0-255,7156,11886,7,358693
31881,5.7e-05,172.31.36.0-255,66,11952,7,358693
31882,6.1e-05,74.125.24.0-255,2041,13993,7,358693
31883,6.4e-05,172.31.36.0-255,66,14059,7,358693
31884,0.000108,74.125.24.0-255,2902,16961,7,358693
31885,0.000111,172.31.36.0-255,66,17027,7,358693
31886,0.000115,74.125.24.0-255,1484,18511,7,358693
31887,0.000117,172.31.36.0-255,66,18577,7,358693
31888,0.000146,74.125.24.0-255,5738,24315,7,358693
31889,0.000149,172.31.36.0-255,66,24381,7,358693
31890,0.000167,74.125.24.0-255,2902,27283,7,358693
31891,0.00017,172.31.36.0-255,66,27349,7,358693
31892,0.000203,74.125.24.0-255,3961,31310,7,358693
31893,0.000206,172.31.36.0-255,66,31376,7,358693
31894,0.000214,74.125.24.0-255,7156,38532,7,358693
31895,0.000222,172.31.36.0-255,66,38598,7,358693
31896,0.00023,74.125.24.0-255,7156,45754,7,358693
31897,0.000232,172.31.36.0-255,66,45820,7,358693
31898,0.000261,74.125.24.0-255,2543,48363,7,358693
31899,0.000268,172.31.36.0-255,66,48429,7,358693
31900,0.000292,74.125.24.0-255,1484,49913,7,358693
31901,0.000294,172.31.36.0-255,66,49979,7,358693
31902,0.000299,74.125.24.0-255,2902,52881,7,358693
31903,0.000301,172.31.36.0-255,66,52947,7,358693
31904,0.000335,74.125.24.0-255,5738,58685,7,358693
31905,0.000337,172.31.36.0-255,66,58751,7,358693
31906,0.000341,74.125.24.0-255,1484,60235,7,358693
31907,0.000371,74.125.24.0-255,5962,66197,7,358693
31908,0.000374,172.31.36.0-255,66,66263,7,358693
31909,0.000533,74.125.24.0-255,1484,67747,7,358693
31910,0.000538,74.125.24.0-255,1484,69231,7,358693
31911,0.000542,172.31.36.0-255,66,69297,7,358693
31912,0.000561,74.125.24.0-255,1484,70781,7,358693
31913,0.000569,74.125.24.0-255,5738,76519,7,358693
31914,0.000571,172.31.36.0-255,66,76585,7,358693
31915,0.000601,74.125.24.0-255,5738,82323,7,358693
31916,0.000604,172.31.36.0-255,66,82389,7,358693
31917,0.000637,172.31.36.0-255,66,82455,7,358693
31918,0.000671,172.31.36.0-255,66,82521,7,358693
31919,0.00126,74.125.24.0-255,1484,84005,7,358693
31920,0.001267,74.125.24.0-255,2902,86907,7,358693
31921,0.00127,172.31.36.0-255,66,86973,7,358693
31922,0.001276,74.125.24.0-255,5738,92711,7,358693
31923,0.001278,172.31.36.0-255,66,92777,7,358693
31924,0.001319,172.31.36.0-255,66,92843,7,358693
31925,0.001329,172.31.36.0-255,66,92909,7,358693
31926,0.001354,74.125.24.0-255,2184,95093,7,358693
31927,0.001356,172.31.36.0-255,66,95159,7,358693
31928,0.001422,74.125.24.0-255,1484,96643,7,358693
31929,0.001445,74.125.24.0-255,2902,99545,7,358693
31930,0.001448,172.31.36.0-255,66,99611,7,358693
31931,0.001454,74.125.24.0-255,5738,105349,7,358693
31932,0.001456,172.31.36.0-255,66,105415,7,358693
31933,0.001464,74.125.24.0-255,2902,108317,7,358693
31934,0.001466,172.31.36.0-255,66,108383,7,358693
31935,0.001469,74.125.24.0-255,1484,109867,7,358693
31936,0.001505,172.31.36.0-255,66,109933,7,358693
31937,0.001512,74.125.24.0-255,7156,117089,7,358693
31938,0.001514,172.31.36.0-255,66,117155,7,358693
31939,0.001538,74.125.24.0-255,3602,120757,7,358693
31940,0.00154,172.31.36.0-255,66,120823,7,358693
31941,0.001749,74.125.24.0-255,1484,122307,7,358693
31942,0.001766,74.125.24.0-255,2902,125209,7,358693
31943,0.001769,172.31.36.0-255,66,125275,7,358693
31944,0.001776,74.125.24.0-255,5738,131013,7,358693
31945,0.001779,172.31.36.0-255,66,131079,7,358693
31946,0.001809,172.31.36.0-255,66,131145,7,358693
31947,0.001835,74.125.24.0-255,4320,135465,7,358693
31948,0.001838,172.31.36.0-255,66,135531,7,358693
31949,0.001846,74.125.24.0-255,7156,142687,7,358693
31950,0.001848,172.31.36.0-255,66,142753,7,358693
31951,0.001878,74.125.24.0-255,3602,146355,7,358693
31952,0.001882,172.31.36.0-255,66,146421,7,358693
31953,0.002415,74.125.24.0-255,1484,147905,7,358693
31954,0.00242,74.125.24.0-255,1484,149389,7,358693
31955,0.002423,172.31.36.0-255,66,149455,7,358693
31956,0.002456,74.125.24.0-255,1484,150939,7,358693
31957,0.002463,74.125.24.0-255,5738,156677,7,358693
31958,0.002466,172.31.36.0-255,66,156743,7,358693
31959,0.002474,74.125.24.0-255,7156,163899,7,358693
31960,0.002477,172.31.36.0-255,66,163965,7,358693
31961,0.002509,74.125.24.0-255,5738,169703,7,358693
31962,0.002512,172.31.36.0-255,66,169769,7,358693
31963,0.002519,74.125.24.0-255,7156,176925,7,358693
31964,0.002521,172.31.36.0-255,66,176991,7,358693
31965,0.002531,74.125.24.0-255,3602,180593,7,358693
31966,0.002533,172.31.36.0-255,66,180659,7,358693
31967,0.005125,74.125.24.0-255,5738,186397,7,358693
31968,0.005132,172.31.36.0-255,66,186463,7,358693
31969,0.007746,74.125.24.0-255,5738,192201,7,358693
31970,0.00775,172.31.36.0-255,66,192267,7,358693
31971,0.010366,74.125.24.0-255,5738,198005,7,358693
31972,0.010373,172.31.36.0-255,66,198071,7,358693
31973,0.01298,74.125.24.0-255,5738,203809,7,358693
31974,0.012989,172.31.36.0-255,66,203875,7,358693
31975,0.015598,74.125.24.0-255,5738,209613,7,358693
31976,0.015606,172.31.36.0-255,66,209679,7,358693
31977,0.018215,74.125.24.0-255,5738,215417,7,358693
31978,0.018225,172.31.36.0-255,66,215483,7,358693
31979,0.020829,74.125.24.0-255,2902,218385,7,358693
31980,0.020836,172.31.36.0-255,66,218451,7,358693
31981,0.020868,74.125.24.0-255,2902,221353,7,358693
31982,0.020871,172.31.36.0-255,66,221419,7,358693
31983,0.023439,74.125.24.0-255,2902,224321,7,358693
31984,0.023447,172.31.36.0-255,66,224387,7,358693
31985,0.02348,74.125.24.0-255,2902,227289,7,358693
31986,0.023483,172.31.36.0-255,66,227355,7,358693
31987,0.026077,74.125.24.0-255,2902,230257,7,358693
31988,0.026084,172.31.36.0-255,66,230323,7,358693
31989,0.026116,74.125.24.0-255,2902,233225,7,358693
31990,0.026119,172.31.36.0-255,66,233291,7,358693
31991,0.028713,74.125.24.0-255,2902,236193,7,358693
31992,0.028721,172.31.36.0-255,66,236259,7,358693
31993,0.028757,74.125.24.0-255,2902,239161,7,358693
31994,0.028759,172.31.36.0-255,66,239227,7,358693
31995,0.031356,74.125.24.0-255,5738,244965,7,358693
31996,0.031364,172.31.36.0-255,66,245031,7,358693
31997,0.033978,74.125.24.0-255,5738,250769,7,358693
31998,0.033985,172.31.36.0-255,66,250835,7,358693
31999,0.036595,74.125.24.0-255,5738,256573,7,358693
32000,0.036602,172.31.36.0-255,66,256639,7,358693
32001,0.037619,172.31.36.0-255,172,256811,7,358693
32002,0.037651,172.31.36.0-255,1113,257924,7,358693
32003,0.037716,172.31.36.0-255,1514,259438,7,358693
32004,0.037718,172.31.36.0-255,1514,260952,7,358693
32005,0.03772,172.31.36.0-255,1514,262466,7,358693
32006,0.037725,172.31.36.0-255,1514,263980,7,358693
32007,0.037726,172.31.36.0-255,1514,265494,7,358693
32008,0.037727,172.31.36.0-255,71,265565,7,358693
32009,0.039146,104.244.42.0-255,66,265631,7,358693
32010,0.039176,74.125.24.0-255,5738,271369,7,358693
32011,0.039182,172.31.36.0-255,66,271435,7,358693
32012,0.0392,104.244.42.0-255,66,271501,7,358693
32013,0.039289,104.244.42.0-255,66,271567,7,358693
32014,0.039294,104.244.42.0-255,66,271633,7,358693
32015,0.041775,74.125.24.0-255,5738,277371,7,358693
32016,0.041784,172.31.36.0-255,66,277437,7,358693
32017,0.044399,74.125.24.0-255,5738,283175,7,358693
32018,0.044406,172.31.36.0-255,66,283241,7,358693
32019,0.047038,74.125.24.0-255,5738,288979,7,358693
32020,0.047045,172.31.36.0-255,66,289045,7,358693
32021,0.04963,74.125.24.0-255,5738,294783,7,358693
32022,0.049636,172.31.36.0-255,66,294849,7,358693
32023,0.052246,74.125.24.0-255,5738,300587,7,358693
32024,0.052253,172.31.36.0-255,66,300653,7,358693
32025,0.054847,74.125.24.0-255,5738,306391,7,358693
32026,0.054854,172.31.36.0-255,66,306457,7,358693
32027,0.057463,74.125.24.0-255,5738,312195,7,358693
32028,0.05747,172.31.36.0-255,66,312261,7,358693
32029,0.060097,74.125.24.0-255,5738,317999,7,358693
32030,0.060103,172.31.36.0-255,66,318065,7,358693
32031,0.062704,74.125.24.0-255,5738,323803,7,358693
32032,0.062712,172.31.36.0-255,66,323869,7,358693
32033,0.065341,74.125.24.0-255,5738,329607,7,358693
32034,0.065348,172.31.36.0-255,66,329673,7,358693
32035,0.067947,74.125.24.0-255,5738,335411,7,358693
32036,0.067953,172.31.36.0-255,66,335477,7,358693
32037,0.070608,74.125.24.0-255,5738,341215,7,358693
32038,0.070615,172.31.36.0-255,66,341281,7,358693
32039,0.073212,74.125.24.0-255,5738,347019,7,358693
32040,0.073219,172.31.36.0-255,66,347085,7,358693
32041,0.075848,74.125.24.0-255,5738,352823,7,358693
32042,0.075855,172.31.36.0-255,66,352889,7,358693
32043,0.078472,74.125.24.0-255,5738,358627,7,358693
32044,0.078479,172.31.36.0-255,66,358693,7,358693
32045,0.0,74.125.24.0-255,149,149,7,205551
32046,3.4e-05,172.31.36.0-255,66,215,7,205551
32047,4.1e-05,74.125.24.0-255,1484,1699,7,205551
32048,4.5e-05,172.31.36.0-255,66,1765,7,205551
32049,5e-05,74.125.24.0-255,2902,4667,7,205551
32050,5.2e-05,172.31.36.0-255,66,4733,7,205551
32051,6.7e-05,74.125.24.0-255,7156,11889,7,205551
32052,7e-05,172.31.36.0-255,66,11955,7,205551
32053,7.4e-05,74.125.24.0-255,2053,14008,7,205551
32054,7.6e-05,172.31.36.0-255,66,14074,7,205551
32055,0.000176,74.125.24.0-255,1484,15558,7,205551
32056,0.00018,172.31.36.0-255,66,15624,7,205551
32057,0.000185,74.125.24.0-255,2902,18526,7,205551
32058,0.000188,172.31.36.0-255,66,18592,7,205551
32059,0.000201,74.125.24.0-255,5738,24330,7,205551
32060,0.000203,172.31.36.0-255,66,24396,7,205551
32061,0.000232,74.125.24.0-255,6797,31193,7,205551
32062,0.00024,172.31.36.0-255,66,31259,7,205551
32063,0.000343,74.125.24.0-255,1484,32743,7,205551
32064,0.000348,172.31.36.0-255,66,32809,7,205551
32065,0.000384,74.125.24.0-255,2902,35711,7,205551
32066,0.000387,172.31.36.0-255,66,35777,7,205551
32067,0.000393,74.125.24.0-255,5738,41515,7,205551
32068,0.000396,172.31.36.0-255,66,41581,7,205551
32069,0.000407,74.125.24.0-255,4320,45901,7,205551
32070,0.00041,172.31.36.0-255,66,45967,7,205551
32071,0.000417,74.125.24.0-255,7156,53123,7,205551
32072,0.000419,172.31.36.0-255,66,53189,7,205551
32073,0.000461,172.31.36.0-255,66,53255,7,205551
32074,0.000466,74.125.24.0-255,2822,56077,7,205551
32075,0.000468,172.31.36.0-255,66,56143,7,205551
32076,0.000522,74.125.24.0-255,125,56268,7,205551
32077,0.000774,74.125.24.0-255,1484,57752,7,205551
32078,0.00078,172.31.36.0-255,66,57818,7,205551
32079,0.000811,74.125.24.0-255,2902,60720,7,205551
32080,0.000818,74.125.24.0-255,5738,66458,7,205551
32081,0.000834,74.125.24.0-255,2902,69360,7,205551
32082,0.000844,172.31.36.0-255,66,69426,7,205551
32083,0.000863,74.125.24.0-255,349,69775,7,205551
32084,0.000864,172.31.36.0-255,66,69841,7,205551
32085,0.001127,172.31.36.0-255,66,69907,7,205551
32086,0.001178,74.125.24.0-255,1484,71391,7,205551
32087,0.001184,74.125.24.0-255,2902,74293,7,205551
32088,0.00119,172.31.36.0-255,66,74359,7,205551
32089,0.001203,74.125.24.0-255,5738,80097,7,205551
32090,0.001212,172.31.36.0-255,66,80163,7,205551
32091,0.001259,172.31.36.0-255,66,80229,7,205551
32092,0.001275,172.31.36.0-255,66,80295,7,205551
32093,0.001312,74.125.24.0-255,1484,81779,7,205551
32094,0.001317,74.125.24.0-255,2902,84681,7,205551
32095,0.001321,172.31.36.0-255,66,84747,7,205551
32096,0.001328,74.125.24.0-255,1484,86231,7,205551
32097,0.001357,74.125.24.0-255,4320,90551,7,205551
32098,0.001363,74.125.24.0-255,4320,94871,7,205551
32099,0.001365,74.125.24.0-255,1484,96355,7,205551
32100,0.001367,172.31.36.0-255,66,96421,7,205551
32101,0.001408,172.31.36.0-255,66,96487,7,205551
32102,0.001426,172.31.36.0-255,66,96553,7,205551
32103,0.001477,74.125.24.0-255,1484,98037,7,205551
32104,0.001482,74.125.24.0-255,2902,100939,7,205551
32105,0.00149,172.31.36.0-255,66,101005,7,205551
32106,0.001495,74.125.24.0-255,4320,105325,7,205551
32107,0.001508,172.31.36.0-255,66,105391,7,205551
32108,0.001516,74.125.24.0-255,1484,106875,7,205551
32109,0.001537,172.31.36.0-255,66,106941,7,205551
32110,0.001545,74.125.24.0-255,1484,108425,7,205551
32111,0.001582,172.31.36.0-255,66,108491,7,205551
32112,0.001609,74.125.24.0-255,1484,109975,7,205551
32113,0.001615,74.125.24.0-255,2902,112877,7,205551
32114,0.001618,172.31.36.0-255,66,112943,7,205551
32115,0.001624,74.125.24.0-255,5738,118681,7,205551
32116,0.001635,172.31.36.0-255,66,118747,7,205551
32117,0.001646,74.125.24.0-255,4320,123067,7,205551
32118,0.00165,172.31.36.0-255,66,123133,7,205551
32119,0.0017,74.125.24.0-255,7156,130289,7,205551
32120,0.0017,172.31.36.0-255,66,130355,7,205551
32121,0.001706,172.31.36.0-255,66,130421,7,205551
32122,0.001723,172.31.36.0-255,66,130487,7,205551
32123,0.00175,172.31.36.0-255,66,130553,7,205551
32124,0.001765,172.31.36.0-255,66,130619,7,205551
32125,0.001855,172.31.36.0-255,66,130685,7,205551
32126,0.00186,172.31.36.0-255,66,130751,7,205551
32127,0.001865,74.125.24.0-255,1484,132235,7,205551
32128,0.001901,172.31.36.0-255,66,132301,7,205551
32129,0.001913,74.125.24.0-255,4320,136621,7,205551
32130,0.001918,172.31.36.0-255,66,136687,7,205551
32131,0.001954,172.31.36.0-255,66,136753,7,205551
32132,0.001986,74.125.24.0-255,1484,138237,7,205551
32133,0.00199,74.125.24.0-255,2902,141139,7,205551
32134,0.001993,74.125.24.0-255,1484,142623,7,205551
32135,0.002009,172.31.36.0-255,66,142689,7,205551
32136,0.002009,74.125.24.0-255,4320,147009,7,205551
32137,0.002013,74.125.24.0-255,2902,149911,7,205551
32138,0.002015,172.31.36.0-255,66,149977,7,205551
32139,0.00203,172.31.36.0-255,66,150043,7,205551
32140,0.002038,74.125.24.0-255,1484,151527,7,205551
32141,0.002056,74.125.24.0-255,1484,153011,7,205551
32142,0.002058,172.31.36.0-255,66,153077,7,205551
32143,0.004055,74.125.24.0-255,4320,157397,7,205551
32144,0.004062,172.31.36.0-255,66,157463,7,205551
32145,0.006062,74.125.24.0-255,5738,163201,7,205551
32146,0.009747,172.31.36.0-255,66,163267,7,205551
32147,0.01177,74.125.24.0-255,5738,169005,7,205551
32148,0.011777,172.31.36.0-255,66,169071,7,205551
32149,0.013769,74.125.24.0-255,5738,174809,7,205551
32150,0.01389,172.31.36.0-255,66,174875,7,205551
32151,0.015882,74.125.24.0-255,5738,180613,7,205551
32152,0.015892,172.31.36.0-255,66,180679,7,205551
32153,0.017891,74.125.24.0-255,5738,186417,7,205551
32154,0.017899,172.31.36.0-255,66,186483,7,205551
32155,0.019884,74.125.24.0-255,5738,192221,7,205551
32156,0.01989,172.31.36.0-255,66,192287,7,205551
32157,0.021898,74.125.24.0-255,5738,198025,7,205551
32158,0.021906,172.31.36.0-255,66,198091,7,205551
32159,0.023898,74.125.24.0-255,2931,201022,7,205551
32160,0.023905,172.31.36.0-255,66,201088,7,205551
32161,0.024091,172.31.36.0-255,105,201193,7,205551
32162,0.026066,74.125.24.0-255,66,201259,7,205551
32163,0.030781,172.31.36.0-255,172,201431,7,205551
32164,0.030821,172.31.36.0-255,1115,202546,7,205551
32165,0.031073,172.31.36.0-255,1514,204060,7,205551
32166,0.031075,172.31.36.0-255,1293,205353,7,205551
32167,0.032288,104.244.42.0-255,66,205419,7,205551
32168,0.032354,104.244.42.0-255,66,205485,7,205551
32169,0.032599,104.244.42.0-255,66,205551,7,205551
32170,0.0,74.125.68.0-255,152,152,7,319267
32171,2e-05,172.31.36.0-255,66,218,7,319267
32172,2.6e-05,74.125.68.0-255,1484,1702,7,319267
32173,3e-05,172.31.36.0-255,66,1768,7,319267
32174,4.8e-05,74.125.68.0-255,2902,4670,7,319267
32175,5.1e-05,172.31.36.0-255,66,4736,7,319267
32176,5.6e-05,74.125.68.0-255,2902,7638,7,319267
32177,5.8e-05,172.31.36.0-255,66,7704,7,319267
32178,7.7e-05,74.125.68.0-255,2902,10606,7,319267
32179,7.9e-05,172.31.36.0-255,66,10672,7,319267
32180,8.5e-05,74.125.68.0-255,3523,14195,7,319267
32181,8.8e-05,172.31.36.0-255,66,14261,7,319267
32182,9.1e-05,74.125.68.0-255,1484,15745,7,319267
32183,9.3e-05,172.31.36.0-255,66,15811,7,319267
32184,0.00012,74.125.68.0-255,2902,18713,7,319267
32185,0.000123,172.31.36.0-255,66,18779,7,319267
32186,0.000135,172.31.36.0-255,66,18845,7,319267
32187,0.00014,74.125.68.0-255,2543,21388,7,319267
32188,0.000142,172.31.36.0-255,66,21454,7,319267
32189,0.000204,74.125.68.0-255,1484,22938,7,319267
32190,0.000208,172.31.36.0-255,66,23004,7,319267
32191,0.000225,74.125.68.0-255,2902,25906,7,319267
32192,0.000228,172.31.36.0-255,66,25972,7,319267
32193,0.000231,74.125.68.0-255,1484,27456,7,319267
32194,0.000233,172.31.36.0-255,66,27522,7,319267
32195,0.000262,74.125.68.0-255,4320,31842,7,319267
32196,0.000266,172.31.36.0-255,66,31908,7,319267
32197,0.000279,74.125.68.0-255,1484,33392,7,319267
32198,0.000281,172.31.36.0-255,66,33458,7,319267
32199,0.000286,74.125.68.0-255,4320,37778,7,319267
32200,0.000288,172.31.36.0-255,66,37844,7,319267
32201,0.000317,74.125.68.0-255,4320,42164,7,319267
32202,0.00032,172.31.36.0-255,66,42230,7,319267
32203,0.000342,74.125.68.0-255,1484,43714,7,319267
32204,0.000347,74.125.68.0-255,1484,45198,7,319267
32205,0.000349,172.31.36.0-255,66,45264,7,319267
32206,0.000354,74.125.68.0-255,2902,48166,7,319267
32207,0.000356,172.31.36.0-255,66,48232,7,319267
32208,0.000362,74.125.68.0-255,5738,53970,7,319267
32209,0.000364,172.31.36.0-255,66,54036,7,319267
32210,0.000387,74.125.68.0-255,2184,56220,7,319267
32211,0.00039,172.31.36.0-255,66,56286,7,319267
32212,0.000429,74.125.68.0-255,356,56642,7,319267
32213,0.000432,74.125.68.0-255,388,57030,7,319267
32214,0.000532,74.125.68.0-255,1484,58514,7,319267
32215,0.000537,172.31.36.0-255,66,58580,7,319267
32216,0.000542,74.125.68.0-255,2902,61482,7,319267
32217,0.000544,172.31.36.0-255,66,61548,7,319267
32218,0.000564,74.125.68.0-255,5738,67286,7,319267
32219,0.000567,172.31.36.0-255,66,67352,7,319267
32220,0.000585,74.125.68.0-255,5738,73090,7,319267
32221,0.000588,172.31.36.0-255,66,73156,7,319267
32222,0.000616,74.125.68.0-255,4320,77476,7,319267
32223,0.000619,172.31.36.0-255,66,77542,7,319267
32224,0.000632,172.31.36.0-255,66,77608,7,319267
32225,0.000637,74.125.68.0-255,2184,79792,7,319267
32226,0.000639,172.31.36.0-255,66,79858,7,319267
32227,0.000643,74.125.68.0-255,2902,82760,7,319267
32228,0.000646,172.31.36.0-255,66,82826,7,319267
32229,0.00068,74.125.68.0-255,7156,89982,7,319267
32230,0.000684,172.31.36.0-255,66,90048,7,319267
32231,0.000692,74.125.68.0-255,6247,96295,7,319267
32232,0.000694,172.31.36.0-255,66,96361,7,319267
32233,0.000855,74.125.68.0-255,1484,97845,7,319267
32234,0.000861,74.125.68.0-255,2902,100747,7,319267
32235,0.000864,172.31.36.0-255,66,100813,7,319267
32236,0.00088,74.125.68.0-255,5738,106551,7,319267
32237,0.000883,172.31.36.0-255,66,106617,7,319267
32238,0.000887,74.125.68.0-255,2902,109519,7,319267
32239,0.000889,172.31.36.0-255,66,109585,7,319267
32240,0.000894,74.125.68.0-255,2902,112487,7,319267
32241,0.000896,172.31.36.0-255,66,112553,7,319267
32242,0.000914,74.125.68.0-255,1484,114037,7,319267
32243,0.000922,74.125.68.0-255,7156,121193,7,319267
32244,0.000925,172.31.36.0-255,66,121259,7,319267
32245,0.000938,74.125.68.0-255,1484,122743,7,319267
32246,0.000942,74.125.68.0-255,2902,125645,7,319267
32247,0.000944,172.31.36.0-255,66,125711,7,319267
32248,0.000967,74.125.68.0-255,2902,128613,7,319267
32249,0.00097,172.31.36.0-255,66,128679,7,319267
32250,0.000988,74.125.68.0-255,2184,130863,7,319267
32251,0.000991,172.31.36.0-255,66,130929,7,319267
32252,0.001129,74.125.68.0-255,1484,132413,7,319267
32253,0.001133,74.125.68.0-255,1484,133897,7,319267
32254,0.001141,172.31.36.0-255,66,133963,7,319267
32255,0.001151,74.125.68.0-255,2902,136865,7,319267
32256,0.001155,172.31.36.0-255,66,136931,7,319267
32257,0.001191,74.125.68.0-255,2902,139833,7,319267
32258,0.001194,172.31.36.0-255,66,139899,7,319267
32259,0.001211,74.125.68.0-255,4320,144219,7,319267
32260,0.001214,172.31.36.0-255,66,144285,7,319267
32261,0.001253,172.31.36.0-255,66,144351,7,319267
32262,0.001255,74.125.68.0-255,1484,145835,7,319267
32263,0.001274,74.125.68.0-255,2902,148737,7,319267
32264,0.001276,172.31.36.0-255,66,148803,7,319267
32265,0.001281,74.125.68.0-255,4320,153123,7,319267
32266,0.001284,172.31.36.0-255,66,153189,7,319267
32267,0.001295,74.125.68.0-255,1484,154673,7,319267
32268,0.001299,74.125.68.0-255,2184,156857,7,319267
32269,0.001302,172.31.36.0-255,66,156923,7,319267
32270,0.00157,74.125.68.0-255,1484,158407,7,319267
32271,0.001575,74.125.68.0-255,1484,159891,7,319267
32272,0.001578,172.31.36.0-255,66,159957,7,319267
32273,0.001601,74.125.68.0-255,1484,161441,7,319267
32274,0.001607,74.125.68.0-255,5738,167179,7,319267
32275,0.00161,172.31.36.0-255,66,167245,7,319267
32276,0.001616,74.125.68.0-255,4320,171565,7,319267
32277,0.001617,172.31.36.0-255,66,171631,7,319267
32278,0.001631,74.125.68.0-255,2902,174533,7,319267
32279,0.001633,172.31.36.0-255,66,174599,7,319267
32280,0.001669,172.31.36.0-255,66,174665,7,319267
32281,0.001689,74.125.68.0-255,5738,180403,7,319267
32282,0.001691,172.31.36.0-255,66,180469,7,319267
32283,0.001706,74.125.68.0-255,2184,182653,7,319267
32284,0.001708,172.31.36.0-255,66,182719,7,319267
32285,0.001809,74.125.68.0-255,1484,184203,7,319267
32286,0.00183,74.125.68.0-255,2902,187105,7,319267
32287,0.001833,172.31.36.0-255,66,187171,7,319267
32288,0.00189,74.125.68.0-255,5738,192909,7,319267
32289,0.001893,172.31.36.0-255,66,192975,7,319267
32290,0.001901,74.125.68.0-255,7156,200131,7,319267
32291,0.001904,172.31.36.0-255,66,200197,7,319267
32292,0.001908,74.125.68.0-255,2902,203099,7,319267
32293,0.00191,172.31.36.0-255,66,203165,7,319267
32294,0.001952,74.125.68.0-255,1484,204649,7,319267
32295,0.001956,172.31.36.0-255,66,204715,7,319267
32296,0.001992,172.31.36.0-255,66,204781,7,319267
32297,0.001997,74.125.68.0-255,2902,207683,7,319267
32298,0.001999,172.31.36.0-255,66,207749,7,319267
32299,0.002025,172.31.36.0-255,66,207815,7,319267
32300,0.002031,74.125.68.0-255,5020,212835,7,319267
32301,0.002034,172.31.36.0-255,66,212901,7,319267
32302,0.002072,74.125.68.0-255,5738,218639,7,319267
32303,0.002075,172.31.36.0-255,66,218705,7,319267
32304,0.002091,74.125.68.0-255,7156,225861,7,319267
32305,0.002094,172.31.36.0-255,66,225927,7,319267
32306,0.002098,74.125.68.0-255,2902,228829,7,319267
32307,0.0021,172.31.36.0-255,66,228895,7,319267
32308,0.00213,172.31.36.0-255,66,228961,7,319267
32309,0.002136,74.125.68.0-255,5738,234699,7,319267
32310,0.002138,172.31.36.0-255,66,234765,7,319267
32311,0.002177,172.31.36.0-255,66,234831,7,319267
32312,0.002201,74.125.68.0-255,3602,238433,7,319267
32313,0.002204,172.31.36.0-255,66,238499,7,319267
32314,0.002216,172.31.36.0-255,66,238565,7,319267
32315,0.002238,74.125.68.0-255,2902,241467,7,319267
32316,0.002241,172.31.36.0-255,66,241533,7,319267
32317,0.002249,74.125.68.0-255,7156,248689,7,319267
32318,0.002252,172.31.36.0-255,66,248755,7,319267
32319,0.002256,74.125.68.0-255,2184,250939,7,319267
32320,0.002258,172.31.36.0-255,66,251005,7,319267
32321,0.004465,74.125.68.0-255,4320,255325,7,319267
32322,0.004471,172.31.36.0-255,66,255391,7,319267
32323,0.00449,74.125.68.0-255,1484,256875,7,319267
32324,0.006683,74.125.68.0-255,4320,261195,7,319267
32325,0.006689,172.31.36.0-255,66,261261,7,319267
32326,0.008911,74.125.68.0-255,4320,265581,7,319267
32327,0.008914,172.31.36.0-255,66,265647,7,319267
32328,0.008931,74.125.68.0-255,1484,267131,7,319267
32329,0.011141,74.125.68.0-255,4320,271451,7,319267
32330,0.011149,172.31.36.0-255,66,271517,7,319267
32331,0.013373,74.125.68.0-255,5738,277255,7,319267
32332,0.013382,172.31.36.0-255,66,277321,7,319267
32333,0.015609,74.125.68.0-255,5738,283059,7,319267
32334,0.015618,172.31.36.0-255,66,283125,7,319267
32335,0.01784,74.125.68.0-255,5738,288863,7,319267
32336,0.017849,172.31.36.0-255,66,288929,7,319267
32337,0.020067,74.125.68.0-255,5738,294667,7,319267
32338,0.020076,172.31.36.0-255,66,294733,7,319267
32339,0.022294,74.125.68.0-255,5738,300471,7,319267
32340,0.022303,172.31.36.0-255,66,300537,7,319267
32341,0.024553,74.125.68.0-255,5738,306275,7,319267
32342,0.024559,172.31.36.0-255,66,306341,7,319267
32343,0.026784,74.125.68.0-255,5738,312079,7,319267
32344,0.026794,172.31.36.0-255,66,312145,7,319267
32345,0.028722,172.31.36.0-255,172,312317,7,319267
32346,0.028761,172.31.36.0-255,1114,313431,7,319267
32347,0.028841,172.31.36.0-255,1514,314945,7,319267
32348,0.028843,172.31.36.0-255,1294,316239,7,319267
32349,0.029022,74.125.68.0-255,2593,318832,7,319267
32350,0.02903,172.31.36.0-255,66,318898,7,319267
32351,0.029192,172.31.36.0-255,105,319003,7,319267
32352,0.030214,104.244.42.0-255,66,319069,7,319267
32353,0.030255,104.244.42.0-255,66,319135,7,319267
32354,0.030339,104.244.42.0-255,66,319201,7,319267
32355,0.031375,74.125.68.0-255,66,319267,7,319267
32356,0.0,172.217.194.0-255,153,153,7,325361
32357,2.6e-05,172.31.36.0-255,66,219,7,325361
32358,3.3e-05,172.217.194.0-255,1484,1703,7,325361
32359,3.7e-05,172.31.36.0-255,66,1769,7,325361
32360,4.2e-05,172.217.194.0-255,2902,4671,7,325361
32361,4.5e-05,172.31.36.0-255,66,4737,7,325361
32362,4.8e-05,172.217.194.0-255,1484,6221,7,325361
32363,5e-05,172.31.36.0-255,66,6287,7,325361
32364,7.1e-05,172.217.194.0-255,4320,10607,7,325361
32365,7.3e-05,172.31.36.0-255,66,10673,7,325361
32366,9e-05,172.217.194.0-255,5738,16411,7,325361
32367,9.2e-05,172.31.36.0-255,66,16477,7,325361
32368,0.000128,172.31.36.0-255,66,16543,7,325361
32369,0.000135,172.217.194.0-255,6797,23340,7,325361
32370,0.000137,172.31.36.0-255,66,23406,7,325361
32371,0.000154,172.217.194.0-255,1484,24890,7,325361
32372,0.000156,172.31.36.0-255,66,24956,7,325361
32373,0.000162,172.217.194.0-255,2902,27858,7,325361
32374,0.000164,172.31.36.0-255,66,27924,7,325361
32375,0.000171,172.217.194.0-255,5738,33662,7,325361
32376,0.000173,172.31.36.0-255,66,33728,7,325361
32377,0.000203,172.217.194.0-255,6797,40525,7,325361
32378,0.000206,172.31.36.0-255,66,40591,7,325361
32379,0.000667,172.217.194.0-255,1484,42075,7,325361
32380,0.000671,172.31.36.0-255,66,42141,7,325361
32381,0.000682,172.217.194.0-255,2902,45043,7,325361
32382,0.000684,172.31.36.0-255,66,45109,7,325361
32383,0.00069,172.217.194.0-255,5738,50847,7,325361
32384,0.000693,172.31.36.0-255,66,50913,7,325361
32385,0.000696,172.217.194.0-255,1484,52397,7,325361
32386,0.000697,172.31.36.0-255,66,52463,7,325361
32387,0.000755,172.217.194.0-255,5379,57842,7,325361
32388,0.000763,172.217.194.0-255,5738,63580,7,325361
32389,0.000795,172.217.194.0-255,2902,66482,7,325361
32390,0.00084,172.217.194.0-255,2902,69384,7,325361
32391,0.000876,172.217.194.0-255,3961,73345,7,325361
32392,0.001019,172.217.194.0-255,1484,74829,7,325361
32393,0.001024,172.217.194.0-255,1484,76313,7,325361
32394,0.001042,172.217.194.0-255,1484,77797,7,325361
32395,0.001048,172.217.194.0-255,5738,83535,7,325361
32396,0.001066,172.217.194.0-255,7156,90691,7,325361
32397,0.001087,172.217.194.0-255,7156,97847,7,325361
32398,0.001102,172.217.194.0-255,7156,105003,7,325361
32399,0.001106,172.217.194.0-255,2184,107187,7,325361
32400,0.001153,172.217.194.0-255,4320,111507,7,325361
32401,0.001187,172.217.194.0-255,5738,117245,7,325361
32402,0.001214,172.217.194.0-255,6438,123683,7,325361
32403,0.00124,172.217.194.0-255,4320,128003,7,325361
32404,0.001254,172.217.194.0-255,2902,130905,7,325361
32405,0.001257,172.217.194.0-255,1484,132389,7,325361
32406,0.001312,172.217.194.0-255,4320,136709,7,325361
32407,0.001425,172.217.194.0-255,1484,138193,7,325361
32408,0.00144,172.217.194.0-255,2902,141095,7,325361
32409,0.001448,172.217.194.0-255,1484,142579,7,325361
32410,0.001464,172.217.194.0-255,4320,146899,7,325361
32411,0.001467,172.217.194.0-255,1484,148383,7,325361
32412,0.001494,172.217.194.0-255,4320,152703,7,325361
32413,0.001513,172.217.194.0-255,7156,159859,7,325361
32414,0.001516,172.217.194.0-255,2184,162043,7,325361
32415,0.001902,172.217.194.0-255,1484,163527,7,325361
32416,0.001919,172.217.194.0-255,1484,165011,7,325361
32417,0.001933,172.217.194.0-255,1484,166495,7,325361
32418,0.001939,172.217.194.0-255,5738,172233,7,325361
32419,0.001952,172.217.194.0-255,4320,176553,7,325361
32420,0.002,172.217.194.0-255,2184,178737,7,325361
32421,0.002537,172.217.194.0-255,1484,180221,7,325361
32422,0.002556,172.217.194.0-255,2902,183123,7,325361
32423,0.002571,172.217.194.0-255,2902,186025,7,325361
32424,0.002584,172.217.194.0-255,2902,188927,7,325361
32425,0.002587,172.217.194.0-255,1484,190411,7,325361
32426,0.002597,172.217.194.0-255,2902,193313,7,325361
32427,0.002623,172.217.194.0-255,4320,197633,7,325361
32428,0.002646,172.217.194.0-255,7156,204789,7,325361
32429,0.00439,172.31.36.0-255,66,204855,7,325361
32430,0.006289,172.31.36.0-255,101,204956,7,325361
32431,0.007052,172.217.194.0-255,5738,210694,7,325361
32432,0.007057,172.31.36.0-255,66,210760,7,325361
32433,0.008864,172.217.194.0-255,66,210826,7,325361
32434,0.009698,172.217.194.0-255,5738,216564,7,325361
32435,0.009703,172.31.36.0-255,66,216630,7,325361
32436,0.012349,172.217.194.0-255,5738,222368,7,325361
32437,0.012484,172.31.36.0-255,66,222434,7,325361
32438,0.015113,172.217.194.0-255,5738,228172,7,325361
32439,0.015122,172.31.36.0-255,66,228238,7,325361
32440,0.017759,172.217.194.0-255,5738,233976,7,325361
32441,0.017768,172.31.36.0-255,66,234042,7,325361
32442,0.02043,172.217.194.0-255,5738,239780,7,325361
32443,0.020437,172.31.36.0-255,66,239846,7,325361
32444,0.023064,172.217.194.0-255,5738,245584,7,325361
32445,0.023072,172.31.36.0-255,66,245650,7,325361
32446,0.025682,172.217.194.0-255,5738,251388,7,325361
32447,0.02569,172.31.36.0-255,66,251454,7,325361
32448,0.028321,172.217.194.0-255,5738,257192,7,325361
32449,0.028329,172.31.36.0-255,66,257258,7,325361
32450,0.029518,172.31.36.0-255,188,257446,7,325361
32451,0.02955,172.31.36.0-255,958,258404,7,325361
32452,0.029584,172.31.36.0-255,1514,259918,7,325361
32453,0.029586,172.31.36.0-255,1448,261366,7,325361
32454,0.030955,172.217.194.0-255,5738,267104,7,325361
32455,0.030962,172.31.36.0-255,66,267170,7,325361
32456,0.0311,104.244.42.0-255,66,267236,7,325361
32457,0.031106,104.244.42.0-255,66,267302,7,325361
32458,0.031141,104.244.42.0-255,66,267368,7,325361
32459,0.033575,172.217.194.0-255,5738,273106,7,325361
32460,0.033582,172.31.36.0-255,66,273172,7,325361
32461,0.036195,172.217.194.0-255,5738,278910,7,325361
32462,0.036201,172.31.36.0-255,66,278976,7,325361
32463,0.03883,172.217.194.0-255,5738,284714,7,325361
32464,0.038834,172.31.36.0-255,66,284780,7,325361
32465,0.041453,172.217.194.0-255,5738,290518,7,325361
32466,0.041457,172.31.36.0-255,66,290584,7,325361
32467,0.044078,172.217.194.0-255,5738,296322,7,325361
32468,0.044084,172.31.36.0-255,66,296388,7,325361
32469,0.046711,172.217.194.0-255,5738,302126,7,325361
32470,0.046717,172.31.36.0-255,66,302192,7,325361
32471,0.049345,172.217.194.0-255,5738,307930,7,325361
32472,0.049366,172.31.36.0-255,66,307996,7,325361
32473,0.052014,172.217.194.0-255,5738,313734,7,325361
32474,0.052019,172.31.36.0-255,66,313800,7,325361
32475,0.054666,172.217.194.0-255,4320,318120,7,325361
32476,0.054672,172.31.36.0-255,66,318186,7,325361
32477,0.054704,172.217.194.0-255,1484,319670,7,325361
32478,0.057357,172.217.194.0-255,4320,323990,7,325361
32479,0.057362,172.31.36.0-255,66,324056,7,325361
32480,0.059972,172.217.194.0-255,1134,325190,7,325361
32481,0.060148,172.31.36.0-255,105,325295,7,325361
32482,0.066749,172.217.194.0-255,66,325361,7,325361
32483,0.0,74.125.68.0-255,143,143,7,281416
32484,2.1e-05,172.31.36.0-255,66,209,7,281416
32485,2.8e-05,74.125.68.0-255,1484,1693,7,281416
32486,3.1e-05,172.31.36.0-255,66,1759,7,281416
32487,5.6e-05,74.125.68.0-255,2902,4661,7,281416
32488,5.9e-05,172.31.36.0-255,66,4727,7,281416
32489,7e-05,74.125.68.0-255,5738,10465,7,281416
32490,7.2e-05,172.31.36.0-255,66,10531,7,281416
32491,7.6e-05,74.125.68.0-255,2902,13433,7,281416
32492,7.8e-05,172.31.36.0-255,66,13499,7,281416
32493,0.000106,74.125.68.0-255,701,14200,7,281416
32494,0.000108,172.31.36.0-255,66,14266,7,281416
32495,0.000305,74.125.68.0-255,1484,15750,7,281416
32496,0.000311,172.31.36.0-255,66,15816,7,281416
32497,0.000317,74.125.68.0-255,2902,18718,7,281416
32498,0.000319,172.31.36.0-255,66,18784,7,281416
32499,0.000323,74.125.68.0-255,1484,20268,7,281416
32500,0.000325,172.31.36.0-255,66,20334,7,281416
32501,0.000369,74.125.68.0-255,4320,24654,7,281416
32502,0.000374,172.31.36.0-255,66,24720,7,281416
32503,0.000382,74.125.68.0-255,6797,31517,7,281416
32504,0.000384,172.31.36.0-255,66,31583,7,281416
32505,0.000451,74.125.68.0-255,1484,33067,7,281416
32506,0.000457,172.31.36.0-255,66,33133,7,281416
32507,0.000468,74.125.68.0-255,2902,36035,7,281416
32508,0.00047,172.31.36.0-255,66,36101,7,281416
32509,0.000504,74.125.68.0-255,2902,39003,7,281416
32510,0.000509,172.31.36.0-255,66,39069,7,281416
32511,0.000515,74.125.68.0-255,4320,43389,7,281416
32512,0.000517,172.31.36.0-255,66,43455,7,281416
32513,0.00055,74.125.68.0-255,5379,48834,7,281416
32514,0.000554,172.31.36.0-255,66,48900,7,281416
32515,0.001184,74.125.68.0-255,1484,50384,7,281416
32516,0.001193,74.125.68.0-255,2902,53286,7,281416
32517,0.001197,172.31.36.0-255,66,53352,7,281416
32518,0.001203,74.125.68.0-255,4320,57672,7,281416
32519,0.001205,172.31.36.0-255,66,57738,7,281416
32520,0.001261,172.31.36.0-255,66,57804,7,281416
32521,0.001337,74.125.68.0-255,1484,59288,7,281416
32522,0.001343,74.125.68.0-255,2902,62190,7,281416
32523,0.001346,172.31.36.0-255,66,62256,7,281416
32524,0.001376,74.125.68.0-255,4320,66576,7,281416
32525,0.001379,172.31.36.0-255,66,66642,7,281416
32526,0.001422,172.31.36.0-255,66,66708,7,281416
32527,0.001428,74.125.68.0-255,4320,71028,7,281416
32528,0.00143,172.31.36.0-255,66,71094,7,281416
32529,0.001456,74.125.68.0-255,5738,76832,7,281416
32530,0.001459,172.31.36.0-255,66,76898,7,281416
32531,0.001465,74.125.68.0-255,5379,82277,7,281416
32532,0.001467,172.31.36.0-255,66,82343,7,281416
32533,0.002299,74.125.68.0-255,1484,83827,7,281416
32534,0.00375,74.125.68.0-255,4320,88147,7,281416
32535,0.003757,172.31.36.0-255,66,88213,7,281416
32536,0.006069,74.125.68.0-255,5738,93951,7,281416
32537,0.006076,172.31.36.0-255,66,94017,7,281416
32538,0.008361,74.125.68.0-255,5738,99755,7,281416
32539,0.00837,172.31.36.0-255,66,99821,7,281416
32540,0.010659,74.125.68.0-255,5738,105559,7,281416
32541,0.010667,172.31.36.0-255,66,105625,7,281416
32542,0.01296,74.125.68.0-255,5738,111363,7,281416
32543,0.012968,172.31.36.0-255,66,111429,7,281416
32544,0.015253,74.125.68.0-255,5738,117167,7,281416
32545,0.015263,172.31.36.0-255,66,117233,7,281416
32546,0.017549,74.125.68.0-255,5738,122971,7,281416
32547,0.017557,172.31.36.0-255,66,123037,7,281416
32548,0.018681,172.31.36.0-255,164,123201,7,281416
32549,0.018713,172.31.36.0-255,1122,124323,7,281416
32550,0.018769,172.31.36.0-255,1514,125837,7,281416
32551,0.01877,172.31.36.0-255,324,126161,7,281416
32552,0.019828,74.125.68.0-255,5738,131899,7,281416
32553,0.019836,172.31.36.0-255,66,131965,7,281416
32554,0.020224,104.244.42.0-255,66,132031,7,281416
32555,0.020272,104.244.42.0-255,66,132097,7,281416
32556,0.020322,104.244.42.0-255,66,132163,7,281416
32557,0.022121,74.125.68.0-255,5738,137901,7,281416
32558,0.022126,172.31.36.0-255,66,137967,7,281416
32559,0.024406,74.125.68.0-255,5738,143705,7,281416
32560,0.024413,172.31.36.0-255,66,143771,7,281416
32561,0.026705,74.125.68.0-255,5738,149509,7,281416
32562,0.026717,172.31.36.0-255,66,149575,7,281416
32563,0.02901,74.125.68.0-255,5738,155313,7,281416
32564,0.029016,172.31.36.0-255,66,155379,7,281416
32565,0.031299,74.125.68.0-255,5738,161117,7,281416
32566,0.031306,172.31.36.0-255,66,161183,7,281416
32567,0.033612,74.125.68.0-255,5738,166921,7,281416
32568,0.033618,172.31.36.0-255,66,166987,7,281416
32569,0.035893,74.125.68.0-255,5738,172725,7,281416
32570,0.0359,172.31.36.0-255,66,172791,7,281416
32571,0.038172,74.125.68.0-255,5738,178529,7,281416
32572,0.038178,172.31.36.0-255,66,178595,7,281416
32573,0.040455,74.125.68.0-255,4320,182915,7,281416
32574,0.04046,172.31.36.0-255,66,182981,7,281416
32575,0.040516,74.125.68.0-255,1484,184465,7,281416
32576,0.042739,74.125.68.0-255,4320,188785,7,281416
32577,0.042744,172.31.36.0-255,66,188851,7,281416
32578,0.045067,74.125.68.0-255,4320,193171,7,281416
32579,0.045072,172.31.36.0-255,66,193237,7,281416
32580,0.045109,74.125.68.0-255,1484,194721,7,281416
32581,0.047355,74.125.68.0-255,4320,199041,7,281416
32582,0.047361,172.31.36.0-255,66,199107,7,281416
32583,0.049033,172.31.36.0-255,105,199212,7,281416
32584,0.049222,172.31.36.0-255,90,199302,7,281416
32585,0.049232,172.31.36.0-255,66,199368,7,281416
32586,0.049633,74.125.68.0-255,5738,205106,7,281416
32587,0.049639,172.31.36.0-255,66,205172,7,281416
32588,0.051516,74.125.130.0-255,66,205238,7,281416
32589,0.051531,74.125.130.0-255,66,205304,7,281416
32590,0.051544,172.31.36.0-255,66,205370,7,281416
32591,0.05191,74.125.68.0-255,5738,211108,7,281416
32592,0.051913,172.31.36.0-255,66,211174,7,281416
32593,0.054186,74.125.68.0-255,5738,216912,7,281416
32594,0.054192,172.31.36.0-255,66,216978,7,281416
32595,0.056466,74.125.68.0-255,5738,222716,7,281416
32596,0.056472,172.31.36.0-255,66,222782,7,281416
32597,0.058758,74.125.68.0-255,5738,228520,7,281416
32598,0.058764,172.31.36.0-255,66,228586,7,281416
32599,0.061055,74.125.68.0-255,5738,234324,7,281416
32600,0.061061,172.31.36.0-255,66,234390,7,281416
32601,0.063334,74.125.68.0-255,5738,240128,7,281416
32602,0.063343,172.31.36.0-255,66,240194,7,281416
32603,0.065609,74.125.68.0-255,5738,245932,7,281416
32604,0.065614,172.31.36.0-255,66,245998,7,281416
32605,0.06789,74.125.68.0-255,5738,251736,7,281416
32606,0.067897,172.31.36.0-255,66,251802,7,281416
32607,0.070171,74.125.68.0-255,5738,257540,7,281416
32608,0.070176,172.31.36.0-255,66,257606,7,281416
32609,0.072446,74.125.68.0-255,2902,260508,7,281416
32610,0.072452,172.31.36.0-255,66,260574,7,281416
32611,0.072499,74.125.68.0-255,2902,263476,7,281416
32612,0.072503,172.31.36.0-255,66,263542,7,281416
32613,0.074722,74.125.68.0-255,2902,266444,7,281416
32614,0.074728,172.31.36.0-255,66,266510,7,281416
32615,0.074775,74.125.68.0-255,2902,269412,7,281416
32616,0.074778,172.31.36.0-255,66,269478,7,281416
32617,0.076997,74.125.68.0-255,2902,272380,7,281416
32618,0.077004,172.31.36.0-255,66,272446,7,281416
32619,0.077032,74.125.68.0-255,1484,273930,7,281416
32620,0.077056,74.125.68.0-255,1484,275414,7,281416
32621,0.077058,172.31.36.0-255,66,275480,7,281416
32622,0.079286,74.125.68.0-255,2902,278382,7,281416
32623,0.079297,172.31.36.0-255,66,278448,7,281416
32624,0.079333,74.125.68.0-255,2902,281350,7,281416
32625,0.079336,172.31.36.0-255,66,281416,7,281416
32626,0.0,74.125.24.0-255,153,153,7,300543
32627,1.8e-05,172.31.36.0-255,66,219,7,300543
32628,2.6e-05,74.125.24.0-255,1484,1703,7,300543
32629,2.9e-05,172.31.36.0-255,66,1769,7,300543
32630,3.5e-05,74.125.24.0-255,2902,4671,7,300543
32631,4e-05,172.31.36.0-255,66,4737,7,300543
32632,4.8e-05,74.125.24.0-255,7156,11893,7,300543
32633,5e-05,172.31.36.0-255,66,11959,7,300543
32634,5.5e-05,74.125.24.0-255,2030,13989,7,300543
32635,5.7e-05,172.31.36.0-255,66,14055,7,300543
32636,9.2e-05,74.125.24.0-255,2902,16957,7,300543
32637,9.6e-05,172.31.36.0-255,66,17023,7,300543
32638,0.000101,74.125.24.0-255,4320,21343,7,300543
32639,0.000104,172.31.36.0-255,66,21409,7,300543
32640,0.00012,74.125.24.0-255,2902,24311,7,300543
32641,0.000123,172.31.36.0-255,66,24377,7,300543
32642,0.000164,74.125.24.0-255,4320,28697,7,300543
32643,0.000168,172.31.36.0-255,66,28763,7,300543
32644,0.000189,74.125.24.0-255,2543,31306,7,300543
32645,0.000192,172.31.36.0-255,66,31372,7,300543
32646,0.000207,74.125.24.0-255,4320,35692,7,300543
32647,0.00021,172.31.36.0-255,66,35758,7,300543
32648,0.000213,74.125.24.0-255,1484,37242,7,300543
32649,0.000215,172.31.36.0-255,66,37308,7,300543
32650,0.000241,74.125.24.0-255,4320,41628,7,300543
32651,0.000244,172.31.36.0-255,66,41694,7,300543
32652,0.000251,74.125.24.0-255,5738,47432,7,300543
32653,0.000253,172.31.36.0-255,66,47498,7,300543
32654,0.000285,74.125.24.0-255,6797,54295,7,300543
32655,0.000288,172.31.36.0-255,66,54361,7,300543
32656,0.000295,74.125.24.0-255,7156,61517,7,300543
32657,0.000298,172.31.36.0-255,66,61583,7,300543
32658,0.000334,74.125.24.0-255,4340,65923,7,300543
32659,0.000337,172.31.36.0-255,66,65989,7,300543
32660,0.00034,74.125.24.0-255,331,66320,7,300543
32661,0.000599,74.125.24.0-255,1484,67804,7,300543
32662,0.000606,172.31.36.0-255,66,67870,7,300543
32663,0.000613,74.125.24.0-255,2902,70772,7,300543
32664,0.000616,172.31.36.0-255,66,70838,7,300543
32665,0.000623,74.125.24.0-255,5738,76576,7,300543
32666,0.000625,172.31.36.0-255,66,76642,7,300543
32667,0.000628,74.125.24.0-255,1484,78126,7,300543
32668,0.000668,172.31.36.0-255,66,78192,7,300543
32669,0.000671,74.125.24.0-255,1484,79676,7,300543
32670,0.0007,172.31.36.0-255,66,79742,7,300543
32671,0.000812,74.125.24.0-255,1484,81226,7,300543
32672,0.000815,74.125.24.0-255,1484,82710,7,300543
32673,0.00082,172.31.36.0-255,66,82776,7,300543
32674,0.000834,74.125.24.0-255,1484,84260,7,300543
32675,0.000841,74.125.24.0-255,5738,89998,7,300543
32676,0.000844,172.31.36.0-255,66,90064,7,300543
32677,0.000847,74.125.24.0-255,1484,91548,7,300543
32678,0.000889,172.31.36.0-255,66,91614,7,300543
32679,0.0009,172.31.36.0-255,66,91680,7,300543
32680,0.000903,74.125.24.0-255,766,92446,7,300543
32681,0.001308,74.125.24.0-255,1484,93930,7,300543
32682,0.001313,172.31.36.0-255,66,93996,7,300543
32683,0.001319,74.125.24.0-255,2902,96898,7,300543
32684,0.001321,172.31.36.0-255,66,96964,7,300543
32685,0.001325,74.125.24.0-255,2902,99866,7,300543
32686,0.001327,172.31.36.0-255,66,99932,7,300543
32687,0.001351,74.125.24.0-255,2902,102834,7,300543
32688,0.001357,74.125.24.0-255,5738,108572,7,300543
32689,0.001361,172.31.36.0-255,66,108638,7,300543
32690,0.001365,172.31.36.0-255,66,108704,7,300543
32691,0.001388,74.125.24.0-255,7156,115860,7,300543
32692,0.001391,172.31.36.0-255,66,115926,7,300543
32693,0.001402,172.31.36.0-255,66,115992,7,300543
32694,0.001405,74.125.24.0-255,766,116758,7,300543
32695,0.001476,74.125.24.0-255,1484,118242,7,300543
32696,0.001479,172.31.36.0-255,66,118308,7,300543
32697,0.001485,74.125.24.0-255,2902,121210,7,300543
32698,0.001487,172.31.36.0-255,66,121276,7,300543
32699,0.001493,74.125.24.0-255,5738,127014,7,300543
32700,0.001495,172.31.36.0-255,66,127080,7,300543
32701,0.00154,172.31.36.0-255,66,127146,7,300543
32702,0.001547,74.125.24.0-255,7156,134302,7,300543
32703,0.001549,172.31.36.0-255,66,134368,7,300543
32704,0.001566,74.125.24.0-255,3602,137970,7,300543
32705,0.001568,172.31.36.0-255,66,138036,7,300543
32706,0.001634,74.125.24.0-255,1484,139520,7,300543
32707,0.00164,74.125.24.0-255,2902,142422,7,300543
32708,0.001644,172.31.36.0-255,66,142488,7,300543
32709,0.001683,74.125.24.0-255,2902,145390,7,300543
32710,0.001686,172.31.36.0-255,66,145456,7,300543
32711,0.001707,74.125.24.0-255,2902,148358,7,300543
32712,0.00171,172.31.36.0-255,66,148424,7,300543
32713,0.001717,74.125.24.0-255,5738,154162,7,300543
32714,0.001719,172.31.36.0-255,66,154228,7,300543
32715,0.001732,172.31.36.0-255,66,154294,7,300543
32716,0.001738,74.125.24.0-255,5020,159314,7,300543
32717,0.001741,172.31.36.0-255,66,159380,7,300543
32718,0.001791,74.125.24.0-255,1484,160864,7,300543
32719,0.001812,74.125.24.0-255,2902,163766,7,300543
32720,0.001816,172.31.36.0-255,66,163832,7,300543
32721,0.001824,74.125.24.0-255,5738,169570,7,300543
32722,0.001826,172.31.36.0-255,66,169636,7,300543
32723,0.001831,74.125.24.0-255,4320,173956,7,300543
32724,0.001833,172.31.36.0-255,66,174022,7,300543
32725,0.001846,74.125.24.0-255,5738,179760,7,300543
32726,0.00185,74.125.24.0-255,2902,182662,7,300543
32727,0.001864,172.31.36.0-255,66,182728,7,300543
32728,0.001886,74.125.24.0-255,2184,184912,7,300543
32729,0.001905,172.31.36.0-255,66,184978,7,300543
32730,0.00194,74.125.24.0-255,1484,186462,7,300543
32731,0.001959,74.125.24.0-255,2902,189364,7,300543
32732,0.001962,172.31.36.0-255,66,189430,7,300543
32733,0.001968,74.125.24.0-255,5738,195168,7,300543
32734,0.001989,74.125.24.0-255,7156,202324,7,300543
32735,0.001992,74.125.24.0-255,1484,203808,7,300543
32736,0.001997,172.31.36.0-255,66,203874,7,300543
32737,0.002021,74.125.24.0-255,2184,206058,7,300543
32738,0.002044,172.31.36.0-255,66,206124,7,300543
32739,0.002094,74.125.24.0-255,1484,207608,7,300543
32740,0.002099,74.125.24.0-255,2902,210510,7,300543
32741,0.002111,172.31.36.0-255,66,210576,7,300543
32742,0.002123,74.125.24.0-255,5738,216314,7,300543
32743,0.002126,74.125.24.0-255,1484,217798,7,300543
32744,0.002146,74.125.24.0-255,2902,220700,7,300543
32745,0.002162,74.125.24.0-255,5738,226438,7,300543
32746,0.002165,172.31.36.0-255,66,226504,7,300543
32747,0.00217,172.31.36.0-255,66,226570,7,300543
32748,0.002185,74.125.24.0-255,4320,230890,7,300543
32749,0.002231,74.125.24.0-255,4320,235210,7,300543
32750,0.002252,172.31.36.0-255,66,235276,7,300543
32751,0.002257,172.31.36.0-255,66,235342,7,300543
32752,0.002268,74.125.24.0-255,1484,236826,7,300543
32753,0.002294,74.125.24.0-255,2902,239728,7,300543
32754,0.002299,74.125.24.0-255,3602,243330,7,300543
32755,0.002314,172.31.36.0-255,66,243396,7,300543
32756,0.002336,74.125.24.0-255,5738,249134,7,300543
32757,0.002341,172.31.36.0-255,66,249200,7,300543
32758,0.00236,74.125.24.0-255,1484,250684,7,300543
32759,0.002916,172.31.36.0-255,101,250785,7,300543
32760,0.004672,74.125.24.0-255,4320,255105,7,300543
32761,0.004679,172.31.36.0-255,66,255171,7,300543
32762,0.00523,74.125.24.0-255,1484,256655,7,300543
32763,0.006987,74.125.24.0-255,4320,260975,7,300543
32764,0.00699,172.31.36.0-255,66,261041,7,300543
32765,0.009355,74.125.24.0-255,5738,266779,7,300543
32766,0.009361,172.31.36.0-255,66,266845,7,300543
32767,0.011683,74.125.24.0-255,5738,272583,7,300543
32768,0.01169,172.31.36.0-255,66,272649,7,300543
32769,0.014035,74.125.24.0-255,5738,278387,7,300543
32770,0.014044,172.31.36.0-255,66,278453,7,300543
32771,0.016388,74.125.24.0-255,5738,284191,7,300543
32772,0.016396,172.31.36.0-255,66,284257,7,300543
32773,0.018742,74.125.24.0-255,5738,289995,7,300543
32774,0.018751,172.31.36.0-255,66,290061,7,300543
32775,0.021076,74.125.24.0-255,947,291008,7,300543
32776,0.021502,172.31.36.0-255,105,291113,7,300543
32777,0.027349,74.125.24.0-255,66,291179,7,300543
32778,0.035579,172.31.36.0-255,172,291351,7,300543
32779,0.03561,172.31.36.0-255,1115,292466,7,300543
32780,0.035681,172.31.36.0-255,1514,293980,7,300543
32781,0.035683,172.31.36.0-255,1514,295494,7,300543
32782,0.035685,172.31.36.0-255,1514,297008,7,300543
32783,0.035686,172.31.36.0-255,1514,298522,7,300543
32784,0.035742,172.31.36.0-255,1514,300036,7,300543
32785,0.035748,172.31.36.0-255,69,300105,7,300543
32786,0.037064,104.244.42.0-255,66,300171,7,300543
32787,0.037114,104.244.42.0-255,66,300237,7,300543
32788,0.037202,104.244.42.0-255,66,300303,7,300543
32789,0.037231,104.244.42.0-255,66,300369,7,300543
32790,0.037826,104.244.42.0-255,108,300477,7,300543
32791,0.037833,172.31.36.0-255,66,300543,7,300543
32792,0.0,74.125.200.0-255,153,153,7,353752
32793,8.1e-05,172.31.36.0-255,66,219,7,353752
32794,8.8e-05,74.125.200.0-255,1484,1703,7,353752
32795,9.2e-05,172.31.36.0-255,66,1769,7,353752
32796,0.000106,74.125.200.0-255,2902,4671,7,353752
32797,0.000109,172.31.36.0-255,66,4737,7,353752
32798,0.000119,74.125.200.0-255,7156,11893,7,353752
32799,0.000122,172.31.36.0-255,66,11959,7,353752
32800,0.000126,74.125.200.0-255,2045,14004,7,353752
32801,0.000129,172.31.36.0-255,66,14070,7,353752
32802,0.000133,74.125.200.0-255,1484,15554,7,353752
32803,0.000134,172.31.36.0-255,66,15620,7,353752
32804,0.000167,74.125.200.0-255,2902,18522,7,353752
32805,0.00017,172.31.36.0-255,66,18588,7,353752
32806,0.000177,74.125.200.0-255,5738,24326,7,353752
32807,0.000179,172.31.36.0-255,66,24392,7,353752
32808,0.000185,74.125.200.0-255,5738,30130,7,353752
32809,0.000187,172.31.36.0-255,66,30196,7,353752
32810,0.000225,74.125.200.0-255,1125,31321,7,353752
32811,0.000228,172.31.36.0-255,66,31387,7,353752
32812,0.000265,74.125.200.0-255,1484,32871,7,353752
32813,0.000268,172.31.36.0-255,66,32937,7,353752
32814,0.000296,74.125.200.0-255,2902,35839,7,353752
32815,0.000299,172.31.36.0-255,66,35905,7,353752
32816,0.000305,74.125.200.0-255,5738,41643,7,353752
32817,0.000308,172.31.36.0-255,66,41709,7,353752
32818,0.000332,74.125.200.0-255,6797,48506,7,353752
32819,0.000337,172.31.36.0-255,66,48572,7,353752
32820,0.000547,74.125.200.0-255,1484,50056,7,353752
32821,0.000551,172.31.36.0-255,66,50122,7,353752
32822,0.00058,74.125.200.0-255,2902,53024,7,353752
32823,0.000583,172.31.36.0-255,66,53090,7,353752
32824,0.000587,74.125.200.0-255,1484,54574,7,353752
32825,0.000615,74.125.200.0-255,5738,60312,7,353752
32826,0.000626,172.31.36.0-255,66,60378,7,353752
32827,0.000636,74.125.200.0-255,5738,66116,7,353752
32828,0.000653,172.31.36.0-255,66,66182,7,353752
32829,0.000655,74.125.200.0-255,3961,70143,7,353752
32830,0.000676,74.125.200.0-255,4320,74463,7,353752
32831,0.000676,172.31.36.0-255,66,74529,7,353752
32832,0.000682,172.31.36.0-255,66,74595,7,353752
32833,0.000712,74.125.200.0-255,5738,80333,7,353752
32834,0.000721,172.31.36.0-255,66,80399,7,353752
32835,0.000749,74.125.200.0-255,7156,87555,7,353752
32836,0.000757,172.31.36.0-255,66,87621,7,353752
32837,0.000763,74.125.200.0-255,2184,89805,7,353752
32838,0.000766,74.125.200.0-255,646,90451,7,353752
32839,0.00077,172.31.36.0-255,66,90517,7,353752
32840,0.000811,74.125.200.0-255,1484,92001,7,353752
32841,0.000817,74.125.200.0-255,4320,96321,7,353752
32842,0.00082,172.31.36.0-255,66,96387,7,353752
32843,0.000824,74.125.200.0-255,1484,97871,7,353752
32844,0.000848,74.125.200.0-255,2902,100773,7,353752
32845,0.000852,74.125.200.0-255,2902,103675,7,353752
32846,0.000853,172.31.36.0-255,66,103741,7,353752
32847,0.000858,172.31.36.0-255,66,103807,7,353752
32848,0.000886,74.125.200.0-255,2902,106709,7,353752
32849,0.000892,74.125.200.0-255,5738,112447,7,353752
32850,0.000895,172.31.36.0-255,66,112513,7,353752
32851,0.0009,172.31.36.0-255,66,112579,7,353752
32852,0.000903,74.125.200.0-255,7156,119735,7,353752
32853,0.000914,172.31.36.0-255,66,119801,7,353752
32854,0.000928,74.125.200.0-255,2902,122703,7,353752
32855,0.00094,172.31.36.0-255,66,122769,7,353752
32856,0.000955,74.125.200.0-255,2184,124953,7,353752
32857,0.000968,172.31.36.0-255,66,125019,7,353752
32858,0.001004,74.125.200.0-255,1484,126503,7,353752
32859,0.001018,74.125.200.0-255,2902,129405,7,353752
32860,0.001022,172.31.36.0-255,66,129471,7,353752
32861,0.001026,74.125.200.0-255,1484,130955,7,353752
32862,0.001048,74.125.200.0-255,4320,135275,7,353752
32863,0.001057,172.31.36.0-255,66,135341,7,353752
32864,0.00107,74.125.200.0-255,7156,142497,7,353752
32865,0.001078,74.125.200.0-255,1484,143981,7,353752
32866,0.001078,172.31.36.0-255,66,144047,7,353752
32867,0.001112,172.31.36.0-255,66,144113,7,353752
32868,0.001138,74.125.200.0-255,1484,145597,7,353752
32869,0.001156,74.125.200.0-255,5020,150617,7,353752
32870,0.00116,172.31.36.0-255,66,150683,7,353752
32871,0.001209,74.125.200.0-255,1484,152167,7,353752
32872,0.001213,74.125.200.0-255,2902,155069,7,353752
32873,0.001225,172.31.36.0-255,66,155135,7,353752
32874,0.001229,74.125.200.0-255,4320,159455,7,353752
32875,0.001238,172.31.36.0-255,66,159521,7,353752
32876,0.001251,74.125.200.0-255,1484,161005,7,353752
32877,0.00126,74.125.200.0-255,7156,168161,7,353752
32878,0.001266,172.31.36.0-255,66,168227,7,353752
32879,0.001286,74.125.200.0-255,5738,173965,7,353752
32880,0.001297,172.31.36.0-255,66,174031,7,353752
32881,0.001329,172.31.36.0-255,66,174097,7,353752
32882,0.001349,74.125.200.0-255,2184,176281,7,353752
32883,0.001355,172.31.36.0-255,66,176347,7,353752
32884,0.00138,74.125.200.0-255,1484,177831,7,353752
32885,0.001394,74.125.200.0-255,2902,180733,7,353752
32886,0.001398,172.31.36.0-255,66,180799,7,353752
32887,0.001427,74.125.200.0-255,5738,186537,7,353752
32888,0.001437,172.31.36.0-255,66,186603,7,353752
32889,0.00147,74.125.200.0-255,1484,188087,7,353752
32890,0.001488,74.125.200.0-255,7156,195243,7,353752
32891,0.001495,172.31.36.0-255,66,195309,7,353752
32892,0.001504,74.125.200.0-255,6438,201747,7,353752
32893,0.001511,172.31.36.0-255,66,201813,7,353752
32894,0.001517,74.125.200.0-255,7156,208969,7,353752
32895,0.001527,172.31.36.0-255,66,209035,7,353752
32896,0.001561,172.31.36.0-255,66,209101,7,353752
32897,0.001591,74.125.200.0-255,4320,213421,7,353752
32898,0.001598,74.125.200.0-255,5738,219159,7,353752
32899,0.001601,172.31.36.0-255,66,219225,7,353752
32900,0.001605,172.31.36.0-255,66,219291,7,353752
32901,0.001635,74.125.200.0-255,5020,224311,7,353752
32902,0.001637,74.125.200.0-255,1484,225795,7,353752
32903,0.00165,172.31.36.0-255,66,225861,7,353752
32904,0.001662,74.125.200.0-255,2902,228763,7,353752
32905,0.001666,74.125.200.0-255,1484,230247,7,353752
32906,0.001672,172.31.36.0-255,66,230313,7,353752
32907,0.001689,74.125.200.0-255,4320,234633,7,353752
32908,0.001692,74.125.200.0-255,1484,236117,7,353752
32909,0.001703,172.31.36.0-255,66,236183,7,353752
32910,0.001721,74.125.200.0-255,2902,239085,7,353752
32911,0.001725,172.31.36.0-255,66,239151,7,353752
32912,0.001728,74.125.200.0-255,1484,240635,7,353752
32913,0.001761,74.125.200.0-255,4320,244955,7,353752
32914,0.001765,74.125.200.0-255,2902,247857,7,353752
32915,0.001768,172.31.36.0-255,66,247923,7,353752
32916,0.001769,74.125.200.0-255,4320,252243,7,353752
32917,0.001773,172.31.36.0-255,66,252309,7,353752
32918,0.001799,74.125.200.0-255,6438,258747,7,353752
32919,0.001807,172.31.36.0-255,66,258813,7,353752
32920,0.001837,74.125.200.0-255,1484,260297,7,353752
32921,0.001851,74.125.200.0-255,2902,263199,7,353752
32922,0.001855,172.31.36.0-255,66,263265,7,353752
32923,0.001865,74.125.200.0-255,2902,266167,7,353752
32924,0.00188,172.31.36.0-255,66,266233,7,353752
32925,0.001888,74.125.200.0-255,2902,269135,7,353752
32926,0.001894,172.31.36.0-255,66,269201,7,353752
32927,0.001907,172.31.36.0-255,66,269267,7,353752
32928,0.001939,172.31.36.0-255,66,269333,7,353752
32929,0.001969,74.125.200.0-255,1484,270817,7,353752
32930,0.001974,74.125.200.0-255,2184,273001,7,353752
32931,0.001987,172.31.36.0-255,66,273067,7,353752
32932,0.002192,74.125.200.0-255,1484,274551,7,353752
32933,0.002199,74.125.200.0-255,2902,277453,7,353752
32934,0.002202,172.31.36.0-255,66,277519,7,353752
32935,0.002225,74.125.200.0-255,5738,283257,7,353752
32936,0.002238,172.31.36.0-255,66,283323,7,353752
32937,0.002239,74.125.200.0-255,2902,286225,7,353752
32938,0.002243,172.31.36.0-255,66,286291,7,353752
32939,0.002259,74.125.200.0-255,5738,292029,7,353752
32940,0.002262,172.31.36.0-255,66,292095,7,353752
32941,0.002295,172.31.36.0-255,66,292161,7,353752
32942,0.002301,74.125.200.0-255,5020,297181,7,353752
32943,0.002308,172.31.36.0-255,66,297247,7,353752
32944,0.002357,74.125.200.0-255,4320,301567,7,353752
32945,0.002362,172.31.36.0-255,66,301633,7,353752
32946,0.002371,74.125.200.0-255,1484,303117,7,353752
32947,0.002391,74.125.200.0-255,1484,304601,7,353752
32948,0.002394,74.125.200.0-255,1484,306085,7,353752
32949,0.002397,172.31.36.0-255,66,306151,7,353752
32950,0.002429,74.125.200.0-255,1484,307635,7,353752
32951,0.002435,74.125.200.0-255,4320,311955,7,353752
32952,0.002436,172.31.36.0-255,66,312021,7,353752
32953,0.002441,172.31.36.0-255,66,312087,7,353752
32954,0.002457,74.125.200.0-255,2902,314989,7,353752
32955,0.00246,74.125.200.0-255,1484,316473,7,353752
32956,0.002462,74.125.200.0-255,1484,317957,7,353752
32957,0.002463,172.31.36.0-255,66,318023,7,353752
32958,0.002504,74.125.200.0-255,2902,320925,7,353752
32959,0.002508,172.31.36.0-255,66,320991,7,353752
32960,0.002512,74.125.200.0-255,1484,322475,7,353752
32961,0.002514,74.125.200.0-255,1484,323959,7,353752
32962,0.002523,172.31.36.0-255,66,324025,7,353752
32963,0.002583,74.125.200.0-255,4320,328345,7,353752
32964,0.002589,74.125.200.0-255,3602,331947,7,353752
32965,0.002593,74.125.200.0-255,4320,336267,7,353752
32966,0.002594,172.31.36.0-255,66,336333,7,353752
32967,0.002595,74.125.200.0-255,1484,337817,7,353752
32968,0.002597,74.125.200.0-255,1484,339301,7,353752
32969,0.0026,74.125.200.0-255,1484,340785,7,353752
32970,0.0026,172.31.36.0-255,66,340851,7,353752
32971,0.002603,74.125.200.0-255,2902,343753,7,353752
32972,0.002614,172.31.36.0-255,66,343819,7,353752
32973,0.002625,74.125.200.0-255,2263,346082,7,353752
32974,0.00263,74.125.200.0-255,97,346179,7,353752
32975,0.002632,172.31.36.0-255,66,346245,7,353752
32976,0.002667,74.125.200.0-255,105,346350,7,353752
32977,0.008025,172.31.36.0-255,66,346416,7,353752
32978,0.008055,172.31.36.0-255,105,346521,7,353752
32979,0.010311,74.125.200.0-255,66,346587,7,353752
32980,0.034046,172.31.36.0-255,172,346759,7,353752
32981,0.034076,172.31.36.0-255,1115,347874,7,353752
32982,0.034125,172.31.36.0-255,1514,349388,7,353752
32983,0.034127,172.31.36.0-255,1514,350902,7,353752
32984,0.034128,172.31.36.0-255,1514,352416,7,353752
32985,0.034152,172.31.36.0-255,1072,353488,7,353752
32986,0.035595,104.244.42.0-255,66,353554,7,353752
32987,0.035647,104.244.42.0-255,66,353620,7,353752
32988,0.035725,104.244.42.0-255,66,353686,7,353752
32989,0.035728,104.244.42.0-255,66,353752,7,353752
32990,0.0,74.125.200.0-255,153,153,7,316458
32991,1.9e-05,172.31.36.0-255,66,219,7,316458
32992,2.7e-05,74.125.200.0-255,1484,1703,7,316458
32993,3.2e-05,172.31.36.0-255,66,1769,7,316458
32994,4.7e-05,74.125.200.0-255,2902,4671,7,316458
32995,5.1e-05,172.31.36.0-255,66,4737,7,316458
32996,5.9e-05,74.125.200.0-255,7156,11893,7,316458
32997,6.2e-05,172.31.36.0-255,66,11959,7,316458
32998,6.6e-05,74.125.200.0-255,1975,13934,7,316458
32999,6.9e-05,172.31.36.0-255,66,14000,7,316458
33000,0.000126,74.125.200.0-255,1484,15484,7,316458
33001,0.000129,172.31.36.0-255,66,15550,7,316458
33002,0.000151,74.125.200.0-255,2902,18452,7,316458
33003,0.000154,172.31.36.0-255,66,18518,7,316458
33004,0.000157,74.125.200.0-255,1484,20002,7,316458
33005,0.00016,172.31.36.0-255,66,20068,7,316458
33006,0.00019,74.125.200.0-255,2902,22970,7,316458
33007,0.000192,172.31.36.0-255,66,23036,7,316458
33008,0.000199,74.125.200.0-255,5738,28774,7,316458
33009,0.000201,172.31.36.0-255,66,28840,7,316458
33010,0.000228,74.125.200.0-255,2543,31383,7,316458
33011,0.000231,172.31.36.0-255,66,31449,7,316458
33012,0.000806,74.125.200.0-255,1484,32933,7,316458
33013,0.000814,172.31.36.0-255,66,32999,7,316458
33014,0.000821,74.125.200.0-255,2902,35901,7,316458
33015,0.000823,172.31.36.0-255,66,35967,7,316458
33016,0.000828,74.125.200.0-255,2902,38869,7,316458
33017,0.00083,172.31.36.0-255,66,38935,7,316458
33018,0.00087,74.125.200.0-255,2902,41837,7,316458
33019,0.000874,172.31.36.0-255,66,41903,7,316458
33020,0.000882,74.125.200.0-255,6797,48700,7,316458
33021,0.000887,74.125.200.0-255,2902,51602,7,316458
33022,0.000892,172.31.36.0-255,66,51668,7,316458
33023,0.000894,172.31.36.0-255,66,51734,7,316458
33024,0.000936,172.31.36.0-255,66,51800,7,316458
33025,0.000943,74.125.200.0-255,5379,57179,7,316458
33026,0.000945,172.31.36.0-255,66,57245,7,316458
33027,0.000948,74.125.200.0-255,645,57890,7,316458
33028,0.001304,74.125.200.0-255,1484,59374,7,316458
33029,0.00131,172.31.36.0-255,66,59440,7,316458
33030,0.001315,74.125.200.0-255,2902,62342,7,316458
33031,0.001317,172.31.36.0-255,66,62408,7,316458
33032,0.001354,74.125.200.0-255,5738,68146,7,316458
33033,0.001357,74.125.200.0-255,2902,71048,7,316458
33034,0.00136,74.125.200.0-255,1484,72532,7,316458
33035,0.001365,172.31.36.0-255,66,72598,7,316458
33036,0.001368,172.31.36.0-255,66,72664,7,316458
33037,0.001387,172.31.36.0-255,66,72730,7,316458
33038,0.001394,74.125.200.0-255,5738,78468,7,316458
33039,0.001396,172.31.36.0-255,66,78534,7,316458
33040,0.001429,74.125.200.0-255,5020,83554,7,316458
33041,0.001432,172.31.36.0-255,66,83620,7,316458
33042,0.002204,74.125.200.0-255,1484,85104,7,316458
33043,0.002214,74.125.200.0-255,2902,88006,7,316458
33044,0.002219,172.31.36.0-255,66,88072,7,316458
33045,0.002227,74.125.200.0-255,4320,92392,7,316458
33046,0.002229,172.31.36.0-255,66,92458,7,316458
33047,0.00226,74.125.200.0-255,1484,93942,7,316458
33048,0.002265,74.125.200.0-255,2902,96844,7,316458
33049,0.002267,172.31.36.0-255,66,96910,7,316458
33050,0.002274,74.125.200.0-255,4320,101230,7,316458
33051,0.002276,172.31.36.0-255,66,101296,7,316458
33052,0.00228,74.125.200.0-255,2902,104198,7,316458
33053,0.002282,172.31.36.0-255,66,104264,7,316458
33054,0.002315,74.125.200.0-255,5738,110002,7,316458
33055,0.002318,172.31.36.0-255,66,110068,7,316458
33056,0.002324,74.125.200.0-255,4320,114388,7,316458
33057,0.002326,172.31.36.0-255,66,114454,7,316458
33058,0.00236,74.125.200.0-255,3602,118056,7,316458
33059,0.002362,172.31.36.0-255,66,118122,7,316458
33060,0.002465,74.125.200.0-255,1484,119606,7,316458
33061,0.002486,74.125.200.0-255,2902,122508,7,316458
33062,0.002489,172.31.36.0-255,66,122574,7,316458
33063,0.002493,74.125.200.0-255,1484,124058,7,316458
33064,0.002522,74.125.200.0-255,2902,126960,7,316458
33065,0.002525,172.31.36.0-255,66,127026,7,316458
33066,0.002534,74.125.200.0-255,5738,132764,7,316458
33067,0.002541,172.31.36.0-255,66,132830,7,316458
33068,0.002573,172.31.36.0-255,66,132896,7,316458
33069,0.002596,74.125.200.0-255,1484,134380,7,316458
33070,0.002612,74.125.200.0-255,4320,138700,7,316458
33071,0.002615,172.31.36.0-255,66,138766,7,316458
33072,0.002642,74.125.200.0-255,5020,143786,7,316458
33073,0.002645,172.31.36.0-255,66,143852,7,316458
33074,0.005245,74.125.200.0-255,5738,149590,7,316458
33075,0.005253,172.31.36.0-255,66,149656,7,316458
33076,0.007905,74.125.200.0-255,5738,155394,7,316458
33077,0.00791,172.31.36.0-255,66,155460,7,316458
33078,0.010516,74.125.200.0-255,5738,161198,7,316458
33079,0.010524,172.31.36.0-255,66,161264,7,316458
33080,0.013122,74.125.200.0-255,5738,167002,7,316458
33081,0.01313,172.31.36.0-255,66,167068,7,316458
33082,0.01577,74.125.200.0-255,5738,172806,7,316458
33083,0.015779,172.31.36.0-255,66,172872,7,316458
33084,0.018387,74.125.200.0-255,5738,178610,7,316458
33085,0.0184,172.31.36.0-255,66,178676,7,316458
33086,0.021009,74.125.200.0-255,5738,184414,7,316458
33087,0.021018,172.31.36.0-255,66,184480,7,316458
33088,0.023633,74.125.200.0-255,5738,190218,7,316458
33089,0.023643,172.31.36.0-255,66,190284,7,316458
33090,0.026251,74.125.200.0-255,5738,196022,7,316458
33091,0.026259,172.31.36.0-255,66,196088,7,316458
33092,0.028861,74.125.200.0-255,5738,201826,7,316458
33093,0.028876,172.31.36.0-255,66,201892,7,316458
33094,0.031477,74.125.200.0-255,5738,207630,7,316458
33095,0.031485,172.31.36.0-255,66,207696,7,316458
33096,0.032929,172.31.36.0-255,172,207868,7,316458
33097,0.032962,172.31.36.0-255,1116,208984,7,316458
33098,0.033019,172.31.36.0-255,1514,210498,7,316458
33099,0.03302,172.31.36.0-255,1290,211788,7,316458
33100,0.034091,74.125.200.0-255,5738,217526,7,316458
33101,0.034099,172.31.36.0-255,66,217592,7,316458
33102,0.034481,104.244.42.0-255,66,217658,7,316458
33103,0.034525,104.244.42.0-255,66,217724,7,316458
33104,0.034573,104.244.42.0-255,66,217790,7,316458
33105,0.036694,74.125.200.0-255,5738,223528,7,316458
33106,0.036699,172.31.36.0-255,66,223594,7,316458
33107,0.039306,74.125.200.0-255,5738,229332,7,316458
33108,0.039333,172.31.36.0-255,66,229398,7,316458
33109,0.041946,74.125.200.0-255,5738,235136,7,316458
33110,0.041961,172.31.36.0-255,66,235202,7,316458
33111,0.044605,74.125.200.0-255,5738,240940,7,316458
33112,0.04462,172.31.36.0-255,66,241006,7,316458
33113,0.047259,74.125.200.0-255,5738,246744,7,316458
33114,0.047267,172.31.36.0-255,66,246810,7,316458
33115,0.049884,74.125.200.0-255,5738,252548,7,316458
33116,0.049891,172.31.36.0-255,66,252614,7,316458
33117,0.052497,74.125.200.0-255,5738,258352,7,316458
33118,0.052505,172.31.36.0-255,66,258418,7,316458
33119,0.055116,74.125.200.0-255,5738,264156,7,316458
33120,0.055122,172.31.36.0-255,66,264222,7,316458
33121,0.057713,74.125.200.0-255,5738,269960,7,316458
33122,0.05772,172.31.36.0-255,66,270026,7,316458
33123,0.060398,74.125.200.0-255,5738,275764,7,316458
33124,0.060405,172.31.36.0-255,66,275830,7,316458
33125,0.063066,74.125.200.0-255,5738,281568,7,316458
33126,0.063078,172.31.36.0-255,66,281634,7,316458
33127,0.065722,74.125.200.0-255,5738,287372,7,316458
33128,0.065731,172.31.36.0-255,66,287438,7,316458
33129,0.068334,74.125.200.0-255,5738,293176,7,316458
33130,0.068342,172.31.36.0-255,66,293242,7,316458
33131,0.070953,74.125.200.0-255,5738,298980,7,316458
33132,0.07096,172.31.36.0-255,66,299046,7,316458
33133,0.07356,74.125.200.0-255,5738,304784,7,316458
33134,0.073567,172.31.36.0-255,66,304850,7,316458
33135,0.076172,74.125.200.0-255,5738,310588,7,316458
33136,0.076179,172.31.36.0-255,66,310654,7,316458
33137,0.078785,74.125.200.0-255,5738,316392,7,316458
33138,0.078796,172.31.36.0-255,66,316458,7,316458
33139,0.0,74.125.24.0-255,153,153,7,238929
33140,1.4e-05,172.31.36.0-255,66,219,7,238929
33141,2.1e-05,74.125.24.0-255,1484,1703,7,238929
33142,3.8e-05,172.31.36.0-255,66,1769,7,238929
33143,4.5e-05,74.125.24.0-255,2902,4671,7,238929
33144,4.9e-05,172.31.36.0-255,66,4737,7,238929
33145,5.7e-05,74.125.24.0-255,7156,11893,7,238929
33146,5.9e-05,172.31.36.0-255,66,11959,7,238929
33147,6.4e-05,74.125.24.0-255,2014,13973,7,238929
33148,6.7e-05,172.31.36.0-255,66,14039,7,238929
33149,8e-05,172.31.36.0-255,66,14105,7,238929
33150,8.6e-05,74.125.24.0-255,4320,18425,7,238929
33151,8.9e-05,172.31.36.0-255,66,18491,7,238929
33152,0.000115,74.125.24.0-255,1125,19616,7,238929
33153,0.000118,172.31.36.0-255,66,19682,7,238929
33154,0.000147,74.125.24.0-255,1484,21166,7,238929
33155,0.000149,172.31.36.0-255,66,21232,7,238929
33156,0.000153,74.125.24.0-255,1484,22716,7,238929
33157,0.000155,172.31.36.0-255,66,22782,7,238929
33158,0.000168,74.125.24.0-255,1484,24266,7,238929
33159,0.000171,172.31.36.0-255,66,24332,7,238929
33160,0.000179,74.125.24.0-255,5738,30070,7,238929
33161,0.000181,172.31.36.0-255,66,30136,7,238929
33162,0.0002,74.125.24.0-255,6797,36933,7,238929
33163,0.000203,172.31.36.0-255,66,36999,7,238929
33164,0.000219,74.125.24.0-255,1484,38483,7,238929
33165,0.000221,172.31.36.0-255,66,38549,7,238929
33166,0.000238,74.125.24.0-255,5738,44287,7,238929
33167,0.000241,172.31.36.0-255,66,44353,7,238929
33168,0.000248,74.125.24.0-255,5738,50091,7,238929
33169,0.00025,172.31.36.0-255,66,50157,7,238929
33170,0.000269,74.125.24.0-255,2902,53059,7,238929
33171,0.000275,172.31.36.0-255,66,53125,7,238929
33172,0.000282,74.125.24.0-255,1418,54543,7,238929
33173,0.000318,74.125.24.0-255,135,54678,7,238929
33174,0.000339,74.125.24.0-255,346,55024,7,238929
33175,0.000461,74.125.24.0-255,1484,56508,7,238929
33176,0.000466,74.125.24.0-255,2902,59410,7,238929
33177,0.00047,74.125.24.0-255,1484,60894,7,238929
33178,0.000488,74.125.24.0-255,4320,65214,7,238929
33179,0.000526,74.125.24.0-255,4320,69534,7,238929
33180,0.000543,74.125.24.0-255,1994,71528,7,238929
33181,0.000581,172.31.36.0-255,66,71594,7,238929
33182,0.000749,74.125.24.0-255,1484,73078,7,238929
33183,0.000756,74.125.24.0-255,2902,75980,7,238929
33184,0.000775,74.125.24.0-255,5738,81718,7,238929
33185,0.000785,172.31.36.0-255,66,81784,7,238929
33186,0.000809,172.31.36.0-255,66,81850,7,238929
33187,0.000815,74.125.24.0-255,4320,86170,7,238929
33188,0.00082,74.125.24.0-255,4320,90490,7,238929
33189,0.000833,74.125.24.0-255,4320,94810,7,238929
33190,0.00085,74.125.24.0-255,2184,96994,7,238929
33191,0.000865,172.31.36.0-255,66,97060,7,238929
33192,0.000977,74.125.24.0-255,1484,98544,7,238929
33193,0.000983,74.125.24.0-255,2902,101446,7,238929
33194,0.000991,172.31.36.0-255,66,101512,7,238929
33195,0.001008,74.125.24.0-255,5738,107250,7,238929
33196,0.001011,74.125.24.0-255,1484,108734,7,238929
33197,0.001028,172.31.36.0-255,66,108800,7,238929
33198,0.001062,74.125.24.0-255,5379,114179,7,238929
33199,0.001069,74.125.24.0-255,5738,119917,7,238929
33200,0.001084,74.125.24.0-255,4320,124237,7,238929
33201,0.001099,172.31.36.0-255,66,124303,7,238929
33202,0.001114,74.125.24.0-255,5738,130041,7,238929
33203,0.00112,172.31.36.0-255,66,130107,7,238929
33204,0.001134,74.125.24.0-255,7156,137263,7,238929
33205,0.001152,74.125.24.0-255,2184,139447,7,238929
33206,0.001159,172.31.36.0-255,66,139513,7,238929
33207,0.001252,74.125.24.0-255,1484,140997,7,238929
33208,0.001257,74.125.24.0-255,1484,142481,7,238929
33209,0.001273,74.125.24.0-255,1484,143965,7,238929
33210,0.001281,74.125.24.0-255,5738,149703,7,238929
33211,0.001293,74.125.24.0-255,4320,154023,7,238929
33212,0.001301,172.31.36.0-255,66,154089,7,238929
33213,0.00133,172.31.36.0-255,66,154155,7,238929
33214,0.001521,74.125.24.0-255,1484,155639,7,238929
33215,0.001527,74.125.24.0-255,2902,158541,7,238929
33216,0.00154,74.125.24.0-255,1484,160025,7,238929
33217,0.001556,74.125.24.0-255,4320,164345,7,238929
33218,0.001562,74.125.24.0-255,4320,168665,7,238929
33219,0.001566,172.31.36.0-255,66,168731,7,238929
33220,0.001575,74.125.24.0-255,1484,170215,7,238929
33221,0.001579,172.31.36.0-255,66,170281,7,238929
33222,0.001589,74.125.24.0-255,4320,174601,7,238929
33223,0.001614,74.125.24.0-255,5020,179621,7,238929
33224,0.001631,172.31.36.0-255,66,179687,7,238929
33225,0.001924,74.125.24.0-255,1484,181171,7,238929
33226,0.00194,74.125.24.0-255,2902,184073,7,238929
33227,0.001944,172.31.36.0-255,66,184139,7,238929
33228,0.001948,74.125.24.0-255,1484,185623,7,238929
33229,0.001967,74.125.24.0-255,4320,189943,7,238929
33230,0.001972,74.125.24.0-255,4320,194263,7,238929
33231,0.001977,172.31.36.0-255,66,194329,7,238929
33232,0.001987,74.125.24.0-255,1484,195813,7,238929
33233,0.002071,74.125.24.0-255,2902,198715,7,238929
33234,0.00209,74.125.24.0-255,5738,204453,7,238929
33235,0.002123,74.125.24.0-255,2902,207355,7,238929
33236,0.002185,74.125.24.0-255,1484,208839,7,238929
33237,0.002203,74.125.24.0-255,2902,211741,7,238929
33238,0.002209,74.125.24.0-255,4320,216061,7,238929
33239,0.00223,74.125.24.0-255,1484,217545,7,238929
33240,0.002234,74.125.24.0-255,2902,220447,7,238929
33241,0.002283,74.125.24.0-255,5738,226185,7,238929
33242,0.002305,74.125.24.0-255,5020,231205,7,238929
33243,0.00231,74.125.24.0-255,2902,234107,7,238929
33244,0.002477,74.125.24.0-255,105,234212,7,238929
33245,0.006511,172.31.36.0-255,66,234278,7,238929
33246,0.008796,172.31.36.0-255,105,234383,7,238929
33247,0.011325,74.125.24.0-255,66,234449,7,238929
33248,0.034846,172.31.36.0-255,188,234637,7,238929
33249,0.034881,172.31.36.0-255,958,235595,7,238929
33250,0.034944,172.31.36.0-255,1514,237109,7,238929
33251,0.034946,172.31.36.0-255,1448,238557,7,238929
33252,0.036407,104.244.42.0-255,66,238623,7,238929
33253,0.036436,104.244.42.0-255,66,238689,7,238929
33254,0.036556,104.244.42.0-255,66,238755,7,238929
33255,0.037582,104.244.42.0-255,108,238863,7,238929
33256,0.037589,172.31.36.0-255,66,238929,7,238929
33257,0.0,74.125.68.0-255,66,66,7,66
33258,0.0,172.217.194.0-255,153,153,7,171363
33259,3.9e-05,172.31.36.0-255,66,219,7,171363
33260,4.7e-05,172.217.194.0-255,1484,1703,7,171363
33261,5e-05,172.31.36.0-255,66,1769,7,171363
33262,5.5e-05,172.217.194.0-255,2902,4671,7,171363
33263,5.8e-05,172.31.36.0-255,66,4737,7,171363
33264,7.3e-05,172.217.194.0-255,5738,10475,7,171363
33265,7.6e-05,172.31.36.0-255,66,10541,7,171363
33266,8.1e-05,172.217.194.0-255,3518,14059,7,171363
33267,8.4e-05,172.31.36.0-255,66,14125,7,171363
33268,0.000185,172.217.194.0-255,1484,15609,7,171363
33269,0.00019,172.31.36.0-255,66,15675,7,171363
33270,0.000196,172.217.194.0-255,2902,18577,7,171363
33271,0.000198,172.31.36.0-255,66,18643,7,171363
33272,0.000201,172.217.194.0-255,1484,20127,7,171363
33273,0.000203,172.31.36.0-255,66,20193,7,171363
33274,0.000233,172.217.194.0-255,4320,24513,7,171363
33275,0.000236,172.31.36.0-255,66,24579,7,171363
33276,0.000243,172.217.194.0-255,6797,31376,7,171363
33277,0.000245,172.31.36.0-255,66,31442,7,171363
33278,0.000299,172.31.36.0-255,66,31508,7,171363
33279,0.000314,172.31.36.0-255,66,31574,7,171363
33280,0.000349,172.217.194.0-255,5299,36873,7,171363
33281,0.000352,172.31.36.0-255,66,36939,7,171363
33282,0.000355,172.217.194.0-255,398,37337,7,171363
33283,0.000357,172.31.36.0-255,66,37403,7,171363
33284,0.000413,172.217.194.0-255,1484,38887,7,171363
33285,0.000417,172.31.36.0-255,66,38953,7,171363
33286,0.000422,172.217.194.0-255,2902,41855,7,171363
33287,0.000425,172.31.36.0-255,66,41921,7,171363
33288,0.000453,172.217.194.0-255,5738,47659,7,171363
33289,0.000459,172.31.36.0-255,66,47725,7,171363
33290,0.00049,172.217.194.0-255,6797,54522,7,171363
33291,0.000494,172.31.36.0-255,66,54588,7,171363
33292,0.000502,172.217.194.0-255,7156,61744,7,171363
33293,0.000505,172.31.36.0-255,66,61810,7,171363
33294,0.000534,172.217.194.0-255,7156,68966,7,171363
33295,0.000538,172.31.36.0-255,66,69032,7,171363
33296,0.000566,172.217.194.0-255,2543,71575,7,171363
33297,0.000569,172.31.36.0-255,66,71641,7,171363
33298,0.000804,172.217.194.0-255,1484,73125,7,171363
33299,0.000811,172.217.194.0-255,2902,76027,7,171363
33300,0.000814,172.31.36.0-255,66,76093,7,171363
33301,0.000846,172.217.194.0-255,5738,81831,7,171363
33302,0.000849,172.31.36.0-255,66,81897,7,171363
33303,0.000856,172.217.194.0-255,5738,87635,7,171363
33304,0.000858,172.31.36.0-255,66,87701,7,171363
33305,0.00088,172.31.36.0-255,66,87767,7,171363
33306,0.000888,172.217.194.0-255,4471,92238,7,171363
33307,0.00089,172.31.36.0-255,66,92304,7,171363
33308,0.000932,172.217.194.0-255,4320,96624,7,171363
33309,0.000935,172.31.36.0-255,66,96690,7,171363
33310,0.000962,172.217.194.0-255,1484,98174,7,171363
33311,0.000968,172.217.194.0-255,4320,102494,7,171363
33312,0.000972,172.31.36.0-255,66,102560,7,171363
33313,0.00098,172.31.36.0-255,66,102626,7,171363
33314,0.001001,172.217.194.0-255,2902,105528,7,171363
33315,0.001004,172.31.36.0-255,66,105594,7,171363
33316,0.001039,172.31.36.0-255,66,105660,7,171363
33317,0.001091,172.217.194.0-255,1484,107144,7,171363
33318,0.001104,172.217.194.0-255,2902,110046,7,171363
33319,0.001107,172.31.36.0-255,66,110112,7,171363
33320,0.001161,172.217.194.0-255,2902,113014,7,171363
33321,0.001164,172.31.36.0-255,66,113080,7,171363
33322,0.001192,172.217.194.0-255,2902,115982,7,171363
33323,0.001195,172.31.36.0-255,66,116048,7,171363
33324,0.001209,172.31.36.0-255,66,116114,7,171363
33325,0.001212,172.217.194.0-255,1484,117598,7,171363
33326,0.001222,172.31.36.0-255,66,117664,7,171363
33327,0.001831,172.217.194.0-255,1484,119148,7,171363
33328,0.001836,172.217.194.0-255,2902,122050,7,171363
33329,0.001839,172.31.36.0-255,66,122116,7,171363
33330,0.001845,172.217.194.0-255,2902,125018,7,171363
33331,0.001847,172.31.36.0-255,66,125084,7,171363
33332,0.001879,172.217.194.0-255,2902,127986,7,171363
33333,0.001883,172.31.36.0-255,66,128052,7,171363
33334,0.001897,172.31.36.0-255,66,128118,7,171363
33335,0.001909,172.31.36.0-255,66,128184,7,171363
33336,0.001936,172.217.194.0-255,766,128950,7,171363
33337,0.002041,172.217.194.0-255,1484,130434,7,171363
33338,0.002045,172.31.36.0-255,66,130500,7,171363
33339,0.00205,172.217.194.0-255,2902,133402,7,171363
33340,0.002052,172.31.36.0-255,66,133468,7,171363
33341,0.002058,172.217.194.0-255,4320,137788,7,171363
33342,0.002065,172.31.36.0-255,66,137854,7,171363
33343,0.002103,172.217.194.0-255,1484,139338,7,171363
33344,0.002123,172.31.36.0-255,66,139404,7,171363
33345,0.002135,172.31.36.0-255,66,139470,7,171363
33346,0.00219,172.31.36.0-255,66,139536,7,171363
33347,0.002195,172.217.194.0-255,2902,142438,7,171363
33348,0.002197,172.31.36.0-255,66,142504,7,171363
33349,0.002242,172.31.36.0-255,66,142570,7,171363
33350,0.002256,172.31.36.0-255,66,142636,7,171363
33351,0.002288,172.31.36.0-255,66,142702,7,171363
33352,0.002332,172.31.36.0-255,66,142768,7,171363
33353,0.002384,172.217.194.0-255,7156,149924,7,171363
33354,0.002388,172.31.36.0-255,66,149990,7,171363
33355,0.002429,172.31.36.0-255,66,150056,7,171363
33356,0.002449,172.31.36.0-255,66,150122,7,171363
33357,0.004786,172.217.194.0-255,5738,155860,7,171363
33358,0.004794,172.31.36.0-255,66,155926,7,171363
33359,0.007145,172.217.194.0-255,5738,161664,7,171363
33360,0.007151,172.31.36.0-255,66,161730,7,171363
33361,0.009477,172.217.194.0-255,4912,166642,7,171363
33362,0.009483,172.31.36.0-255,66,166708,7,171363
33363,0.00969,172.31.36.0-255,105,166813,7,171363
33364,0.012,172.217.194.0-255,66,166879,7,171363
33365,0.031626,172.31.36.0-255,190,167069,7,171363
33366,0.031655,172.31.36.0-255,1114,168183,7,171363
33367,0.031698,172.31.36.0-255,1514,169697,7,171363
33368,0.0317,172.31.36.0-255,1294,170991,7,171363
33369,0.033185,104.244.42.0-255,66,171057,7,171363
33370,0.033211,104.244.42.0-255,66,171123,7,171363
33371,0.033256,104.244.42.0-255,66,171189,7,171363
33372,0.03389,104.244.42.0-255,108,171297,7,171363
33373,0.033894,172.31.36.0-255,66,171363,7,171363
33374,0.0,74.125.24.0-255,153,153,7,346829
33375,1.3e-05,172.31.36.0-255,66,219,7,346829
33376,1.9e-05,74.125.24.0-255,1484,1703,7,346829
33377,2.3e-05,172.31.36.0-255,66,1769,7,346829
33378,2.8e-05,74.125.24.0-255,2902,4671,7,346829
33379,3.1e-05,172.31.36.0-255,66,4737,7,346829
33380,4.7e-05,74.125.24.0-255,7156,11893,7,346829
33381,5.1e-05,172.31.36.0-255,66,11959,7,346829
33382,5.5e-05,74.125.24.0-255,2016,13975,7,346829
33383,5.8e-05,172.31.36.0-255,66,14041,7,346829
33384,0.000216,74.125.24.0-255,1484,15525,7,346829
33385,0.00022,172.31.36.0-255,66,15591,7,346829
33386,0.000226,74.125.24.0-255,2902,18493,7,346829
33387,0.000229,172.31.36.0-255,66,18559,7,346829
33388,0.000239,74.125.24.0-255,5738,24297,7,346829
33389,0.000242,172.31.36.0-255,66,24363,7,346829
33390,0.000247,74.125.24.0-255,4320,28683,7,346829
33391,0.000249,172.31.36.0-255,66,28749,7,346829
33392,0.000269,74.125.24.0-255,2543,31292,7,346829
33393,0.000271,172.31.36.0-255,66,31358,7,346829
33394,0.000327,74.125.24.0-255,1484,32842,7,346829
33395,0.000329,172.31.36.0-255,66,32908,7,346829
33396,0.000334,74.125.24.0-255,2902,35810,7,346829
33397,0.000336,172.31.36.0-255,66,35876,7,346829
33398,0.000339,74.125.24.0-255,1484,37360,7,346829
33399,0.000341,172.31.36.0-255,66,37426,7,346829
33400,0.000365,74.125.24.0-255,4320,41746,7,346829
33401,0.000368,172.31.36.0-255,66,41812,7,346829
33402,0.000374,74.125.24.0-255,5738,47550,7,346829
33403,0.000375,172.31.36.0-255,66,47616,7,346829
33404,0.00038,74.125.24.0-255,4320,51936,7,346829
33405,0.000382,172.31.36.0-255,66,52002,7,346829
33406,0.000419,172.31.36.0-255,66,52068,7,346829
33407,0.000424,74.125.24.0-255,4237,56305,7,346829
33408,0.000426,172.31.36.0-255,66,56371,7,346829
33409,0.000452,74.125.24.0-255,129,56500,7,346829
33410,0.000542,74.125.24.0-255,349,56849,7,346829
33411,0.000819,74.125.24.0-255,1484,58333,7,346829
33412,0.000823,172.31.36.0-255,66,58399,7,346829
33413,0.000829,74.125.24.0-255,2902,61301,7,346829
33414,0.00083,172.31.36.0-255,66,61367,7,346829
33415,0.000836,74.125.24.0-255,4320,65687,7,346829
33416,0.000838,172.31.36.0-255,66,65753,7,346829
33417,0.000867,74.125.24.0-255,1484,67237,7,346829
33418,0.000879,172.31.36.0-255,66,67303,7,346829
33419,0.000912,74.125.24.0-255,2902,70205,7,346829
33420,0.000914,172.31.36.0-255,66,70271,7,346829
33421,0.000934,172.31.36.0-255,66,70337,7,346829
33422,0.001385,74.125.24.0-255,1484,71821,7,346829
33423,0.001394,74.125.24.0-255,2902,74723,7,346829
33424,0.001397,172.31.36.0-255,66,74789,7,346829
33425,0.001404,74.125.24.0-255,5738,80527,7,346829
33426,0.001405,172.31.36.0-255,66,80593,7,346829
33427,0.001431,74.125.24.0-255,1484,82077,7,346829
33428,0.001454,74.125.24.0-255,5738,87815,7,346829
33429,0.001456,172.31.36.0-255,66,87881,7,346829
33430,0.001465,172.31.36.0-255,66,87947,7,346829
33431,0.001467,74.125.24.0-255,1484,89431,7,346829
33432,0.001499,74.125.24.0-255,6438,95869,7,346829
33433,0.001502,172.31.36.0-255,66,95935,7,346829
33434,0.001568,74.125.24.0-255,1484,97419,7,346829
33435,0.001573,74.125.24.0-255,2902,100321,7,346829
33436,0.001576,172.31.36.0-255,66,100387,7,346829
33437,0.00158,74.125.24.0-255,2902,103289,7,346829
33438,0.001582,172.31.36.0-255,66,103355,7,346829
33439,0.001612,74.125.24.0-255,2902,106257,7,346829
33440,0.001614,172.31.36.0-255,66,106323,7,346829
33441,0.001627,172.31.36.0-255,66,106389,7,346829
33442,0.001634,74.125.24.0-255,7156,113545,7,346829
33443,0.001636,172.31.36.0-255,66,113611,7,346829
33444,0.001674,74.125.24.0-255,3602,117213,7,346829
33445,0.001677,172.31.36.0-255,66,117279,7,346829
33446,0.003588,74.125.24.0-255,1484,118763,7,346829
33447,0.003623,74.125.24.0-255,4320,123083,7,346829
33448,0.003634,172.31.36.0-255,66,123149,7,346829
33449,0.005597,74.125.24.0-255,5738,128887,7,346829
33450,0.005603,172.31.36.0-255,66,128953,7,346829
33451,0.007538,74.125.24.0-255,5738,134691,7,346829
33452,0.007544,172.31.36.0-255,66,134757,7,346829
33453,0.009516,74.125.24.0-255,5738,140495,7,346829
33454,0.009522,172.31.36.0-255,66,140561,7,346829
33455,0.011471,74.125.24.0-255,5738,146299,7,346829
33456,0.011477,172.31.36.0-255,66,146365,7,346829
33457,0.013449,74.125.24.0-255,5738,152103,7,346829
33458,0.013458,172.31.36.0-255,66,152169,7,346829
33459,0.015423,74.125.24.0-255,5738,157907,7,346829
33460,0.015434,172.31.36.0-255,66,157973,7,346829
33461,0.017416,74.125.24.0-255,5738,163711,7,346829
33462,0.017426,172.31.36.0-255,66,163777,7,346829
33463,0.019384,74.125.24.0-255,5738,169515,7,346829
33464,0.019392,172.31.36.0-255,66,169581,7,346829
33465,0.021352,74.125.24.0-255,5738,175319,7,346829
33466,0.02136,172.31.36.0-255,66,175385,7,346829
33467,0.023329,74.125.24.0-255,5738,181123,7,346829
33468,0.023336,172.31.36.0-255,66,181189,7,346829
33469,0.025293,74.125.24.0-255,5738,186927,7,346829
33470,0.025302,172.31.36.0-255,66,186993,7,346829
33471,0.027281,74.125.24.0-255,5738,192731,7,346829
33472,0.027288,172.31.36.0-255,66,192797,7,346829
33473,0.028941,172.31.36.0-255,188,192985,7,346829
33474,0.028975,172.31.36.0-255,958,193943,7,346829
33475,0.029038,172.31.36.0-255,1514,195457,7,346829
33476,0.02904,172.31.36.0-255,1448,196905,7,346829
33477,0.029252,74.125.24.0-255,5738,202643,7,346829
33478,0.029259,172.31.36.0-255,66,202709,7,346829
33479,0.030479,104.244.42.0-255,66,202775,7,346829
33480,0.030488,104.244.42.0-255,66,202841,7,346829
33481,0.030596,104.244.42.0-255,66,202907,7,346829
33482,0.03102,104.244.42.0-255,108,203015,7,346829
33483,0.031026,172.31.36.0-255,66,203081,7,346829
33484,0.031211,74.125.24.0-255,5738,208819,7,346829
33485,0.031216,172.31.36.0-255,66,208885,7,346829
33486,0.033184,74.125.24.0-255,5738,214623,7,346829
33487,0.033191,172.31.36.0-255,66,214689,7,346829
33488,0.035186,74.125.24.0-255,5738,220427,7,346829
33489,0.035192,172.31.36.0-255,66,220493,7,346829
33490,0.037153,74.125.24.0-255,5738,226231,7,346829
33491,0.037159,172.31.36.0-255,66,226297,7,346829
33492,0.039132,74.125.24.0-255,5738,232035,7,346829
33493,0.039139,172.31.36.0-255,66,232101,7,346829
33494,0.041104,74.125.24.0-255,5738,237839,7,346829
33495,0.04111,172.31.36.0-255,66,237905,7,346829
33496,0.043072,74.125.24.0-255,5738,243643,7,346829
33497,0.043079,172.31.36.0-255,66,243709,7,346829
33498,0.045069,74.125.24.0-255,5738,249447,7,346829
33499,0.045079,172.31.36.0-255,66,249513,7,346829
33500,0.047047,74.125.24.0-255,5738,255251,7,346829
33501,0.047054,172.31.36.0-255,66,255317,7,346829
33502,0.049016,74.125.24.0-255,5738,261055,7,346829
33503,0.049022,172.31.36.0-255,66,261121,7,346829
33504,0.050956,74.125.24.0-255,5738,266859,7,346829
33505,0.050963,172.31.36.0-255,66,266925,7,346829
33506,0.052918,74.125.24.0-255,5738,272663,7,346829
33507,0.052925,172.31.36.0-255,66,272729,7,346829
33508,0.054892,74.125.24.0-255,5738,278467,7,346829
33509,0.054898,172.31.36.0-255,66,278533,7,346829
33510,0.056841,74.125.24.0-255,5738,284271,7,346829
33511,0.056848,172.31.36.0-255,66,284337,7,346829
33512,0.058782,74.125.24.0-255,5738,290075,7,346829
33513,0.058789,172.31.36.0-255,66,290141,7,346829
33514,0.06073,74.125.24.0-255,5738,295879,7,346829
33515,0.060736,172.31.36.0-255,66,295945,7,346829
33516,0.062703,74.125.24.0-255,5738,301683,7,346829
33517,0.062709,172.31.36.0-255,66,301749,7,346829
33518,0.064686,74.125.24.0-255,5738,307487,7,346829
33519,0.064693,172.31.36.0-255,66,307553,7,346829
33520,0.066654,74.125.24.0-255,5738,313291,7,346829
33521,0.06666,172.31.36.0-255,66,313357,7,346829
33522,0.06861,74.125.24.0-255,5738,319095,7,346829
33523,0.068616,172.31.36.0-255,66,319161,7,346829
33524,0.070576,74.125.24.0-255,5738,324899,7,346829
33525,0.070582,172.31.36.0-255,66,324965,7,346829
33526,0.072538,74.125.24.0-255,4320,329285,7,346829
33527,0.072545,172.31.36.0-255,66,329351,7,346829
33528,0.072568,74.125.24.0-255,1484,330835,7,346829
33529,0.074501,74.125.24.0-255,4320,335155,7,346829
33530,0.074508,172.31.36.0-255,66,335221,7,346829
33531,0.076461,74.125.24.0-255,5738,340959,7,346829
33532,0.076466,172.31.36.0-255,66,341025,7,346829
33533,0.078441,74.125.24.0-255,5738,346763,7,346829
33534,0.078447,172.31.36.0-255,66,346829,7,346829
33535,0.0,74.125.130.0-255,152,152,7,361577
33536,1.9e-05,172.31.36.0-255,66,218,7,361577
33537,2.7e-05,74.125.130.0-255,1484,1702,7,361577
33538,3.2e-05,172.31.36.0-255,66,1768,7,361577
33539,3.8e-05,74.125.130.0-255,2902,4670,7,361577
33540,4e-05,172.31.36.0-255,66,4736,7,361577
33541,4.4e-05,74.125.130.0-255,1484,6220,7,361577
33542,4.6e-05,172.31.36.0-255,66,6286,7,361577
33543,6.8e-05,74.125.130.0-255,2902,9188,7,361577
33544,7.1e-05,172.31.36.0-255,66,9254,7,361577
33545,8.7e-05,74.125.130.0-255,2902,12156,7,361577
33546,8.9e-05,172.31.36.0-255,66,12222,7,361577
33547,0.00012,74.125.130.0-255,3440,15662,7,361577
33548,0.000122,172.31.36.0-255,66,15728,7,361577
33549,0.000125,74.125.130.0-255,1484,17212,7,361577
33550,0.000127,172.31.36.0-255,66,17278,7,361577
33551,0.000191,74.125.130.0-255,2902,20180,7,361577
33552,0.000194,172.31.36.0-255,66,20246,7,361577
33553,0.000215,74.125.130.0-255,4320,24566,7,361577
33554,0.000217,172.31.36.0-255,66,24632,7,361577
33555,0.000235,74.125.130.0-255,2902,27534,7,361577
33556,0.000237,172.31.36.0-255,66,27600,7,361577
33557,0.000258,74.125.130.0-255,1484,29084,7,361577
33558,0.000261,172.31.36.0-255,66,29150,7,361577
33559,0.000296,74.125.130.0-255,2543,31693,7,361577
33560,0.000299,172.31.36.0-255,66,31759,7,361577
33561,0.000597,74.125.130.0-255,1484,33243,7,361577
33562,0.000603,172.31.36.0-255,66,33309,7,361577
33563,0.00061,74.125.130.0-255,2902,36211,7,361577
33564,0.000612,172.31.36.0-255,66,36277,7,361577
33565,0.000632,74.125.130.0-255,2902,39179,7,361577
33566,0.000634,172.31.36.0-255,66,39245,7,361577
33567,0.000656,74.125.130.0-255,2902,42147,7,361577
33568,0.000658,172.31.36.0-255,66,42213,7,361577
33569,0.000687,74.125.130.0-255,6797,49010,7,361577
33570,0.000691,172.31.36.0-255,66,49076,7,361577
33571,0.000722,74.125.130.0-255,1484,50560,7,361577
33572,0.000741,74.125.130.0-255,2902,53462,7,361577
33573,0.000744,172.31.36.0-255,66,53528,7,361577
33574,0.000767,74.125.130.0-255,4320,57848,7,361577
33575,0.00077,172.31.36.0-255,66,57914,7,361577
33576,0.000788,74.125.130.0-255,2902,60816,7,361577
33577,0.000793,172.31.36.0-255,66,60882,7,361577
33578,0.000807,74.125.130.0-255,2902,63784,7,361577
33579,0.00081,172.31.36.0-255,66,63850,7,361577
33580,0.000847,74.125.130.0-255,3123,66973,7,361577
33581,0.00085,172.31.36.0-255,66,67039,7,361577
33582,0.000962,74.125.130.0-255,1484,68523,7,361577
33583,0.000982,74.125.130.0-255,2902,71425,7,361577
33584,0.000985,172.31.36.0-255,66,71491,7,361577
33585,0.001022,74.125.130.0-255,2902,74393,7,361577
33586,0.001025,172.31.36.0-255,66,74459,7,361577
33587,0.001043,74.125.130.0-255,1484,75943,7,361577
33588,0.001047,74.125.130.0-255,1484,77427,7,361577
33589,0.001049,172.31.36.0-255,66,77493,7,361577
33590,0.001053,74.125.130.0-255,2902,80395,7,361577
33591,0.001055,172.31.36.0-255,66,80461,7,361577
33592,0.001093,74.125.130.0-255,3961,84422,7,361577
33593,0.001096,172.31.36.0-255,66,84488,7,361577
33594,0.001191,74.125.130.0-255,1484,85972,7,361577
33595,0.001207,74.125.130.0-255,2902,88874,7,361577
33596,0.00121,172.31.36.0-255,66,88940,7,361577
33597,0.00123,74.125.130.0-255,1484,90424,7,361577
33598,0.001245,74.125.130.0-255,4320,94744,7,361577
33599,0.001248,172.31.36.0-255,66,94810,7,361577
33600,0.001272,74.125.130.0-255,5738,100548,7,361577
33601,0.001274,172.31.36.0-255,66,100614,7,361577
33602,0.001293,74.125.130.0-255,1125,101739,7,361577
33603,0.001413,74.125.130.0-255,1484,103223,7,361577
33604,0.001416,172.31.36.0-255,66,103289,7,361577
33605,0.001449,74.125.130.0-255,1484,104773,7,361577
33606,0.001454,74.125.130.0-255,2902,107675,7,361577
33607,0.001456,172.31.36.0-255,66,107741,7,361577
33608,0.001485,74.125.130.0-255,5738,113479,7,361577
33609,0.001488,172.31.36.0-255,66,113545,7,361577
33610,0.001491,74.125.130.0-255,1484,115029,7,361577
33611,0.001521,74.125.130.0-255,2902,117931,7,361577
33612,0.001523,172.31.36.0-255,66,117997,7,361577
33613,0.001546,74.125.130.0-255,5738,123735,7,361577
33614,0.001548,172.31.36.0-255,66,123801,7,361577
33615,0.001562,74.125.130.0-255,1484,125285,7,361577
33616,0.00158,74.125.130.0-255,5738,131023,7,361577
33617,0.001583,172.31.36.0-255,66,131089,7,361577
33618,0.001586,74.125.130.0-255,1484,132573,7,361577
33619,0.001605,74.125.130.0-255,2902,135475,7,361577
33620,0.001608,172.31.36.0-255,66,135541,7,361577
33621,0.001635,74.125.130.0-255,766,136307,7,361577
33622,0.002022,74.125.130.0-255,1484,137791,7,361577
33623,0.002026,172.31.36.0-255,66,137857,7,361577
33624,0.002032,74.125.130.0-255,2902,140759,7,361577
33625,0.002034,172.31.36.0-255,66,140825,7,361577
33626,0.002056,74.125.130.0-255,1484,142309,7,361577
33627,0.00207,74.125.130.0-255,2902,145211,7,361577
33628,0.002072,172.31.36.0-255,66,145277,7,361577
33629,0.002086,74.125.130.0-255,1484,146761,7,361577
33630,0.002107,74.125.130.0-255,4320,151081,7,361577
33631,0.002109,172.31.36.0-255,66,151147,7,361577
33632,0.002113,74.125.130.0-255,1484,152631,7,361577
33633,0.002164,74.125.130.0-255,2902,155533,7,361577
33634,0.002167,172.31.36.0-255,66,155599,7,361577
33635,0.002173,74.125.130.0-255,5738,161337,7,361577
33636,0.002175,172.31.36.0-255,66,161403,7,361577
33637,0.002178,74.125.130.0-255,1484,162887,7,361577
33638,0.002203,74.125.130.0-255,2902,165789,7,361577
33639,0.002205,172.31.36.0-255,66,165855,7,361577
33640,0.002225,74.125.130.0-255,1484,167339,7,361577
33641,0.002235,74.125.130.0-255,1484,168823,7,361577
33642,0.002237,172.31.36.0-255,66,168889,7,361577
33643,0.00225,74.125.130.0-255,1484,170373,7,361577
33644,0.002252,74.125.130.0-255,766,171139,7,361577
33645,0.002254,172.31.36.0-255,66,171205,7,361577
33646,0.004557,74.125.130.0-255,4320,175525,7,361577
33647,0.004564,172.31.36.0-255,66,175591,7,361577
33648,0.004595,74.125.130.0-255,1484,177075,7,361577
33649,0.006869,74.125.130.0-255,2902,179977,7,361577
33650,0.006872,172.31.36.0-255,66,180043,7,361577
33651,0.00689,74.125.130.0-255,1484,181527,7,361577
33652,0.009198,74.125.130.0-255,4320,185847,7,361577
33653,0.009205,172.31.36.0-255,66,185913,7,361577
33654,0.011551,74.125.130.0-255,5738,191651,7,361577
33655,0.01156,172.31.36.0-255,66,191717,7,361577
33656,0.013887,74.125.130.0-255,5738,197455,7,361577
33657,0.013895,172.31.36.0-255,66,197521,7,361577
33658,0.016225,74.125.130.0-255,5738,203259,7,361577
33659,0.016234,172.31.36.0-255,66,203325,7,361577
33660,0.018551,74.125.130.0-255,5738,209063,7,361577
33661,0.018559,172.31.36.0-255,66,209129,7,361577
33662,0.020895,74.125.130.0-255,5738,214867,7,361577
33663,0.020902,172.31.36.0-255,66,214933,7,361577
33664,0.023238,74.125.130.0-255,5738,220671,7,361577
33665,0.023246,172.31.36.0-255,66,220737,7,361577
33666,0.025563,74.125.130.0-255,5738,226475,7,361577
33667,0.025569,172.31.36.0-255,66,226541,7,361577
33668,0.025664,172.31.36.0-255,101,226642,7,361577
33669,0.027885,74.125.130.0-255,5738,232380,7,361577
33670,0.027892,172.31.36.0-255,66,232446,7,361577
33671,0.027956,74.125.130.0-255,66,232512,7,361577
33672,0.030215,74.125.130.0-255,5738,238250,7,361577
33673,0.030223,172.31.36.0-255,66,238316,7,361577
33674,0.032545,74.125.130.0-255,5738,244054,7,361577
33675,0.032553,172.31.36.0-255,66,244120,7,361577
33676,0.034887,74.125.130.0-255,5738,249858,7,361577
33677,0.034893,172.31.36.0-255,66,249924,7,361577
33678,0.034927,172.31.36.0-255,172,250096,7,361577
33679,0.034954,172.31.36.0-255,1073,251169,7,361577
33680,0.036472,104.244.42.0-255,66,251235,7,361577
33681,0.0365,104.244.42.0-255,66,251301,7,361577
33682,0.037218,74.125.130.0-255,5738,257039,7,361577
33683,0.037225,172.31.36.0-255,66,257105,7,361577
33684,0.039555,74.125.130.0-255,5738,262843,7,361577
33685,0.039562,172.31.36.0-255,66,262909,7,361577
33686,0.041906,74.125.130.0-255,5738,268647,7,361577
33687,0.041912,172.31.36.0-255,66,268713,7,361577
33688,0.044252,74.125.130.0-255,5738,274451,7,361577
33689,0.044259,172.31.36.0-255,66,274517,7,361577
33690,0.046591,74.125.130.0-255,5738,280255,7,361577
33691,0.046599,172.31.36.0-255,66,280321,7,361577
33692,0.048925,74.125.130.0-255,5738,286059,7,361577
33693,0.048931,172.31.36.0-255,66,286125,7,361577
33694,0.051265,74.125.130.0-255,5738,291863,7,361577
33695,0.051271,172.31.36.0-255,66,291929,7,361577
33696,0.053604,74.125.130.0-255,5738,297667,7,361577
33697,0.05361,172.31.36.0-255,66,297733,7,361577
33698,0.055948,74.125.130.0-255,5738,303471,7,361577
33699,0.055955,172.31.36.0-255,66,303537,7,361577
33700,0.058288,74.125.130.0-255,5738,309275,7,361577
33701,0.058294,172.31.36.0-255,66,309341,7,361577
33702,0.060619,74.125.130.0-255,5738,315079,7,361577
33703,0.060626,172.31.36.0-255,66,315145,7,361577
33704,0.062958,74.125.130.0-255,5738,320883,7,361577
33705,0.062965,172.31.36.0-255,66,320949,7,361577
33706,0.065278,74.125.130.0-255,5738,326687,7,361577
33707,0.065284,172.31.36.0-255,66,326753,7,361577
33708,0.06764,74.125.130.0-255,5738,332491,7,361577
33709,0.067646,172.31.36.0-255,66,332557,7,361577
33710,0.069974,74.125.130.0-255,5738,338295,7,361577
33711,0.06998,172.31.36.0-255,66,338361,7,361577
33712,0.072359,74.125.130.0-255,5738,344099,7,361577
33713,0.072366,172.31.36.0-255,66,344165,7,361577
33714,0.074697,74.125.130.0-255,5738,349903,7,361577
33715,0.074703,172.31.36.0-255,66,349969,7,361577
33716,0.077038,74.125.130.0-255,5738,355707,7,361577
33717,0.077044,172.31.36.0-255,66,355773,7,361577
33718,0.079375,74.125.130.0-255,5738,361511,7,361577
33719,0.079381,172.31.36.0-255,66,361577,7,361577
33720,0.0,74.125.24.0-255,147,147,7,261186
33721,2.7e-05,172.31.36.0-255,66,213,7,261186
33722,3.5e-05,74.125.24.0-255,1484,1697,7,261186
33723,3.8e-05,172.31.36.0-255,66,1763,7,261186
33724,4.3e-05,74.125.24.0-255,2902,4665,7,261186
33725,5.7e-05,172.31.36.0-255,66,4731,7,261186
33726,0.0001,74.125.24.0-255,7156,11887,7,261186
33727,0.000104,172.31.36.0-255,66,11953,7,261186
33728,0.000231,74.125.24.0-255,3455,15408,7,261186
33729,0.000235,172.31.36.0-255,66,15474,7,261186
33730,0.000317,74.125.24.0-255,5738,21212,7,261186
33731,0.000322,172.31.36.0-255,66,21278,7,261186
33732,0.000349,74.125.24.0-255,7156,28434,7,261186
33733,0.000353,172.31.36.0-255,66,28500,7,261186
33734,0.000571,74.125.24.0-255,2543,31043,7,261186
33735,0.000576,172.31.36.0-255,66,31109,7,261186
33736,0.000643,74.125.24.0-255,4320,35429,7,261186
33737,0.000648,172.31.36.0-255,66,35495,7,261186
33738,0.000702,172.31.36.0-255,66,35561,7,261186
33739,0.001011,74.125.24.0-255,5738,41299,7,261186
33740,0.001017,172.31.36.0-255,66,41365,7,261186
33741,0.001055,172.31.36.0-255,66,41431,7,261186
33742,0.001342,74.125.24.0-255,5738,47169,7,261186
33743,0.001348,172.31.36.0-255,66,47235,7,261186
33744,0.001386,172.31.36.0-255,66,47301,7,261186
33745,0.001407,74.125.24.0-255,2611,49912,7,261186
33746,0.00141,172.31.36.0-255,66,49978,7,261186
33747,0.001862,74.125.24.0-255,2902,52880,7,261186
33748,0.001864,172.31.36.0-255,66,52946,7,261186
33749,0.001891,74.125.24.0-255,5076,58022,7,261186
33750,0.001894,172.31.36.0-255,66,58088,7,261186
33751,0.002029,74.125.24.0-255,2902,60990,7,261186
33752,0.002721,74.125.24.0-255,1484,62474,7,261186
33753,0.002749,74.125.24.0-255,2902,65376,7,261186
33754,0.00279,172.31.36.0-255,66,65442,7,261186
33755,0.002817,74.125.24.0-255,4320,69762,7,261186
33756,0.002823,172.31.36.0-255,66,69828,7,261186
33757,0.002832,74.125.24.0-255,1484,71312,7,261186
33758,0.002936,74.125.24.0-255,7156,78468,7,261186
33759,0.002948,172.31.36.0-255,66,78534,7,261186
33760,0.002951,74.125.24.0-255,5738,84272,7,261186
33761,0.002964,172.31.36.0-255,66,84338,7,261186
33762,0.003213,172.31.36.0-255,66,84404,7,261186
33763,0.003262,172.31.36.0-255,66,84470,7,261186
33764,0.005784,74.125.24.0-255,5738,90208,7,261186
33765,0.00579,172.31.36.0-255,66,90274,7,261186
33766,0.008328,74.125.24.0-255,4320,94594,7,261186
33767,0.008334,172.31.36.0-255,66,94660,7,261186
33768,0.008363,74.125.24.0-255,1484,96144,7,261186
33769,0.010871,74.125.24.0-255,4320,100464,7,261186
33770,0.010878,172.31.36.0-255,66,100530,7,261186
33771,0.013399,74.125.24.0-255,5738,106268,7,261186
33772,0.013407,172.31.36.0-255,66,106334,7,261186
33773,0.01602,74.125.24.0-255,5738,112072,7,261186
33774,0.016032,172.31.36.0-255,66,112138,7,261186
33775,0.018579,74.125.24.0-255,5738,117876,7,261186
33776,0.018589,172.31.36.0-255,66,117942,7,261186
33777,0.021129,74.125.24.0-255,5738,123680,7,261186
33778,0.021137,172.31.36.0-255,66,123746,7,261186
33779,0.023677,74.125.24.0-255,5738,129484,7,261186
33780,0.023684,172.31.36.0-255,66,129550,7,261186
33781,0.026218,74.125.24.0-255,5738,135288,7,261186
33782,0.026226,172.31.36.0-255,66,135354,7,261186
33783,0.028266,172.31.36.0-255,192,135546,7,261186
33784,0.028297,172.31.36.0-255,958,136504,7,261186
33785,0.028332,172.31.36.0-255,1514,138018,7,261186
33786,0.028334,172.31.36.0-255,1448,139466,7,261186
33787,0.028758,74.125.24.0-255,5738,145204,7,261186
33788,0.028765,172.31.36.0-255,66,145270,7,261186
33789,0.029822,104.244.42.0-255,66,145336,7,261186
33790,0.029875,104.244.42.0-255,66,145402,7,261186
33791,0.029921,104.244.42.0-255,66,145468,7,261186
33792,0.031299,74.125.24.0-255,5738,151206,7,261186
33793,0.031304,172.31.36.0-255,66,151272,7,261186
33794,0.033842,74.125.24.0-255,4320,155592,7,261186
33795,0.033866,172.31.36.0-255,66,155658,7,261186
33796,0.033891,74.125.24.0-255,1484,157142,7,261186
33797,0.036399,74.125.24.0-255,4320,161462,7,261186
33798,0.036404,172.31.36.0-255,66,161528,7,261186
33799,0.038944,74.125.24.0-255,5738,167266,7,261186
33800,0.038949,172.31.36.0-255,66,167332,7,261186
33801,0.041496,74.125.24.0-255,5738,173070,7,261186
33802,0.041501,172.31.36.0-255,66,173136,7,261186
33803,0.044009,74.125.24.0-255,5738,178874,7,261186
33804,0.044015,172.31.36.0-255,66,178940,7,261186
33805,0.046523,74.125.24.0-255,5738,184678,7,261186
33806,0.046529,172.31.36.0-255,66,184744,7,261186
33807,0.049066,74.125.24.0-255,5738,190482,7,261186
33808,0.049071,172.31.36.0-255,66,190548,7,261186
33809,0.051604,74.125.24.0-255,5738,196286,7,261186
33810,0.051611,172.31.36.0-255,66,196352,7,261186
33811,0.054122,74.125.24.0-255,5738,202090,7,261186
33812,0.054127,172.31.36.0-255,66,202156,7,261186
33813,0.056641,74.125.24.0-255,5738,207894,7,261186
33814,0.056647,172.31.36.0-255,66,207960,7,261186
33815,0.059185,74.125.24.0-255,5738,213698,7,261186
33816,0.05919,172.31.36.0-255,66,213764,7,261186
33817,0.06172,74.125.24.0-255,5738,219502,7,261186
33818,0.061727,172.31.36.0-255,66,219568,7,261186
33819,0.064288,74.125.24.0-255,2902,222470,7,261186
33820,0.064294,172.31.36.0-255,66,222536,7,261186
33821,0.064328,74.125.24.0-255,2902,225438,7,261186
33822,0.064331,172.31.36.0-255,66,225504,7,261186
33823,0.066815,74.125.24.0-255,2902,228406,7,261186
33824,0.06682,172.31.36.0-255,66,228472,7,261186
33825,0.066863,74.125.24.0-255,2902,231374,7,261186
33826,0.066867,172.31.36.0-255,66,231440,7,261186
33827,0.069349,74.125.24.0-255,2902,234342,7,261186
33828,0.069354,172.31.36.0-255,66,234408,7,261186
33829,0.06939,74.125.24.0-255,2902,237310,7,261186
33830,0.069393,172.31.36.0-255,66,237376,7,261186
33831,0.071871,74.125.24.0-255,2902,240278,7,261186
33832,0.071893,172.31.36.0-255,66,240344,7,261186
33833,0.071921,74.125.24.0-255,2902,243246,7,261186
33834,0.071926,172.31.36.0-255,66,243312,7,261186
33835,0.074431,74.125.24.0-255,2902,246214,7,261186
33836,0.074437,172.31.36.0-255,66,246280,7,261186
33837,0.074476,74.125.24.0-255,2902,249182,7,261186
33838,0.074479,172.31.36.0-255,66,249248,7,261186
33839,0.076968,74.125.24.0-255,2902,252150,7,261186
33840,0.076973,172.31.36.0-255,66,252216,7,261186
33841,0.07701,74.125.24.0-255,2902,255118,7,261186
33842,0.077013,172.31.36.0-255,66,255184,7,261186
33843,0.079496,74.125.24.0-255,1484,256668,7,261186
33844,0.079525,74.125.24.0-255,1484,258152,7,261186
33845,0.079529,172.31.36.0-255,66,258218,7,261186
33846,0.079557,74.125.24.0-255,2902,261120,7,261186
33847,0.079562,172.31.36.0-255,66,261186,7,261186
33848,0.0,74.125.24.0-255,152,152,7,292105
33849,3.3e-05,172.31.36.0-255,66,218,7,292105
33850,4e-05,74.125.24.0-255,1484,1702,7,292105
33851,4.4e-05,172.31.36.0-255,66,1768,7,292105
33852,4.9e-05,74.125.24.0-255,2902,4670,7,292105
33853,5.1e-05,172.31.36.0-255,66,4736,7,292105
33854,7.4e-05,74.125.24.0-255,4320,9056,7,292105
33855,7.6e-05,172.31.36.0-255,66,9122,7,292105
33856,0.000112,74.125.24.0-255,4822,13944,7,292105
33857,0.000115,172.31.36.0-255,66,14010,7,292105
33858,0.000196,74.125.24.0-255,1484,15494,7,292105
33859,0.0002,172.31.36.0-255,66,15560,7,292105
33860,0.000204,74.125.24.0-255,1484,17044,7,292105
33861,0.000206,172.31.36.0-255,66,17110,7,292105
33862,0.00022,74.125.24.0-255,1484,18594,7,292105
33863,0.000222,172.31.36.0-255,66,18660,7,292105
33864,0.000228,74.125.24.0-255,2902,21562,7,292105
33865,0.000232,172.31.36.0-255,66,21628,7,292105
33866,0.000252,74.125.24.0-255,2902,24530,7,292105
33867,0.000254,172.31.36.0-255,66,24596,7,292105
33868,0.00026,74.125.24.0-255,4320,28916,7,292105
33869,0.000262,172.31.36.0-255,66,28982,7,292105
33870,0.00028,74.125.24.0-255,2543,31525,7,292105
33871,0.000283,172.31.36.0-255,66,31591,7,292105
33872,0.000303,74.125.24.0-255,5738,37329,7,292105
33873,0.000306,172.31.36.0-255,66,37395,7,292105
33874,0.000328,74.125.24.0-255,1484,38879,7,292105
33875,0.000332,172.31.36.0-255,66,38945,7,292105
33876,0.000337,74.125.24.0-255,2902,41847,7,292105
33877,0.000341,172.31.36.0-255,66,41913,7,292105
33878,0.000358,74.125.24.0-255,1484,43397,7,292105
33879,0.000362,172.31.36.0-255,66,43463,7,292105
33880,0.000386,74.125.24.0-255,5379,48842,7,292105
33881,0.00039,172.31.36.0-255,66,48908,7,292105
33882,0.000454,74.125.24.0-255,1484,50392,7,292105
33883,0.00046,74.125.24.0-255,2902,53294,7,292105
33884,0.000463,172.31.36.0-255,66,53360,7,292105
33885,0.00048,74.125.24.0-255,2902,56262,7,292105
33886,0.000483,172.31.36.0-255,66,56328,7,292105
33887,0.000505,74.125.24.0-255,2902,59230,7,292105
33888,0.000508,172.31.36.0-255,66,59296,7,292105
33889,0.000512,74.125.24.0-255,2902,62198,7,292105
33890,0.000515,172.31.36.0-255,66,62264,7,292105
33891,0.000529,74.125.24.0-255,3961,66225,7,292105
33892,0.000532,172.31.36.0-255,66,66291,7,292105
33893,0.001002,74.125.24.0-255,647,66938,7,292105
33894,0.001162,74.125.24.0-255,1484,68422,7,292105
33895,0.001168,172.31.36.0-255,66,68488,7,292105
33896,0.001174,74.125.24.0-255,2902,71390,7,292105
33897,0.001176,172.31.36.0-255,66,71456,7,292105
33898,0.001202,74.125.24.0-255,5738,77194,7,292105
33899,0.001204,172.31.36.0-255,66,77260,7,292105
33900,0.001242,172.31.36.0-255,66,77326,7,292105
33901,0.001255,172.31.36.0-255,66,77392,7,292105
33902,0.002267,74.125.24.0-255,1484,78876,7,292105
33903,0.002274,74.125.24.0-255,2902,81778,7,292105
33904,0.002278,172.31.36.0-255,66,81844,7,292105
33905,0.002283,74.125.24.0-255,1484,83328,7,292105
33906,0.002298,74.125.24.0-255,4320,87648,7,292105
33907,0.0023,172.31.36.0-255,66,87714,7,292105
33908,0.002329,172.31.36.0-255,66,87780,7,292105
33909,0.002363,74.125.24.0-255,5738,93518,7,292105
33910,0.002365,172.31.36.0-255,66,93584,7,292105
33911,0.00238,74.125.24.0-255,5020,98604,7,292105
33912,0.002382,172.31.36.0-255,66,98670,7,292105
33913,0.004714,74.125.24.0-255,5738,104408,7,292105
33914,0.004716,172.31.36.0-255,66,104474,7,292105
33915,0.007082,74.125.24.0-255,5738,110212,7,292105
33916,0.007089,172.31.36.0-255,66,110278,7,292105
33917,0.009454,74.125.24.0-255,5738,116016,7,292105
33918,0.009461,172.31.36.0-255,66,116082,7,292105
33919,0.011798,74.125.24.0-255,5738,121820,7,292105
33920,0.011805,172.31.36.0-255,66,121886,7,292105
33921,0.014133,74.125.24.0-255,5738,127624,7,292105
33922,0.014142,172.31.36.0-255,66,127690,7,292105
33923,0.016494,74.125.24.0-255,5738,133428,7,292105
33924,0.016503,172.31.36.0-255,66,133494,7,292105
33925,0.018852,74.125.24.0-255,5738,139232,7,292105
33926,0.018859,172.31.36.0-255,66,139298,7,292105
33927,0.021219,74.125.24.0-255,5738,145036,7,292105
33928,0.021226,172.31.36.0-255,66,145102,7,292105
33929,0.023582,74.125.24.0-255,5738,150840,7,292105
33930,0.023588,172.31.36.0-255,66,150906,7,292105
33931,0.02592,74.125.24.0-255,5738,156644,7,292105
33932,0.025926,172.31.36.0-255,66,156710,7,292105
33933,0.026419,172.31.36.0-255,188,156898,7,292105
33934,0.026445,172.31.36.0-255,958,157856,7,292105
33935,0.026492,172.31.36.0-255,1514,159370,7,292105
33936,0.026494,172.31.36.0-255,1450,160820,7,292105
33937,0.027937,104.244.42.0-255,66,160886,7,292105
33938,0.027945,104.244.42.0-255,66,160952,7,292105
33939,0.028053,104.244.42.0-255,66,161018,7,292105
33940,0.028265,74.125.24.0-255,2902,163920,7,292105
33941,0.02827,172.31.36.0-255,66,163986,7,292105
33942,0.028288,74.125.24.0-255,2902,166888,7,292105
33943,0.028291,172.31.36.0-255,66,166954,7,292105
33944,0.030606,74.125.24.0-255,4320,171274,7,292105
33945,0.030611,172.31.36.0-255,66,171340,7,292105
33946,0.030645,74.125.24.0-255,1484,172824,7,292105
33947,0.03295,74.125.24.0-255,4320,177144,7,292105
33948,0.032957,172.31.36.0-255,66,177210,7,292105
33949,0.035304,74.125.24.0-255,5738,182948,7,292105
33950,0.03531,172.31.36.0-255,66,183014,7,292105
33951,0.037647,74.125.24.0-255,5738,188752,7,292105
33952,0.037652,172.31.36.0-255,66,188818,7,292105
33953,0.040006,74.125.24.0-255,5738,194556,7,292105
33954,0.04001,172.31.36.0-255,66,194622,7,292105
33955,0.042359,74.125.24.0-255,4320,198942,7,292105
33956,0.042365,172.31.36.0-255,66,199008,7,292105
33957,0.042391,74.125.24.0-255,1484,200492,7,292105
33958,0.044703,74.125.24.0-255,4320,204812,7,292105
33959,0.044709,172.31.36.0-255,66,204878,7,292105
33960,0.047064,74.125.24.0-255,5738,210616,7,292105
33961,0.047069,172.31.36.0-255,66,210682,7,292105
33962,0.049413,74.125.24.0-255,5738,216420,7,292105
33963,0.04942,172.31.36.0-255,66,216486,7,292105
33964,0.051772,74.125.24.0-255,5738,222224,7,292105
33965,0.05178,172.31.36.0-255,66,222290,7,292105
33966,0.054105,74.125.24.0-255,5738,228028,7,292105
33967,0.05411,172.31.36.0-255,66,228094,7,292105
33968,0.056426,74.125.24.0-255,5738,233832,7,292105
33969,0.056431,172.31.36.0-255,66,233898,7,292105
33970,0.058766,74.125.24.0-255,5738,239636,7,292105
33971,0.058771,172.31.36.0-255,66,239702,7,292105
33972,0.061104,74.125.24.0-255,5738,245440,7,292105
33973,0.06111,172.31.36.0-255,66,245506,7,292105
33974,0.061194,172.31.36.0-255,101,245607,7,292105
33975,0.063442,74.125.24.0-255,5738,251345,7,292105
33976,0.063447,172.31.36.0-255,66,251411,7,292105
33977,0.06348,74.125.24.0-255,66,251477,7,292105
33978,0.065783,74.125.24.0-255,5738,257215,7,292105
33979,0.065789,172.31.36.0-255,66,257281,7,292105
33980,0.068115,74.125.24.0-255,5738,263019,7,292105
33981,0.06812,172.31.36.0-255,66,263085,7,292105
33982,0.070462,74.125.24.0-255,5738,268823,7,292105
33983,0.070468,172.31.36.0-255,66,268889,7,292105
33984,0.072811,74.125.24.0-255,5738,274627,7,292105
33985,0.072816,172.31.36.0-255,66,274693,7,292105
33986,0.075164,74.125.24.0-255,5738,280431,7,292105
33987,0.075171,172.31.36.0-255,66,280497,7,292105
33988,0.077554,74.125.24.0-255,5738,286235,7,292105
33989,0.07756,172.31.36.0-255,66,286301,7,292105
33990,0.079926,74.125.24.0-255,5738,292039,7,292105
33991,0.079932,172.31.36.0-255,66,292105,7,292105
33992,0.0,74.125.24.0-255,148,148,7,311042
33993,3.7e-05,172.31.36.0-255,66,214,7,311042
33994,4.4e-05,74.125.24.0-255,1484,1698,7,311042
33995,4.8e-05,172.31.36.0-255,66,1764,7,311042
33996,5.3e-05,74.125.24.0-255,2902,4666,7,311042
33997,5.6e-05,172.31.36.0-255,66,4732,7,311042
33998,6.5e-05,74.125.24.0-255,7156,11888,7,311042
33999,6.7e-05,172.31.36.0-255,66,11954,7,311042
34000,7.5e-05,74.125.24.0-255,7156,19110,7,311042
34001,7.8e-05,172.31.36.0-255,66,19176,7,311042
34002,9.8e-05,74.125.24.0-255,4836,24012,7,311042
34003,0.000101,172.31.36.0-255,66,24078,7,311042
34004,0.00013,74.125.24.0-255,6797,30875,7,311042
34005,0.000133,172.31.36.0-255,66,30941,7,311042
34006,0.000173,74.125.24.0-255,1484,32425,7,311042
34007,0.000178,172.31.36.0-255,66,32491,7,311042
34008,0.000183,74.125.24.0-255,2902,35393,7,311042
34009,0.000185,172.31.36.0-255,66,35459,7,311042
34010,0.000221,74.125.24.0-255,5738,41197,7,311042
34011,0.000224,172.31.36.0-255,66,41263,7,311042
34012,0.00023,74.125.24.0-255,4320,45583,7,311042
34013,0.000233,172.31.36.0-255,66,45649,7,311042
34014,0.000265,172.31.36.0-255,66,45715,7,311042
34015,0.000268,74.125.24.0-255,1484,47199,7,311042
34016,0.00027,172.31.36.0-255,66,47265,7,311042
34017,0.000331,172.31.36.0-255,66,47331,7,311042
34018,0.000351,74.125.24.0-255,1405,48736,7,311042
34019,0.000353,172.31.36.0-255,66,48802,7,311042
34020,0.00051,74.125.24.0-255,377,49179,7,311042
34021,0.000518,172.31.36.0-255,66,49245,7,311042
34022,0.000833,74.125.24.0-255,1484,50729,7,311042
34023,0.000841,74.125.24.0-255,2902,53631,7,311042
34024,0.000846,74.125.24.0-255,5738,59369,7,311042
34025,0.000846,172.31.36.0-255,66,59435,7,311042
34026,0.00085,172.31.36.0-255,66,59501,7,311042
34027,0.000891,74.125.24.0-255,6797,66298,7,311042
34028,0.000895,172.31.36.0-255,66,66364,7,311042
34029,0.000921,74.125.24.0-255,7156,73520,7,311042
34030,0.000924,172.31.36.0-255,66,73586,7,311042
34031,0.000968,172.31.36.0-255,66,73652,7,311042
34032,0.001332,74.125.24.0-255,1484,75136,7,311042
34033,0.001339,74.125.24.0-255,2902,78038,7,311042
34034,0.001343,74.125.24.0-255,2902,80940,7,311042
34035,0.001345,172.31.36.0-255,66,81006,7,311042
34036,0.001349,172.31.36.0-255,66,81072,7,311042
34037,0.001357,74.125.24.0-255,2902,83974,7,311042
34038,0.00136,172.31.36.0-255,66,84040,7,311042
34039,0.001363,74.125.24.0-255,1484,85524,7,311042
34040,0.001401,172.31.36.0-255,66,85590,7,311042
34041,0.001421,74.125.24.0-255,1484,87074,7,311042
34042,0.001435,172.31.36.0-255,66,87140,7,311042
34043,0.002104,74.125.24.0-255,1484,88624,7,311042
34044,0.002125,74.125.24.0-255,2902,91526,7,311042
34045,0.002129,172.31.36.0-255,66,91592,7,311042
34046,0.002134,74.125.24.0-255,4320,95912,7,311042
34047,0.002137,172.31.36.0-255,66,95978,7,311042
34048,0.002148,172.31.36.0-255,66,96044,7,311042
34049,0.002176,74.125.24.0-255,4320,100364,7,311042
34050,0.002179,172.31.36.0-255,66,100430,7,311042
34051,0.00221,172.31.36.0-255,66,100496,7,311042
34052,0.004342,74.125.24.0-255,4320,104816,7,311042
34053,0.00435,172.31.36.0-255,66,104882,7,311042
34054,0.004379,74.125.24.0-255,1484,106366,7,311042
34055,0.006504,74.125.24.0-255,4320,110686,7,311042
34056,0.006511,172.31.36.0-255,66,110752,7,311042
34057,0.008617,74.125.24.0-255,5738,116490,7,311042
34058,0.00863,172.31.36.0-255,66,116556,7,311042
34059,0.010804,74.125.24.0-255,4320,120876,7,311042
34060,0.010813,172.31.36.0-255,66,120942,7,311042
34061,0.010844,74.125.24.0-255,1484,122426,7,311042
34062,0.012976,74.125.24.0-255,4320,126746,7,311042
34063,0.012984,172.31.36.0-255,66,126812,7,311042
34064,0.015134,74.125.24.0-255,5738,132550,7,311042
34065,0.015163,172.31.36.0-255,66,132616,7,311042
34066,0.01727,74.125.24.0-255,5738,138354,7,311042
34067,0.017276,172.31.36.0-255,66,138420,7,311042
34068,0.019438,74.125.24.0-255,5738,144158,7,311042
34069,0.019447,172.31.36.0-255,66,144224,7,311042
34070,0.021644,74.125.24.0-255,5738,149962,7,311042
34071,0.021652,172.31.36.0-255,66,150028,7,311042
34072,0.023771,74.125.24.0-255,5738,155766,7,311042
34073,0.023778,172.31.36.0-255,66,155832,7,311042
34074,0.025924,74.125.24.0-255,5738,161570,7,311042
34075,0.025931,172.31.36.0-255,66,161636,7,311042
34076,0.02809,74.125.24.0-255,5738,167374,7,311042
34077,0.028106,172.31.36.0-255,66,167440,7,311042
34078,0.030214,74.125.24.0-255,5738,173178,7,311042
34079,0.030226,172.31.36.0-255,66,173244,7,311042
34080,0.032351,74.125.24.0-255,5738,178982,7,311042
34081,0.032364,172.31.36.0-255,66,179048,7,311042
34082,0.034552,74.125.24.0-255,5738,184786,7,311042
34083,0.034567,172.31.36.0-255,66,184852,7,311042
34084,0.036686,74.125.24.0-255,5738,190590,7,311042
34085,0.036697,172.31.36.0-255,66,190656,7,311042
34086,0.03887,74.125.24.0-255,5738,196394,7,311042
34087,0.038883,172.31.36.0-255,66,196460,7,311042
34088,0.040139,172.31.36.0-255,188,196648,7,311042
34089,0.040176,172.31.36.0-255,958,197606,7,311042
34090,0.040247,172.31.36.0-255,1514,199120,7,311042
34091,0.040249,172.31.36.0-255,1448,200568,7,311042
34092,0.041023,74.125.24.0-255,5738,206306,7,311042
34093,0.041031,172.31.36.0-255,66,206372,7,311042
34094,0.041691,104.244.42.0-255,66,206438,7,311042
34095,0.041722,104.244.42.0-255,66,206504,7,311042
34096,0.041866,104.244.42.0-255,66,206570,7,311042
34097,0.043193,74.125.24.0-255,5738,212308,7,311042
34098,0.043201,172.31.36.0-255,66,212374,7,311042
34099,0.04532,74.125.24.0-255,5738,218112,7,311042
34100,0.045328,172.31.36.0-255,66,218178,7,311042
34101,0.047488,74.125.24.0-255,5738,223916,7,311042
34102,0.047498,172.31.36.0-255,66,223982,7,311042
34103,0.049647,74.125.24.0-255,5738,229720,7,311042
34104,0.049653,172.31.36.0-255,66,229786,7,311042
34105,0.051826,74.125.24.0-255,5738,235524,7,311042
34106,0.051833,172.31.36.0-255,66,235590,7,311042
34107,0.054011,74.125.24.0-255,5738,241328,7,311042
34108,0.054018,172.31.36.0-255,66,241394,7,311042
34109,0.056126,74.125.24.0-255,5738,247132,7,311042
34110,0.056133,172.31.36.0-255,66,247198,7,311042
34111,0.058279,74.125.24.0-255,5738,252936,7,311042
34112,0.058286,172.31.36.0-255,66,253002,7,311042
34113,0.06043,74.125.24.0-255,5738,258740,7,311042
34114,0.060438,172.31.36.0-255,66,258806,7,311042
34115,0.062619,74.125.24.0-255,5738,264544,7,311042
34116,0.062629,172.31.36.0-255,66,264610,7,311042
34117,0.064779,74.125.24.0-255,5738,270348,7,311042
34118,0.06479,172.31.36.0-255,66,270414,7,311042
34119,0.066981,74.125.24.0-255,5738,276152,7,311042
34120,0.066991,172.31.36.0-255,66,276218,7,311042
34121,0.069138,74.125.24.0-255,5738,281956,7,311042
34122,0.069149,172.31.36.0-255,66,282022,7,311042
34123,0.071303,74.125.24.0-255,5738,287760,7,311042
34124,0.07131,172.31.36.0-255,66,287826,7,311042
34125,0.073473,74.125.24.0-255,5738,293564,7,311042
34126,0.073484,172.31.36.0-255,66,293630,7,311042
34127,0.07562,74.125.24.0-255,5738,299368,7,311042
34128,0.075627,172.31.36.0-255,66,299434,7,311042
34129,0.077731,74.125.24.0-255,5738,305172,7,311042
34130,0.077736,172.31.36.0-255,66,305238,7,311042
34131,0.079902,74.125.24.0-255,5738,310976,7,311042
34132,0.079909,172.31.36.0-255,66,311042,7,311042
34133,0.0,172.217.27.0-255,153,153,7,383937
34134,1.5e-05,172.31.36.0-255,66,219,7,383937
34135,2.3e-05,172.217.27.0-255,1484,1703,7,383937
34136,2.7e-05,172.31.36.0-255,66,1769,7,383937
34137,4.1e-05,172.217.27.0-255,2902,4671,7,383937
34138,4.5e-05,172.31.36.0-255,66,4737,7,383937
34139,4.8e-05,172.217.27.0-255,1484,6221,7,383937
34140,5e-05,172.31.36.0-255,66,6287,7,383937
34141,5.7e-05,172.217.27.0-255,5738,12025,7,383937
34142,5.9e-05,172.31.36.0-255,66,12091,7,383937
34143,7.6e-05,172.217.27.0-255,2066,14157,7,383937
34144,8.3e-05,172.31.36.0-255,66,14223,7,383937
34145,0.000111,172.217.27.0-255,2902,17125,7,383937
34146,0.000114,172.31.36.0-255,66,17191,7,383937
34147,0.000121,172.217.27.0-255,4320,21511,7,383937
34148,0.000123,172.31.36.0-255,66,21577,7,383937
34149,0.000152,172.217.27.0-255,2902,24479,7,383937
34150,0.000154,172.31.36.0-255,66,24545,7,383937
34151,0.000162,172.217.27.0-255,6797,31342,7,383937
34152,0.000164,172.31.36.0-255,66,31408,7,383937
34153,0.000211,172.217.27.0-255,1484,32892,7,383937
34154,0.000214,172.31.36.0-255,66,32958,7,383937
34155,0.000219,172.217.27.0-255,2902,35860,7,383937
34156,0.000221,172.31.36.0-255,66,35926,7,383937
34157,0.000224,172.217.27.0-255,1484,37410,7,383937
34158,0.000226,172.31.36.0-255,66,37476,7,383937
34159,0.000249,172.217.27.0-255,1484,38960,7,383937
34160,0.000257,172.31.36.0-255,66,39026,7,383937
34161,0.000262,172.217.27.0-255,4320,43346,7,383937
34162,0.000265,172.31.36.0-255,66,43412,7,383937
34163,0.000293,172.217.27.0-255,5379,48791,7,383937
34164,0.0003,172.31.36.0-255,66,48857,7,383937
34165,0.000396,172.217.27.0-255,1484,50341,7,383937
34166,0.000402,172.217.27.0-255,2902,53243,7,383937
34167,0.000405,172.31.36.0-255,66,53309,7,383937
34168,0.000411,172.217.27.0-255,2902,56211,7,383937
34169,0.000414,172.31.36.0-255,66,56277,7,383937
34170,0.000446,172.217.27.0-255,2902,59179,7,383937
34171,0.000449,172.31.36.0-255,66,59245,7,383937
34172,0.000456,172.217.27.0-255,7124,66369,7,383937
34173,0.000459,172.31.36.0-255,66,66435,7,383937
34174,0.000754,172.217.27.0-255,116,66551,7,383937
34175,0.000872,172.217.27.0-255,1484,68035,7,383937
34176,0.000877,172.31.36.0-255,66,68101,7,383937
34177,0.000883,172.217.27.0-255,2902,71003,7,383937
34178,0.000885,172.31.36.0-255,66,71069,7,383937
34179,0.00089,172.217.27.0-255,2902,73971,7,383937
34180,0.000891,172.31.36.0-255,66,74037,7,383937
34181,0.000901,172.217.27.0-255,4320,78357,7,383937
34182,0.000903,172.31.36.0-255,66,78423,7,383937
34183,0.000944,172.217.27.0-255,5379,83802,7,383937
34184,0.000947,172.31.36.0-255,66,83868,7,383937
34185,0.000952,172.217.27.0-255,2902,86770,7,383937
34186,0.000954,172.31.36.0-255,66,86836,7,383937
34187,0.000985,172.217.27.0-255,2902,89738,7,383937
34188,0.000988,172.31.36.0-255,66,89804,7,383937
34189,0.000995,172.217.27.0-255,4320,94124,7,383937
34190,0.000997,172.31.36.0-255,66,94190,7,383937
34191,0.001028,172.217.27.0-255,6797,100987,7,383937
34192,0.001031,172.31.36.0-255,66,101053,7,383937
34193,0.002652,172.217.27.0-255,5738,106791,7,383937
34194,0.00266,172.31.36.0-255,66,106857,7,383937
34195,0.004288,172.217.27.0-255,5738,112595,7,383937
34196,0.004292,172.31.36.0-255,66,112661,7,383937
34197,0.005921,172.217.27.0-255,5738,118399,7,383937
34198,0.005928,172.31.36.0-255,66,118465,7,383937
34199,0.007552,172.217.27.0-255,5738,124203,7,383937
34200,0.007558,172.31.36.0-255,66,124269,7,383937
34201,0.009184,172.217.27.0-255,5738,130007,7,383937
34202,0.009192,172.31.36.0-255,66,130073,7,383937
34203,0.010817,172.217.27.0-255,5738,135811,7,383937
34204,0.010825,172.31.36.0-255,66,135877,7,383937
34205,0.01245,172.217.27.0-255,5738,141615,7,383937
34206,0.012457,172.31.36.0-255,66,141681,7,383937
34207,0.014084,172.217.27.0-255,5738,147419,7,383937
34208,0.014092,172.31.36.0-255,66,147485,7,383937
34209,0.015715,172.217.27.0-255,5738,153223,7,383937
34210,0.015723,172.31.36.0-255,66,153289,7,383937
34211,0.01735,172.217.27.0-255,5738,159027,7,383937
34212,0.017358,172.31.36.0-255,66,159093,7,383937
34213,0.019019,172.217.27.0-255,5738,164831,7,383937
34214,0.019029,172.31.36.0-255,66,164897,7,383937
34215,0.020655,172.217.27.0-255,5738,170635,7,383937
34216,0.020663,172.31.36.0-255,66,170701,7,383937
34217,0.022286,172.217.27.0-255,5738,176439,7,383937
34218,0.022293,172.31.36.0-255,66,176505,7,383937
34219,0.023923,172.217.27.0-255,5738,182243,7,383937
34220,0.023931,172.31.36.0-255,66,182309,7,383937
34221,0.02556,172.217.27.0-255,5738,188047,7,383937
34222,0.025568,172.31.36.0-255,66,188113,7,383937
34223,0.027197,172.217.27.0-255,5738,193851,7,383937
34224,0.027204,172.31.36.0-255,66,193917,7,383937
34225,0.028838,172.217.27.0-255,5738,199655,7,383937
34226,0.028846,172.31.36.0-255,66,199721,7,383937
34227,0.03047,172.217.27.0-255,5738,205459,7,383937
34228,0.030478,172.31.36.0-255,66,205525,7,383937
34229,0.032104,172.217.27.0-255,5738,211263,7,383937
34230,0.032111,172.31.36.0-255,66,211329,7,383937
34231,0.032217,172.31.36.0-255,172,211501,7,383937
34232,0.032245,172.31.36.0-255,1114,212615,7,383937
34233,0.032305,172.31.36.0-255,1514,214129,7,383937
34234,0.032307,172.31.36.0-255,1294,215423,7,383937
34235,0.033707,104.244.42.0-255,66,215489,7,383937
34236,0.033736,104.244.42.0-255,66,215555,7,383937
34237,0.033759,172.217.27.0-255,5738,221293,7,383937
34238,0.033765,172.31.36.0-255,66,221359,7,383937
34239,0.033801,104.244.42.0-255,66,221425,7,383937
34240,0.03539,172.217.27.0-255,5738,227163,7,383937
34241,0.035397,172.31.36.0-255,66,227229,7,383937
34242,0.037032,172.217.27.0-255,5738,232967,7,383937
34243,0.037039,172.31.36.0-255,66,233033,7,383937
34244,0.03867,172.217.27.0-255,5738,238771,7,383937
34245,0.038679,172.31.36.0-255,66,238837,7,383937
34246,0.040315,172.217.27.0-255,5738,244575,7,383937
34247,0.040321,172.31.36.0-255,66,244641,7,383937
34248,0.041956,172.217.27.0-255,5738,250379,7,383937
34249,0.041963,172.31.36.0-255,66,250445,7,383937
34250,0.043601,172.217.27.0-255,5738,256183,7,383937
34251,0.043608,172.31.36.0-255,66,256249,7,383937
34252,0.045239,172.217.27.0-255,5738,261987,7,383937
34253,0.045246,172.31.36.0-255,66,262053,7,383937
34254,0.046868,172.217.27.0-255,5738,267791,7,383937
34255,0.046874,172.31.36.0-255,66,267857,7,383937
34256,0.048503,172.217.27.0-255,5738,273595,7,383937
34257,0.048509,172.31.36.0-255,66,273661,7,383937
34258,0.050143,172.217.27.0-255,5738,279399,7,383937
34259,0.050149,172.31.36.0-255,66,279465,7,383937
34260,0.051782,172.217.27.0-255,5738,285203,7,383937
34261,0.051789,172.31.36.0-255,66,285269,7,383937
34262,0.053423,172.217.27.0-255,5738,291007,7,383937
34263,0.053429,172.31.36.0-255,66,291073,7,383937
34264,0.055052,172.217.27.0-255,5738,296811,7,383937
34265,0.055059,172.31.36.0-255,66,296877,7,383937
34266,0.056695,172.217.27.0-255,5738,302615,7,383937
34267,0.056702,172.31.36.0-255,66,302681,7,383937
34268,0.058337,172.217.27.0-255,5738,308419,7,383937
34269,0.058344,172.31.36.0-255,66,308485,7,383937
34270,0.059976,172.217.27.0-255,5738,314223,7,383937
34271,0.059984,172.31.36.0-255,66,314289,7,383937
34272,0.061614,172.217.27.0-255,5738,320027,7,383937
34273,0.06162,172.31.36.0-255,66,320093,7,383937
34274,0.063248,172.217.27.0-255,5738,325831,7,383937
34275,0.063254,172.31.36.0-255,66,325897,7,383937
34276,0.064889,172.217.27.0-255,5738,331635,7,383937
34277,0.064896,172.31.36.0-255,66,331701,7,383937
34278,0.06652,172.217.27.0-255,5738,337439,7,383937
34279,0.066527,172.31.36.0-255,66,337505,7,383937
34280,0.068166,172.217.27.0-255,5738,343243,7,383937
34281,0.068172,172.31.36.0-255,66,343309,7,383937
34282,0.069835,172.217.27.0-255,5738,349047,7,383937
34283,0.069842,172.31.36.0-255,66,349113,7,383937
34284,0.071471,172.217.27.0-255,5738,354851,7,383937
34285,0.071478,172.31.36.0-255,66,354917,7,383937
34286,0.073118,172.217.27.0-255,5738,360655,7,383937
34287,0.073125,172.31.36.0-255,66,360721,7,383937
34288,0.074753,172.217.27.0-255,5738,366459,7,383937
34289,0.07476,172.31.36.0-255,66,366525,7,383937
34290,0.076393,172.217.27.0-255,5738,372263,7,383937
34291,0.0764,172.31.36.0-255,66,372329,7,383937
34292,0.078031,172.217.27.0-255,5738,378067,7,383937
34293,0.078037,172.31.36.0-255,66,378133,7,383937
34294,0.079669,172.217.27.0-255,5738,383871,7,383937
34295,0.079675,172.31.36.0-255,66,383937,7,383937
34296,0.0,172.217.194.0-255,153,153,7,218723
34297,3.4e-05,172.31.36.0-255,66,219,7,218723
34298,4.1e-05,172.217.194.0-255,1484,1703,7,218723
34299,4.6e-05,172.31.36.0-255,66,1769,7,218723
34300,5.1e-05,172.217.194.0-255,2902,4671,7,218723
34301,5.3e-05,172.31.36.0-255,66,4737,7,218723
34302,0.000112,172.217.194.0-255,7156,11893,7,218723
34303,0.000115,172.31.36.0-255,66,11959,7,218723
34304,0.000293,172.217.194.0-255,4320,16279,7,218723
34305,0.000298,172.31.36.0-255,66,16345,7,218723
34306,0.000322,172.31.36.0-255,66,16411,7,218723
34307,0.000631,172.31.36.0-255,66,16477,7,218723
34308,0.00066,172.31.36.0-255,66,16543,7,218723
34309,0.001156,172.217.194.0-255,2543,19086,7,218723
34310,0.001162,172.31.36.0-255,66,19152,7,218723
34311,0.001221,172.217.194.0-255,2902,22054,7,218723
34312,0.001224,172.31.36.0-255,66,22120,7,218723
34313,0.001253,172.31.36.0-255,66,22186,7,218723
34314,0.001656,172.217.194.0-255,2902,25088,7,218723
34315,0.001658,172.31.36.0-255,66,25154,7,218723
34316,0.001689,172.31.36.0-255,66,25220,7,218723
34317,0.001717,172.31.36.0-255,66,25286,7,218723
34318,0.002547,172.217.194.0-255,4320,29606,7,218723
34319,0.00255,172.31.36.0-255,66,29672,7,218723
34320,0.002584,172.31.36.0-255,66,29738,7,218723
34321,0.004584,172.31.36.0-255,66,29804,7,218723
34322,0.006874,172.217.194.0-255,5738,35542,7,218723
34323,0.00688,172.31.36.0-255,66,35608,7,218723
34324,0.009153,172.217.194.0-255,5738,41346,7,218723
34325,0.010149,172.31.36.0-255,66,41412,7,218723
34326,0.012445,172.217.194.0-255,5738,47150,7,218723
34327,0.012454,172.31.36.0-255,66,47216,7,218723
34328,0.014726,172.217.194.0-255,5738,52954,7,218723
34329,0.014733,172.31.36.0-255,66,53020,7,218723
34330,0.017026,172.217.194.0-255,5738,58758,7,218723
34331,0.017033,172.31.36.0-255,66,58824,7,218723
34332,0.017381,172.31.36.0-255,164,58988,7,218723
34333,0.01741,172.31.36.0-255,1122,60110,7,218723
34334,0.017449,172.31.36.0-255,1514,61624,7,218723
34335,0.017451,172.31.36.0-255,323,61947,7,218723
34336,0.01892,104.244.42.0-255,66,62013,7,218723
34337,0.018952,104.244.42.0-255,66,62079,7,218723
34338,0.019001,104.244.42.0-255,66,62145,7,218723
34339,0.019304,172.217.194.0-255,1484,63629,7,218723
34340,0.019335,172.217.194.0-255,4320,67949,7,218723
34341,0.01934,172.31.36.0-255,66,68015,7,218723
34342,0.021599,172.217.194.0-255,5738,73753,7,218723
34343,0.021605,172.31.36.0-255,66,73819,7,218723
34344,0.023875,172.217.194.0-255,5738,79557,7,218723
34345,0.02388,172.31.36.0-255,66,79623,7,218723
34346,0.026162,172.217.194.0-255,4320,83943,7,218723
34347,0.026166,172.31.36.0-255,66,84009,7,218723
34348,0.02619,172.217.194.0-255,1484,85493,7,218723
34349,0.028457,172.217.194.0-255,4320,89813,7,218723
34350,0.028461,172.31.36.0-255,66,89879,7,218723
34351,0.030737,172.217.194.0-255,4320,94199,7,218723
34352,0.030742,172.31.36.0-255,66,94265,7,218723
34353,0.030775,172.217.194.0-255,1484,95749,7,218723
34354,0.033015,172.217.194.0-255,4320,100069,7,218723
34355,0.03302,172.31.36.0-255,66,100135,7,218723
34356,0.035287,172.217.194.0-255,5738,105873,7,218723
34357,0.035342,172.31.36.0-255,66,105939,7,218723
34358,0.037594,172.217.194.0-255,2902,108841,7,218723
34359,0.037598,172.31.36.0-255,66,108907,7,218723
34360,0.037631,172.217.194.0-255,2902,111809,7,218723
34361,0.037644,172.31.36.0-255,66,111875,7,218723
34362,0.039889,172.217.194.0-255,2902,114777,7,218723
34363,0.039893,172.31.36.0-255,66,114843,7,218723
34364,0.039927,172.217.194.0-255,2902,117745,7,218723
34365,0.039938,172.31.36.0-255,66,117811,7,218723
34366,0.042163,172.217.194.0-255,2902,120713,7,218723
34367,0.042167,172.31.36.0-255,66,120779,7,218723
34368,0.042209,172.217.194.0-255,2902,123681,7,218723
34369,0.042315,172.31.36.0-255,66,123747,7,218723
34370,0.044462,172.217.194.0-255,2902,126649,7,218723
34371,0.044468,172.31.36.0-255,66,126715,7,218723
34372,0.044577,172.217.194.0-255,2902,129617,7,218723
34373,0.044582,172.31.36.0-255,66,129683,7,218723
34374,0.04677,172.217.194.0-255,2902,132585,7,218723
34375,0.046775,172.31.36.0-255,66,132651,7,218723
34376,0.046875,172.217.194.0-255,2902,135553,7,218723
34377,0.04688,172.31.36.0-255,66,135619,7,218723
34378,0.049068,172.217.194.0-255,2902,138521,7,218723
34379,0.049074,172.31.36.0-255,66,138587,7,218723
34380,0.04915,172.217.194.0-255,2902,141489,7,218723
34381,0.049159,172.31.36.0-255,66,141555,7,218723
34382,0.051351,172.217.194.0-255,2902,144457,7,218723
34383,0.051356,172.31.36.0-255,66,144523,7,218723
34384,0.0514,172.217.194.0-255,2902,147425,7,218723
34385,0.051411,172.31.36.0-255,66,147491,7,218723
34386,0.053644,172.217.194.0-255,2902,150393,7,218723
34387,0.053652,172.31.36.0-255,66,150459,7,218723
34388,0.053675,172.217.194.0-255,2902,153361,7,218723
34389,0.054411,172.31.36.0-255,66,153427,7,218723
34390,0.055953,172.217.194.0-255,2902,156329,7,218723
34391,0.055957,172.31.36.0-255,66,156395,7,218723
34392,0.056676,172.217.194.0-255,2902,159297,7,218723
34393,0.056681,172.31.36.0-255,66,159363,7,218723
34394,0.058227,172.217.194.0-255,2902,162265,7,218723
34395,0.058232,172.31.36.0-255,66,162331,7,218723
34396,0.058944,172.217.194.0-255,2902,165233,7,218723
34397,0.058948,172.31.36.0-255,66,165299,7,218723
34398,0.060499,172.217.194.0-255,2902,168201,7,218723
34399,0.060503,172.31.36.0-255,66,168267,7,218723
34400,0.061243,172.217.194.0-255,2902,171169,7,218723
34401,0.061249,172.31.36.0-255,66,171235,7,218723
34402,0.062767,172.217.194.0-255,2902,174137,7,218723
34403,0.062772,172.31.36.0-255,66,174203,7,218723
34404,0.063506,172.217.194.0-255,2902,177105,7,218723
34405,0.063512,172.31.36.0-255,66,177171,7,218723
34406,0.065049,172.217.194.0-255,2902,180073,7,218723
34407,0.065054,172.31.36.0-255,66,180139,7,218723
34408,0.065802,172.217.194.0-255,2902,183041,7,218723
34409,0.065807,172.31.36.0-255,66,183107,7,218723
34410,0.067331,172.217.194.0-255,2902,186009,7,218723
34411,0.067337,172.31.36.0-255,66,186075,7,218723
34412,0.068061,172.217.194.0-255,2902,188977,7,218723
34413,0.068066,172.31.36.0-255,66,189043,7,218723
34414,0.069621,172.217.194.0-255,2902,191945,7,218723
34415,0.069626,172.31.36.0-255,66,192011,7,218723
34416,0.070326,172.217.194.0-255,2902,194913,7,218723
34417,0.070331,172.31.36.0-255,66,194979,7,218723
34418,0.071882,172.217.194.0-255,2902,197881,7,218723
34419,0.071887,172.31.36.0-255,66,197947,7,218723
34420,0.072595,172.217.194.0-255,2902,200849,7,218723
34421,0.072601,172.31.36.0-255,66,200915,7,218723
34422,0.07416,172.217.194.0-255,2902,203817,7,218723
34423,0.074165,172.31.36.0-255,66,203883,7,218723
34424,0.07489,172.217.194.0-255,2902,206785,7,218723
34425,0.074895,172.31.36.0-255,66,206851,7,218723
34426,0.076427,172.217.194.0-255,2902,209753,7,218723
34427,0.076432,172.31.36.0-255,66,209819,7,218723
34428,0.077164,172.217.194.0-255,2902,212721,7,218723
34429,0.077169,172.31.36.0-255,66,212787,7,218723
34430,0.07871,172.217.194.0-255,2902,215689,7,218723
34431,0.078715,172.31.36.0-255,66,215755,7,218723
34432,0.079479,172.217.194.0-255,2902,218657,7,218723
34433,0.079484,172.31.36.0-255,66,218723,7,218723
34434,0.0,74.125.68.0-255,299,299,7,256592
34435,2.9e-05,172.31.36.0-255,66,365,7,256592
34436,3.7e-05,74.125.68.0-255,1484,1849,7,256592
34437,4.2e-05,172.31.36.0-255,66,1915,7,256592
34438,4.5e-05,74.125.68.0-255,1484,3399,7,256592
34439,4.6e-05,172.31.36.0-255,66,3465,7,256592
34440,5.1e-05,74.125.68.0-255,2902,6367,7,256592
34441,5.3e-05,172.31.36.0-255,66,6433,7,256592
34442,7.8e-05,74.125.68.0-255,5738,12171,7,256592
34443,8e-05,172.31.36.0-255,66,12237,7,256592
34444,9.3e-05,74.125.68.0-255,1750,13987,7,256592
34445,9.6e-05,172.31.36.0-255,66,14053,7,256592
34446,0.0001,74.125.68.0-255,2902,16955,7,256592
34447,0.000102,172.31.36.0-255,66,17021,7,256592
34448,0.000138,74.125.68.0-255,2902,19923,7,256592
34449,0.000142,172.31.36.0-255,66,19989,7,256592
34450,0.000161,74.125.68.0-255,4320,24309,7,256592
34451,0.000164,172.31.36.0-255,66,24375,7,256592
34452,0.000193,74.125.68.0-255,4320,28695,7,256592
34453,0.000196,172.31.36.0-255,66,28761,7,256592
34454,0.00021,74.125.68.0-255,2543,31304,7,256592
34455,0.000214,172.31.36.0-255,66,31370,7,256592
34456,0.002064,74.125.68.0-255,1484,32854,7,256592
34457,0.002072,172.31.36.0-255,66,32920,7,256592
34458,0.002082,74.125.68.0-255,2902,35822,7,256592
34459,0.002084,172.31.36.0-255,66,35888,7,256592
34460,0.002089,74.125.68.0-255,4320,40208,7,256592
34461,0.002091,172.31.36.0-255,66,40274,7,256592
34462,0.002111,74.125.68.0-255,1484,41758,7,256592
34463,0.002113,172.31.36.0-255,66,41824,7,256592
34464,0.002128,74.125.68.0-255,4320,46144,7,256592
34465,0.00213,172.31.36.0-255,66,46210,7,256592
34466,0.00215,74.125.68.0-255,2902,49112,7,256592
34467,0.002152,172.31.36.0-255,66,49178,7,256592
34468,0.002162,172.31.36.0-255,66,49244,7,256592
34469,0.002195,74.125.68.0-255,4320,53564,7,256592
34470,0.002197,172.31.36.0-255,66,53630,7,256592
34471,0.002218,74.125.68.0-255,3602,57232,7,256592
34472,0.002219,172.31.36.0-255,66,57298,7,256592
34473,0.004441,74.125.68.0-255,4320,61618,7,256592
34474,0.004447,172.31.36.0-255,66,61684,7,256592
34475,0.004466,74.125.68.0-255,1484,63168,7,256592
34476,0.006686,74.125.68.0-255,4320,67488,7,256592
34477,0.006691,172.31.36.0-255,66,67554,7,256592
34478,0.008938,74.125.68.0-255,5738,73292,7,256592
34479,0.008945,172.31.36.0-255,66,73358,7,256592
34480,0.011192,74.125.68.0-255,5738,79096,7,256592
34481,0.011199,172.31.36.0-255,66,79162,7,256592
34482,0.013449,74.125.68.0-255,5738,84900,7,256592
34483,0.013459,172.31.36.0-255,66,84966,7,256592
34484,0.015702,74.125.68.0-255,5738,90704,7,256592
34485,0.015711,172.31.36.0-255,66,90770,7,256592
34486,0.017948,74.125.68.0-255,5738,96508,7,256592
34487,0.017955,172.31.36.0-255,66,96574,7,256592
34488,0.020203,74.125.68.0-255,5738,102312,7,256592
34489,0.020209,172.31.36.0-255,66,102378,7,256592
34490,0.020946,172.31.36.0-255,172,102550,7,256592
34491,0.020979,172.31.36.0-255,1114,103664,7,256592
34492,0.021042,172.31.36.0-255,1514,105178,7,256592
34493,0.021044,172.31.36.0-255,1292,106470,7,256592
34494,0.022469,104.244.42.0-255,66,106536,7,256592
34495,0.022502,74.125.68.0-255,5738,112274,7,256592
34496,0.022507,172.31.36.0-255,66,112340,7,256592
34497,0.022558,104.244.42.0-255,66,112406,7,256592
34498,0.022602,104.244.42.0-255,66,112472,7,256592
34499,0.023123,104.244.42.0-255,108,112580,7,256592
34500,0.023129,172.31.36.0-255,66,112646,7,256592
34501,0.024766,74.125.68.0-255,5738,118384,7,256592
34502,0.024773,172.31.36.0-255,66,118450,7,256592
34503,0.027039,74.125.68.0-255,5738,124188,7,256592
34504,0.02706,172.31.36.0-255,66,124254,7,256592
34505,0.02931,74.125.68.0-255,5738,129992,7,256592
34506,0.029316,172.31.36.0-255,66,130058,7,256592
34507,0.031558,74.125.68.0-255,2902,132960,7,256592
34508,0.031565,172.31.36.0-255,66,133026,7,256592
34509,0.031587,74.125.68.0-255,2902,135928,7,256592
34510,0.03159,172.31.36.0-255,66,135994,7,256592
34511,0.033827,74.125.68.0-255,4320,140314,7,256592
34512,0.033835,172.31.36.0-255,66,140380,7,256592
34513,0.033853,74.125.68.0-255,1484,141864,7,256592
34514,0.036126,74.125.68.0-255,4320,146184,7,256592
34515,0.036133,172.31.36.0-255,66,146250,7,256592
34516,0.038374,74.125.68.0-255,5738,151988,7,256592
34517,0.03838,172.31.36.0-255,66,152054,7,256592
34518,0.04063,74.125.68.0-255,5738,157792,7,256592
34519,0.040637,172.31.36.0-255,66,157858,7,256592
34520,0.042896,74.125.68.0-255,5738,163596,7,256592
34521,0.042903,172.31.36.0-255,66,163662,7,256592
34522,0.045162,74.125.68.0-255,5738,169400,7,256592
34523,0.045169,172.31.36.0-255,66,169466,7,256592
34524,0.047423,74.125.68.0-255,5738,175204,7,256592
34525,0.04743,172.31.36.0-255,66,175270,7,256592
34526,0.049683,74.125.68.0-255,5738,181008,7,256592
34527,0.04969,172.31.36.0-255,66,181074,7,256592
34528,0.051941,74.125.68.0-255,5738,186812,7,256592
34529,0.051948,172.31.36.0-255,66,186878,7,256592
34530,0.0542,74.125.68.0-255,5738,192616,7,256592
34531,0.054206,172.31.36.0-255,66,192682,7,256592
34532,0.056455,74.125.68.0-255,5738,198420,7,256592
34533,0.056462,172.31.36.0-255,66,198486,7,256592
34534,0.058715,74.125.68.0-255,5738,204224,7,256592
34535,0.058721,172.31.36.0-255,66,204290,7,256592
34536,0.06098,74.125.68.0-255,5738,210028,7,256592
34537,0.060987,172.31.36.0-255,66,210094,7,256592
34538,0.063232,74.125.68.0-255,5738,215832,7,256592
34539,0.063239,172.31.36.0-255,66,215898,7,256592
34540,0.065479,74.125.68.0-255,5738,221636,7,256592
34541,0.065486,172.31.36.0-255,66,221702,7,256592
34542,0.06774,74.125.68.0-255,5738,227440,7,256592
34543,0.067747,172.31.36.0-255,66,227506,7,256592
34544,0.069988,74.125.68.0-255,5738,233244,7,256592
34545,0.069994,172.31.36.0-255,66,233310,7,256592
34546,0.072285,74.125.68.0-255,5738,239048,7,256592
34547,0.072295,172.31.36.0-255,66,239114,7,256592
34548,0.074547,74.125.68.0-255,5738,244852,7,256592
34549,0.074554,172.31.36.0-255,66,244918,7,256592
34550,0.076857,74.125.68.0-255,5738,250656,7,256592
34551,0.076863,172.31.36.0-255,66,250722,7,256592
34552,0.079116,74.125.68.0-255,4320,255042,7,256592
34553,0.079122,172.31.36.0-255,66,255108,7,256592
34554,0.079141,74.125.68.0-255,1484,256592,7,256592
34555,0.0,74.125.24.0-255,153,153,7,265405
34556,3.4e-05,172.31.36.0-255,66,219,7,265405
34557,4.2e-05,74.125.24.0-255,1484,1703,7,265405
34558,4.6e-05,172.31.36.0-255,66,1769,7,265405
34559,6e-05,74.125.24.0-255,2902,4671,7,265405
34560,6.3e-05,172.31.36.0-255,66,4737,7,265405
34561,7e-05,74.125.24.0-255,7156,11893,7,265405
34562,7.3e-05,172.31.36.0-255,66,11959,7,265405
34563,7.7e-05,74.125.24.0-255,2015,13974,7,265405
34564,7.9e-05,172.31.36.0-255,66,14040,7,265405
34565,0.000139,74.125.24.0-255,1484,15524,7,265405
34566,0.000143,172.31.36.0-255,66,15590,7,265405
34567,0.000148,74.125.24.0-255,2902,18492,7,265405
34568,0.000151,172.31.36.0-255,66,18558,7,265405
34569,0.000154,74.125.24.0-255,1484,20042,7,265405
34570,0.000161,172.31.36.0-255,66,20108,7,265405
34571,0.000197,74.125.24.0-255,4320,24428,7,265405
34572,0.0002,172.31.36.0-255,66,24494,7,265405
34573,0.000205,74.125.24.0-255,4320,28814,7,265405
34574,0.000208,172.31.36.0-255,66,28880,7,265405
34575,0.000241,74.125.24.0-255,2543,31423,7,265405
34576,0.000243,172.31.36.0-255,66,31489,7,265405
34577,0.000681,74.125.24.0-255,1484,32973,7,265405
34578,0.000686,172.31.36.0-255,66,33039,7,265405
34579,0.000695,74.125.24.0-255,2902,35941,7,265405
34580,0.000705,172.31.36.0-255,66,36007,7,265405
34581,0.000712,74.125.24.0-255,4320,40327,7,265405
34582,0.000714,172.31.36.0-255,66,40393,7,265405
34583,0.00074,74.125.24.0-255,1484,41877,7,265405
34584,0.000743,172.31.36.0-255,66,41943,7,265405
34585,0.000771,74.125.24.0-255,5738,47681,7,265405
34586,0.000775,172.31.36.0-255,66,47747,7,265405
34587,0.000805,74.125.24.0-255,1125,48872,7,265405
34588,0.000818,74.125.24.0-255,1484,50356,7,265405
34589,0.00082,172.31.36.0-255,66,50422,7,265405
34590,0.000848,74.125.24.0-255,4320,54742,7,265405
34591,0.000851,172.31.36.0-255,66,54808,7,265405
34592,0.000882,74.125.24.0-255,7156,61964,7,265405
34593,0.000885,172.31.36.0-255,66,62030,7,265405
34594,0.000914,74.125.24.0-255,2902,64932,7,265405
34595,0.000918,172.31.36.0-255,66,64998,7,265405
34596,0.000921,74.125.24.0-255,1125,66123,7,265405
34597,0.000923,74.125.24.0-255,647,66770,7,265405
34598,0.000926,172.31.36.0-255,66,66836,7,265405
34599,0.001108,74.125.24.0-255,1484,68320,7,265405
34600,0.001116,74.125.24.0-255,2902,71222,7,265405
34601,0.001121,172.31.36.0-255,66,71288,7,265405
34602,0.001125,74.125.24.0-255,2902,74190,7,265405
34603,0.001127,172.31.36.0-255,66,74256,7,265405
34604,0.001155,74.125.24.0-255,2902,77158,7,265405
34605,0.001164,74.125.24.0-255,2902,80060,7,265405
34606,0.001191,74.125.24.0-255,7156,87216,7,265405
34607,0.001209,74.125.24.0-255,3961,91177,7,265405
34608,0.001214,74.125.24.0-255,4320,95497,7,265405
34609,0.001246,74.125.24.0-255,2902,98399,7,265405
34610,0.001261,74.125.24.0-255,2543,100942,7,265405
34611,0.001733,74.125.24.0-255,1484,102426,7,265405
34612,0.001747,74.125.24.0-255,2902,105328,7,265405
34613,0.001793,74.125.24.0-255,5738,111066,7,265405
34614,0.001811,74.125.24.0-255,2902,113968,7,265405
34615,0.001851,74.125.24.0-255,1484,115452,7,265405
34616,0.001875,74.125.24.0-255,2902,118354,7,265405
34617,0.001888,74.125.24.0-255,5738,124092,7,265405
34618,0.001903,74.125.24.0-255,1484,125576,7,265405
34619,0.001921,74.125.24.0-255,766,126342,7,265405
34620,0.00206,74.125.24.0-255,1484,127826,7,265405
34621,0.002063,74.125.24.0-255,1484,129310,7,265405
34622,0.002073,74.125.24.0-255,1484,130794,7,265405
34623,0.002088,74.125.24.0-255,1484,132278,7,265405
34624,0.002104,74.125.24.0-255,4320,136598,7,265405
34625,0.002109,74.125.24.0-255,4320,140918,7,265405
34626,0.002111,74.125.24.0-255,1484,142402,7,265405
34627,0.002145,74.125.24.0-255,4320,146722,7,265405
34628,0.002169,74.125.24.0-255,1484,148206,7,265405
34629,0.002171,74.125.24.0-255,1484,149690,7,265405
34630,0.002174,74.125.24.0-255,766,150456,7,265405
34631,0.002228,74.125.24.0-255,1484,151940,7,265405
34632,0.002232,74.125.24.0-255,2902,154842,7,265405
34633,0.002237,74.125.24.0-255,2902,157744,7,265405
34634,0.00227,74.125.24.0-255,2902,160646,7,265405
34635,0.002276,74.125.24.0-255,6438,167084,7,265405
34636,0.002362,74.125.24.0-255,1484,168568,7,265405
34637,0.002372,74.125.24.0-255,1484,170052,7,265405
34638,0.002392,74.125.24.0-255,1484,171536,7,265405
34639,0.002397,74.125.24.0-255,5738,177274,7,265405
34640,0.00242,74.125.24.0-255,2902,180176,7,265405
34641,0.002444,74.125.24.0-255,7156,187332,7,265405
34642,0.002472,74.125.24.0-255,2902,190234,7,265405
34643,0.002476,74.125.24.0-255,2184,192418,7,265405
34644,0.002559,74.125.24.0-255,1484,193902,7,265405
34645,0.002573,74.125.24.0-255,2902,196804,7,265405
34646,0.002577,74.125.24.0-255,2902,199706,7,265405
34647,0.002593,74.125.24.0-255,2902,202608,7,265405
34648,0.002596,74.125.24.0-255,2902,205510,7,265405
34649,0.002643,74.125.24.0-255,5738,211248,7,265405
34650,0.002673,74.125.24.0-255,4320,215568,7,265405
34651,0.00276,74.125.24.0-255,5738,221306,7,265405
34652,0.002787,74.125.24.0-255,2184,223490,7,265405
34653,0.002815,74.125.24.0-255,1484,224974,7,265405
34654,0.002817,74.125.24.0-255,766,225740,7,265405
34655,0.00282,74.125.24.0-255,1484,227224,7,265405
34656,0.002845,74.125.24.0-255,1484,228708,7,265405
34657,0.002888,74.125.24.0-255,7156,235864,7,265405
34658,0.002901,74.125.24.0-255,1484,237348,7,265405
34659,0.002907,74.125.24.0-255,5738,243086,7,265405
34660,0.002909,74.125.24.0-255,1484,244570,7,265405
34661,0.002924,74.125.24.0-255,5738,250308,7,265405
34662,0.002947,74.125.24.0-255,6438,256746,7,265405
34663,0.002958,74.125.24.0-255,1484,258230,7,265405
34664,0.003006,74.125.24.0-255,2202,260432,7,265405
34665,0.003009,74.125.24.0-255,105,260537,7,265405
34666,0.003051,172.31.36.0-255,66,260603,7,265405
34667,0.005241,172.31.36.0-255,101,260704,7,265405
34668,0.006052,172.31.36.0-255,105,260809,7,265405
34669,0.007142,74.125.24.0-255,66,260875,7,265405
34670,0.007994,74.125.24.0-255,66,260941,7,265405
34671,0.031925,172.31.36.0-255,172,261113,7,265405
34672,0.031959,172.31.36.0-255,1116,262229,7,265405
34673,0.032004,172.31.36.0-255,1514,263743,7,265405
34674,0.032006,172.31.36.0-255,1290,265033,7,265405
34675,0.033483,104.244.42.0-255,66,265099,7,265405
34676,0.033523,104.244.42.0-255,66,265165,7,265405
34677,0.033577,104.244.42.0-255,66,265231,7,265405
34678,0.034144,104.244.42.0-255,108,265339,7,265405
34679,0.034149,172.31.36.0-255,66,265405,7,265405
34680,0.0,172.31.36.0-255,105,105,7,276
34681,0.068353,31.13.82.0-255,105,210,7,276
34682,0.068361,172.31.36.0-255,66,276,7,276
34683,0.0,74.125.130.0-255,153,153,7,337696
34684,5.2e-05,172.31.36.0-255,66,219,7,337696
34685,5.9e-05,74.125.130.0-255,1484,1703,7,337696
34686,6.3e-05,172.31.36.0-255,66,1769,7,337696
34687,6.7e-05,74.125.130.0-255,2902,4671,7,337696
34688,7.8e-05,172.31.36.0-255,66,4737,7,337696
34689,8.2e-05,74.125.130.0-255,2902,7639,7,337696
34690,8.5e-05,172.31.36.0-255,66,7705,7,337696
34691,0.000116,74.125.130.0-255,4320,12025,7,337696
34692,0.00012,172.31.36.0-255,66,12091,7,337696
34693,0.000136,74.125.130.0-255,2077,14168,7,337696
34694,0.000139,172.31.36.0-255,66,14234,7,337696
34695,0.000143,74.125.130.0-255,2902,17136,7,337696
34696,0.000145,172.31.36.0-255,66,17202,7,337696
34697,0.00017,74.125.130.0-255,4320,21522,7,337696
34698,0.000173,172.31.36.0-255,66,21588,7,337696
34699,0.000204,74.125.130.0-255,2902,24490,7,337696
34700,0.000208,172.31.36.0-255,66,24556,7,337696
34701,0.00023,74.125.130.0-255,1484,26040,7,337696
34702,0.000232,172.31.36.0-255,66,26106,7,337696
34703,0.000262,74.125.130.0-255,5379,31485,7,337696
34704,0.000265,172.31.36.0-255,66,31551,7,337696
34705,0.00034,74.125.130.0-255,1484,33035,7,337696
34706,0.000344,172.31.36.0-255,66,33101,7,337696
34707,0.00037,74.125.130.0-255,2902,36003,7,337696
34708,0.000373,172.31.36.0-255,66,36069,7,337696
34709,0.000376,74.125.130.0-255,1484,37553,7,337696
34710,0.000378,172.31.36.0-255,66,37619,7,337696
34711,0.00041,74.125.130.0-255,4320,41939,7,337696
34712,0.000414,172.31.36.0-255,66,42005,7,337696
34713,0.000421,74.125.130.0-255,7156,49161,7,337696
34714,0.000423,172.31.36.0-255,66,49227,7,337696
34715,0.000487,74.125.130.0-255,2902,52129,7,337696
34716,0.000489,172.31.36.0-255,66,52195,7,337696
34717,0.000493,172.31.36.0-255,66,52261,7,337696
34718,0.000515,74.125.130.0-255,2460,54721,7,337696
34719,0.000518,74.125.130.0-255,111,54832,7,337696
34720,0.000519,172.31.36.0-255,66,54898,7,337696
34721,0.00068,74.125.130.0-255,1484,56382,7,337696
34722,0.000684,172.31.36.0-255,66,56448,7,337696
34723,0.000689,74.125.130.0-255,2902,59350,7,337696
34724,0.000691,172.31.36.0-255,66,59416,7,337696
34725,0.000722,74.125.130.0-255,4320,63736,7,337696
34726,0.000726,172.31.36.0-255,66,63802,7,337696
34727,0.000753,74.125.130.0-255,1484,65286,7,337696
34728,0.000757,74.125.130.0-255,2902,68188,7,337696
34729,0.00076,172.31.36.0-255,66,68254,7,337696
34730,0.000765,74.125.130.0-255,4320,72574,7,337696
34731,0.000768,172.31.36.0-255,66,72640,7,337696
34732,0.000792,74.125.130.0-255,2902,75542,7,337696
34733,0.000795,172.31.36.0-255,66,75608,7,337696
34734,0.000824,74.125.130.0-255,5738,81346,7,337696
34735,0.000827,172.31.36.0-255,66,81412,7,337696
34736,0.000858,172.31.36.0-255,66,81478,7,337696
34737,0.000964,74.125.130.0-255,1484,82962,7,337696
34738,0.000979,74.125.130.0-255,2902,85864,7,337696
34739,0.000983,172.31.36.0-255,66,85930,7,337696
34740,0.001015,74.125.130.0-255,4320,90250,7,337696
34741,0.001019,172.31.36.0-255,66,90316,7,337696
34742,0.001045,172.31.36.0-255,66,90382,7,337696
34743,0.001049,74.125.130.0-255,2902,93284,7,337696
34744,0.001051,172.31.36.0-255,66,93350,7,337696
34745,0.001079,74.125.130.0-255,4320,97670,7,337696
34746,0.001082,172.31.36.0-255,66,97736,7,337696
34747,0.001115,172.31.36.0-255,66,97802,7,337696
34748,0.001118,74.125.130.0-255,766,98568,7,337696
34749,0.001232,74.125.130.0-255,1484,100052,7,337696
34750,0.001236,172.31.36.0-255,66,100118,7,337696
34751,0.001259,74.125.130.0-255,2902,103020,7,337696
34752,0.001261,172.31.36.0-255,66,103086,7,337696
34753,0.001264,74.125.130.0-255,1484,104570,7,337696
34754,0.001289,74.125.130.0-255,4320,108890,7,337696
34755,0.001292,172.31.36.0-255,66,108956,7,337696
34756,0.001294,74.125.130.0-255,1484,110440,7,337696
34757,0.001328,74.125.130.0-255,4320,114760,7,337696
34758,0.001331,172.31.36.0-255,66,114826,7,337696
34759,0.001337,74.125.130.0-255,7156,121982,7,337696
34760,0.001338,172.31.36.0-255,66,122048,7,337696
34761,0.001343,74.125.130.0-255,4320,126368,7,337696
34762,0.001345,172.31.36.0-255,66,126434,7,337696
34763,0.001367,74.125.130.0-255,4320,130754,7,337696
34764,0.001374,172.31.36.0-255,66,130820,7,337696
34765,0.001389,74.125.130.0-255,1484,132304,7,337696
34766,0.001392,74.125.130.0-255,766,133070,7,337696
34767,0.001395,172.31.36.0-255,66,133136,7,337696
34768,0.001816,74.125.130.0-255,1484,134620,7,337696
34769,0.001824,74.125.130.0-255,2902,137522,7,337696
34770,0.001827,172.31.36.0-255,66,137588,7,337696
34771,0.001856,74.125.130.0-255,5738,143326,7,337696
34772,0.001859,172.31.36.0-255,66,143392,7,337696
34773,0.001863,74.125.130.0-255,2902,146294,7,337696
34774,0.001865,172.31.36.0-255,66,146360,7,337696
34775,0.001883,74.125.130.0-255,4320,150680,7,337696
34776,0.001886,172.31.36.0-255,66,150746,7,337696
34777,0.001894,172.31.36.0-255,66,150812,7,337696
34778,0.001897,74.125.130.0-255,2902,153714,7,337696
34779,0.001904,172.31.36.0-255,66,153780,7,337696
34780,0.00193,74.125.130.0-255,2902,156682,7,337696
34781,0.001932,172.31.36.0-255,66,156748,7,337696
34782,0.00196,74.125.130.0-255,2184,158932,7,337696
34783,0.001962,172.31.36.0-255,66,158998,7,337696
34784,0.002283,74.125.130.0-255,1484,160482,7,337696
34785,0.002288,74.125.130.0-255,1484,161966,7,337696
34786,0.002291,172.31.36.0-255,66,162032,7,337696
34787,0.002318,74.125.130.0-255,1484,163516,7,337696
34788,0.002322,74.125.130.0-255,4320,167836,7,337696
34789,0.002324,172.31.36.0-255,66,167902,7,337696
34790,0.002329,74.125.130.0-255,5738,173640,7,337696
34791,0.00233,172.31.36.0-255,66,173706,7,337696
34792,0.002356,74.125.130.0-255,5738,179444,7,337696
34793,0.002358,172.31.36.0-255,66,179510,7,337696
34794,0.002383,74.125.130.0-255,5738,185248,7,337696
34795,0.002385,172.31.36.0-255,66,185314,7,337696
34796,0.002443,74.125.130.0-255,7156,192470,7,337696
34797,0.002445,172.31.36.0-255,66,192536,7,337696
34798,0.002472,74.125.130.0-255,5020,197556,7,337696
34799,0.002474,172.31.36.0-255,66,197622,7,337696
34800,0.002491,172.31.36.0-255,66,197688,7,337696
34801,0.002495,74.125.130.0-255,4320,202008,7,337696
34802,0.002497,172.31.36.0-255,66,202074,7,337696
34803,0.002535,172.31.36.0-255,66,202140,7,337696
34804,0.002567,172.31.36.0-255,66,202206,7,337696
34805,0.002572,74.125.130.0-255,5738,207944,7,337696
34806,0.002574,172.31.36.0-255,66,208010,7,337696
34807,0.002577,74.125.130.0-255,2902,210912,7,337696
34808,0.002579,172.31.36.0-255,66,210978,7,337696
34809,0.005073,74.125.130.0-255,5738,216716,7,337696
34810,0.005077,172.31.36.0-255,66,216782,7,337696
34811,0.007581,74.125.130.0-255,4320,221102,7,337696
34812,0.007588,172.31.36.0-255,66,221168,7,337696
34813,0.007623,74.125.130.0-255,1484,222652,7,337696
34814,0.01011,74.125.130.0-255,2902,225554,7,337696
34815,0.010118,172.31.36.0-255,66,225620,7,337696
34816,0.01015,74.125.130.0-255,1484,227104,7,337696
34817,0.012649,74.125.130.0-255,4320,231424,7,337696
34818,0.012656,172.31.36.0-255,66,231490,7,337696
34819,0.015175,74.125.130.0-255,5738,237228,7,337696
34820,0.015184,172.31.36.0-255,66,237294,7,337696
34821,0.017698,74.125.130.0-255,5738,243032,7,337696
34822,0.017705,172.31.36.0-255,66,243098,7,337696
34823,0.020216,74.125.130.0-255,5738,248836,7,337696
34824,0.020224,172.31.36.0-255,66,248902,7,337696
34825,0.022735,74.125.130.0-255,5738,254640,7,337696
34826,0.022743,172.31.36.0-255,66,254706,7,337696
34827,0.025249,74.125.130.0-255,5738,260444,7,337696
34828,0.025256,172.31.36.0-255,66,260510,7,337696
34829,0.027771,74.125.130.0-255,5738,266248,7,337696
34830,0.027779,172.31.36.0-255,66,266314,7,337696
34831,0.030294,74.125.130.0-255,5738,272052,7,337696
34832,0.030301,172.31.36.0-255,66,272118,7,337696
34833,0.03259,172.31.36.0-255,172,272290,7,337696
34834,0.032622,172.31.36.0-255,1113,273403,7,337696
34835,0.032659,172.31.36.0-255,566,273969,7,337696
34836,0.032797,74.125.130.0-255,4320,278289,7,337696
34837,0.032805,172.31.36.0-255,66,278355,7,337696
34838,0.032843,74.125.130.0-255,1484,279839,7,337696
34839,0.034161,104.244.42.0-255,66,279905,7,337696
34840,0.03417,104.244.42.0-255,66,279971,7,337696
34841,0.034202,104.244.42.0-255,66,280037,7,337696
34842,0.035305,74.125.130.0-255,4320,284357,7,337696
34843,0.035311,172.31.36.0-255,66,284423,7,337696
34844,0.03784,74.125.130.0-255,5738,290161,7,337696
34845,0.037847,172.31.36.0-255,66,290227,7,337696
34846,0.040365,74.125.130.0-255,5738,295965,7,337696
34847,0.040372,172.31.36.0-255,66,296031,7,337696
34848,0.042881,74.125.130.0-255,5738,301769,7,337696
34849,0.042887,172.31.36.0-255,66,301835,7,337696
34850,0.045403,74.125.130.0-255,5738,307573,7,337696
34851,0.045409,172.31.36.0-255,66,307639,7,337696
34852,0.047918,74.125.130.0-255,4320,311959,7,337696
34853,0.047924,172.31.36.0-255,66,312025,7,337696
34854,0.047958,74.125.130.0-255,1484,313509,7,337696
34855,0.050433,74.125.130.0-255,4320,317829,7,337696
34856,0.050438,172.31.36.0-255,66,317895,7,337696
34857,0.052954,74.125.130.0-255,5738,323633,7,337696
34858,0.05296,172.31.36.0-255,66,323699,7,337696
34859,0.055469,74.125.130.0-255,5738,329437,7,337696
34860,0.055475,172.31.36.0-255,66,329503,7,337696
34861,0.057984,74.125.130.0-255,5738,335241,7,337696
34862,0.05799,172.31.36.0-255,66,335307,7,337696
34863,0.060505,74.125.130.0-255,2152,337459,7,337696
34864,0.06051,172.31.36.0-255,66,337525,7,337696
34865,0.060688,172.31.36.0-255,105,337630,7,337696
34866,0.06316,74.125.130.0-255,66,337696,7,337696
34867,0.0,31.13.82.0-255,105,105,7,171
34868,2.2e-05,172.31.36.0-255,66,171,7,171
34869,0.0,172.217.194.0-255,153,153,7,189736
34870,3.7e-05,172.31.36.0-255,66,219,7,189736
34871,4.4e-05,172.217.194.0-255,1484,1703,7,189736
34872,4.7e-05,172.31.36.0-255,66,1769,7,189736
34873,5e-05,172.217.194.0-255,1484,3253,7,189736
34874,5.2e-05,172.31.36.0-255,66,3319,7,189736
34875,5.8e-05,172.217.194.0-255,2902,6221,7,189736
34876,6e-05,172.31.36.0-255,66,6287,7,189736
34877,6.7e-05,172.217.194.0-255,5738,12025,7,189736
34878,7.1e-05,172.31.36.0-255,66,12091,7,189736
34879,0.000121,172.31.36.0-255,66,12157,7,189736
34880,0.000132,172.31.36.0-255,66,12223,7,189736
34881,0.000183,172.217.194.0-255,1484,13707,7,189736
34882,0.000186,172.31.36.0-255,66,13773,7,189736
34883,0.000193,172.217.194.0-255,2902,16675,7,189736
34884,0.000195,172.31.36.0-255,66,16741,7,189736
34885,0.000217,172.217.194.0-255,5738,22479,7,189736
34886,0.00022,172.31.36.0-255,66,22545,7,189736
34887,0.000242,172.217.194.0-255,5738,28283,7,189736
34888,0.000244,172.31.36.0-255,66,28349,7,189736
34889,0.000258,172.217.194.0-255,1125,29474,7,189736
34890,0.00026,172.31.36.0-255,66,29540,7,189736
34891,0.000267,172.217.194.0-255,7156,36696,7,189736
34892,0.000269,172.31.36.0-255,66,36762,7,189736
34893,0.000296,172.31.36.0-255,66,36828,7,189736
34894,0.000312,172.217.194.0-255,398,37226,7,189736
34895,0.000315,172.31.36.0-255,66,37292,7,189736
34896,0.000395,172.217.194.0-255,1484,38776,7,189736
34897,0.000399,172.31.36.0-255,66,38842,7,189736
34898,0.000404,172.217.194.0-255,2902,41744,7,189736
34899,0.000411,172.217.194.0-255,5738,47482,7,189736
34900,0.000417,172.31.36.0-255,66,47548,7,189736
34901,0.000443,172.217.194.0-255,7156,54704,7,189736
34902,0.000448,172.31.36.0-255,66,54770,7,189736
34903,0.000459,172.217.194.0-255,4320,59090,7,189736
34904,0.000463,172.217.194.0-255,2902,61992,7,189736
34905,0.000467,172.31.36.0-255,66,62058,7,189736
34906,0.000496,172.31.36.0-255,66,62124,7,189736
34907,0.000652,172.217.194.0-255,1484,63608,7,189736
34908,0.000657,172.217.194.0-255,1484,65092,7,189736
34909,0.000661,172.31.36.0-255,66,65158,7,189736
34910,0.000684,172.217.194.0-255,1484,66642,7,189736
34911,0.000691,172.217.194.0-255,5738,72380,7,189736
34912,0.000696,172.217.194.0-255,5738,78118,7,189736
34913,0.000699,172.31.36.0-255,66,78184,7,189736
34914,0.000704,172.31.36.0-255,66,78250,7,189736
34915,0.000758,172.31.36.0-255,66,78316,7,189736
34916,0.000777,172.217.194.0-255,5020,83336,7,189736
34917,0.000787,172.31.36.0-255,66,83402,7,189736
34918,0.000807,172.217.194.0-255,1484,84886,7,189736
34919,0.000812,172.217.194.0-255,1484,86370,7,189736
34920,0.000815,172.31.36.0-255,66,86436,7,189736
34921,0.000823,172.217.194.0-255,1484,87920,7,189736
34922,0.00084,172.217.194.0-255,5738,93658,7,189736
34923,0.00085,172.31.36.0-255,66,93724,7,189736
34924,0.000865,172.217.194.0-255,4320,98044,7,189736
34925,0.000882,172.31.36.0-255,66,98110,7,189736
34926,0.000893,172.217.194.0-255,1484,99594,7,189736
34927,0.000897,172.31.36.0-255,66,99660,7,189736
34928,0.000933,172.31.36.0-255,66,99726,7,189736
34929,0.000949,172.31.36.0-255,66,99792,7,189736
34930,0.000987,172.217.194.0-255,2902,102694,7,189736
34931,0.000998,172.31.36.0-255,66,102760,7,189736
34932,0.001015,172.217.194.0-255,5738,108498,7,189736
34933,0.001025,172.31.36.0-255,66,108564,7,189736
34934,0.001039,172.31.36.0-255,66,108630,7,189736
34935,0.001076,172.217.194.0-255,1484,110114,7,189736
34936,0.001082,172.31.36.0-255,66,110180,7,189736
34937,0.001096,172.217.194.0-255,7156,117336,7,189736
34938,0.001101,172.31.36.0-255,66,117402,7,189736
34939,0.001127,172.217.194.0-255,766,118168,7,189736
34940,0.001131,172.31.36.0-255,66,118234,7,189736
34941,0.00114,172.217.194.0-255,1484,119718,7,189736
34942,0.001175,172.31.36.0-255,66,119784,7,189736
34943,0.001191,172.31.36.0-255,66,119850,7,189736
34944,0.001207,172.217.194.0-255,1484,121334,7,189736
34945,0.001216,172.217.194.0-255,6438,127772,7,189736
34946,0.001228,172.31.36.0-255,66,127838,7,189736
34947,0.001241,172.217.194.0-255,1484,129322,7,189736
34948,0.001258,172.217.194.0-255,2902,132224,7,189736
34949,0.001268,172.31.36.0-255,66,132290,7,189736
34950,0.001281,172.217.194.0-255,5738,138028,7,189736
34951,0.001294,172.31.36.0-255,66,138094,7,189736
34952,0.001307,172.217.194.0-255,7156,145250,7,189736
34953,0.001311,172.217.194.0-255,1484,146734,7,189736
34954,0.001319,172.31.36.0-255,66,146800,7,189736
34955,0.001334,172.217.194.0-255,7156,153956,7,189736
34956,0.001343,172.31.36.0-255,66,154022,7,189736
34957,0.001356,172.217.194.0-255,4320,158342,7,189736
34958,0.001361,172.31.36.0-255,66,158408,7,189736
34959,0.001401,172.217.194.0-255,3602,162010,7,189736
34960,0.001409,172.31.36.0-255,66,162076,7,189736
34961,0.001441,172.217.194.0-255,4320,166396,7,189736
34962,0.001447,172.217.194.0-255,4320,170716,7,189736
34963,0.001451,172.31.36.0-255,66,170782,7,189736
34964,0.001495,172.31.36.0-255,66,170848,7,189736
34965,0.0015,172.217.194.0-255,1484,172332,7,189736
34966,0.001531,172.31.36.0-255,66,172398,7,189736
34967,0.001556,172.217.194.0-255,4320,176718,7,189736
34968,0.001563,172.217.194.0-255,5738,182456,7,189736
34969,0.001567,172.31.36.0-255,66,182522,7,189736
34970,0.001607,172.31.36.0-255,66,182588,7,189736
34971,0.001659,172.31.36.0-255,66,182654,7,189736
34972,0.00167,172.217.194.0-255,2184,184838,7,189736
34973,0.001677,172.31.36.0-255,66,184904,7,189736
34974,0.00169,172.31.36.0-255,66,184970,7,189736
34975,0.001716,172.31.36.0-255,66,185036,7,189736
34976,0.001738,172.31.36.0-255,66,185102,7,189736
34977,0.001777,172.217.194.0-255,105,185207,7,189736
34978,0.001787,172.31.36.0-255,66,185273,7,189736
34979,0.003968,172.31.36.0-255,105,185378,7,189736
34980,0.006021,172.217.194.0-255,66,185444,7,189736
34981,0.027239,172.31.36.0-255,172,185616,7,189736
34982,0.027286,172.31.36.0-255,1112,186728,7,189736
34983,0.02735,172.31.36.0-255,1514,188242,7,189736
34984,0.027352,172.31.36.0-255,1296,189538,7,189736
34985,0.028748,104.244.42.0-255,66,189604,7,189736
34986,0.028786,104.244.42.0-255,66,189670,7,189736
34987,0.028852,104.244.42.0-255,66,189736,7,189736
34988,0.0,74.125.24.0-255,152,152,7,328426
34989,3.6e-05,172.31.36.0-255,66,218,7,328426
34990,4.4e-05,74.125.24.0-255,1484,1702,7,328426
34991,4.8e-05,172.31.36.0-255,66,1768,7,328426
34992,5.3e-05,74.125.24.0-255,2902,4670,7,328426
34993,6.3e-05,172.31.36.0-255,66,4736,7,328426
34994,7e-05,74.125.24.0-255,5738,10474,7,328426
34995,7.3e-05,172.31.36.0-255,66,10540,7,328426
34996,7.8e-05,74.125.24.0-255,3454,13994,7,328426
34997,8.1e-05,172.31.36.0-255,66,14060,7,328426
34998,0.000124,74.125.24.0-255,1484,15544,7,328426
34999,0.000127,172.31.36.0-255,66,15610,7,328426
35000,0.000147,74.125.24.0-255,5738,21348,7,328426
35001,0.000151,172.31.36.0-255,66,21414,7,328426
35002,0.000186,74.125.24.0-255,4320,25734,7,328426
35003,0.000189,172.31.36.0-255,66,25800,7,328426
35004,0.000196,74.125.24.0-255,5379,31179,7,328426
35005,0.000198,172.31.36.0-255,66,31245,7,328426
35006,0.000259,74.125.24.0-255,1484,32729,7,328426
35007,0.000262,172.31.36.0-255,66,32795,7,328426
35008,0.000279,74.125.24.0-255,2902,35697,7,328426
35009,0.000282,172.31.36.0-255,66,35763,7,328426
35010,0.000287,74.125.24.0-255,2902,38665,7,328426
35011,0.000289,172.31.36.0-255,66,38731,7,328426
35012,0.000316,74.125.24.0-255,2902,41633,7,328426
35013,0.000325,172.31.36.0-255,66,41699,7,328426
35014,0.000364,172.31.36.0-255,66,41765,7,328426
35015,0.000392,74.125.24.0-255,7156,48921,7,328426
35016,0.000395,172.31.36.0-255,66,48987,7,328426
35017,0.000427,74.125.24.0-255,3961,52948,7,328426
35018,0.000432,172.31.36.0-255,66,53014,7,328426
35019,0.000435,74.125.24.0-255,404,53418,7,328426
35020,0.000761,74.125.24.0-255,341,53759,7,328426
35021,0.000827,172.31.36.0-255,66,53825,7,328426
35022,0.00099,74.125.24.0-255,1484,55309,7,328426
35023,0.001,74.125.24.0-255,2902,58211,7,328426
35024,0.001004,172.31.36.0-255,66,58277,7,328426
35025,0.001011,74.125.24.0-255,5738,64015,7,328426
35026,0.001013,172.31.36.0-255,66,64081,7,328426
35027,0.001037,74.125.24.0-255,1484,65565,7,328426
35028,0.001073,172.31.36.0-255,66,65631,7,328426
35029,0.001104,74.125.24.0-255,4320,69951,7,328426
35030,0.001107,172.31.36.0-255,66,70017,7,328426
35031,0.00113,74.125.24.0-255,6438,76455,7,328426
35032,0.001133,172.31.36.0-255,66,76521,7,328426
35033,0.001964,74.125.24.0-255,1484,78005,7,328426
35034,0.001971,74.125.24.0-255,2902,80907,7,328426
35035,0.001976,172.31.36.0-255,66,80973,7,328426
35036,0.001984,74.125.24.0-255,5738,86711,7,328426
35037,0.001985,172.31.36.0-255,66,86777,7,328426
35038,0.002023,172.31.36.0-255,66,86843,7,328426
35039,0.002029,74.125.24.0-255,7156,93999,7,328426
35040,0.002031,172.31.36.0-255,66,94065,7,328426
35041,0.004013,74.125.24.0-255,5738,99803,7,328426
35042,0.004017,172.31.36.0-255,66,99869,7,328426
35043,0.005992,74.125.24.0-255,5738,105607,7,328426
35044,0.005997,172.31.36.0-255,66,105673,7,328426
35045,0.007993,74.125.24.0-255,5738,111411,7,328426
35046,0.008003,172.31.36.0-255,66,111477,7,328426
35047,0.009993,74.125.24.0-255,5738,117215,7,328426
35048,0.010007,172.31.36.0-255,66,117281,7,328426
35049,0.012003,74.125.24.0-255,5738,123019,7,328426
35050,0.012021,172.31.36.0-255,66,123085,7,328426
35051,0.014013,74.125.24.0-255,5738,128823,7,328426
35052,0.014021,172.31.36.0-255,66,128889,7,328426
35053,0.016037,74.125.24.0-255,5738,134627,7,328426
35054,0.016047,172.31.36.0-255,66,134693,7,328426
35055,0.018012,74.125.24.0-255,5738,140431,7,328426
35056,0.01802,172.31.36.0-255,66,140497,7,328426
35057,0.019985,74.125.24.0-255,5738,146235,7,328426
35058,0.019992,172.31.36.0-255,66,146301,7,328426
35059,0.021977,74.125.24.0-255,5738,152039,7,328426
35060,0.021986,172.31.36.0-255,66,152105,7,328426
35061,0.02396,74.125.24.0-255,5738,157843,7,328426
35062,0.023968,172.31.36.0-255,66,157909,7,328426
35063,0.025964,74.125.24.0-255,5738,163647,7,328426
35064,0.025971,172.31.36.0-255,66,163713,7,328426
35065,0.027977,74.125.24.0-255,5738,169451,7,328426
35066,0.027984,172.31.36.0-255,66,169517,7,328426
35067,0.028114,172.31.36.0-255,101,169618,7,328426
35068,0.029949,74.125.24.0-255,5738,175356,7,328426
35069,0.029956,172.31.36.0-255,66,175422,7,328426
35070,0.030033,74.125.24.0-255,66,175488,7,328426
35071,0.031931,74.125.24.0-255,5738,181226,7,328426
35072,0.031938,172.31.36.0-255,66,181292,7,328426
35073,0.03394,74.125.24.0-255,5738,187030,7,328426
35074,0.033948,172.31.36.0-255,66,187096,7,328426
35075,0.035922,74.125.24.0-255,5738,192834,7,328426
35076,0.035938,172.31.36.0-255,66,192900,7,328426
35077,0.037938,74.125.24.0-255,5738,198638,7,328426
35078,0.03795,172.31.36.0-255,66,198704,7,328426
35079,0.039945,74.125.24.0-255,5738,204442,7,328426
35080,0.039968,172.31.36.0-255,66,204508,7,328426
35081,0.041975,74.125.24.0-255,5738,210246,7,328426
35082,0.041984,172.31.36.0-255,66,210312,7,328426
35083,0.044004,74.125.24.0-255,5738,216050,7,328426
35084,0.044012,172.31.36.0-255,66,216116,7,328426
35085,0.046023,74.125.24.0-255,5738,221854,7,328426
35086,0.04603,172.31.36.0-255,66,221920,7,328426
35087,0.048,74.125.24.0-255,5738,227658,7,328426
35088,0.048006,172.31.36.0-255,66,227724,7,328426
35089,0.04994,172.31.36.0-255,172,227896,7,328426
35090,0.04997,172.31.36.0-255,1113,229009,7,328426
35091,0.050002,74.125.24.0-255,4320,233329,7,328426
35092,0.050007,172.31.36.0-255,66,233395,7,328426
35093,0.05002,172.31.36.0-255,1514,234909,7,328426
35094,0.050023,172.31.36.0-255,1514,236423,7,328426
35095,0.050025,172.31.36.0-255,1514,237937,7,328426
35096,0.05003,172.31.36.0-255,1514,239451,7,328426
35097,0.050031,172.31.36.0-255,1514,240965,7,328426
35098,0.050032,172.31.36.0-255,71,241036,7,328426
35099,0.050039,74.125.24.0-255,1484,242520,7,328426
35100,0.051484,104.244.42.0-255,66,242586,7,328426
35101,0.051527,104.244.42.0-255,66,242652,7,328426
35102,0.051619,104.244.42.0-255,66,242718,7,328426
35103,0.051625,104.244.42.0-255,66,242784,7,328426
35104,0.05203,74.125.24.0-255,4320,247104,7,328426
35105,0.052039,172.31.36.0-255,66,247170,7,328426
35106,0.054045,74.125.24.0-255,5738,252908,7,328426
35107,0.054052,172.31.36.0-255,66,252974,7,328426
35108,0.056024,74.125.24.0-255,5738,258712,7,328426
35109,0.056032,172.31.36.0-255,66,258778,7,328426
35110,0.057997,74.125.24.0-255,5738,264516,7,328426
35111,0.058004,172.31.36.0-255,66,264582,7,328426
35112,0.05997,74.125.24.0-255,5738,270320,7,328426
35113,0.059976,172.31.36.0-255,66,270386,7,328426
35114,0.061944,74.125.24.0-255,5738,276124,7,328426
35115,0.06195,172.31.36.0-255,66,276190,7,328426
35116,0.063944,74.125.24.0-255,5738,281928,7,328426
35117,0.06395,172.31.36.0-255,66,281994,7,328426
35118,0.06598,74.125.24.0-255,5738,287732,7,328426
35119,0.065986,172.31.36.0-255,66,287798,7,328426
35120,0.067964,74.125.24.0-255,5738,293536,7,328426
35121,0.067969,172.31.36.0-255,66,293602,7,328426
35122,0.06995,74.125.24.0-255,5738,299340,7,328426
35123,0.069955,172.31.36.0-255,66,299406,7,328426
35124,0.071919,74.125.24.0-255,5738,305144,7,328426
35125,0.071925,172.31.36.0-255,66,305210,7,328426
35126,0.073878,74.125.24.0-255,5738,310948,7,328426
35127,0.073883,172.31.36.0-255,66,311014,7,328426
35128,0.075836,74.125.24.0-255,5738,316752,7,328426
35129,0.075841,172.31.36.0-255,66,316818,7,328426
35130,0.077842,74.125.24.0-255,5738,322556,7,328426
35131,0.077848,172.31.36.0-255,66,322622,7,328426
35132,0.079835,74.125.24.0-255,5738,328360,7,328426
35133,0.079841,172.31.36.0-255,66,328426,7,328426
35134,0.0,172.217.194.0-255,156,156,7,142836
35135,1.6e-05,172.31.36.0-255,66,222,7,142836
35136,2.2e-05,172.217.194.0-255,1484,1706,7,142836
35137,2.6e-05,172.31.36.0-255,66,1772,7,142836
35138,2.9e-05,172.217.194.0-255,1484,3256,7,142836
35139,3.2e-05,172.31.36.0-255,66,3322,7,142836
35140,4.6e-05,172.217.194.0-255,2902,6224,7,142836
35141,4.9e-05,172.31.36.0-255,66,6290,7,142836
35142,5.6e-05,172.217.194.0-255,5738,12028,7,142836
35143,5.8e-05,172.31.36.0-255,66,12094,7,142836
35144,0.000105,172.31.36.0-255,66,12160,7,142836
35145,0.000111,172.217.194.0-255,5379,17539,7,142836
35146,0.000113,172.31.36.0-255,66,17605,7,142836
35147,0.000162,172.217.194.0-255,1484,19089,7,142836
35148,0.000164,172.31.36.0-255,66,19155,7,142836
35149,0.000169,172.217.194.0-255,2902,22057,7,142836
35150,0.000171,172.31.36.0-255,66,22123,7,142836
35151,0.000203,172.217.194.0-255,5738,27861,7,142836
35152,0.000206,172.31.36.0-255,66,27927,7,142836
35153,0.000209,172.217.194.0-255,1484,29411,7,142836
35154,0.000211,172.31.36.0-255,66,29477,7,142836
35155,0.000228,172.31.36.0-255,66,29543,7,142836
35156,0.000271,172.31.36.0-255,66,29609,7,142836
35157,0.000321,172.217.194.0-255,99,29708,7,142836
35158,0.000324,172.31.36.0-255,66,29774,7,142836
35159,0.000355,172.217.194.0-255,363,30137,7,142836
35160,0.000358,172.31.36.0-255,66,30203,7,142836
35161,0.000519,172.217.194.0-255,1484,31687,7,142836
35162,0.000521,172.31.36.0-255,66,31753,7,142836
35163,0.000527,172.217.194.0-255,2902,34655,7,142836
35164,0.000529,172.31.36.0-255,66,34721,7,142836
35165,0.000542,172.217.194.0-255,5738,40459,7,142836
35166,0.000544,172.31.36.0-255,66,40525,7,142836
35167,0.000581,172.31.36.0-255,66,40591,7,142836
35168,0.0006,172.31.36.0-255,66,40657,7,142836
35169,0.000806,172.217.194.0-255,1484,42141,7,142836
35170,0.000813,172.217.194.0-255,2902,45043,7,142836
35171,0.000816,172.31.36.0-255,66,45109,7,142836
35172,0.000848,172.217.194.0-255,5738,50847,7,142836
35173,0.000852,172.31.36.0-255,66,50913,7,142836
35174,0.000871,172.31.36.0-255,66,50979,7,142836
35175,0.000874,172.217.194.0-255,1484,52463,7,142836
35176,0.000904,172.217.194.0-255,2902,55365,7,142836
35177,0.000908,172.31.36.0-255,66,55431,7,142836
35178,0.000946,172.31.36.0-255,66,55497,7,142836
35179,0.000966,172.31.36.0-255,66,55563,7,142836
35180,0.000986,172.217.194.0-255,5738,61301,7,142836
35181,0.000989,172.31.36.0-255,66,61367,7,142836
35182,0.001026,172.31.36.0-255,66,61433,7,142836
35183,0.001068,172.31.36.0-255,66,61499,7,142836
35184,0.001073,172.217.194.0-255,4320,65819,7,142836
35185,0.001076,172.31.36.0-255,66,65885,7,142836
35186,0.001114,172.31.36.0-255,66,65951,7,142836
35187,0.001118,172.217.194.0-255,2184,68135,7,142836
35188,0.00112,172.31.36.0-255,66,68201,7,142836
35189,0.001153,172.217.194.0-255,2902,71103,7,142836
35190,0.001156,172.31.36.0-255,66,71169,7,142836
35191,0.00116,172.217.194.0-255,1484,72653,7,142836
35192,0.001185,172.217.194.0-255,2902,75555,7,142836
35193,0.001188,172.31.36.0-255,66,75621,7,142836
35194,0.001197,172.31.36.0-255,66,75687,7,142836
35195,0.001218,172.217.194.0-255,4320,80007,7,142836
35196,0.001226,172.31.36.0-255,66,80073,7,142836
35197,0.001265,172.31.36.0-255,66,80139,7,142836
35198,0.001269,172.217.194.0-255,2902,83041,7,142836
35199,0.001272,172.217.194.0-255,2902,85943,7,142836
35200,0.001273,172.31.36.0-255,66,86009,7,142836
35201,0.001276,172.31.36.0-255,66,86075,7,142836
35202,0.001303,172.217.194.0-255,1484,87559,7,142836
35203,0.00132,172.31.36.0-255,66,87625,7,142836
35204,0.001337,172.31.36.0-255,66,87691,7,142836
35205,0.001373,172.31.36.0-255,66,87757,7,142836
35206,0.001376,172.217.194.0-255,1484,89241,7,142836
35207,0.00138,172.217.194.0-255,2902,92143,7,142836
35208,0.001382,172.31.36.0-255,66,92209,7,142836
35209,0.001388,172.217.194.0-255,4320,96529,7,142836
35210,0.00139,172.31.36.0-255,66,96595,7,142836
35211,0.001418,172.217.194.0-255,1484,98079,7,142836
35212,0.00144,172.31.36.0-255,66,98145,7,142836
35213,0.001452,172.31.36.0-255,66,98211,7,142836
35214,0.001455,172.217.194.0-255,766,98977,7,142836
35215,0.001516,172.217.194.0-255,1484,100461,7,142836
35216,0.00152,172.31.36.0-255,66,100527,7,142836
35217,0.001526,172.217.194.0-255,4320,104847,7,142836
35218,0.001529,172.31.36.0-255,66,104913,7,142836
35219,0.001541,172.217.194.0-255,5738,110651,7,142836
35220,0.001544,172.31.36.0-255,66,110717,7,142836
35221,0.001557,172.31.36.0-255,66,110783,7,142836
35222,0.001591,172.31.36.0-255,66,110849,7,142836
35223,0.001618,172.217.194.0-255,1484,112333,7,142836
35224,0.001621,172.217.194.0-255,1484,113817,7,142836
35225,0.001625,172.31.36.0-255,66,113883,7,142836
35226,0.001649,172.217.194.0-255,1484,115367,7,142836
35227,0.001657,172.217.194.0-255,5738,121105,7,142836
35228,0.001659,172.31.36.0-255,66,121171,7,142836
35229,0.001664,172.217.194.0-255,4320,125491,7,142836
35230,0.001667,172.31.36.0-255,66,125557,7,142836
35231,0.001704,172.31.36.0-255,66,125623,7,142836
35232,0.001713,172.31.36.0-255,66,125689,7,142836
35233,0.001724,172.217.194.0-255,2902,128591,7,142836
35234,0.001727,172.31.36.0-255,66,128657,7,142836
35235,0.001775,172.31.36.0-255,66,128723,7,142836
35236,0.00179,172.31.36.0-255,66,128789,7,142836
35237,0.001805,172.217.194.0-255,2902,131691,7,142836
35238,0.001814,172.31.36.0-255,66,131757,7,142836
35239,0.001833,172.217.194.0-255,6101,137858,7,142836
35240,0.001837,172.217.194.0-255,97,137955,7,142836
35241,0.001854,172.31.36.0-255,66,138021,7,142836
35242,0.001859,172.217.194.0-255,105,138126,7,142836
35243,0.008705,172.31.36.0-255,66,138192,7,142836
35244,0.008734,172.31.36.0-255,105,138297,7,142836
35245,0.010415,172.217.194.0-255,105,138402,7,142836
35246,0.010424,172.31.36.0-255,78,138480,7,142836
35247,0.010652,172.217.194.0-255,66,138546,7,142836
35248,0.045756,172.31.36.0-255,172,138718,7,142836
35249,0.045803,172.31.36.0-255,1115,139833,7,142836
35250,0.045828,172.31.36.0-255,1514,141347,7,142836
35251,0.04583,172.31.36.0-255,1291,142638,7,142836
35252,0.047313,104.244.42.0-255,66,142704,7,142836
35253,0.047356,104.244.42.0-255,66,142770,7,142836
35254,0.047403,104.244.42.0-255,66,142836,7,142836
35255,0.0,74.125.68.0-255,145,145,7,325721
35256,3.4e-05,172.31.36.0-255,66,211,7,325721
35257,4.1e-05,74.125.68.0-255,1484,1695,7,325721
35258,4.5e-05,172.31.36.0-255,66,1761,7,325721
35259,5e-05,74.125.68.0-255,2902,4663,7,325721
35260,5.3e-05,172.31.36.0-255,66,4729,7,325721
35261,5.6e-05,74.125.68.0-255,1484,6213,7,325721
35262,5.8e-05,172.31.36.0-255,66,6279,7,325721
35263,8.2e-05,74.125.68.0-255,2902,9181,7,325721
35264,8.5e-05,172.31.36.0-255,66,9247,7,325721
35265,0.000105,74.125.68.0-255,7156,16403,7,325721
35266,0.000108,172.31.36.0-255,66,16469,7,325721
35267,0.00013,74.125.68.0-255,2047,18516,7,325721
35268,0.000133,172.31.36.0-255,66,18582,7,325721
35269,0.0002,74.125.68.0-255,2902,21484,7,325721
35270,0.000204,172.31.36.0-255,66,21550,7,325721
35271,0.000221,74.125.68.0-255,1484,23034,7,325721
35272,0.000223,172.31.36.0-255,66,23100,7,325721
35273,0.000268,172.31.36.0-255,66,23166,7,325721
35274,0.000555,74.125.68.0-255,1484,24650,7,325721
35275,0.000559,172.31.36.0-255,66,24716,7,325721
35276,0.000583,74.125.68.0-255,2902,27618,7,325721
35277,0.000586,172.31.36.0-255,66,27684,7,325721
35278,0.000592,74.125.68.0-255,5738,33422,7,325721
35279,0.000594,172.31.36.0-255,66,33488,7,325721
35280,0.000644,74.125.68.0-255,2902,36390,7,325721
35281,0.000649,172.31.36.0-255,66,36456,7,325721
35282,0.000684,74.125.68.0-255,4320,40776,7,325721
35283,0.000687,172.31.36.0-255,66,40842,7,325721
35284,0.000708,74.125.68.0-255,1484,42326,7,325721
35285,0.000712,172.31.36.0-255,66,42392,7,325721
35286,0.000739,74.125.68.0-255,7156,49548,7,325721
35287,0.000743,172.31.36.0-255,66,49614,7,325721
35288,0.000824,172.31.36.0-255,66,49680,7,325721
35289,0.000933,74.125.68.0-255,414,50094,7,325721
35290,0.000972,74.125.68.0-255,1484,51578,7,325721
35291,0.000978,172.31.36.0-255,66,51644,7,325721
35292,0.000985,74.125.68.0-255,4320,55964,7,325721
35293,0.000987,172.31.36.0-255,66,56030,7,325721
35294,0.001019,74.125.68.0-255,2902,58932,7,325721
35295,0.001022,172.31.36.0-255,66,58998,7,325721
35296,0.001045,74.125.68.0-255,5738,64736,7,325721
35297,0.001048,172.31.36.0-255,66,64802,7,325721
35298,0.001117,74.125.68.0-255,5738,70540,7,325721
35299,0.001121,172.31.36.0-255,66,70606,7,325721
35300,0.001144,74.125.68.0-255,4320,74926,7,325721
35301,0.001148,172.31.36.0-255,66,74992,7,325721
35302,0.001224,74.125.68.0-255,5738,80730,7,325721
35303,0.001229,172.31.36.0-255,66,80796,7,325721
35304,0.00125,74.125.68.0-255,3602,84398,7,325721
35305,0.001253,172.31.36.0-255,66,84464,7,325721
35306,0.001285,74.125.68.0-255,330,84794,7,325721
35307,0.001543,172.31.36.0-255,66,84860,7,325721
35308,0.001645,74.125.68.0-255,1484,86344,7,325721
35309,0.001662,74.125.68.0-255,2902,89246,7,325721
35310,0.001665,172.31.36.0-255,66,89312,7,325721
35311,0.001682,74.125.68.0-255,4320,93632,7,325721
35312,0.001684,172.31.36.0-255,66,93698,7,325721
35313,0.001722,74.125.68.0-255,5738,99436,7,325721
35314,0.001724,172.31.36.0-255,66,99502,7,325721
35315,0.001743,74.125.68.0-255,2902,102404,7,325721
35316,0.001745,172.31.36.0-255,66,102470,7,325721
35317,0.001812,74.125.68.0-255,4320,106790,7,325721
35318,0.001815,172.31.36.0-255,66,106856,7,325721
35319,0.001829,74.125.68.0-255,1484,108340,7,325721
35320,0.001879,74.125.68.0-255,4320,112660,7,325721
35321,0.001883,172.31.36.0-255,66,112726,7,325721
35322,0.001903,74.125.68.0-255,6438,119164,7,325721
35323,0.001905,172.31.36.0-255,66,119230,7,325721
35324,0.002117,74.125.68.0-255,1484,120714,7,325721
35325,0.002136,74.125.68.0-255,2902,123616,7,325721
35326,0.00214,172.31.36.0-255,66,123682,7,325721
35327,0.002147,74.125.68.0-255,5738,129420,7,325721
35328,0.002149,172.31.36.0-255,66,129486,7,325721
35329,0.002211,172.31.36.0-255,66,129552,7,325721
35330,0.002296,74.125.68.0-255,5738,135290,7,325721
35331,0.002299,172.31.36.0-255,66,135356,7,325721
35332,0.002319,74.125.68.0-255,4320,139676,7,325721
35333,0.002321,172.31.36.0-255,66,139742,7,325721
35334,0.002415,172.31.36.0-255,66,139808,7,325721
35335,0.002439,172.31.36.0-255,66,139874,7,325721
35336,0.002625,74.125.68.0-255,5738,145612,7,325721
35337,0.002629,172.31.36.0-255,66,145678,7,325721
35338,0.002645,74.125.68.0-255,1484,147162,7,325721
35339,0.002701,74.125.68.0-255,5738,152900,7,325721
35340,0.002704,172.31.36.0-255,66,152966,7,325721
35341,0.002727,74.125.68.0-255,5020,157986,7,325721
35342,0.00273,172.31.36.0-255,66,158052,7,325721
35343,0.002813,74.125.68.0-255,1484,159536,7,325721
35344,0.002831,74.125.68.0-255,5738,165274,7,325721
35345,0.002834,172.31.36.0-255,66,165340,7,325721
35346,0.002873,172.31.36.0-255,66,165406,7,325721
35347,0.003073,74.125.68.0-255,7156,172562,7,325721
35348,0.003093,172.31.36.0-255,66,172628,7,325721
35349,0.003144,172.31.36.0-255,66,172694,7,325721
35350,0.005755,74.125.68.0-255,2902,175596,7,325721
35351,0.005761,172.31.36.0-255,66,175662,7,325721
35352,0.00578,74.125.68.0-255,2902,178564,7,325721
35353,0.005782,172.31.36.0-255,66,178630,7,325721
35354,0.008373,74.125.68.0-255,2902,181532,7,325721
35355,0.00838,172.31.36.0-255,66,181598,7,325721
35356,0.008403,74.125.68.0-255,2902,184500,7,325721
35357,0.008407,172.31.36.0-255,66,184566,7,325721
35358,0.011001,74.125.68.0-255,2902,187468,7,325721
35359,0.011009,172.31.36.0-255,66,187534,7,325721
35360,0.011031,74.125.68.0-255,2902,190436,7,325721
35361,0.011034,172.31.36.0-255,66,190502,7,325721
35362,0.013643,74.125.68.0-255,5738,196240,7,325721
35363,0.013651,172.31.36.0-255,66,196306,7,325721
35364,0.016291,74.125.68.0-255,5738,202044,7,325721
35365,0.016302,172.31.36.0-255,66,202110,7,325721
35366,0.01893,74.125.68.0-255,5738,207848,7,325721
35367,0.018939,172.31.36.0-255,66,207914,7,325721
35368,0.021557,74.125.68.0-255,5738,213652,7,325721
35369,0.021564,172.31.36.0-255,66,213718,7,325721
35370,0.024181,74.125.68.0-255,5738,219456,7,325721
35371,0.024189,172.31.36.0-255,66,219522,7,325721
35372,0.02592,172.31.36.0-255,164,219686,7,325721
35373,0.025974,172.31.36.0-255,1121,220807,7,325721
35374,0.026046,172.31.36.0-255,1514,222321,7,325721
35375,0.026048,172.31.36.0-255,1287,223608,7,325721
35376,0.026835,74.125.68.0-255,5738,229346,7,325721
35377,0.026841,172.31.36.0-255,66,229412,7,325721
35378,0.027434,104.244.42.0-255,66,229478,7,325721
35379,0.02753,104.244.42.0-255,66,229544,7,325721
35380,0.02758,104.244.42.0-255,66,229610,7,325721
35381,0.028207,104.244.42.0-255,108,229718,7,325721
35382,0.028211,172.31.36.0-255,66,229784,7,325721
35383,0.029462,74.125.68.0-255,5738,235522,7,325721
35384,0.029466,172.31.36.0-255,66,235588,7,325721
35385,0.032078,74.125.68.0-255,5738,241326,7,325721
35386,0.032084,172.31.36.0-255,66,241392,7,325721
35387,0.03473,74.125.68.0-255,5738,247130,7,325721
35388,0.034744,172.31.36.0-255,66,247196,7,325721
35389,0.037375,74.125.68.0-255,5738,252934,7,325721
35390,0.037388,172.31.36.0-255,66,253000,7,325721
35391,0.040046,74.125.68.0-255,5738,258738,7,325721
35392,0.040077,172.31.36.0-255,66,258804,7,325721
35393,0.042724,74.125.68.0-255,5738,264542,7,325721
35394,0.04274,172.31.36.0-255,66,264608,7,325721
35395,0.045359,74.125.68.0-255,4320,268928,7,325721
35396,0.045365,172.31.36.0-255,66,268994,7,325721
35397,0.045393,74.125.68.0-255,1484,270478,7,325721
35398,0.047981,74.125.68.0-255,4320,274798,7,325721
35399,0.047987,172.31.36.0-255,66,274864,7,325721
35400,0.050613,74.125.68.0-255,5738,280602,7,325721
35401,0.050619,172.31.36.0-255,66,280668,7,325721
35402,0.053241,74.125.68.0-255,4320,284988,7,325721
35403,0.053246,172.31.36.0-255,66,285054,7,325721
35404,0.053281,74.125.68.0-255,1484,286538,7,325721
35405,0.055861,74.125.68.0-255,4320,290858,7,325721
35406,0.055866,172.31.36.0-255,66,290924,7,325721
35407,0.058478,74.125.68.0-255,5738,296662,7,325721
35408,0.058483,172.31.36.0-255,66,296728,7,325721
35409,0.061098,74.125.68.0-255,5738,302466,7,325721
35410,0.061103,172.31.36.0-255,66,302532,7,325721
35411,0.063769,74.125.68.0-255,5738,308270,7,325721
35412,0.063774,172.31.36.0-255,66,308336,7,325721
35413,0.066401,74.125.68.0-255,5738,314074,7,325721
35414,0.066407,172.31.36.0-255,66,314140,7,325721
35415,0.069024,74.125.68.0-255,5738,319878,7,325721
35416,0.069029,172.31.36.0-255,66,319944,7,325721
35417,0.071648,74.125.68.0-255,5540,325484,7,325721
35418,0.071653,172.31.36.0-255,66,325550,7,325721
35419,0.071841,172.31.36.0-255,105,325655,7,325721
35420,0.074414,74.125.68.0-255,66,325721,7,325721
35421,0.0,74.125.24.0-255,153,153,7,297614
35422,2.3e-05,172.31.36.0-255,66,219,7,297614
35423,3.1e-05,74.125.24.0-255,1484,1703,7,297614
35424,3.5e-05,172.31.36.0-255,66,1769,7,297614
35425,4.1e-05,74.125.24.0-255,2902,4671,7,297614
35426,5.2e-05,172.31.36.0-255,66,4737,7,297614
35427,5.8e-05,74.125.24.0-255,4320,9057,7,297614
35428,6.1e-05,172.31.36.0-255,66,9123,7,297614
35429,0.0001,172.31.36.0-255,66,9189,7,297614
35430,0.000105,74.125.24.0-255,2902,12091,7,297614
35431,0.000107,172.31.36.0-255,66,12157,7,297614
35432,0.000137,74.125.24.0-255,6797,18954,7,297614
35433,0.00014,172.31.36.0-255,66,19020,7,297614
35434,0.000166,74.125.24.0-255,1484,20504,7,297614
35435,0.000169,172.31.36.0-255,66,20570,7,297614
35436,0.000195,74.125.24.0-255,2902,23472,7,297614
35437,0.000197,172.31.36.0-255,66,23538,7,297614
35438,0.000203,74.125.24.0-255,4320,27858,7,297614
35439,0.000205,172.31.36.0-255,66,27924,7,297614
35440,0.000221,74.125.24.0-255,1484,29408,7,297614
35441,0.000224,172.31.36.0-255,66,29474,7,297614
35442,0.000253,74.125.24.0-255,6797,36271,7,297614
35443,0.000256,172.31.36.0-255,66,36337,7,297614
35444,0.000294,74.125.24.0-255,4320,40657,7,297614
35445,0.000296,172.31.36.0-255,66,40723,7,297614
35446,0.000324,74.125.24.0-255,2902,43625,7,297614
35447,0.000327,172.31.36.0-255,66,43691,7,297614
35448,0.000333,74.125.24.0-255,4320,48011,7,297614
35449,0.000336,172.31.36.0-255,66,48077,7,297614
35450,0.000371,74.125.24.0-255,1484,49561,7,297614
35451,0.000374,172.31.36.0-255,66,49627,7,297614
35452,0.000408,74.125.24.0-255,4338,53965,7,297614
35453,0.000412,172.31.36.0-255,66,54031,7,297614
35454,0.000415,74.125.24.0-255,330,54361,7,297614
35455,0.000872,74.125.24.0-255,1484,55845,7,297614
35456,0.000878,172.31.36.0-255,66,55911,7,297614
35457,0.000884,74.125.24.0-255,2902,58813,7,297614
35458,0.000886,172.31.36.0-255,66,58879,7,297614
35459,0.000891,74.125.24.0-255,2902,61781,7,297614
35460,0.000894,172.31.36.0-255,66,61847,7,297614
35461,0.000936,74.125.24.0-255,2902,64749,7,297614
35462,0.000939,172.31.36.0-255,66,64815,7,297614
35463,0.000951,172.31.36.0-255,66,64881,7,297614
35464,0.00097,172.31.36.0-255,66,64947,7,297614
35465,0.001016,74.125.24.0-255,2184,67131,7,297614
35466,0.001018,172.31.36.0-255,66,67197,7,297614
35467,0.001077,74.125.24.0-255,1484,68681,7,297614
35468,0.001082,74.125.24.0-255,2902,71583,7,297614
35469,0.001085,172.31.36.0-255,66,71649,7,297614
35470,0.001114,74.125.24.0-255,5738,77387,7,297614
35471,0.001117,172.31.36.0-255,66,77453,7,297614
35472,0.001145,74.125.24.0-255,4320,81773,7,297614
35473,0.001154,172.31.36.0-255,66,81839,7,297614
35474,0.00116,74.125.24.0-255,4320,86159,7,297614
35475,0.001162,172.31.36.0-255,66,86225,7,297614
35476,0.001184,74.125.24.0-255,1484,87709,7,297614
35477,0.001197,74.125.24.0-255,7156,94865,7,297614
35478,0.0012,172.31.36.0-255,66,94931,7,297614
35479,0.001236,74.125.24.0-255,4320,99251,7,297614
35480,0.001239,172.31.36.0-255,66,99317,7,297614
35481,0.001267,74.125.24.0-255,2184,101501,7,297614
35482,0.001271,172.31.36.0-255,66,101567,7,297614
35483,0.001278,74.125.24.0-255,7156,108723,7,297614
35484,0.001281,172.31.36.0-255,66,108789,7,297614
35485,0.00129,74.125.24.0-255,4320,113109,7,297614
35486,0.001292,172.31.36.0-255,66,113175,7,297614
35487,0.00133,172.31.36.0-255,66,113241,7,297614
35488,0.001336,74.125.24.0-255,4320,117561,7,297614
35489,0.001337,172.31.36.0-255,66,117627,7,297614
35490,0.001365,74.125.24.0-255,5020,122647,7,297614
35491,0.001372,172.31.36.0-255,66,122713,7,297614
35492,0.001463,74.125.24.0-255,1484,124197,7,297614
35493,0.001467,74.125.24.0-255,1484,125681,7,297614
35494,0.00147,172.31.36.0-255,66,125747,7,297614
35495,0.001491,74.125.24.0-255,1484,127231,7,297614
35496,0.001498,74.125.24.0-255,5738,132969,7,297614
35497,0.0015,172.31.36.0-255,66,133035,7,297614
35498,0.001544,74.125.24.0-255,1484,134519,7,297614
35499,0.001547,172.31.36.0-255,78,134597,7,297614
35500,0.001565,172.31.36.0-255,66,134663,7,297614
35501,0.001605,74.125.24.0-255,2902,137565,7,297614
35502,0.001608,172.31.36.0-255,66,137631,7,297614
35503,0.001635,172.31.36.0-255,66,137697,7,297614
35504,0.001718,74.125.24.0-255,1484,139181,7,297614
35505,0.001723,74.125.24.0-255,2902,142083,7,297614
35506,0.001727,172.31.36.0-255,66,142149,7,297614
35507,0.001732,74.125.24.0-255,4320,146469,7,297614
35508,0.001735,172.31.36.0-255,66,146535,7,297614
35509,0.001755,74.125.24.0-255,1484,148019,7,297614
35510,0.001761,74.125.24.0-255,5738,153757,7,297614
35511,0.001764,172.31.36.0-255,66,153823,7,297614
35512,0.001798,74.125.24.0-255,7156,160979,7,297614
35513,0.001801,172.31.36.0-255,66,161045,7,297614
35514,0.001804,74.125.24.0-255,1484,162529,7,297614
35515,0.001838,172.31.36.0-255,66,162595,7,297614
35516,0.001877,74.125.24.0-255,1484,164079,7,297614
35517,0.00188,74.125.24.0-255,1484,165563,7,297614
35518,0.001883,172.31.36.0-255,66,165629,7,297614
35519,0.001896,74.125.24.0-255,1484,167113,7,297614
35520,0.001908,74.125.24.0-255,5738,172851,7,297614
35521,0.001911,172.31.36.0-255,66,172917,7,297614
35522,0.001948,74.125.24.0-255,5738,178655,7,297614
35523,0.001951,172.31.36.0-255,66,178721,7,297614
35524,0.001959,74.125.24.0-255,7156,185877,7,297614
35525,0.001962,172.31.36.0-255,66,185943,7,297614
35526,0.001982,74.125.24.0-255,5738,191681,7,297614
35527,0.001988,172.31.36.0-255,66,191747,7,297614
35528,0.002014,74.125.24.0-255,5020,196767,7,297614
35529,0.002018,172.31.36.0-255,66,196833,7,297614
35530,0.002312,74.125.24.0-255,1484,198317,7,297614
35531,0.002318,74.125.24.0-255,2902,201219,7,297614
35532,0.002321,172.31.36.0-255,66,201285,7,297614
35533,0.002352,74.125.24.0-255,5738,207023,7,297614
35534,0.002355,172.31.36.0-255,66,207089,7,297614
35535,0.002401,74.125.24.0-255,5738,212827,7,297614
35536,0.002403,172.31.36.0-255,66,212893,7,297614
35537,0.002434,74.125.24.0-255,7156,220049,7,297614
35538,0.002437,172.31.36.0-255,66,220115,7,297614
35539,0.002453,172.31.36.0-255,66,220181,7,297614
35540,0.002455,74.125.24.0-255,766,220947,7,297614
35541,0.002548,74.125.24.0-255,1484,222431,7,297614
35542,0.002553,172.31.36.0-255,66,222497,7,297614
35543,0.002559,74.125.24.0-255,2902,225399,7,297614
35544,0.002561,172.31.36.0-255,66,225465,7,297614
35545,0.002592,74.125.24.0-255,5738,231203,7,297614
35546,0.002598,74.125.24.0-255,5738,236941,7,297614
35547,0.002604,172.31.36.0-255,66,237007,7,297614
35548,0.002607,172.31.36.0-255,66,237073,7,297614
35549,0.002623,74.125.24.0-255,4320,241393,7,297614
35550,0.002626,172.31.36.0-255,66,241459,7,297614
35551,0.002667,172.31.36.0-255,66,241525,7,297614
35552,0.002673,74.125.24.0-255,5738,247263,7,297614
35553,0.002675,172.31.36.0-255,66,247329,7,297614
35554,0.002681,74.125.24.0-255,4320,251649,7,297614
35555,0.002683,172.31.36.0-255,66,251715,7,297614
35556,0.002704,172.31.36.0-255,66,251781,7,297614
35557,0.002715,74.125.24.0-255,5738,257519,7,297614
35558,0.002719,172.31.36.0-255,66,257585,7,297614
35559,0.002733,74.125.24.0-255,3602,261187,7,297614
35560,0.002735,172.31.36.0-255,66,261253,7,297614
35561,0.003089,74.125.24.0-255,1484,262737,7,297614
35562,0.003096,74.125.24.0-255,2902,265639,7,297614
35563,0.003099,172.31.36.0-255,66,265705,7,297614
35564,0.003137,74.125.24.0-255,5738,271443,7,297614
35565,0.00314,172.31.36.0-255,66,271509,7,297614
35566,0.003145,74.125.24.0-255,2902,274411,7,297614
35567,0.003147,172.31.36.0-255,66,274477,7,297614
35568,0.003166,172.31.36.0-255,66,274543,7,297614
35569,0.003174,74.125.24.0-255,6438,280981,7,297614
35570,0.003177,172.31.36.0-255,66,281047,7,297614
35571,0.003184,74.125.24.0-255,5738,286785,7,297614
35572,0.003187,172.31.36.0-255,66,286851,7,297614
35573,0.003212,74.125.24.0-255,1484,288335,7,297614
35574,0.003218,74.125.24.0-255,4581,292916,7,297614
35575,0.003232,172.31.36.0-255,66,292982,7,297614
35576,0.003236,74.125.24.0-255,105,293087,7,297614
35577,0.005225,172.31.36.0-255,66,293153,7,297614
35578,0.005268,172.31.36.0-255,105,293258,7,297614
35579,0.007892,74.125.24.0-255,66,293324,7,297614
35580,0.032279,172.31.36.0-255,172,293496,7,297614
35581,0.032314,172.31.36.0-255,1114,294610,7,297614
35582,0.032375,172.31.36.0-255,1514,296124,7,297614
35583,0.032377,172.31.36.0-255,1292,297416,7,297614
35584,0.03393,104.244.42.0-255,66,297482,7,297614
35585,0.034079,104.244.42.0-255,66,297548,7,297614
35586,0.0341,104.244.42.0-255,66,297614,7,297614
35587,0.0,74.125.24.0-255,153,153,7,330634
35588,2.4e-05,172.31.36.0-255,66,219,7,330634
35589,3.1e-05,74.125.24.0-255,1484,1703,7,330634
35590,3.5e-05,172.31.36.0-255,66,1769,7,330634
35591,4.1e-05,74.125.24.0-255,2902,4671,7,330634
35592,5.2e-05,172.31.36.0-255,66,4737,7,330634
35593,5.6e-05,74.125.24.0-255,2902,7639,7,330634
35594,5.9e-05,172.31.36.0-255,66,7705,7,330634
35595,8.1e-05,74.125.24.0-255,1484,9189,7,330634
35596,8.4e-05,172.31.36.0-255,66,9255,7,330634
35597,0.000117,74.125.24.0-255,4828,14083,7,330634
35598,0.00012,172.31.36.0-255,66,14149,7,330634
35599,0.000127,74.125.24.0-255,7156,21305,7,330634
35600,0.000128,172.31.36.0-255,66,21371,7,330634
35601,0.000155,74.125.24.0-255,4320,25691,7,330634
35602,0.000157,172.31.36.0-255,66,25757,7,330634
35603,0.000184,74.125.24.0-255,5379,31136,7,330634
35604,0.000187,172.31.36.0-255,66,31202,7,330634
35605,0.000189,74.125.24.0-255,1484,32686,7,330634
35606,0.000191,172.31.36.0-255,66,32752,7,330634
35607,0.000212,74.125.24.0-255,2902,35654,7,330634
35608,0.000218,172.31.36.0-255,66,35720,7,330634
35609,0.000224,74.125.24.0-255,5738,41458,7,330634
35610,0.000226,172.31.36.0-255,66,41524,7,330634
35611,0.000253,74.125.24.0-255,2902,44426,7,330634
35612,0.000255,172.31.36.0-255,66,44492,7,330634
35613,0.000269,74.125.24.0-255,3961,48453,7,330634
35614,0.000274,172.31.36.0-255,66,48519,7,330634
35615,0.000903,74.125.24.0-255,1484,50003,7,330634
35616,0.000909,172.31.36.0-255,66,50069,7,330634
35617,0.000915,74.125.24.0-255,2902,52971,7,330634
35618,0.000917,172.31.36.0-255,66,53037,7,330634
35619,0.000922,74.125.24.0-255,4320,57357,7,330634
35620,0.000931,172.31.36.0-255,66,57423,7,330634
35621,0.000963,74.125.24.0-255,1484,58907,7,330634
35622,0.000972,74.125.24.0-255,6797,65704,7,330634
35623,0.000975,172.31.36.0-255,66,65770,7,330634
35624,0.001069,74.125.24.0-255,1484,67254,7,330634
35625,0.001076,74.125.24.0-255,2902,70156,7,330634
35626,0.001079,172.31.36.0-255,66,70222,7,330634
35627,0.001097,74.125.24.0-255,4320,74542,7,330634
35628,0.001099,172.31.36.0-255,66,74608,7,330634
35629,0.001138,74.125.24.0-255,5738,80346,7,330634
35630,0.001141,172.31.36.0-255,66,80412,7,330634
35631,0.001162,74.125.24.0-255,3123,83535,7,330634
35632,0.001164,172.31.36.0-255,66,83601,7,330634
35633,0.001507,74.125.24.0-255,1484,85085,7,330634
35634,0.001515,74.125.24.0-255,2902,87987,7,330634
35635,0.001518,172.31.36.0-255,66,88053,7,330634
35636,0.001545,74.125.24.0-255,5738,93791,7,330634
35637,0.001547,172.31.36.0-255,66,93857,7,330634
35638,0.001553,74.125.24.0-255,4320,98177,7,330634
35639,0.001554,172.31.36.0-255,66,98243,7,330634
35640,0.001615,172.31.36.0-255,66,98309,7,330634
35641,0.00163,172.31.36.0-255,66,98375,7,330634
35642,0.001803,74.125.24.0-255,1484,99859,7,330634
35643,0.00182,74.125.24.0-255,2902,102761,7,330634
35644,0.001823,172.31.36.0-255,66,102827,7,330634
35645,0.001858,74.125.24.0-255,1484,104311,7,330634
35646,0.001873,74.125.24.0-255,4320,108631,7,330634
35647,0.001875,172.31.36.0-255,66,108697,7,330634
35648,0.001906,74.125.24.0-255,5738,114435,7,330634
35649,0.001909,172.31.36.0-255,66,114501,7,330634
35650,0.001938,74.125.24.0-255,7156,121657,7,330634
35651,0.00194,172.31.36.0-255,66,121723,7,330634
35652,0.001969,74.125.24.0-255,5738,127461,7,330634
35653,0.001971,172.31.36.0-255,66,127527,7,330634
35654,0.001998,74.125.24.0-255,5020,132547,7,330634
35655,0.002,172.31.36.0-255,66,132613,7,330634
35656,0.004252,74.125.24.0-255,5738,138351,7,330634
35657,0.004256,172.31.36.0-255,66,138417,7,330634
35658,0.006554,74.125.24.0-255,5738,144155,7,330634
35659,0.006561,172.31.36.0-255,66,144221,7,330634
35660,0.008868,74.125.24.0-255,5738,149959,7,330634
35661,0.008876,172.31.36.0-255,66,150025,7,330634
35662,0.011155,74.125.24.0-255,5738,155763,7,330634
35663,0.011164,172.31.36.0-255,66,155829,7,330634
35664,0.013439,74.125.24.0-255,5738,161567,7,330634
35665,0.013445,172.31.36.0-255,66,161633,7,330634
35666,0.015675,74.125.24.0-255,5738,167371,7,330634
35667,0.015678,172.31.36.0-255,66,167437,7,330634
35668,0.018,74.125.24.0-255,5738,173175,7,330634
35669,0.018006,172.31.36.0-255,66,173241,7,330634
35670,0.02026,74.125.24.0-255,5738,178979,7,330634
35671,0.020268,172.31.36.0-255,66,179045,7,330634
35672,0.022543,74.125.24.0-255,5738,184783,7,330634
35673,0.022551,172.31.36.0-255,66,184849,7,330634
35674,0.02486,74.125.24.0-255,5738,190587,7,330634
35675,0.024867,172.31.36.0-255,66,190653,7,330634
35676,0.027156,74.125.24.0-255,5738,196391,7,330634
35677,0.027164,172.31.36.0-255,66,196457,7,330634
35678,0.029446,74.125.24.0-255,5738,202195,7,330634
35679,0.029453,172.31.36.0-255,66,202261,7,330634
35680,0.03176,74.125.24.0-255,5738,207999,7,330634
35681,0.031769,172.31.36.0-255,66,208065,7,330634
35682,0.033755,172.31.36.0-255,172,208237,7,330634
35683,0.033784,172.31.36.0-255,1073,209310,7,330634
35684,0.034056,74.125.24.0-255,5738,215048,7,330634
35685,0.034062,172.31.36.0-255,66,215114,7,330634
35686,0.035297,104.244.42.0-255,66,215180,7,330634
35687,0.035337,104.244.42.0-255,66,215246,7,330634
35688,0.036305,74.125.24.0-255,5738,220984,7,330634
35689,0.036311,172.31.36.0-255,66,221050,7,330634
35690,0.038599,74.125.24.0-255,5738,226788,7,330634
35691,0.038605,172.31.36.0-255,66,226854,7,330634
35692,0.040867,74.125.24.0-255,4320,231174,7,330634
35693,0.040873,172.31.36.0-255,66,231240,7,330634
35694,0.040904,74.125.24.0-255,1484,232724,7,330634
35695,0.043142,74.125.24.0-255,4320,237044,7,330634
35696,0.043148,172.31.36.0-255,66,237110,7,330634
35697,0.045407,74.125.24.0-255,5738,242848,7,330634
35698,0.045414,172.31.36.0-255,66,242914,7,330634
35699,0.047663,74.125.24.0-255,5738,248652,7,330634
35700,0.04767,172.31.36.0-255,66,248718,7,330634
35701,0.049907,74.125.24.0-255,2902,251620,7,330634
35702,0.049913,172.31.36.0-255,66,251686,7,330634
35703,0.04995,74.125.24.0-255,2902,254588,7,330634
35704,0.049953,172.31.36.0-255,66,254654,7,330634
35705,0.052157,74.125.24.0-255,2902,257556,7,330634
35706,0.052163,172.31.36.0-255,66,257622,7,330634
35707,0.052236,74.125.24.0-255,2902,260524,7,330634
35708,0.052243,172.31.36.0-255,66,260590,7,330634
35709,0.054441,74.125.24.0-255,2902,263492,7,330634
35710,0.054447,172.31.36.0-255,66,263558,7,330634
35711,0.054519,74.125.24.0-255,2902,266460,7,330634
35712,0.054524,172.31.36.0-255,66,266526,7,330634
35713,0.056697,74.125.24.0-255,1484,268010,7,330634
35714,0.056816,74.125.24.0-255,4320,272330,7,330634
35715,0.056821,172.31.36.0-255,66,272396,7,330634
35716,0.059043,74.125.24.0-255,5738,278134,7,330634
35717,0.05905,172.31.36.0-255,66,278200,7,330634
35718,0.061312,74.125.24.0-255,5738,283938,7,330634
35719,0.061318,172.31.36.0-255,66,284004,7,330634
35720,0.063547,74.125.24.0-255,5738,289742,7,330634
35721,0.063553,172.31.36.0-255,66,289808,7,330634
35722,0.06578,74.125.24.0-255,5738,295546,7,330634
35723,0.065785,172.31.36.0-255,66,295612,7,330634
35724,0.068022,74.125.24.0-255,1484,297096,7,330634
35725,0.068054,74.125.24.0-255,4320,301416,7,330634
35726,0.068059,172.31.36.0-255,66,301482,7,330634
35727,0.07038,74.125.24.0-255,5738,307220,7,330634
35728,0.070386,172.31.36.0-255,66,307286,7,330634
35729,0.072634,74.125.24.0-255,5738,313024,7,330634
35730,0.07264,172.31.36.0-255,66,313090,7,330634
35731,0.074883,74.125.24.0-255,2902,315992,7,330634
35732,0.074889,172.31.36.0-255,66,316058,7,330634
35733,0.074921,74.125.24.0-255,2902,318960,7,330634
35734,0.074924,172.31.36.0-255,66,319026,7,330634
35735,0.077154,74.125.24.0-255,5738,324764,7,330634
35736,0.07716,172.31.36.0-255,66,324830,7,330634
35737,0.079426,74.125.24.0-255,5738,330568,7,330634
35738,0.07943,172.31.36.0-255,66,330634,7,330634
35739,0.0,172.217.194.0-255,152,152,7,199776
35740,3.4e-05,172.31.36.0-255,66,218,7,199776
35741,4.1e-05,172.217.194.0-255,1484,1702,7,199776
35742,4.6e-05,172.31.36.0-255,66,1768,7,199776
35743,5.2e-05,172.217.194.0-255,2902,4670,7,199776
35744,5.4e-05,172.31.36.0-255,66,4736,7,199776
35745,6.1e-05,172.217.194.0-255,5738,10474,7,199776
35746,6.3e-05,172.31.36.0-255,66,10540,7,199776
35747,6.6e-05,172.217.194.0-255,1484,12024,7,199776
35748,6.9e-05,172.31.36.0-255,66,12090,7,199776
35749,0.000116,172.31.36.0-255,66,12156,7,199776
35750,0.000123,172.217.194.0-255,6797,18953,7,199776
35751,0.000125,172.31.36.0-255,66,19019,7,199776
35752,0.000147,172.217.194.0-255,1484,20503,7,199776
35753,0.00015,172.31.36.0-255,66,20569,7,199776
35754,0.000171,172.217.194.0-255,2902,23471,7,199776
35755,0.000173,172.31.36.0-255,66,23537,7,199776
35756,0.00018,172.217.194.0-255,5738,29275,7,199776
35757,0.000184,172.31.36.0-255,66,29341,7,199776
35758,0.000218,172.217.194.0-255,4320,33661,7,199776
35759,0.000221,172.31.36.0-255,66,33727,7,199776
35760,0.000241,172.31.36.0-255,66,33793,7,199776
35761,0.000244,172.217.194.0-255,1484,35277,7,199776
35762,0.000246,172.31.36.0-255,66,35343,7,199776
35763,0.000274,172.31.36.0-255,66,35409,7,199776
35764,0.000277,172.217.194.0-255,98,35507,7,199776
35765,0.000279,172.31.36.0-255,66,35573,7,199776
35766,0.000471,172.217.194.0-255,365,35938,7,199776
35767,0.000475,172.31.36.0-255,66,36004,7,199776
35768,0.000729,172.217.194.0-255,1484,37488,7,199776
35769,0.000762,172.217.194.0-255,2902,40390,7,199776
35770,0.000766,172.31.36.0-255,66,40456,7,199776
35771,0.000772,172.217.194.0-255,5738,46194,7,199776
35772,0.000775,172.31.36.0-255,66,46260,7,199776
35773,0.000778,172.217.194.0-255,1484,47744,7,199776
35774,0.000806,172.31.36.0-255,66,47810,7,199776
35775,0.000819,172.31.36.0-255,66,47876,7,199776
35776,0.001281,172.217.194.0-255,1484,49360,7,199776
35777,0.00129,172.217.194.0-255,2902,52262,7,199776
35778,0.001295,172.31.36.0-255,66,52328,7,199776
35779,0.001302,172.217.194.0-255,5738,58066,7,199776
35780,0.001304,172.31.36.0-255,66,58132,7,199776
35781,0.001311,172.217.194.0-255,5738,63870,7,199776
35782,0.001313,172.31.36.0-255,66,63936,7,199776
35783,0.001333,172.217.194.0-255,5738,69674,7,199776
35784,0.001336,172.31.36.0-255,66,69740,7,199776
35785,0.001372,172.217.194.0-255,7156,76896,7,199776
35786,0.001375,172.31.36.0-255,66,76962,7,199776
35787,0.001381,172.217.194.0-255,5020,81982,7,199776
35788,0.001383,172.31.36.0-255,66,82048,7,199776
35789,0.002526,172.217.194.0-255,1484,83532,7,199776
35790,0.002534,172.217.194.0-255,2902,86434,7,199776
35791,0.002538,172.31.36.0-255,66,86500,7,199776
35792,0.002546,172.217.194.0-255,5738,92238,7,199776
35793,0.002548,172.31.36.0-255,66,92304,7,199776
35794,0.002552,172.217.194.0-255,2902,95206,7,199776
35795,0.002554,172.31.36.0-255,66,95272,7,199776
35796,0.002589,172.31.36.0-255,66,95338,7,199776
35797,0.002629,172.217.194.0-255,7156,102494,7,199776
35798,0.00263,172.31.36.0-255,66,102560,7,199776
35799,0.002651,172.217.194.0-255,3602,106162,7,199776
35800,0.002653,172.31.36.0-255,66,106228,7,199776
35801,0.002751,172.217.194.0-255,1484,107712,7,199776
35802,0.002754,172.217.194.0-255,1484,109196,7,199776
35803,0.002757,172.31.36.0-255,66,109262,7,199776
35804,0.002773,172.217.194.0-255,1484,110746,7,199776
35805,0.002779,172.217.194.0-255,5738,116484,7,199776
35806,0.002781,172.31.36.0-255,66,116550,7,199776
35807,0.002786,172.217.194.0-255,4320,120870,7,199776
35808,0.002788,172.31.36.0-255,66,120936,7,199776
35809,0.002806,172.217.194.0-255,2902,123838,7,199776
35810,0.002808,172.31.36.0-255,66,123904,7,199776
35811,0.002811,172.217.194.0-255,1484,125388,7,199776
35812,0.002836,172.31.36.0-255,66,125454,7,199776
35813,0.002839,172.217.194.0-255,1484,126938,7,199776
35814,0.002843,172.217.194.0-255,2184,129122,7,199776
35815,0.002845,172.31.36.0-255,66,129188,7,199776
35816,0.002868,172.217.194.0-255,1484,130672,7,199776
35817,0.002871,172.217.194.0-255,1484,132156,7,199776
35818,0.002873,172.31.36.0-255,66,132222,7,199776
35819,0.00289,172.217.194.0-255,2902,135124,7,199776
35820,0.002893,172.31.36.0-255,66,135190,7,199776
35821,0.002897,172.217.194.0-255,2902,138092,7,199776
35822,0.002899,172.31.36.0-255,66,138158,7,199776
35823,0.002915,172.217.194.0-255,7156,145314,7,199776
35824,0.002917,172.31.36.0-255,66,145380,7,199776
35825,0.002934,172.217.194.0-255,1484,146864,7,199776
35826,0.00294,172.217.194.0-255,4320,151184,7,199776
35827,0.002942,172.31.36.0-255,66,151250,7,199776
35828,0.002967,172.31.36.0-255,66,151316,7,199776
35829,0.002982,172.217.194.0-255,766,152082,7,199776
35830,0.003074,172.217.194.0-255,1484,153566,7,199776
35831,0.003076,172.31.36.0-255,66,153632,7,199776
35832,0.003089,172.217.194.0-255,2902,156534,7,199776
35833,0.003092,172.31.36.0-255,66,156600,7,199776
35834,0.003106,172.217.194.0-255,2902,159502,7,199776
35835,0.003109,172.31.36.0-255,66,159568,7,199776
35836,0.003134,172.217.194.0-255,2902,162470,7,199776
35837,0.003137,172.31.36.0-255,66,162536,7,199776
35838,0.003168,172.31.36.0-255,66,162602,7,199776
35839,0.003179,172.31.36.0-255,66,162668,7,199776
35840,0.003226,172.217.194.0-255,1484,164152,7,199776
35841,0.003239,172.217.194.0-255,2902,167054,7,199776
35842,0.003242,172.31.36.0-255,66,167120,7,199776
35843,0.003246,172.217.194.0-255,1484,168604,7,199776
35844,0.003266,172.217.194.0-255,4320,172924,7,199776
35845,0.003269,172.31.36.0-255,66,172990,7,199776
35846,0.0033,172.31.36.0-255,66,173056,7,199776
35847,0.003318,172.217.194.0-255,1484,174540,7,199776
35848,0.003329,172.31.36.0-255,66,174606,7,199776
35849,0.00335,172.217.194.0-255,2184,176790,7,199776
35850,0.003353,172.31.36.0-255,66,176856,7,199776
35851,0.003389,172.217.194.0-255,1484,178340,7,199776
35852,0.0034,172.217.194.0-255,1484,179824,7,199776
35853,0.003403,172.31.36.0-255,66,179890,7,199776
35854,0.003407,172.217.194.0-255,1484,181374,7,199776
35855,0.003432,172.217.194.0-255,5738,187112,7,199776
35856,0.003436,172.31.36.0-255,66,187178,7,199776
35857,0.003455,172.217.194.0-255,1484,188662,7,199776
35858,0.003466,172.31.36.0-255,66,188728,7,199776
35859,0.003481,172.217.194.0-255,1484,190212,7,199776
35860,0.00351,172.31.36.0-255,66,190278,7,199776
35861,0.003555,172.217.194.0-255,766,191044,7,199776
35862,0.00357,172.31.36.0-255,66,191110,7,199776
35863,0.003622,172.31.36.0-255,66,191176,7,199776
35864,0.00366,172.31.36.0-255,66,191242,7,199776
35865,0.003662,172.217.194.0-255,1484,192726,7,199776
35866,0.003688,172.31.36.0-255,66,192792,7,199776
35867,0.003691,172.217.194.0-255,1484,194276,7,199776
35868,0.003695,172.217.194.0-255,1763,196039,7,199776
35869,0.003697,172.31.36.0-255,66,196105,7,199776
35870,0.0037,172.217.194.0-255,105,196210,7,199776
35871,0.006323,172.31.36.0-255,66,196276,7,199776
35872,0.006353,172.31.36.0-255,105,196381,7,199776
35873,0.008372,172.217.194.0-255,66,196447,7,199776
35874,0.027253,172.31.36.0-255,172,196619,7,199776
35875,0.027293,172.31.36.0-255,1114,197733,7,199776
35876,0.027333,172.31.36.0-255,1514,199247,7,199776
35877,0.027334,172.31.36.0-255,331,199578,7,199776
35878,0.028786,104.244.42.0-255,66,199644,7,199776
35879,0.028981,104.244.42.0-255,66,199710,7,199776
35880,0.028987,104.244.42.0-255,66,199776,7,199776
35881,0.0,172.217.194.0-255,294,294,7,252991
35882,3.4e-05,172.31.36.0-255,66,360,7,252991
35883,4.2e-05,172.217.194.0-255,1484,1844,7,252991
35884,4.6e-05,172.31.36.0-255,66,1910,7,252991
35885,6e-05,172.217.194.0-255,4320,6230,7,252991
35886,6.2e-05,172.31.36.0-255,66,6296,7,252991
35887,7.4e-05,172.31.36.0-255,66,6362,7,252991
35888,8e-05,172.217.194.0-255,5738,12100,7,252991
35889,8.2e-05,172.31.36.0-255,66,12166,7,252991
35890,0.000112,172.217.194.0-255,1484,13650,7,252991
35891,0.000114,172.31.36.0-255,66,13716,7,252991
35892,0.000125,172.31.36.0-255,66,13782,7,252991
35893,0.000522,172.217.194.0-255,1484,15266,7,252991
35894,0.00053,172.31.36.0-255,66,15332,7,252991
35895,0.000536,172.217.194.0-255,2902,18234,7,252991
35896,0.000538,172.31.36.0-255,66,18300,7,252991
35897,0.000562,172.217.194.0-255,1484,19784,7,252991
35898,0.000565,172.31.36.0-255,66,19850,7,252991
35899,0.00059,172.217.194.0-255,4320,24170,7,252991
35900,0.000594,172.31.36.0-255,66,24236,7,252991
35901,0.0006,172.217.194.0-255,5738,29974,7,252991
35902,0.000603,172.31.36.0-255,66,30040,7,252991
35903,0.000606,172.217.194.0-255,1484,31524,7,252991
35904,0.000608,172.31.36.0-255,66,31590,7,252991
35905,0.000659,172.31.36.0-255,66,31656,7,252991
35906,0.000665,172.217.194.0-255,4254,35910,7,252991
35907,0.000668,172.31.36.0-255,66,35976,7,252991
35908,0.000671,172.217.194.0-255,361,36337,7,252991
35909,0.000681,172.31.36.0-255,66,36403,7,252991
35910,0.000755,172.217.194.0-255,1484,37887,7,252991
35911,0.000765,172.217.194.0-255,2902,40789,7,252991
35912,0.000772,172.31.36.0-255,66,40855,7,252991
35913,0.000796,172.217.194.0-255,5738,46593,7,252991
35914,0.000799,172.31.36.0-255,66,46659,7,252991
35915,0.000842,172.31.36.0-255,66,46725,7,252991
35916,0.000851,172.217.194.0-255,3961,50686,7,252991
35917,0.000861,172.31.36.0-255,66,50752,7,252991
35918,0.000862,172.217.194.0-255,5738,56490,7,252991
35919,0.000865,172.31.36.0-255,66,56556,7,252991
35920,0.000889,172.217.194.0-255,3961,60517,7,252991
35921,0.000899,172.31.36.0-255,66,60583,7,252991
35922,0.001186,172.217.194.0-255,1484,62067,7,252991
35923,0.001193,172.217.194.0-255,2902,64969,7,252991
35924,0.001196,172.31.36.0-255,66,65035,7,252991
35925,0.001251,172.217.194.0-255,5738,70773,7,252991
35926,0.001261,172.31.36.0-255,66,70839,7,252991
35927,0.001286,172.31.36.0-255,66,70905,7,252991
35928,0.001299,172.217.194.0-255,5738,76643,7,252991
35929,0.001307,172.31.36.0-255,66,76709,7,252991
35930,0.001337,172.217.194.0-255,2184,78893,7,252991
35931,0.001341,172.31.36.0-255,66,78959,7,252991
35932,0.001357,172.31.36.0-255,66,79025,7,252991
35933,0.001373,172.31.36.0-255,66,79091,7,252991
35934,0.001391,172.217.194.0-255,2902,81993,7,252991
35935,0.001393,172.217.194.0-255,766,82759,7,252991
35936,0.001402,172.31.36.0-255,66,82825,7,252991
35937,0.001744,172.217.194.0-255,1484,84309,7,252991
35938,0.001762,172.217.194.0-255,2902,87211,7,252991
35939,0.001765,172.217.194.0-255,1484,88695,7,252991
35940,0.001766,172.31.36.0-255,66,88761,7,252991
35941,0.001786,172.217.194.0-255,4320,93081,7,252991
35942,0.001792,172.217.194.0-255,4320,97401,7,252991
35943,0.001798,172.31.36.0-255,66,97467,7,252991
35944,0.001835,172.31.36.0-255,66,97533,7,252991
35945,0.001843,172.217.194.0-255,7156,104689,7,252991
35946,0.001854,172.31.36.0-255,66,104755,7,252991
35947,0.001861,172.217.194.0-255,3602,108357,7,252991
35948,0.001868,172.31.36.0-255,66,108423,7,252991
35949,0.001886,172.217.194.0-255,4320,112743,7,252991
35950,0.00189,172.217.194.0-255,2902,115645,7,252991
35951,0.001893,172.31.36.0-255,66,115711,7,252991
35952,0.001898,172.31.36.0-255,66,115777,7,252991
35953,0.001935,172.217.194.0-255,7156,122933,7,252991
35954,0.001944,172.31.36.0-255,66,122999,7,252991
35955,0.001949,172.31.36.0-255,66,123065,7,252991
35956,0.001993,172.31.36.0-255,66,123131,7,252991
35957,0.002003,172.217.194.0-255,2902,126033,7,252991
35958,0.002008,172.31.36.0-255,66,126099,7,252991
35959,0.002014,172.217.194.0-255,4320,130419,7,252991
35960,0.002025,172.31.36.0-255,66,130485,7,252991
35961,0.002052,172.31.36.0-255,66,130551,7,252991
35962,0.002096,172.31.36.0-255,66,130617,7,252991
35963,0.002128,172.217.194.0-255,6438,137055,7,252991
35964,0.002135,172.31.36.0-255,66,137121,7,252991
35965,0.002202,172.217.194.0-255,1484,138605,7,252991
35966,0.002218,172.217.194.0-255,2902,141507,7,252991
35967,0.002222,172.31.36.0-255,66,141573,7,252991
35968,0.002227,172.217.194.0-255,2902,144475,7,252991
35969,0.002237,172.31.36.0-255,66,144541,7,252991
35970,0.002251,172.217.194.0-255,2902,147443,7,252991
35971,0.002257,172.217.194.0-255,4320,151763,7,252991
35972,0.002265,172.31.36.0-255,66,151829,7,252991
35973,0.002289,172.31.36.0-255,66,151895,7,252991
35974,0.002323,172.217.194.0-255,1484,153379,7,252991
35975,0.002359,172.31.36.0-255,66,153445,7,252991
35976,0.002361,172.217.194.0-255,1484,154929,7,252991
35977,0.002366,172.31.36.0-255,66,154995,7,252991
35978,0.002379,172.31.36.0-255,66,155061,7,252991
35979,0.004698,172.217.194.0-255,5738,160799,7,252991
35980,0.004705,172.31.36.0-255,66,160865,7,252991
35981,0.006985,172.217.194.0-255,2902,163767,7,252991
35982,0.007001,172.217.194.0-255,2902,166669,7,252991
35983,0.00983,172.31.36.0-255,66,166735,7,252991
35984,0.012143,172.217.194.0-255,5738,172473,7,252991
35985,0.012151,172.31.36.0-255,66,172539,7,252991
35986,0.014452,172.217.194.0-255,5738,178277,7,252991
35987,0.015496,172.31.36.0-255,66,178343,7,252991
35988,0.017795,172.217.194.0-255,5738,184081,7,252991
35989,0.017805,172.31.36.0-255,66,184147,7,252991
35990,0.020114,172.217.194.0-255,5738,189885,7,252991
35991,0.020121,172.31.36.0-255,66,189951,7,252991
35992,0.02244,172.217.194.0-255,5738,195689,7,252991
35993,0.022447,172.31.36.0-255,66,195755,7,252991
35994,0.02475,172.217.194.0-255,5738,201493,7,252991
35995,0.024757,172.31.36.0-255,66,201559,7,252991
35996,0.027039,172.217.194.0-255,5738,207297,7,252991
35997,0.027046,172.31.36.0-255,66,207363,7,252991
35998,0.029337,172.217.194.0-255,5738,213101,7,252991
35999,0.029344,172.31.36.0-255,66,213167,7,252991
36000,0.031665,172.217.194.0-255,5738,218905,7,252991
36001,0.031672,172.31.36.0-255,66,218971,7,252991
36002,0.03359,172.31.36.0-255,167,219138,7,252991
36003,0.033615,172.31.36.0-255,1114,220252,7,252991
36004,0.033659,172.31.36.0-255,1514,221766,7,252991
36005,0.033661,172.31.36.0-255,1292,223058,7,252991
36006,0.033972,172.217.194.0-255,5738,228796,7,252991
36007,0.033979,172.31.36.0-255,66,228862,7,252991
36008,0.035132,104.244.42.0-255,66,228928,7,252991
36009,0.03529,104.244.42.0-255,66,228994,7,252991
36010,0.035312,104.244.42.0-255,66,229060,7,252991
36011,0.036275,172.217.194.0-255,4320,233380,7,252991
36012,0.03628,172.31.36.0-255,66,233446,7,252991
36013,0.036307,172.217.194.0-255,1484,234930,7,252991
36014,0.038565,172.217.194.0-255,4320,239250,7,252991
36015,0.038573,172.31.36.0-255,66,239316,7,252991
36016,0.040881,172.217.194.0-255,5738,245054,7,252991
36017,0.040944,172.31.36.0-255,66,245120,7,252991
36018,0.043247,172.217.194.0-255,5738,250858,7,252991
36019,0.043252,172.31.36.0-255,66,250924,7,252991
36020,0.045567,172.217.194.0-255,1830,252754,7,252991
36021,0.045572,172.31.36.0-255,66,252820,7,252991
36022,0.045746,172.31.36.0-255,105,252925,7,252991
36023,0.048056,172.217.194.0-255,66,252991,7,252991
36024,0.0,172.217.194.0-255,156,156,7,208008
36025,2.3e-05,172.31.36.0-255,66,222,7,208008
36026,2.9e-05,172.217.194.0-255,1484,1706,7,208008
36027,3.3e-05,172.31.36.0-255,66,1772,7,208008
36028,3.6e-05,172.217.194.0-255,1484,3256,7,208008
36029,3.8e-05,172.31.36.0-255,66,3322,7,208008
36030,6.4e-05,172.217.194.0-255,1484,4806,7,208008
36031,6.7e-05,172.31.36.0-255,66,4872,7,208008
36032,7.5e-05,172.217.194.0-255,7156,12028,7,208008
36033,7.7e-05,172.31.36.0-255,66,12094,7,208008
36034,9.6e-05,172.217.194.0-255,2902,14996,7,208008
36035,9.8e-05,172.31.36.0-255,66,15062,7,208008
36036,0.000122,172.31.36.0-255,66,15128,7,208008
36037,0.000139,172.217.194.0-255,6797,21925,7,208008
36038,0.000141,172.31.36.0-255,66,21991,7,208008
36039,0.000185,172.217.194.0-255,7156,29147,7,208008
36040,0.000189,172.31.36.0-255,66,29213,7,208008
36041,0.000214,172.31.36.0-255,66,29279,7,208008
36042,0.000229,172.217.194.0-255,1484,30763,7,208008
36043,0.000232,172.31.36.0-255,66,30829,7,208008
36044,0.000257,172.31.36.0-255,66,30895,7,208008
36045,0.000288,172.217.194.0-255,5738,36633,7,208008
36046,0.000291,172.31.36.0-255,66,36699,7,208008
36047,0.000308,172.217.194.0-255,2795,39494,7,208008
36048,0.000312,172.31.36.0-255,66,39560,7,208008
36049,0.000422,172.217.194.0-255,1484,41044,7,208008
36050,0.000427,172.31.36.0-255,66,41110,7,208008
36051,0.000432,172.217.194.0-255,2902,44012,7,208008
36052,0.000439,172.31.36.0-255,66,44078,7,208008
36053,0.000448,172.217.194.0-255,4320,48398,7,208008
36054,0.000451,172.31.36.0-255,66,48464,7,208008
36055,0.000462,172.217.194.0-255,1484,49948,7,208008
36056,0.000504,172.217.194.0-255,5738,55686,7,208008
36057,0.000508,172.31.36.0-255,66,55752,7,208008
36058,0.000526,172.217.194.0-255,576,56328,7,208008
36059,0.000531,172.217.194.0-255,2902,59230,7,208008
36060,0.000534,172.31.36.0-255,66,59296,7,208008
36061,0.00056,172.217.194.0-255,4320,63616,7,208008
36062,0.000564,172.31.36.0-255,66,63682,7,208008
36063,0.000572,172.217.194.0-255,7156,70838,7,208008
36064,0.000574,172.31.36.0-255,66,70904,7,208008
36065,0.000598,172.217.194.0-255,1484,72388,7,208008
36066,0.000602,172.217.194.0-255,1125,73513,7,208008
36067,0.000604,172.31.36.0-255,66,73579,7,208008
36068,0.000607,172.217.194.0-255,1484,75063,7,208008
36069,0.000612,172.217.194.0-255,4320,79383,7,208008
36070,0.000614,172.31.36.0-255,66,79449,7,208008
36071,0.00065,172.31.36.0-255,66,79515,7,208008
36072,0.00068,172.217.194.0-255,1125,80640,7,208008
36073,0.000762,172.217.194.0-255,1484,82124,7,208008
36074,0.000766,172.31.36.0-255,66,82190,7,208008
36075,0.000775,172.217.194.0-255,2902,85092,7,208008
36076,0.000777,172.31.36.0-255,66,85158,7,208008
36077,0.000798,172.217.194.0-255,5738,90896,7,208008
36078,0.000801,172.31.36.0-255,66,90962,7,208008
36079,0.000861,172.31.36.0-255,66,91028,7,208008
36080,0.000874,172.217.194.0-255,1484,92512,7,208008
36081,0.000887,172.31.36.0-255,66,92578,7,208008
36082,0.00089,172.217.194.0-255,1484,94062,7,208008
36083,0.000904,172.217.194.0-255,2902,96964,7,208008
36084,0.000907,172.31.36.0-255,66,97030,7,208008
36085,0.00091,172.217.194.0-255,1484,98514,7,208008
36086,0.000931,172.217.194.0-255,4320,102834,7,208008
36087,0.000935,172.31.36.0-255,66,102900,7,208008
36088,0.000961,172.31.36.0-255,66,102966,7,208008
36089,0.000967,172.217.194.0-255,5738,108704,7,208008
36090,0.00097,172.31.36.0-255,66,108770,7,208008
36091,0.001,172.217.194.0-255,2902,111672,7,208008
36092,0.001004,172.31.36.0-255,66,111738,7,208008
36093,0.001036,172.31.36.0-255,66,111804,7,208008
36094,0.001047,172.31.36.0-255,66,111870,7,208008
36095,0.001071,172.217.194.0-255,7156,119026,7,208008
36096,0.001073,172.31.36.0-255,66,119092,7,208008
36097,0.00108,172.217.194.0-255,5020,124112,7,208008
36098,0.001082,172.31.36.0-255,66,124178,7,208008
36099,0.001136,172.31.36.0-255,66,124244,7,208008
36100,0.001157,172.217.194.0-255,2543,126787,7,208008
36101,0.00116,172.31.36.0-255,66,126853,7,208008
36102,0.001179,172.217.194.0-255,2902,129755,7,208008
36103,0.001182,172.31.36.0-255,66,129821,7,208008
36104,0.001188,172.217.194.0-255,5738,135559,7,208008
36105,0.001191,172.31.36.0-255,66,135625,7,208008
36106,0.00121,172.217.194.0-255,1484,137109,7,208008
36107,0.001215,172.217.194.0-255,4320,141429,7,208008
36108,0.001218,172.31.36.0-255,66,141495,7,208008
36109,0.001265,172.31.36.0-255,66,141561,7,208008
36110,0.001272,172.217.194.0-255,5379,146940,7,208008
36111,0.001275,172.31.36.0-255,66,147006,7,208008
36112,0.001296,172.217.194.0-255,1484,148490,7,208008
36113,0.00131,172.217.194.0-255,5738,154228,7,208008
36114,0.001313,172.31.36.0-255,66,154294,7,208008
36115,0.001325,172.31.36.0-255,66,154360,7,208008
36116,0.001348,172.217.194.0-255,1125,155485,7,208008
36117,0.001406,172.217.194.0-255,1484,156969,7,208008
36118,0.00141,172.31.36.0-255,66,157035,7,208008
36119,0.001415,172.217.194.0-255,2902,159937,7,208008
36120,0.001418,172.31.36.0-255,66,160003,7,208008
36121,0.001447,172.217.194.0-255,5738,165741,7,208008
36122,0.00145,172.31.36.0-255,66,165807,7,208008
36123,0.001455,172.217.194.0-255,2902,168709,7,208008
36124,0.001457,172.31.36.0-255,66,168775,7,208008
36125,0.001482,172.31.36.0-255,66,168841,7,208008
36126,0.001542,172.31.36.0-255,66,168907,7,208008
36127,0.001562,172.217.194.0-255,766,169673,7,208008
36128,0.001572,172.31.36.0-255,66,169739,7,208008
36129,0.001587,172.31.36.0-255,66,169805,7,208008
36130,0.001616,172.31.36.0-255,66,169871,7,208008
36131,0.00163,172.31.36.0-255,66,169937,7,208008
36132,0.001649,172.217.194.0-255,2543,172480,7,208008
36133,0.001652,172.31.36.0-255,66,172546,7,208008
36134,0.001666,172.217.194.0-255,4320,176866,7,208008
36135,0.001669,172.31.36.0-255,66,176932,7,208008
36136,0.001708,172.31.36.0-255,66,176998,7,208008
36137,0.001751,172.217.194.0-255,1484,178482,7,208008
36138,0.001766,172.217.194.0-255,2902,181384,7,208008
36139,0.001769,172.31.36.0-255,66,181450,7,208008
36140,0.001775,172.217.194.0-255,4320,185770,7,208008
36141,0.001777,172.31.36.0-255,66,185836,7,208008
36142,0.001795,172.217.194.0-255,1484,187320,7,208008
36143,0.0018,172.217.194.0-255,4320,191640,7,208008
36144,0.001803,172.31.36.0-255,66,191706,7,208008
36145,0.001818,172.217.194.0-255,4320,196026,7,208008
36146,0.001822,172.31.36.0-255,66,196092,7,208008
36147,0.001851,172.217.194.0-255,4320,200412,7,208008
36148,0.001854,172.31.36.0-255,66,200478,7,208008
36149,0.001864,172.31.36.0-255,66,200544,7,208008
36150,0.001868,172.217.194.0-255,2764,203308,7,208008
36151,0.00187,172.31.36.0-255,66,203374,7,208008
36152,0.001908,172.217.194.0-255,105,203479,7,208008
36153,0.007929,172.31.36.0-255,66,203545,7,208008
36154,0.007958,172.31.36.0-255,105,203650,7,208008
36155,0.010161,172.217.194.0-255,66,203716,7,208008
36156,0.032914,172.31.36.0-255,172,203888,7,208008
36157,0.032944,172.31.36.0-255,1115,205003,7,208008
36158,0.032985,172.31.36.0-255,1514,206517,7,208008
36159,0.032987,172.31.36.0-255,1293,207810,7,208008
36160,0.03446,104.244.42.0-255,66,207876,7,208008
36161,0.034514,104.244.42.0-255,66,207942,7,208008
36162,0.034556,104.244.42.0-255,66,208008,7,208008
36163,0.0,74.125.130.0-255,153,153,7,337303
36164,2.9e-05,172.31.36.0-255,66,219,7,337303
36165,3.7e-05,74.125.130.0-255,1484,1703,7,337303
36166,4.1e-05,172.31.36.0-255,66,1769,7,337303
36167,4.7e-05,74.125.130.0-255,2902,4671,7,337303
36168,5e-05,172.31.36.0-255,66,4737,7,337303
36169,5.7e-05,74.125.130.0-255,5738,10475,7,337303
36170,6e-05,172.31.36.0-255,66,10541,7,337303
36171,8.2e-05,74.125.130.0-255,3436,13977,7,337303
36172,8.7e-05,172.31.36.0-255,66,14043,7,337303
36173,0.000182,74.125.130.0-255,1484,15527,7,337303
36174,0.000187,172.31.36.0-255,66,15593,7,337303
36175,0.000193,74.125.130.0-255,2902,18495,7,337303
36176,0.000196,172.31.36.0-255,66,18561,7,337303
36177,0.000201,74.125.130.0-255,4320,22881,7,337303
36178,0.000203,172.31.36.0-255,66,22947,7,337303
36179,0.000225,74.125.130.0-255,1484,24431,7,337303
36180,0.000228,172.31.36.0-255,66,24497,7,337303
36181,0.000234,74.125.130.0-255,5738,30235,7,337303
36182,0.000237,172.31.36.0-255,66,30301,7,337303
36183,0.000268,74.125.130.0-255,1484,31785,7,337303
36184,0.00027,172.31.36.0-255,66,31851,7,337303
36185,0.000295,74.125.130.0-255,3961,35812,7,337303
36186,0.000298,172.31.36.0-255,66,35878,7,337303
36187,0.000304,74.125.130.0-255,5738,41616,7,337303
36188,0.000306,172.31.36.0-255,66,41682,7,337303
36189,0.000342,74.125.130.0-255,4320,46002,7,337303
36190,0.000346,172.31.36.0-255,66,46068,7,337303
36191,0.000361,74.125.130.0-255,2543,48611,7,337303
36192,0.000364,172.31.36.0-255,66,48677,7,337303
36193,0.000411,74.125.130.0-255,1484,50161,7,337303
36194,0.000414,172.31.36.0-255,66,50227,7,337303
36195,0.000417,74.125.130.0-255,1484,51711,7,337303
36196,0.000432,74.125.130.0-255,2902,54613,7,337303
36197,0.000435,172.31.36.0-255,66,54679,7,337303
36198,0.000467,74.125.130.0-255,5738,60417,7,337303
36199,0.00047,172.31.36.0-255,66,60483,7,337303
36200,0.000473,74.125.130.0-255,1484,61967,7,337303
36201,0.000493,74.125.130.0-255,3961,65928,7,337303
36202,0.000495,172.31.36.0-255,66,65994,7,337303
36203,0.000542,74.125.130.0-255,378,66372,7,337303
36204,0.000803,172.31.36.0-255,66,66438,7,337303
36205,0.000858,74.125.130.0-255,364,66802,7,337303
36206,0.001304,74.125.130.0-255,1484,68286,7,337303
36207,0.001311,172.31.36.0-255,66,68352,7,337303
36208,0.001318,74.125.130.0-255,2902,71254,7,337303
36209,0.00132,172.31.36.0-255,66,71320,7,337303
36210,0.001326,74.125.130.0-255,4320,75640,7,337303
36211,0.001328,172.31.36.0-255,66,75706,7,337303
36212,0.001359,74.125.130.0-255,1484,77190,7,337303
36213,0.001367,74.125.130.0-255,6797,83987,7,337303
36214,0.00137,172.31.36.0-255,66,84053,7,337303
36215,0.001374,74.125.130.0-255,2902,86955,7,337303
36216,0.001377,172.31.36.0-255,66,87021,7,337303
36217,0.0014,172.31.36.0-255,66,87087,7,337303
36218,0.001404,74.125.130.0-255,2543,89630,7,337303
36219,0.001406,172.31.36.0-255,66,89696,7,337303
36220,0.002029,74.125.130.0-255,1484,91180,7,337303
36221,0.002042,74.125.130.0-255,2902,94082,7,337303
36222,0.002044,172.31.36.0-255,66,94148,7,337303
36223,0.002047,74.125.130.0-255,1484,95632,7,337303
36224,0.002065,74.125.130.0-255,4320,99952,7,337303
36225,0.002067,172.31.36.0-255,66,100018,7,337303
36226,0.002097,172.31.36.0-255,66,100084,7,337303
36227,0.002116,74.125.130.0-255,1484,101568,7,337303
36228,0.002123,74.125.130.0-255,7156,108724,7,337303
36229,0.002125,172.31.36.0-255,66,108790,7,337303
36230,0.002141,74.125.130.0-255,3602,112392,7,337303
36231,0.002142,172.31.36.0-255,66,112458,7,337303
36232,0.002194,74.125.130.0-255,2902,115360,7,337303
36233,0.002196,172.31.36.0-255,66,115426,7,337303
36234,0.002199,74.125.130.0-255,1484,116910,7,337303
36235,0.002215,74.125.130.0-255,2902,119812,7,337303
36236,0.002217,172.31.36.0-255,66,119878,7,337303
36237,0.002223,74.125.130.0-255,5738,125616,7,337303
36238,0.002225,172.31.36.0-255,66,125682,7,337303
36239,0.002241,74.125.130.0-255,2902,128584,7,337303
36240,0.002243,172.31.36.0-255,66,128650,7,337303
36241,0.002249,74.125.130.0-255,5738,134388,7,337303
36242,0.002251,172.31.36.0-255,66,134454,7,337303
36243,0.004439,74.125.130.0-255,5738,140192,7,337303
36244,0.004443,172.31.36.0-255,66,140258,7,337303
36245,0.006678,74.125.130.0-255,5738,145996,7,337303
36246,0.006685,172.31.36.0-255,66,146062,7,337303
36247,0.008895,74.125.130.0-255,5738,151800,7,337303
36248,0.008902,172.31.36.0-255,66,151866,7,337303
36249,0.011094,74.125.130.0-255,5738,157604,7,337303
36250,0.011102,172.31.36.0-255,66,157670,7,337303
36251,0.013296,74.125.130.0-255,5738,163408,7,337303
36252,0.013303,172.31.36.0-255,66,163474,7,337303
36253,0.01553,74.125.130.0-255,5738,169212,7,337303
36254,0.015538,172.31.36.0-255,66,169278,7,337303
36255,0.017753,74.125.130.0-255,5738,175016,7,337303
36256,0.017761,172.31.36.0-255,66,175082,7,337303
36257,0.019966,74.125.130.0-255,5738,180820,7,337303
36258,0.019974,172.31.36.0-255,66,180886,7,337303
36259,0.022181,74.125.130.0-255,5738,186624,7,337303
36260,0.022187,172.31.36.0-255,66,186690,7,337303
36261,0.024405,74.125.130.0-255,5738,192428,7,337303
36262,0.024412,172.31.36.0-255,66,192494,7,337303
36263,0.026611,74.125.130.0-255,5738,198232,7,337303
36264,0.026624,172.31.36.0-255,66,198298,7,337303
36265,0.027777,172.31.36.0-255,172,198470,7,337303
36266,0.027809,172.31.36.0-255,1115,199585,7,337303
36267,0.027868,172.31.36.0-255,1514,201099,7,337303
36268,0.02787,172.31.36.0-255,1291,202390,7,337303
36269,0.02884,74.125.130.0-255,5738,208128,7,337303
36270,0.028848,172.31.36.0-255,66,208194,7,337303
36271,0.029324,104.244.42.0-255,66,208260,7,337303
36272,0.029374,104.244.42.0-255,66,208326,7,337303
36273,0.02943,104.244.42.0-255,66,208392,7,337303
36274,0.031071,74.125.130.0-255,5738,214130,7,337303
36275,0.031077,172.31.36.0-255,66,214196,7,337303
36276,0.033281,74.125.130.0-255,5738,219934,7,337303
36277,0.033286,172.31.36.0-255,66,220000,7,337303
36278,0.035493,74.125.130.0-255,2902,222902,7,337303
36279,0.035498,172.31.36.0-255,66,222968,7,337303
36280,0.035526,74.125.130.0-255,2902,225870,7,337303
36281,0.03553,172.31.36.0-255,66,225936,7,337303
36282,0.037696,74.125.130.0-255,2902,228838,7,337303
36283,0.037702,172.31.36.0-255,66,228904,7,337303
36284,0.037724,74.125.130.0-255,2902,231806,7,337303
36285,0.037727,172.31.36.0-255,66,231872,7,337303
36286,0.0399,74.125.130.0-255,2902,234774,7,337303
36287,0.039921,172.31.36.0-255,66,234840,7,337303
36288,0.039941,74.125.130.0-255,2902,237742,7,337303
36289,0.039945,172.31.36.0-255,66,237808,7,337303
36290,0.04211,74.125.130.0-255,2902,240710,7,337303
36291,0.042115,172.31.36.0-255,66,240776,7,337303
36292,0.042144,74.125.130.0-255,2902,243678,7,337303
36293,0.042148,172.31.36.0-255,66,243744,7,337303
36294,0.044298,74.125.130.0-255,2902,246646,7,337303
36295,0.044304,172.31.36.0-255,66,246712,7,337303
36296,0.044324,74.125.130.0-255,2902,249614,7,337303
36297,0.044327,172.31.36.0-255,66,249680,7,337303
36298,0.046496,74.125.130.0-255,4320,254000,7,337303
36299,0.046502,172.31.36.0-255,66,254066,7,337303
36300,0.04653,74.125.130.0-255,1484,255550,7,337303
36301,0.046635,172.31.36.0-255,101,255651,7,337303
36302,0.048726,74.125.130.0-255,4320,259971,7,337303
36303,0.048731,172.31.36.0-255,66,260037,7,337303
36304,0.048826,74.125.130.0-255,1484,261521,7,337303
36305,0.050924,74.125.130.0-255,4320,265841,7,337303
36306,0.05093,172.31.36.0-255,66,265907,7,337303
36307,0.053122,74.125.130.0-255,4320,270227,7,337303
36308,0.053128,172.31.36.0-255,66,270293,7,337303
36309,0.053156,74.125.130.0-255,1484,271777,7,337303
36310,0.055313,74.125.130.0-255,4320,276097,7,337303
36311,0.055318,172.31.36.0-255,66,276163,7,337303
36312,0.057515,74.125.130.0-255,5738,281901,7,337303
36313,0.057521,172.31.36.0-255,66,281967,7,337303
36314,0.059727,74.125.130.0-255,5738,287705,7,337303
36315,0.059732,172.31.36.0-255,66,287771,7,337303
36316,0.061935,74.125.130.0-255,4320,292091,7,337303
36317,0.061941,172.31.36.0-255,66,292157,7,337303
36318,0.061971,74.125.130.0-255,1484,293641,7,337303
36319,0.064139,74.125.130.0-255,4320,297961,7,337303
36320,0.064144,172.31.36.0-255,66,298027,7,337303
36321,0.066335,74.125.130.0-255,5738,303765,7,337303
36322,0.066341,172.31.36.0-255,66,303831,7,337303
36323,0.068544,74.125.130.0-255,5738,309569,7,337303
36324,0.068549,172.31.36.0-255,66,309635,7,337303
36325,0.070748,74.125.130.0-255,5738,315373,7,337303
36326,0.070752,172.31.36.0-255,66,315439,7,337303
36327,0.072954,74.125.130.0-255,5738,321177,7,337303
36328,0.07296,172.31.36.0-255,66,321243,7,337303
36329,0.075169,74.125.130.0-255,4320,325563,7,337303
36330,0.075174,172.31.36.0-255,66,325629,7,337303
36331,0.075201,74.125.130.0-255,1484,327113,7,337303
36332,0.077399,74.125.130.0-255,4320,331433,7,337303
36333,0.077405,172.31.36.0-255,66,331499,7,337303
36334,0.079611,74.125.130.0-255,5738,337237,7,337303
36335,0.079617,172.31.36.0-255,66,337303,7,337303
36336,0.0,172.217.194.0-255,146,146,7,219377
36337,2.3e-05,172.31.36.0-255,66,212,7,219377
36338,2.9e-05,172.217.194.0-255,1484,1696,7,219377
36339,3.3e-05,172.31.36.0-255,66,1762,7,219377
36340,3.9e-05,172.217.194.0-255,2902,4664,7,219377
36341,4.2e-05,172.31.36.0-255,66,4730,7,219377
36342,5e-05,172.217.194.0-255,7156,11886,7,219377
36343,5.3e-05,172.31.36.0-255,66,11952,7,219377
36344,5.7e-05,172.217.194.0-255,1940,13892,7,219377
36345,6e-05,172.31.36.0-255,66,13958,7,219377
36346,6.7e-05,172.217.194.0-255,5738,19696,7,219377
36347,7e-05,172.31.36.0-255,66,19762,7,219377
36348,9.3e-05,172.217.194.0-255,5738,25500,7,219377
36349,9.5e-05,172.31.36.0-255,66,25566,7,219377
36350,0.000102,172.217.194.0-255,5379,30945,7,219377
36351,0.000105,172.31.36.0-255,66,31011,7,219377
36352,0.000132,172.217.194.0-255,1484,32495,7,219377
36353,0.000135,172.31.36.0-255,66,32561,7,219377
36354,0.00014,172.217.194.0-255,2902,35463,7,219377
36355,0.000142,172.31.36.0-255,66,35529,7,219377
36356,0.000145,172.217.194.0-255,1484,37013,7,219377
36357,0.000147,172.31.36.0-255,66,37079,7,219377
36358,0.000168,172.217.194.0-255,4320,41399,7,219377
36359,0.000171,172.31.36.0-255,66,41465,7,219377
36360,0.000174,172.217.194.0-255,1484,42949,7,219377
36361,0.000175,172.31.36.0-255,66,43015,7,219377
36362,0.000192,172.217.194.0-255,5379,48394,7,219377
36363,0.000194,172.31.36.0-255,66,48460,7,219377
36364,0.000544,172.217.194.0-255,1484,49944,7,219377
36365,0.00055,172.31.36.0-255,66,50010,7,219377
36366,0.000555,172.217.194.0-255,2902,52912,7,219377
36367,0.000558,172.31.36.0-255,66,52978,7,219377
36368,0.000606,172.217.194.0-255,5738,58716,7,219377
36369,0.000609,172.31.36.0-255,66,58782,7,219377
36370,0.000632,172.217.194.0-255,5738,64520,7,219377
36371,0.000635,172.31.36.0-255,66,64586,7,219377
36372,0.000654,172.217.194.0-255,1705,66291,7,219377
36373,0.000657,172.31.36.0-255,66,66357,7,219377
36374,0.00095,172.217.194.0-255,1484,67841,7,219377
36375,0.000956,172.217.194.0-255,2902,70743,7,219377
36376,0.000959,172.31.36.0-255,66,70809,7,219377
36377,0.000966,172.217.194.0-255,4320,75129,7,219377
36378,0.000968,172.31.36.0-255,66,75195,7,219377
36379,0.00098,172.217.194.0-255,1484,76679,7,219377
36380,0.000984,172.217.194.0-255,2902,79581,7,219377
36381,0.000986,172.31.36.0-255,66,79647,7,219377
36382,0.001024,172.31.36.0-255,66,79713,7,219377
36383,0.001037,172.31.36.0-255,66,79779,7,219377
36384,0.001068,172.217.194.0-255,7156,86935,7,219377
36385,0.001071,172.31.36.0-255,66,87001,7,219377
36386,0.00109,172.217.194.0-255,2902,89903,7,219377
36387,0.001092,172.31.36.0-255,66,89969,7,219377
36388,0.001113,172.31.36.0-255,66,90035,7,219377
36389,0.001118,172.217.194.0-255,4320,94355,7,219377
36390,0.001121,172.31.36.0-255,66,94421,7,219377
36391,0.001166,172.31.36.0-255,66,94487,7,219377
36392,0.001179,172.31.36.0-255,66,94553,7,219377
36393,0.001185,172.217.194.0-255,4320,98873,7,219377
36394,0.001187,172.31.36.0-255,66,98939,7,219377
36395,0.001219,172.31.36.0-255,66,99005,7,219377
36396,0.001258,172.217.194.0-255,7156,106161,7,219377
36397,0.001261,172.31.36.0-255,66,106227,7,219377
36398,0.001284,172.31.36.0-255,66,106293,7,219377
36399,0.001297,172.31.36.0-255,66,106359,7,219377
36400,0.001314,172.31.36.0-255,66,106425,7,219377
36401,0.001335,172.217.194.0-255,5738,112163,7,219377
36402,0.001338,172.31.36.0-255,66,112229,7,219377
36403,0.001363,172.217.194.0-255,2184,114413,7,219377
36404,0.001365,172.31.36.0-255,66,114479,7,219377
36405,0.001405,172.31.36.0-255,66,114545,7,219377
36406,0.001432,172.31.36.0-255,66,114611,7,219377
36407,0.00145,172.217.194.0-255,4320,118931,7,219377
36408,0.001453,172.217.194.0-255,1484,120415,7,219377
36409,0.001466,172.217.194.0-255,2902,123317,7,219377
36410,0.001484,172.217.194.0-255,4471,127788,7,219377
36411,0.001487,172.31.36.0-255,66,127854,7,219377
36412,0.001492,172.31.36.0-255,66,127920,7,219377
36413,0.001636,172.217.194.0-255,1484,129404,7,219377
36414,0.001642,172.217.194.0-255,2902,132306,7,219377
36415,0.001651,172.31.36.0-255,66,132372,7,219377
36416,0.001663,172.217.194.0-255,5738,138110,7,219377
36417,0.001676,172.217.194.0-255,2902,141012,7,219377
36418,0.00169,172.217.194.0-255,1484,142496,7,219377
36419,0.001712,172.217.194.0-255,7156,149652,7,219377
36420,0.001716,172.31.36.0-255,66,149718,7,219377
36421,0.001721,172.31.36.0-255,66,149784,7,219377
36422,0.001734,172.217.194.0-255,1484,151268,7,219377
36423,0.001741,172.217.194.0-255,5738,157006,7,219377
36424,0.00175,172.31.36.0-255,66,157072,7,219377
36425,0.001759,172.217.194.0-255,2902,159974,7,219377
36426,0.001762,172.217.194.0-255,2184,162158,7,219377
36427,0.001773,172.31.36.0-255,66,162224,7,219377
36428,0.001804,172.217.194.0-255,2902,165126,7,219377
36429,0.001822,172.217.194.0-255,1484,166610,7,219377
36430,0.001825,172.31.36.0-255,66,166676,7,219377
36431,0.001835,172.217.194.0-255,2902,169578,7,219377
36432,0.001842,172.31.36.0-255,66,169644,7,219377
36433,0.001855,172.217.194.0-255,2902,172546,7,219377
36434,0.001859,172.217.194.0-255,2902,175448,7,219377
36435,0.00187,172.31.36.0-255,66,175514,7,219377
36436,0.001903,172.217.194.0-255,5738,181252,7,219377
36437,0.001908,172.31.36.0-255,66,181318,7,219377
36438,0.001926,172.217.194.0-255,5738,187056,7,219377
36439,0.001938,172.31.36.0-255,66,187122,7,219377
36440,0.001976,172.217.194.0-255,2184,189306,7,219377
36441,0.002013,172.217.194.0-255,5738,195044,7,219377
36442,0.00202,172.31.36.0-255,66,195110,7,219377
36443,0.002043,172.217.194.0-255,1484,196594,7,219377
36444,0.002065,172.31.36.0-255,66,196660,7,219377
36445,0.002089,172.217.194.0-255,7156,203816,7,219377
36446,0.002095,172.217.194.0-255,5020,208836,7,219377
36447,0.0021,172.217.194.0-255,2902,211738,7,219377
36448,0.002122,172.31.36.0-255,66,211804,7,219377
36449,0.002133,172.31.36.0-255,66,211870,7,219377
36450,0.002139,172.217.194.0-255,105,211975,7,219377
36451,0.004681,172.31.36.0-255,66,212041,7,219377
36452,0.00472,172.31.36.0-255,105,212146,7,219377
36453,0.007324,172.217.194.0-255,66,212212,7,219377
36454,0.03842,172.31.36.0-255,172,212384,7,219377
36455,0.038456,172.31.36.0-255,1114,213498,7,219377
36456,0.038524,172.31.36.0-255,1514,215012,7,219377
36457,0.038526,172.31.36.0-255,1514,216526,7,219377
36458,0.038532,172.31.36.0-255,1514,218040,7,219377
36459,0.038533,172.31.36.0-255,1073,219113,7,219377
36460,0.040043,104.244.42.0-255,66,219179,7,219377
36461,0.040081,104.244.42.0-255,66,219245,7,219377
36462,0.040131,104.244.42.0-255,66,219311,7,219377
36463,0.040153,104.244.42.0-255,66,219377,7,219377
36464,0.0,74.125.68.0-255,145,145,7,362730
36465,2.6e-05,172.31.36.0-255,66,211,7,362730
36466,3.3e-05,74.125.68.0-255,1484,1695,7,362730
36467,3.7e-05,172.31.36.0-255,66,1761,7,362730
36468,5.7e-05,74.125.68.0-255,2902,4663,7,362730
36469,5.9e-05,172.31.36.0-255,66,4729,7,362730
36470,7.4e-05,74.125.68.0-255,5738,10467,7,362730
36471,7.7e-05,172.31.36.0-255,66,10533,7,362730
36472,0.000117,74.125.68.0-255,2902,13435,7,362730
36473,0.00012,172.31.36.0-255,66,13501,7,362730
36474,0.000165,74.125.68.0-255,2902,16403,7,362730
36475,0.00017,172.31.36.0-255,66,16469,7,362730
36476,0.000196,172.31.36.0-255,66,16535,7,362730
36477,0.000244,74.125.68.0-255,2902,19437,7,362730
36478,0.000246,172.31.36.0-255,66,19503,7,362730
36479,0.000264,74.125.68.0-255,1484,20987,7,362730
36480,0.000267,172.31.36.0-255,66,21053,7,362730
36481,0.000288,74.125.68.0-255,2543,23596,7,362730
36482,0.000291,172.31.36.0-255,66,23662,7,362730
36483,0.000343,74.125.68.0-255,1484,25146,7,362730
36484,0.000348,74.125.68.0-255,2902,28048,7,362730
36485,0.000348,172.31.36.0-255,66,28114,7,362730
36486,0.000353,172.31.36.0-255,66,28180,7,362730
36487,0.000363,74.125.68.0-255,2902,31082,7,362730
36488,0.000366,172.31.36.0-255,66,31148,7,362730
36489,0.000382,74.125.68.0-255,2902,34050,7,362730
36490,0.000385,172.31.36.0-255,66,34116,7,362730
36491,0.000421,74.125.68.0-255,4320,38436,7,362730
36492,0.000425,172.31.36.0-255,66,38502,7,362730
36493,0.000461,74.125.68.0-255,5379,43881,7,362730
36494,0.000465,172.31.36.0-255,66,43947,7,362730
36495,0.000519,74.125.68.0-255,7156,51103,7,362730
36496,0.000523,172.31.36.0-255,66,51169,7,362730
36497,0.000582,74.125.68.0-255,1484,52653,7,362730
36498,0.000599,74.125.68.0-255,5653,58306,7,362730
36499,0.000603,172.31.36.0-255,66,58372,7,362730
36500,0.000867,74.125.68.0-255,129,58501,7,362730
36501,0.000906,74.125.68.0-255,1484,59985,7,362730
36502,0.00091,172.31.36.0-255,66,60051,7,362730
36503,0.000916,74.125.68.0-255,2902,62953,7,362730
36504,0.000918,172.31.36.0-255,66,63019,7,362730
36505,0.000942,74.125.68.0-255,5738,68757,7,362730
36506,0.000945,172.31.36.0-255,66,68823,7,362730
36507,0.000987,74.125.68.0-255,1484,70307,7,362730
36508,0.001003,74.125.68.0-255,5379,75686,7,362730
36509,0.001006,172.31.36.0-255,66,75752,7,362730
36510,0.001252,74.125.68.0-255,1484,77236,7,362730
36511,0.00126,74.125.68.0-255,2902,80138,7,362730
36512,0.001264,172.31.36.0-255,66,80204,7,362730
36513,0.001283,74.125.68.0-255,5738,85942,7,362730
36514,0.001286,172.31.36.0-255,66,86008,7,362730
36515,0.001326,74.125.68.0-255,2902,88910,7,362730
36516,0.001329,172.31.36.0-255,66,88976,7,362730
36517,0.001365,74.125.68.0-255,4320,93296,7,362730
36518,0.001368,172.31.36.0-255,66,93362,7,362730
36519,0.001403,74.125.68.0-255,2902,96264,7,362730
36520,0.001406,172.31.36.0-255,66,96330,7,362730
36521,0.001426,74.125.68.0-255,5738,102068,7,362730
36522,0.001428,172.31.36.0-255,66,102134,7,362730
36523,0.001482,74.125.68.0-255,2902,105036,7,362730
36524,0.001485,172.31.36.0-255,66,105102,7,362730
36525,0.001501,74.125.68.0-255,1484,106586,7,362730
36526,0.001527,74.125.68.0-255,3602,110188,7,362730
36527,0.001531,172.31.36.0-255,66,110254,7,362730
36528,0.001948,74.125.68.0-255,1484,111738,7,362730
36529,0.001967,74.125.68.0-255,2902,114640,7,362730
36530,0.00197,172.31.36.0-255,66,114706,7,362730
36531,0.001981,74.125.68.0-255,2902,117608,7,362730
36532,0.001983,172.31.36.0-255,66,117674,7,362730
36533,0.002003,74.125.68.0-255,2902,120576,7,362730
36534,0.002005,172.31.36.0-255,66,120642,7,362730
36535,0.002031,74.125.68.0-255,4320,124962,7,362730
36536,0.002033,172.31.36.0-255,66,125028,7,362730
36537,0.002044,74.125.68.0-255,2902,127930,7,362730
36538,0.002045,172.31.36.0-255,66,127996,7,362730
36539,0.00211,74.125.68.0-255,4320,132316,7,362730
36540,0.002112,172.31.36.0-255,66,132382,7,362730
36541,0.002134,74.125.68.0-255,4320,136702,7,362730
36542,0.002136,172.31.36.0-255,66,136768,7,362730
36543,0.002195,74.125.68.0-255,4320,141088,7,362730
36544,0.002197,172.31.36.0-255,66,141154,7,362730
36545,0.00221,74.125.68.0-255,2902,144056,7,362730
36546,0.002211,172.31.36.0-255,66,144122,7,362730
36547,0.002261,74.125.68.0-255,4320,148442,7,362730
36548,0.002263,172.31.36.0-255,66,148508,7,362730
36549,0.002307,172.31.36.0-255,66,148574,7,362730
36550,0.002443,74.125.68.0-255,7156,155730,7,362730
36551,0.002448,172.31.36.0-255,66,155796,7,362730
36552,0.002474,172.31.36.0-255,66,155862,7,362730
36553,0.002567,74.125.68.0-255,766,156628,7,362730
36554,0.003197,172.31.36.0-255,66,156694,7,362730
36555,0.004706,74.125.68.0-255,4320,161014,7,362730
36556,0.00471,172.31.36.0-255,66,161080,7,362730
36557,0.005421,74.125.68.0-255,1484,162564,7,362730
36558,0.00699,74.125.68.0-255,4320,166884,7,362730
36559,0.006995,172.31.36.0-255,66,166950,7,362730
36560,0.00924,74.125.68.0-255,5738,172688,7,362730
36561,0.009249,172.31.36.0-255,66,172754,7,362730
36562,0.011518,74.125.68.0-255,5738,178492,7,362730
36563,0.011531,172.31.36.0-255,66,178558,7,362730
36564,0.013791,74.125.68.0-255,5738,184296,7,362730
36565,0.013803,172.31.36.0-255,66,184362,7,362730
36566,0.016065,74.125.68.0-255,5738,190100,7,362730
36567,0.016075,172.31.36.0-255,66,190166,7,362730
36568,0.018322,74.125.68.0-255,5738,195904,7,362730
36569,0.018331,172.31.36.0-255,66,195970,7,362730
36570,0.020584,74.125.68.0-255,5738,201708,7,362730
36571,0.020597,172.31.36.0-255,66,201774,7,362730
36572,0.022843,74.125.68.0-255,5738,207512,7,362730
36573,0.022853,172.31.36.0-255,66,207578,7,362730
36574,0.025121,74.125.68.0-255,5738,213316,7,362730
36575,0.025137,172.31.36.0-255,66,213382,7,362730
36576,0.027385,74.125.68.0-255,5738,219120,7,362730
36577,0.027394,172.31.36.0-255,66,219186,7,362730
36578,0.028686,172.31.36.0-255,176,219362,7,362730
36579,0.028715,172.31.36.0-255,1115,220477,7,362730
36580,0.028772,172.31.36.0-255,1514,221991,7,362730
36581,0.028774,172.31.36.0-255,1514,223505,7,362730
36582,0.028775,172.31.36.0-255,1514,225019,7,362730
36583,0.028776,172.31.36.0-255,1514,226533,7,362730
36584,0.028802,172.31.36.0-255,1514,228047,7,362730
36585,0.028805,172.31.36.0-255,69,228116,7,362730
36586,0.02964,74.125.68.0-255,5738,233854,7,362730
36587,0.029648,172.31.36.0-255,66,233920,7,362730
36588,0.030239,104.244.42.0-255,66,233986,7,362730
36589,0.030308,104.244.42.0-255,66,234052,7,362730
36590,0.030374,104.244.42.0-255,66,234118,7,362730
36591,0.030377,104.244.42.0-255,66,234184,7,362730
36592,0.031887,74.125.68.0-255,2902,237086,7,362730
36593,0.03189,172.31.36.0-255,66,237152,7,362730
36594,0.031923,74.125.68.0-255,2902,240054,7,362730
36595,0.031926,172.31.36.0-255,66,240120,7,362730
36596,0.034129,74.125.68.0-255,2902,243022,7,362730
36597,0.034134,172.31.36.0-255,66,243088,7,362730
36598,0.034168,74.125.68.0-255,2902,245990,7,362730
36599,0.034171,172.31.36.0-255,66,246056,7,362730
36600,0.036371,74.125.68.0-255,2902,248958,7,362730
36601,0.036375,172.31.36.0-255,66,249024,7,362730
36602,0.036408,74.125.68.0-255,2902,251926,7,362730
36603,0.036411,172.31.36.0-255,66,251992,7,362730
36604,0.038614,74.125.68.0-255,2902,254894,7,362730
36605,0.038621,172.31.36.0-255,66,254960,7,362730
36606,0.038658,74.125.68.0-255,2902,257862,7,362730
36607,0.038661,172.31.36.0-255,66,257928,7,362730
36608,0.040866,74.125.68.0-255,2902,260830,7,362730
36609,0.040871,172.31.36.0-255,66,260896,7,362730
36610,0.040901,74.125.68.0-255,2902,263798,7,362730
36611,0.040904,172.31.36.0-255,66,263864,7,362730
36612,0.043127,74.125.68.0-255,2902,266766,7,362730
36613,0.04315,172.31.36.0-255,66,266832,7,362730
36614,0.043166,74.125.68.0-255,2902,269734,7,362730
36615,0.043171,172.31.36.0-255,66,269800,7,362730
36616,0.0454,74.125.68.0-255,5738,275538,7,362730
36617,0.04541,172.31.36.0-255,66,275604,7,362730
36618,0.047678,74.125.68.0-255,5738,281342,7,362730
36619,0.047695,172.31.36.0-255,66,281408,7,362730
36620,0.049954,74.125.68.0-255,5738,287146,7,362730
36621,0.049968,172.31.36.0-255,66,287212,7,362730
36622,0.052223,74.125.68.0-255,5738,292950,7,362730
36623,0.052231,172.31.36.0-255,66,293016,7,362730
36624,0.054463,74.125.68.0-255,1484,294500,7,362730
36625,0.05449,74.125.68.0-255,4320,298820,7,362730
36626,0.054494,172.31.36.0-255,66,298886,7,362730
36627,0.056752,74.125.68.0-255,5738,304624,7,362730
36628,0.056759,172.31.36.0-255,66,304690,7,362730
36629,0.059006,74.125.68.0-255,5738,310428,7,362730
36630,0.059012,172.31.36.0-255,66,310494,7,362730
36631,0.061269,74.125.68.0-255,5738,316232,7,362730
36632,0.06128,172.31.36.0-255,66,316298,7,362730
36633,0.063526,74.125.68.0-255,5738,322036,7,362730
36634,0.063535,172.31.36.0-255,66,322102,7,362730
36635,0.065787,74.125.68.0-255,5738,327840,7,362730
36636,0.065796,172.31.36.0-255,66,327906,7,362730
36637,0.06805,74.125.68.0-255,5738,333644,7,362730
36638,0.068059,172.31.36.0-255,66,333710,7,362730
36639,0.070314,74.125.68.0-255,5738,339448,7,362730
36640,0.070325,172.31.36.0-255,66,339514,7,362730
36641,0.072589,74.125.68.0-255,5738,345252,7,362730
36642,0.072603,172.31.36.0-255,66,345318,7,362730
36643,0.07485,74.125.68.0-255,5738,351056,7,362730
36644,0.074857,172.31.36.0-255,66,351122,7,362730
36645,0.077123,74.125.68.0-255,5738,356860,7,362730
36646,0.07713,172.31.36.0-255,66,356926,7,362730
36647,0.079377,74.125.68.0-255,5738,362664,7,362730
36648,0.079385,172.31.36.0-255,66,362730,7,362730
36649,0.0,74.125.24.0-255,226,226,7,78419
36650,2.3e-05,172.31.36.0-255,66,292,7,78419
36651,3e-05,74.125.24.0-255,1484,1776,7,78419
36652,3.4e-05,172.31.36.0-255,66,1842,7,78419
36653,5.5e-05,74.125.24.0-255,4320,6162,7,78419
36654,5.8e-05,172.31.36.0-255,66,6228,7,78419
36655,0.000238,172.31.36.0-255,66,6294,7,78419
36656,0.000544,74.125.24.0-255,5738,12032,7,78419
36657,0.000551,172.31.36.0-255,66,12098,7,78419
36658,0.000583,172.31.36.0-255,66,12164,7,78419
36659,0.001144,172.31.36.0-255,66,12230,7,78419
36660,0.002093,74.125.24.0-255,2902,15132,7,78419
36661,0.002099,172.31.36.0-255,66,15198,7,78419
36662,0.002132,74.125.24.0-255,2902,18100,7,78419
36663,0.002136,172.31.36.0-255,66,18166,7,78419
36664,0.002259,172.31.36.0-255,66,18232,7,78419
36665,0.002604,74.125.24.0-255,5738,23970,7,78419
36666,0.002609,172.31.36.0-255,66,24036,7,78419
36667,0.002835,74.125.24.0-255,2902,26938,7,78419
36668,0.002839,172.31.36.0-255,66,27004,7,78419
36669,0.002867,172.31.36.0-255,66,27070,7,78419
36670,0.003305,74.125.24.0-255,5738,32808,7,78419
36671,0.00331,172.31.36.0-255,66,32874,7,78419
36672,0.00333,74.125.24.0-255,2902,35776,7,78419
36673,0.003332,172.31.36.0-255,66,35842,7,78419
36674,0.003658,74.125.24.0-255,2902,38744,7,78419
36675,0.003662,172.31.36.0-255,66,38810,7,78419
36676,0.003771,74.125.24.0-255,4320,43130,7,78419
36677,0.003774,172.31.36.0-255,66,43196,7,78419
36678,0.003804,172.31.36.0-255,66,43262,7,78419
36679,0.00432,172.31.36.0-255,66,43328,7,78419
36680,0.004349,172.31.36.0-255,66,43394,7,78419
36681,0.00486,74.125.24.0-255,2902,46296,7,78419
36682,0.004864,172.31.36.0-255,66,46362,7,78419
36683,0.004936,172.31.36.0-255,66,46428,7,78419
36684,0.005198,172.31.36.0-255,66,46494,7,78419
36685,0.005331,74.125.24.0-255,5738,52232,7,78419
36686,0.005335,172.31.36.0-255,66,52298,7,78419
36687,0.005357,74.125.24.0-255,5738,58036,7,78419
36688,0.00536,172.31.36.0-255,66,58102,7,78419
36689,0.005858,74.125.24.0-255,7156,65258,7,78419
36690,0.005863,172.31.36.0-255,66,65324,7,78419
36691,0.005891,172.31.36.0-255,66,65390,7,78419
36692,0.005933,172.31.36.0-255,66,65456,7,78419
36693,0.006403,172.31.36.0-255,66,65522,7,78419
36694,0.00703,172.31.36.0-255,66,65588,7,78419
36695,0.007091,172.31.36.0-255,66,65654,7,78419
36696,0.007266,74.125.24.0-255,4320,69974,7,78419
36697,0.007271,172.31.36.0-255,66,70040,7,78419
36698,0.007319,172.31.36.0-255,66,70106,7,78419
36699,0.007358,172.31.36.0-255,66,70172,7,78419
36700,0.007998,172.31.36.0-255,66,70238,7,78419
36701,0.008052,172.31.36.0-255,66,70304,7,78419
36702,0.008372,172.31.36.0-255,66,70370,7,78419
36703,0.008417,172.31.36.0-255,66,70436,7,78419
36704,0.008443,74.125.24.0-255,581,71017,7,78419
36705,0.008448,172.31.36.0-255,66,71083,7,78419
36706,0.00931,172.31.36.0-255,105,71188,7,78419
36707,0.01135,74.125.24.0-255,66,71254,7,78419
36708,0.030631,172.31.36.0-255,172,71426,7,78419
36709,0.030673,172.31.36.0-255,1116,72542,7,78419
36710,0.030749,172.31.36.0-255,1514,74056,7,78419
36711,0.030751,172.31.36.0-255,1514,75570,7,78419
36712,0.030752,172.31.36.0-255,1514,77084,7,78419
36713,0.030753,172.31.36.0-255,1071,78155,7,78419
36714,0.032168,104.244.42.0-255,66,78221,7,78419
36715,0.032179,104.244.42.0-255,66,78287,7,78419
36716,0.032264,104.244.42.0-255,66,78353,7,78419
36717,0.032316,104.244.42.0-255,66,78419,7,78419
36718,0.0,74.125.24.0-255,146,146,7,376134
36719,1.6e-05,172.31.36.0-255,66,212,7,376134
36720,2.2e-05,74.125.24.0-255,1484,1696,7,376134
36721,2.6e-05,172.31.36.0-255,66,1762,7,376134
36722,3.1e-05,74.125.24.0-255,2902,4664,7,376134
36723,3.3e-05,172.31.36.0-255,66,4730,7,376134
36724,4e-05,74.125.24.0-255,7156,11886,7,376134
36725,4.2e-05,172.31.36.0-255,66,11952,7,376134
36726,4.6e-05,74.125.24.0-255,2050,14002,7,376134
36727,4.8e-05,172.31.36.0-255,66,14068,7,376134
36728,0.000106,74.125.24.0-255,1484,15552,7,376134
36729,0.000109,172.31.36.0-255,66,15618,7,376134
36730,0.000113,74.125.24.0-255,2902,18520,7,376134
36731,0.000115,172.31.36.0-255,66,18586,7,376134
36732,0.000132,74.125.24.0-255,5738,24324,7,376134
36733,0.000134,172.31.36.0-255,66,24390,7,376134
36734,0.000139,74.125.24.0-255,4320,28710,7,376134
36735,0.000141,172.31.36.0-255,66,28776,7,376134
36736,0.000184,74.125.24.0-255,2543,31319,7,376134
36737,0.000187,172.31.36.0-255,66,31385,7,376134
36738,0.000317,74.125.24.0-255,1484,32869,7,376134
36739,0.000321,172.31.36.0-255,66,32935,7,376134
36740,0.000326,74.125.24.0-255,2902,35837,7,376134
36741,0.000328,172.31.36.0-255,66,35903,7,376134
36742,0.000358,74.125.24.0-255,5738,41641,7,376134
36743,0.00036,172.31.36.0-255,66,41707,7,376134
36744,0.000367,74.125.24.0-255,6797,48504,7,376134
36745,0.000369,172.31.36.0-255,66,48570,7,376134
36746,0.000393,74.125.24.0-255,4320,52890,7,376134
36747,0.000395,172.31.36.0-255,66,52956,7,376134
36748,0.000411,74.125.24.0-255,7156,60112,7,376134
36749,0.000413,172.31.36.0-255,66,60178,7,376134
36750,0.000437,74.125.24.0-255,2902,63080,7,376134
36751,0.000439,172.31.36.0-255,66,63146,7,376134
36752,0.000443,74.125.24.0-255,2543,65689,7,376134
36753,0.000445,172.31.36.0-255,66,65755,7,376134
36754,0.000447,74.125.24.0-255,363,66118,7,376134
36755,0.00051,74.125.24.0-255,382,66500,7,376134
36756,0.000665,74.125.24.0-255,1484,67984,7,376134
36757,0.000668,172.31.36.0-255,66,68050,7,376134
36758,0.000688,74.125.24.0-255,2902,70952,7,376134
36759,0.00069,172.31.36.0-255,66,71018,7,376134
36760,0.000715,74.125.24.0-255,1484,72502,7,376134
36761,0.000735,74.125.24.0-255,1484,73986,7,376134
36762,0.000741,74.125.24.0-255,7156,81142,7,376134
36763,0.000744,172.31.36.0-255,66,81208,7,376134
36764,0.000747,172.31.36.0-255,66,81274,7,376134
36765,0.000755,74.125.24.0-255,2543,83817,7,376134
36766,0.000756,172.31.36.0-255,66,83883,7,376134
36767,0.00076,74.125.24.0-255,2902,86785,7,376134
36768,0.000762,172.31.36.0-255,66,86851,7,376134
36769,0.000791,74.125.24.0-255,7156,94007,7,376134
36770,0.000794,172.31.36.0-255,66,94073,7,376134
36771,0.000818,74.125.24.0-255,6797,100870,7,376134
36772,0.000821,172.31.36.0-255,66,100936,7,376134
36773,0.00093,74.125.24.0-255,1484,102420,7,376134
36774,0.000944,74.125.24.0-255,2902,105322,7,376134
36775,0.000946,74.125.24.0-255,1484,106806,7,376134
36776,0.00095,172.31.36.0-255,66,106872,7,376134
36777,0.000969,74.125.24.0-255,4320,111192,7,376134
36778,0.000971,172.31.36.0-255,66,111258,7,376134
36779,0.000976,74.125.24.0-255,2902,114160,7,376134
36780,0.000977,172.31.36.0-255,66,114226,7,376134
36781,0.001012,172.31.36.0-255,66,114292,7,376134
36782,0.001024,172.31.36.0-255,66,114358,7,376134
36783,0.001073,74.125.24.0-255,1484,115842,7,376134
36784,0.001096,74.125.24.0-255,2902,118744,7,376134
36785,0.001101,74.125.24.0-255,5738,124482,7,376134
36786,0.001104,74.125.24.0-255,2902,127384,7,376134
36787,0.001107,172.31.36.0-255,66,127450,7,376134
36788,0.001114,172.31.36.0-255,66,127516,7,376134
36789,0.001117,172.31.36.0-255,66,127582,7,376134
36790,0.001124,74.125.24.0-255,2902,130484,7,376134
36791,0.001127,172.31.36.0-255,66,130550,7,376134
36792,0.001157,74.125.24.0-255,7156,137706,7,376134
36793,0.001161,172.31.36.0-255,66,137772,7,376134
36794,0.001168,74.125.24.0-255,5738,143510,7,376134
36795,0.001171,172.31.36.0-255,66,143576,7,376134
36796,0.001186,74.125.24.0-255,5020,148596,7,376134
36797,0.001189,172.31.36.0-255,66,148662,7,376134
36798,0.001377,74.125.24.0-255,1484,150146,7,376134
36799,0.001384,74.125.24.0-255,2902,153048,7,376134
36800,0.001387,172.31.36.0-255,66,153114,7,376134
36801,0.001392,74.125.24.0-255,2902,156016,7,376134
36802,0.001394,172.31.36.0-255,66,156082,7,376134
36803,0.001412,74.125.24.0-255,2902,158984,7,376134
36804,0.001414,172.31.36.0-255,66,159050,7,376134
36805,0.001427,172.31.36.0-255,66,159116,7,376134
36806,0.001464,74.125.24.0-255,4320,163436,7,376134
36807,0.001467,172.31.36.0-255,66,163502,7,376134
36808,0.001495,172.31.36.0-255,66,163568,7,376134
36809,0.002133,74.125.24.0-255,1484,165052,7,376134
36810,0.002141,74.125.24.0-255,2902,167954,7,376134
36811,0.002146,172.31.36.0-255,66,168020,7,376134
36812,0.002154,74.125.24.0-255,5738,173758,7,376134
36813,0.002157,172.31.36.0-255,66,173824,7,376134
36814,0.002162,74.125.24.0-255,4320,178144,7,376134
36815,0.002165,172.31.36.0-255,66,178210,7,376134
36816,0.002178,172.31.36.0-255,66,178276,7,376134
36817,0.002182,74.125.24.0-255,2902,181178,7,376134
36818,0.002184,172.31.36.0-255,66,181244,7,376134
36819,0.002203,74.125.24.0-255,5020,186264,7,376134
36820,0.002205,172.31.36.0-255,66,186330,7,376134
36821,0.002263,74.125.24.0-255,1484,187814,7,376134
36822,0.002283,74.125.24.0-255,2902,190716,7,376134
36823,0.002286,172.31.36.0-255,66,190782,7,376134
36824,0.002289,74.125.24.0-255,1484,192266,7,376134
36825,0.002307,74.125.24.0-255,4320,196586,7,376134
36826,0.002309,172.31.36.0-255,66,196652,7,376134
36827,0.002336,74.125.24.0-255,7156,203808,7,376134
36828,0.002339,172.31.36.0-255,66,203874,7,376134
36829,0.002377,74.125.24.0-255,2902,206776,7,376134
36830,0.002379,172.31.36.0-255,66,206842,7,376134
36831,0.002393,74.125.24.0-255,4320,211162,7,376134
36832,0.002395,172.31.36.0-255,66,211228,7,376134
36833,0.004727,74.125.24.0-255,1484,212712,7,376134
36834,0.004744,74.125.24.0-255,4320,217032,7,376134
36835,0.004747,172.31.36.0-255,66,217098,7,376134
36836,0.007099,74.125.24.0-255,5738,222836,7,376134
36837,0.007105,172.31.36.0-255,66,222902,7,376134
36838,0.009455,74.125.24.0-255,5738,228640,7,376134
36839,0.009461,172.31.36.0-255,66,228706,7,376134
36840,0.011806,74.125.24.0-255,5738,234444,7,376134
36841,0.011814,172.31.36.0-255,66,234510,7,376134
36842,0.014136,74.125.24.0-255,5738,240248,7,376134
36843,0.014144,172.31.36.0-255,66,240314,7,376134
36844,0.016504,74.125.24.0-255,5738,246052,7,376134
36845,0.016515,172.31.36.0-255,66,246118,7,376134
36846,0.018854,74.125.24.0-255,5738,251856,7,376134
36847,0.018863,172.31.36.0-255,66,251922,7,376134
36848,0.021208,74.125.24.0-255,5738,257660,7,376134
36849,0.021216,172.31.36.0-255,66,257726,7,376134
36850,0.023589,74.125.24.0-255,5738,263464,7,376134
36851,0.023597,172.31.36.0-255,66,263530,7,376134
36852,0.025934,74.125.24.0-255,5738,269268,7,376134
36853,0.025942,172.31.36.0-255,66,269334,7,376134
36854,0.028276,74.125.24.0-255,5738,275072,7,376134
36855,0.028284,172.31.36.0-255,66,275138,7,376134
36856,0.030623,74.125.24.0-255,5738,280876,7,376134
36857,0.030633,172.31.36.0-255,66,280942,7,376134
36858,0.032863,172.31.36.0-255,190,281132,7,376134
36859,0.032896,172.31.36.0-255,1113,282245,7,376134
36860,0.032957,74.125.24.0-255,5738,287983,7,376134
36861,0.032963,172.31.36.0-255,66,288049,7,376134
36862,0.032995,172.31.36.0-255,1514,289563,7,376134
36863,0.032997,172.31.36.0-255,1514,291077,7,376134
36864,0.032998,172.31.36.0-255,1514,292591,7,376134
36865,0.032999,172.31.36.0-255,1514,294105,7,376134
36866,0.033026,172.31.36.0-255,1514,295619,7,376134
36867,0.033027,172.31.36.0-255,71,295690,7,376134
36868,0.034391,104.244.42.0-255,66,295756,7,376134
36869,0.034426,104.244.42.0-255,66,295822,7,376134
36870,0.034598,104.244.42.0-255,66,295888,7,376134
36871,0.034639,104.244.42.0-255,66,295954,7,376134
36872,0.035279,74.125.24.0-255,5738,301692,7,376134
36873,0.035286,172.31.36.0-255,66,301758,7,376134
36874,0.03762,74.125.24.0-255,5738,307496,7,376134
36875,0.037627,172.31.36.0-255,66,307562,7,376134
36876,0.039967,74.125.24.0-255,5738,313300,7,376134
36877,0.039973,172.31.36.0-255,66,313366,7,376134
36878,0.040048,104.244.42.0-255,108,313474,7,376134
36879,0.040053,172.31.36.0-255,66,313540,7,376134
36880,0.042321,74.125.24.0-255,5738,319278,7,376134
36881,0.042331,172.31.36.0-255,66,319344,7,376134
36882,0.044678,74.125.24.0-255,5738,325082,7,376134
36883,0.044684,172.31.36.0-255,66,325148,7,376134
36884,0.04701,74.125.24.0-255,5738,330886,7,376134
36885,0.047017,172.31.36.0-255,66,330952,7,376134
36886,0.049345,74.125.24.0-255,5738,336690,7,376134
36887,0.049352,172.31.36.0-255,66,336756,7,376134
36888,0.051679,74.125.24.0-255,5738,342494,7,376134
36889,0.051686,172.31.36.0-255,66,342560,7,376134
36890,0.054045,74.125.24.0-255,5738,348298,7,376134
36891,0.054052,172.31.36.0-255,66,348364,7,376134
36892,0.056417,74.125.24.0-255,5738,354102,7,376134
36893,0.056424,172.31.36.0-255,66,354168,7,376134
36894,0.05875,74.125.24.0-255,5738,359906,7,376134
36895,0.058756,172.31.36.0-255,66,359972,7,376134
36896,0.061102,74.125.24.0-255,5738,365710,7,376134
36897,0.061108,172.31.36.0-255,66,365776,7,376134
36898,0.063454,74.125.24.0-255,5738,371514,7,376134
36899,0.063461,172.31.36.0-255,66,371580,7,376134
36900,0.065809,74.125.24.0-255,4317,375897,7,376134
36901,0.065815,172.31.36.0-255,66,375963,7,376134
36902,0.065994,172.31.36.0-255,105,376068,7,376134
36903,0.068292,74.125.24.0-255,66,376134,7,376134
36904,0.0,74.125.24.0-255,146,146,7,235683
36905,2.6e-05,172.31.36.0-255,66,212,7,235683
36906,3.2e-05,74.125.24.0-255,1484,1696,7,235683
36907,3.7e-05,172.31.36.0-255,66,1762,7,235683
36908,4.2e-05,74.125.24.0-255,2902,4664,7,235683
36909,4.5e-05,172.31.36.0-255,66,4730,7,235683
36910,6.9e-05,74.125.24.0-255,7156,11886,7,235683
36911,7.1e-05,172.31.36.0-255,66,11952,7,235683
36912,0.000116,74.125.24.0-255,2104,14056,7,235683
36913,0.000119,172.31.36.0-255,66,14122,7,235683
36914,0.00032,74.125.24.0-255,1484,15606,7,235683
36915,0.000325,172.31.36.0-255,66,15672,7,235683
36916,0.000331,74.125.24.0-255,2902,18574,7,235683
36917,0.000334,172.31.36.0-255,66,18640,7,235683
36918,0.000365,74.125.24.0-255,5738,24378,7,235683
36919,0.000369,172.31.36.0-255,66,24444,7,235683
36920,0.000375,74.125.24.0-255,4320,28764,7,235683
36921,0.000377,172.31.36.0-255,66,28830,7,235683
36922,0.000392,74.125.24.0-255,2543,31373,7,235683
36923,0.000395,172.31.36.0-255,66,31439,7,235683
36924,0.000531,74.125.24.0-255,1484,32923,7,235683
36925,0.000536,172.31.36.0-255,66,32989,7,235683
36926,0.000541,74.125.24.0-255,2902,35891,7,235683
36927,0.000543,172.31.36.0-255,66,35957,7,235683
36928,0.000569,74.125.24.0-255,5738,41695,7,235683
36929,0.000572,172.31.36.0-255,66,41761,7,235683
36930,0.000576,74.125.24.0-255,1484,43245,7,235683
36931,0.000578,172.31.36.0-255,66,43311,7,235683
36932,0.000602,74.125.24.0-255,5379,48690,7,235683
36933,0.000605,172.31.36.0-255,66,48756,7,235683
36934,0.000623,74.125.24.0-255,5738,54494,7,235683
36935,0.000626,172.31.36.0-255,66,54560,7,235683
36936,0.000653,172.31.36.0-255,66,54626,7,235683
36937,0.000657,74.125.24.0-255,2543,57169,7,235683
36938,0.000659,172.31.36.0-255,66,57235,7,235683
36939,0.000693,74.125.24.0-255,397,57632,7,235683
36940,0.000717,74.125.24.0-255,347,57979,7,235683
36941,0.000862,74.125.24.0-255,1484,59463,7,235683
36942,0.000863,172.31.36.0-255,66,59529,7,235683
36943,0.00088,74.125.24.0-255,2902,62431,7,235683
36944,0.000883,172.31.36.0-255,66,62497,7,235683
36945,0.000928,74.125.24.0-255,5738,68235,7,235683
36946,0.000932,172.31.36.0-255,66,68301,7,235683
36947,0.000939,74.125.24.0-255,7156,75457,7,235683
36948,0.000942,172.31.36.0-255,66,75523,7,235683
36949,0.000958,172.31.36.0-255,66,75589,7,235683
36950,0.00098,74.125.24.0-255,2902,78491,7,235683
36951,0.000983,172.31.36.0-255,66,78557,7,235683
36952,0.000996,74.125.24.0-255,2184,80741,7,235683
36953,0.000999,172.31.36.0-255,66,80807,7,235683
36954,0.001169,74.125.24.0-255,1484,82291,7,235683
36955,0.001174,74.125.24.0-255,1484,83775,7,235683
36956,0.001177,172.31.36.0-255,66,83841,7,235683
36957,0.001193,74.125.24.0-255,1484,85325,7,235683
36958,0.001198,74.125.24.0-255,2902,88227,7,235683
36959,0.001201,172.31.36.0-255,66,88293,7,235683
36960,0.001222,74.125.24.0-255,2902,91195,7,235683
36961,0.001224,172.31.36.0-255,66,91261,7,235683
36962,0.001228,74.125.24.0-255,1484,92745,7,235683
36963,0.001239,172.31.36.0-255,66,92811,7,235683
36964,0.001255,74.125.24.0-255,2902,95713,7,235683
36965,0.001257,172.31.36.0-255,66,95779,7,235683
36966,0.001285,172.31.36.0-255,66,95845,7,235683
36967,0.001447,74.125.24.0-255,1484,97329,7,235683
36968,0.001451,74.125.24.0-255,1484,98813,7,235683
36969,0.001454,172.31.36.0-255,66,98879,7,235683
36970,0.001474,74.125.24.0-255,1484,100363,7,235683
36971,0.00148,74.125.24.0-255,5738,106101,7,235683
36972,0.001483,172.31.36.0-255,66,106167,7,235683
36973,0.001519,172.31.36.0-255,66,106233,7,235683
36974,0.00153,172.31.36.0-255,66,106299,7,235683
36975,0.00155,74.125.24.0-255,766,107065,7,235683
36976,0.00157,74.125.24.0-255,1484,108549,7,235683
36977,0.001573,172.31.36.0-255,66,108615,7,235683
36978,0.001586,74.125.24.0-255,2902,111517,7,235683
36979,0.001589,172.31.36.0-255,66,111583,7,235683
36980,0.001609,74.125.24.0-255,1484,113067,7,235683
36981,0.001621,172.31.36.0-255,66,113133,7,235683
36982,0.001625,74.125.24.0-255,2902,116035,7,235683
36983,0.001627,172.31.36.0-255,66,116101,7,235683
36984,0.001647,74.125.24.0-255,2902,119003,7,235683
36985,0.001652,172.31.36.0-255,66,119069,7,235683
36986,0.001673,172.31.36.0-255,66,119135,7,235683
36987,0.001676,74.125.24.0-255,766,119901,7,235683
36988,0.001733,74.125.24.0-255,1484,121385,7,235683
36989,0.001736,172.31.36.0-255,66,121451,7,235683
36990,0.001741,74.125.24.0-255,2902,124353,7,235683
36991,0.001743,172.31.36.0-255,66,124419,7,235683
36992,0.001761,74.125.24.0-255,5738,130157,7,235683
36993,0.001765,172.31.36.0-255,66,130223,7,235683
36994,0.00177,74.125.24.0-255,4320,134543,7,235683
36995,0.001773,172.31.36.0-255,66,134609,7,235683
36996,0.001795,74.125.24.0-255,7156,141765,7,235683
36997,0.001799,172.31.36.0-255,66,141831,7,235683
36998,0.001819,74.125.24.0-255,4320,146151,7,235683
36999,0.001821,172.31.36.0-255,66,146217,7,235683
37000,0.001827,74.125.24.0-255,5738,151955,7,235683
37001,0.00183,172.31.36.0-255,66,152021,7,235683
37002,0.001845,74.125.24.0-255,2184,154205,7,235683
37003,0.001848,172.31.36.0-255,66,154271,7,235683
37004,0.001872,74.125.24.0-255,1484,155755,7,235683
37005,0.001886,74.125.24.0-255,2902,158657,7,235683
37006,0.001889,172.31.36.0-255,66,158723,7,235683
37007,0.001893,74.125.24.0-255,1484,160207,7,235683
37008,0.001912,74.125.24.0-255,4320,164527,7,235683
37009,0.001915,172.31.36.0-255,66,164593,7,235683
37010,0.001927,74.125.24.0-255,5738,170331,7,235683
37011,0.001931,172.31.36.0-255,66,170397,7,235683
37012,0.001947,74.125.24.0-255,7156,177553,7,235683
37013,0.001951,172.31.36.0-255,66,177619,7,235683
37014,0.002013,172.31.36.0-255,66,177685,7,235683
37015,0.002025,172.31.36.0-255,66,177751,7,235683
37016,0.002032,74.125.24.0-255,7156,184907,7,235683
37017,0.002035,172.31.36.0-255,66,184973,7,235683
37018,0.002085,74.125.24.0-255,5738,190711,7,235683
37019,0.00209,172.31.36.0-255,66,190777,7,235683
37020,0.002122,172.31.36.0-255,66,190843,7,235683
37021,0.002183,74.125.24.0-255,1484,192327,7,235683
37022,0.002187,74.125.24.0-255,1484,193811,7,235683
37023,0.00219,172.31.36.0-255,66,193877,7,235683
37024,0.002208,74.125.24.0-255,1484,195361,7,235683
37025,0.002214,74.125.24.0-255,5738,201099,7,235683
37026,0.002218,172.31.36.0-255,66,201165,7,235683
37027,0.00225,172.31.36.0-255,66,201231,7,235683
37028,0.002254,74.125.24.0-255,1484,202715,7,235683
37029,0.002296,172.31.36.0-255,66,202781,7,235683
37030,0.002303,74.125.24.0-255,7156,209937,7,235683
37031,0.002306,172.31.36.0-255,66,210003,7,235683
37032,0.002351,74.125.24.0-255,2902,212905,7,235683
37033,0.002356,172.31.36.0-255,66,212971,7,235683
37034,0.002372,74.125.24.0-255,5738,218709,7,235683
37035,0.002376,172.31.36.0-255,66,218775,7,235683
37036,0.002415,172.31.36.0-255,66,218841,7,235683
37037,0.002427,172.31.36.0-255,66,218907,7,235683
37038,0.002462,172.31.36.0-255,66,218973,7,235683
37039,0.002475,172.31.36.0-255,66,219039,7,235683
37040,0.00485,74.125.24.0-255,5738,224777,7,235683
37041,0.004857,172.31.36.0-255,66,224843,7,235683
37042,0.007196,74.125.24.0-255,5738,230581,7,235683
37043,0.007199,172.31.36.0-255,66,230647,7,235683
37044,0.009522,74.125.24.0-255,507,231154,7,235683
37045,0.009912,172.31.36.0-255,66,231220,7,235683
37046,0.009941,172.31.36.0-255,105,231325,7,235683
37047,0.012265,74.125.24.0-255,66,231391,7,235683
37048,0.030785,172.31.36.0-255,172,231563,7,235683
37049,0.030822,172.31.36.0-255,1114,232677,7,235683
37050,0.030901,172.31.36.0-255,1514,234191,7,235683
37051,0.030903,172.31.36.0-255,1294,235485,7,235683
37052,0.032349,104.244.42.0-255,66,235551,7,235683
37053,0.032387,104.244.42.0-255,66,235617,7,235683
37054,0.03244,104.244.42.0-255,66,235683,7,235683
37055,0.0,74.125.130.0-255,153,153,7,309131
37056,1.3e-05,172.31.36.0-255,66,219,7,309131
37057,2e-05,74.125.130.0-255,1484,1703,7,309131
37058,2.4e-05,172.31.36.0-255,66,1769,7,309131
37059,4.4e-05,74.125.130.0-255,2902,4671,7,309131
37060,4.8e-05,172.31.36.0-255,66,4737,7,309131
37061,5.1e-05,74.125.130.0-255,1484,6221,7,309131
37062,5.4e-05,172.31.36.0-255,66,6287,7,309131
37063,7e-05,74.125.130.0-255,1484,7771,7,309131
37064,7.2e-05,172.31.36.0-255,66,7837,7,309131
37065,7.8e-05,74.125.130.0-255,4320,12157,7,309131
37066,8e-05,172.31.36.0-255,66,12223,7,309131
37067,0.000106,74.125.130.0-255,2077,14300,7,309131
37068,0.000109,172.31.36.0-255,66,14366,7,309131
37069,0.000174,74.125.130.0-255,1484,15850,7,309131
37070,0.000177,172.31.36.0-255,66,15916,7,309131
37071,0.00018,74.125.130.0-255,1484,17400,7,309131
37072,0.000182,172.31.36.0-255,66,17466,7,309131
37073,0.0002,74.125.130.0-255,1484,18950,7,309131
37074,0.000202,172.31.36.0-255,66,19016,7,309131
37075,0.000209,74.125.130.0-255,5738,24754,7,309131
37076,0.000212,172.31.36.0-255,66,24820,7,309131
37077,0.000216,74.125.130.0-255,2902,27722,7,309131
37078,0.000218,172.31.36.0-255,66,27788,7,309131
37079,0.000244,74.125.130.0-255,3961,31749,7,309131
37080,0.000247,172.31.36.0-255,66,31815,7,309131
37081,0.001474,74.125.130.0-255,1484,33299,7,309131
37082,0.001482,172.31.36.0-255,66,33365,7,309131
37083,0.00149,74.125.130.0-255,2902,36267,7,309131
37084,0.001493,172.31.36.0-255,66,36333,7,309131
37085,0.001496,74.125.130.0-255,1484,37817,7,309131
37086,0.001498,172.31.36.0-255,66,37883,7,309131
37087,0.001525,74.125.130.0-255,4320,42203,7,309131
37088,0.001528,172.31.36.0-255,66,42269,7,309131
37089,0.001531,74.125.130.0-255,1484,43753,7,309131
37090,0.001535,74.125.130.0-255,2902,46655,7,309131
37091,0.001538,172.31.36.0-255,66,46721,7,309131
37092,0.001571,74.125.130.0-255,2543,49264,7,309131
37093,0.001574,172.31.36.0-255,66,49330,7,309131
37094,0.001746,74.125.130.0-255,1484,50814,7,309131
37095,0.001762,74.125.130.0-255,2902,53716,7,309131
37096,0.001765,172.31.36.0-255,66,53782,7,309131
37097,0.001769,74.125.130.0-255,2902,56684,7,309131
37098,0.001771,172.31.36.0-255,66,56750,7,309131
37099,0.001775,74.125.130.0-255,1484,58234,7,309131
37100,0.001797,74.125.130.0-255,2902,61136,7,309131
37101,0.001799,172.31.36.0-255,66,61202,7,309131
37102,0.001835,172.31.36.0-255,66,61268,7,309131
37103,0.001853,74.125.130.0-255,1125,62393,7,309131
37104,0.001865,172.31.36.0-255,66,62459,7,309131
37105,0.001884,74.125.130.0-255,3122,65581,7,309131
37106,0.001887,172.31.36.0-255,66,65647,7,309131
37107,0.001917,74.125.130.0-255,2902,68549,7,309131
37108,0.001919,172.31.36.0-255,66,68615,7,309131
37109,0.001951,74.125.130.0-255,4320,72935,7,309131
37110,0.001954,172.31.36.0-255,66,73001,7,309131
37111,0.001964,74.125.130.0-255,1484,74485,7,309131
37112,0.001987,74.125.130.0-255,7156,81641,7,309131
37113,0.001989,172.31.36.0-255,66,81707,7,309131
37114,0.001992,74.125.130.0-255,1125,82832,7,309131
37115,0.003981,74.125.130.0-255,4320,87152,7,309131
37116,0.003988,172.31.36.0-255,66,87218,7,309131
37117,0.005982,74.125.130.0-255,5738,92956,7,309131
37118,0.00599,172.31.36.0-255,66,93022,7,309131
37119,0.008041,74.125.130.0-255,5738,98760,7,309131
37120,0.008048,172.31.36.0-255,66,98826,7,309131
37121,0.010046,74.125.130.0-255,5738,104564,7,309131
37122,0.010054,172.31.36.0-255,66,104630,7,309131
37123,0.012069,74.125.130.0-255,5738,110368,7,309131
37124,0.01208,172.31.36.0-255,66,110434,7,309131
37125,0.014099,74.125.130.0-255,5738,116172,7,309131
37126,0.014108,172.31.36.0-255,66,116238,7,309131
37127,0.01611,74.125.130.0-255,5738,121976,7,309131
37128,0.016121,172.31.36.0-255,66,122042,7,309131
37129,0.018148,74.125.130.0-255,5738,127780,7,309131
37130,0.018157,172.31.36.0-255,66,127846,7,309131
37131,0.020167,74.125.130.0-255,5738,133584,7,309131
37132,0.020175,172.31.36.0-255,66,133650,7,309131
37133,0.022181,74.125.130.0-255,5738,139388,7,309131
37134,0.02219,172.31.36.0-255,66,139454,7,309131
37135,0.023735,172.31.36.0-255,172,139626,7,309131
37136,0.023767,172.31.36.0-255,1114,140740,7,309131
37137,0.023833,172.31.36.0-255,1514,142254,7,309131
37138,0.023835,172.31.36.0-255,1514,143768,7,309131
37139,0.023836,172.31.36.0-255,1514,145282,7,309131
37140,0.023837,172.31.36.0-255,1073,146355,7,309131
37141,0.024195,74.125.130.0-255,5738,152093,7,309131
37142,0.024202,172.31.36.0-255,66,152159,7,309131
37143,0.025272,104.244.42.0-255,66,152225,7,309131
37144,0.025319,104.244.42.0-255,66,152291,7,309131
37145,0.025423,104.244.42.0-255,66,152357,7,309131
37146,0.025429,104.244.42.0-255,66,152423,7,309131
37147,0.026195,74.125.130.0-255,5738,158161,7,309131
37148,0.026201,172.31.36.0-255,66,158227,7,309131
37149,0.028203,74.125.130.0-255,5738,163965,7,309131
37150,0.028209,172.31.36.0-255,66,164031,7,309131
37151,0.03022,74.125.130.0-255,5738,169769,7,309131
37152,0.030226,172.31.36.0-255,66,169835,7,309131
37153,0.032241,74.125.130.0-255,5738,175573,7,309131
37154,0.032247,172.31.36.0-255,66,175639,7,309131
37155,0.034277,74.125.130.0-255,5738,181377,7,309131
37156,0.034284,172.31.36.0-255,66,181443,7,309131
37157,0.036292,74.125.130.0-255,5738,187181,7,309131
37158,0.036299,172.31.36.0-255,66,187247,7,309131
37159,0.038315,74.125.130.0-255,5738,192985,7,309131
37160,0.038321,172.31.36.0-255,66,193051,7,309131
37161,0.040331,74.125.130.0-255,5738,198789,7,309131
37162,0.040338,172.31.36.0-255,66,198855,7,309131
37163,0.042347,74.125.130.0-255,5738,204593,7,309131
37164,0.042356,172.31.36.0-255,66,204659,7,309131
37165,0.044356,74.125.130.0-255,5738,210397,7,309131
37166,0.044362,172.31.36.0-255,66,210463,7,309131
37167,0.046394,74.125.130.0-255,5738,216201,7,309131
37168,0.046403,172.31.36.0-255,66,216267,7,309131
37169,0.048404,74.125.130.0-255,5738,222005,7,309131
37170,0.048413,172.31.36.0-255,66,222071,7,309131
37171,0.050438,74.125.130.0-255,5738,227809,7,309131
37172,0.050448,172.31.36.0-255,66,227875,7,309131
37173,0.052467,74.125.130.0-255,5738,233613,7,309131
37174,0.052477,172.31.36.0-255,66,233679,7,309131
37175,0.054512,74.125.130.0-255,5738,239417,7,309131
37176,0.054524,172.31.36.0-255,66,239483,7,309131
37177,0.056536,74.125.130.0-255,5738,245221,7,309131
37178,0.056563,172.31.36.0-255,66,245287,7,309131
37179,0.058574,74.125.130.0-255,5738,251025,7,309131
37180,0.058584,172.31.36.0-255,66,251091,7,309131
37181,0.060585,74.125.130.0-255,5738,256829,7,309131
37182,0.060593,172.31.36.0-255,66,256895,7,309131
37183,0.062595,74.125.130.0-255,5738,262633,7,309131
37184,0.062602,172.31.36.0-255,66,262699,7,309131
37185,0.064613,74.125.130.0-255,5738,268437,7,309131
37186,0.064623,172.31.36.0-255,66,268503,7,309131
37187,0.066618,74.125.130.0-255,5738,274241,7,309131
37188,0.066627,172.31.36.0-255,66,274307,7,309131
37189,0.068632,74.125.130.0-255,5738,280045,7,309131
37190,0.068639,172.31.36.0-255,66,280111,7,309131
37191,0.070653,74.125.130.0-255,5738,285849,7,309131
37192,0.070659,172.31.36.0-255,66,285915,7,309131
37193,0.072662,74.125.130.0-255,5738,291653,7,309131
37194,0.07267,172.31.36.0-255,66,291719,7,309131
37195,0.074685,74.125.130.0-255,5738,297457,7,309131
37196,0.074692,172.31.36.0-255,66,297523,7,309131
37197,0.076704,74.125.130.0-255,5738,303261,7,309131
37198,0.07671,172.31.36.0-255,66,303327,7,309131
37199,0.078732,74.125.130.0-255,5738,309065,7,309131
37200,0.078739,172.31.36.0-255,66,309131,7,309131
37201,0.0,74.125.24.0-255,150,150,7,175140
37202,2.4e-05,172.31.36.0-255,66,216,7,175140
37203,2.9e-05,74.125.24.0-255,1484,1700,7,175140
37204,3.3e-05,172.31.36.0-255,66,1766,7,175140
37205,3.8e-05,74.125.24.0-255,2902,4668,7,175140
37206,4.6e-05,172.31.36.0-255,66,4734,7,175140
37207,7.6e-05,74.125.24.0-255,5738,10472,7,175140
37208,7.8e-05,172.31.36.0-255,66,10538,7,175140
37209,8.3e-05,74.125.24.0-255,3435,13973,7,175140
37210,8.5e-05,172.31.36.0-255,66,14039,7,175140
37211,0.000172,74.125.24.0-255,1484,15523,7,175140
37212,0.000177,172.31.36.0-255,66,15589,7,175140
37213,0.000181,74.125.24.0-255,2902,18491,7,175140
37214,0.000184,172.31.36.0-255,66,18557,7,175140
37215,0.000206,74.125.24.0-255,4320,22877,7,175140
37216,0.000209,172.31.36.0-255,66,22943,7,175140
37217,0.000232,74.125.24.0-255,1484,24427,7,175140
37218,0.000235,172.31.36.0-255,66,24493,7,175140
37219,0.000243,74.125.24.0-255,7156,31649,7,175140
37220,0.000245,172.31.36.0-255,66,31715,7,175140
37221,0.000262,74.125.24.0-255,6797,38512,7,175140
37222,0.000269,172.31.36.0-255,66,38578,7,175140
37223,0.000279,172.31.36.0-255,66,38644,7,175140
37224,0.000313,74.125.24.0-255,5738,44382,7,175140
37225,0.000316,172.31.36.0-255,66,44448,7,175140
37226,0.000332,172.31.36.0-255,66,44514,7,175140
37227,0.000375,74.125.24.0-255,110,44624,7,175140
37228,0.000378,172.31.36.0-255,66,44690,7,175140
37229,0.000551,74.125.24.0-255,1484,46174,7,175140
37230,0.000555,172.31.36.0-255,66,46240,7,175140
37231,0.00056,74.125.24.0-255,2902,49142,7,175140
37232,0.000562,172.31.36.0-255,66,49208,7,175140
37233,0.000565,74.125.24.0-255,1484,50692,7,175140
37234,0.000585,74.125.24.0-255,4320,55012,7,175140
37235,0.000588,172.31.36.0-255,66,55078,7,175140
37236,0.000593,74.125.24.0-255,4320,59398,7,175140
37237,0.000595,172.31.36.0-255,66,59464,7,175140
37238,0.000602,74.125.24.0-255,7156,66620,7,175140
37239,0.000604,172.31.36.0-255,66,66686,7,175140
37240,0.000635,74.125.24.0-255,4320,71006,7,175140
37241,0.000638,172.31.36.0-255,66,71072,7,175140
37242,0.000648,172.31.36.0-255,66,71138,7,175140
37243,0.000678,74.125.24.0-255,2184,73322,7,175140
37244,0.000681,172.31.36.0-255,66,73388,7,175140
37245,0.000693,172.31.36.0-255,66,73454,7,175140
37246,0.000708,172.31.36.0-255,66,73520,7,175140
37247,0.000735,74.125.24.0-255,5738,79258,7,175140
37248,0.000738,172.31.36.0-255,66,79324,7,175140
37249,0.000765,74.125.24.0-255,6438,85762,7,175140
37250,0.000768,172.31.36.0-255,66,85828,7,175140
37251,0.000774,74.125.24.0-255,5738,91566,7,175140
37252,0.000776,172.31.36.0-255,66,91632,7,175140
37253,0.000806,74.125.24.0-255,7156,98788,7,175140
37254,0.000809,172.31.36.0-255,66,98854,7,175140
37255,0.000813,74.125.24.0-255,4320,103174,7,175140
37256,0.000815,172.31.36.0-255,66,103240,7,175140
37257,0.000824,74.125.24.0-255,5738,108978,7,175140
37258,0.000827,172.31.36.0-255,66,109044,7,175140
37259,0.000858,74.125.24.0-255,5020,114064,7,175140
37260,0.000863,172.31.36.0-255,66,114130,7,175140
37261,0.001405,74.125.24.0-255,1484,115614,7,175140
37262,0.001411,74.125.24.0-255,2902,118516,7,175140
37263,0.001415,172.31.36.0-255,66,118582,7,175140
37264,0.00142,74.125.24.0-255,2902,121484,7,175140
37265,0.001423,172.31.36.0-255,66,121550,7,175140
37266,0.001446,74.125.24.0-255,2902,124452,7,175140
37267,0.001449,172.31.36.0-255,66,124518,7,175140
37268,0.001462,74.125.24.0-255,7156,131674,7,175140
37269,0.001465,172.31.36.0-255,66,131740,7,175140
37270,0.001475,172.31.36.0-255,66,131806,7,175140
37271,0.001517,172.31.36.0-255,66,131872,7,175140
37272,0.001612,74.125.24.0-255,1484,133356,7,175140
37273,0.001616,74.125.24.0-255,1484,134840,7,175140
37274,0.001619,172.31.36.0-255,66,134906,7,175140
37275,0.001645,74.125.24.0-255,1484,136390,7,175140
37276,0.001652,74.125.24.0-255,5738,142128,7,175140
37277,0.001655,172.31.36.0-255,66,142194,7,175140
37278,0.001661,74.125.24.0-255,4320,146514,7,175140
37279,0.001663,172.31.36.0-255,66,146580,7,175140
37280,0.001681,172.31.36.0-255,66,146646,7,175140
37281,0.001711,74.125.24.0-255,4320,150966,7,175140
37282,0.001715,172.31.36.0-255,66,151032,7,175140
37283,0.001751,172.31.36.0-255,66,151098,7,175140
37284,0.001755,74.125.24.0-255,1484,152582,7,175140
37285,0.001822,172.31.36.0-255,66,152648,7,175140
37286,0.001865,74.125.24.0-255,7156,159804,7,175140
37287,0.001869,172.31.36.0-255,66,159870,7,175140
37288,0.001881,172.31.36.0-255,66,159936,7,175140
37289,0.001912,172.31.36.0-255,66,160002,7,175140
37290,0.001918,74.125.24.0-255,5020,165022,7,175140
37291,0.001921,172.31.36.0-255,66,165088,7,175140
37292,0.001946,172.31.36.0-255,66,165154,7,175140
37293,0.001984,74.125.24.0-255,5020,170174,7,175140
37294,0.001988,172.31.36.0-255,66,170240,7,175140
37295,0.00202,172.31.36.0-255,66,170306,7,175140
37296,0.002041,172.31.36.0-255,66,170372,7,175140
37297,0.00209,172.31.36.0-255,66,170438,7,175140
37298,0.002109,172.31.36.0-255,66,170504,7,175140
37299,0.002112,74.125.24.0-255,105,170609,7,175140
37300,0.003366,172.31.36.0-255,66,170675,7,175140
37301,0.003389,172.31.36.0-255,105,170780,7,175140
37302,0.005635,74.125.24.0-255,66,170846,7,175140
37303,0.033154,172.31.36.0-255,176,171022,7,175140
37304,0.033185,172.31.36.0-255,1115,172137,7,175140
37305,0.033223,172.31.36.0-255,1514,173651,7,175140
37306,0.033225,172.31.36.0-255,1291,174942,7,175140
37307,0.034712,104.244.42.0-255,66,175008,7,175140
37308,0.034759,104.244.42.0-255,66,175074,7,175140
37309,0.034803,104.244.42.0-255,66,175140,7,175140
37310,0.0,74.125.24.0-255,153,153,7,225750
37311,1.8e-05,172.31.36.0-255,66,219,7,225750
37312,2.5e-05,74.125.24.0-255,1484,1703,7,225750
37313,2.9e-05,172.31.36.0-255,66,1769,7,225750
37314,3.6e-05,74.125.24.0-255,2902,4671,7,225750
37315,4e-05,172.31.36.0-255,66,4737,7,225750
37316,4.7e-05,74.125.24.0-255,7156,11893,7,225750
37317,5.1e-05,172.31.36.0-255,66,11959,7,225750
37318,8.9e-05,74.125.24.0-255,2050,14009,7,225750
37319,9.2e-05,172.31.36.0-255,66,14075,7,225750
37320,0.000141,74.125.24.0-255,2902,16977,7,225750
37321,0.000144,172.31.36.0-255,66,17043,7,225750
37322,0.00015,74.125.24.0-255,4320,21363,7,225750
37323,0.000153,172.31.36.0-255,66,21429,7,225750
37324,0.00019,172.31.36.0-255,66,21495,7,225750
37325,0.000193,74.125.24.0-255,1125,22620,7,225750
37326,0.000195,172.31.36.0-255,66,22686,7,225750
37327,0.000199,74.125.24.0-255,1484,24170,7,225750
37328,0.000201,172.31.36.0-255,66,24236,7,225750
37329,0.000229,74.125.24.0-255,4320,28556,7,225750
37330,0.000232,172.31.36.0-255,66,28622,7,225750
37331,0.000246,172.31.36.0-255,66,28688,7,225750
37332,0.000249,74.125.24.0-255,1125,29813,7,225750
37333,0.000251,172.31.36.0-255,66,29879,7,225750
37334,0.000296,74.125.24.0-255,1484,31363,7,225750
37335,0.000299,172.31.36.0-255,66,31429,7,225750
37336,0.000304,74.125.24.0-255,2902,34331,7,225750
37337,0.000306,172.31.36.0-255,66,34397,7,225750
37338,0.000309,74.125.24.0-255,1484,35881,7,225750
37339,0.000311,172.31.36.0-255,66,35947,7,225750
37340,0.000333,74.125.24.0-255,4320,40267,7,225750
37341,0.000352,74.125.24.0-255,6797,47064,7,225750
37342,0.000376,74.125.24.0-255,679,47743,7,225750
37343,0.000479,172.31.36.0-255,66,47809,7,225750
37344,0.000548,74.125.24.0-255,1484,49293,7,225750
37345,0.000554,74.125.24.0-255,2902,52195,7,225750
37346,0.000557,74.125.24.0-255,1484,53679,7,225750
37347,0.000571,74.125.24.0-255,4320,57999,7,225750
37348,0.000588,172.31.36.0-255,66,58065,7,225750
37349,0.000609,74.125.24.0-255,4320,62385,7,225750
37350,0.000616,172.31.36.0-255,66,62451,7,225750
37351,0.000648,74.125.24.0-255,5738,68189,7,225750
37352,0.000657,172.31.36.0-255,66,68255,7,225750
37353,0.000668,74.125.24.0-255,3961,72216,7,225750
37354,0.000673,172.31.36.0-255,66,72282,7,225750
37355,0.000983,74.125.24.0-255,1484,73766,7,225750
37356,0.000999,74.125.24.0-255,2902,76668,7,225750
37357,0.001003,172.31.36.0-255,66,76734,7,225750
37358,0.001011,74.125.24.0-255,5738,82472,7,225750
37359,0.001038,172.31.36.0-255,66,82538,7,225750
37360,0.001059,74.125.24.0-255,4320,86858,7,225750
37361,0.001091,172.31.36.0-255,66,86924,7,225750
37362,0.001101,74.125.24.0-255,2902,89826,7,225750
37363,0.001118,74.125.24.0-255,3602,93428,7,225750
37364,0.001137,172.31.36.0-255,66,93494,7,225750
37365,0.001592,74.125.24.0-255,1484,94978,7,225750
37366,0.001599,74.125.24.0-255,2902,97880,7,225750
37367,0.001602,172.31.36.0-255,66,97946,7,225750
37368,0.001607,74.125.24.0-255,1484,99430,7,225750
37369,0.001622,74.125.24.0-255,1484,100914,7,225750
37370,0.00163,172.31.36.0-255,66,100980,7,225750
37371,0.001641,74.125.24.0-255,4320,105300,7,225750
37372,0.001645,172.31.36.0-255,66,105366,7,225750
37373,0.001706,74.125.24.0-255,1484,106850,7,225750
37374,0.001713,172.31.36.0-255,66,106916,7,225750
37375,0.001723,74.125.24.0-255,2902,109818,7,225750
37376,0.001726,74.125.24.0-255,2902,112720,7,225750
37377,0.001735,172.31.36.0-255,66,112786,7,225750
37378,0.00174,74.125.24.0-255,2902,115688,7,225750
37379,0.001757,74.125.24.0-255,5738,121426,7,225750
37380,0.001771,172.31.36.0-255,66,121492,7,225750
37381,0.001779,74.125.24.0-255,7156,128648,7,225750
37382,0.001784,172.31.36.0-255,66,128714,7,225750
37383,0.001803,74.125.24.0-255,2902,131616,7,225750
37384,0.001812,172.31.36.0-255,66,131682,7,225750
37385,0.001843,172.31.36.0-255,66,131748,7,225750
37386,0.001875,74.125.24.0-255,1484,133232,7,225750
37387,0.00188,74.125.24.0-255,2902,136134,7,225750
37388,0.001896,74.125.24.0-255,2902,139036,7,225750
37389,0.001902,172.31.36.0-255,66,139102,7,225750
37390,0.001911,74.125.24.0-255,2902,142004,7,225750
37391,0.001913,74.125.24.0-255,1484,143488,7,225750
37392,0.001915,74.125.24.0-255,1484,144972,7,225750
37393,0.001921,172.31.36.0-255,66,145038,7,225750
37394,0.001941,74.125.24.0-255,7156,152194,7,225750
37395,0.001948,172.31.36.0-255,66,152260,7,225750
37396,0.001984,172.31.36.0-255,66,152326,7,225750
37397,0.002093,74.125.24.0-255,1484,153810,7,225750
37398,0.002099,74.125.24.0-255,2902,156712,7,225750
37399,0.002109,172.31.36.0-255,66,156778,7,225750
37400,0.002121,74.125.24.0-255,5738,162516,7,225750
37401,0.002154,74.125.24.0-255,7156,169672,7,225750
37402,0.002171,74.125.24.0-255,5738,175410,7,225750
37403,0.002174,74.125.24.0-255,1484,176894,7,225750
37404,0.002311,74.125.24.0-255,1484,178378,7,225750
37405,0.002317,74.125.24.0-255,2902,181280,7,225750
37406,0.002338,74.125.24.0-255,5738,187018,7,225750
37407,0.002345,74.125.24.0-255,5738,192756,7,225750
37408,0.002367,74.125.24.0-255,7156,199912,7,225750
37409,0.002415,74.125.24.0-255,1484,201396,7,225750
37410,0.002598,74.125.24.0-255,2184,203580,7,225750
37411,0.002643,74.125.24.0-255,2902,206482,7,225750
37412,0.007481,172.31.36.0-255,66,206548,7,225750
37413,0.010019,74.125.24.0-255,5738,212286,7,225750
37414,0.010026,172.31.36.0-255,66,212352,7,225750
37415,0.012597,74.125.24.0-255,5738,218090,7,225750
37416,0.012606,172.31.36.0-255,66,218156,7,225750
37417,0.015161,74.125.24.0-255,3065,221221,7,225750
37418,0.017275,172.31.36.0-255,66,221287,7,225750
37419,0.017497,172.31.36.0-255,105,221392,7,225750
37420,0.020021,74.125.24.0-255,66,221458,7,225750
37421,0.032922,172.31.36.0-255,172,221630,7,225750
37422,0.032956,172.31.36.0-255,1116,222746,7,225750
37423,0.033046,172.31.36.0-255,1514,224260,7,225750
37424,0.033048,172.31.36.0-255,1292,225552,7,225750
37425,0.03443,104.244.42.0-255,66,225618,7,225750
37426,0.034467,104.244.42.0-255,66,225684,7,225750
37427,0.03456,104.244.42.0-255,66,225750,7,225750
37428,0.0,74.125.200.0-255,153,153,7,251808
37429,2.4e-05,172.31.36.0-255,66,219,7,251808
37430,3.1e-05,74.125.200.0-255,1484,1703,7,251808
37431,3.6e-05,172.31.36.0-255,66,1769,7,251808
37432,4.2e-05,74.125.200.0-255,2902,4671,7,251808
37433,4.5e-05,172.31.36.0-255,66,4737,7,251808
37434,4.8e-05,74.125.200.0-255,1484,6221,7,251808
37435,5.1e-05,172.31.36.0-255,66,6287,7,251808
37436,5.6e-05,74.125.200.0-255,2902,9189,7,251808
37437,6e-05,172.31.36.0-255,66,9255,7,251808
37438,9.1e-05,74.125.200.0-255,1484,10739,7,251808
37439,9.4e-05,172.31.36.0-255,66,10805,7,251808
37440,0.000124,74.125.200.0-255,3421,14226,7,251808
37441,0.000127,172.31.36.0-255,66,14292,7,251808
37442,0.000146,74.125.200.0-255,1484,15776,7,251808
37443,0.000148,172.31.36.0-255,66,15842,7,251808
37444,0.000169,74.125.200.0-255,2902,18744,7,251808
37445,0.000171,172.31.36.0-255,66,18810,7,251808
37446,0.000177,74.125.200.0-255,5738,24548,7,251808
37447,0.000179,172.31.36.0-255,66,24614,7,251808
37448,0.000198,74.125.200.0-255,1484,26098,7,251808
37449,0.0002,172.31.36.0-255,66,26164,7,251808
37450,0.000225,74.125.200.0-255,5379,31543,7,251808
37451,0.000228,172.31.36.0-255,66,31609,7,251808
37452,0.001168,74.125.200.0-255,1484,33093,7,251808
37453,0.001175,172.31.36.0-255,66,33159,7,251808
37454,0.001183,74.125.200.0-255,2902,36061,7,251808
37455,0.001186,172.31.36.0-255,66,36127,7,251808
37456,0.001193,74.125.200.0-255,4320,40447,7,251808
37457,0.001194,172.31.36.0-255,66,40513,7,251808
37458,0.00122,74.125.200.0-255,1484,41997,7,251808
37459,0.001224,172.31.36.0-255,66,42063,7,251808
37460,0.001228,74.125.200.0-255,1484,43547,7,251808
37461,0.001234,74.125.200.0-255,2902,46449,7,251808
37462,0.001236,172.31.36.0-255,66,46515,7,251808
37463,0.001239,74.125.200.0-255,1484,47999,7,251808
37464,0.001269,74.125.200.0-255,5379,53378,7,251808
37465,0.001272,172.31.36.0-255,66,53444,7,251808
37466,0.001277,74.125.200.0-255,2902,56346,7,251808
37467,0.001278,172.31.36.0-255,66,56412,7,251808
37468,0.001311,74.125.200.0-255,1484,57896,7,251808
37469,0.001335,172.31.36.0-255,66,57962,7,251808
37470,0.002279,74.125.200.0-255,108,58070,7,251808
37471,0.00231,172.31.36.0-255,66,58136,7,251808
37472,0.003703,74.125.200.0-255,4320,62456,7,251808
37473,0.003708,172.31.36.0-255,66,62522,7,251808
37474,0.004657,74.125.200.0-255,1484,64006,7,251808
37475,0.006065,74.125.200.0-255,4320,68326,7,251808
37476,0.006073,172.31.36.0-255,66,68392,7,251808
37477,0.008434,74.125.200.0-255,5738,74130,7,251808
37478,0.008442,172.31.36.0-255,66,74196,7,251808
37479,0.010803,74.125.200.0-255,5738,79934,7,251808
37480,0.010812,172.31.36.0-255,66,80000,7,251808
37481,0.013189,74.125.200.0-255,5738,85738,7,251808
37482,0.013201,172.31.36.0-255,66,85804,7,251808
37483,0.015565,74.125.200.0-255,5738,91542,7,251808
37484,0.015573,172.31.36.0-255,66,91608,7,251808
37485,0.017951,74.125.200.0-255,5738,97346,7,251808
37486,0.017964,172.31.36.0-255,66,97412,7,251808
37487,0.020338,74.125.200.0-255,5738,103150,7,251808
37488,0.020349,172.31.36.0-255,66,103216,7,251808
37489,0.022716,74.125.200.0-255,5738,108954,7,251808
37490,0.022721,172.31.36.0-255,66,109020,7,251808
37491,0.02497,172.31.36.0-255,187,109207,7,251808
37492,0.025006,172.31.36.0-255,982,110189,7,251808
37493,0.025069,172.31.36.0-255,1514,111703,7,251808
37494,0.025071,172.31.36.0-255,1424,113127,7,251808
37495,0.02508,74.125.200.0-255,5738,118865,7,251808
37496,0.025089,172.31.36.0-255,66,118931,7,251808
37497,0.026541,104.244.42.0-255,66,118997,7,251808
37498,0.026581,104.244.42.0-255,66,119063,7,251808
37499,0.026632,104.244.42.0-255,66,119129,7,251808
37500,0.02733,104.244.42.0-255,108,119237,7,251808
37501,0.027337,172.31.36.0-255,66,119303,7,251808
37502,0.027451,74.125.200.0-255,2902,122205,7,251808
37503,0.027456,172.31.36.0-255,66,122271,7,251808
37504,0.027478,74.125.200.0-255,2902,125173,7,251808
37505,0.027481,172.31.36.0-255,66,125239,7,251808
37506,0.029809,74.125.200.0-255,1484,126723,7,251808
37507,0.029842,74.125.200.0-255,4320,131043,7,251808
37508,0.029848,172.31.36.0-255,66,131109,7,251808
37509,0.032211,74.125.200.0-255,5738,136847,7,251808
37510,0.032217,172.31.36.0-255,66,136913,7,251808
37511,0.034582,74.125.200.0-255,5738,142651,7,251808
37512,0.03459,172.31.36.0-255,66,142717,7,251808
37513,0.036964,74.125.200.0-255,5738,148455,7,251808
37514,0.036971,172.31.36.0-255,66,148521,7,251808
37515,0.037087,172.31.36.0-255,101,148622,7,251808
37516,0.039341,74.125.200.0-255,5738,154360,7,251808
37517,0.039348,172.31.36.0-255,66,154426,7,251808
37518,0.039412,74.125.200.0-255,66,154492,7,251808
37519,0.041716,74.125.200.0-255,4320,158812,7,251808
37520,0.041723,172.31.36.0-255,66,158878,7,251808
37521,0.041743,74.125.200.0-255,1484,160362,7,251808
37522,0.044083,74.125.200.0-255,4320,164682,7,251808
37523,0.044092,172.31.36.0-255,66,164748,7,251808
37524,0.046477,74.125.200.0-255,5738,170486,7,251808
37525,0.046483,172.31.36.0-255,66,170552,7,251808
37526,0.048837,74.125.200.0-255,5738,176290,7,251808
37527,0.048844,172.31.36.0-255,66,176356,7,251808
37528,0.051233,74.125.200.0-255,5738,182094,7,251808
37529,0.051239,172.31.36.0-255,66,182160,7,251808
37530,0.053604,74.125.200.0-255,5738,187898,7,251808
37531,0.05361,172.31.36.0-255,66,187964,7,251808
37532,0.055969,74.125.200.0-255,5738,193702,7,251808
37533,0.055976,172.31.36.0-255,66,193768,7,251808
37534,0.058337,74.125.200.0-255,5738,199506,7,251808
37535,0.058344,172.31.36.0-255,66,199572,7,251808
37536,0.060712,74.125.200.0-255,5738,205310,7,251808
37537,0.060717,172.31.36.0-255,66,205376,7,251808
37538,0.063106,74.125.200.0-255,5738,211114,7,251808
37539,0.063113,172.31.36.0-255,66,211180,7,251808
37540,0.065474,74.125.200.0-255,5738,216918,7,251808
37541,0.06548,172.31.36.0-255,66,216984,7,251808
37542,0.067833,74.125.200.0-255,5738,222722,7,251808
37543,0.067841,172.31.36.0-255,66,222788,7,251808
37544,0.070214,74.125.200.0-255,5738,228526,7,251808
37545,0.070221,172.31.36.0-255,66,228592,7,251808
37546,0.07258,74.125.200.0-255,5738,234330,7,251808
37547,0.072587,172.31.36.0-255,66,234396,7,251808
37548,0.074947,74.125.200.0-255,5738,240134,7,251808
37549,0.074953,172.31.36.0-255,66,240200,7,251808
37550,0.077323,74.125.200.0-255,5738,245938,7,251808
37551,0.077329,172.31.36.0-255,66,246004,7,251808
37552,0.079694,74.125.200.0-255,5738,251742,7,251808
37553,0.079701,172.31.36.0-255,66,251808,7,251808
37554,0.0,172.31.36.0-255,105,105,7,105
37555,0.0,172.31.36.0-255,105,105,7,276
37556,0.074946,31.13.82.0-255,105,210,7,276
37557,0.074958,172.31.36.0-255,66,276,7,276
37558,0.0,172.217.24.0-255,146,146,7,359007
37559,1.8e-05,172.31.36.0-255,66,212,7,359007
37560,2.5e-05,172.217.24.0-255,1484,1696,7,359007
37561,3e-05,172.31.36.0-255,66,1762,7,359007
37562,3.5e-05,172.217.24.0-255,2902,4664,7,359007
37563,4e-05,172.31.36.0-255,66,4730,7,359007
37564,4.8e-05,172.217.24.0-255,7156,11886,7,359007
37565,5.1e-05,172.31.36.0-255,66,11952,7,359007
37566,5.5e-05,172.217.24.0-255,1996,13948,7,359007
37567,5.8e-05,172.31.36.0-255,66,14014,7,359007
37568,6.3e-05,172.217.24.0-255,2902,16916,7,359007
37569,6.6e-05,172.31.36.0-255,66,16982,7,359007
37570,7.4e-05,172.217.24.0-255,7156,24138,7,359007
37571,7.7e-05,172.31.36.0-255,66,24204,7,359007
37572,0.000108,172.217.24.0-255,6797,31001,7,359007
37573,0.00011,172.31.36.0-255,66,31067,7,359007
37574,0.000128,172.217.24.0-255,1484,32551,7,359007
37575,0.000131,172.31.36.0-255,66,32617,7,359007
37576,0.00015,172.217.24.0-255,2902,35519,7,359007
37577,0.000152,172.31.36.0-255,66,35585,7,359007
37578,0.000159,172.217.24.0-255,5738,41323,7,359007
37579,0.000161,172.31.36.0-255,66,41389,7,359007
37580,0.000196,172.217.24.0-255,6797,48186,7,359007
37581,0.000199,172.31.36.0-255,66,48252,7,359007
37582,0.000297,172.217.24.0-255,1484,49736,7,359007
37583,0.000301,172.31.36.0-255,66,49802,7,359007
37584,0.000307,172.217.24.0-255,2902,52704,7,359007
37585,0.000309,172.31.36.0-255,66,52770,7,359007
37586,0.000313,172.217.24.0-255,2902,55672,7,359007
37587,0.000316,172.31.36.0-255,66,55738,7,359007
37588,0.000339,172.217.24.0-255,2902,58640,7,359007
37589,0.000342,172.31.36.0-255,66,58706,7,359007
37590,0.000349,172.217.24.0-255,6797,65503,7,359007
37591,0.000351,172.31.36.0-255,66,65569,7,359007
37592,0.000372,172.217.24.0-255,356,65925,7,359007
37593,0.000375,172.31.36.0-255,66,65991,7,359007
37594,0.000819,172.217.24.0-255,137,66128,7,359007
37595,0.000824,172.31.36.0-255,66,66194,7,359007
37596,0.001033,172.217.24.0-255,1484,67678,7,359007
37597,0.001038,172.31.36.0-255,66,67744,7,359007
37598,0.001042,172.217.24.0-255,1484,69228,7,359007
37599,0.001058,172.31.36.0-255,66,69294,7,359007
37600,0.001064,172.217.24.0-255,2902,72196,7,359007
37601,0.001066,172.31.36.0-255,66,72262,7,359007
37602,0.001073,172.217.24.0-255,5738,78000,7,359007
37603,0.001075,172.31.36.0-255,66,78066,7,359007
37604,0.001134,172.31.36.0-255,66,78132,7,359007
37605,0.001151,172.217.24.0-255,1125,79257,7,359007
37606,0.001154,172.31.36.0-255,66,79323,7,359007
37607,0.001161,172.217.24.0-255,7156,86479,7,359007
37608,0.001163,172.31.36.0-255,66,86545,7,359007
37609,0.001166,172.217.24.0-255,826,87371,7,359007
37610,0.001168,172.31.36.0-255,66,87437,7,359007
37611,0.001281,172.217.24.0-255,1484,88921,7,359007
37612,0.001285,172.31.36.0-255,66,88987,7,359007
37613,0.001291,172.217.24.0-255,2902,91889,7,359007
37614,0.001293,172.31.36.0-255,66,91955,7,359007
37615,0.001299,172.217.24.0-255,5738,97693,7,359007
37616,0.001302,172.31.36.0-255,66,97759,7,359007
37617,0.001321,172.217.24.0-255,4320,102079,7,359007
37618,0.001324,172.31.36.0-255,66,102145,7,359007
37619,0.00133,172.217.24.0-255,5738,107883,7,359007
37620,0.001333,172.31.36.0-255,66,107949,7,359007
37621,0.001364,172.31.36.0-255,66,108015,7,359007
37622,0.001368,172.217.24.0-255,2184,110199,7,359007
37623,0.001371,172.31.36.0-255,66,110265,7,359007
37624,0.001919,172.217.24.0-255,1484,111749,7,359007
37625,0.001926,172.31.36.0-255,66,111815,7,359007
37626,0.001934,172.217.24.0-255,2902,114717,7,359007
37627,0.001937,172.31.36.0-255,66,114783,7,359007
37628,0.001944,172.217.24.0-255,5738,120521,7,359007
37629,0.001946,172.31.36.0-255,66,120587,7,359007
37630,0.001976,172.31.36.0-255,66,120653,7,359007
37631,0.001995,172.217.24.0-255,2902,123555,7,359007
37632,0.001997,172.31.36.0-255,66,123621,7,359007
37633,0.002004,172.217.24.0-255,7156,130777,7,359007
37634,0.002006,172.31.36.0-255,66,130843,7,359007
37635,0.003962,172.217.24.0-255,5738,136581,7,359007
37636,0.00397,172.31.36.0-255,66,136647,7,359007
37637,0.005936,172.217.24.0-255,5738,142385,7,359007
37638,0.005943,172.31.36.0-255,66,142451,7,359007
37639,0.007903,172.217.24.0-255,4320,146771,7,359007
37640,0.007907,172.31.36.0-255,66,146837,7,359007
37641,0.007919,172.217.24.0-255,1484,148321,7,359007
37642,0.009869,172.217.24.0-255,4320,152641,7,359007
37643,0.009876,172.31.36.0-255,66,152707,7,359007
37644,0.011838,172.217.24.0-255,5738,158445,7,359007
37645,0.011846,172.31.36.0-255,66,158511,7,359007
37646,0.013802,172.217.24.0-255,5738,164249,7,359007
37647,0.01381,172.31.36.0-255,66,164315,7,359007
37648,0.015775,172.217.24.0-255,5738,170053,7,359007
37649,0.015784,172.31.36.0-255,66,170119,7,359007
37650,0.017746,172.217.24.0-255,5738,175857,7,359007
37651,0.017754,172.31.36.0-255,66,175923,7,359007
37652,0.019721,172.217.24.0-255,5738,181661,7,359007
37653,0.019729,172.31.36.0-255,66,181727,7,359007
37654,0.021695,172.217.24.0-255,5738,187465,7,359007
37655,0.021704,172.31.36.0-255,66,187531,7,359007
37656,0.023667,172.217.24.0-255,5738,193269,7,359007
37657,0.023675,172.31.36.0-255,66,193335,7,359007
37658,0.025644,172.217.24.0-255,5738,199073,7,359007
37659,0.025652,172.31.36.0-255,66,199139,7,359007
37660,0.027606,172.217.24.0-255,5738,204877,7,359007
37661,0.027614,172.31.36.0-255,66,204943,7,359007
37662,0.027689,172.31.36.0-255,220,205163,7,359007
37663,0.027715,172.31.36.0-255,982,206145,7,359007
37664,0.027834,172.31.36.0-255,1514,207659,7,359007
37665,0.027836,172.31.36.0-255,1424,209083,7,359007
37666,0.029249,104.244.42.0-255,66,209149,7,359007
37667,0.029276,104.244.42.0-255,66,209215,7,359007
37668,0.029412,104.244.42.0-255,66,209281,7,359007
37669,0.02958,172.217.24.0-255,5738,215019,7,359007
37670,0.029586,172.31.36.0-255,66,215085,7,359007
37671,0.03144,104.244.42.0-255,108,215193,7,359007
37672,0.031449,172.31.36.0-255,66,215259,7,359007
37673,0.031561,172.217.24.0-255,5738,220997,7,359007
37674,0.031566,172.31.36.0-255,66,221063,7,359007
37675,0.03354,172.217.24.0-255,5738,226801,7,359007
37676,0.033547,172.31.36.0-255,66,226867,7,359007
37677,0.035533,172.217.24.0-255,5738,232605,7,359007
37678,0.03554,172.31.36.0-255,66,232671,7,359007
37679,0.037578,172.217.24.0-255,5738,238409,7,359007
37680,0.037585,172.31.36.0-255,66,238475,7,359007
37681,0.039551,172.217.24.0-255,5738,244213,7,359007
37682,0.039557,172.31.36.0-255,66,244279,7,359007
37683,0.041532,172.217.24.0-255,5738,250017,7,359007
37684,0.041539,172.31.36.0-255,66,250083,7,359007
37685,0.043507,172.217.24.0-255,5738,255821,7,359007
37686,0.043514,172.31.36.0-255,66,255887,7,359007
37687,0.045492,172.217.24.0-255,5738,261625,7,359007
37688,0.045499,172.31.36.0-255,66,261691,7,359007
37689,0.047467,172.217.24.0-255,5738,267429,7,359007
37690,0.047476,172.31.36.0-255,66,267495,7,359007
37691,0.049443,172.217.24.0-255,5738,273233,7,359007
37692,0.04945,172.31.36.0-255,66,273299,7,359007
37693,0.051407,172.217.24.0-255,4320,277619,7,359007
37694,0.051414,172.31.36.0-255,66,277685,7,359007
37695,0.051435,172.217.24.0-255,1484,279169,7,359007
37696,0.053383,172.217.24.0-255,4320,283489,7,359007
37697,0.05339,172.31.36.0-255,66,283555,7,359007
37698,0.055363,172.217.24.0-255,5738,289293,7,359007
37699,0.055371,172.31.36.0-255,66,289359,7,359007
37700,0.057342,172.217.24.0-255,5738,295097,7,359007
37701,0.057348,172.31.36.0-255,66,295163,7,359007
37702,0.059323,172.217.24.0-255,5738,300901,7,359007
37703,0.059329,172.31.36.0-255,66,300967,7,359007
37704,0.061298,172.217.24.0-255,5738,306705,7,359007
37705,0.061304,172.31.36.0-255,66,306771,7,359007
37706,0.063279,172.217.24.0-255,5738,312509,7,359007
37707,0.063286,172.31.36.0-255,66,312575,7,359007
37708,0.065258,172.217.24.0-255,5738,318313,7,359007
37709,0.065264,172.31.36.0-255,66,318379,7,359007
37710,0.067243,172.217.24.0-255,5738,324117,7,359007
37711,0.067249,172.31.36.0-255,66,324183,7,359007
37712,0.069217,172.217.24.0-255,5738,329921,7,359007
37713,0.069224,172.31.36.0-255,66,329987,7,359007
37714,0.071194,172.217.24.0-255,5738,335725,7,359007
37715,0.071201,172.31.36.0-255,66,335791,7,359007
37716,0.073177,172.217.24.0-255,5738,341529,7,359007
37717,0.073184,172.31.36.0-255,66,341595,7,359007
37718,0.075156,172.217.24.0-255,5738,347333,7,359007
37719,0.075163,172.31.36.0-255,66,347399,7,359007
37720,0.077134,172.217.24.0-255,5738,353137,7,359007
37721,0.07714,172.31.36.0-255,66,353203,7,359007
37722,0.079119,172.217.24.0-255,5738,358941,7,359007
37723,0.079126,172.31.36.0-255,66,359007,7,359007
37724,0.0,74.125.24.0-255,153,153,7,154913
37725,1.4e-05,172.31.36.0-255,66,219,7,154913
37726,2.1e-05,74.125.24.0-255,1484,1703,7,154913
37727,2.5e-05,172.31.36.0-255,66,1769,7,154913
37728,3e-05,74.125.24.0-255,2902,4671,7,154913
37729,3.3e-05,172.31.36.0-255,66,4737,7,154913
37730,4.1e-05,74.125.24.0-255,7156,11893,7,154913
37731,4.4e-05,172.31.36.0-255,66,11959,7,154913
37732,6.1e-05,74.125.24.0-255,2902,14861,7,154913
37733,6.3e-05,172.31.36.0-255,66,14927,7,154913
37734,8e-05,74.125.24.0-255,4902,19829,7,154913
37735,8.2e-05,172.31.36.0-255,66,19895,7,154913
37736,9.4e-05,172.31.36.0-255,66,19961,7,154913
37737,0.000113,74.125.24.0-255,1484,21445,7,154913
37738,0.000116,172.31.36.0-255,66,21511,7,154913
37739,0.000149,172.31.36.0-255,66,21577,7,154913
37740,0.000152,74.125.24.0-255,766,22343,7,154913
37741,0.000154,172.31.36.0-255,66,22409,7,154913
37742,0.000383,74.125.24.0-255,1484,23893,7,154913
37743,0.000388,172.31.36.0-255,66,23959,7,154913
37744,0.000394,74.125.24.0-255,2902,26861,7,154913
37745,0.000396,172.31.36.0-255,66,26927,7,154913
37746,0.000422,74.125.24.0-255,5738,32665,7,154913
37747,0.000424,172.31.36.0-255,66,32731,7,154913
37748,0.000427,74.125.24.0-255,1484,34215,7,154913
37749,0.000429,172.31.36.0-255,66,34281,7,154913
37750,0.000456,74.125.24.0-255,1484,35765,7,154913
37751,0.000458,172.31.36.0-255,66,35831,7,154913
37752,0.00048,74.125.24.0-255,4316,40147,7,154913
37753,0.000483,172.31.36.0-255,66,40213,7,154913
37754,0.000562,74.125.24.0-255,1484,41697,7,154913
37755,0.000569,74.125.24.0-255,2902,44599,7,154913
37756,0.000573,172.31.36.0-255,66,44665,7,154913
37757,0.000596,74.125.24.0-255,5738,50403,7,154913
37758,0.000598,172.31.36.0-255,66,50469,7,154913
37759,0.000622,172.31.36.0-255,66,50535,7,154913
37760,0.000642,74.125.24.0-255,1484,52019,7,154913
37761,0.00065,74.125.24.0-255,7156,59175,7,154913
37762,0.000653,172.31.36.0-255,66,59241,7,154913
37763,0.000682,74.125.24.0-255,3602,62843,7,154913
37764,0.000685,172.31.36.0-255,66,62909,7,154913
37765,0.000799,74.125.24.0-255,1484,64393,7,154913
37766,0.000817,74.125.24.0-255,2902,67295,7,154913
37767,0.00082,172.31.36.0-255,66,67361,7,154913
37768,0.000826,74.125.24.0-255,2902,70263,7,154913
37769,0.000828,172.31.36.0-255,66,70329,7,154913
37770,0.000841,74.125.24.0-255,2902,73231,7,154913
37771,0.000844,172.31.36.0-255,66,73297,7,154913
37772,0.000882,172.31.36.0-255,66,73363,7,154913
37773,0.000889,74.125.24.0-255,7156,80519,7,154913
37774,0.000891,172.31.36.0-255,66,80585,7,154913
37775,0.00093,74.125.24.0-255,1484,82069,7,154913
37776,0.000961,172.31.36.0-255,66,82135,7,154913
37777,0.000976,74.125.24.0-255,7156,89291,7,154913
37778,0.000979,172.31.36.0-255,66,89357,7,154913
37779,0.000997,74.125.24.0-255,2184,91541,7,154913
37780,0.000999,172.31.36.0-255,66,91607,7,154913
37781,0.001013,172.31.36.0-255,66,91673,7,154913
37782,0.001018,74.125.24.0-255,2184,93857,7,154913
37783,0.001019,172.31.36.0-255,66,93923,7,154913
37784,0.001116,74.125.24.0-255,1484,95407,7,154913
37785,0.001122,74.125.24.0-255,2902,98309,7,154913
37786,0.001125,172.31.36.0-255,66,98375,7,154913
37787,0.001128,74.125.24.0-255,1484,99859,7,154913
37788,0.00115,74.125.24.0-255,4320,104179,7,154913
37789,0.001153,172.31.36.0-255,66,104245,7,154913
37790,0.00116,74.125.24.0-255,5738,109983,7,154913
37791,0.001162,172.31.36.0-255,66,110049,7,154913
37792,0.001219,172.31.36.0-255,66,110115,7,154913
37793,0.00123,74.125.24.0-255,5020,115135,7,154913
37794,0.001233,172.31.36.0-255,66,115201,7,154913
37795,0.00137,74.125.24.0-255,1484,116685,7,154913
37796,0.001378,74.125.24.0-255,2902,119587,7,154913
37797,0.001381,172.31.36.0-255,66,119653,7,154913
37798,0.001386,74.125.24.0-255,2902,122555,7,154913
37799,0.001389,172.31.36.0-255,66,122621,7,154913
37800,0.001405,74.125.24.0-255,2902,125523,7,154913
37801,0.001408,172.31.36.0-255,66,125589,7,154913
37802,0.001414,74.125.24.0-255,5738,131327,7,154913
37803,0.001416,172.31.36.0-255,66,131393,7,154913
37804,0.001422,74.125.24.0-255,4320,135713,7,154913
37805,0.001424,172.31.36.0-255,66,135779,7,154913
37806,0.001453,172.31.36.0-255,66,135845,7,154913
37807,0.001499,74.125.24.0-255,4320,140165,7,154913
37808,0.001501,172.31.36.0-255,66,140231,7,154913
37809,0.001521,172.31.36.0-255,66,140297,7,154913
37810,0.00154,172.31.36.0-255,66,140363,7,154913
37811,0.001552,172.31.36.0-255,66,140429,7,154913
37812,0.001584,172.31.36.0-255,66,140495,7,154913
37813,0.001614,172.31.36.0-255,66,140561,7,154913
37814,0.001628,172.31.36.0-255,66,140627,7,154913
37815,0.001667,172.31.36.0-255,66,140693,7,154913
37816,0.001699,172.31.36.0-255,66,140759,7,154913
37817,0.001735,172.31.36.0-255,66,140825,7,154913
37818,0.001754,172.31.36.0-255,66,140891,7,154913
37819,0.001794,172.31.36.0-255,66,140957,7,154913
37820,0.001805,172.31.36.0-255,66,141023,7,154913
37821,0.001814,74.125.24.0-255,7156,148179,7,154913
37822,0.001816,172.31.36.0-255,66,148245,7,154913
37823,0.001873,172.31.36.0-255,66,148311,7,154913
37824,0.001888,172.31.36.0-255,66,148377,7,154913
37825,0.001941,74.125.24.0-255,1838,150215,7,154913
37826,0.001944,172.31.36.0-255,66,150281,7,154913
37827,0.001948,74.125.24.0-255,105,150386,7,154913
37828,0.00744,172.31.36.0-255,66,150452,7,154913
37829,0.00748,172.31.36.0-255,105,150557,7,154913
37830,0.009512,74.125.24.0-255,66,150623,7,154913
37831,0.033951,172.31.36.0-255,172,150795,7,154913
37832,0.033985,172.31.36.0-255,1114,151909,7,154913
37833,0.034049,172.31.36.0-255,1514,153423,7,154913
37834,0.03405,172.31.36.0-255,1292,154715,7,154913
37835,0.035518,104.244.42.0-255,66,154781,7,154913
37836,0.035571,104.244.42.0-255,66,154847,7,154913
37837,0.035611,104.244.42.0-255,66,154913,7,154913
37838,0.0,172.217.194.0-255,153,153,7,321892
37839,2e-05,172.31.36.0-255,66,219,7,321892
37840,2.7e-05,172.217.194.0-255,1484,1703,7,321892
37841,3.1e-05,172.31.36.0-255,66,1769,7,321892
37842,3.7e-05,172.217.194.0-255,2902,4671,7,321892
37843,4.1e-05,172.31.36.0-255,66,4737,7,321892
37844,4.6e-05,172.217.194.0-255,4320,9057,7,321892
37845,4.9e-05,172.31.36.0-255,66,9123,7,321892
37846,8.9e-05,172.217.194.0-255,4901,14024,7,321892
37847,9.2e-05,172.31.36.0-255,66,14090,7,321892
37848,0.000117,172.217.194.0-255,5738,19828,7,321892
37849,0.00012,172.31.36.0-255,66,19894,7,321892
37850,0.000146,172.31.36.0-255,66,19960,7,321892
37851,0.000164,172.217.194.0-255,2543,22503,7,321892
37852,0.000167,172.31.36.0-255,66,22569,7,321892
37853,0.000185,172.217.194.0-255,2902,25471,7,321892
37854,0.000187,172.31.36.0-255,66,25537,7,321892
37855,0.00022,172.31.36.0-255,66,25603,7,321892
37856,0.000241,172.217.194.0-255,4320,29923,7,321892
37857,0.000243,172.31.36.0-255,66,29989,7,321892
37858,0.000267,172.31.36.0-255,66,30055,7,321892
37859,0.000289,172.217.194.0-255,2543,32598,7,321892
37860,0.000291,172.31.36.0-255,66,32664,7,321892
37861,0.000295,172.217.194.0-255,342,33006,7,321892
37862,0.000297,172.31.36.0-255,66,33072,7,321892
37863,0.0003,172.217.194.0-255,118,33190,7,321892
37864,0.000303,172.31.36.0-255,66,33256,7,321892
37865,0.000461,172.217.194.0-255,381,33637,7,321892
37866,0.000466,172.31.36.0-255,66,33703,7,321892
37867,0.00072,172.217.194.0-255,1484,35187,7,321892
37868,0.000725,172.217.194.0-255,1484,36671,7,321892
37869,0.000729,172.31.36.0-255,66,36737,7,321892
37870,0.000744,172.217.194.0-255,1484,38221,7,321892
37871,0.00075,172.217.194.0-255,4320,42541,7,321892
37872,0.000753,172.31.36.0-255,66,42607,7,321892
37873,0.00078,172.217.194.0-255,1484,44091,7,321892
37874,0.000788,172.217.194.0-255,7156,51247,7,321892
37875,0.00079,172.31.36.0-255,66,51313,7,321892
37876,0.000799,172.217.194.0-255,7156,58469,7,321892
37877,0.000801,172.31.36.0-255,66,58535,7,321892
37878,0.000826,172.217.194.0-255,7156,65691,7,321892
37879,0.000829,172.31.36.0-255,66,65757,7,321892
37880,0.000848,172.217.194.0-255,2184,67941,7,321892
37881,0.000851,172.31.36.0-255,66,68007,7,321892
37882,0.001051,172.217.194.0-255,1484,69491,7,321892
37883,0.001056,172.217.194.0-255,1484,70975,7,321892
37884,0.001078,172.31.36.0-255,66,71041,7,321892
37885,0.0011,172.217.194.0-255,1484,72525,7,321892
37886,0.001108,172.217.194.0-255,5738,78263,7,321892
37887,0.00111,172.31.36.0-255,66,78329,7,321892
37888,0.001121,172.31.36.0-255,66,78395,7,321892
37889,0.001166,172.31.36.0-255,66,78461,7,321892
37890,0.001295,172.217.194.0-255,1484,79945,7,321892
37891,0.001301,172.217.194.0-255,2902,82847,7,321892
37892,0.001305,172.31.36.0-255,66,82913,7,321892
37893,0.001312,172.217.194.0-255,5738,88651,7,321892
37894,0.001314,172.31.36.0-255,66,88717,7,321892
37895,0.001317,172.217.194.0-255,1484,90201,7,321892
37896,0.001351,172.31.36.0-255,66,90267,7,321892
37897,0.001355,172.217.194.0-255,1484,91751,7,321892
37898,0.001378,172.217.194.0-255,7156,98907,7,321892
37899,0.001381,172.31.36.0-255,66,98973,7,321892
37900,0.001398,172.217.194.0-255,2184,101157,7,321892
37901,0.0014,172.31.36.0-255,66,101223,7,321892
37902,0.001531,172.217.194.0-255,1484,102707,7,321892
37903,0.001538,172.217.194.0-255,2902,105609,7,321892
37904,0.001541,172.31.36.0-255,66,105675,7,321892
37905,0.001548,172.217.194.0-255,5738,111413,7,321892
37906,0.00155,172.31.36.0-255,66,111479,7,321892
37907,0.00159,172.31.36.0-255,66,111545,7,321892
37908,0.001601,172.31.36.0-255,66,111611,7,321892
37909,0.001619,172.217.194.0-255,2184,113795,7,321892
37910,0.001621,172.31.36.0-255,66,113861,7,321892
37911,0.002036,172.217.194.0-255,1484,115345,7,321892
37912,0.00204,172.217.194.0-255,1484,116829,7,321892
37913,0.002044,172.31.36.0-255,66,116895,7,321892
37914,0.002068,172.217.194.0-255,1484,118379,7,321892
37915,0.002074,172.217.194.0-255,5738,124117,7,321892
37916,0.002077,172.31.36.0-255,66,124183,7,321892
37917,0.002084,172.217.194.0-255,7156,131339,7,321892
37918,0.002087,172.31.36.0-255,66,131405,7,321892
37919,0.002104,172.217.194.0-255,5738,137143,7,321892
37920,0.002107,172.31.36.0-255,66,137209,7,321892
37921,0.002117,172.31.36.0-255,66,137275,7,321892
37922,0.002138,172.217.194.0-255,2184,139459,7,321892
37923,0.00214,172.31.36.0-255,66,139525,7,321892
37924,0.002261,172.217.194.0-255,1484,141009,7,321892
37925,0.002274,172.217.194.0-255,2902,143911,7,321892
37926,0.002277,172.31.36.0-255,66,143977,7,321892
37927,0.002281,172.217.194.0-255,1484,145461,7,321892
37928,0.0023,172.217.194.0-255,4320,149781,7,321892
37929,0.002303,172.31.36.0-255,66,149847,7,321892
37930,0.002315,172.217.194.0-255,7156,157003,7,321892
37931,0.002318,172.31.36.0-255,66,157069,7,321892
37932,0.002322,172.217.194.0-255,2902,159971,7,321892
37933,0.002324,172.31.36.0-255,66,160037,7,321892
37934,0.002357,172.31.36.0-255,66,160103,7,321892
37935,0.002361,172.217.194.0-255,2184,162287,7,321892
37936,0.002363,172.31.36.0-255,66,162353,7,321892
37937,0.002398,172.217.194.0-255,2902,165255,7,321892
37938,0.002401,172.31.36.0-255,66,165321,7,321892
37939,0.002406,172.217.194.0-255,2902,168223,7,321892
37940,0.002408,172.31.36.0-255,66,168289,7,321892
37941,0.004784,172.217.194.0-255,5738,174027,7,321892
37942,0.004792,172.31.36.0-255,66,174093,7,321892
37943,0.00717,172.217.194.0-255,4320,178413,7,321892
37944,0.007173,172.31.36.0-255,66,178479,7,321892
37945,0.007197,172.217.194.0-255,1484,179963,7,321892
37946,0.009582,172.217.194.0-255,4320,184283,7,321892
37947,0.009587,172.31.36.0-255,66,184349,7,321892
37948,0.011963,172.217.194.0-255,5738,190087,7,321892
37949,0.011972,172.31.36.0-255,66,190153,7,321892
37950,0.014339,172.217.194.0-255,5738,195891,7,321892
37951,0.014346,172.31.36.0-255,66,195957,7,321892
37952,0.016725,172.217.194.0-255,5738,201695,7,321892
37953,0.016732,172.31.36.0-255,66,201761,7,321892
37954,0.019137,172.217.194.0-255,5738,207499,7,321892
37955,0.019148,172.31.36.0-255,66,207565,7,321892
37956,0.021567,172.217.194.0-255,5738,213303,7,321892
37957,0.021575,172.31.36.0-255,66,213369,7,321892
37958,0.023957,172.217.194.0-255,5738,219107,7,321892
37959,0.023965,172.31.36.0-255,66,219173,7,321892
37960,0.026351,172.217.194.0-255,5738,224911,7,321892
37961,0.026357,172.31.36.0-255,66,224977,7,321892
37962,0.02874,172.217.194.0-255,5738,230715,7,321892
37963,0.028747,172.31.36.0-255,66,230781,7,321892
37964,0.031141,172.217.194.0-255,5738,236519,7,321892
37965,0.031153,172.31.36.0-255,66,236585,7,321892
37966,0.03356,172.217.194.0-255,5738,242323,7,321892
37967,0.033569,172.31.36.0-255,66,242389,7,321892
37968,0.035946,172.217.194.0-255,5738,248127,7,321892
37969,0.035954,172.31.36.0-255,66,248193,7,321892
37970,0.038365,172.217.194.0-255,5738,253931,7,321892
37971,0.038373,172.31.36.0-255,66,253997,7,321892
37972,0.03976,172.31.36.0-255,172,254169,7,321892
37973,0.03979,172.31.36.0-255,1115,255284,7,321892
37974,0.039844,172.31.36.0-255,1514,256798,7,321892
37975,0.039845,172.31.36.0-255,1514,258312,7,321892
37976,0.039846,172.31.36.0-255,1514,259826,7,321892
37977,0.039871,172.31.36.0-255,1514,261340,7,321892
37978,0.039872,172.31.36.0-255,1514,262854,7,321892
37979,0.039873,172.31.36.0-255,69,262923,7,321892
37980,0.040735,172.217.194.0-255,5738,268661,7,321892
37981,0.040742,172.31.36.0-255,66,268727,7,321892
37982,0.041303,104.244.42.0-255,66,268793,7,321892
37983,0.04135,104.244.42.0-255,66,268859,7,321892
37984,0.041445,104.244.42.0-255,66,268925,7,321892
37985,0.041449,104.244.42.0-255,66,268991,7,321892
37986,0.041451,104.244.42.0-255,66,269057,7,321892
37987,0.04311,172.217.194.0-255,5738,274795,7,321892
37988,0.043118,172.31.36.0-255,66,274861,7,321892
37989,0.045491,172.217.194.0-255,5738,280599,7,321892
37990,0.0455,172.31.36.0-255,66,280665,7,321892
37991,0.047902,172.217.194.0-255,5738,286403,7,321892
37992,0.047911,172.31.36.0-255,66,286469,7,321892
37993,0.050307,172.217.194.0-255,5738,292207,7,321892
37994,0.050315,172.31.36.0-255,66,292273,7,321892
37995,0.052747,172.217.194.0-255,5738,298011,7,321892
37996,0.052757,172.31.36.0-255,66,298077,7,321892
37997,0.055141,172.217.194.0-255,5738,303815,7,321892
37998,0.055146,172.31.36.0-255,66,303881,7,321892
37999,0.057504,172.217.194.0-255,5738,309619,7,321892
38000,0.057511,172.31.36.0-255,66,309685,7,321892
38001,0.05989,172.217.194.0-255,5738,315423,7,321892
38002,0.059897,172.31.36.0-255,66,315489,7,321892
38003,0.062281,172.217.194.0-255,5738,321227,7,321892
38004,0.062287,172.31.36.0-255,66,321293,7,321892
38005,0.064652,172.217.194.0-255,362,321655,7,321892
38006,0.064796,172.31.36.0-255,66,321721,7,321892
38007,0.064833,172.31.36.0-255,105,321826,7,321892
38008,0.067151,172.217.194.0-255,66,321892,7,321892
38009,0.0,172.217.194.0-255,153,153,7,145627
38010,2.4e-05,172.31.36.0-255,66,219,7,145627
38011,3.1e-05,172.217.194.0-255,1484,1703,7,145627
38012,3.6e-05,172.31.36.0-255,66,1769,7,145627
38013,4.2e-05,172.217.194.0-255,2902,4671,7,145627
38014,4.5e-05,172.31.36.0-255,66,4737,7,145627
38015,5.3e-05,172.217.194.0-255,7156,11893,7,145627
38016,5.5e-05,172.31.36.0-255,66,11959,7,145627
38017,7.2e-05,172.31.36.0-255,66,12025,7,145627
38018,9.8e-05,172.217.194.0-255,2543,14568,7,145627
38019,0.000101,172.31.36.0-255,66,14634,7,145627
38020,0.000141,172.217.194.0-255,2902,17536,7,145627
38021,0.000144,172.31.36.0-255,66,17602,7,145627
38022,0.000149,172.217.194.0-255,2902,20504,7,145627
38023,0.000151,172.31.36.0-255,66,20570,7,145627
38024,0.000161,172.217.194.0-255,1484,22054,7,145627
38025,0.000164,172.31.36.0-255,66,22120,7,145627
38026,0.000176,172.31.36.0-255,66,22186,7,145627
38027,0.000196,172.217.194.0-255,1484,23670,7,145627
38028,0.000198,172.31.36.0-255,66,23736,7,145627
38029,0.00023,172.31.36.0-255,66,23802,7,145627
38030,0.000244,172.217.194.0-255,2902,26704,7,145627
38031,0.000246,172.31.36.0-255,66,26770,7,145627
38032,0.000265,172.217.194.0-255,2795,29565,7,145627
38033,0.000268,172.31.36.0-255,66,29631,7,145627
38034,0.000289,172.217.194.0-255,118,29749,7,145627
38035,0.000291,172.31.36.0-255,66,29815,7,145627
38036,0.000294,172.217.194.0-255,383,30198,7,145627
38037,0.000296,172.31.36.0-255,66,30264,7,145627
38038,0.000496,172.217.194.0-255,1484,31748,7,145627
38039,0.000504,172.217.194.0-255,2902,34650,7,145627
38040,0.000508,172.31.36.0-255,66,34716,7,145627
38041,0.000515,172.217.194.0-255,5738,40454,7,145627
38042,0.000518,172.31.36.0-255,66,40520,7,145627
38043,0.000572,172.31.36.0-255,66,40586,7,145627
38044,0.000585,172.31.36.0-255,66,40652,7,145627
38045,0.000781,172.217.194.0-255,1484,42136,7,145627
38046,0.000786,172.217.194.0-255,1484,43620,7,145627
38047,0.000789,172.31.36.0-255,66,43686,7,145627
38048,0.00081,172.217.194.0-255,1484,45170,7,145627
38049,0.000817,172.217.194.0-255,5738,50908,7,145627
38050,0.000819,172.31.36.0-255,66,50974,7,145627
38051,0.000826,172.217.194.0-255,5738,56712,7,145627
38052,0.000828,172.31.36.0-255,66,56778,7,145627
38053,0.000849,172.217.194.0-255,7156,63934,7,145627
38054,0.000852,172.31.36.0-255,66,64000,7,145627
38055,0.00086,172.217.194.0-255,7156,71156,7,145627
38056,0.000862,172.31.36.0-255,66,71222,7,145627
38057,0.000881,172.217.194.0-255,3602,74824,7,145627
38058,0.000884,172.31.36.0-255,66,74890,7,145627
38059,0.001412,172.217.194.0-255,1484,76374,7,145627
38060,0.001418,172.217.194.0-255,2902,79276,7,145627
38061,0.001422,172.31.36.0-255,66,79342,7,145627
38062,0.00143,172.217.194.0-255,5738,85080,7,145627
38063,0.001432,172.31.36.0-255,66,85146,7,145627
38064,0.001476,172.31.36.0-255,66,85212,7,145627
38065,0.001487,172.31.36.0-255,66,85278,7,145627
38066,0.001522,172.217.194.0-255,2184,87462,7,145627
38067,0.001525,172.31.36.0-255,66,87528,7,145627
38068,0.00154,172.217.194.0-255,1484,89012,7,145627
38069,0.001556,172.217.194.0-255,1484,90496,7,145627
38070,0.001558,172.31.36.0-255,66,90562,7,145627
38071,0.001563,172.217.194.0-255,2902,93464,7,145627
38072,0.001565,172.31.36.0-255,66,93530,7,145627
38073,0.001583,172.217.194.0-255,4320,97850,7,145627
38074,0.001585,172.31.36.0-255,66,97916,7,145627
38075,0.001601,172.31.36.0-255,66,97982,7,145627
38076,0.00162,172.217.194.0-255,5738,103720,7,145627
38077,0.001623,172.31.36.0-255,66,103786,7,145627
38078,0.001645,172.217.194.0-255,2184,105970,7,145627
38079,0.001649,172.31.36.0-255,66,106036,7,145627
38080,0.00167,172.217.194.0-255,1484,107520,7,145627
38081,0.001674,172.217.194.0-255,2902,110422,7,145627
38082,0.001677,172.31.36.0-255,66,110488,7,145627
38083,0.001683,172.217.194.0-255,5738,116226,7,145627
38084,0.001685,172.31.36.0-255,66,116292,7,145627
38085,0.001703,172.217.194.0-255,1484,117776,7,145627
38086,0.001726,172.31.36.0-255,66,117842,7,145627
38087,0.001737,172.31.36.0-255,66,117908,7,145627
38088,0.001758,172.217.194.0-255,766,118674,7,145627
38089,0.001811,172.217.194.0-255,1484,120158,7,145627
38090,0.001814,172.31.36.0-255,66,120224,7,145627
38091,0.001818,172.217.194.0-255,1484,121708,7,145627
38092,0.001833,172.217.194.0-255,1484,123192,7,145627
38093,0.001836,172.31.36.0-255,66,123258,7,145627
38094,0.001842,172.217.194.0-255,5738,128996,7,145627
38095,0.001845,172.31.36.0-255,66,129062,7,145627
38096,0.001878,172.31.36.0-255,66,129128,7,145627
38097,0.001895,172.217.194.0-255,4320,133448,7,145627
38098,0.001898,172.31.36.0-255,66,133514,7,145627
38099,0.001911,172.31.36.0-255,66,133580,7,145627
38100,0.00199,172.31.36.0-255,66,133646,7,145627
38101,0.002002,172.31.36.0-255,66,133712,7,145627
38102,0.002013,172.31.36.0-255,66,133778,7,145627
38103,0.002102,172.31.36.0-255,66,133844,7,145627
38104,0.00211,172.217.194.0-255,7156,141000,7,145627
38105,0.002134,172.217.194.0-255,105,141105,7,145627
38106,0.002147,172.31.36.0-255,66,141171,7,145627
38107,0.004301,172.31.36.0-255,105,141276,7,145627
38108,0.006492,172.217.194.0-255,66,141342,7,145627
38109,0.033393,172.31.36.0-255,167,141509,7,145627
38110,0.033427,172.31.36.0-255,1115,142624,7,145627
38111,0.033492,172.31.36.0-255,1514,144138,7,145627
38112,0.033494,172.31.36.0-255,1291,145429,7,145627
38113,0.034917,104.244.42.0-255,66,145495,7,145627
38114,0.034927,104.244.42.0-255,66,145561,7,145627
38115,0.035004,104.244.42.0-255,66,145627,7,145627
38116,0.0,172.217.194.0-255,146,146,7,168414
38117,2.1e-05,172.31.36.0-255,66,212,7,168414
38118,2.8e-05,172.217.194.0-255,1484,1696,7,168414
38119,3.3e-05,172.31.36.0-255,66,1762,7,168414
38120,3.7e-05,172.217.194.0-255,2902,4664,7,168414
38121,4e-05,172.31.36.0-255,66,4730,7,168414
38122,7.6e-05,172.217.194.0-255,7156,11886,7,168414
38123,8e-05,172.31.36.0-255,66,11952,7,168414
38124,8.9e-05,172.31.36.0-255,66,12018,7,168414
38125,0.000136,172.31.36.0-255,66,12084,7,168414
38126,0.000185,172.217.194.0-255,1484,13568,7,168414
38127,0.000189,172.31.36.0-255,66,13634,7,168414
38128,0.000194,172.217.194.0-255,2902,16536,7,168414
38129,0.000197,172.31.36.0-255,66,16602,7,168414
38130,0.000223,172.217.194.0-255,5738,22340,7,168414
38131,0.000226,172.31.36.0-255,66,22406,7,168414
38132,0.000244,172.217.194.0-255,1484,23890,7,168414
38133,0.000247,172.31.36.0-255,66,23956,7,168414
38134,0.00028,172.31.36.0-255,66,24022,7,168414
38135,0.000293,172.31.36.0-255,66,24088,7,168414
38136,0.000296,172.217.194.0-255,1484,25572,7,168414
38137,0.0003,172.31.36.0-255,66,25638,7,168414
38138,0.000321,172.217.194.0-255,287,25925,7,168414
38139,0.000324,172.31.36.0-255,66,25991,7,168414
38140,0.000627,172.217.194.0-255,1484,27475,7,168414
38141,0.000632,172.31.36.0-255,66,27541,7,168414
38142,0.000639,172.217.194.0-255,2902,30443,7,168414
38143,0.000641,172.31.36.0-255,66,30509,7,168414
38144,0.000647,172.217.194.0-255,5738,36247,7,168414
38145,0.000649,172.31.36.0-255,66,36313,7,168414
38146,0.000653,172.217.194.0-255,1484,37797,7,168414
38147,0.000676,172.217.194.0-255,2902,40699,7,168414
38148,0.000679,172.31.36.0-255,66,40765,7,168414
38149,0.000691,172.31.36.0-255,66,40831,7,168414
38150,0.000713,172.217.194.0-255,1484,42315,7,168414
38151,0.000745,172.31.36.0-255,66,42381,7,168414
38152,0.001085,172.217.194.0-255,1484,43865,7,168414
38153,0.001094,172.217.194.0-255,2902,46767,7,168414
38154,0.001097,172.31.36.0-255,66,46833,7,168414
38155,0.001105,172.217.194.0-255,5738,52571,7,168414
38156,0.001107,172.31.36.0-255,66,52637,7,168414
38157,0.001135,172.217.194.0-255,5738,58375,7,168414
38158,0.001138,172.31.36.0-255,66,58441,7,168414
38159,0.00117,172.31.36.0-255,66,58507,7,168414
38160,0.001194,172.217.194.0-255,4320,62827,7,168414
38161,0.001198,172.31.36.0-255,66,62893,7,168414
38162,0.001204,172.217.194.0-255,5020,67913,7,168414
38163,0.001206,172.31.36.0-255,66,67979,7,168414
38164,0.001249,172.217.194.0-255,1484,69463,7,168414
38165,0.001255,172.217.194.0-255,2902,72365,7,168414
38166,0.001258,172.31.36.0-255,66,72431,7,168414
38167,0.001278,172.217.194.0-255,4320,76751,7,168414
38168,0.001282,172.31.36.0-255,66,76817,7,168414
38169,0.001298,172.217.194.0-255,1484,78301,7,168414
38170,0.001303,172.217.194.0-255,2902,81203,7,168414
38171,0.001307,172.31.36.0-255,66,81269,7,168414
38172,0.001344,172.31.36.0-255,66,81335,7,168414
38173,0.001356,172.31.36.0-255,66,81401,7,168414
38174,0.001398,172.217.194.0-255,1484,82885,7,168414
38175,0.001405,172.217.194.0-255,2902,85787,7,168414
38176,0.001409,172.31.36.0-255,66,85853,7,168414
38177,0.001415,172.217.194.0-255,2902,88755,7,168414
38178,0.001417,172.31.36.0-255,66,88821,7,168414
38179,0.001434,172.217.194.0-255,4320,93141,7,168414
38180,0.001437,172.31.36.0-255,66,93207,7,168414
38181,0.001461,172.217.194.0-255,2902,96109,7,168414
38182,0.001464,172.31.36.0-255,66,96175,7,168414
38183,0.00147,172.217.194.0-255,4320,100495,7,168414
38184,0.001473,172.31.36.0-255,66,100561,7,168414
38185,0.001497,172.31.36.0-255,66,100627,7,168414
38186,0.001502,172.217.194.0-255,3602,104229,7,168414
38187,0.001505,172.31.36.0-255,66,104295,7,168414
38188,0.001567,172.31.36.0-255,66,104361,7,168414
38189,0.001591,172.217.194.0-255,5738,110099,7,168414
38190,0.001594,172.31.36.0-255,66,110165,7,168414
38191,0.001624,172.217.194.0-255,5738,115903,7,168414
38192,0.001629,172.31.36.0-255,66,115969,7,168414
38193,0.001643,172.31.36.0-255,66,116035,7,168414
38194,0.001906,172.217.194.0-255,1484,117519,7,168414
38195,0.001912,172.217.194.0-255,2902,120421,7,168414
38196,0.001918,172.31.36.0-255,66,120487,7,168414
38197,0.001927,172.217.194.0-255,2902,123389,7,168414
38198,0.001929,172.31.36.0-255,66,123455,7,168414
38199,0.001944,172.217.194.0-255,2902,126357,7,168414
38200,0.001946,172.31.36.0-255,66,126423,7,168414
38201,0.00195,172.217.194.0-255,1484,127907,7,168414
38202,0.001988,172.31.36.0-255,66,127973,7,168414
38203,0.002038,172.217.194.0-255,1484,129457,7,168414
38204,0.002043,172.31.36.0-255,66,129523,7,168414
38205,0.002061,172.31.36.0-255,66,129589,7,168414
38206,0.002096,172.31.36.0-255,66,129655,7,168414
38207,0.002102,172.217.194.0-255,6438,136093,7,168414
38208,0.002104,172.31.36.0-255,66,136159,7,168414
38209,0.002109,172.217.194.0-255,5738,141897,7,168414
38210,0.002111,172.31.36.0-255,66,141963,7,168414
38211,0.002153,172.31.36.0-255,66,142029,7,168414
38212,0.002162,172.217.194.0-255,3602,145631,7,168414
38213,0.002164,172.31.36.0-255,66,145697,7,168414
38214,0.00217,172.217.194.0-255,7156,152853,7,168414
38215,0.002173,172.217.194.0-255,1484,154337,7,168414
38216,0.002203,172.31.36.0-255,66,154403,7,168414
38217,0.002232,172.217.194.0-255,4320,158723,7,168414
38218,0.002251,172.31.36.0-255,66,158789,7,168414
38219,0.002327,172.31.36.0-255,66,158855,7,168414
38220,0.002349,172.217.194.0-255,4927,163782,7,168414
38221,0.002351,172.217.194.0-255,105,163887,7,168414
38222,0.002362,172.31.36.0-255,66,163953,7,168414
38223,0.004247,172.31.36.0-255,105,164058,7,168414
38224,0.006792,172.217.194.0-255,66,164124,7,168414
38225,0.026785,172.31.36.0-255,172,164296,7,168414
38226,0.026843,172.31.36.0-255,1114,165410,7,168414
38227,0.026915,172.31.36.0-255,1514,166924,7,168414
38228,0.026917,172.31.36.0-255,1292,168216,7,168414
38229,0.028324,104.244.42.0-255,66,168282,7,168414
38230,0.028363,104.244.42.0-255,66,168348,7,168414
38231,0.028446,104.244.42.0-255,66,168414,7,168414
38232,0.0,172.253.118.0-255,153,153,7,295108
38233,2.2e-05,172.31.36.0-255,66,219,7,295108
38234,5.9e-05,172.253.118.0-255,1484,1703,7,295108
38235,6.5e-05,172.31.36.0-255,66,1769,7,295108
38236,7.1e-05,172.253.118.0-255,2902,4671,7,295108
38237,7.4e-05,172.31.36.0-255,66,4737,7,295108
38238,8.1e-05,172.253.118.0-255,5738,10475,7,295108
38239,8.4e-05,172.31.36.0-255,66,10541,7,295108
38240,0.000119,172.253.118.0-255,3485,14026,7,295108
38241,0.000122,172.31.36.0-255,66,14092,7,295108
38242,0.000147,172.253.118.0-255,4320,18412,7,295108
38243,0.00015,172.31.36.0-255,66,18478,7,295108
38244,0.000156,172.253.118.0-255,4320,22798,7,295108
38245,0.000159,172.31.36.0-255,66,22864,7,295108
38246,0.00025,172.31.36.0-255,66,22930,7,295108
38247,0.000349,172.253.118.0-255,1484,24414,7,295108
38248,0.000352,172.31.36.0-255,66,24480,7,295108
38249,0.000358,172.253.118.0-255,2902,27382,7,295108
38250,0.00036,172.31.36.0-255,66,27448,7,295108
38251,0.000395,172.253.118.0-255,5738,33186,7,295108
38252,0.000398,172.31.36.0-255,66,33252,7,295108
38253,0.00043,172.31.36.0-255,66,33318,7,295108
38254,0.000437,172.253.118.0-255,5738,39056,7,295108
38255,0.000439,172.31.36.0-255,66,39122,7,295108
38256,0.000469,172.253.118.0-255,2902,42024,7,295108
38257,0.000472,172.31.36.0-255,66,42090,7,295108
38258,0.00048,172.253.118.0-255,7103,49193,7,295108
38259,0.000483,172.31.36.0-255,66,49259,7,295108
38260,0.000485,172.253.118.0-255,113,49372,7,295108
38261,0.000488,172.31.36.0-255,66,49438,7,295108
38262,0.00055,172.253.118.0-255,332,49770,7,295108
38263,0.001129,172.253.118.0-255,1484,51254,7,295108
38264,0.001135,172.31.36.0-255,66,51320,7,295108
38265,0.001141,172.253.118.0-255,2902,54222,7,295108
38266,0.001143,172.31.36.0-255,66,54288,7,295108
38267,0.001147,172.253.118.0-255,1484,55772,7,295108
38268,0.001184,172.253.118.0-255,4320,60092,7,295108
38269,0.001187,172.31.36.0-255,66,60158,7,295108
38270,0.001193,172.253.118.0-255,4320,64478,7,295108
38271,0.001194,172.31.36.0-255,66,64544,7,295108
38272,0.001208,172.31.36.0-255,66,64610,7,295108
38273,0.001234,172.253.118.0-255,2902,67512,7,295108
38274,0.001236,172.31.36.0-255,66,67578,7,295108
38275,0.001261,172.253.118.0-255,5020,72598,7,295108
38276,0.001264,172.31.36.0-255,66,72664,7,295108
38277,0.002111,172.253.118.0-255,1484,74148,7,295108
38278,0.002122,172.253.118.0-255,2902,77050,7,295108
38279,0.002127,172.31.36.0-255,66,77116,7,295108
38280,0.002133,172.253.118.0-255,2902,80018,7,295108
38281,0.002135,172.31.36.0-255,66,80084,7,295108
38282,0.002138,172.253.118.0-255,1484,81568,7,295108
38283,0.002167,172.253.118.0-255,2902,84470,7,295108
38284,0.00217,172.31.36.0-255,66,84536,7,295108
38285,0.002178,172.253.118.0-255,7156,91692,7,295108
38286,0.00218,172.31.36.0-255,66,91758,7,295108
38287,0.002199,172.253.118.0-255,1484,93242,7,295108
38288,0.002207,172.253.118.0-255,5738,98980,7,295108
38289,0.002209,172.31.36.0-255,66,99046,7,295108
38290,0.002245,172.31.36.0-255,66,99112,7,295108
38291,0.004548,172.253.118.0-255,5738,104850,7,295108
38292,0.004554,172.31.36.0-255,66,104916,7,295108
38293,0.006848,172.253.118.0-255,5738,110654,7,295108
38294,0.006851,172.31.36.0-255,66,110720,7,295108
38295,0.009159,172.253.118.0-255,5738,116458,7,295108
38296,0.009167,172.31.36.0-255,66,116524,7,295108
38297,0.011466,172.253.118.0-255,5738,122262,7,295108
38298,0.011475,172.31.36.0-255,66,122328,7,295108
38299,0.013765,172.253.118.0-255,5738,128066,7,295108
38300,0.013774,172.31.36.0-255,66,128132,7,295108
38301,0.01609,172.253.118.0-255,5738,133870,7,295108
38302,0.0161,172.31.36.0-255,66,133936,7,295108
38303,0.018432,172.253.118.0-255,5738,139674,7,295108
38304,0.01844,172.31.36.0-255,66,139740,7,295108
38305,0.020743,172.253.118.0-255,5738,145478,7,295108
38306,0.020751,172.31.36.0-255,66,145544,7,295108
38307,0.023051,172.253.118.0-255,5738,151282,7,295108
38308,0.02306,172.31.36.0-255,66,151348,7,295108
38309,0.025359,172.253.118.0-255,5738,157086,7,295108
38310,0.025366,172.31.36.0-255,66,157152,7,295108
38311,0.027247,172.31.36.0-255,172,157324,7,295108
38312,0.027275,172.31.36.0-255,1114,158438,7,295108
38313,0.027334,172.31.36.0-255,1514,159952,7,295108
38314,0.027336,172.31.36.0-255,1292,161244,7,295108
38315,0.02768,172.253.118.0-255,5738,166982,7,295108
38316,0.027687,172.31.36.0-255,66,167048,7,295108
38317,0.028821,104.244.42.0-255,66,167114,7,295108
38318,0.028853,104.244.42.0-255,66,167180,7,295108
38319,0.028895,104.244.42.0-255,66,167246,7,295108
38320,0.029533,104.244.42.0-255,108,167354,7,295108
38321,0.029538,172.31.36.0-255,66,167420,7,295108
38322,0.029998,172.253.118.0-255,5738,173158,7,295108
38323,0.030003,172.31.36.0-255,66,173224,7,295108
38324,0.032302,172.253.118.0-255,5738,178962,7,295108
38325,0.032311,172.31.36.0-255,66,179028,7,295108
38326,0.034613,172.253.118.0-255,5738,184766,7,295108
38327,0.034621,172.31.36.0-255,66,184832,7,295108
38328,0.036959,172.253.118.0-255,5738,190570,7,295108
38329,0.036971,172.31.36.0-255,66,190636,7,295108
38330,0.039286,172.253.118.0-255,5738,196374,7,295108
38331,0.039297,172.31.36.0-255,66,196440,7,295108
38332,0.041622,172.253.118.0-255,5738,202178,7,295108
38333,0.041628,172.31.36.0-255,66,202244,7,295108
38334,0.043939,172.253.118.0-255,5738,207982,7,295108
38335,0.043946,172.31.36.0-255,66,208048,7,295108
38336,0.046266,172.253.118.0-255,5738,213786,7,295108
38337,0.046273,172.31.36.0-255,66,213852,7,295108
38338,0.048614,172.253.118.0-255,5738,219590,7,295108
38339,0.04862,172.31.36.0-255,66,219656,7,295108
38340,0.050926,172.253.118.0-255,5738,225394,7,295108
38341,0.050934,172.31.36.0-255,66,225460,7,295108
38342,0.053227,172.253.118.0-255,5738,231198,7,295108
38343,0.053234,172.31.36.0-255,66,231264,7,295108
38344,0.055551,172.253.118.0-255,5738,237002,7,295108
38345,0.055559,172.31.36.0-255,66,237068,7,295108
38346,0.05788,172.253.118.0-255,5738,242806,7,295108
38347,0.057892,172.31.36.0-255,66,242872,7,295108
38348,0.060243,172.253.118.0-255,5738,248610,7,295108
38349,0.060251,172.31.36.0-255,66,248676,7,295108
38350,0.062551,172.253.118.0-255,5738,254414,7,295108
38351,0.062557,172.31.36.0-255,66,254480,7,295108
38352,0.064875,172.253.118.0-255,5738,260218,7,295108
38353,0.064882,172.31.36.0-255,66,260284,7,295108
38354,0.067175,172.253.118.0-255,5738,266022,7,295108
38355,0.067182,172.31.36.0-255,66,266088,7,295108
38356,0.069482,172.253.118.0-255,5738,271826,7,295108
38357,0.069489,172.31.36.0-255,66,271892,7,295108
38358,0.071782,172.253.118.0-255,5738,277630,7,295108
38359,0.071789,172.31.36.0-255,66,277696,7,295108
38360,0.074091,172.253.118.0-255,5738,283434,7,295108
38361,0.074098,172.31.36.0-255,66,283500,7,295108
38362,0.076405,172.253.118.0-255,5738,289238,7,295108
38363,0.076412,172.31.36.0-255,66,289304,7,295108
38364,0.078754,172.253.118.0-255,5738,295042,7,295108
38365,0.078763,172.31.36.0-255,66,295108,7,295108
38366,0.0,172.217.24.0-255,297,297,7,301561
38367,2.3e-05,172.31.36.0-255,66,363,7,301561
38368,2.9e-05,172.217.24.0-255,1484,1847,7,301561
38369,3.4e-05,172.31.36.0-255,66,1913,7,301561
38370,3.7e-05,172.217.24.0-255,1484,3397,7,301561
38371,4.1e-05,172.31.36.0-255,66,3463,7,301561
38372,4.7e-05,172.217.24.0-255,2902,6365,7,301561
38373,5e-05,172.31.36.0-255,66,6431,7,301561
38374,5.4e-05,172.217.24.0-255,2902,9333,7,301561
38375,5.8e-05,172.31.36.0-255,66,9399,7,301561
38376,6.3e-05,172.217.24.0-255,4320,13719,7,301561
38377,6.6e-05,172.31.36.0-255,66,13785,7,301561
38378,6.9e-05,172.217.24.0-255,388,14173,7,301561
38379,7.1e-05,172.31.36.0-255,66,14239,7,301561
38380,0.000207,172.217.24.0-255,1484,15723,7,301561
38381,0.000212,172.31.36.0-255,66,15789,7,301561
38382,0.000219,172.217.24.0-255,2902,18691,7,301561
38383,0.000222,172.31.36.0-255,66,18757,7,301561
38384,0.000239,172.217.24.0-255,5738,24495,7,301561
38385,0.000241,172.31.36.0-255,66,24561,7,301561
38386,0.000248,172.217.24.0-255,5738,30299,7,301561
38387,0.000251,172.31.36.0-255,66,30365,7,301561
38388,0.00029,172.217.24.0-255,6797,37162,7,301561
38389,0.000293,172.31.36.0-255,66,37228,7,301561
38390,0.000299,172.217.24.0-255,5738,42966,7,301561
38391,0.000301,172.31.36.0-255,66,43032,7,301561
38392,0.000352,172.217.24.0-255,5379,48411,7,301561
38393,0.000355,172.31.36.0-255,66,48477,7,301561
38394,0.000373,172.217.24.0-255,1484,49961,7,301561
38395,0.000376,172.31.36.0-255,66,50027,7,301561
38396,0.000394,172.217.24.0-255,4320,54347,7,301561
38397,0.000396,172.31.36.0-255,66,54413,7,301561
38398,0.000404,172.217.24.0-255,7156,61569,7,301561
38399,0.000406,172.31.36.0-255,66,61635,7,301561
38400,0.000421,172.217.24.0-255,1484,63119,7,301561
38401,0.000452,172.217.24.0-255,2873,65992,7,301561
38402,0.000456,172.31.36.0-255,66,66058,7,301561
38403,0.001911,172.217.24.0-255,114,66172,7,301561
38404,0.00239,172.217.24.0-255,4320,70492,7,301561
38405,0.002396,172.31.36.0-255,66,70558,7,301561
38406,0.004338,172.217.24.0-255,5738,76296,7,301561
38407,0.004344,172.31.36.0-255,66,76362,7,301561
38408,0.006278,172.217.24.0-255,5738,82100,7,301561
38409,0.006285,172.31.36.0-255,66,82166,7,301561
38410,0.008226,172.217.24.0-255,5738,87904,7,301561
38411,0.008233,172.31.36.0-255,66,87970,7,301561
38412,0.010187,172.217.24.0-255,5738,93708,7,301561
38413,0.010192,172.31.36.0-255,66,93774,7,301561
38414,0.012131,172.217.24.0-255,5738,99512,7,301561
38415,0.012139,172.31.36.0-255,66,99578,7,301561
38416,0.014081,172.217.24.0-255,5738,105316,7,301561
38417,0.01409,172.31.36.0-255,66,105382,7,301561
38418,0.016037,172.217.24.0-255,5738,111120,7,301561
38419,0.016045,172.31.36.0-255,66,111186,7,301561
38420,0.017991,172.217.24.0-255,5738,116924,7,301561
38421,0.017999,172.31.36.0-255,66,116990,7,301561
38422,0.019965,172.217.24.0-255,5738,122728,7,301561
38423,0.019974,172.31.36.0-255,66,122794,7,301561
38424,0.021916,172.217.24.0-255,5738,128532,7,301561
38425,0.021924,172.31.36.0-255,66,128598,7,301561
38426,0.023861,172.217.24.0-255,5738,134336,7,301561
38427,0.023868,172.31.36.0-255,66,134402,7,301561
38428,0.025812,172.217.24.0-255,5738,140140,7,301561
38429,0.02582,172.31.36.0-255,66,140206,7,301561
38430,0.025905,172.31.36.0-255,101,140307,7,301561
38431,0.027427,172.31.36.0-255,188,140495,7,301561
38432,0.027459,172.31.36.0-255,958,141453,7,301561
38433,0.02752,172.31.36.0-255,1514,142967,7,301561
38434,0.027522,172.31.36.0-255,1448,144415,7,301561
38435,0.027755,172.217.24.0-255,5738,150153,7,301561
38436,0.027761,172.31.36.0-255,66,150219,7,301561
38437,0.027796,172.217.24.0-255,66,150285,7,301561
38438,0.02897,104.244.42.0-255,66,150351,7,301561
38439,0.029051,104.244.42.0-255,66,150417,7,301561
38440,0.029086,104.244.42.0-255,66,150483,7,301561
38441,0.029699,172.217.24.0-255,5738,156221,7,301561
38442,0.029705,172.31.36.0-255,66,156287,7,301561
38443,0.029722,104.244.42.0-255,108,156395,7,301561
38444,0.029725,172.31.36.0-255,66,156461,7,301561
38445,0.031645,172.217.24.0-255,5738,162199,7,301561
38446,0.031652,172.31.36.0-255,66,162265,7,301561
38447,0.033597,172.217.24.0-255,5738,168003,7,301561
38448,0.033604,172.31.36.0-255,66,168069,7,301561
38449,0.035547,172.217.24.0-255,5738,173807,7,301561
38450,0.035553,172.31.36.0-255,66,173873,7,301561
38451,0.037511,172.217.24.0-255,5738,179611,7,301561
38452,0.03752,172.31.36.0-255,66,179677,7,301561
38453,0.039483,172.217.24.0-255,5738,185415,7,301561
38454,0.039491,172.31.36.0-255,66,185481,7,301561
38455,0.041438,172.217.24.0-255,5738,191219,7,301561
38456,0.041448,172.31.36.0-255,66,191285,7,301561
38457,0.043402,172.217.24.0-255,5738,197023,7,301561
38458,0.043409,172.31.36.0-255,66,197089,7,301561
38459,0.045391,172.217.24.0-255,5738,202827,7,301561
38460,0.045398,172.31.36.0-255,66,202893,7,301561
38461,0.04737,172.217.24.0-255,5738,208631,7,301561
38462,0.047376,172.31.36.0-255,66,208697,7,301561
38463,0.049327,172.217.24.0-255,5738,214435,7,301561
38464,0.049335,172.31.36.0-255,66,214501,7,301561
38465,0.051273,172.217.24.0-255,5738,220239,7,301561
38466,0.051279,172.31.36.0-255,66,220305,7,301561
38467,0.05322,172.217.24.0-255,5738,226043,7,301561
38468,0.053227,172.31.36.0-255,66,226109,7,301561
38469,0.055175,172.217.24.0-255,5738,231847,7,301561
38470,0.055182,172.31.36.0-255,66,231913,7,301561
38471,0.057124,172.217.24.0-255,5738,237651,7,301561
38472,0.057132,172.31.36.0-255,66,237717,7,301561
38473,0.05909,172.217.24.0-255,5738,243455,7,301561
38474,0.059098,172.31.36.0-255,66,243521,7,301561
38475,0.061048,172.217.24.0-255,5738,249259,7,301561
38476,0.061055,172.31.36.0-255,66,249325,7,301561
38477,0.063008,172.217.24.0-255,5738,255063,7,301561
38478,0.063015,172.31.36.0-255,66,255129,7,301561
38479,0.06497,172.217.24.0-255,5738,260867,7,301561
38480,0.064977,172.31.36.0-255,66,260933,7,301561
38481,0.066929,172.217.24.0-255,5738,266671,7,301561
38482,0.066935,172.31.36.0-255,66,266737,7,301561
38483,0.068874,172.217.24.0-255,5738,272475,7,301561
38484,0.068881,172.31.36.0-255,66,272541,7,301561
38485,0.070821,172.217.24.0-255,5738,278279,7,301561
38486,0.070827,172.31.36.0-255,66,278345,7,301561
38487,0.072765,172.217.24.0-255,5738,284083,7,301561
38488,0.072772,172.31.36.0-255,66,284149,7,301561
38489,0.074704,172.217.24.0-255,5738,289887,7,301561
38490,0.074711,172.31.36.0-255,66,289953,7,301561
38491,0.076656,172.217.24.0-255,5738,295691,7,301561
38492,0.076663,172.31.36.0-255,66,295757,7,301561
38493,0.078627,172.217.24.0-255,5738,301495,7,301561
38494,0.078636,172.31.36.0-255,66,301561,7,301561
38495,0.0,172.217.194.0-255,150,150,7,311542
38496,3.5e-05,172.31.36.0-255,66,216,7,311542
38497,4.1e-05,172.217.194.0-255,1484,1700,7,311542
38498,4.6e-05,172.31.36.0-255,66,1766,7,311542
38499,5.1e-05,172.217.194.0-255,2902,4668,7,311542
38500,5.3e-05,172.31.36.0-255,66,4734,7,311542
38501,6e-05,172.217.194.0-255,7156,11890,7,311542
38502,6.3e-05,172.31.36.0-255,66,11956,7,311542
38503,9e-05,172.217.194.0-255,2104,14060,7,311542
38504,9.3e-05,172.31.36.0-255,66,14126,7,311542
38505,0.000153,172.217.194.0-255,1484,15610,7,311542
38506,0.000157,172.31.36.0-255,66,15676,7,311542
38507,0.00016,172.217.194.0-255,1484,17160,7,311542
38508,0.000164,172.31.36.0-255,66,17226,7,311542
38509,0.000182,172.217.194.0-255,1484,18710,7,311542
38510,0.000184,172.31.36.0-255,66,18776,7,311542
38511,0.000191,172.217.194.0-255,5738,24514,7,311542
38512,0.000194,172.31.36.0-255,66,24580,7,311542
38513,0.000199,172.217.194.0-255,4320,28900,7,311542
38514,0.000201,172.31.36.0-255,66,28966,7,311542
38515,0.000252,172.31.36.0-255,66,29032,7,311542
38516,0.000274,172.217.194.0-255,3961,32993,7,311542
38517,0.000279,172.31.36.0-255,66,33059,7,311542
38518,0.000293,172.31.36.0-255,66,33125,7,311542
38519,0.000299,172.217.194.0-255,4320,37445,7,311542
38520,0.000302,172.31.36.0-255,66,37511,7,311542
38521,0.000325,172.217.194.0-255,2476,39987,7,311542
38522,0.000328,172.31.36.0-255,66,40053,7,311542
38523,0.000331,172.217.194.0-255,384,40437,7,311542
38524,0.000335,172.31.36.0-255,66,40503,7,311542
38525,0.000567,172.217.194.0-255,1484,41987,7,311542
38526,0.000581,172.217.194.0-255,1484,43471,7,311542
38527,0.000585,172.31.36.0-255,66,43537,7,311542
38528,0.000607,172.217.194.0-255,1484,45021,7,311542
38529,0.000614,172.217.194.0-255,5738,50759,7,311542
38530,0.000619,172.31.36.0-255,66,50825,7,311542
38531,0.000623,172.31.36.0-255,66,50891,7,311542
38532,0.00067,172.217.194.0-255,7156,58047,7,311542
38533,0.000673,172.31.36.0-255,66,58113,7,311542
38534,0.0007,172.31.36.0-255,66,58179,7,311542
38535,0.001176,172.217.194.0-255,1484,59663,7,311542
38536,0.001186,172.217.194.0-255,2902,62565,7,311542
38537,0.00119,172.31.36.0-255,66,62631,7,311542
38538,0.001197,172.217.194.0-255,5738,68369,7,311542
38539,0.001199,172.31.36.0-255,66,68435,7,311542
38540,0.001216,172.217.194.0-255,4320,72755,7,311542
38541,0.001219,172.31.36.0-255,66,72821,7,311542
38542,0.001254,172.31.36.0-255,66,72887,7,311542
38543,0.001283,172.31.36.0-255,66,72953,7,311542
38544,0.001554,172.217.194.0-255,1484,74437,7,311542
38545,0.001563,172.217.194.0-255,2902,77339,7,311542
38546,0.001567,172.31.36.0-255,66,77405,7,311542
38547,0.001574,172.217.194.0-255,5738,83143,7,311542
38548,0.001577,172.31.36.0-255,66,83209,7,311542
38549,0.001589,172.217.194.0-255,1484,84693,7,311542
38550,0.001617,172.31.36.0-255,66,84759,7,311542
38551,0.001621,172.217.194.0-255,2902,87661,7,311542
38552,0.001624,172.31.36.0-255,66,87727,7,311542
38553,0.001657,172.31.36.0-255,66,87793,7,311542
38554,0.001662,172.217.194.0-255,4320,92113,7,311542
38555,0.001665,172.31.36.0-255,66,92179,7,311542
38556,0.001697,172.217.194.0-255,7156,99335,7,311542
38557,0.001701,172.31.36.0-255,66,99401,7,311542
38558,0.001713,172.31.36.0-255,66,99467,7,311542
38559,0.001753,172.31.36.0-255,66,99533,7,311542
38560,0.00182,172.217.194.0-255,1484,101017,7,311542
38561,0.001825,172.217.194.0-255,2902,103919,7,311542
38562,0.001827,172.31.36.0-255,66,103985,7,311542
38563,0.001848,172.217.194.0-255,5738,109723,7,311542
38564,0.001851,172.31.36.0-255,66,109789,7,311542
38565,0.001853,172.217.194.0-255,1484,111273,7,311542
38566,0.001871,172.217.194.0-255,5738,117011,7,311542
38567,0.001873,172.31.36.0-255,66,117077,7,311542
38568,0.001893,172.217.194.0-255,5738,122815,7,311542
38569,0.001896,172.31.36.0-255,66,122881,7,311542
38570,0.001907,172.31.36.0-255,66,122947,7,311542
38571,0.003875,172.217.194.0-255,5738,128685,7,311542
38572,0.003882,172.31.36.0-255,66,128751,7,311542
38573,0.005867,172.217.194.0-255,2902,131653,7,311542
38574,0.005873,172.31.36.0-255,66,131719,7,311542
38575,0.005889,172.217.194.0-255,2902,134621,7,311542
38576,0.005891,172.31.36.0-255,66,134687,7,311542
38577,0.007842,172.217.194.0-255,5738,140425,7,311542
38578,0.007849,172.31.36.0-255,66,140491,7,311542
38579,0.009811,172.217.194.0-255,5738,146229,7,311542
38580,0.009819,172.31.36.0-255,66,146295,7,311542
38581,0.011781,172.217.194.0-255,5738,152033,7,311542
38582,0.011789,172.31.36.0-255,66,152099,7,311542
38583,0.013802,172.217.194.0-255,5738,157837,7,311542
38584,0.013811,172.31.36.0-255,66,157903,7,311542
38585,0.015781,172.217.194.0-255,5738,163641,7,311542
38586,0.015794,172.31.36.0-255,66,163707,7,311542
38587,0.017792,172.217.194.0-255,5738,169445,7,311542
38588,0.017801,172.31.36.0-255,66,169511,7,311542
38589,0.019762,172.217.194.0-255,5738,175249,7,311542
38590,0.01977,172.31.36.0-255,66,175315,7,311542
38591,0.021706,172.217.194.0-255,5738,181053,7,311542
38592,0.021713,172.31.36.0-255,66,181119,7,311542
38593,0.023667,172.217.194.0-255,5738,186857,7,311542
38594,0.023676,172.31.36.0-255,66,186923,7,311542
38595,0.025648,172.217.194.0-255,5738,192661,7,311542
38596,0.025658,172.31.36.0-255,66,192727,7,311542
38597,0.027646,172.217.194.0-255,5738,198465,7,311542
38598,0.027653,172.31.36.0-255,66,198531,7,311542
38599,0.029618,172.217.194.0-255,5738,204269,7,311542
38600,0.029633,172.31.36.0-255,66,204335,7,311542
38601,0.031571,172.217.194.0-255,5738,210073,7,311542
38602,0.031583,172.31.36.0-255,66,210139,7,311542
38603,0.033533,172.217.194.0-255,5738,215877,7,311542
38604,0.03354,172.31.36.0-255,66,215943,7,311542
38605,0.034376,172.31.36.0-255,172,216115,7,311542
38606,0.034468,172.31.36.0-255,1114,217229,7,311542
38607,0.034821,172.31.36.0-255,1514,218743,7,311542
38608,0.034824,172.31.36.0-255,1292,220035,7,311542
38609,0.035508,172.217.194.0-255,5738,225773,7,311542
38610,0.035514,172.31.36.0-255,66,225839,7,311542
38611,0.035942,104.244.42.0-255,66,225905,7,311542
38612,0.036041,104.244.42.0-255,66,225971,7,311542
38613,0.036372,104.244.42.0-255,66,226037,7,311542
38614,0.037435,172.217.194.0-255,4320,230357,7,311542
38615,0.037439,172.31.36.0-255,66,230423,7,311542
38616,0.03747,172.217.194.0-255,1484,231907,7,311542
38617,0.039396,172.217.194.0-255,4320,236227,7,311542
38618,0.039402,172.31.36.0-255,66,236293,7,311542
38619,0.041358,172.217.194.0-255,5738,242031,7,311542
38620,0.041363,172.31.36.0-255,66,242097,7,311542
38621,0.043339,172.217.194.0-255,5738,247835,7,311542
38622,0.043345,172.31.36.0-255,66,247901,7,311542
38623,0.045336,172.217.194.0-255,5738,253639,7,311542
38624,0.045342,172.31.36.0-255,66,253705,7,311542
38625,0.047297,172.217.194.0-255,5738,259443,7,311542
38626,0.047304,172.31.36.0-255,66,259509,7,311542
38627,0.049264,172.217.194.0-255,5738,265247,7,311542
38628,0.049271,172.31.36.0-255,66,265313,7,311542
38629,0.051243,172.217.194.0-255,5738,271051,7,311542
38630,0.051254,172.31.36.0-255,66,271117,7,311542
38631,0.053231,172.217.194.0-255,5738,276855,7,311542
38632,0.053237,172.31.36.0-255,66,276921,7,311542
38633,0.055182,172.217.194.0-255,5738,282659,7,311542
38634,0.055186,172.31.36.0-255,66,282725,7,311542
38635,0.057145,172.217.194.0-255,5738,288463,7,311542
38636,0.057151,172.31.36.0-255,66,288529,7,311542
38637,0.05911,172.217.194.0-255,5738,294267,7,311542
38638,0.059116,172.31.36.0-255,66,294333,7,311542
38639,0.061092,172.217.194.0-255,5738,300071,7,311542
38640,0.061098,172.31.36.0-255,66,300137,7,311542
38641,0.063062,172.217.194.0-255,5738,305875,7,311542
38642,0.063069,172.31.36.0-255,66,305941,7,311542
38643,0.065032,172.217.194.0-255,5364,311305,7,311542
38644,0.065039,172.31.36.0-255,66,311371,7,311542
38645,0.065264,172.31.36.0-255,105,311476,7,311542
38646,0.067152,172.217.194.0-255,66,311542,7,311542
38647,0.0,172.31.36.0-255,105,105,7,302668
38648,0.027725,74.125.24.0-255,152,257,7,302668
38649,0.027745,172.31.36.0-255,66,323,7,302668
38650,0.027752,74.125.24.0-255,1484,1807,7,302668
38651,0.027756,172.31.36.0-255,66,1873,7,302668
38652,0.027762,74.125.24.0-255,2902,4775,7,302668
38653,0.027765,172.31.36.0-255,66,4841,7,302668
38654,0.027771,74.125.24.0-255,4320,9161,7,302668
38655,0.027775,172.31.36.0-255,66,9227,7,302668
38656,0.027817,172.31.36.0-255,66,9293,7,302668
38657,0.027825,74.125.24.0-255,7156,16449,7,302668
38658,0.027828,172.31.36.0-255,66,16515,7,302668
38659,0.027854,74.125.24.0-255,2902,19417,7,302668
38660,0.027857,172.31.36.0-255,66,19483,7,302668
38661,0.027876,74.125.24.0-255,2543,22026,7,302668
38662,0.027878,172.31.36.0-255,66,22092,7,302668
38663,0.027959,74.125.24.0-255,1484,23576,7,302668
38664,0.027962,172.31.36.0-255,66,23642,7,302668
38665,0.027976,74.125.24.0-255,2902,26544,7,302668
38666,0.027979,172.31.36.0-255,66,26610,7,302668
38667,0.027987,74.125.24.0-255,5738,32348,7,302668
38668,0.027989,172.31.36.0-255,66,32414,7,302668
38669,0.028022,74.125.24.0-255,6797,39211,7,302668
38670,0.028026,172.31.36.0-255,66,39277,7,302668
38671,0.028063,172.31.36.0-255,66,39343,7,302668
38672,0.028067,74.125.24.0-255,2543,41886,7,302668
38673,0.028069,172.31.36.0-255,66,41952,7,302668
38674,0.028087,74.125.24.0-255,362,42314,7,302668
38675,0.028089,172.31.36.0-255,66,42380,7,302668
38676,0.028164,74.125.24.0-255,1484,43864,7,302668
38677,0.028168,172.31.36.0-255,66,43930,7,302668
38678,0.028172,74.125.24.0-255,2902,46832,7,302668
38679,0.028175,172.31.36.0-255,66,46898,7,302668
38680,0.028178,74.125.24.0-255,1484,48382,7,302668
38681,0.028195,74.125.24.0-255,4320,52702,7,302668
38682,0.028198,172.31.36.0-255,66,52768,7,302668
38683,0.02823,74.125.24.0-255,7091,59859,7,302668
38684,0.028233,172.31.36.0-255,66,59925,7,302668
38685,0.028241,74.125.24.0-255,7156,67081,7,302668
38686,0.028244,172.31.36.0-255,66,67147,7,302668
38687,0.02828,172.31.36.0-255,66,67213,7,302668
38688,0.028381,74.125.24.0-255,1484,68697,7,302668
38689,0.028388,74.125.24.0-255,2902,71599,7,302668
38690,0.028391,172.31.36.0-255,66,71665,7,302668
38691,0.028398,74.125.24.0-255,5738,77403,7,302668
38692,0.028401,172.31.36.0-255,66,77469,7,302668
38693,0.028407,74.125.24.0-255,4320,81789,7,302668
38694,0.02841,172.31.36.0-255,66,81855,7,302668
38695,0.028428,74.125.24.0-255,1484,83339,7,302668
38696,0.028437,74.125.24.0-255,7156,90495,7,302668
38697,0.028439,172.31.36.0-255,66,90561,7,302668
38698,0.028455,74.125.24.0-255,2902,93463,7,302668
38699,0.028457,172.31.36.0-255,66,93529,7,302668
38700,0.028487,172.31.36.0-255,66,93595,7,302668
38701,0.028495,74.125.24.0-255,7156,100751,7,302668
38702,0.028498,172.31.36.0-255,66,100817,7,302668
38703,0.02851,74.125.24.0-255,1484,102301,7,302668
38704,0.028528,74.125.24.0-255,7156,109457,7,302668
38705,0.028531,172.31.36.0-255,66,109523,7,302668
38706,0.028568,172.31.36.0-255,66,109589,7,302668
38707,0.028571,74.125.24.0-255,1484,111073,7,302668
38708,0.028577,74.125.24.0-255,2902,113975,7,302668
38709,0.02858,172.31.36.0-255,66,114041,7,302668
38710,0.028643,74.125.24.0-255,5738,119779,7,302668
38711,0.028647,172.31.36.0-255,66,119845,7,302668
38712,0.028655,74.125.24.0-255,6797,126642,7,302668
38713,0.028657,172.31.36.0-255,66,126708,7,302668
38714,0.028692,74.125.24.0-255,1484,128192,7,302668
38715,0.028696,74.125.24.0-255,1484,129676,7,302668
38716,0.028698,172.31.36.0-255,66,129742,7,302668
38717,0.028719,74.125.24.0-255,1484,131226,7,302668
38718,0.028726,74.125.24.0-255,5738,136964,7,302668
38719,0.028728,172.31.36.0-255,66,137030,7,302668
38720,0.028757,74.125.24.0-255,7156,144186,7,302668
38721,0.028761,172.31.36.0-255,66,144252,7,302668
38722,0.028777,74.125.24.0-255,5738,149990,7,302668
38723,0.02878,172.31.36.0-255,66,150056,7,302668
38724,0.028788,74.125.24.0-255,7156,157212,7,302668
38725,0.028818,74.125.24.0-255,3602,160814,7,302668
38726,0.0289,172.31.36.0-255,66,160880,7,302668
38727,0.02898,74.125.24.0-255,1484,162364,7,302668
38728,0.028987,74.125.24.0-255,2902,165266,7,302668
38729,0.028993,74.125.24.0-255,5738,171004,7,302668
38730,0.029011,74.125.24.0-255,1484,172488,7,302668
38731,0.029051,74.125.24.0-255,5738,178226,7,302668
38732,0.029084,74.125.24.0-255,5738,183964,7,302668
38733,0.029104,172.31.36.0-255,66,184030,7,302668
38734,0.029128,74.125.24.0-255,7156,191186,7,302668
38735,0.029131,172.31.36.0-255,66,191252,7,302668
38736,0.029137,172.31.36.0-255,66,191318,7,302668
38737,0.029155,74.125.24.0-255,1484,192802,7,302668
38738,0.029173,74.125.24.0-255,7156,199958,7,302668
38739,0.029183,172.31.36.0-255,66,200024,7,302668
38740,0.02919,74.125.24.0-255,2184,202208,7,302668
38741,0.029198,172.31.36.0-255,66,202274,7,302668
38742,0.029211,74.125.24.0-255,1484,203758,7,302668
38743,0.029215,74.125.24.0-255,2902,206660,7,302668
38744,0.029218,74.125.24.0-255,1484,208144,7,302668
38745,0.029227,172.31.36.0-255,66,208210,7,302668
38746,0.029238,74.125.24.0-255,4320,212530,7,302668
38747,0.029242,172.31.36.0-255,66,212596,7,302668
38748,0.029245,74.125.24.0-255,7156,219752,7,302668
38749,0.02926,172.31.36.0-255,66,219818,7,302668
38750,0.029267,74.125.24.0-255,2902,222720,7,302668
38751,0.029279,172.31.36.0-255,66,222786,7,302668
38752,0.029291,74.125.24.0-255,2902,225688,7,302668
38753,0.029299,172.31.36.0-255,66,225754,7,302668
38754,0.029315,74.125.24.0-255,7156,232910,7,302668
38755,0.029335,74.125.24.0-255,3602,236512,7,302668
38756,0.029336,172.31.36.0-255,66,236578,7,302668
38757,0.029341,172.31.36.0-255,66,236644,7,302668
38758,0.029523,74.125.24.0-255,1484,238128,7,302668
38759,0.029537,74.125.24.0-255,2902,241030,7,302668
38760,0.02954,172.31.36.0-255,66,241096,7,302668
38761,0.029554,74.125.24.0-255,4320,245416,7,302668
38762,0.02956,172.31.36.0-255,66,245482,7,302668
38763,0.029567,74.125.24.0-255,1484,246966,7,302668
38764,0.02957,74.125.24.0-255,1484,248450,7,302668
38765,0.029574,172.31.36.0-255,66,248516,7,302668
38766,0.029597,74.125.24.0-255,7156,255672,7,302668
38767,0.029605,172.31.36.0-255,66,255738,7,302668
38768,0.0297,172.31.36.0-255,66,255804,7,302668
38769,0.029706,74.125.24.0-255,6438,262242,7,302668
38770,0.029713,74.125.24.0-255,7156,269398,7,302668
38771,0.029715,172.31.36.0-255,66,269464,7,302668
38772,0.02972,172.31.36.0-255,66,269530,7,302668
38773,0.029734,172.31.36.0-255,66,269596,7,302668
38774,0.029754,74.125.24.0-255,1484,271080,7,302668
38775,0.029773,74.125.24.0-255,2902,273982,7,302668
38776,0.029776,74.125.24.0-255,1484,275466,7,302668
38777,0.029776,172.31.36.0-255,66,275532,7,302668
38778,0.029798,74.125.24.0-255,4320,279852,7,302668
38779,0.029803,74.125.24.0-255,2902,282754,7,302668
38780,0.029813,172.31.36.0-255,66,282820,7,302668
38781,0.029822,74.125.24.0-255,2902,285722,7,302668
38782,0.029828,172.31.36.0-255,66,285788,7,302668
38783,0.029847,74.125.24.0-255,5738,291526,7,302668
38784,0.029853,172.31.36.0-255,66,291592,7,302668
38785,0.029879,74.125.24.0-255,7156,298748,7,302668
38786,0.029881,74.125.24.0-255,1194,299942,7,302668
38787,0.029884,74.125.24.0-255,97,300039,7,302668
38788,0.02989,172.31.36.0-255,66,300105,7,302668
38789,0.029938,74.125.24.0-255,105,300210,7,302668
38790,0.032434,172.31.36.0-255,66,300276,7,302668
38791,0.032462,172.31.36.0-255,105,300381,7,302668
38792,0.034724,74.125.24.0-255,66,300447,7,302668
38793,0.061533,172.31.36.0-255,172,300619,7,302668
38794,0.061562,172.31.36.0-255,1113,301732,7,302668
38795,0.061592,172.31.36.0-255,567,302299,7,302668
38796,0.063063,104.244.42.0-255,66,302365,7,302668
38797,0.0631,104.244.42.0-255,66,302431,7,302668
38798,0.063144,104.244.42.0-255,66,302497,7,302668
38799,0.074281,31.13.82.0-255,105,302602,7,302668
38800,0.074297,172.31.36.0-255,66,302668,7,302668
38801,0.0,172.217.194.0-255,146,146,7,292200
38802,1.9e-05,172.31.36.0-255,66,212,7,292200
38803,2.6e-05,172.217.194.0-255,1484,1696,7,292200
38804,3e-05,172.31.36.0-255,66,1762,7,292200
38805,3.6e-05,172.217.194.0-255,2902,4664,7,292200
38806,4.7e-05,172.31.36.0-255,66,4730,7,292200
38807,5.5e-05,172.217.194.0-255,5738,10468,7,292200
38808,5.8e-05,172.31.36.0-255,66,10534,7,292200
38809,7.8e-05,172.217.194.0-255,1484,12018,7,292200
38810,8e-05,172.31.36.0-255,66,12084,7,292200
38811,9e-05,172.217.194.0-255,2002,14086,7,292200
38812,9.3e-05,172.31.36.0-255,66,14152,7,292200
38813,0.000319,172.217.194.0-255,1484,15636,7,292200
38814,0.000325,172.31.36.0-255,66,15702,7,292200
38815,0.000346,172.217.194.0-255,2902,18604,7,292200
38816,0.000349,172.31.36.0-255,66,18670,7,292200
38817,0.000356,172.217.194.0-255,5738,24408,7,292200
38818,0.000358,172.31.36.0-255,66,24474,7,292200
38819,0.000388,172.217.194.0-255,5738,30212,7,292200
38820,0.000392,172.31.36.0-255,66,30278,7,292200
38821,0.000434,172.31.36.0-255,66,30344,7,292200
38822,0.000452,172.31.36.0-255,66,30410,7,292200
38823,0.000457,172.217.194.0-255,4320,34730,7,292200
38824,0.000459,172.31.36.0-255,66,34796,7,292200
38825,0.000507,172.31.36.0-255,66,34862,7,292200
38826,0.00051,172.217.194.0-255,380,35242,7,292200
38827,0.000512,172.31.36.0-255,66,35308,7,292200
38828,0.000724,172.217.194.0-255,364,35672,7,292200
38829,0.000727,172.31.36.0-255,66,35738,7,292200
38830,0.001358,172.217.194.0-255,1484,37222,7,292200
38831,0.001364,172.31.36.0-255,66,37288,7,292200
38832,0.001374,172.217.194.0-255,2902,40190,7,292200
38833,0.001376,172.31.36.0-255,66,40256,7,292200
38834,0.001389,172.217.194.0-255,5738,45994,7,292200
38835,0.001391,172.31.36.0-255,66,46060,7,292200
38836,0.001427,172.31.36.0-255,66,46126,7,292200
38837,0.00144,172.31.36.0-255,66,46192,7,292200
38838,0.001564,172.217.194.0-255,1484,47676,7,292200
38839,0.001569,172.31.36.0-255,66,47742,7,292200
38840,0.001585,172.217.194.0-255,2902,50644,7,292200
38841,0.001587,172.31.36.0-255,66,50710,7,292200
38842,0.001599,172.217.194.0-255,5738,56448,7,292200
38843,0.001601,172.31.36.0-255,66,56514,7,292200
38844,0.001669,172.31.36.0-255,66,56580,7,292200
38845,0.001673,172.217.194.0-255,1484,58064,7,292200
38846,0.001675,172.31.36.0-255,66,58130,7,292200
38847,0.001687,172.31.36.0-255,66,58196,7,292200
38848,0.00183,172.217.194.0-255,1484,59680,7,292200
38849,0.001834,172.31.36.0-255,66,59746,7,292200
38850,0.00184,172.217.194.0-255,2902,62648,7,292200
38851,0.001843,172.31.36.0-255,66,62714,7,292200
38852,0.001846,172.217.194.0-255,1484,64198,7,292200
38853,0.001853,172.31.36.0-255,66,64264,7,292200
38854,0.001891,172.217.194.0-255,4320,68584,7,292200
38855,0.001894,172.31.36.0-255,66,68650,7,292200
38856,0.001908,172.31.36.0-255,66,68716,7,292200
38857,0.001921,172.31.36.0-255,66,68782,7,292200
38858,0.001924,172.217.194.0-255,766,69548,7,292200
38859,0.003971,172.217.194.0-255,4320,73868,7,292200
38860,0.00533,172.31.36.0-255,66,73934,7,292200
38861,0.007377,172.217.194.0-255,5738,79672,7,292200
38862,0.007383,172.31.36.0-255,66,79738,7,292200
38863,0.009444,172.217.194.0-255,5738,85476,7,292200
38864,0.009451,172.31.36.0-255,66,85542,7,292200
38865,0.0115,172.217.194.0-255,5738,91280,7,292200
38866,0.011508,172.31.36.0-255,66,91346,7,292200
38867,0.013535,172.217.194.0-255,5738,97084,7,292200
38868,0.013544,172.31.36.0-255,66,97150,7,292200
38869,0.015567,172.217.194.0-255,5738,102888,7,292200
38870,0.015575,172.31.36.0-255,66,102954,7,292200
38871,0.017626,172.217.194.0-255,5738,108692,7,292200
38872,0.017633,172.31.36.0-255,66,108758,7,292200
38873,0.019672,172.217.194.0-255,5738,114496,7,292200
38874,0.019681,172.31.36.0-255,66,114562,7,292200
38875,0.021719,172.217.194.0-255,5738,120300,7,292200
38876,0.021726,172.31.36.0-255,66,120366,7,292200
38877,0.023757,172.217.194.0-255,5738,126104,7,292200
38878,0.023768,172.31.36.0-255,66,126170,7,292200
38879,0.025812,172.217.194.0-255,5738,131908,7,292200
38880,0.025824,172.31.36.0-255,66,131974,7,292200
38881,0.02786,172.217.194.0-255,5738,137712,7,292200
38882,0.027871,172.31.36.0-255,66,137778,7,292200
38883,0.029915,172.217.194.0-255,5738,143516,7,292200
38884,0.029923,172.31.36.0-255,66,143582,7,292200
38885,0.031963,172.217.194.0-255,2902,146484,7,292200
38886,0.031969,172.31.36.0-255,66,146550,7,292200
38887,0.031976,172.31.36.0-255,172,146722,7,292200
38888,0.031997,172.217.194.0-255,2902,149624,7,292200
38889,0.032,172.31.36.0-255,66,149690,7,292200
38890,0.032034,172.31.36.0-255,1113,150803,7,292200
38891,0.032107,172.31.36.0-255,1514,152317,7,292200
38892,0.032109,172.31.36.0-255,1514,153831,7,292200
38893,0.032114,172.31.36.0-255,1514,155345,7,292200
38894,0.032116,172.31.36.0-255,1514,156859,7,292200
38895,0.032148,172.31.36.0-255,1514,158373,7,292200
38896,0.03215,172.31.36.0-255,71,158444,7,292200
38897,0.033514,104.244.42.0-255,66,158510,7,292200
38898,0.033614,104.244.42.0-255,66,158576,7,292200
38899,0.033713,104.244.42.0-255,66,158642,7,292200
38900,0.033719,104.244.42.0-255,66,158708,7,292200
38901,0.034012,172.217.194.0-255,5738,164446,7,292200
38902,0.034019,172.31.36.0-255,66,164512,7,292200
38903,0.036088,172.217.194.0-255,5738,170250,7,292200
38904,0.036097,172.31.36.0-255,66,170316,7,292200
38905,0.038149,172.217.194.0-255,5738,176054,7,292200
38906,0.038156,172.31.36.0-255,66,176120,7,292200
38907,0.040224,172.217.194.0-255,5738,181858,7,292200
38908,0.040231,172.31.36.0-255,66,181924,7,292200
38909,0.042286,172.217.194.0-255,5738,187662,7,292200
38910,0.042296,172.31.36.0-255,66,187728,7,292200
38911,0.044335,172.217.194.0-255,5738,193466,7,292200
38912,0.044342,172.31.36.0-255,66,193532,7,292200
38913,0.046387,172.217.194.0-255,5738,199270,7,292200
38914,0.046395,172.31.36.0-255,66,199336,7,292200
38915,0.048488,172.217.194.0-255,5738,205074,7,292200
38916,0.048495,172.31.36.0-255,66,205140,7,292200
38917,0.050559,172.217.194.0-255,5738,210878,7,292200
38918,0.050566,172.31.36.0-255,66,210944,7,292200
38919,0.052629,172.217.194.0-255,5738,216682,7,292200
38920,0.052636,172.31.36.0-255,66,216748,7,292200
38921,0.054667,172.217.194.0-255,5738,222486,7,292200
38922,0.054674,172.31.36.0-255,66,222552,7,292200
38923,0.056728,172.217.194.0-255,5738,228290,7,292200
38924,0.056736,172.31.36.0-255,66,228356,7,292200
38925,0.058782,172.217.194.0-255,5738,234094,7,292200
38926,0.058789,172.31.36.0-255,66,234160,7,292200
38927,0.060831,172.217.194.0-255,5738,239898,7,292200
38928,0.060839,172.31.36.0-255,66,239964,7,292200
38929,0.062863,172.217.194.0-255,5738,245702,7,292200
38930,0.06287,172.31.36.0-255,66,245768,7,292200
38931,0.064893,172.217.194.0-255,5738,251506,7,292200
38932,0.064899,172.31.36.0-255,66,251572,7,292200
38933,0.066909,172.217.194.0-255,5738,257310,7,292200
38934,0.066915,172.31.36.0-255,66,257376,7,292200
38935,0.068952,172.217.194.0-255,5738,263114,7,292200
38936,0.068959,172.31.36.0-255,66,263180,7,292200
38937,0.070986,172.217.194.0-255,5738,268918,7,292200
38938,0.070993,172.31.36.0-255,66,268984,7,292200
38939,0.073055,172.217.194.0-255,5738,274722,7,292200
38940,0.073062,172.31.36.0-255,66,274788,7,292200
38941,0.075142,172.217.194.0-255,5738,280526,7,292200
38942,0.075148,172.31.36.0-255,66,280592,7,292200
38943,0.077184,172.217.194.0-255,5738,286330,7,292200
38944,0.077192,172.31.36.0-255,66,286396,7,292200
38945,0.079348,172.217.194.0-255,5738,292134,7,292200
38946,0.079356,172.31.36.0-255,66,292200,7,292200
38947,0.0,172.31.36.0-255,105,105,7,276
38948,0.001763,157.240.13.0-255,105,210,7,276
38949,0.001778,172.31.36.0-255,66,276,7,276
38950,0.0,74.125.24.0-255,152,152,7,156128
38951,2.2e-05,172.31.36.0-255,66,218,7,156128
38952,3e-05,74.125.24.0-255,1484,1702,7,156128
38953,3.5e-05,172.31.36.0-255,66,1768,7,156128
38954,4.9e-05,74.125.24.0-255,2902,4670,7,156128
38955,5.3e-05,172.31.36.0-255,66,4736,7,156128
38956,5.9e-05,74.125.24.0-255,4320,9056,7,156128
38957,6.2e-05,172.31.36.0-255,66,9122,7,156128
38958,7.5e-05,172.31.36.0-255,66,9188,7,156128
38959,0.000112,172.31.36.0-255,66,9254,7,156128
38960,0.000195,74.125.24.0-255,1484,10738,7,156128
38961,0.000198,172.31.36.0-255,66,10804,7,156128
38962,0.000204,74.125.24.0-255,2902,13706,7,156128
38963,0.000206,172.31.36.0-255,66,13772,7,156128
38964,0.000237,74.125.24.0-255,5738,19510,7,156128
38965,0.00024,172.31.36.0-255,66,19576,7,156128
38966,0.000248,74.125.24.0-255,6797,26373,7,156128
38967,0.00025,172.31.36.0-255,66,26439,7,156128
38968,0.000286,172.31.36.0-255,66,26505,7,156128
38969,0.000292,74.125.24.0-255,2854,29359,7,156128
38970,0.000293,172.31.36.0-255,66,29425,7,156128
38971,0.000357,74.125.24.0-255,109,29534,7,156128
38972,0.000361,172.31.36.0-255,66,29600,7,156128
38973,0.000532,74.125.24.0-255,1484,31084,7,156128
38974,0.000536,172.31.36.0-255,66,31150,7,156128
38975,0.000543,74.125.24.0-255,2902,34052,7,156128
38976,0.000545,172.31.36.0-255,66,34118,7,156128
38977,0.000579,74.125.24.0-255,5738,39856,7,156128
38978,0.000582,172.31.36.0-255,66,39922,7,156128
38979,0.000587,74.125.24.0-255,2902,42824,7,156128
38980,0.000589,172.31.36.0-255,66,42890,7,156128
38981,0.000634,172.31.36.0-255,66,42956,7,156128
38982,0.000648,172.31.36.0-255,66,43022,7,156128
38983,0.000651,74.125.24.0-255,1125,44147,7,156128
38984,0.001142,74.125.24.0-255,1484,45631,7,156128
38985,0.001147,172.31.36.0-255,66,45697,7,156128
38986,0.001153,74.125.24.0-255,2902,48599,7,156128
38987,0.001155,172.31.36.0-255,66,48665,7,156128
38988,0.001159,74.125.24.0-255,1484,50149,7,156128
38989,0.001189,74.125.24.0-255,4320,54469,7,156128
38990,0.001192,172.31.36.0-255,66,54535,7,156128
38991,0.001207,172.31.36.0-255,66,54601,7,156128
38992,0.001214,74.125.24.0-255,5738,60339,7,156128
38993,0.001217,172.31.36.0-255,66,60405,7,156128
38994,0.001273,74.125.24.0-255,5020,65425,7,156128
38995,0.001276,172.31.36.0-255,66,65491,7,156128
38996,0.001341,74.125.24.0-255,1484,66975,7,156128
38997,0.001347,74.125.24.0-255,2902,69877,7,156128
38998,0.001349,172.31.36.0-255,66,69943,7,156128
38999,0.001371,74.125.24.0-255,5738,75681,7,156128
39000,0.001377,172.31.36.0-255,66,75747,7,156128
39001,0.001441,172.31.36.0-255,66,75813,7,156128
39002,0.001471,74.125.24.0-255,4320,80133,7,156128
39003,0.001474,172.31.36.0-255,66,80199,7,156128
39004,0.00148,74.125.24.0-255,4320,84519,7,156128
39005,0.001482,172.31.36.0-255,66,84585,7,156128
39006,0.00149,74.125.24.0-255,6438,91023,7,156128
39007,0.001493,172.31.36.0-255,66,91089,7,156128
39008,0.001716,74.125.24.0-255,1484,92573,7,156128
39009,0.001733,74.125.24.0-255,2902,95475,7,156128
39010,0.001736,172.31.36.0-255,66,95541,7,156128
39011,0.001766,74.125.24.0-255,5738,101279,7,156128
39012,0.001768,172.31.36.0-255,66,101345,7,156128
39013,0.001772,74.125.24.0-255,1484,102829,7,156128
39014,0.001801,74.125.24.0-255,4320,107149,7,156128
39015,0.001804,172.31.36.0-255,66,107215,7,156128
39016,0.001825,74.125.24.0-255,4320,111535,7,156128
39017,0.001827,172.31.36.0-255,66,111601,7,156128
39018,0.001835,74.125.24.0-255,7156,118757,7,156128
39019,0.001839,172.31.36.0-255,66,118823,7,156128
39020,0.001877,74.125.24.0-255,6438,125261,7,156128
39021,0.00188,172.31.36.0-255,66,125327,7,156128
39022,0.002066,74.125.24.0-255,1484,126811,7,156128
39023,0.002073,74.125.24.0-255,2902,129713,7,156128
39024,0.002076,172.31.36.0-255,66,129779,7,156128
39025,0.002081,74.125.24.0-255,2902,132681,7,156128
39026,0.002083,172.31.36.0-255,66,132747,7,156128
39027,0.002105,74.125.24.0-255,2902,135649,7,156128
39028,0.002108,172.31.36.0-255,66,135715,7,156128
39029,0.002134,172.31.36.0-255,66,135781,7,156128
39030,0.002142,74.125.24.0-255,7156,142937,7,156128
39031,0.002145,172.31.36.0-255,66,143003,7,156128
39032,0.002206,172.31.36.0-255,66,143069,7,156128
39033,0.002217,172.31.36.0-255,66,143135,7,156128
39034,0.002264,172.31.36.0-255,66,143201,7,156128
39035,0.002293,74.125.24.0-255,5020,148221,7,156128
39036,0.002296,172.31.36.0-255,66,148287,7,156128
39037,0.002317,172.31.36.0-255,66,148353,7,156128
39038,0.002361,172.31.36.0-255,66,148419,7,156128
39039,0.002388,172.31.36.0-255,66,148485,7,156128
39040,0.002483,172.31.36.0-255,66,148551,7,156128
39041,0.00251,172.31.36.0-255,66,148617,7,156128
39042,0.002539,74.125.24.0-255,2902,151519,7,156128
39043,0.002541,172.31.36.0-255,66,151585,7,156128
39044,0.002574,172.31.36.0-255,66,151651,7,156128
39045,0.00976,172.31.36.0-255,105,151756,7,156128
39046,0.012249,74.125.24.0-255,66,151822,7,156128
39047,0.032172,172.31.36.0-255,188,152010,7,156128
39048,0.032212,172.31.36.0-255,958,152968,7,156128
39049,0.033693,104.244.42.0-255,66,153034,7,156128
39050,0.033738,104.244.42.0-255,66,153100,7,156128
39051,0.03439,172.31.36.0-255,1514,154614,7,156128
39052,0.034393,172.31.36.0-255,1448,156062,7,156128
39053,0.035975,104.244.42.0-255,66,156128,7,156128
39054,0.0,91.189.92.0-255,97,97,7,458
39055,3.8e-05,172.31.36.0-255,66,163,7,458
39056,0.000106,172.31.36.0-255,97,260,7,458
39057,0.000125,172.31.36.0-255,66,326,7,458
39058,0.000126,91.189.92.0-255,66,392,7,458
39059,0.000131,172.31.36.0-255,66,458,7,458
39060,0.0,74.125.24.0-255,146,146,7,298986
39061,1.4e-05,172.31.36.0-255,66,212,7,298986
39062,2e-05,74.125.24.0-255,1484,1696,7,298986
39063,2.5e-05,172.31.36.0-255,66,1762,7,298986
39064,3.8e-05,74.125.24.0-255,2902,4664,7,298986
39065,4.2e-05,172.31.36.0-255,66,4730,7,298986
39066,8.1e-05,74.125.24.0-255,5738,10468,7,298986
39067,8.5e-05,172.31.36.0-255,66,10534,7,298986
39068,0.000121,172.31.36.0-255,66,10600,7,298986
39069,0.000129,74.125.24.0-255,6797,17397,7,298986
39070,0.000131,172.31.36.0-255,66,17463,7,298986
39071,0.000475,74.125.24.0-255,1484,18947,7,298986
39072,0.000482,172.31.36.0-255,66,19013,7,298986
39073,0.000489,74.125.24.0-255,2902,21915,7,298986
39074,0.000491,172.31.36.0-255,66,21981,7,298986
39075,0.000504,74.125.24.0-255,5738,27719,7,298986
39076,0.000507,172.31.36.0-255,66,27785,7,298986
39077,0.000551,172.31.36.0-255,66,27851,7,298986
39078,0.000566,172.31.36.0-255,66,27917,7,298986
39079,0.000598,74.125.24.0-255,131,28048,7,298986
39080,0.000601,172.31.36.0-255,66,28114,7,298986
39081,0.000742,74.125.24.0-255,1484,29598,7,298986
39082,0.000748,172.31.36.0-255,66,29664,7,298986
39083,0.000775,74.125.24.0-255,2902,32566,7,298986
39084,0.000778,172.31.36.0-255,66,32632,7,298986
39085,0.000784,74.125.24.0-255,5738,38370,7,298986
39086,0.000787,172.31.36.0-255,66,38436,7,298986
39087,0.000812,74.125.24.0-255,2902,41338,7,298986
39088,0.000814,172.31.36.0-255,66,41404,7,298986
39089,0.000866,74.125.24.0-255,3961,45365,7,298986
39090,0.00087,172.31.36.0-255,66,45431,7,298986
39091,0.000886,172.31.36.0-255,66,45497,7,298986
39092,0.00089,74.125.24.0-255,2543,48040,7,298986
39093,0.000892,172.31.36.0-255,66,48106,7,298986
39094,0.000918,74.125.24.0-255,350,48456,7,298986
39095,0.001483,172.31.36.0-255,66,48522,7,298986
39096,0.001512,74.125.24.0-255,1484,50006,7,298986
39097,0.001518,74.125.24.0-255,2902,52908,7,298986
39098,0.001521,172.31.36.0-255,66,52974,7,298986
39099,0.001528,74.125.24.0-255,5738,58712,7,298986
39100,0.00153,172.31.36.0-255,66,58778,7,298986
39101,0.001566,172.31.36.0-255,66,58844,7,298986
39102,0.001569,74.125.24.0-255,1484,60328,7,298986
39103,0.001595,74.125.24.0-255,2902,63230,7,298986
39104,0.001597,172.31.36.0-255,66,63296,7,298986
39105,0.001604,74.125.24.0-255,5738,69034,7,298986
39106,0.001606,172.31.36.0-255,66,69100,7,298986
39107,0.001609,74.125.24.0-255,766,69866,7,298986
39108,0.001859,172.31.36.0-255,66,69932,7,298986
39109,0.001891,74.125.24.0-255,1484,71416,7,298986
39110,0.001898,74.125.24.0-255,2902,74318,7,298986
39111,0.0019,172.31.36.0-255,66,74384,7,298986
39112,0.001907,74.125.24.0-255,5738,80122,7,298986
39113,0.001909,172.31.36.0-255,66,80188,7,298986
39114,0.001914,74.125.24.0-255,2902,83090,7,298986
39115,0.001916,172.31.36.0-255,66,83156,7,298986
39116,0.001947,74.125.24.0-255,2902,86058,7,298986
39117,0.00195,172.31.36.0-255,66,86124,7,298986
39118,0.001963,172.31.36.0-255,66,86190,7,298986
39119,0.001969,74.125.24.0-255,5020,91210,7,298986
39120,0.001971,172.31.36.0-255,66,91276,7,298986
39121,0.002091,74.125.24.0-255,1484,92760,7,298986
39122,0.002097,74.125.24.0-255,2902,95662,7,298986
39123,0.0021,172.31.36.0-255,66,95728,7,298986
39124,0.002122,74.125.24.0-255,5738,101466,7,298986
39125,0.002125,172.31.36.0-255,66,101532,7,298986
39126,0.002128,74.125.24.0-255,1484,103016,7,298986
39127,0.002166,172.31.36.0-255,66,103082,7,298986
39128,0.002179,172.31.36.0-255,66,103148,7,298986
39129,0.004452,74.125.24.0-255,5738,108886,7,298986
39130,0.00446,172.31.36.0-255,66,108952,7,298986
39131,0.006753,74.125.24.0-255,5738,114690,7,298986
39132,0.006756,172.31.36.0-255,66,114756,7,298986
39133,0.009037,74.125.24.0-255,5738,120494,7,298986
39134,0.009044,172.31.36.0-255,66,120560,7,298986
39135,0.011352,74.125.24.0-255,5738,126298,7,298986
39136,0.01136,172.31.36.0-255,66,126364,7,298986
39137,0.013683,74.125.24.0-255,5738,132102,7,298986
39138,0.013692,172.31.36.0-255,66,132168,7,298986
39139,0.016006,74.125.24.0-255,5738,137906,7,298986
39140,0.016015,172.31.36.0-255,66,137972,7,298986
39141,0.018277,74.125.24.0-255,5738,143710,7,298986
39142,0.018285,172.31.36.0-255,66,143776,7,298986
39143,0.020558,74.125.24.0-255,5738,149514,7,298986
39144,0.020566,172.31.36.0-255,66,149580,7,298986
39145,0.022898,74.125.24.0-255,5738,155318,7,298986
39146,0.022908,172.31.36.0-255,66,155384,7,298986
39147,0.02522,74.125.24.0-255,5738,161122,7,298986
39148,0.025228,172.31.36.0-255,66,161188,7,298986
39149,0.027578,74.125.24.0-255,5738,166926,7,298986
39150,0.027585,172.31.36.0-255,66,166992,7,298986
39151,0.029182,172.31.36.0-255,188,167180,7,298986
39152,0.029213,172.31.36.0-255,958,168138,7,298986
39153,0.029277,172.31.36.0-255,1514,169652,7,298986
39154,0.029278,172.31.36.0-255,1448,171100,7,298986
39155,0.029882,74.125.24.0-255,5738,176838,7,298986
39156,0.029889,172.31.36.0-255,66,176904,7,298986
39157,0.030757,104.244.42.0-255,66,176970,7,298986
39158,0.030784,104.244.42.0-255,66,177036,7,298986
39159,0.030861,104.244.42.0-255,66,177102,7,298986
39160,0.032215,74.125.24.0-255,5738,182840,7,298986
39161,0.032221,172.31.36.0-255,66,182906,7,298986
39162,0.034526,74.125.24.0-255,5738,188644,7,298986
39163,0.034534,172.31.36.0-255,66,188710,7,298986
39164,0.036836,74.125.24.0-255,5738,194448,7,298986
39165,0.036844,172.31.36.0-255,66,194514,7,298986
39166,0.039163,74.125.24.0-255,5738,200252,7,298986
39167,0.03917,172.31.36.0-255,66,200318,7,298986
39168,0.041452,74.125.24.0-255,5738,206056,7,298986
39169,0.041461,172.31.36.0-255,66,206122,7,298986
39170,0.04379,74.125.24.0-255,5738,211860,7,298986
39171,0.043797,172.31.36.0-255,66,211926,7,298986
39172,0.046076,74.125.24.0-255,5738,217664,7,298986
39173,0.046083,172.31.36.0-255,66,217730,7,298986
39174,0.048375,74.125.24.0-255,5738,223468,7,298986
39175,0.048382,172.31.36.0-255,66,223534,7,298986
39176,0.050668,74.125.24.0-255,5738,229272,7,298986
39177,0.050674,172.31.36.0-255,66,229338,7,298986
39178,0.053022,74.125.24.0-255,5738,235076,7,298986
39179,0.053029,172.31.36.0-255,66,235142,7,298986
39180,0.055327,74.125.24.0-255,5738,240880,7,298986
39181,0.055335,172.31.36.0-255,66,240946,7,298986
39182,0.057651,74.125.24.0-255,5738,246684,7,298986
39183,0.057657,172.31.36.0-255,66,246750,7,298986
39184,0.05997,74.125.24.0-255,5738,252488,7,298986
39185,0.059978,172.31.36.0-255,66,252554,7,298986
39186,0.062264,74.125.24.0-255,5738,258292,7,298986
39187,0.06227,172.31.36.0-255,66,258358,7,298986
39188,0.064563,74.125.24.0-255,5738,264096,7,298986
39189,0.064569,172.31.36.0-255,66,264162,7,298986
39190,0.066881,74.125.24.0-255,5738,269900,7,298986
39191,0.066888,172.31.36.0-255,66,269966,7,298986
39192,0.06915,74.125.24.0-255,5738,275704,7,298986
39193,0.069157,172.31.36.0-255,66,275770,7,298986
39194,0.071482,74.125.24.0-255,5738,281508,7,298986
39195,0.071488,172.31.36.0-255,66,281574,7,298986
39196,0.073802,74.125.24.0-255,5738,287312,7,298986
39197,0.073809,172.31.36.0-255,66,287378,7,298986
39198,0.076068,74.125.24.0-255,5738,293116,7,298986
39199,0.076076,172.31.36.0-255,66,293182,7,298986
39200,0.078353,74.125.24.0-255,5738,298920,7,298986
39201,0.078361,172.31.36.0-255,66,298986,7,298986
39202,0.0,172.217.194.0-255,153,153,7,98920
39203,1.5e-05,172.31.36.0-255,66,219,7,98920
39204,2e-05,172.217.194.0-255,1484,1703,7,98920
39205,2.5e-05,172.31.36.0-255,66,1769,7,98920
39206,3.1e-05,172.217.194.0-255,2902,4671,7,98920
39207,3.5e-05,172.31.36.0-255,66,4737,7,98920
39208,6.2e-05,172.217.194.0-255,7156,11893,7,98920
39209,6.5e-05,172.31.36.0-255,66,11959,7,98920
39210,0.000147,172.217.194.0-255,1975,13934,7,98920
39211,0.00015,172.31.36.0-255,66,14000,7,98920
39212,0.000164,172.217.194.0-255,1484,15484,7,98920
39213,0.000167,172.31.36.0-255,66,15550,7,98920
39214,0.000197,172.31.36.0-255,66,15616,7,98920
39215,0.000312,172.217.194.0-255,5379,20995,7,98920
39216,0.000316,172.31.36.0-255,66,21061,7,98920
39217,0.000376,172.217.194.0-255,5738,26799,7,98920
39218,0.000379,172.31.36.0-255,66,26865,7,98920
39219,0.000441,172.217.194.0-255,5738,32603,7,98920
39220,0.000445,172.31.36.0-255,66,32669,7,98920
39221,0.000462,172.217.194.0-255,5379,38048,7,98920
39222,0.000465,172.31.36.0-255,66,38114,7,98920
39223,0.000601,172.31.36.0-255,66,38180,7,98920
39224,0.000765,172.217.194.0-255,647,38827,7,98920
39225,0.00077,172.31.36.0-255,66,38893,7,98920
39226,0.000865,172.217.194.0-255,1484,40377,7,98920
39227,0.000869,172.31.36.0-255,66,40443,7,98920
39228,0.000875,172.217.194.0-255,2902,43345,7,98920
39229,0.000877,172.31.36.0-255,66,43411,7,98920
39230,0.00089,172.217.194.0-255,1484,44895,7,98920
39231,0.000892,172.31.36.0-255,66,44961,7,98920
39232,0.00091,172.217.194.0-255,4320,49281,7,98920
39233,0.000916,172.31.36.0-255,66,49347,7,98920
39234,0.000972,172.217.194.0-255,4320,53667,7,98920
39235,0.000977,172.31.36.0-255,66,53733,7,98920
39236,0.001013,172.31.36.0-255,66,53799,7,98920
39237,0.001132,172.217.194.0-255,7156,60955,7,98920
39238,0.001136,172.31.36.0-255,66,61021,7,98920
39239,0.001153,172.217.194.0-255,2902,63923,7,98920
39240,0.001175,172.31.36.0-255,66,63989,7,98920
39241,0.001231,172.217.194.0-255,766,64755,7,98920
39242,0.00128,172.217.194.0-255,4320,69075,7,98920
39243,0.001283,172.31.36.0-255,66,69141,7,98920
39244,0.001288,172.31.36.0-255,66,69207,7,98920
39245,0.00143,172.31.36.0-255,66,69273,7,98920
39246,0.001473,172.31.36.0-255,66,69339,7,98920
39247,0.001678,172.31.36.0-255,66,69405,7,98920
39248,0.001744,172.31.36.0-255,66,69471,7,98920
39249,0.002129,172.31.36.0-255,66,69537,7,98920
39250,0.002175,172.31.36.0-255,66,69603,7,98920
39251,0.002492,172.217.194.0-255,2902,72505,7,98920
39252,0.002496,172.31.36.0-255,66,72571,7,98920
39253,0.002565,172.31.36.0-255,66,72637,7,98920
39254,0.00292,172.217.194.0-255,5738,78375,7,98920
39255,0.002925,172.31.36.0-255,66,78441,7,98920
39256,0.004559,172.217.194.0-255,7156,85597,7,98920
39257,0.004723,172.217.194.0-255,2902,88499,7,98920
39258,0.004771,172.217.194.0-255,5711,94210,7,98920
39259,0.008025,172.31.36.0-255,66,94276,7,98920
39260,0.008193,172.31.36.0-255,101,94377,7,98920
39261,0.00949,172.31.36.0-255,105,94482,7,98920
39262,0.010455,172.217.194.0-255,66,94548,7,98920
39263,0.011734,172.217.194.0-255,66,94614,7,98920
39264,0.036653,172.31.36.0-255,188,94802,7,98920
39265,0.036685,172.31.36.0-255,958,95760,7,98920
39266,0.036747,172.31.36.0-255,1514,97274,7,98920
39267,0.036749,172.31.36.0-255,1448,98722,7,98920
39268,0.038233,104.244.42.0-255,66,98788,7,98920
39269,0.038263,104.244.42.0-255,66,98854,7,98920
39270,0.038323,104.244.42.0-255,66,98920,7,98920
39271,0.0,172.217.194.0-255,152,152,7,201370
39272,2.5e-05,172.31.36.0-255,66,218,7,201370
39273,3.1e-05,172.217.194.0-255,1484,1702,7,201370
39274,3.4e-05,172.31.36.0-255,66,1768,7,201370
39275,3.8e-05,172.217.194.0-255,2902,4670,7,201370
39276,5e-05,172.31.36.0-255,66,4736,7,201370
39277,5.7e-05,172.217.194.0-255,7156,11892,7,201370
39278,6e-05,172.31.36.0-255,66,11958,7,201370
39279,8.7e-05,172.217.194.0-255,2067,14025,7,201370
39280,8.9e-05,172.31.36.0-255,66,14091,7,201370
39281,0.000113,172.217.194.0-255,2902,16993,7,201370
39282,0.000116,172.31.36.0-255,66,17059,7,201370
39283,0.000123,172.217.194.0-255,7156,24215,7,201370
39284,0.000125,172.31.36.0-255,66,24281,7,201370
39285,0.000135,172.217.194.0-255,5738,30019,7,201370
39286,0.000136,172.31.36.0-255,66,30085,7,201370
39287,0.000163,172.217.194.0-255,1125,31210,7,201370
39288,0.000166,172.31.36.0-255,66,31276,7,201370
39289,0.000199,172.217.194.0-255,1484,32760,7,201370
39290,0.000201,172.31.36.0-255,66,32826,7,201370
39291,0.000206,172.217.194.0-255,2902,35728,7,201370
39292,0.000208,172.31.36.0-255,66,35794,7,201370
39293,0.000235,172.217.194.0-255,1484,37278,7,201370
39294,0.000238,172.31.36.0-255,66,37344,7,201370
39295,0.000245,172.217.194.0-255,7156,44500,7,201370
39296,0.000247,172.31.36.0-255,66,44566,7,201370
39297,0.000309,172.31.36.0-255,66,44632,7,201370
39298,0.000312,172.217.194.0-255,1484,46116,7,201370
39299,0.000314,172.31.36.0-255,66,46182,7,201370
39300,0.000332,172.31.36.0-255,66,46248,7,201370
39301,0.000334,172.217.194.0-255,389,46637,7,201370
39302,0.000369,172.217.194.0-255,386,47023,7,201370
39303,0.00067,172.217.194.0-255,1484,48507,7,201370
39304,0.000674,172.31.36.0-255,66,48573,7,201370
39305,0.000679,172.217.194.0-255,2902,51475,7,201370
39306,0.000681,172.31.36.0-255,66,51541,7,201370
39307,0.000687,172.217.194.0-255,5738,57279,7,201370
39308,0.000689,172.31.36.0-255,66,57345,7,201370
39309,0.000719,172.217.194.0-255,7156,64501,7,201370
39310,0.000722,172.31.36.0-255,66,64567,7,201370
39311,0.000726,172.217.194.0-255,2902,67469,7,201370
39312,0.000728,172.31.36.0-255,66,67535,7,201370
39313,0.000766,172.31.36.0-255,66,67601,7,201370
39314,0.000769,172.217.194.0-255,2184,69785,7,201370
39315,0.000771,172.31.36.0-255,66,69851,7,201370
39316,0.000983,172.217.194.0-255,1484,71335,7,201370
39317,0.000992,172.217.194.0-255,2902,74237,7,201370
39318,0.000995,172.31.36.0-255,66,74303,7,201370
39319,0.001001,172.217.194.0-255,4320,78623,7,201370
39320,0.001002,172.31.36.0-255,66,78689,7,201370
39321,0.001024,172.217.194.0-255,1484,80173,7,201370
39322,0.001029,172.217.194.0-255,2902,83075,7,201370
39323,0.001031,172.31.36.0-255,66,83141,7,201370
39324,0.001063,172.217.194.0-255,7156,90297,7,201370
39325,0.001067,172.31.36.0-255,66,90363,7,201370
39326,0.001078,172.31.36.0-255,66,90429,7,201370
39327,0.001101,172.217.194.0-255,2184,92613,7,201370
39328,0.001104,172.31.36.0-255,66,92679,7,201370
39329,0.001127,172.217.194.0-255,1484,94163,7,201370
39330,0.001132,172.217.194.0-255,2902,97065,7,201370
39331,0.001135,172.31.36.0-255,66,97131,7,201370
39332,0.001169,172.217.194.0-255,5738,102869,7,201370
39333,0.001172,172.31.36.0-255,66,102935,7,201370
39334,0.001182,172.31.36.0-255,66,103001,7,201370
39335,0.001199,172.217.194.0-255,1484,104485,7,201370
39336,0.001216,172.217.194.0-255,5738,110223,7,201370
39337,0.00122,172.31.36.0-255,66,110289,7,201370
39338,0.001256,172.31.36.0-255,66,110355,7,201370
39339,0.001293,172.31.36.0-255,66,110421,7,201370
39340,0.001302,172.217.194.0-255,7156,117577,7,201370
39341,0.001304,172.31.36.0-255,66,117643,7,201370
39342,0.001352,172.31.36.0-255,66,117709,7,201370
39343,0.001366,172.31.36.0-255,66,117775,7,201370
39344,0.001395,172.217.194.0-255,4320,122095,7,201370
39345,0.001403,172.31.36.0-255,66,122161,7,201370
39346,0.001435,172.217.194.0-255,7156,129317,7,201370
39347,0.001438,172.31.36.0-255,66,129383,7,201370
39348,0.001449,172.31.36.0-255,66,129449,7,201370
39349,0.001525,172.217.194.0-255,1484,130933,7,201370
39350,0.001531,172.217.194.0-255,2902,133835,7,201370
39351,0.001534,172.31.36.0-255,66,133901,7,201370
39352,0.001541,172.217.194.0-255,5738,139639,7,201370
39353,0.001544,172.31.36.0-255,66,139705,7,201370
39354,0.001608,172.31.36.0-255,66,139771,7,201370
39355,0.001624,172.31.36.0-255,66,139837,7,201370
39356,0.001628,172.217.194.0-255,766,140603,7,201370
39357,0.001682,172.217.194.0-255,1484,142087,7,201370
39358,0.001686,172.31.36.0-255,66,142153,7,201370
39359,0.001692,172.217.194.0-255,2902,145055,7,201370
39360,0.001695,172.31.36.0-255,66,145121,7,201370
39361,0.001706,172.217.194.0-255,5738,150859,7,201370
39362,0.001709,172.31.36.0-255,66,150925,7,201370
39363,0.001723,172.217.194.0-255,2902,153827,7,201370
39364,0.001725,172.31.36.0-255,66,153893,7,201370
39365,0.001758,172.217.194.0-255,7156,161049,7,201370
39366,0.001762,172.31.36.0-255,66,161115,7,201370
39367,0.00178,172.31.36.0-255,66,161181,7,201370
39368,0.001784,172.217.194.0-255,2184,163365,7,201370
39369,0.001787,172.31.36.0-255,66,163431,7,201370
39370,0.002077,172.217.194.0-255,1484,164915,7,201370
39371,0.002085,172.217.194.0-255,2902,167817,7,201370
39372,0.002089,172.31.36.0-255,66,167883,7,201370
39373,0.002096,172.217.194.0-255,5738,173621,7,201370
39374,0.002098,172.31.36.0-255,66,173687,7,201370
39375,0.002144,172.31.36.0-255,66,173753,7,201370
39376,0.002173,172.217.194.0-255,2902,176655,7,201370
39377,0.002177,172.31.36.0-255,66,176721,7,201370
39378,0.002187,172.31.36.0-255,66,176787,7,201370
39379,0.002194,172.217.194.0-255,1484,178271,7,201370
39380,0.002237,172.31.36.0-255,66,178337,7,201370
39381,0.002264,172.217.194.0-255,3602,181939,7,201370
39382,0.002267,172.31.36.0-255,66,182005,7,201370
39383,0.002273,172.217.194.0-255,7156,189161,7,201370
39384,0.002275,172.31.36.0-255,66,189227,7,201370
39385,0.002342,172.217.194.0-255,2105,191332,7,201370
39386,0.002346,172.31.36.0-255,66,191398,7,201370
39387,0.002355,172.31.36.0-255,66,191464,7,201370
39388,0.002357,172.31.36.0-255,66,191530,7,201370
39389,0.002364,172.31.36.0-255,66,191596,7,201370
39390,0.002367,172.217.194.0-255,105,191701,7,201370
39391,0.004159,172.31.36.0-255,66,191767,7,201370
39392,0.00419,172.31.36.0-255,105,191872,7,201370
39393,0.00678,172.217.194.0-255,66,191938,7,201370
39394,0.02955,172.31.36.0-255,172,192110,7,201370
39395,0.029615,172.31.36.0-255,1113,193223,7,201370
39396,0.029704,172.31.36.0-255,1514,194737,7,201370
39397,0.029706,172.31.36.0-255,1514,196251,7,201370
39398,0.029708,172.31.36.0-255,1514,197765,7,201370
39399,0.029709,172.31.36.0-255,1514,199279,7,201370
39400,0.029741,172.31.36.0-255,1514,200793,7,201370
39401,0.029742,172.31.36.0-255,73,200866,7,201370
39402,0.031092,104.244.42.0-255,66,200932,7,201370
39403,0.031174,104.244.42.0-255,66,200998,7,201370
39404,0.031245,104.244.42.0-255,66,201064,7,201370
39405,0.031248,104.244.42.0-255,66,201130,7,201370
39406,0.03125,104.244.42.0-255,66,201196,7,201370
39407,0.031877,104.244.42.0-255,108,201304,7,201370
39408,0.031899,172.31.36.0-255,66,201370,7,201370
39409,0.0,216.58.221.0-255,153,153,7,305005
39410,3.4e-05,172.31.36.0-255,66,219,7,305005
39411,4.1e-05,216.58.221.0-255,1484,1703,7,305005
39412,4.5e-05,172.31.36.0-255,66,1769,7,305005
39413,5.1e-05,216.58.221.0-255,2902,4671,7,305005
39414,5.4e-05,172.31.36.0-255,66,4737,7,305005
39415,6.8e-05,216.58.221.0-255,5738,10475,7,305005
39416,7.1e-05,172.31.36.0-255,66,10541,7,305005
39417,7.6e-05,216.58.221.0-255,3454,13995,7,305005
39418,7.8e-05,172.31.36.0-255,66,14061,7,305005
39419,0.000334,216.58.221.0-255,1484,15545,7,305005
39420,0.00034,172.31.36.0-255,66,15611,7,305005
39421,0.000346,216.58.221.0-255,2902,18513,7,305005
39422,0.000348,172.31.36.0-255,66,18579,7,305005
39423,0.000362,216.58.221.0-255,5738,24317,7,305005
39424,0.000365,172.31.36.0-255,66,24383,7,305005
39425,0.000409,216.58.221.0-255,6797,31180,7,305005
39426,0.000413,172.31.36.0-255,66,31246,7,305005
39427,0.000509,216.58.221.0-255,1484,32730,7,305005
39428,0.000513,172.31.36.0-255,66,32796,7,305005
39429,0.000519,216.58.221.0-255,2902,35698,7,305005
39430,0.000521,172.31.36.0-255,66,35764,7,305005
39431,0.00053,216.58.221.0-255,1484,37248,7,305005
39432,0.000532,172.31.36.0-255,66,37314,7,305005
39433,0.000561,216.58.221.0-255,2902,40216,7,305005
39434,0.000565,172.31.36.0-255,66,40282,7,305005
39435,0.000577,172.31.36.0-255,66,40348,7,305005
39436,0.000602,216.58.221.0-255,2902,43250,7,305005
39437,0.000605,172.31.36.0-255,66,43316,7,305005
39438,0.000645,172.31.36.0-255,66,43382,7,305005
39439,0.000649,216.58.221.0-255,361,43743,7,305005
39440,0.000823,172.31.36.0-255,66,43809,7,305005
39441,0.001186,216.58.221.0-255,131,43940,7,305005
39442,0.001291,216.58.221.0-255,348,44288,7,305005
39443,0.001532,216.58.221.0-255,1484,45772,7,305005
39444,0.001539,172.31.36.0-255,66,45838,7,305005
39445,0.001546,216.58.221.0-255,2902,48740,7,305005
39446,0.001548,172.31.36.0-255,66,48806,7,305005
39447,0.001555,216.58.221.0-255,5738,54544,7,305005
39448,0.001565,172.31.36.0-255,66,54610,7,305005
39449,0.001572,216.58.221.0-255,4320,58930,7,305005
39450,0.001573,172.31.36.0-255,66,58996,7,305005
39451,0.001618,172.31.36.0-255,66,59062,7,305005
39452,0.001634,172.31.36.0-255,66,59128,7,305005
39453,0.001784,216.58.221.0-255,1484,60612,7,305005
39454,0.0018,216.58.221.0-255,2902,63514,7,305005
39455,0.001803,172.31.36.0-255,66,63580,7,305005
39456,0.001808,216.58.221.0-255,4320,67900,7,305005
39457,0.00181,172.31.36.0-255,66,67966,7,305005
39458,0.001829,216.58.221.0-255,1484,69450,7,305005
39459,0.001833,216.58.221.0-255,2902,72352,7,305005
39460,0.001835,172.31.36.0-255,66,72418,7,305005
39461,0.001888,172.31.36.0-255,66,72484,7,305005
39462,0.001903,172.31.36.0-255,66,72550,7,305005
39463,0.001907,216.58.221.0-255,2184,74734,7,305005
39464,0.001909,172.31.36.0-255,66,74800,7,305005
39465,0.003898,216.58.221.0-255,1484,76284,7,305005
39466,0.003917,216.58.221.0-255,4320,80604,7,305005
39467,0.00392,172.31.36.0-255,66,80670,7,305005
39468,0.005892,216.58.221.0-255,4320,84990,7,305005
39469,0.005897,172.31.36.0-255,66,85056,7,305005
39470,0.005924,216.58.221.0-255,1484,86540,7,305005
39471,0.007868,216.58.221.0-255,4320,90860,7,305005
39472,0.007874,172.31.36.0-255,66,90926,7,305005
39473,0.00987,216.58.221.0-255,5738,96664,7,305005
39474,0.009876,172.31.36.0-255,66,96730,7,305005
39475,0.011856,216.58.221.0-255,5738,102468,7,305005
39476,0.011864,172.31.36.0-255,66,102534,7,305005
39477,0.013873,216.58.221.0-255,5738,108272,7,305005
39478,0.013883,172.31.36.0-255,66,108338,7,305005
39479,0.015905,216.58.221.0-255,5738,114076,7,305005
39480,0.015913,172.31.36.0-255,66,114142,7,305005
39481,0.017877,216.58.221.0-255,4320,118462,7,305005
39482,0.017885,172.31.36.0-255,66,118528,7,305005
39483,0.017919,216.58.221.0-255,1484,120012,7,305005
39484,0.019867,216.58.221.0-255,4320,124332,7,305005
39485,0.019874,172.31.36.0-255,66,124398,7,305005
39486,0.021882,216.58.221.0-255,5738,130136,7,305005
39487,0.021892,172.31.36.0-255,66,130202,7,305005
39488,0.023878,216.58.221.0-255,5738,135940,7,305005
39489,0.023889,172.31.36.0-255,66,136006,7,305005
39490,0.025914,216.58.221.0-255,5738,141744,7,305005
39491,0.025931,172.31.36.0-255,66,141810,7,305005
39492,0.027925,216.58.221.0-255,5738,147548,7,305005
39493,0.027938,172.31.36.0-255,66,147614,7,305005
39494,0.029921,216.58.221.0-255,5738,153352,7,305005
39495,0.029928,172.31.36.0-255,66,153418,7,305005
39496,0.030683,172.31.36.0-255,172,153590,7,305005
39497,0.03071,172.31.36.0-255,1113,154703,7,305005
39498,0.03075,172.31.36.0-255,1514,156217,7,305005
39499,0.030751,172.31.36.0-255,1514,157731,7,305005
39500,0.030757,172.31.36.0-255,1514,159245,7,305005
39501,0.030758,172.31.36.0-255,1514,160759,7,305005
39502,0.030773,172.31.36.0-255,1514,162273,7,305005
39503,0.030774,172.31.36.0-255,72,162345,7,305005
39504,0.031916,216.58.221.0-255,5738,168083,7,305005
39505,0.031922,172.31.36.0-255,66,168149,7,305005
39506,0.032234,104.244.42.0-255,66,168215,7,305005
39507,0.032242,104.244.42.0-255,66,168281,7,305005
39508,0.03229,104.244.42.0-255,66,168347,7,305005
39509,0.032397,104.244.42.0-255,66,168413,7,305005
39510,0.0339,216.58.221.0-255,4320,172733,7,305005
39511,0.033905,172.31.36.0-255,66,172799,7,305005
39512,0.033936,216.58.221.0-255,1484,174283,7,305005
39513,0.035902,216.58.221.0-255,4320,178603,7,305005
39514,0.035907,172.31.36.0-255,66,178669,7,305005
39515,0.037879,216.58.221.0-255,5738,184407,7,305005
39516,0.037884,172.31.36.0-255,66,184473,7,305005
39517,0.039852,216.58.221.0-255,5738,190211,7,305005
39518,0.039857,172.31.36.0-255,66,190277,7,305005
39519,0.04186,216.58.221.0-255,5738,196015,7,305005
39520,0.041867,172.31.36.0-255,66,196081,7,305005
39521,0.043837,216.58.221.0-255,5738,201819,7,305005
39522,0.043842,172.31.36.0-255,66,201885,7,305005
39523,0.045821,216.58.221.0-255,5738,207623,7,305005
39524,0.045826,172.31.36.0-255,66,207689,7,305005
39525,0.047819,216.58.221.0-255,5738,213427,7,305005
39526,0.047826,172.31.36.0-255,66,213493,7,305005
39527,0.049808,216.58.221.0-255,5738,219231,7,305005
39528,0.049814,172.31.36.0-255,66,219297,7,305005
39529,0.051786,216.58.221.0-255,5738,225035,7,305005
39530,0.051791,172.31.36.0-255,66,225101,7,305005
39531,0.053766,216.58.221.0-255,5738,230839,7,305005
39532,0.053772,172.31.36.0-255,66,230905,7,305005
39533,0.055751,216.58.221.0-255,5738,236643,7,305005
39534,0.055758,172.31.36.0-255,66,236709,7,305005
39535,0.057745,216.58.221.0-255,5738,242447,7,305005
39536,0.057758,172.31.36.0-255,66,242513,7,305005
39537,0.059733,216.58.221.0-255,5738,248251,7,305005
39538,0.059739,172.31.36.0-255,66,248317,7,305005
39539,0.06171,216.58.221.0-255,5738,254055,7,305005
39540,0.061715,172.31.36.0-255,66,254121,7,305005
39541,0.063681,216.58.221.0-255,5738,259859,7,305005
39542,0.063686,172.31.36.0-255,66,259925,7,305005
39543,0.065648,216.58.221.0-255,5738,265663,7,305005
39544,0.065654,172.31.36.0-255,66,265729,7,305005
39545,0.067626,216.58.221.0-255,5738,271467,7,305005
39546,0.067631,172.31.36.0-255,66,271533,7,305005
39547,0.069606,216.58.221.0-255,5738,277271,7,305005
39548,0.069612,172.31.36.0-255,66,277337,7,305005
39549,0.071585,216.58.221.0-255,4320,281657,7,305005
39550,0.07159,172.31.36.0-255,66,281723,7,305005
39551,0.071624,216.58.221.0-255,1484,283207,7,305005
39552,0.073556,216.58.221.0-255,4320,287527,7,305005
39553,0.073562,172.31.36.0-255,66,287593,7,305005
39554,0.075548,216.58.221.0-255,5738,293331,7,305005
39555,0.075554,172.31.36.0-255,66,293397,7,305005
39556,0.077528,216.58.221.0-255,5738,299135,7,305005
39557,0.077533,172.31.36.0-255,66,299201,7,305005
39558,0.07951,216.58.221.0-255,5738,304939,7,305005
39559,0.079515,172.31.36.0-255,66,305005,7,305005
39560,0.0,74.125.24.0-255,152,152,7,237047
39561,2.4e-05,172.31.36.0-255,66,218,7,237047
39562,3.1e-05,74.125.24.0-255,1484,1702,7,237047
39563,3.5e-05,172.31.36.0-255,66,1768,7,237047
39564,4e-05,74.125.24.0-255,2902,4670,7,237047
39565,4.4e-05,172.31.36.0-255,66,4736,7,237047
39566,4.9e-05,74.125.24.0-255,2902,7638,7,237047
39567,5.3e-05,172.31.36.0-255,66,7704,7,237047
39568,7.7e-05,74.125.24.0-255,1484,9188,7,237047
39569,8e-05,172.31.36.0-255,66,9254,7,237047
39570,0.00011,74.125.24.0-255,4845,14099,7,237047
39571,0.000113,172.31.36.0-255,66,14165,7,237047
39572,0.000468,74.125.24.0-255,1484,15649,7,237047
39573,0.000474,172.31.36.0-255,66,15715,7,237047
39574,0.000481,74.125.24.0-255,2902,18617,7,237047
39575,0.000484,172.31.36.0-255,66,18683,7,237047
39576,0.00049,74.125.24.0-255,5738,24421,7,237047
39577,0.000492,172.31.36.0-255,66,24487,7,237047
39578,0.000525,74.125.24.0-255,6797,31284,7,237047
39579,0.000528,172.31.36.0-255,66,31350,7,237047
39580,0.000533,74.125.24.0-255,2902,34252,7,237047
39581,0.000536,172.31.36.0-255,66,34318,7,237047
39582,0.000551,74.125.24.0-255,4320,38638,7,237047
39583,0.000553,172.31.36.0-255,66,38704,7,237047
39584,0.000557,74.125.24.0-255,2902,41606,7,237047
39585,0.000559,172.31.36.0-255,66,41672,7,237047
39586,0.000606,172.31.36.0-255,66,41738,7,237047
39587,0.000621,172.31.36.0-255,66,41804,7,237047
39588,0.000684,74.125.24.0-255,403,42207,7,237047
39589,0.000688,172.31.36.0-255,66,42273,7,237047
39590,0.000727,74.125.24.0-255,110,42383,7,237047
39591,0.000767,74.125.24.0-255,1484,43867,7,237047
39592,0.000771,172.31.36.0-255,66,43933,7,237047
39593,0.000775,74.125.24.0-255,2902,46835,7,237047
39594,0.000778,172.31.36.0-255,66,46901,7,237047
39595,0.00078,74.125.24.0-255,1484,48385,7,237047
39596,0.000808,74.125.24.0-255,5738,54123,7,237047
39597,0.000811,172.31.36.0-255,66,54189,7,237047
39598,0.000816,74.125.24.0-255,4320,58509,7,237047
39599,0.000819,172.31.36.0-255,66,58575,7,237047
39600,0.000843,172.31.36.0-255,66,58641,7,237047
39601,0.000881,74.125.24.0-255,2902,61543,7,237047
39602,0.000884,172.31.36.0-255,66,61609,7,237047
39603,0.000906,74.125.24.0-255,5283,66892,7,237047
39604,0.000909,172.31.36.0-255,66,66958,7,237047
39605,0.000945,74.125.24.0-255,1484,68442,7,237047
39606,0.000961,74.125.24.0-255,2902,71344,7,237047
39607,0.000964,172.31.36.0-255,66,71410,7,237047
39608,0.000968,74.125.24.0-255,1484,72894,7,237047
39609,0.000986,74.125.24.0-255,4320,77214,7,237047
39610,0.000991,172.31.36.0-255,66,77280,7,237047
39611,0.001,74.125.24.0-255,2902,80182,7,237047
39612,0.001003,172.31.36.0-255,66,80248,7,237047
39613,0.001038,74.125.24.0-255,5738,85986,7,237047
39614,0.001047,172.31.36.0-255,66,86052,7,237047
39615,0.00105,172.31.36.0-255,66,86118,7,237047
39616,0.001067,74.125.24.0-255,5020,91138,7,237047
39617,0.001069,172.31.36.0-255,66,91204,7,237047
39618,0.001104,74.125.24.0-255,2902,94106,7,237047
39619,0.001107,172.31.36.0-255,66,94172,7,237047
39620,0.001129,74.125.24.0-255,2902,97074,7,237047
39621,0.001131,172.31.36.0-255,66,97140,7,237047
39622,0.001137,74.125.24.0-255,4320,101460,7,237047
39623,0.001139,172.31.36.0-255,66,101526,7,237047
39624,0.001152,172.31.36.0-255,66,101592,7,237047
39625,0.001211,172.31.36.0-255,66,101658,7,237047
39626,0.001232,74.125.24.0-255,3602,105260,7,237047
39627,0.001235,172.31.36.0-255,66,105326,7,237047
39628,0.00124,74.125.24.0-255,4320,109646,7,237047
39629,0.001242,172.31.36.0-255,66,109712,7,237047
39630,0.001248,74.125.24.0-255,5738,115450,7,237047
39631,0.00125,172.31.36.0-255,66,115516,7,237047
39632,0.001281,172.31.36.0-255,66,115582,7,237047
39633,0.001288,74.125.24.0-255,5738,121320,7,237047
39634,0.00129,172.31.36.0-255,66,121386,7,237047
39635,0.001325,74.125.24.0-255,6438,127824,7,237047
39636,0.001328,172.31.36.0-255,66,127890,7,237047
39637,0.001377,74.125.24.0-255,7156,135046,7,237047
39638,0.001382,172.31.36.0-255,66,135112,7,237047
39639,0.001403,172.31.36.0-255,66,135178,7,237047
39640,0.001415,74.125.24.0-255,1484,136662,7,237047
39641,0.001447,172.31.36.0-255,66,136728,7,237047
39642,0.00145,74.125.24.0-255,766,137494,7,237047
39643,0.001501,74.125.24.0-255,1484,138978,7,237047
39644,0.001504,172.31.36.0-255,66,139044,7,237047
39645,0.001509,74.125.24.0-255,2902,141946,7,237047
39646,0.001511,172.31.36.0-255,66,142012,7,237047
39647,0.001515,74.125.24.0-255,1484,143496,7,237047
39648,0.001533,74.125.24.0-255,4320,147816,7,237047
39649,0.001536,172.31.36.0-255,66,147882,7,237047
39650,0.001541,74.125.24.0-255,4320,152202,7,237047
39651,0.001544,172.31.36.0-255,66,152268,7,237047
39652,0.001553,74.125.24.0-255,2902,155170,7,237047
39653,0.001556,172.31.36.0-255,66,155236,7,237047
39654,0.001584,172.31.36.0-255,66,155302,7,237047
39655,0.001593,172.31.36.0-255,66,155368,7,237047
39656,0.001639,74.125.24.0-255,7156,162524,7,237047
39657,0.001642,172.31.36.0-255,66,162590,7,237047
39658,0.001665,74.125.24.0-255,1484,164074,7,237047
39659,0.001677,172.31.36.0-255,66,164140,7,237047
39660,0.0017,172.31.36.0-255,66,164206,7,237047
39661,0.001726,74.125.24.0-255,6438,170644,7,237047
39662,0.001729,74.125.24.0-255,1484,172128,7,237047
39663,0.001733,172.31.36.0-255,66,172194,7,237047
39664,0.001741,74.125.24.0-255,1484,173678,7,237047
39665,0.001744,172.31.36.0-255,66,173744,7,237047
39666,0.00175,74.125.24.0-255,4320,178064,7,237047
39667,0.001752,172.31.36.0-255,66,178130,7,237047
39668,0.00178,74.125.24.0-255,5738,183868,7,237047
39669,0.001783,172.31.36.0-255,66,183934,7,237047
39670,0.001806,74.125.24.0-255,2902,186836,7,237047
39671,0.001809,172.31.36.0-255,66,186902,7,237047
39672,0.001817,74.125.24.0-255,7156,194058,7,237047
39673,0.001819,172.31.36.0-255,66,194124,7,237047
39674,0.001839,74.125.24.0-255,2902,197026,7,237047
39675,0.001842,172.31.36.0-255,66,197092,7,237047
39676,0.001873,172.31.36.0-255,66,197158,7,237047
39677,0.001892,74.125.24.0-255,7156,204314,7,237047
39678,0.001895,172.31.36.0-255,66,204380,7,237047
39679,0.001929,172.31.36.0-255,66,204446,7,237047
39680,0.00201,172.31.36.0-255,66,204512,7,237047
39681,0.002012,74.125.24.0-255,766,205278,7,237047
39682,0.002016,74.125.24.0-255,1484,206762,7,237047
39683,0.002018,172.31.36.0-255,66,206828,7,237047
39684,0.002024,74.125.24.0-255,4320,211148,7,237047
39685,0.002026,172.31.36.0-255,66,211214,7,237047
39686,0.002039,172.31.36.0-255,66,211280,7,237047
39687,0.00205,172.31.36.0-255,66,211346,7,237047
39688,0.002053,74.125.24.0-255,1484,212830,7,237047
39689,0.004064,74.125.24.0-255,4320,217150,7,237047
39690,0.004071,172.31.36.0-255,66,217216,7,237047
39691,0.006112,74.125.24.0-255,5738,222954,7,237047
39692,0.006123,172.31.36.0-255,66,223020,7,237047
39693,0.00814,74.125.24.0-255,4320,227340,7,237047
39694,0.008144,172.31.36.0-255,66,227406,7,237047
39695,0.008164,74.125.24.0-255,1484,228890,7,237047
39696,0.01017,74.125.24.0-255,3628,232518,7,237047
39697,0.010174,172.31.36.0-255,66,232584,7,237047
39698,0.01077,172.31.36.0-255,105,232689,7,237047
39699,0.012824,74.125.24.0-255,66,232755,7,237047
39700,0.043374,172.31.36.0-255,172,232927,7,237047
39701,0.043411,172.31.36.0-255,1114,234041,7,237047
39702,0.043477,172.31.36.0-255,1514,235555,7,237047
39703,0.043479,172.31.36.0-255,1294,236849,7,237047
39704,0.044882,104.244.42.0-255,66,236915,7,237047
39705,0.044914,104.244.42.0-255,66,236981,7,237047
39706,0.044981,104.244.42.0-255,66,237047,7,237047
39707,0.0,172.217.194.0-255,143,143,7,310830
39708,3e-05,172.31.36.0-255,66,209,7,310830
39709,3.8e-05,172.217.194.0-255,1484,1693,7,310830
39710,4.2e-05,172.31.36.0-255,66,1759,7,310830
39711,4.7e-05,172.217.194.0-255,2902,4661,7,310830
39712,5e-05,172.31.36.0-255,66,4727,7,310830
39713,5.8e-05,172.217.194.0-255,7156,11883,7,310830
39714,6e-05,172.31.36.0-255,66,11949,7,310830
39715,6.7e-05,172.217.194.0-255,7156,19105,7,310830
39716,7e-05,172.31.36.0-255,66,19171,7,310830
39717,9e-05,172.217.194.0-255,2048,21219,7,310830
39718,9.2e-05,172.31.36.0-255,66,21285,7,310830
39719,0.000113,172.217.194.0-255,1484,22769,7,310830
39720,0.000116,172.31.36.0-255,66,22835,7,310830
39721,0.000141,172.31.36.0-255,66,22901,7,310830
39722,0.000228,172.217.194.0-255,1484,24385,7,310830
39723,0.000232,172.31.36.0-255,66,24451,7,310830
39724,0.000237,172.217.194.0-255,2902,27353,7,310830
39725,0.000239,172.31.36.0-255,66,27419,7,310830
39726,0.000259,172.217.194.0-255,5738,33157,7,310830
39727,0.000263,172.31.36.0-255,66,33223,7,310830
39728,0.000307,172.217.194.0-255,2902,36125,7,310830
39729,0.000311,172.31.36.0-255,66,36191,7,310830
39730,0.000331,172.217.194.0-255,3961,40152,7,310830
39731,0.000334,172.31.36.0-255,66,40218,7,310830
39732,0.000697,172.217.194.0-255,1484,41702,7,310830
39733,0.000702,172.31.36.0-255,66,41768,7,310830
39734,0.000711,172.217.194.0-255,2902,44670,7,310830
39735,0.000713,172.31.36.0-255,66,44736,7,310830
39736,0.00072,172.217.194.0-255,5738,50474,7,310830
39737,0.000722,172.31.36.0-255,66,50540,7,310830
39738,0.000729,172.217.194.0-255,6797,57337,7,310830
39739,0.000731,172.31.36.0-255,66,57403,7,310830
39740,0.00117,172.217.194.0-255,1484,58887,7,310830
39741,0.00118,172.217.194.0-255,2902,61789,7,310830
39742,0.001185,172.31.36.0-255,66,61855,7,310830
39743,0.001193,172.217.194.0-255,5738,67593,7,310830
39744,0.001195,172.31.36.0-255,66,67659,7,310830
39745,0.001228,172.217.194.0-255,4320,71979,7,310830
39746,0.001231,172.31.36.0-255,66,72045,7,310830
39747,0.001247,172.217.194.0-255,3122,75167,7,310830
39748,0.00125,172.31.36.0-255,66,75233,7,310830
39749,0.001303,172.217.194.0-255,1484,76717,7,310830
39750,0.001322,172.217.194.0-255,2902,79619,7,310830
39751,0.001324,172.31.36.0-255,66,79685,7,310830
39752,0.001329,172.217.194.0-255,2902,82587,7,310830
39753,0.00133,172.31.36.0-255,66,82653,7,310830
39754,0.001346,172.217.194.0-255,2902,85555,7,310830
39755,0.001348,172.31.36.0-255,66,85621,7,310830
39756,0.001386,172.217.194.0-255,5738,91359,7,310830
39757,0.001389,172.31.36.0-255,66,91425,7,310830
39758,0.001403,172.217.194.0-255,1125,92550,7,310830
39759,0.001616,172.31.36.0-255,66,92616,7,310830
39760,0.001695,172.217.194.0-255,1484,94100,7,310830
39761,0.001721,172.217.194.0-255,2902,97002,7,310830
39762,0.001724,172.31.36.0-255,66,97068,7,310830
39763,0.001729,172.217.194.0-255,2902,99970,7,310830
39764,0.001731,172.31.36.0-255,66,100036,7,310830
39765,0.001744,172.217.194.0-255,2902,102938,7,310830
39766,0.001746,172.31.36.0-255,66,103004,7,310830
39767,0.00175,172.217.194.0-255,2902,105906,7,310830
39768,0.001752,172.31.36.0-255,66,105972,7,310830
39769,0.001792,172.31.36.0-255,66,106038,7,310830
39770,0.001803,172.31.36.0-255,66,106104,7,310830
39771,0.001816,172.217.194.0-255,2184,108288,7,310830
39772,0.001819,172.31.36.0-255,66,108354,7,310830
39773,0.002071,172.217.194.0-255,1484,109838,7,310830
39774,0.002076,172.217.194.0-255,2902,112740,7,310830
39775,0.002079,172.31.36.0-255,66,112806,7,310830
39776,0.002084,172.217.194.0-255,2902,115708,7,310830
39777,0.002086,172.31.36.0-255,66,115774,7,310830
39778,0.002101,172.217.194.0-255,2902,118676,7,310830
39779,0.002103,172.31.36.0-255,66,118742,7,310830
39780,0.002113,172.31.36.0-255,66,118808,7,310830
39781,0.002163,172.217.194.0-255,7156,125964,7,310830
39782,0.002166,172.31.36.0-255,66,126030,7,310830
39783,0.002193,172.31.36.0-255,66,126096,7,310830
39784,0.004539,172.217.194.0-255,2902,128998,7,310830
39785,0.004544,172.31.36.0-255,66,129064,7,310830
39786,0.004566,172.217.194.0-255,2902,131966,7,310830
39787,0.004568,172.31.36.0-255,66,132032,7,310830
39788,0.006947,172.217.194.0-255,5738,137770,7,310830
39789,0.006953,172.31.36.0-255,66,137836,7,310830
39790,0.009319,172.217.194.0-255,5738,143574,7,310830
39791,0.009326,172.31.36.0-255,66,143640,7,310830
39792,0.011707,172.217.194.0-255,5738,149378,7,310830
39793,0.011718,172.31.36.0-255,66,149444,7,310830
39794,0.014076,172.217.194.0-255,5738,155182,7,310830
39795,0.014088,172.31.36.0-255,66,155248,7,310830
39796,0.016469,172.217.194.0-255,5738,160986,7,310830
39797,0.016478,172.31.36.0-255,66,161052,7,310830
39798,0.01886,172.217.194.0-255,5738,166790,7,310830
39799,0.018869,172.31.36.0-255,66,166856,7,310830
39800,0.021244,172.217.194.0-255,5738,172594,7,310830
39801,0.021254,172.31.36.0-255,66,172660,7,310830
39802,0.022088,172.31.36.0-255,164,172824,7,310830
39803,0.02212,172.31.36.0-255,1123,173947,7,310830
39804,0.022172,172.31.36.0-255,1514,175461,7,310830
39805,0.022174,172.31.36.0-255,1283,176744,7,310830
39806,0.02361,104.244.42.0-255,66,176810,7,310830
39807,0.023622,172.217.194.0-255,5738,182548,7,310830
39808,0.023625,172.31.36.0-255,66,182614,7,310830
39809,0.023649,104.244.42.0-255,66,182680,7,310830
39810,0.023736,104.244.42.0-255,66,182746,7,310830
39811,0.02599,172.217.194.0-255,4320,187066,7,310830
39812,0.025995,172.31.36.0-255,66,187132,7,310830
39813,0.026028,172.217.194.0-255,1484,188616,7,310830
39814,0.028365,172.217.194.0-255,2902,191518,7,310830
39815,0.028371,172.31.36.0-255,66,191584,7,310830
39816,0.0284,172.217.194.0-255,1484,193068,7,310830
39817,0.030741,172.217.194.0-255,4320,197388,7,310830
39818,0.030747,172.31.36.0-255,66,197454,7,310830
39819,0.033105,172.217.194.0-255,5738,203192,7,310830
39820,0.03311,172.31.36.0-255,66,203258,7,310830
39821,0.035472,172.217.194.0-255,5738,208996,7,310830
39822,0.03548,172.31.36.0-255,66,209062,7,310830
39823,0.037849,172.217.194.0-255,5738,214800,7,310830
39824,0.037854,172.31.36.0-255,66,214866,7,310830
39825,0.040221,172.217.194.0-255,5738,220604,7,310830
39826,0.040226,172.31.36.0-255,66,220670,7,310830
39827,0.042574,172.217.194.0-255,5738,226408,7,310830
39828,0.04258,172.31.36.0-255,66,226474,7,310830
39829,0.044943,172.217.194.0-255,5738,232212,7,310830
39830,0.044949,172.31.36.0-255,66,232278,7,310830
39831,0.047298,172.217.194.0-255,5738,238016,7,310830
39832,0.047304,172.31.36.0-255,66,238082,7,310830
39833,0.049666,172.217.194.0-255,5738,243820,7,310830
39834,0.049671,172.31.36.0-255,66,243886,7,310830
39835,0.052039,172.217.194.0-255,5738,249624,7,310830
39836,0.052045,172.31.36.0-255,66,249690,7,310830
39837,0.054404,172.217.194.0-255,5738,255428,7,310830
39838,0.05441,172.31.36.0-255,66,255494,7,310830
39839,0.056786,172.217.194.0-255,5738,261232,7,310830
39840,0.056792,172.31.36.0-255,66,261298,7,310830
39841,0.059153,172.217.194.0-255,5738,267036,7,310830
39842,0.059158,172.31.36.0-255,66,267102,7,310830
39843,0.061514,172.217.194.0-255,5738,272840,7,310830
39844,0.06152,172.31.36.0-255,66,272906,7,310830
39845,0.063896,172.217.194.0-255,4320,277226,7,310830
39846,0.063901,172.31.36.0-255,66,277292,7,310830
39847,0.063928,172.217.194.0-255,1484,278776,7,310830
39848,0.06628,172.217.194.0-255,2902,281678,7,310830
39849,0.066285,172.31.36.0-255,66,281744,7,310830
39850,0.066316,172.217.194.0-255,1484,283228,7,310830
39851,0.068638,172.217.194.0-255,4320,287548,7,310830
39852,0.068644,172.31.36.0-255,66,287614,7,310830
39853,0.071004,172.217.194.0-255,5738,293352,7,310830
39854,0.07101,172.31.36.0-255,66,293418,7,310830
39855,0.073367,172.217.194.0-255,5738,299156,7,310830
39856,0.073373,172.31.36.0-255,66,299222,7,310830
39857,0.075728,172.217.194.0-255,5738,304960,7,310830
39858,0.075734,172.31.36.0-255,66,305026,7,310830
39859,0.078097,172.217.194.0-255,5738,310764,7,310830
39860,0.078103,172.31.36.0-255,66,310830,7,310830
39861,0.0,172.217.194.0-255,153,153,7,309769
39862,2.3e-05,172.31.36.0-255,66,219,7,309769
39863,3e-05,172.217.194.0-255,1484,1703,7,309769
39864,3.5e-05,172.31.36.0-255,66,1769,7,309769
39865,4.1e-05,172.217.194.0-255,2902,4671,7,309769
39866,4.4e-05,172.31.36.0-255,66,4737,7,309769
39867,5.1e-05,172.217.194.0-255,7156,11893,7,309769
39868,5.4e-05,172.31.36.0-255,66,11959,7,309769
39869,5.9e-05,172.217.194.0-255,2902,14861,7,309769
39870,6.3e-05,172.31.36.0-255,66,14927,7,309769
39871,0.000103,172.31.36.0-255,66,14993,7,309769
39872,0.000107,172.217.194.0-255,2543,17536,7,309769
39873,0.000109,172.31.36.0-255,66,17602,7,309769
39874,0.00014,172.217.194.0-255,2902,20504,7,309769
39875,0.000143,172.31.36.0-255,66,20570,7,309769
39876,0.000146,172.217.194.0-255,1484,22054,7,309769
39877,0.000148,172.31.36.0-255,66,22120,7,309769
39878,0.000164,172.217.194.0-255,2902,25022,7,309769
39879,0.000166,172.31.36.0-255,66,25088,7,309769
39880,0.000173,172.217.194.0-255,5738,30826,7,309769
39881,0.000175,172.31.36.0-255,66,30892,7,309769
39882,0.000196,172.217.194.0-255,2902,33794,7,309769
39883,0.000198,172.31.36.0-255,66,33860,7,309769
39884,0.000202,172.217.194.0-255,1484,35344,7,309769
39885,0.000204,172.31.36.0-255,66,35410,7,309769
39886,0.00022,172.217.194.0-255,4320,39730,7,309769
39887,0.000223,172.31.36.0-255,66,39796,7,309769
39888,0.000249,172.31.36.0-255,66,39862,7,309769
39889,0.000266,172.217.194.0-255,2436,42298,7,309769
39890,0.000268,172.31.36.0-255,66,42364,7,309769
39891,0.000305,172.217.194.0-255,121,42485,7,309769
39892,0.000651,172.217.194.0-255,379,42864,7,309769
39893,0.000877,172.217.194.0-255,1484,44348,7,309769
39894,0.000884,172.31.36.0-255,66,44414,7,309769
39895,0.000895,172.217.194.0-255,2902,47316,7,309769
39896,0.000898,172.31.36.0-255,66,47382,7,309769
39897,0.00092,172.217.194.0-255,5738,53120,7,309769
39898,0.000923,172.31.36.0-255,66,53186,7,309769
39899,0.000942,172.217.194.0-255,4320,57506,7,309769
39900,0.000944,172.31.36.0-255,66,57572,7,309769
39901,0.00098,172.31.36.0-255,66,57638,7,309769
39902,0.000987,172.217.194.0-255,5738,63376,7,309769
39903,0.00099,172.31.36.0-255,66,63442,7,309769
39904,0.001018,172.217.194.0-255,5020,68462,7,309769
39905,0.001022,172.31.36.0-255,66,68528,7,309769
39906,0.001298,172.217.194.0-255,1484,70012,7,309769
39907,0.001303,172.217.194.0-255,2902,72914,7,309769
39908,0.001309,172.31.36.0-255,66,72980,7,309769
39909,0.001321,172.217.194.0-255,5738,78718,7,309769
39910,0.001325,172.31.36.0-255,66,78784,7,309769
39911,0.001337,172.217.194.0-255,2902,81686,7,309769
39912,0.001339,172.31.36.0-255,66,81752,7,309769
39913,0.001369,172.31.36.0-255,66,81818,7,309769
39914,0.00139,172.217.194.0-255,2902,84720,7,309769
39915,0.001392,172.31.36.0-255,66,84786,7,309769
39916,0.001419,172.31.36.0-255,66,84852,7,309769
39917,0.001499,172.217.194.0-255,1484,86336,7,309769
39918,0.001516,172.217.194.0-255,2902,89238,7,309769
39919,0.001519,172.217.194.0-255,1484,90722,7,309769
39920,0.001523,172.31.36.0-255,66,90788,7,309769
39921,0.001542,172.217.194.0-255,4320,95108,7,309769
39922,0.001545,172.31.36.0-255,66,95174,7,309769
39923,0.001561,172.31.36.0-255,66,95240,7,309769
39924,0.001597,172.217.194.0-255,2902,98142,7,309769
39925,0.0016,172.31.36.0-255,66,98208,7,309769
39926,0.001631,172.217.194.0-255,7156,105364,7,309769
39927,0.001635,172.31.36.0-255,66,105430,7,309769
39928,0.001639,172.217.194.0-255,2184,107614,7,309769
39929,0.001641,172.31.36.0-255,66,107680,7,309769
39930,0.001645,172.217.194.0-255,2902,110582,7,309769
39931,0.001647,172.31.36.0-255,66,110648,7,309769
39932,0.001655,172.217.194.0-255,7156,117804,7,309769
39933,0.001658,172.31.36.0-255,66,117870,7,309769
39934,0.001673,172.31.36.0-255,66,117936,7,309769
39935,0.001678,172.217.194.0-255,4320,122256,7,309769
39936,0.00168,172.31.36.0-255,66,122322,7,309769
39937,0.001698,172.217.194.0-255,2184,124506,7,309769
39938,0.0017,172.31.36.0-255,66,124572,7,309769
39939,0.001703,172.217.194.0-255,1484,126056,7,309769
39940,0.001722,172.217.194.0-255,5738,131794,7,309769
39941,0.001725,172.31.36.0-255,66,131860,7,309769
39942,0.001757,172.31.36.0-255,66,131926,7,309769
39943,0.001778,172.217.194.0-255,7156,139082,7,309769
39944,0.001781,172.31.36.0-255,66,139148,7,309769
39945,0.001793,172.31.36.0-255,66,139214,7,309769
39946,0.002297,172.217.194.0-255,1484,140698,7,309769
39947,0.002303,172.217.194.0-255,2902,143600,7,309769
39948,0.002307,172.31.36.0-255,66,143666,7,309769
39949,0.002311,172.217.194.0-255,1484,145150,7,309769
39950,0.002332,172.217.194.0-255,4320,149470,7,309769
39951,0.002337,172.31.36.0-255,66,149536,7,309769
39952,0.002348,172.217.194.0-255,4320,153856,7,309769
39953,0.00235,172.31.36.0-255,66,153922,7,309769
39954,0.002395,172.31.36.0-255,66,153988,7,309769
39955,0.002407,172.31.36.0-255,66,154054,7,309769
39956,0.00241,172.217.194.0-255,766,154820,7,309769
39957,0.00474,172.217.194.0-255,4320,159140,7,309769
39958,0.004748,172.31.36.0-255,66,159206,7,309769
39959,0.007135,172.217.194.0-255,5738,164944,7,309769
39960,0.007145,172.31.36.0-255,66,165010,7,309769
39961,0.009529,172.217.194.0-255,5738,170748,7,309769
39962,0.009535,172.31.36.0-255,66,170814,7,309769
39963,0.011884,172.217.194.0-255,5738,176552,7,309769
39964,0.011891,172.31.36.0-255,66,176618,7,309769
39965,0.014217,172.217.194.0-255,5738,182356,7,309769
39966,0.014225,172.31.36.0-255,66,182422,7,309769
39967,0.016558,172.217.194.0-255,5738,188160,7,309769
39968,0.016566,172.31.36.0-255,66,188226,7,309769
39969,0.018947,172.217.194.0-255,5738,193964,7,309769
39970,0.018956,172.31.36.0-255,66,194030,7,309769
39971,0.021295,172.217.194.0-255,5738,199768,7,309769
39972,0.021302,172.31.36.0-255,66,199834,7,309769
39973,0.023624,172.217.194.0-255,5738,205572,7,309769
39974,0.023632,172.31.36.0-255,66,205638,7,309769
39975,0.025969,172.217.194.0-255,5738,211376,7,309769
39976,0.025976,172.31.36.0-255,66,211442,7,309769
39977,0.028309,172.217.194.0-255,5738,217180,7,309769
39978,0.028317,172.31.36.0-255,66,217246,7,309769
39979,0.030665,172.217.194.0-255,5738,222984,7,309769
39980,0.030673,172.31.36.0-255,66,223050,7,309769
39981,0.033047,172.217.194.0-255,5738,228788,7,309769
39982,0.033054,172.31.36.0-255,66,228854,7,309769
39983,0.034001,172.31.36.0-255,164,229018,7,309769
39984,0.034031,172.31.36.0-255,1121,230139,7,309769
39985,0.034093,172.31.36.0-255,1514,231653,7,309769
39986,0.034095,172.31.36.0-255,1285,232938,7,309769
39987,0.035437,172.217.194.0-255,5738,238676,7,309769
39988,0.035444,172.31.36.0-255,66,238742,7,309769
39989,0.035549,104.244.42.0-255,66,238808,7,309769
39990,0.035588,104.244.42.0-255,66,238874,7,309769
39991,0.03563,104.244.42.0-255,66,238940,7,309769
39992,0.03781,172.217.194.0-255,5738,244678,7,309769
39993,0.037821,172.31.36.0-255,66,244744,7,309769
39994,0.040172,172.217.194.0-255,5738,250482,7,309769
39995,0.04018,172.31.36.0-255,66,250548,7,309769
39996,0.042526,172.217.194.0-255,5738,256286,7,309769
39997,0.042535,172.31.36.0-255,66,256352,7,309769
39998,0.04487,172.217.194.0-255,5738,262090,7,309769
39999,0.044877,172.31.36.0-255,66,262156,7,309769
40000,0.047199,172.217.194.0-255,5738,267894,7,309769
40001,0.047206,172.31.36.0-255,66,267960,7,309769
40002,0.049539,172.217.194.0-255,5738,273698,7,309769
40003,0.049546,172.31.36.0-255,66,273764,7,309769
40004,0.051895,172.217.194.0-255,5738,279502,7,309769
40005,0.051902,172.31.36.0-255,66,279568,7,309769
40006,0.054251,172.217.194.0-255,5738,285306,7,309769
40007,0.05426,172.31.36.0-255,66,285372,7,309769
40008,0.056605,172.217.194.0-255,5738,291110,7,309769
40009,0.056612,172.31.36.0-255,66,291176,7,309769
40010,0.058984,172.217.194.0-255,5738,296914,7,309769
40011,0.058992,172.31.36.0-255,66,296980,7,309769
40012,0.06133,172.217.194.0-255,5738,302718,7,309769
40013,0.061336,172.31.36.0-255,66,302784,7,309769
40014,0.063697,172.217.194.0-255,5738,308522,7,309769
40015,0.063705,172.31.36.0-255,66,308588,7,309769
40016,0.066021,172.217.194.0-255,944,309532,7,309769
40017,0.06614,172.31.36.0-255,66,309598,7,309769
40018,0.066179,172.31.36.0-255,105,309703,7,309769
40019,0.068499,172.217.194.0-255,66,309769,7,309769
40020,0.0,74.125.24.0-255,307,307,7,287091
40021,3.2e-05,172.31.36.0-255,66,373,7,287091
40022,3.9e-05,74.125.24.0-255,1484,1857,7,287091
40023,4.3e-05,172.31.36.0-255,66,1923,7,287091
40024,5.6e-05,74.125.24.0-255,2902,4825,7,287091
40025,5.9e-05,172.31.36.0-255,66,4891,7,287091
40026,6.6e-05,74.125.24.0-255,5738,10629,7,287091
40027,6.9e-05,172.31.36.0-255,66,10695,7,287091
40028,0.000108,74.125.24.0-255,4640,15335,7,287091
40029,0.000111,172.31.36.0-255,66,15401,7,287091
40030,0.000117,74.125.24.0-255,5738,21139,7,287091
40031,0.000119,172.31.36.0-255,66,21205,7,287091
40032,0.000156,172.31.36.0-255,66,21271,7,287091
40033,0.000308,74.125.24.0-255,1484,22755,7,287091
40034,0.000313,74.125.24.0-255,2902,25657,7,287091
40035,0.000314,172.31.36.0-255,66,25723,7,287091
40036,0.000319,172.31.36.0-255,66,25789,7,287091
40037,0.000356,74.125.24.0-255,5738,31527,7,287091
40038,0.00036,172.31.36.0-255,66,31593,7,287091
40039,0.000366,74.125.24.0-255,4320,35913,7,287091
40040,0.000368,172.31.36.0-255,66,35979,7,287091
40041,0.00038,172.31.36.0-255,66,36045,7,287091
40042,0.000395,74.125.24.0-255,2543,38588,7,287091
40043,0.000398,172.31.36.0-255,66,38654,7,287091
40044,0.000412,74.125.24.0-255,6797,45451,7,287091
40045,0.000415,172.31.36.0-255,66,45517,7,287091
40046,0.000418,74.125.24.0-255,400,45917,7,287091
40047,0.00042,172.31.36.0-255,66,45983,7,287091
40048,0.000516,74.125.24.0-255,108,46091,7,287091
40049,0.00052,172.31.36.0-255,66,46157,7,287091
40050,0.000551,74.125.24.0-255,334,46491,7,287091
40051,0.000822,74.125.24.0-255,1484,47975,7,287091
40052,0.000827,172.31.36.0-255,66,48041,7,287091
40053,0.000854,74.125.24.0-255,2902,50943,7,287091
40054,0.00086,74.125.24.0-255,5738,56681,7,287091
40055,0.00086,172.31.36.0-255,66,56747,7,287091
40056,0.000864,172.31.36.0-255,66,56813,7,287091
40057,0.0009,74.125.24.0-255,4320,61133,7,287091
40058,0.000903,172.31.36.0-255,66,61199,7,287091
40059,0.000939,172.31.36.0-255,66,61265,7,287091
40060,0.000951,172.31.36.0-255,66,61331,7,287091
40061,0.001426,74.125.24.0-255,1484,62815,7,287091
40062,0.001437,74.125.24.0-255,2902,65717,7,287091
40063,0.001441,172.31.36.0-255,66,65783,7,287091
40064,0.001448,74.125.24.0-255,5738,71521,7,287091
40065,0.001451,172.31.36.0-255,66,71587,7,287091
40066,0.001463,74.125.24.0-255,2902,74489,7,287091
40067,0.001465,172.31.36.0-255,66,74555,7,287091
40068,0.001513,172.31.36.0-255,66,74621,7,287091
40069,0.001522,74.125.24.0-255,7156,81777,7,287091
40070,0.001524,172.31.36.0-255,66,81843,7,287091
40071,0.001551,74.125.24.0-255,3602,85445,7,287091
40072,0.001554,172.31.36.0-255,66,85511,7,287091
40073,0.003777,74.125.24.0-255,1484,86995,7,287091
40074,0.003827,74.125.24.0-255,2902,89897,7,287091
40075,0.003831,172.31.36.0-255,66,89963,7,287091
40076,0.003848,74.125.24.0-255,1484,91447,7,287091
40077,0.006068,74.125.24.0-255,4320,95767,7,287091
40078,0.006071,172.31.36.0-255,66,95833,7,287091
40079,0.008313,74.125.24.0-255,4320,100153,7,287091
40080,0.00832,172.31.36.0-255,66,100219,7,287091
40081,0.008352,74.125.24.0-255,1484,101703,7,287091
40082,0.010605,74.125.24.0-255,4320,106023,7,287091
40083,0.010612,172.31.36.0-255,66,106089,7,287091
40084,0.012914,74.125.24.0-255,5738,111827,7,287091
40085,0.012922,172.31.36.0-255,66,111893,7,287091
40086,0.015191,74.125.24.0-255,5738,117631,7,287091
40087,0.015201,172.31.36.0-255,66,117697,7,287091
40088,0.017482,74.125.24.0-255,5738,123435,7,287091
40089,0.01749,172.31.36.0-255,66,123501,7,287091
40090,0.019756,74.125.24.0-255,5738,129239,7,287091
40091,0.019765,172.31.36.0-255,66,129305,7,287091
40092,0.022043,74.125.24.0-255,5738,135043,7,287091
40093,0.02205,172.31.36.0-255,66,135109,7,287091
40094,0.024322,74.125.24.0-255,5738,140847,7,287091
40095,0.024329,172.31.36.0-255,66,140913,7,287091
40096,0.026635,74.125.24.0-255,5738,146651,7,287091
40097,0.026648,172.31.36.0-255,66,146717,7,287091
40098,0.028964,74.125.24.0-255,5738,152455,7,287091
40099,0.028978,172.31.36.0-255,66,152521,7,287091
40100,0.031239,74.125.24.0-255,5738,158259,7,287091
40101,0.031249,172.31.36.0-255,66,158325,7,287091
40102,0.031474,172.31.36.0-255,172,158497,7,287091
40103,0.031531,172.31.36.0-255,1113,159610,7,287091
40104,0.031629,172.31.36.0-255,1514,161124,7,287091
40105,0.031631,172.31.36.0-255,1514,162638,7,287091
40106,0.031632,172.31.36.0-255,1514,164152,7,287091
40107,0.031633,172.31.36.0-255,1514,165666,7,287091
40108,0.031664,172.31.36.0-255,1514,167180,7,287091
40109,0.031665,172.31.36.0-255,71,167251,7,287091
40110,0.033022,104.244.42.0-255,66,167317,7,287091
40111,0.033121,104.244.42.0-255,66,167383,7,287091
40112,0.033207,104.244.42.0-255,66,167449,7,287091
40113,0.033213,104.244.42.0-255,66,167515,7,287091
40114,0.033498,74.125.24.0-255,5738,173253,7,287091
40115,0.033506,172.31.36.0-255,66,173319,7,287091
40116,0.035756,74.125.24.0-255,5738,179057,7,287091
40117,0.035765,172.31.36.0-255,66,179123,7,287091
40118,0.03806,74.125.24.0-255,5738,184861,7,287091
40119,0.038069,172.31.36.0-255,66,184927,7,287091
40120,0.040324,74.125.24.0-255,4320,189247,7,287091
40121,0.040332,172.31.36.0-255,66,189313,7,287091
40122,0.04037,74.125.24.0-255,1484,190797,7,287091
40123,0.042607,74.125.24.0-255,4320,195117,7,287091
40124,0.042613,172.31.36.0-255,66,195183,7,287091
40125,0.044897,74.125.24.0-255,5738,200921,7,287091
40126,0.044903,172.31.36.0-255,66,200987,7,287091
40127,0.047181,74.125.24.0-255,4320,205307,7,287091
40128,0.047191,172.31.36.0-255,66,205373,7,287091
40129,0.047218,74.125.24.0-255,1484,206857,7,287091
40130,0.049488,74.125.24.0-255,4320,211177,7,287091
40131,0.049493,172.31.36.0-255,66,211243,7,287091
40132,0.051774,74.125.24.0-255,5738,216981,7,287091
40133,0.051781,172.31.36.0-255,66,217047,7,287091
40134,0.054042,74.125.24.0-255,5738,222785,7,287091
40135,0.054048,172.31.36.0-255,66,222851,7,287091
40136,0.05633,74.125.24.0-255,5738,228589,7,287091
40137,0.056336,172.31.36.0-255,66,228655,7,287091
40138,0.058611,74.125.24.0-255,5738,234393,7,287091
40139,0.058617,172.31.36.0-255,66,234459,7,287091
40140,0.060931,74.125.24.0-255,5738,240197,7,287091
40141,0.060937,172.31.36.0-255,66,240263,7,287091
40142,0.063217,74.125.24.0-255,5738,246001,7,287091
40143,0.063222,172.31.36.0-255,66,246067,7,287091
40144,0.065468,74.125.24.0-255,5738,251805,7,287091
40145,0.065472,172.31.36.0-255,66,251871,7,287091
40146,0.067742,74.125.24.0-255,5738,257609,7,287091
40147,0.067748,172.31.36.0-255,66,257675,7,287091
40148,0.070009,74.125.24.0-255,5738,263413,7,287091
40149,0.070015,172.31.36.0-255,66,263479,7,287091
40150,0.072254,74.125.24.0-255,2902,266381,7,287091
40151,0.07226,172.31.36.0-255,66,266447,7,287091
40152,0.072299,74.125.24.0-255,2902,269349,7,287091
40153,0.072303,172.31.36.0-255,66,269415,7,287091
40154,0.074527,74.125.24.0-255,2902,272317,7,287091
40155,0.074533,172.31.36.0-255,66,272383,7,287091
40156,0.074565,74.125.24.0-255,2902,275285,7,287091
40157,0.074568,172.31.36.0-255,66,275351,7,287091
40158,0.076785,74.125.24.0-255,2902,278253,7,287091
40159,0.07679,172.31.36.0-255,66,278319,7,287091
40160,0.076829,74.125.24.0-255,2902,281221,7,287091
40161,0.076832,172.31.36.0-255,66,281287,7,287091
40162,0.079078,74.125.24.0-255,5738,287025,7,287091
40163,0.079083,172.31.36.0-255,66,287091,7,287091
40164,0.0,172.31.36.0-255,105,105,7,459
40165,0.000186,172.31.36.0-255,90,195,7,459
40166,0.000197,172.31.36.0-255,66,261,7,459
40167,0.002535,74.125.24.0-255,66,327,7,459
40168,0.002549,74.125.24.0-255,66,393,7,459
40169,0.002559,172.31.36.0-255,66,459,7,459
40170,0.0,74.125.130.0-255,153,153,7,309946
40171,2.1e-05,172.31.36.0-255,66,219,7,309946
40172,2.9e-05,74.125.130.0-255,1484,1703,7,309946
40173,3.4e-05,172.31.36.0-255,66,1769,7,309946
40174,3.8e-05,74.125.130.0-255,1484,3253,7,309946
40175,4.1e-05,172.31.36.0-255,66,3319,7,309946
40176,4.8e-05,74.125.130.0-255,2902,6221,7,309946
40177,5.1e-05,172.31.36.0-255,66,6287,7,309946
40178,5.8e-05,74.125.130.0-255,5738,12025,7,309946
40179,6.1e-05,172.31.36.0-255,66,12091,7,309946
40180,6.5e-05,74.125.130.0-255,2064,14155,7,309946
40181,6.9e-05,172.31.36.0-255,66,14221,7,309946
40182,9.2e-05,74.125.130.0-255,2902,17123,7,309946
40183,9.5e-05,172.31.36.0-255,66,17189,7,309946
40184,0.000119,74.125.130.0-255,5738,22927,7,309946
40185,0.000122,172.31.36.0-255,66,22993,7,309946
40186,0.000142,74.125.130.0-255,2902,25895,7,309946
40187,0.000144,172.31.36.0-255,66,25961,7,309946
40188,0.000167,74.125.130.0-255,4320,30281,7,309946
40189,0.00017,172.31.36.0-255,66,30347,7,309946
40190,0.000173,74.125.130.0-255,1125,31472,7,309946
40191,0.000175,172.31.36.0-255,66,31538,7,309946
40192,0.000327,74.125.130.0-255,1484,33022,7,309946
40193,0.000333,172.31.36.0-255,66,33088,7,309946
40194,0.000337,74.125.130.0-255,1484,34572,7,309946
40195,0.000339,172.31.36.0-255,66,34638,7,309946
40196,0.000361,74.125.130.0-255,1484,36122,7,309946
40197,0.000364,172.31.36.0-255,66,36188,7,309946
40198,0.000368,74.125.130.0-255,1484,37672,7,309946
40199,0.00037,172.31.36.0-255,66,37738,7,309946
40200,0.000388,74.125.130.0-255,2902,40640,7,309946
40201,0.000391,172.31.36.0-255,66,40706,7,309946
40202,0.000397,74.125.130.0-255,5738,46444,7,309946
40203,0.0004,172.31.36.0-255,66,46510,7,309946
40204,0.000423,74.125.130.0-255,2543,49053,7,309946
40205,0.000425,172.31.36.0-255,66,49119,7,309946
40206,0.000647,74.125.130.0-255,1484,50603,7,309946
40207,0.000671,74.125.130.0-255,2902,53505,7,309946
40208,0.000675,172.31.36.0-255,66,53571,7,309946
40209,0.000698,74.125.130.0-255,4320,57891,7,309946
40210,0.000701,172.31.36.0-255,66,57957,7,309946
40211,0.00072,74.125.130.0-255,2902,60859,7,309946
40212,0.000723,172.31.36.0-255,66,60925,7,309946
40213,0.000741,74.125.130.0-255,4320,65245,7,309946
40214,0.000744,172.31.36.0-255,66,65311,7,309946
40215,0.000765,74.125.130.0-255,1125,66436,7,309946
40216,0.001234,74.125.130.0-255,646,67082,7,309946
40217,0.00124,172.31.36.0-255,66,67148,7,309946
40218,0.001474,74.125.130.0-255,1484,68632,7,309946
40219,0.001493,74.125.130.0-255,2902,71534,7,309946
40220,0.001497,172.31.36.0-255,66,71600,7,309946
40221,0.00153,74.125.130.0-255,5738,77338,7,309946
40222,0.001533,172.31.36.0-255,66,77404,7,309946
40223,0.001537,74.125.130.0-255,1484,78888,7,309946
40224,0.001542,74.125.130.0-255,2902,81790,7,309946
40225,0.001544,172.31.36.0-255,66,81856,7,309946
40226,0.001564,74.125.130.0-255,1484,83340,7,309946
40227,0.001585,74.125.130.0-255,4320,87660,7,309946
40228,0.001589,172.31.36.0-255,66,87726,7,309946
40229,0.001593,74.125.130.0-255,1484,89210,7,309946
40230,0.001639,172.31.36.0-255,66,89276,7,309946
40231,0.001643,74.125.130.0-255,1484,90760,7,309946
40232,0.001647,74.125.130.0-255,2184,92944,7,309946
40233,0.001649,172.31.36.0-255,66,93010,7,309946
40234,0.002066,74.125.130.0-255,1484,94494,7,309946
40235,0.002084,74.125.130.0-255,2902,97396,7,309946
40236,0.002089,172.31.36.0-255,66,97462,7,309946
40237,0.002097,74.125.130.0-255,4320,101782,7,309946
40238,0.002099,172.31.36.0-255,66,101848,7,309946
40239,0.002103,74.125.130.0-255,1484,103332,7,309946
40240,0.002126,74.125.130.0-255,4320,107652,7,309946
40241,0.002128,172.31.36.0-255,66,107718,7,309946
40242,0.00214,74.125.130.0-255,2902,110620,7,309946
40243,0.002142,172.31.36.0-255,66,110686,7,309946
40244,0.002168,74.125.130.0-255,5738,116424,7,309946
40245,0.00217,172.31.36.0-255,66,116490,7,309946
40246,0.002183,172.31.36.0-255,66,116556,7,309946
40247,0.002185,74.125.130.0-255,766,117322,7,309946
40248,0.002488,74.125.130.0-255,1484,118806,7,309946
40249,0.002491,172.31.36.0-255,66,118872,7,309946
40250,0.002512,74.125.130.0-255,2902,121774,7,309946
40251,0.002514,172.31.36.0-255,66,121840,7,309946
40252,0.002531,74.125.130.0-255,1484,123324,7,309946
40253,0.002544,74.125.130.0-255,4320,127644,7,309946
40254,0.002548,172.31.36.0-255,66,127710,7,309946
40255,0.002551,74.125.130.0-255,1484,129194,7,309946
40256,0.002565,74.125.130.0-255,2902,132096,7,309946
40257,0.002568,172.31.36.0-255,66,132162,7,309946
40258,0.002587,74.125.130.0-255,4320,136482,7,309946
40259,0.00259,172.31.36.0-255,66,136548,7,309946
40260,0.005161,74.125.130.0-255,2902,139450,7,309946
40261,0.005169,172.31.36.0-255,66,139516,7,309946
40262,0.005191,74.125.130.0-255,2902,142418,7,309946
40263,0.005194,172.31.36.0-255,66,142484,7,309946
40264,0.007739,74.125.130.0-255,2902,145386,7,309946
40265,0.007746,172.31.36.0-255,66,145452,7,309946
40266,0.007764,74.125.130.0-255,2902,148354,7,309946
40267,0.007766,172.31.36.0-255,66,148420,7,309946
40268,0.010327,74.125.130.0-255,5738,154158,7,309946
40269,0.010334,172.31.36.0-255,66,154224,7,309946
40270,0.012911,74.125.130.0-255,5738,159962,7,309946
40271,0.012919,172.31.36.0-255,66,160028,7,309946
40272,0.015494,74.125.130.0-255,5738,165766,7,309946
40273,0.015503,172.31.36.0-255,66,165832,7,309946
40274,0.018079,74.125.130.0-255,5738,171570,7,309946
40275,0.018093,172.31.36.0-255,66,171636,7,309946
40276,0.020666,74.125.130.0-255,5738,177374,7,309946
40277,0.020674,172.31.36.0-255,66,177440,7,309946
40278,0.02324,74.125.130.0-255,5738,183178,7,309946
40279,0.023248,172.31.36.0-255,66,183244,7,309946
40280,0.025812,74.125.130.0-255,5738,188982,7,309946
40281,0.02582,172.31.36.0-255,66,189048,7,309946
40282,0.026546,172.31.36.0-255,172,189220,7,309946
40283,0.026579,172.31.36.0-255,1114,190334,7,309946
40284,0.026635,172.31.36.0-255,1514,191848,7,309946
40285,0.026637,172.31.36.0-255,1292,193140,7,309946
40286,0.028089,104.244.42.0-255,66,193206,7,309946
40287,0.028167,104.244.42.0-255,66,193272,7,309946
40288,0.028236,104.244.42.0-255,66,193338,7,309946
40289,0.028391,74.125.130.0-255,5738,199076,7,309946
40290,0.028397,172.31.36.0-255,66,199142,7,309946
40291,0.030972,74.125.130.0-255,5738,204880,7,309946
40292,0.030979,172.31.36.0-255,66,204946,7,309946
40293,0.033558,74.125.130.0-255,5738,210684,7,309946
40294,0.033566,172.31.36.0-255,66,210750,7,309946
40295,0.036147,74.125.130.0-255,5738,216488,7,309946
40296,0.036154,172.31.36.0-255,66,216554,7,309946
40297,0.038775,74.125.130.0-255,5738,222292,7,309946
40298,0.038782,172.31.36.0-255,66,222358,7,309946
40299,0.041361,74.125.130.0-255,5738,228096,7,309946
40300,0.041371,172.31.36.0-255,66,228162,7,309946
40301,0.043947,74.125.130.0-255,5738,233900,7,309946
40302,0.043953,172.31.36.0-255,66,233966,7,309946
40303,0.046518,74.125.130.0-255,2902,236868,7,309946
40304,0.046525,172.31.36.0-255,66,236934,7,309946
40305,0.046544,74.125.130.0-255,2902,239836,7,309946
40306,0.046547,172.31.36.0-255,66,239902,7,309946
40307,0.049082,74.125.130.0-255,2902,242804,7,309946
40308,0.049089,172.31.36.0-255,66,242870,7,309946
40309,0.049109,74.125.130.0-255,2902,245772,7,309946
40310,0.049111,172.31.36.0-255,66,245838,7,309946
40311,0.051646,74.125.130.0-255,2902,248740,7,309946
40312,0.051653,172.31.36.0-255,66,248806,7,309946
40313,0.05167,74.125.130.0-255,2902,251708,7,309946
40314,0.051673,172.31.36.0-255,66,251774,7,309946
40315,0.054214,74.125.130.0-255,2902,254676,7,309946
40316,0.054223,172.31.36.0-255,66,254742,7,309946
40317,0.054242,74.125.130.0-255,2902,257644,7,309946
40318,0.054245,172.31.36.0-255,66,257710,7,309946
40319,0.056796,74.125.130.0-255,5738,263448,7,309946
40320,0.056802,172.31.36.0-255,66,263514,7,309946
40321,0.059386,74.125.130.0-255,5738,269252,7,309946
40322,0.059392,172.31.36.0-255,66,269318,7,309946
40323,0.061967,74.125.130.0-255,5738,275056,7,309946
40324,0.061974,172.31.36.0-255,66,275122,7,309946
40325,0.064565,74.125.130.0-255,5738,280860,7,309946
40326,0.064571,172.31.36.0-255,66,280926,7,309946
40327,0.067153,74.125.130.0-255,5738,286664,7,309946
40328,0.067161,172.31.36.0-255,66,286730,7,309946
40329,0.069741,74.125.130.0-255,5738,292468,7,309946
40330,0.069747,172.31.36.0-255,66,292534,7,309946
40331,0.072328,74.125.130.0-255,5738,298272,7,309946
40332,0.072335,172.31.36.0-255,66,298338,7,309946
40333,0.074923,74.125.130.0-255,5738,304076,7,309946
40334,0.074929,172.31.36.0-255,66,304142,7,309946
40335,0.077517,74.125.130.0-255,5738,309880,7,309946
40336,0.077525,172.31.36.0-255,66,309946,7,309946
40337,0.0,74.125.24.0-255,153,153,7,257109
40338,2.7e-05,172.31.36.0-255,66,219,7,257109
40339,3.4e-05,74.125.24.0-255,1484,1703,7,257109
40340,3.8e-05,172.31.36.0-255,66,1769,7,257109
40341,4.3e-05,74.125.24.0-255,2902,4671,7,257109
40342,4.6e-05,172.31.36.0-255,66,4737,7,257109
40343,5.3e-05,74.125.24.0-255,7156,11893,7,257109
40344,5.6e-05,172.31.36.0-255,66,11959,7,257109
40345,5.9e-05,74.125.24.0-255,1484,13443,7,257109
40346,6.1e-05,172.31.36.0-255,66,13509,7,257109
40347,8.2e-05,74.125.24.0-255,631,14140,7,257109
40348,8.6e-05,172.31.36.0-255,66,14206,7,257109
40349,0.000127,74.125.24.0-255,1484,15690,7,257109
40350,0.00013,172.31.36.0-255,66,15756,7,257109
40351,0.000136,74.125.24.0-255,2902,18658,7,257109
40352,0.000138,172.31.36.0-255,66,18724,7,257109
40353,0.000141,74.125.24.0-255,1484,20208,7,257109
40354,0.000142,172.31.36.0-255,66,20274,7,257109
40355,0.000161,74.125.24.0-255,4320,24594,7,257109
40356,0.000164,172.31.36.0-255,66,24660,7,257109
40357,0.00019,74.125.24.0-255,4320,28980,7,257109
40358,0.000193,172.31.36.0-255,66,29046,7,257109
40359,0.000211,74.125.24.0-255,2543,31589,7,257109
40360,0.000213,172.31.36.0-255,66,31655,7,257109
40361,0.000325,74.125.24.0-255,1484,33139,7,257109
40362,0.00033,172.31.36.0-255,66,33205,7,257109
40363,0.000334,74.125.24.0-255,2902,36107,7,257109
40364,0.000336,172.31.36.0-255,66,36173,7,257109
40365,0.000342,74.125.24.0-255,4320,40493,7,257109
40366,0.000344,172.31.36.0-255,66,40559,7,257109
40367,0.000365,74.125.24.0-255,1484,42043,7,257109
40368,0.000368,172.31.36.0-255,66,42109,7,257109
40369,0.000375,74.125.24.0-255,5738,47847,7,257109
40370,0.000378,172.31.36.0-255,66,47913,7,257109
40371,0.000407,172.31.36.0-255,66,47979,7,257109
40372,0.000419,172.31.36.0-255,66,48045,7,257109
40373,0.000422,74.125.24.0-255,400,48445,7,257109
40374,0.000474,74.125.24.0-255,109,48554,7,257109
40375,0.000572,74.125.24.0-255,331,48885,7,257109
40376,0.000801,172.31.36.0-255,66,48951,7,257109
40377,0.000952,74.125.24.0-255,1484,50435,7,257109
40378,0.000962,74.125.24.0-255,2902,53337,7,257109
40379,0.000965,172.31.36.0-255,66,53403,7,257109
40380,0.000973,74.125.24.0-255,5738,59141,7,257109
40381,0.000975,172.31.36.0-255,66,59207,7,257109
40382,0.001005,172.31.36.0-255,66,59273,7,257109
40383,0.001021,74.125.24.0-255,1484,60757,7,257109
40384,0.001034,172.31.36.0-255,66,60823,7,257109
40385,0.001213,74.125.24.0-255,1484,62307,7,257109
40386,0.001221,74.125.24.0-255,2902,65209,7,257109
40387,0.001225,172.31.36.0-255,66,65275,7,257109
40388,0.001231,74.125.24.0-255,4320,69595,7,257109
40389,0.00125,172.31.36.0-255,66,69661,7,257109
40390,0.001278,74.125.24.0-255,1484,71145,7,257109
40391,0.001295,172.31.36.0-255,66,71211,7,257109
40392,0.001306,172.31.36.0-255,66,71277,7,257109
40393,0.001309,74.125.24.0-255,766,72043,7,257109
40394,0.001913,74.125.24.0-255,1484,73527,7,257109
40395,0.001918,172.31.36.0-255,66,73593,7,257109
40396,0.001924,74.125.24.0-255,2902,76495,7,257109
40397,0.001927,172.31.36.0-255,66,76561,7,257109
40398,0.001931,74.125.24.0-255,2902,79463,7,257109
40399,0.001933,172.31.36.0-255,66,79529,7,257109
40400,0.001959,74.125.24.0-255,2902,82431,7,257109
40401,0.001962,172.31.36.0-255,66,82497,7,257109
40402,0.001975,172.31.36.0-255,66,82563,7,257109
40403,0.001981,74.125.24.0-255,5738,88301,7,257109
40404,0.001983,172.31.36.0-255,66,88367,7,257109
40405,0.002001,74.125.24.0-255,5020,93387,7,257109
40406,0.002003,172.31.36.0-255,66,93453,7,257109
40407,0.002149,74.125.24.0-255,1484,94937,7,257109
40408,0.002166,74.125.24.0-255,2902,97839,7,257109
40409,0.002168,172.31.36.0-255,66,97905,7,257109
40410,0.002206,74.125.24.0-255,2902,100807,7,257109
40411,0.002208,172.31.36.0-255,66,100873,7,257109
40412,0.002229,74.125.24.0-255,2902,103775,7,257109
40413,0.00223,172.31.36.0-255,66,103841,7,257109
40414,0.002243,172.31.36.0-255,66,103907,7,257109
40415,0.002255,172.31.36.0-255,66,103973,7,257109
40416,0.002301,74.125.24.0-255,1484,105457,7,257109
40417,0.002303,74.125.24.0-255,1484,106941,7,257109
40418,0.002305,172.31.36.0-255,66,107007,7,257109
40419,0.002321,74.125.24.0-255,1484,108491,7,257109
40420,0.002328,74.125.24.0-255,5738,114229,7,257109
40421,0.00233,172.31.36.0-255,66,114295,7,257109
40422,0.002332,74.125.24.0-255,1484,115779,7,257109
40423,0.002357,172.31.36.0-255,66,115845,7,257109
40424,0.002399,172.31.36.0-255,66,115911,7,257109
40425,0.002412,74.125.24.0-255,2902,118813,7,257109
40426,0.002415,172.31.36.0-255,66,118879,7,257109
40427,0.002452,172.31.36.0-255,66,118945,7,257109
40428,0.002465,172.31.36.0-255,66,119011,7,257109
40429,0.002507,172.31.36.0-255,66,119077,7,257109
40430,0.002522,74.125.24.0-255,3602,122679,7,257109
40431,0.002524,172.31.36.0-255,66,122745,7,257109
40432,0.002538,172.31.36.0-255,66,122811,7,257109
40433,0.002548,172.31.36.0-255,66,122877,7,257109
40434,0.00255,74.125.24.0-255,1484,124361,7,257109
40435,0.005029,74.125.24.0-255,4320,128681,7,257109
40436,0.005034,172.31.36.0-255,66,128747,7,257109
40437,0.007546,74.125.24.0-255,5738,134485,7,257109
40438,0.007551,172.31.36.0-255,66,134551,7,257109
40439,0.010083,74.125.24.0-255,5738,140289,7,257109
40440,0.010095,172.31.36.0-255,66,140355,7,257109
40441,0.012611,74.125.24.0-255,5738,146093,7,257109
40442,0.012622,172.31.36.0-255,66,146159,7,257109
40443,0.015193,74.125.24.0-255,5738,151897,7,257109
40444,0.015205,172.31.36.0-255,66,151963,7,257109
40445,0.017724,74.125.24.0-255,5738,157701,7,257109
40446,0.017731,172.31.36.0-255,66,157767,7,257109
40447,0.020227,74.125.24.0-255,4320,162087,7,257109
40448,0.02023,172.31.36.0-255,66,162153,7,257109
40449,0.020247,74.125.24.0-255,1484,163637,7,257109
40450,0.022758,74.125.24.0-255,4320,167957,7,257109
40451,0.022769,172.31.36.0-255,66,168023,7,257109
40452,0.025277,74.125.24.0-255,5738,173761,7,257109
40453,0.025285,172.31.36.0-255,66,173827,7,257109
40454,0.027824,74.125.24.0-255,5738,179565,7,257109
40455,0.027831,172.31.36.0-255,66,179631,7,257109
40456,0.028154,172.31.36.0-255,172,179803,7,257109
40457,0.028185,172.31.36.0-255,1114,180917,7,257109
40458,0.028225,172.31.36.0-255,1514,182431,7,257109
40459,0.028227,172.31.36.0-255,1294,183725,7,257109
40460,0.029625,104.244.42.0-255,66,183791,7,257109
40461,0.029817,104.244.42.0-255,66,183857,7,257109
40462,0.029822,104.244.42.0-255,66,183923,7,257109
40463,0.030334,74.125.24.0-255,4320,188243,7,257109
40464,0.030338,172.31.36.0-255,66,188309,7,257109
40465,0.030401,74.125.24.0-255,1484,189793,7,257109
40466,0.032844,74.125.24.0-255,4320,194113,7,257109
40467,0.03285,172.31.36.0-255,66,194179,7,257109
40468,0.035371,74.125.24.0-255,2902,197081,7,257109
40469,0.035376,172.31.36.0-255,66,197147,7,257109
40470,0.035409,74.125.24.0-255,2902,200049,7,257109
40471,0.035413,172.31.36.0-255,66,200115,7,257109
40472,0.037874,74.125.24.0-255,2902,203017,7,257109
40473,0.037879,172.31.36.0-255,66,203083,7,257109
40474,0.037909,74.125.24.0-255,2902,205985,7,257109
40475,0.037912,172.31.36.0-255,66,206051,7,257109
40476,0.040366,74.125.24.0-255,2902,208953,7,257109
40477,0.040372,172.31.36.0-255,66,209019,7,257109
40478,0.040401,74.125.24.0-255,2902,211921,7,257109
40479,0.040405,172.31.36.0-255,66,211987,7,257109
40480,0.042879,74.125.24.0-255,2902,214889,7,257109
40481,0.042885,172.31.36.0-255,66,214955,7,257109
40482,0.042922,74.125.24.0-255,2902,217857,7,257109
40483,0.042925,172.31.36.0-255,66,217923,7,257109
40484,0.045366,74.125.24.0-255,2902,220825,7,257109
40485,0.045371,172.31.36.0-255,66,220891,7,257109
40486,0.045407,74.125.24.0-255,2902,223793,7,257109
40487,0.045411,172.31.36.0-255,66,223859,7,257109
40488,0.047878,74.125.24.0-255,2902,226761,7,257109
40489,0.047883,172.31.36.0-255,66,226827,7,257109
40490,0.047919,74.125.24.0-255,2902,229729,7,257109
40491,0.047922,172.31.36.0-255,66,229795,7,257109
40492,0.050395,74.125.24.0-255,2902,232697,7,257109
40493,0.050401,172.31.36.0-255,66,232763,7,257109
40494,0.050431,74.125.24.0-255,2902,235665,7,257109
40495,0.050434,172.31.36.0-255,66,235731,7,257109
40496,0.052909,74.125.24.0-255,2902,238633,7,257109
40497,0.052915,172.31.36.0-255,66,238699,7,257109
40498,0.052947,74.125.24.0-255,2902,241601,7,257109
40499,0.05295,172.31.36.0-255,66,241667,7,257109
40500,0.055402,74.125.24.0-255,2902,244569,7,257109
40501,0.055407,172.31.36.0-255,66,244635,7,257109
40502,0.055476,74.125.24.0-255,2902,247537,7,257109
40503,0.055481,172.31.36.0-255,66,247603,7,257109
40504,0.057892,74.125.24.0-255,2902,250505,7,257109
40505,0.057897,172.31.36.0-255,66,250571,7,257109
40506,0.057964,74.125.24.0-255,2902,253473,7,257109
40507,0.057968,172.31.36.0-255,66,253539,7,257109
40508,0.060391,74.125.24.0-255,2902,256441,7,257109
40509,0.060397,172.31.36.0-255,66,256507,7,257109
40510,0.060464,74.125.24.0-255,365,256872,7,257109
40511,0.060551,172.31.36.0-255,66,256938,7,257109
40512,0.060576,172.31.36.0-255,105,257043,7,257109
40513,0.063064,74.125.24.0-255,66,257109,7,257109
40514,0.0,172.31.36.0-255,105,105,7,276
40515,0.069089,31.13.82.0-255,105,210,7,276
40516,0.069102,172.31.36.0-255,66,276,7,276
40517,0.0,74.125.24.0-255,153,153,7,168587
40518,2.6e-05,172.31.36.0-255,66,219,7,168587
40519,3.4e-05,74.125.24.0-255,1484,1703,7,168587
40520,3.8e-05,172.31.36.0-255,66,1769,7,168587
40521,4.3e-05,74.125.24.0-255,2902,4671,7,168587
40522,4.7e-05,172.31.36.0-255,66,4737,7,168587
40523,5.5e-05,74.125.24.0-255,7156,11893,7,168587
40524,5.8e-05,172.31.36.0-255,66,11959,7,168587
40525,6.1e-05,74.125.24.0-255,1979,13938,7,168587
40526,6.4e-05,172.31.36.0-255,66,14004,7,168587
40527,9.7e-05,74.125.24.0-255,2902,16906,7,168587
40528,0.000102,172.31.36.0-255,66,16972,7,168587
40529,0.000122,74.125.24.0-255,1484,18456,7,168587
40530,0.000125,172.31.36.0-255,66,18522,7,168587
40531,0.000132,74.125.24.0-255,5738,24260,7,168587
40532,0.000134,172.31.36.0-255,66,24326,7,168587
40533,0.000157,74.125.24.0-255,2902,27228,7,168587
40534,0.00016,172.31.36.0-255,66,27294,7,168587
40535,0.00018,74.125.24.0-255,3961,31255,7,168587
40536,0.000183,172.31.36.0-255,66,31321,7,168587
40537,0.000217,74.125.24.0-255,1484,32805,7,168587
40538,0.00022,172.31.36.0-255,66,32871,7,168587
40539,0.000226,74.125.24.0-255,2902,35773,7,168587
40540,0.000229,172.31.36.0-255,66,35839,7,168587
40541,0.000232,74.125.24.0-255,1484,37323,7,168587
40542,0.000234,172.31.36.0-255,66,37389,7,168587
40543,0.000257,74.125.24.0-255,4320,41709,7,168587
40544,0.000259,172.31.36.0-255,66,41775,7,168587
40545,0.000266,74.125.24.0-255,4320,46095,7,168587
40546,0.000269,172.31.36.0-255,66,46161,7,168587
40547,0.000295,172.31.36.0-255,66,46227,7,168587
40548,0.000321,74.125.24.0-255,2543,48770,7,168587
40549,0.000324,172.31.36.0-255,66,48836,7,168587
40550,0.000333,74.125.24.0-255,6797,55633,7,168587
40551,0.000335,172.31.36.0-255,66,55699,7,168587
40552,0.000338,74.125.24.0-255,356,56055,7,168587
40553,0.00048,74.125.24.0-255,388,56443,7,168587
40554,0.000505,74.125.24.0-255,1484,57927,7,168587
40555,0.000509,172.31.36.0-255,66,57993,7,168587
40556,0.000529,74.125.24.0-255,4320,62313,7,168587
40557,0.000532,172.31.36.0-255,66,62379,7,168587
40558,0.000561,74.125.24.0-255,1484,63863,7,168587
40559,0.000577,74.125.24.0-255,5738,69601,7,168587
40560,0.00058,172.31.36.0-255,66,69667,7,168587
40561,0.000599,74.125.24.0-255,2902,72569,7,168587
40562,0.000602,172.31.36.0-255,66,72635,7,168587
40563,0.000618,172.31.36.0-255,66,72701,7,168587
40564,0.000622,74.125.24.0-255,2184,74885,7,168587
40565,0.000625,172.31.36.0-255,66,74951,7,168587
40566,0.000828,74.125.24.0-255,1484,76435,7,168587
40567,0.000834,74.125.24.0-255,2902,79337,7,168587
40568,0.000837,172.31.36.0-255,66,79403,7,168587
40569,0.000844,74.125.24.0-255,5738,85141,7,168587
40570,0.000846,172.31.36.0-255,66,85207,7,168587
40571,0.000885,172.31.36.0-255,66,85273,7,168587
40572,0.000919,74.125.24.0-255,5738,91011,7,168587
40573,0.000923,172.31.36.0-255,66,91077,7,168587
40574,0.00095,172.31.36.0-255,66,91143,7,168587
40575,0.000977,74.125.24.0-255,1484,92627,7,168587
40576,0.000981,74.125.24.0-255,1484,94111,7,168587
40577,0.000983,172.31.36.0-255,66,94177,7,168587
40578,0.001005,74.125.24.0-255,1484,95661,7,168587
40579,0.001012,74.125.24.0-255,5738,101399,7,168587
40580,0.001015,172.31.36.0-255,66,101465,7,168587
40581,0.001027,172.31.36.0-255,66,101531,7,168587
40582,0.001094,172.31.36.0-255,66,101597,7,168587
40583,0.001648,74.125.24.0-255,1484,103081,7,168587
40584,0.00167,74.125.24.0-255,2902,105983,7,168587
40585,0.001675,172.31.36.0-255,66,106049,7,168587
40586,0.00171,74.125.24.0-255,4320,110369,7,168587
40587,0.001714,172.31.36.0-255,66,110435,7,168587
40588,0.001738,74.125.24.0-255,1484,111919,7,168587
40589,0.001746,74.125.24.0-255,7156,119075,7,168587
40590,0.001748,172.31.36.0-255,66,119141,7,168587
40591,0.001762,172.31.36.0-255,66,119207,7,168587
40592,0.00179,74.125.24.0-255,3602,122809,7,168587
40593,0.001795,172.31.36.0-255,66,122875,7,168587
40594,0.001981,74.125.24.0-255,1484,124359,7,168587
40595,0.001987,74.125.24.0-255,2902,127261,7,168587
40596,0.00199,172.31.36.0-255,66,127327,7,168587
40597,0.001994,74.125.24.0-255,2902,130229,7,168587
40598,0.001996,172.31.36.0-255,66,130295,7,168587
40599,0.002011,74.125.24.0-255,2902,133197,7,168587
40600,0.002013,172.31.36.0-255,66,133263,7,168587
40601,0.002051,172.31.36.0-255,66,133329,7,168587
40602,0.002063,172.31.36.0-255,66,133395,7,168587
40603,0.002089,74.125.24.0-255,3602,136997,7,168587
40604,0.002092,172.31.36.0-255,66,137063,7,168587
40605,0.002111,172.31.36.0-255,66,137129,7,168587
40606,0.002125,172.31.36.0-255,66,137195,7,168587
40607,0.002132,74.125.24.0-255,7156,144351,7,168587
40608,0.002135,172.31.36.0-255,66,144417,7,168587
40609,0.00217,74.125.24.0-255,6438,150855,7,168587
40610,0.002172,172.31.36.0-255,66,150921,7,168587
40611,0.002183,172.31.36.0-255,66,150987,7,168587
40612,0.0022,74.125.24.0-255,1484,152471,7,168587
40613,0.002222,172.31.36.0-255,66,152537,7,168587
40614,0.002225,74.125.24.0-255,1484,154021,7,168587
40615,0.002253,172.31.36.0-255,66,154087,7,168587
40616,0.002257,74.125.24.0-255,2902,156989,7,168587
40617,0.002259,172.31.36.0-255,66,157055,7,168587
40618,0.002283,172.31.36.0-255,66,157121,7,168587
40619,0.002305,74.125.24.0-255,5020,162141,7,168587
40620,0.002308,172.31.36.0-255,66,162207,7,168587
40621,0.002352,172.31.36.0-255,66,162273,7,168587
40622,0.002398,172.31.36.0-255,66,162339,7,168587
40623,0.002421,172.31.36.0-255,66,162405,7,168587
40624,0.002423,74.125.24.0-255,1484,163889,7,168587
40625,0.002467,172.31.36.0-255,66,163955,7,168587
40626,0.004809,74.125.24.0-255,105,164060,7,168587
40627,0.004919,172.31.36.0-255,66,164126,7,168587
40628,0.004948,172.31.36.0-255,105,164231,7,168587
40629,0.007292,74.125.24.0-255,66,164297,7,168587
40630,0.033964,172.31.36.0-255,172,164469,7,168587
40631,0.034005,172.31.36.0-255,1114,165583,7,168587
40632,0.034079,172.31.36.0-255,1514,167097,7,168587
40633,0.034081,172.31.36.0-255,1292,168389,7,168587
40634,0.035495,104.244.42.0-255,66,168455,7,168587
40635,0.035521,104.244.42.0-255,66,168521,7,168587
40636,0.03562,104.244.42.0-255,66,168587,7,168587
40637,0.0,172.217.194.0-255,153,153,7,248688
40638,3.6e-05,172.31.36.0-255,66,219,7,248688
40639,4.3e-05,172.217.194.0-255,1484,1703,7,248688
40640,4.8e-05,172.31.36.0-255,66,1769,7,248688
40641,5.3e-05,172.217.194.0-255,2902,4671,7,248688
40642,5.6e-05,172.31.36.0-255,66,4737,7,248688
40643,6.4e-05,172.217.194.0-255,7156,11893,7,248688
40644,6.7e-05,172.31.36.0-255,66,11959,7,248688
40645,7.1e-05,172.217.194.0-255,2068,14027,7,248688
40646,7.5e-05,172.31.36.0-255,66,14093,7,248688
40647,0.000424,172.217.194.0-255,1484,15577,7,248688
40648,0.00043,172.31.36.0-255,66,15643,7,248688
40649,0.00044,172.217.194.0-255,2902,18545,7,248688
40650,0.000443,172.31.36.0-255,66,18611,7,248688
40651,0.000486,172.217.194.0-255,5738,24349,7,248688
40652,0.00049,172.31.36.0-255,66,24415,7,248688
40653,0.000515,172.217.194.0-255,6797,31212,7,248688
40654,0.000519,172.31.36.0-255,66,31278,7,248688
40655,0.000814,172.217.194.0-255,1484,32762,7,248688
40656,0.00082,172.31.36.0-255,66,32828,7,248688
40657,0.000827,172.217.194.0-255,2902,35730,7,248688
40658,0.00083,172.31.36.0-255,66,35796,7,248688
40659,0.000836,172.217.194.0-255,5738,41534,7,248688
40660,0.00084,172.31.36.0-255,66,41600,7,248688
40661,0.000871,172.31.36.0-255,66,41666,7,248688
40662,0.000889,172.217.194.0-255,3961,45627,7,248688
40663,0.000891,172.31.36.0-255,66,45693,7,248688
40664,0.000928,172.31.36.0-255,66,45759,7,248688
40665,0.00186,172.217.194.0-255,648,46407,7,248688
40666,0.001866,172.31.36.0-255,66,46473,7,248688
40667,0.002014,172.217.194.0-255,1484,47957,7,248688
40668,0.002021,172.217.194.0-255,2902,50859,7,248688
40669,0.002024,172.31.36.0-255,66,50925,7,248688
40670,0.002027,172.217.194.0-255,1484,52409,7,248688
40671,0.002048,172.217.194.0-255,4320,56729,7,248688
40672,0.00205,172.31.36.0-255,66,56795,7,248688
40673,0.002054,172.217.194.0-255,2902,59697,7,248688
40674,0.002056,172.31.36.0-255,66,59763,7,248688
40675,0.002081,172.31.36.0-255,66,59829,7,248688
40676,0.002091,172.31.36.0-255,66,59895,7,248688
40677,0.002498,172.217.194.0-255,1484,61379,7,248688
40678,0.002504,172.217.194.0-255,2902,64281,7,248688
40679,0.002506,172.31.36.0-255,66,64347,7,248688
40680,0.002527,172.217.194.0-255,5738,70085,7,248688
40681,0.00253,172.31.36.0-255,66,70151,7,248688
40682,0.002533,172.217.194.0-255,1484,71635,7,248688
40683,0.005033,172.217.194.0-255,4320,75955,7,248688
40684,0.005044,172.31.36.0-255,66,76021,7,248688
40685,0.00755,172.217.194.0-255,5738,81759,7,248688
40686,0.007561,172.31.36.0-255,66,81825,7,248688
40687,0.010076,172.217.194.0-255,5738,87563,7,248688
40688,0.010089,172.31.36.0-255,66,87629,7,248688
40689,0.012574,172.217.194.0-255,5738,93367,7,248688
40690,0.012585,172.31.36.0-255,66,93433,7,248688
40691,0.015092,172.217.194.0-255,5738,99171,7,248688
40692,0.015103,172.31.36.0-255,66,99237,7,248688
40693,0.01762,172.217.194.0-255,5738,104975,7,248688
40694,0.017635,172.31.36.0-255,66,105041,7,248688
40695,0.020131,172.217.194.0-255,5738,110779,7,248688
40696,0.020141,172.31.36.0-255,66,110845,7,248688
40697,0.020274,172.31.36.0-255,167,111012,7,248688
40698,0.020303,172.31.36.0-255,1114,112126,7,248688
40699,0.020364,172.31.36.0-255,1514,113640,7,248688
40700,0.020366,172.31.36.0-255,1292,114932,7,248688
40701,0.021847,104.244.42.0-255,66,114998,7,248688
40702,0.021883,104.244.42.0-255,66,115064,7,248688
40703,0.021932,104.244.42.0-255,66,115130,7,248688
40704,0.022616,172.217.194.0-255,5738,120868,7,248688
40705,0.022622,172.31.36.0-255,66,120934,7,248688
40706,0.025118,172.217.194.0-255,5738,126672,7,248688
40707,0.025124,172.31.36.0-255,66,126738,7,248688
40708,0.027621,172.217.194.0-255,5738,132476,7,248688
40709,0.027627,172.31.36.0-255,66,132542,7,248688
40710,0.030119,172.217.194.0-255,5738,138280,7,248688
40711,0.030127,172.31.36.0-255,66,138346,7,248688
40712,0.032646,172.217.194.0-255,5738,144084,7,248688
40713,0.032658,172.31.36.0-255,66,144150,7,248688
40714,0.035188,172.217.194.0-255,5738,149888,7,248688
40715,0.035195,172.31.36.0-255,66,149954,7,248688
40716,0.03771,172.217.194.0-255,5738,155692,7,248688
40717,0.037716,172.31.36.0-255,66,155758,7,248688
40718,0.040225,172.217.194.0-255,5738,161496,7,248688
40719,0.040232,172.31.36.0-255,66,161562,7,248688
40720,0.042744,172.217.194.0-255,5738,167300,7,248688
40721,0.042753,172.31.36.0-255,66,167366,7,248688
40722,0.04523,172.217.194.0-255,5738,173104,7,248688
40723,0.045237,172.31.36.0-255,66,173170,7,248688
40724,0.047769,172.217.194.0-255,5738,178908,7,248688
40725,0.047776,172.31.36.0-255,66,178974,7,248688
40726,0.050289,172.217.194.0-255,5738,184712,7,248688
40727,0.0503,172.31.36.0-255,66,184778,7,248688
40728,0.052798,172.217.194.0-255,5738,190516,7,248688
40729,0.052805,172.31.36.0-255,66,190582,7,248688
40730,0.055313,172.217.194.0-255,5738,196320,7,248688
40731,0.055319,172.31.36.0-255,66,196386,7,248688
40732,0.057832,172.217.194.0-255,5738,202124,7,248688
40733,0.057839,172.31.36.0-255,66,202190,7,248688
40734,0.060344,172.217.194.0-255,5738,207928,7,248688
40735,0.060356,172.31.36.0-255,66,207994,7,248688
40736,0.062838,172.217.194.0-255,5738,213732,7,248688
40737,0.062849,172.31.36.0-255,66,213798,7,248688
40738,0.065383,172.217.194.0-255,5738,219536,7,248688
40739,0.065395,172.31.36.0-255,66,219602,7,248688
40740,0.067927,172.217.194.0-255,5738,225340,7,248688
40741,0.067939,172.31.36.0-255,66,225406,7,248688
40742,0.070441,172.217.194.0-255,5738,231144,7,248688
40743,0.07045,172.31.36.0-255,66,231210,7,248688
40744,0.072989,172.217.194.0-255,5738,236948,7,248688
40745,0.072996,172.31.36.0-255,66,237014,7,248688
40746,0.07549,172.217.194.0-255,5738,242752,7,248688
40747,0.075496,172.31.36.0-255,66,242818,7,248688
40748,0.07799,172.217.194.0-255,4320,247138,7,248688
40749,0.077996,172.31.36.0-255,66,247204,7,248688
40750,0.078016,172.217.194.0-255,1484,248688,7,248688
40751,0.0,74.125.24.0-255,298,298,7,291028
40752,3.4e-05,172.31.36.0-255,66,364,7,291028
40753,4.1e-05,74.125.24.0-255,1484,1848,7,291028
40754,4.7e-05,172.31.36.0-255,66,1914,7,291028
40755,5.3e-05,74.125.24.0-255,4320,6234,7,291028
40756,5.6e-05,172.31.36.0-255,66,6300,7,291028
40757,6.8e-05,172.31.36.0-255,66,6366,7,291028
40758,7.3e-05,74.125.24.0-255,4320,10686,7,291028
40759,7.5e-05,172.31.36.0-255,66,10752,7,291028
40760,0.000128,172.31.36.0-255,66,10818,7,291028
40761,0.000188,74.125.24.0-255,1484,12302,7,291028
40762,0.000192,172.31.36.0-255,66,12368,7,291028
40763,0.000196,74.125.24.0-255,1484,13852,7,291028
40764,0.000198,172.31.36.0-255,66,13918,7,291028
40765,0.000215,74.125.24.0-255,1484,15402,7,291028
40766,0.000217,172.31.36.0-255,66,15468,7,291028
40767,0.000225,74.125.24.0-255,2902,18370,7,291028
40768,0.000228,172.31.36.0-255,66,18436,7,291028
40769,0.000233,74.125.24.0-255,4320,22756,7,291028
40770,0.000236,172.31.36.0-255,66,22822,7,291028
40771,0.000268,172.31.36.0-255,66,22888,7,291028
40772,0.000275,74.125.24.0-255,4320,27208,7,291028
40773,0.000277,172.31.36.0-255,66,27274,7,291028
40774,0.000308,74.125.24.0-255,1484,28758,7,291028
40775,0.000314,172.31.36.0-255,66,28824,7,291028
40776,0.000337,74.125.24.0-255,6797,35621,7,291028
40777,0.00034,172.31.36.0-255,66,35687,7,291028
40778,0.000344,74.125.24.0-255,360,36047,7,291028
40779,0.000346,172.31.36.0-255,66,36113,7,291028
40780,0.001351,74.125.24.0-255,383,36496,7,291028
40781,0.001455,74.125.24.0-255,1484,37980,7,291028
40782,0.001461,172.31.36.0-255,66,38046,7,291028
40783,0.001468,74.125.24.0-255,2902,40948,7,291028
40784,0.00147,172.31.36.0-255,66,41014,7,291028
40785,0.001476,74.125.24.0-255,4320,45334,7,291028
40786,0.001478,172.31.36.0-255,66,45400,7,291028
40787,0.001503,74.125.24.0-255,1484,46884,7,291028
40788,0.00151,74.125.24.0-255,6797,53681,7,291028
40789,0.001589,74.125.24.0-255,1484,55165,7,291028
40790,0.001595,74.125.24.0-255,2902,58067,7,291028
40791,0.00161,74.125.24.0-255,2902,60969,7,291028
40792,0.001626,74.125.24.0-255,2902,63871,7,291028
40793,0.001636,74.125.24.0-255,6797,70668,7,291028
40794,0.002041,74.125.24.0-255,1484,72152,7,291028
40795,0.00205,74.125.24.0-255,2902,75054,7,291028
40796,0.002065,74.125.24.0-255,5738,80792,7,291028
40797,0.002102,74.125.24.0-255,4320,85112,7,291028
40798,0.002108,74.125.24.0-255,7156,92268,7,291028
40799,0.002142,74.125.24.0-255,3602,95870,7,291028
40800,0.003127,172.31.36.0-255,66,95936,7,291028
40801,0.005466,74.125.24.0-255,5738,101674,7,291028
40802,0.005481,172.31.36.0-255,66,101740,7,291028
40803,0.007783,74.125.24.0-255,5738,107478,7,291028
40804,0.007792,172.31.36.0-255,66,107544,7,291028
40805,0.010131,74.125.24.0-255,5738,113282,7,291028
40806,0.010145,172.31.36.0-255,66,113348,7,291028
40807,0.012482,74.125.24.0-255,5738,119086,7,291028
40808,0.012497,172.31.36.0-255,66,119152,7,291028
40809,0.014847,74.125.24.0-255,5738,124890,7,291028
40810,0.014868,172.31.36.0-255,66,124956,7,291028
40811,0.017215,74.125.24.0-255,5738,130694,7,291028
40812,0.017229,172.31.36.0-255,66,130760,7,291028
40813,0.019538,74.125.24.0-255,5738,136498,7,291028
40814,0.019549,172.31.36.0-255,66,136564,7,291028
40815,0.021887,74.125.24.0-255,5738,142302,7,291028
40816,0.021903,172.31.36.0-255,66,142368,7,291028
40817,0.024223,74.125.24.0-255,5738,148106,7,291028
40818,0.024234,172.31.36.0-255,66,148172,7,291028
40819,0.026577,74.125.24.0-255,5738,153910,7,291028
40820,0.026588,172.31.36.0-255,66,153976,7,291028
40821,0.028896,74.125.24.0-255,5738,159714,7,291028
40822,0.028903,172.31.36.0-255,66,159780,7,291028
40823,0.030895,172.31.36.0-255,172,159952,7,291028
40824,0.030944,172.31.36.0-255,1113,161065,7,291028
40825,0.031013,172.31.36.0-255,1514,162579,7,291028
40826,0.031015,172.31.36.0-255,1514,164093,7,291028
40827,0.031016,172.31.36.0-255,1514,165607,7,291028
40828,0.031017,172.31.36.0-255,1514,167121,7,291028
40829,0.031047,172.31.36.0-255,1514,168635,7,291028
40830,0.031048,172.31.36.0-255,71,168706,7,291028
40831,0.031245,74.125.24.0-255,5738,174444,7,291028
40832,0.031251,172.31.36.0-255,66,174510,7,291028
40833,0.032451,104.244.42.0-255,66,174576,7,291028
40834,0.032481,104.244.42.0-255,66,174642,7,291028
40835,0.032604,104.244.42.0-255,66,174708,7,291028
40836,0.03261,104.244.42.0-255,66,174774,7,291028
40837,0.033127,104.244.42.0-255,108,174882,7,291028
40838,0.033133,172.31.36.0-255,66,174948,7,291028
40839,0.033611,74.125.24.0-255,5738,180686,7,291028
40840,0.033617,172.31.36.0-255,66,180752,7,291028
40841,0.035968,74.125.24.0-255,5738,186490,7,291028
40842,0.035975,172.31.36.0-255,66,186556,7,291028
40843,0.038307,74.125.24.0-255,5738,192294,7,291028
40844,0.038315,172.31.36.0-255,66,192360,7,291028
40845,0.040645,74.125.24.0-255,5738,198098,7,291028
40846,0.040652,172.31.36.0-255,66,198164,7,291028
40847,0.043009,74.125.24.0-255,5738,203902,7,291028
40848,0.043016,172.31.36.0-255,66,203968,7,291028
40849,0.04535,74.125.24.0-255,5738,209706,7,291028
40850,0.045361,172.31.36.0-255,66,209772,7,291028
40851,0.047704,74.125.24.0-255,5738,215510,7,291028
40852,0.047712,172.31.36.0-255,66,215576,7,291028
40853,0.05003,74.125.24.0-255,5738,221314,7,291028
40854,0.050038,172.31.36.0-255,66,221380,7,291028
40855,0.052351,74.125.24.0-255,5738,227118,7,291028
40856,0.05236,172.31.36.0-255,66,227184,7,291028
40857,0.054725,74.125.24.0-255,5738,232922,7,291028
40858,0.054738,172.31.36.0-255,66,232988,7,291028
40859,0.057078,74.125.24.0-255,5738,238726,7,291028
40860,0.057087,172.31.36.0-255,66,238792,7,291028
40861,0.059452,74.125.24.0-255,5738,244530,7,291028
40862,0.059465,172.31.36.0-255,66,244596,7,291028
40863,0.061775,74.125.24.0-255,5738,250334,7,291028
40864,0.061782,172.31.36.0-255,66,250400,7,291028
40865,0.064107,74.125.24.0-255,5738,256138,7,291028
40866,0.064115,172.31.36.0-255,66,256204,7,291028
40867,0.066439,74.125.24.0-255,5738,261942,7,291028
40868,0.066447,172.31.36.0-255,66,262008,7,291028
40869,0.068776,74.125.24.0-255,5738,267746,7,291028
40870,0.068785,172.31.36.0-255,66,267812,7,291028
40871,0.071111,74.125.24.0-255,5738,273550,7,291028
40872,0.071122,172.31.36.0-255,66,273616,7,291028
40873,0.073456,74.125.24.0-255,5738,279354,7,291028
40874,0.073464,172.31.36.0-255,66,279420,7,291028
40875,0.075796,74.125.24.0-255,5738,285158,7,291028
40876,0.075805,172.31.36.0-255,66,285224,7,291028
40877,0.078182,74.125.24.0-255,5738,290962,7,291028
40878,0.078189,172.31.36.0-255,66,291028,7,291028
40879,0.0,172.217.194.0-255,146,146,7,242354
40880,2e-05,172.31.36.0-255,66,212,7,242354
40881,2.6e-05,172.217.194.0-255,1484,1696,7,242354
40882,3e-05,172.31.36.0-255,66,1762,7,242354
40883,3.5e-05,172.217.194.0-255,2902,4664,7,242354
40884,3.7e-05,172.31.36.0-255,66,4730,7,242354
40885,4.4e-05,172.217.194.0-255,5738,10468,7,242354
40886,4.6e-05,172.31.36.0-255,66,10534,7,242354
40887,6.3e-05,172.217.194.0-255,1484,12018,7,242354
40888,6.5e-05,172.31.36.0-255,66,12084,7,242354
40889,7e-05,172.217.194.0-255,2902,14986,7,242354
40890,7.2e-05,172.31.36.0-255,66,15052,7,242354
40891,0.000102,172.31.36.0-255,66,15118,7,242354
40892,0.000109,172.217.194.0-255,6797,21915,7,242354
40893,0.000111,172.31.36.0-255,66,21981,7,242354
40894,0.000393,172.217.194.0-255,1484,23465,7,242354
40895,0.000399,172.31.36.0-255,66,23531,7,242354
40896,0.000404,172.217.194.0-255,2902,26433,7,242354
40897,0.000406,172.31.36.0-255,66,26499,7,242354
40898,0.000426,172.217.194.0-255,1484,27983,7,242354
40899,0.000428,172.31.36.0-255,66,28049,7,242354
40900,0.00045,172.217.194.0-255,4320,32369,7,242354
40901,0.000453,172.31.36.0-255,66,32435,7,242354
40902,0.000474,172.31.36.0-255,66,32501,7,242354
40903,0.000479,172.217.194.0-255,4320,36821,7,242354
40904,0.000481,172.31.36.0-255,66,36887,7,242354
40905,0.000504,172.217.194.0-255,4320,41207,7,242354
40906,0.000507,172.31.36.0-255,66,41273,7,242354
40907,0.000527,172.217.194.0-255,6797,48070,7,242354
40908,0.00053,172.31.36.0-255,66,48136,7,242354
40909,0.000632,172.217.194.0-255,1484,49620,7,242354
40910,0.000638,172.217.194.0-255,2902,52522,7,242354
40911,0.00064,172.31.36.0-255,66,52588,7,242354
40912,0.000653,172.217.194.0-255,2902,55490,7,242354
40913,0.000655,172.31.36.0-255,66,55556,7,242354
40914,0.000682,172.217.194.0-255,2902,58458,7,242354
40915,0.000685,172.31.36.0-255,66,58524,7,242354
40916,0.000689,172.217.194.0-255,4320,62844,7,242354
40917,0.000691,172.31.36.0-255,66,62910,7,242354
40918,0.000714,172.217.194.0-255,5738,68648,7,242354
40919,0.000716,172.31.36.0-255,66,68714,7,242354
40920,0.000744,172.217.194.0-255,5959,74673,7,242354
40921,0.000746,172.31.36.0-255,66,74739,7,242354
40922,0.000762,172.217.194.0-255,5738,80477,7,242354
40923,0.000766,172.31.36.0-255,66,80543,7,242354
40924,0.000787,172.217.194.0-255,2543,83086,7,242354
40925,0.00079,172.31.36.0-255,66,83152,7,242354
40926,0.000899,172.217.194.0-255,1484,84636,7,242354
40927,0.000916,172.217.194.0-255,2902,87538,7,242354
40928,0.00092,172.217.194.0-255,5738,93276,7,242354
40929,0.000924,172.31.36.0-255,66,93342,7,242354
40930,0.000927,172.31.36.0-255,66,93408,7,242354
40931,0.000944,172.217.194.0-255,2902,96310,7,242354
40932,0.000946,172.31.36.0-255,66,96376,7,242354
40933,0.000975,172.31.36.0-255,66,96442,7,242354
40934,0.000986,172.31.36.0-255,66,96508,7,242354
40935,0.001042,172.217.194.0-255,1484,97992,7,242354
40936,0.001047,172.217.194.0-255,2902,100894,7,242354
40937,0.001049,172.31.36.0-255,66,100960,7,242354
40938,0.001052,172.217.194.0-255,1484,102444,7,242354
40939,0.001072,172.217.194.0-255,4320,106764,7,242354
40940,0.001075,172.31.36.0-255,66,106830,7,242354
40941,0.001093,172.217.194.0-255,7156,113986,7,242354
40942,0.001096,172.31.36.0-255,66,114052,7,242354
40943,0.001113,172.217.194.0-255,5738,119790,7,242354
40944,0.001115,172.31.36.0-255,66,119856,7,242354
40945,0.001118,172.217.194.0-255,1484,121340,7,242354
40946,0.001139,172.217.194.0-255,5738,127078,7,242354
40947,0.001142,172.31.36.0-255,66,127144,7,242354
40948,0.001162,172.217.194.0-255,3602,130746,7,242354
40949,0.001164,172.31.36.0-255,66,130812,7,242354
40950,0.001169,172.217.194.0-255,4320,135132,7,242354
40951,0.001171,172.31.36.0-255,66,135198,7,242354
40952,0.001196,172.217.194.0-255,7156,142354,7,242354
40953,0.001199,172.31.36.0-255,66,142420,7,242354
40954,0.001242,172.217.194.0-255,4320,146740,7,242354
40955,0.001244,172.31.36.0-255,66,146806,7,242354
40956,0.001263,172.217.194.0-255,7156,153962,7,242354
40957,0.001266,172.31.36.0-255,66,154028,7,242354
40958,0.001277,172.31.36.0-255,66,154094,7,242354
40959,0.00129,172.31.36.0-255,66,154160,7,242354
40960,0.001304,172.31.36.0-255,66,154226,7,242354
40961,0.001327,172.217.194.0-255,3602,157828,7,242354
40962,0.00133,172.31.36.0-255,66,157894,7,242354
40963,0.001333,172.217.194.0-255,1484,159378,7,242354
40964,0.001336,172.217.194.0-255,2902,162280,7,242354
40965,0.001338,172.31.36.0-255,66,162346,7,242354
40966,0.001342,172.217.194.0-255,2902,165248,7,242354
40967,0.001343,172.31.36.0-255,66,165314,7,242354
40968,0.001364,172.217.194.0-255,2902,168216,7,242354
40969,0.001367,172.31.36.0-255,66,168282,7,242354
40970,0.001379,172.217.194.0-255,7156,175438,7,242354
40971,0.001381,172.31.36.0-255,66,175504,7,242354
40972,0.001403,172.217.194.0-255,5738,181242,7,242354
40973,0.001406,172.31.36.0-255,66,181308,7,242354
40974,0.001417,172.31.36.0-255,66,181374,7,242354
40975,0.001465,172.217.194.0-255,1484,182858,7,242354
40976,0.001469,172.217.194.0-255,2902,185760,7,242354
40977,0.001472,172.31.36.0-255,66,185826,7,242354
40978,0.001478,172.217.194.0-255,4320,190146,7,242354
40979,0.00148,172.31.36.0-255,66,190212,7,242354
40980,0.001494,172.217.194.0-255,1484,191696,7,242354
40981,0.001497,172.217.194.0-255,1484,193180,7,242354
40982,0.001499,172.31.36.0-255,66,193246,7,242354
40983,0.001526,172.31.36.0-255,66,193312,7,242354
40984,0.001531,172.217.194.0-255,2902,196214,7,242354
40985,0.001533,172.31.36.0-255,66,196280,7,242354
40986,0.00157,172.31.36.0-255,66,196346,7,242354
40987,0.001596,172.217.194.0-255,1484,197830,7,242354
40988,0.001601,172.217.194.0-255,2902,200732,7,242354
40989,0.001603,172.31.36.0-255,66,200798,7,242354
40990,0.001607,172.217.194.0-255,1484,202282,7,242354
40991,0.001627,172.217.194.0-255,4320,206602,7,242354
40992,0.00163,172.31.36.0-255,66,206668,7,242354
40993,0.001638,172.217.194.0-255,5738,212406,7,242354
40994,0.001641,172.31.36.0-255,66,212472,7,242354
40995,0.001668,172.217.194.0-255,4320,216792,7,242354
40996,0.001672,172.31.36.0-255,66,216858,7,242354
40997,0.001696,172.217.194.0-255,5738,222596,7,242354
40998,0.0017,172.31.36.0-255,66,222662,7,242354
40999,0.001746,172.31.36.0-255,66,222728,7,242354
41000,0.001753,172.217.194.0-255,7156,229884,7,242354
41001,0.001757,172.31.36.0-255,66,229950,7,242354
41002,0.001778,172.217.194.0-255,7156,237106,7,242354
41003,0.001781,172.31.36.0-255,66,237172,7,242354
41004,0.001795,172.31.36.0-255,66,237238,7,242354
41005,0.001848,172.31.36.0-255,66,237304,7,242354
41006,0.001887,172.31.36.0-255,66,237370,7,242354
41007,0.001909,172.31.36.0-255,66,237436,7,242354
41008,0.001913,172.217.194.0-255,97,237533,7,242354
41009,0.001916,172.217.194.0-255,105,237638,7,242354
41010,0.005086,172.31.36.0-255,66,237704,7,242354
41011,0.005127,172.31.36.0-255,105,237809,7,242354
41012,0.007043,172.217.194.0-255,66,237875,7,242354
41013,0.03513,172.31.36.0-255,187,238062,7,242354
41014,0.035187,172.31.36.0-255,982,239044,7,242354
41015,0.035298,172.31.36.0-255,1514,240558,7,242354
41016,0.0353,172.31.36.0-255,1424,241982,7,242354
41017,0.036687,104.244.42.0-255,66,242048,7,242354
41018,0.036718,104.244.42.0-255,66,242114,7,242354
41019,0.036911,104.244.42.0-255,66,242180,7,242354
41020,0.040514,104.244.42.0-255,108,242288,7,242354
41021,0.040521,172.31.36.0-255,66,242354,7,242354
41022,0.0,172.31.36.0-255,105,105,7,276
41023,0.002304,157.240.13.0-255,105,210,7,276
41024,0.002322,172.31.36.0-255,66,276,7,276
41025,0.0,172.217.194.0-255,143,143,7,288986
41026,2.5e-05,172.31.36.0-255,66,209,7,288986
41027,3.2e-05,172.217.194.0-255,1484,1693,7,288986
41028,3.6e-05,172.31.36.0-255,66,1759,7,288986
41029,5.1e-05,172.217.194.0-255,2902,4661,7,288986
41030,5.4e-05,172.31.36.0-255,66,4727,7,288986
41031,6e-05,172.217.194.0-255,4320,9047,7,288986
41032,6.3e-05,172.31.36.0-255,66,9113,7,288986
41033,6.9e-05,172.217.194.0-255,4837,13950,7,288986
41034,7.3e-05,172.31.36.0-255,66,14016,7,288986
41035,0.00019,172.217.194.0-255,1484,15500,7,288986
41036,0.000194,172.31.36.0-255,66,15566,7,288986
41037,0.0002,172.217.194.0-255,2902,18468,7,288986
41038,0.000202,172.31.36.0-255,66,18534,7,288986
41039,0.000214,172.217.194.0-255,5738,24272,7,288986
41040,0.000217,172.31.36.0-255,66,24338,7,288986
41041,0.000258,172.31.36.0-255,66,24404,7,288986
41042,0.000264,172.217.194.0-255,5738,30142,7,288986
41043,0.000267,172.31.36.0-255,66,30208,7,288986
41044,0.00029,172.217.194.0-255,2902,33110,7,288986
41045,0.000292,172.31.36.0-255,66,33176,7,288986
41046,0.000302,172.217.194.0-255,5738,38914,7,288986
41047,0.000306,172.31.36.0-255,66,38980,7,288986
41048,0.000348,172.31.36.0-255,66,39046,7,288986
41049,0.000356,172.217.194.0-255,6438,45484,7,288986
41050,0.000359,172.31.36.0-255,66,45550,7,288986
41051,0.000411,172.217.194.0-255,413,45963,7,288986
41052,0.000414,172.31.36.0-255,66,46029,7,288986
41053,0.00044,172.217.194.0-255,1484,47513,7,288986
41054,0.000443,172.31.36.0-255,66,47579,7,288986
41055,0.000446,172.217.194.0-255,1484,49063,7,288986
41056,0.000467,172.217.194.0-255,1484,50547,7,288986
41057,0.00047,172.31.36.0-255,66,50613,7,288986
41058,0.000477,172.217.194.0-255,5738,56351,7,288986
41059,0.000479,172.31.36.0-255,66,56417,7,288986
41060,0.000519,172.31.36.0-255,66,56483,7,288986
41061,0.000548,172.217.194.0-255,5738,62221,7,288986
41062,0.000551,172.31.36.0-255,66,62287,7,288986
41063,0.00058,172.217.194.0-255,5315,67602,7,288986
41064,0.000583,172.31.36.0-255,66,67668,7,288986
41065,0.000816,172.217.194.0-255,1484,69152,7,288986
41066,0.000824,172.217.194.0-255,2902,72054,7,288986
41067,0.000828,172.31.36.0-255,66,72120,7,288986
41068,0.000859,172.217.194.0-255,5738,77858,7,288986
41069,0.000863,172.31.36.0-255,66,77924,7,288986
41070,0.000869,172.217.194.0-255,4320,82244,7,288986
41071,0.000871,172.31.36.0-255,66,82310,7,288986
41072,0.000911,172.31.36.0-255,66,82376,7,288986
41073,0.000923,172.31.36.0-255,66,82442,7,288986
41074,0.003219,172.217.194.0-255,5738,88180,7,288986
41075,0.003225,172.31.36.0-255,66,88246,7,288986
41076,0.005493,172.217.194.0-255,5738,93984,7,288986
41077,0.005498,172.31.36.0-255,66,94050,7,288986
41078,0.0078,172.217.194.0-255,5738,99788,7,288986
41079,0.007807,172.31.36.0-255,66,99854,7,288986
41080,0.010094,172.217.194.0-255,5738,105592,7,288986
41081,0.010103,172.31.36.0-255,66,105658,7,288986
41082,0.012394,172.217.194.0-255,5738,111396,7,288986
41083,0.012403,172.31.36.0-255,66,111462,7,288986
41084,0.014699,172.217.194.0-255,5738,117200,7,288986
41085,0.01471,172.31.36.0-255,66,117266,7,288986
41086,0.01706,172.217.194.0-255,5738,123004,7,288986
41087,0.017069,172.31.36.0-255,66,123070,7,288986
41088,0.019371,172.217.194.0-255,5738,128808,7,288986
41089,0.019389,172.31.36.0-255,66,128874,7,288986
41090,0.021691,172.217.194.0-255,5738,134612,7,288986
41091,0.021702,172.31.36.0-255,66,134678,7,288986
41092,0.024037,172.217.194.0-255,5738,140416,7,288986
41093,0.024045,172.31.36.0-255,66,140482,7,288986
41094,0.02634,172.217.194.0-255,5738,146220,7,288986
41095,0.02635,172.31.36.0-255,66,146286,7,288986
41096,0.028667,172.217.194.0-255,5738,152024,7,288986
41097,0.028674,172.31.36.0-255,66,152090,7,288986
41098,0.030982,172.217.194.0-255,5738,157828,7,288986
41099,0.030988,172.31.36.0-255,66,157894,7,288986
41100,0.031144,172.31.36.0-255,190,158084,7,288986
41101,0.031169,172.31.36.0-255,1113,159197,7,288986
41102,0.031283,172.31.36.0-255,1514,160711,7,288986
41103,0.031285,172.31.36.0-255,1514,162225,7,288986
41104,0.031286,172.31.36.0-255,1514,163739,7,288986
41105,0.031291,172.31.36.0-255,1514,165253,7,288986
41106,0.031312,172.31.36.0-255,1514,166767,7,288986
41107,0.031313,172.31.36.0-255,71,166838,7,288986
41108,0.032668,104.244.42.0-255,66,166904,7,288986
41109,0.032717,104.244.42.0-255,66,166970,7,288986
41110,0.032856,104.244.42.0-255,66,167036,7,288986
41111,0.032863,104.244.42.0-255,66,167102,7,288986
41112,0.033267,172.217.194.0-255,5738,172840,7,288986
41113,0.033274,172.31.36.0-255,66,172906,7,288986
41114,0.03559,172.217.194.0-255,5738,178644,7,288986
41115,0.035597,172.31.36.0-255,66,178710,7,288986
41116,0.037914,172.217.194.0-255,5738,184448,7,288986
41117,0.037921,172.31.36.0-255,66,184514,7,288986
41118,0.040222,172.217.194.0-255,5738,190252,7,288986
41119,0.040232,172.31.36.0-255,66,190318,7,288986
41120,0.042516,172.217.194.0-255,5738,196056,7,288986
41121,0.042522,172.31.36.0-255,66,196122,7,288986
41122,0.044837,172.217.194.0-255,5738,201860,7,288986
41123,0.044843,172.31.36.0-255,66,201926,7,288986
41124,0.047206,172.217.194.0-255,5738,207664,7,288986
41125,0.047212,172.31.36.0-255,66,207730,7,288986
41126,0.049517,172.217.194.0-255,5738,213468,7,288986
41127,0.049526,172.31.36.0-255,66,213534,7,288986
41128,0.051856,172.217.194.0-255,5738,219272,7,288986
41129,0.051866,172.31.36.0-255,66,219338,7,288986
41130,0.054158,172.217.194.0-255,5738,225076,7,288986
41131,0.054165,172.31.36.0-255,66,225142,7,288986
41132,0.056471,172.217.194.0-255,5738,230880,7,288986
41133,0.056477,172.31.36.0-255,66,230946,7,288986
41134,0.058781,172.217.194.0-255,5738,236684,7,288986
41135,0.058787,172.31.36.0-255,66,236750,7,288986
41136,0.061079,172.217.194.0-255,5738,242488,7,288986
41137,0.061084,172.31.36.0-255,66,242554,7,288986
41138,0.063377,172.217.194.0-255,5738,248292,7,288986
41139,0.063384,172.31.36.0-255,66,248358,7,288986
41140,0.06571,172.217.194.0-255,5738,254096,7,288986
41141,0.065716,172.31.36.0-255,66,254162,7,288986
41142,0.068034,172.217.194.0-255,5738,259900,7,288986
41143,0.06804,172.31.36.0-255,66,259966,7,288986
41144,0.070362,172.217.194.0-255,5738,265704,7,288986
41145,0.070368,172.31.36.0-255,66,265770,7,288986
41146,0.07267,172.217.194.0-255,5738,271508,7,288986
41147,0.072676,172.31.36.0-255,66,271574,7,288986
41148,0.074988,172.217.194.0-255,5738,277312,7,288986
41149,0.074996,172.31.36.0-255,66,277378,7,288986
41150,0.077287,172.217.194.0-255,5738,283116,7,288986
41151,0.077292,172.31.36.0-255,66,283182,7,288986
41152,0.079602,172.217.194.0-255,5738,288920,7,288986
41153,0.079608,172.31.36.0-255,66,288986,7,288986
41154,0.0,172.31.36.0-255,66,66,7,66
41155,0.0,74.125.68.0-255,148,148,7,328296
41156,3.5e-05,172.31.36.0-255,66,214,7,328296
41157,4.3e-05,74.125.68.0-255,1484,1698,7,328296
41158,4.8e-05,172.31.36.0-255,66,1764,7,328296
41159,5.3e-05,74.125.68.0-255,2902,4666,7,328296
41160,5.5e-05,172.31.36.0-255,66,4732,7,328296
41161,6.2e-05,74.125.68.0-255,7156,11888,7,328296
41162,6.4e-05,172.31.36.0-255,66,11954,7,328296
41163,6.8e-05,74.125.68.0-255,2040,13994,7,328296
41164,7.1e-05,172.31.36.0-255,66,14060,7,328296
41165,0.000116,74.125.68.0-255,1484,15544,7,328296
41166,0.000119,172.31.36.0-255,66,15610,7,328296
41167,0.000125,74.125.68.0-255,2902,18512,7,328296
41168,0.000127,172.31.36.0-255,66,18578,7,328296
41169,0.000159,74.125.68.0-255,5738,24316,7,328296
41170,0.000162,172.31.36.0-255,66,24382,7,328296
41171,0.000168,74.125.68.0-255,5738,30120,7,328296
41172,0.00017,172.31.36.0-255,66,30186,7,328296
41173,0.000205,74.125.68.0-255,1125,31311,7,328296
41174,0.000208,172.31.36.0-255,66,31377,7,328296
41175,0.000371,74.125.68.0-255,1484,32861,7,328296
41176,0.000376,172.31.36.0-255,66,32927,7,328296
41177,0.000382,74.125.68.0-255,2902,35829,7,328296
41178,0.000384,172.31.36.0-255,66,35895,7,328296
41179,0.000406,74.125.68.0-255,2902,38797,7,328296
41180,0.000408,172.31.36.0-255,66,38863,7,328296
41181,0.000426,74.125.68.0-255,2902,41765,7,328296
41182,0.000429,172.31.36.0-255,66,41831,7,328296
41183,0.000437,74.125.68.0-255,6797,48628,7,328296
41184,0.000439,172.31.36.0-255,66,48694,7,328296
41185,0.000486,172.31.36.0-255,66,48760,7,328296
41186,0.000518,74.125.68.0-255,5738,54498,7,328296
41187,0.000521,172.31.36.0-255,66,54564,7,328296
41188,0.000536,74.125.68.0-255,1437,56001,7,328296
41189,0.00054,74.125.68.0-255,376,56377,7,328296
41190,0.000542,172.31.36.0-255,66,56443,7,328296
41191,0.000736,74.125.68.0-255,1484,57927,7,328296
41192,0.000755,74.125.68.0-255,2902,60829,7,328296
41193,0.000758,172.31.36.0-255,66,60895,7,328296
41194,0.000785,74.125.68.0-255,2902,63797,7,328296
41195,0.000788,172.31.36.0-255,66,63863,7,328296
41196,0.000813,74.125.68.0-255,2902,66765,7,328296
41197,0.000816,172.31.36.0-255,66,66831,7,328296
41198,0.000828,172.31.36.0-255,66,66897,7,328296
41199,0.000841,172.31.36.0-255,66,66963,7,328296
41200,0.000845,74.125.68.0-255,2184,69147,7,328296
41201,0.000848,172.31.36.0-255,66,69213,7,328296
41202,0.0011,74.125.68.0-255,1484,70697,7,328296
41203,0.001116,74.125.68.0-255,2902,73599,7,328296
41204,0.00112,172.31.36.0-255,66,73665,7,328296
41205,0.001124,74.125.68.0-255,1484,75149,7,328296
41206,0.001144,74.125.68.0-255,4320,79469,7,328296
41207,0.001146,172.31.36.0-255,66,79535,7,328296
41208,0.001152,74.125.68.0-255,4320,83855,7,328296
41209,0.001154,172.31.36.0-255,66,83921,7,328296
41210,0.001158,74.125.68.0-255,2902,86823,7,328296
41211,0.00116,172.31.36.0-255,66,86889,7,328296
41212,0.001178,74.125.68.0-255,2902,89791,7,328296
41213,0.001181,172.31.36.0-255,66,89857,7,328296
41214,0.001211,74.125.68.0-255,2184,92041,7,328296
41215,0.001218,172.31.36.0-255,66,92107,7,328296
41216,0.001222,172.31.36.0-255,66,92173,7,328296
41217,0.001497,74.125.68.0-255,1484,93657,7,328296
41218,0.001506,74.125.68.0-255,2902,96559,7,328296
41219,0.00151,172.31.36.0-255,66,96625,7,328296
41220,0.001531,74.125.68.0-255,5738,102363,7,328296
41221,0.001533,172.31.36.0-255,66,102429,7,328296
41222,0.001564,74.125.68.0-255,2902,105331,7,328296
41223,0.001568,172.31.36.0-255,66,105397,7,328296
41224,0.001596,172.31.36.0-255,66,105463,7,328296
41225,0.0016,74.125.68.0-255,1484,106947,7,328296
41226,0.001632,172.31.36.0-255,66,107013,7,328296
41227,0.001658,74.125.68.0-255,1484,108497,7,328296
41228,0.001674,74.125.68.0-255,2902,111399,7,328296
41229,0.001677,172.31.36.0-255,66,111465,7,328296
41230,0.001682,74.125.68.0-255,2902,114367,7,328296
41231,0.001684,172.31.36.0-255,66,114433,7,328296
41232,0.001697,74.125.68.0-255,2902,117335,7,328296
41233,0.0017,172.31.36.0-255,66,117401,7,328296
41234,0.001735,172.31.36.0-255,66,117467,7,328296
41235,0.001739,74.125.68.0-255,2902,120369,7,328296
41236,0.001741,172.31.36.0-255,66,120435,7,328296
41237,0.001759,74.125.68.0-255,7156,127591,7,328296
41238,0.001762,172.31.36.0-255,66,127657,7,328296
41239,0.001769,74.125.68.0-255,5020,132677,7,328296
41240,0.001772,172.31.36.0-255,66,132743,7,328296
41241,0.001971,74.125.68.0-255,1484,134227,7,328296
41242,0.00198,74.125.68.0-255,2902,137129,7,328296
41243,0.001984,172.31.36.0-255,66,137195,7,328296
41244,0.002015,74.125.68.0-255,5738,142933,7,328296
41245,0.002018,172.31.36.0-255,66,142999,7,328296
41246,0.002023,74.125.68.0-255,4320,147319,7,328296
41247,0.002026,172.31.36.0-255,66,147385,7,328296
41248,0.002029,74.125.68.0-255,1484,148869,7,328296
41249,0.002052,74.125.68.0-255,4320,153189,7,328296
41250,0.002056,172.31.36.0-255,66,153255,7,328296
41251,0.00206,74.125.68.0-255,1484,154739,7,328296
41252,0.00209,172.31.36.0-255,66,154805,7,328296
41253,0.002094,74.125.68.0-255,2184,156989,7,328296
41254,0.002096,172.31.36.0-255,66,157055,7,328296
41255,0.002173,74.125.68.0-255,1484,158539,7,328296
41256,0.002197,74.125.68.0-255,2902,161441,7,328296
41257,0.002204,74.125.68.0-255,5738,167179,7,328296
41258,0.002247,74.125.68.0-255,5738,172917,7,328296
41259,0.002259,74.125.68.0-255,4320,177237,7,328296
41260,0.002297,74.125.68.0-255,1484,178721,7,328296
41261,0.002324,74.125.68.0-255,2184,180905,7,328296
41262,0.002458,74.125.68.0-255,1484,182389,7,328296
41263,0.002474,74.125.68.0-255,2902,185291,7,328296
41264,0.002477,74.125.68.0-255,1484,186775,7,328296
41265,0.002499,74.125.68.0-255,2902,189677,7,328296
41266,0.002519,74.125.68.0-255,5738,195415,7,328296
41267,0.002591,74.125.68.0-255,5738,201153,7,328296
41268,0.002607,74.125.68.0-255,3602,204755,7,328296
41269,0.007374,172.31.36.0-255,66,204821,7,328296
41270,0.009942,74.125.68.0-255,5738,210559,7,328296
41271,0.00995,172.31.36.0-255,66,210625,7,328296
41272,0.012514,74.125.68.0-255,5738,216363,7,328296
41273,0.012521,172.31.36.0-255,66,216429,7,328296
41274,0.01508,74.125.68.0-255,5738,222167,7,328296
41275,0.015088,172.31.36.0-255,66,222233,7,328296
41276,0.01765,74.125.68.0-255,5738,227971,7,328296
41277,0.017659,172.31.36.0-255,66,228037,7,328296
41278,0.020229,74.125.68.0-255,5738,233775,7,328296
41279,0.020237,172.31.36.0-255,66,233841,7,328296
41280,0.022806,74.125.68.0-255,5738,239579,7,328296
41281,0.022812,172.31.36.0-255,66,239645,7,328296
41282,0.025366,74.125.68.0-255,5738,245383,7,328296
41283,0.025374,172.31.36.0-255,66,245449,7,328296
41284,0.027937,74.125.68.0-255,5738,251187,7,328296
41285,0.027945,172.31.36.0-255,66,251253,7,328296
41286,0.030517,74.125.68.0-255,5738,256991,7,328296
41287,0.030523,172.31.36.0-255,66,257057,7,328296
41288,0.03309,74.125.68.0-255,5738,262795,7,328296
41289,0.033098,172.31.36.0-255,66,262861,7,328296
41290,0.035272,172.31.36.0-255,172,263033,7,328296
41291,0.035316,172.31.36.0-255,1113,264146,7,328296
41292,0.035401,172.31.36.0-255,1514,265660,7,328296
41293,0.035402,172.31.36.0-255,1514,267174,7,328296
41294,0.035403,172.31.36.0-255,1514,268688,7,328296
41295,0.035408,172.31.36.0-255,1514,270202,7,328296
41296,0.035409,172.31.36.0-255,1514,271716,7,328296
41297,0.03541,172.31.36.0-255,73,271789,7,328296
41298,0.035663,74.125.68.0-255,5738,277527,7,328296
41299,0.03567,172.31.36.0-255,66,277593,7,328296
41300,0.036756,104.244.42.0-255,66,277659,7,328296
41301,0.036798,104.244.42.0-255,66,277725,7,328296
41302,0.036902,104.244.42.0-255,66,277791,7,328296
41303,0.036908,104.244.42.0-255,66,277857,7,328296
41304,0.038223,74.125.68.0-255,5738,283595,7,328296
41305,0.038228,172.31.36.0-255,66,283661,7,328296
41306,0.040784,74.125.68.0-255,5738,289399,7,328296
41307,0.040792,172.31.36.0-255,66,289465,7,328296
41308,0.04336,74.125.68.0-255,4320,293785,7,328296
41309,0.043366,172.31.36.0-255,66,293851,7,328296
41310,0.04338,74.125.68.0-255,1484,295335,7,328296
41311,0.045921,74.125.68.0-255,4320,299655,7,328296
41312,0.045928,172.31.36.0-255,66,299721,7,328296
41313,0.048484,74.125.68.0-255,4320,304041,7,328296
41314,0.048491,172.31.36.0-255,66,304107,7,328296
41315,0.048526,74.125.68.0-255,1484,305591,7,328296
41316,0.051056,74.125.68.0-255,4320,309911,7,328296
41317,0.051061,172.31.36.0-255,66,309977,7,328296
41318,0.053625,74.125.68.0-255,5738,315715,7,328296
41319,0.053631,172.31.36.0-255,66,315781,7,328296
41320,0.056194,74.125.68.0-255,5738,321519,7,328296
41321,0.0562,172.31.36.0-255,66,321585,7,328296
41322,0.058755,74.125.68.0-255,5738,327323,7,328296
41323,0.058761,172.31.36.0-255,66,327389,7,328296
41324,0.061302,74.125.68.0-255,670,328059,7,328296
41325,0.06149,172.31.36.0-255,66,328125,7,328296
41326,0.061518,172.31.36.0-255,105,328230,7,328296
41327,0.064033,74.125.68.0-255,66,328296,7,328296
41328,0.0,172.217.194.0-255,146,146,7,259470
41329,1.6e-05,172.31.36.0-255,66,212,7,259470
41330,2.3e-05,172.217.194.0-255,1484,1696,7,259470
41331,2.7e-05,172.31.36.0-255,66,1762,7,259470
41332,3.3e-05,172.217.194.0-255,2902,4664,7,259470
41333,3.6e-05,172.31.36.0-255,66,4730,7,259470
41334,4.4e-05,172.217.194.0-255,5738,10468,7,259470
41335,4.8e-05,172.31.36.0-255,66,10534,7,259470
41336,7.3e-05,172.217.194.0-255,1484,12018,7,259470
41337,7.6e-05,172.31.36.0-255,66,12084,7,259470
41338,9.1e-05,172.31.36.0-255,66,12150,7,259470
41339,9.7e-05,172.217.194.0-255,6797,18947,7,259470
41340,0.0001,172.31.36.0-255,66,19013,7,259470
41341,0.000151,172.217.194.0-255,1484,20497,7,259470
41342,0.000155,172.31.36.0-255,66,20563,7,259470
41343,0.00016,172.217.194.0-255,2902,23465,7,259470
41344,0.000162,172.31.36.0-255,66,23531,7,259470
41345,0.000168,172.217.194.0-255,5738,29269,7,259470
41346,0.000171,172.31.36.0-255,66,29335,7,259470
41347,0.000208,172.31.36.0-255,66,29401,7,259470
41348,0.000214,172.217.194.0-255,3961,33362,7,259470
41349,0.000216,172.31.36.0-255,66,33428,7,259470
41350,0.000267,172.31.36.0-255,66,33494,7,259470
41351,0.00027,172.217.194.0-255,365,33859,7,259470
41352,0.000272,172.31.36.0-255,66,33925,7,259470
41353,0.000419,172.217.194.0-255,1484,35409,7,259470
41354,0.000426,172.31.36.0-255,66,35475,7,259470
41355,0.000431,172.217.194.0-255,2902,38377,7,259470
41356,0.000433,172.31.36.0-255,66,38443,7,259470
41357,0.00044,172.217.194.0-255,5738,44181,7,259470
41358,0.000442,172.31.36.0-255,66,44247,7,259470
41359,0.000447,172.217.194.0-255,2902,47149,7,259470
41360,0.000449,172.31.36.0-255,66,47215,7,259470
41361,0.000471,172.217.194.0-255,4320,51535,7,259470
41362,0.000474,172.31.36.0-255,66,51601,7,259470
41363,0.000483,172.31.36.0-255,66,51667,7,259470
41364,0.000505,172.217.194.0-255,4320,55987,7,259470
41365,0.000507,172.31.36.0-255,66,56053,7,259470
41366,0.00051,172.217.194.0-255,2184,58237,7,259470
41367,0.000512,172.31.36.0-255,66,58303,7,259470
41368,0.001151,172.217.194.0-255,1484,59787,7,259470
41369,0.001178,172.217.194.0-255,2902,62689,7,259470
41370,0.001183,172.217.194.0-255,5738,68427,7,259470
41371,0.001203,172.31.36.0-255,66,68493,7,259470
41372,0.00121,172.31.36.0-255,66,68559,7,259470
41373,0.001221,172.217.194.0-255,2902,71461,7,259470
41374,0.001224,172.31.36.0-255,66,71527,7,259470
41375,0.001252,172.217.194.0-255,5738,77265,7,259470
41376,0.001255,172.31.36.0-255,66,77331,7,259470
41377,0.001265,172.217.194.0-255,4320,81651,7,259470
41378,0.001267,172.31.36.0-255,66,81717,7,259470
41379,0.001294,172.217.194.0-255,5738,87455,7,259470
41380,0.001297,172.31.36.0-255,66,87521,7,259470
41381,0.001303,172.217.194.0-255,5020,92541,7,259470
41382,0.001304,172.31.36.0-255,66,92607,7,259470
41383,0.001328,172.217.194.0-255,2902,95509,7,259470
41384,0.001331,172.31.36.0-255,66,95575,7,259470
41385,0.001337,172.217.194.0-255,4320,99895,7,259470
41386,0.001339,172.31.36.0-255,66,99961,7,259470
41387,0.001343,172.217.194.0-255,1484,101445,7,259470
41388,0.001375,172.217.194.0-255,7156,108601,7,259470
41389,0.001379,172.31.36.0-255,66,108667,7,259470
41390,0.00139,172.31.36.0-255,66,108733,7,259470
41391,0.001403,172.217.194.0-255,1484,110217,7,259470
41392,0.001426,172.31.36.0-255,66,110283,7,259470
41393,0.001515,172.217.194.0-255,1484,111767,7,259470
41394,0.001522,172.217.194.0-255,2902,114669,7,259470
41395,0.001525,172.31.36.0-255,66,114735,7,259470
41396,0.001532,172.217.194.0-255,5738,120473,7,259470
41397,0.001534,172.31.36.0-255,66,120539,7,259470
41398,0.001564,172.31.36.0-255,66,120605,7,259470
41399,0.00159,172.217.194.0-255,1484,122089,7,259470
41400,0.001603,172.31.36.0-255,66,122155,7,259470
41401,0.00163,172.217.194.0-255,1484,123639,7,259470
41402,0.001634,172.217.194.0-255,2902,126541,7,259470
41403,0.001636,172.31.36.0-255,66,126607,7,259470
41404,0.00164,172.217.194.0-255,1484,128091,7,259470
41405,0.00166,172.217.194.0-255,4320,132411,7,259470
41406,0.001663,172.31.36.0-255,66,132477,7,259470
41407,0.001668,172.217.194.0-255,4320,136797,7,259470
41408,0.00167,172.31.36.0-255,66,136863,7,259470
41409,0.001707,172.31.36.0-255,66,136929,7,259470
41410,0.001709,172.217.194.0-255,1484,138413,7,259470
41411,0.001726,172.217.194.0-255,7156,145569,7,259470
41412,0.001729,172.31.36.0-255,66,145635,7,259470
41413,0.001751,172.217.194.0-255,2184,147819,7,259470
41414,0.001753,172.31.36.0-255,66,147885,7,259470
41415,0.001793,172.217.194.0-255,7156,155041,7,259470
41416,0.001795,172.31.36.0-255,66,155107,7,259470
41417,0.001813,172.217.194.0-255,2902,158009,7,259470
41418,0.001816,172.31.36.0-255,66,158075,7,259470
41419,0.001831,172.31.36.0-255,66,158141,7,259470
41420,0.001844,172.31.36.0-255,66,158207,7,259470
41421,0.001934,172.217.194.0-255,1484,159691,7,259470
41422,0.001951,172.217.194.0-255,2902,162593,7,259470
41423,0.001954,172.31.36.0-255,66,162659,7,259470
41424,0.00197,172.217.194.0-255,2902,165561,7,259470
41425,0.001972,172.31.36.0-255,66,165627,7,259470
41426,0.001984,172.217.194.0-255,2902,168529,7,259470
41427,0.001986,172.31.36.0-255,66,168595,7,259470
41428,0.001989,172.217.194.0-255,1484,170079,7,259470
41429,0.002018,172.31.36.0-255,66,170145,7,259470
41430,0.002046,172.217.194.0-255,2902,173047,7,259470
41431,0.002048,172.31.36.0-255,66,173113,7,259470
41432,0.002059,172.31.36.0-255,66,173179,7,259470
41433,0.002176,172.217.194.0-255,1484,174663,7,259470
41434,0.002181,172.217.194.0-255,2902,177565,7,259470
41435,0.002184,172.31.36.0-255,66,177631,7,259470
41436,0.002188,172.217.194.0-255,1484,179115,7,259470
41437,0.002207,172.217.194.0-255,4320,183435,7,259470
41438,0.002209,172.31.36.0-255,66,183501,7,259470
41439,0.002216,172.217.194.0-255,7156,190657,7,259470
41440,0.002219,172.31.36.0-255,66,190723,7,259470
41441,0.002241,172.217.194.0-255,5738,196461,7,259470
41442,0.002243,172.31.36.0-255,66,196527,7,259470
41443,0.002255,172.31.36.0-255,66,196593,7,259470
41444,0.00228,172.217.194.0-255,5738,202331,7,259470
41445,0.002282,172.31.36.0-255,66,202397,7,259470
41446,0.002326,172.31.36.0-255,66,202463,7,259470
41447,0.002336,172.31.36.0-255,66,202529,7,259470
41448,0.002342,172.217.194.0-255,7156,209685,7,259470
41449,0.002345,172.31.36.0-255,66,209751,7,259470
41450,0.004632,172.217.194.0-255,5738,215489,7,259470
41451,0.004638,172.31.36.0-255,66,215555,7,259470
41452,0.00693,172.217.194.0-255,5738,221293,7,259470
41453,0.006936,172.31.36.0-255,66,221359,7,259470
41454,0.009226,172.217.194.0-255,5738,227097,7,259470
41455,0.009233,172.31.36.0-255,66,227163,7,259470
41456,0.011511,172.217.194.0-255,5738,232901,7,259470
41457,0.01152,172.31.36.0-255,66,232967,7,259470
41458,0.013815,172.217.194.0-255,5738,238705,7,259470
41459,0.013826,172.31.36.0-255,66,238771,7,259470
41460,0.016127,172.217.194.0-255,5738,244509,7,259470
41461,0.016134,172.31.36.0-255,66,244575,7,259470
41462,0.018448,172.217.194.0-255,5228,249803,7,259470
41463,0.018456,172.31.36.0-255,66,249869,7,259470
41464,0.018688,172.31.36.0-255,105,249974,7,259470
41465,0.020944,172.217.194.0-255,66,250040,7,259470
41466,0.029562,172.31.36.0-255,172,250212,7,259470
41467,0.029591,172.31.36.0-255,1113,251325,7,259470
41468,0.029639,172.31.36.0-255,1514,252839,7,259470
41469,0.02964,172.31.36.0-255,1514,254353,7,259470
41470,0.029641,172.31.36.0-255,1514,255867,7,259470
41471,0.029643,172.31.36.0-255,1514,257381,7,259470
41472,0.029672,172.31.36.0-255,1514,258895,7,259470
41473,0.029673,172.31.36.0-255,71,258966,7,259470
41474,0.031089,104.244.42.0-255,66,259032,7,259470
41475,0.031131,104.244.42.0-255,66,259098,7,259470
41476,0.031206,104.244.42.0-255,66,259164,7,259470
41477,0.031211,104.244.42.0-255,66,259230,7,259470
41478,0.031214,104.244.42.0-255,66,259296,7,259470
41479,0.03205,104.244.42.0-255,108,259404,7,259470
41480,0.032071,172.31.36.0-255,66,259470,7,259470
41481,0.0,74.125.68.0-255,152,152,7,307457
41482,1.9e-05,172.31.36.0-255,66,218,7,307457
41483,2.5e-05,74.125.68.0-255,1484,1702,7,307457
41484,3e-05,172.31.36.0-255,66,1768,7,307457
41485,4.3e-05,74.125.68.0-255,2902,4670,7,307457
41486,4.5e-05,172.31.36.0-255,66,4736,7,307457
41487,4.9e-05,74.125.68.0-255,1484,6220,7,307457
41488,5.2e-05,172.31.36.0-255,66,6286,7,307457
41489,8.8e-05,74.125.68.0-255,4320,10606,7,307457
41490,9.1e-05,172.31.36.0-255,66,10672,7,307457
41491,9.7e-05,74.125.68.0-255,3396,14068,7,307457
41492,9.9e-05,172.31.36.0-255,66,14134,7,307457
41493,0.000102,74.125.68.0-255,1484,15618,7,307457
41494,0.000104,172.31.36.0-255,66,15684,7,307457
41495,0.000135,74.125.68.0-255,2902,18586,7,307457
41496,0.000138,172.31.36.0-255,66,18652,7,307457
41497,0.000144,74.125.68.0-255,5738,24390,7,307457
41498,0.000147,172.31.36.0-255,66,24456,7,307457
41499,0.000153,74.125.68.0-255,7156,31612,7,307457
41500,0.000157,172.31.36.0-255,66,31678,7,307457
41501,0.000197,172.31.36.0-255,66,31744,7,307457
41502,0.000247,74.125.68.0-255,4320,36064,7,307457
41503,0.000249,172.31.36.0-255,66,36130,7,307457
41504,0.000273,74.125.68.0-255,2184,38314,7,307457
41505,0.000275,172.31.36.0-255,66,38380,7,307457
41506,0.000357,74.125.68.0-255,1484,39864,7,307457
41507,0.000361,172.31.36.0-255,66,39930,7,307457
41508,0.000366,74.125.68.0-255,2902,42832,7,307457
41509,0.000369,172.31.36.0-255,66,42898,7,307457
41510,0.000372,74.125.68.0-255,1484,44382,7,307457
41511,0.000379,172.31.36.0-255,66,44448,7,307457
41512,0.000402,74.125.68.0-255,1484,45932,7,307457
41513,0.000408,74.125.68.0-255,4320,50252,7,307457
41514,0.000411,172.31.36.0-255,66,50318,7,307457
41515,0.000421,74.125.68.0-255,1484,51802,7,307457
41516,0.000446,74.125.68.0-255,4233,56035,7,307457
41517,0.00049,74.125.68.0-255,383,56418,7,307457
41518,0.000532,74.125.68.0-255,1484,57902,7,307457
41519,0.000546,74.125.68.0-255,2902,60804,7,307457
41520,0.000567,74.125.68.0-255,5738,66542,7,307457
41521,0.000588,74.125.68.0-255,5738,72280,7,307457
41522,0.000608,74.125.68.0-255,7156,79436,7,307457
41523,0.000633,74.125.68.0-255,2902,82338,7,307457
41524,0.000671,172.31.36.0-255,66,82404,7,307457
41525,0.000822,74.125.68.0-255,1484,83888,7,307457
41526,0.000845,74.125.68.0-255,2902,86790,7,307457
41527,0.000851,74.125.68.0-255,4320,91110,7,307457
41528,0.000857,172.31.36.0-255,66,91176,7,307457
41529,0.000895,74.125.68.0-255,5738,96914,7,307457
41530,0.0009,74.125.68.0-255,2902,99816,7,307457
41531,0.000909,172.31.36.0-255,66,99882,7,307457
41532,0.000927,74.125.68.0-255,4320,104202,7,307457
41533,0.000943,74.125.68.0-255,3602,107804,7,307457
41534,0.000962,172.31.36.0-255,66,107870,7,307457
41535,0.000999,74.125.68.0-255,1484,109354,7,307457
41536,0.001014,74.125.68.0-255,2902,112256,7,307457
41537,0.001028,74.125.68.0-255,5738,117994,7,307457
41538,0.001041,74.125.68.0-255,1484,119478,7,307457
41539,0.001057,172.31.36.0-255,66,119544,7,307457
41540,0.001062,74.125.68.0-255,2902,122446,7,307457
41541,0.00107,172.31.36.0-255,66,122512,7,307457
41542,0.001089,74.125.68.0-255,5738,128250,7,307457
41543,0.001093,74.125.68.0-255,2902,131152,7,307457
41544,0.001113,74.125.68.0-255,2902,134054,7,307457
41545,0.00112,74.125.68.0-255,5738,139792,7,307457
41546,0.001135,74.125.68.0-255,1484,141276,7,307457
41547,0.001138,74.125.68.0-255,766,142042,7,307457
41548,0.001149,172.31.36.0-255,66,142108,7,307457
41549,0.001267,74.125.68.0-255,1484,143592,7,307457
41550,0.001286,74.125.68.0-255,2902,146494,7,307457
41551,0.001289,74.125.68.0-255,1484,147978,7,307457
41552,0.001301,74.125.68.0-255,2902,150880,7,307457
41553,0.00131,172.31.36.0-255,66,150946,7,307457
41554,0.00132,172.31.36.0-255,66,151012,7,307457
41555,0.00133,74.125.68.0-255,5738,156750,7,307457
41556,0.001382,74.125.68.0-255,2902,159652,7,307457
41557,0.001411,74.125.68.0-255,2902,162554,7,307457
41558,0.001414,172.31.36.0-255,66,162620,7,307457
41559,0.00142,172.31.36.0-255,66,162686,7,307457
41560,0.001478,74.125.68.0-255,4320,167006,7,307457
41561,0.001484,74.125.68.0-255,5738,172744,7,307457
41562,0.001527,172.31.36.0-255,66,172810,7,307457
41563,0.001579,74.125.68.0-255,5738,178548,7,307457
41564,0.001585,74.125.68.0-255,7156,185704,7,307457
41565,0.001602,74.125.68.0-255,3053,188757,7,307457
41566,0.001619,172.31.36.0-255,66,188823,7,307457
41567,0.001748,74.125.68.0-255,1484,190307,7,307457
41568,0.001781,74.125.68.0-255,2902,193209,7,307457
41569,0.001793,172.31.36.0-255,66,193275,7,307457
41570,0.001804,74.125.68.0-255,2902,196177,7,307457
41571,0.001821,74.125.68.0-255,1484,197661,7,307457
41572,0.001834,74.125.68.0-255,2902,200563,7,307457
41573,0.001847,74.125.68.0-255,1484,202047,7,307457
41574,0.00185,172.31.36.0-255,66,202113,7,307457
41575,0.001871,74.125.68.0-255,7156,209269,7,307457
41576,0.001874,74.125.68.0-255,1484,210753,7,307457
41577,0.00189,172.31.36.0-255,66,210819,7,307457
41578,0.0019,74.125.68.0-255,2902,213721,7,307457
41579,0.00191,172.31.36.0-255,66,213787,7,307457
41580,0.001927,74.125.68.0-255,766,214553,7,307457
41581,0.001954,172.31.36.0-255,66,214619,7,307457
41582,0.002011,74.125.68.0-255,1484,216103,7,307457
41583,0.002016,74.125.68.0-255,1484,217587,7,307457
41584,0.00203,74.125.68.0-255,1484,219071,7,307457
41585,0.002046,74.125.68.0-255,5738,224809,7,307457
41586,0.002053,172.31.36.0-255,66,224875,7,307457
41587,0.0021,74.125.68.0-255,7156,232031,7,307457
41588,0.002113,74.125.68.0-255,1484,233515,7,307457
41589,0.002137,74.125.68.0-255,6438,239953,7,307457
41590,0.002139,74.125.68.0-255,1484,241437,7,307457
41591,0.002145,172.31.36.0-255,66,241503,7,307457
41592,0.002177,74.125.68.0-255,7156,248659,7,307457
41593,0.002193,74.125.68.0-255,7156,255815,7,307457
41594,0.002206,74.125.68.0-255,2902,258717,7,307457
41595,0.002209,74.125.68.0-255,1484,260201,7,307457
41596,0.002214,172.31.36.0-255,66,260267,7,307457
41597,0.002236,74.125.68.0-255,5020,265287,7,307457
41598,0.00224,74.125.68.0-255,2902,268189,7,307457
41599,0.002262,74.125.68.0-255,4320,272509,7,307457
41600,0.002267,74.125.68.0-255,2902,275411,7,307457
41601,0.002281,74.125.68.0-255,4320,279731,7,307457
41602,0.002293,74.125.68.0-255,1484,281215,7,307457
41603,0.002308,74.125.68.0-255,5738,286953,7,307457
41604,0.002313,172.31.36.0-255,66,287019,7,307457
41605,0.002318,172.31.36.0-255,66,287085,7,307457
41606,0.002338,74.125.68.0-255,1484,288569,7,307457
41607,0.002351,74.125.68.0-255,1484,290053,7,307457
41608,0.002382,74.125.68.0-255,7156,297209,7,307457
41609,0.002384,74.125.68.0-255,1484,298693,7,307457
41610,0.002387,74.125.68.0-255,1484,300177,7,307457
41611,0.002425,172.31.36.0-255,66,300243,7,307457
41612,0.002431,172.31.36.0-255,66,300309,7,307457
41613,0.002452,74.125.68.0-255,2353,302662,7,307457
41614,0.002455,74.125.68.0-255,97,302759,7,307457
41615,0.002481,172.31.36.0-255,66,302825,7,307457
41616,0.002526,74.125.68.0-255,105,302930,7,307457
41617,0.016043,172.31.36.0-255,66,302996,7,307457
41618,0.016098,172.31.36.0-255,105,303101,7,307457
41619,0.018382,74.125.68.0-255,66,303167,7,307457
41620,0.038677,172.31.36.0-255,172,303339,7,307457
41621,0.038712,172.31.36.0-255,1114,304453,7,307457
41622,0.038776,172.31.36.0-255,1514,305967,7,307457
41623,0.038778,172.31.36.0-255,1292,307259,7,307457
41624,0.040235,104.244.42.0-255,66,307325,7,307457
41625,0.040289,104.244.42.0-255,66,307391,7,307457
41626,0.04037,104.244.42.0-255,66,307457,7,307457
41627,0.0,74.125.200.0-255,158,158,7,337604
41628,2.3e-05,172.31.36.0-255,66,224,7,337604
41629,3e-05,74.125.200.0-255,1484,1708,7,337604
41630,3.5e-05,172.31.36.0-255,66,1774,7,337604
41631,4.1e-05,74.125.200.0-255,2902,4676,7,337604
41632,4.4e-05,172.31.36.0-255,66,4742,7,337604
41633,5.9e-05,74.125.200.0-255,7156,11898,7,337604
41634,6.3e-05,172.31.36.0-255,66,11964,7,337604
41635,6.6e-05,74.125.200.0-255,1484,13448,7,337604
41636,6.8e-05,172.31.36.0-255,66,13514,7,337604
41637,0.0001,74.125.200.0-255,585,14099,7,337604
41638,0.000103,172.31.36.0-255,66,14165,7,337604
41639,0.000128,74.125.200.0-255,1484,15649,7,337604
41640,0.00013,172.31.36.0-255,66,15715,7,337604
41641,0.000151,74.125.200.0-255,4320,20035,7,337604
41642,0.000153,172.31.36.0-255,66,20101,7,337604
41643,0.000158,74.125.200.0-255,2902,23003,7,337604
41644,0.00016,172.31.36.0-255,66,23069,7,337604
41645,0.00019,74.125.200.0-255,4320,27389,7,337604
41646,0.000196,172.31.36.0-255,66,27455,7,337604
41647,0.000224,74.125.200.0-255,3961,31416,7,337604
41648,0.000226,172.31.36.0-255,66,31482,7,337604
41649,0.000253,74.125.200.0-255,2902,34384,7,337604
41650,0.000256,172.31.36.0-255,66,34450,7,337604
41651,0.000259,74.125.200.0-255,1484,35934,7,337604
41652,0.000261,172.31.36.0-255,66,36000,7,337604
41653,0.000295,74.125.200.0-255,2902,38902,7,337604
41654,0.000297,172.31.36.0-255,66,38968,7,337604
41655,0.000307,172.31.36.0-255,66,39034,7,337604
41656,0.000315,74.125.200.0-255,1125,40159,7,337604
41657,0.000316,172.31.36.0-255,66,40225,7,337604
41658,0.000713,74.125.200.0-255,1484,41709,7,337604
41659,0.000721,74.125.200.0-255,2902,44611,7,337604
41660,0.000725,172.31.36.0-255,66,44677,7,337604
41661,0.000756,74.125.200.0-255,4320,48997,7,337604
41662,0.000759,172.31.36.0-255,66,49063,7,337604
41663,0.000787,74.125.200.0-255,1484,50547,7,337604
41664,0.00079,74.125.200.0-255,1484,52031,7,337604
41665,0.000793,172.31.36.0-255,66,52097,7,337604
41666,0.000798,74.125.200.0-255,2902,54999,7,337604
41667,0.0008,172.31.36.0-255,66,55065,7,337604
41668,0.00083,74.125.200.0-255,2543,57608,7,337604
41669,0.000834,172.31.36.0-255,66,57674,7,337604
41670,0.000876,74.125.200.0-255,647,58321,7,337604
41671,0.001147,74.125.200.0-255,1484,59805,7,337604
41672,0.001151,172.31.36.0-255,66,59871,7,337604
41673,0.001157,74.125.200.0-255,2902,62773,7,337604
41674,0.00116,172.31.36.0-255,66,62839,7,337604
41675,0.00117,74.125.200.0-255,2902,65741,7,337604
41676,0.001172,172.31.36.0-255,66,65807,7,337604
41677,0.001176,74.125.200.0-255,2902,68709,7,337604
41678,0.001178,172.31.36.0-255,66,68775,7,337604
41679,0.0012,74.125.200.0-255,1484,70259,7,337604
41680,0.001216,172.31.36.0-255,66,70325,7,337604
41681,0.00125,74.125.200.0-255,5738,76063,7,337604
41682,0.001257,74.125.200.0-255,7156,83219,7,337604
41683,0.001261,172.31.36.0-255,66,83285,7,337604
41684,0.001271,172.31.36.0-255,66,83351,7,337604
41685,0.001295,74.125.200.0-255,766,84117,7,337604
41686,0.001377,74.125.200.0-255,1484,85601,7,337604
41687,0.001381,172.31.36.0-255,66,85667,7,337604
41688,0.001411,74.125.200.0-255,2902,88569,7,337604
41689,0.001413,172.31.36.0-255,66,88635,7,337604
41690,0.001446,74.125.200.0-255,5738,94373,7,337604
41691,0.001448,172.31.36.0-255,66,94439,7,337604
41692,0.001452,74.125.200.0-255,1484,95923,7,337604
41693,0.001475,74.125.200.0-255,5738,101661,7,337604
41694,0.001477,172.31.36.0-255,66,101727,7,337604
41695,0.001485,74.125.200.0-255,7156,108883,7,337604
41696,0.001487,172.31.36.0-255,66,108949,7,337604
41697,0.001491,74.125.200.0-255,2902,111851,7,337604
41698,0.001493,172.31.36.0-255,66,111917,7,337604
41699,0.001527,74.125.200.0-255,5738,117655,7,337604
41700,0.001531,172.31.36.0-255,66,117721,7,337604
41701,0.001534,74.125.200.0-255,766,118487,7,337604
41702,0.001595,74.125.200.0-255,1484,119971,7,337604
41703,0.001598,172.31.36.0-255,66,120037,7,337604
41704,0.001628,74.125.200.0-255,2902,122939,7,337604
41705,0.001631,172.31.36.0-255,66,123005,7,337604
41706,0.001638,74.125.200.0-255,5738,128743,7,337604
41707,0.001641,172.31.36.0-255,66,128809,7,337604
41708,0.001653,74.125.200.0-255,7156,135965,7,337604
41709,0.001655,172.31.36.0-255,66,136031,7,337604
41710,0.001681,74.125.200.0-255,4320,140351,7,337604
41711,0.001684,172.31.36.0-255,66,140417,7,337604
41712,0.001725,172.31.36.0-255,66,140483,7,337604
41713,0.001729,74.125.200.0-255,2184,142667,7,337604
41714,0.001731,172.31.36.0-255,66,142733,7,337604
41715,0.001918,74.125.200.0-255,1484,144217,7,337604
41716,0.001924,74.125.200.0-255,2902,147119,7,337604
41717,0.001927,172.31.36.0-255,66,147185,7,337604
41718,0.001948,74.125.200.0-255,5738,152923,7,337604
41719,0.00195,172.31.36.0-255,66,152989,7,337604
41720,0.002015,74.125.200.0-255,7156,160145,7,337604
41721,0.002018,172.31.36.0-255,66,160211,7,337604
41722,0.002037,172.31.36.0-255,66,160277,7,337604
41723,0.002042,74.125.200.0-255,2184,162461,7,337604
41724,0.002044,172.31.36.0-255,66,162527,7,337604
41725,0.0021,74.125.200.0-255,1484,164011,7,337604
41726,0.002123,74.125.200.0-255,2902,166913,7,337604
41727,0.002126,172.31.36.0-255,66,166979,7,337604
41728,0.002132,74.125.200.0-255,5738,172717,7,337604
41729,0.002135,172.31.36.0-255,66,172783,7,337604
41730,0.002143,74.125.200.0-255,2902,175685,7,337604
41731,0.002146,172.31.36.0-255,66,175751,7,337604
41732,0.002168,74.125.200.0-255,2902,178653,7,337604
41733,0.002171,172.31.36.0-255,66,178719,7,337604
41734,0.002201,74.125.200.0-255,7156,185875,7,337604
41735,0.002204,172.31.36.0-255,66,185941,7,337604
41736,0.002217,172.31.36.0-255,66,186007,7,337604
41737,0.002247,74.125.200.0-255,7156,193163,7,337604
41738,0.002252,172.31.36.0-255,66,193229,7,337604
41739,0.002272,74.125.200.0-255,4320,197549,7,337604
41740,0.002274,172.31.36.0-255,66,197615,7,337604
41741,0.002285,74.125.200.0-255,4320,201935,7,337604
41742,0.002288,172.31.36.0-255,66,202001,7,337604
41743,0.002291,74.125.200.0-255,1484,203485,7,337604
41744,0.002341,172.31.36.0-255,66,203551,7,337604
41745,0.002344,74.125.200.0-255,766,204317,7,337604
41746,0.002406,74.125.200.0-255,1484,205801,7,337604
41747,0.00241,172.31.36.0-255,66,205867,7,337604
41748,0.002416,74.125.200.0-255,2902,208769,7,337604
41749,0.002418,172.31.36.0-255,66,208835,7,337604
41750,0.002455,74.125.200.0-255,5738,214573,7,337604
41751,0.002459,172.31.36.0-255,66,214639,7,337604
41752,0.002477,74.125.200.0-255,1484,216123,7,337604
41753,0.006481,172.31.36.0-255,66,216189,7,337604
41754,0.008997,74.125.200.0-255,5738,221927,7,337604
41755,0.009004,172.31.36.0-255,66,221993,7,337604
41756,0.01152,74.125.200.0-255,5738,227731,7,337604
41757,0.011528,172.31.36.0-255,66,227797,7,337604
41758,0.014041,74.125.200.0-255,5738,233535,7,337604
41759,0.01405,172.31.36.0-255,66,233601,7,337604
41760,0.016568,74.125.200.0-255,5738,239339,7,337604
41761,0.016579,172.31.36.0-255,66,239405,7,337604
41762,0.0191,74.125.200.0-255,5738,245143,7,337604
41763,0.019112,172.31.36.0-255,66,245209,7,337604
41764,0.021633,74.125.200.0-255,5738,250947,7,337604
41765,0.021641,172.31.36.0-255,66,251013,7,337604
41766,0.024148,74.125.200.0-255,5738,256751,7,337604
41767,0.024156,172.31.36.0-255,66,256817,7,337604
41768,0.026669,74.125.200.0-255,5738,262555,7,337604
41769,0.026678,172.31.36.0-255,66,262621,7,337604
41770,0.029195,74.125.200.0-255,5738,268359,7,337604
41771,0.029203,172.31.36.0-255,66,268425,7,337604
41772,0.03175,74.125.200.0-255,5738,274163,7,337604
41773,0.031759,172.31.36.0-255,66,274229,7,337604
41774,0.034283,74.125.200.0-255,5738,279967,7,337604
41775,0.034293,172.31.36.0-255,66,280033,7,337604
41776,0.036808,74.125.200.0-255,5738,285771,7,337604
41777,0.036815,172.31.36.0-255,66,285837,7,337604
41778,0.037278,172.31.36.0-255,172,286009,7,337604
41779,0.037312,172.31.36.0-255,1113,287122,7,337604
41780,0.03738,172.31.36.0-255,1514,288636,7,337604
41781,0.037382,172.31.36.0-255,1514,290150,7,337604
41782,0.037383,172.31.36.0-255,1514,291664,7,337604
41783,0.037384,172.31.36.0-255,1514,293178,7,337604
41784,0.037385,172.31.36.0-255,1514,294692,7,337604
41785,0.037413,172.31.36.0-255,71,294763,7,337604
41786,0.03884,104.244.42.0-255,66,294829,7,337604
41787,0.038891,104.244.42.0-255,66,294895,7,337604
41788,0.038988,104.244.42.0-255,66,294961,7,337604
41789,0.038994,104.244.42.0-255,66,295027,7,337604
41790,0.03932,74.125.200.0-255,5738,300765,7,337604
41791,0.039327,172.31.36.0-255,66,300831,7,337604
41792,0.039535,104.244.42.0-255,108,300939,7,337604
41793,0.03954,172.31.36.0-255,66,301005,7,337604
41794,0.041954,74.125.200.0-255,5738,306743,7,337604
41795,0.041962,172.31.36.0-255,66,306809,7,337604
41796,0.044473,74.125.200.0-255,5738,312547,7,337604
41797,0.044483,172.31.36.0-255,66,312613,7,337604
41798,0.047012,74.125.200.0-255,5738,318351,7,337604
41799,0.04702,172.31.36.0-255,66,318417,7,337604
41800,0.049546,74.125.200.0-255,5738,324155,7,337604
41801,0.049557,172.31.36.0-255,66,324221,7,337604
41802,0.052088,74.125.200.0-255,5738,329959,7,337604
41803,0.052104,172.31.36.0-255,66,330025,7,337604
41804,0.054621,74.125.200.0-255,5738,335763,7,337604
41805,0.054628,172.31.36.0-255,66,335829,7,337604
41806,0.057137,74.125.200.0-255,1538,337367,7,337604
41807,0.057143,172.31.36.0-255,66,337433,7,337604
41808,0.057296,172.31.36.0-255,105,337538,7,337604
41809,0.059778,74.125.200.0-255,66,337604,7,337604
41810,0.0,172.217.194.0-255,153,153,7,292674
41811,2.3e-05,172.31.36.0-255,66,219,7,292674
41812,3.9e-05,172.217.194.0-255,1484,1703,7,292674
41813,4.3e-05,172.31.36.0-255,66,1769,7,292674
41814,5.4e-05,172.217.194.0-255,1484,3253,7,292674
41815,5.7e-05,172.31.36.0-255,66,3319,7,292674
41816,6.3e-05,172.217.194.0-255,2902,6221,7,292674
41817,6.6e-05,172.31.36.0-255,66,6287,7,292674
41818,7.2e-05,172.217.194.0-255,5738,12025,7,292674
41819,7.7e-05,172.31.36.0-255,66,12091,7,292674
41820,8.1e-05,172.217.194.0-255,2019,14110,7,292674
41821,8.4e-05,172.31.36.0-255,66,14176,7,292674
41822,8.8e-05,172.217.194.0-255,1484,15660,7,292674
41823,9.2e-05,172.31.36.0-255,66,15726,7,292674
41824,0.000126,172.217.194.0-255,1484,17210,7,292674
41825,0.000128,172.31.36.0-255,66,17276,7,292674
41826,0.000156,172.217.194.0-255,7156,24432,7,292674
41827,0.00016,172.31.36.0-255,66,24498,7,292674
41828,0.000167,172.217.194.0-255,6797,31295,7,292674
41829,0.00017,172.31.36.0-255,66,31361,7,292674
41830,0.000176,172.217.194.0-255,7156,38517,7,292674
41831,0.000179,172.31.36.0-255,66,38583,7,292674
41832,0.000183,172.217.194.0-255,2902,41485,7,292674
41833,0.000186,172.31.36.0-255,66,41551,7,292674
41834,0.000224,172.217.194.0-255,6797,48348,7,292674
41835,0.000227,172.31.36.0-255,66,48414,7,292674
41836,0.000866,172.217.194.0-255,1484,49898,7,292674
41837,0.000872,172.31.36.0-255,66,49964,7,292674
41838,0.000878,172.217.194.0-255,2902,52866,7,292674
41839,0.00088,172.31.36.0-255,66,52932,7,292674
41840,0.00092,172.217.194.0-255,5738,58670,7,292674
41841,0.000923,172.31.36.0-255,66,58736,7,292674
41842,0.000932,172.217.194.0-255,5738,64474,7,292674
41843,0.000934,172.31.36.0-255,66,64540,7,292674
41844,0.000969,172.31.36.0-255,66,64606,7,292674
41845,0.000972,172.217.194.0-255,1484,66090,7,292674
41846,0.001007,172.31.36.0-255,66,66156,7,292674
41847,0.001047,172.31.36.0-255,66,66222,7,292674
41848,0.001724,172.217.194.0-255,1484,67706,7,292674
41849,0.001734,172.217.194.0-255,2902,70608,7,292674
41850,0.001738,172.31.36.0-255,66,70674,7,292674
41851,0.001746,172.217.194.0-255,5738,76412,7,292674
41852,0.001749,172.31.36.0-255,66,76478,7,292674
41853,0.00176,172.217.194.0-255,4320,80798,7,292674
41854,0.001763,172.31.36.0-255,66,80864,7,292674
41855,0.001802,172.217.194.0-255,2902,83766,7,292674
41856,0.001806,172.31.36.0-255,66,83832,7,292674
41857,0.001825,172.31.36.0-255,66,83898,7,292674
41858,0.00183,172.217.194.0-255,2184,86082,7,292674
41859,0.001832,172.31.36.0-255,66,86148,7,292674
41860,0.004115,172.217.194.0-255,5738,91886,7,292674
41861,0.004122,172.31.36.0-255,66,91952,7,292674
41862,0.006358,172.217.194.0-255,5738,97690,7,292674
41863,0.006361,172.31.36.0-255,66,97756,7,292674
41864,0.008622,172.217.194.0-255,5738,103494,7,292674
41865,0.00863,172.31.36.0-255,66,103560,7,292674
41866,0.010907,172.217.194.0-255,5738,109298,7,292674
41867,0.010915,172.31.36.0-255,66,109364,7,292674
41868,0.013162,172.217.194.0-255,5738,115102,7,292674
41869,0.013172,172.31.36.0-255,66,115168,7,292674
41870,0.015407,172.217.194.0-255,5738,120906,7,292674
41871,0.015415,172.31.36.0-255,66,120972,7,292674
41872,0.017687,172.217.194.0-255,5738,126710,7,292674
41873,0.017694,172.31.36.0-255,66,126776,7,292674
41874,0.01995,172.217.194.0-255,5738,132514,7,292674
41875,0.019958,172.31.36.0-255,66,132580,7,292674
41876,0.022221,172.217.194.0-255,5738,138318,7,292674
41877,0.022226,172.31.36.0-255,66,138384,7,292674
41878,0.024498,172.217.194.0-255,5738,144122,7,292674
41879,0.024506,172.31.36.0-255,66,144188,7,292674
41880,0.026758,172.217.194.0-255,5738,149926,7,292674
41881,0.026768,172.31.36.0-255,66,149992,7,292674
41882,0.029034,172.217.194.0-255,5738,155730,7,292674
41883,0.029041,172.31.36.0-255,66,155796,7,292674
41884,0.031317,172.217.194.0-255,5738,161534,7,292674
41885,0.031324,172.31.36.0-255,66,161600,7,292674
41886,0.033615,172.217.194.0-255,5738,167338,7,292674
41887,0.033623,172.31.36.0-255,66,167404,7,292674
41888,0.035875,172.217.194.0-255,5738,173142,7,292674
41889,0.035883,172.31.36.0-255,66,173208,7,292674
41890,0.038164,172.217.194.0-255,5738,178946,7,292674
41891,0.038173,172.31.36.0-255,66,179012,7,292674
41892,0.040447,172.217.194.0-255,5738,184750,7,292674
41893,0.040455,172.31.36.0-255,66,184816,7,292674
41894,0.041049,172.31.36.0-255,172,184988,7,292674
41895,0.041086,172.31.36.0-255,1115,186103,7,292674
41896,0.041152,172.31.36.0-255,1514,187617,7,292674
41897,0.041153,172.31.36.0-255,1514,189131,7,292674
41898,0.041159,172.31.36.0-255,1514,190645,7,292674
41899,0.04116,172.31.36.0-255,1514,192159,7,292674
41900,0.041179,172.31.36.0-255,1514,193673,7,292674
41901,0.04118,172.31.36.0-255,69,193742,7,292674
41902,0.042585,104.244.42.0-255,66,193808,7,292674
41903,0.042667,104.244.42.0-255,66,193874,7,292674
41904,0.042707,172.217.194.0-255,5738,199612,7,292674
41905,0.042713,172.31.36.0-255,66,199678,7,292674
41906,0.042747,104.244.42.0-255,66,199744,7,292674
41907,0.042752,104.244.42.0-255,66,199810,7,292674
41908,0.044962,172.217.194.0-255,5738,205548,7,292674
41909,0.044969,172.31.36.0-255,66,205614,7,292674
41910,0.047213,172.217.194.0-255,5738,211352,7,292674
41911,0.047221,172.31.36.0-255,66,211418,7,292674
41912,0.049462,172.217.194.0-255,5738,217156,7,292674
41913,0.04947,172.31.36.0-255,66,217222,7,292674
41914,0.051715,172.217.194.0-255,5738,222960,7,292674
41915,0.051723,172.31.36.0-255,66,223026,7,292674
41916,0.054041,172.217.194.0-255,5738,228764,7,292674
41917,0.054048,172.31.36.0-255,66,228830,7,292674
41918,0.056319,172.217.194.0-255,5738,234568,7,292674
41919,0.056326,172.31.36.0-255,66,234634,7,292674
41920,0.058576,172.217.194.0-255,5738,240372,7,292674
41921,0.058583,172.31.36.0-255,66,240438,7,292674
41922,0.060836,172.217.194.0-255,5738,246176,7,292674
41923,0.060843,172.31.36.0-255,66,246242,7,292674
41924,0.063104,172.217.194.0-255,5738,251980,7,292674
41925,0.063111,172.31.36.0-255,66,252046,7,292674
41926,0.065356,172.217.194.0-255,5738,257784,7,292674
41927,0.065362,172.31.36.0-255,66,257850,7,292674
41928,0.067606,172.217.194.0-255,5738,263588,7,292674
41929,0.067612,172.31.36.0-255,66,263654,7,292674
41930,0.069896,172.217.194.0-255,5738,269392,7,292674
41931,0.069903,172.31.36.0-255,66,269458,7,292674
41932,0.07214,172.217.194.0-255,5738,275196,7,292674
41933,0.072147,172.31.36.0-255,66,275262,7,292674
41934,0.074414,172.217.194.0-255,5738,281000,7,292674
41935,0.074422,172.31.36.0-255,66,281066,7,292674
41936,0.076718,172.217.194.0-255,5738,286804,7,292674
41937,0.076724,172.31.36.0-255,66,286870,7,292674
41938,0.078991,172.217.194.0-255,5738,292608,7,292674
41939,0.078999,172.31.36.0-255,66,292674,7,292674
41940,0.0,74.125.24.0-255,297,297,7,251050
41941,2.3e-05,172.31.36.0-255,66,363,7,251050
41942,3.1e-05,74.125.24.0-255,1484,1847,7,251050
41943,3.6e-05,172.31.36.0-255,66,1913,7,251050
41944,4.3e-05,74.125.24.0-255,4320,6233,7,251050
41945,4.7e-05,172.31.36.0-255,66,6299,7,251050
41946,5.3e-05,74.125.24.0-255,5738,12037,7,251050
41947,5.6e-05,172.31.36.0-255,66,12103,7,251050
41948,6e-05,74.125.24.0-255,1874,13977,7,251050
41949,6.2e-05,172.31.36.0-255,66,14043,7,251050
41950,0.000146,74.125.24.0-255,1484,15527,7,251050
41951,0.00015,172.31.36.0-255,66,15593,7,251050
41952,0.000155,74.125.24.0-255,2902,18495,7,251050
41953,0.000157,172.31.36.0-255,66,18561,7,251050
41954,0.000187,74.125.24.0-255,5738,24299,7,251050
41955,0.00019,172.31.36.0-255,66,24365,7,251050
41956,0.000225,74.125.24.0-255,6797,31162,7,251050
41957,0.000228,172.31.36.0-255,66,31228,7,251050
41958,0.000714,74.125.24.0-255,1484,32712,7,251050
41959,0.000721,172.31.36.0-255,66,32778,7,251050
41960,0.000729,74.125.24.0-255,2902,35680,7,251050
41961,0.000731,172.31.36.0-255,66,35746,7,251050
41962,0.000752,74.125.24.0-255,4320,40066,7,251050
41963,0.000755,172.31.36.0-255,66,40132,7,251050
41964,0.000773,74.125.24.0-255,1484,41616,7,251050
41965,0.000775,172.31.36.0-255,66,41682,7,251050
41966,0.000786,172.31.36.0-255,66,41748,7,251050
41967,0.000796,172.31.36.0-255,66,41814,7,251050
41968,0.000822,74.125.24.0-255,6797,48611,7,251050
41969,0.000824,172.31.36.0-255,66,48677,7,251050
41970,0.002203,74.125.24.0-255,645,49322,7,251050
41971,0.002345,74.125.24.0-255,1484,50806,7,251050
41972,0.00235,172.31.36.0-255,66,50872,7,251050
41973,0.003148,74.125.24.0-255,2902,53774,7,251050
41974,0.003155,172.31.36.0-255,66,53840,7,251050
41975,0.004672,74.125.24.0-255,2902,56742,7,251050
41976,0.004679,172.31.36.0-255,66,56808,7,251050
41977,0.005492,74.125.24.0-255,2902,59710,7,251050
41978,0.005495,172.31.36.0-255,66,59776,7,251050
41979,0.007014,74.125.24.0-255,2902,62678,7,251050
41980,0.007019,172.31.36.0-255,66,62744,7,251050
41981,0.00782,74.125.24.0-255,2902,65646,7,251050
41982,0.007827,172.31.36.0-255,66,65712,7,251050
41983,0.009326,74.125.24.0-255,2902,68614,7,251050
41984,0.009333,172.31.36.0-255,66,68680,7,251050
41985,0.010167,74.125.24.0-255,2902,71582,7,251050
41986,0.010174,172.31.36.0-255,66,71648,7,251050
41987,0.011698,74.125.24.0-255,2902,74550,7,251050
41988,0.011707,172.31.36.0-255,66,74616,7,251050
41989,0.012501,74.125.24.0-255,2902,77518,7,251050
41990,0.012508,172.31.36.0-255,66,77584,7,251050
41991,0.014034,74.125.24.0-255,2902,80486,7,251050
41992,0.014041,172.31.36.0-255,66,80552,7,251050
41993,0.014846,74.125.24.0-255,2902,83454,7,251050
41994,0.014853,172.31.36.0-255,66,83520,7,251050
41995,0.016358,74.125.24.0-255,2902,86422,7,251050
41996,0.016367,172.31.36.0-255,66,86488,7,251050
41997,0.01719,74.125.24.0-255,2902,89390,7,251050
41998,0.017196,172.31.36.0-255,66,89456,7,251050
41999,0.018697,74.125.24.0-255,2902,92358,7,251050
42000,0.018704,172.31.36.0-255,66,92424,7,251050
42001,0.019522,74.125.24.0-255,2902,95326,7,251050
42002,0.019529,172.31.36.0-255,66,95392,7,251050
42003,0.021052,74.125.24.0-255,2902,98294,7,251050
42004,0.02106,172.31.36.0-255,66,98360,7,251050
42005,0.021882,74.125.24.0-255,2902,101262,7,251050
42006,0.02189,172.31.36.0-255,66,101328,7,251050
42007,0.023403,74.125.24.0-255,2902,104230,7,251050
42008,0.02341,172.31.36.0-255,66,104296,7,251050
42009,0.024247,74.125.24.0-255,2902,107198,7,251050
42010,0.024253,172.31.36.0-255,66,107264,7,251050
42011,0.025733,74.125.24.0-255,2902,110166,7,251050
42012,0.02574,172.31.36.0-255,66,110232,7,251050
42013,0.026639,74.125.24.0-255,2902,113134,7,251050
42014,0.026646,172.31.36.0-255,66,113200,7,251050
42015,0.02809,74.125.24.0-255,2902,116102,7,251050
42016,0.028097,172.31.36.0-255,66,116168,7,251050
42017,0.028972,74.125.24.0-255,2902,119070,7,251050
42018,0.02898,172.31.36.0-255,66,119136,7,251050
42019,0.030436,74.125.24.0-255,2902,122038,7,251050
42020,0.030443,172.31.36.0-255,66,122104,7,251050
42021,0.03135,74.125.24.0-255,2902,125006,7,251050
42022,0.031356,172.31.36.0-255,66,125072,7,251050
42023,0.032045,172.31.36.0-255,172,125244,7,251050
42024,0.032087,172.31.36.0-255,1114,126358,7,251050
42025,0.032149,172.31.36.0-255,1514,127872,7,251050
42026,0.032151,172.31.36.0-255,1292,129164,7,251050
42027,0.032779,74.125.24.0-255,2902,132066,7,251050
42028,0.032786,172.31.36.0-255,66,132132,7,251050
42029,0.033589,104.244.42.0-255,66,132198,7,251050
42030,0.033634,104.244.42.0-255,66,132264,7,251050
42031,0.033662,74.125.24.0-255,2902,135166,7,251050
42032,0.033667,172.31.36.0-255,66,135232,7,251050
42033,0.033685,104.244.42.0-255,66,135298,7,251050
42034,0.035163,74.125.24.0-255,2902,138200,7,251050
42035,0.035169,172.31.36.0-255,66,138266,7,251050
42036,0.036016,74.125.24.0-255,2902,141168,7,251050
42037,0.036022,172.31.36.0-255,66,141234,7,251050
42038,0.037488,74.125.24.0-255,2902,144136,7,251050
42039,0.037495,172.31.36.0-255,66,144202,7,251050
42040,0.038378,74.125.24.0-255,2902,147104,7,251050
42041,0.038384,172.31.36.0-255,66,147170,7,251050
42042,0.039853,74.125.24.0-255,2902,150072,7,251050
42043,0.039859,172.31.36.0-255,66,150138,7,251050
42044,0.040702,74.125.24.0-255,2902,153040,7,251050
42045,0.040708,172.31.36.0-255,66,153106,7,251050
42046,0.042199,74.125.24.0-255,2902,156008,7,251050
42047,0.042208,172.31.36.0-255,66,156074,7,251050
42048,0.04308,74.125.24.0-255,2902,158976,7,251050
42049,0.043087,172.31.36.0-255,66,159042,7,251050
42050,0.044576,74.125.24.0-255,2902,161944,7,251050
42051,0.044583,172.31.36.0-255,66,162010,7,251050
42052,0.04545,74.125.24.0-255,2902,164912,7,251050
42053,0.045457,172.31.36.0-255,66,164978,7,251050
42054,0.046904,74.125.24.0-255,2902,167880,7,251050
42055,0.046911,172.31.36.0-255,66,167946,7,251050
42056,0.047777,74.125.24.0-255,2902,170848,7,251050
42057,0.047784,172.31.36.0-255,66,170914,7,251050
42058,0.049283,74.125.24.0-255,2902,173816,7,251050
42059,0.049289,172.31.36.0-255,66,173882,7,251050
42060,0.050157,74.125.24.0-255,2902,176784,7,251050
42061,0.050163,172.31.36.0-255,66,176850,7,251050
42062,0.051613,74.125.24.0-255,2902,179752,7,251050
42063,0.05162,172.31.36.0-255,66,179818,7,251050
42064,0.052495,74.125.24.0-255,2902,182720,7,251050
42065,0.052502,172.31.36.0-255,66,182786,7,251050
42066,0.053974,74.125.24.0-255,2902,185688,7,251050
42067,0.053981,172.31.36.0-255,66,185754,7,251050
42068,0.054866,74.125.24.0-255,2902,188656,7,251050
42069,0.054887,172.31.36.0-255,66,188722,7,251050
42070,0.056366,74.125.24.0-255,2902,191624,7,251050
42071,0.056373,172.31.36.0-255,66,191690,7,251050
42072,0.05724,74.125.24.0-255,2902,194592,7,251050
42073,0.057247,172.31.36.0-255,66,194658,7,251050
42074,0.05874,74.125.24.0-255,2902,197560,7,251050
42075,0.058747,172.31.36.0-255,66,197626,7,251050
42076,0.05958,74.125.24.0-255,2902,200528,7,251050
42077,0.059586,172.31.36.0-255,66,200594,7,251050
42078,0.061109,74.125.24.0-255,2902,203496,7,251050
42079,0.061115,172.31.36.0-255,66,203562,7,251050
42080,0.061945,74.125.24.0-255,2902,206464,7,251050
42081,0.061953,172.31.36.0-255,66,206530,7,251050
42082,0.063455,74.125.24.0-255,2902,209432,7,251050
42083,0.063462,172.31.36.0-255,66,209498,7,251050
42084,0.064331,74.125.24.0-255,2902,212400,7,251050
42085,0.064337,172.31.36.0-255,66,212466,7,251050
42086,0.065825,74.125.24.0-255,2902,215368,7,251050
42087,0.065832,172.31.36.0-255,66,215434,7,251050
42088,0.06668,74.125.24.0-255,2902,218336,7,251050
42089,0.066687,172.31.36.0-255,66,218402,7,251050
42090,0.06819,74.125.24.0-255,2902,221304,7,251050
42091,0.068197,172.31.36.0-255,66,221370,7,251050
42092,0.069047,74.125.24.0-255,2902,224272,7,251050
42093,0.069053,172.31.36.0-255,66,224338,7,251050
42094,0.070559,74.125.24.0-255,2902,227240,7,251050
42095,0.070566,172.31.36.0-255,66,227306,7,251050
42096,0.071408,74.125.24.0-255,2902,230208,7,251050
42097,0.071414,172.31.36.0-255,66,230274,7,251050
42098,0.0729,74.125.24.0-255,2902,233176,7,251050
42099,0.072907,172.31.36.0-255,66,233242,7,251050
42100,0.073755,74.125.24.0-255,2902,236144,7,251050
42101,0.073761,172.31.36.0-255,66,236210,7,251050
42102,0.07524,74.125.24.0-255,2902,239112,7,251050
42103,0.075248,172.31.36.0-255,66,239178,7,251050
42104,0.076096,74.125.24.0-255,2902,242080,7,251050
42105,0.076102,172.31.36.0-255,66,242146,7,251050
42106,0.077559,74.125.24.0-255,2902,245048,7,251050
42107,0.077566,172.31.36.0-255,66,245114,7,251050
42108,0.078439,74.125.24.0-255,2902,248016,7,251050
42109,0.078445,172.31.36.0-255,66,248082,7,251050
42110,0.079904,74.125.24.0-255,2902,250984,7,251050
42111,0.07991,172.31.36.0-255,66,251050,7,251050
42112,0.0,74.125.68.0-255,153,153,7,262946
42113,2.9e-05,172.31.36.0-255,66,219,7,262946
42114,3.5e-05,74.125.68.0-255,1484,1703,7,262946
42115,3.9e-05,172.31.36.0-255,66,1769,7,262946
42116,5.2e-05,74.125.68.0-255,2902,4671,7,262946
42117,5.6e-05,172.31.36.0-255,66,4737,7,262946
42118,8.9e-05,74.125.68.0-255,2902,7639,7,262946
42119,9.2e-05,172.31.36.0-255,66,7705,7,262946
42120,0.000155,74.125.68.0-255,4320,12025,7,262946
42121,0.00016,172.31.36.0-255,66,12091,7,262946
42122,0.000242,74.125.68.0-255,4846,16937,7,262946
42123,0.000247,172.31.36.0-255,66,17003,7,262946
42124,0.000342,74.125.68.0-255,4320,21323,7,262946
42125,0.000349,172.31.36.0-255,66,21389,7,262946
42126,0.000379,74.125.68.0-255,7156,28545,7,262946
42127,0.000383,172.31.36.0-255,66,28611,7,262946
42128,0.000577,74.125.68.0-255,2543,31154,7,262946
42129,0.000582,172.31.36.0-255,66,31220,7,262946
42130,0.000628,74.125.68.0-255,4320,35540,7,262946
42131,0.000633,172.31.36.0-255,66,35606,7,262946
42132,0.000675,172.31.36.0-255,66,35672,7,262946
42133,0.00096,74.125.68.0-255,1125,36797,7,262946
42134,0.000967,172.31.36.0-255,66,36863,7,262946
42135,0.000998,74.125.68.0-255,1484,38347,7,262946
42136,0.001001,172.31.36.0-255,66,38413,7,262946
42137,0.001006,74.125.68.0-255,1484,39897,7,262946
42138,0.001008,172.31.36.0-255,66,39963,7,262946
42139,0.001035,74.125.68.0-255,2902,42865,7,262946
42140,0.001039,172.31.36.0-255,66,42931,7,262946
42141,0.001114,172.31.36.0-255,66,42997,7,262946
42142,0.00114,74.125.68.0-255,1484,44481,7,262946
42143,0.00134,74.125.68.0-255,4320,48801,7,262946
42144,0.001345,172.31.36.0-255,66,48867,7,262946
42145,0.001393,74.125.68.0-255,2902,51769,7,262946
42146,0.001416,74.125.68.0-255,5379,57148,7,262946
42147,0.001864,74.125.68.0-255,5738,62886,7,262946
42148,0.002827,74.125.68.0-255,1484,64370,7,262946
42149,0.003809,74.125.68.0-255,2902,67272,7,262946
42150,0.004159,172.31.36.0-255,66,67338,7,262946
42151,0.006401,74.125.68.0-255,5738,73076,7,262946
42152,0.006407,172.31.36.0-255,66,73142,7,262946
42153,0.008658,74.125.68.0-255,5738,78880,7,262946
42154,0.008665,172.31.36.0-255,66,78946,7,262946
42155,0.010907,74.125.68.0-255,5738,84684,7,262946
42156,0.010915,172.31.36.0-255,66,84750,7,262946
42157,0.01316,74.125.68.0-255,5738,90488,7,262946
42158,0.013168,172.31.36.0-255,66,90554,7,262946
42159,0.015423,74.125.68.0-255,5738,96292,7,262946
42160,0.015431,172.31.36.0-255,66,96358,7,262946
42161,0.017693,74.125.68.0-255,5738,102096,7,262946
42162,0.017701,172.31.36.0-255,66,102162,7,262946
42163,0.01994,74.125.68.0-255,5738,107900,7,262946
42164,0.019947,172.31.36.0-255,66,107966,7,262946
42165,0.022228,74.125.68.0-255,5738,113704,7,262946
42166,0.022236,172.31.36.0-255,66,113770,7,262946
42167,0.024474,74.125.68.0-255,5738,119508,7,262946
42168,0.024481,172.31.36.0-255,66,119574,7,262946
42169,0.026719,74.125.68.0-255,5738,125312,7,262946
42170,0.026726,172.31.36.0-255,66,125378,7,262946
42171,0.02865,172.31.36.0-255,188,125566,7,262946
42172,0.028683,172.31.36.0-255,958,126524,7,262946
42173,0.028749,172.31.36.0-255,1514,128038,7,262946
42174,0.028751,172.31.36.0-255,1448,129486,7,262946
42175,0.02897,74.125.68.0-255,5738,135224,7,262946
42176,0.028977,172.31.36.0-255,66,135290,7,262946
42177,0.030178,104.244.42.0-255,66,135356,7,262946
42178,0.030208,104.244.42.0-255,66,135422,7,262946
42179,0.030318,104.244.42.0-255,66,135488,7,262946
42180,0.031216,74.125.68.0-255,5738,141226,7,262946
42181,0.031221,172.31.36.0-255,66,141292,7,262946
42182,0.033468,74.125.68.0-255,5738,147030,7,262946
42183,0.033475,172.31.36.0-255,66,147096,7,262946
42184,0.035726,74.125.68.0-255,5738,152834,7,262946
42185,0.035733,172.31.36.0-255,66,152900,7,262946
42186,0.03797,74.125.68.0-255,5738,158638,7,262946
42187,0.037976,172.31.36.0-255,66,158704,7,262946
42188,0.040204,74.125.68.0-255,5738,164442,7,262946
42189,0.040224,172.31.36.0-255,66,164508,7,262946
42190,0.042452,74.125.68.0-255,5738,170246,7,262946
42191,0.042458,172.31.36.0-255,66,170312,7,262946
42192,0.044691,74.125.68.0-255,5738,176050,7,262946
42193,0.044698,172.31.36.0-255,66,176116,7,262946
42194,0.046932,74.125.68.0-255,5738,181854,7,262946
42195,0.046938,172.31.36.0-255,66,181920,7,262946
42196,0.049297,74.125.68.0-255,4320,186240,7,262946
42197,0.049303,172.31.36.0-255,66,186306,7,262946
42198,0.049343,74.125.68.0-255,1484,187790,7,262946
42199,0.051554,74.125.68.0-255,4320,192110,7,262946
42200,0.051561,172.31.36.0-255,66,192176,7,262946
42201,0.053804,74.125.68.0-255,5738,197914,7,262946
42202,0.05385,172.31.36.0-255,66,197980,7,262946
42203,0.056074,74.125.68.0-255,1484,199464,7,262946
42204,0.056119,74.125.68.0-255,4320,203784,7,262946
42205,0.056124,172.31.36.0-255,66,203850,7,262946
42206,0.058358,74.125.68.0-255,5738,209588,7,262946
42207,0.058363,172.31.36.0-255,66,209654,7,262946
42208,0.060598,74.125.68.0-255,5738,215392,7,262946
42209,0.060603,172.31.36.0-255,66,215458,7,262946
42210,0.062837,74.125.68.0-255,2902,218360,7,262946
42211,0.062842,172.31.36.0-255,66,218426,7,262946
42212,0.062873,74.125.68.0-255,2902,221328,7,262946
42213,0.062901,172.31.36.0-255,66,221394,7,262946
42214,0.065077,74.125.68.0-255,2902,224296,7,262946
42215,0.065082,172.31.36.0-255,66,224362,7,262946
42216,0.065124,74.125.68.0-255,2902,227264,7,262946
42217,0.065155,172.31.36.0-255,66,227330,7,262946
42218,0.067324,74.125.68.0-255,2902,230232,7,262946
42219,0.067331,172.31.36.0-255,66,230298,7,262946
42220,0.067384,74.125.68.0-255,2902,233200,7,262946
42221,0.067412,172.31.36.0-255,66,233266,7,262946
42222,0.069566,74.125.68.0-255,2902,236168,7,262946
42223,0.069572,172.31.36.0-255,66,236234,7,262946
42224,0.069636,74.125.68.0-255,2902,239136,7,262946
42225,0.069649,172.31.36.0-255,66,239202,7,262946
42226,0.071804,74.125.68.0-255,2902,242104,7,262946
42227,0.07181,172.31.36.0-255,66,242170,7,262946
42228,0.071877,74.125.68.0-255,2902,245072,7,262946
42229,0.071892,172.31.36.0-255,66,245138,7,262946
42230,0.074046,74.125.68.0-255,2902,248040,7,262946
42231,0.074052,172.31.36.0-255,66,248106,7,262946
42232,0.074116,74.125.68.0-255,2902,251008,7,262946
42233,0.074131,172.31.36.0-255,66,251074,7,262946
42234,0.076282,74.125.68.0-255,2902,253976,7,262946
42235,0.076287,172.31.36.0-255,66,254042,7,262946
42236,0.076352,74.125.68.0-255,2902,256944,7,262946
42237,0.07637,172.31.36.0-255,66,257010,7,262946
42238,0.078518,74.125.68.0-255,2902,259912,7,262946
42239,0.078523,172.31.36.0-255,66,259978,7,262946
42240,0.078602,74.125.68.0-255,2902,262880,7,262946
42241,0.078615,172.31.36.0-255,66,262946,7,262946
42242,0.0,74.125.24.0-255,146,146,7,349917
42243,2.1e-05,172.31.36.0-255,66,212,7,349917
42244,2.8e-05,74.125.24.0-255,1484,1696,7,349917
42245,3.3e-05,172.31.36.0-255,66,1762,7,349917
42246,3.9e-05,74.125.24.0-255,2902,4664,7,349917
42247,4.3e-05,172.31.36.0-255,66,4730,7,349917
42248,5e-05,74.125.24.0-255,5738,10468,7,349917
42249,5.4e-05,172.31.36.0-255,66,10534,7,349917
42250,9.2e-05,74.125.24.0-255,3405,13939,7,349917
42251,9.5e-05,172.31.36.0-255,66,14005,7,349917
42252,0.000115,74.125.24.0-255,2902,16907,7,349917
42253,0.000117,172.31.36.0-255,66,16973,7,349917
42254,0.000133,74.125.24.0-255,1484,18457,7,349917
42255,0.000135,172.31.36.0-255,66,18523,7,349917
42256,0.000141,74.125.24.0-255,4320,22843,7,349917
42257,0.000143,172.31.36.0-255,66,22909,7,349917
42258,0.000184,74.125.24.0-255,2902,25811,7,349917
42259,0.000186,172.31.36.0-255,66,25877,7,349917
42260,0.000207,74.125.24.0-255,5379,31256,7,349917
42261,0.00021,172.31.36.0-255,66,31322,7,349917
42262,0.000234,172.31.36.0-255,66,31388,7,349917
42263,0.000264,74.125.24.0-255,2902,34290,7,349917
42264,0.000266,172.31.36.0-255,66,34356,7,349917
42265,0.000286,74.125.24.0-255,1484,35840,7,349917
42266,0.000288,172.31.36.0-255,66,35906,7,349917
42267,0.000294,74.125.24.0-255,5738,41644,7,349917
42268,0.000296,172.31.36.0-255,66,41710,7,349917
42269,0.000323,172.31.36.0-255,66,41776,7,349917
42270,0.0004,74.125.24.0-255,5690,47466,7,349917
42271,0.000404,172.31.36.0-255,66,47532,7,349917
42272,0.000418,74.125.24.0-255,377,47909,7,349917
42273,0.000687,74.125.24.0-255,1484,49393,7,349917
42274,0.000692,172.31.36.0-255,66,49459,7,349917
42275,0.000697,74.125.24.0-255,2902,52361,7,349917
42276,0.0007,172.31.36.0-255,66,52427,7,349917
42277,0.000706,74.125.24.0-255,5738,58165,7,349917
42278,0.000709,172.31.36.0-255,66,58231,7,349917
42279,0.000742,74.125.24.0-255,2902,61133,7,349917
42280,0.000746,172.31.36.0-255,66,61199,7,349917
42281,0.000761,74.125.24.0-255,4320,65519,7,349917
42282,0.000764,172.31.36.0-255,66,65585,7,349917
42283,0.000789,74.125.24.0-255,5738,71323,7,349917
42284,0.000792,172.31.36.0-255,66,71389,7,349917
42285,0.000809,74.125.24.0-255,1484,72873,7,349917
42286,0.000825,74.125.24.0-255,5738,78611,7,349917
42287,0.000827,172.31.36.0-255,66,78677,7,349917
42288,0.000847,74.125.24.0-255,3602,82279,7,349917
42289,0.00085,172.31.36.0-255,66,82345,7,349917
42290,0.001152,74.125.24.0-255,1484,83829,7,349917
42291,0.001158,74.125.24.0-255,2902,86731,7,349917
42292,0.001161,172.31.36.0-255,66,86797,7,349917
42293,0.001168,74.125.24.0-255,4320,91117,7,349917
42294,0.00117,172.31.36.0-255,66,91183,7,349917
42295,0.001188,74.125.24.0-255,1484,92667,7,349917
42296,0.001205,74.125.24.0-255,5738,98405,7,349917
42297,0.001207,172.31.36.0-255,66,98471,7,349917
42298,0.001231,74.125.24.0-255,5738,104209,7,349917
42299,0.001233,172.31.36.0-255,66,104275,7,349917
42300,0.001248,74.125.24.0-255,1484,105759,7,349917
42301,0.001289,74.125.24.0-255,2902,108661,7,349917
42302,0.001293,172.31.36.0-255,66,108727,7,349917
42303,0.001321,172.31.36.0-255,66,108793,7,349917
42304,0.002008,74.125.24.0-255,1484,110277,7,349917
42305,0.002016,74.125.24.0-255,1484,111761,7,349917
42306,0.00202,172.31.36.0-255,66,111827,7,349917
42307,0.002038,74.125.24.0-255,1484,113311,7,349917
42308,0.002071,74.125.24.0-255,5738,119049,7,349917
42309,0.002075,172.31.36.0-255,66,119115,7,349917
42310,0.002085,172.31.36.0-255,66,119181,7,349917
42311,0.002097,74.125.24.0-255,1484,120665,7,349917
42312,0.002128,74.125.24.0-255,5738,126403,7,349917
42313,0.00213,172.31.36.0-255,66,126469,7,349917
42314,0.002154,74.125.24.0-255,4320,130789,7,349917
42315,0.002157,172.31.36.0-255,66,130855,7,349917
42316,0.002177,74.125.24.0-255,2902,133757,7,349917
42317,0.002178,172.31.36.0-255,66,133823,7,349917
42318,0.002195,74.125.24.0-255,766,134589,7,349917
42319,0.002272,74.125.24.0-255,1484,136073,7,349917
42320,0.002275,172.31.36.0-255,66,136139,7,349917
42321,0.002279,74.125.24.0-255,2902,139041,7,349917
42322,0.002281,172.31.36.0-255,66,139107,7,349917
42323,0.002305,74.125.24.0-255,2902,142009,7,349917
42324,0.002307,172.31.36.0-255,66,142075,7,349917
42325,0.002321,74.125.24.0-255,2902,144977,7,349917
42326,0.002323,172.31.36.0-255,66,145043,7,349917
42327,0.002354,74.125.24.0-255,2902,147945,7,349917
42328,0.002356,172.31.36.0-255,66,148011,7,349917
42329,0.002378,172.31.36.0-255,66,148077,7,349917
42330,0.002409,74.125.24.0-255,4320,152397,7,349917
42331,0.002412,172.31.36.0-255,66,152463,7,349917
42332,0.002429,74.125.24.0-255,2902,155365,7,349917
42333,0.002431,172.31.36.0-255,66,155431,7,349917
42334,0.002465,74.125.24.0-255,4320,159751,7,349917
42335,0.002468,172.31.36.0-255,66,159817,7,349917
42336,0.002505,172.31.36.0-255,66,159883,7,349917
42337,0.004855,74.125.24.0-255,5738,165621,7,349917
42338,0.004862,172.31.36.0-255,66,165687,7,349917
42339,0.0072,74.125.24.0-255,5738,171425,7,349917
42340,0.007207,172.31.36.0-255,66,171491,7,349917
42341,0.00955,74.125.24.0-255,5738,177229,7,349917
42342,0.009557,172.31.36.0-255,66,177295,7,349917
42343,0.011888,74.125.24.0-255,5738,183033,7,349917
42344,0.011896,172.31.36.0-255,66,183099,7,349917
42345,0.014252,74.125.24.0-255,5738,188837,7,349917
42346,0.01426,172.31.36.0-255,66,188903,7,349917
42347,0.01663,74.125.24.0-255,5738,194641,7,349917
42348,0.016642,172.31.36.0-255,66,194707,7,349917
42349,0.018988,74.125.24.0-255,5738,200445,7,349917
42350,0.018997,172.31.36.0-255,66,200511,7,349917
42351,0.02135,74.125.24.0-255,5738,206249,7,349917
42352,0.021359,172.31.36.0-255,66,206315,7,349917
42353,0.023732,74.125.24.0-255,5738,212053,7,349917
42354,0.02374,172.31.36.0-255,66,212119,7,349917
42355,0.026095,74.125.24.0-255,5738,217857,7,349917
42356,0.026104,172.31.36.0-255,66,217923,7,349917
42357,0.028456,74.125.24.0-255,5738,223661,7,349917
42358,0.028465,172.31.36.0-255,66,223727,7,349917
42359,0.030802,74.125.24.0-255,5738,229465,7,349917
42360,0.030809,172.31.36.0-255,66,229531,7,349917
42361,0.032094,172.31.36.0-255,188,229719,7,349917
42362,0.032127,172.31.36.0-255,958,230677,7,349917
42363,0.032188,172.31.36.0-255,1514,232191,7,349917
42364,0.03219,172.31.36.0-255,1448,233639,7,349917
42365,0.033159,74.125.24.0-255,5738,239377,7,349917
42366,0.033167,172.31.36.0-255,66,239443,7,349917
42367,0.033665,104.244.42.0-255,66,239509,7,349917
42368,0.033674,104.244.42.0-255,66,239575,7,349917
42369,0.033797,104.244.42.0-255,66,239641,7,349917
42370,0.035547,74.125.24.0-255,5738,245379,7,349917
42371,0.035554,172.31.36.0-255,66,245445,7,349917
42372,0.037919,74.125.24.0-255,5738,251183,7,349917
42373,0.037926,172.31.36.0-255,66,251249,7,349917
42374,0.040275,74.125.24.0-255,5738,256987,7,349917
42375,0.040285,172.31.36.0-255,66,257053,7,349917
42376,0.042636,74.125.24.0-255,5738,262791,7,349917
42377,0.042642,172.31.36.0-255,66,262857,7,349917
42378,0.04499,74.125.24.0-255,5738,268595,7,349917
42379,0.044997,172.31.36.0-255,66,268661,7,349917
42380,0.047334,74.125.24.0-255,5738,274399,7,349917
42381,0.04734,172.31.36.0-255,66,274465,7,349917
42382,0.04968,74.125.24.0-255,5738,280203,7,349917
42383,0.049686,172.31.36.0-255,66,280269,7,349917
42384,0.052068,74.125.24.0-255,5738,286007,7,349917
42385,0.052074,172.31.36.0-255,66,286073,7,349917
42386,0.054426,74.125.24.0-255,5738,291811,7,349917
42387,0.054433,172.31.36.0-255,66,291877,7,349917
42388,0.056776,74.125.24.0-255,5738,297615,7,349917
42389,0.056786,172.31.36.0-255,66,297681,7,349917
42390,0.059137,74.125.24.0-255,5738,303419,7,349917
42391,0.059144,172.31.36.0-255,66,303485,7,349917
42392,0.06156,74.125.24.0-255,5738,309223,7,349917
42393,0.061567,172.31.36.0-255,66,309289,7,349917
42394,0.064456,74.125.24.0-255,5738,315027,7,349917
42395,0.064463,172.31.36.0-255,66,315093,7,349917
42396,0.066794,74.125.24.0-255,5738,320831,7,349917
42397,0.066801,172.31.36.0-255,66,320897,7,349917
42398,0.069147,74.125.24.0-255,5738,326635,7,349917
42399,0.069154,172.31.36.0-255,66,326701,7,349917
42400,0.071499,74.125.24.0-255,5738,332439,7,349917
42401,0.071506,172.31.36.0-255,66,332505,7,349917
42402,0.073844,74.125.24.0-255,5738,338243,7,349917
42403,0.073851,172.31.36.0-255,66,338309,7,349917
42404,0.076193,74.125.24.0-255,5738,344047,7,349917
42405,0.0762,172.31.36.0-255,66,344113,7,349917
42406,0.078534,74.125.24.0-255,5738,349851,7,349917
42407,0.07854,172.31.36.0-255,66,349917,7,349917
42408,0.0,216.58.221.0-255,66,66,7,66
42409,0.0,74.125.130.0-255,142,142,7,397707
42410,2.6e-05,172.31.36.0-255,66,208,7,397707
42411,3.3e-05,74.125.130.0-255,1484,1692,7,397707
42412,3.8e-05,172.31.36.0-255,66,1758,7,397707
42413,4.3e-05,74.125.130.0-255,2902,4660,7,397707
42414,5.4e-05,172.31.36.0-255,66,4726,7,397707
42415,5.9e-05,74.125.130.0-255,4320,9046,7,397707
42416,6.2e-05,172.31.36.0-255,66,9112,7,397707
42417,6.8e-05,74.125.130.0-255,4939,14051,7,397707
42418,7.2e-05,172.31.36.0-255,66,14117,7,397707
42419,0.0001,74.125.130.0-255,1484,15601,7,397707
42420,0.000103,172.31.36.0-255,66,15667,7,397707
42421,0.00013,74.125.130.0-255,2902,18569,7,397707
42422,0.000132,172.31.36.0-255,66,18635,7,397707
42423,0.000139,74.125.130.0-255,5738,24373,7,397707
42424,0.000142,172.31.36.0-255,66,24439,7,397707
42425,0.000153,74.125.130.0-255,4320,28759,7,397707
42426,0.000155,172.31.36.0-255,66,28825,7,397707
42427,0.000208,74.125.130.0-255,2543,31368,7,397707
42428,0.000211,172.31.36.0-255,66,31434,7,397707
42429,0.000291,74.125.130.0-255,1484,32918,7,397707
42430,0.000294,172.31.36.0-255,66,32984,7,397707
42431,0.000299,74.125.130.0-255,1484,34468,7,397707
42432,0.000301,172.31.36.0-255,66,34534,7,397707
42433,0.000327,74.125.130.0-255,1484,36018,7,397707
42434,0.00033,172.31.36.0-255,66,36084,7,397707
42435,0.000341,74.125.130.0-255,5738,41822,7,397707
42436,0.000344,172.31.36.0-255,66,41888,7,397707
42437,0.000351,74.125.130.0-255,6797,48685,7,397707
42438,0.000354,172.31.36.0-255,66,48751,7,397707
42439,0.000419,74.125.130.0-255,1484,50235,7,397707
42440,0.000422,172.31.36.0-255,66,50301,7,397707
42441,0.000427,74.125.130.0-255,2902,53203,7,397707
42442,0.00043,172.31.36.0-255,66,53269,7,397707
42443,0.000436,74.125.130.0-255,5738,59007,7,397707
42444,0.000445,74.125.130.0-255,1484,60491,7,397707
42445,0.000441,172.31.36.0-255,66,60557,7,397707
42446,0.000475,74.125.130.0-255,2902,63459,7,397707
42447,0.000479,172.31.36.0-255,66,63525,7,397707
42448,0.000506,74.125.130.0-255,3154,66679,7,397707
42449,0.000509,172.31.36.0-255,66,66745,7,397707
42450,0.00091,74.125.130.0-255,1484,68229,7,397707
42451,0.00092,74.125.130.0-255,2902,71131,7,397707
42452,0.000924,172.31.36.0-255,66,71197,7,397707
42453,0.000929,74.125.130.0-255,1484,72681,7,397707
42454,0.00096,74.125.130.0-255,4320,77001,7,397707
42455,0.000964,172.31.36.0-255,66,77067,7,397707
42456,0.000971,74.125.130.0-255,5738,82805,7,397707
42457,0.000974,172.31.36.0-255,66,82871,7,397707
42458,0.001015,74.125.130.0-255,7156,90027,7,397707
42459,0.001019,172.31.36.0-255,66,90093,7,397707
42460,0.001024,74.125.130.0-255,2902,92995,7,397707
42461,0.001026,172.31.36.0-255,66,93061,7,397707
42462,0.001053,74.125.130.0-255,5738,98799,7,397707
42463,0.001061,172.31.36.0-255,66,98865,7,397707
42464,0.001067,74.125.130.0-255,2184,101049,7,397707
42465,0.001069,172.31.36.0-255,66,101115,7,397707
42466,0.001131,74.125.130.0-255,1484,102599,7,397707
42467,0.001151,74.125.130.0-255,2902,105501,7,397707
42468,0.001155,172.31.36.0-255,66,105567,7,397707
42469,0.001161,74.125.130.0-255,4320,109887,7,397707
42470,0.001163,172.31.36.0-255,66,109953,7,397707
42471,0.001232,74.125.130.0-255,5738,115691,7,397707
42472,0.001238,172.31.36.0-255,66,115757,7,397707
42473,0.001255,74.125.130.0-255,1994,117751,7,397707
42474,0.001258,172.31.36.0-255,66,117817,7,397707
42475,0.001354,74.125.130.0-255,1484,119301,7,397707
42476,0.001372,74.125.130.0-255,2902,122203,7,397707
42477,0.001377,172.31.36.0-255,66,122269,7,397707
42478,0.001404,74.125.130.0-255,1484,123753,7,397707
42479,0.001423,74.125.130.0-255,2902,126655,7,397707
42480,0.001427,172.31.36.0-255,66,126721,7,397707
42481,0.001452,74.125.130.0-255,5738,132459,7,397707
42482,0.001455,172.31.36.0-255,66,132525,7,397707
42483,0.001463,74.125.130.0-255,5738,138263,7,397707
42484,0.001465,172.31.36.0-255,66,138329,7,397707
42485,0.001501,74.125.130.0-255,7156,145485,7,397707
42486,0.001509,172.31.36.0-255,66,145551,7,397707
42487,0.00154,74.125.130.0-255,6438,151989,7,397707
42488,0.001543,172.31.36.0-255,66,152055,7,397707
42489,0.001611,74.125.130.0-255,1484,153539,7,397707
42490,0.001628,74.125.130.0-255,2902,156441,7,397707
42491,0.00163,172.31.36.0-255,66,156507,7,397707
42492,0.001661,74.125.130.0-255,5738,162245,7,397707
42493,0.001664,172.31.36.0-255,66,162311,7,397707
42494,0.00167,74.125.130.0-255,5738,168049,7,397707
42495,0.001673,172.31.36.0-255,66,168115,7,397707
42496,0.001701,74.125.130.0-255,2902,171017,7,397707
42497,0.001704,172.31.36.0-255,66,171083,7,397707
42498,0.00173,74.125.130.0-255,3961,175044,7,397707
42499,0.001734,172.31.36.0-255,66,175110,7,397707
42500,0.001738,74.125.130.0-255,2902,178012,7,397707
42501,0.00174,172.31.36.0-255,66,178078,7,397707
42502,0.001785,172.31.36.0-255,66,178144,7,397707
42503,0.001796,172.31.36.0-255,66,178210,7,397707
42504,0.001831,74.125.130.0-255,5020,183230,7,397707
42505,0.001834,172.31.36.0-255,66,183296,7,397707
42506,0.001998,74.125.130.0-255,1484,184780,7,397707
42507,0.002012,74.125.130.0-255,2902,187682,7,397707
42508,0.002015,172.31.36.0-255,66,187748,7,397707
42509,0.002042,74.125.130.0-255,4320,192068,7,397707
42510,0.002044,172.31.36.0-255,66,192134,7,397707
42511,0.00211,172.31.36.0-255,66,192200,7,397707
42512,0.002116,74.125.130.0-255,5738,197938,7,397707
42513,0.002119,172.31.36.0-255,66,198004,7,397707
42514,0.00213,74.125.130.0-255,7156,205160,7,397707
42515,0.002133,172.31.36.0-255,66,205226,7,397707
42516,0.002137,74.125.130.0-255,3602,208828,7,397707
42517,0.002139,172.31.36.0-255,66,208894,7,397707
42518,0.004351,74.125.130.0-255,5738,214632,7,397707
42519,0.004357,172.31.36.0-255,66,214698,7,397707
42520,0.006578,74.125.130.0-255,5738,220436,7,397707
42521,0.006585,172.31.36.0-255,66,220502,7,397707
42522,0.00884,74.125.130.0-255,5738,226240,7,397707
42523,0.008848,172.31.36.0-255,66,226306,7,397707
42524,0.011071,74.125.130.0-255,5738,232044,7,397707
42525,0.011078,172.31.36.0-255,66,232110,7,397707
42526,0.013313,74.125.130.0-255,5738,237848,7,397707
42527,0.013321,172.31.36.0-255,66,237914,7,397707
42528,0.015555,74.125.130.0-255,5738,243652,7,397707
42529,0.015562,172.31.36.0-255,66,243718,7,397707
42530,0.01779,74.125.130.0-255,5738,249456,7,397707
42531,0.017797,172.31.36.0-255,66,249522,7,397707
42532,0.020022,74.125.130.0-255,5738,255260,7,397707
42533,0.02003,172.31.36.0-255,66,255326,7,397707
42534,0.022262,74.125.130.0-255,5738,261064,7,397707
42535,0.022271,172.31.36.0-255,66,261130,7,397707
42536,0.024511,74.125.130.0-255,5738,266868,7,397707
42537,0.024519,172.31.36.0-255,66,266934,7,397707
42538,0.026375,172.31.36.0-255,164,267098,7,397707
42539,0.026482,172.31.36.0-255,1123,268221,7,397707
42540,0.026542,172.31.36.0-255,1514,269735,7,397707
42541,0.026544,172.31.36.0-255,1283,271018,7,397707
42542,0.026749,74.125.130.0-255,5738,276756,7,397707
42543,0.026758,172.31.36.0-255,66,276822,7,397707
42544,0.027936,104.244.42.0-255,66,276888,7,397707
42545,0.028029,104.244.42.0-255,66,276954,7,397707
42546,0.028129,104.244.42.0-255,66,277020,7,397707
42547,0.028975,74.125.130.0-255,4320,281340,7,397707
42548,0.028979,172.31.36.0-255,66,281406,7,397707
42549,0.029018,74.125.130.0-255,1484,282890,7,397707
42550,0.031205,74.125.130.0-255,4320,287210,7,397707
42551,0.031212,172.31.36.0-255,66,287276,7,397707
42552,0.033441,74.125.130.0-255,5738,293014,7,397707
42553,0.033447,172.31.36.0-255,66,293080,7,397707
42554,0.035678,74.125.130.0-255,5738,298818,7,397707
42555,0.035684,172.31.36.0-255,66,298884,7,397707
42556,0.037913,74.125.130.0-255,5738,304622,7,397707
42557,0.037919,172.31.36.0-255,66,304688,7,397707
42558,0.040156,74.125.130.0-255,5738,310426,7,397707
42559,0.040161,172.31.36.0-255,66,310492,7,397707
42560,0.0424,74.125.130.0-255,4320,314812,7,397707
42561,0.042408,172.31.36.0-255,66,314878,7,397707
42562,0.04244,74.125.130.0-255,1484,316362,7,397707
42563,0.044635,74.125.130.0-255,4320,320682,7,397707
42564,0.044641,172.31.36.0-255,66,320748,7,397707
42565,0.046866,74.125.130.0-255,5738,326486,7,397707
42566,0.046872,172.31.36.0-255,66,326552,7,397707
42567,0.049096,74.125.130.0-255,5738,332290,7,397707
42568,0.049101,172.31.36.0-255,66,332356,7,397707
42569,0.051321,74.125.130.0-255,4320,336676,7,397707
42570,0.051327,172.31.36.0-255,66,336742,7,397707
42571,0.051358,74.125.130.0-255,1484,338226,7,397707
42572,0.053551,74.125.130.0-255,2902,341128,7,397707
42573,0.053557,172.31.36.0-255,66,341194,7,397707
42574,0.055798,74.125.130.0-255,5738,346932,7,397707
42575,0.055803,172.31.36.0-255,66,346998,7,397707
42576,0.058038,74.125.130.0-255,5738,352736,7,397707
42577,0.058044,172.31.36.0-255,66,352802,7,397707
42578,0.060264,74.125.130.0-255,5738,358540,7,397707
42579,0.06027,172.31.36.0-255,66,358606,7,397707
42580,0.062495,74.125.130.0-255,5738,364344,7,397707
42581,0.0625,172.31.36.0-255,66,364410,7,397707
42582,0.064752,74.125.130.0-255,5738,370148,7,397707
42583,0.064758,172.31.36.0-255,66,370214,7,397707
42584,0.067009,74.125.130.0-255,5738,375952,7,397707
42585,0.067015,172.31.36.0-255,66,376018,7,397707
42586,0.06924,74.125.130.0-255,5738,381756,7,397707
42587,0.069247,172.31.36.0-255,66,381822,7,397707
42588,0.071466,74.125.130.0-255,5738,387560,7,397707
42589,0.071472,172.31.36.0-255,66,387626,7,397707
42590,0.073696,74.125.130.0-255,5738,393364,7,397707
42591,0.073701,172.31.36.0-255,66,393430,7,397707
42592,0.075919,74.125.130.0-255,4040,397470,7,397707
42593,0.075924,172.31.36.0-255,66,397536,7,397707
42594,0.076107,172.31.36.0-255,105,397641,7,397707
42595,0.078294,74.125.130.0-255,66,397707,7,397707
42596,0.0,74.125.200.0-255,297,297,7,335872
42597,2.3e-05,172.31.36.0-255,66,363,7,335872
42598,2.9e-05,74.125.200.0-255,1484,1847,7,335872
42599,3.3e-05,172.31.36.0-255,66,1913,7,335872
42600,3.6e-05,74.125.200.0-255,1484,3397,7,335872
42601,4.8e-05,172.31.36.0-255,66,3463,7,335872
42602,5.5e-05,74.125.200.0-255,2902,6365,7,335872
42603,5.8e-05,172.31.36.0-255,66,6431,7,335872
42604,6.3e-05,74.125.200.0-255,2902,9333,7,335872
42605,6.6e-05,172.31.36.0-255,66,9399,7,335872
42606,0.000103,74.125.200.0-255,2902,12301,7,335872
42607,0.000106,172.31.36.0-255,66,12367,7,335872
42608,0.00011,74.125.200.0-255,1851,14218,7,335872
42609,0.000113,172.31.36.0-255,66,14284,7,335872
42610,0.000117,74.125.200.0-255,2902,17186,7,335872
42611,0.00012,172.31.36.0-255,66,17252,7,335872
42612,0.000128,74.125.200.0-255,7156,24408,7,335872
42613,0.00013,172.31.36.0-255,66,24474,7,335872
42614,0.000137,74.125.200.0-255,5738,30212,7,335872
42615,0.000139,172.31.36.0-255,66,30278,7,335872
42616,0.000179,74.125.200.0-255,1125,31403,7,335872
42617,0.000181,172.31.36.0-255,66,31469,7,335872
42618,0.000258,74.125.200.0-255,1484,32953,7,335872
42619,0.000262,172.31.36.0-255,66,33019,7,335872
42620,0.000288,74.125.200.0-255,2902,35921,7,335872
42621,0.00029,172.31.36.0-255,66,35987,7,335872
42622,0.000296,74.125.200.0-255,4320,40307,7,335872
42623,0.000299,172.31.36.0-255,66,40373,7,335872
42624,0.000346,172.31.36.0-255,66,40439,7,335872
42625,0.000351,74.125.200.0-255,4320,44759,7,335872
42626,0.000353,172.31.36.0-255,66,44825,7,335872
42627,0.000414,172.31.36.0-255,66,44891,7,335872
42628,0.000417,74.125.200.0-255,378,45269,7,335872
42629,0.000567,74.125.200.0-255,1484,46753,7,335872
42630,0.000571,172.31.36.0-255,66,46819,7,335872
42631,0.000576,74.125.200.0-255,2902,49721,7,335872
42632,0.000579,172.31.36.0-255,66,49787,7,335872
42633,0.000611,74.125.200.0-255,5738,55525,7,335872
42634,0.000614,172.31.36.0-255,66,55591,7,335872
42635,0.000622,74.125.200.0-255,7156,62747,7,335872
42636,0.000624,172.31.36.0-255,66,62813,7,335872
42637,0.000649,74.125.200.0-255,5738,68551,7,335872
42638,0.000652,172.31.36.0-255,66,68617,7,335872
42639,0.000673,74.125.200.0-255,7156,75773,7,335872
42640,0.000675,172.31.36.0-255,66,75839,7,335872
42641,0.0007,74.125.200.0-255,3602,79441,7,335872
42642,0.000703,172.31.36.0-255,66,79507,7,335872
42643,0.000846,74.125.200.0-255,1484,80991,7,335872
42644,0.000864,74.125.200.0-255,2902,83893,7,335872
42645,0.000868,172.31.36.0-255,66,83959,7,335872
42646,0.000875,74.125.200.0-255,5738,89697,7,335872
42647,0.000878,172.31.36.0-255,66,89763,7,335872
42648,0.000911,172.31.36.0-255,66,89829,7,335872
42649,0.00095,172.31.36.0-255,66,89895,7,335872
42650,0.000973,74.125.200.0-255,2184,92079,7,335872
42651,0.000976,172.31.36.0-255,66,92145,7,335872
42652,0.001042,74.125.200.0-255,1484,93629,7,335872
42653,0.001048,74.125.200.0-255,2902,96531,7,335872
42654,0.001051,172.31.36.0-255,66,96597,7,335872
42655,0.001058,74.125.200.0-255,5738,102335,7,335872
42656,0.00106,172.31.36.0-255,66,102401,7,335872
42657,0.001073,74.125.200.0-255,7156,109557,7,335872
42658,0.001075,172.31.36.0-255,66,109623,7,335872
42659,0.00115,172.31.36.0-255,66,109689,7,335872
42660,0.001155,74.125.200.0-255,2184,111873,7,335872
42661,0.001157,172.31.36.0-255,66,111939,7,335872
42662,0.001186,74.125.200.0-255,2902,114841,7,335872
42663,0.001188,172.31.36.0-255,66,114907,7,335872
42664,0.001195,74.125.200.0-255,7156,122063,7,335872
42665,0.001198,172.31.36.0-255,66,122129,7,335872
42666,0.001209,74.125.200.0-255,5738,127867,7,335872
42667,0.001212,172.31.36.0-255,66,127933,7,335872
42668,0.00125,74.125.200.0-255,7156,135089,7,335872
42669,0.001253,172.31.36.0-255,66,135155,7,335872
42670,0.001259,74.125.200.0-255,4320,139475,7,335872
42671,0.001261,172.31.36.0-255,66,139541,7,335872
42672,0.001295,74.125.200.0-255,6438,145979,7,335872
42673,0.001298,172.31.36.0-255,66,146045,7,335872
42674,0.001301,74.125.200.0-255,1484,147529,7,335872
42675,0.00133,74.125.200.0-255,2902,150431,7,335872
42676,0.001333,172.31.36.0-255,66,150497,7,335872
42677,0.00134,74.125.200.0-255,5738,156235,7,335872
42678,0.001343,172.31.36.0-255,66,156301,7,335872
42679,0.001388,172.31.36.0-255,66,156367,7,335872
42680,0.0014,172.31.36.0-255,66,156433,7,335872
42681,0.001433,74.125.200.0-255,2184,158617,7,335872
42682,0.001435,172.31.36.0-255,66,158683,7,335872
42683,0.001742,74.125.200.0-255,1484,160167,7,335872
42684,0.001746,74.125.200.0-255,1484,161651,7,335872
42685,0.001749,172.31.36.0-255,66,161717,7,335872
42686,0.001782,74.125.200.0-255,1484,163201,7,335872
42687,0.001787,74.125.200.0-255,4320,167521,7,335872
42688,0.00179,172.31.36.0-255,66,167587,7,335872
42689,0.001797,74.125.200.0-255,5738,173325,7,335872
42690,0.001799,172.31.36.0-255,66,173391,7,335872
42691,0.001824,172.31.36.0-255,66,173457,7,335872
42692,0.00183,74.125.200.0-255,5738,179195,7,335872
42693,0.001833,172.31.36.0-255,66,179261,7,335872
42694,0.001857,74.125.200.0-255,2184,181445,7,335872
42695,0.00186,172.31.36.0-255,66,181511,7,335872
42696,0.00197,74.125.200.0-255,1484,182995,7,335872
42697,0.001987,74.125.200.0-255,2902,185897,7,335872
42698,0.00199,172.31.36.0-255,66,185963,7,335872
42699,0.001996,74.125.200.0-255,2902,188865,7,335872
42700,0.001999,172.31.36.0-255,66,188931,7,335872
42701,0.00203,74.125.200.0-255,2902,191833,7,335872
42702,0.002033,172.31.36.0-255,66,191899,7,335872
42703,0.002039,74.125.200.0-255,4320,196219,7,335872
42704,0.002041,172.31.36.0-255,66,196285,7,335872
42705,0.002052,74.125.200.0-255,5738,202023,7,335872
42706,0.002055,172.31.36.0-255,66,202089,7,335872
42707,0.00206,74.125.200.0-255,5738,207827,7,335872
42708,0.002063,172.31.36.0-255,66,207893,7,335872
42709,0.004099,74.125.200.0-255,5738,213631,7,335872
42710,0.004109,172.31.36.0-255,66,213697,7,335872
42711,0.006145,74.125.200.0-255,5738,219435,7,335872
42712,0.006154,172.31.36.0-255,66,219501,7,335872
42713,0.008174,74.125.200.0-255,5738,225239,7,335872
42714,0.008177,172.31.36.0-255,66,225305,7,335872
42715,0.010201,74.125.200.0-255,5738,231043,7,335872
42716,0.010208,172.31.36.0-255,66,231109,7,335872
42717,0.012239,74.125.200.0-255,5738,236847,7,335872
42718,0.012251,172.31.36.0-255,66,236913,7,335872
42719,0.014275,74.125.200.0-255,5738,242651,7,335872
42720,0.014284,172.31.36.0-255,66,242717,7,335872
42721,0.016351,74.125.200.0-255,5738,248455,7,335872
42722,0.016359,172.31.36.0-255,66,248521,7,335872
42723,0.018401,74.125.200.0-255,5738,254259,7,335872
42724,0.01841,172.31.36.0-255,66,254325,7,335872
42725,0.020442,74.125.200.0-255,5738,260063,7,335872
42726,0.02045,172.31.36.0-255,66,260129,7,335872
42727,0.02249,74.125.200.0-255,5738,265867,7,335872
42728,0.022497,172.31.36.0-255,66,265933,7,335872
42729,0.024533,74.125.200.0-255,5738,271671,7,335872
42730,0.02454,172.31.36.0-255,66,271737,7,335872
42731,0.026577,74.125.200.0-255,5738,277475,7,335872
42732,0.026584,172.31.36.0-255,66,277541,7,335872
42733,0.028619,74.125.200.0-255,5738,283279,7,335872
42734,0.028625,172.31.36.0-255,66,283345,7,335872
42735,0.030661,74.125.200.0-255,5738,289083,7,335872
42736,0.030669,172.31.36.0-255,66,289149,7,335872
42737,0.032706,74.125.200.0-255,5738,294887,7,335872
42738,0.032714,172.31.36.0-255,66,294953,7,335872
42739,0.034745,74.125.200.0-255,5738,300691,7,335872
42740,0.034753,172.31.36.0-255,66,300757,7,335872
42741,0.036656,172.31.36.0-255,172,300929,7,335872
42742,0.036691,172.31.36.0-255,1112,302041,7,335872
42743,0.036751,172.31.36.0-255,1514,303555,7,335872
42744,0.036753,172.31.36.0-255,1296,304851,7,335872
42745,0.036792,74.125.200.0-255,5738,310589,7,335872
42746,0.036798,172.31.36.0-255,66,310655,7,335872
42747,0.038144,104.244.42.0-255,66,310721,7,335872
42748,0.038181,104.244.42.0-255,66,310787,7,335872
42749,0.038254,104.244.42.0-255,66,310853,7,335872
42750,0.038826,74.125.200.0-255,5738,316591,7,335872
42751,0.038839,172.31.36.0-255,66,316657,7,335872
42752,0.040882,74.125.200.0-255,5738,322395,7,335872
42753,0.04089,172.31.36.0-255,66,322461,7,335872
42754,0.042933,74.125.200.0-255,5738,328199,7,335872
42755,0.042941,172.31.36.0-255,66,328265,7,335872
42756,0.045019,74.125.200.0-255,5738,334003,7,335872
42757,0.045027,172.31.36.0-255,66,334069,7,335872
42758,0.04706,74.125.200.0-255,1566,335635,7,335872
42759,0.047066,172.31.36.0-255,66,335701,7,335872
42760,0.047235,172.31.36.0-255,105,335806,7,335872
42761,0.049242,74.125.200.0-255,66,335872,7,335872
42762,0.0,74.125.68.0-255,142,142,7,337205
42763,3.2e-05,172.31.36.0-255,66,208,7,337205
42764,3.9e-05,74.125.68.0-255,1484,1692,7,337205
42765,4.3e-05,172.31.36.0-255,66,1758,7,337205
42766,4.6e-05,74.125.68.0-255,1484,3242,7,337205
42767,4.9e-05,172.31.36.0-255,66,3308,7,337205
42768,6.9e-05,74.125.68.0-255,2902,6210,7,337205
42769,7.1e-05,172.31.36.0-255,66,6276,7,337205
42770,9.9e-05,74.125.68.0-255,2902,9178,7,337205
42771,0.000102,172.31.36.0-255,66,9244,7,337205
42772,0.000121,74.125.68.0-255,2902,12146,7,337205
42773,0.000123,172.31.36.0-255,66,12212,7,337205
42774,0.000128,74.125.68.0-255,2049,14261,7,337205
42775,0.00013,172.31.36.0-255,66,14327,7,337205
42776,0.000212,74.125.68.0-255,1484,15811,7,337205
42777,0.000217,172.31.36.0-255,66,15877,7,337205
42778,0.000223,74.125.68.0-255,2902,18779,7,337205
42779,0.000225,172.31.36.0-255,66,18845,7,337205
42780,0.000253,74.125.68.0-255,5738,24583,7,337205
42781,0.000255,172.31.36.0-255,66,24649,7,337205
42782,0.00026,74.125.68.0-255,2902,27551,7,337205
42783,0.000261,172.31.36.0-255,66,27617,7,337205
42784,0.000297,74.125.68.0-255,2902,30519,7,337205
42785,0.000301,172.31.36.0-255,66,30585,7,337205
42786,0.000331,172.31.36.0-255,66,30651,7,337205
42787,0.000337,74.125.68.0-255,4320,34971,7,337205
42788,0.000339,172.31.36.0-255,66,35037,7,337205
42789,0.00037,74.125.68.0-255,7156,42193,7,337205
42790,0.000376,172.31.36.0-255,66,42259,7,337205
42791,0.000395,172.31.36.0-255,66,42325,7,337205
42792,0.000401,74.125.68.0-255,5020,47345,7,337205
42793,0.000403,172.31.36.0-255,66,47411,7,337205
42794,0.000406,74.125.68.0-255,422,47833,7,337205
42795,0.000504,74.125.68.0-255,352,48185,7,337205
42796,0.00087,172.31.36.0-255,66,48251,7,337205
42797,0.00101,74.125.68.0-255,1484,49735,7,337205
42798,0.001032,74.125.68.0-255,1484,51219,7,337205
42799,0.001037,172.31.36.0-255,66,51285,7,337205
42800,0.001052,74.125.68.0-255,2902,54187,7,337205
42801,0.001055,172.31.36.0-255,66,54253,7,337205
42802,0.001079,74.125.68.0-255,1484,55737,7,337205
42803,0.001098,74.125.68.0-255,1484,57221,7,337205
42804,0.001101,172.31.36.0-255,66,57287,7,337205
42805,0.001107,74.125.68.0-255,4320,61607,7,337205
42806,0.00111,172.31.36.0-255,66,61673,7,337205
42807,0.001139,74.125.68.0-255,7156,68829,7,337205
42808,0.001142,172.31.36.0-255,66,68895,7,337205
42809,0.001158,74.125.68.0-255,4320,73215,7,337205
42810,0.001161,172.31.36.0-255,66,73281,7,337205
42811,0.001185,74.125.68.0-255,4320,77601,7,337205
42812,0.001188,172.31.36.0-255,66,77667,7,337205
42813,0.001194,74.125.68.0-255,5020,82687,7,337205
42814,0.001196,172.31.36.0-255,66,82753,7,337205
42815,0.00182,74.125.68.0-255,1484,84237,7,337205
42816,0.001836,74.125.68.0-255,1484,85721,7,337205
42817,0.001841,172.31.36.0-255,66,85787,7,337205
42818,0.001845,74.125.68.0-255,1484,87271,7,337205
42819,0.001858,74.125.68.0-255,1484,88755,7,337205
42820,0.00186,172.31.36.0-255,66,88821,7,337205
42821,0.001874,74.125.68.0-255,4320,93141,7,337205
42822,0.001876,172.31.36.0-255,66,93207,7,337205
42823,0.001888,74.125.68.0-255,1484,94691,7,337205
42824,0.001893,74.125.68.0-255,4320,99011,7,337205
42825,0.001895,172.31.36.0-255,66,99077,7,337205
42826,0.001909,74.125.68.0-255,4320,103397,7,337205
42827,0.001911,172.31.36.0-255,66,103463,7,337205
42828,0.001916,74.125.68.0-255,5738,109201,7,337205
42829,0.001918,172.31.36.0-255,66,109267,7,337205
42830,0.001941,74.125.68.0-255,4320,113587,7,337205
42831,0.001943,172.31.36.0-255,66,113653,7,337205
42832,0.001946,74.125.68.0-255,1484,115137,7,337205
42833,0.001961,74.125.68.0-255,2184,117321,7,337205
42834,0.001964,172.31.36.0-255,66,117387,7,337205
42835,0.002302,74.125.68.0-255,1484,118871,7,337205
42836,0.002312,74.125.68.0-255,1484,120355,7,337205
42837,0.002314,172.31.36.0-255,66,120421,7,337205
42838,0.002324,74.125.68.0-255,1484,121905,7,337205
42839,0.002339,74.125.68.0-255,2902,124807,7,337205
42840,0.002341,172.31.36.0-255,66,124873,7,337205
42841,0.002354,74.125.68.0-255,2902,127775,7,337205
42842,0.002356,172.31.36.0-255,66,127841,7,337205
42843,0.002359,74.125.68.0-255,1484,129325,7,337205
42844,0.002373,74.125.68.0-255,4320,133645,7,337205
42845,0.002375,172.31.36.0-255,66,133711,7,337205
42846,0.004698,74.125.68.0-255,2902,136613,7,337205
42847,0.004701,172.31.36.0-255,66,136679,7,337205
42848,0.004722,74.125.68.0-255,2902,139581,7,337205
42849,0.004724,172.31.36.0-255,66,139647,7,337205
42850,0.007018,74.125.68.0-255,2902,142549,7,337205
42851,0.007025,172.31.36.0-255,66,142615,7,337205
42852,0.007042,74.125.68.0-255,2902,145517,7,337205
42853,0.007045,172.31.36.0-255,66,145583,7,337205
42854,0.009358,74.125.68.0-255,5738,151321,7,337205
42855,0.009365,172.31.36.0-255,66,151387,7,337205
42856,0.0117,74.125.68.0-255,5738,157125,7,337205
42857,0.011707,172.31.36.0-255,66,157191,7,337205
42858,0.014046,74.125.68.0-255,5738,162929,7,337205
42859,0.014059,172.31.36.0-255,66,162995,7,337205
42860,0.016392,74.125.68.0-255,5738,168733,7,337205
42861,0.016399,172.31.36.0-255,66,168799,7,337205
42862,0.018765,74.125.68.0-255,5738,174537,7,337205
42863,0.018774,172.31.36.0-255,66,174603,7,337205
42864,0.0211,74.125.68.0-255,5738,180341,7,337205
42865,0.021106,172.31.36.0-255,66,180407,7,337205
42866,0.023444,74.125.68.0-255,5738,186145,7,337205
42867,0.023451,172.31.36.0-255,66,186211,7,337205
42868,0.025788,74.125.68.0-255,5738,191949,7,337205
42869,0.025795,172.31.36.0-255,66,192015,7,337205
42870,0.028139,74.125.68.0-255,5738,197753,7,337205
42871,0.028147,172.31.36.0-255,66,197819,7,337205
42872,0.030484,74.125.68.0-255,5738,203557,7,337205
42873,0.030492,172.31.36.0-255,66,203623,7,337205
42874,0.032679,172.31.36.0-255,172,203795,7,337205
42875,0.032708,172.31.36.0-255,1113,204908,7,337205
42876,0.032764,172.31.36.0-255,1514,206422,7,337205
42877,0.032766,172.31.36.0-255,1514,207936,7,337205
42878,0.032767,172.31.36.0-255,1514,209450,7,337205
42879,0.032772,172.31.36.0-255,1514,210964,7,337205
42880,0.032774,172.31.36.0-255,1514,212478,7,337205
42881,0.032775,172.31.36.0-255,71,212549,7,337205
42882,0.032818,74.125.68.0-255,5738,218287,7,337205
42883,0.032824,172.31.36.0-255,66,218353,7,337205
42884,0.03423,104.244.42.0-255,66,218419,7,337205
42885,0.034238,104.244.42.0-255,66,218485,7,337205
42886,0.034349,104.244.42.0-255,66,218551,7,337205
42887,0.034356,104.244.42.0-255,66,218617,7,337205
42888,0.03516,74.125.68.0-255,5738,224355,7,337205
42889,0.035168,172.31.36.0-255,66,224421,7,337205
42890,0.037487,74.125.68.0-255,2902,227323,7,337205
42891,0.037493,172.31.36.0-255,66,227389,7,337205
42892,0.037528,74.125.68.0-255,2902,230291,7,337205
42893,0.037531,172.31.36.0-255,66,230357,7,337205
42894,0.039831,74.125.68.0-255,2902,233259,7,337205
42895,0.039837,172.31.36.0-255,66,233325,7,337205
42896,0.039855,74.125.68.0-255,2902,236227,7,337205
42897,0.039858,172.31.36.0-255,66,236293,7,337205
42898,0.042156,74.125.68.0-255,2902,239195,7,337205
42899,0.042176,172.31.36.0-255,66,239261,7,337205
42900,0.042195,74.125.68.0-255,2902,242163,7,337205
42901,0.042198,172.31.36.0-255,66,242229,7,337205
42902,0.044493,74.125.68.0-255,2902,245131,7,337205
42903,0.044497,172.31.36.0-255,66,245197,7,337205
42904,0.044531,74.125.68.0-255,2902,248099,7,337205
42905,0.044534,172.31.36.0-255,66,248165,7,337205
42906,0.046835,74.125.68.0-255,2902,251067,7,337205
42907,0.046841,172.31.36.0-255,66,251133,7,337205
42908,0.046877,74.125.68.0-255,2902,254035,7,337205
42909,0.04688,172.31.36.0-255,66,254101,7,337205
42910,0.049172,74.125.68.0-255,2902,257003,7,337205
42911,0.049178,172.31.36.0-255,66,257069,7,337205
42912,0.049212,74.125.68.0-255,2902,259971,7,337205
42913,0.049214,172.31.36.0-255,66,260037,7,337205
42914,0.051501,74.125.68.0-255,2902,262939,7,337205
42915,0.051506,172.31.36.0-255,66,263005,7,337205
42916,0.05154,74.125.68.0-255,2902,265907,7,337205
42917,0.051543,172.31.36.0-255,66,265973,7,337205
42918,0.053843,74.125.68.0-255,2902,268875,7,337205
42919,0.053848,172.31.36.0-255,66,268941,7,337205
42920,0.053881,74.125.68.0-255,2902,271843,7,337205
42921,0.053884,172.31.36.0-255,66,271909,7,337205
42922,0.056173,74.125.68.0-255,2902,274811,7,337205
42923,0.056179,172.31.36.0-255,66,274877,7,337205
42924,0.056211,74.125.68.0-255,2902,277779,7,337205
42925,0.056214,172.31.36.0-255,66,277845,7,337205
42926,0.05851,74.125.68.0-255,2902,280747,7,337205
42927,0.058516,172.31.36.0-255,66,280813,7,337205
42928,0.058552,74.125.68.0-255,2902,283715,7,337205
42929,0.058555,172.31.36.0-255,66,283781,7,337205
42930,0.06084,74.125.68.0-255,2902,286683,7,337205
42931,0.060845,172.31.36.0-255,66,286749,7,337205
42932,0.060878,74.125.68.0-255,2902,289651,7,337205
42933,0.06088,172.31.36.0-255,66,289717,7,337205
42934,0.063174,74.125.68.0-255,2902,292619,7,337205
42935,0.06318,172.31.36.0-255,66,292685,7,337205
42936,0.063216,74.125.68.0-255,2902,295587,7,337205
42937,0.063219,172.31.36.0-255,66,295653,7,337205
42938,0.065501,74.125.68.0-255,2902,298555,7,337205
42939,0.065506,172.31.36.0-255,66,298621,7,337205
42940,0.065539,74.125.68.0-255,2902,301523,7,337205
42941,0.065541,172.31.36.0-255,66,301589,7,337205
42942,0.067828,74.125.68.0-255,2902,304491,7,337205
42943,0.067833,172.31.36.0-255,66,304557,7,337205
42944,0.067865,74.125.68.0-255,2902,307459,7,337205
42945,0.067869,172.31.36.0-255,66,307525,7,337205
42946,0.070153,74.125.68.0-255,2902,310427,7,337205
42947,0.070158,172.31.36.0-255,66,310493,7,337205
42948,0.070191,74.125.68.0-255,2902,313395,7,337205
42949,0.070194,172.31.36.0-255,66,313461,7,337205
42950,0.07247,74.125.68.0-255,2902,316363,7,337205
42951,0.072475,172.31.36.0-255,66,316429,7,337205
42952,0.072508,74.125.68.0-255,2902,319331,7,337205
42953,0.072511,172.31.36.0-255,66,319397,7,337205
42954,0.074796,74.125.68.0-255,2902,322299,7,337205
42955,0.074802,172.31.36.0-255,66,322365,7,337205
42956,0.074837,74.125.68.0-255,2902,325267,7,337205
42957,0.07484,172.31.36.0-255,66,325333,7,337205
42958,0.077114,74.125.68.0-255,2902,328235,7,337205
42959,0.077119,172.31.36.0-255,66,328301,7,337205
42960,0.07716,74.125.68.0-255,2902,331203,7,337205
42961,0.077163,172.31.36.0-255,66,331269,7,337205
42962,0.079442,74.125.68.0-255,2902,334171,7,337205
42963,0.079449,172.31.36.0-255,66,334237,7,337205
42964,0.079479,74.125.68.0-255,2902,337139,7,337205
42965,0.079482,172.31.36.0-255,66,337205,7,337205
42966,0.0,74.125.68.0-255,153,153,7,407606
42967,3.4e-05,172.31.36.0-255,66,219,7,407606
42968,5.4e-05,74.125.68.0-255,1484,1703,7,407606
42969,5.8e-05,172.31.36.0-255,66,1769,7,407606
42970,7.9e-05,74.125.68.0-255,2902,4671,7,407606
42971,8.2e-05,172.31.36.0-255,66,4737,7,407606
42972,8.7e-05,74.125.68.0-255,4320,9057,7,407606
42973,8.9e-05,172.31.36.0-255,66,9123,7,407606
42974,9.2e-05,74.125.68.0-255,1484,10607,7,407606
42975,9.4e-05,172.31.36.0-255,66,10673,7,407606
42976,0.000113,74.125.68.0-255,3442,14115,7,407606
42977,0.000115,172.31.36.0-255,66,14181,7,407606
42978,0.000132,74.125.68.0-255,1484,15665,7,407606
42979,0.000134,172.31.36.0-255,66,15731,7,407606
42980,0.000149,74.125.68.0-255,2902,18633,7,407606
42981,0.000152,172.31.36.0-255,66,18699,7,407606
42982,0.000156,74.125.68.0-255,1484,20183,7,407606
42983,0.000158,172.31.36.0-255,66,20249,7,407606
42984,0.000181,74.125.68.0-255,4320,24569,7,407606
42985,0.000183,172.31.36.0-255,66,24635,7,407606
42986,0.000193,74.125.68.0-255,4320,28955,7,407606
42987,0.000195,172.31.36.0-255,66,29021,7,407606
42988,0.000217,74.125.68.0-255,2543,31564,7,407606
42989,0.00022,172.31.36.0-255,66,31630,7,407606
42990,0.000364,74.125.68.0-255,1484,33114,7,407606
42991,0.000368,172.31.36.0-255,66,33180,7,407606
42992,0.000374,74.125.68.0-255,2902,36082,7,407606
42993,0.000377,74.125.68.0-255,1484,37566,7,407606
42994,0.000379,172.31.36.0-255,66,37632,7,407606
42995,0.000382,172.31.36.0-255,66,37698,7,407606
42996,0.000406,74.125.68.0-255,4320,42018,7,407606
42997,0.000409,172.31.36.0-255,66,42084,7,407606
42998,0.000414,74.125.68.0-255,4320,46404,7,407606
42999,0.000418,172.31.36.0-255,66,46470,7,407606
43000,0.000452,74.125.68.0-255,2543,49013,7,407606
43001,0.000456,74.125.68.0-255,2902,51915,7,407606
43002,0.000457,172.31.36.0-255,66,51981,7,407606
43003,0.000461,172.31.36.0-255,66,52047,7,407606
43004,0.000474,74.125.68.0-255,1484,53531,7,407606
43005,0.000501,74.125.68.0-255,5738,59269,7,407606
43006,0.000505,172.31.36.0-255,66,59335,7,407606
43007,0.00051,74.125.68.0-255,4320,63655,7,407606
43008,0.000513,172.31.36.0-255,66,63721,7,407606
43009,0.000547,74.125.68.0-255,2812,66533,7,407606
43010,0.00055,172.31.36.0-255,66,66599,7,407606
43011,0.000703,74.125.68.0-255,388,66987,7,407606
43012,0.000857,172.31.36.0-255,66,67053,7,407606
43013,0.000956,74.125.68.0-255,1484,68537,7,407606
43014,0.000965,74.125.68.0-255,2902,71439,7,407606
43015,0.000968,172.31.36.0-255,66,71505,7,407606
43016,0.000974,74.125.68.0-255,2902,74407,7,407606
43017,0.000976,172.31.36.0-255,66,74473,7,407606
43018,0.000992,74.125.68.0-255,2902,77375,7,407606
43019,0.000994,172.31.36.0-255,66,77441,7,407606
43020,0.001011,74.125.68.0-255,1484,78925,7,407606
43021,0.001031,74.125.68.0-255,2902,81827,7,407606
43022,0.001033,172.31.36.0-255,66,81893,7,407606
43023,0.00104,74.125.68.0-255,4320,86213,7,407606
43024,0.001042,172.31.36.0-255,66,86279,7,407606
43025,0.001061,74.125.68.0-255,1484,87763,7,407606
43026,0.001095,74.125.68.0-255,2902,90665,7,407606
43027,0.001098,172.31.36.0-255,66,90731,7,407606
43028,0.001117,74.125.68.0-255,4320,95051,7,407606
43029,0.00112,172.31.36.0-255,66,95117,7,407606
43030,0.001141,74.125.68.0-255,1484,96601,7,407606
43031,0.001164,74.125.68.0-255,5020,101621,7,407606
43032,0.001167,172.31.36.0-255,66,101687,7,407606
43033,0.001274,74.125.68.0-255,1484,103171,7,407606
43034,0.001281,74.125.68.0-255,2902,106073,7,407606
43035,0.001285,172.31.36.0-255,66,106139,7,407606
43036,0.001291,74.125.68.0-255,2902,109041,7,407606
43037,0.001293,172.31.36.0-255,66,109107,7,407606
43038,0.001313,74.125.68.0-255,4320,113427,7,407606
43039,0.001316,172.31.36.0-255,66,113493,7,407606
43040,0.001363,172.31.36.0-255,66,113559,7,407606
43041,0.001393,74.125.68.0-255,2902,116461,7,407606
43042,0.001396,172.31.36.0-255,66,116527,7,407606
43043,0.00142,74.125.68.0-255,7156,123683,7,407606
43044,0.001423,172.31.36.0-255,66,123749,7,407606
43045,0.001427,74.125.68.0-255,2902,126651,7,407606
43046,0.00143,172.31.36.0-255,66,126717,7,407606
43047,0.001467,74.125.68.0-255,4320,131037,7,407606
43048,0.00147,172.31.36.0-255,66,131103,7,407606
43049,0.00149,74.125.68.0-255,3602,134705,7,407606
43050,0.001493,172.31.36.0-255,66,134771,7,407606
43051,0.001503,172.31.36.0-255,66,134837,7,407606
43052,0.00151,74.125.68.0-255,4320,139157,7,407606
43053,0.001512,172.31.36.0-255,66,139223,7,407606
43054,0.001547,74.125.68.0-255,5738,144961,7,407606
43055,0.001552,172.31.36.0-255,66,145027,7,407606
43056,0.001583,172.31.36.0-255,66,145093,7,407606
43057,0.001602,74.125.68.0-255,1484,146577,7,407606
43058,0.001631,74.125.68.0-255,2902,149479,7,407606
43059,0.001634,172.31.36.0-255,66,149545,7,407606
43060,0.00164,74.125.68.0-255,4320,153865,7,407606
43061,0.001643,172.31.36.0-255,66,153931,7,407606
43062,0.001667,74.125.68.0-255,1484,155415,7,407606
43063,0.001682,74.125.68.0-255,1484,156899,7,407606
43064,0.001686,172.31.36.0-255,66,156965,7,407606
43065,0.001716,74.125.68.0-255,2902,159867,7,407606
43066,0.001718,172.31.36.0-255,66,159933,7,407606
43067,0.001772,74.125.68.0-255,4320,164253,7,407606
43068,0.001774,172.31.36.0-255,66,164319,7,407606
43069,0.001779,74.125.68.0-255,5738,170057,7,407606
43070,0.001781,172.31.36.0-255,66,170123,7,407606
43071,0.001787,74.125.68.0-255,7156,177279,7,407606
43072,0.001789,172.31.36.0-255,66,177345,7,407606
43073,0.001829,74.125.68.0-255,2184,179529,7,407606
43074,0.001831,172.31.36.0-255,66,179595,7,407606
43075,0.001992,74.125.68.0-255,1484,181079,7,407606
43076,0.002022,74.125.68.0-255,1484,182563,7,407606
43077,0.002024,172.31.36.0-255,66,182629,7,407606
43078,0.002027,74.125.68.0-255,1484,184113,7,407606
43079,0.002041,74.125.68.0-255,1484,185597,7,407606
43080,0.002043,172.31.36.0-255,66,185663,7,407606
43081,0.00206,74.125.68.0-255,5738,191401,7,407606
43082,0.002062,172.31.36.0-255,66,191467,7,407606
43083,0.002065,74.125.68.0-255,1484,192951,7,407606
43084,0.002096,74.125.68.0-255,5738,198689,7,407606
43085,0.002099,172.31.36.0-255,66,198755,7,407606
43086,0.002117,74.125.68.0-255,2902,201657,7,407606
43087,0.002119,172.31.36.0-255,66,201723,7,407606
43088,0.002126,74.125.68.0-255,7156,208879,7,407606
43089,0.002129,172.31.36.0-255,66,208945,7,407606
43090,0.002186,74.125.68.0-255,4320,213265,7,407606
43091,0.002188,172.31.36.0-255,66,213331,7,407606
43092,0.002206,74.125.68.0-255,3602,216933,7,407606
43093,0.002208,172.31.36.0-255,66,216999,7,407606
43094,0.002251,74.125.68.0-255,1484,218483,7,407606
43095,0.004449,74.125.68.0-255,4320,222803,7,407606
43096,0.004455,172.31.36.0-255,66,222869,7,407606
43097,0.006731,74.125.68.0-255,2902,225771,7,407606
43098,0.006737,172.31.36.0-255,66,225837,7,407606
43099,0.00676,74.125.68.0-255,2902,228739,7,407606
43100,0.006762,172.31.36.0-255,66,228805,7,407606
43101,0.008974,74.125.68.0-255,2902,231707,7,407606
43102,0.00898,172.31.36.0-255,66,231773,7,407606
43103,0.009003,74.125.68.0-255,2902,234675,7,407606
43104,0.009006,172.31.36.0-255,66,234741,7,407606
43105,0.011229,74.125.68.0-255,2902,237643,7,407606
43106,0.011238,172.31.36.0-255,66,237709,7,407606
43107,0.011247,74.125.68.0-255,2902,240611,7,407606
43108,0.01125,172.31.36.0-255,66,240677,7,407606
43109,0.013477,74.125.68.0-255,5738,246415,7,407606
43110,0.013483,172.31.36.0-255,66,246481,7,407606
43111,0.015737,74.125.68.0-255,5738,252219,7,407606
43112,0.015746,172.31.36.0-255,66,252285,7,407606
43113,0.017985,74.125.68.0-255,5738,258023,7,407606
43114,0.017995,172.31.36.0-255,66,258089,7,407606
43115,0.020243,74.125.68.0-255,5738,263827,7,407606
43116,0.020252,172.31.36.0-255,66,263893,7,407606
43117,0.022502,74.125.68.0-255,5738,269631,7,407606
43118,0.02251,172.31.36.0-255,66,269697,7,407606
43119,0.024751,74.125.68.0-255,5738,275435,7,407606
43120,0.024758,172.31.36.0-255,66,275501,7,407606
43121,0.026997,74.125.68.0-255,5738,281239,7,407606
43122,0.027004,172.31.36.0-255,66,281305,7,407606
43123,0.029249,74.125.68.0-255,5738,287043,7,407606
43124,0.029256,172.31.36.0-255,66,287109,7,407606
43125,0.030467,172.31.36.0-255,192,287301,7,407606
43126,0.0305,172.31.36.0-255,958,288259,7,407606
43127,0.030537,172.31.36.0-255,1514,289773,7,407606
43128,0.030539,172.31.36.0-255,1448,291221,7,407606
43129,0.031494,74.125.68.0-255,5738,296959,7,407606
43130,0.0315,172.31.36.0-255,66,297025,7,407606
43131,0.032034,104.244.42.0-255,66,297091,7,407606
43132,0.03204,104.244.42.0-255,66,297157,7,407606
43133,0.032081,104.244.42.0-255,66,297223,7,407606
43134,0.033737,74.125.68.0-255,5738,302961,7,407606
43135,0.033742,172.31.36.0-255,66,303027,7,407606
43136,0.035973,74.125.68.0-255,5738,308765,7,407606
43137,0.035978,172.31.36.0-255,66,308831,7,407606
43138,0.038221,74.125.68.0-255,5738,314569,7,407606
43139,0.038226,172.31.36.0-255,66,314635,7,407606
43140,0.040463,74.125.68.0-255,5738,320373,7,407606
43141,0.040468,172.31.36.0-255,66,320439,7,407606
43142,0.042694,74.125.68.0-255,5738,326177,7,407606
43143,0.042715,172.31.36.0-255,66,326243,7,407606
43144,0.044946,74.125.68.0-255,5738,331981,7,407606
43145,0.044951,172.31.36.0-255,66,332047,7,407606
43146,0.047181,74.125.68.0-255,5738,337785,7,407606
43147,0.047187,172.31.36.0-255,66,337851,7,407606
43148,0.049423,74.125.68.0-255,5738,343589,7,407606
43149,0.049428,172.31.36.0-255,66,343655,7,407606
43150,0.051697,74.125.68.0-255,5738,349393,7,407606
43151,0.051702,172.31.36.0-255,66,349459,7,407606
43152,0.053929,74.125.68.0-255,2902,352361,7,407606
43153,0.053935,172.31.36.0-255,66,352427,7,407606
43154,0.053966,74.125.68.0-255,2902,355329,7,407606
43155,0.053969,172.31.36.0-255,66,355395,7,407606
43156,0.056171,74.125.68.0-255,2902,358297,7,407606
43157,0.056177,172.31.36.0-255,66,358363,7,407606
43158,0.056215,74.125.68.0-255,2902,361265,7,407606
43159,0.056219,172.31.36.0-255,66,361331,7,407606
43160,0.058405,74.125.68.0-255,2902,364233,7,407606
43161,0.058411,172.31.36.0-255,66,364299,7,407606
43162,0.058443,74.125.68.0-255,2902,367201,7,407606
43163,0.058446,172.31.36.0-255,66,367267,7,407606
43164,0.060637,74.125.68.0-255,2902,370169,7,407606
43165,0.060641,172.31.36.0-255,66,370235,7,407606
43166,0.060683,74.125.68.0-255,2902,373137,7,407606
43167,0.060687,172.31.36.0-255,66,373203,7,407606
43168,0.062886,74.125.68.0-255,2902,376105,7,407606
43169,0.062891,172.31.36.0-255,66,376171,7,407606
43170,0.062924,74.125.68.0-255,2902,379073,7,407606
43171,0.062927,172.31.36.0-255,66,379139,7,407606
43172,0.065126,74.125.68.0-255,2902,382041,7,407606
43173,0.065131,172.31.36.0-255,66,382107,7,407606
43174,0.065168,74.125.68.0-255,2902,385009,7,407606
43175,0.065171,172.31.36.0-255,66,385075,7,407606
43176,0.067357,74.125.68.0-255,2902,387977,7,407606
43177,0.067363,172.31.36.0-255,66,388043,7,407606
43178,0.067393,74.125.68.0-255,1484,389527,7,407606
43179,0.067403,74.125.68.0-255,1484,391011,7,407606
43180,0.067407,172.31.36.0-255,66,391077,7,407606
43181,0.069591,74.125.68.0-255,2902,393979,7,407606
43182,0.069596,172.31.36.0-255,66,394045,7,407606
43183,0.069626,74.125.68.0-255,2902,396947,7,407606
43184,0.06963,172.31.36.0-255,66,397013,7,407606
43185,0.071832,74.125.68.0-255,2902,399915,7,407606
43186,0.071837,172.31.36.0-255,66,399981,7,407606
43187,0.071867,74.125.68.0-255,2902,402883,7,407606
43188,0.07187,172.31.36.0-255,66,402949,7,407606
43189,0.074073,74.125.68.0-255,2902,405851,7,407606
43190,0.074078,172.31.36.0-255,66,405917,7,407606
43191,0.074106,74.125.68.0-255,1452,407369,7,407606
43192,0.074249,172.31.36.0-255,66,407435,7,407606
43193,0.074277,172.31.36.0-255,105,407540,7,407606
43194,0.076487,74.125.68.0-255,66,407606,7,407606
43195,0.0,74.125.200.0-255,153,153,7,299356
43196,3.6e-05,172.31.36.0-255,66,219,7,299356
43197,4.3e-05,74.125.200.0-255,1484,1703,7,299356
43198,4.7e-05,172.31.36.0-255,66,1769,7,299356
43199,5.3e-05,74.125.200.0-255,2902,4671,7,299356
43200,6.5e-05,172.31.36.0-255,66,4737,7,299356
43201,6.7e-05,74.125.200.0-255,1484,6221,7,299356
43202,7e-05,172.31.36.0-255,66,6287,7,299356
43203,7.6e-05,74.125.200.0-255,2902,9189,7,299356
43204,7.9e-05,172.31.36.0-255,66,9255,7,299356
43205,0.000115,74.125.200.0-255,2902,12157,7,299356
43206,0.000118,172.31.36.0-255,66,12223,7,299356
43207,0.000145,74.125.200.0-255,2028,14251,7,299356
43208,0.000149,172.31.36.0-255,66,14317,7,299356
43209,0.000157,74.125.200.0-255,5738,20055,7,299356
43210,0.00016,172.31.36.0-255,66,20121,7,299356
43211,0.000171,74.125.200.0-255,5738,25859,7,299356
43212,0.000173,172.31.36.0-255,66,25925,7,299356
43213,0.000203,74.125.200.0-255,4320,30245,7,299356
43214,0.000206,172.31.36.0-255,66,30311,7,299356
43215,0.000243,74.125.200.0-255,2902,33213,7,299356
43216,0.000246,172.31.36.0-255,66,33279,7,299356
43217,0.000264,172.31.36.0-255,66,33345,7,299356
43218,0.000269,74.125.200.0-255,3602,36947,7,299356
43219,0.000272,172.31.36.0-255,66,37013,7,299356
43220,0.000728,74.125.200.0-255,1484,38497,7,299356
43221,0.000735,172.31.36.0-255,66,38563,7,299356
43222,0.00074,74.125.200.0-255,1484,40047,7,299356
43223,0.000742,172.31.36.0-255,66,40113,7,299356
43224,0.000769,74.125.200.0-255,1484,41597,7,299356
43225,0.000775,172.31.36.0-255,66,41663,7,299356
43226,0.000781,74.125.200.0-255,5738,47401,7,299356
43227,0.000784,172.31.36.0-255,66,47467,7,299356
43228,0.000789,74.125.200.0-255,2902,50369,7,299356
43229,0.00079,172.31.36.0-255,66,50435,7,299356
43230,0.000832,74.125.200.0-255,4272,54707,7,299356
43231,0.000835,172.31.36.0-255,66,54773,7,299356
43232,0.000868,74.125.200.0-255,110,54883,7,299356
43233,0.000896,74.125.200.0-255,1484,56367,7,299356
43234,0.0009,172.31.36.0-255,66,56433,7,299356
43235,0.000905,74.125.200.0-255,2902,59335,7,299356
43236,0.000908,172.31.36.0-255,66,59401,7,299356
43237,0.00091,74.125.200.0-255,1484,60885,7,299356
43238,0.000945,74.125.200.0-255,2902,63787,7,299356
43239,0.000949,172.31.36.0-255,66,63853,7,299356
43240,0.000955,74.125.200.0-255,5738,69591,7,299356
43241,0.000958,172.31.36.0-255,66,69657,7,299356
43242,0.000998,172.31.36.0-255,66,69723,7,299356
43243,0.001022,74.125.200.0-255,1484,71207,7,299356
43244,0.001039,74.125.200.0-255,5020,76227,7,299356
43245,0.001042,172.31.36.0-255,66,76293,7,299356
43246,0.002002,74.125.200.0-255,1484,77777,7,299356
43247,0.003008,74.125.200.0-255,4320,82097,7,299356
43248,0.003014,172.31.36.0-255,66,82163,7,299356
43249,0.005011,74.125.200.0-255,4320,86483,7,299356
43250,0.005016,172.31.36.0-255,66,86549,7,299356
43251,0.005043,74.125.200.0-255,1484,88033,7,299356
43252,0.007,74.125.200.0-255,4320,92353,7,299356
43253,0.007007,172.31.36.0-255,66,92419,7,299356
43254,0.008995,74.125.200.0-255,5738,98157,7,299356
43255,0.009003,172.31.36.0-255,66,98223,7,299356
43256,0.010992,74.125.200.0-255,5738,103961,7,299356
43257,0.011,172.31.36.0-255,66,104027,7,299356
43258,0.012982,74.125.200.0-255,4320,108347,7,299356
43259,0.012992,172.31.36.0-255,66,108413,7,299356
43260,0.013033,74.125.200.0-255,1484,109897,7,299356
43261,0.014966,74.125.200.0-255,4320,114217,7,299356
43262,0.014974,172.31.36.0-255,66,114283,7,299356
43263,0.016946,74.125.200.0-255,5738,120021,7,299356
43264,0.016967,172.31.36.0-255,66,120087,7,299356
43265,0.018946,74.125.200.0-255,5738,125825,7,299356
43266,0.018954,172.31.36.0-255,66,125891,7,299356
43267,0.020931,74.125.200.0-255,5738,131629,7,299356
43268,0.020939,172.31.36.0-255,66,131695,7,299356
43269,0.02292,74.125.200.0-255,5738,137433,7,299356
43270,0.022927,172.31.36.0-255,66,137499,7,299356
43271,0.024905,74.125.200.0-255,5738,143237,7,299356
43272,0.024914,172.31.36.0-255,66,143303,7,299356
43273,0.026946,74.125.200.0-255,5738,149041,7,299356
43274,0.026953,172.31.36.0-255,66,149107,7,299356
43275,0.028923,74.125.200.0-255,5738,154845,7,299356
43276,0.02893,172.31.36.0-255,66,154911,7,299356
43277,0.030908,74.125.200.0-255,5738,160649,7,299356
43278,0.030913,172.31.36.0-255,66,160715,7,299356
43279,0.031363,172.31.36.0-255,172,160887,7,299356
43280,0.031396,172.31.36.0-255,1113,162000,7,299356
43281,0.031449,172.31.36.0-255,566,162566,7,299356
43282,0.032885,74.125.200.0-255,5738,168304,7,299356
43283,0.032892,172.31.36.0-255,66,168370,7,299356
43284,0.032922,104.244.42.0-255,66,168436,7,299356
43285,0.032976,104.244.42.0-255,66,168502,7,299356
43286,0.03302,104.244.42.0-255,66,168568,7,299356
43287,0.03487,74.125.200.0-255,4320,172888,7,299356
43288,0.03488,172.31.36.0-255,66,172954,7,299356
43289,0.03491,74.125.200.0-255,1484,174438,7,299356
43290,0.036867,74.125.200.0-255,4320,178758,7,299356
43291,0.03688,172.31.36.0-255,66,178824,7,299356
43292,0.038862,74.125.200.0-255,5738,184562,7,299356
43293,0.038869,172.31.36.0-255,66,184628,7,299356
43294,0.040894,74.125.200.0-255,5738,190366,7,299356
43295,0.040901,172.31.36.0-255,66,190432,7,299356
43296,0.042882,74.125.200.0-255,5738,196170,7,299356
43297,0.042889,172.31.36.0-255,66,196236,7,299356
43298,0.044872,74.125.200.0-255,5738,201974,7,299356
43299,0.044879,172.31.36.0-255,66,202040,7,299356
43300,0.046869,74.125.200.0-255,5738,207778,7,299356
43301,0.046876,172.31.36.0-255,66,207844,7,299356
43302,0.048846,74.125.200.0-255,4320,212164,7,299356
43303,0.048852,172.31.36.0-255,66,212230,7,299356
43304,0.048879,74.125.200.0-255,1484,213714,7,299356
43305,0.050822,74.125.200.0-255,4320,218034,7,299356
43306,0.050829,172.31.36.0-255,66,218100,7,299356
43307,0.052829,74.125.200.0-255,5738,223838,7,299356
43308,0.052837,172.31.36.0-255,66,223904,7,299356
43309,0.05482,74.125.200.0-255,5738,229642,7,299356
43310,0.054828,172.31.36.0-255,66,229708,7,299356
43311,0.056844,74.125.200.0-255,5738,235446,7,299356
43312,0.056854,172.31.36.0-255,66,235512,7,299356
43313,0.05884,74.125.200.0-255,5738,241250,7,299356
43314,0.058848,172.31.36.0-255,66,241316,7,299356
43315,0.060825,74.125.200.0-255,5738,247054,7,299356
43316,0.060832,172.31.36.0-255,66,247120,7,299356
43317,0.062816,74.125.200.0-255,5738,252858,7,299356
43318,0.062822,172.31.36.0-255,66,252924,7,299356
43319,0.064802,74.125.200.0-255,5738,258662,7,299356
43320,0.064808,172.31.36.0-255,66,258728,7,299356
43321,0.066784,74.125.200.0-255,5738,264466,7,299356
43322,0.066791,172.31.36.0-255,66,264532,7,299356
43323,0.068766,74.125.200.0-255,5738,270270,7,299356
43324,0.068773,172.31.36.0-255,66,270336,7,299356
43325,0.070739,74.125.200.0-255,5738,276074,7,299356
43326,0.070746,172.31.36.0-255,66,276140,7,299356
43327,0.072732,74.125.200.0-255,5738,281878,7,299356
43328,0.072739,172.31.36.0-255,66,281944,7,299356
43329,0.074735,74.125.200.0-255,5738,287682,7,299356
43330,0.074746,172.31.36.0-255,66,287748,7,299356
43331,0.076732,74.125.200.0-255,5738,293486,7,299356
43332,0.07674,172.31.36.0-255,66,293552,7,299356
43333,0.078733,74.125.200.0-255,5738,299290,7,299356
43334,0.078739,172.31.36.0-255,66,299356,7,299356
43335,0.0,172.217.194.0-255,153,153,7,201901
43336,2.3e-05,172.31.36.0-255,66,219,7,201901
43337,2.9e-05,172.217.194.0-255,1484,1703,7,201901
43338,3.3e-05,172.31.36.0-255,66,1769,7,201901
43339,3.8e-05,172.217.194.0-255,2902,4671,7,201901
43340,4.1e-05,172.31.36.0-255,66,4737,7,201901
43341,4.7e-05,172.217.194.0-255,5738,10475,7,201901
43342,5e-05,172.31.36.0-255,66,10541,7,201901
43343,7.4e-05,172.217.194.0-255,1484,12025,7,201901
43344,7.6e-05,172.31.36.0-255,66,12091,7,201901
43345,8.1e-05,172.217.194.0-255,2040,14131,7,201901
43346,8.2e-05,172.31.36.0-255,66,14197,7,201901
43347,9.6e-05,172.31.36.0-255,66,14263,7,201901
43348,0.000123,172.217.194.0-255,5379,19642,7,201901
43349,0.000127,172.31.36.0-255,66,19708,7,201901
43350,0.000173,172.217.194.0-255,1484,21192,7,201901
43351,0.000175,172.31.36.0-255,66,21258,7,201901
43352,0.00018,172.217.194.0-255,2902,24160,7,201901
43353,0.000183,172.31.36.0-255,66,24226,7,201901
43354,0.000197,172.217.194.0-255,1484,25710,7,201901
43355,0.000199,172.31.36.0-255,66,25776,7,201901
43356,0.000223,172.217.194.0-255,4320,30096,7,201901
43357,0.000226,172.31.36.0-255,66,30162,7,201901
43358,0.000233,172.217.194.0-255,6797,36959,7,201901
43359,0.000235,172.31.36.0-255,66,37025,7,201901
43360,0.000249,172.31.36.0-255,66,37091,7,201901
43361,0.000268,172.217.194.0-255,2834,39925,7,201901
43362,0.000271,172.31.36.0-255,66,39991,7,201901
43363,0.000292,172.217.194.0-255,364,40355,7,201901
43364,0.000295,172.31.36.0-255,66,40421,7,201901
43365,0.000383,172.217.194.0-255,1484,41905,7,201901
43366,0.000389,172.217.194.0-255,2902,44807,7,201901
43367,0.000391,172.31.36.0-255,66,44873,7,201901
43368,0.000396,172.217.194.0-255,2902,47775,7,201901
43369,0.000398,172.31.36.0-255,66,47841,7,201901
43370,0.000416,172.217.194.0-255,2902,50743,7,201901
43371,0.00042,172.31.36.0-255,66,50809,7,201901
43372,0.000426,172.217.194.0-255,6797,57606,7,201901
43373,0.00043,172.31.36.0-255,66,57672,7,201901
43374,0.000465,172.31.36.0-255,66,57738,7,201901
43375,0.000469,172.217.194.0-255,2543,60281,7,201901
43376,0.000471,172.31.36.0-255,66,60347,7,201901
43377,0.000491,172.217.194.0-255,2902,63249,7,201901
43378,0.000493,172.31.36.0-255,66,63315,7,201901
43379,0.000498,172.217.194.0-255,2902,66217,7,201901
43380,0.0005,172.31.36.0-255,66,66283,7,201901
43381,0.000521,172.217.194.0-255,4320,70603,7,201901
43382,0.000524,172.31.36.0-255,66,70669,7,201901
43383,0.000535,172.31.36.0-255,66,70735,7,201901
43384,0.000573,172.217.194.0-255,7156,77891,7,201901
43385,0.000578,172.31.36.0-255,66,77957,7,201901
43386,0.000609,172.31.36.0-255,66,78023,7,201901
43387,0.000624,172.31.36.0-255,66,78089,7,201901
43388,0.000637,172.31.36.0-255,66,78155,7,201901
43389,0.000672,172.217.194.0-255,7156,85311,7,201901
43390,0.000676,172.31.36.0-255,66,85377,7,201901
43391,0.000697,172.217.194.0-255,2184,87561,7,201901
43392,0.0007,172.31.36.0-255,66,87627,7,201901
43393,0.000711,172.31.36.0-255,66,87693,7,201901
43394,0.000746,172.31.36.0-255,66,87759,7,201901
43395,0.000759,172.217.194.0-255,766,88525,7,201901
43396,0.000762,172.217.194.0-255,1484,90009,7,201901
43397,0.000764,172.31.36.0-255,66,90075,7,201901
43398,0.000785,172.217.194.0-255,2902,92977,7,201901
43399,0.00079,172.31.36.0-255,66,93043,7,201901
43400,0.00079,172.217.194.0-255,5738,98781,7,201901
43401,0.000793,172.31.36.0-255,66,98847,7,201901
43402,0.000808,172.217.194.0-255,1484,100331,7,201901
43403,0.000838,172.31.36.0-255,66,100397,7,201901
43404,0.000845,172.217.194.0-255,7156,107553,7,201901
43405,0.000847,172.31.36.0-255,66,107619,7,201901
43406,0.000909,172.217.194.0-255,3602,111221,7,201901
43407,0.000912,172.31.36.0-255,66,111287,7,201901
43408,0.000918,172.217.194.0-255,4320,115607,7,201901
43409,0.00092,172.31.36.0-255,66,115673,7,201901
43410,0.000931,172.31.36.0-255,66,115739,7,201901
43411,0.000944,172.217.194.0-255,7156,122895,7,201901
43412,0.000947,172.31.36.0-255,66,122961,7,201901
43413,0.000971,172.217.194.0-255,4320,127281,7,201901
43414,0.000975,172.31.36.0-255,66,127347,7,201901
43415,0.00098,172.217.194.0-255,2902,130249,7,201901
43416,0.000983,172.31.36.0-255,66,130315,7,201901
43417,0.001002,172.217.194.0-255,5020,135335,7,201901
43418,0.001005,172.31.36.0-255,66,135401,7,201901
43419,0.001012,172.217.194.0-255,5738,141139,7,201901
43420,0.001014,172.31.36.0-255,66,141205,7,201901
43421,0.001034,172.217.194.0-255,2902,144107,7,201901
43422,0.001037,172.31.36.0-255,66,144173,7,201901
43423,0.001052,172.31.36.0-255,66,144239,7,201901
43424,0.001077,172.217.194.0-255,1484,145723,7,201901
43425,0.001095,172.31.36.0-255,66,145789,7,201901
43426,0.001105,172.31.36.0-255,66,145855,7,201901
43427,0.001139,172.217.194.0-255,5738,151593,7,201901
43428,0.001143,172.31.36.0-255,66,151659,7,201901
43429,0.001187,172.31.36.0-255,66,151725,7,201901
43430,0.001221,172.217.194.0-255,1484,153209,7,201901
43431,0.001226,172.217.194.0-255,2902,156111,7,201901
43432,0.001229,172.31.36.0-255,66,156177,7,201901
43433,0.001233,172.217.194.0-255,1484,157661,7,201901
43434,0.001254,172.217.194.0-255,4320,161981,7,201901
43435,0.001259,172.31.36.0-255,66,162047,7,201901
43436,0.001266,172.217.194.0-255,5738,167785,7,201901
43437,0.001268,172.31.36.0-255,66,167851,7,201901
43438,0.001284,172.217.194.0-255,7156,175007,7,201901
43439,0.001289,172.31.36.0-255,66,175073,7,201901
43440,0.001301,172.31.36.0-255,66,175139,7,201901
43441,0.001334,172.217.194.0-255,1484,176623,7,201901
43442,0.001338,172.217.194.0-255,1484,178107,7,201901
43443,0.001342,172.31.36.0-255,66,178173,7,201901
43444,0.001364,172.217.194.0-255,1484,179657,7,201901
43445,0.00137,172.217.194.0-255,5738,185395,7,201901
43446,0.001373,172.31.36.0-255,66,185461,7,201901
43447,0.001378,172.217.194.0-255,4320,189781,7,201901
43448,0.00138,172.31.36.0-255,66,189847,7,201901
43449,0.001414,172.31.36.0-255,66,189913,7,201901
43450,0.001425,172.31.36.0-255,66,189979,7,201901
43451,0.001445,172.217.194.0-255,7156,197135,7,201901
43452,0.001449,172.31.36.0-255,66,197201,7,201901
43453,0.001485,172.31.36.0-255,66,197267,7,201901
43454,0.001488,172.217.194.0-255,105,197372,7,201901
43455,0.008205,172.31.36.0-255,66,197438,7,201901
43456,0.008232,172.31.36.0-255,105,197543,7,201901
43457,0.010501,172.217.194.0-255,66,197609,7,201901
43458,0.03002,172.31.36.0-255,172,197781,7,201901
43459,0.03005,172.31.36.0-255,1114,198895,7,201901
43460,0.030095,172.31.36.0-255,1514,200409,7,201901
43461,0.030096,172.31.36.0-255,1294,201703,7,201901
43462,0.031527,104.244.42.0-255,66,201769,7,201901
43463,0.031594,104.244.42.0-255,66,201835,7,201901
43464,0.031638,104.244.42.0-255,66,201901,7,201901
43465,0.0,172.217.194.0-255,146,146,7,237288
43466,2.3e-05,172.31.36.0-255,66,212,7,237288
43467,2.9e-05,172.217.194.0-255,1484,1696,7,237288
43468,3.3e-05,172.31.36.0-255,66,1762,7,237288
43469,5.7e-05,172.217.194.0-255,2902,4664,7,237288
43470,6.4e-05,172.31.36.0-255,66,4730,7,237288
43471,7e-05,172.217.194.0-255,7156,11886,7,237288
43472,7.3e-05,172.31.36.0-255,66,11952,7,237288
43473,7.6e-05,172.217.194.0-255,2084,14036,7,237288
43474,7.8e-05,172.31.36.0-255,66,14102,7,237288
43475,0.000139,172.217.194.0-255,1484,15586,7,237288
43476,0.000143,172.31.36.0-255,66,15652,7,237288
43477,0.000148,172.217.194.0-255,2902,18554,7,237288
43478,0.000152,172.31.36.0-255,66,18620,7,237288
43479,0.000163,172.217.194.0-255,5738,24358,7,237288
43480,0.000165,172.31.36.0-255,66,24424,7,237288
43481,0.000196,172.217.194.0-255,6797,31221,7,237288
43482,0.000199,172.31.36.0-255,66,31287,7,237288
43483,0.000338,172.217.194.0-255,1484,32771,7,237288
43484,0.000342,172.31.36.0-255,66,32837,7,237288
43485,0.000346,172.217.194.0-255,1484,34321,7,237288
43486,0.000349,172.31.36.0-255,66,34387,7,237288
43487,0.000375,172.217.194.0-255,1484,35871,7,237288
43488,0.000378,172.31.36.0-255,66,35937,7,237288
43489,0.000385,172.217.194.0-255,5738,41675,7,237288
43490,0.000388,172.31.36.0-255,66,41741,7,237288
43491,0.000394,172.217.194.0-255,6797,48538,7,237288
43492,0.000397,172.31.36.0-255,66,48604,7,237288
43493,0.000427,172.31.36.0-255,66,48670,7,237288
43494,0.000449,172.217.194.0-255,2819,51489,7,237288
43495,0.000452,172.31.36.0-255,66,51555,7,237288
43496,0.000523,172.217.194.0-255,118,51673,7,237288
43497,0.000526,172.31.36.0-255,66,51739,7,237288
43498,0.000576,172.217.194.0-255,382,52121,7,237288
43499,0.000579,172.31.36.0-255,66,52187,7,237288
43500,0.001091,172.217.194.0-255,1484,53671,7,237288
43501,0.0011,172.217.194.0-255,2902,56573,7,237288
43502,0.001104,172.31.36.0-255,66,56639,7,237288
43503,0.001111,172.217.194.0-255,5738,62377,7,237288
43504,0.001113,172.31.36.0-255,66,62443,7,237288
43505,0.001143,172.31.36.0-255,66,62509,7,237288
43506,0.001166,172.217.194.0-255,1484,63993,7,237288
43507,0.00117,172.217.194.0-255,2902,66895,7,237288
43508,0.001172,172.31.36.0-255,66,66961,7,237288
43509,0.001204,172.217.194.0-255,7156,74117,7,237288
43510,0.001207,172.31.36.0-255,66,74183,7,237288
43511,0.00121,172.217.194.0-255,766,74949,7,237288
43512,0.001361,172.217.194.0-255,1484,76433,7,237288
43513,0.001365,172.31.36.0-255,66,76499,7,237288
43514,0.00137,172.217.194.0-255,2902,79401,7,237288
43515,0.001372,172.31.36.0-255,66,79467,7,237288
43516,0.001395,172.217.194.0-255,5738,85205,7,237288
43517,0.001399,172.31.36.0-255,66,85271,7,237288
43518,0.001403,172.217.194.0-255,2902,88173,7,237288
43519,0.001404,172.31.36.0-255,66,88239,7,237288
43520,0.001424,172.217.194.0-255,2902,91141,7,237288
43521,0.001427,172.31.36.0-255,66,91207,7,237288
43522,0.001444,172.31.36.0-255,66,91273,7,237288
43523,0.00145,172.217.194.0-255,5020,96293,7,237288
43524,0.001456,172.31.36.0-255,66,96359,7,237288
43525,0.00156,172.217.194.0-255,1484,97843,7,237288
43526,0.001572,172.217.194.0-255,2902,100745,7,237288
43527,0.001575,172.31.36.0-255,66,100811,7,237288
43528,0.001578,172.217.194.0-255,1484,102295,7,237288
43529,0.001606,172.217.194.0-255,4320,106615,7,237288
43530,0.001609,172.31.36.0-255,66,106681,7,237288
43531,0.001621,172.217.194.0-255,2902,109583,7,237288
43532,0.001628,172.31.36.0-255,66,109649,7,237288
43533,0.001653,172.31.36.0-255,66,109715,7,237288
43534,0.001665,172.31.36.0-255,66,109781,7,237288
43535,0.001725,172.217.194.0-255,5738,115519,7,237288
43536,0.001728,172.31.36.0-255,66,115585,7,237288
43537,0.001753,172.217.194.0-255,7156,122741,7,237288
43538,0.001756,172.31.36.0-255,66,122807,7,237288
43539,0.001764,172.31.36.0-255,66,122873,7,237288
43540,0.00177,172.217.194.0-255,4320,127193,7,237288
43541,0.001771,172.31.36.0-255,66,127259,7,237288
43542,0.001805,172.31.36.0-255,66,127325,7,237288
43543,0.001831,172.217.194.0-255,4320,131645,7,237288
43544,0.001835,172.217.194.0-255,2902,134547,7,237288
43545,0.001835,172.31.36.0-255,66,134613,7,237288
43546,0.001839,172.31.36.0-255,66,134679,7,237288
43547,0.001862,172.217.194.0-255,2902,137581,7,237288
43548,0.001864,172.31.36.0-255,66,137647,7,237288
43549,0.001874,172.31.36.0-255,66,137713,7,237288
43550,0.001879,172.217.194.0-255,4320,142033,7,237288
43551,0.00188,172.31.36.0-255,66,142099,7,237288
43552,0.001905,172.217.194.0-255,5738,147837,7,237288
43553,0.001909,172.31.36.0-255,66,147903,7,237288
43554,0.001912,172.217.194.0-255,2184,150087,7,237288
43555,0.001915,172.31.36.0-255,66,150153,7,237288
43556,0.001936,172.217.194.0-255,2902,153055,7,237288
43557,0.001938,172.31.36.0-255,66,153121,7,237288
43558,0.001966,172.217.194.0-255,7156,160277,7,237288
43559,0.00197,172.31.36.0-255,66,160343,7,237288
43560,0.001985,172.217.194.0-255,7156,167499,7,237288
43561,0.001989,172.31.36.0-255,66,167565,7,237288
43562,0.00202,172.31.36.0-255,66,167631,7,237288
43563,0.002039,172.217.194.0-255,1484,169115,7,237288
43564,0.002041,172.217.194.0-255,766,169881,7,237288
43565,0.002043,172.31.36.0-255,66,169947,7,237288
43566,0.002084,172.217.194.0-255,1484,171431,7,237288
43567,0.002128,172.217.194.0-255,1484,172915,7,237288
43568,0.002131,172.31.36.0-255,66,172981,7,237288
43569,0.002135,172.217.194.0-255,2902,175883,7,237288
43570,0.002137,172.31.36.0-255,66,175949,7,237288
43571,0.00217,172.217.194.0-255,5738,181687,7,237288
43572,0.002173,172.31.36.0-255,66,181753,7,237288
43573,0.002183,172.31.36.0-255,66,181819,7,237288
43574,0.002214,172.217.194.0-255,4320,186139,7,237288
43575,0.002218,172.31.36.0-255,66,186205,7,237288
43576,0.002227,172.31.36.0-255,66,186271,7,237288
43577,0.002528,172.217.194.0-255,1484,187755,7,237288
43578,0.002549,172.217.194.0-255,2902,190657,7,237288
43579,0.002554,172.31.36.0-255,66,190723,7,237288
43580,0.002574,172.217.194.0-255,5738,196461,7,237288
43581,0.002577,172.31.36.0-255,66,196527,7,237288
43582,0.002582,172.217.194.0-255,5738,202265,7,237288
43583,0.002584,172.31.36.0-255,66,202331,7,237288
43584,0.002611,172.217.194.0-255,7156,209487,7,237288
43585,0.002614,172.31.36.0-255,66,209553,7,237288
43586,0.002628,172.31.36.0-255,66,209619,7,237288
43587,0.002647,172.217.194.0-255,1484,211103,7,237288
43588,0.00265,172.217.194.0-255,766,211869,7,237288
43589,0.002653,172.31.36.0-255,66,211935,7,237288
43590,0.002659,172.31.36.0-255,66,212001,7,237288
43591,0.002689,172.217.194.0-255,1484,213485,7,237288
43592,0.002726,172.31.36.0-255,66,213551,7,237288
43593,0.002757,172.217.194.0-255,2902,216453,7,237288
43594,0.00276,172.31.36.0-255,66,216519,7,237288
43595,0.00277,172.31.36.0-255,66,216585,7,237288
43596,0.002833,172.217.194.0-255,1484,218069,7,237288
43597,0.002852,172.217.194.0-255,1484,219553,7,237288
43598,0.002855,172.31.36.0-255,66,219619,7,237288
43599,0.00288,172.217.194.0-255,1484,221103,7,237288
43600,0.002883,172.217.194.0-255,1484,222587,7,237288
43601,0.002886,172.31.36.0-255,66,222653,7,237288
43602,0.002891,172.31.36.0-255,66,222719,7,237288
43603,0.002895,172.217.194.0-255,2902,225621,7,237288
43604,0.002898,172.31.36.0-255,66,225687,7,237288
43605,0.002951,172.31.36.0-255,66,225753,7,237288
43606,0.00296,172.31.36.0-255,66,225819,7,237288
43607,0.002964,172.217.194.0-255,1871,227690,7,237288
43608,0.002965,172.31.36.0-255,66,227756,7,237288
43609,0.002985,172.217.194.0-255,105,227861,7,237288
43610,0.00367,172.31.36.0-255,66,227927,7,237288
43611,0.003696,172.31.36.0-255,105,228032,7,237288
43612,0.005927,172.217.194.0-255,66,228098,7,237288
43613,0.025668,172.31.36.0-255,172,228270,7,237288
43614,0.025697,172.31.36.0-255,1113,229383,7,237288
43615,0.025769,172.31.36.0-255,1514,230897,7,237288
43616,0.025771,172.31.36.0-255,1514,232411,7,237288
43617,0.025772,172.31.36.0-255,1514,233925,7,237288
43618,0.025779,172.31.36.0-255,1514,235439,7,237288
43619,0.025781,172.31.36.0-255,1514,236953,7,237288
43620,0.025781,172.31.36.0-255,71,237024,7,237288
43621,0.027205,104.244.42.0-255,66,237090,7,237288
43622,0.027214,104.244.42.0-255,66,237156,7,237288
43623,0.027282,104.244.42.0-255,66,237222,7,237288
43624,0.027329,104.244.42.0-255,66,237288,7,237288
43625,0.0,74.125.200.0-255,146,146,7,369700
43626,3.1e-05,172.31.36.0-255,66,212,7,369700
43627,3.8e-05,74.125.200.0-255,1484,1696,7,369700
43628,4.3e-05,172.31.36.0-255,66,1762,7,369700
43629,6.4e-05,74.125.200.0-255,2902,4664,7,369700
43630,7.2e-05,172.31.36.0-255,66,4730,7,369700
43631,7.6e-05,74.125.200.0-255,2902,7632,7,369700
43632,7.8e-05,172.31.36.0-255,66,7698,7,369700
43633,8.1e-05,74.125.200.0-255,1484,9182,7,369700
43634,8.4e-05,172.31.36.0-255,66,9248,7,369700
43635,0.00011,74.125.200.0-255,2902,12150,7,369700
43636,0.000113,172.31.36.0-255,66,12216,7,369700
43637,0.000117,74.125.200.0-255,2014,14230,7,369700
43638,0.000119,172.31.36.0-255,66,14296,7,369700
43639,0.000148,74.125.200.0-255,2902,17198,7,369700
43640,0.000151,172.31.36.0-255,66,17264,7,369700
43641,0.000184,74.125.200.0-255,7156,24420,7,369700
43642,0.000187,172.31.36.0-255,66,24486,7,369700
43643,0.00019,74.125.200.0-255,1484,25970,7,369700
43644,0.000192,172.31.36.0-255,66,26036,7,369700
43645,0.000197,74.125.200.0-255,2902,28938,7,369700
43646,0.000199,172.31.36.0-255,66,29004,7,369700
43647,0.000239,74.125.200.0-255,2543,31547,7,369700
43648,0.000242,172.31.36.0-255,66,31613,7,369700
43649,0.000347,74.125.200.0-255,1484,33097,7,369700
43650,0.000352,172.31.36.0-255,66,33163,7,369700
43651,0.000357,74.125.200.0-255,2902,36065,7,369700
43652,0.00036,172.31.36.0-255,66,36131,7,369700
43653,0.000362,74.125.200.0-255,1484,37615,7,369700
43654,0.00037,172.31.36.0-255,66,37681,7,369700
43655,0.000394,74.125.200.0-255,2902,40583,7,369700
43656,0.000398,172.31.36.0-255,66,40649,7,369700
43657,0.000401,74.125.200.0-255,1484,42133,7,369700
43658,0.000428,74.125.200.0-255,4320,46453,7,369700
43659,0.000433,74.125.200.0-255,2543,48996,7,369700
43660,0.00044,172.31.36.0-255,66,49062,7,369700
43661,0.000461,74.125.200.0-255,2902,51964,7,369700
43662,0.000469,172.31.36.0-255,66,52030,7,369700
43663,0.000496,74.125.200.0-255,5738,57768,7,369700
43664,0.000501,172.31.36.0-255,66,57834,7,369700
43665,0.000503,74.125.200.0-255,7156,64990,7,369700
43666,0.000518,172.31.36.0-255,66,65056,7,369700
43667,0.000521,74.125.200.0-255,1125,66181,7,369700
43668,0.000555,74.125.200.0-255,396,66577,7,369700
43669,0.000599,74.125.200.0-255,348,66925,7,369700
43670,0.000604,172.31.36.0-255,66,66991,7,369700
43671,0.000778,74.125.200.0-255,1484,68475,7,369700
43672,0.000801,74.125.200.0-255,2902,71377,7,369700
43673,0.000805,172.31.36.0-255,66,71443,7,369700
43674,0.000809,74.125.200.0-255,1484,72927,7,369700
43675,0.000835,74.125.200.0-255,4320,77247,7,369700
43676,0.000838,74.125.200.0-255,1484,78731,7,369700
43677,0.000842,172.31.36.0-255,66,78797,7,369700
43678,0.000887,74.125.200.0-255,2902,81699,7,369700
43679,0.000895,74.125.200.0-255,5738,87437,7,369700
43680,0.000896,172.31.36.0-255,66,87503,7,369700
43681,0.000903,172.31.36.0-255,66,87569,7,369700
43682,0.000924,74.125.200.0-255,4320,91889,7,369700
43683,0.000929,172.31.36.0-255,66,91955,7,369700
43684,0.000959,74.125.200.0-255,2902,94857,7,369700
43685,0.000962,74.125.200.0-255,1484,96341,7,369700
43686,0.000963,172.31.36.0-255,66,96407,7,369700
43687,0.000965,74.125.200.0-255,2902,99309,7,369700
43688,0.000981,172.31.36.0-255,66,99375,7,369700
43689,0.000988,74.125.200.0-255,2184,101559,7,369700
43690,0.000995,172.31.36.0-255,66,101625,7,369700
43691,0.001229,74.125.200.0-255,1484,103109,7,369700
43692,0.001238,74.125.200.0-255,2902,106011,7,369700
43693,0.001242,172.31.36.0-255,66,106077,7,369700
43694,0.001275,74.125.200.0-255,5738,111815,7,369700
43695,0.001297,74.125.200.0-255,7156,118971,7,369700
43696,0.001302,74.125.200.0-255,1484,120455,7,369700
43697,0.001327,74.125.200.0-255,7156,127611,7,369700
43698,0.001384,74.125.200.0-255,4320,131931,7,369700
43699,0.001397,74.125.200.0-255,2902,134833,7,369700
43700,0.001413,74.125.200.0-255,2902,137735,7,369700
43701,0.001428,74.125.200.0-255,5738,143473,7,369700
43702,0.001456,74.125.200.0-255,5738,149211,7,369700
43703,0.001463,74.125.200.0-255,5738,154949,7,369700
43704,0.001493,74.125.200.0-255,4320,159269,7,369700
43705,0.001505,74.125.200.0-255,2184,161453,7,369700
43706,0.001557,74.125.200.0-255,1484,162937,7,369700
43707,0.001598,74.125.200.0-255,1484,164421,7,369700
43708,0.001603,74.125.200.0-255,2902,167323,7,369700
43709,0.001621,74.125.200.0-255,2902,170225,7,369700
43710,0.001637,74.125.200.0-255,2902,173127,7,369700
43711,0.001642,74.125.200.0-255,4320,177447,7,369700
43712,0.001655,74.125.200.0-255,1484,178931,7,369700
43713,0.00166,74.125.200.0-255,4320,183251,7,369700
43714,0.001678,74.125.200.0-255,2902,186153,7,369700
43715,0.001693,74.125.200.0-255,5738,191891,7,369700
43716,0.001712,74.125.200.0-255,3602,195493,7,369700
43717,0.001788,74.125.200.0-255,1484,196977,7,369700
43718,0.001794,74.125.200.0-255,2902,199879,7,369700
43719,0.001815,74.125.200.0-255,5738,205617,7,369700
43720,0.001833,74.125.200.0-255,1484,207101,7,369700
43721,0.001877,74.125.200.0-255,5738,212839,7,369700
43722,0.001908,74.125.200.0-255,5020,217859,7,369700
43723,0.001978,74.125.200.0-255,1484,219343,7,369700
43724,0.001992,74.125.200.0-255,2902,222245,7,369700
43725,0.001994,74.125.200.0-255,1484,223729,7,369700
43726,0.001996,74.125.200.0-255,1484,225213,7,369700
43727,0.002014,74.125.200.0-255,1484,226697,7,369700
43728,0.002019,74.125.200.0-255,4320,231017,7,369700
43729,0.002034,74.125.200.0-255,1484,232501,7,369700
43730,0.002066,74.125.200.0-255,2902,235403,7,369700
43731,0.002148,74.125.200.0-255,2902,238305,7,369700
43732,0.002155,74.125.200.0-255,7156,245461,7,369700
43733,0.002181,74.125.200.0-255,5020,250481,7,369700
43734,0.002216,74.125.200.0-255,1484,251965,7,369700
43735,0.002221,74.125.200.0-255,2902,254867,7,369700
43736,0.002249,74.125.200.0-255,4320,259187,7,369700
43737,0.00226,74.125.200.0-255,1484,260671,7,369700
43738,0.002266,74.125.200.0-255,4320,264991,7,369700
43739,0.00227,74.125.200.0-255,1484,266475,7,369700
43740,0.002293,74.125.200.0-255,4320,270795,7,369700
43741,0.002309,74.125.200.0-255,4320,275115,7,369700
43742,0.002336,74.125.200.0-255,7156,282271,7,369700
43743,0.002364,74.125.200.0-255,5738,288009,7,369700
43744,0.002385,74.125.200.0-255,6438,294447,7,369700
43745,0.002388,74.125.200.0-255,1484,295931,7,369700
43746,0.002443,172.31.36.0-255,66,295997,7,369700
43747,0.004812,74.125.200.0-255,5738,301735,7,369700
43748,0.004819,172.31.36.0-255,66,301801,7,369700
43749,0.007142,74.125.200.0-255,2902,304703,7,369700
43750,0.007163,74.125.200.0-255,2902,307605,7,369700
43751,0.008295,172.31.36.0-255,66,307671,7,369700
43752,0.010634,74.125.200.0-255,5738,313409,7,369700
43753,0.01064,172.31.36.0-255,66,313475,7,369700
43754,0.012968,74.125.200.0-255,4320,317795,7,369700
43755,0.012975,172.31.36.0-255,66,317861,7,369700
43756,0.01301,74.125.200.0-255,1484,319345,7,369700
43757,0.015305,74.125.200.0-255,4320,323665,7,369700
43758,0.015312,172.31.36.0-255,66,323731,7,369700
43759,0.017627,74.125.200.0-255,5738,329469,7,369700
43760,0.017671,172.31.36.0-255,66,329535,7,369700
43761,0.019995,74.125.200.0-255,5738,335273,7,369700
43762,0.020003,172.31.36.0-255,66,335339,7,369700
43763,0.022344,74.125.200.0-255,5738,341077,7,369700
43764,0.022352,172.31.36.0-255,66,341143,7,369700
43765,0.02468,74.125.200.0-255,5738,346881,7,369700
43766,0.024687,172.31.36.0-255,66,346947,7,369700
43767,0.027007,74.125.200.0-255,5738,352685,7,369700
43768,0.027013,172.31.36.0-255,66,352751,7,369700
43769,0.029352,74.125.200.0-255,5738,358489,7,369700
43770,0.029361,172.31.36.0-255,66,358555,7,369700
43771,0.029686,172.31.36.0-255,172,358727,7,369700
43772,0.029726,172.31.36.0-255,1116,359843,7,369700
43773,0.029796,172.31.36.0-255,1514,361357,7,369700
43774,0.029798,172.31.36.0-255,1290,362647,7,369700
43775,0.031275,104.244.42.0-255,66,362713,7,369700
43776,0.031281,104.244.42.0-255,66,362779,7,369700
43777,0.031345,104.244.42.0-255,66,362845,7,369700
43778,0.031684,74.125.200.0-255,2902,365747,7,369700
43779,0.031687,172.31.36.0-255,66,365813,7,369700
43780,0.031719,74.125.200.0-255,2902,368715,7,369700
43781,0.031751,172.31.36.0-255,66,368781,7,369700
43782,0.033993,74.125.200.0-255,682,369463,7,369700
43783,0.034124,172.31.36.0-255,66,369529,7,369700
43784,0.03415,172.31.36.0-255,105,369634,7,369700
43785,0.036437,74.125.200.0-255,66,369700,7,369700
43786,0.0,172.217.194.0-255,153,153,7,266395
43787,7.5e-05,172.31.36.0-255,66,219,7,266395
43788,8.1e-05,172.217.194.0-255,1484,1703,7,266395
43789,8.5e-05,172.31.36.0-255,66,1769,7,266395
43790,9e-05,172.217.194.0-255,2902,4671,7,266395
43791,9.3e-05,172.31.36.0-255,66,4737,7,266395
43792,9.9e-05,172.217.194.0-255,4320,9057,7,266395
43793,0.000102,172.31.36.0-255,66,9123,7,266395
43794,0.000108,172.217.194.0-255,4849,13972,7,266395
43795,0.00011,172.31.36.0-255,66,14038,7,266395
43796,0.000116,172.217.194.0-255,5738,19776,7,266395
43797,0.00012,172.31.36.0-255,66,19842,7,266395
43798,0.000148,172.217.194.0-255,5738,25580,7,266395
43799,0.00015,172.31.36.0-255,66,25646,7,266395
43800,0.000172,172.217.194.0-255,5379,31025,7,266395
43801,0.000176,172.31.36.0-255,66,31091,7,266395
43802,0.000193,172.217.194.0-255,1484,32575,7,266395
43803,0.000196,172.31.36.0-255,66,32641,7,266395
43804,0.000217,172.217.194.0-255,2902,35543,7,266395
43805,0.00022,172.31.36.0-255,66,35609,7,266395
43806,0.000227,172.217.194.0-255,5738,41347,7,266395
43807,0.00023,172.31.36.0-255,66,41413,7,266395
43808,0.000241,172.217.194.0-255,2902,44315,7,266395
43809,0.000245,172.31.36.0-255,66,44381,7,266395
43810,0.000255,172.217.194.0-255,1484,45865,7,266395
43811,0.000258,172.31.36.0-255,66,45931,7,266395
43812,0.000298,172.217.194.0-255,1484,47415,7,266395
43813,0.000301,172.31.36.0-255,66,47481,7,266395
43814,0.000322,172.217.194.0-255,5379,52860,7,266395
43815,0.000325,172.31.36.0-255,66,52926,7,266395
43816,0.000331,172.217.194.0-255,7156,60082,7,266395
43817,0.000333,172.31.36.0-255,66,60148,7,266395
43818,0.000354,172.217.194.0-255,2902,63050,7,266395
43819,0.000366,172.31.36.0-255,66,63116,7,266395
43820,0.000372,172.217.194.0-255,2543,65659,7,266395
43821,0.000381,172.31.36.0-255,66,65725,7,266395
43822,0.000399,172.217.194.0-255,648,66373,7,266395
43823,0.000497,172.217.194.0-255,1484,67857,7,266395
43824,0.000511,172.217.194.0-255,2902,70759,7,266395
43825,0.000513,172.31.36.0-255,66,70825,7,266395
43826,0.000518,172.31.36.0-255,66,70891,7,266395
43827,0.000537,172.217.194.0-255,5738,76629,7,266395
43828,0.000544,172.31.36.0-255,66,76695,7,266395
43829,0.000553,172.217.194.0-255,1484,78179,7,266395
43830,0.000568,172.217.194.0-255,5379,83558,7,266395
43831,0.000571,172.31.36.0-255,66,83624,7,266395
43832,0.000641,172.217.194.0-255,2543,86167,7,266395
43833,0.000643,172.31.36.0-255,66,86233,7,266395
43834,0.000649,172.31.36.0-255,66,86299,7,266395
43835,0.000783,172.217.194.0-255,1484,87783,7,266395
43836,0.000819,172.217.194.0-255,2902,90685,7,266395
43837,0.000823,172.31.36.0-255,66,90751,7,266395
43838,0.000843,172.217.194.0-255,4320,95071,7,266395
43839,0.000854,172.217.194.0-255,1484,96555,7,266395
43840,0.000854,172.31.36.0-255,66,96621,7,266395
43841,0.000856,172.217.194.0-255,1484,98105,7,266395
43842,0.000859,172.217.194.0-255,1484,99589,7,266395
43843,0.000859,172.31.36.0-255,66,99655,7,266395
43844,0.000884,172.31.36.0-255,66,99721,7,266395
43845,0.000896,172.217.194.0-255,1484,101205,7,266395
43846,0.0009,172.217.194.0-255,2902,104107,7,266395
43847,0.000902,172.31.36.0-255,66,104173,7,266395
43848,0.000918,172.217.194.0-255,5887,110060,7,266395
43849,0.000924,172.31.36.0-255,66,110126,7,266395
43850,0.000964,172.217.194.0-255,1484,111610,7,266395
43851,0.000981,172.217.194.0-255,2902,114512,7,266395
43852,0.000986,172.31.36.0-255,66,114578,7,266395
43853,0.001023,172.31.36.0-255,66,114644,7,266395
43854,0.001048,172.217.194.0-255,1484,116128,7,266395
43855,0.00107,172.31.36.0-255,66,116194,7,266395
43856,0.001092,172.217.194.0-255,5020,121214,7,266395
43857,0.001098,172.31.36.0-255,66,121280,7,266395
43858,0.001209,172.217.194.0-255,1484,122764,7,266395
43859,0.001214,172.217.194.0-255,2902,125666,7,266395
43860,0.001217,172.31.36.0-255,66,125732,7,266395
43861,0.001221,172.217.194.0-255,2902,128634,7,266395
43862,0.001231,172.31.36.0-255,66,128700,7,266395
43863,0.001235,172.217.194.0-255,2902,131602,7,266395
43864,0.001241,172.217.194.0-255,7156,138758,7,266395
43865,0.001248,172.31.36.0-255,66,138824,7,266395
43866,0.001257,172.217.194.0-255,5738,144562,7,266395
43867,0.001259,172.31.36.0-255,66,144628,7,266395
43868,0.001289,172.31.36.0-255,66,144694,7,266395
43869,0.001369,172.217.194.0-255,1484,146178,7,266395
43870,0.001387,172.217.194.0-255,2902,149080,7,266395
43871,0.00139,172.31.36.0-255,66,149146,7,266395
43872,0.001394,172.217.194.0-255,1484,150630,7,266395
43873,0.001406,172.217.194.0-255,1484,152114,7,266395
43874,0.001412,172.31.36.0-255,66,152180,7,266395
43875,0.001416,172.217.194.0-255,1484,153664,7,266395
43876,0.001429,172.217.194.0-255,1484,155148,7,266395
43877,0.001437,172.31.36.0-255,66,155214,7,266395
43878,0.001478,172.31.36.0-255,66,155280,7,266395
43879,0.00148,172.217.194.0-255,7156,162436,7,266395
43880,0.001496,172.31.36.0-255,66,162502,7,266395
43881,0.0015,172.217.194.0-255,6438,168940,7,266395
43882,0.001508,172.31.36.0-255,66,169006,7,266395
43883,0.001511,172.217.194.0-255,1484,170490,7,266395
43884,0.001534,172.217.194.0-255,2902,173392,7,266395
43885,0.00154,172.217.194.0-255,5738,179130,7,266395
43886,0.001545,172.31.36.0-255,66,179196,7,266395
43887,0.001564,172.217.194.0-255,2902,182098,7,266395
43888,0.001567,172.31.36.0-255,66,182164,7,266395
43889,0.001592,172.217.194.0-255,7156,189320,7,266395
43890,0.001596,172.31.36.0-255,66,189386,7,266395
43891,0.001606,172.217.194.0-255,4320,193706,7,266395
43892,0.00161,172.31.36.0-255,66,193772,7,266395
43893,0.001654,172.31.36.0-255,66,193838,7,266395
43894,0.001696,172.31.36.0-255,66,193904,7,266395
43895,0.001721,172.217.194.0-255,5738,199642,7,266395
43896,0.001725,172.31.36.0-255,66,199708,7,266395
43897,0.001731,172.217.194.0-255,1484,201192,7,266395
43898,0.001744,172.31.36.0-255,66,201258,7,266395
43899,0.001756,172.217.194.0-255,4320,205578,7,266395
43900,0.001756,172.31.36.0-255,66,205644,7,266395
43901,0.00176,172.31.36.0-255,66,205710,7,266395
43902,0.001776,172.217.194.0-255,5738,211448,7,266395
43903,0.001781,172.31.36.0-255,66,211514,7,266395
43904,0.00179,172.217.194.0-255,4320,215834,7,266395
43905,0.001798,172.31.36.0-255,66,215900,7,266395
43906,0.00182,172.217.194.0-255,4320,220220,7,266395
43907,0.001823,172.217.194.0-255,1484,221704,7,266395
43908,0.001824,172.31.36.0-255,66,221770,7,266395
43909,0.001824,172.217.194.0-255,766,222536,7,266395
43910,0.001828,172.31.36.0-255,66,222602,7,266395
43911,0.001923,172.217.194.0-255,1484,224086,7,266395
43912,0.001936,172.217.194.0-255,2902,226988,7,266395
43913,0.001939,172.217.194.0-255,1484,228472,7,266395
43914,0.001947,172.31.36.0-255,66,228538,7,266395
43915,0.001957,172.217.194.0-255,4320,232858,7,266395
43916,0.00196,172.31.36.0-255,66,232924,7,266395
43917,0.001964,172.217.194.0-255,2902,235826,7,266395
43918,0.001972,172.31.36.0-255,66,235892,7,266395
43919,0.002,172.31.36.0-255,66,235958,7,266395
43920,0.002048,172.217.194.0-255,4320,240278,7,266395
43921,0.002055,172.31.36.0-255,66,240344,7,266395
43922,0.002063,172.217.194.0-255,6438,246782,7,266395
43923,0.002067,172.31.36.0-255,66,246848,7,266395
43924,0.002105,172.217.194.0-255,1484,248332,7,266395
43925,0.002118,172.217.194.0-255,2902,251234,7,266395
43926,0.002122,172.31.36.0-255,66,251300,7,266395
43927,0.002143,172.217.194.0-255,5738,257038,7,266395
43928,0.002145,172.31.36.0-255,66,257104,7,266395
43929,0.002151,172.217.194.0-255,4320,261424,7,266395
43930,0.002157,172.31.36.0-255,66,261490,7,266395
43931,0.002183,172.31.36.0-255,66,261556,7,266395
43932,0.002187,172.31.36.0-255,66,261622,7,266395
43933,0.002203,172.217.194.0-255,766,262388,7,266395
43934,0.002219,172.217.194.0-255,1484,263872,7,266395
43935,0.002223,172.31.36.0-255,66,263938,7,266395
43936,0.002244,172.217.194.0-255,105,264043,7,266395
43937,0.002246,172.31.36.0-255,66,264109,7,266395
43938,0.008814,172.31.36.0-255,66,264175,7,266395
43939,0.008851,172.31.36.0-255,105,264280,7,266395
43940,0.011047,172.217.194.0-255,66,264346,7,266395
43941,0.033401,172.31.36.0-255,172,264518,7,266395
43942,0.033431,172.31.36.0-255,1113,265631,7,266395
43943,0.033465,172.31.36.0-255,566,266197,7,266395
43944,0.034969,104.244.42.0-255,66,266263,7,266395
43945,0.034979,104.244.42.0-255,66,266329,7,266395
43946,0.035017,104.244.42.0-255,66,266395,7,266395
43947,0.0,172.217.160.0-255,153,153,7,301510
43948,2.3e-05,172.31.36.0-255,66,219,7,301510
43949,3.1e-05,172.217.160.0-255,1484,1703,7,301510
43950,3.5e-05,172.31.36.0-255,66,1769,7,301510
43951,4.2e-05,172.217.160.0-255,2902,4671,7,301510
43952,4.5e-05,172.31.36.0-255,66,4737,7,301510
43953,5.4e-05,172.217.160.0-255,7156,11893,7,301510
43954,5.7e-05,172.31.36.0-255,66,11959,7,301510
43955,9.8e-05,172.31.36.0-255,66,12025,7,301510
43956,0.000143,172.31.36.0-255,66,12091,7,301510
43957,0.000197,172.217.160.0-255,1484,13575,7,301510
43958,0.0002,172.31.36.0-255,66,13641,7,301510
43959,0.000206,172.217.160.0-255,2902,16543,7,301510
43960,0.000208,172.31.36.0-255,66,16609,7,301510
43961,0.000212,172.217.160.0-255,1484,18093,7,301510
43962,0.000214,172.31.36.0-255,66,18159,7,301510
43963,0.000236,172.217.160.0-255,2902,21061,7,301510
43964,0.000239,172.31.36.0-255,66,21127,7,301510
43965,0.000274,172.217.160.0-255,5738,26865,7,301510
43966,0.000277,172.31.36.0-255,66,26931,7,301510
43967,0.000292,172.217.160.0-255,2543,29474,7,301510
43968,0.000294,172.31.36.0-255,66,29540,7,301510
43969,0.00033,172.217.160.0-255,5738,35278,7,301510
43970,0.000333,172.31.36.0-255,66,35344,7,301510
43971,0.000355,172.217.160.0-255,1484,36828,7,301510
43972,0.000357,172.31.36.0-255,66,36894,7,301510
43973,0.000368,172.31.36.0-255,66,36960,7,301510
43974,0.000371,172.217.160.0-255,1434,38394,7,301510
43975,0.000373,172.31.36.0-255,66,38460,7,301510
43976,0.000679,172.217.160.0-255,103,38563,7,301510
43977,0.000859,172.217.160.0-255,1484,40047,7,301510
43978,0.000863,172.31.36.0-255,66,40113,7,301510
43979,0.00087,172.217.160.0-255,2902,43015,7,301510
43980,0.000872,172.31.36.0-255,66,43081,7,301510
43981,0.000895,172.217.160.0-255,4320,47401,7,301510
43982,0.000898,172.31.36.0-255,66,47467,7,301510
43983,0.000926,172.217.160.0-255,1484,48951,7,301510
43984,0.000941,172.31.36.0-255,66,49017,7,301510
43985,0.000953,172.31.36.0-255,66,49083,7,301510
43986,0.00097,172.217.160.0-255,1484,50567,7,301510
43987,0.000974,172.217.160.0-255,1484,52051,7,301510
43988,0.000976,172.31.36.0-255,66,52117,7,301510
43989,0.000995,172.217.160.0-255,1484,53601,7,301510
43990,0.001002,172.217.160.0-255,5738,59339,7,301510
43991,0.001005,172.31.36.0-255,66,59405,7,301510
43992,0.001013,172.217.160.0-255,7156,66561,7,301510
43993,0.001015,172.31.36.0-255,66,66627,7,301510
43994,0.001045,172.217.160.0-255,5738,72365,7,301510
43995,0.001063,172.31.36.0-255,66,72431,7,301510
43996,0.001066,172.31.36.0-255,66,72497,7,301510
43997,0.001104,172.217.160.0-255,1484,73981,7,301510
43998,0.001124,172.217.160.0-255,2902,76883,7,301510
43999,0.001127,172.31.36.0-255,66,76949,7,301510
44000,0.001131,172.217.160.0-255,1484,78433,7,301510
44001,0.001137,172.217.160.0-255,4320,82753,7,301510
44002,0.001153,172.31.36.0-255,66,82819,7,301510
44003,0.001183,172.217.160.0-255,1484,84303,7,301510
44004,0.001199,172.31.36.0-255,66,84369,7,301510
44005,0.001211,172.31.36.0-255,66,84435,7,301510
44006,0.001255,172.217.160.0-255,1484,85919,7,301510
44007,0.001258,172.217.160.0-255,1484,87403,7,301510
44008,0.00126,172.31.36.0-255,66,87469,7,301510
44009,0.001277,172.217.160.0-255,1484,88953,7,301510
44010,0.001284,172.217.160.0-255,5738,94691,7,301510
44011,0.001286,172.31.36.0-255,66,94757,7,301510
44012,0.00129,172.217.160.0-255,2902,97659,7,301510
44013,0.001292,172.31.36.0-255,66,97725,7,301510
44014,0.001319,172.217.160.0-255,4320,102045,7,301510
44015,0.001323,172.31.36.0-255,66,102111,7,301510
44016,0.001336,172.31.36.0-255,66,102177,7,301510
44017,0.00136,172.217.160.0-255,2902,105079,7,301510
44018,0.001363,172.31.36.0-255,66,105145,7,301510
44019,0.001367,172.217.160.0-255,2184,107329,7,301510
44020,0.001369,172.31.36.0-255,66,107395,7,301510
44021,0.001414,172.217.160.0-255,1484,108879,7,301510
44022,0.00142,172.217.160.0-255,2902,111781,7,301510
44023,0.001423,172.31.36.0-255,66,111847,7,301510
44024,0.001427,172.217.160.0-255,2902,114749,7,301510
44025,0.00143,172.31.36.0-255,66,114815,7,301510
44026,0.001443,172.217.160.0-255,2902,117717,7,301510
44027,0.001445,172.31.36.0-255,66,117783,7,301510
44028,0.001448,172.217.160.0-255,1484,119267,7,301510
44029,0.001566,172.217.160.0-255,1484,120751,7,301510
44030,0.001572,172.217.160.0-255,2902,123653,7,301510
44031,0.001576,172.217.160.0-255,2902,126555,7,301510
44032,0.001594,172.217.160.0-255,2902,129457,7,301510
44033,0.001606,172.217.160.0-255,7156,136613,7,301510
44034,0.00162,172.217.160.0-255,5738,142351,7,301510
44035,0.005498,172.31.36.0-255,66,142417,7,301510
44036,0.007163,172.217.160.0-255,5738,148155,7,301510
44037,0.007169,172.31.36.0-255,66,148221,7,301510
44038,0.008816,172.217.160.0-255,5738,153959,7,301510
44039,0.008822,172.31.36.0-255,66,154025,7,301510
44040,0.01048,172.217.160.0-255,5738,159763,7,301510
44041,0.010487,172.31.36.0-255,66,159829,7,301510
44042,0.012144,172.217.160.0-255,5738,165567,7,301510
44043,0.012152,172.31.36.0-255,66,165633,7,301510
44044,0.013806,172.217.160.0-255,5738,171371,7,301510
44045,0.013814,172.31.36.0-255,66,171437,7,301510
44046,0.015473,172.217.160.0-255,5738,177175,7,301510
44047,0.015481,172.31.36.0-255,66,177241,7,301510
44048,0.017159,172.217.160.0-255,5738,182979,7,301510
44049,0.017167,172.31.36.0-255,66,183045,7,301510
44050,0.01883,172.217.160.0-255,5738,188783,7,301510
44051,0.018838,172.31.36.0-255,66,188849,7,301510
44052,0.020486,172.217.160.0-255,5738,194587,7,301510
44053,0.020494,172.31.36.0-255,66,194653,7,301510
44054,0.022144,172.217.160.0-255,5738,200391,7,301510
44055,0.022151,172.31.36.0-255,66,200457,7,301510
44056,0.023804,172.217.160.0-255,5738,206195,7,301510
44057,0.023811,172.31.36.0-255,66,206261,7,301510
44058,0.025465,172.217.160.0-255,5738,211999,7,301510
44059,0.025472,172.31.36.0-255,66,212065,7,301510
44060,0.027137,172.217.160.0-255,5738,217803,7,301510
44061,0.027144,172.31.36.0-255,66,217869,7,301510
44062,0.028802,172.217.160.0-255,5738,223607,7,301510
44063,0.028809,172.31.36.0-255,66,223673,7,301510
44064,0.03046,172.217.160.0-255,5738,229411,7,301510
44065,0.030467,172.31.36.0-255,66,229477,7,301510
44066,0.032121,172.217.160.0-255,5738,235215,7,301510
44067,0.032129,172.31.36.0-255,66,235281,7,301510
44068,0.032955,172.31.36.0-255,171,235452,7,301510
44069,0.032987,172.31.36.0-255,1138,236590,7,301510
44070,0.033046,172.31.36.0-255,1514,238104,7,301510
44071,0.033048,172.31.36.0-255,1270,239374,7,301510
44072,0.033781,172.217.160.0-255,5738,245112,7,301510
44073,0.033789,172.31.36.0-255,66,245178,7,301510
44074,0.034508,104.244.42.0-255,66,245244,7,301510
44075,0.034545,104.244.42.0-255,66,245310,7,301510
44076,0.034587,104.244.42.0-255,66,245376,7,301510
44077,0.035448,172.217.160.0-255,5738,251114,7,301510
44078,0.035453,172.31.36.0-255,66,251180,7,301510
44079,0.037105,172.217.160.0-255,5738,256918,7,301510
44080,0.037111,172.31.36.0-255,66,256984,7,301510
44081,0.038764,172.217.160.0-255,5738,262722,7,301510
44082,0.038771,172.31.36.0-255,66,262788,7,301510
44083,0.040426,172.217.160.0-255,5738,268526,7,301510
44084,0.040433,172.31.36.0-255,66,268592,7,301510
44085,0.042083,172.217.160.0-255,5738,274330,7,301510
44086,0.042091,172.31.36.0-255,66,274396,7,301510
44087,0.043762,172.217.160.0-255,5738,280134,7,301510
44088,0.043771,172.31.36.0-255,66,280200,7,301510
44089,0.045431,172.217.160.0-255,5738,285938,7,301510
44090,0.045437,172.31.36.0-255,66,286004,7,301510
44091,0.047095,172.217.160.0-255,5738,291742,7,301510
44092,0.047102,172.31.36.0-255,66,291808,7,301510
44093,0.048766,172.217.160.0-255,5738,297546,7,301510
44094,0.048773,172.31.36.0-255,66,297612,7,301510
44095,0.050435,172.217.160.0-255,3661,301273,7,301510
44096,0.050442,172.31.36.0-255,66,301339,7,301510
44097,0.050625,172.31.36.0-255,105,301444,7,301510
44098,0.052259,172.217.160.0-255,66,301510,7,301510
44099,0.0,74.125.24.0-255,153,153,7,332885
44100,2.8e-05,172.31.36.0-255,66,219,7,332885
44101,3.5e-05,74.125.24.0-255,1484,1703,7,332885
44102,3.9e-05,172.31.36.0-255,66,1769,7,332885
44103,4.4e-05,74.125.24.0-255,2902,4671,7,332885
44104,4.7e-05,172.31.36.0-255,66,4737,7,332885
44105,5.5e-05,74.125.24.0-255,7156,11893,7,332885
44106,5.7e-05,172.31.36.0-255,66,11959,7,332885
44107,8.4e-05,74.125.24.0-255,2002,13961,7,332885
44108,8.7e-05,172.31.36.0-255,66,14027,7,332885
44109,0.000615,74.125.24.0-255,1484,15511,7,332885
44110,0.000621,172.31.36.0-255,66,15577,7,332885
44111,0.000631,74.125.24.0-255,2902,18479,7,332885
44112,0.000634,172.31.36.0-255,66,18545,7,332885
44113,0.00064,74.125.24.0-255,4320,22865,7,332885
44114,0.000642,172.31.36.0-255,66,22931,7,332885
44115,0.000669,74.125.24.0-255,5738,28669,7,332885
44116,0.000673,172.31.36.0-255,66,28735,7,332885
44117,0.000694,74.125.24.0-255,2543,31278,7,332885
44118,0.000698,172.31.36.0-255,66,31344,7,332885
44119,0.001076,74.125.24.0-255,1484,32828,7,332885
44120,0.001083,172.31.36.0-255,66,32894,7,332885
44121,0.001092,74.125.24.0-255,2902,35796,7,332885
44122,0.001095,172.31.36.0-255,66,35862,7,332885
44123,0.001102,74.125.24.0-255,5738,41600,7,332885
44124,0.001105,172.31.36.0-255,66,41666,7,332885
44125,0.001135,74.125.24.0-255,5738,47404,7,332885
44126,0.001137,172.31.36.0-255,66,47470,7,332885
44127,0.001167,172.31.36.0-255,66,47536,7,332885
44128,0.001172,74.125.24.0-255,4320,51856,7,332885
44129,0.001174,172.31.36.0-255,66,51922,7,332885
44130,0.001202,74.125.24.0-255,5687,57609,7,332885
44131,0.001205,172.31.36.0-255,66,57675,7,332885
44132,0.001218,74.125.24.0-255,379,58054,7,332885
44133,0.001351,74.125.24.0-255,1484,59538,7,332885
44134,0.001355,172.31.36.0-255,66,59604,7,332885
44135,0.00136,74.125.24.0-255,2902,62506,7,332885
44136,0.001362,172.31.36.0-255,66,62572,7,332885
44137,0.001365,74.125.24.0-255,1484,64056,7,332885
44138,0.00138,74.125.24.0-255,4320,68376,7,332885
44139,0.001382,172.31.36.0-255,66,68442,7,332885
44140,0.001406,74.125.24.0-255,5738,74180,7,332885
44141,0.001409,172.31.36.0-255,66,74246,7,332885
44142,0.001424,74.125.24.0-255,7156,81402,7,332885
44143,0.001426,172.31.36.0-255,66,81468,7,332885
44144,0.001469,74.125.24.0-255,4320,85788,7,332885
44145,0.001472,172.31.36.0-255,66,85854,7,332885
44146,0.001494,74.125.24.0-255,6438,92292,7,332885
44147,0.001497,172.31.36.0-255,66,92358,7,332885
44148,0.003413,74.125.24.0-255,5738,98096,7,332885
44149,0.003418,172.31.36.0-255,66,98162,7,332885
44150,0.005351,74.125.24.0-255,5738,103900,7,332885
44151,0.005357,172.31.36.0-255,66,103966,7,332885
44152,0.007311,74.125.24.0-255,5738,109704,7,332885
44153,0.007319,172.31.36.0-255,66,109770,7,332885
44154,0.009255,74.125.24.0-255,5738,115508,7,332885
44155,0.009262,172.31.36.0-255,66,115574,7,332885
44156,0.011208,74.125.24.0-255,5738,121312,7,332885
44157,0.011216,172.31.36.0-255,66,121378,7,332885
44158,0.013189,74.125.24.0-255,5738,127116,7,332885
44159,0.013197,172.31.36.0-255,66,127182,7,332885
44160,0.015156,74.125.24.0-255,5738,132920,7,332885
44161,0.015165,172.31.36.0-255,66,132986,7,332885
44162,0.017101,74.125.24.0-255,5738,138724,7,332885
44163,0.017109,172.31.36.0-255,66,138790,7,332885
44164,0.019058,74.125.24.0-255,5738,144528,7,332885
44165,0.019066,172.31.36.0-255,66,144594,7,332885
44166,0.021006,74.125.24.0-255,5738,150332,7,332885
44167,0.021012,172.31.36.0-255,66,150398,7,332885
44168,0.022948,74.125.24.0-255,5738,156136,7,332885
44169,0.022955,172.31.36.0-255,66,156202,7,332885
44170,0.024913,74.125.24.0-255,5738,161940,7,332885
44171,0.024921,172.31.36.0-255,66,162006,7,332885
44172,0.026872,74.125.24.0-255,5738,167744,7,332885
44173,0.026878,172.31.36.0-255,66,167810,7,332885
44174,0.026928,172.31.36.0-255,171,167981,7,332885
44175,0.026966,172.31.36.0-255,1137,169118,7,332885
44176,0.027196,172.31.36.0-255,1514,170632,7,332885
44177,0.027198,172.31.36.0-255,1514,172146,7,332885
44178,0.0272,172.31.36.0-255,1514,173660,7,332885
44179,0.027201,172.31.36.0-255,1514,175174,7,332885
44180,0.027233,172.31.36.0-255,1497,176671,7,332885
44181,0.028475,104.244.42.0-255,66,176737,7,332885
44182,0.028518,104.244.42.0-255,66,176803,7,332885
44183,0.028767,104.244.42.0-255,66,176869,7,332885
44184,0.028773,104.244.42.0-255,66,176935,7,332885
44185,0.028838,74.125.24.0-255,5738,182673,7,332885
44186,0.028844,172.31.36.0-255,66,182739,7,332885
44187,0.030802,74.125.24.0-255,5738,188477,7,332885
44188,0.030807,172.31.36.0-255,66,188543,7,332885
44189,0.032733,74.125.24.0-255,5738,194281,7,332885
44190,0.032738,172.31.36.0-255,66,194347,7,332885
44191,0.034682,74.125.24.0-255,5738,200085,7,332885
44192,0.034687,172.31.36.0-255,66,200151,7,332885
44193,0.036607,74.125.24.0-255,5738,205889,7,332885
44194,0.036613,172.31.36.0-255,66,205955,7,332885
44195,0.038551,74.125.24.0-255,5738,211693,7,332885
44196,0.038571,172.31.36.0-255,66,211759,7,332885
44197,0.040509,74.125.24.0-255,2902,214661,7,332885
44198,0.040515,172.31.36.0-255,66,214727,7,332885
44199,0.040549,74.125.24.0-255,2902,217629,7,332885
44200,0.040552,172.31.36.0-255,66,217695,7,332885
44201,0.042431,74.125.24.0-255,2902,220597,7,332885
44202,0.042436,172.31.36.0-255,66,220663,7,332885
44203,0.042467,74.125.24.0-255,1484,222147,7,332885
44204,0.042477,74.125.24.0-255,1484,223631,7,332885
44205,0.04248,172.31.36.0-255,66,223697,7,332885
44206,0.044373,74.125.24.0-255,2902,226599,7,332885
44207,0.044378,172.31.36.0-255,66,226665,7,332885
44208,0.044407,74.125.24.0-255,2902,229567,7,332885
44209,0.04441,172.31.36.0-255,66,229633,7,332885
44210,0.046309,74.125.24.0-255,2902,232535,7,332885
44211,0.046313,172.31.36.0-255,66,232601,7,332885
44212,0.046339,74.125.24.0-255,2902,235503,7,332885
44213,0.046342,172.31.36.0-255,66,235569,7,332885
44214,0.048268,74.125.24.0-255,5738,241307,7,332885
44215,0.048272,172.31.36.0-255,66,241373,7,332885
44216,0.050218,74.125.24.0-255,5738,247111,7,332885
44217,0.050225,172.31.36.0-255,66,247177,7,332885
44218,0.05219,74.125.24.0-255,5738,252915,7,332885
44219,0.052196,172.31.36.0-255,66,252981,7,332885
44220,0.054133,74.125.24.0-255,5738,258719,7,332885
44221,0.054137,172.31.36.0-255,66,258785,7,332885
44222,0.056086,74.125.24.0-255,5738,264523,7,332885
44223,0.056091,172.31.36.0-255,66,264589,7,332885
44224,0.058055,74.125.24.0-255,5738,270327,7,332885
44225,0.058061,172.31.36.0-255,66,270393,7,332885
44226,0.059993,74.125.24.0-255,5738,276131,7,332885
44227,0.059998,172.31.36.0-255,66,276197,7,332885
44228,0.061945,74.125.24.0-255,5738,281935,7,332885
44229,0.061951,172.31.36.0-255,66,282001,7,332885
44230,0.0639,74.125.24.0-255,5738,287739,7,332885
44231,0.063905,172.31.36.0-255,66,287805,7,332885
44232,0.065842,74.125.24.0-255,5738,293543,7,332885
44233,0.065848,172.31.36.0-255,66,293609,7,332885
44234,0.067765,74.125.24.0-255,5738,299347,7,332885
44235,0.06777,172.31.36.0-255,66,299413,7,332885
44236,0.069681,74.125.24.0-255,4320,303733,7,332885
44237,0.069686,172.31.36.0-255,66,303799,7,332885
44238,0.069721,74.125.24.0-255,1484,305283,7,332885
44239,0.071633,74.125.24.0-255,4320,309603,7,332885
44240,0.071637,172.31.36.0-255,66,309669,7,332885
44241,0.073592,74.125.24.0-255,5738,315407,7,332885
44242,0.073599,172.31.36.0-255,66,315473,7,332885
44243,0.075536,74.125.24.0-255,5738,321211,7,332885
44244,0.075542,172.31.36.0-255,66,321277,7,332885
44245,0.077485,74.125.24.0-255,5738,327015,7,332885
44246,0.07749,172.31.36.0-255,66,327081,7,332885
44247,0.079425,74.125.24.0-255,5738,332819,7,332885
44248,0.07943,172.31.36.0-255,66,332885,7,332885
44249,0.0,74.125.24.0-255,153,153,7,185974
44250,2.7e-05,172.31.36.0-255,66,219,7,185974
44251,3.3e-05,74.125.24.0-255,1484,1703,7,185974
44252,3.8e-05,172.31.36.0-255,66,1769,7,185974
44253,4.2e-05,74.125.24.0-255,2902,4671,7,185974
44254,4.5e-05,172.31.36.0-255,66,4737,7,185974
44255,5.2e-05,74.125.24.0-255,7156,11893,7,185974
44256,5.5e-05,172.31.36.0-255,66,11959,7,185974
44257,0.000103,172.31.36.0-255,66,12025,7,185974
44258,0.000128,74.125.24.0-255,6797,18822,7,185974
44259,0.000131,172.31.36.0-255,66,18888,7,185974
44260,0.000171,74.125.24.0-255,1484,20372,7,185974
44261,0.000174,172.31.36.0-255,66,20438,7,185974
44262,0.00018,74.125.24.0-255,2902,23340,7,185974
44263,0.000182,172.31.36.0-255,66,23406,7,185974
44264,0.000186,74.125.24.0-255,1484,24890,7,185974
44265,0.000188,172.31.36.0-255,66,24956,7,185974
44266,0.000203,74.125.24.0-255,4320,29276,7,185974
44267,0.000206,172.31.36.0-255,66,29342,7,185974
44268,0.000225,74.125.24.0-255,6797,36139,7,185974
44269,0.000228,172.31.36.0-255,66,36205,7,185974
44270,0.000258,74.125.24.0-255,7156,43361,7,185974
44271,0.000261,172.31.36.0-255,66,43427,7,185974
44272,0.000289,172.31.36.0-255,66,43493,7,185974
44273,0.000292,74.125.24.0-255,131,43624,7,185974
44274,0.000294,172.31.36.0-255,66,43690,7,185974
44275,0.000416,74.125.24.0-255,1484,45174,7,185974
44276,0.000419,172.31.36.0-255,66,45240,7,185974
44277,0.000424,74.125.24.0-255,2902,48142,7,185974
44278,0.000426,172.31.36.0-255,66,48208,7,185974
44279,0.000452,74.125.24.0-255,4320,52528,7,185974
44280,0.000455,172.31.36.0-255,66,52594,7,185974
44281,0.000472,74.125.24.0-255,1484,54078,7,185974
44282,0.000504,172.31.36.0-255,66,54144,7,185974
44283,0.000515,172.31.36.0-255,66,54210,7,185974
44284,0.000519,74.125.24.0-255,1385,55595,7,185974
44285,0.000735,74.125.24.0-255,1484,57079,7,185974
44286,0.000739,74.125.24.0-255,2902,59981,7,185974
44287,0.00074,172.31.36.0-255,66,60047,7,185974
44288,0.000745,172.31.36.0-255,66,60113,7,185974
44289,0.000764,74.125.24.0-255,5738,65851,7,185974
44290,0.000767,172.31.36.0-255,66,65917,7,185974
44291,0.000782,74.125.24.0-255,4320,70237,7,185974
44292,0.000784,172.31.36.0-255,66,70303,7,185974
44293,0.000811,172.31.36.0-255,66,70369,7,185974
44294,0.000838,74.125.24.0-255,5738,76107,7,185974
44295,0.00084,172.31.36.0-255,66,76173,7,185974
44296,0.000857,74.125.24.0-255,5020,81193,7,185974
44297,0.00086,172.31.36.0-255,66,81259,7,185974
44298,0.000883,74.125.24.0-255,1484,82743,7,185974
44299,0.000905,74.125.24.0-255,2902,85645,7,185974
44300,0.000908,172.31.36.0-255,66,85711,7,185974
44301,0.000934,74.125.24.0-255,4320,90031,7,185974
44302,0.000937,172.31.36.0-255,66,90097,7,185974
44303,0.000975,74.125.24.0-255,5738,95835,7,185974
44304,0.000978,172.31.36.0-255,66,95901,7,185974
44305,0.000997,74.125.24.0-255,2902,98803,7,185974
44306,0.001,172.31.36.0-255,66,98869,7,185974
44307,0.001037,172.31.36.0-255,66,98935,7,185974
44308,0.001042,74.125.24.0-255,2902,101837,7,185974
44309,0.001044,172.31.36.0-255,66,101903,7,185974
44310,0.001105,74.125.24.0-255,3602,105505,7,185974
44311,0.001108,172.31.36.0-255,66,105571,7,185974
44312,0.001234,74.125.24.0-255,1484,107055,7,185974
44313,0.001252,74.125.24.0-255,2902,109957,7,185974
44314,0.001255,172.31.36.0-255,66,110023,7,185974
44315,0.00126,74.125.24.0-255,2902,112925,7,185974
44316,0.001263,172.31.36.0-255,66,112991,7,185974
44317,0.001276,74.125.24.0-255,2902,115893,7,185974
44318,0.001279,172.31.36.0-255,66,115959,7,185974
44319,0.001284,74.125.24.0-255,4320,120279,7,185974
44320,0.001286,172.31.36.0-255,66,120345,7,185974
44321,0.001323,172.31.36.0-255,66,120411,7,185974
44322,0.001331,74.125.24.0-255,7156,127567,7,185974
44323,0.001335,172.31.36.0-255,66,127633,7,185974
44324,0.001387,74.125.24.0-255,3602,131235,7,185974
44325,0.00139,172.31.36.0-255,66,131301,7,185974
44326,0.00143,74.125.24.0-255,1484,132785,7,185974
44327,0.001441,74.125.24.0-255,1484,134269,7,185974
44328,0.001444,172.31.36.0-255,66,134335,7,185974
44329,0.001466,74.125.24.0-255,2902,137237,7,185974
44330,0.001469,172.31.36.0-255,66,137303,7,185974
44331,0.001476,74.125.24.0-255,5738,143041,7,185974
44332,0.001478,172.31.36.0-255,66,143107,7,185974
44333,0.001496,74.125.24.0-255,5738,148845,7,185974
44334,0.001499,172.31.36.0-255,66,148911,7,185974
44335,0.001519,74.125.24.0-255,7156,156067,7,185974
44336,0.001522,172.31.36.0-255,66,156133,7,185974
44337,0.001567,172.31.36.0-255,66,156199,7,185974
44338,0.001641,74.125.24.0-255,1484,157683,7,185974
44339,0.001645,74.125.24.0-255,1484,159167,7,185974
44340,0.001648,172.31.36.0-255,66,159233,7,185974
44341,0.00167,74.125.24.0-255,1484,160717,7,185974
44342,0.001677,74.125.24.0-255,5738,166455,7,185974
44343,0.001679,172.31.36.0-255,66,166521,7,185974
44344,0.001684,74.125.24.0-255,2902,169423,7,185974
44345,0.001685,172.31.36.0-255,66,169489,7,185974
44346,0.00174,172.31.36.0-255,66,169555,7,185974
44347,0.001751,172.31.36.0-255,66,169621,7,185974
44348,0.001783,172.31.36.0-255,66,169687,7,185974
44349,0.001792,172.31.36.0-255,66,169753,7,185974
44350,0.001823,74.125.24.0-255,4320,174073,7,185974
44351,0.001827,172.31.36.0-255,66,174139,7,185974
44352,0.001871,172.31.36.0-255,66,174205,7,185974
44353,0.001888,172.31.36.0-255,66,174271,7,185974
44354,0.00189,74.125.24.0-255,766,175037,7,185974
44355,0.001926,172.31.36.0-255,66,175103,7,185974
44356,0.001955,172.31.36.0-255,66,175169,7,185974
44357,0.001966,172.31.36.0-255,66,175235,7,185974
44358,0.001981,74.125.24.0-255,2902,178137,7,185974
44359,0.001984,172.31.36.0-255,66,178203,7,185974
44360,0.002018,172.31.36.0-255,66,178269,7,185974
44361,0.002068,74.125.24.0-255,105,178374,7,185974
44362,0.003892,172.31.36.0-255,66,178440,7,185974
44363,0.00392,172.31.36.0-255,105,178545,7,185974
44364,0.006101,74.125.24.0-255,66,178611,7,185974
44365,0.027705,172.31.36.0-255,192,178803,7,185974
44366,0.027739,172.31.36.0-255,958,179761,7,185974
44367,0.027784,172.31.36.0-255,1514,181275,7,185974
44368,0.027786,172.31.36.0-255,1514,182789,7,185974
44369,0.027788,172.31.36.0-255,1514,184303,7,185974
44370,0.027789,172.31.36.0-255,1233,185536,7,185974
44371,0.029221,104.244.42.0-255,66,185602,7,185974
44372,0.029274,104.244.42.0-255,66,185668,7,185974
44373,0.029316,104.244.42.0-255,66,185734,7,185974
44374,0.029318,104.244.42.0-255,66,185800,7,185974
44375,0.030065,104.244.42.0-255,108,185908,7,185974
44376,0.030088,172.31.36.0-255,66,185974,7,185974
44377,0.0,74.125.24.0-255,153,153,7,301743
44378,3.5e-05,172.31.36.0-255,66,219,7,301743
44379,4.2e-05,74.125.24.0-255,1484,1703,7,301743
44380,4.7e-05,172.31.36.0-255,66,1769,7,301743
44381,5.2e-05,74.125.24.0-255,2902,4671,7,301743
44382,6.3e-05,172.31.36.0-255,66,4737,7,301743
44383,6.5e-05,74.125.24.0-255,1484,6221,7,301743
44384,6.8e-05,172.31.36.0-255,66,6287,7,301743
44385,7.2e-05,74.125.24.0-255,2902,9189,7,301743
44386,7.4e-05,172.31.36.0-255,66,9255,7,301743
44387,0.000112,74.125.24.0-255,4885,14140,7,301743
44388,0.000116,172.31.36.0-255,66,14206,7,301743
44389,0.000141,74.125.24.0-255,1484,15690,7,301743
44390,0.000144,172.31.36.0-255,66,15756,7,301743
44391,0.000166,74.125.24.0-255,2902,18658,7,301743
44392,0.000171,172.31.36.0-255,66,18724,7,301743
44393,0.000178,74.125.24.0-255,5738,24462,7,301743
44394,0.00018,172.31.36.0-255,66,24528,7,301743
44395,0.000238,74.125.24.0-255,6797,31325,7,301743
44396,0.000241,172.31.36.0-255,66,31391,7,301743
44397,0.000382,74.125.24.0-255,1484,32875,7,301743
44398,0.000386,172.31.36.0-255,66,32941,7,301743
44399,0.000391,74.125.24.0-255,2902,35843,7,301743
44400,0.000394,172.31.36.0-255,66,35909,7,301743
44401,0.000399,74.125.24.0-255,5738,41647,7,301743
44402,0.000407,172.31.36.0-255,66,41713,7,301743
44403,0.000451,74.125.24.0-255,7156,48869,7,301743
44404,0.000453,172.31.36.0-255,66,48935,7,301743
44405,0.000457,172.31.36.0-255,66,49001,7,301743
44406,0.000472,74.125.24.0-255,2543,51544,7,301743
44407,0.000475,172.31.36.0-255,66,51610,7,301743
44408,0.000478,74.125.24.0-255,397,52007,7,301743
44409,0.000683,74.125.24.0-255,347,52354,7,301743
44410,0.00078,172.31.36.0-255,66,52420,7,301743
44411,0.00091,74.125.24.0-255,1484,53904,7,301743
44412,0.000921,74.125.24.0-255,2902,56806,7,301743
44413,0.000925,172.31.36.0-255,66,56872,7,301743
44414,0.000932,74.125.24.0-255,5738,62610,7,301743
44415,0.000934,172.31.36.0-255,66,62676,7,301743
44416,0.000985,172.31.36.0-255,66,62742,7,301743
44417,0.000998,172.31.36.0-255,66,62808,7,301743
44418,0.001001,74.125.24.0-255,1125,63933,7,301743
44419,0.00131,172.31.36.0-255,66,63999,7,301743
44420,0.001935,74.125.24.0-255,1484,65483,7,301743
44421,0.001955,74.125.24.0-255,2902,68385,7,301743
44422,0.001959,172.31.36.0-255,66,68451,7,301743
44423,0.001965,74.125.24.0-255,5738,74189,7,301743
44424,0.001967,172.31.36.0-255,66,74255,7,301743
44425,0.001976,74.125.24.0-255,4320,78575,7,301743
44426,0.001978,172.31.36.0-255,66,78641,7,301743
44427,0.001981,74.125.24.0-255,1484,80125,7,301743
44428,0.002027,172.31.36.0-255,66,80191,7,301743
44429,0.00203,172.31.36.0-255,66,80257,7,301743
44430,0.002173,74.125.24.0-255,1484,81741,7,301743
44431,0.002184,74.125.24.0-255,2902,84643,7,301743
44432,0.002187,172.31.36.0-255,66,84709,7,301743
44433,0.002219,74.125.24.0-255,5738,90447,7,301743
44434,0.002223,172.31.36.0-255,66,90513,7,301743
44435,0.002229,74.125.24.0-255,5738,96251,7,301743
44436,0.002231,172.31.36.0-255,66,96317,7,301743
44437,0.002271,172.31.36.0-255,66,96383,7,301743
44438,0.002276,74.125.24.0-255,5020,101403,7,301743
44439,0.002279,172.31.36.0-255,66,101469,7,301743
44440,0.00458,74.125.24.0-255,5738,107207,7,301743
44441,0.004585,172.31.36.0-255,66,107273,7,301743
44442,0.006846,74.125.24.0-255,5738,113011,7,301743
44443,0.006853,172.31.36.0-255,66,113077,7,301743
44444,0.009114,74.125.24.0-255,5738,118815,7,301743
44445,0.009122,172.31.36.0-255,66,118881,7,301743
44446,0.011443,74.125.24.0-255,5738,124619,7,301743
44447,0.011451,172.31.36.0-255,66,124685,7,301743
44448,0.013728,74.125.24.0-255,5738,130423,7,301743
44449,0.013736,172.31.36.0-255,66,130489,7,301743
44450,0.015999,74.125.24.0-255,5738,136227,7,301743
44451,0.016006,172.31.36.0-255,66,136293,7,301743
44452,0.018299,74.125.24.0-255,5738,142031,7,301743
44453,0.018306,172.31.36.0-255,66,142097,7,301743
44454,0.020585,74.125.24.0-255,5738,147835,7,301743
44455,0.020593,172.31.36.0-255,66,147901,7,301743
44456,0.022857,74.125.24.0-255,5738,153639,7,301743
44457,0.022864,172.31.36.0-255,66,153705,7,301743
44458,0.023946,172.31.36.0-255,172,153877,7,301743
44459,0.023989,172.31.36.0-255,1112,154989,7,301743
44460,0.02415,172.31.36.0-255,1514,156503,7,301743
44461,0.024152,172.31.36.0-255,1294,157797,7,301743
44462,0.025131,74.125.24.0-255,5738,163535,7,301743
44463,0.025139,172.31.36.0-255,66,163601,7,301743
44464,0.025471,104.244.42.0-255,66,163667,7,301743
44465,0.025512,104.244.42.0-255,66,163733,7,301743
44466,0.025716,104.244.42.0-255,66,163799,7,301743
44467,0.027395,74.125.24.0-255,5738,169537,7,301743
44468,0.027399,172.31.36.0-255,66,169603,7,301743
44469,0.029683,74.125.24.0-255,5738,175341,7,301743
44470,0.029689,172.31.36.0-255,66,175407,7,301743
44471,0.031948,74.125.24.0-255,5738,181145,7,301743
44472,0.031954,172.31.36.0-255,66,181211,7,301743
44473,0.034255,74.125.24.0-255,5738,186949,7,301743
44474,0.034263,172.31.36.0-255,66,187015,7,301743
44475,0.036572,74.125.24.0-255,5738,192753,7,301743
44476,0.036578,172.31.36.0-255,66,192819,7,301743
44477,0.038862,74.125.24.0-255,5738,198557,7,301743
44478,0.038867,172.31.36.0-255,66,198623,7,301743
44479,0.041135,74.125.24.0-255,4320,202943,7,301743
44480,0.041142,172.31.36.0-255,66,203009,7,301743
44481,0.041171,74.125.24.0-255,1484,204493,7,301743
44482,0.043434,74.125.24.0-255,4320,208813,7,301743
44483,0.04344,172.31.36.0-255,66,208879,7,301743
44484,0.045716,74.125.24.0-255,5738,214617,7,301743
44485,0.045722,172.31.36.0-255,66,214683,7,301743
44486,0.047991,74.125.24.0-255,5738,220421,7,301743
44487,0.047996,172.31.36.0-255,66,220487,7,301743
44488,0.05028,74.125.24.0-255,5738,226225,7,301743
44489,0.050285,172.31.36.0-255,66,226291,7,301743
44490,0.052556,74.125.24.0-255,5738,232029,7,301743
44491,0.052561,172.31.36.0-255,66,232095,7,301743
44492,0.054842,74.125.24.0-255,5738,237833,7,301743
44493,0.054846,172.31.36.0-255,66,237899,7,301743
44494,0.057117,74.125.24.0-255,5738,243637,7,301743
44495,0.057122,172.31.36.0-255,66,243703,7,301743
44496,0.059377,74.125.24.0-255,5738,249441,7,301743
44497,0.059383,172.31.36.0-255,66,249507,7,301743
44498,0.061634,74.125.24.0-255,5738,255245,7,301743
44499,0.061639,172.31.36.0-255,66,255311,7,301743
44500,0.063914,74.125.24.0-255,5738,261049,7,301743
44501,0.06392,172.31.36.0-255,66,261115,7,301743
44502,0.066179,74.125.24.0-255,5738,266853,7,301743
44503,0.066183,172.31.36.0-255,66,266919,7,301743
44504,0.068455,74.125.24.0-255,5738,272657,7,301743
44505,0.068459,172.31.36.0-255,66,272723,7,301743
44506,0.070705,74.125.24.0-255,5738,278461,7,301743
44507,0.070709,172.31.36.0-255,66,278527,7,301743
44508,0.072974,74.125.24.0-255,5738,284265,7,301743
44509,0.072981,172.31.36.0-255,66,284331,7,301743
44510,0.07525,74.125.24.0-255,5738,290069,7,301743
44511,0.075256,172.31.36.0-255,66,290135,7,301743
44512,0.077563,74.125.24.0-255,5738,295873,7,301743
44513,0.077585,172.31.36.0-255,66,295939,7,301743
44514,0.079841,74.125.24.0-255,5738,301677,7,301743
44515,0.079846,172.31.36.0-255,66,301743,7,301743
44516,0.0,172.217.194.0-255,298,298,7,310048
44517,2.8e-05,172.31.36.0-255,66,364,7,310048
44518,3.4e-05,172.217.194.0-255,1484,1848,7,310048
44519,3.8e-05,172.31.36.0-255,66,1914,7,310048
44520,4.3e-05,172.217.194.0-255,2902,4816,7,310048
44521,5.3e-05,172.31.36.0-255,66,4882,7,310048
44522,6e-05,172.217.194.0-255,5738,10620,7,310048
44523,6.3e-05,172.31.36.0-255,66,10686,7,310048
44524,9.9e-05,172.217.194.0-255,5738,16424,7,310048
44525,0.000102,172.31.36.0-255,66,16490,7,310048
44526,0.000135,172.31.36.0-255,66,16556,7,310048
44527,0.000143,172.217.194.0-255,6797,23353,7,310048
44528,0.000145,172.31.36.0-255,66,23419,7,310048
44529,0.000194,172.217.194.0-255,1484,24903,7,310048
44530,0.000198,172.31.36.0-255,66,24969,7,310048
44531,0.000203,172.217.194.0-255,2902,27871,7,310048
44532,0.000204,172.31.36.0-255,66,27937,7,310048
44533,0.000208,172.217.194.0-255,2902,30839,7,310048
44534,0.00021,172.31.36.0-255,66,30905,7,310048
44535,0.000237,172.217.194.0-255,2902,33807,7,310048
44536,0.000239,172.31.36.0-255,66,33873,7,310048
44537,0.000245,172.217.194.0-255,2902,36775,7,310048
44538,0.000247,172.31.36.0-255,66,36841,7,310048
44539,0.000285,172.31.36.0-255,66,36907,7,310048
44540,0.000322,172.31.36.0-255,66,36973,7,310048
44541,0.00039,172.217.194.0-255,381,37354,7,310048
44542,0.000393,172.31.36.0-255,66,37420,7,310048
44543,0.000771,172.217.194.0-255,1484,38904,7,310048
44544,0.000775,172.31.36.0-255,66,38970,7,310048
44545,0.000779,172.217.194.0-255,1484,40454,7,310048
44546,0.000803,172.217.194.0-255,1484,41938,7,310048
44547,0.000806,172.31.36.0-255,66,42004,7,310048
44548,0.000813,172.217.194.0-255,5738,47742,7,310048
44549,0.000816,172.31.36.0-255,66,47808,7,310048
44550,0.000822,172.217.194.0-255,5738,53546,7,310048
44551,0.000824,172.31.36.0-255,66,53612,7,310048
44552,0.000831,172.217.194.0-255,7156,60768,7,310048
44553,0.000834,172.31.36.0-255,66,60834,7,310048
44554,0.000893,172.31.36.0-255,66,60900,7,310048
44555,0.00125,172.217.194.0-255,1484,62384,7,310048
44556,0.001259,172.217.194.0-255,2902,65286,7,310048
44557,0.001263,172.31.36.0-255,66,65352,7,310048
44558,0.001268,172.217.194.0-255,1484,66836,7,310048
44559,0.001289,172.217.194.0-255,4320,71156,7,310048
44560,0.001292,172.31.36.0-255,66,71222,7,310048
44561,0.001298,172.217.194.0-255,4320,75542,7,310048
44562,0.001301,172.31.36.0-255,66,75608,7,310048
44563,0.001337,172.31.36.0-255,66,75674,7,310048
44564,0.00135,172.31.36.0-255,66,75740,7,310048
44565,0.001499,172.217.194.0-255,1484,77224,7,310048
44566,0.001518,172.217.194.0-255,1484,78708,7,310048
44567,0.001522,172.31.36.0-255,66,78774,7,310048
44568,0.001539,172.217.194.0-255,1484,80258,7,310048
44569,0.001549,172.217.194.0-255,4320,84578,7,310048
44570,0.001552,172.31.36.0-255,66,84644,7,310048
44571,0.001561,172.31.36.0-255,66,84710,7,310048
44572,0.001574,172.217.194.0-255,2902,87612,7,310048
44573,0.001576,172.31.36.0-255,66,87678,7,310048
44574,0.001618,172.31.36.0-255,66,87744,7,310048
44575,0.001624,172.217.194.0-255,4320,92064,7,310048
44576,0.001627,172.31.36.0-255,66,92130,7,310048
44577,0.001671,172.31.36.0-255,66,92196,7,310048
44578,0.001678,172.217.194.0-255,5738,97934,7,310048
44579,0.00168,172.31.36.0-255,66,98000,7,310048
44580,0.001725,172.31.36.0-255,66,98066,7,310048
44581,0.002243,172.217.194.0-255,1484,99550,7,310048
44582,0.002251,172.217.194.0-255,2902,102452,7,310048
44583,0.002256,172.31.36.0-255,66,102518,7,310048
44584,0.002264,172.217.194.0-255,5738,108256,7,310048
44585,0.002266,172.31.36.0-255,66,108322,7,310048
44586,0.004474,172.217.194.0-255,5738,114060,7,310048
44587,0.004481,172.31.36.0-255,66,114126,7,310048
44588,0.006725,172.217.194.0-255,5738,119864,7,310048
44589,0.006731,172.31.36.0-255,66,119930,7,310048
44590,0.00896,172.217.194.0-255,5738,125668,7,310048
44591,0.008966,172.31.36.0-255,66,125734,7,310048
44592,0.01119,172.217.194.0-255,5738,131472,7,310048
44593,0.0112,172.31.36.0-255,66,131538,7,310048
44594,0.013439,172.217.194.0-255,5738,137276,7,310048
44595,0.013447,172.31.36.0-255,66,137342,7,310048
44596,0.015684,172.217.194.0-255,5738,143080,7,310048
44597,0.015694,172.31.36.0-255,66,143146,7,310048
44598,0.017922,172.217.194.0-255,5738,148884,7,310048
44599,0.01793,172.31.36.0-255,66,148950,7,310048
44600,0.020172,172.217.194.0-255,5738,154688,7,310048
44601,0.02018,172.31.36.0-255,66,154754,7,310048
44602,0.022398,172.217.194.0-255,5738,160492,7,310048
44603,0.022407,172.31.36.0-255,66,160558,7,310048
44604,0.024634,172.217.194.0-255,5738,166296,7,310048
44605,0.024641,172.31.36.0-255,66,166362,7,310048
44606,0.026876,172.217.194.0-255,5738,172100,7,310048
44607,0.026884,172.31.36.0-255,66,172166,7,310048
44608,0.029166,172.217.194.0-255,5738,177904,7,310048
44609,0.029173,172.31.36.0-255,66,177970,7,310048
44610,0.03141,172.217.194.0-255,5738,183708,7,310048
44611,0.031418,172.31.36.0-255,66,183774,7,310048
44612,0.033636,172.217.194.0-255,5738,189512,7,310048
44613,0.033643,172.31.36.0-255,66,189578,7,310048
44614,0.033936,172.31.36.0-255,172,189750,7,310048
44615,0.033995,172.31.36.0-255,1115,190865,7,310048
44616,0.034049,172.31.36.0-255,1514,192379,7,310048
44617,0.034051,172.31.36.0-255,1291,193670,7,310048
44618,0.035515,104.244.42.0-255,66,193736,7,310048
44619,0.03556,104.244.42.0-255,66,193802,7,310048
44620,0.035617,104.244.42.0-255,66,193868,7,310048
44621,0.035873,172.217.194.0-255,4320,198188,7,310048
44622,0.035878,172.31.36.0-255,66,198254,7,310048
44623,0.03591,172.217.194.0-255,1484,199738,7,310048
44624,0.038105,172.217.194.0-255,4320,204058,7,310048
44625,0.038113,172.31.36.0-255,66,204124,7,310048
44626,0.040336,172.217.194.0-255,5738,209862,7,310048
44627,0.040341,172.31.36.0-255,66,209928,7,310048
44628,0.042557,172.217.194.0-255,5738,215666,7,310048
44629,0.042562,172.31.36.0-255,66,215732,7,310048
44630,0.044822,172.217.194.0-255,5738,221470,7,310048
44631,0.044827,172.31.36.0-255,66,221536,7,310048
44632,0.047064,172.217.194.0-255,5738,227274,7,310048
44633,0.047069,172.31.36.0-255,66,227340,7,310048
44634,0.049304,172.217.194.0-255,5738,233078,7,310048
44635,0.04931,172.31.36.0-255,66,233144,7,310048
44636,0.051517,172.217.194.0-255,5738,238882,7,310048
44637,0.051524,172.31.36.0-255,66,238948,7,310048
44638,0.053764,172.217.194.0-255,5738,244686,7,310048
44639,0.053771,172.31.36.0-255,66,244752,7,310048
44640,0.056005,172.217.194.0-255,2902,247654,7,310048
44641,0.056013,172.31.36.0-255,66,247720,7,310048
44642,0.056053,172.217.194.0-255,2902,250622,7,310048
44643,0.056057,172.31.36.0-255,66,250688,7,310048
44644,0.058249,172.217.194.0-255,2902,253590,7,310048
44645,0.058254,172.31.36.0-255,66,253656,7,310048
44646,0.058291,172.217.194.0-255,2902,256558,7,310048
44647,0.058295,172.31.36.0-255,66,256624,7,310048
44648,0.060464,172.217.194.0-255,2902,259526,7,310048
44649,0.06047,172.31.36.0-255,66,259592,7,310048
44650,0.060504,172.217.194.0-255,2902,262494,7,310048
44651,0.060506,172.31.36.0-255,66,262560,7,310048
44652,0.062668,172.217.194.0-255,2902,265462,7,310048
44653,0.062674,172.31.36.0-255,66,265528,7,310048
44654,0.062719,172.217.194.0-255,2902,268430,7,310048
44655,0.062723,172.31.36.0-255,66,268496,7,310048
44656,0.064905,172.217.194.0-255,2902,271398,7,310048
44657,0.06491,172.31.36.0-255,66,271464,7,310048
44658,0.064952,172.217.194.0-255,2902,274366,7,310048
44659,0.064956,172.31.36.0-255,66,274432,7,310048
44660,0.067121,172.217.194.0-255,2902,277334,7,310048
44661,0.067127,172.31.36.0-255,66,277400,7,310048
44662,0.067175,172.217.194.0-255,2902,280302,7,310048
44663,0.067179,172.31.36.0-255,66,280368,7,310048
44664,0.069417,172.217.194.0-255,2902,283270,7,310048
44665,0.069423,172.31.36.0-255,66,283336,7,310048
44666,0.069483,172.217.194.0-255,2902,286238,7,310048
44667,0.069486,172.31.36.0-255,66,286304,7,310048
44668,0.071653,172.217.194.0-255,2902,289206,7,310048
44669,0.07166,172.31.36.0-255,66,289272,7,310048
44670,0.0717,172.217.194.0-255,2902,292174,7,310048
44671,0.071703,172.31.36.0-255,66,292240,7,310048
44672,0.073864,172.217.194.0-255,2902,295142,7,310048
44673,0.07387,172.31.36.0-255,66,295208,7,310048
44674,0.073903,172.217.194.0-255,2902,298110,7,310048
44675,0.073906,172.31.36.0-255,66,298176,7,310048
44676,0.076093,172.217.194.0-255,2902,301078,7,310048
44677,0.076098,172.31.36.0-255,66,301144,7,310048
44678,0.076136,172.217.194.0-255,2902,304046,7,310048
44679,0.07614,172.31.36.0-255,66,304112,7,310048
44680,0.078308,172.217.194.0-255,2902,307014,7,310048
44681,0.078313,172.31.36.0-255,66,307080,7,310048
44682,0.078352,172.217.194.0-255,2902,309982,7,310048
44683,0.078354,172.31.36.0-255,66,310048,7,310048
44684,0.0,74.125.68.0-255,153,153,7,362809
44685,2.8e-05,172.31.36.0-255,66,219,7,362809
44686,3.6e-05,74.125.68.0-255,1484,1703,7,362809
44687,4.1e-05,172.31.36.0-255,66,1769,7,362809
44688,5.7e-05,74.125.68.0-255,2902,4671,7,362809
44689,6e-05,172.31.36.0-255,66,4737,7,362809
44690,6.6e-05,74.125.68.0-255,4320,9057,7,362809
44691,6.9e-05,172.31.36.0-255,66,9123,7,362809
44692,9.4e-05,74.125.68.0-255,1484,10607,7,362809
44693,9.8e-05,172.31.36.0-255,66,10673,7,362809
44694,0.000104,74.125.68.0-255,3471,14144,7,362809
44695,0.000107,172.31.36.0-255,66,14210,7,362809
44696,0.000142,74.125.68.0-255,2902,17112,7,362809
44697,0.000145,172.31.36.0-255,66,17178,7,362809
44698,0.000162,74.125.68.0-255,4320,21498,7,362809
44699,0.000166,172.31.36.0-255,66,21564,7,362809
44700,0.000194,172.31.36.0-255,66,21630,7,362809
44701,0.000197,74.125.68.0-255,1125,22755,7,362809
44702,0.000199,172.31.36.0-255,66,22821,7,362809
44703,0.000245,74.125.68.0-255,1484,24305,7,362809
44704,0.000248,172.31.36.0-255,66,24371,7,362809
44705,0.000266,74.125.68.0-255,2902,27273,7,362809
44706,0.00027,172.31.36.0-255,66,27339,7,362809
44707,0.000297,74.125.68.0-255,5738,33077,7,362809
44708,0.0003,172.31.36.0-255,66,33143,7,362809
44709,0.000305,74.125.68.0-255,4320,37463,7,362809
44710,0.000307,172.31.36.0-255,66,37529,7,362809
44711,0.000353,74.125.68.0-255,2543,40072,7,362809
44712,0.000357,172.31.36.0-255,66,40138,7,362809
44713,0.000384,74.125.68.0-255,2902,43040,7,362809
44714,0.000388,172.31.36.0-255,66,43106,7,362809
44715,0.000391,74.125.68.0-255,1484,44590,7,362809
44716,0.000405,74.125.68.0-255,1484,46074,7,362809
44717,0.00041,74.125.68.0-255,4320,50394,7,362809
44718,0.000411,172.31.36.0-255,66,50460,7,362809
44719,0.000431,172.31.36.0-255,66,50526,7,362809
44720,0.000458,74.125.68.0-255,6797,57323,7,362809
44721,0.000472,74.125.68.0-255,398,57721,7,362809
44722,0.000474,172.31.36.0-255,66,57787,7,362809
44723,0.000656,74.125.68.0-255,111,57898,7,362809
44724,0.000799,172.31.36.0-255,66,57964,7,362809
44725,0.000884,74.125.68.0-255,331,58295,7,362809
44726,0.001101,74.125.68.0-255,1484,59779,7,362809
44727,0.001118,74.125.68.0-255,2902,62681,7,362809
44728,0.001134,74.125.68.0-255,5738,68419,7,362809
44729,0.001148,74.125.68.0-255,1484,69903,7,362809
44730,0.001164,74.125.68.0-255,4320,74223,7,362809
44731,0.001206,74.125.68.0-255,1125,75348,7,362809
44732,0.00121,74.125.68.0-255,1484,76832,7,362809
44733,0.001223,74.125.68.0-255,1484,78316,7,362809
44734,0.001235,74.125.68.0-255,2902,81218,7,362809
44735,0.00126,74.125.68.0-255,7156,88374,7,362809
44736,0.001276,74.125.68.0-255,2902,91276,7,362809
44737,0.001295,74.125.68.0-255,1125,92401,7,362809
44738,0.002014,74.125.68.0-255,1484,93885,7,362809
44739,0.002021,74.125.68.0-255,2902,96787,7,362809
44740,0.002041,74.125.68.0-255,4320,101107,7,362809
44741,0.002065,74.125.68.0-255,5738,106845,7,362809
44742,0.002078,74.125.68.0-255,2902,109747,7,362809
44743,0.002085,74.125.68.0-255,7156,116903,7,362809
44744,0.002101,74.125.68.0-255,5738,122641,7,362809
44745,0.002114,74.125.68.0-255,2902,125543,7,362809
44746,0.002116,74.125.68.0-255,766,126309,7,362809
44747,0.002178,74.125.68.0-255,1484,127793,7,362809
44748,0.00219,74.125.68.0-255,2902,130695,7,362809
44749,0.002209,74.125.68.0-255,5738,136433,7,362809
44750,0.002232,74.125.68.0-255,5738,142171,7,362809
44751,0.002247,74.125.68.0-255,1484,143655,7,362809
44752,0.002253,74.125.68.0-255,5738,149393,7,362809
44753,0.002263,74.125.68.0-255,2902,152295,7,362809
44754,0.002283,74.125.68.0-255,2902,155197,7,362809
44755,0.002303,74.125.68.0-255,5020,160217,7,362809
44756,0.0025,74.125.68.0-255,1484,161701,7,362809
44757,0.002515,74.125.68.0-255,2902,164603,7,362809
44758,0.00253,74.125.68.0-255,1484,166087,7,362809
44759,0.002532,74.125.68.0-255,1484,167571,7,362809
44760,0.002546,74.125.68.0-255,1484,169055,7,362809
44761,0.002561,74.125.68.0-255,5738,174793,7,362809
44762,0.002592,74.125.68.0-255,5738,180531,7,362809
44763,0.00261,74.125.68.0-255,5738,186269,7,362809
44764,0.002635,74.125.68.0-255,4320,190589,7,362809
44765,0.002648,74.125.68.0-255,3602,194191,7,362809
44766,0.00323,172.31.36.0-255,66,194257,7,362809
44767,0.00585,74.125.68.0-255,5738,199995,7,362809
44768,0.005856,172.31.36.0-255,66,200061,7,362809
44769,0.008455,74.125.68.0-255,5738,205799,7,362809
44770,0.008462,172.31.36.0-255,66,205865,7,362809
44771,0.011084,74.125.68.0-255,5738,211603,7,362809
44772,0.011093,172.31.36.0-255,66,211669,7,362809
44773,0.013696,74.125.68.0-255,5738,217407,7,362809
44774,0.013704,172.31.36.0-255,66,217473,7,362809
44775,0.016312,74.125.68.0-255,5738,223211,7,362809
44776,0.016322,172.31.36.0-255,66,223277,7,362809
44777,0.018925,74.125.68.0-255,5738,229015,7,362809
44778,0.018933,172.31.36.0-255,66,229081,7,362809
44779,0.021539,74.125.68.0-255,5738,234819,7,362809
44780,0.021548,172.31.36.0-255,66,234885,7,362809
44781,0.024152,74.125.68.0-255,5738,240623,7,362809
44782,0.024161,172.31.36.0-255,66,240689,7,362809
44783,0.026759,74.125.68.0-255,5738,246427,7,362809
44784,0.026767,172.31.36.0-255,66,246493,7,362809
44785,0.029308,172.31.36.0-255,172,246665,7,362809
44786,0.029339,172.31.36.0-255,1115,247780,7,362809
44787,0.029374,74.125.68.0-255,5738,253518,7,362809
44788,0.029376,172.31.36.0-255,1514,255032,7,362809
44789,0.029378,172.31.36.0-255,1293,256325,7,362809
44790,0.029379,172.31.36.0-255,66,256391,7,362809
44791,0.030837,104.244.42.0-255,66,256457,7,362809
44792,0.030869,104.244.42.0-255,66,256523,7,362809
44793,0.030906,104.244.42.0-255,66,256589,7,362809
44794,0.031998,74.125.68.0-255,4320,260909,7,362809
44795,0.032003,172.31.36.0-255,66,260975,7,362809
44796,0.032037,74.125.68.0-255,1484,262459,7,362809
44797,0.034604,74.125.68.0-255,4320,266779,7,362809
44798,0.03461,172.31.36.0-255,66,266845,7,362809
44799,0.037211,74.125.68.0-255,5738,272583,7,362809
44800,0.037264,172.31.36.0-255,66,272649,7,362809
44801,0.039865,74.125.68.0-255,5738,278387,7,362809
44802,0.039871,172.31.36.0-255,66,278453,7,362809
44803,0.042458,74.125.68.0-255,5738,284191,7,362809
44804,0.042464,172.31.36.0-255,66,284257,7,362809
44805,0.045053,74.125.68.0-255,5738,289995,7,362809
44806,0.045059,172.31.36.0-255,66,290061,7,362809
44807,0.047671,74.125.68.0-255,5738,295799,7,362809
44808,0.047676,172.31.36.0-255,66,295865,7,362809
44809,0.050267,74.125.68.0-255,5738,301603,7,362809
44810,0.050273,172.31.36.0-255,66,301669,7,362809
44811,0.052869,74.125.68.0-255,4320,305989,7,362809
44812,0.052875,172.31.36.0-255,66,306055,7,362809
44813,0.052907,74.125.68.0-255,1484,307539,7,362809
44814,0.055474,74.125.68.0-255,4320,311859,7,362809
44815,0.05548,172.31.36.0-255,66,311925,7,362809
44816,0.058067,74.125.68.0-255,5738,317663,7,362809
44817,0.05812,172.31.36.0-255,66,317729,7,362809
44818,0.060715,74.125.68.0-255,5738,323467,7,362809
44819,0.060721,172.31.36.0-255,66,323533,7,362809
44820,0.063321,74.125.68.0-255,5738,329271,7,362809
44821,0.063327,172.31.36.0-255,66,329337,7,362809
44822,0.065916,74.125.68.0-255,4320,333657,7,362809
44823,0.065921,172.31.36.0-255,66,333723,7,362809
44824,0.065947,74.125.68.0-255,1484,335207,7,362809
44825,0.068512,74.125.68.0-255,4320,339527,7,362809
44826,0.068518,172.31.36.0-255,66,339593,7,362809
44827,0.071119,74.125.68.0-255,5738,345331,7,362809
44828,0.071181,172.31.36.0-255,66,345397,7,362809
44829,0.073789,74.125.68.0-255,5738,351135,7,362809
44830,0.073796,172.31.36.0-255,66,351201,7,362809
44831,0.076398,74.125.68.0-255,5738,356939,7,362809
44832,0.076405,172.31.36.0-255,66,357005,7,362809
44833,0.079004,74.125.68.0-255,5738,362743,7,362809
44834,0.079009,172.31.36.0-255,66,362809,7,362809
44835,0.0,172.217.194.0-255,156,156,7,286752
44836,2.1e-05,172.31.36.0-255,66,222,7,286752
44837,2.9e-05,172.217.194.0-255,1484,1706,7,286752
44838,3.4e-05,172.31.36.0-255,66,1772,7,286752
44839,5.1e-05,172.217.194.0-255,1484,3256,7,286752
44840,5.4e-05,172.31.36.0-255,66,3322,7,286752
44841,6.8e-05,172.217.194.0-255,1484,4806,7,286752
44842,7.1e-05,172.31.36.0-255,66,4872,7,286752
44843,9e-05,172.217.194.0-255,1484,6356,7,286752
44844,9.2e-05,172.31.36.0-255,66,6422,7,286752
44845,0.0001,172.217.194.0-255,4320,10742,7,286752
44846,0.000103,172.31.36.0-255,66,10808,7,286752
44847,0.000148,172.217.194.0-255,4914,15722,7,286752
44848,0.000152,172.31.36.0-255,66,15788,7,286752
44849,0.000187,172.217.194.0-255,5738,21526,7,286752
44850,0.00019,172.31.36.0-255,66,21592,7,286752
44851,0.000207,172.217.194.0-255,1484,23076,7,286752
44852,0.000209,172.31.36.0-255,66,23142,7,286752
44853,0.000228,172.217.194.0-255,4320,27462,7,286752
44854,0.00023,172.31.36.0-255,66,27528,7,286752
44855,0.000237,172.217.194.0-255,7156,34684,7,286752
44856,0.000239,172.31.36.0-255,66,34750,7,286752
44857,0.000255,172.217.194.0-255,1484,36234,7,286752
44858,0.000257,172.31.36.0-255,66,36300,7,286752
44859,0.000295,172.31.36.0-255,66,36366,7,286752
44860,0.000308,172.217.194.0-255,3602,39968,7,286752
44861,0.00031,172.31.36.0-255,66,40034,7,286752
44862,0.000847,172.217.194.0-255,1484,41518,7,286752
44863,0.000853,172.31.36.0-255,66,41584,7,286752
44864,0.000859,172.217.194.0-255,2902,44486,7,286752
44865,0.000861,172.31.36.0-255,66,44552,7,286752
44866,0.000901,172.217.194.0-255,5738,50290,7,286752
44867,0.000931,172.217.194.0-255,7102,57392,7,286752
44868,0.000965,172.31.36.0-255,66,57458,7,286752
44869,0.002967,172.217.194.0-255,5738,63196,7,286752
44870,0.002975,172.31.36.0-255,66,63262,7,286752
44871,0.004942,172.217.194.0-255,5738,69000,7,286752
44872,0.006029,172.31.36.0-255,66,69066,7,286752
44873,0.00798,172.217.194.0-255,5738,74804,7,286752
44874,0.007988,172.31.36.0-255,66,74870,7,286752
44875,0.009976,172.217.194.0-255,5738,80608,7,286752
44876,0.01044,172.31.36.0-255,66,80674,7,286752
44877,0.012419,172.217.194.0-255,5738,86412,7,286752
44878,0.012427,172.31.36.0-255,66,86478,7,286752
44879,0.01442,172.217.194.0-255,5738,92216,7,286752
44880,0.014429,172.31.36.0-255,66,92282,7,286752
44881,0.016384,172.217.194.0-255,5738,98020,7,286752
44882,0.016391,172.31.36.0-255,66,98086,7,286752
44883,0.018375,172.217.194.0-255,5738,103824,7,286752
44884,0.018383,172.31.36.0-255,66,103890,7,286752
44885,0.020363,172.217.194.0-255,5738,109628,7,286752
44886,0.020373,172.31.36.0-255,66,109694,7,286752
44887,0.022348,172.217.194.0-255,5738,115432,7,286752
44888,0.022356,172.31.36.0-255,66,115498,7,286752
44889,0.024385,172.217.194.0-255,5738,121236,7,286752
44890,0.024394,172.31.36.0-255,66,121302,7,286752
44891,0.026355,172.217.194.0-255,5738,127040,7,286752
44892,0.026364,172.31.36.0-255,66,127106,7,286752
44893,0.028181,172.31.36.0-255,172,127278,7,286752
44894,0.028211,172.31.36.0-255,1114,128392,7,286752
44895,0.028272,172.31.36.0-255,1514,129906,7,286752
44896,0.028274,172.31.36.0-255,1292,131198,7,286752
44897,0.028352,172.217.194.0-255,5738,136936,7,286752
44898,0.028357,172.31.36.0-255,66,137002,7,286752
44899,0.02972,104.244.42.0-255,66,137068,7,286752
44900,0.02981,104.244.42.0-255,66,137134,7,286752
44901,0.029815,104.244.42.0-255,66,137200,7,286752
44902,0.03032,172.217.194.0-255,5738,142938,7,286752
44903,0.030327,172.31.36.0-255,66,143004,7,286752
44904,0.032279,172.217.194.0-255,5738,148742,7,286752
44905,0.032287,172.31.36.0-255,66,148808,7,286752
44906,0.034241,172.217.194.0-255,5738,154546,7,286752
44907,0.034249,172.31.36.0-255,66,154612,7,286752
44908,0.036218,172.217.194.0-255,5738,160350,7,286752
44909,0.036226,172.31.36.0-255,66,160416,7,286752
44910,0.038191,172.217.194.0-255,5738,166154,7,286752
44911,0.038198,172.31.36.0-255,66,166220,7,286752
44912,0.040135,172.217.194.0-255,5738,171958,7,286752
44913,0.040143,172.31.36.0-255,66,172024,7,286752
44914,0.04212,172.217.194.0-255,5738,177762,7,286752
44915,0.042138,172.31.36.0-255,66,177828,7,286752
44916,0.044154,172.217.194.0-255,5738,183566,7,286752
44917,0.044172,172.31.36.0-255,66,183632,7,286752
44918,0.04615,172.217.194.0-255,5738,189370,7,286752
44919,0.046166,172.31.36.0-255,66,189436,7,286752
44920,0.048138,172.217.194.0-255,5738,195174,7,286752
44921,0.04815,172.31.36.0-255,66,195240,7,286752
44922,0.050125,172.217.194.0-255,5738,200978,7,286752
44923,0.050133,172.31.36.0-255,66,201044,7,286752
44924,0.052133,172.217.194.0-255,5738,206782,7,286752
44925,0.052141,172.31.36.0-255,66,206848,7,286752
44926,0.054108,172.217.194.0-255,5738,212586,7,286752
44927,0.054116,172.31.36.0-255,66,212652,7,286752
44928,0.056078,172.217.194.0-255,5738,218390,7,286752
44929,0.056086,172.31.36.0-255,66,218456,7,286752
44930,0.058059,172.217.194.0-255,5738,224194,7,286752
44931,0.058066,172.31.36.0-255,66,224260,7,286752
44932,0.060001,172.217.194.0-255,5738,229998,7,286752
44933,0.060009,172.31.36.0-255,66,230064,7,286752
44934,0.062007,172.217.194.0-255,5738,235802,7,286752
44935,0.062016,172.31.36.0-255,66,235868,7,286752
44936,0.063978,172.217.194.0-255,5738,241606,7,286752
44937,0.063986,172.31.36.0-255,66,241672,7,286752
44938,0.065935,172.217.194.0-255,5738,247410,7,286752
44939,0.065942,172.31.36.0-255,66,247476,7,286752
44940,0.067906,172.217.194.0-255,5738,253214,7,286752
44941,0.067913,172.31.36.0-255,66,253280,7,286752
44942,0.069865,172.217.194.0-255,4320,257600,7,286752
44943,0.069872,172.31.36.0-255,66,257666,7,286752
44944,0.069891,172.217.194.0-255,1484,259150,7,286752
44945,0.071827,172.217.194.0-255,4320,263470,7,286752
44946,0.071835,172.31.36.0-255,66,263536,7,286752
44947,0.073796,172.217.194.0-255,5738,269274,7,286752
44948,0.073861,172.31.36.0-255,66,269340,7,286752
44949,0.075885,172.217.194.0-255,5738,275078,7,286752
44950,0.075895,172.31.36.0-255,66,275144,7,286752
44951,0.077876,172.217.194.0-255,5738,280882,7,286752
44952,0.077884,172.31.36.0-255,66,280948,7,286752
44953,0.079894,172.217.194.0-255,5738,286686,7,286752
44954,0.079901,172.31.36.0-255,66,286752,7,286752
44955,0.0,74.125.200.0-255,153,153,7,272986
44956,2.7e-05,172.31.36.0-255,66,219,7,272986
44957,3.4e-05,74.125.200.0-255,1484,1703,7,272986
44958,3.8e-05,172.31.36.0-255,66,1769,7,272986
44959,4.1e-05,74.125.200.0-255,1484,3253,7,272986
44960,4.4e-05,172.31.36.0-255,66,3319,7,272986
44961,6.5e-05,74.125.200.0-255,1484,4803,7,272986
44962,6.8e-05,172.31.36.0-255,66,4869,7,272986
44963,8.3e-05,74.125.200.0-255,4320,9189,7,272986
44964,8.6e-05,172.31.36.0-255,66,9255,7,272986
44965,0.000104,74.125.200.0-255,1484,10739,7,272986
44966,0.000106,172.31.36.0-255,66,10805,7,272986
44967,0.000128,74.125.200.0-255,6257,17062,7,272986
44968,0.000131,172.31.36.0-255,66,17128,7,272986
44969,0.000134,74.125.200.0-255,1484,18612,7,272986
44970,0.000136,172.31.36.0-255,66,18678,7,272986
44971,0.000148,74.125.200.0-255,1484,20162,7,272986
44972,0.00015,172.31.36.0-255,66,20228,7,272986
44973,0.000164,74.125.200.0-255,1484,21712,7,272986
44974,0.000167,172.31.36.0-255,66,21778,7,272986
44975,0.000193,74.125.200.0-255,5738,27516,7,272986
44976,0.000196,172.31.36.0-255,66,27582,7,272986
44977,0.0002,74.125.200.0-255,2902,30484,7,272986
44978,0.000203,172.31.36.0-255,66,30550,7,272986
44979,0.000208,74.125.200.0-255,4320,34870,7,272986
44980,0.00021,172.31.36.0-255,66,34936,7,272986
44981,0.000243,172.31.36.0-255,66,35002,7,272986
44982,0.000246,74.125.200.0-255,1484,36486,7,272986
44983,0.000248,172.31.36.0-255,66,36552,7,272986
44984,0.000286,74.125.200.0-255,3602,40154,7,272986
44985,0.00029,172.31.36.0-255,66,40220,7,272986
44986,0.000531,74.125.200.0-255,1484,41704,7,272986
44987,0.000537,74.125.200.0-255,1484,43188,7,272986
44988,0.000541,172.31.36.0-255,66,43254,7,272986
44989,0.000561,74.125.200.0-255,1484,44738,7,272986
44990,0.000568,74.125.200.0-255,5738,50476,7,272986
44991,0.000571,172.31.36.0-255,66,50542,7,272986
44992,0.000618,74.125.200.0-255,7154,57696,7,272986
44993,0.000626,172.31.36.0-255,66,57762,7,272986
44994,0.000875,74.125.200.0-255,1484,59246,7,272986
44995,0.000885,74.125.200.0-255,2902,62148,7,272986
44996,0.000889,172.31.36.0-255,66,62214,7,272986
44997,0.000908,74.125.200.0-255,4320,66534,7,272986
44998,0.000911,172.31.36.0-255,66,66600,7,272986
44999,0.00095,74.125.200.0-255,7156,73756,7,272986
45000,0.000955,172.31.36.0-255,66,73822,7,272986
45001,0.000967,74.125.200.0-255,1484,75306,7,272986
45002,0.000982,74.125.200.0-255,5738,81044,7,272986
45003,0.000985,172.31.36.0-255,66,81110,7,272986
45004,0.001007,74.125.200.0-255,4320,85430,7,272986
45005,0.00101,172.31.36.0-255,66,85496,7,272986
45006,0.001014,74.125.200.0-255,2902,88398,7,272986
45007,0.001016,172.31.36.0-255,66,88464,7,272986
45008,0.001046,74.125.200.0-255,3602,92066,7,272986
45009,0.001049,172.31.36.0-255,66,92132,7,272986
45010,0.00121,74.125.200.0-255,1484,93616,7,272986
45011,0.001217,74.125.200.0-255,2902,96518,7,272986
45012,0.001221,172.31.36.0-255,66,96584,7,272986
45013,0.001244,74.125.200.0-255,5738,102322,7,272986
45014,0.001246,172.31.36.0-255,66,102388,7,272986
45015,0.001252,74.125.200.0-255,4320,106708,7,272986
45016,0.001254,172.31.36.0-255,66,106774,7,272986
45017,0.001259,74.125.200.0-255,2902,109676,7,272986
45018,0.001261,172.31.36.0-255,66,109742,7,272986
45019,0.001279,74.125.200.0-255,2902,112644,7,272986
45020,0.001283,172.31.36.0-255,66,112710,7,272986
45021,0.001286,74.125.200.0-255,1484,114194,7,272986
45022,0.001311,172.31.36.0-255,66,114260,7,272986
45023,0.001316,74.125.200.0-255,2184,116444,7,272986
45024,0.001318,172.31.36.0-255,66,116510,7,272986
45025,0.001352,74.125.200.0-255,4320,120830,7,272986
45026,0.001356,172.31.36.0-255,66,120896,7,272986
45027,0.00138,172.31.36.0-255,66,120962,7,272986
45028,0.001387,74.125.200.0-255,7156,128118,7,272986
45029,0.001391,172.31.36.0-255,66,128184,7,272986
45030,0.001412,172.31.36.0-255,66,128250,7,272986
45031,0.001414,74.125.200.0-255,766,129016,7,272986
45032,0.001469,172.31.36.0-255,66,129082,7,272986
45033,0.001502,172.31.36.0-255,66,129148,7,272986
45034,0.001507,74.125.200.0-255,4320,133468,7,272986
45035,0.00151,172.31.36.0-255,66,133534,7,272986
45036,0.001545,172.31.36.0-255,66,133600,7,272986
45037,0.001577,172.31.36.0-255,66,133666,7,272986
45038,0.001594,74.125.200.0-255,2902,136568,7,272986
45039,0.001596,172.31.36.0-255,66,136634,7,272986
45040,0.001602,74.125.200.0-255,5738,142372,7,272986
45041,0.001604,172.31.36.0-255,66,142438,7,272986
45042,0.001608,74.125.200.0-255,2902,145340,7,272986
45043,0.00161,172.31.36.0-255,66,145406,7,272986
45044,0.001653,172.31.36.0-255,66,145472,7,272986
45045,0.001695,172.31.36.0-255,66,145538,7,272986
45046,0.001736,172.31.36.0-255,66,145604,7,272986
45047,0.001743,74.125.200.0-255,7156,152760,7,272986
45048,0.001745,172.31.36.0-255,66,152826,7,272986
45049,0.00176,172.31.36.0-255,66,152892,7,272986
45050,0.001772,172.31.36.0-255,66,152958,7,272986
45051,0.001792,74.125.200.0-255,5738,158696,7,272986
45052,0.001795,172.31.36.0-255,66,158762,7,272986
45053,0.001801,74.125.200.0-255,4320,163082,7,272986
45054,0.001803,172.31.36.0-255,66,163148,7,272986
45055,0.001827,74.125.200.0-255,2902,166050,7,272986
45056,0.00183,172.31.36.0-255,66,166116,7,272986
45057,0.001855,172.31.36.0-255,66,166182,7,272986
45058,0.00186,74.125.200.0-255,4320,170502,7,272986
45059,0.001863,172.31.36.0-255,66,170568,7,272986
45060,0.0019,172.31.36.0-255,66,170634,7,272986
45061,0.001907,74.125.200.0-255,7156,177790,7,272986
45062,0.001909,172.31.36.0-255,66,177856,7,272986
45063,0.001914,74.125.200.0-255,4320,182176,7,272986
45064,0.001916,172.31.36.0-255,66,182242,7,272986
45065,0.001944,74.125.200.0-255,3602,185844,7,272986
45066,0.001947,172.31.36.0-255,66,185910,7,272986
45067,0.001954,74.125.200.0-255,7156,193066,7,272986
45068,0.001957,172.31.36.0-255,66,193132,7,272986
45069,0.001965,74.125.200.0-255,7156,200288,7,272986
45070,0.002104,172.31.36.0-255,66,200354,7,272986
45071,0.004031,74.125.200.0-255,5738,206092,7,272986
45072,0.004038,172.31.36.0-255,66,206158,7,272986
45073,0.005988,74.125.200.0-255,5738,211896,7,272986
45074,0.005993,172.31.36.0-255,66,211962,7,272986
45075,0.007911,74.125.200.0-255,5738,217700,7,272986
45076,0.007917,172.31.36.0-255,66,217766,7,272986
45077,0.009833,74.125.200.0-255,5738,223504,7,272986
45078,0.00984,172.31.36.0-255,66,223570,7,272986
45079,0.011754,74.125.200.0-255,5738,229308,7,272986
45080,0.011762,172.31.36.0-255,66,229374,7,272986
45081,0.013692,74.125.200.0-255,5738,235112,7,272986
45082,0.013699,172.31.36.0-255,66,235178,7,272986
45083,0.015629,74.125.200.0-255,5738,240916,7,272986
45084,0.015637,172.31.36.0-255,66,240982,7,272986
45085,0.01756,74.125.200.0-255,5738,246720,7,272986
45086,0.017567,172.31.36.0-255,66,246786,7,272986
45087,0.019492,74.125.200.0-255,5738,252524,7,272986
45088,0.019501,172.31.36.0-255,66,252590,7,272986
45089,0.021422,74.125.200.0-255,5738,258328,7,272986
45090,0.021429,172.31.36.0-255,66,258394,7,272986
45091,0.023339,74.125.200.0-255,5165,263559,7,272986
45092,0.023347,172.31.36.0-255,66,263625,7,272986
45093,0.02357,172.31.36.0-255,105,263730,7,272986
45094,0.025447,74.125.200.0-255,66,263796,7,272986
45095,0.034133,172.31.36.0-255,172,263968,7,272986
45096,0.034171,172.31.36.0-255,1113,265081,7,272986
45097,0.034216,172.31.36.0-255,1514,266595,7,272986
45098,0.034217,172.31.36.0-255,1514,268109,7,272986
45099,0.034219,172.31.36.0-255,1514,269623,7,272986
45100,0.034225,172.31.36.0-255,1514,271137,7,272986
45101,0.034226,172.31.36.0-255,1514,272651,7,272986
45102,0.034227,172.31.36.0-255,71,272722,7,272986
45103,0.035677,104.244.42.0-255,66,272788,7,272986
45104,0.035735,104.244.42.0-255,66,272854,7,272986
45105,0.035823,104.244.42.0-255,66,272920,7,272986
45106,0.03583,104.244.42.0-255,66,272986,7,272986
45107,0.0,172.31.36.0-255,66,66,7,66
45108,0.0,172.217.194.0-255,153,153,7,293628
45109,3.4e-05,172.31.36.0-255,66,219,7,293628
45110,4.2e-05,172.217.194.0-255,1484,1703,7,293628
45111,4.7e-05,172.31.36.0-255,66,1769,7,293628
45112,5.3e-05,172.217.194.0-255,2902,4671,7,293628
45113,5.5e-05,172.31.36.0-255,66,4737,7,293628
45114,6.3e-05,172.217.194.0-255,7156,11893,7,293628
45115,6.5e-05,172.31.36.0-255,66,11959,7,293628
45116,0.000104,172.217.194.0-255,2091,14050,7,293628
45117,0.000107,172.31.36.0-255,66,14116,7,293628
45118,0.000139,172.217.194.0-255,1484,15600,7,293628
45119,0.000141,172.31.36.0-255,66,15666,7,293628
45120,0.000159,172.217.194.0-255,2902,18568,7,293628
45121,0.000162,172.31.36.0-255,66,18634,7,293628
45122,0.000165,172.217.194.0-255,1484,20118,7,293628
45123,0.000166,172.31.36.0-255,66,20184,7,293628
45124,0.000196,172.217.194.0-255,4320,24504,7,293628
45125,0.000198,172.31.36.0-255,66,24570,7,293628
45126,0.000218,172.217.194.0-255,1484,26054,7,293628
45127,0.00022,172.31.36.0-255,66,26120,7,293628
45128,0.000243,172.217.194.0-255,5379,31499,7,293628
45129,0.000245,172.31.36.0-255,66,31565,7,293628
45130,0.000652,172.217.194.0-255,1484,33049,7,293628
45131,0.000657,172.31.36.0-255,66,33115,7,293628
45132,0.000667,172.217.194.0-255,2902,36017,7,293628
45133,0.00067,172.31.36.0-255,66,36083,7,293628
45134,0.000676,172.217.194.0-255,5738,41821,7,293628
45135,0.000678,172.31.36.0-255,66,41887,7,293628
45136,0.000683,172.217.194.0-255,4320,46207,7,293628
45137,0.000685,172.31.36.0-255,66,46273,7,293628
45138,0.000704,172.217.194.0-255,1484,47757,7,293628
45139,0.000708,172.31.36.0-255,66,47823,7,293628
45140,0.000738,172.217.194.0-255,5379,53202,7,293628
45141,0.000743,172.217.194.0-255,4256,57458,7,293628
45142,0.000758,172.217.194.0-255,381,57839,7,293628
45143,0.000769,172.31.36.0-255,66,57905,7,293628
45144,0.000915,172.217.194.0-255,1484,59389,7,293628
45145,0.000934,172.217.194.0-255,2902,62291,7,293628
45146,0.00094,172.217.194.0-255,4320,66611,7,293628
45147,0.000947,172.31.36.0-255,66,66677,7,293628
45148,0.000957,172.217.194.0-255,1484,68161,7,293628
45149,0.000971,172.31.36.0-255,66,68227,7,293628
45150,0.001056,172.31.36.0-255,66,68293,7,293628
45151,0.001259,172.217.194.0-255,1484,69777,7,293628
45152,0.001265,172.217.194.0-255,2902,72679,7,293628
45153,0.001268,172.217.194.0-255,1484,74163,7,293628
45154,0.001279,172.31.36.0-255,66,74229,7,293628
45155,0.001289,172.217.194.0-255,4320,78549,7,293628
45156,0.001293,172.217.194.0-255,2902,81451,7,293628
45157,0.001297,172.31.36.0-255,66,81517,7,293628
45158,0.001325,172.217.194.0-255,5738,87255,7,293628
45159,0.001353,172.217.194.0-255,1484,88739,7,293628
45160,0.001358,172.217.194.0-255,5020,93759,7,293628
45161,0.001361,172.31.36.0-255,66,93825,7,293628
45162,0.001367,172.31.36.0-255,66,93891,7,293628
45163,0.001581,172.217.194.0-255,1484,95375,7,293628
45164,0.001587,172.217.194.0-255,2902,98277,7,293628
45165,0.001589,172.31.36.0-255,66,98343,7,293628
45166,0.00163,172.217.194.0-255,5738,104081,7,293628
45167,0.001635,172.31.36.0-255,66,104147,7,293628
45168,0.001646,172.217.194.0-255,4320,108467,7,293628
45169,0.001714,172.31.36.0-255,66,108533,7,293628
45170,0.001722,172.217.194.0-255,766,109299,7,293628
45171,0.001778,172.217.194.0-255,1484,110783,7,293628
45172,0.001781,172.31.36.0-255,66,110849,7,293628
45173,0.001803,172.217.194.0-255,2902,113751,7,293628
45174,0.001808,172.217.194.0-255,2902,116653,7,293628
45175,0.001816,172.31.36.0-255,66,116719,7,293628
45176,0.001824,172.217.194.0-255,2902,119621,7,293628
45177,0.001827,172.217.194.0-255,1484,121105,7,293628
45178,0.001831,172.31.36.0-255,66,121171,7,293628
45179,0.001866,172.217.194.0-255,2902,124073,7,293628
45180,0.00187,172.217.194.0-255,2902,126975,7,293628
45181,0.001873,172.31.36.0-255,66,127041,7,293628
45182,0.001878,172.31.36.0-255,66,127107,7,293628
45183,0.00191,172.31.36.0-255,66,127173,7,293628
45184,0.002012,172.217.194.0-255,1484,128657,7,293628
45185,0.002017,172.217.194.0-255,2902,131559,7,293628
45186,0.002019,172.31.36.0-255,66,131625,7,293628
45187,0.002023,172.217.194.0-255,1484,133109,7,293628
45188,0.002044,172.217.194.0-255,4320,137429,7,293628
45189,0.002048,172.217.194.0-255,2902,140331,7,293628
45190,0.002055,172.31.36.0-255,66,140397,7,293628
45191,0.002097,172.217.194.0-255,766,141163,7,293628
45192,0.002102,172.31.36.0-255,66,141229,7,293628
45193,0.00219,172.217.194.0-255,1484,142713,7,293628
45194,0.002203,172.217.194.0-255,2902,145615,7,293628
45195,0.002207,172.31.36.0-255,66,145681,7,293628
45196,0.002223,172.217.194.0-255,5738,151419,7,293628
45197,0.002242,172.217.194.0-255,4320,155739,7,293628
45198,0.002267,172.217.194.0-255,1484,157223,7,293628
45199,0.002334,172.217.194.0-255,7156,164379,7,293628
45200,0.002354,172.217.194.0-255,6438,170817,7,293628
45201,0.002377,172.217.194.0-255,7156,177973,7,293628
45202,0.00238,172.217.194.0-255,1484,179457,7,293628
45203,0.002403,172.217.194.0-255,7156,186613,7,293628
45204,0.002688,172.31.36.0-255,66,186679,7,293628
45205,0.005028,172.217.194.0-255,2902,189581,7,293628
45206,0.005034,172.31.36.0-255,66,189647,7,293628
45207,0.005056,172.217.194.0-255,2902,192549,7,293628
45208,0.005071,172.31.36.0-255,66,192615,7,293628
45209,0.007368,172.217.194.0-255,2902,195517,7,293628
45210,0.007376,172.31.36.0-255,66,195583,7,293628
45211,0.007399,172.217.194.0-255,2902,198485,7,293628
45212,0.007433,172.31.36.0-255,66,198551,7,293628
45213,0.009726,172.217.194.0-255,2902,201453,7,293628
45214,0.009734,172.31.36.0-255,66,201519,7,293628
45215,0.009756,172.217.194.0-255,2902,204421,7,293628
45216,0.009784,172.31.36.0-255,66,204487,7,293628
45217,0.012072,172.217.194.0-255,2902,207389,7,293628
45218,0.012082,172.31.36.0-255,66,207455,7,293628
45219,0.012125,172.217.194.0-255,2902,210357,7,293628
45220,0.012162,172.31.36.0-255,66,210423,7,293628
45221,0.014418,172.217.194.0-255,2902,213325,7,293628
45222,0.014427,172.31.36.0-255,66,213391,7,293628
45223,0.014505,172.217.194.0-255,2902,216293,7,293628
45224,0.014533,172.31.36.0-255,66,216359,7,293628
45225,0.016799,172.217.194.0-255,2902,219261,7,293628
45226,0.016807,172.31.36.0-255,66,219327,7,293628
45227,0.016877,172.217.194.0-255,2902,222229,7,293628
45228,0.016899,172.31.36.0-255,66,222295,7,293628
45229,0.019155,172.217.194.0-255,2902,225197,7,293628
45230,0.019162,172.31.36.0-255,66,225263,7,293628
45231,0.019254,172.217.194.0-255,2902,228165,7,293628
45232,0.019272,172.31.36.0-255,66,228231,7,293628
45233,0.021488,172.217.194.0-255,2902,231133,7,293628
45234,0.021495,172.31.36.0-255,66,231199,7,293628
45235,0.021621,172.217.194.0-255,2902,234101,7,293628
45236,0.021627,172.31.36.0-255,66,234167,7,293628
45237,0.023847,172.217.194.0-255,2902,237069,7,293628
45238,0.023863,172.31.36.0-255,66,237135,7,293628
45239,0.023983,172.217.194.0-255,2902,240037,7,293628
45240,0.024016,172.31.36.0-255,66,240103,7,293628
45241,0.02451,172.31.36.0-255,172,240275,7,293628
45242,0.024552,172.31.36.0-255,1115,241390,7,293628
45243,0.024626,172.31.36.0-255,1514,242904,7,293628
45244,0.024628,172.31.36.0-255,1291,244195,7,293628
45245,0.026077,104.244.42.0-255,66,244261,7,293628
45246,0.02613,104.244.42.0-255,66,244327,7,293628
45247,0.026165,172.217.194.0-255,2902,247229,7,293628
45248,0.026172,172.31.36.0-255,66,247295,7,293628
45249,0.026193,104.244.42.0-255,66,247361,7,293628
45250,0.02633,172.217.194.0-255,2902,250263,7,293628
45251,0.026517,172.31.36.0-255,66,250329,7,293628
45252,0.027118,104.244.42.0-255,108,250437,7,293628
45253,0.027124,172.31.36.0-255,66,250503,7,293628
45254,0.0285,172.217.194.0-255,2902,253405,7,293628
45255,0.028504,172.31.36.0-255,66,253471,7,293628
45256,0.028898,172.217.194.0-255,2902,256373,7,293628
45257,0.028904,172.31.36.0-255,66,256439,7,293628
45258,0.030842,172.217.194.0-255,2902,259341,7,293628
45259,0.030847,172.31.36.0-255,66,259407,7,293628
45260,0.031251,172.217.194.0-255,2902,262309,7,293628
45261,0.031256,172.31.36.0-255,66,262375,7,293628
45262,0.033177,172.217.194.0-255,2902,265277,7,293628
45263,0.033183,172.31.36.0-255,66,265343,7,293628
45264,0.033615,172.217.194.0-255,2902,268245,7,293628
45265,0.033621,172.31.36.0-255,66,268311,7,293628
45266,0.035529,172.217.194.0-255,2902,271213,7,293628
45267,0.035535,172.31.36.0-255,66,271279,7,293628
45268,0.035967,172.217.194.0-255,2902,274181,7,293628
45269,0.035972,172.31.36.0-255,66,274247,7,293628
45270,0.037881,172.217.194.0-255,2902,277149,7,293628
45271,0.037886,172.31.36.0-255,66,277215,7,293628
45272,0.038308,172.217.194.0-255,2902,280117,7,293628
45273,0.038314,172.31.36.0-255,66,280183,7,293628
45274,0.040211,172.217.194.0-255,2902,283085,7,293628
45275,0.040216,172.31.36.0-255,66,283151,7,293628
45276,0.040654,172.217.194.0-255,2902,286053,7,293628
45277,0.040659,172.31.36.0-255,66,286119,7,293628
45278,0.042572,172.217.194.0-255,2902,289021,7,293628
45279,0.042577,172.31.36.0-255,66,289087,7,293628
45280,0.042988,172.217.194.0-255,2902,291989,7,293628
45281,0.042993,172.31.36.0-255,66,292055,7,293628
45282,0.044908,172.217.194.0-255,1336,293391,7,293628
45283,0.045058,172.31.36.0-255,66,293457,7,293628
45284,0.045085,172.31.36.0-255,105,293562,7,293628
45285,0.047404,172.217.194.0-255,66,293628,7,293628
45286,0.0,74.125.24.0-255,153,153,7,284174
45287,2.9e-05,172.31.36.0-255,66,219,7,284174
45288,3.5e-05,74.125.24.0-255,1484,1703,7,284174
45289,4e-05,172.31.36.0-255,66,1769,7,284174
45290,4.4e-05,74.125.24.0-255,2902,4671,7,284174
45291,4.7e-05,172.31.36.0-255,66,4737,7,284174
45292,5.4e-05,74.125.24.0-255,7156,11893,7,284174
45293,5.6e-05,172.31.36.0-255,66,11959,7,284174
45294,8.1e-05,74.125.24.0-255,2064,14023,7,284174
45295,8.3e-05,172.31.36.0-255,66,14089,7,284174
45296,0.000113,74.125.24.0-255,2902,16991,7,284174
45297,0.000116,172.31.36.0-255,66,17057,7,284174
45298,0.00012,74.125.24.0-255,4320,21377,7,284174
45299,0.000122,172.31.36.0-255,66,21443,7,284174
45300,0.000159,172.31.36.0-255,66,21509,7,284174
45301,0.000179,74.125.24.0-255,1125,22634,7,284174
45302,0.000181,172.31.36.0-255,66,22700,7,284174
45303,0.00025,74.125.24.0-255,1484,24184,7,284174
45304,0.000253,172.31.36.0-255,66,24250,7,284174
45305,0.000257,74.125.24.0-255,2902,27152,7,284174
45306,0.000259,172.31.36.0-255,66,27218,7,284174
45307,0.000263,74.125.24.0-255,1484,28702,7,284174
45308,0.000266,172.31.36.0-255,66,28768,7,284174
45309,0.000284,74.125.24.0-255,2902,31670,7,284174
45310,0.000287,172.31.36.0-255,66,31736,7,284174
45311,0.000322,74.125.24.0-255,2902,34638,7,284174
45312,0.000325,172.31.36.0-255,66,34704,7,284174
45313,0.000347,74.125.24.0-255,5379,40083,7,284174
45314,0.00035,172.31.36.0-255,66,40149,7,284174
45315,0.000359,172.31.36.0-255,66,40215,7,284174
45316,0.000375,74.125.24.0-255,1484,41699,7,284174
45317,0.000391,74.125.24.0-255,7099,48798,7,284174
45318,0.000396,172.31.36.0-255,66,48864,7,284174
45319,0.000443,74.125.24.0-255,127,48991,7,284174
45320,0.000471,74.125.24.0-255,347,49338,7,284174
45321,0.000811,74.125.24.0-255,1484,50822,7,284174
45322,0.000815,172.31.36.0-255,66,50888,7,284174
45323,0.00082,74.125.24.0-255,2902,53790,7,284174
45324,0.000822,172.31.36.0-255,66,53856,7,284174
45325,0.000828,74.125.24.0-255,5738,59594,7,284174
45326,0.00083,172.31.36.0-255,66,59660,7,284174
45327,0.000863,172.31.36.0-255,66,59726,7,284174
45328,0.000883,74.125.24.0-255,5738,65464,7,284174
45329,0.000887,172.31.36.0-255,66,65530,7,284174
45330,0.000905,74.125.24.0-255,5020,70550,7,284174
45331,0.000907,172.31.36.0-255,66,70616,7,284174
45332,0.001899,74.125.24.0-255,1484,72100,7,284174
45333,0.00192,74.125.24.0-255,2902,75002,7,284174
45334,0.001924,172.31.36.0-255,66,75068,7,284174
45335,0.001931,74.125.24.0-255,4320,79388,7,284174
45336,0.001933,172.31.36.0-255,66,79454,7,284174
45337,0.001956,74.125.24.0-255,1484,80938,7,284174
45338,0.001963,74.125.24.0-255,7156,88094,7,284174
45339,0.001965,172.31.36.0-255,66,88160,7,284174
45340,0.002,74.125.24.0-255,5738,93898,7,284174
45341,0.002002,172.31.36.0-255,66,93964,7,284174
45342,0.002023,74.125.24.0-255,7156,101120,7,284174
45343,0.002025,172.31.36.0-255,66,101186,7,284174
45344,0.002039,74.125.24.0-255,3602,104788,7,284174
45345,0.002041,172.31.36.0-255,66,104854,7,284174
45346,0.004591,74.125.24.0-255,1484,106338,7,284174
45347,0.004612,74.125.24.0-255,4320,110658,7,284174
45348,0.004614,172.31.36.0-255,66,110724,7,284174
45349,0.007225,74.125.24.0-255,5738,116462,7,284174
45350,0.007231,172.31.36.0-255,66,116528,7,284174
45351,0.00985,74.125.24.0-255,5738,122266,7,284174
45352,0.009857,172.31.36.0-255,66,122332,7,284174
45353,0.012431,74.125.24.0-255,5738,128070,7,284174
45354,0.012438,172.31.36.0-255,66,128136,7,284174
45355,0.015068,74.125.24.0-255,5738,133874,7,284174
45356,0.015078,172.31.36.0-255,66,133940,7,284174
45357,0.017672,74.125.24.0-255,5738,139678,7,284174
45358,0.017682,172.31.36.0-255,66,139744,7,284174
45359,0.020272,74.125.24.0-255,5738,145482,7,284174
45360,0.020281,172.31.36.0-255,66,145548,7,284174
45361,0.022861,74.125.24.0-255,5738,151286,7,284174
45362,0.022869,172.31.36.0-255,66,151352,7,284174
45363,0.025508,74.125.24.0-255,5738,157090,7,284174
45364,0.025516,172.31.36.0-255,66,157156,7,284174
45365,0.028084,74.125.24.0-255,5738,162894,7,284174
45366,0.028091,172.31.36.0-255,66,162960,7,284174
45367,0.029559,172.31.36.0-255,172,163132,7,284174
45368,0.029591,172.31.36.0-255,1113,164245,7,284174
45369,0.029638,172.31.36.0-255,1514,165759,7,284174
45370,0.02964,172.31.36.0-255,1514,167273,7,284174
45371,0.029642,172.31.36.0-255,1514,168787,7,284174
45372,0.029643,172.31.36.0-255,1514,170301,7,284174
45373,0.029644,172.31.36.0-255,1514,171815,7,284174
45374,0.029672,172.31.36.0-255,71,171886,7,284174
45375,0.030713,74.125.24.0-255,5738,177624,7,284174
45376,0.03072,172.31.36.0-255,66,177690,7,284174
45377,0.031142,104.244.42.0-255,66,177756,7,284174
45378,0.031194,104.244.42.0-255,66,177822,7,284174
45379,0.031235,104.244.42.0-255,66,177888,7,284174
45380,0.03124,104.244.42.0-255,66,177954,7,284174
45381,0.033271,74.125.24.0-255,5738,183692,7,284174
45382,0.033277,172.31.36.0-255,66,183758,7,284174
45383,0.035847,74.125.24.0-255,4320,188078,7,284174
45384,0.035853,172.31.36.0-255,66,188144,7,284174
45385,0.035884,74.125.24.0-255,1484,189628,7,284174
45386,0.038439,74.125.24.0-255,2902,192530,7,284174
45387,0.038444,172.31.36.0-255,66,192596,7,284174
45388,0.038474,74.125.24.0-255,1484,194080,7,284174
45389,0.041049,74.125.24.0-255,4320,198400,7,284174
45390,0.041055,172.31.36.0-255,66,198466,7,284174
45391,0.043618,74.125.24.0-255,5738,204204,7,284174
45392,0.043624,172.31.36.0-255,66,204270,7,284174
45393,0.046193,74.125.24.0-255,5738,210008,7,284174
45394,0.046203,172.31.36.0-255,66,210074,7,284174
45395,0.048767,74.125.24.0-255,5738,215812,7,284174
45396,0.048777,172.31.36.0-255,66,215878,7,284174
45397,0.051388,74.125.24.0-255,5738,221616,7,284174
45398,0.051396,172.31.36.0-255,66,221682,7,284174
45399,0.053984,74.125.24.0-255,5738,227420,7,284174
45400,0.053994,172.31.36.0-255,66,227486,7,284174
45401,0.056583,74.125.24.0-255,5738,233224,7,284174
45402,0.056588,172.31.36.0-255,66,233290,7,284174
45403,0.059191,74.125.24.0-255,5738,239028,7,284174
45404,0.059196,172.31.36.0-255,66,239094,7,284174
45405,0.061777,74.125.24.0-255,5738,244832,7,284174
45406,0.061783,172.31.36.0-255,66,244898,7,284174
45407,0.064341,74.125.24.0-255,5738,250636,7,284174
45408,0.064346,172.31.36.0-255,66,250702,7,284174
45409,0.066941,74.125.24.0-255,5738,256440,7,284174
45410,0.066948,172.31.36.0-255,66,256506,7,284174
45411,0.069542,74.125.24.0-255,5738,262244,7,284174
45412,0.069548,172.31.36.0-255,66,262310,7,284174
45413,0.072137,74.125.24.0-255,4320,266630,7,284174
45414,0.072143,172.31.36.0-255,66,266696,7,284174
45415,0.072174,74.125.24.0-255,1484,268180,7,284174
45416,0.074746,74.125.24.0-255,4320,272500,7,284174
45417,0.074752,172.31.36.0-255,66,272566,7,284174
45418,0.077297,74.125.24.0-255,5738,278304,7,284174
45419,0.077302,172.31.36.0-255,66,278370,7,284174
45420,0.079889,74.125.24.0-255,5738,284108,7,284174
45421,0.079896,172.31.36.0-255,66,284174,7,284174
45422,0.0,74.125.24.0-255,153,153,7,202310
45423,3.2e-05,172.31.36.0-255,66,219,7,202310
45424,3.9e-05,74.125.24.0-255,1484,1703,7,202310
45425,4.4e-05,172.31.36.0-255,66,1769,7,202310
45426,4.9e-05,74.125.24.0-255,2902,4671,7,202310
45427,5.1e-05,172.31.36.0-255,66,4737,7,202310
45428,5.8e-05,74.125.24.0-255,7156,11893,7,202310
45429,6.1e-05,172.31.36.0-255,66,11959,7,202310
45430,6.5e-05,74.125.24.0-255,2072,14031,7,202310
45431,6.7e-05,172.31.36.0-255,66,14097,7,202310
45432,0.000111,74.125.24.0-255,1484,15581,7,202310
45433,0.000113,172.31.36.0-255,66,15647,7,202310
45434,0.000141,74.125.24.0-255,2902,18549,7,202310
45435,0.000144,172.31.36.0-255,66,18615,7,202310
45436,0.000148,74.125.24.0-255,1484,20099,7,202310
45437,0.00015,172.31.36.0-255,66,20165,7,202310
45438,0.000166,74.125.24.0-255,2902,23067,7,202310
45439,0.000168,172.31.36.0-255,66,23133,7,202310
45440,0.000175,74.125.24.0-255,5738,28871,7,202310
45441,0.000177,172.31.36.0-255,66,28937,7,202310
45442,0.000208,74.125.24.0-255,2543,31480,7,202310
45443,0.000211,172.31.36.0-255,66,31546,7,202310
45444,0.000275,74.125.24.0-255,1484,33030,7,202310
45445,0.000279,172.31.36.0-255,66,33096,7,202310
45446,0.000295,74.125.24.0-255,2902,35998,7,202310
45447,0.000298,172.31.36.0-255,66,36064,7,202310
45448,0.000325,74.125.24.0-255,5738,41802,7,202310
45449,0.000328,172.31.36.0-255,66,41868,7,202310
45450,0.000334,74.125.24.0-255,5738,47606,7,202310
45451,0.000337,172.31.36.0-255,66,47672,7,202310
45452,0.000378,172.31.36.0-255,66,47738,7,202310
45453,0.000384,74.125.24.0-255,3961,51699,7,202310
45454,0.000386,172.31.36.0-255,66,51765,7,202310
45455,0.000524,74.125.24.0-255,395,52160,7,202310
45456,0.000672,74.125.24.0-255,347,52507,7,202310
45457,0.000807,172.31.36.0-255,66,52573,7,202310
45458,0.001155,74.125.24.0-255,1484,54057,7,202310
45459,0.001164,74.125.24.0-255,1484,55541,7,202310
45460,0.001168,172.31.36.0-255,66,55607,7,202310
45461,0.001188,74.125.24.0-255,1484,57091,7,202310
45462,0.001196,74.125.24.0-255,5738,62829,7,202310
45463,0.001198,172.31.36.0-255,66,62895,7,202310
45464,0.001223,74.125.24.0-255,4320,67215,7,202310
45465,0.001227,172.31.36.0-255,66,67281,7,202310
45466,0.001257,172.31.36.0-255,66,67347,7,202310
45467,0.001264,74.125.24.0-255,5738,73085,7,202310
45468,0.001265,172.31.36.0-255,66,73151,7,202310
45469,0.0013,74.125.24.0-255,1484,74635,7,202310
45470,0.001321,74.125.24.0-255,3602,78237,7,202310
45471,0.001324,172.31.36.0-255,66,78303,7,202310
45472,0.001417,74.125.24.0-255,1484,79787,7,202310
45473,0.001425,74.125.24.0-255,2902,82689,7,202310
45474,0.001428,172.31.36.0-255,66,82755,7,202310
45475,0.001447,74.125.24.0-255,5738,88493,7,202310
45476,0.00145,172.31.36.0-255,66,88559,7,202310
45477,0.001453,74.125.24.0-255,1484,90043,7,202310
45478,0.001484,172.31.36.0-255,66,90109,7,202310
45479,0.001511,172.31.36.0-255,66,90175,7,202310
45480,0.001643,74.125.24.0-255,1484,91659,7,202310
45481,0.001649,74.125.24.0-255,1484,93143,7,202310
45482,0.001652,172.31.36.0-255,66,93209,7,202310
45483,0.00167,74.125.24.0-255,1484,94693,7,202310
45484,0.001673,74.125.24.0-255,1484,96177,7,202310
45485,0.001675,172.31.36.0-255,66,96243,7,202310
45486,0.001694,74.125.24.0-255,4320,100563,7,202310
45487,0.001697,172.31.36.0-255,66,100629,7,202310
45488,0.001702,74.125.24.0-255,4320,104949,7,202310
45489,0.001704,172.31.36.0-255,66,105015,7,202310
45490,0.001734,172.31.36.0-255,66,105081,7,202310
45491,0.001758,74.125.24.0-255,1484,106565,7,202310
45492,0.001784,74.125.24.0-255,6438,113003,7,202310
45493,0.001786,172.31.36.0-255,66,113069,7,202310
45494,0.001897,74.125.24.0-255,1484,114553,7,202310
45495,0.0019,74.125.24.0-255,1484,116037,7,202310
45496,0.001901,172.31.36.0-255,66,116103,7,202310
45497,0.001913,74.125.24.0-255,1484,117587,7,202310
45498,0.001916,74.125.24.0-255,1484,119071,7,202310
45499,0.001919,172.31.36.0-255,66,119137,7,202310
45500,0.001946,74.125.24.0-255,4320,123457,7,202310
45501,0.001949,172.31.36.0-255,66,123523,7,202310
45502,0.001959,172.31.36.0-255,66,123589,7,202310
45503,0.001976,74.125.24.0-255,2902,126491,7,202310
45504,0.001979,172.31.36.0-255,66,126557,7,202310
45505,0.001988,172.31.36.0-255,66,126623,7,202310
45506,0.002013,74.125.24.0-255,2184,128807,7,202310
45507,0.002015,172.31.36.0-255,66,128873,7,202310
45508,0.00216,74.125.24.0-255,1484,130357,7,202310
45509,0.002177,74.125.24.0-255,2902,133259,7,202310
45510,0.00218,172.31.36.0-255,66,133325,7,202310
45511,0.002184,74.125.24.0-255,2902,136227,7,202310
45512,0.002186,172.31.36.0-255,66,136293,7,202310
45513,0.0022,74.125.24.0-255,2902,139195,7,202310
45514,0.002202,172.31.36.0-255,66,139261,7,202310
45515,0.002205,74.125.24.0-255,1484,140745,7,202310
45516,0.002238,172.31.36.0-255,66,140811,7,202310
45517,0.002254,74.125.24.0-255,1484,142295,7,202310
45518,0.002283,172.31.36.0-255,66,142361,7,202310
45519,0.00232,74.125.24.0-255,5738,148099,7,202310
45520,0.002322,172.31.36.0-255,66,148165,7,202310
45521,0.002327,74.125.24.0-255,4320,152485,7,202310
45522,0.00233,172.31.36.0-255,66,152551,7,202310
45523,0.002341,74.125.24.0-255,2902,155453,7,202310
45524,0.002343,172.31.36.0-255,66,155519,7,202310
45525,0.002386,74.125.24.0-255,2902,158421,7,202310
45526,0.00239,172.31.36.0-255,66,158487,7,202310
45527,0.002419,172.31.36.0-255,66,158553,7,202310
45528,0.002433,172.31.36.0-255,66,158619,7,202310
45529,0.002439,74.125.24.0-255,5738,164357,7,202310
45530,0.002442,172.31.36.0-255,66,164423,7,202310
45531,0.002455,74.125.24.0-255,2902,167325,7,202310
45532,0.002458,172.31.36.0-255,66,167391,7,202310
45533,0.002485,172.31.36.0-255,66,167457,7,202310
45534,0.00251,74.125.24.0-255,2184,169641,7,202310
45535,0.002513,172.31.36.0-255,66,169707,7,202310
45536,0.002516,74.125.24.0-255,1484,171191,7,202310
45537,0.002519,74.125.24.0-255,1484,172675,7,202310
45538,0.002521,172.31.36.0-255,66,172741,7,202310
45539,0.002524,74.125.24.0-255,1484,174225,7,202310
45540,0.002527,74.125.24.0-255,1484,175709,7,202310
45541,0.00253,172.31.36.0-255,66,175775,7,202310
45542,0.002534,74.125.24.0-255,2902,178677,7,202310
45543,0.002537,172.31.36.0-255,66,178743,7,202310
45544,0.002572,172.31.36.0-255,66,178809,7,202310
45545,0.002583,172.31.36.0-255,66,178875,7,202310
45546,0.002604,74.125.24.0-255,2902,181777,7,202310
45547,0.002607,172.31.36.0-255,66,181843,7,202310
45548,0.002614,74.125.24.0-255,5738,187581,7,202310
45549,0.002617,172.31.36.0-255,66,187647,7,202310
45550,0.002638,74.125.24.0-255,6438,194085,7,202310
45551,0.002641,172.31.36.0-255,66,194151,7,202310
45552,0.002655,172.31.36.0-255,66,194217,7,202310
45553,0.002667,172.31.36.0-255,66,194283,7,202310
45554,0.002703,74.125.24.0-255,1484,195767,7,202310
45555,0.002739,172.31.36.0-255,66,195833,7,202310
45556,0.002742,74.125.24.0-255,1484,197317,7,202310
45557,0.002751,172.31.36.0-255,66,197383,7,202310
45558,0.002761,172.31.36.0-255,66,197449,7,202310
45559,0.002799,172.31.36.0-255,66,197515,7,202310
45560,0.002811,74.125.24.0-255,97,197612,7,202310
45561,0.002821,172.31.36.0-255,66,197678,7,202310
45562,0.002852,74.125.24.0-255,105,197783,7,202310
45563,0.005428,172.31.36.0-255,66,197849,7,202310
45564,0.005455,172.31.36.0-255,105,197954,7,202310
45565,0.007745,74.125.24.0-255,66,198020,7,202310
45566,0.031169,172.31.36.0-255,172,198192,7,202310
45567,0.031201,172.31.36.0-255,1115,199307,7,202310
45568,0.031248,172.31.36.0-255,1514,200821,7,202310
45569,0.03125,172.31.36.0-255,1291,202112,7,202310
45570,0.032717,104.244.42.0-255,66,202178,7,202310
45571,0.032896,104.244.42.0-255,66,202244,7,202310
45572,0.032951,104.244.42.0-255,66,202310,7,202310
45573,0.0,74.125.24.0-255,152,152,7,330299
45574,2.3e-05,172.31.36.0-255,66,218,7,330299
45575,3e-05,74.125.24.0-255,1484,1702,7,330299
45576,3.4e-05,172.31.36.0-255,66,1768,7,330299
45577,3.9e-05,74.125.24.0-255,2902,4670,7,330299
45578,4.2e-05,172.31.36.0-255,66,4736,7,330299
45579,4.9e-05,74.125.24.0-255,5738,10474,7,330299
45580,5.1e-05,172.31.36.0-255,66,10540,7,330299
45581,7.4e-05,74.125.24.0-255,3430,13970,7,330299
45582,7.7e-05,172.31.36.0-255,66,14036,7,330299
45583,9.9e-05,74.125.24.0-255,1484,15520,7,330299
45584,0.000102,172.31.36.0-255,66,15586,7,330299
45585,0.000124,74.125.24.0-255,2902,18488,7,330299
45586,0.000127,172.31.36.0-255,66,18554,7,330299
45587,0.000134,74.125.24.0-255,5738,24292,7,330299
45588,0.000136,172.31.36.0-255,66,24358,7,330299
45589,0.000175,74.125.24.0-255,2902,27260,7,330299
45590,0.000178,172.31.36.0-255,66,27326,7,330299
45591,0.000196,74.125.24.0-255,3961,31287,7,330299
45592,0.000198,172.31.36.0-255,66,31353,7,330299
45593,0.000318,74.125.24.0-255,1484,32837,7,330299
45594,0.000322,172.31.36.0-255,66,32903,7,330299
45595,0.000327,74.125.24.0-255,2902,35805,7,330299
45596,0.00033,172.31.36.0-255,66,35871,7,330299
45597,0.000346,74.125.24.0-255,5738,41609,7,330299
45598,0.000348,172.31.36.0-255,66,41675,7,330299
45599,0.000377,172.31.36.0-255,66,41741,7,330299
45600,0.000404,74.125.24.0-255,5379,47120,7,330299
45601,0.000406,172.31.36.0-255,66,47186,7,330299
45602,0.000417,172.31.36.0-255,66,47252,7,330299
45603,0.000419,74.125.24.0-255,1420,48672,7,330299
45604,0.000495,74.125.24.0-255,383,49055,7,330299
45605,0.000499,172.31.36.0-255,66,49121,7,330299
45606,0.000791,74.125.24.0-255,1484,50605,7,330299
45607,0.000797,74.125.24.0-255,2902,53507,7,330299
45608,0.0008,172.31.36.0-255,66,53573,7,330299
45609,0.000806,74.125.24.0-255,2902,56475,7,330299
45610,0.000809,172.31.36.0-255,66,56541,7,330299
45611,0.000825,74.125.24.0-255,2902,59443,7,330299
45612,0.000832,74.125.24.0-255,7156,66599,7,330299
45613,0.000836,172.31.36.0-255,66,66665,7,330299
45614,0.000839,172.31.36.0-255,66,66731,7,330299
45615,0.000867,74.125.24.0-255,5738,72469,7,330299
45616,0.00087,172.31.36.0-255,66,72535,7,330299
45617,0.000877,74.125.24.0-255,7156,79691,7,330299
45618,0.000897,172.31.36.0-255,66,79757,7,330299
45619,0.000904,74.125.24.0-255,3602,83359,7,330299
45620,0.000915,172.31.36.0-255,66,83425,7,330299
45621,0.001141,74.125.24.0-255,1484,84909,7,330299
45622,0.001155,74.125.24.0-255,2902,87811,7,330299
45623,0.001158,172.31.36.0-255,66,87877,7,330299
45624,0.001166,74.125.24.0-255,5738,93615,7,330299
45625,0.001168,172.31.36.0-255,66,93681,7,330299
45626,0.001208,172.31.36.0-255,66,93747,7,330299
45627,0.001215,74.125.24.0-255,5738,99485,7,330299
45628,0.001217,172.31.36.0-255,66,99551,7,330299
45629,0.001267,74.125.24.0-255,5020,104571,7,330299
45630,0.00127,172.31.36.0-255,66,104637,7,330299
45631,0.001736,74.125.24.0-255,1484,106121,7,330299
45632,0.00174,74.125.24.0-255,1484,107605,7,330299
45633,0.001744,172.31.36.0-255,66,107671,7,330299
45634,0.001767,74.125.24.0-255,1484,109155,7,330299
45635,0.001773,74.125.24.0-255,5738,114893,7,330299
45636,0.001775,172.31.36.0-255,66,114959,7,330299
45637,0.001788,172.31.36.0-255,66,115025,7,330299
45638,0.001811,74.125.24.0-255,2902,117927,7,330299
45639,0.001814,172.31.36.0-255,66,117993,7,330299
45640,0.001826,172.31.36.0-255,66,118059,7,330299
45641,0.00183,74.125.24.0-255,1484,119543,7,330299
45642,0.001856,172.31.36.0-255,66,119609,7,330299
45643,0.001867,74.125.24.0-255,2902,122511,7,330299
45644,0.001898,172.31.36.0-255,66,122577,7,330299
45645,0.001907,74.125.24.0-255,2902,125479,7,330299
45646,0.001912,172.31.36.0-255,66,125545,7,330299
45647,0.00195,172.31.36.0-255,66,125611,7,330299
45648,0.001957,74.125.24.0-255,1484,127095,7,330299
45649,0.001974,74.125.24.0-255,2902,129997,7,330299
45650,0.001976,172.31.36.0-255,66,130063,7,330299
45651,0.001984,74.125.24.0-255,5738,135801,7,330299
45652,0.002001,74.125.24.0-255,2902,138703,7,330299
45653,0.00201,172.31.36.0-255,66,138769,7,330299
45654,0.002044,172.31.36.0-255,66,138835,7,330299
45655,0.002053,74.125.24.0-255,2902,141737,7,330299
45656,0.002058,172.31.36.0-255,66,141803,7,330299
45657,0.002102,172.31.36.0-255,66,141869,7,330299
45658,0.004159,74.125.24.0-255,5738,147607,7,330299
45659,0.004167,172.31.36.0-255,66,147673,7,330299
45660,0.0062,74.125.24.0-255,4320,151993,7,330299
45661,0.006204,172.31.36.0-255,66,152059,7,330299
45662,0.00622,74.125.24.0-255,1484,153543,7,330299
45663,0.008241,74.125.24.0-255,4320,157863,7,330299
45664,0.008248,172.31.36.0-255,66,157929,7,330299
45665,0.010312,74.125.24.0-255,5738,163667,7,330299
45666,0.010319,172.31.36.0-255,66,163733,7,330299
45667,0.012367,74.125.24.0-255,5738,169471,7,330299
45668,0.012375,172.31.36.0-255,66,169537,7,330299
45669,0.014463,74.125.24.0-255,5738,175275,7,330299
45670,0.014481,172.31.36.0-255,66,175341,7,330299
45671,0.016532,74.125.24.0-255,5738,181079,7,330299
45672,0.016544,172.31.36.0-255,66,181145,7,330299
45673,0.018647,74.125.24.0-255,5738,186883,7,330299
45674,0.018661,172.31.36.0-255,66,186949,7,330299
45675,0.020721,74.125.24.0-255,5738,192687,7,330299
45676,0.020734,172.31.36.0-255,66,192753,7,330299
45677,0.022782,74.125.24.0-255,5738,198491,7,330299
45678,0.022792,172.31.36.0-255,66,198557,7,330299
45679,0.024881,74.125.24.0-255,5738,204295,7,330299
45680,0.024895,172.31.36.0-255,66,204361,7,330299
45681,0.026967,74.125.24.0-255,5738,210099,7,330299
45682,0.026975,172.31.36.0-255,66,210165,7,330299
45683,0.029051,74.125.24.0-255,5738,215903,7,330299
45684,0.029063,172.31.36.0-255,66,215969,7,330299
45685,0.031168,74.125.24.0-255,5738,221707,7,330299
45686,0.031175,172.31.36.0-255,66,221773,7,330299
45687,0.033265,74.125.24.0-255,5738,227511,7,330299
45688,0.033273,172.31.36.0-255,66,227577,7,330299
45689,0.035336,74.125.24.0-255,5738,233315,7,330299
45690,0.035344,172.31.36.0-255,66,233381,7,330299
45691,0.037405,74.125.24.0-255,5738,239119,7,330299
45692,0.037411,172.31.36.0-255,66,239185,7,330299
45693,0.038902,172.31.36.0-255,172,239357,7,330299
45694,0.038932,172.31.36.0-255,1114,240471,7,330299
45695,0.038998,172.31.36.0-255,1514,241985,7,330299
45696,0.039,172.31.36.0-255,1293,243278,7,330299
45697,0.039459,74.125.24.0-255,5738,249016,7,330299
45698,0.039466,172.31.36.0-255,66,249082,7,330299
45699,0.040447,104.244.42.0-255,66,249148,7,330299
45700,0.040493,104.244.42.0-255,66,249214,7,330299
45701,0.040541,104.244.42.0-255,66,249280,7,330299
45702,0.041108,104.244.42.0-255,108,249388,7,330299
45703,0.041115,172.31.36.0-255,66,249454,7,330299
45704,0.041539,74.125.24.0-255,5738,255192,7,330299
45705,0.041543,172.31.36.0-255,66,255258,7,330299
45706,0.041817,172.31.36.0-255,105,255363,7,330299
45707,0.043606,74.125.24.0-255,5738,261101,7,330299
45708,0.043614,172.31.36.0-255,66,261167,7,330299
45709,0.045688,74.125.24.0-255,5738,266905,7,330299
45710,0.045695,172.31.36.0-255,66,266971,7,330299
45711,0.047744,74.125.24.0-255,5738,272709,7,330299
45712,0.047752,172.31.36.0-255,66,272775,7,330299
45713,0.04986,74.125.24.0-255,5738,278513,7,330299
45714,0.049866,172.31.36.0-255,66,278579,7,330299
45715,0.05193,74.125.24.0-255,5738,284317,7,330299
45716,0.051937,172.31.36.0-255,66,284383,7,330299
45717,0.054077,74.125.24.0-255,5738,290121,7,330299
45718,0.054085,172.31.36.0-255,66,290187,7,330299
45719,0.056164,74.125.24.0-255,5738,295925,7,330299
45720,0.056169,172.31.36.0-255,66,295991,7,330299
45721,0.058243,74.125.24.0-255,5738,301729,7,330299
45722,0.05825,172.31.36.0-255,66,301795,7,330299
45723,0.060294,74.125.24.0-255,5738,307533,7,330299
45724,0.060301,172.31.36.0-255,66,307599,7,330299
45725,0.062361,74.125.24.0-255,5738,313337,7,330299
45726,0.062368,172.31.36.0-255,66,313403,7,330299
45727,0.064444,74.125.24.0-255,5738,319141,7,330299
45728,0.06445,172.31.36.0-255,66,319207,7,330299
45729,0.06653,74.125.24.0-255,5738,324945,7,330299
45730,0.066536,172.31.36.0-255,66,325011,7,330299
45731,0.068648,74.125.24.0-255,5051,330062,7,330299
45732,0.068654,172.31.36.0-255,66,330128,7,330299
45733,0.068837,172.31.36.0-255,105,330233,7,330299
45734,0.070864,74.125.24.0-255,66,330299,7,330299
45735,0.0,172.31.36.0-255,105,105,7,525
45736,0.000188,172.31.36.0-255,90,195,7,525
45737,0.000198,172.31.36.0-255,66,261,7,525
45738,0.00242,74.125.24.0-255,66,327,7,525
45739,0.00243,74.125.24.0-255,66,393,7,525
45740,0.002435,172.31.36.0-255,66,459,7,525
45741,0.002448,74.125.24.0-255,66,525,7,525
45742,0.0,172.31.36.0-255,105,105,7,105
45743,0.0,172.31.36.0-255,105,105,7,459
45744,0.00019,172.31.36.0-255,90,195,7,459
45745,0.000199,172.31.36.0-255,66,261,7,459
45746,0.002215,74.125.130.0-255,66,327,7,459
45747,0.002241,74.125.130.0-255,66,393,7,459
45748,0.002272,172.31.36.0-255,66,459,7,459
45749,0.0,172.217.194.0-255,146,146,7,292667
45750,2e-05,172.31.36.0-255,66,212,7,292667
45751,2.8e-05,172.217.194.0-255,1484,1696,7,292667
45752,3.3e-05,172.31.36.0-255,66,1762,7,292667
45753,3.9e-05,172.217.194.0-255,2902,4664,7,292667
45754,4.2e-05,172.31.36.0-255,66,4730,7,292667
45755,5.8e-05,172.217.194.0-255,7156,11886,7,292667
45756,6.1e-05,172.31.36.0-255,66,11952,7,292667
45757,6.6e-05,172.217.194.0-255,2008,13960,7,292667
45758,6.9e-05,172.31.36.0-255,66,14026,7,292667
45759,0.000113,172.217.194.0-255,1484,15510,7,292667
45760,0.000115,172.31.36.0-255,66,15576,7,292667
45761,0.000121,172.217.194.0-255,2902,18478,7,292667
45762,0.000124,172.31.36.0-255,66,18544,7,292667
45763,0.000149,172.217.194.0-255,5738,24282,7,292667
45764,0.000152,172.31.36.0-255,66,24348,7,292667
45765,0.000159,172.217.194.0-255,6797,31145,7,292667
45766,0.000162,172.31.36.0-255,66,31211,7,292667
45767,0.00021,172.217.194.0-255,1484,32695,7,292667
45768,0.000212,172.31.36.0-255,66,32761,7,292667
45769,0.000217,172.217.194.0-255,2902,35663,7,292667
45770,0.000219,172.31.36.0-255,66,35729,7,292667
45771,0.000249,172.217.194.0-255,5738,41467,7,292667
45772,0.000251,172.31.36.0-255,66,41533,7,292667
45773,0.000259,172.217.194.0-255,6797,48330,7,292667
45774,0.000262,172.31.36.0-255,66,48396,7,292667
45775,0.000621,172.217.194.0-255,1484,49880,7,292667
45776,0.000627,172.31.36.0-255,66,49946,7,292667
45777,0.000633,172.217.194.0-255,2902,52848,7,292667
45778,0.000637,172.31.36.0-255,66,52914,7,292667
45779,0.000648,172.217.194.0-255,5738,58652,7,292667
45780,0.000651,172.31.36.0-255,66,58718,7,292667
45781,0.000659,172.217.194.0-255,6797,65515,7,292667
45782,0.000661,172.31.36.0-255,66,65581,7,292667
45783,0.000692,172.217.194.0-255,647,66228,7,292667
45784,0.000766,172.217.194.0-255,1484,67712,7,292667
45785,0.000771,172.31.36.0-255,66,67778,7,292667
45786,0.000776,172.217.194.0-255,2902,70680,7,292667
45787,0.000778,172.31.36.0-255,66,70746,7,292667
45788,0.000788,172.217.194.0-255,2902,73648,7,292667
45789,0.000791,172.31.36.0-255,66,73714,7,292667
45790,0.000816,172.217.194.0-255,2902,76616,7,292667
45791,0.000819,172.31.36.0-255,66,76682,7,292667
45792,0.000831,172.217.194.0-255,5738,82420,7,292667
45793,0.000833,172.31.36.0-255,66,82486,7,292667
45794,0.000858,172.217.194.0-255,3961,86447,7,292667
45795,0.000864,172.31.36.0-255,66,86513,7,292667
45796,0.00087,172.217.194.0-255,4320,90833,7,292667
45797,0.000872,172.31.36.0-255,66,90899,7,292667
45798,0.000886,172.31.36.0-255,66,90965,7,292667
45799,0.001523,172.217.194.0-255,1484,92449,7,292667
45800,0.001529,172.217.194.0-255,2902,95351,7,292667
45801,0.001533,172.31.36.0-255,66,95417,7,292667
45802,0.001541,172.217.194.0-255,5738,101155,7,292667
45803,0.001544,172.31.36.0-255,66,101221,7,292667
45804,0.001582,172.31.36.0-255,66,101287,7,292667
45805,0.001616,172.31.36.0-255,66,101353,7,292667
45806,0.00193,172.217.194.0-255,1484,102837,7,292667
45807,0.001939,172.217.194.0-255,2902,105739,7,292667
45808,0.001942,172.31.36.0-255,66,105805,7,292667
45809,0.00195,172.217.194.0-255,5738,111543,7,292667
45810,0.001952,172.31.36.0-255,66,111609,7,292667
45811,0.001961,172.217.194.0-255,1484,113093,7,292667
45812,0.001993,172.31.36.0-255,66,113159,7,292667
45813,0.001997,172.217.194.0-255,1484,114643,7,292667
45814,0.00203,172.31.36.0-255,66,114709,7,292667
45815,0.002059,172.217.194.0-255,1484,116193,7,292667
45816,0.002072,172.217.194.0-255,2902,119095,7,292667
45817,0.002075,172.31.36.0-255,66,119161,7,292667
45818,0.002081,172.217.194.0-255,5738,124899,7,292667
45819,0.002084,172.31.36.0-255,66,124965,7,292667
45820,0.002118,172.31.36.0-255,66,125031,7,292667
45821,0.002121,172.217.194.0-255,1484,126515,7,292667
45822,0.002156,172.31.36.0-255,66,126581,7,292667
45823,0.002203,172.31.36.0-255,66,126647,7,292667
45824,0.002233,172.217.194.0-255,1484,128131,7,292667
45825,0.002246,172.31.36.0-255,66,128197,7,292667
45826,0.002282,172.31.36.0-255,66,128263,7,292667
45827,0.00232,172.31.36.0-255,66,128329,7,292667
45828,0.002367,172.31.36.0-255,66,128395,7,292667
45829,0.004594,172.217.194.0-255,5738,134133,7,292667
45830,0.004601,172.31.36.0-255,66,134199,7,292667
45831,0.006893,172.217.194.0-255,1484,135683,7,292667
45832,0.00691,172.217.194.0-255,4320,140003,7,292667
45833,0.006914,172.31.36.0-255,66,140069,7,292667
45834,0.009164,172.217.194.0-255,5738,145807,7,292667
45835,0.009171,172.31.36.0-255,66,145873,7,292667
45836,0.011412,172.217.194.0-255,5738,151611,7,292667
45837,0.01142,172.31.36.0-255,66,151677,7,292667
45838,0.013693,172.217.194.0-255,5738,157415,7,292667
45839,0.013702,172.31.36.0-255,66,157481,7,292667
45840,0.015975,172.217.194.0-255,5738,163219,7,292667
45841,0.015983,172.31.36.0-255,66,163285,7,292667
45842,0.018252,172.217.194.0-255,5738,169023,7,292667
45843,0.01826,172.31.36.0-255,66,169089,7,292667
45844,0.020509,172.217.194.0-255,5738,174827,7,292667
45845,0.020516,172.31.36.0-255,66,174893,7,292667
45846,0.022773,172.217.194.0-255,5738,180631,7,292667
45847,0.02278,172.31.36.0-255,66,180697,7,292667
45848,0.025038,172.217.194.0-255,5738,186435,7,292667
45849,0.025044,172.31.36.0-255,66,186501,7,292667
45850,0.027334,172.217.194.0-255,5738,192239,7,292667
45851,0.02734,172.31.36.0-255,66,192305,7,292667
45852,0.029586,172.217.194.0-255,5738,198043,7,292667
45853,0.029593,172.31.36.0-255,66,198109,7,292667
45854,0.031874,172.217.194.0-255,5738,203847,7,292667
45855,0.031882,172.31.36.0-255,66,203913,7,292667
45856,0.034157,172.217.194.0-255,5738,209651,7,292667
45857,0.034164,172.31.36.0-255,66,209717,7,292667
45858,0.034595,172.31.36.0-255,210,209927,7,292667
45859,0.034622,172.31.36.0-255,958,210885,7,292667
45860,0.034684,172.31.36.0-255,1514,212399,7,292667
45861,0.034686,172.31.36.0-255,1514,213913,7,292667
45862,0.034687,172.31.36.0-255,1514,215427,7,292667
45863,0.034688,172.31.36.0-255,1229,216656,7,292667
45864,0.036159,104.244.42.0-255,66,216722,7,292667
45865,0.036216,104.244.42.0-255,66,216788,7,292667
45866,0.036268,104.244.42.0-255,66,216854,7,292667
45867,0.036289,104.244.42.0-255,66,216920,7,292667
45868,0.036433,172.217.194.0-255,5738,222658,7,292667
45869,0.036439,172.31.36.0-255,66,222724,7,292667
45870,0.036972,104.244.42.0-255,108,222832,7,292667
45871,0.036982,172.31.36.0-255,66,222898,7,292667
45872,0.038693,172.217.194.0-255,5738,228636,7,292667
45873,0.038698,172.31.36.0-255,66,228702,7,292667
45874,0.040982,172.217.194.0-255,5738,234440,7,292667
45875,0.040988,172.31.36.0-255,66,234506,7,292667
45876,0.043248,172.217.194.0-255,5738,240244,7,292667
45877,0.043255,172.31.36.0-255,66,240310,7,292667
45878,0.045496,172.217.194.0-255,5738,246048,7,292667
45879,0.045505,172.31.36.0-255,66,246114,7,292667
45880,0.04788,172.217.194.0-255,5738,251852,7,292667
45881,0.047887,172.31.36.0-255,66,251918,7,292667
45882,0.050154,172.217.194.0-255,5738,257656,7,292667
45883,0.050162,172.31.36.0-255,66,257722,7,292667
45884,0.052408,172.217.194.0-255,5738,263460,7,292667
45885,0.052415,172.31.36.0-255,66,263526,7,292667
45886,0.054674,172.217.194.0-255,5738,269264,7,292667
45887,0.05468,172.31.36.0-255,66,269330,7,292667
45888,0.056955,172.217.194.0-255,5738,275068,7,292667
45889,0.056962,172.31.36.0-255,66,275134,7,292667
45890,0.059224,172.217.194.0-255,5738,280872,7,292667
45891,0.059231,172.31.36.0-255,66,280938,7,292667
45892,0.061494,172.217.194.0-255,5738,286676,7,292667
45893,0.061501,172.31.36.0-255,66,286742,7,292667
45894,0.063769,172.217.194.0-255,5688,292430,7,292667
45895,0.063776,172.31.36.0-255,66,292496,7,292667
45896,0.064003,172.31.36.0-255,105,292601,7,292667
45897,0.066244,172.217.194.0-255,66,292667,7,292667
45898,0.0,74.125.200.0-255,150,150,7,366553
45899,3.6e-05,172.31.36.0-255,66,216,7,366553
45900,4.3e-05,74.125.200.0-255,1484,1700,7,366553
45901,4.9e-05,172.31.36.0-255,66,1766,7,366553
45902,6.1e-05,74.125.200.0-255,2902,4668,7,366553
45903,6.5e-05,172.31.36.0-255,66,4734,7,366553
45904,7.2e-05,74.125.200.0-255,5738,10472,7,366553
45905,7.5e-05,172.31.36.0-255,66,10538,7,366553
45906,0.000101,74.125.200.0-255,1484,12022,7,366553
45907,0.000104,172.31.36.0-255,66,12088,7,366553
45908,0.000131,74.125.200.0-255,2019,14107,7,366553
45909,0.000134,172.31.36.0-255,66,14173,7,366553
45910,0.000162,74.125.200.0-255,1484,15657,7,366553
45911,0.000165,172.31.36.0-255,66,15723,7,366553
45912,0.000171,74.125.200.0-255,2902,18625,7,366553
45913,0.000173,172.31.36.0-255,66,18691,7,366553
45914,0.000206,74.125.200.0-255,5738,24429,7,366553
45915,0.000211,172.31.36.0-255,66,24495,7,366553
45916,0.000218,74.125.200.0-255,6797,31292,7,366553
45917,0.00022,172.31.36.0-255,66,31358,7,366553
45918,0.000247,74.125.200.0-255,1484,32842,7,366553
45919,0.00025,172.31.36.0-255,66,32908,7,366553
45920,0.000254,74.125.200.0-255,2902,35810,7,366553
45921,0.000256,172.31.36.0-255,66,35876,7,366553
45922,0.000283,74.125.200.0-255,5738,41614,7,366553
45923,0.000287,172.31.36.0-255,66,41680,7,366553
45924,0.000292,74.125.200.0-255,2902,44582,7,366553
45925,0.000294,172.31.36.0-255,66,44648,7,366553
45926,0.000297,74.125.200.0-255,1484,46132,7,366553
45927,0.0003,172.31.36.0-255,66,46198,7,366553
45928,0.000331,74.125.200.0-255,2543,48741,7,366553
45929,0.000335,172.31.36.0-255,66,48807,7,366553
45930,0.0004,74.125.200.0-255,1484,50291,7,366553
45931,0.000406,74.125.200.0-255,2902,53193,7,366553
45932,0.00041,172.31.36.0-255,66,53259,7,366553
45933,0.000441,74.125.200.0-255,5738,58997,7,366553
45934,0.000445,172.31.36.0-255,66,59063,7,366553
45935,0.000473,74.125.200.0-255,6797,65860,7,366553
45936,0.000477,172.31.36.0-255,66,65926,7,366553
45937,0.00048,74.125.200.0-255,399,66325,7,366553
45938,0.000567,74.125.200.0-255,112,66437,7,366553
45939,0.000607,74.125.200.0-255,330,66767,7,366553
45940,0.000831,172.31.36.0-255,66,66833,7,366553
45941,0.000933,74.125.200.0-255,1484,68317,7,366553
45942,0.000954,74.125.200.0-255,2902,71219,7,366553
45943,0.000958,172.31.36.0-255,66,71285,7,366553
45944,0.000966,74.125.200.0-255,5738,77023,7,366553
45945,0.000968,172.31.36.0-255,66,77089,7,366553
45946,0.001009,172.31.36.0-255,66,77155,7,366553
45947,0.001015,74.125.200.0-255,4320,81475,7,366553
45948,0.001017,172.31.36.0-255,66,81541,7,366553
45949,0.001056,74.125.200.0-255,4320,85861,7,366553
45950,0.00106,172.31.36.0-255,66,85927,7,366553
45951,0.001085,74.125.200.0-255,2184,88111,7,366553
45952,0.001088,172.31.36.0-255,66,88177,7,366553
45953,0.001133,74.125.200.0-255,1484,89661,7,366553
45954,0.001146,74.125.200.0-255,2902,92563,7,366553
45955,0.001149,172.31.36.0-255,66,92629,7,366553
45956,0.00118,74.125.200.0-255,4320,96949,7,366553
45957,0.001184,172.31.36.0-255,66,97015,7,366553
45958,0.001196,172.31.36.0-255,66,97081,7,366553
45959,0.0012,74.125.200.0-255,2902,99983,7,366553
45960,0.001202,172.31.36.0-255,66,100049,7,366553
45961,0.001242,74.125.200.0-255,4320,104369,7,366553
45962,0.001245,172.31.36.0-255,66,104435,7,366553
45963,0.001255,172.31.36.0-255,66,104501,7,366553
45964,0.001258,74.125.200.0-255,766,105267,7,366553
45965,0.001282,74.125.200.0-255,1484,106751,7,366553
45966,0.001285,172.31.36.0-255,66,106817,7,366553
45967,0.00129,74.125.200.0-255,2902,109719,7,366553
45968,0.001293,172.31.36.0-255,66,109785,7,366553
45969,0.001309,74.125.200.0-255,1484,111269,7,366553
45970,0.001313,74.125.200.0-255,1484,112753,7,366553
45971,0.001316,172.31.36.0-255,66,112819,7,366553
45972,0.001326,74.125.200.0-255,2902,115721,7,366553
45973,0.001329,172.31.36.0-255,66,115787,7,366553
45974,0.001334,74.125.200.0-255,5738,121525,7,366553
45975,0.001339,172.31.36.0-255,66,121591,7,366553
45976,0.001364,74.125.200.0-255,4320,125911,7,366553
45977,0.001368,172.31.36.0-255,66,125977,7,366553
45978,0.0014,74.125.200.0-255,5738,131715,7,366553
45979,0.001404,172.31.36.0-255,66,131781,7,366553
45980,0.00141,74.125.200.0-255,2902,134683,7,366553
45981,0.001412,172.31.36.0-255,66,134749,7,366553
45982,0.001442,74.125.200.0-255,5020,139769,7,366553
45983,0.001446,172.31.36.0-255,66,139835,7,366553
45984,0.001878,74.125.200.0-255,1484,141319,7,366553
45985,0.001882,74.125.200.0-255,1484,142803,7,366553
45986,0.001885,172.31.36.0-255,66,142869,7,366553
45987,0.001902,74.125.200.0-255,1484,144353,7,366553
45988,0.001908,74.125.200.0-255,5738,150091,7,366553
45989,0.001911,172.31.36.0-255,66,150157,7,366553
45990,0.001943,74.125.200.0-255,4320,154477,7,366553
45991,0.001945,172.31.36.0-255,66,154543,7,366553
45992,0.001957,172.31.36.0-255,66,154609,7,366553
45993,0.002003,74.125.200.0-255,2902,157511,7,366553
45994,0.002006,172.31.36.0-255,66,157577,7,366553
45995,0.002031,74.125.200.0-255,5020,162597,7,366553
45996,0.002034,172.31.36.0-255,66,162663,7,366553
45997,0.004279,74.125.200.0-255,5738,168401,7,366553
45998,0.004283,172.31.36.0-255,66,168467,7,366553
45999,0.006555,74.125.200.0-255,5738,174205,7,366553
46000,0.006562,172.31.36.0-255,66,174271,7,366553
46001,0.008831,74.125.200.0-255,5738,180009,7,366553
46002,0.00884,172.31.36.0-255,66,180075,7,366553
46003,0.011098,74.125.200.0-255,5738,185813,7,366553
46004,0.011106,172.31.36.0-255,66,185879,7,366553
46005,0.013367,74.125.200.0-255,5738,191617,7,366553
46006,0.013375,172.31.36.0-255,66,191683,7,366553
46007,0.015629,74.125.200.0-255,5738,197421,7,366553
46008,0.015636,172.31.36.0-255,66,197487,7,366553
46009,0.017891,74.125.200.0-255,5738,203225,7,366553
46010,0.017898,172.31.36.0-255,66,203291,7,366553
46011,0.020153,74.125.200.0-255,5738,209029,7,366553
46012,0.02016,172.31.36.0-255,66,209095,7,366553
46013,0.022425,74.125.200.0-255,5738,214833,7,366553
46014,0.022431,172.31.36.0-255,66,214899,7,366553
46015,0.024695,74.125.200.0-255,5738,220637,7,366553
46016,0.024703,172.31.36.0-255,66,220703,7,366553
46017,0.026961,74.125.200.0-255,5738,226441,7,366553
46018,0.026969,172.31.36.0-255,66,226507,7,366553
46019,0.02926,74.125.200.0-255,5738,232245,7,366553
46020,0.029268,172.31.36.0-255,66,232311,7,366553
46021,0.029993,172.31.36.0-255,172,232483,7,366553
46022,0.030034,172.31.36.0-255,1113,233596,7,366553
46023,0.030119,172.31.36.0-255,1514,235110,7,366553
46024,0.030144,172.31.36.0-255,1514,236624,7,366553
46025,0.030146,172.31.36.0-255,1514,238138,7,366553
46026,0.030169,172.31.36.0-255,1514,239652,7,366553
46027,0.03017,172.31.36.0-255,1514,241166,7,366553
46028,0.030171,172.31.36.0-255,73,241239,7,366553
46029,0.031519,104.244.42.0-255,66,241305,7,366553
46030,0.031535,74.125.200.0-255,5738,247043,7,366553
46031,0.031542,172.31.36.0-255,66,247109,7,366553
46032,0.031578,104.244.42.0-255,66,247175,7,366553
46033,0.03166,104.244.42.0-255,66,247241,7,366553
46034,0.031709,104.244.42.0-255,66,247307,7,366553
46035,0.031712,104.244.42.0-255,66,247373,7,366553
46036,0.033802,74.125.200.0-255,5738,253111,7,366553
46037,0.033808,172.31.36.0-255,66,253177,7,366553
46038,0.036067,74.125.200.0-255,5738,258915,7,366553
46039,0.036072,172.31.36.0-255,66,258981,7,366553
46040,0.038336,74.125.200.0-255,5738,264719,7,366553
46041,0.038342,172.31.36.0-255,66,264785,7,366553
46042,0.040597,74.125.200.0-255,5738,270523,7,366553
46043,0.040603,172.31.36.0-255,66,270589,7,366553
46044,0.042864,74.125.200.0-255,5738,276327,7,366553
46045,0.042887,172.31.36.0-255,66,276393,7,366553
46046,0.045141,74.125.200.0-255,5738,282131,7,366553
46047,0.045147,172.31.36.0-255,66,282197,7,366553
46048,0.047423,74.125.200.0-255,5738,287935,7,366553
46049,0.047429,172.31.36.0-255,66,288001,7,366553
46050,0.049679,74.125.200.0-255,5738,293739,7,366553
46051,0.049684,172.31.36.0-255,66,293805,7,366553
46052,0.051939,74.125.200.0-255,4320,298125,7,366553
46053,0.051944,172.31.36.0-255,66,298191,7,366553
46054,0.051979,74.125.200.0-255,1484,299675,7,366553
46055,0.054195,74.125.200.0-255,4320,303995,7,366553
46056,0.054201,172.31.36.0-255,66,304061,7,366553
46057,0.056451,74.125.200.0-255,5738,309799,7,366553
46058,0.056456,172.31.36.0-255,66,309865,7,366553
46059,0.058719,74.125.200.0-255,5738,315603,7,366553
46060,0.058725,172.31.36.0-255,66,315669,7,366553
46061,0.060979,74.125.200.0-255,5738,321407,7,366553
46062,0.060983,172.31.36.0-255,66,321473,7,366553
46063,0.063248,74.125.200.0-255,5738,327211,7,366553
46064,0.063253,172.31.36.0-255,66,327277,7,366553
46065,0.065507,74.125.200.0-255,5738,333015,7,366553
46066,0.065512,172.31.36.0-255,66,333081,7,366553
46067,0.067767,74.125.200.0-255,5738,338819,7,366553
46068,0.067771,172.31.36.0-255,66,338885,7,366553
46069,0.070029,74.125.200.0-255,5738,344623,7,366553
46070,0.070034,172.31.36.0-255,66,344689,7,366553
46071,0.072317,74.125.200.0-255,4320,349009,7,366553
46072,0.072322,172.31.36.0-255,66,349075,7,366553
46073,0.072358,74.125.200.0-255,1484,350559,7,366553
46074,0.074579,74.125.200.0-255,4320,354879,7,366553
46075,0.074584,172.31.36.0-255,66,354945,7,366553
46076,0.076836,74.125.200.0-255,5738,360683,7,366553
46077,0.076841,172.31.36.0-255,66,360749,7,366553
46078,0.079105,74.125.200.0-255,5738,366487,7,366553
46079,0.07911,172.31.36.0-255,66,366553,7,366553
46080,0.0,172.217.194.0-255,153,153,7,286536
46081,2.2e-05,172.31.36.0-255,66,219,7,286536
46082,3e-05,172.217.194.0-255,1484,1703,7,286536
46083,3.4e-05,172.31.36.0-255,66,1769,7,286536
46084,4e-05,172.217.194.0-255,2902,4671,7,286536
46085,4.3e-05,172.31.36.0-255,66,4737,7,286536
46086,5.1e-05,172.217.194.0-255,7156,11893,7,286536
46087,5.4e-05,172.31.36.0-255,66,11959,7,286536
46088,5.9e-05,172.217.194.0-255,2035,13994,7,286536
46089,6.1e-05,172.31.36.0-255,66,14060,7,286536
46090,0.000303,172.217.194.0-255,1484,15544,7,286536
46091,0.000308,172.31.36.0-255,66,15610,7,286536
46092,0.000315,172.217.194.0-255,2902,18512,7,286536
46093,0.000318,172.31.36.0-255,66,18578,7,286536
46094,0.000325,172.217.194.0-255,5738,24316,7,286536
46095,0.000327,172.31.36.0-255,66,24382,7,286536
46096,0.000377,172.31.36.0-255,66,24448,7,286536
46097,0.000385,172.217.194.0-255,7156,31604,7,286536
46098,0.000387,172.31.36.0-255,66,31670,7,286536
46099,0.000435,172.217.194.0-255,4320,35990,7,286536
46100,0.000438,172.31.36.0-255,66,36056,7,286536
46101,0.000473,172.31.36.0-255,66,36122,7,286536
46102,0.000476,172.217.194.0-255,347,36469,7,286536
46103,0.000478,172.31.36.0-255,66,36535,7,286536
46104,0.000778,172.217.194.0-255,116,36651,7,286536
46105,0.000783,172.31.36.0-255,66,36717,7,286536
46106,0.000834,172.217.194.0-255,1484,38201,7,286536
46107,0.000838,172.217.194.0-255,2902,41103,7,286536
46108,0.000844,172.31.36.0-255,66,41169,7,286536
46109,0.000853,172.31.36.0-255,66,41235,7,286536
46110,0.000858,172.217.194.0-255,4320,45555,7,286536
46111,0.00086,172.31.36.0-255,66,45621,7,286536
46112,0.000877,172.217.194.0-255,2902,48523,7,286536
46113,0.000879,172.31.36.0-255,66,48589,7,286536
46114,0.000886,172.217.194.0-255,4320,52909,7,286536
46115,0.000888,172.31.36.0-255,66,52975,7,286536
46116,0.00091,172.217.194.0-255,5738,58713,7,286536
46117,0.000913,172.31.36.0-255,66,58779,7,286536
46118,0.000916,172.217.194.0-255,1484,60263,7,286536
46119,0.000954,172.31.36.0-255,66,60329,7,286536
46120,0.000957,172.217.194.0-255,766,61095,7,286536
46121,0.00111,172.217.194.0-255,1484,62579,7,286536
46122,0.00112,172.31.36.0-255,66,62645,7,286536
46123,0.001125,172.217.194.0-255,2902,65547,7,286536
46124,0.001128,172.31.36.0-255,66,65613,7,286536
46125,0.001131,172.217.194.0-255,1484,67097,7,286536
46126,0.001153,172.217.194.0-255,4320,71417,7,286536
46127,0.001156,172.31.36.0-255,66,71483,7,286536
46128,0.00117,172.217.194.0-255,2902,74385,7,286536
46129,0.001173,172.31.36.0-255,66,74451,7,286536
46130,0.001215,172.31.36.0-255,66,74517,7,286536
46131,0.001227,172.31.36.0-255,66,74583,7,286536
46132,0.00125,172.217.194.0-255,1484,76067,7,286536
46133,0.00127,172.217.194.0-255,2902,78969,7,286536
46134,0.001273,172.31.36.0-255,66,79035,7,286536
46135,0.001279,172.217.194.0-255,4320,83355,7,286536
46136,0.001282,172.31.36.0-255,66,83421,7,286536
46137,0.001299,172.217.194.0-255,1484,84905,7,286536
46138,0.001306,172.217.194.0-255,5738,90643,7,286536
46139,0.001309,172.31.36.0-255,66,90709,7,286536
46140,0.001322,172.31.36.0-255,66,90775,7,286536
46141,0.001377,172.217.194.0-255,5020,95795,7,286536
46142,0.001381,172.31.36.0-255,66,95861,7,286536
46143,0.00172,172.217.194.0-255,1484,97345,7,286536
46144,0.001727,172.217.194.0-255,2902,100247,7,286536
46145,0.00173,172.31.36.0-255,66,100313,7,286536
46146,0.001736,172.217.194.0-255,4320,104633,7,286536
46147,0.001738,172.31.36.0-255,66,104699,7,286536
46148,0.00175,172.217.194.0-255,1484,106183,7,286536
46149,0.001767,172.217.194.0-255,5738,111921,7,286536
46150,0.001769,172.31.36.0-255,66,111987,7,286536
46151,0.001783,172.217.194.0-255,1484,113471,7,286536
46152,0.001799,172.31.36.0-255,66,113537,7,286536
46153,0.001819,172.217.194.0-255,2902,116439,7,286536
46154,0.001822,172.31.36.0-255,66,116505,7,286536
46155,0.001826,172.217.194.0-255,2184,118689,7,286536
46156,0.001828,172.31.36.0-255,66,118755,7,286536
46157,0.001852,172.217.194.0-255,1484,120239,7,286536
46158,0.001874,172.217.194.0-255,2902,123141,7,286536
46159,0.001877,172.31.36.0-255,66,123207,7,286536
46160,0.001884,172.217.194.0-255,5738,128945,7,286536
46161,0.001886,172.31.36.0-255,66,129011,7,286536
46162,0.001927,172.31.36.0-255,66,129077,7,286536
46163,0.00195,172.217.194.0-255,1484,130561,7,286536
46164,0.001972,172.31.36.0-255,66,130627,7,286536
46165,0.001994,172.217.194.0-255,1484,132111,7,286536
46166,0.002007,172.217.194.0-255,2902,135013,7,286536
46167,0.002009,172.31.36.0-255,66,135079,7,286536
46168,0.002016,172.217.194.0-255,4320,139399,7,286536
46169,0.002018,172.31.36.0-255,66,139465,7,286536
46170,0.002032,172.217.194.0-255,1484,140949,7,286536
46171,0.002037,172.217.194.0-255,4320,145269,7,286536
46172,0.002041,172.31.36.0-255,66,145335,7,286536
46173,0.002063,172.31.36.0-255,66,145401,7,286536
46174,0.002074,172.31.36.0-255,66,145467,7,286536
46175,0.002205,172.217.194.0-255,1484,146951,7,286536
46176,0.002223,172.217.194.0-255,2902,149853,7,286536
46177,0.002226,172.31.36.0-255,66,149919,7,286536
46178,0.002243,172.217.194.0-255,5738,155657,7,286536
46179,0.002246,172.31.36.0-255,66,155723,7,286536
46180,0.002274,172.31.36.0-255,66,155789,7,286536
46181,0.002295,172.217.194.0-255,4320,160109,7,286536
46182,0.002298,172.31.36.0-255,66,160175,7,286536
46183,0.002337,172.31.36.0-255,66,160241,7,286536
46184,0.002352,172.217.194.0-255,2184,162425,7,286536
46185,0.002355,172.31.36.0-255,66,162491,7,286536
46186,0.002611,172.217.194.0-255,1484,163975,7,286536
46187,0.002617,172.217.194.0-255,2902,166877,7,286536
46188,0.002621,172.31.36.0-255,66,166943,7,286536
46189,0.002628,172.217.194.0-255,5738,172681,7,286536
46190,0.002631,172.31.36.0-255,66,172747,7,286536
46191,0.002633,172.217.194.0-255,1484,174231,7,286536
46192,0.005235,172.217.194.0-255,4320,178551,7,286536
46193,0.005244,172.31.36.0-255,66,178617,7,286536
46194,0.007854,172.217.194.0-255,5738,184355,7,286536
46195,0.00786,172.31.36.0-255,66,184421,7,286536
46196,0.010488,172.217.194.0-255,2902,187323,7,286536
46197,0.010495,172.31.36.0-255,66,187389,7,286536
46198,0.010516,172.217.194.0-255,2902,190291,7,286536
46199,0.010519,172.31.36.0-255,66,190357,7,286536
46200,0.013118,172.217.194.0-255,5738,196095,7,286536
46201,0.013126,172.31.36.0-255,66,196161,7,286536
46202,0.01574,172.217.194.0-255,5738,201899,7,286536
46203,0.015749,172.31.36.0-255,66,201965,7,286536
46204,0.018406,172.217.194.0-255,5738,207703,7,286536
46205,0.018417,172.31.36.0-255,66,207769,7,286536
46206,0.021056,172.217.194.0-255,5738,213507,7,286536
46207,0.021071,172.31.36.0-255,66,213573,7,286536
46208,0.023703,172.217.194.0-255,5738,219311,7,286536
46209,0.023712,172.31.36.0-255,66,219377,7,286536
46210,0.026332,172.217.194.0-255,5738,225115,7,286536
46211,0.026341,172.31.36.0-255,66,225181,7,286536
46212,0.028939,172.217.194.0-255,5738,230919,7,286536
46213,0.028945,172.31.36.0-255,66,230985,7,286536
46214,0.031574,172.217.194.0-255,5738,236723,7,286536
46215,0.031583,172.31.36.0-255,66,236789,7,286536
46216,0.034191,172.217.194.0-255,5738,242527,7,286536
46217,0.0342,172.31.36.0-255,66,242593,7,286536
46218,0.036233,172.31.36.0-255,172,242765,7,286536
46219,0.036265,172.31.36.0-255,1113,243878,7,286536
46220,0.036329,172.31.36.0-255,1514,245392,7,286536
46221,0.036331,172.31.36.0-255,1514,246906,7,286536
46222,0.036336,172.31.36.0-255,1514,248420,7,286536
46223,0.036338,172.31.36.0-255,1514,249934,7,286536
46224,0.036356,172.31.36.0-255,1514,251448,7,286536
46225,0.036357,172.31.36.0-255,71,251519,7,286536
46226,0.036829,172.217.194.0-255,5738,257257,7,286536
46227,0.036837,172.31.36.0-255,66,257323,7,286536
46228,0.037813,104.244.42.0-255,66,257389,7,286536
46229,0.037821,104.244.42.0-255,66,257455,7,286536
46230,0.037893,104.244.42.0-255,66,257521,7,286536
46231,0.037898,104.244.42.0-255,66,257587,7,286536
46232,0.039482,172.217.194.0-255,5738,263325,7,286536
46233,0.039492,172.31.36.0-255,66,263391,7,286536
46234,0.042099,172.217.194.0-255,5738,269129,7,286536
46235,0.042106,172.31.36.0-255,66,269195,7,286536
46236,0.044714,172.217.194.0-255,5738,274933,7,286536
46237,0.044721,172.31.36.0-255,66,274999,7,286536
46238,0.047321,172.217.194.0-255,5738,280737,7,286536
46239,0.047328,172.31.36.0-255,66,280803,7,286536
46240,0.04993,172.217.194.0-255,5496,286299,7,286536
46241,0.049936,172.31.36.0-255,66,286365,7,286536
46242,0.050119,172.31.36.0-255,105,286470,7,286536
46243,0.052715,172.217.194.0-255,66,286536,7,286536
46244,0.0,172.31.36.0-255,105,105,7,276
46245,0.068039,31.13.82.0-255,105,210,7,276
46246,0.068061,172.31.36.0-255,66,276,7,276
46247,0.0,74.125.24.0-255,153,153,7,313992
46248,3.6e-05,172.31.36.0-255,66,219,7,313992
46249,4.4e-05,74.125.24.0-255,1484,1703,7,313992
46250,4.9e-05,172.31.36.0-255,66,1769,7,313992
46251,6.2e-05,74.125.24.0-255,2902,4671,7,313992
46252,6.5e-05,172.31.36.0-255,66,4737,7,313992
46253,7.2e-05,74.125.24.0-255,7156,11893,7,313992
46254,7.5e-05,172.31.36.0-255,66,11959,7,313992
46255,8e-05,74.125.24.0-255,2053,14012,7,313992
46256,8.2e-05,172.31.36.0-255,66,14078,7,313992
46257,0.000436,74.125.24.0-255,1484,15562,7,313992
46258,0.000442,172.31.36.0-255,66,15628,7,313992
46259,0.000448,74.125.24.0-255,2902,18530,7,313992
46260,0.00045,172.31.36.0-255,66,18596,7,313992
46261,0.000463,74.125.24.0-255,5738,24334,7,313992
46262,0.000465,172.31.36.0-255,66,24400,7,313992
46263,0.000501,74.125.24.0-255,6797,31197,7,313992
46264,0.000505,172.31.36.0-255,66,31263,7,313992
46265,0.000751,74.125.24.0-255,1484,32747,7,313992
46266,0.000757,172.31.36.0-255,66,32813,7,313992
46267,0.000766,74.125.24.0-255,2902,35715,7,313992
46268,0.000776,172.31.36.0-255,66,35781,7,313992
46269,0.000784,74.125.24.0-255,5738,41519,7,313992
46270,0.000787,172.31.36.0-255,66,41585,7,313992
46271,0.000833,74.125.24.0-255,5738,47323,7,313992
46272,0.000837,172.31.36.0-255,66,47389,7,313992
46273,0.000867,74.125.24.0-255,5379,52768,7,313992
46274,0.00087,172.31.36.0-255,66,52834,7,313992
46275,0.000884,172.31.36.0-255,66,52900,7,313992
46276,0.000886,74.125.24.0-255,1125,54025,7,313992
46277,0.000889,172.31.36.0-255,66,54091,7,313992
46278,0.000894,74.125.24.0-255,400,54491,7,313992
46279,0.000999,74.125.24.0-255,109,54600,7,313992
46280,0.001032,74.125.24.0-255,1484,56084,7,313992
46281,0.001036,172.31.36.0-255,66,56150,7,313992
46282,0.00104,74.125.24.0-255,1484,57634,7,313992
46283,0.001064,74.125.24.0-255,1484,59118,7,313992
46284,0.001067,172.31.36.0-255,66,59184,7,313992
46285,0.001075,74.125.24.0-255,7156,66340,7,313992
46286,0.001077,172.31.36.0-255,66,66406,7,313992
46287,0.001089,74.125.24.0-255,5379,71785,7,313992
46288,0.001091,172.31.36.0-255,66,71851,7,313992
46289,0.001132,74.125.24.0-255,4320,76171,7,313992
46290,0.001136,172.31.36.0-255,66,76237,7,313992
46291,0.001166,74.125.24.0-255,7156,83393,7,313992
46292,0.001169,172.31.36.0-255,66,83459,7,313992
46293,0.001196,74.125.24.0-255,5379,88838,7,313992
46294,0.001199,172.31.36.0-255,66,88904,7,313992
46295,0.001233,74.125.24.0-255,1484,90388,7,313992
46296,0.001273,74.125.24.0-255,1484,91872,7,313992
46297,0.001276,172.31.36.0-255,66,91938,7,313992
46298,0.001297,74.125.24.0-255,1484,93422,7,313992
46299,0.001303,74.125.24.0-255,5738,99160,7,313992
46300,0.001305,172.31.36.0-255,66,99226,7,313992
46301,0.001312,74.125.24.0-255,7156,106382,7,313992
46302,0.001346,74.125.24.0-255,5738,112120,7,313992
46303,0.001372,74.125.24.0-255,2184,114304,7,313992
46304,0.001409,74.125.24.0-255,2902,117206,7,313992
46305,0.001434,74.125.24.0-255,7156,124362,7,313992
46306,0.001504,74.125.24.0-255,3602,127964,7,313992
46307,0.005647,172.31.36.0-255,66,128030,7,313992
46308,0.007929,74.125.24.0-255,5738,133768,7,313992
46309,0.007936,172.31.36.0-255,66,133834,7,313992
46310,0.010188,74.125.24.0-255,5738,139572,7,313992
46311,0.010195,172.31.36.0-255,66,139638,7,313992
46312,0.012452,74.125.24.0-255,5738,145376,7,313992
46313,0.01246,172.31.36.0-255,66,145442,7,313992
46314,0.014734,74.125.24.0-255,5738,151180,7,313992
46315,0.014742,172.31.36.0-255,66,151246,7,313992
46316,0.017052,74.125.24.0-255,5738,156984,7,313992
46317,0.017062,172.31.36.0-255,66,157050,7,313992
46318,0.019327,74.125.24.0-255,5738,162788,7,313992
46319,0.019336,172.31.36.0-255,66,162854,7,313992
46320,0.021595,74.125.24.0-255,5738,168592,7,313992
46321,0.021603,172.31.36.0-255,66,168658,7,313992
46322,0.023864,74.125.24.0-255,5738,174396,7,313992
46323,0.023872,172.31.36.0-255,66,174462,7,313992
46324,0.02613,74.125.24.0-255,5738,180200,7,313992
46325,0.026138,172.31.36.0-255,66,180266,7,313992
46326,0.028418,74.125.24.0-255,5738,186004,7,313992
46327,0.028425,172.31.36.0-255,66,186070,7,313992
46328,0.029756,172.31.36.0-255,172,186242,7,313992
46329,0.029787,172.31.36.0-255,1115,187357,7,313992
46330,0.02983,172.31.36.0-255,1514,188871,7,313992
46331,0.029832,172.31.36.0-255,1291,190162,7,313992
46332,0.030719,74.125.24.0-255,5738,195900,7,313992
46333,0.030726,172.31.36.0-255,66,195966,7,313992
46334,0.031351,104.244.42.0-255,66,196032,7,313992
46335,0.031358,104.244.42.0-255,66,196098,7,313992
46336,0.031387,104.244.42.0-255,66,196164,7,313992
46337,0.032991,74.125.24.0-255,4320,200484,7,313992
46338,0.032996,172.31.36.0-255,66,200550,7,313992
46339,0.03303,74.125.24.0-255,1484,202034,7,313992
46340,0.035287,74.125.24.0-255,4320,206354,7,313992
46341,0.035294,172.31.36.0-255,66,206420,7,313992
46342,0.037586,74.125.24.0-255,4320,210740,7,313992
46343,0.037592,172.31.36.0-255,66,210806,7,313992
46344,0.037621,74.125.24.0-255,1484,212290,7,313992
46345,0.03987,74.125.24.0-255,4320,216610,7,313992
46346,0.039881,172.31.36.0-255,66,216676,7,313992
46347,0.042149,74.125.24.0-255,5738,222414,7,313992
46348,0.042155,172.31.36.0-255,66,222480,7,313992
46349,0.044425,74.125.24.0-255,5738,228218,7,313992
46350,0.044431,172.31.36.0-255,66,228284,7,313992
46351,0.046711,74.125.24.0-255,5738,234022,7,313992
46352,0.046716,172.31.36.0-255,66,234088,7,313992
46353,0.048968,74.125.24.0-255,5738,239826,7,313992
46354,0.048973,172.31.36.0-255,66,239892,7,313992
46355,0.051297,74.125.24.0-255,4320,244212,7,313992
46356,0.051303,172.31.36.0-255,66,244278,7,313992
46357,0.051331,74.125.24.0-255,1484,245762,7,313992
46358,0.05357,74.125.24.0-255,4320,250082,7,313992
46359,0.053576,172.31.36.0-255,66,250148,7,313992
46360,0.055842,74.125.24.0-255,5738,255886,7,313992
46361,0.055853,172.31.36.0-255,66,255952,7,313992
46362,0.058104,74.125.24.0-255,5738,261690,7,313992
46363,0.05811,172.31.36.0-255,66,261756,7,313992
46364,0.060387,74.125.24.0-255,5738,267494,7,313992
46365,0.060393,172.31.36.0-255,66,267560,7,313992
46366,0.062677,74.125.24.0-255,5738,273298,7,313992
46367,0.062683,172.31.36.0-255,66,273364,7,313992
46368,0.064955,74.125.24.0-255,5738,279102,7,313992
46369,0.064961,172.31.36.0-255,66,279168,7,313992
46370,0.06723,74.125.24.0-255,5738,284906,7,313992
46371,0.067236,172.31.36.0-255,66,284972,7,313992
46372,0.069487,74.125.24.0-255,5738,290710,7,313992
46373,0.069492,172.31.36.0-255,66,290776,7,313992
46374,0.071781,74.125.24.0-255,5738,296514,7,313992
46375,0.07179,172.31.36.0-255,66,296580,7,313992
46376,0.074046,74.125.24.0-255,5738,302318,7,313992
46377,0.074052,172.31.36.0-255,66,302384,7,313992
46378,0.076306,74.125.24.0-255,5738,308122,7,313992
46379,0.076311,172.31.36.0-255,66,308188,7,313992
46380,0.078602,74.125.24.0-255,5738,313926,7,313992
46381,0.078608,172.31.36.0-255,66,313992,7,313992
46382,0.0,74.125.24.0-255,151,151,7,266141
46383,2.4e-05,172.31.36.0-255,66,217,7,266141
46384,3.1e-05,74.125.24.0-255,1484,1701,7,266141
46385,3.6e-05,172.31.36.0-255,66,1767,7,266141
46386,4.2e-05,74.125.24.0-255,2902,4669,7,266141
46387,5.3e-05,172.31.36.0-255,66,4735,7,266141
46388,6.1e-05,74.125.24.0-255,7156,11891,7,266141
46389,6.4e-05,172.31.36.0-255,66,11957,7,266141
46390,6.8e-05,74.125.24.0-255,2066,14023,7,266141
46391,7.2e-05,172.31.36.0-255,66,14089,7,266141
46392,0.000137,74.125.24.0-255,5738,19827,7,266141
46393,0.000141,172.31.36.0-255,66,19893,7,266141
46394,0.000171,74.125.24.0-255,5738,25631,7,266141
46395,0.000175,172.31.36.0-255,66,25697,7,266141
46396,0.000181,74.125.24.0-255,5379,31076,7,266141
46397,0.000183,172.31.36.0-255,66,31142,7,266141
46398,0.000214,74.125.24.0-255,1484,32626,7,266141
46399,0.000216,172.31.36.0-255,66,32692,7,266141
46400,0.000221,74.125.24.0-255,2902,35594,7,266141
46401,0.000223,172.31.36.0-255,66,35660,7,266141
46402,0.000231,74.125.24.0-255,5738,41398,7,266141
46403,0.000237,172.31.36.0-255,66,41464,7,266141
46404,0.000282,172.31.36.0-255,66,41530,7,266141
46405,0.000319,172.31.36.0-255,66,41596,7,266141
46406,0.000385,74.125.24.0-255,116,41712,7,266141
46407,0.000389,172.31.36.0-255,66,41778,7,266141
46408,0.000415,74.125.24.0-255,327,42105,7,266141
46409,0.000417,172.31.36.0-255,66,42171,7,266141
46410,0.000593,74.125.24.0-255,1484,43655,7,266141
46411,0.000598,172.31.36.0-255,66,43721,7,266141
46412,0.000604,74.125.24.0-255,2902,46623,7,266141
46413,0.000606,172.31.36.0-255,66,46689,7,266141
46414,0.000618,74.125.24.0-255,4320,51009,7,266141
46415,0.000621,172.31.36.0-255,66,51075,7,266141
46416,0.000648,74.125.24.0-255,1484,52559,7,266141
46417,0.000664,172.31.36.0-255,66,52625,7,266141
46418,0.00067,74.125.24.0-255,4320,56945,7,266141
46419,0.000672,172.31.36.0-255,66,57011,7,266141
46420,0.000695,74.125.24.0-255,6438,63449,7,266141
46421,0.000711,172.31.36.0-255,66,63515,7,266141
46422,0.000778,74.125.24.0-255,1484,64999,7,266141
46423,0.000784,74.125.24.0-255,2902,67901,7,266141
46424,0.000787,172.31.36.0-255,66,67967,7,266141
46425,0.000794,74.125.24.0-255,5738,73705,7,266141
46426,0.000797,172.31.36.0-255,66,73771,7,266141
46427,0.000818,74.125.24.0-255,5738,79509,7,266141
46428,0.000843,74.125.24.0-255,7156,86665,7,266141
46429,0.000851,172.31.36.0-255,66,86731,7,266141
46430,0.000876,74.125.24.0-255,4320,91051,7,266141
46431,0.000894,74.125.24.0-255,6438,97489,7,266141
46432,0.0009,172.31.36.0-255,66,97555,7,266141
46433,0.000971,74.125.24.0-255,5738,103293,7,266141
46434,0.000991,74.125.24.0-255,4320,107613,7,266141
46435,0.001013,172.31.36.0-255,66,107679,7,266141
46436,0.001039,74.125.24.0-255,1484,109163,7,266141
46437,0.001044,74.125.24.0-255,2902,112065,7,266141
46438,0.001048,74.125.24.0-255,1484,113549,7,266141
46439,0.001057,172.31.36.0-255,66,113615,7,266141
46440,0.001067,74.125.24.0-255,4320,117935,7,266141
46441,0.001077,172.31.36.0-255,66,118001,7,266141
46442,0.001084,74.125.24.0-255,1484,119485,7,266141
46443,0.001087,74.125.24.0-255,1484,120969,7,266141
46444,0.0011,74.125.24.0-255,1484,122453,7,266141
46445,0.001106,74.125.24.0-255,4320,126773,7,266141
46446,0.001124,74.125.24.0-255,1484,128257,7,266141
46447,0.00113,74.125.24.0-255,5738,133995,7,266141
46448,0.001149,172.31.36.0-255,66,134061,7,266141
46449,0.001186,172.31.36.0-255,66,134127,7,266141
46450,0.001222,74.125.24.0-255,4320,138447,7,266141
46451,0.001233,74.125.24.0-255,1484,139931,7,266141
46452,0.00125,74.125.24.0-255,4320,144251,7,266141
46453,0.00126,172.31.36.0-255,66,144317,7,266141
46454,0.001273,172.31.36.0-255,66,144383,7,266141
46455,0.001305,74.125.24.0-255,2902,147285,7,266141
46456,0.00131,74.125.24.0-255,3602,150887,7,266141
46457,0.001322,74.125.24.0-255,4320,155207,7,266141
46458,0.001335,172.31.36.0-255,66,155273,7,266141
46459,0.001358,74.125.24.0-255,1484,156757,7,266141
46460,0.001361,74.125.24.0-255,1484,158241,7,266141
46461,0.001366,172.31.36.0-255,66,158307,7,266141
46462,0.001435,172.31.36.0-255,66,158373,7,266141
46463,0.001475,172.31.36.0-255,66,158439,7,266141
46464,0.00175,74.125.24.0-255,1484,159923,7,266141
46465,0.001756,74.125.24.0-255,2902,162825,7,266141
46466,0.001759,74.125.24.0-255,1484,164309,7,266141
46467,0.001774,74.125.24.0-255,4320,168629,7,266141
46468,0.001777,172.31.36.0-255,66,168695,7,266141
46469,0.001782,172.31.36.0-255,66,168761,7,266141
46470,0.001797,74.125.24.0-255,4320,173081,7,266141
46471,0.001831,74.125.24.0-255,5738,178819,7,266141
46472,0.001838,74.125.24.0-255,5738,184557,7,266141
46473,0.001848,172.31.36.0-255,66,184623,7,266141
46474,0.00187,74.125.24.0-255,5738,190361,7,266141
46475,0.001874,74.125.24.0-255,2184,192545,7,266141
46476,0.00192,172.31.36.0-255,66,192611,7,266141
46477,0.00195,74.125.24.0-255,1484,194095,7,266141
46478,0.001955,74.125.24.0-255,2902,196997,7,266141
46479,0.001961,74.125.24.0-255,5738,202735,7,266141
46480,0.001969,172.31.36.0-255,66,202801,7,266141
46481,0.002014,74.125.24.0-255,4320,207121,7,266141
46482,0.002029,172.31.36.0-255,66,207187,7,266141
46483,0.002041,74.125.24.0-255,2902,210089,7,266141
46484,0.002082,172.31.36.0-255,66,210155,7,266141
46485,0.003066,172.31.36.0-255,101,210256,7,266141
46486,0.004096,74.125.24.0-255,5738,215994,7,266141
46487,0.004102,172.31.36.0-255,66,216060,7,266141
46488,0.005061,74.125.24.0-255,66,216126,7,266141
46489,0.006148,74.125.24.0-255,5738,221864,7,266141
46490,0.006155,172.31.36.0-255,66,221930,7,266141
46491,0.008214,74.125.24.0-255,5738,227668,7,266141
46492,0.008221,172.31.36.0-255,66,227734,7,266141
46493,0.010254,74.125.24.0-255,5738,233472,7,266141
46494,0.01026,172.31.36.0-255,66,233538,7,266141
46495,0.012306,74.125.24.0-255,5738,239276,7,266141
46496,0.012314,172.31.36.0-255,66,239342,7,266141
46497,0.014323,74.125.24.0-255,5738,245080,7,266141
46498,0.014332,172.31.36.0-255,66,245146,7,266141
46499,0.016415,74.125.24.0-255,5738,250884,7,266141
46500,0.016424,172.31.36.0-255,66,250950,7,266141
46501,0.018453,74.125.24.0-255,5738,256688,7,266141
46502,0.018461,172.31.36.0-255,66,256754,7,266141
46503,0.02051,74.125.24.0-255,4860,261614,7,266141
46504,0.020517,172.31.36.0-255,66,261680,7,266141
46505,0.020876,172.31.36.0-255,105,261785,7,266141
46506,0.028193,74.125.24.0-255,66,261851,7,266141
46507,0.032906,172.31.36.0-255,172,262023,7,266141
46508,0.032988,172.31.36.0-255,1114,263137,7,266141
46509,0.034462,104.244.42.0-255,66,263203,7,266141
46510,0.034508,104.244.42.0-255,66,263269,7,266141
46511,0.035638,172.31.36.0-255,1514,264783,7,266141
46512,0.03564,172.31.36.0-255,1292,266075,7,266141
46513,0.037191,104.244.42.0-255,66,266141,7,266141
46514,0.0,172.217.194.0-255,153,153,7,179585
46515,1.5e-05,172.31.36.0-255,66,219,7,179585
46516,2.2e-05,172.217.194.0-255,1484,1703,7,179585
46517,2.6e-05,172.31.36.0-255,66,1769,7,179585
46518,3.2e-05,172.217.194.0-255,2902,4671,7,179585
46519,4.3e-05,172.31.36.0-255,66,4737,7,179585
46520,5.2e-05,172.217.194.0-255,7156,11893,7,179585
46521,5.5e-05,172.31.36.0-255,66,11959,7,179585
46522,5.9e-05,172.217.194.0-255,2028,13987,7,179585
46523,6.2e-05,172.31.36.0-255,66,14053,7,179585
46524,7.5e-05,172.31.36.0-255,66,14119,7,179585
46525,8.1e-05,172.217.194.0-255,2902,17021,7,179585
46526,8.3e-05,172.31.36.0-255,66,17087,7,179585
46527,0.000125,172.31.36.0-255,66,17153,7,179585
46528,0.000128,172.217.194.0-255,766,17919,7,179585
46529,0.00013,172.31.36.0-255,66,17985,7,179585
46530,0.00034,172.217.194.0-255,1484,19469,7,179585
46531,0.000346,172.31.36.0-255,66,19535,7,179585
46532,0.000353,172.217.194.0-255,2902,22437,7,179585
46533,0.000355,172.31.36.0-255,66,22503,7,179585
46534,0.00036,172.217.194.0-255,2902,25405,7,179585
46535,0.000367,172.31.36.0-255,66,25471,7,179585
46536,0.000392,172.217.194.0-255,2902,28373,7,179585
46537,0.000395,172.31.36.0-255,66,28439,7,179585
46538,0.000402,172.217.194.0-255,5738,34177,7,179585
46539,0.000404,172.31.36.0-255,66,34243,7,179585
46540,0.000433,172.217.194.0-255,1430,35673,7,179585
46541,0.000436,172.31.36.0-255,66,35739,7,179585
46542,0.000595,172.217.194.0-255,1484,37223,7,179585
46543,0.000599,172.31.36.0-255,66,37289,7,179585
46544,0.000604,172.217.194.0-255,1484,38773,7,179585
46545,0.000645,172.217.194.0-255,1484,40257,7,179585
46546,0.000648,172.31.36.0-255,66,40323,7,179585
46547,0.000655,172.217.194.0-255,5738,46061,7,179585
46548,0.000657,172.31.36.0-255,66,46127,7,179585
46549,0.000668,172.217.194.0-255,5738,51865,7,179585
46550,0.00067,172.31.36.0-255,66,51931,7,179585
46551,0.000685,172.31.36.0-255,66,51997,7,179585
46552,0.000691,172.217.194.0-255,4320,56317,7,179585
46553,0.000693,172.31.36.0-255,66,56383,7,179585
46554,0.000723,172.217.194.0-255,766,57149,7,179585
46555,0.000899,172.217.194.0-255,1484,58633,7,179585
46556,0.000904,172.31.36.0-255,66,58699,7,179585
46557,0.00091,172.217.194.0-255,2902,61601,7,179585
46558,0.000912,172.31.36.0-255,66,61667,7,179585
46559,0.000931,172.217.194.0-255,2902,64569,7,179585
46560,0.000934,172.31.36.0-255,66,64635,7,179585
46561,0.000964,172.217.194.0-255,2902,67537,7,179585
46562,0.000967,172.31.36.0-255,66,67603,7,179585
46563,0.000981,172.31.36.0-255,66,67669,7,179585
46564,0.001006,172.217.194.0-255,5738,73407,7,179585
46565,0.001009,172.31.36.0-255,66,73473,7,179585
46566,0.001047,172.31.36.0-255,66,73539,7,179585
46567,0.001059,172.31.36.0-255,66,73605,7,179585
46568,0.001083,172.217.194.0-255,4320,77925,7,179585
46569,0.001085,172.31.36.0-255,66,77991,7,179585
46570,0.001092,172.217.194.0-255,5738,83729,7,179585
46571,0.001094,172.31.36.0-255,66,83795,7,179585
46572,0.00112,172.217.194.0-255,3602,87397,7,179585
46573,0.001124,172.31.36.0-255,66,87463,7,179585
46574,0.001143,172.217.194.0-255,1484,88947,7,179585
46575,0.001148,172.217.194.0-255,2902,91849,7,179585
46576,0.001152,172.31.36.0-255,66,91915,7,179585
46577,0.001217,172.217.194.0-255,5738,97653,7,179585
46578,0.00122,172.31.36.0-255,66,97719,7,179585
46579,0.001226,172.217.194.0-255,5738,103457,7,179585
46580,0.001228,172.31.36.0-255,66,103523,7,179585
46581,0.001241,172.31.36.0-255,66,103589,7,179585
46582,0.001274,172.217.194.0-255,5020,108609,7,179585
46583,0.001278,172.31.36.0-255,66,108675,7,179585
46584,0.001315,172.217.194.0-255,1484,110159,7,179585
46585,0.001331,172.217.194.0-255,2902,113061,7,179585
46586,0.001334,172.31.36.0-255,66,113127,7,179585
46587,0.001338,172.217.194.0-255,1484,114611,7,179585
46588,0.001361,172.217.194.0-255,4320,118931,7,179585
46589,0.001365,172.31.36.0-255,66,118997,7,179585
46590,0.001397,172.31.36.0-255,66,119063,7,179585
46591,0.001424,172.217.194.0-255,4320,123383,7,179585
46592,0.001428,172.31.36.0-255,66,123449,7,179585
46593,0.001433,172.217.194.0-255,2902,126351,7,179585
46594,0.001435,172.31.36.0-255,66,126417,7,179585
46595,0.001466,172.31.36.0-255,66,126483,7,179585
46596,0.001509,172.31.36.0-255,66,126549,7,179585
46597,0.001529,172.31.36.0-255,66,126615,7,179585
46598,0.00154,172.31.36.0-255,66,126681,7,179585
46599,0.001598,172.217.194.0-255,1484,128165,7,179585
46600,0.001603,172.217.194.0-255,2902,131067,7,179585
46601,0.001606,172.31.36.0-255,66,131133,7,179585
46602,0.001613,172.217.194.0-255,5738,136871,7,179585
46603,0.001616,172.31.36.0-255,66,136937,7,179585
46604,0.001637,172.217.194.0-255,7156,144093,7,179585
46605,0.001639,172.31.36.0-255,66,144159,7,179585
46606,0.001674,172.217.194.0-255,5738,149897,7,179585
46607,0.001678,172.31.36.0-255,66,149963,7,179585
46608,0.00169,172.31.36.0-255,66,150029,7,179585
46609,0.001694,172.217.194.0-255,1484,151513,7,179585
46610,0.001698,172.217.194.0-255,2902,154415,7,179585
46611,0.001701,172.31.36.0-255,66,154481,7,179585
46612,0.001708,172.217.194.0-255,5738,160219,7,179585
46613,0.00171,172.31.36.0-255,66,160285,7,179585
46614,0.001747,172.31.36.0-255,66,160351,7,179585
46615,0.001786,172.217.194.0-255,1484,161835,7,179585
46616,0.001805,172.31.36.0-255,66,161901,7,179585
46617,0.001863,172.217.194.0-255,5738,167639,7,179585
46618,0.001921,172.31.36.0-255,66,167705,7,179585
46619,0.00195,172.217.194.0-255,7156,174861,7,179585
46620,0.001961,172.31.36.0-255,66,174927,7,179585
46621,0.002001,172.217.194.0-255,105,175032,7,179585
46622,0.002025,172.31.36.0-255,66,175098,7,179585
46623,0.004683,172.31.36.0-255,105,175203,7,179585
46624,0.00688,172.217.194.0-255,66,175269,7,179585
46625,0.030768,172.31.36.0-255,198,175467,7,179585
46626,0.030801,172.31.36.0-255,958,176425,7,179585
46627,0.030864,172.31.36.0-255,1514,177939,7,179585
46628,0.030866,172.31.36.0-255,1448,179387,7,179585
46629,0.03234,104.244.42.0-255,66,179453,7,179585
46630,0.03237,104.244.42.0-255,66,179519,7,179585
46631,0.032475,104.244.42.0-255,66,179585,7,179585
46632,0.0,74.125.24.0-255,143,143,7,378170
46633,3.4e-05,172.31.36.0-255,66,209,7,378170
46634,4.1e-05,74.125.24.0-255,1484,1693,7,378170
46635,4.5e-05,172.31.36.0-255,66,1759,7,378170
46636,5e-05,74.125.24.0-255,2902,4661,7,378170
46637,5.3e-05,172.31.36.0-255,66,4727,7,378170
46638,6e-05,74.125.24.0-255,7156,11883,7,378170
46639,6.2e-05,172.31.36.0-255,66,11949,7,378170
46640,8e-05,74.125.24.0-255,2039,13988,7,378170
46641,8.2e-05,172.31.36.0-255,66,14054,7,378170
46642,0.000132,74.125.24.0-255,1484,15538,7,378170
46643,0.000135,172.31.36.0-255,66,15604,7,378170
46644,0.00014,74.125.24.0-255,2902,18506,7,378170
46645,0.000143,172.31.36.0-255,66,18572,7,378170
46646,0.000145,74.125.24.0-255,1484,20056,7,378170
46647,0.000148,172.31.36.0-255,66,20122,7,378170
46648,0.000172,74.125.24.0-255,4320,24442,7,378170
46649,0.000174,172.31.36.0-255,66,24508,7,378170
46650,0.00018,74.125.24.0-255,1484,25992,7,378170
46651,0.000182,172.31.36.0-255,66,26058,7,378170
46652,0.000198,74.125.24.0-255,5379,31437,7,378170
46653,0.000201,172.31.36.0-255,66,31503,7,378170
46654,0.000208,74.125.24.0-255,7156,38659,7,378170
46655,0.000211,172.31.36.0-255,66,38725,7,378170
46656,0.000271,74.125.24.0-255,2902,41627,7,378170
46657,0.000275,172.31.36.0-255,66,41693,7,378170
46658,0.000296,74.125.24.0-255,6797,48490,7,378170
46659,0.0003,172.31.36.0-255,66,48556,7,378170
46660,0.00045,74.125.24.0-255,1484,50040,7,378170
46661,0.000454,172.31.36.0-255,66,50106,7,378170
46662,0.000459,74.125.24.0-255,2902,53008,7,378170
46663,0.000462,172.31.36.0-255,66,53074,7,378170
46664,0.000468,74.125.24.0-255,4320,57394,7,378170
46665,0.00047,172.31.36.0-255,66,57460,7,378170
46666,0.000482,74.125.24.0-255,1484,58944,7,378170
46667,0.000501,74.125.24.0-255,2902,61846,7,378170
46668,0.000504,172.31.36.0-255,66,61912,7,378170
46669,0.000524,74.125.24.0-255,4307,66219,7,378170
46670,0.000528,172.31.36.0-255,66,66285,7,378170
46671,0.000531,74.125.24.0-255,332,66617,7,378170
46672,0.000673,74.125.24.0-255,1484,68101,7,378170
46673,0.000677,172.31.36.0-255,66,68167,7,378170
46674,0.000682,74.125.24.0-255,2902,71069,7,378170
46675,0.000685,172.31.36.0-255,66,71135,7,378170
46676,0.00071,74.125.24.0-255,2902,74037,7,378170
46677,0.000713,172.31.36.0-255,66,74103,7,378170
46678,0.000718,74.125.24.0-255,4320,78423,7,378170
46679,0.00072,172.31.36.0-255,66,78489,7,378170
46680,0.000753,74.125.24.0-255,1484,79973,7,378170
46681,0.000757,172.31.36.0-255,66,80039,7,378170
46682,0.000807,74.125.24.0-255,4320,84359,7,378170
46683,0.000811,172.31.36.0-255,66,84425,7,378170
46684,0.000833,74.125.24.0-255,6797,91222,7,378170
46685,0.000836,172.31.36.0-255,66,91288,7,378170
46686,0.001411,74.125.24.0-255,1484,92772,7,378170
46687,0.001419,74.125.24.0-255,2902,95674,7,378170
46688,0.001423,172.31.36.0-255,66,95740,7,378170
46689,0.001429,74.125.24.0-255,2902,98642,7,378170
46690,0.001431,172.31.36.0-255,66,98708,7,378170
46691,0.001445,74.125.24.0-255,2902,101610,7,378170
46692,0.001447,172.31.36.0-255,66,101676,7,378170
46693,0.001452,74.125.24.0-255,2902,104578,7,378170
46694,0.001454,172.31.36.0-255,66,104644,7,378170
46695,0.001474,172.31.36.0-255,66,104710,7,378170
46696,0.00148,74.125.24.0-255,5738,110448,7,378170
46697,0.001483,172.31.36.0-255,66,110514,7,378170
46698,0.001529,74.125.24.0-255,6438,116952,7,378170
46699,0.001533,172.31.36.0-255,66,117018,7,378170
46700,0.001558,74.125.24.0-255,7156,124174,7,378170
46701,0.001562,172.31.36.0-255,66,124240,7,378170
46702,0.001567,74.125.24.0-255,2902,127142,7,378170
46703,0.001569,172.31.36.0-255,66,127208,7,378170
46704,0.00159,172.31.36.0-255,66,127274,7,378170
46705,0.001609,74.125.24.0-255,1484,128758,7,378170
46706,0.001624,74.125.24.0-255,5738,134496,7,378170
46707,0.001627,172.31.36.0-255,66,134562,7,378170
46708,0.001645,74.125.24.0-255,3602,138164,7,378170
46709,0.001648,172.31.36.0-255,66,138230,7,378170
46710,0.002094,74.125.24.0-255,1484,139714,7,378170
46711,0.002102,74.125.24.0-255,1484,141198,7,378170
46712,0.002108,172.31.36.0-255,66,141264,7,378170
46713,0.002129,74.125.24.0-255,1484,142748,7,378170
46714,0.002135,74.125.24.0-255,5738,148486,7,378170
46715,0.002138,172.31.36.0-255,66,148552,7,378170
46716,0.002143,74.125.24.0-255,2902,151454,7,378170
46717,0.002146,172.31.36.0-255,66,151520,7,378170
46718,0.002154,74.125.24.0-255,7156,158676,7,378170
46719,0.002156,172.31.36.0-255,66,158742,7,378170
46720,0.00217,74.125.24.0-255,2902,161644,7,378170
46721,0.002172,172.31.36.0-255,66,161710,7,378170
46722,0.002179,74.125.24.0-255,5738,167448,7,378170
46723,0.00218,172.31.36.0-255,66,167514,7,378170
46724,0.002227,74.125.24.0-255,4320,171834,7,378170
46725,0.00223,172.31.36.0-255,66,171900,7,378170
46726,0.002247,74.125.24.0-255,766,172666,7,378170
46727,0.00443,74.125.24.0-255,4320,176986,7,378170
46728,0.004437,172.31.36.0-255,66,177052,7,378170
46729,0.006627,74.125.24.0-255,4320,181372,7,378170
46730,0.00663,172.31.36.0-255,66,181438,7,378170
46731,0.006647,74.125.24.0-255,1484,182922,7,378170
46732,0.008818,74.125.24.0-255,4320,187242,7,378170
46733,0.008825,172.31.36.0-255,66,187308,7,378170
46734,0.01104,74.125.24.0-255,5738,193046,7,378170
46735,0.011048,172.31.36.0-255,66,193112,7,378170
46736,0.013307,74.125.24.0-255,5738,198850,7,378170
46737,0.013314,172.31.36.0-255,66,198916,7,378170
46738,0.015497,74.125.24.0-255,5738,204654,7,378170
46739,0.015503,172.31.36.0-255,66,204720,7,378170
46740,0.017693,74.125.24.0-255,5738,210458,7,378170
46741,0.017706,172.31.36.0-255,66,210524,7,378170
46742,0.019911,74.125.24.0-255,5738,216262,7,378170
46743,0.01992,172.31.36.0-255,66,216328,7,378170
46744,0.022117,74.125.24.0-255,4320,220648,7,378170
46745,0.022125,172.31.36.0-255,66,220714,7,378170
46746,0.022162,74.125.24.0-255,1484,222198,7,378170
46747,0.024329,74.125.24.0-255,4320,226518,7,378170
46748,0.024336,172.31.36.0-255,66,226584,7,378170
46749,0.026535,74.125.24.0-255,5738,232322,7,378170
46750,0.026542,172.31.36.0-255,66,232388,7,378170
46751,0.028735,74.125.24.0-255,5738,238126,7,378170
46752,0.028742,172.31.36.0-255,66,238192,7,378170
46753,0.030935,74.125.24.0-255,5738,243930,7,378170
46754,0.030942,172.31.36.0-255,66,243996,7,378170
46755,0.03315,74.125.24.0-255,5738,249734,7,378170
46756,0.033158,172.31.36.0-255,66,249800,7,378170
46757,0.035361,74.125.24.0-255,5738,255538,7,378170
46758,0.03537,172.31.36.0-255,66,255604,7,378170
46759,0.037585,74.125.24.0-255,5738,261342,7,378170
46760,0.037596,172.31.36.0-255,66,261408,7,378170
46761,0.038236,172.31.36.0-255,172,261580,7,378170
46762,0.038273,172.31.36.0-255,1113,262693,7,378170
46763,0.038326,172.31.36.0-255,1514,264207,7,378170
46764,0.038328,172.31.36.0-255,1514,265721,7,378170
46765,0.038333,172.31.36.0-255,1514,267235,7,378170
46766,0.038334,172.31.36.0-255,1514,268749,7,378170
46767,0.038357,172.31.36.0-255,1514,270263,7,378170
46768,0.038363,172.31.36.0-255,71,270334,7,378170
46769,0.039787,74.125.24.0-255,5738,276072,7,378170
46770,0.039802,172.31.36.0-255,66,276138,7,378170
46771,0.039824,104.244.42.0-255,66,276204,7,378170
46772,0.039853,104.244.42.0-255,66,276270,7,378170
46773,0.039906,104.244.42.0-255,66,276336,7,378170
46774,0.039966,104.244.42.0-255,66,276402,7,378170
46775,0.042,74.125.24.0-255,5738,282140,7,378170
46776,0.042007,172.31.36.0-255,66,282206,7,378170
46777,0.044216,74.125.24.0-255,5738,287944,7,378170
46778,0.044221,172.31.36.0-255,66,288010,7,378170
46779,0.046405,74.125.24.0-255,5738,293748,7,378170
46780,0.046411,172.31.36.0-255,66,293814,7,378170
46781,0.048589,74.125.24.0-255,5738,299552,7,378170
46782,0.048593,172.31.36.0-255,66,299618,7,378170
46783,0.050799,74.125.24.0-255,5738,305356,7,378170
46784,0.050805,172.31.36.0-255,66,305422,7,378170
46785,0.052984,74.125.24.0-255,4320,309742,7,378170
46786,0.052989,172.31.36.0-255,66,309808,7,378170
46787,0.053023,74.125.24.0-255,1484,311292,7,378170
46788,0.055165,74.125.24.0-255,4320,315612,7,378170
46789,0.05517,172.31.36.0-255,66,315678,7,378170
46790,0.057366,74.125.24.0-255,5738,321416,7,378170
46791,0.057371,172.31.36.0-255,66,321482,7,378170
46792,0.059587,74.125.24.0-255,5738,327220,7,378170
46793,0.059594,172.31.36.0-255,66,327286,7,378170
46794,0.061806,74.125.24.0-255,5738,333024,7,378170
46795,0.061813,172.31.36.0-255,66,333090,7,378170
46796,0.064011,74.125.24.0-255,5738,338828,7,378170
46797,0.064016,172.31.36.0-255,66,338894,7,378170
46798,0.066203,74.125.24.0-255,5738,344632,7,378170
46799,0.066208,172.31.36.0-255,66,344698,7,378170
46800,0.068413,74.125.24.0-255,5738,350436,7,378170
46801,0.068418,172.31.36.0-255,66,350502,7,378170
46802,0.070599,74.125.24.0-255,5738,356240,7,378170
46803,0.070605,172.31.36.0-255,66,356306,7,378170
46804,0.072812,74.125.24.0-255,4320,360626,7,378170
46805,0.072818,172.31.36.0-255,66,360692,7,378170
46806,0.072845,74.125.24.0-255,1484,362176,7,378170
46807,0.074993,74.125.24.0-255,4320,366496,7,378170
46808,0.074998,172.31.36.0-255,66,366562,7,378170
46809,0.077188,74.125.24.0-255,5738,372300,7,378170
46810,0.077194,172.31.36.0-255,66,372366,7,378170
46811,0.079394,74.125.24.0-255,5738,378104,7,378170
46812,0.0794,172.31.36.0-255,66,378170,7,378170
46813,0.0,74.125.200.0-255,300,300,7,397962
46814,3.4e-05,172.31.36.0-255,66,366,7,397962
46815,4.1e-05,74.125.200.0-255,1484,1850,7,397962
46816,4.6e-05,172.31.36.0-255,66,1916,7,397962
46817,5.3e-05,74.125.200.0-255,4320,6236,7,397962
46818,5.5e-05,172.31.36.0-255,66,6302,7,397962
46819,7e-05,74.125.200.0-255,2902,9204,7,397962
46820,7.2e-05,172.31.36.0-255,66,9270,7,397962
46821,8.8e-05,74.125.200.0-255,4729,13999,7,397962
46822,9e-05,172.31.36.0-255,66,14065,7,397962
46823,0.000111,74.125.200.0-255,2902,16967,7,397962
46824,0.000114,172.31.36.0-255,66,17033,7,397962
46825,0.000134,74.125.200.0-255,5738,22771,7,397962
46826,0.000137,172.31.36.0-255,66,22837,7,397962
46827,0.000143,74.125.200.0-255,5738,28575,7,397962
46828,0.000146,172.31.36.0-255,66,28641,7,397962
46829,0.000171,74.125.200.0-255,2543,31184,7,397962
46830,0.000173,172.31.36.0-255,66,31250,7,397962
46831,0.000402,74.125.200.0-255,1484,32734,7,397962
46832,0.000407,172.31.36.0-255,66,32800,7,397962
46833,0.000422,74.125.200.0-255,1484,34284,7,397962
46834,0.000425,172.31.36.0-255,66,34350,7,397962
46835,0.000429,74.125.200.0-255,2902,37252,7,397962
46836,0.000432,172.31.36.0-255,66,37318,7,397962
46837,0.00046,74.125.200.0-255,5738,43056,7,397962
46838,0.000467,172.31.36.0-255,66,43122,7,397962
46839,0.000475,74.125.200.0-255,4320,47442,7,397962
46840,0.000477,172.31.36.0-255,66,47508,7,397962
46841,0.000493,74.125.200.0-255,2543,50051,7,397962
46842,0.000496,172.31.36.0-255,66,50117,7,397962
46843,0.000503,74.125.200.0-255,7156,57273,7,397962
46844,0.000506,172.31.36.0-255,66,57339,7,397962
46845,0.000519,74.125.200.0-255,1484,58823,7,397962
46846,0.000536,74.125.200.0-255,6797,65620,7,397962
46847,0.00054,172.31.36.0-255,66,65686,7,397962
46848,0.000563,74.125.200.0-255,359,66045,7,397962
46849,0.000603,74.125.200.0-255,135,66180,7,397962
46850,0.000621,74.125.200.0-255,345,66525,7,397962
46851,0.000789,74.125.200.0-255,1484,68009,7,397962
46852,0.000793,172.31.36.0-255,66,68075,7,397962
46853,0.000798,74.125.200.0-255,2902,70977,7,397962
46854,0.0008,172.31.36.0-255,66,71043,7,397962
46855,0.000833,74.125.200.0-255,2902,73945,7,397962
46856,0.000836,172.31.36.0-255,66,74011,7,397962
46857,0.000851,74.125.200.0-255,2902,76913,7,397962
46858,0.000854,172.31.36.0-255,66,76979,7,397962
46859,0.000859,74.125.200.0-255,4320,81299,7,397962
46860,0.000862,172.31.36.0-255,66,81365,7,397962
46861,0.000881,74.125.200.0-255,2902,84267,7,397962
46862,0.000883,172.31.36.0-255,66,84333,7,397962
46863,0.000888,74.125.200.0-255,2902,87235,7,397962
46864,0.00089,172.31.36.0-255,66,87301,7,397962
46865,0.000918,172.31.36.0-255,66,87367,7,397962
46866,0.000958,74.125.200.0-255,5020,92387,7,397962
46867,0.000961,172.31.36.0-255,66,92453,7,397962
46868,0.001386,74.125.200.0-255,1484,93937,7,397962
46869,0.001397,74.125.200.0-255,2902,96839,7,397962
46870,0.001401,172.31.36.0-255,66,96905,7,397962
46871,0.001405,74.125.200.0-255,1484,98389,7,397962
46872,0.001427,74.125.200.0-255,4320,102709,7,397962
46873,0.001429,172.31.36.0-255,66,102775,7,397962
46874,0.001434,74.125.200.0-255,2902,105677,7,397962
46875,0.001435,172.31.36.0-255,66,105743,7,397962
46876,0.001456,74.125.200.0-255,4320,110063,7,397962
46877,0.001458,172.31.36.0-255,66,110129,7,397962
46878,0.001468,172.31.36.0-255,66,110195,7,397962
46879,0.001486,74.125.200.0-255,2902,113097,7,397962
46880,0.001488,172.31.36.0-255,66,113163,7,397962
46881,0.001504,74.125.200.0-255,5020,118183,7,397962
46882,0.001506,172.31.36.0-255,66,118249,7,397962
46883,0.001569,74.125.200.0-255,1484,119733,7,397962
46884,0.001582,74.125.200.0-255,1484,121217,7,397962
46885,0.001585,172.31.36.0-255,66,121283,7,397962
46886,0.001589,74.125.200.0-255,1484,122767,7,397962
46887,0.0016,74.125.200.0-255,1484,124251,7,397962
46888,0.001602,172.31.36.0-255,66,124317,7,397962
46889,0.001622,74.125.200.0-255,2902,127219,7,397962
46890,0.001626,172.31.36.0-255,66,127285,7,397962
46891,0.001653,74.125.200.0-255,2902,130187,7,397962
46892,0.001656,172.31.36.0-255,66,130253,7,397962
46893,0.001661,74.125.200.0-255,2902,133155,7,397962
46894,0.001665,172.31.36.0-255,66,133221,7,397962
46895,0.001665,74.125.200.0-255,4320,137541,7,397962
46896,0.001669,172.31.36.0-255,66,137607,7,397962
46897,0.001675,172.31.36.0-255,66,137673,7,397962
46898,0.00168,74.125.200.0-255,2902,140575,7,397962
46899,0.001681,172.31.36.0-255,66,140641,7,397962
46900,0.001698,74.125.200.0-255,3602,144243,7,397962
46901,0.001701,172.31.36.0-255,66,144309,7,397962
46902,0.001733,74.125.200.0-255,7156,151465,7,397962
46903,0.001736,172.31.36.0-255,66,151531,7,397962
46904,0.001741,74.125.200.0-255,2902,154433,7,397962
46905,0.001743,172.31.36.0-255,66,154499,7,397962
46906,0.001764,74.125.200.0-255,2902,157401,7,397962
46907,0.001767,172.31.36.0-255,66,157467,7,397962
46908,0.001791,172.31.36.0-255,66,157533,7,397962
46909,0.001797,74.125.200.0-255,5738,163271,7,397962
46910,0.001799,172.31.36.0-255,66,163337,7,397962
46911,0.001822,74.125.200.0-255,5738,169075,7,397962
46912,0.001824,74.125.200.0-255,766,169841,7,397962
46913,0.001827,172.31.36.0-255,66,169907,7,397962
46914,0.00191,74.125.200.0-255,1484,171391,7,397962
46915,0.001914,172.31.36.0-255,66,171457,7,397962
46916,0.001918,74.125.200.0-255,1484,172941,7,397962
46917,0.001934,74.125.200.0-255,1484,174425,7,397962
46918,0.001938,172.31.36.0-255,66,174491,7,397962
46919,0.001942,74.125.200.0-255,2902,177393,7,397962
46920,0.001944,172.31.36.0-255,66,177459,7,397962
46921,0.00195,74.125.200.0-255,4320,181779,7,397962
46922,0.001952,172.31.36.0-255,66,181845,7,397962
46923,0.001968,74.125.200.0-255,4320,186165,7,397962
46924,0.001971,172.31.36.0-255,66,186231,7,397962
46925,0.001987,74.125.200.0-255,4320,190551,7,397962
46926,0.001989,172.31.36.0-255,66,190617,7,397962
46927,0.001997,74.125.200.0-255,7156,197773,7,397962
46928,0.002,172.31.36.0-255,66,197839,7,397962
46929,0.002037,74.125.200.0-255,2902,200741,7,397962
46930,0.002041,172.31.36.0-255,66,200807,7,397962
46931,0.002061,74.125.200.0-255,3602,204409,7,397962
46932,0.002064,172.31.36.0-255,66,204475,7,397962
46933,0.002098,74.125.200.0-255,1484,205959,7,397962
46934,0.002111,74.125.200.0-255,2902,208861,7,397962
46935,0.002114,172.31.36.0-255,66,208927,7,397962
46936,0.002132,74.125.200.0-255,1484,210411,7,397962
46937,0.00215,74.125.200.0-255,4320,214731,7,397962
46938,0.002153,172.31.36.0-255,66,214797,7,397962
46939,0.002161,74.125.200.0-255,1484,216281,7,397962
46940,0.00218,74.125.200.0-255,2902,219183,7,397962
46941,0.002184,172.31.36.0-255,66,219249,7,397962
46942,0.00219,74.125.200.0-255,4320,223569,7,397962
46943,0.002192,172.31.36.0-255,66,223635,7,397962
46944,0.002204,74.125.200.0-255,1484,225119,7,397962
46945,0.002228,74.125.200.0-255,4320,229439,7,397962
46946,0.002231,172.31.36.0-255,66,229505,7,397962
46947,0.002252,74.125.200.0-255,2902,232407,7,397962
46948,0.002255,172.31.36.0-255,66,232473,7,397962
46949,0.002259,74.125.200.0-255,2902,235375,7,397962
46950,0.002262,172.31.36.0-255,66,235441,7,397962
46951,0.002267,74.125.200.0-255,3602,239043,7,397962
46952,0.002269,172.31.36.0-255,66,239109,7,397962
46953,0.002576,172.31.36.0-255,101,239210,7,397962
46954,0.004584,74.125.200.0-255,2902,242112,7,397962
46955,0.004591,172.31.36.0-255,66,242178,7,397962
46956,0.004607,74.125.200.0-255,2902,245080,7,397962
46957,0.004609,172.31.36.0-255,66,245146,7,397962
46958,0.00485,74.125.200.0-255,66,245212,7,397962
46959,0.006895,74.125.200.0-255,2902,248114,7,397962
46960,0.0069,172.31.36.0-255,66,248180,7,397962
46961,0.006929,74.125.200.0-255,2902,251082,7,397962
46962,0.006931,172.31.36.0-255,66,251148,7,397962
46963,0.009206,74.125.200.0-255,2902,254050,7,397962
46964,0.009212,172.31.36.0-255,66,254116,7,397962
46965,0.009245,74.125.200.0-255,2902,257018,7,397962
46966,0.009248,172.31.36.0-255,66,257084,7,397962
46967,0.011529,74.125.200.0-255,2902,259986,7,397962
46968,0.011536,172.31.36.0-255,66,260052,7,397962
46969,0.011565,74.125.200.0-255,2902,262954,7,397962
46970,0.011568,172.31.36.0-255,66,263020,7,397962
46971,0.013849,74.125.200.0-255,2902,265922,7,397962
46972,0.013855,172.31.36.0-255,66,265988,7,397962
46973,0.013875,74.125.200.0-255,2902,268890,7,397962
46974,0.013877,172.31.36.0-255,66,268956,7,397962
46975,0.016179,74.125.200.0-255,2902,271858,7,397962
46976,0.016187,172.31.36.0-255,66,271924,7,397962
46977,0.01622,74.125.200.0-255,2902,274826,7,397962
46978,0.016223,172.31.36.0-255,66,274892,7,397962
46979,0.018514,74.125.200.0-255,2902,277794,7,397962
46980,0.018521,172.31.36.0-255,66,277860,7,397962
46981,0.018556,74.125.200.0-255,2902,280762,7,397962
46982,0.018559,172.31.36.0-255,66,280828,7,397962
46983,0.020842,74.125.200.0-255,2902,283730,7,397962
46984,0.020849,172.31.36.0-255,66,283796,7,397962
46985,0.020884,74.125.200.0-255,2902,286698,7,397962
46986,0.020888,172.31.36.0-255,66,286764,7,397962
46987,0.023188,74.125.200.0-255,2902,289666,7,397962
46988,0.023198,172.31.36.0-255,66,289732,7,397962
46989,0.023234,74.125.200.0-255,2902,292634,7,397962
46990,0.023237,172.31.36.0-255,66,292700,7,397962
46991,0.025521,74.125.200.0-255,2902,295602,7,397962
46992,0.025529,172.31.36.0-255,66,295668,7,397962
46993,0.025563,74.125.200.0-255,2902,298570,7,397962
46994,0.025567,172.31.36.0-255,66,298636,7,397962
46995,0.027853,74.125.200.0-255,2902,301538,7,397962
46996,0.027863,172.31.36.0-255,66,301604,7,397962
46997,0.027899,74.125.200.0-255,2902,304506,7,397962
46998,0.027902,172.31.36.0-255,66,304572,7,397962
46999,0.030179,74.125.200.0-255,2902,307474,7,397962
47000,0.030187,172.31.36.0-255,66,307540,7,397962
47001,0.030222,74.125.200.0-255,2902,310442,7,397962
47002,0.030226,172.31.36.0-255,66,310508,7,397962
47003,0.031972,172.31.36.0-255,172,310680,7,397962
47004,0.032002,172.31.36.0-255,1115,311795,7,397962
47005,0.032044,172.31.36.0-255,1514,313309,7,397962
47006,0.032045,172.31.36.0-255,1291,314600,7,397962
47007,0.0325,74.125.200.0-255,2902,317502,7,397962
47008,0.032506,172.31.36.0-255,66,317568,7,397962
47009,0.032541,74.125.200.0-255,2902,320470,7,397962
47010,0.032545,172.31.36.0-255,66,320536,7,397962
47011,0.033492,104.244.42.0-255,66,320602,7,397962
47012,0.033581,104.244.42.0-255,66,320668,7,397962
47013,0.033634,104.244.42.0-255,66,320734,7,397962
47014,0.034236,104.244.42.0-255,108,320842,7,397962
47015,0.034242,172.31.36.0-255,66,320908,7,397962
47016,0.034812,74.125.200.0-255,2902,323810,7,397962
47017,0.034816,172.31.36.0-255,66,323876,7,397962
47018,0.034867,74.125.200.0-255,2902,326778,7,397962
47019,0.034871,172.31.36.0-255,66,326844,7,397962
47020,0.037125,74.125.200.0-255,2902,329746,7,397962
47021,0.037131,172.31.36.0-255,66,329812,7,397962
47022,0.037178,74.125.200.0-255,2902,332714,7,397962
47023,0.037184,172.31.36.0-255,66,332780,7,397962
47024,0.039448,74.125.200.0-255,2902,335682,7,397962
47025,0.039469,172.31.36.0-255,66,335748,7,397962
47026,0.039502,74.125.200.0-255,2902,338650,7,397962
47027,0.039506,172.31.36.0-255,66,338716,7,397962
47028,0.041795,74.125.200.0-255,2902,341618,7,397962
47029,0.0418,172.31.36.0-255,66,341684,7,397962
47030,0.041832,74.125.200.0-255,2902,344586,7,397962
47031,0.041835,172.31.36.0-255,66,344652,7,397962
47032,0.044134,74.125.200.0-255,2902,347554,7,397962
47033,0.044139,172.31.36.0-255,66,347620,7,397962
47034,0.044169,74.125.200.0-255,2902,350522,7,397962
47035,0.044172,172.31.36.0-255,66,350588,7,397962
47036,0.046461,74.125.200.0-255,2902,353490,7,397962
47037,0.046466,172.31.36.0-255,66,353556,7,397962
47038,0.046495,74.125.200.0-255,2902,356458,7,397962
47039,0.046498,172.31.36.0-255,66,356524,7,397962
47040,0.048791,74.125.200.0-255,2902,359426,7,397962
47041,0.048796,172.31.36.0-255,66,359492,7,397962
47042,0.048824,74.125.200.0-255,2902,362394,7,397962
47043,0.048827,172.31.36.0-255,66,362460,7,397962
47044,0.051111,74.125.200.0-255,2902,365362,7,397962
47045,0.051116,172.31.36.0-255,66,365428,7,397962
47046,0.051151,74.125.200.0-255,2902,368330,7,397962
47047,0.051154,172.31.36.0-255,66,368396,7,397962
47048,0.053426,74.125.200.0-255,2902,371298,7,397962
47049,0.053431,172.31.36.0-255,66,371364,7,397962
47050,0.053464,74.125.200.0-255,2902,374266,7,397962
47051,0.053467,172.31.36.0-255,66,374332,7,397962
47052,0.055746,74.125.200.0-255,2902,377234,7,397962
47053,0.055751,172.31.36.0-255,66,377300,7,397962
47054,0.055782,74.125.200.0-255,2902,380202,7,397962
47055,0.055785,172.31.36.0-255,66,380268,7,397962
47056,0.058069,74.125.200.0-255,2902,383170,7,397962
47057,0.058074,172.31.36.0-255,66,383236,7,397962
47058,0.058108,74.125.200.0-255,2902,386138,7,397962
47059,0.058111,172.31.36.0-255,66,386204,7,397962
47060,0.060385,74.125.200.0-255,2902,389106,7,397962
47061,0.06039,172.31.36.0-255,66,389172,7,397962
47062,0.060429,74.125.200.0-255,2902,392074,7,397962
47063,0.060432,172.31.36.0-255,66,392140,7,397962
47064,0.062704,74.125.200.0-255,2902,395042,7,397962
47065,0.062709,172.31.36.0-255,66,395108,7,397962
47066,0.062741,74.125.200.0-255,2617,397725,7,397962
47067,0.062744,172.31.36.0-255,66,397791,7,397962
47068,0.062931,172.31.36.0-255,105,397896,7,397962
47069,0.070506,74.125.200.0-255,66,397962,7,397962
47070,0.0,74.125.24.0-255,226,226,7,226160
47071,2.3e-05,172.31.36.0-255,66,292,7,226160
47072,3.1e-05,74.125.24.0-255,1484,1776,7,226160
47073,3.5e-05,172.31.36.0-255,66,1842,7,226160
47074,6.9e-05,74.125.24.0-255,4320,6162,7,226160
47075,7.8e-05,172.31.36.0-255,66,6228,7,226160
47076,0.000241,172.31.36.0-255,66,6294,7,226160
47077,0.000584,74.125.24.0-255,2902,9196,7,226160
47078,0.000589,172.31.36.0-255,66,9262,7,226160
47079,0.000616,172.31.36.0-255,66,9328,7,226160
47080,0.0012,74.125.24.0-255,2543,11871,7,226160
47081,0.001203,172.31.36.0-255,66,11937,7,226160
47082,0.002841,74.125.24.0-255,2902,14839,7,226160
47083,0.002846,172.31.36.0-255,66,14905,7,226160
47084,0.003439,74.125.24.0-255,2902,17807,7,226160
47085,0.003446,172.31.36.0-255,66,17873,7,226160
47086,0.005072,74.125.24.0-255,2902,20775,7,226160
47087,0.00508,172.31.36.0-255,66,20841,7,226160
47088,0.005681,74.125.24.0-255,2902,23743,7,226160
47089,0.005684,172.31.36.0-255,66,23809,7,226160
47090,0.007311,74.125.24.0-255,2902,26711,7,226160
47091,0.007318,172.31.36.0-255,66,26777,7,226160
47092,0.007938,74.125.24.0-255,2902,29679,7,226160
47093,0.007944,172.31.36.0-255,66,29745,7,226160
47094,0.009577,74.125.24.0-255,2902,32647,7,226160
47095,0.009581,172.31.36.0-255,66,32713,7,226160
47096,0.010212,74.125.24.0-255,2902,35615,7,226160
47097,0.010218,172.31.36.0-255,66,35681,7,226160
47098,0.011838,74.125.24.0-255,2902,38583,7,226160
47099,0.011844,172.31.36.0-255,66,38649,7,226160
47100,0.012458,74.125.24.0-255,2902,41551,7,226160
47101,0.012465,172.31.36.0-255,66,41617,7,226160
47102,0.014076,74.125.24.0-255,2902,44519,7,226160
47103,0.014083,172.31.36.0-255,66,44585,7,226160
47104,0.014778,74.125.24.0-255,2902,47487,7,226160
47105,0.014784,172.31.36.0-255,66,47553,7,226160
47106,0.016349,74.125.24.0-255,2902,50455,7,226160
47107,0.016358,172.31.36.0-255,66,50521,7,226160
47108,0.017029,74.125.24.0-255,2902,53423,7,226160
47109,0.017036,172.31.36.0-255,66,53489,7,226160
47110,0.018596,74.125.24.0-255,2902,56391,7,226160
47111,0.018603,172.31.36.0-255,66,56457,7,226160
47112,0.019288,74.125.24.0-255,2902,59359,7,226160
47113,0.019295,172.31.36.0-255,66,59425,7,226160
47114,0.020857,74.125.24.0-255,2902,62327,7,226160
47115,0.020864,172.31.36.0-255,66,62393,7,226160
47116,0.02153,74.125.24.0-255,2902,65295,7,226160
47117,0.021543,172.31.36.0-255,66,65361,7,226160
47118,0.023119,74.125.24.0-255,2902,68263,7,226160
47119,0.023125,172.31.36.0-255,66,68329,7,226160
47120,0.023766,74.125.24.0-255,2902,71231,7,226160
47121,0.023772,172.31.36.0-255,66,71297,7,226160
47122,0.025402,74.125.24.0-255,2902,74199,7,226160
47123,0.025409,172.31.36.0-255,66,74265,7,226160
47124,0.026036,74.125.24.0-255,2902,77167,7,226160
47125,0.026043,172.31.36.0-255,66,77233,7,226160
47126,0.027654,74.125.24.0-255,2902,80135,7,226160
47127,0.027661,172.31.36.0-255,66,80201,7,226160
47128,0.028292,74.125.24.0-255,2902,83103,7,226160
47129,0.028299,172.31.36.0-255,66,83169,7,226160
47130,0.029918,74.125.24.0-255,2902,86071,7,226160
47131,0.029924,172.31.36.0-255,66,86137,7,226160
47132,0.030536,74.125.24.0-255,2902,89039,7,226160
47133,0.030542,172.31.36.0-255,66,89105,7,226160
47134,0.032164,74.125.24.0-255,2902,92007,7,226160
47135,0.032172,172.31.36.0-255,66,92073,7,226160
47136,0.032784,74.125.24.0-255,2902,94975,7,226160
47137,0.03279,172.31.36.0-255,66,95041,7,226160
47138,0.034407,74.125.24.0-255,2902,97943,7,226160
47139,0.034418,172.31.36.0-255,66,98009,7,226160
47140,0.03502,74.125.24.0-255,2902,100911,7,226160
47141,0.035027,172.31.36.0-255,66,100977,7,226160
47142,0.035251,172.31.36.0-255,172,101149,7,226160
47143,0.035282,172.31.36.0-255,1113,102262,7,226160
47144,0.035349,172.31.36.0-255,1514,103776,7,226160
47145,0.035351,172.31.36.0-255,1514,105290,7,226160
47146,0.035352,172.31.36.0-255,1514,106804,7,226160
47147,0.035353,172.31.36.0-255,1514,108318,7,226160
47148,0.035382,172.31.36.0-255,1514,109832,7,226160
47149,0.035387,172.31.36.0-255,72,109904,7,226160
47150,0.036675,74.125.24.0-255,2902,112806,7,226160
47151,0.036682,172.31.36.0-255,66,112872,7,226160
47152,0.036793,104.244.42.0-255,66,112938,7,226160
47153,0.03685,104.244.42.0-255,66,113004,7,226160
47154,0.036895,104.244.42.0-255,66,113070,7,226160
47155,0.036962,104.244.42.0-255,66,113136,7,226160
47156,0.036967,104.244.42.0-255,66,113202,7,226160
47157,0.037264,74.125.24.0-255,2902,116104,7,226160
47158,0.03727,172.31.36.0-255,66,116170,7,226160
47159,0.038527,104.244.42.0-255,108,116278,7,226160
47160,0.038538,172.31.36.0-255,66,116344,7,226160
47161,0.03893,74.125.24.0-255,2902,119246,7,226160
47162,0.038936,172.31.36.0-255,66,119312,7,226160
47163,0.039528,74.125.24.0-255,2902,122214,7,226160
47164,0.039535,172.31.36.0-255,66,122280,7,226160
47165,0.041202,74.125.24.0-255,2902,125182,7,226160
47166,0.041209,172.31.36.0-255,66,125248,7,226160
47167,0.041774,74.125.24.0-255,2902,128150,7,226160
47168,0.041781,172.31.36.0-255,66,128216,7,226160
47169,0.043488,74.125.24.0-255,2902,131118,7,226160
47170,0.0435,172.31.36.0-255,66,131184,7,226160
47171,0.044055,74.125.24.0-255,2902,134086,7,226160
47172,0.044061,172.31.36.0-255,66,134152,7,226160
47173,0.045731,74.125.24.0-255,2902,137054,7,226160
47174,0.045739,172.31.36.0-255,66,137120,7,226160
47175,0.046297,74.125.24.0-255,2902,140022,7,226160
47176,0.046303,172.31.36.0-255,66,140088,7,226160
47177,0.047983,74.125.24.0-255,2902,142990,7,226160
47178,0.047989,172.31.36.0-255,66,143056,7,226160
47179,0.048543,74.125.24.0-255,2902,145958,7,226160
47180,0.048549,172.31.36.0-255,66,146024,7,226160
47181,0.050248,74.125.24.0-255,2902,148926,7,226160
47182,0.050253,172.31.36.0-255,66,148992,7,226160
47183,0.050799,74.125.24.0-255,2902,151894,7,226160
47184,0.050804,172.31.36.0-255,66,151960,7,226160
47185,0.052526,74.125.24.0-255,2902,154862,7,226160
47186,0.052532,172.31.36.0-255,66,154928,7,226160
47187,0.053037,74.125.24.0-255,2902,157830,7,226160
47188,0.053042,172.31.36.0-255,66,157896,7,226160
47189,0.054771,74.125.24.0-255,2902,160798,7,226160
47190,0.054777,172.31.36.0-255,66,160864,7,226160
47191,0.055269,74.125.24.0-255,2902,163766,7,226160
47192,0.055279,172.31.36.0-255,66,163832,7,226160
47193,0.05704,74.125.24.0-255,2902,166734,7,226160
47194,0.057048,172.31.36.0-255,66,166800,7,226160
47195,0.057564,74.125.24.0-255,2902,169702,7,226160
47196,0.057571,172.31.36.0-255,66,169768,7,226160
47197,0.059298,74.125.24.0-255,2902,172670,7,226160
47198,0.059304,172.31.36.0-255,66,172736,7,226160
47199,0.059836,74.125.24.0-255,2902,175638,7,226160
47200,0.05984,172.31.36.0-255,66,175704,7,226160
47201,0.06156,74.125.24.0-255,2902,178606,7,226160
47202,0.061566,172.31.36.0-255,66,178672,7,226160
47203,0.06209,74.125.24.0-255,2902,181574,7,226160
47204,0.062096,172.31.36.0-255,66,181640,7,226160
47205,0.063819,74.125.24.0-255,2902,184542,7,226160
47206,0.063825,172.31.36.0-255,66,184608,7,226160
47207,0.064338,74.125.24.0-255,2902,187510,7,226160
47208,0.064344,172.31.36.0-255,66,187576,7,226160
47209,0.06609,74.125.24.0-255,2902,190478,7,226160
47210,0.066096,172.31.36.0-255,66,190544,7,226160
47211,0.06657,74.125.24.0-255,2902,193446,7,226160
47212,0.066574,172.31.36.0-255,66,193512,7,226160
47213,0.068338,74.125.24.0-255,2902,196414,7,226160
47214,0.068345,172.31.36.0-255,66,196480,7,226160
47215,0.068812,74.125.24.0-255,2902,199382,7,226160
47216,0.068817,172.31.36.0-255,66,199448,7,226160
47217,0.070586,74.125.24.0-255,2902,202350,7,226160
47218,0.070591,172.31.36.0-255,66,202416,7,226160
47219,0.071085,74.125.24.0-255,2902,205318,7,226160
47220,0.071091,172.31.36.0-255,66,205384,7,226160
47221,0.072817,74.125.24.0-255,2902,208286,7,226160
47222,0.072823,172.31.36.0-255,66,208352,7,226160
47223,0.073346,74.125.24.0-255,2902,211254,7,226160
47224,0.073352,172.31.36.0-255,66,211320,7,226160
47225,0.075065,74.125.24.0-255,2902,214222,7,226160
47226,0.075071,172.31.36.0-255,66,214288,7,226160
47227,0.075587,74.125.24.0-255,2902,217190,7,226160
47228,0.075592,172.31.36.0-255,66,217256,7,226160
47229,0.077347,74.125.24.0-255,2902,220158,7,226160
47230,0.077356,172.31.36.0-255,66,220224,7,226160
47231,0.077895,74.125.24.0-255,2902,223126,7,226160
47232,0.077903,172.31.36.0-255,66,223192,7,226160
47233,0.079625,74.125.24.0-255,2902,226094,7,226160
47234,0.079632,172.31.36.0-255,66,226160,7,226160
47235,0.0,74.125.130.0-255,155,155,7,358880
47236,3.7e-05,172.31.36.0-255,66,221,7,358880
47237,4.4e-05,74.125.130.0-255,1484,1705,7,358880
47238,4.8e-05,172.31.36.0-255,66,1771,7,358880
47239,5.3e-05,74.125.130.0-255,2902,4673,7,358880
47240,5.6e-05,172.31.36.0-255,66,4739,7,358880
47241,5.9e-05,74.125.130.0-255,1484,6223,7,358880
47242,6.2e-05,172.31.36.0-255,66,6289,7,358880
47243,9.2e-05,74.125.130.0-255,5738,12027,7,358880
47244,9.5e-05,172.31.36.0-255,66,12093,7,358880
47245,0.0001,74.125.130.0-255,2003,14096,7,358880
47246,0.000101,172.31.36.0-255,66,14162,7,358880
47247,0.000106,74.125.130.0-255,2902,17064,7,358880
47248,0.000108,172.31.36.0-255,66,17130,7,358880
47249,0.000114,74.125.130.0-255,4320,21450,7,358880
47250,0.000116,172.31.36.0-255,66,21516,7,358880
47251,0.000154,74.125.130.0-255,2902,24418,7,358880
47252,0.000157,172.31.36.0-255,66,24484,7,358880
47253,0.000162,74.125.130.0-255,2902,27386,7,358880
47254,0.000165,172.31.36.0-255,66,27452,7,358880
47255,0.000171,74.125.130.0-255,3961,31413,7,358880
47256,0.000174,172.31.36.0-255,66,31479,7,358880
47257,0.000235,74.125.130.0-255,1484,32963,7,358880
47258,0.000238,172.31.36.0-255,66,33029,7,358880
47259,0.00027,74.125.130.0-255,2902,35931,7,358880
47260,0.000274,172.31.36.0-255,66,35997,7,358880
47261,0.000281,74.125.130.0-255,5738,41735,7,358880
47262,0.000283,172.31.36.0-255,66,41801,7,358880
47263,0.000292,74.125.130.0-255,1484,43285,7,358880
47264,0.000294,172.31.36.0-255,66,43351,7,358880
47265,0.000329,74.125.130.0-255,1484,44835,7,358880
47266,0.000333,172.31.36.0-255,66,44901,7,358880
47267,0.000362,74.125.130.0-255,3961,48862,7,358880
47268,0.000366,172.31.36.0-255,66,48928,7,358880
47269,0.000867,74.125.130.0-255,1484,50412,7,358880
47270,0.000879,74.125.130.0-255,2902,53314,7,358880
47271,0.000883,172.31.36.0-255,66,53380,7,358880
47272,0.000914,74.125.130.0-255,4320,57700,7,358880
47273,0.000918,172.31.36.0-255,66,57766,7,358880
47274,0.000948,74.125.130.0-255,7156,64922,7,358880
47275,0.000951,172.31.36.0-255,66,64988,7,358880
47276,0.000986,74.125.130.0-255,2543,67531,7,358880
47277,0.00099,172.31.36.0-255,66,67597,7,358880
47278,0.00101,172.31.36.0-255,66,67663,7,358880
47279,0.001017,74.125.130.0-255,7156,74819,7,358880
47280,0.001019,172.31.36.0-255,66,74885,7,358880
47281,0.001029,172.31.36.0-255,66,74951,7,358880
47282,0.001034,74.125.130.0-255,4320,79271,7,358880
47283,0.001036,172.31.36.0-255,66,79337,7,358880
47284,0.001082,74.125.130.0-255,2184,81521,7,358880
47285,0.001085,172.31.36.0-255,66,81587,7,358880
47286,0.001119,74.125.130.0-255,646,82233,7,358880
47287,0.001334,74.125.130.0-255,1484,83717,7,358880
47288,0.00134,172.31.36.0-255,66,83783,7,358880
47289,0.001346,74.125.130.0-255,2902,86685,7,358880
47290,0.001348,172.31.36.0-255,66,86751,7,358880
47291,0.001384,74.125.130.0-255,5738,92489,7,358880
47292,0.001388,172.31.36.0-255,66,92555,7,358880
47293,0.001392,74.125.130.0-255,4320,96875,7,358880
47294,0.001394,172.31.36.0-255,66,96941,7,358880
47295,0.001422,74.125.130.0-255,2902,99843,7,358880
47296,0.001424,172.31.36.0-255,66,99909,7,358880
47297,0.001433,172.31.36.0-255,66,99975,7,358880
47298,0.001437,74.125.130.0-255,2902,102877,7,358880
47299,0.001441,172.31.36.0-255,66,102943,7,358880
47300,0.001462,74.125.130.0-255,5020,107963,7,358880
47301,0.001464,172.31.36.0-255,66,108029,7,358880
47302,0.001778,74.125.130.0-255,1484,109513,7,358880
47303,0.001792,74.125.130.0-255,1484,110997,7,358880
47304,0.001794,172.31.36.0-255,66,111063,7,358880
47305,0.001799,74.125.130.0-255,2902,113965,7,358880
47306,0.001801,172.31.36.0-255,66,114031,7,358880
47307,0.001826,74.125.130.0-255,5738,119769,7,358880
47308,0.001832,172.31.36.0-255,66,119835,7,358880
47309,0.001846,74.125.130.0-255,2902,122737,7,358880
47310,0.001847,172.31.36.0-255,66,122803,7,358880
47311,0.001869,74.125.130.0-255,5738,128541,7,358880
47312,0.001872,172.31.36.0-255,66,128607,7,358880
47313,0.001912,74.125.130.0-255,7156,135763,7,358880
47314,0.001915,172.31.36.0-255,66,135829,7,358880
47315,0.001938,74.125.130.0-255,2902,138731,7,358880
47316,0.001941,172.31.36.0-255,66,138797,7,358880
47317,0.001945,74.125.130.0-255,3602,142399,7,358880
47318,0.001947,172.31.36.0-255,66,142465,7,358880
47319,0.002092,74.125.130.0-255,1484,143949,7,358880
47320,0.002098,74.125.130.0-255,2902,146851,7,358880
47321,0.002101,172.31.36.0-255,66,146917,7,358880
47322,0.002126,74.125.130.0-255,5738,152655,7,358880
47323,0.002129,172.31.36.0-255,66,152721,7,358880
47324,0.002169,172.31.36.0-255,66,152787,7,358880
47325,0.00219,74.125.130.0-255,1484,154271,7,358880
47326,0.002208,74.125.130.0-255,2902,157173,7,358880
47327,0.00221,172.31.36.0-255,66,157239,7,358880
47328,0.002242,172.31.36.0-255,66,157305,7,358880
47329,0.004504,74.125.130.0-255,5738,163043,7,358880
47330,0.004508,172.31.36.0-255,66,163109,7,358880
47331,0.006815,74.125.130.0-255,5738,168847,7,358880
47332,0.006821,172.31.36.0-255,66,168913,7,358880
47333,0.009103,74.125.130.0-255,5738,174651,7,358880
47334,0.009111,172.31.36.0-255,66,174717,7,358880
47335,0.011411,74.125.130.0-255,5738,180455,7,358880
47336,0.01142,172.31.36.0-255,66,180521,7,358880
47337,0.013703,74.125.130.0-255,5738,186259,7,358880
47338,0.013715,172.31.36.0-255,66,186325,7,358880
47339,0.01601,74.125.130.0-255,5738,192063,7,358880
47340,0.016025,172.31.36.0-255,66,192129,7,358880
47341,0.018328,74.125.130.0-255,5738,197867,7,358880
47342,0.01834,172.31.36.0-255,66,197933,7,358880
47343,0.02063,74.125.130.0-255,5738,203671,7,358880
47344,0.020639,172.31.36.0-255,66,203737,7,358880
47345,0.02294,74.125.130.0-255,5738,209475,7,358880
47346,0.022947,172.31.36.0-255,66,209541,7,358880
47347,0.025228,74.125.130.0-255,5738,215279,7,358880
47348,0.025235,172.31.36.0-255,66,215345,7,358880
47349,0.027524,74.125.130.0-255,5738,221083,7,358880
47350,0.027531,172.31.36.0-255,66,221149,7,358880
47351,0.029828,74.125.130.0-255,5738,226887,7,358880
47352,0.029837,172.31.36.0-255,66,226953,7,358880
47353,0.032139,74.125.130.0-255,5738,232691,7,358880
47354,0.032151,172.31.36.0-255,66,232757,7,358880
47355,0.034439,74.125.130.0-255,5738,238495,7,358880
47356,0.034449,172.31.36.0-255,66,238561,7,358880
47357,0.036528,172.31.36.0-255,199,238760,7,358880
47358,0.036558,172.31.36.0-255,1113,239873,7,358880
47359,0.036606,172.31.36.0-255,1514,241387,7,358880
47360,0.036608,172.31.36.0-255,1514,242901,7,358880
47361,0.036613,172.31.36.0-255,1514,244415,7,358880
47362,0.036615,172.31.36.0-255,1514,245929,7,358880
47363,0.036639,172.31.36.0-255,1514,247443,7,358880
47364,0.03664,172.31.36.0-255,71,247514,7,358880
47365,0.036723,74.125.130.0-255,5738,253252,7,358880
47366,0.036729,172.31.36.0-255,66,253318,7,358880
47367,0.038049,104.244.42.0-255,66,253384,7,358880
47368,0.038109,104.244.42.0-255,66,253450,7,358880
47369,0.03816,104.244.42.0-255,66,253516,7,358880
47370,0.03828,104.244.42.0-255,66,253582,7,358880
47371,0.039018,74.125.130.0-255,5738,259320,7,358880
47372,0.039025,172.31.36.0-255,66,259386,7,358880
47373,0.041319,74.125.130.0-255,4320,263706,7,358880
47374,0.041325,172.31.36.0-255,66,263772,7,358880
47375,0.041356,74.125.130.0-255,1484,265256,7,358880
47376,0.043599,74.125.130.0-255,1484,266740,7,358880
47377,0.043605,172.31.36.0-255,66,266806,7,358880
47378,0.043643,74.125.130.0-255,2902,269708,7,358880
47379,0.043647,172.31.36.0-255,66,269774,7,358880
47380,0.0459,74.125.130.0-255,2902,272676,7,358880
47381,0.045907,172.31.36.0-255,66,272742,7,358880
47382,0.045939,74.125.130.0-255,2902,275644,7,358880
47383,0.045943,172.31.36.0-255,66,275710,7,358880
47384,0.048183,74.125.130.0-255,2902,278612,7,358880
47385,0.04819,172.31.36.0-255,66,278678,7,358880
47386,0.048218,74.125.130.0-255,2902,281580,7,358880
47387,0.048221,172.31.36.0-255,66,281646,7,358880
47388,0.050462,74.125.130.0-255,2902,284548,7,358880
47389,0.050468,172.31.36.0-255,66,284614,7,358880
47390,0.050506,74.125.130.0-255,2902,287516,7,358880
47391,0.050509,172.31.36.0-255,66,287582,7,358880
47392,0.052751,74.125.130.0-255,2902,290484,7,358880
47393,0.052756,172.31.36.0-255,66,290550,7,358880
47394,0.052791,74.125.130.0-255,2902,293452,7,358880
47395,0.052794,172.31.36.0-255,66,293518,7,358880
47396,0.055027,74.125.130.0-255,1484,295002,7,358880
47397,0.055088,74.125.130.0-255,1484,296486,7,358880
47398,0.055093,172.31.36.0-255,66,296552,7,358880
47399,0.05512,74.125.130.0-255,2902,299454,7,358880
47400,0.055124,172.31.36.0-255,66,299520,7,358880
47401,0.057368,74.125.130.0-255,2902,302422,7,358880
47402,0.057375,172.31.36.0-255,66,302488,7,358880
47403,0.057402,74.125.130.0-255,2902,305390,7,358880
47404,0.057405,172.31.36.0-255,66,305456,7,358880
47405,0.059651,74.125.130.0-255,2902,308358,7,358880
47406,0.059658,172.31.36.0-255,66,308424,7,358880
47407,0.059696,74.125.130.0-255,2902,311326,7,358880
47408,0.059699,172.31.36.0-255,66,311392,7,358880
47409,0.061961,74.125.130.0-255,2902,314294,7,358880
47410,0.061966,172.31.36.0-255,66,314360,7,358880
47411,0.062002,74.125.130.0-255,2902,317262,7,358880
47412,0.062005,172.31.36.0-255,66,317328,7,358880
47413,0.064249,74.125.130.0-255,2902,320230,7,358880
47414,0.064254,172.31.36.0-255,66,320296,7,358880
47415,0.064292,74.125.130.0-255,2902,323198,7,358880
47416,0.064296,172.31.36.0-255,66,323264,7,358880
47417,0.066519,74.125.130.0-255,2902,326166,7,358880
47418,0.066525,172.31.36.0-255,66,326232,7,358880
47419,0.066565,74.125.130.0-255,2902,329134,7,358880
47420,0.066568,172.31.36.0-255,66,329200,7,358880
47421,0.068792,74.125.130.0-255,2902,332102,7,358880
47422,0.068797,172.31.36.0-255,66,332168,7,358880
47423,0.068838,74.125.130.0-255,2902,335070,7,358880
47424,0.068841,172.31.36.0-255,66,335136,7,358880
47425,0.071066,74.125.130.0-255,2902,338038,7,358880
47426,0.071071,172.31.36.0-255,66,338104,7,358880
47427,0.071111,74.125.130.0-255,2902,341006,7,358880
47428,0.071114,172.31.36.0-255,66,341072,7,358880
47429,0.073342,74.125.130.0-255,2902,343974,7,358880
47430,0.073347,172.31.36.0-255,66,344040,7,358880
47431,0.073381,74.125.130.0-255,2902,346942,7,358880
47432,0.073384,172.31.36.0-255,66,347008,7,358880
47433,0.075626,74.125.130.0-255,2902,349910,7,358880
47434,0.075631,172.31.36.0-255,66,349976,7,358880
47435,0.075664,74.125.130.0-255,2902,352878,7,358880
47436,0.075667,172.31.36.0-255,66,352944,7,358880
47437,0.077908,74.125.130.0-255,2902,355846,7,358880
47438,0.077913,172.31.36.0-255,66,355912,7,358880
47439,0.077946,74.125.130.0-255,2902,358814,7,358880
47440,0.077949,172.31.36.0-255,66,358880,7,358880
47441,0.0,216.58.203.0-255,152,152,7,394757
47442,3.2e-05,172.31.36.0-255,66,218,7,394757
47443,3.9e-05,216.58.203.0-255,1484,1702,7,394757
47444,4.3e-05,172.31.36.0-255,66,1768,7,394757
47445,4.7e-05,216.58.203.0-255,2902,4670,7,394757
47446,5.9e-05,172.31.36.0-255,66,4736,7,394757
47447,6.5e-05,216.58.203.0-255,5738,10474,7,394757
47448,6.9e-05,172.31.36.0-255,66,10540,7,394757
47449,7.6e-05,216.58.203.0-255,7156,17696,7,394757
47450,7.9e-05,172.31.36.0-255,66,17762,7,394757
47451,0.000112,216.58.203.0-255,6293,24055,7,394757
47452,0.000117,172.31.36.0-255,66,24121,7,394757
47453,0.000124,216.58.203.0-255,6797,30918,7,394757
47454,0.000126,172.31.36.0-255,66,30984,7,394757
47455,0.000275,216.58.203.0-255,1484,32468,7,394757
47456,0.00028,172.31.36.0-255,66,32534,7,394757
47457,0.000283,216.58.203.0-255,1484,34018,7,394757
47458,0.000285,172.31.36.0-255,66,34084,7,394757
47459,0.000291,216.58.203.0-255,2902,36986,7,394757
47460,0.000299,172.31.36.0-255,66,37052,7,394757
47461,0.000306,216.58.203.0-255,5738,42790,7,394757
47462,0.00031,172.31.36.0-255,66,42856,7,394757
47463,0.000353,216.58.203.0-255,5379,48235,7,394757
47464,0.000357,172.31.36.0-255,66,48301,7,394757
47465,0.000655,216.58.203.0-255,1484,49785,7,394757
47466,0.000659,172.31.36.0-255,66,49851,7,394757
47467,0.000665,216.58.203.0-255,2902,52753,7,394757
47468,0.000668,172.31.36.0-255,66,52819,7,394757
47469,0.000681,216.58.203.0-255,5738,58557,7,394757
47470,0.000684,172.31.36.0-255,66,58623,7,394757
47471,0.000688,216.58.203.0-255,2902,61525,7,394757
47472,0.000691,172.31.36.0-255,66,61591,7,394757
47473,0.000721,216.58.203.0-255,3961,65552,7,394757
47474,0.000725,172.31.36.0-255,66,65618,7,394757
47475,0.00075,216.58.203.0-255,357,65975,7,394757
47476,0.000845,172.31.36.0-255,66,66041,7,394757
47477,0.00089,216.58.203.0-255,1484,67525,7,394757
47478,0.000894,216.58.203.0-255,1484,69009,7,394757
47479,0.000898,172.31.36.0-255,66,69075,7,394757
47480,0.000904,216.58.203.0-255,2902,71977,7,394757
47481,0.000906,172.31.36.0-255,66,72043,7,394757
47482,0.000917,216.58.203.0-255,5738,77781,7,394757
47483,0.000919,172.31.36.0-255,66,77847,7,394757
47484,0.000954,216.58.203.0-255,5379,83226,7,394757
47485,0.000957,172.31.36.0-255,66,83292,7,394757
47486,0.001051,216.58.203.0-255,1484,84776,7,394757
47487,0.001055,216.58.203.0-255,1484,86260,7,394757
47488,0.001058,172.31.36.0-255,66,86326,7,394757
47489,0.00108,216.58.203.0-255,1484,87810,7,394757
47490,0.001086,216.58.203.0-255,5738,93548,7,394757
47491,0.001088,172.31.36.0-255,66,93614,7,394757
47492,0.001114,172.31.36.0-255,66,93680,7,394757
47493,0.001124,172.31.36.0-255,66,93746,7,394757
47494,0.001156,216.58.203.0-255,6682,100428,7,394757
47495,0.001159,172.31.36.0-255,66,100494,7,394757
47496,0.001518,216.58.203.0-255,1484,101978,7,394757
47497,0.001529,216.58.203.0-255,2902,104880,7,394757
47498,0.001532,172.31.36.0-255,66,104946,7,394757
47499,0.001569,216.58.203.0-255,5738,110684,7,394757
47500,0.001572,172.31.36.0-255,66,110750,7,394757
47501,0.001589,172.31.36.0-255,66,110816,7,394757
47502,0.001618,216.58.203.0-255,1484,112300,7,394757
47503,0.001636,216.58.203.0-255,2902,115202,7,394757
47504,0.001639,172.31.36.0-255,66,115268,7,394757
47505,0.001646,216.58.203.0-255,5738,121006,7,394757
47506,0.001648,172.31.36.0-255,66,121072,7,394757
47507,0.001652,216.58.203.0-255,2902,123974,7,394757
47508,0.00166,172.31.36.0-255,66,124040,7,394757
47509,0.001689,216.58.203.0-255,1484,125524,7,394757
47510,0.001696,216.58.203.0-255,5738,131262,7,394757
47511,0.001699,172.31.36.0-255,66,131328,7,394757
47512,0.00171,172.31.36.0-255,66,131394,7,394757
47513,0.001714,216.58.203.0-255,2184,133578,7,394757
47514,0.001715,172.31.36.0-255,66,133644,7,394757
47515,0.003379,216.58.203.0-255,4320,137964,7,394757
47516,0.003385,172.31.36.0-255,66,138030,7,394757
47517,0.003408,216.58.203.0-255,1484,139514,7,394757
47518,0.005053,216.58.203.0-255,4320,143834,7,394757
47519,0.005059,172.31.36.0-255,66,143900,7,394757
47520,0.006733,216.58.203.0-255,5738,149638,7,394757
47521,0.006739,172.31.36.0-255,66,149704,7,394757
47522,0.00842,216.58.203.0-255,5738,155442,7,394757
47523,0.008427,172.31.36.0-255,66,155508,7,394757
47524,0.010104,216.58.203.0-255,5738,161246,7,394757
47525,0.010112,172.31.36.0-255,66,161312,7,394757
47526,0.011787,216.58.203.0-255,5738,167050,7,394757
47527,0.011795,172.31.36.0-255,66,167116,7,394757
47528,0.013476,216.58.203.0-255,5738,172854,7,394757
47529,0.013486,172.31.36.0-255,66,172920,7,394757
47530,0.015155,216.58.203.0-255,5738,178658,7,394757
47531,0.01516,172.31.36.0-255,66,178724,7,394757
47532,0.01683,216.58.203.0-255,5738,184462,7,394757
47533,0.016836,172.31.36.0-255,66,184528,7,394757
47534,0.018551,216.58.203.0-255,5738,190266,7,394757
47535,0.01856,172.31.36.0-255,66,190332,7,394757
47536,0.020233,216.58.203.0-255,5738,196070,7,394757
47537,0.02024,172.31.36.0-255,66,196136,7,394757
47538,0.021909,216.58.203.0-255,5738,201874,7,394757
47539,0.021915,172.31.36.0-255,66,201940,7,394757
47540,0.023603,216.58.203.0-255,5738,207678,7,394757
47541,0.02361,172.31.36.0-255,66,207744,7,394757
47542,0.025289,216.58.203.0-255,5738,213482,7,394757
47543,0.025296,172.31.36.0-255,66,213548,7,394757
47544,0.026993,216.58.203.0-255,5738,219286,7,394757
47545,0.027,172.31.36.0-255,66,219352,7,394757
47546,0.028678,216.58.203.0-255,5738,225090,7,394757
47547,0.028684,172.31.36.0-255,66,225156,7,394757
47548,0.030362,216.58.203.0-255,5738,230894,7,394757
47549,0.03037,172.31.36.0-255,66,230960,7,394757
47550,0.031951,172.31.36.0-255,172,231132,7,394757
47551,0.031981,172.31.36.0-255,1113,232245,7,394757
47552,0.032038,172.31.36.0-255,1514,233759,7,394757
47553,0.03204,172.31.36.0-255,1514,235273,7,394757
47554,0.032041,216.58.203.0-255,5738,241011,7,394757
47555,0.032041,172.31.36.0-255,1514,242525,7,394757
47556,0.032046,172.31.36.0-255,1514,244039,7,394757
47557,0.032047,172.31.36.0-255,1514,245553,7,394757
47558,0.032048,172.31.36.0-255,74,245627,7,394757
47559,0.03205,172.31.36.0-255,66,245693,7,394757
47560,0.033482,104.244.42.0-255,66,245759,7,394757
47561,0.033491,104.244.42.0-255,66,245825,7,394757
47562,0.033579,104.244.42.0-255,66,245891,7,394757
47563,0.033586,104.244.42.0-255,66,245957,7,394757
47564,0.03372,216.58.203.0-255,4320,250277,7,394757
47565,0.033726,172.31.36.0-255,66,250343,7,394757
47566,0.033761,216.58.203.0-255,1484,251827,7,394757
47567,0.035399,216.58.203.0-255,4320,256147,7,394757
47568,0.035405,172.31.36.0-255,66,256213,7,394757
47569,0.037074,216.58.203.0-255,5738,261951,7,394757
47570,0.03708,172.31.36.0-255,66,262017,7,394757
47571,0.038745,216.58.203.0-255,5738,267755,7,394757
47572,0.038751,172.31.36.0-255,66,267821,7,394757
47573,0.040412,216.58.203.0-255,5738,273559,7,394757
47574,0.040418,172.31.36.0-255,66,273625,7,394757
47575,0.042091,216.58.203.0-255,5738,279363,7,394757
47576,0.042096,172.31.36.0-255,66,279429,7,394757
47577,0.043766,216.58.203.0-255,5738,285167,7,394757
47578,0.043772,172.31.36.0-255,66,285233,7,394757
47579,0.045445,216.58.203.0-255,5738,290971,7,394757
47580,0.04545,172.31.36.0-255,66,291037,7,394757
47581,0.047128,216.58.203.0-255,5738,296775,7,394757
47582,0.047133,172.31.36.0-255,66,296841,7,394757
47583,0.048807,216.58.203.0-255,5738,302579,7,394757
47584,0.048812,172.31.36.0-255,66,302645,7,394757
47585,0.050483,216.58.203.0-255,5738,308383,7,394757
47586,0.050488,172.31.36.0-255,66,308449,7,394757
47587,0.052158,216.58.203.0-255,5738,314187,7,394757
47588,0.052163,172.31.36.0-255,66,314253,7,394757
47589,0.053824,216.58.203.0-255,5738,319991,7,394757
47590,0.053829,172.31.36.0-255,66,320057,7,394757
47591,0.055503,216.58.203.0-255,5738,325795,7,394757
47592,0.055508,172.31.36.0-255,66,325861,7,394757
47593,0.057173,216.58.203.0-255,4320,330181,7,394757
47594,0.057178,172.31.36.0-255,66,330247,7,394757
47595,0.057211,216.58.203.0-255,1484,331731,7,394757
47596,0.058851,216.58.203.0-255,2902,334633,7,394757
47597,0.058858,172.31.36.0-255,66,334699,7,394757
47598,0.060541,216.58.203.0-255,5738,340437,7,394757
47599,0.060547,172.31.36.0-255,66,340503,7,394757
47600,0.062224,216.58.203.0-255,5738,346241,7,394757
47601,0.062229,172.31.36.0-255,66,346307,7,394757
47602,0.063899,216.58.203.0-255,5738,352045,7,394757
47603,0.063904,172.31.36.0-255,66,352111,7,394757
47604,0.065576,216.58.203.0-255,2902,355013,7,394757
47605,0.065581,172.31.36.0-255,66,355079,7,394757
47606,0.06561,216.58.203.0-255,2902,357981,7,394757
47607,0.065613,172.31.36.0-255,66,358047,7,394757
47608,0.067246,216.58.203.0-255,2902,360949,7,394757
47609,0.067252,172.31.36.0-255,66,361015,7,394757
47610,0.06729,216.58.203.0-255,2902,363917,7,394757
47611,0.067293,172.31.36.0-255,66,363983,7,394757
47612,0.068918,216.58.203.0-255,2902,366885,7,394757
47613,0.068924,172.31.36.0-255,66,366951,7,394757
47614,0.068951,216.58.203.0-255,2902,369853,7,394757
47615,0.068954,172.31.36.0-255,66,369919,7,394757
47616,0.070618,216.58.203.0-255,5738,375657,7,394757
47617,0.070624,172.31.36.0-255,66,375723,7,394757
47618,0.072294,216.58.203.0-255,2902,378625,7,394757
47619,0.072299,172.31.36.0-255,66,378691,7,394757
47620,0.072368,216.58.203.0-255,2902,381593,7,394757
47621,0.072372,172.31.36.0-255,66,381659,7,394757
47622,0.073968,216.58.203.0-255,2902,384561,7,394757
47623,0.073973,172.31.36.0-255,66,384627,7,394757
47624,0.074022,216.58.203.0-255,2902,387529,7,394757
47625,0.074025,172.31.36.0-255,66,387595,7,394757
47626,0.075648,216.58.203.0-255,2902,390497,7,394757
47627,0.075653,172.31.36.0-255,66,390563,7,394757
47628,0.075684,216.58.203.0-255,2902,393465,7,394757
47629,0.075687,172.31.36.0-255,66,393531,7,394757
47630,0.077312,216.58.203.0-255,989,394520,7,394757
47631,0.077463,172.31.36.0-255,66,394586,7,394757
47632,0.077491,172.31.36.0-255,105,394691,7,394757
47633,0.079122,216.58.203.0-255,66,394757,7,394757
47634,0.0,74.125.68.0-255,152,152,7,261802
47635,9.5e-05,172.31.36.0-255,66,218,7,261802
47636,0.000102,74.125.68.0-255,1484,1702,7,261802
47637,0.000107,172.31.36.0-255,66,1768,7,261802
47638,0.000111,74.125.68.0-255,2902,4670,7,261802
47639,0.000114,172.31.36.0-255,66,4736,7,261802
47640,0.000117,74.125.68.0-255,1484,6220,7,261802
47641,0.000119,172.31.36.0-255,66,6286,7,261802
47642,0.000126,74.125.68.0-255,5738,12024,7,261802
47643,0.000128,172.31.36.0-255,66,12090,7,261802
47644,0.000269,74.125.68.0-255,2048,14138,7,261802
47645,0.000274,172.31.36.0-255,66,14204,7,261802
47646,0.000421,74.125.68.0-255,1484,15688,7,261802
47647,0.000425,172.31.36.0-255,66,15754,7,261802
47648,0.00046,74.125.68.0-255,2902,18656,7,261802
47649,0.000464,172.31.36.0-255,66,18722,7,261802
47650,0.000493,74.125.68.0-255,4320,23042,7,261802
47651,0.000496,172.31.36.0-255,66,23108,7,261802
47652,0.000607,74.125.68.0-255,5738,28846,7,261802
47653,0.000611,172.31.36.0-255,66,28912,7,261802
47654,0.000632,74.125.68.0-255,3961,32873,7,261802
47655,0.000635,172.31.36.0-255,66,32939,7,261802
47656,0.000844,172.31.36.0-255,66,33005,7,261802
47657,0.000869,74.125.68.0-255,7156,40161,7,261802
47658,0.000874,172.31.36.0-255,66,40227,7,261802
47659,0.001221,74.125.68.0-255,4320,44547,7,261802
47660,0.001227,172.31.36.0-255,66,44613,7,261802
47661,0.001331,172.31.36.0-255,66,44679,7,261802
47662,0.001615,172.31.36.0-255,66,44745,7,261802
47663,0.00167,172.31.36.0-255,66,44811,7,261802
47664,0.002432,172.31.36.0-255,66,44877,7,261802
47665,0.002472,172.31.36.0-255,66,44943,7,261802
47666,0.003253,172.31.36.0-255,66,45009,7,261802
47667,0.003286,172.31.36.0-255,66,45075,7,261802
47668,0.005362,74.125.68.0-255,5738,50813,7,261802
47669,0.005366,172.31.36.0-255,66,50879,7,261802
47670,0.007456,74.125.68.0-255,5738,56617,7,261802
47671,0.007463,172.31.36.0-255,66,56683,7,261802
47672,0.00955,74.125.68.0-255,5738,62421,7,261802
47673,0.009557,172.31.36.0-255,66,62487,7,261802
47674,0.011643,74.125.68.0-255,5738,68225,7,261802
47675,0.011654,172.31.36.0-255,66,68291,7,261802
47676,0.013755,74.125.68.0-255,5738,74029,7,261802
47677,0.013762,172.31.36.0-255,66,74095,7,261802
47678,0.015882,74.125.68.0-255,5738,79833,7,261802
47679,0.015889,172.31.36.0-255,66,79899,7,261802
47680,0.017994,74.125.68.0-255,5738,85637,7,261802
47681,0.018001,172.31.36.0-255,66,85703,7,261802
47682,0.020094,74.125.68.0-255,5738,91441,7,261802
47683,0.020101,172.31.36.0-255,66,91507,7,261802
47684,0.022184,74.125.68.0-255,5738,97245,7,261802
47685,0.02219,172.31.36.0-255,66,97311,7,261802
47686,0.023315,172.31.36.0-255,167,97478,7,261802
47687,0.023351,172.31.36.0-255,1112,98590,7,261802
47688,0.023409,172.31.36.0-255,1514,100104,7,261802
47689,0.023411,172.31.36.0-255,1294,101398,7,261802
47690,0.024275,74.125.68.0-255,5738,107136,7,261802
47691,0.024279,172.31.36.0-255,66,107202,7,261802
47692,0.024846,104.244.42.0-255,66,107268,7,261802
47693,0.024903,104.244.42.0-255,66,107334,7,261802
47694,0.024947,104.244.42.0-255,66,107400,7,261802
47695,0.026358,74.125.68.0-255,2902,110302,7,261802
47696,0.026363,172.31.36.0-255,66,110368,7,261802
47697,0.026387,74.125.68.0-255,2902,113270,7,261802
47698,0.026403,172.31.36.0-255,66,113336,7,261802
47699,0.028442,74.125.68.0-255,2902,116238,7,261802
47700,0.028447,172.31.36.0-255,66,116304,7,261802
47701,0.028481,74.125.68.0-255,2902,119206,7,261802
47702,0.028494,172.31.36.0-255,66,119272,7,261802
47703,0.030521,74.125.68.0-255,2902,122174,7,261802
47704,0.030526,172.31.36.0-255,66,122240,7,261802
47705,0.030591,74.125.68.0-255,2902,125142,7,261802
47706,0.0306,172.31.36.0-255,66,125208,7,261802
47707,0.032603,74.125.68.0-255,2902,128110,7,261802
47708,0.032608,172.31.36.0-255,66,128176,7,261802
47709,0.032665,74.125.68.0-255,2902,131078,7,261802
47710,0.032692,172.31.36.0-255,66,131144,7,261802
47711,0.034688,74.125.68.0-255,2902,134046,7,261802
47712,0.034693,172.31.36.0-255,66,134112,7,261802
47713,0.034763,74.125.68.0-255,2902,137014,7,261802
47714,0.034773,172.31.36.0-255,66,137080,7,261802
47715,0.036769,74.125.68.0-255,2902,139982,7,261802
47716,0.036774,172.31.36.0-255,66,140048,7,261802
47717,0.036864,74.125.68.0-255,2902,142950,7,261802
47718,0.036868,172.31.36.0-255,66,143016,7,261802
47719,0.038846,74.125.68.0-255,2902,145918,7,261802
47720,0.03885,172.31.36.0-255,66,145984,7,261802
47721,0.038938,74.125.68.0-255,2902,148886,7,261802
47722,0.038942,172.31.36.0-255,66,148952,7,261802
47723,0.040919,74.125.68.0-255,2902,151854,7,261802
47724,0.040925,172.31.36.0-255,66,151920,7,261802
47725,0.041008,74.125.68.0-255,2902,154822,7,261802
47726,0.041013,172.31.36.0-255,66,154888,7,261802
47727,0.04301,74.125.68.0-255,2902,157790,7,261802
47728,0.043015,172.31.36.0-255,66,157856,7,261802
47729,0.043089,74.125.68.0-255,2902,160758,7,261802
47730,0.043093,172.31.36.0-255,66,160824,7,261802
47731,0.04508,74.125.68.0-255,2902,163726,7,261802
47732,0.045085,172.31.36.0-255,66,163792,7,261802
47733,0.045163,74.125.68.0-255,2902,166694,7,261802
47734,0.045167,172.31.36.0-255,66,166760,7,261802
47735,0.047164,74.125.68.0-255,2902,169662,7,261802
47736,0.047169,172.31.36.0-255,66,169728,7,261802
47737,0.047244,74.125.68.0-255,2902,172630,7,261802
47738,0.047251,172.31.36.0-255,66,172696,7,261802
47739,0.049251,74.125.68.0-255,2902,175598,7,261802
47740,0.049256,172.31.36.0-255,66,175664,7,261802
47741,0.049329,74.125.68.0-255,2902,178566,7,261802
47742,0.049335,172.31.36.0-255,66,178632,7,261802
47743,0.051332,74.125.68.0-255,2902,181534,7,261802
47744,0.051337,172.31.36.0-255,66,181600,7,261802
47745,0.051419,74.125.68.0-255,2902,184502,7,261802
47746,0.051423,172.31.36.0-255,66,184568,7,261802
47747,0.053406,74.125.68.0-255,2902,187470,7,261802
47748,0.053411,172.31.36.0-255,66,187536,7,261802
47749,0.053485,74.125.68.0-255,2902,190438,7,261802
47750,0.053492,172.31.36.0-255,66,190504,7,261802
47751,0.05548,74.125.68.0-255,2902,193406,7,261802
47752,0.055484,172.31.36.0-255,66,193472,7,261802
47753,0.055561,74.125.68.0-255,2902,196374,7,261802
47754,0.055565,172.31.36.0-255,66,196440,7,261802
47755,0.057563,74.125.68.0-255,2902,199342,7,261802
47756,0.057568,172.31.36.0-255,66,199408,7,261802
47757,0.057639,74.125.68.0-255,2902,202310,7,261802
47758,0.057646,172.31.36.0-255,66,202376,7,261802
47759,0.059641,74.125.68.0-255,2902,205278,7,261802
47760,0.059647,172.31.36.0-255,66,205344,7,261802
47761,0.059713,74.125.68.0-255,2902,208246,7,261802
47762,0.059731,172.31.36.0-255,66,208312,7,261802
47763,0.061719,74.125.68.0-255,2902,211214,7,261802
47764,0.061723,172.31.36.0-255,66,211280,7,261802
47765,0.061802,74.125.68.0-255,2902,214182,7,261802
47766,0.061806,172.31.36.0-255,66,214248,7,261802
47767,0.063803,74.125.68.0-255,2902,217150,7,261802
47768,0.063808,172.31.36.0-255,66,217216,7,261802
47769,0.063878,74.125.68.0-255,2902,220118,7,261802
47770,0.063884,172.31.36.0-255,66,220184,7,261802
47771,0.065876,74.125.68.0-255,2902,223086,7,261802
47772,0.065881,172.31.36.0-255,66,223152,7,261802
47773,0.065961,74.125.68.0-255,2902,226054,7,261802
47774,0.065985,172.31.36.0-255,66,226120,7,261802
47775,0.067964,74.125.68.0-255,2902,229022,7,261802
47776,0.067969,172.31.36.0-255,66,229088,7,261802
47777,0.068073,74.125.68.0-255,2902,231990,7,261802
47778,0.068077,172.31.36.0-255,66,232056,7,261802
47779,0.070052,74.125.68.0-255,2902,234958,7,261802
47780,0.070057,172.31.36.0-255,66,235024,7,261802
47781,0.070182,74.125.68.0-255,2902,237926,7,261802
47782,0.070197,172.31.36.0-255,66,237992,7,261802
47783,0.07213,74.125.68.0-255,1484,239476,7,261802
47784,0.072154,74.125.68.0-255,1484,240960,7,261802
47785,0.072158,172.31.36.0-255,66,241026,7,261802
47786,0.07229,74.125.68.0-255,2902,243928,7,261802
47787,0.072295,172.31.36.0-255,66,243994,7,261802
47788,0.074237,74.125.68.0-255,2902,246896,7,261802
47789,0.074241,172.31.36.0-255,66,246962,7,261802
47790,0.074365,74.125.68.0-255,2902,249864,7,261802
47791,0.07437,172.31.36.0-255,66,249930,7,261802
47792,0.076317,74.125.68.0-255,2902,252832,7,261802
47793,0.076322,172.31.36.0-255,66,252898,7,261802
47794,0.076444,74.125.68.0-255,2902,255800,7,261802
47795,0.076449,172.31.36.0-255,66,255866,7,261802
47796,0.078405,74.125.68.0-255,2902,258768,7,261802
47797,0.07841,172.31.36.0-255,66,258834,7,261802
47798,0.078521,74.125.68.0-255,2902,261736,7,261802
47799,0.078526,172.31.36.0-255,66,261802,7,261802
47800,0.0,172.31.36.0-255,105,105,7,105
47801,0.0,74.125.68.0-255,152,152,7,324764
47802,2.5e-05,172.31.36.0-255,66,218,7,324764
47803,3.3e-05,74.125.68.0-255,1484,1702,7,324764
47804,3.8e-05,172.31.36.0-255,66,1768,7,324764
47805,4.4e-05,74.125.68.0-255,2902,4670,7,324764
47806,7.5e-05,172.31.36.0-255,66,4736,7,324764
47807,8.4e-05,74.125.68.0-255,7156,11892,7,324764
47808,8.8e-05,172.31.36.0-255,66,11958,7,324764
47809,9.2e-05,74.125.68.0-255,1484,13442,7,324764
47810,9.5e-05,172.31.36.0-255,66,13508,7,324764
47811,0.000101,74.125.68.0-255,2020,15528,7,324764
47812,0.000103,172.31.36.0-255,66,15594,7,324764
47813,0.000109,74.125.68.0-255,2902,18496,7,324764
47814,0.000113,172.31.36.0-255,66,18562,7,324764
47815,0.000141,74.125.68.0-255,2902,21464,7,324764
47816,0.000144,172.31.36.0-255,66,21530,7,324764
47817,0.00015,74.125.68.0-255,2902,24432,7,324764
47818,0.000152,172.31.36.0-255,66,24498,7,324764
47819,0.00016,74.125.68.0-255,4320,28818,7,324764
47820,0.000163,172.31.36.0-255,66,28884,7,324764
47821,0.000196,74.125.68.0-255,2543,31427,7,324764
47822,0.000199,172.31.36.0-255,66,31493,7,324764
47823,0.000533,74.125.68.0-255,1484,32977,7,324764
47824,0.000541,172.31.36.0-255,66,33043,7,324764
47825,0.000549,74.125.68.0-255,2902,35945,7,324764
47826,0.000552,172.31.36.0-255,66,36011,7,324764
47827,0.000564,74.125.68.0-255,5738,41749,7,324764
47828,0.000567,172.31.36.0-255,66,41815,7,324764
47829,0.000572,74.125.68.0-255,2902,44717,7,324764
47830,0.000574,172.31.36.0-255,66,44783,7,324764
47831,0.000609,74.125.68.0-255,3961,48744,7,324764
47832,0.000612,172.31.36.0-255,66,48810,7,324764
47833,0.000644,74.125.68.0-255,5738,54548,7,324764
47834,0.000647,172.31.36.0-255,66,54614,7,324764
47835,0.000653,74.125.68.0-255,2902,57516,7,324764
47836,0.000655,172.31.36.0-255,66,57582,7,324764
47837,0.000688,74.125.68.0-255,4320,61902,7,324764
47838,0.000691,172.31.36.0-255,66,61968,7,324764
47839,0.000696,74.125.68.0-255,4270,66238,7,324764
47840,0.000699,172.31.36.0-255,66,66304,7,324764
47841,0.000702,74.125.68.0-255,111,66415,7,324764
47842,0.000927,74.125.68.0-255,1484,67899,7,324764
47843,0.000932,172.31.36.0-255,66,67965,7,324764
47844,0.00094,74.125.68.0-255,2902,70867,7,324764
47845,0.000942,172.31.36.0-255,66,70933,7,324764
47846,0.000946,74.125.68.0-255,1484,72417,7,324764
47847,0.000977,74.125.68.0-255,4320,76737,7,324764
47848,0.00098,172.31.36.0-255,66,76803,7,324764
47849,0.000988,74.125.68.0-255,6797,83600,7,324764
47850,0.00099,172.31.36.0-255,66,83666,7,324764
47851,0.001043,74.125.68.0-255,5738,89404,7,324764
47852,0.001046,172.31.36.0-255,66,89470,7,324764
47853,0.001072,74.125.68.0-255,1484,90954,7,324764
47854,0.001084,172.31.36.0-255,66,91020,7,324764
47855,0.001148,74.125.68.0-255,1369,92389,7,324764
47856,0.001297,74.125.68.0-255,1484,93873,7,324764
47857,0.001303,172.31.36.0-255,66,93939,7,324764
47858,0.001333,74.125.68.0-255,2902,96841,7,324764
47859,0.001336,172.31.36.0-255,66,96907,7,324764
47860,0.001343,74.125.68.0-255,5738,102645,7,324764
47861,0.001345,172.31.36.0-255,66,102711,7,324764
47862,0.001356,74.125.68.0-255,4320,107031,7,324764
47863,0.001358,172.31.36.0-255,66,107097,7,324764
47864,0.001365,74.125.68.0-255,5738,112835,7,324764
47865,0.001368,172.31.36.0-255,66,112901,7,324764
47866,0.001391,74.125.68.0-255,4320,117221,7,324764
47867,0.001394,172.31.36.0-255,66,117287,7,324764
47868,0.001425,74.125.68.0-255,7156,124443,7,324764
47869,0.001428,172.31.36.0-255,66,124509,7,324764
47870,0.001447,74.125.68.0-255,2184,126693,7,324764
47871,0.00145,172.31.36.0-255,66,126759,7,324764
47872,0.003716,74.125.68.0-255,2902,129661,7,324764
47873,0.003724,172.31.36.0-255,66,129727,7,324764
47874,0.003758,74.125.68.0-255,2902,132629,7,324764
47875,0.00376,172.31.36.0-255,66,132695,7,324764
47876,0.006027,74.125.68.0-255,2902,135597,7,324764
47877,0.006031,172.31.36.0-255,66,135663,7,324764
47878,0.006055,74.125.68.0-255,2902,138565,7,324764
47879,0.006058,172.31.36.0-255,66,138631,7,324764
47880,0.008323,74.125.68.0-255,2902,141533,7,324764
47881,0.00833,172.31.36.0-255,66,141599,7,324764
47882,0.008357,74.125.68.0-255,2902,144501,7,324764
47883,0.00836,172.31.36.0-255,66,144567,7,324764
47884,0.010639,74.125.68.0-255,2902,147469,7,324764
47885,0.010647,172.31.36.0-255,66,147535,7,324764
47886,0.010675,74.125.68.0-255,2902,150437,7,324764
47887,0.010678,172.31.36.0-255,66,150503,7,324764
47888,0.012958,74.125.68.0-255,2902,153405,7,324764
47889,0.012966,172.31.36.0-255,66,153471,7,324764
47890,0.012996,74.125.68.0-255,2902,156373,7,324764
47891,0.012999,172.31.36.0-255,66,156439,7,324764
47892,0.015267,74.125.68.0-255,2902,159341,7,324764
47893,0.015274,172.31.36.0-255,66,159407,7,324764
47894,0.015313,74.125.68.0-255,2902,162309,7,324764
47895,0.015316,172.31.36.0-255,66,162375,7,324764
47896,0.017576,74.125.68.0-255,2902,165277,7,324764
47897,0.017587,172.31.36.0-255,66,165343,7,324764
47898,0.01762,74.125.68.0-255,2902,168245,7,324764
47899,0.017624,172.31.36.0-255,66,168311,7,324764
47900,0.019887,74.125.68.0-255,2902,171213,7,324764
47901,0.019896,172.31.36.0-255,66,171279,7,324764
47902,0.019928,74.125.68.0-255,2902,174181,7,324764
47903,0.019931,172.31.36.0-255,66,174247,7,324764
47904,0.022205,74.125.68.0-255,2902,177149,7,324764
47905,0.022213,172.31.36.0-255,66,177215,7,324764
47906,0.022247,74.125.68.0-255,2902,180117,7,324764
47907,0.02225,172.31.36.0-255,66,180183,7,324764
47908,0.024515,74.125.68.0-255,2902,183085,7,324764
47909,0.024522,172.31.36.0-255,66,183151,7,324764
47910,0.024552,74.125.68.0-255,2902,186053,7,324764
47911,0.024555,172.31.36.0-255,66,186119,7,324764
47912,0.026816,74.125.68.0-255,2902,189021,7,324764
47913,0.026824,172.31.36.0-255,66,189087,7,324764
47914,0.026851,74.125.68.0-255,2902,191989,7,324764
47915,0.026855,172.31.36.0-255,66,192055,7,324764
47916,0.029119,74.125.68.0-255,2902,194957,7,324764
47917,0.029128,172.31.36.0-255,66,195023,7,324764
47918,0.029161,74.125.68.0-255,2902,197925,7,324764
47919,0.029164,172.31.36.0-255,66,197991,7,324764
47920,0.031439,74.125.68.0-255,5738,203729,7,324764
47921,0.031446,172.31.36.0-255,66,203795,7,324764
47922,0.032648,172.31.36.0-255,176,203971,7,324764
47923,0.032678,172.31.36.0-255,1115,205086,7,324764
47924,0.032754,172.31.36.0-255,1514,206600,7,324764
47925,0.032756,172.31.36.0-255,1292,207892,7,324764
47926,0.033785,74.125.68.0-255,5738,213630,7,324764
47927,0.033792,172.31.36.0-255,66,213696,7,324764
47928,0.034215,104.244.42.0-255,66,213762,7,324764
47929,0.034259,104.244.42.0-255,66,213828,7,324764
47930,0.034306,104.244.42.0-255,66,213894,7,324764
47931,0.036093,74.125.68.0-255,5738,219632,7,324764
47932,0.0361,172.31.36.0-255,66,219698,7,324764
47933,0.038413,74.125.68.0-255,5738,225436,7,324764
47934,0.038421,172.31.36.0-255,66,225502,7,324764
47935,0.040719,74.125.68.0-255,5738,231240,7,324764
47936,0.040738,172.31.36.0-255,66,231306,7,324764
47937,0.043053,74.125.68.0-255,5738,237044,7,324764
47938,0.043065,172.31.36.0-255,66,237110,7,324764
47939,0.045367,74.125.68.0-255,5738,242848,7,324764
47940,0.045373,172.31.36.0-255,66,242914,7,324764
47941,0.047695,74.125.68.0-255,5738,248652,7,324764
47942,0.047701,172.31.36.0-255,66,248718,7,324764
47943,0.050018,74.125.68.0-255,5738,254456,7,324764
47944,0.050024,172.31.36.0-255,66,254522,7,324764
47945,0.052322,74.125.68.0-255,5738,260260,7,324764
47946,0.052329,172.31.36.0-255,66,260326,7,324764
47947,0.054627,74.125.68.0-255,5738,266064,7,324764
47948,0.054633,172.31.36.0-255,66,266130,7,324764
47949,0.056927,74.125.68.0-255,5738,271868,7,324764
47950,0.056934,172.31.36.0-255,66,271934,7,324764
47951,0.059288,74.125.68.0-255,5738,277672,7,324764
47952,0.059299,172.31.36.0-255,66,277738,7,324764
47953,0.061607,74.125.68.0-255,5738,283476,7,324764
47954,0.061614,172.31.36.0-255,66,283542,7,324764
47955,0.063911,74.125.68.0-255,5738,289280,7,324764
47956,0.063917,172.31.36.0-255,66,289346,7,324764
47957,0.066203,74.125.68.0-255,2902,292248,7,324764
47958,0.066209,172.31.36.0-255,66,292314,7,324764
47959,0.066238,74.125.68.0-255,2902,295216,7,324764
47960,0.066243,172.31.36.0-255,66,295282,7,324764
47961,0.068498,74.125.68.0-255,2902,298184,7,324764
47962,0.068505,172.31.36.0-255,66,298250,7,324764
47963,0.068525,74.125.68.0-255,1484,299734,7,324764
47964,0.068538,74.125.68.0-255,1484,301218,7,324764
47965,0.068541,172.31.36.0-255,66,301284,7,324764
47966,0.070828,74.125.68.0-255,2902,304186,7,324764
47967,0.070837,172.31.36.0-255,66,304252,7,324764
47968,0.070866,74.125.68.0-255,2902,307154,7,324764
47969,0.070869,172.31.36.0-255,66,307220,7,324764
47970,0.073133,74.125.68.0-255,2902,310122,7,324764
47971,0.07314,172.31.36.0-255,66,310188,7,324764
47972,0.073168,74.125.68.0-255,2902,313090,7,324764
47973,0.073171,172.31.36.0-255,66,313156,7,324764
47974,0.075461,74.125.68.0-255,5738,318894,7,324764
47975,0.075468,172.31.36.0-255,66,318960,7,324764
47976,0.077786,74.125.68.0-255,5738,324698,7,324764
47977,0.077792,172.31.36.0-255,66,324764,7,324764
47978,0.0,172.217.194.0-255,146,146,7,329589
47979,2.5e-05,172.31.36.0-255,66,212,7,329589
47980,3.3e-05,172.217.194.0-255,1484,1696,7,329589
47981,3.8e-05,172.31.36.0-255,66,1762,7,329589
47982,5.1e-05,172.217.194.0-255,2902,4664,7,329589
47983,5.4e-05,172.31.36.0-255,66,4730,7,329589
47984,6.2e-05,172.217.194.0-255,7156,11886,7,329589
47985,6.6e-05,172.31.36.0-255,66,11952,7,329589
47986,7e-05,172.217.194.0-255,2065,14017,7,329589
47987,7.2e-05,172.31.36.0-255,66,14083,7,329589
47988,0.000113,172.217.194.0-255,2902,16985,7,329589
47989,0.000122,172.31.36.0-255,66,17051,7,329589
47990,0.00013,172.217.194.0-255,7156,24207,7,329589
47991,0.000133,172.31.36.0-255,66,24273,7,329589
47992,0.00014,172.217.194.0-255,6797,31070,7,329589
47993,0.000143,172.31.36.0-255,66,31136,7,329589
47994,0.000168,172.217.194.0-255,4320,35456,7,329589
47995,0.000172,172.31.36.0-255,66,35522,7,329589
47996,0.000205,172.31.36.0-255,66,35588,7,329589
47997,0.000208,172.217.194.0-255,1125,36713,7,329589
47998,0.00021,172.31.36.0-255,66,36779,7,329589
47999,0.000236,172.217.194.0-255,5738,42517,7,329589
48000,0.000239,172.31.36.0-255,66,42583,7,329589
48001,0.000272,172.31.36.0-255,66,42649,7,329589
48002,0.000275,172.217.194.0-255,676,43325,7,329589
48003,0.000277,172.31.36.0-255,66,43391,7,329589
48004,0.00049,172.217.194.0-255,1484,44875,7,329589
48005,0.000496,172.31.36.0-255,66,44941,7,329589
48006,0.000502,172.217.194.0-255,2902,47843,7,329589
48007,0.000504,172.31.36.0-255,66,47909,7,329589
48008,0.000513,172.217.194.0-255,2902,50811,7,329589
48009,0.000515,172.31.36.0-255,66,50877,7,329589
48010,0.000542,172.217.194.0-255,2902,53779,7,329589
48011,0.000545,172.31.36.0-255,66,53845,7,329589
48012,0.000557,172.31.36.0-255,66,53911,7,329589
48013,0.00059,172.217.194.0-255,7156,61067,7,329589
48014,0.000592,172.31.36.0-255,66,61133,7,329589
48015,0.000622,172.217.194.0-255,5890,67023,7,329589
48016,0.000625,172.31.36.0-255,66,67089,7,329589
48017,0.000657,172.31.36.0-255,66,67155,7,329589
48018,0.000685,172.217.194.0-255,3961,71116,7,329589
48019,0.000688,172.31.36.0-255,66,71182,7,329589
48020,0.00087,172.217.194.0-255,1484,72666,7,329589
48021,0.000876,172.217.194.0-255,1484,74150,7,329589
48022,0.000879,172.31.36.0-255,66,74216,7,329589
48023,0.000906,172.217.194.0-255,1484,75700,7,329589
48024,0.000913,172.217.194.0-255,5738,81438,7,329589
48025,0.000916,172.31.36.0-255,66,81504,7,329589
48026,0.000941,172.217.194.0-255,1484,82988,7,329589
48027,0.000967,172.31.36.0-255,66,83054,7,329589
48028,0.000983,172.217.194.0-255,1484,84538,7,329589
48029,0.000986,172.217.194.0-255,1484,86022,7,329589
48030,0.000988,172.31.36.0-255,66,86088,7,329589
48031,0.001019,172.31.36.0-255,66,86154,7,329589
48032,0.001075,172.217.194.0-255,1484,87638,7,329589
48033,0.001081,172.217.194.0-255,2902,90540,7,329589
48034,0.001084,172.31.36.0-255,66,90606,7,329589
48035,0.001105,172.217.194.0-255,5738,96344,7,329589
48036,0.001108,172.31.36.0-255,66,96410,7,329589
48037,0.001126,172.217.194.0-255,2902,99312,7,329589
48038,0.001128,172.31.36.0-255,66,99378,7,329589
48039,0.00117,172.217.194.0-255,7156,106534,7,329589
48040,0.001174,172.31.36.0-255,66,106600,7,329589
48041,0.001182,172.31.36.0-255,66,106666,7,329589
48042,0.001185,172.217.194.0-255,1484,108150,7,329589
48043,0.001215,172.217.194.0-255,2184,110334,7,329589
48044,0.001218,172.31.36.0-255,66,110400,7,329589
48045,0.001243,172.217.194.0-255,4320,114720,7,329589
48046,0.001246,172.31.36.0-255,66,114786,7,329589
48047,0.001251,172.217.194.0-255,2902,117688,7,329589
48048,0.001253,172.31.36.0-255,66,117754,7,329589
48049,0.001276,172.217.194.0-255,1484,119238,7,329589
48050,0.00128,172.217.194.0-255,1484,120722,7,329589
48051,0.001282,172.31.36.0-255,66,120788,7,329589
48052,0.001322,172.31.36.0-255,66,120854,7,329589
48053,0.001364,172.217.194.0-255,2902,123756,7,329589
48054,0.001367,172.31.36.0-255,66,123822,7,329589
48055,0.001396,172.31.36.0-255,66,123888,7,329589
48056,0.001401,172.217.194.0-255,3602,127490,7,329589
48057,0.001403,172.31.36.0-255,66,127556,7,329589
48058,0.001673,172.217.194.0-255,1484,129040,7,329589
48059,0.001701,172.217.194.0-255,2902,131942,7,329589
48060,0.001705,172.31.36.0-255,66,132008,7,329589
48061,0.00171,172.217.194.0-255,2902,134910,7,329589
48062,0.001713,172.31.36.0-255,66,134976,7,329589
48063,0.001723,172.217.194.0-255,4320,139296,7,329589
48064,0.001726,172.31.36.0-255,66,139362,7,329589
48065,0.001737,172.217.194.0-255,2902,142264,7,329589
48066,0.001739,172.31.36.0-255,66,142330,7,329589
48067,0.001765,172.217.194.0-255,5738,148068,7,329589
48068,0.001768,172.31.36.0-255,66,148134,7,329589
48069,0.001804,172.31.36.0-255,66,148200,7,329589
48070,0.001815,172.217.194.0-255,3602,151802,7,329589
48071,0.001817,172.31.36.0-255,66,151868,7,329589
48072,0.003872,172.217.194.0-255,5738,157606,7,329589
48073,0.003879,172.31.36.0-255,66,157672,7,329589
48074,0.005942,172.217.194.0-255,4320,161992,7,329589
48075,0.005949,172.31.36.0-255,66,162058,7,329589
48076,0.005977,172.217.194.0-255,1484,163542,7,329589
48077,0.008024,172.217.194.0-255,4320,167862,7,329589
48078,0.00803,172.31.36.0-255,66,167928,7,329589
48079,0.010107,172.217.194.0-255,5738,173666,7,329589
48080,0.010115,172.31.36.0-255,66,173732,7,329589
48081,0.012161,172.217.194.0-255,5738,179470,7,329589
48082,0.01217,172.31.36.0-255,66,179536,7,329589
48083,0.014253,172.217.194.0-255,5738,185274,7,329589
48084,0.014263,172.31.36.0-255,66,185340,7,329589
48085,0.01636,172.217.194.0-255,5738,191078,7,329589
48086,0.01637,172.31.36.0-255,66,191144,7,329589
48087,0.018436,172.217.194.0-255,5738,196882,7,329589
48088,0.018445,172.31.36.0-255,66,196948,7,329589
48089,0.020504,172.217.194.0-255,5738,202686,7,329589
48090,0.020512,172.31.36.0-255,66,202752,7,329589
48091,0.022634,172.217.194.0-255,5738,208490,7,329589
48092,0.022641,172.31.36.0-255,66,208556,7,329589
48093,0.024695,172.217.194.0-255,5738,214294,7,329589
48094,0.024705,172.31.36.0-255,66,214360,7,329589
48095,0.026801,172.217.194.0-255,5738,220098,7,329589
48096,0.026809,172.31.36.0-255,66,220164,7,329589
48097,0.028893,172.217.194.0-255,5738,225902,7,329589
48098,0.028901,172.31.36.0-255,66,225968,7,329589
48099,0.030331,172.31.36.0-255,210,226178,7,329589
48100,0.030364,172.31.36.0-255,1114,227292,7,329589
48101,0.030427,172.31.36.0-255,1514,228806,7,329589
48102,0.030429,172.31.36.0-255,1514,230320,7,329589
48103,0.03043,172.31.36.0-255,1514,231834,7,329589
48104,0.030431,172.31.36.0-255,1073,232907,7,329589
48105,0.030985,172.217.194.0-255,5738,238645,7,329589
48106,0.030993,172.31.36.0-255,66,238711,7,329589
48107,0.031865,104.244.42.0-255,66,238777,7,329589
48108,0.031942,104.244.42.0-255,66,238843,7,329589
48109,0.032022,104.244.42.0-255,66,238909,7,329589
48110,0.032043,104.244.42.0-255,66,238975,7,329589
48111,0.033058,172.217.194.0-255,5738,244713,7,329589
48112,0.033064,172.31.36.0-255,66,244779,7,329589
48113,0.035166,172.217.194.0-255,5738,250517,7,329589
48114,0.035173,172.31.36.0-255,66,250583,7,329589
48115,0.037264,172.217.194.0-255,5738,256321,7,329589
48116,0.037271,172.31.36.0-255,66,256387,7,329589
48117,0.039352,172.217.194.0-255,5738,262125,7,329589
48118,0.039358,172.31.36.0-255,66,262191,7,329589
48119,0.041444,172.217.194.0-255,5738,267929,7,329589
48120,0.04145,172.31.36.0-255,66,267995,7,329589
48121,0.043555,172.217.194.0-255,5738,273733,7,329589
48122,0.043561,172.31.36.0-255,66,273799,7,329589
48123,0.045647,172.217.194.0-255,2902,276701,7,329589
48124,0.045657,172.31.36.0-255,66,276767,7,329589
48125,0.045687,172.217.194.0-255,2902,279669,7,329589
48126,0.045692,172.31.36.0-255,66,279735,7,329589
48127,0.047709,172.217.194.0-255,2902,282637,7,329589
48128,0.047717,172.31.36.0-255,66,282703,7,329589
48129,0.04775,172.217.194.0-255,2902,285605,7,329589
48130,0.047753,172.31.36.0-255,66,285671,7,329589
48131,0.049783,172.217.194.0-255,2902,288573,7,329589
48132,0.04979,172.31.36.0-255,66,288639,7,329589
48133,0.049818,172.217.194.0-255,2902,291541,7,329589
48134,0.049821,172.31.36.0-255,66,291607,7,329589
48135,0.051907,172.217.194.0-255,5738,297345,7,329589
48136,0.051914,172.31.36.0-255,66,297411,7,329589
48137,0.053993,172.217.194.0-255,5738,303149,7,329589
48138,0.053998,172.31.36.0-255,66,303215,7,329589
48139,0.056072,172.217.194.0-255,5738,308953,7,329589
48140,0.056079,172.31.36.0-255,66,309019,7,329589
48141,0.058184,172.217.194.0-255,5738,314757,7,329589
48142,0.058191,172.31.36.0-255,66,314823,7,329589
48143,0.060246,172.217.194.0-255,5738,320561,7,329589
48144,0.060252,172.31.36.0-255,66,320627,7,329589
48145,0.06234,172.217.194.0-255,5738,326365,7,329589
48146,0.062346,172.31.36.0-255,66,326431,7,329589
48147,0.064426,172.217.194.0-255,2921,329352,7,329589
48148,0.064433,172.31.36.0-255,66,329418,7,329589
48149,0.064599,172.31.36.0-255,105,329523,7,329589
48150,0.066632,172.217.194.0-255,66,329589,7,329589
48151,0.0,172.31.36.0-255,105,105,7,276
48152,0.002064,157.240.13.0-255,105,210,7,276
48153,0.002078,172.31.36.0-255,66,276,7,276
48154,0.0,172.253.118.0-255,143,143,7,332522
48155,1.9e-05,172.31.36.0-255,66,209,7,332522
48156,2.6e-05,172.253.118.0-255,1484,1693,7,332522
48157,3e-05,172.31.36.0-255,66,1759,7,332522
48158,3.7e-05,172.253.118.0-255,2902,4661,7,332522
48159,4.1e-05,172.31.36.0-255,66,4727,7,332522
48160,4.6e-05,172.253.118.0-255,2902,7629,7,332522
48161,4.8e-05,172.31.36.0-255,66,7695,7,332522
48162,9.9e-05,172.31.36.0-255,66,7761,7,332522
48163,0.000105,172.253.118.0-255,5738,13499,7,332522
48164,0.000108,172.31.36.0-255,66,13565,7,332522
48165,0.000111,172.253.118.0-255,1484,15049,7,332522
48166,0.000113,172.31.36.0-255,66,15115,7,332522
48167,0.000138,172.253.118.0-255,5738,20853,7,332522
48168,0.000141,172.31.36.0-255,66,20919,7,332522
48169,0.000146,172.253.118.0-255,2543,23462,7,332522
48170,0.000148,172.31.36.0-255,66,23528,7,332522
48171,0.000303,172.253.118.0-255,1484,25012,7,332522
48172,0.000307,172.31.36.0-255,66,25078,7,332522
48173,0.00032,172.253.118.0-255,2902,27980,7,332522
48174,0.000324,172.31.36.0-255,66,28046,7,332522
48175,0.000326,172.253.118.0-255,1484,29530,7,332522
48176,0.000328,172.31.36.0-255,66,29596,7,332522
48177,0.000352,172.253.118.0-255,4320,33916,7,332522
48178,0.000355,172.31.36.0-255,66,33982,7,332522
48179,0.000361,172.253.118.0-255,4320,38302,7,332522
48180,0.000363,172.31.36.0-255,66,38368,7,332522
48181,0.000397,172.253.118.0-255,5738,44106,7,332522
48182,0.000401,172.31.36.0-255,66,44172,7,332522
48183,0.000421,172.253.118.0-255,6797,50969,7,332522
48184,0.000424,172.31.36.0-255,66,51035,7,332522
48185,0.000429,172.253.118.0-255,2902,53937,7,332522
48186,0.000431,172.31.36.0-255,66,54003,7,332522
48187,0.000452,172.253.118.0-255,1484,55487,7,332522
48188,0.000465,172.253.118.0-255,2819,58306,7,332522
48189,0.000467,172.31.36.0-255,66,58372,7,332522
48190,0.000494,172.253.118.0-255,129,58501,7,332522
48191,0.000626,172.253.118.0-255,1484,59985,7,332522
48192,0.00063,172.31.36.0-255,66,60051,7,332522
48193,0.000635,172.253.118.0-255,2902,62953,7,332522
48194,0.000638,172.31.36.0-255,66,63019,7,332522
48195,0.00067,172.253.118.0-255,5738,68757,7,332522
48196,0.000673,172.31.36.0-255,66,68823,7,332522
48197,0.000702,172.31.36.0-255,66,68889,7,332522
48198,0.000732,172.31.36.0-255,66,68955,7,332522
48199,0.000778,172.253.118.0-255,3883,72838,7,332522
48200,0.00078,172.31.36.0-255,66,72904,7,332522
48201,0.00118,172.253.118.0-255,1484,74388,7,332522
48202,0.001188,172.253.118.0-255,2902,77290,7,332522
48203,0.001193,172.31.36.0-255,66,77356,7,332522
48204,0.0012,172.253.118.0-255,5738,83094,7,332522
48205,0.001203,172.31.36.0-255,66,83160,7,332522
48206,0.001225,172.253.118.0-255,4320,87480,7,332522
48207,0.001228,172.31.36.0-255,66,87546,7,332522
48208,0.001235,172.253.118.0-255,5738,93284,7,332522
48209,0.001238,172.31.36.0-255,66,93350,7,332522
48210,0.001258,172.253.118.0-255,5738,99088,7,332522
48211,0.00126,172.31.36.0-255,66,99154,7,332522
48212,0.001299,172.31.36.0-255,66,99220,7,332522
48213,0.00131,172.31.36.0-255,66,99286,7,332522
48214,0.001358,172.31.36.0-255,66,99352,7,332522
48215,0.001377,172.253.118.0-255,2902,102254,7,332522
48216,0.001379,172.31.36.0-255,66,102320,7,332522
48217,0.001402,172.253.118.0-255,3602,105922,7,332522
48218,0.001404,172.31.36.0-255,66,105988,7,332522
48219,0.001596,172.253.118.0-255,1484,107472,7,332522
48220,0.001613,172.253.118.0-255,2902,110374,7,332522
48221,0.001618,172.31.36.0-255,66,110440,7,332522
48222,0.001625,172.253.118.0-255,5738,116178,7,332522
48223,0.001627,172.31.36.0-255,66,116244,7,332522
48224,0.00166,172.31.36.0-255,66,116310,7,332522
48225,0.001679,172.253.118.0-255,1484,117794,7,332522
48226,0.001701,172.253.118.0-255,2902,120696,7,332522
48227,0.001705,172.31.36.0-255,66,120762,7,332522
48228,0.001714,172.253.118.0-255,2902,123664,7,332522
48229,0.001718,172.31.36.0-255,66,123730,7,332522
48230,0.001741,172.31.36.0-255,66,123796,7,332522
48231,0.002283,172.253.118.0-255,1484,125280,7,332522
48232,0.002288,172.253.118.0-255,2902,128182,7,332522
48233,0.002298,172.31.36.0-255,66,128248,7,332522
48234,0.00232,172.253.118.0-255,5738,133986,7,332522
48235,0.002322,172.31.36.0-255,66,134052,7,332522
48236,0.002326,172.253.118.0-255,1484,135536,7,332522
48237,0.002357,172.253.118.0-255,5738,141274,7,332522
48238,0.00236,172.31.36.0-255,66,141340,7,332522
48239,0.002374,172.31.36.0-255,66,141406,7,332522
48240,0.002391,172.253.118.0-255,1484,142890,7,332522
48241,0.002395,172.253.118.0-255,2184,145074,7,332522
48242,0.002397,172.31.36.0-255,66,145140,7,332522
48243,0.00471,172.253.118.0-255,1484,146624,7,332522
48244,0.00473,172.253.118.0-255,2902,149526,7,332522
48245,0.004735,172.31.36.0-255,66,149592,7,332522
48246,0.004748,172.253.118.0-255,1484,151076,7,332522
48247,0.007054,172.253.118.0-255,4320,155396,7,332522
48248,0.007057,172.31.36.0-255,66,155462,7,332522
48249,0.009414,172.253.118.0-255,5738,161200,7,332522
48250,0.009421,172.31.36.0-255,66,161266,7,332522
48251,0.011761,172.253.118.0-255,5738,167004,7,332522
48252,0.011767,172.31.36.0-255,66,167070,7,332522
48253,0.014114,172.253.118.0-255,5738,172808,7,332522
48254,0.014123,172.31.36.0-255,66,172874,7,332522
48255,0.016498,172.253.118.0-255,5738,178612,7,332522
48256,0.016512,172.31.36.0-255,66,178678,7,332522
48257,0.01887,172.253.118.0-255,5738,184416,7,332522
48258,0.01888,172.31.36.0-255,66,184482,7,332522
48259,0.021264,172.253.118.0-255,5738,190220,7,332522
48260,0.021271,172.31.36.0-255,66,190286,7,332522
48261,0.023622,172.253.118.0-255,5738,196024,7,332522
48262,0.02363,172.31.36.0-255,66,196090,7,332522
48263,0.025988,172.253.118.0-255,5738,201828,7,332522
48264,0.025995,172.31.36.0-255,66,201894,7,332522
48265,0.028356,172.253.118.0-255,5738,207632,7,332522
48266,0.028364,172.31.36.0-255,66,207698,7,332522
48267,0.030721,172.253.118.0-255,5738,213436,7,332522
48268,0.030732,172.31.36.0-255,66,213502,7,332522
48269,0.033096,172.253.118.0-255,5738,219240,7,332522
48270,0.033103,172.31.36.0-255,66,219306,7,332522
48271,0.034322,172.31.36.0-255,172,219478,7,332522
48272,0.034355,172.31.36.0-255,1116,220594,7,332522
48273,0.034411,172.31.36.0-255,1514,222108,7,332522
48274,0.034413,172.31.36.0-255,1292,223400,7,332522
48275,0.035473,172.253.118.0-255,4320,227720,7,332522
48276,0.035479,172.31.36.0-255,66,227786,7,332522
48277,0.035495,172.253.118.0-255,1484,229270,7,332522
48278,0.035855,104.244.42.0-255,66,229336,7,332522
48279,0.035964,104.244.42.0-255,66,229402,7,332522
48280,0.035969,104.244.42.0-255,66,229468,7,332522
48281,0.03786,172.253.118.0-255,4320,233788,7,332522
48282,0.037867,172.31.36.0-255,66,233854,7,332522
48283,0.040212,172.253.118.0-255,5738,239592,7,332522
48284,0.040218,172.31.36.0-255,66,239658,7,332522
48285,0.042569,172.253.118.0-255,5738,245396,7,332522
48286,0.042576,172.31.36.0-255,66,245462,7,332522
48287,0.044932,172.253.118.0-255,5738,251200,7,332522
48288,0.044939,172.31.36.0-255,66,251266,7,332522
48289,0.047299,172.253.118.0-255,5738,257004,7,332522
48290,0.047307,172.31.36.0-255,66,257070,7,332522
48291,0.049658,172.253.118.0-255,5738,262808,7,332522
48292,0.049666,172.31.36.0-255,66,262874,7,332522
48293,0.052045,172.253.118.0-255,5738,268612,7,332522
48294,0.05205,172.31.36.0-255,66,268678,7,332522
48295,0.054403,172.253.118.0-255,5738,274416,7,332522
48296,0.054408,172.31.36.0-255,66,274482,7,332522
48297,0.056776,172.253.118.0-255,5738,280220,7,332522
48298,0.056781,172.31.36.0-255,66,280286,7,332522
48299,0.059136,172.253.118.0-255,5738,286024,7,332522
48300,0.059143,172.31.36.0-255,66,286090,7,332522
48301,0.061494,172.253.118.0-255,5738,291828,7,332522
48302,0.061501,172.31.36.0-255,66,291894,7,332522
48303,0.063878,172.253.118.0-255,5738,297632,7,332522
48304,0.063886,172.31.36.0-255,66,297698,7,332522
48305,0.06625,172.253.118.0-255,5738,303436,7,332522
48306,0.066255,172.31.36.0-255,66,303502,7,332522
48307,0.068639,172.253.118.0-255,5738,309240,7,332522
48308,0.068646,172.31.36.0-255,66,309306,7,332522
48309,0.071007,172.253.118.0-255,5738,315044,7,332522
48310,0.071013,172.31.36.0-255,66,315110,7,332522
48311,0.073385,172.253.118.0-255,5738,320848,7,332522
48312,0.073394,172.31.36.0-255,66,320914,7,332522
48313,0.07576,172.253.118.0-255,5738,326652,7,332522
48314,0.075768,172.31.36.0-255,66,326718,7,332522
48315,0.078112,172.253.118.0-255,5738,332456,7,332522
48316,0.078119,172.31.36.0-255,66,332522,7,332522
48317,0.0,172.31.36.0-255,66,66,7,66
48318,0.0,74.125.24.0-255,150,150,7,295312
48319,2.2e-05,172.31.36.0-255,66,216,7,295312
48320,3e-05,74.125.24.0-255,1484,1700,7,295312
48321,3.4e-05,172.31.36.0-255,66,1766,7,295312
48322,4e-05,74.125.24.0-255,2902,4668,7,295312
48323,5.1e-05,172.31.36.0-255,66,4734,7,295312
48324,6e-05,74.125.24.0-255,7156,11890,7,295312
48325,6.4e-05,172.31.36.0-255,66,11956,7,295312
48326,6.7e-05,74.125.24.0-255,1484,13440,7,295312
48327,7e-05,172.31.36.0-255,66,13506,7,295312
48328,7.5e-05,74.125.24.0-255,2083,15589,7,295312
48329,7.8e-05,172.31.36.0-255,66,15655,7,295312
48330,8.3e-05,74.125.24.0-255,2902,18557,7,295312
48331,8.6e-05,172.31.36.0-255,66,18623,7,295312
48332,9.3e-05,74.125.24.0-255,5738,24361,7,295312
48333,9.5e-05,172.31.36.0-255,66,24427,7,295312
48334,0.000118,74.125.24.0-255,1484,25911,7,295312
48335,0.000121,172.31.36.0-255,66,25977,7,295312
48336,0.000134,74.125.24.0-255,5379,31356,7,295312
48337,0.000137,172.31.36.0-255,66,31422,7,295312
48338,0.000294,74.125.24.0-255,1484,32906,7,295312
48339,0.000299,172.31.36.0-255,66,32972,7,295312
48340,0.000306,74.125.24.0-255,2902,35874,7,295312
48341,0.000308,172.31.36.0-255,66,35940,7,295312
48342,0.000342,74.125.24.0-255,5738,41678,7,295312
48343,0.000346,172.31.36.0-255,66,41744,7,295312
48344,0.000351,74.125.24.0-255,4320,46064,7,295312
48345,0.000353,172.31.36.0-255,66,46130,7,295312
48346,0.000378,74.125.24.0-255,2543,48673,7,295312
48347,0.000381,172.31.36.0-255,66,48739,7,295312
48348,0.000409,74.125.24.0-255,2902,51641,7,295312
48349,0.000411,172.31.36.0-255,66,51707,7,295312
48350,0.000418,74.125.24.0-255,7156,58863,7,295312
48351,0.000421,172.31.36.0-255,66,58929,7,295312
48352,0.000426,74.125.24.0-255,2902,61831,7,295312
48353,0.000428,172.31.36.0-255,66,61897,7,295312
48354,0.000457,74.125.24.0-255,3961,65858,7,295312
48355,0.00046,172.31.36.0-255,66,65924,7,295312
48356,0.000462,74.125.24.0-255,365,66289,7,295312
48357,0.000645,74.125.24.0-255,379,66668,7,295312
48358,0.000791,74.125.24.0-255,1484,68152,7,295312
48359,0.000796,172.31.36.0-255,66,68218,7,295312
48360,0.000802,74.125.24.0-255,2902,71120,7,295312
48361,0.000804,172.31.36.0-255,66,71186,7,295312
48362,0.000824,74.125.24.0-255,4320,75506,7,295312
48363,0.000826,172.31.36.0-255,66,75572,7,295312
48364,0.000852,74.125.24.0-255,1484,77056,7,295312
48365,0.00086,74.125.24.0-255,6797,83853,7,295312
48366,0.000863,172.31.36.0-255,66,83919,7,295312
48367,0.000903,172.31.36.0-255,66,83985,7,295312
48368,0.000946,74.125.24.0-255,2902,86887,7,295312
48369,0.000949,172.31.36.0-255,66,86953,7,295312
48370,0.000974,74.125.24.0-255,2543,89496,7,295312
48371,0.000977,172.31.36.0-255,66,89562,7,295312
48372,0.003169,74.125.24.0-255,2902,92464,7,295312
48373,0.003176,172.31.36.0-255,66,92530,7,295312
48374,0.003205,74.125.24.0-255,2902,95432,7,295312
48375,0.003208,172.31.36.0-255,66,95498,7,295312
48376,0.005377,74.125.24.0-255,2902,98400,7,295312
48377,0.00538,172.31.36.0-255,66,98466,7,295312
48378,0.005422,74.125.24.0-255,2902,101368,7,295312
48379,0.005424,172.31.36.0-255,66,101434,7,295312
48380,0.007594,74.125.24.0-255,2902,104336,7,295312
48381,0.007601,172.31.36.0-255,66,104402,7,295312
48382,0.00766,74.125.24.0-255,2902,107304,7,295312
48383,0.007664,172.31.36.0-255,66,107370,7,295312
48384,0.009841,74.125.24.0-255,2902,110272,7,295312
48385,0.009849,172.31.36.0-255,66,110338,7,295312
48386,0.009883,74.125.24.0-255,2902,113240,7,295312
48387,0.009886,172.31.36.0-255,66,113306,7,295312
48388,0.012072,74.125.24.0-255,2902,116208,7,295312
48389,0.012079,172.31.36.0-255,66,116274,7,295312
48390,0.012107,74.125.24.0-255,2902,119176,7,295312
48391,0.01211,172.31.36.0-255,66,119242,7,295312
48392,0.014309,74.125.24.0-255,2902,122144,7,295312
48393,0.014318,172.31.36.0-255,66,122210,7,295312
48394,0.014345,74.125.24.0-255,2902,125112,7,295312
48395,0.014348,172.31.36.0-255,66,125178,7,295312
48396,0.016564,74.125.24.0-255,2902,128080,7,295312
48397,0.016572,172.31.36.0-255,66,128146,7,295312
48398,0.016579,74.125.24.0-255,2902,131048,7,295312
48399,0.016582,172.31.36.0-255,66,131114,7,295312
48400,0.018821,74.125.24.0-255,5738,136852,7,295312
48401,0.018833,172.31.36.0-255,66,136918,7,295312
48402,0.021069,74.125.24.0-255,5738,142656,7,295312
48403,0.021077,172.31.36.0-255,66,142722,7,295312
48404,0.023304,74.125.24.0-255,5738,148460,7,295312
48405,0.023311,172.31.36.0-255,66,148526,7,295312
48406,0.025569,74.125.24.0-255,4320,152846,7,295312
48407,0.025576,172.31.36.0-255,66,152912,7,295312
48408,0.025594,74.125.24.0-255,1484,154396,7,295312
48409,0.025774,172.31.36.0-255,164,154560,7,295312
48410,0.025804,172.31.36.0-255,1121,155681,7,295312
48411,0.025917,172.31.36.0-255,1514,157195,7,295312
48412,0.025919,172.31.36.0-255,1285,158480,7,295312
48413,0.027343,104.244.42.0-255,66,158546,7,295312
48414,0.027352,104.244.42.0-255,66,158612,7,295312
48415,0.027484,104.244.42.0-255,66,158678,7,295312
48416,0.02779,74.125.24.0-255,2902,161580,7,295312
48417,0.027797,172.31.36.0-255,66,161646,7,295312
48418,0.02828,104.244.42.0-255,108,161754,7,295312
48419,0.028287,172.31.36.0-255,66,161820,7,295312
48420,0.030017,74.125.24.0-255,5738,167558,7,295312
48421,0.030021,172.31.36.0-255,66,167624,7,295312
48422,0.032266,74.125.24.0-255,5738,173362,7,295312
48423,0.032272,172.31.36.0-255,66,173428,7,295312
48424,0.034542,74.125.24.0-255,5738,179166,7,295312
48425,0.034549,172.31.36.0-255,66,179232,7,295312
48426,0.03679,74.125.24.0-255,5738,184970,7,295312
48427,0.036796,172.31.36.0-255,66,185036,7,295312
48428,0.039032,74.125.24.0-255,5738,190774,7,295312
48429,0.039038,172.31.36.0-255,66,190840,7,295312
48430,0.041279,74.125.24.0-255,5738,196578,7,295312
48431,0.041284,172.31.36.0-255,66,196644,7,295312
48432,0.043514,74.125.24.0-255,5738,202382,7,295312
48433,0.04352,172.31.36.0-255,66,202448,7,295312
48434,0.045758,74.125.24.0-255,5738,208186,7,295312
48435,0.045765,172.31.36.0-255,66,208252,7,295312
48436,0.048014,74.125.24.0-255,5738,213990,7,295312
48437,0.048021,172.31.36.0-255,66,214056,7,295312
48438,0.050266,74.125.24.0-255,5738,219794,7,295312
48439,0.050277,172.31.36.0-255,66,219860,7,295312
48440,0.052513,74.125.24.0-255,5738,225598,7,295312
48441,0.05252,172.31.36.0-255,66,225664,7,295312
48442,0.054735,74.125.24.0-255,5738,231402,7,295312
48443,0.054741,172.31.36.0-255,66,231468,7,295312
48444,0.056969,74.125.24.0-255,5738,237206,7,295312
48445,0.056975,172.31.36.0-255,66,237272,7,295312
48446,0.059207,74.125.24.0-255,5738,243010,7,295312
48447,0.059214,172.31.36.0-255,66,243076,7,295312
48448,0.061433,74.125.24.0-255,5738,248814,7,295312
48449,0.061439,172.31.36.0-255,66,248880,7,295312
48450,0.063691,74.125.24.0-255,5738,254618,7,295312
48451,0.063701,172.31.36.0-255,66,254684,7,295312
48452,0.065933,74.125.24.0-255,5738,260422,7,295312
48453,0.06594,172.31.36.0-255,66,260488,7,295312
48454,0.068179,74.125.24.0-255,5738,266226,7,295312
48455,0.068185,172.31.36.0-255,66,266292,7,295312
48456,0.070426,74.125.24.0-255,5738,272030,7,295312
48457,0.070433,172.31.36.0-255,66,272096,7,295312
48458,0.07269,74.125.24.0-255,5738,277834,7,295312
48459,0.072697,172.31.36.0-255,66,277900,7,295312
48460,0.074933,74.125.24.0-255,5738,283638,7,295312
48461,0.07494,172.31.36.0-255,66,283704,7,295312
48462,0.077166,74.125.24.0-255,5738,289442,7,295312
48463,0.077173,172.31.36.0-255,66,289508,7,295312
48464,0.079405,74.125.24.0-255,5738,295246,7,295312
48465,0.079412,172.31.36.0-255,66,295312,7,295312
48466,0.0,172.217.160.0-255,153,153,7,310186
48467,1.6e-05,172.31.36.0-255,66,219,7,310186
48468,2.3e-05,172.217.160.0-255,1484,1703,7,310186
48469,2.8e-05,172.31.36.0-255,66,1769,7,310186
48470,4.1e-05,172.217.160.0-255,2902,4671,7,310186
48471,4.5e-05,172.31.36.0-255,66,4737,7,310186
48472,5.3e-05,172.217.160.0-255,7156,11893,7,310186
48473,5.6e-05,172.31.36.0-255,66,11959,7,310186
48474,6.1e-05,172.217.160.0-255,2036,13995,7,310186
48475,6.3e-05,172.31.36.0-255,66,14061,7,310186
48476,0.000102,172.217.160.0-255,1484,15545,7,310186
48477,0.000104,172.31.36.0-255,66,15611,7,310186
48478,0.000109,172.217.160.0-255,2902,18513,7,310186
48479,0.000111,172.31.36.0-255,66,18579,7,310186
48480,0.000144,172.217.160.0-255,5738,24317,7,310186
48481,0.000146,172.31.36.0-255,66,24383,7,310186
48482,0.000151,172.217.160.0-255,2902,27285,7,310186
48483,0.000154,172.31.36.0-255,66,27351,7,310186
48484,0.000176,172.217.160.0-255,3961,31312,7,310186
48485,0.000179,172.31.36.0-255,66,31378,7,310186
48486,0.000215,172.217.160.0-255,1484,32862,7,310186
48487,0.000217,172.31.36.0-255,66,32928,7,310186
48488,0.000221,172.217.160.0-255,1484,34412,7,310186
48489,0.000223,172.31.36.0-255,66,34478,7,310186
48490,0.000243,172.217.160.0-255,1484,35962,7,310186
48491,0.000245,172.31.36.0-255,66,36028,7,310186
48492,0.000258,172.217.160.0-255,5738,41766,7,310186
48493,0.000261,172.31.36.0-255,66,41832,7,310186
48494,0.000265,172.217.160.0-255,2902,44734,7,310186
48495,0.000267,172.31.36.0-255,66,44800,7,310186
48496,0.000303,172.217.160.0-255,3961,48761,7,310186
48497,0.00031,172.31.36.0-255,66,48827,7,310186
48498,0.001278,172.217.160.0-255,1484,50311,7,310186
48499,0.001289,172.217.160.0-255,2902,53213,7,310186
48500,0.001293,172.31.36.0-255,66,53279,7,310186
48501,0.001302,172.217.160.0-255,5738,59017,7,310186
48502,0.001329,172.217.160.0-255,6797,65814,7,310186
48503,0.001835,172.217.160.0-255,1484,67298,7,310186
48504,0.001841,172.217.160.0-255,1484,68782,7,310186
48505,0.001857,172.217.160.0-255,1484,70266,7,310186
48506,0.001864,172.217.160.0-255,5738,76004,7,310186
48507,0.001882,172.217.160.0-255,6797,82801,7,310186
48508,0.001925,172.217.160.0-255,4320,87121,7,310186
48509,0.001954,172.217.160.0-255,3961,91082,7,310186
48510,0.002774,172.31.36.0-255,66,91148,7,310186
48511,0.004724,172.217.160.0-255,5738,96886,7,310186
48512,0.004729,172.31.36.0-255,66,96952,7,310186
48513,0.006683,172.217.160.0-255,5738,102690,7,310186
48514,0.00669,172.31.36.0-255,66,102756,7,310186
48515,0.008645,172.217.160.0-255,5738,108494,7,310186
48516,0.008657,172.31.36.0-255,66,108560,7,310186
48517,0.010639,172.217.160.0-255,5738,114298,7,310186
48518,0.014754,172.31.36.0-255,66,114364,7,310186
48519,0.01671,172.217.160.0-255,5738,120102,7,310186
48520,0.016724,172.31.36.0-255,66,120168,7,310186
48521,0.018676,172.217.160.0-255,5738,125906,7,310186
48522,0.018685,172.31.36.0-255,66,125972,7,310186
48523,0.02063,172.217.160.0-255,5738,131710,7,310186
48524,0.020638,172.31.36.0-255,66,131776,7,310186
48525,0.022659,172.217.160.0-255,5738,137514,7,310186
48526,0.022665,172.31.36.0-255,66,137580,7,310186
48527,0.022849,172.31.36.0-255,172,137752,7,310186
48528,0.022881,172.31.36.0-255,1115,138867,7,310186
48529,0.02294,172.31.36.0-255,1514,140381,7,310186
48530,0.022942,172.31.36.0-255,1291,141672,7,310186
48531,0.024421,104.244.42.0-255,66,141738,7,310186
48532,0.024451,104.244.42.0-255,66,141804,7,310186
48533,0.024527,104.244.42.0-255,66,141870,7,310186
48534,0.0246,172.217.160.0-255,5738,147608,7,310186
48535,0.024606,172.31.36.0-255,66,147674,7,310186
48536,0.026573,172.217.160.0-255,5738,153412,7,310186
48537,0.02658,172.31.36.0-255,66,153478,7,310186
48538,0.02853,172.217.160.0-255,5738,159216,7,310186
48539,0.028537,172.31.36.0-255,66,159282,7,310186
48540,0.030488,172.217.160.0-255,5738,165020,7,310186
48541,0.030494,172.31.36.0-255,66,165086,7,310186
48542,0.032453,172.217.160.0-255,5738,170824,7,310186
48543,0.032459,172.31.36.0-255,66,170890,7,310186
48544,0.03441,172.217.160.0-255,5738,176628,7,310186
48545,0.034417,172.31.36.0-255,66,176694,7,310186
48546,0.036362,172.217.160.0-255,5738,182432,7,310186
48547,0.036368,172.31.36.0-255,66,182498,7,310186
48548,0.038321,172.217.160.0-255,5738,188236,7,310186
48549,0.038327,172.31.36.0-255,66,188302,7,310186
48550,0.040272,172.217.160.0-255,5738,194040,7,310186
48551,0.040278,172.31.36.0-255,66,194106,7,310186
48552,0.04223,172.217.160.0-255,5738,199844,7,310186
48553,0.042237,172.31.36.0-255,66,199910,7,310186
48554,0.044202,172.217.160.0-255,5738,205648,7,310186
48555,0.04421,172.31.36.0-255,66,205714,7,310186
48556,0.046162,172.217.160.0-255,5738,211452,7,310186
48557,0.046171,172.31.36.0-255,66,211518,7,310186
48558,0.04811,172.217.160.0-255,5738,217256,7,310186
48559,0.048122,172.31.36.0-255,66,217322,7,310186
48560,0.050077,172.217.160.0-255,5738,223060,7,310186
48561,0.050083,172.31.36.0-255,66,223126,7,310186
48562,0.052033,172.217.160.0-255,5738,228864,7,310186
48563,0.052039,172.31.36.0-255,66,228930,7,310186
48564,0.054004,172.217.160.0-255,5738,234668,7,310186
48565,0.05401,172.31.36.0-255,66,234734,7,310186
48566,0.055955,172.217.160.0-255,5738,240472,7,310186
48567,0.055962,172.31.36.0-255,66,240538,7,310186
48568,0.057912,172.217.160.0-255,5738,246276,7,310186
48569,0.057918,172.31.36.0-255,66,246342,7,310186
48570,0.059869,172.217.160.0-255,5738,252080,7,310186
48571,0.059875,172.31.36.0-255,66,252146,7,310186
48572,0.061833,172.217.160.0-255,5738,257884,7,310186
48573,0.061839,172.31.36.0-255,66,257950,7,310186
48574,0.063788,172.217.160.0-255,5738,263688,7,310186
48575,0.063795,172.31.36.0-255,66,263754,7,310186
48576,0.065743,172.217.160.0-255,5738,269492,7,310186
48577,0.065749,172.31.36.0-255,66,269558,7,310186
48578,0.067696,172.217.160.0-255,5738,275296,7,310186
48579,0.067702,172.31.36.0-255,66,275362,7,310186
48580,0.069654,172.217.160.0-255,5738,281100,7,310186
48581,0.069661,172.31.36.0-255,66,281166,7,310186
48582,0.07162,172.217.160.0-255,5738,286904,7,310186
48583,0.071626,172.31.36.0-255,66,286970,7,310186
48584,0.073573,172.217.160.0-255,5738,292708,7,310186
48585,0.07358,172.31.36.0-255,66,292774,7,310186
48586,0.075526,172.217.160.0-255,5738,298512,7,310186
48587,0.075533,172.31.36.0-255,66,298578,7,310186
48588,0.077487,172.217.160.0-255,5738,304316,7,310186
48589,0.077493,172.31.36.0-255,66,304382,7,310186
48590,0.079472,172.217.160.0-255,5738,310120,7,310186
48591,0.079478,172.31.36.0-255,66,310186,7,310186
48592,0.0,172.31.36.0-255,105,105,7,276
48593,0.002232,157.240.13.0-255,105,210,7,276
48594,0.002252,172.31.36.0-255,66,276,7,276
48595,0.0,74.125.24.0-255,153,153,7,238524
48596,2.6e-05,172.31.36.0-255,66,219,7,238524
48597,3.2e-05,74.125.24.0-255,1484,1703,7,238524
48598,3.6e-05,172.31.36.0-255,66,1769,7,238524
48599,4.1e-05,74.125.24.0-255,2902,4671,7,238524
48600,4.4e-05,172.31.36.0-255,66,4737,7,238524
48601,5.1e-05,74.125.24.0-255,7156,11893,7,238524
48602,5.4e-05,172.31.36.0-255,66,11959,7,238524
48603,5.7e-05,74.125.24.0-255,1484,13443,7,238524
48604,5.9e-05,172.31.36.0-255,66,13509,7,238524
48605,8.3e-05,74.125.24.0-255,648,14157,7,238524
48606,8.5e-05,172.31.36.0-255,66,14223,7,238524
48607,0.000123,74.125.24.0-255,1484,15707,7,238524
48608,0.000125,172.31.36.0-255,66,15773,7,238524
48609,0.00013,74.125.24.0-255,2902,18675,7,238524
48610,0.000133,172.31.36.0-255,66,18741,7,238524
48611,0.000136,74.125.24.0-255,1484,20225,7,238524
48612,0.000138,172.31.36.0-255,66,20291,7,238524
48613,0.000166,74.125.24.0-255,4320,24611,7,238524
48614,0.00017,172.31.36.0-255,66,24677,7,238524
48615,0.000177,74.125.24.0-255,6797,31474,7,238524
48616,0.00018,172.31.36.0-255,66,31540,7,238524
48617,0.000355,74.125.24.0-255,1484,33024,7,238524
48618,0.000361,172.31.36.0-255,66,33090,7,238524
48619,0.000366,74.125.24.0-255,2902,35992,7,238524
48620,0.000369,172.31.36.0-255,66,36058,7,238524
48621,0.000375,74.125.24.0-255,4320,40378,7,238524
48622,0.000377,172.31.36.0-255,66,40444,7,238524
48623,0.000395,74.125.24.0-255,1484,41928,7,238524
48624,0.000398,172.31.36.0-255,66,41994,7,238524
48625,0.000439,172.31.36.0-255,66,42060,7,238524
48626,0.000452,172.31.36.0-255,66,42126,7,238524
48627,0.000539,74.125.24.0-255,412,42538,7,238524
48628,0.000597,74.125.24.0-255,330,42868,7,238524
48629,0.000828,172.31.36.0-255,66,42934,7,238524
48630,0.000953,74.125.24.0-255,1484,44418,7,238524
48631,0.000962,74.125.24.0-255,2902,47320,7,238524
48632,0.000965,172.31.36.0-255,66,47386,7,238524
48633,0.000971,74.125.24.0-255,4320,51706,7,238524
48634,0.000973,172.31.36.0-255,66,51772,7,238524
48635,0.000988,74.125.24.0-255,1484,53256,7,238524
48636,0.000995,74.125.24.0-255,5738,58994,7,238524
48637,0.000998,172.31.36.0-255,66,59060,7,238524
48638,0.001004,74.125.24.0-255,4320,63380,7,238524
48639,0.001006,172.31.36.0-255,66,63446,7,238524
48640,0.001034,172.31.36.0-255,66,63512,7,238524
48641,0.001041,74.125.24.0-255,5020,68532,7,238524
48642,0.001043,172.31.36.0-255,66,68598,7,238524
48643,0.001232,74.125.24.0-255,1484,70082,7,238524
48644,0.001239,74.125.24.0-255,2902,72984,7,238524
48645,0.001242,172.31.36.0-255,66,73050,7,238524
48646,0.001249,74.125.24.0-255,5738,78788,7,238524
48647,0.001251,172.31.36.0-255,66,78854,7,238524
48648,0.00129,172.31.36.0-255,66,78920,7,238524
48649,0.001339,74.125.24.0-255,4320,83240,7,238524
48650,0.001343,172.31.36.0-255,66,83306,7,238524
48651,0.001367,74.125.24.0-255,6438,89744,7,238524
48652,0.001369,172.31.36.0-255,66,89810,7,238524
48653,0.001581,74.125.24.0-255,1484,91294,7,238524
48654,0.001589,74.125.24.0-255,2902,94196,7,238524
48655,0.001596,172.31.36.0-255,66,94262,7,238524
48656,0.0016,74.125.24.0-255,1484,95746,7,238524
48657,0.001621,74.125.24.0-255,4320,100066,7,238524
48658,0.001623,172.31.36.0-255,66,100132,7,238524
48659,0.001629,74.125.24.0-255,2902,103034,7,238524
48660,0.001631,172.31.36.0-255,66,103100,7,238524
48661,0.001655,172.31.36.0-255,66,103166,7,238524
48662,0.001662,74.125.24.0-255,7156,110322,7,238524
48663,0.001664,172.31.36.0-255,66,110388,7,238524
48664,0.001712,74.125.24.0-255,3602,113990,7,238524
48665,0.001714,172.31.36.0-255,66,114056,7,238524
48666,0.001744,74.125.24.0-255,4320,118376,7,238524
48667,0.001746,172.31.36.0-255,66,118442,7,238524
48668,0.00175,74.125.24.0-255,2902,121344,7,238524
48669,0.001752,172.31.36.0-255,66,121410,7,238524
48670,0.001779,74.125.24.0-255,7156,128566,7,238524
48671,0.001782,172.31.36.0-255,66,128632,7,238524
48672,0.001797,74.125.24.0-255,1484,130116,7,238524
48673,0.001812,74.125.24.0-255,5738,135854,7,238524
48674,0.001814,172.31.36.0-255,66,135920,7,238524
48675,0.001841,172.31.36.0-255,66,135986,7,238524
48676,0.002946,74.125.24.0-255,1484,137470,7,238524
48677,0.002962,74.125.24.0-255,2902,140372,7,238524
48678,0.002965,172.31.36.0-255,66,140438,7,238524
48679,0.002969,74.125.24.0-255,2902,143340,7,238524
48680,0.002971,172.31.36.0-255,66,143406,7,238524
48681,0.002985,74.125.24.0-255,1484,144890,7,238524
48682,0.003003,74.125.24.0-255,5738,150628,7,238524
48683,0.003005,172.31.36.0-255,66,150694,7,238524
48684,0.003039,172.31.36.0-255,66,150760,7,238524
48685,0.003053,74.125.24.0-255,7156,157916,7,238524
48686,0.003055,172.31.36.0-255,66,157982,7,238524
48687,0.003067,74.125.24.0-255,3602,161584,7,238524
48688,0.00307,172.31.36.0-255,66,161650,7,238524
48689,0.003121,74.125.24.0-255,1484,163134,7,238524
48690,0.00314,74.125.24.0-255,2902,166036,7,238524
48691,0.003142,172.31.36.0-255,66,166102,7,238524
48692,0.003162,74.125.24.0-255,4320,170422,7,238524
48693,0.003164,172.31.36.0-255,66,170488,7,238524
48694,0.003207,172.31.36.0-255,66,170554,7,238524
48695,0.003213,74.125.24.0-255,5738,176292,7,238524
48696,0.003215,172.31.36.0-255,66,176358,7,238524
48697,0.003248,172.31.36.0-255,66,176424,7,238524
48698,0.003262,74.125.24.0-255,766,177190,7,238524
48699,0.003323,74.125.24.0-255,1484,178674,7,238524
48700,0.003327,172.31.36.0-255,66,178740,7,238524
48701,0.003332,74.125.24.0-255,2902,181642,7,238524
48702,0.003334,172.31.36.0-255,66,181708,7,238524
48703,0.00334,74.125.24.0-255,5738,187446,7,238524
48704,0.003343,172.31.36.0-255,66,187512,7,238524
48705,0.003348,74.125.24.0-255,2902,190414,7,238524
48706,0.00335,172.31.36.0-255,66,190480,7,238524
48707,0.003354,74.125.24.0-255,1484,191964,7,238524
48708,0.003404,74.125.24.0-255,4320,196284,7,238524
48709,0.003408,172.31.36.0-255,66,196350,7,238524
48710,0.003442,172.31.36.0-255,66,196416,7,238524
48711,0.003475,74.125.24.0-255,1484,197900,7,238524
48712,0.00348,74.125.24.0-255,2902,200802,7,238524
48713,0.003483,172.31.36.0-255,66,200868,7,238524
48714,0.003488,74.125.24.0-255,4320,205188,7,238524
48715,0.003491,172.31.36.0-255,66,205254,7,238524
48716,0.003501,74.125.24.0-255,1484,206738,7,238524
48717,0.003535,172.31.36.0-255,66,206804,7,238524
48718,0.003553,74.125.24.0-255,2902,209706,7,238524
48719,0.003555,172.31.36.0-255,66,209772,7,238524
48720,0.003568,172.31.36.0-255,66,209838,7,238524
48721,0.003571,74.125.24.0-255,1484,211322,7,238524
48722,0.003575,74.125.24.0-255,2902,214224,7,238524
48723,0.003577,172.31.36.0-255,66,214290,7,238524
48724,0.003623,172.31.36.0-255,66,214356,7,238524
48725,0.003635,172.31.36.0-255,66,214422,7,238524
48726,0.003642,74.125.24.0-255,6438,220860,7,238524
48727,0.003645,172.31.36.0-255,66,220926,7,238524
48728,0.003649,74.125.24.0-255,2902,223828,7,238524
48729,0.003652,172.31.36.0-255,78,223906,7,238524
48730,0.003694,74.125.24.0-255,2902,226808,7,238524
48731,0.003697,172.31.36.0-255,78,226886,7,238524
48732,0.00374,172.31.36.0-255,66,226952,7,238524
48733,0.003743,74.125.24.0-255,1484,228436,7,238524
48734,0.003746,74.125.24.0-255,1484,229920,7,238524
48735,0.003748,172.31.36.0-255,66,229986,7,238524
48736,0.003761,172.31.36.0-255,66,230052,7,238524
48737,0.003773,172.31.36.0-255,66,230118,7,238524
48738,0.003778,74.125.24.0-255,3708,233826,7,238524
48739,0.003781,172.31.36.0-255,66,233892,7,238524
48740,0.003785,74.125.24.0-255,105,233997,7,238524
48741,0.006725,172.31.36.0-255,66,234063,7,238524
48742,0.006753,172.31.36.0-255,105,234168,7,238524
48743,0.009023,74.125.24.0-255,66,234234,7,238524
48744,0.031552,172.31.36.0-255,172,234406,7,238524
48745,0.031583,172.31.36.0-255,1114,235520,7,238524
48746,0.031623,172.31.36.0-255,1514,237034,7,238524
48747,0.031625,172.31.36.0-255,1292,238326,7,238524
48748,0.033109,104.244.42.0-255,66,238392,7,238524
48749,0.033283,104.244.42.0-255,66,238458,7,238524
48750,0.033285,104.244.42.0-255,66,238524,7,238524
48751,0.0,172.217.194.0-255,153,153,7,197982
48752,2.1e-05,172.31.36.0-255,66,219,7,197982
48753,2.8e-05,172.217.194.0-255,1484,1703,7,197982
48754,3.3e-05,172.31.36.0-255,66,1769,7,197982
48755,3.9e-05,172.217.194.0-255,2902,4671,7,197982
48756,4.3e-05,172.31.36.0-255,66,4737,7,197982
48757,5.1e-05,172.217.194.0-255,7156,11893,7,197982
48758,5.4e-05,172.31.36.0-255,66,11959,7,197982
48759,5.8e-05,172.217.194.0-255,2038,13997,7,197982
48760,6.1e-05,172.31.36.0-255,66,14063,7,197982
48761,8.5e-05,172.217.194.0-255,4320,18383,7,197982
48762,8.7e-05,172.31.36.0-255,66,18449,7,197982
48763,0.000124,172.217.194.0-255,7156,25605,7,197982
48764,0.000126,172.31.36.0-255,66,25671,7,197982
48765,0.000141,172.31.36.0-255,66,25737,7,197982
48766,0.000153,172.31.36.0-255,66,25803,7,197982
48767,0.000204,172.217.194.0-255,1484,27287,7,197982
48768,0.000206,172.31.36.0-255,66,27353,7,197982
48769,0.000211,172.217.194.0-255,2902,30255,7,197982
48770,0.000213,172.31.36.0-255,66,30321,7,197982
48771,0.00022,172.217.194.0-255,5738,36059,7,197982
48772,0.000222,172.31.36.0-255,66,36125,7,197982
48773,0.000253,172.217.194.0-255,7049,43174,7,197982
48774,0.000256,172.31.36.0-255,66,43240,7,197982
48775,0.000531,172.217.194.0-255,121,43361,7,197982
48776,0.000536,172.31.36.0-255,66,43427,7,197982
48777,0.000568,172.217.194.0-255,1484,44911,7,197982
48778,0.000571,172.31.36.0-255,66,44977,7,197982
48779,0.000577,172.217.194.0-255,2902,47879,7,197982
48780,0.000579,172.31.36.0-255,66,47945,7,197982
48781,0.000586,172.217.194.0-255,5738,53683,7,197982
48782,0.000589,172.31.36.0-255,66,53749,7,197982
48783,0.000613,172.217.194.0-255,1484,55233,7,197982
48784,0.000621,172.217.194.0-255,5379,60612,7,197982
48785,0.000624,172.31.36.0-255,66,60678,7,197982
48786,0.000659,172.31.36.0-255,66,60744,7,197982
48787,0.000675,172.217.194.0-255,1484,62228,7,197982
48788,0.00068,172.217.194.0-255,2543,64771,7,197982
48789,0.000683,172.31.36.0-255,66,64837,7,197982
48790,0.001282,172.217.194.0-255,1484,66321,7,197982
48791,0.001305,172.217.194.0-255,2902,69223,7,197982
48792,0.001308,172.31.36.0-255,66,69289,7,197982
48793,0.001315,172.217.194.0-255,5738,75027,7,197982
48794,0.001318,172.31.36.0-255,66,75093,7,197982
48795,0.001321,172.217.194.0-255,1484,76577,7,197982
48796,0.001328,172.217.194.0-255,7156,83733,7,197982
48797,0.00133,172.31.36.0-255,66,83799,7,197982
48798,0.001352,172.217.194.0-255,5738,89537,7,197982
48799,0.001354,172.31.36.0-255,66,89603,7,197982
48800,0.001367,172.31.36.0-255,66,89669,7,197982
48801,0.001517,172.217.194.0-255,1484,91153,7,197982
48802,0.001531,172.217.194.0-255,2902,94055,7,197982
48803,0.001534,172.31.36.0-255,66,94121,7,197982
48804,0.001542,172.217.194.0-255,5738,99859,7,197982
48805,0.001544,172.31.36.0-255,66,99925,7,197982
48806,0.001569,172.217.194.0-255,4320,104245,7,197982
48807,0.001572,172.31.36.0-255,66,104311,7,197982
48808,0.001596,172.217.194.0-255,4320,108631,7,197982
48809,0.001599,172.31.36.0-255,66,108697,7,197982
48810,0.001611,172.31.36.0-255,66,108763,7,197982
48811,0.001616,172.217.194.0-255,2902,111665,7,197982
48812,0.001617,172.31.36.0-255,66,111731,7,197982
48813,0.001639,172.217.194.0-255,2184,113915,7,197982
48814,0.001642,172.31.36.0-255,66,113981,7,197982
48815,0.001669,172.217.194.0-255,1484,115465,7,197982
48816,0.001689,172.217.194.0-255,2902,118367,7,197982
48817,0.001692,172.31.36.0-255,66,118433,7,197982
48818,0.001699,172.217.194.0-255,5738,124171,7,197982
48819,0.001701,172.31.36.0-255,66,124237,7,197982
48820,0.001705,172.217.194.0-255,1484,125721,7,197982
48821,0.001743,172.217.194.0-255,7156,132877,7,197982
48822,0.001746,172.31.36.0-255,66,132943,7,197982
48823,0.001769,172.217.194.0-255,5738,138681,7,197982
48824,0.001771,172.31.36.0-255,66,138747,7,197982
48825,0.001797,172.31.36.0-255,66,138813,7,197982
48826,0.001905,172.217.194.0-255,1484,140297,7,197982
48827,0.001933,172.217.194.0-255,2902,143199,7,197982
48828,0.001938,172.31.36.0-255,66,143265,7,197982
48829,0.001945,172.217.194.0-255,5738,149003,7,197982
48830,0.001947,172.31.36.0-255,66,149069,7,197982
48831,0.001954,172.217.194.0-255,7156,156225,7,197982
48832,0.001956,172.31.36.0-255,66,156291,7,197982
48833,0.001996,172.217.194.0-255,5738,162029,7,197982
48834,0.002,172.31.36.0-255,66,162095,7,197982
48835,0.002013,172.31.36.0-255,66,162161,7,197982
48836,0.002065,172.217.194.0-255,1484,163645,7,197982
48837,0.002069,172.217.194.0-255,2902,166547,7,197982
48838,0.002072,172.31.36.0-255,66,166613,7,197982
48839,0.002078,172.217.194.0-255,5738,172351,7,197982
48840,0.00208,172.31.36.0-255,66,172417,7,197982
48841,0.002086,172.217.194.0-255,5738,178155,7,197982
48842,0.002089,172.31.36.0-255,66,178221,7,197982
48843,0.002107,172.31.36.0-255,66,178287,7,197982
48844,0.002139,172.31.36.0-255,66,178353,7,197982
48845,0.00218,172.31.36.0-255,66,178419,7,197982
48846,0.002203,172.31.36.0-255,66,178485,7,197982
48847,0.002215,172.31.36.0-255,66,178551,7,197982
48848,0.002259,172.31.36.0-255,66,178617,7,197982
48849,0.002284,172.217.194.0-255,3602,182219,7,197982
48850,0.002287,172.31.36.0-255,66,182285,7,197982
48851,0.002309,172.31.36.0-255,66,182351,7,197982
48852,0.002322,172.31.36.0-255,66,182417,7,197982
48853,0.002357,172.217.194.0-255,5738,188155,7,197982
48854,0.00236,172.31.36.0-255,66,188221,7,197982
48855,0.002384,172.31.36.0-255,66,188287,7,197982
48856,0.002409,172.31.36.0-255,66,188353,7,197982
48857,0.002412,172.217.194.0-255,97,188450,7,197982
48858,0.002415,172.217.194.0-255,105,188555,7,197982
48859,0.009117,172.31.36.0-255,66,188621,7,197982
48860,0.009163,172.31.36.0-255,105,188726,7,197982
48861,0.011647,172.217.194.0-255,66,188792,7,197982
48862,0.036963,172.31.36.0-255,172,188964,7,197982
48863,0.036999,172.31.36.0-255,1113,190077,7,197982
48864,0.037069,172.31.36.0-255,1514,191591,7,197982
48865,0.037071,172.31.36.0-255,1514,193105,7,197982
48866,0.037076,172.31.36.0-255,1514,194619,7,197982
48867,0.037077,172.31.36.0-255,1514,196133,7,197982
48868,0.037097,172.31.36.0-255,1514,197647,7,197982
48869,0.037098,172.31.36.0-255,71,197718,7,197982
48870,0.038514,104.244.42.0-255,66,197784,7,197982
48871,0.038526,104.244.42.0-255,66,197850,7,197982
48872,0.038615,104.244.42.0-255,66,197916,7,197982
48873,0.038654,104.244.42.0-255,66,197982,7,197982
48874,0.0,74.125.24.0-255,147,147,7,285195
48875,1.8e-05,172.31.36.0-255,66,213,7,285195
48876,2.6e-05,74.125.24.0-255,1484,1697,7,285195
48877,3e-05,172.31.36.0-255,66,1763,7,285195
48878,3.6e-05,74.125.24.0-255,2902,4665,7,285195
48879,3.9e-05,172.31.36.0-255,66,4731,7,285195
48880,4.7e-05,74.125.24.0-255,7156,11887,7,285195
48881,5e-05,172.31.36.0-255,66,11953,7,285195
48882,7.4e-05,74.125.24.0-255,2036,13989,7,285195
48883,7.8e-05,172.31.36.0-255,66,14055,7,285195
48884,0.000318,74.125.24.0-255,1484,15539,7,285195
48885,0.000323,172.31.36.0-255,66,15605,7,285195
48886,0.000329,74.125.24.0-255,2902,18507,7,285195
48887,0.000332,172.31.36.0-255,66,18573,7,285195
48888,0.000338,74.125.24.0-255,5738,24311,7,285195
48889,0.000341,172.31.36.0-255,66,24377,7,285195
48890,0.000387,74.125.24.0-255,4320,28697,7,285195
48891,0.000391,172.31.36.0-255,66,28763,7,285195
48892,0.000409,74.125.24.0-255,2543,31306,7,285195
48893,0.000412,172.31.36.0-255,66,31372,7,285195
48894,0.00048,74.125.24.0-255,1484,32856,7,285195
48895,0.000484,172.31.36.0-255,66,32922,7,285195
48896,0.000488,74.125.24.0-255,1484,34406,7,285195
48897,0.00049,172.31.36.0-255,66,34472,7,285195
48898,0.000503,74.125.24.0-255,1484,35956,7,285195
48899,0.000509,74.125.24.0-255,5738,41694,7,285195
48900,0.000513,172.31.36.0-255,66,41760,7,285195
48901,0.000517,172.31.36.0-255,66,41826,7,285195
48902,0.000539,74.125.24.0-255,6797,48623,7,285195
48903,0.000542,172.31.36.0-255,66,48689,7,285195
48904,0.000549,74.125.24.0-255,5738,54427,7,285195
48905,0.000552,172.31.36.0-255,66,54493,7,285195
48906,0.000594,74.125.24.0-255,1484,55977,7,285195
48907,0.000609,172.31.36.0-255,66,56043,7,285195
48908,0.000628,74.125.24.0-255,111,56154,7,285195
48909,0.001142,74.125.24.0-255,330,56484,7,285195
48910,0.001473,172.31.36.0-255,66,56550,7,285195
48911,0.001572,74.125.24.0-255,1484,58034,7,285195
48912,0.00158,74.125.24.0-255,2902,60936,7,285195
48913,0.001584,172.31.36.0-255,66,61002,7,285195
48914,0.001593,74.125.24.0-255,5738,66740,7,285195
48915,0.001595,172.31.36.0-255,66,66806,7,285195
48916,0.00163,172.31.36.0-255,66,66872,7,285195
48917,0.001647,74.125.24.0-255,2902,69774,7,285195
48918,0.001649,172.31.36.0-255,66,69840,7,285195
48919,0.001686,74.125.24.0-255,5738,75578,7,285195
48920,0.001689,172.31.36.0-255,66,75644,7,285195
48921,0.001709,74.125.24.0-255,5020,80664,7,285195
48922,0.001712,172.31.36.0-255,66,80730,7,285195
48923,0.002185,74.125.24.0-255,1484,82214,7,285195
48924,0.002194,74.125.24.0-255,2902,85116,7,285195
48925,0.002198,172.31.36.0-255,66,85182,7,285195
48926,0.002206,74.125.24.0-255,5738,90920,7,285195
48927,0.002208,172.31.36.0-255,66,90986,7,285195
48928,0.002223,74.125.24.0-255,2902,93888,7,285195
48929,0.002225,172.31.36.0-255,66,93954,7,285195
48930,0.00225,172.31.36.0-255,66,94020,7,285195
48931,0.002262,172.31.36.0-255,66,94086,7,285195
48932,0.002265,74.125.24.0-255,766,94852,7,285195
48933,0.004556,74.125.24.0-255,4320,99172,7,285195
48934,0.004582,172.31.36.0-255,66,99238,7,285195
48935,0.006863,74.125.24.0-255,5738,104976,7,285195
48936,0.00687,172.31.36.0-255,66,105042,7,285195
48937,0.009181,74.125.24.0-255,5738,110780,7,285195
48938,0.009193,172.31.36.0-255,66,110846,7,285195
48939,0.011484,74.125.24.0-255,5738,116584,7,285195
48940,0.011493,172.31.36.0-255,66,116650,7,285195
48941,0.013783,74.125.24.0-255,4320,120970,7,285195
48942,0.013791,172.31.36.0-255,66,121036,7,285195
48943,0.013813,74.125.24.0-255,1484,122520,7,285195
48944,0.016118,74.125.24.0-255,4320,126840,7,285195
48945,0.016128,172.31.36.0-255,66,126906,7,285195
48946,0.018418,74.125.24.0-255,5738,132644,7,285195
48947,0.018427,172.31.36.0-255,66,132710,7,285195
48948,0.020705,74.125.24.0-255,5738,138448,7,285195
48949,0.020719,172.31.36.0-255,66,138514,7,285195
48950,0.023005,74.125.24.0-255,5738,144252,7,285195
48951,0.023013,172.31.36.0-255,66,144318,7,285195
48952,0.025293,74.125.24.0-255,4320,148638,7,285195
48953,0.0253,172.31.36.0-255,66,148704,7,285195
48954,0.025321,74.125.24.0-255,1484,150188,7,285195
48955,0.027588,74.125.24.0-255,4320,154508,7,285195
48956,0.027595,172.31.36.0-255,66,154574,7,285195
48957,0.029412,172.31.36.0-255,167,154741,7,285195
48958,0.02944,172.31.36.0-255,1115,155856,7,285195
48959,0.029498,172.31.36.0-255,1514,157370,7,285195
48960,0.0295,172.31.36.0-255,1291,158661,7,285195
48961,0.029897,74.125.24.0-255,4320,162981,7,285195
48962,0.029905,172.31.36.0-255,66,163047,7,285195
48963,0.029925,74.125.24.0-255,1484,164531,7,285195
48964,0.030942,104.244.42.0-255,66,164597,7,285195
48965,0.030993,104.244.42.0-255,66,164663,7,285195
48966,0.031038,104.244.42.0-255,66,164729,7,285195
48967,0.032179,74.125.24.0-255,4320,169049,7,285195
48968,0.032186,172.31.36.0-255,66,169115,7,285195
48969,0.0345,74.125.24.0-255,5738,174853,7,285195
48970,0.034507,172.31.36.0-255,66,174919,7,285195
48971,0.036782,74.125.24.0-255,5738,180657,7,285195
48972,0.036788,172.31.36.0-255,66,180723,7,285195
48973,0.03909,74.125.24.0-255,5738,186461,7,285195
48974,0.039096,172.31.36.0-255,66,186527,7,285195
48975,0.041391,74.125.24.0-255,5738,192265,7,285195
48976,0.041398,172.31.36.0-255,66,192331,7,285195
48977,0.043722,74.125.24.0-255,5738,198069,7,285195
48978,0.043728,172.31.36.0-255,66,198135,7,285195
48979,0.046034,74.125.24.0-255,5738,203873,7,285195
48980,0.04604,172.31.36.0-255,66,203939,7,285195
48981,0.048354,74.125.24.0-255,5738,209677,7,285195
48982,0.048361,172.31.36.0-255,66,209743,7,285195
48983,0.050756,74.125.24.0-255,5738,215481,7,285195
48984,0.050763,172.31.36.0-255,66,215547,7,285195
48985,0.053051,74.125.24.0-255,5738,221285,7,285195
48986,0.053057,172.31.36.0-255,66,221351,7,285195
48987,0.055376,74.125.24.0-255,5738,227089,7,285195
48988,0.055382,172.31.36.0-255,66,227155,7,285195
48989,0.057677,74.125.24.0-255,5738,232893,7,285195
48990,0.057684,172.31.36.0-255,66,232959,7,285195
48991,0.059962,74.125.24.0-255,5738,238697,7,285195
48992,0.059969,172.31.36.0-255,66,238763,7,285195
48993,0.062257,74.125.24.0-255,5738,244501,7,285195
48994,0.062263,172.31.36.0-255,66,244567,7,285195
48995,0.064552,74.125.24.0-255,5738,250305,7,285195
48996,0.06456,172.31.36.0-255,66,250371,7,285195
48997,0.066848,74.125.24.0-255,5738,256109,7,285195
48998,0.066854,172.31.36.0-255,66,256175,7,285195
48999,0.069151,74.125.24.0-255,5738,261913,7,285195
49000,0.06916,172.31.36.0-255,66,261979,7,285195
49001,0.071464,74.125.24.0-255,5738,267717,7,285195
49002,0.07147,172.31.36.0-255,66,267783,7,285195
49003,0.073744,74.125.24.0-255,5738,273521,7,285195
49004,0.073752,172.31.36.0-255,66,273587,7,285195
49005,0.076041,74.125.24.0-255,5738,279325,7,285195
49006,0.076047,172.31.36.0-255,66,279391,7,285195
49007,0.07835,74.125.24.0-255,5738,285129,7,285195
49008,0.078356,172.31.36.0-255,66,285195,7,285195
49009,0.0,74.125.24.0-255,146,146,7,228854
49010,3.6e-05,172.31.36.0-255,66,212,7,228854
49011,4.3e-05,74.125.24.0-255,1484,1696,7,228854
49012,4.7e-05,172.31.36.0-255,66,1762,7,228854
49013,5.3e-05,74.125.24.0-255,2902,4664,7,228854
49014,6.5e-05,172.31.36.0-255,66,4730,7,228854
49015,7.2e-05,74.125.24.0-255,5738,10468,7,228854
49016,7.4e-05,172.31.36.0-255,66,10534,7,228854
49017,8e-05,74.125.24.0-255,3454,13988,7,228854
49018,8.3e-05,172.31.36.0-255,66,14054,7,228854
49019,0.000207,74.125.24.0-255,1484,15538,7,228854
49020,0.000213,172.31.36.0-255,66,15604,7,228854
49021,0.000218,74.125.24.0-255,2902,18506,7,228854
49022,0.000221,172.31.36.0-255,66,18572,7,228854
49023,0.000228,74.125.24.0-255,5738,24310,7,228854
49024,0.000236,172.31.36.0-255,66,24376,7,228854
49025,0.000297,74.125.24.0-255,6797,31173,7,228854
49026,0.000302,172.31.36.0-255,66,31239,7,228854
49027,0.000309,74.125.24.0-255,7156,38395,7,228854
49028,0.000312,172.31.36.0-255,66,38461,7,228854
49029,0.000352,172.31.36.0-255,66,38527,7,228854
49030,0.001105,74.125.24.0-255,1484,40011,7,228854
49031,0.001111,172.31.36.0-255,66,40077,7,228854
49032,0.001122,74.125.24.0-255,2902,42979,7,228854
49033,0.001125,172.31.36.0-255,66,43045,7,228854
49034,0.001138,74.125.24.0-255,5738,48783,7,228854
49035,0.00114,172.31.36.0-255,66,48849,7,228854
49036,0.001147,74.125.24.0-255,5738,54587,7,228854
49037,0.001149,172.31.36.0-255,66,54653,7,228854
49038,0.001178,74.125.24.0-255,7156,61809,7,228854
49039,0.00118,172.31.36.0-255,66,61875,7,228854
49040,0.001215,74.125.24.0-255,6797,68672,7,228854
49041,0.001221,74.125.24.0-255,3961,72633,7,228854
49042,0.001245,172.31.36.0-255,66,72699,7,228854
49043,0.00125,74.125.24.0-255,2902,75601,7,228854
49044,0.001255,172.31.36.0-255,66,75667,7,228854
49045,0.001333,172.31.36.0-255,66,75733,7,228854
49046,0.001489,74.125.24.0-255,1484,77217,7,228854
49047,0.001496,74.125.24.0-255,2902,80119,7,228854
49048,0.001515,172.31.36.0-255,66,80185,7,228854
49049,0.001521,74.125.24.0-255,5738,85923,7,228854
49050,0.001524,74.125.24.0-255,1484,87407,7,228854
49051,0.001549,172.31.36.0-255,66,87473,7,228854
49052,0.001581,74.125.24.0-255,2902,90375,7,228854
49053,0.001592,74.125.24.0-255,766,91141,7,228854
49054,0.001616,172.31.36.0-255,66,91207,7,228854
49055,0.002092,74.125.24.0-255,1484,92691,7,228854
49056,0.002098,74.125.24.0-255,2902,95593,7,228854
49057,0.002101,172.31.36.0-255,66,95659,7,228854
49058,0.002108,74.125.24.0-255,5738,101397,7,228854
49059,0.00213,74.125.24.0-255,4320,105717,7,228854
49060,0.002136,172.31.36.0-255,66,105783,7,228854
49061,0.002192,74.125.24.0-255,2902,108685,7,228854
49062,0.002216,172.31.36.0-255,66,108751,7,228854
49063,0.002655,74.125.24.0-255,1484,110235,7,228854
49064,0.002676,74.125.24.0-255,2902,113137,7,228854
49065,0.00268,172.31.36.0-255,66,113203,7,228854
49066,0.002687,74.125.24.0-255,5738,118941,7,228854
49067,0.00272,74.125.24.0-255,2902,121843,7,228854
49068,0.002722,74.125.24.0-255,1484,123327,7,228854
49069,0.00273,172.31.36.0-255,66,123393,7,228854
49070,0.002764,74.125.24.0-255,6438,129831,7,228854
49071,0.002782,172.31.36.0-255,66,129897,7,228854
49072,0.002794,74.125.24.0-255,4320,134217,7,228854
49073,0.002808,74.125.24.0-255,2902,137119,7,228854
49074,0.002814,74.125.24.0-255,5738,142857,7,228854
49075,0.002833,74.125.24.0-255,4320,147177,7,228854
49076,0.002836,172.31.36.0-255,66,147243,7,228854
49077,0.00284,172.31.36.0-255,66,147309,7,228854
49078,0.002892,74.125.24.0-255,6438,153747,7,228854
49079,0.002918,172.31.36.0-255,66,153813,7,228854
49080,0.002969,74.125.24.0-255,5020,158833,7,228854
49081,0.003079,74.125.24.0-255,1484,160317,7,228854
49082,0.003085,74.125.24.0-255,2902,163219,7,228854
49083,0.003091,74.125.24.0-255,5738,168957,7,228854
49084,0.003104,74.125.24.0-255,1484,170441,7,228854
49085,0.003171,74.125.24.0-255,7156,177597,7,228854
49086,0.003179,74.125.24.0-255,3602,181199,7,228854
49087,0.003229,74.125.24.0-255,1484,182683,7,228854
49088,0.003235,74.125.24.0-255,2902,185585,7,228854
49089,0.003254,74.125.24.0-255,5738,191323,7,228854
49090,0.003299,74.125.24.0-255,7156,198479,7,228854
49091,0.00343,74.125.24.0-255,3602,202081,7,228854
49092,0.003481,74.125.24.0-255,2902,204983,7,228854
49093,0.003525,74.125.24.0-255,1484,206467,7,228854
49094,0.003532,74.125.24.0-255,5020,211487,7,228854
49095,0.003592,74.125.24.0-255,1484,212971,7,228854
49096,0.003617,74.125.24.0-255,1484,214455,7,228854
49097,0.003623,74.125.24.0-255,4320,218775,7,228854
49098,0.003632,74.125.24.0-255,5437,224212,7,228854
49099,0.003684,74.125.24.0-255,105,224317,7,228854
49100,0.00394,172.31.36.0-255,66,224383,7,228854
49101,0.006296,172.31.36.0-255,105,224488,7,228854
49102,0.008642,74.125.24.0-255,66,224554,7,228854
49103,0.032637,172.31.36.0-255,182,224736,7,228854
49104,0.032696,172.31.36.0-255,1114,225850,7,228854
49105,0.03278,172.31.36.0-255,1514,227364,7,228854
49106,0.032782,172.31.36.0-255,1292,228656,7,228854
49107,0.034182,104.244.42.0-255,66,228722,7,228854
49108,0.034294,104.244.42.0-255,66,228788,7,228854
49109,0.034337,104.244.42.0-255,66,228854,7,228854
