,TIME,SRC,PACKET_SIZE,CUMULATIVE_PACKET_SIZE,PAGE_NUMBER,TOTAL_PACKET_SIZE
0,0.0,172.217.194.0-255,153,153,92,248958
1,2.2e-05,172.31.47.0-255,66,219,92,248958
2,2.9e-05,172.217.194.0-255,1484,1703,92,248958
3,3.2e-05,172.31.47.0-255,66,1769,92,248958
4,3.6e-05,172.217.194.0-255,2902,4671,92,248958
5,3.8e-05,172.31.47.0-255,66,4737,92,248958
6,5.3e-05,172.217.194.0-255,2902,7639,92,248958
7,5.4e-05,172.31.47.0-255,66,7705,92,248958
8,7.1e-05,172.217.194.0-255,4320,12025,92,248958
9,7.3e-05,172.31.47.0-255,66,12091,92,248958
10,7.6e-05,172.217.194.0-255,1987,14078,92,248958
11,7.8e-05,172.31.47.0-255,66,14144,92,248958
12,0.000114,172.217.194.0-255,1484,15628,92,248958
13,0.000116,172.31.47.0-255,66,15694,92,248958
14,0.000133,172.217.194.0-255,2902,18596,92,248958
15,0.000135,172.31.47.0-255,66,18662,92,248958
16,0.00014,172.217.194.0-255,4320,22982,92,248958
17,0.000142,172.31.47.0-255,66,23048,92,248958
18,0.000153,172.217.194.0-255,1484,24532,92,248958
19,0.000155,172.31.47.0-255,66,24598,92,248958
20,0.000171,172.217.194.0-255,4320,28918,92,248958
21,0.000173,172.31.47.0-255,66,28984,92,248958
22,0.000184,172.217.194.0-255,2543,31527,92,248958
23,0.000186,172.31.47.0-255,66,31593,92,248958
24,0.000624,172.217.194.0-255,1484,33077,92,248958
25,0.000629,172.31.47.0-255,66,33143,92,248958
26,0.000638,172.217.194.0-255,2902,36045,92,248958
27,0.00064,172.31.47.0-255,66,36111,92,248958
28,0.000643,172.217.194.0-255,1484,37595,92,248958
29,0.000645,172.31.47.0-255,66,37661,92,248958
30,0.000669,172.217.194.0-255,4320,41981,92,248958
31,0.000671,172.31.47.0-255,66,42047,92,248958
32,0.000692,172.217.194.0-255,2902,44949,92,248958
33,0.000694,172.31.47.0-255,66,45015,92,248958
34,0.000714,172.31.47.0-255,66,45081,92,248958
35,0.000754,172.31.47.0-255,66,45147,92,248958
36,0.001041,172.217.194.0-255,648,45795,92,248958
37,0.001047,172.31.47.0-255,66,45861,92,248958
38,0.001114,172.217.194.0-255,1484,47345,92,248958
39,0.001118,172.31.47.0-255,66,47411,92,248958
40,0.001126,172.217.194.0-255,2902,50313,92,248958
41,0.001148,172.217.194.0-255,5738,56051,92,248958
42,0.001157,172.31.47.0-255,66,56117,92,248958
43,0.001191,172.217.194.0-255,6797,62914,92,248958
44,0.001203,172.31.47.0-255,66,62980,92,248958
45,0.001207,172.217.194.0-255,2902,65882,92,248958
46,0.001211,172.31.47.0-255,66,65948,92,248958
47,0.001228,172.217.194.0-255,4320,70268,92,248958
48,0.001232,172.217.194.0-255,4320,74588,92,248958
49,0.001239,172.31.47.0-255,66,74654,92,248958
50,0.001247,172.217.194.0-255,1484,76138,92,248958
51,0.001286,172.217.194.0-255,3961,80099,92,248958
52,0.0013,172.31.47.0-255,66,80165,92,248958
53,0.001948,172.217.194.0-255,1484,81649,92,248958
54,0.001952,172.31.47.0-255,66,81715,92,248958
55,0.00196,172.217.194.0-255,2902,84617,92,248958
56,0.001963,172.217.194.0-255,1484,86101,92,248958
57,0.001984,172.217.194.0-255,4320,90421,92,248958
58,0.001988,172.217.194.0-255,4320,94741,92,248958
59,0.002015,172.217.194.0-255,7156,101897,92,248958
60,0.002017,172.31.47.0-255,66,101963,92,248958
61,0.002028,172.31.47.0-255,66,102029,92,248958
62,0.002074,172.217.194.0-255,3602,105631,92,248958
63,0.0021,172.31.47.0-255,66,105697,92,248958
64,0.002311,172.217.194.0-255,1484,107181,92,248958
65,0.004374,172.217.194.0-255,4320,111501,92,248958
66,0.004379,172.31.47.0-255,66,111567,92,248958
67,0.006685,172.217.194.0-255,5738,117305,92,248958
68,0.006723,172.31.47.0-255,66,117371,92,248958
69,0.009042,172.217.194.0-255,5738,123109,92,248958
70,0.009049,172.31.47.0-255,66,123175,92,248958
71,0.011348,172.217.194.0-255,5738,128913,92,248958
72,0.011357,172.31.47.0-255,66,128979,92,248958
73,0.013648,172.217.194.0-255,5738,134717,92,248958
74,0.013655,172.31.47.0-255,66,134783,92,248958
75,0.016015,172.217.194.0-255,5738,140521,92,248958
76,0.016021,172.31.47.0-255,66,140587,92,248958
77,0.018318,172.217.194.0-255,5738,146325,92,248958
78,0.018325,172.31.47.0-255,66,146391,92,248958
79,0.020615,172.217.194.0-255,5738,152129,92,248958
80,0.020622,172.31.47.0-255,66,152195,92,248958
81,0.022929,172.217.194.0-255,5738,157933,92,248958
82,0.022936,172.31.47.0-255,66,157999,92,248958
83,0.024237,172.31.47.0-255,172,158171,92,248958
84,0.024263,172.31.47.0-255,1111,159282,92,248958
85,0.024288,172.31.47.0-255,570,159852,92,248958
86,0.025217,172.217.194.0-255,5738,165590,92,248958
87,0.025223,172.31.47.0-255,66,165656,92,248958
88,0.025816,104.244.42.0-255,66,165722,92,248958
89,0.025823,104.244.42.0-255,66,165788,92,248958
90,0.025946,104.244.42.0-255,66,165854,92,248958
91,0.027517,172.217.194.0-255,2902,168756,92,248958
92,0.027521,172.31.47.0-255,66,168822,92,248958
93,0.027539,172.217.194.0-255,2902,171724,92,248958
94,0.027731,172.31.47.0-255,66,171790,92,248958
95,0.029785,172.217.194.0-255,2902,174692,92,248958
96,0.029789,172.31.47.0-255,66,174758,92,248958
97,0.030004,172.217.194.0-255,2902,177660,92,248958
98,0.030012,172.31.47.0-255,66,177726,92,248958
99,0.032092,172.217.194.0-255,2902,180628,92,248958
100,0.032096,172.31.47.0-255,66,180694,92,248958
101,0.032291,172.217.194.0-255,2902,183596,92,248958
102,0.032296,172.31.47.0-255,66,183662,92,248958
103,0.034394,172.217.194.0-255,2902,186564,92,248958
104,0.034398,172.31.47.0-255,66,186630,92,248958
105,0.034573,172.217.194.0-255,2902,189532,92,248958
106,0.034578,172.31.47.0-255,66,189598,92,248958
107,0.036657,172.217.194.0-255,2902,192500,92,248958
108,0.036662,172.31.47.0-255,66,192566,92,248958
109,0.03686,172.217.194.0-255,2902,195468,92,248958
110,0.036866,172.31.47.0-255,66,195534,92,248958
111,0.038956,172.217.194.0-255,1484,197018,92,248958
112,0.038988,172.217.194.0-255,1484,198502,92,248958
113,0.038992,172.31.47.0-255,66,198568,92,248958
114,0.03916,172.217.194.0-255,2902,201470,92,248958
115,0.039166,172.31.47.0-255,66,201536,92,248958
116,0.041289,172.217.194.0-255,2902,204438,92,248958
117,0.041294,172.31.47.0-255,66,204504,92,248958
118,0.041442,172.217.194.0-255,2902,207406,92,248958
119,0.041448,172.31.47.0-255,66,207472,92,248958
120,0.043561,172.217.194.0-255,2902,210374,92,248958
121,0.043566,172.31.47.0-255,66,210440,92,248958
122,0.04373,172.217.194.0-255,2902,213342,92,248958
123,0.043736,172.31.47.0-255,66,213408,92,248958
124,0.045841,172.217.194.0-255,2902,216310,92,248958
125,0.045847,172.31.47.0-255,66,216376,92,248958
126,0.046013,172.217.194.0-255,2902,219278,92,248958
127,0.046018,172.31.47.0-255,66,219344,92,248958
128,0.048136,172.217.194.0-255,2902,222246,92,248958
129,0.048141,172.31.47.0-255,66,222312,92,248958
130,0.048297,172.217.194.0-255,2902,225214,92,248958
131,0.04858,172.31.47.0-255,66,225280,92,248958
132,0.050422,172.217.194.0-255,2902,228182,92,248958
133,0.050427,172.31.47.0-255,66,228248,92,248958
134,0.050853,172.217.194.0-255,2902,231150,92,248958
135,0.050857,172.31.47.0-255,66,231216,92,248958
136,0.052705,172.217.194.0-255,2902,234118,92,248958
137,0.052709,172.31.47.0-255,66,234184,92,248958
138,0.053126,172.217.194.0-255,2902,237086,92,248958
139,0.053131,172.31.47.0-255,66,237152,92,248958
140,0.055001,172.217.194.0-255,2902,240054,92,248958
141,0.055006,172.31.47.0-255,66,240120,92,248958
142,0.055406,172.217.194.0-255,2902,243022,92,248958
143,0.055411,172.31.47.0-255,66,243088,92,248958
144,0.057285,172.217.194.0-255,1484,244572,92,248958
145,0.0577,172.217.194.0-255,4320,248892,92,248958
146,0.057744,172.31.47.0-255,66,248958,92,248958
147,0.0,74.125.130.0-255,153,153,92,271073
148,1.7e-05,172.31.47.0-255,66,219,92,271073
149,2.5e-05,74.125.130.0-255,1484,1703,92,271073
150,2.8e-05,172.31.47.0-255,66,1769,92,271073
151,3.4e-05,74.125.130.0-255,2902,4671,92,271073
152,4.5e-05,172.31.47.0-255,66,4737,92,271073
153,5.2e-05,74.125.130.0-255,4320,9057,92,271073
154,5.5e-05,172.31.47.0-255,66,9123,92,271073
155,5.9e-05,74.125.130.0-255,2902,12025,92,271073
156,6.2e-05,172.31.47.0-255,66,12091,92,271073
157,8.5e-05,74.125.130.0-255,2079,14170,92,271073
158,8.8e-05,172.31.47.0-255,66,14236,92,271073
159,0.000105,172.31.47.0-255,66,14302,92,271073
160,0.000111,74.125.130.0-255,4320,18622,92,271073
161,0.000113,172.31.47.0-255,66,18688,92,271073
162,0.000134,74.125.130.0-255,1125,19813,92,271073
163,0.000137,172.31.47.0-255,66,19879,92,271073
164,0.000203,74.125.130.0-255,1484,21363,92,271073
165,0.000206,172.31.47.0-255,66,21429,92,271073
166,0.000209,74.125.130.0-255,1484,22913,92,271073
167,0.000212,172.31.47.0-255,66,22979,92,271073
168,0.000231,74.125.130.0-255,1484,24463,92,271073
169,0.000234,172.31.47.0-255,66,24529,92,271073
170,0.000241,74.125.130.0-255,5738,30267,92,271073
171,0.000243,172.31.47.0-255,66,30333,92,271073
172,0.000248,74.125.130.0-255,4320,34653,92,271073
173,0.000251,172.31.47.0-255,66,34719,92,271073
174,0.00031,74.125.130.0-255,5379,40098,92,271073
175,0.000313,172.31.47.0-255,66,40164,92,271073
176,0.000324,172.31.47.0-255,66,40230,92,271073
177,0.000358,74.125.130.0-255,5685,45915,92,271073
178,0.00036,172.31.47.0-255,66,45981,92,271073
179,0.000363,74.125.130.0-255,379,46360,92,271073
180,0.000615,74.125.130.0-255,1484,47844,92,271073
181,0.000621,172.31.47.0-255,66,47910,92,271073
182,0.000626,74.125.130.0-255,1484,49394,92,271073
183,0.000652,74.125.130.0-255,1484,50878,92,271073
184,0.000655,172.31.47.0-255,66,50944,92,271073
185,0.000661,74.125.130.0-255,5738,56682,92,271073
186,0.000664,172.31.47.0-255,66,56748,92,271073
187,0.000674,74.125.130.0-255,5738,62486,92,271073
188,0.000676,172.31.47.0-255,66,62552,92,271073
189,0.000683,74.125.130.0-255,7156,69708,92,271073
190,0.000686,172.31.47.0-255,66,69774,92,271073
191,0.00074,172.31.47.0-255,66,69840,92,271073
192,0.001118,74.125.130.0-255,1484,71324,92,271073
193,0.001123,74.125.130.0-255,1484,72808,92,271073
194,0.001127,172.31.47.0-255,66,72874,92,271073
195,0.001131,74.125.130.0-255,1484,74358,92,271073
196,0.001151,74.125.130.0-255,1484,75842,92,271073
197,0.001157,74.125.130.0-255,4320,80162,92,271073
198,0.00116,172.31.47.0-255,66,80228,92,271073
199,0.001168,172.31.47.0-255,66,80294,92,271073
200,0.001171,74.125.130.0-255,1484,81778,92,271073
201,0.001208,172.31.47.0-255,66,81844,92,271073
202,0.001231,74.125.130.0-255,1484,83328,92,271073
203,0.001255,172.31.47.0-255,66,83394,92,271073
204,0.001748,74.125.130.0-255,1484,84878,92,271073
205,0.001754,74.125.130.0-255,2902,87780,92,271073
206,0.001758,172.31.47.0-255,66,87846,92,271073
207,0.001765,74.125.130.0-255,5738,93584,92,271073
208,0.001768,172.31.47.0-255,66,93650,92,271073
209,0.001807,172.31.47.0-255,66,93716,92,271073
210,0.001844,172.31.47.0-255,66,93782,92,271073
211,0.001849,74.125.130.0-255,2184,95966,92,271073
212,0.001851,172.31.47.0-255,66,96032,92,271073
213,0.002006,74.125.130.0-255,1484,97516,92,271073
214,0.002026,74.125.130.0-255,2902,100418,92,271073
215,0.002029,172.31.47.0-255,66,100484,92,271073
216,0.002036,74.125.130.0-255,4320,104804,92,271073
217,0.002039,172.31.47.0-255,66,104870,92,271073
218,0.002066,74.125.130.0-255,1484,106354,92,271073
219,0.002073,74.125.130.0-255,7156,113510,92,271073
220,0.002075,172.31.47.0-255,66,113576,92,271073
221,0.002086,172.31.47.0-255,66,113642,92,271073
222,0.002126,172.31.47.0-255,66,113708,92,271073
223,0.002531,74.125.130.0-255,1484,115192,92,271073
224,0.002538,74.125.130.0-255,2902,118094,92,271073
225,0.002542,172.31.47.0-255,66,118160,92,271073
226,0.002571,74.125.130.0-255,2902,121062,92,271073
227,0.002573,172.31.47.0-255,66,121128,92,271073
228,0.002579,74.125.130.0-255,4320,125448,92,271073
229,0.002581,172.31.47.0-255,66,125514,92,271073
230,0.002585,74.125.130.0-255,2902,128416,92,271073
231,0.002587,172.31.47.0-255,66,128482,92,271073
232,0.002616,74.125.130.0-255,5738,134220,92,271073
233,0.002619,172.31.47.0-255,66,134286,92,271073
234,0.002629,172.31.47.0-255,66,134352,92,271073
235,0.005212,74.125.130.0-255,5738,140090,92,271073
236,0.005218,172.31.47.0-255,66,140156,92,271073
237,0.007802,74.125.130.0-255,5738,145894,92,271073
238,0.007808,172.31.47.0-255,66,145960,92,271073
239,0.010397,74.125.130.0-255,5738,151698,92,271073
240,0.010405,172.31.47.0-255,66,151764,92,271073
241,0.012999,74.125.130.0-255,5738,157502,92,271073
242,0.013007,172.31.47.0-255,66,157568,92,271073
243,0.015609,74.125.130.0-255,5738,163306,92,271073
244,0.015619,172.31.47.0-255,66,163372,92,271073
245,0.018229,74.125.130.0-255,5738,169110,92,271073
246,0.018236,172.31.47.0-255,66,169176,92,271073
247,0.020822,74.125.130.0-255,5738,174914,92,271073
248,0.02083,172.31.47.0-255,66,174980,92,271073
249,0.02343,74.125.130.0-255,5738,180718,92,271073
250,0.023437,172.31.47.0-255,66,180784,92,271073
251,0.026029,74.125.130.0-255,5738,186522,92,271073
252,0.026036,172.31.47.0-255,66,186588,92,271073
253,0.028624,74.125.130.0-255,5738,192326,92,271073
254,0.028632,172.31.47.0-255,66,192392,92,271073
255,0.031206,74.125.130.0-255,5738,198130,92,271073
256,0.031213,172.31.47.0-255,66,198196,92,271073
257,0.032055,172.31.47.0-255,172,198368,92,271073
258,0.032083,172.31.47.0-255,1112,199480,92,271073
259,0.032143,172.31.47.0-255,1514,200994,92,271073
260,0.032145,172.31.47.0-255,1514,202508,92,271073
261,0.032149,172.31.47.0-255,1514,204022,92,271073
262,0.03215,172.31.47.0-255,1514,205536,92,271073
263,0.03218,172.31.47.0-255,1495,207031,92,271073
264,0.033627,104.244.42.0-255,66,207097,92,271073
265,0.033655,104.244.42.0-255,66,207163,92,271073
266,0.033737,104.244.42.0-255,66,207229,92,271073
267,0.033806,74.125.130.0-255,5738,212967,92,271073
268,0.033812,172.31.47.0-255,66,213033,92,271073
269,0.036399,74.125.130.0-255,5738,218771,92,271073
270,0.036404,172.31.47.0-255,66,218837,92,271073
271,0.038994,74.125.130.0-255,5738,224575,92,271073
272,0.038999,172.31.47.0-255,66,224641,92,271073
273,0.041592,74.125.130.0-255,5738,230379,92,271073
274,0.041599,172.31.47.0-255,66,230445,92,271073
275,0.044196,74.125.130.0-255,5738,236183,92,271073
276,0.044205,172.31.47.0-255,66,236249,92,271073
277,0.046818,74.125.130.0-255,5738,241987,92,271073
278,0.046825,172.31.47.0-255,66,242053,92,271073
279,0.049409,74.125.130.0-255,5738,247791,92,271073
280,0.049414,172.31.47.0-255,66,247857,92,271073
281,0.052016,74.125.130.0-255,5738,253595,92,271073
282,0.052021,172.31.47.0-255,66,253661,92,271073
283,0.054609,74.125.130.0-255,5738,259399,92,271073
284,0.054614,172.31.47.0-255,66,259465,92,271073
285,0.057207,74.125.130.0-255,5738,265203,92,271073
286,0.057213,172.31.47.0-255,66,265269,92,271073
287,0.05981,74.125.130.0-255,5738,271007,92,271073
288,0.059815,172.31.47.0-255,66,271073,92,271073
289,0.0,172.217.194.0-255,153,153,92,228790
290,2.3e-05,172.31.47.0-255,66,219,92,228790
291,2.9e-05,172.217.194.0-255,1484,1703,92,228790
292,3.3e-05,172.31.47.0-255,66,1769,92,228790
293,5.4e-05,172.217.194.0-255,2902,4671,92,228790
294,5.6e-05,172.31.47.0-255,66,4737,92,228790
295,6.6e-05,172.217.194.0-255,4320,9057,92,228790
296,6.8e-05,172.31.47.0-255,66,9123,92,228790
297,9.6e-05,172.217.194.0-255,2902,12025,92,228790
298,9.8e-05,172.31.47.0-255,66,12091,92,228790
299,0.000102,172.217.194.0-255,2164,14255,92,228790
300,0.000104,172.31.47.0-255,66,14321,92,228790
301,0.000134,172.31.47.0-255,66,14387,92,228790
302,0.000181,172.217.194.0-255,5379,19766,92,228790
303,0.000184,172.31.47.0-255,66,19832,92,228790
304,0.000263,172.217.194.0-255,1484,21316,92,228790
305,0.000267,172.31.47.0-255,66,21382,92,228790
306,0.000292,172.217.194.0-255,2902,24284,92,228790
307,0.000295,172.31.47.0-255,66,24350,92,228790
308,0.0003,172.217.194.0-255,5738,30088,92,228790
309,0.000302,172.31.47.0-255,66,30154,92,228790
310,0.000329,172.217.194.0-255,6797,36951,92,228790
311,0.000332,172.31.47.0-255,66,37017,92,228790
312,0.000354,172.217.194.0-255,7156,44173,92,228790
313,0.000358,172.31.47.0-255,66,44239,92,228790
314,0.000396,172.31.47.0-255,66,44305,92,228790
315,0.000398,172.217.194.0-255,434,44739,92,228790
316,0.0004,172.31.47.0-255,66,44805,92,228790
317,0.000641,172.217.194.0-255,1484,46289,92,228790
318,0.000644,172.31.47.0-255,66,46355,92,228790
319,0.000649,172.217.194.0-255,2902,49257,92,228790
320,0.000651,172.31.47.0-255,66,49323,92,228790
321,0.000682,172.217.194.0-255,5738,55061,92,228790
322,0.000685,172.31.47.0-255,66,55127,92,228790
323,0.000691,172.217.194.0-255,7156,62283,92,228790
324,0.000693,172.31.47.0-255,66,62349,92,228790
325,0.000733,172.31.47.0-255,66,62415,92,228790
326,0.000737,172.217.194.0-255,2184,64599,92,228790
327,0.000739,172.31.47.0-255,66,64665,92,228790
328,0.000766,172.217.194.0-255,2902,67567,92,228790
329,0.000772,172.31.47.0-255,66,67633,92,228790
330,0.000777,172.217.194.0-255,4320,71953,92,228790
331,0.000779,172.31.47.0-255,66,72019,92,228790
332,0.000814,172.31.47.0-255,66,72085,92,228790
333,0.000837,172.217.194.0-255,2902,74987,92,228790
334,0.00084,172.31.47.0-255,66,75053,92,228790
335,0.00087,172.31.47.0-255,66,75119,92,228790
336,0.000891,172.217.194.0-255,1484,76603,92,228790
337,0.000896,172.217.194.0-255,2902,79505,92,228790
338,0.000898,172.31.47.0-255,66,79571,92,228790
339,0.000928,172.217.194.0-255,5738,85309,92,228790
340,0.000931,172.31.47.0-255,66,85375,92,228790
341,0.000943,172.31.47.0-255,66,85441,92,228790
342,0.000993,172.217.194.0-255,7156,92597,92,228790
343,0.000997,172.31.47.0-255,66,92663,92,228790
344,0.001015,172.217.194.0-255,6438,99101,92,228790
345,0.001018,172.31.47.0-255,66,99167,92,228790
346,0.00106,172.217.194.0-255,1484,100651,92,228790
347,0.001064,172.217.194.0-255,1484,102135,92,228790
348,0.001066,172.31.47.0-255,66,102201,92,228790
349,0.001092,172.217.194.0-255,1484,103685,92,228790
350,0.001099,172.217.194.0-255,5738,109423,92,228790
351,0.001101,172.31.47.0-255,66,109489,92,228790
352,0.001141,172.31.47.0-255,66,109555,92,228790
353,0.001175,172.217.194.0-255,4320,113875,92,228790
354,0.001179,172.31.47.0-255,66,113941,92,228790
355,0.001185,172.31.47.0-255,66,114007,92,228790
356,0.00122,172.217.194.0-255,1484,115491,92,228790
357,0.001225,172.217.194.0-255,2902,118393,92,228790
358,0.001227,172.31.47.0-255,66,118459,92,228790
359,0.00123,172.217.194.0-255,1484,119943,92,228790
360,0.001249,172.217.194.0-255,4320,124263,92,228790
361,0.001251,172.31.47.0-255,66,124329,92,228790
362,0.001292,172.31.47.0-255,66,124395,92,228790
363,0.001303,172.31.47.0-255,66,124461,92,228790
364,0.001327,172.217.194.0-255,2184,126645,92,228790
365,0.001335,172.31.47.0-255,66,126711,92,228790
366,0.001356,172.217.194.0-255,1484,128195,92,228790
367,0.001374,172.217.194.0-255,2902,131097,92,228790
368,0.001378,172.31.47.0-255,66,131163,92,228790
369,0.001382,172.217.194.0-255,2902,134065,92,228790
370,0.001386,172.31.47.0-255,66,134131,92,228790
371,0.001398,172.217.194.0-255,2902,137033,92,228790
372,0.001401,172.31.47.0-255,66,137099,92,228790
373,0.001448,172.31.47.0-255,66,137165,92,228790
374,0.001456,172.217.194.0-255,7156,144321,92,228790
375,0.001458,172.31.47.0-255,66,144387,92,228790
376,0.001488,172.217.194.0-255,2902,147289,92,228790
377,0.001492,172.31.47.0-255,66,147355,92,228790
378,0.00152,172.217.194.0-255,3602,150957,92,228790
379,0.001524,172.31.47.0-255,66,151023,92,228790
380,0.001552,172.217.194.0-255,1484,152507,92,228790
381,0.001555,172.217.194.0-255,1484,153991,92,228790
382,0.001558,172.31.47.0-255,66,154057,92,228790
383,0.001585,172.217.194.0-255,1484,155541,92,228790
384,0.001592,172.217.194.0-255,5738,161279,92,228790
385,0.001595,172.31.47.0-255,66,161345,92,228790
386,0.001621,172.217.194.0-255,4320,165665,92,228790
387,0.001625,172.31.47.0-255,66,165731,92,228790
388,0.001656,172.217.194.0-255,5738,171469,92,228790
389,0.00166,172.31.47.0-255,66,171535,92,228790
390,0.001676,172.217.194.0-255,7156,178691,92,228790
391,0.001684,172.31.47.0-255,66,178757,92,228790
392,0.001715,172.217.194.0-255,6438,185195,92,228790
393,0.001718,172.217.194.0-255,1484,186679,92,228790
394,0.001719,172.31.47.0-255,66,186745,92,228790
395,0.001728,172.217.194.0-255,2902,189647,92,228790
396,0.001731,172.31.47.0-255,66,189713,92,228790
397,0.001742,172.217.194.0-255,5738,195451,92,228790
398,0.001745,172.31.47.0-255,66,195517,92,228790
399,0.001753,172.217.194.0-255,7156,202673,92,228790
400,0.001755,172.31.47.0-255,66,202739,92,228790
401,0.001788,172.217.194.0-255,5738,208477,92,228790
402,0.001792,172.31.47.0-255,66,208543,92,228790
403,0.001817,172.31.47.0-255,66,208609,92,228790
404,0.001849,172.217.194.0-255,2184,210793,92,228790
405,0.001852,172.31.47.0-255,66,210859,92,228790
406,0.001865,172.31.47.0-255,66,210925,92,228790
407,0.001877,172.31.47.0-255,66,210991,92,228790
408,0.001905,172.217.194.0-255,2902,213893,92,228790
409,0.001908,172.31.47.0-255,66,213959,92,228790
410,0.001957,172.31.47.0-255,66,214025,92,228790
411,0.00198,172.31.47.0-255,66,214091,92,228790
412,0.001987,172.217.194.0-255,5020,219111,92,228790
413,0.001989,172.31.47.0-255,66,219177,92,228790
414,0.002074,172.31.47.0-255,66,219243,92,228790
415,0.002077,172.217.194.0-255,105,219348,92,228790
416,0.003476,172.31.47.0-255,66,219414,92,228790
417,0.003503,172.31.47.0-255,105,219519,92,228790
418,0.005768,172.217.194.0-255,66,219585,92,228790
419,0.009368,172.31.47.0-255,105,219690,92,228790
420,0.030824,172.31.47.0-255,172,219862,92,228790
421,0.030851,172.31.47.0-255,1111,220973,92,228790
422,0.030888,172.31.47.0-255,1514,222487,92,228790
423,0.030889,172.31.47.0-255,1514,224001,92,228790
424,0.03089,172.31.47.0-255,1514,225515,92,228790
425,0.030891,172.31.47.0-255,1514,227029,92,228790
426,0.030914,172.31.47.0-255,1497,228526,92,228790
427,0.032388,104.244.42.0-255,66,228592,92,228790
428,0.032397,104.244.42.0-255,66,228658,92,228790
429,0.032474,104.244.42.0-255,66,228724,92,228790
430,0.032559,104.244.42.0-255,66,228790,92,228790
431,0.0,74.125.24.0-255,153,153,92,233654
432,3.1e-05,172.31.47.0-255,66,219,92,233654
433,3.8e-05,74.125.24.0-255,1484,1703,92,233654
434,4.2e-05,172.31.47.0-255,66,1769,92,233654
435,4.6e-05,74.125.24.0-255,2902,4671,92,233654
436,4.9e-05,172.31.47.0-255,66,4737,92,233654
437,6.1e-05,74.125.24.0-255,4320,9057,92,233654
438,6.3e-05,172.31.47.0-255,66,9123,92,233654
439,7.3e-05,172.31.47.0-255,66,9189,92,233654
440,0.000106,172.31.47.0-255,66,9255,92,233654
441,0.000156,74.125.24.0-255,1484,10739,92,233654
442,0.000159,172.31.47.0-255,66,10805,92,233654
443,0.000162,74.125.24.0-255,1484,12289,92,233654
444,0.000164,172.31.47.0-255,66,12355,92,233654
445,0.000186,74.125.24.0-255,1484,13839,92,233654
446,0.000188,172.31.47.0-255,66,13905,92,233654
447,0.000198,74.125.24.0-255,5738,19643,92,233654
448,0.000201,172.31.47.0-255,66,19709,92,233654
449,0.000207,74.125.24.0-255,6797,26506,92,233654
450,0.000209,172.31.47.0-255,66,26572,92,233654
451,0.000517,74.125.24.0-255,1484,28056,92,233654
452,0.000521,172.31.47.0-255,66,28122,92,233654
453,0.000546,74.125.24.0-255,2902,31024,92,233654
454,0.000549,172.31.47.0-255,66,31090,92,233654
455,0.000554,74.125.24.0-255,5738,36828,92,233654
456,0.000556,172.31.47.0-255,66,36894,92,233654
457,0.000594,74.125.24.0-255,5738,42632,92,233654
458,0.000597,172.31.47.0-255,66,42698,92,233654
459,0.000613,74.125.24.0-255,1705,44403,92,233654
460,0.000616,172.31.47.0-255,66,44469,92,233654
461,0.000707,74.125.24.0-255,1484,45953,92,233654
462,0.000711,172.31.47.0-255,66,46019,92,233654
463,0.000718,74.125.24.0-255,2902,48921,92,233654
464,0.00072,172.31.47.0-255,66,48987,92,233654
465,0.000749,74.125.24.0-255,5738,54725,92,233654
466,0.000752,172.31.47.0-255,66,54791,92,233654
467,0.000757,74.125.24.0-255,4320,59111,92,233654
468,0.000759,172.31.47.0-255,66,59177,92,233654
469,0.000761,74.125.24.0-255,1484,60661,92,233654
470,0.000792,74.125.24.0-255,2902,63563,92,233654
471,0.000793,172.31.47.0-255,66,63629,92,233654
472,0.000798,172.31.47.0-255,66,63695,92,233654
473,0.000811,74.125.24.0-255,3961,67656,92,233654
474,0.000818,172.31.47.0-255,66,67722,92,233654
475,0.001146,74.125.24.0-255,1484,69206,92,233654
476,0.00115,172.31.47.0-255,66,69272,92,233654
477,0.001159,74.125.24.0-255,2902,72174,92,233654
478,0.001161,172.31.47.0-255,66,72240,92,233654
479,0.001173,74.125.24.0-255,5738,77978,92,233654
480,0.001217,74.125.24.0-255,7156,85134,92,233654
481,0.001252,74.125.24.0-255,3602,88736,92,233654
482,0.002406,74.125.24.0-255,1484,90220,92,233654
483,0.002413,74.125.24.0-255,2902,93122,92,233654
484,0.002419,74.125.24.0-255,5738,98860,92,233654
485,0.002433,74.125.24.0-255,1484,100344,92,233654
486,0.002485,74.125.24.0-255,2184,102528,92,233654
487,0.004531,172.31.47.0-255,66,102594,92,233654
488,0.007105,74.125.24.0-255,5738,108332,92,233654
489,0.007111,172.31.47.0-255,66,108398,92,233654
490,0.009707,74.125.24.0-255,5738,114136,92,233654
491,0.009714,172.31.47.0-255,66,114202,92,233654
492,0.012291,74.125.24.0-255,5738,119940,92,233654
493,0.012297,172.31.47.0-255,66,120006,92,233654
494,0.014894,74.125.24.0-255,5738,125744,92,233654
495,0.014902,172.31.47.0-255,66,125810,92,233654
496,0.017501,74.125.24.0-255,5738,131548,92,233654
497,0.017509,172.31.47.0-255,66,131614,92,233654
498,0.020118,74.125.24.0-255,5738,137352,92,233654
499,0.020124,172.31.47.0-255,66,137418,92,233654
500,0.022743,74.125.24.0-255,5738,143156,92,233654
501,0.02275,172.31.47.0-255,66,143222,92,233654
502,0.025381,74.125.24.0-255,5738,148960,92,233654
503,0.025388,172.31.47.0-255,66,149026,92,233654
504,0.027977,74.125.24.0-255,5738,154764,92,233654
505,0.027985,172.31.47.0-255,66,154830,92,233654
506,0.029026,172.31.47.0-255,172,155002,92,233654
507,0.029061,172.31.47.0-255,1111,156113,92,233654
508,0.029212,172.31.47.0-255,1514,157627,92,233654
509,0.029214,172.31.47.0-255,1514,159141,92,233654
510,0.029216,172.31.47.0-255,1514,160655,92,233654
511,0.029217,172.31.47.0-255,1514,162169,92,233654
512,0.029243,172.31.47.0-255,1497,163666,92,233654
513,0.030501,104.244.42.0-255,66,163732,92,233654
514,0.030527,104.244.42.0-255,66,163798,92,233654
515,0.030554,74.125.24.0-255,4320,168118,92,233654
516,0.030559,172.31.47.0-255,66,168184,92,233654
517,0.03059,74.125.24.0-255,1484,169668,92,233654
518,0.030731,104.244.42.0-255,66,169734,92,233654
519,0.031312,104.244.42.0-255,108,169842,92,233654
520,0.031317,172.31.47.0-255,66,169908,92,233654
521,0.033179,74.125.24.0-255,4320,174228,92,233654
522,0.033183,172.31.47.0-255,66,174294,92,233654
523,0.035745,74.125.24.0-255,2902,177196,92,233654
524,0.035749,172.31.47.0-255,66,177262,92,233654
525,0.035777,74.125.24.0-255,2902,180164,92,233654
526,0.035787,172.31.47.0-255,66,180230,92,233654
527,0.038342,74.125.24.0-255,2902,183132,92,233654
528,0.038347,172.31.47.0-255,66,183198,92,233654
529,0.038376,74.125.24.0-255,2902,186100,92,233654
530,0.038391,172.31.47.0-255,66,186166,92,233654
531,0.04092,74.125.24.0-255,2902,189068,92,233654
532,0.040925,172.31.47.0-255,66,189134,92,233654
533,0.040961,74.125.24.0-255,1484,190618,92,233654
534,0.040978,74.125.24.0-255,1484,192102,92,233654
535,0.04125,172.31.47.0-255,66,192168,92,233654
536,0.043496,74.125.24.0-255,2902,195070,92,233654
537,0.0435,172.31.47.0-255,66,195136,92,233654
538,0.043817,74.125.24.0-255,2902,198038,92,233654
539,0.043821,172.31.47.0-255,66,198104,92,233654
540,0.046095,74.125.24.0-255,2902,201006,92,233654
541,0.046101,172.31.47.0-255,66,201072,92,233654
542,0.04639,74.125.24.0-255,2902,203974,92,233654
543,0.046396,172.31.47.0-255,66,204040,92,233654
544,0.048667,74.125.24.0-255,2902,206942,92,233654
545,0.048671,172.31.47.0-255,66,207008,92,233654
546,0.048964,74.125.24.0-255,2902,209910,92,233654
547,0.048969,172.31.47.0-255,66,209976,92,233654
548,0.051252,74.125.24.0-255,2902,212878,92,233654
549,0.051257,172.31.47.0-255,66,212944,92,233654
550,0.05155,74.125.24.0-255,2902,215846,92,233654
551,0.051554,172.31.47.0-255,66,215912,92,233654
552,0.05383,74.125.24.0-255,2902,218814,92,233654
553,0.053834,172.31.47.0-255,66,218880,92,233654
554,0.054128,74.125.24.0-255,2902,221782,92,233654
555,0.054133,172.31.47.0-255,66,221848,92,233654
556,0.056417,74.125.24.0-255,2902,224750,92,233654
557,0.056422,172.31.47.0-255,66,224816,92,233654
558,0.056702,74.125.24.0-255,2902,227718,92,233654
559,0.056707,172.31.47.0-255,66,227784,92,233654
560,0.05899,74.125.24.0-255,2902,230686,92,233654
561,0.058995,172.31.47.0-255,66,230752,92,233654
562,0.059286,74.125.24.0-255,2902,233654,92,233654
563,0.0,172.217.194.0-255,152,152,92,281489
564,1.8e-05,172.31.47.0-255,66,218,92,281489
565,2.4e-05,172.217.194.0-255,1484,1702,92,281489
566,2.8e-05,172.31.47.0-255,66,1768,92,281489
567,3.3e-05,172.217.194.0-255,2902,4670,92,281489
568,3.6e-05,172.31.47.0-255,66,4736,92,281489
569,4.1e-05,172.217.194.0-255,4320,9056,92,281489
570,4.3e-05,172.31.47.0-255,66,9122,92,281489
571,4.8e-05,172.217.194.0-255,4320,13442,92,281489
572,5e-05,172.31.47.0-255,66,13508,92,281489
573,7e-05,172.217.194.0-255,627,14135,92,281489
574,7.3e-05,172.31.47.0-255,66,14201,92,281489
575,7.6e-05,172.217.194.0-255,1484,15685,92,281489
576,7.8e-05,172.31.47.0-255,66,15751,92,281489
577,0.0001,172.31.47.0-255,66,15817,92,281489
578,0.000105,172.217.194.0-255,5738,21555,92,281489
579,0.000107,172.31.47.0-255,66,21621,92,281489
580,0.000136,172.217.194.0-255,7156,28777,92,281489
581,0.000138,172.31.47.0-255,66,28843,92,281489
582,0.000144,172.217.194.0-255,7156,35999,92,281489
583,0.000146,172.31.47.0-255,66,36065,92,281489
584,0.000156,172.217.194.0-255,2184,38249,92,281489
585,0.000158,172.31.47.0-255,66,38315,92,281489
586,0.000173,172.217.194.0-255,4320,42635,92,281489
587,0.000175,172.31.47.0-255,66,42701,92,281489
588,0.000192,172.217.194.0-255,5738,48439,92,281489
589,0.000194,172.31.47.0-255,66,48505,92,281489
590,0.0002,172.217.194.0-255,7085,55590,92,281489
591,0.000202,172.31.47.0-255,66,55656,92,281489
592,0.00078,172.217.194.0-255,99,55755,92,281489
593,0.000785,172.31.47.0-255,66,55821,92,281489
594,0.000845,172.217.194.0-255,1484,57305,92,281489
595,0.000858,172.217.194.0-255,2902,60207,92,281489
596,0.000861,172.31.47.0-255,66,60273,92,281489
597,0.000879,172.217.194.0-255,4320,64593,92,281489
598,0.000881,172.31.47.0-255,66,64659,92,281489
599,0.0009,172.217.194.0-255,1484,66143,92,281489
600,0.000903,172.217.194.0-255,2902,69045,92,281489
601,0.000905,172.31.47.0-255,66,69111,92,281489
602,0.000923,172.217.194.0-255,3961,73072,92,281489
603,0.000925,172.31.47.0-255,66,73138,92,281489
604,0.00094,172.217.194.0-255,2902,76040,92,281489
605,0.000942,172.31.47.0-255,66,76106,92,281489
606,0.000975,172.31.47.0-255,66,76172,92,281489
607,0.000989,172.217.194.0-255,2543,78715,92,281489
608,0.00099,172.31.47.0-255,66,78781,92,281489
609,0.001336,172.217.194.0-255,1484,80265,92,281489
610,0.001344,172.217.194.0-255,2902,83167,92,281489
611,0.001348,172.31.47.0-255,66,83233,92,281489
612,0.001355,172.217.194.0-255,5738,88971,92,281489
613,0.001356,172.31.47.0-255,66,89037,92,281489
614,0.001362,172.217.194.0-255,7156,96193,92,281489
615,0.001364,172.31.47.0-255,66,96259,92,281489
616,0.001411,172.31.47.0-255,66,96325,92,281489
617,0.001429,172.217.194.0-255,5738,102063,92,281489
618,0.001432,172.31.47.0-255,66,102129,92,281489
619,0.001455,172.217.194.0-255,2184,104313,92,281489
620,0.001458,172.31.47.0-255,66,104379,92,281489
621,0.001657,172.217.194.0-255,1484,105863,92,281489
622,0.001665,172.217.194.0-255,2902,108765,92,281489
623,0.001669,172.31.47.0-255,66,108831,92,281489
624,0.001676,172.217.194.0-255,5738,114569,92,281489
625,0.001678,172.31.47.0-255,66,114635,92,281489
626,0.001707,172.31.47.0-255,66,114701,92,281489
627,0.001739,172.31.47.0-255,66,114767,92,281489
628,0.001757,172.217.194.0-255,2184,116951,92,281489
629,0.001759,172.31.47.0-255,66,117017,92,281489
630,0.002036,172.217.194.0-255,1484,118501,92,281489
631,0.002044,172.217.194.0-255,2902,121403,92,281489
632,0.002049,172.31.47.0-255,66,121469,92,281489
633,0.002072,172.217.194.0-255,5738,127207,92,281489
634,0.002074,172.31.47.0-255,66,127273,92,281489
635,0.002079,172.217.194.0-255,4320,131593,92,281489
636,0.002082,172.31.47.0-255,66,131659,92,281489
637,0.002099,172.217.194.0-255,4320,135979,92,281489
638,0.002102,172.31.47.0-255,66,136045,92,281489
639,0.002139,172.217.194.0-255,4320,140365,92,281489
640,0.002142,172.31.47.0-255,66,140431,92,281489
641,0.00217,172.31.47.0-255,66,140497,92,281489
642,0.002195,172.217.194.0-255,7156,147653,92,281489
643,0.002198,172.31.47.0-255,66,147719,92,281489
644,0.002205,172.217.194.0-255,7156,154875,92,281489
645,0.002208,172.31.47.0-255,66,154941,92,281489
646,0.00222,172.217.194.0-255,1484,156425,92,281489
647,0.002226,172.217.194.0-255,4320,160745,92,281489
648,0.002228,172.31.47.0-255,66,160811,92,281489
649,0.002266,172.31.47.0-255,66,160877,92,281489
650,0.002268,172.217.194.0-255,766,161643,92,281489
651,0.002312,172.217.194.0-255,1484,163127,92,281489
652,0.002314,172.31.47.0-255,66,163193,92,281489
653,0.002318,172.217.194.0-255,2902,166095,92,281489
654,0.00232,172.31.47.0-255,66,166161,92,281489
655,0.002332,172.217.194.0-255,1484,167645,92,281489
656,0.00235,172.217.194.0-255,4320,171965,92,281489
657,0.002352,172.31.47.0-255,66,172031,92,281489
658,0.002357,172.217.194.0-255,2902,174933,92,281489
659,0.002359,172.31.47.0-255,66,174999,92,281489
660,0.002363,172.217.194.0-255,2902,177901,92,281489
661,0.00237,172.31.47.0-255,66,177967,92,281489
662,0.002373,172.217.194.0-255,1484,179451,92,281489
663,0.002393,172.217.194.0-255,1484,180935,92,281489
664,0.002395,172.31.47.0-255,66,181001,92,281489
665,0.002425,172.31.47.0-255,66,181067,92,281489
666,0.002428,172.217.194.0-255,1484,182551,92,281489
667,0.002431,172.217.194.0-255,766,183317,92,281489
668,0.002433,172.31.47.0-255,66,183383,92,281489
669,0.002525,172.217.194.0-255,1484,184867,92,281489
670,0.002537,172.217.194.0-255,2902,187769,92,281489
671,0.00254,172.31.47.0-255,66,187835,92,281489
672,0.002563,172.217.194.0-255,5738,193573,92,281489
673,0.002566,172.31.47.0-255,66,193639,92,281489
674,0.002569,172.217.194.0-255,1484,195123,92,281489
675,0.002596,172.31.47.0-255,66,195189,92,281489
676,0.002599,172.217.194.0-255,1484,196673,92,281489
677,0.002656,172.217.194.0-255,7156,203829,92,281489
678,0.002659,172.31.47.0-255,66,203895,92,281489
679,0.002674,172.217.194.0-255,1484,205379,92,281489
680,0.002676,172.217.194.0-255,766,206145,92,281489
681,0.002679,172.31.47.0-255,66,206211,92,281489
682,0.002681,172.217.194.0-255,1484,207695,92,281489
683,0.002685,172.217.194.0-255,1484,209179,92,281489
684,0.002687,172.31.47.0-255,66,209245,92,281489
685,0.002713,172.217.194.0-255,2902,212147,92,281489
686,0.002715,172.31.47.0-255,66,212213,92,281489
687,0.002721,172.217.194.0-255,4320,216533,92,281489
688,0.002723,172.31.47.0-255,66,216599,92,281489
689,0.002729,172.217.194.0-255,5738,222337,92,281489
690,0.002732,172.31.47.0-255,66,222403,92,281489
691,0.002755,172.217.194.0-255,4320,226723,92,281489
692,0.002757,172.31.47.0-255,66,226789,92,281489
693,0.002764,172.217.194.0-255,7156,233945,92,281489
694,0.002766,172.31.47.0-255,66,234011,92,281489
695,0.002789,172.217.194.0-255,6438,240449,92,281489
696,0.002791,172.31.47.0-255,66,240515,92,281489
697,0.002804,172.31.47.0-255,66,240581,92,281489
698,0.002823,172.217.194.0-255,2902,243483,92,281489
699,0.002826,172.31.47.0-255,66,243549,92,281489
700,0.002833,172.217.194.0-255,7156,250705,92,281489
701,0.002835,172.31.47.0-255,66,250771,92,281489
702,0.002865,172.217.194.0-255,2902,253673,92,281489
703,0.002867,172.31.47.0-255,66,253739,92,281489
704,0.002898,172.31.47.0-255,66,253805,92,281489
705,0.002902,172.217.194.0-255,2902,256707,92,281489
706,0.002905,172.31.47.0-255,66,256773,92,281489
707,0.002928,172.31.47.0-255,66,256839,92,281489
708,0.002948,172.217.194.0-255,7156,263995,92,281489
709,0.00295,172.31.47.0-255,66,264061,92,281489
710,0.002957,172.217.194.0-255,6438,270499,92,281489
711,0.002959,172.31.47.0-255,66,270565,92,281489
712,0.002962,172.217.194.0-255,1484,272049,92,281489
713,0.003001,172.31.47.0-255,66,272115,92,281489
714,0.003018,172.217.194.0-255,105,272220,92,281489
715,0.00948,172.31.47.0-255,66,272286,92,281489
716,0.009517,172.31.47.0-255,105,272391,92,281489
717,0.011809,172.217.194.0-255,66,272457,92,281489
718,0.034523,172.31.47.0-255,172,272629,92,281489
719,0.034553,172.31.47.0-255,1112,273741,92,281489
720,0.034605,172.31.47.0-255,1514,275255,92,281489
721,0.034606,172.31.47.0-255,1514,276769,92,281489
722,0.03461,172.31.47.0-255,1514,278283,92,281489
723,0.034611,172.31.47.0-255,1514,279797,92,281489
724,0.034629,172.31.47.0-255,1494,281291,92,281489
725,0.036115,104.244.42.0-255,66,281357,92,281489
726,0.036148,104.244.42.0-255,66,281423,92,281489
727,0.036246,104.244.42.0-255,66,281489,92,281489
728,0.0,172.31.47.0-255,66,66,92,66
729,0.0,74.125.24.0-255,146,146,92,158402
730,7.9e-05,172.31.47.0-255,66,212,92,158402
731,8.7e-05,74.125.24.0-255,1484,1696,92,158402
732,9.1e-05,172.31.47.0-255,66,1762,92,158402
733,9.5e-05,74.125.24.0-255,2902,4664,92,158402
734,9.8e-05,172.31.47.0-255,66,4730,92,158402
735,0.000111,74.125.24.0-255,7156,11886,92,158402
736,0.000114,172.31.47.0-255,66,11952,92,158402
737,0.000123,172.31.47.0-255,66,12018,92,158402
738,0.000135,172.31.47.0-255,66,12084,92,158402
739,0.000163,74.125.24.0-255,1484,13568,92,158402
740,0.000166,172.31.47.0-255,66,13634,92,158402
741,0.00017,74.125.24.0-255,2902,16536,92,158402
742,0.000172,172.31.47.0-255,66,16602,92,158402
743,0.000177,74.125.24.0-255,2902,19504,92,158402
744,0.000179,172.31.47.0-255,66,19570,92,158402
745,0.000224,74.125.24.0-255,2902,22472,92,158402
746,0.000227,172.31.47.0-255,66,22538,92,158402
747,0.000237,172.31.47.0-255,66,22604,92,158402
748,0.000254,172.31.47.0-255,66,22670,92,158402
749,0.000287,74.125.24.0-255,7107,29777,92,158402
750,0.00029,172.31.47.0-255,66,29843,92,158402
751,0.000292,74.125.24.0-255,112,29955,92,158402
752,0.000294,172.31.47.0-255,66,30021,92,158402
753,0.000296,74.125.24.0-255,330,30351,92,158402
754,0.000299,172.31.47.0-255,66,30417,92,158402
755,0.00065,74.125.24.0-255,1484,31901,92,158402
756,0.000655,172.31.47.0-255,66,31967,92,158402
757,0.000661,74.125.24.0-255,2902,34869,92,158402
758,0.000663,172.31.47.0-255,66,34935,92,158402
759,0.000666,74.125.24.0-255,1484,36419,92,158402
760,0.000701,74.125.24.0-255,4320,40739,92,158402
761,0.000715,74.125.24.0-255,2902,43641,92,158402
762,0.00072,172.31.47.0-255,66,43707,92,158402
763,0.000726,172.31.47.0-255,66,43773,92,158402
764,0.000752,172.31.47.0-255,66,43839,92,158402
765,0.001024,74.125.24.0-255,1484,45323,92,158402
766,0.001029,74.125.24.0-255,2902,48225,92,158402
767,0.001033,172.31.47.0-255,66,48291,92,158402
768,0.001062,74.125.24.0-255,5738,54029,92,158402
769,0.001068,172.31.47.0-255,66,54095,92,158402
770,0.001086,172.31.47.0-255,66,54161,92,158402
771,0.001124,74.125.24.0-255,7156,61317,92,158402
772,0.001134,172.31.47.0-255,66,61383,92,158402
773,0.00114,74.125.24.0-255,6438,67821,92,158402
774,0.00115,172.31.47.0-255,66,67887,92,158402
775,0.001286,74.125.24.0-255,1484,69371,92,158402
776,0.001292,74.125.24.0-255,2902,72273,92,158402
777,0.001295,172.31.47.0-255,66,72339,92,158402
778,0.00136,74.125.24.0-255,5738,78077,92,158402
779,0.001368,172.31.47.0-255,66,78143,92,158402
780,0.001382,172.31.47.0-255,66,78209,92,158402
781,0.001402,74.125.24.0-255,1484,79693,92,158402
782,0.001406,74.125.24.0-255,2902,82595,92,158402
783,0.001408,172.31.47.0-255,66,82661,92,158402
784,0.001441,74.125.24.0-255,5738,88399,92,158402
785,0.001449,172.31.47.0-255,66,88465,92,158402
786,0.00146,172.31.47.0-255,66,88531,92,158402
787,0.001476,74.125.24.0-255,1484,90015,92,158402
788,0.001493,172.31.47.0-255,66,90081,92,158402
789,0.0015,74.125.24.0-255,2902,92983,92,158402
790,0.001525,172.31.47.0-255,66,93049,92,158402
791,0.00157,172.31.47.0-255,66,93115,92,158402
792,0.001582,172.31.47.0-255,66,93181,92,158402
793,0.001594,74.125.24.0-255,2902,96083,92,158402
794,0.001601,172.31.47.0-255,66,96149,92,158402
795,0.001642,74.125.24.0-255,3602,99751,92,158402
796,0.001646,172.31.47.0-255,66,99817,92,158402
797,0.001675,172.31.47.0-255,66,99883,92,158402
798,0.001713,172.31.47.0-255,66,99949,92,158402
799,0.001726,172.31.47.0-255,66,100015,92,158402
800,0.00174,74.125.24.0-255,2184,102199,92,158402
801,0.001747,172.31.47.0-255,66,102265,92,158402
802,0.001761,172.31.47.0-255,66,102331,92,158402
803,0.001765,172.31.47.0-255,66,102397,92,158402
804,0.001832,172.31.47.0-255,66,102463,92,158402
805,0.001856,74.125.24.0-255,1484,103947,92,158402
806,0.001873,74.125.24.0-255,2902,106849,92,158402
807,0.00188,172.31.47.0-255,66,106915,92,158402
808,0.001891,74.125.24.0-255,5738,112653,92,158402
809,0.001898,172.31.47.0-255,66,112719,92,158402
810,0.001933,172.31.47.0-255,66,112785,92,158402
811,0.001982,74.125.24.0-255,5738,118523,92,158402
812,0.001991,172.31.47.0-255,66,118589,92,158402
813,0.001999,74.125.24.0-255,5020,123609,92,158402
814,0.002006,172.31.47.0-255,66,123675,92,158402
815,0.002403,74.125.24.0-255,1484,125159,92,158402
816,0.002408,74.125.24.0-255,1484,126643,92,158402
817,0.002411,172.31.47.0-255,66,126709,92,158402
818,0.002434,74.125.24.0-255,1484,128193,92,158402
819,0.00244,74.125.24.0-255,5738,133931,92,158402
820,0.002447,172.31.47.0-255,66,133997,92,158402
821,0.002472,172.31.47.0-255,66,134063,92,158402
822,0.002512,172.31.47.0-255,66,134129,92,158402
823,0.002518,74.125.24.0-255,2184,136313,92,158402
824,0.002524,172.31.47.0-255,66,136379,92,158402
825,0.002543,74.125.24.0-255,1484,137863,92,158402
826,0.002555,74.125.24.0-255,2902,140765,92,158402
827,0.002561,172.31.47.0-255,66,140831,92,158402
828,0.002569,74.125.24.0-255,2902,143733,92,158402
829,0.00258,172.31.47.0-255,66,143799,92,158402
830,0.002586,74.125.24.0-255,2902,146701,92,158402
831,0.002588,74.125.24.0-255,1484,148185,92,158402
832,0.002593,172.31.47.0-255,66,148251,92,158402
833,0.002615,172.31.47.0-255,66,148317,92,158402
834,0.002636,74.125.24.0-255,1426,149743,92,158402
835,0.002638,74.125.24.0-255,97,149840,92,158402
836,0.003334,172.31.47.0-255,66,149906,92,158402
837,0.005141,74.125.24.0-255,105,150011,92,158402
838,0.008278,172.31.47.0-255,66,150077,92,158402
839,0.008307,172.31.47.0-255,105,150182,92,158402
840,0.010876,74.125.24.0-255,66,150248,92,158402
841,0.025638,172.31.47.0-255,190,150438,92,158402
842,0.025668,172.31.47.0-255,1111,151549,92,158402
843,0.025708,172.31.47.0-255,1514,153063,92,158402
844,0.025709,172.31.47.0-255,1514,154577,92,158402
845,0.02571,172.31.47.0-255,1514,156091,92,158402
846,0.025711,172.31.47.0-255,1514,157605,92,158402
847,0.025712,172.31.47.0-255,533,158138,92,158402
848,0.027211,104.244.42.0-255,66,158204,92,158402
849,0.027219,104.244.42.0-255,66,158270,92,158402
850,0.027253,104.244.42.0-255,66,158336,92,158402
851,0.027255,104.244.42.0-255,66,158402,92,158402
852,0.0,172.217.194.0-255,152,152,92,222242
853,2.1e-05,172.31.47.0-255,66,218,92,222242
854,2.8e-05,172.217.194.0-255,1484,1702,92,222242
855,3.1e-05,172.31.47.0-255,66,1768,92,222242
856,3.7e-05,172.217.194.0-255,2902,4670,92,222242
857,4e-05,172.31.47.0-255,66,4736,92,222242
858,6.8e-05,172.217.194.0-255,5738,10474,92,222242
859,7e-05,172.31.47.0-255,66,10540,92,222242
860,7.3e-05,172.217.194.0-255,1484,12024,92,222242
861,7.5e-05,172.31.47.0-255,66,12090,92,222242
862,9.3e-05,172.217.194.0-255,2201,14291,92,222242
863,9.5e-05,172.31.47.0-255,66,14357,92,222242
864,0.0001,172.217.194.0-255,4320,18677,92,222242
865,0.000102,172.31.47.0-255,66,18743,92,222242
866,0.000124,172.217.194.0-255,5738,24481,92,222242
867,0.000127,172.31.47.0-255,66,24547,92,222242
868,0.000155,172.217.194.0-255,4320,28867,92,222242
869,0.000158,172.31.47.0-255,66,28933,92,222242
870,0.000163,172.217.194.0-255,5738,34671,92,222242
871,0.000165,172.31.47.0-255,66,34737,92,222242
872,0.000192,172.217.194.0-255,7156,41893,92,222242
873,0.000195,172.31.47.0-255,66,41959,92,222242
874,0.00021,172.217.194.0-255,2902,44861,92,222242
875,0.000212,172.31.47.0-255,66,44927,92,222242
876,0.000228,172.217.194.0-255,2902,47829,92,222242
877,0.00023,172.31.47.0-255,66,47895,92,222242
878,0.00025,172.217.194.0-255,766,48661,92,222242
879,0.000252,172.31.47.0-255,66,48727,92,222242
880,0.001541,172.217.194.0-255,1484,50211,92,222242
881,0.001547,172.31.47.0-255,66,50277,92,222242
882,0.001555,172.217.194.0-255,2902,53179,92,222242
883,0.001557,172.31.47.0-255,66,53245,92,222242
884,0.001579,172.217.194.0-255,4320,57565,92,222242
885,0.001604,172.217.194.0-255,5738,63303,92,222242
886,0.001622,172.217.194.0-255,2851,66154,92,222242
887,0.00538,172.31.47.0-255,66,66220,92,222242
888,0.007454,172.217.194.0-255,5738,71958,92,222242
889,0.007463,172.31.47.0-255,66,72024,92,222242
890,0.009542,172.217.194.0-255,5738,77762,92,222242
891,0.010358,172.31.47.0-255,66,77828,92,222242
892,0.012439,172.217.194.0-255,5738,83566,92,222242
893,0.01245,172.31.47.0-255,66,83632,92,222242
894,0.014523,172.217.194.0-255,5738,89370,92,222242
895,0.014531,172.31.47.0-255,66,89436,92,222242
896,0.016602,172.217.194.0-255,5738,95174,92,222242
897,0.016608,172.31.47.0-255,66,95240,92,222242
898,0.018693,172.217.194.0-255,5738,100978,92,222242
899,0.0187,172.31.47.0-255,66,101044,92,222242
900,0.02077,172.217.194.0-255,5738,106782,92,222242
901,0.020776,172.31.47.0-255,66,106848,92,222242
902,0.022867,172.217.194.0-255,5738,112586,92,222242
903,0.022874,172.31.47.0-255,66,112652,92,222242
904,0.024958,172.217.194.0-255,5738,118390,92,222242
905,0.024965,172.31.47.0-255,66,118456,92,222242
906,0.026212,172.31.47.0-255,172,118628,92,222242
907,0.02624,172.31.47.0-255,1111,119739,92,222242
908,0.026296,172.31.47.0-255,1514,121253,92,222242
909,0.026298,172.31.47.0-255,1514,122767,92,222242
910,0.026299,172.31.47.0-255,1514,124281,92,222242
911,0.0263,172.31.47.0-255,1514,125795,92,222242
912,0.026301,172.31.47.0-255,1495,127290,92,222242
913,0.027026,172.217.194.0-255,5738,133028,92,222242
914,0.027032,172.31.47.0-255,66,133094,92,222242
915,0.027744,104.244.42.0-255,66,133160,92,222242
916,0.02783,104.244.42.0-255,66,133226,92,222242
917,0.02788,104.244.42.0-255,66,133292,92,222242
918,0.029109,172.217.194.0-255,5738,139030,92,222242
919,0.029114,172.31.47.0-255,66,139096,92,222242
920,0.029177,104.244.42.0-255,108,139204,92,222242
921,0.029181,172.31.47.0-255,66,139270,92,222242
922,0.03118,172.217.194.0-255,2902,142172,92,222242
923,0.031186,172.31.47.0-255,66,142238,92,222242
924,0.031205,172.217.194.0-255,2902,145140,92,222242
925,0.031242,172.31.47.0-255,66,145206,92,222242
926,0.033247,172.217.194.0-255,2902,148108,92,222242
927,0.033253,172.31.47.0-255,66,148174,92,222242
928,0.033277,172.217.194.0-255,2902,151076,92,222242
929,0.033319,172.31.47.0-255,66,151142,92,222242
930,0.035347,172.217.194.0-255,2902,154044,92,222242
931,0.035354,172.31.47.0-255,66,154110,92,222242
932,0.035397,172.217.194.0-255,2902,157012,92,222242
933,0.035428,172.31.47.0-255,66,157078,92,222242
934,0.037465,172.217.194.0-255,2902,159980,92,222242
935,0.037472,172.31.47.0-255,66,160046,92,222242
936,0.037488,172.217.194.0-255,2902,162948,92,222242
937,0.03752,172.31.47.0-255,66,163014,92,222242
938,0.03953,172.217.194.0-255,2902,165916,92,222242
939,0.039536,172.31.47.0-255,66,165982,92,222242
940,0.039589,172.217.194.0-255,2902,168884,92,222242
941,0.039614,172.31.47.0-255,66,168950,92,222242
942,0.041613,172.217.194.0-255,2902,171852,92,222242
943,0.041618,172.31.47.0-255,66,171918,92,222242
944,0.041706,172.217.194.0-255,2902,174820,92,222242
945,0.041712,172.31.47.0-255,66,174886,92,222242
946,0.043695,172.217.194.0-255,2902,177788,92,222242
947,0.043701,172.31.47.0-255,66,177854,92,222242
948,0.04375,172.217.194.0-255,2902,180756,92,222242
949,0.043757,172.31.47.0-255,66,180822,92,222242
950,0.045765,172.217.194.0-255,2902,183724,92,222242
951,0.04577,172.31.47.0-255,66,183790,92,222242
952,0.045805,172.217.194.0-255,2902,186692,92,222242
953,0.045819,172.31.47.0-255,66,186758,92,222242
954,0.04784,172.217.194.0-255,2902,189660,92,222242
955,0.047846,172.31.47.0-255,66,189726,92,222242
956,0.047866,172.217.194.0-255,2902,192628,92,222242
957,0.047896,172.31.47.0-255,66,192694,92,222242
958,0.049917,172.217.194.0-255,2902,195596,92,222242
959,0.049923,172.31.47.0-255,66,195662,92,222242
960,0.049942,172.217.194.0-255,2902,198564,92,222242
961,0.049969,172.31.47.0-255,66,198630,92,222242
962,0.051991,172.217.194.0-255,2902,201532,92,222242
963,0.051997,172.31.47.0-255,66,201598,92,222242
964,0.052031,172.217.194.0-255,2902,204500,92,222242
965,0.052049,172.31.47.0-255,66,204566,92,222242
966,0.054077,172.217.194.0-255,2902,207468,92,222242
967,0.054083,172.31.47.0-255,66,207534,92,222242
968,0.054104,172.217.194.0-255,2902,210436,92,222242
969,0.054141,172.31.47.0-255,66,210502,92,222242
970,0.056165,172.217.194.0-255,2902,213404,92,222242
971,0.05617,172.31.47.0-255,66,213470,92,222242
972,0.056205,172.217.194.0-255,2902,216372,92,222242
973,0.056212,172.31.47.0-255,66,216438,92,222242
974,0.058284,172.217.194.0-255,5738,222176,92,222242
975,0.058326,172.31.47.0-255,66,222242,92,222242
976,0.0,74.125.24.0-255,153,153,92,186061
977,3.4e-05,172.31.47.0-255,66,219,92,186061
978,4.1e-05,74.125.24.0-255,1484,1703,92,186061
979,4.6e-05,172.31.47.0-255,66,1769,92,186061
980,5.1e-05,74.125.24.0-255,2902,4671,92,186061
981,5.4e-05,172.31.47.0-255,66,4737,92,186061
982,6e-05,74.125.24.0-255,5738,10475,92,186061
983,6.3e-05,172.31.47.0-255,66,10541,92,186061
984,0.000101,172.31.47.0-255,66,10607,92,186061
985,0.000107,74.125.24.0-255,6797,17404,92,186061
986,0.000109,172.31.47.0-255,66,17470,92,186061
987,0.00021,74.125.24.0-255,1484,18954,92,186061
988,0.000214,172.31.47.0-255,66,19020,92,186061
989,0.000227,74.125.24.0-255,2902,21922,92,186061
990,0.000229,172.31.47.0-255,66,21988,92,186061
991,0.000252,74.125.24.0-255,2902,24890,92,186061
992,0.000255,172.31.47.0-255,66,24956,92,186061
993,0.000262,74.125.24.0-255,7156,32112,92,186061
994,0.000265,172.31.47.0-255,66,32178,92,186061
995,0.000287,74.125.24.0-255,2902,35080,92,186061
996,0.000291,172.31.47.0-255,66,35146,92,186061
997,0.000322,172.31.47.0-255,66,35212,92,186061
998,0.000326,74.125.24.0-255,2813,38025,92,186061
999,0.000329,172.31.47.0-255,66,38091,92,186061
1000,0.000437,74.125.24.0-255,134,38225,92,186061
1001,0.000441,172.31.47.0-255,66,38291,92,186061
1002,0.00057,74.125.24.0-255,1484,39775,92,186061
1003,0.000574,172.31.47.0-255,66,39841,92,186061
1004,0.000579,74.125.24.0-255,2902,42743,92,186061
1005,0.000582,172.31.47.0-255,66,42809,92,186061
1006,0.000609,74.125.24.0-255,5738,48547,92,186061
1007,0.000612,172.31.47.0-255,66,48613,92,186061
1008,0.000616,74.125.24.0-255,1484,50097,92,186061
1009,0.000636,74.125.24.0-255,5379,55476,92,186061
1010,0.000639,172.31.47.0-255,66,55542,92,186061
1011,0.000665,172.31.47.0-255,66,55608,92,186061
1012,0.000685,74.125.24.0-255,2902,58510,92,186061
1013,0.000687,172.31.47.0-255,66,58576,92,186061
1014,0.000691,74.125.24.0-255,2543,61119,92,186061
1015,0.000693,172.31.47.0-255,66,61185,92,186061
1016,0.000725,74.125.24.0-255,1484,62669,92,186061
1017,0.000739,74.125.24.0-255,2902,65571,92,186061
1018,0.000743,172.31.47.0-255,66,65637,92,186061
1019,0.00075,74.125.24.0-255,5738,71375,92,186061
1020,0.000752,172.31.47.0-255,66,71441,92,186061
1021,0.000755,74.125.24.0-255,1484,72925,92,186061
1022,0.000791,74.125.24.0-255,5738,78663,92,186061
1023,0.000795,172.31.47.0-255,66,78729,92,186061
1024,0.00081,74.125.24.0-255,5738,84467,92,186061
1025,0.000813,172.31.47.0-255,66,84533,92,186061
1026,0.000824,74.125.24.0-255,4320,88853,92,186061
1027,0.000826,172.31.47.0-255,66,88919,92,186061
1028,0.000852,74.125.24.0-255,6438,95357,92,186061
1029,0.000855,172.31.47.0-255,66,95423,92,186061
1030,0.000885,172.31.47.0-255,66,95489,92,186061
1031,0.000891,74.125.24.0-255,7156,102645,92,186061
1032,0.000894,172.31.47.0-255,66,102711,92,186061
1033,0.000921,74.125.24.0-255,4320,107031,92,186061
1034,0.000924,172.31.47.0-255,66,107097,92,186061
1035,0.000952,172.31.47.0-255,66,107163,92,186061
1036,0.001408,74.125.24.0-255,1484,108647,92,186061
1037,0.001432,74.125.24.0-255,2902,111549,92,186061
1038,0.001436,172.31.47.0-255,66,111615,92,186061
1039,0.001439,74.125.24.0-255,1484,113099,92,186061
1040,0.001459,74.125.24.0-255,4320,117419,92,186061
1041,0.001462,172.31.47.0-255,66,117485,92,186061
1042,0.001493,172.31.47.0-255,66,117551,92,186061
1043,0.001514,74.125.24.0-255,1484,119035,92,186061
1044,0.001526,172.31.47.0-255,66,119101,92,186061
1045,0.001547,74.125.24.0-255,2184,121285,92,186061
1046,0.001551,172.31.47.0-255,66,121351,92,186061
1047,0.001759,74.125.24.0-255,1484,122835,92,186061
1048,0.001769,74.125.24.0-255,2902,125737,92,186061
1049,0.001773,172.31.47.0-255,66,125803,92,186061
1050,0.001797,74.125.24.0-255,5738,131541,92,186061
1051,0.001801,172.31.47.0-255,66,131607,92,186061
1052,0.001807,74.125.24.0-255,4320,135927,92,186061
1053,0.001809,172.31.47.0-255,66,135993,92,186061
1054,0.001822,74.125.24.0-255,2902,138895,92,186061
1055,0.001826,172.31.47.0-255,66,138961,92,186061
1056,0.001842,74.125.24.0-255,5738,144699,92,186061
1057,0.001845,172.31.47.0-255,66,144765,92,186061
1058,0.001875,172.31.47.0-255,66,144831,92,186061
1059,0.001879,74.125.24.0-255,2184,147015,92,186061
1060,0.001881,172.31.47.0-255,66,147081,92,186061
1061,0.001898,74.125.24.0-255,5738,152819,92,186061
1062,0.001901,172.31.47.0-255,66,152885,92,186061
1063,0.001945,172.31.47.0-255,66,152951,92,186061
1064,0.001956,172.31.47.0-255,66,153017,92,186061
1065,0.00199,172.31.47.0-255,66,153083,92,186061
1066,0.002019,172.31.47.0-255,66,153149,92,186061
1067,0.002029,172.31.47.0-255,66,153215,92,186061
1068,0.002056,172.31.47.0-255,66,153281,92,186061
1069,0.002073,172.31.47.0-255,66,153347,92,186061
1070,0.002125,172.31.47.0-255,66,153413,92,186061
1071,0.002147,74.125.24.0-255,766,154179,92,186061
1072,0.002167,172.31.47.0-255,66,154245,92,186061
1073,0.002174,74.125.24.0-255,7156,161401,92,186061
1074,0.002176,172.31.47.0-255,66,161467,92,186061
1075,0.002206,74.125.24.0-255,5020,166487,92,186061
1076,0.00221,172.31.47.0-255,66,166553,92,186061
1077,0.002224,172.31.47.0-255,66,166619,92,186061
1078,0.002241,172.31.47.0-255,66,166685,92,186061
1079,0.002252,74.125.24.0-255,1484,168169,92,186061
1080,0.002276,74.125.24.0-255,7156,175325,92,186061
1081,0.002279,172.31.47.0-255,66,175391,92,186061
1082,0.002303,172.31.47.0-255,66,175457,92,186061
1083,0.002313,172.31.47.0-255,66,175523,92,186061
1084,0.002316,74.125.24.0-255,1164,176687,92,186061
1085,0.002345,74.125.24.0-255,105,176792,92,186061
1086,0.004992,172.31.47.0-255,66,176858,92,186061
1087,0.005015,172.31.47.0-255,105,176963,92,186061
1088,0.007539,74.125.24.0-255,66,177029,92,186061
1089,0.032576,172.31.47.0-255,172,177201,92,186061
1090,0.032609,172.31.47.0-255,1112,178313,92,186061
1091,0.032639,172.31.47.0-255,1514,179827,92,186061
1092,0.032641,172.31.47.0-255,1514,181341,92,186061
1093,0.032645,172.31.47.0-255,1514,182855,92,186061
1094,0.032646,172.31.47.0-255,1514,184369,92,186061
1095,0.032673,172.31.47.0-255,1494,185863,92,186061
1096,0.034131,104.244.42.0-255,66,185929,92,186061
1097,0.034174,104.244.42.0-255,66,185995,92,186061
1098,0.03426,104.244.42.0-255,66,186061,92,186061
1099,0.0,74.125.68.0-255,153,153,92,255739
1100,2.1e-05,172.31.47.0-255,66,219,92,255739
1101,2.9e-05,74.125.68.0-255,1484,1703,92,255739
1102,3.3e-05,172.31.47.0-255,66,1769,92,255739
1103,3.9e-05,74.125.68.0-255,2902,4671,92,255739
1104,4.2e-05,172.31.47.0-255,66,4737,92,255739
1105,5e-05,74.125.68.0-255,7156,11893,92,255739
1106,5.3e-05,172.31.47.0-255,66,11959,92,255739
1107,7.9e-05,74.125.68.0-255,1977,13936,92,255739
1108,8.2e-05,172.31.47.0-255,66,14002,92,255739
1109,8.6e-05,74.125.68.0-255,1484,15486,92,255739
1110,8.8e-05,172.31.47.0-255,66,15552,92,255739
1111,0.0001,74.125.68.0-255,1484,17036,92,255739
1112,0.000103,172.31.47.0-255,66,17102,92,255739
1113,0.000111,74.125.68.0-255,7156,24258,92,255739
1114,0.000113,172.31.47.0-255,66,24324,92,255739
1115,0.000119,74.125.68.0-255,5738,30062,92,255739
1116,0.000121,172.31.47.0-255,66,30128,92,255739
1117,0.000145,74.125.68.0-255,1125,31253,92,255739
1118,0.000148,172.31.47.0-255,66,31319,92,255739
1119,0.000201,74.125.68.0-255,1484,32803,92,255739
1120,0.000204,172.31.47.0-255,66,32869,92,255739
1121,0.000207,74.125.68.0-255,1484,34353,92,255739
1122,0.000209,172.31.47.0-255,66,34419,92,255739
1123,0.000224,74.125.68.0-255,1484,35903,92,255739
1124,0.000227,172.31.47.0-255,66,35969,92,255739
1125,0.000231,74.125.68.0-255,2902,38871,92,255739
1126,0.000234,172.31.47.0-255,66,38937,92,255739
1127,0.000259,74.125.68.0-255,2902,41839,92,255739
1128,0.000261,172.31.47.0-255,66,41905,92,255739
1129,0.000268,74.125.68.0-255,6797,48702,92,255739
1130,0.000271,172.31.47.0-255,66,48768,92,255739
1131,0.000601,74.125.68.0-255,1484,50252,92,255739
1132,0.000607,172.31.47.0-255,66,50318,92,255739
1133,0.000613,74.125.68.0-255,2902,53220,92,255739
1134,0.000616,172.31.47.0-255,66,53286,92,255739
1135,0.000622,74.125.68.0-255,5738,59024,92,255739
1136,0.000625,172.31.47.0-255,66,59090,92,255739
1137,0.000629,74.125.68.0-255,2902,61992,92,255739
1138,0.000631,172.31.47.0-255,66,62058,92,255739
1139,0.000685,74.125.68.0-255,4543,66601,92,255739
1140,0.00069,172.31.47.0-255,66,66667,92,255739
1141,0.001276,74.125.68.0-255,1484,68151,92,255739
1142,0.001282,172.31.47.0-255,66,68217,92,255739
1143,0.001292,74.125.68.0-255,2902,71119,92,255739
1144,0.001294,172.31.47.0-255,66,71185,92,255739
1145,0.001315,74.125.68.0-255,4320,75505,92,255739
1146,0.001317,172.31.47.0-255,66,75571,92,255739
1147,0.001324,74.125.68.0-255,5738,81309,92,255739
1148,0.001326,172.31.47.0-255,66,81375,92,255739
1149,0.001351,74.125.68.0-255,4320,85695,92,255739
1150,0.001353,172.31.47.0-255,66,85761,92,255739
1151,0.001377,74.125.68.0-255,5738,91499,92,255739
1152,0.00138,172.31.47.0-255,66,91565,92,255739
1153,0.001398,74.125.68.0-255,1484,93049,92,255739
1154,0.0014,172.31.47.0-255,66,93115,92,255739
1155,0.001408,74.125.68.0-255,5738,98853,92,255739
1156,0.00141,172.31.47.0-255,66,98919,92,255739
1157,0.001415,74.125.68.0-255,2184,101103,92,255739
1158,0.001417,172.31.47.0-255,66,101169,92,255739
1159,0.003687,74.125.68.0-255,5738,106907,92,255739
1160,0.003694,172.31.47.0-255,66,106973,92,255739
1161,0.00599,74.125.68.0-255,2902,109875,92,255739
1162,0.005993,172.31.47.0-255,66,109941,92,255739
1163,0.00601,74.125.68.0-255,2902,112843,92,255739
1164,0.006012,172.31.47.0-255,66,112909,92,255739
1165,0.008287,74.125.68.0-255,5738,118647,92,255739
1166,0.008296,172.31.47.0-255,66,118713,92,255739
1167,0.010595,74.125.68.0-255,5738,124451,92,255739
1168,0.010632,172.31.47.0-255,66,124517,92,255739
1169,0.012927,74.125.68.0-255,5738,130255,92,255739
1170,0.01294,172.31.47.0-255,66,130321,92,255739
1171,0.015237,74.125.68.0-255,5738,136059,92,255739
1172,0.015251,172.31.47.0-255,66,136125,92,255739
1173,0.017533,74.125.68.0-255,5738,141863,92,255739
1174,0.017545,172.31.47.0-255,66,141929,92,255739
1175,0.019866,74.125.68.0-255,5738,147667,92,255739
1176,0.019877,172.31.47.0-255,66,147733,92,255739
1177,0.02218,74.125.68.0-255,5738,153471,92,255739
1178,0.022191,172.31.47.0-255,66,153537,92,255739
1179,0.024472,74.125.68.0-255,5738,159275,92,255739
1180,0.02448,172.31.47.0-255,66,159341,92,255739
1181,0.02677,74.125.68.0-255,5738,165079,92,255739
1182,0.026781,172.31.47.0-255,66,165145,92,255739
1183,0.029082,74.125.68.0-255,5738,170883,92,255739
1184,0.029095,172.31.47.0-255,66,170949,92,255739
1185,0.031399,74.125.68.0-255,5738,176687,92,255739
1186,0.031411,172.31.47.0-255,66,176753,92,255739
1187,0.032666,172.31.47.0-255,172,176925,92,255739
1188,0.032699,172.31.47.0-255,1112,178037,92,255739
1189,0.032764,172.31.47.0-255,1514,179551,92,255739
1190,0.032766,172.31.47.0-255,1514,181065,92,255739
1191,0.032768,172.31.47.0-255,1514,182579,92,255739
1192,0.032769,172.31.47.0-255,1514,184093,92,255739
1193,0.03277,172.31.47.0-255,1494,185587,92,255739
1194,0.033694,74.125.68.0-255,5738,191325,92,255739
1195,0.0337,172.31.47.0-255,66,191391,92,255739
1196,0.034207,104.244.42.0-255,66,191457,92,255739
1197,0.034306,104.244.42.0-255,66,191523,92,255739
1198,0.034351,104.244.42.0-255,66,191589,92,255739
1199,0.035208,104.244.42.0-255,108,191697,92,255739
1200,0.035214,172.31.47.0-255,66,191763,92,255739
1201,0.035979,74.125.68.0-255,4320,196083,92,255739
1202,0.035983,172.31.47.0-255,66,196149,92,255739
1203,0.035997,74.125.68.0-255,1484,197633,92,255739
1204,0.035999,172.31.47.0-255,66,197699,92,255739
1205,0.038297,74.125.68.0-255,5738,203437,92,255739
1206,0.038303,172.31.47.0-255,66,203503,92,255739
1207,0.040585,74.125.68.0-255,5738,209241,92,255739
1208,0.040591,172.31.47.0-255,66,209307,92,255739
1209,0.042866,74.125.68.0-255,5738,215045,92,255739
1210,0.042872,172.31.47.0-255,66,215111,92,255739
1211,0.045164,74.125.68.0-255,5738,220849,92,255739
1212,0.04517,172.31.47.0-255,66,220915,92,255739
1213,0.047461,74.125.68.0-255,5738,226653,92,255739
1214,0.047467,172.31.47.0-255,66,226719,92,255739
1215,0.049758,74.125.68.0-255,5738,232457,92,255739
1216,0.049766,172.31.47.0-255,66,232523,92,255739
1217,0.05209,74.125.68.0-255,5738,238261,92,255739
1218,0.052097,172.31.47.0-255,66,238327,92,255739
1219,0.0544,74.125.68.0-255,5738,244065,92,255739
1220,0.054407,172.31.47.0-255,66,244131,92,255739
1221,0.056697,74.125.68.0-255,5738,249869,92,255739
1222,0.056704,172.31.47.0-255,66,249935,92,255739
1223,0.058994,74.125.68.0-255,5738,255673,92,255739
1224,0.059001,172.31.47.0-255,66,255739,92,255739
1225,0.0,172.217.194.0-255,152,152,92,254326
1226,2.3e-05,172.31.47.0-255,66,218,92,254326
1227,3e-05,172.217.194.0-255,1484,1702,92,254326
1228,3.6e-05,172.31.47.0-255,66,1768,92,254326
1229,4.2e-05,172.217.194.0-255,2902,4670,92,254326
1230,5.4e-05,172.31.47.0-255,66,4736,92,254326
1231,6.3e-05,172.217.194.0-255,7156,11892,92,254326
1232,6.6e-05,172.31.47.0-255,66,11958,92,254326
1233,7.2e-05,172.217.194.0-255,4320,16278,92,254326
1234,7.5e-05,172.31.47.0-255,66,16344,92,254326
1235,0.000104,172.217.194.0-255,3482,19826,92,254326
1236,0.000108,172.31.47.0-255,66,19892,92,254326
1237,0.00012,172.31.47.0-255,66,19958,92,254326
1238,0.000141,172.217.194.0-255,2543,22501,92,254326
1239,0.000144,172.31.47.0-255,66,22567,92,254326
1240,0.000229,172.217.194.0-255,1484,24051,92,254326
1241,0.000234,172.31.47.0-255,66,24117,92,254326
1242,0.000239,172.217.194.0-255,2902,27019,92,254326
1243,0.000242,172.31.47.0-255,66,27085,92,254326
1244,0.000262,172.217.194.0-255,5738,32823,92,254326
1245,0.000266,172.31.47.0-255,66,32889,92,254326
1246,0.000276,172.217.194.0-255,5738,38627,92,254326
1247,0.000278,172.31.47.0-255,66,38693,92,254326
1248,0.000283,172.217.194.0-255,4320,43013,92,254326
1249,0.000285,172.31.47.0-255,66,43079,92,254326
1250,0.000328,172.31.47.0-255,66,43145,92,254326
1251,0.000334,172.217.194.0-255,5332,48477,92,254326
1252,0.000337,172.31.47.0-255,66,48543,92,254326
1253,0.000357,172.217.194.0-255,98,48641,92,254326
1254,0.000359,172.31.47.0-255,66,48707,92,254326
1255,0.000544,172.217.194.0-255,1484,50191,92,254326
1256,0.000553,172.217.194.0-255,2902,53093,92,254326
1257,0.000558,172.31.47.0-255,66,53159,92,254326
1258,0.000566,172.217.194.0-255,5738,58897,92,254326
1259,0.000568,172.31.47.0-255,66,58963,92,254326
1260,0.000597,172.217.194.0-255,2902,61865,92,254326
1261,0.0006,172.31.47.0-255,66,61931,92,254326
1262,0.00062,172.217.194.0-255,7156,69087,92,254326
1263,0.000623,172.31.47.0-255,66,69153,92,254326
1264,0.000627,172.217.194.0-255,2902,72055,92,254326
1265,0.000629,172.31.47.0-255,66,72121,92,254326
1266,0.000675,172.31.47.0-255,66,72187,92,254326
1267,0.000837,172.217.194.0-255,364,72551,92,254326
1268,0.000898,172.217.194.0-255,1484,74035,92,254326
1269,0.000903,172.31.47.0-255,66,74101,92,254326
1270,0.000909,172.217.194.0-255,2902,77003,92,254326
1271,0.000911,172.31.47.0-255,66,77069,92,254326
1272,0.000948,172.217.194.0-255,5738,82807,92,254326
1273,0.000956,172.217.194.0-255,7156,89963,92,254326
1274,0.000961,172.31.47.0-255,66,90029,92,254326
1275,0.000964,172.31.47.0-255,66,90095,92,254326
1276,0.000999,172.31.47.0-255,66,90161,92,254326
1277,0.001002,172.217.194.0-255,589,90750,92,254326
1278,0.001042,172.217.194.0-255,5738,96488,92,254326
1279,0.001045,172.31.47.0-255,66,96554,92,254326
1280,0.001078,172.217.194.0-255,4320,100874,92,254326
1281,0.001081,172.31.47.0-255,66,100940,92,254326
1282,0.001094,172.31.47.0-255,66,101006,92,254326
1283,0.001097,172.217.194.0-255,1484,102490,92,254326
1284,0.00113,172.31.47.0-255,66,102556,92,254326
1285,0.001174,172.217.194.0-255,1484,104040,92,254326
1286,0.001178,172.217.194.0-255,2902,106942,92,254326
1287,0.00118,172.31.47.0-255,66,107008,92,254326
1288,0.001202,172.217.194.0-255,5738,112746,92,254326
1289,0.001205,172.31.47.0-255,66,112812,92,254326
1290,0.001242,172.217.194.0-255,5738,118550,92,254326
1291,0.001245,172.31.47.0-255,66,118616,92,254326
1292,0.001266,172.217.194.0-255,7156,125772,92,254326
1293,0.001269,172.31.47.0-255,66,125838,92,254326
1294,0.001306,172.31.47.0-255,66,125904,92,254326
1295,0.001359,172.217.194.0-255,1484,127388,92,254326
1296,0.001362,172.217.194.0-255,1484,128872,92,254326
1297,0.001365,172.31.47.0-255,66,128938,92,254326
1298,0.001386,172.217.194.0-255,1484,130422,92,254326
1299,0.001392,172.217.194.0-255,5738,136160,92,254326
1300,0.001395,172.31.47.0-255,66,136226,92,254326
1301,0.001402,172.217.194.0-255,7156,143382,92,254326
1302,0.001404,172.31.47.0-255,66,143448,92,254326
1303,0.001441,172.31.47.0-255,66,143514,92,254326
1304,0.001445,172.217.194.0-255,2184,145698,92,254326
1305,0.001448,172.31.47.0-255,66,145764,92,254326
1306,0.001876,172.217.194.0-255,1484,147248,92,254326
1307,0.001883,172.217.194.0-255,2902,150150,92,254326
1308,0.001887,172.31.47.0-255,66,150216,92,254326
1309,0.001894,172.217.194.0-255,4320,154536,92,254326
1310,0.001896,172.31.47.0-255,66,154602,92,254326
1311,0.001917,172.217.194.0-255,1484,156086,92,254326
1312,0.001928,172.217.194.0-255,5738,161824,92,254326
1313,0.00193,172.31.47.0-255,66,161890,92,254326
1314,0.00195,172.217.194.0-255,2902,164792,92,254326
1315,0.001953,172.31.47.0-255,66,164858,92,254326
1316,0.001983,172.31.47.0-255,66,164924,92,254326
1317,0.001988,172.217.194.0-255,5020,169944,92,254326
1318,0.00199,172.31.47.0-255,66,170010,92,254326
1319,0.00206,172.217.194.0-255,1484,171494,92,254326
1320,0.002066,172.217.194.0-255,2902,174396,92,254326
1321,0.002069,172.31.47.0-255,66,174462,92,254326
1322,0.002105,172.217.194.0-255,5738,180200,92,254326
1323,0.002109,172.31.47.0-255,66,180266,92,254326
1324,0.00212,172.31.47.0-255,66,180332,92,254326
1325,0.002153,172.217.194.0-255,4320,184652,92,254326
1326,0.002157,172.31.47.0-255,66,184718,92,254326
1327,0.002176,172.31.47.0-255,66,184784,92,254326
1328,0.002192,172.31.47.0-255,66,184850,92,254326
1329,0.002213,172.217.194.0-255,2902,187752,92,254326
1330,0.002215,172.31.47.0-255,66,187818,92,254326
1331,0.002265,172.31.47.0-255,66,187884,92,254326
1332,0.002277,172.31.47.0-255,66,187950,92,254326
1333,0.004481,172.217.194.0-255,5738,193688,92,254326
1334,0.004486,172.31.47.0-255,66,193754,92,254326
1335,0.006718,172.217.194.0-255,5738,199492,92,254326
1336,0.006723,172.31.47.0-255,66,199558,92,254326
1337,0.00894,172.217.194.0-255,5738,205296,92,254326
1338,0.008945,172.31.47.0-255,66,205362,92,254326
1339,0.011188,172.217.194.0-255,5738,211100,92,254326
1340,0.011192,172.31.47.0-255,66,211166,92,254326
1341,0.013614,172.217.194.0-255,5738,216904,92,254326
1342,0.013657,172.31.47.0-255,66,216970,92,254326
1343,0.015901,172.217.194.0-255,5738,222708,92,254326
1344,0.01591,172.31.47.0-255,66,222774,92,254326
1345,0.01816,172.217.194.0-255,5738,228512,92,254326
1346,0.018169,172.31.47.0-255,66,228578,92,254326
1347,0.020451,172.217.194.0-255,5738,234316,92,254326
1348,0.02046,172.31.47.0-255,66,234382,92,254326
1349,0.022692,172.217.194.0-255,5738,240120,92,254326
1350,0.022698,172.31.47.0-255,66,240186,92,254326
1351,0.024949,172.217.194.0-255,4869,245055,92,254326
1352,0.024955,172.31.47.0-255,66,245121,92,254326
1353,0.025139,172.31.47.0-255,105,245226,92,254326
1354,0.027329,172.217.194.0-255,66,245292,92,254326
1355,0.030354,172.31.47.0-255,172,245464,92,254326
1356,0.030382,172.31.47.0-255,1107,246571,92,254326
1357,0.030451,172.31.47.0-255,1514,248085,92,254326
1358,0.030453,172.31.47.0-255,1514,249599,92,254326
1359,0.030454,172.31.47.0-255,1514,251113,92,254326
1360,0.030455,172.31.47.0-255,1514,252627,92,254326
1361,0.030478,172.31.47.0-255,1501,254128,92,254326
1362,0.031906,104.244.42.0-255,66,254194,92,254326
1363,0.03193,104.244.42.0-255,66,254260,92,254326
1364,0.031995,104.244.42.0-255,66,254326,92,254326
1365,0.0,74.125.24.0-255,153,153,92,195439
1366,2.3e-05,172.31.47.0-255,66,219,92,195439
1367,3e-05,74.125.24.0-255,1484,1703,92,195439
1368,3.4e-05,172.31.47.0-255,66,1769,92,195439
1369,3.9e-05,74.125.24.0-255,2902,4671,92,195439
1370,4.2e-05,172.31.47.0-255,66,4737,92,195439
1371,5.5e-05,74.125.24.0-255,7156,11893,92,195439
1372,5.9e-05,172.31.47.0-255,66,11959,92,195439
1373,9.6e-05,172.31.47.0-255,66,12025,92,195439
1374,0.000121,74.125.24.0-255,2173,14198,92,195439
1375,0.000123,172.31.47.0-255,66,14264,92,195439
1376,0.000135,172.31.47.0-255,66,14330,92,195439
1377,0.000148,74.125.24.0-255,4320,18650,92,195439
1378,0.00015,172.31.47.0-255,66,18716,92,195439
1379,0.000177,74.125.24.0-255,6438,25154,92,195439
1380,0.000179,172.31.47.0-255,66,25220,92,195439
1381,0.000199,74.125.24.0-255,7156,32376,92,195439
1382,0.000202,172.31.47.0-255,66,32442,92,195439
1383,0.000226,172.31.47.0-255,66,32508,92,195439
1384,0.000327,74.125.24.0-255,115,32623,92,195439
1385,0.000331,172.31.47.0-255,66,32689,92,195439
1386,0.000366,74.125.24.0-255,1484,34173,92,195439
1387,0.000368,172.31.47.0-255,66,34239,92,195439
1388,0.000373,74.125.24.0-255,2902,37141,92,195439
1389,0.000375,172.31.47.0-255,66,37207,92,195439
1390,0.000416,74.125.24.0-255,2902,40109,92,195439
1391,0.000418,172.31.47.0-255,66,40175,92,195439
1392,0.000445,74.125.24.0-255,4320,44495,92,195439
1393,0.000447,172.31.47.0-255,66,44561,92,195439
1394,0.000453,74.125.24.0-255,7156,51717,92,195439
1395,0.000455,172.31.47.0-255,66,51783,92,195439
1396,0.000487,74.125.24.0-255,4320,56103,92,195439
1397,0.000954,172.31.47.0-255,66,56169,92,195439
1398,0.001,74.125.24.0-255,1484,57653,92,195439
1399,0.001021,74.125.24.0-255,2902,60555,92,195439
1400,0.001043,74.125.24.0-255,5738,66293,92,195439
1401,0.001047,74.125.24.0-255,1484,67777,92,195439
1402,0.001088,74.125.24.0-255,1484,69261,92,195439
1403,0.001093,74.125.24.0-255,4320,73581,92,195439
1404,0.001122,74.125.24.0-255,2902,76483,92,195439
1405,0.001141,74.125.24.0-255,3602,80085,92,195439
1406,0.001248,172.31.47.0-255,66,80151,92,195439
1407,0.001295,74.125.24.0-255,1484,81635,92,195439
1408,0.001301,74.125.24.0-255,2902,84537,92,195439
1409,0.001314,172.31.47.0-255,66,84603,92,195439
1410,0.001321,74.125.24.0-255,5738,90341,92,195439
1411,0.001371,74.125.24.0-255,1484,91825,92,195439
1412,0.001374,172.31.47.0-255,66,91891,92,195439
1413,0.001404,74.125.24.0-255,5738,97629,92,195439
1414,0.00142,74.125.24.0-255,2184,99813,92,195439
1415,0.001441,172.31.47.0-255,66,99879,92,195439
1416,0.00154,74.125.24.0-255,1484,101363,92,195439
1417,0.00156,74.125.24.0-255,2902,104265,92,195439
1418,0.001567,74.125.24.0-255,5738,110003,92,195439
1419,0.001588,74.125.24.0-255,4320,114323,92,195439
1420,0.001602,172.31.47.0-255,66,114389,92,195439
1421,0.001628,172.31.47.0-255,66,114455,92,195439
1422,0.001664,172.31.47.0-255,66,114521,92,195439
1423,0.001766,74.125.24.0-255,1484,116005,92,195439
1424,0.001786,74.125.24.0-255,2902,118907,92,195439
1425,0.001793,74.125.24.0-255,5738,124645,92,195439
1426,0.0018,172.31.47.0-255,66,124711,92,195439
1427,0.001851,74.125.24.0-255,7156,131867,92,195439
1428,0.001858,172.31.47.0-255,66,131933,92,195439
1429,0.001877,74.125.24.0-255,3602,135535,92,195439
1430,0.001897,74.125.24.0-255,2902,138437,92,195439
1431,0.001919,74.125.24.0-255,7156,145593,92,195439
1432,0.001925,172.31.47.0-255,66,145659,92,195439
1433,0.001974,74.125.24.0-255,1484,147143,92,195439
1434,0.001988,172.31.47.0-255,66,147209,92,195439
1435,0.001993,74.125.24.0-255,4320,151529,92,195439
1436,0.001998,172.31.47.0-255,66,151595,92,195439
1437,0.00202,74.125.24.0-255,5738,157333,92,195439
1438,0.002049,172.31.47.0-255,66,157399,92,195439
1439,0.002053,172.31.47.0-255,66,157465,92,195439
1440,0.002102,74.125.24.0-255,7156,164621,92,195439
1441,0.002138,172.31.47.0-255,66,164687,92,195439
1442,0.002204,172.31.47.0-255,66,164753,92,195439
1443,0.002284,172.31.47.0-255,66,164819,92,195439
1444,0.002327,74.125.24.0-255,4320,169139,92,195439
1445,0.002336,172.31.47.0-255,66,169205,92,195439
1446,0.002348,74.125.24.0-255,7156,176361,92,195439
1447,0.002358,172.31.47.0-255,66,176427,92,195439
1448,0.002405,172.31.47.0-255,66,176493,92,195439
1449,0.002441,172.31.47.0-255,66,176559,92,195439
1450,0.002526,74.125.24.0-255,7156,183715,92,195439
1451,0.002558,172.31.47.0-255,66,183781,92,195439
1452,0.002568,74.125.24.0-255,3182,186963,92,195439
1453,0.002575,74.125.24.0-255,105,187068,92,195439
1454,0.002597,172.31.47.0-255,66,187134,92,195439
1455,0.004986,172.31.47.0-255,105,187239,92,195439
1456,0.007168,74.125.24.0-255,66,187305,92,195439
1457,0.02971,172.31.47.0-255,172,187477,92,195439
1458,0.029746,172.31.47.0-255,1111,188588,92,195439
1459,0.029817,172.31.47.0-255,1514,190102,92,195439
1460,0.029819,172.31.47.0-255,1514,191616,92,195439
1461,0.02982,172.31.47.0-255,1514,193130,92,195439
1462,0.029821,172.31.47.0-255,1514,194644,92,195439
1463,0.029822,172.31.47.0-255,531,195175,92,195439
1464,0.031268,104.244.42.0-255,66,195241,92,195439
1465,0.031316,104.244.42.0-255,66,195307,92,195439
1466,0.031416,104.244.42.0-255,66,195373,92,195439
1467,0.031418,104.244.42.0-255,66,195439,92,195439
1468,0.0,172.31.47.0-255,105,105,92,276
1469,0.002095,157.240.13.0-255,105,210,92,276
1470,0.002106,172.31.47.0-255,66,276,92,276
1471,0.0,74.125.24.0-255,153,153,92,218712
1472,2.5e-05,172.31.47.0-255,66,219,92,218712
1473,3.1e-05,74.125.24.0-255,1484,1703,92,218712
1474,3.5e-05,172.31.47.0-255,66,1769,92,218712
1475,3.9e-05,74.125.24.0-255,2902,4671,92,218712
1476,4.9e-05,172.31.47.0-255,66,4737,92,218712
1477,5.4e-05,74.125.24.0-255,2902,7639,92,218712
1478,5.6e-05,172.31.47.0-255,66,7705,92,218712
1479,6.6e-05,74.125.24.0-255,1484,9189,92,218712
1480,7e-05,172.31.47.0-255,66,9255,92,218712
1481,0.000106,74.125.24.0-255,5090,14345,92,218712
1482,0.00011,172.31.47.0-255,66,14411,92,218712
1483,0.000138,74.125.24.0-255,5738,20149,92,218712
1484,0.00014,172.31.47.0-255,66,20215,92,218712
1485,0.00016,74.125.24.0-255,4320,24535,92,218712
1486,0.000162,172.31.47.0-255,66,24601,92,218712
1487,0.000187,74.125.24.0-255,6797,31398,92,218712
1488,0.00019,172.31.47.0-255,66,31464,92,218712
1489,0.000315,74.125.24.0-255,1484,32948,92,218712
1490,0.000319,172.31.47.0-255,66,33014,92,218712
1491,0.000323,74.125.24.0-255,2902,35916,92,218712
1492,0.000326,172.31.47.0-255,66,35982,92,218712
1493,0.000331,74.125.24.0-255,5738,41720,92,218712
1494,0.000348,172.31.47.0-255,66,41786,92,218712
1495,0.000381,172.31.47.0-255,66,41852,92,218712
1496,0.000413,74.125.24.0-255,2902,44754,92,218712
1497,0.000416,172.31.47.0-255,66,44820,92,218712
1498,0.00045,172.31.47.0-255,66,44886,92,218712
1499,0.000453,74.125.24.0-255,382,45268,92,218712
1500,0.000455,172.31.47.0-255,66,45334,92,218712
1501,0.000601,74.125.24.0-255,1484,46818,92,218712
1502,0.000613,74.125.24.0-255,2902,49720,92,218712
1503,0.000616,172.31.47.0-255,66,49786,92,218712
1504,0.000628,74.125.24.0-255,2902,52688,92,218712
1505,0.000634,172.31.47.0-255,66,52754,92,218712
1506,0.000664,74.125.24.0-255,2902,55656,92,218712
1507,0.000667,172.31.47.0-255,66,55722,92,218712
1508,0.00068,172.31.47.0-255,66,55788,92,218712
1509,0.000691,74.125.24.0-255,5738,61526,92,218712
1510,0.000694,172.31.47.0-255,66,61592,92,218712
1511,0.000719,74.125.24.0-255,1484,63076,92,218712
1512,0.000755,172.31.47.0-255,66,63142,92,218712
1513,0.000783,74.125.24.0-255,3961,67103,92,218712
1514,0.000786,172.31.47.0-255,66,67169,92,218712
1515,0.000964,74.125.24.0-255,1484,68653,92,218712
1516,0.00099,74.125.24.0-255,2902,71555,92,218712
1517,0.000993,172.31.47.0-255,66,71621,92,218712
1518,0.001,74.125.24.0-255,5738,77359,92,218712
1519,0.001002,172.31.47.0-255,66,77425,92,218712
1520,0.001046,172.31.47.0-255,66,77491,92,218712
1521,0.001053,74.125.24.0-255,7156,84647,92,218712
1522,0.001055,172.31.47.0-255,66,84713,92,218712
1523,0.001141,172.31.47.0-255,66,84779,92,218712
1524,0.001173,172.31.47.0-255,66,84845,92,218712
1525,0.001179,74.125.24.0-255,3602,88447,92,218712
1526,0.001181,172.31.47.0-255,66,88513,92,218712
1527,0.001185,74.125.24.0-255,4320,92833,92,218712
1528,0.001187,172.31.47.0-255,66,92899,92,218712
1529,0.001192,74.125.24.0-255,4320,97219,92,218712
1530,0.001195,172.31.47.0-255,66,97285,92,218712
1531,0.001225,74.125.24.0-255,1484,98769,92,218712
1532,0.00123,74.125.24.0-255,2902,101671,92,218712
1533,0.001233,172.31.47.0-255,66,101737,92,218712
1534,0.001252,74.125.24.0-255,3961,105698,92,218712
1535,0.001256,172.31.47.0-255,66,105764,92,218712
1536,0.00131,74.125.24.0-255,1484,107248,92,218712
1537,0.001316,74.125.24.0-255,2902,110150,92,218712
1538,0.001318,172.31.47.0-255,66,110216,92,218712
1539,0.001324,74.125.24.0-255,4320,114536,92,218712
1540,0.001327,172.31.47.0-255,66,114602,92,218712
1541,0.00135,74.125.24.0-255,1484,116086,92,218712
1542,0.00136,74.125.24.0-255,4320,120406,92,218712
1543,0.001364,172.31.47.0-255,66,120472,92,218712
1544,0.001377,172.31.47.0-255,66,120538,92,218712
1545,0.001383,74.125.24.0-255,4320,124858,92,218712
1546,0.001385,172.31.47.0-255,66,124924,92,218712
1547,0.001416,74.125.24.0-255,3602,128526,92,218712
1548,0.001419,172.31.47.0-255,66,128592,92,218712
1549,0.00143,172.31.47.0-255,66,128658,92,218712
1550,0.001474,172.31.47.0-255,66,128724,92,218712
1551,0.001497,74.125.24.0-255,7156,135880,92,218712
1552,0.001501,172.31.47.0-255,66,135946,92,218712
1553,0.001531,74.125.24.0-255,3602,139548,92,218712
1554,0.001534,172.31.47.0-255,66,139614,92,218712
1555,0.001549,74.125.24.0-255,1484,141098,92,218712
1556,0.00157,74.125.24.0-255,2902,144000,92,218712
1557,0.001572,172.31.47.0-255,66,144066,92,218712
1558,0.001578,74.125.24.0-255,5738,149804,92,218712
1559,0.001581,172.31.47.0-255,66,149870,92,218712
1560,0.001585,74.125.24.0-255,2902,152772,92,218712
1561,0.001587,172.31.47.0-255,66,152838,92,218712
1562,0.001619,74.125.24.0-255,7156,159994,92,218712
1563,0.001623,172.31.47.0-255,66,160060,92,218712
1564,0.001628,74.125.24.0-255,4320,164380,92,218712
1565,0.00163,172.31.47.0-255,66,164446,92,218712
1566,0.001673,172.31.47.0-255,66,164512,92,218712
1567,0.001718,74.125.24.0-255,1484,165996,92,218712
1568,0.001744,74.125.24.0-255,2902,168898,92,218712
1569,0.001746,172.31.47.0-255,66,168964,92,218712
1570,0.001768,74.125.24.0-255,5738,174702,92,218712
1571,0.001771,172.31.47.0-255,66,174768,92,218712
1572,0.001774,74.125.24.0-255,2902,177670,92,218712
1573,0.001776,172.31.47.0-255,66,177736,92,218712
1574,0.001808,74.125.24.0-255,4320,182056,92,218712
1575,0.00181,172.31.47.0-255,66,182122,92,218712
1576,0.001818,172.31.47.0-255,66,182188,92,218712
1577,0.001848,74.125.24.0-255,1484,183672,92,218712
1578,0.00187,74.125.24.0-255,6438,190110,92,218712
1579,0.001872,172.31.47.0-255,66,190176,92,218712
1580,0.001896,74.125.24.0-255,1484,191660,92,218712
1581,0.001908,74.125.24.0-255,2902,194562,92,218712
1582,0.00191,172.31.47.0-255,66,194628,92,218712
1583,0.001913,74.125.24.0-255,1484,196112,92,218712
1584,0.001934,74.125.24.0-255,4320,200432,92,218712
1585,0.001935,172.31.47.0-255,66,200498,92,218712
1586,0.001945,172.31.47.0-255,66,200564,92,218712
1587,0.00196,172.31.47.0-255,66,200630,92,218712
1588,0.001976,74.125.24.0-255,1484,202114,92,218712
1589,0.00201,172.31.47.0-255,66,202180,92,218712
1590,0.002033,74.125.24.0-255,4320,206500,92,218712
1591,0.002035,172.31.47.0-255,66,206566,92,218712
1592,0.002053,172.31.47.0-255,66,206632,92,218712
1593,0.002062,172.31.47.0-255,66,206698,92,218712
1594,0.002087,74.125.24.0-255,2400,209098,92,218712
1595,0.002089,172.31.47.0-255,66,209164,92,218712
1596,0.002114,74.125.24.0-255,105,209269,92,218712
1597,0.008456,172.31.47.0-255,66,209335,92,218712
1598,0.008479,172.31.47.0-255,105,209440,92,218712
1599,0.011051,74.125.24.0-255,66,209506,92,218712
1600,0.028312,172.31.47.0-255,172,209678,92,218712
1601,0.028338,172.31.47.0-255,1107,210785,92,218712
1602,0.02838,172.31.47.0-255,1514,212299,92,218712
1603,0.028381,172.31.47.0-255,1514,213813,92,218712
1604,0.028382,172.31.47.0-255,1514,215327,92,218712
1605,0.028383,172.31.47.0-255,1514,216841,92,218712
1606,0.028412,172.31.47.0-255,1499,218340,92,218712
1607,0.029826,104.244.42.0-255,66,218406,92,218712
1608,0.029835,104.244.42.0-255,66,218472,92,218712
1609,0.029899,104.244.42.0-255,66,218538,92,218712
1610,0.030578,104.244.42.0-255,108,218646,92,218712
1611,0.030585,172.31.47.0-255,66,218712,92,218712
1612,0.0,172.217.194.0-255,153,153,92,205549
1613,2.9e-05,172.31.47.0-255,66,219,92,205549
1614,3.6e-05,172.217.194.0-255,1484,1703,92,205549
1615,4.1e-05,172.31.47.0-255,66,1769,92,205549
1616,5.2e-05,172.217.194.0-255,2902,4671,92,205549
1617,5.5e-05,172.31.47.0-255,66,4737,92,205549
1618,6.1e-05,172.217.194.0-255,5738,10475,92,205549
1619,6.3e-05,172.31.47.0-255,66,10541,92,205549
1620,0.000103,172.31.47.0-255,66,10607,92,205549
1621,0.000135,172.31.47.0-255,66,10673,92,205549
1622,0.000158,172.217.194.0-255,1484,12157,92,205549
1623,0.00016,172.31.47.0-255,66,12223,92,205549
1624,0.000187,172.217.194.0-255,2902,15125,92,205549
1625,0.00019,172.31.47.0-255,66,15191,92,205549
1626,0.000196,172.217.194.0-255,5738,20929,92,205549
1627,0.000199,172.31.47.0-255,66,20995,92,205549
1628,0.000229,172.217.194.0-255,6797,27792,92,205549
1629,0.000232,172.31.47.0-255,66,27858,92,205549
1630,0.000238,172.217.194.0-255,7156,35014,92,205549
1631,0.00024,172.31.47.0-255,66,35080,92,205549
1632,0.000296,172.31.47.0-255,66,35146,92,205549
1633,0.000299,172.217.194.0-255,363,35509,92,205549
1634,0.000303,172.31.47.0-255,66,35575,92,205549
1635,0.000446,172.217.194.0-255,381,35956,92,205549
1636,0.000449,172.31.47.0-255,66,36022,92,205549
1637,0.000545,172.217.194.0-255,1484,37506,92,205549
1638,0.000549,172.31.47.0-255,66,37572,92,205549
1639,0.000567,172.217.194.0-255,2902,40474,92,205549
1640,0.00057,172.31.47.0-255,66,40540,92,205549
1641,0.000576,172.217.194.0-255,5738,46278,92,205549
1642,0.000578,172.31.47.0-255,66,46344,92,205549
1643,0.000582,172.217.194.0-255,2902,49246,92,205549
1644,0.000583,172.31.47.0-255,66,49312,92,205549
1645,0.000603,172.31.47.0-255,66,49378,92,205549
1646,0.000645,172.31.47.0-255,66,49444,92,205549
1647,0.000685,172.217.194.0-255,1484,50928,92,205549
1648,0.000695,172.217.194.0-255,2902,53830,92,205549
1649,0.000701,172.31.47.0-255,66,53896,92,205549
1650,0.000727,172.217.194.0-255,5738,59634,92,205549
1651,0.00073,172.31.47.0-255,66,59700,92,205549
1652,0.000735,172.217.194.0-255,5738,65438,92,205549
1653,0.000746,172.217.194.0-255,7156,72594,92,205549
1654,0.000745,172.31.47.0-255,66,72660,92,205549
1655,0.000761,172.31.47.0-255,66,72726,92,205549
1656,0.000777,172.217.194.0-255,2902,75628,92,205549
1657,0.000781,172.31.47.0-255,66,75694,92,205549
1658,0.000818,172.31.47.0-255,66,75760,92,205549
1659,0.00125,172.217.194.0-255,1484,77244,92,205549
1660,0.001275,172.217.194.0-255,2902,80146,92,205549
1661,0.001279,172.31.47.0-255,66,80212,92,205549
1662,0.001284,172.217.194.0-255,4320,84532,92,205549
1663,0.001286,172.31.47.0-255,66,84598,92,205549
1664,0.001317,172.217.194.0-255,1484,86082,92,205549
1665,0.001322,172.217.194.0-255,1484,87566,92,205549
1666,0.001325,172.31.47.0-255,66,87632,92,205549
1667,0.001336,172.31.47.0-255,66,87698,92,205549
1668,0.00135,172.31.47.0-255,66,87764,92,205549
1669,0.001382,172.217.194.0-255,1484,89248,92,205549
1670,0.001387,172.217.194.0-255,2902,92150,92,205549
1671,0.001389,172.31.47.0-255,66,92216,92,205549
1672,0.001393,172.217.194.0-255,1484,93700,92,205549
1673,0.001418,172.217.194.0-255,4320,98020,92,205549
1674,0.001421,172.31.47.0-255,66,98086,92,205549
1675,0.001426,172.217.194.0-255,2902,100988,92,205549
1676,0.001428,172.31.47.0-255,66,101054,92,205549
1677,0.00147,172.217.194.0-255,4320,105374,92,205549
1678,0.001495,172.217.194.0-255,4320,109694,92,205549
1679,0.001511,172.217.194.0-255,2184,111878,92,205549
1680,0.001568,172.217.194.0-255,1484,113362,92,205549
1681,0.001573,172.217.194.0-255,2902,116264,92,205549
1682,0.001594,172.217.194.0-255,5738,122002,92,205549
1683,0.001641,172.217.194.0-255,4320,126322,92,205549
1684,0.001662,172.217.194.0-255,6438,132760,92,205549
1685,0.001728,172.217.194.0-255,1484,134244,92,205549
1686,0.001733,172.217.194.0-255,1484,135728,92,205549
1687,0.001746,172.217.194.0-255,1484,137212,92,205549
1688,0.001752,172.217.194.0-255,5738,142950,92,205549
1689,0.001772,172.217.194.0-255,7156,150106,92,205549
1690,0.001801,172.217.194.0-255,5738,155844,92,205549
1691,0.001833,172.217.194.0-255,1484,157328,92,205549
1692,0.00185,172.217.194.0-255,2902,160230,92,205549
1693,0.001854,172.217.194.0-255,2902,163132,92,205549
1694,0.001868,172.217.194.0-255,2902,166034,92,205549
1695,0.001879,172.217.194.0-255,2902,168936,92,205549
1696,0.001909,172.217.194.0-255,4320,173256,92,205549
1697,0.001924,172.217.194.0-255,4320,177576,92,205549
1698,0.001937,172.217.194.0-255,4320,181896,92,205549
1699,0.001988,172.217.194.0-255,2184,184080,92,205549
1700,0.00202,172.217.194.0-255,7156,191236,92,205549
1701,0.002062,172.217.194.0-255,5738,196974,92,205549
1702,0.002172,172.217.194.0-255,97,197071,92,205549
1703,0.002174,172.217.194.0-255,105,197176,92,205549
1704,0.005629,172.31.47.0-255,66,197242,92,205549
1705,0.007853,172.31.47.0-255,105,197347,92,205549
1706,0.010114,172.217.194.0-255,66,197413,92,205549
1707,0.025465,172.31.47.0-255,172,197585,92,205549
1708,0.025493,172.31.47.0-255,1107,198692,92,205549
1709,0.025529,172.31.47.0-255,1514,200206,92,205549
1710,0.025531,172.31.47.0-255,1514,201720,92,205549
1711,0.025531,172.31.47.0-255,1514,203234,92,205549
1712,0.025532,172.31.47.0-255,1514,204748,92,205549
1713,0.025533,172.31.47.0-255,537,205285,92,205549
1714,0.027005,104.244.42.0-255,66,205351,92,205549
1715,0.027013,104.244.42.0-255,66,205417,92,205549
1716,0.02705,104.244.42.0-255,66,205483,92,205549
1717,0.027052,104.244.42.0-255,66,205549,92,205549
1718,0.0,74.125.68.0-255,153,153,92,372145
1719,1.2e-05,172.31.47.0-255,66,219,92,372145
1720,1.7e-05,74.125.68.0-255,1484,1703,92,372145
1721,2.2e-05,172.31.47.0-255,66,1769,92,372145
1722,5.3e-05,74.125.68.0-255,2902,4671,92,372145
1723,5.7e-05,172.31.47.0-255,66,4737,92,372145
1724,6.4e-05,74.125.68.0-255,7156,11893,92,372145
1725,6.7e-05,172.31.47.0-255,66,11959,92,372145
1726,9.4e-05,74.125.68.0-255,3447,15406,92,372145
1727,9.6e-05,172.31.47.0-255,66,15472,92,372145
1728,0.000102,74.125.68.0-255,4320,19792,92,372145
1729,0.000104,172.31.47.0-255,66,19858,92,372145
1730,0.000132,74.125.68.0-255,4320,24178,92,372145
1731,0.000135,172.31.47.0-255,66,24244,92,372145
1732,0.000155,74.125.68.0-255,5738,29982,92,372145
1733,0.000157,172.31.47.0-255,66,30048,92,372145
1734,0.00016,74.125.68.0-255,1125,31173,92,372145
1735,0.000162,172.31.47.0-255,66,31239,92,372145
1736,0.000229,74.125.68.0-255,1484,32723,92,372145
1737,0.000233,172.31.47.0-255,66,32789,92,372145
1738,0.000243,74.125.68.0-255,2902,35691,92,372145
1739,0.000245,172.31.47.0-255,66,35757,92,372145
1740,0.000274,74.125.68.0-255,5738,41495,92,372145
1741,0.000276,172.31.47.0-255,66,41561,92,372145
1742,0.000308,74.125.68.0-255,6797,48358,92,372145
1743,0.00031,172.31.47.0-255,66,48424,92,372145
1744,0.000315,74.125.68.0-255,4320,52744,92,372145
1745,0.000317,172.31.47.0-255,66,52810,92,372145
1746,0.000342,74.125.68.0-255,2902,55712,92,372145
1747,0.000345,172.31.47.0-255,66,55778,92,372145
1748,0.00036,172.31.47.0-255,66,55844,92,372145
1749,0.000363,74.125.68.0-255,108,55952,92,372145
1750,0.000367,74.125.68.0-255,332,56284,92,372145
1751,0.000556,74.125.68.0-255,1484,57768,92,372145
1752,0.000561,74.125.68.0-255,2902,60670,92,372145
1753,0.000566,172.31.47.0-255,66,60736,92,372145
1754,0.000571,172.31.47.0-255,66,60802,92,372145
1755,0.000582,74.125.68.0-255,5738,66540,92,372145
1756,0.000584,172.31.47.0-255,66,66606,92,372145
1757,0.000593,74.125.68.0-255,2902,69508,92,372145
1758,0.000595,172.31.47.0-255,66,69574,92,372145
1759,0.0006,74.125.68.0-255,2902,72476,92,372145
1760,0.000603,172.31.47.0-255,66,72542,92,372145
1761,0.00063,74.125.68.0-255,1484,74026,92,372145
1762,0.000646,172.31.47.0-255,66,74092,92,372145
1763,0.000652,74.125.68.0-255,5738,79830,92,372145
1764,0.000654,172.31.47.0-255,66,79896,92,372145
1765,0.000684,74.125.68.0-255,2184,82080,92,372145
1766,0.000687,172.31.47.0-255,66,82146,92,372145
1767,0.0008,74.125.68.0-255,1484,83630,92,372145
1768,0.000804,74.125.68.0-255,1484,85114,92,372145
1769,0.000807,172.31.47.0-255,66,85180,92,372145
1770,0.000833,74.125.68.0-255,1484,86664,92,372145
1771,0.00084,74.125.68.0-255,5738,92402,92,372145
1772,0.000842,172.31.47.0-255,66,92468,92,372145
1773,0.000848,74.125.68.0-255,4320,96788,92,372145
1774,0.00085,172.31.47.0-255,66,96854,92,372145
1775,0.000885,74.125.68.0-255,5738,102592,92,372145
1776,0.000897,172.31.47.0-255,66,102658,92,372145
1777,0.000901,172.31.47.0-255,66,102724,92,372145
1778,0.000922,74.125.68.0-255,1484,104208,92,372145
1779,0.00093,74.125.68.0-255,2184,106392,92,372145
1780,0.000933,172.31.47.0-255,66,106458,92,372145
1781,0.000957,74.125.68.0-255,1484,107942,92,372145
1782,0.000961,74.125.68.0-255,2902,110844,92,372145
1783,0.000964,172.31.47.0-255,66,110910,92,372145
1784,0.000994,74.125.68.0-255,5738,116648,92,372145
1785,0.000997,172.31.47.0-255,66,116714,92,372145
1786,0.001003,74.125.68.0-255,5738,122452,92,372145
1787,0.001006,172.31.47.0-255,66,122518,92,372145
1788,0.001031,74.125.68.0-255,7156,129674,92,372145
1789,0.001034,172.31.47.0-255,66,129740,92,372145
1790,0.00106,74.125.68.0-255,5738,135478,92,372145
1791,0.001064,172.31.47.0-255,66,135544,92,372145
1792,0.001091,74.125.68.0-255,5020,140564,92,372145
1793,0.001094,172.31.47.0-255,66,140630,92,372145
1794,0.001216,74.125.68.0-255,1484,142114,92,372145
1795,0.001234,74.125.68.0-255,2902,145016,92,372145
1796,0.001238,172.31.47.0-255,66,145082,92,372145
1797,0.001241,74.125.68.0-255,1484,146566,92,372145
1798,0.001277,74.125.68.0-255,4320,150886,92,372145
1799,0.00128,172.31.47.0-255,66,150952,92,372145
1800,0.001287,74.125.68.0-255,7156,158108,92,372145
1801,0.001289,172.31.47.0-255,66,158174,92,372145
1802,0.001326,172.31.47.0-255,66,158240,92,372145
1803,0.001354,74.125.68.0-255,5020,163260,92,372145
1804,0.001375,172.31.47.0-255,66,163326,92,372145
1805,0.001386,74.125.68.0-255,5738,169064,92,372145
1806,0.001407,74.125.68.0-255,5738,174802,92,372145
1807,0.00145,172.31.47.0-255,66,174868,92,372145
1808,0.001478,74.125.68.0-255,7156,182024,92,372145
1809,0.001493,74.125.68.0-255,766,182790,92,372145
1810,0.001499,172.31.47.0-255,66,182856,92,372145
1811,0.001947,74.125.68.0-255,1484,184340,92,372145
1812,0.001966,74.125.68.0-255,2902,187242,92,372145
1813,0.00197,172.31.47.0-255,66,187308,92,372145
1814,0.001976,74.125.68.0-255,4320,191628,92,372145
1815,0.001978,172.31.47.0-255,66,191694,92,372145
1816,0.002028,172.31.47.0-255,66,191760,92,372145
1817,0.002034,74.125.68.0-255,5738,197498,92,372145
1818,0.002036,172.31.47.0-255,66,197564,92,372145
1819,0.002048,74.125.68.0-255,7156,204720,92,372145
1820,0.00205,172.31.47.0-255,66,204786,92,372145
1821,0.002062,74.125.68.0-255,1484,206270,92,372145
1822,0.002087,74.125.68.0-255,2184,208454,92,372145
1823,0.002107,172.31.47.0-255,66,208520,92,372145
1824,0.002246,74.125.68.0-255,1484,210004,92,372145
1825,0.002252,74.125.68.0-255,2902,212906,92,372145
1826,0.002271,172.31.47.0-255,66,212972,92,372145
1827,0.002281,74.125.68.0-255,2902,215874,92,372145
1828,0.002287,172.31.47.0-255,66,215940,92,372145
1829,0.002307,74.125.68.0-255,4320,220260,92,372145
1830,0.002317,74.125.68.0-255,4320,224580,92,372145
1831,0.002339,172.31.47.0-255,66,224646,92,372145
1832,0.004643,74.125.68.0-255,5738,230384,92,372145
1833,0.00465,172.31.47.0-255,66,230450,92,372145
1834,0.006955,74.125.68.0-255,5738,236188,92,372145
1835,0.006962,172.31.47.0-255,66,236254,92,372145
1836,0.009265,74.125.68.0-255,5738,241992,92,372145
1837,0.009271,172.31.47.0-255,66,242058,92,372145
1838,0.011573,74.125.68.0-255,5738,247796,92,372145
1839,0.011583,172.31.47.0-255,66,247862,92,372145
1840,0.013903,74.125.68.0-255,5738,253600,92,372145
1841,0.013912,172.31.47.0-255,66,253666,92,372145
1842,0.016227,74.125.68.0-255,5738,259404,92,372145
1843,0.016235,172.31.47.0-255,66,259470,92,372145
1844,0.018548,74.125.68.0-255,5738,265208,92,372145
1845,0.018555,172.31.47.0-255,66,265274,92,372145
1846,0.020868,74.125.68.0-255,5738,271012,92,372145
1847,0.020874,172.31.47.0-255,66,271078,92,372145
1848,0.021164,172.31.47.0-255,172,271250,92,372145
1849,0.021194,172.31.47.0-255,1107,272357,92,372145
1850,0.021255,172.31.47.0-255,1514,273871,92,372145
1851,0.021257,172.31.47.0-255,1514,275385,92,372145
1852,0.021258,172.31.47.0-255,1514,276899,92,372145
1853,0.02126,172.31.47.0-255,1514,278413,92,372145
1854,0.021261,172.31.47.0-255,538,278951,92,372145
1855,0.022665,104.244.42.0-255,66,279017,92,372145
1856,0.022695,104.244.42.0-255,66,279083,92,372145
1857,0.022756,104.244.42.0-255,66,279149,92,372145
1858,0.022773,104.244.42.0-255,66,279215,92,372145
1859,0.023193,74.125.68.0-255,5738,284953,92,372145
1860,0.023199,172.31.47.0-255,66,285019,92,372145
1861,0.025514,74.125.68.0-255,5738,290757,92,372145
1862,0.025519,172.31.47.0-255,66,290823,92,372145
1863,0.027849,74.125.68.0-255,5738,296561,92,372145
1864,0.027855,172.31.47.0-255,66,296627,92,372145
1865,0.030169,74.125.68.0-255,5738,302365,92,372145
1866,0.030176,172.31.47.0-255,66,302431,92,372145
1867,0.032496,74.125.68.0-255,5738,308169,92,372145
1868,0.032508,172.31.47.0-255,66,308235,92,372145
1869,0.034822,74.125.68.0-255,5738,313973,92,372145
1870,0.034829,172.31.47.0-255,66,314039,92,372145
1871,0.037151,74.125.68.0-255,5738,319777,92,372145
1872,0.03716,172.31.47.0-255,66,319843,92,372145
1873,0.039473,74.125.68.0-255,5738,325581,92,372145
1874,0.039482,172.31.47.0-255,66,325647,92,372145
1875,0.041801,74.125.68.0-255,5738,331385,92,372145
1876,0.041809,172.31.47.0-255,66,331451,92,372145
1877,0.044119,74.125.68.0-255,5738,337189,92,372145
1878,0.044125,172.31.47.0-255,66,337255,92,372145
1879,0.046468,74.125.68.0-255,5738,342993,92,372145
1880,0.046473,172.31.47.0-255,66,343059,92,372145
1881,0.048796,74.125.68.0-255,5738,348797,92,372145
1882,0.048802,172.31.47.0-255,66,348863,92,372145
1883,0.051115,74.125.68.0-255,5738,354601,92,372145
1884,0.051122,172.31.47.0-255,66,354667,92,372145
1885,0.053434,74.125.68.0-255,5738,360405,92,372145
1886,0.053439,172.31.47.0-255,66,360471,92,372145
1887,0.055767,74.125.68.0-255,5738,366209,92,372145
1888,0.055773,172.31.47.0-255,66,366275,92,372145
1889,0.058082,74.125.68.0-255,4320,370595,92,372145
1890,0.058089,172.31.47.0-255,66,370661,92,372145
1891,0.058113,74.125.68.0-255,1484,372145,92,372145
1892,0.0,74.125.68.0-255,153,153,92,280330
1893,3.1e-05,172.31.47.0-255,66,219,92,280330
1894,3.8e-05,74.125.68.0-255,1484,1703,92,280330
1895,4.2e-05,172.31.47.0-255,66,1769,92,280330
1896,7.9e-05,74.125.68.0-255,2902,4671,92,280330
1897,8.3e-05,172.31.47.0-255,66,4737,92,280330
1898,8.9e-05,74.125.68.0-255,7156,11893,92,280330
1899,9.2e-05,172.31.47.0-255,66,11959,92,280330
1900,0.000115,74.125.68.0-255,2217,14176,92,280330
1901,0.000118,172.31.47.0-255,66,14242,92,280330
1902,0.000164,74.125.68.0-255,1484,15726,92,280330
1903,0.000167,172.31.47.0-255,66,15792,92,280330
1904,0.000196,74.125.68.0-255,2902,18694,92,280330
1905,0.000203,172.31.47.0-255,66,18760,92,280330
1906,0.000211,74.125.68.0-255,5738,24498,92,280330
1907,0.000213,172.31.47.0-255,66,24564,92,280330
1908,0.00022,74.125.68.0-255,5738,30302,92,280330
1909,0.000223,172.31.47.0-255,66,30368,92,280330
1910,0.00026,74.125.68.0-255,1125,31493,92,280330
1911,0.000263,172.31.47.0-255,66,31559,92,280330
1912,0.000317,74.125.68.0-255,1484,33043,92,280330
1913,0.000321,172.31.47.0-255,66,33109,92,280330
1914,0.000327,74.125.68.0-255,2902,36011,92,280330
1915,0.000329,172.31.47.0-255,66,36077,92,280330
1916,0.000355,74.125.68.0-255,5738,41815,92,280330
1917,0.000358,172.31.47.0-255,66,41881,92,280330
1918,0.000362,74.125.68.0-255,2902,44783,92,280330
1919,0.000364,172.31.47.0-255,66,44849,92,280330
1920,0.000383,74.125.68.0-255,2902,47751,92,280330
1921,0.000391,172.31.47.0-255,66,47817,92,280330
1922,0.000398,74.125.68.0-255,5738,53555,92,280330
1923,0.0004,172.31.47.0-255,66,53621,92,280330
1924,0.000427,74.125.68.0-255,1125,54746,92,280330
1925,0.00043,172.31.47.0-255,66,54812,92,280330
1926,0.000445,172.31.47.0-255,66,54878,92,280330
1927,0.000473,74.125.68.0-255,1480,56358,92,280330
1928,0.000489,74.125.68.0-255,331,56689,92,280330
1929,0.000492,172.31.47.0-255,66,56755,92,280330
1930,0.000724,74.125.68.0-255,1484,58239,92,280330
1931,0.000729,74.125.68.0-255,2902,61141,92,280330
1932,0.000731,172.31.47.0-255,66,61207,92,280330
1933,0.000757,74.125.68.0-255,5738,66945,92,280330
1934,0.000761,172.31.47.0-255,66,67011,92,280330
1935,0.000791,74.125.68.0-255,7156,74167,92,280330
1936,0.000794,172.31.47.0-255,66,74233,92,280330
1937,0.000803,172.31.47.0-255,66,74299,92,280330
1938,0.000824,74.125.68.0-255,4320,78619,92,280330
1939,0.000827,172.31.47.0-255,66,78685,92,280330
1940,0.000835,74.125.68.0-255,3602,82287,92,280330
1941,0.000838,172.31.47.0-255,66,82353,92,280330
1942,0.001471,74.125.68.0-255,1484,83837,92,280330
1943,0.001489,74.125.68.0-255,2902,86739,92,280330
1944,0.001493,172.31.47.0-255,66,86805,92,280330
1945,0.001524,74.125.68.0-255,2902,89707,92,280330
1946,0.001527,172.31.47.0-255,66,89773,92,280330
1947,0.001532,74.125.68.0-255,4320,94093,92,280330
1948,0.001533,172.31.47.0-255,66,94159,92,280330
1949,0.001538,74.125.68.0-255,4320,98479,92,280330
1950,0.001541,172.31.47.0-255,66,98545,92,280330
1951,0.001574,74.125.68.0-255,4320,102865,92,280330
1952,0.001576,172.31.47.0-255,66,102931,92,280330
1953,0.001582,74.125.68.0-255,5738,108669,92,280330
1954,0.001584,172.31.47.0-255,66,108735,92,280330
1955,0.00159,74.125.68.0-255,7156,115891,92,280330
1956,0.001591,172.31.47.0-255,66,115957,92,280330
1957,0.001594,74.125.68.0-255,766,116723,92,280330
1958,0.003525,74.125.68.0-255,4320,121043,92,280330
1959,0.003527,172.31.47.0-255,66,121109,92,280330
1960,0.005476,74.125.68.0-255,5738,126847,92,280330
1961,0.00548,172.31.47.0-255,66,126913,92,280330
1962,0.007425,74.125.68.0-255,5738,132651,92,280330
1963,0.007431,172.31.47.0-255,66,132717,92,280330
1964,0.009366,74.125.68.0-255,5738,138455,92,280330
1965,0.009374,172.31.47.0-255,66,138521,92,280330
1966,0.011319,74.125.68.0-255,5738,144259,92,280330
1967,0.011326,172.31.47.0-255,66,144325,92,280330
1968,0.01327,74.125.68.0-255,5738,150063,92,280330
1969,0.01328,172.31.47.0-255,66,150129,92,280330
1970,0.015223,74.125.68.0-255,5738,155867,92,280330
1971,0.015232,172.31.47.0-255,66,155933,92,280330
1972,0.01721,74.125.68.0-255,5738,161671,92,280330
1973,0.017217,172.31.47.0-255,66,161737,92,280330
1974,0.019158,74.125.68.0-255,5738,167475,92,280330
1975,0.019164,172.31.47.0-255,66,167541,92,280330
1976,0.021116,74.125.68.0-255,5738,173279,92,280330
1977,0.021127,172.31.47.0-255,66,173345,92,280330
1978,0.023074,74.125.68.0-255,5738,179083,92,280330
1979,0.023083,172.31.47.0-255,66,179149,92,280330
1980,0.025025,74.125.68.0-255,5738,184887,92,280330
1981,0.025033,172.31.47.0-255,66,184953,92,280330
1982,0.026974,74.125.68.0-255,4320,189273,92,280330
1983,0.02698,172.31.47.0-255,66,189339,92,280330
1984,0.027003,74.125.68.0-255,1484,190823,92,280330
1985,0.028918,74.125.68.0-255,4320,195143,92,280330
1986,0.028923,172.31.47.0-255,66,195209,92,280330
1987,0.028986,172.31.47.0-255,172,195381,92,280330
1988,0.029008,172.31.47.0-255,1107,196488,92,280330
1989,0.029034,172.31.47.0-255,574,197062,92,280330
1990,0.030545,104.244.42.0-255,66,197128,92,280330
1991,0.030552,104.244.42.0-255,66,197194,92,280330
1992,0.030583,104.244.42.0-255,66,197260,92,280330
1993,0.030868,74.125.68.0-255,5738,202998,92,280330
1994,0.030873,172.31.47.0-255,66,203064,92,280330
1995,0.03281,74.125.68.0-255,5738,208802,92,280330
1996,0.032815,172.31.47.0-255,66,208868,92,280330
1997,0.034755,74.125.68.0-255,5738,214606,92,280330
1998,0.03476,172.31.47.0-255,66,214672,92,280330
1999,0.036708,74.125.68.0-255,5738,220410,92,280330
2000,0.036714,172.31.47.0-255,66,220476,92,280330
2001,0.038659,74.125.68.0-255,5738,226214,92,280330
2002,0.038663,172.31.47.0-255,66,226280,92,280330
2003,0.040608,74.125.68.0-255,4320,230600,92,280330
2004,0.040613,172.31.47.0-255,66,230666,92,280330
2005,0.040644,74.125.68.0-255,1484,232150,92,280330
2006,0.042562,74.125.68.0-255,4320,236470,92,280330
2007,0.042566,172.31.47.0-255,66,236536,92,280330
2008,0.044521,74.125.68.0-255,5738,242274,92,280330
2009,0.044526,172.31.47.0-255,66,242340,92,280330
2010,0.046476,74.125.68.0-255,5738,248078,92,280330
2011,0.046481,172.31.47.0-255,66,248144,92,280330
2012,0.048412,74.125.68.0-255,4320,252464,92,280330
2013,0.048418,172.31.47.0-255,66,252530,92,280330
2014,0.048454,74.125.68.0-255,1484,254014,92,280330
2015,0.050355,74.125.68.0-255,4320,258334,92,280330
2016,0.05036,172.31.47.0-255,66,258400,92,280330
2017,0.052294,74.125.68.0-255,5738,264138,92,280330
2018,0.052299,172.31.47.0-255,66,264204,92,280330
2019,0.054247,74.125.68.0-255,5738,269942,92,280330
2020,0.054262,172.31.47.0-255,66,270008,92,280330
2021,0.056205,74.125.68.0-255,4320,274328,92,280330
2022,0.05621,172.31.47.0-255,66,274394,92,280330
2023,0.056241,74.125.68.0-255,1484,275878,92,280330
2024,0.058153,74.125.68.0-255,2902,278780,92,280330
2025,0.058158,172.31.47.0-255,66,278846,92,280330
2026,0.058189,74.125.68.0-255,1484,280330,92,280330
2027,0.0,74.125.130.0-255,153,153,92,345783
2028,1.7e-05,172.31.47.0-255,66,219,92,345783
2029,2.3e-05,74.125.130.0-255,1484,1703,92,345783
2030,2.7e-05,172.31.47.0-255,66,1769,92,345783
2031,3.2e-05,74.125.130.0-255,2902,4671,92,345783
2032,3.5e-05,172.31.47.0-255,66,4737,92,345783
2033,6.2e-05,74.125.130.0-255,5738,10475,92,345783
2034,6.5e-05,172.31.47.0-255,66,10541,92,345783
2035,7e-05,74.125.130.0-255,3426,13967,92,345783
2036,7.2e-05,172.31.47.0-255,66,14033,92,345783
2037,0.000115,74.125.130.0-255,1484,15517,92,345783
2038,0.000117,172.31.47.0-255,66,15583,92,345783
2039,0.000133,74.125.130.0-255,2902,18485,92,345783
2040,0.000135,172.31.47.0-255,66,18551,92,345783
2041,0.000138,74.125.130.0-255,1484,20035,92,345783
2042,0.00014,172.31.47.0-255,66,20101,92,345783
2043,0.000163,74.125.130.0-255,4320,24421,92,345783
2044,0.000165,172.31.47.0-255,66,24487,92,345783
2045,0.000171,74.125.130.0-255,5738,30225,92,345783
2046,0.000173,172.31.47.0-255,66,30291,92,345783
2047,0.000212,74.125.130.0-255,1125,31416,92,345783
2048,0.000214,172.31.47.0-255,66,31482,92,345783
2049,0.000599,74.125.130.0-255,1484,32966,92,345783
2050,0.000604,172.31.47.0-255,66,33032,92,345783
2051,0.000608,74.125.130.0-255,1484,34516,92,345783
2052,0.00061,172.31.47.0-255,66,34582,92,345783
2053,0.00069,74.125.130.0-255,2902,37484,92,345783
2054,0.000693,172.31.47.0-255,66,37550,92,345783
2055,0.000699,74.125.130.0-255,1484,39034,92,345783
2056,0.0007,172.31.47.0-255,66,39100,92,345783
2057,0.000705,74.125.130.0-255,2902,42002,92,345783
2058,0.000707,172.31.47.0-255,66,42068,92,345783
2059,0.000713,74.125.130.0-255,5738,47806,92,345783
2060,0.000715,172.31.47.0-255,66,47872,92,345783
2061,0.000748,74.125.130.0-255,3961,51833,92,345783
2062,0.00075,172.31.47.0-255,66,51899,92,345783
2063,0.000769,74.125.130.0-255,4320,56219,92,345783
2064,0.000771,172.31.47.0-255,66,56285,92,345783
2065,0.000789,74.125.130.0-255,2902,59187,92,345783
2066,0.000791,172.31.47.0-255,66,59253,92,345783
2067,0.000811,74.125.130.0-255,5738,64991,92,345783
2068,0.000813,172.31.47.0-255,66,65057,92,345783
2069,0.000828,74.125.130.0-255,1125,66182,92,345783
2070,0.000845,74.125.130.0-255,367,66549,92,345783
2071,0.001012,74.125.130.0-255,1484,68033,92,345783
2072,0.001016,172.31.47.0-255,66,68099,92,345783
2073,0.001035,74.125.130.0-255,2902,71001,92,345783
2074,0.001038,172.31.47.0-255,66,71067,92,345783
2075,0.001046,74.125.130.0-255,5738,76805,92,345783
2076,0.001048,172.31.47.0-255,66,76871,92,345783
2077,0.001077,74.125.130.0-255,5738,82609,92,345783
2078,0.00108,172.31.47.0-255,66,82675,92,345783
2079,0.001093,74.125.130.0-255,4320,86995,92,345783
2080,0.001095,172.31.47.0-255,66,87061,92,345783
2081,0.001134,172.31.47.0-255,66,87127,92,345783
2082,0.00115,74.125.130.0-255,1484,88611,92,345783
2083,0.001162,74.125.130.0-255,2495,91106,92,345783
2084,0.001164,172.31.47.0-255,66,91172,92,345783
2085,0.002111,74.125.130.0-255,1484,92656,92,345783
2086,0.002118,74.125.130.0-255,2902,95558,92,345783
2087,0.002122,172.31.47.0-255,66,95624,92,345783
2088,0.00216,74.125.130.0-255,4320,99944,92,345783
2089,0.002163,172.31.47.0-255,66,100010,92,345783
2090,0.002176,74.125.130.0-255,1484,101494,92,345783
2091,0.002188,74.125.130.0-255,2902,104396,92,345783
2092,0.00219,172.31.47.0-255,66,104462,92,345783
2093,0.002208,74.125.130.0-255,4320,108782,92,345783
2094,0.00221,172.31.47.0-255,66,108848,92,345783
2095,0.00222,74.125.130.0-255,1484,110332,92,345783
2096,0.002238,74.125.130.0-255,5738,116070,92,345783
2097,0.00224,172.31.47.0-255,66,116136,92,345783
2098,0.002272,74.125.130.0-255,1484,117620,92,345783
2099,0.002289,74.125.130.0-255,2902,120522,92,345783
2100,0.002291,172.31.47.0-255,66,120588,92,345783
2101,0.002296,74.125.130.0-255,5020,125608,92,345783
2102,0.002298,172.31.47.0-255,66,125674,92,345783
2103,0.002923,74.125.130.0-255,1484,127158,92,345783
2104,0.002944,74.125.130.0-255,1484,128642,92,345783
2105,0.002946,172.31.47.0-255,66,128708,92,345783
2106,0.00295,74.125.130.0-255,1484,130192,92,345783
2107,0.002968,74.125.130.0-255,1484,131676,92,345783
2108,0.00297,172.31.47.0-255,66,131742,92,345783
2109,0.002972,74.125.130.0-255,1484,133226,92,345783
2110,0.003007,74.125.130.0-255,2902,136128,92,345783
2111,0.003009,172.31.47.0-255,66,136194,92,345783
2112,0.003031,74.125.130.0-255,7156,143350,92,345783
2113,0.003034,172.31.47.0-255,66,143416,92,345783
2114,0.003036,74.125.130.0-255,1484,144900,92,345783
2115,0.00304,74.125.130.0-255,2902,147802,92,345783
2116,0.003042,172.31.47.0-255,66,147868,92,345783
2117,0.003045,74.125.130.0-255,1484,149352,92,345783
2118,0.003092,74.125.130.0-255,5738,155090,92,345783
2119,0.003094,172.31.47.0-255,66,155156,92,345783
2120,0.003099,74.125.130.0-255,4320,159476,92,345783
2121,0.0031,172.31.47.0-255,66,159542,92,345783
2122,0.003103,74.125.130.0-255,766,160308,92,345783
2123,0.003122,74.125.130.0-255,4320,164628,92,345783
2124,0.003124,172.31.47.0-255,66,164694,92,345783
2125,0.003144,74.125.130.0-255,2902,167596,92,345783
2126,0.003146,172.31.47.0-255,66,167662,92,345783
2127,0.00315,74.125.130.0-255,4320,171982,92,345783
2128,0.003152,172.31.47.0-255,66,172048,92,345783
2129,0.003158,74.125.130.0-255,5738,177786,92,345783
2130,0.00316,172.31.47.0-255,66,177852,92,345783
2131,0.003173,74.125.130.0-255,1484,179336,92,345783
2132,0.003196,172.31.47.0-255,66,179402,92,345783
2133,0.003201,74.125.130.0-255,4320,183722,92,345783
2134,0.003202,172.31.47.0-255,66,183788,92,345783
2135,0.003225,74.125.130.0-255,766,184554,92,345783
2136,0.003271,74.125.130.0-255,1484,186038,92,345783
2137,0.003273,172.31.47.0-255,66,186104,92,345783
2138,0.003287,74.125.130.0-255,1484,187588,92,345783
2139,0.00329,74.125.130.0-255,1484,189072,92,345783
2140,0.003292,172.31.47.0-255,66,189138,92,345783
2141,0.003309,74.125.130.0-255,1484,190622,92,345783
2142,0.003312,74.125.130.0-255,2902,193524,92,345783
2143,0.003314,172.31.47.0-255,66,193590,92,345783
2144,0.003331,74.125.130.0-255,2902,196492,92,345783
2145,0.003333,172.31.47.0-255,66,196558,92,345783
2146,0.003337,74.125.130.0-255,2902,199460,92,345783
2147,0.003338,172.31.47.0-255,66,199526,92,345783
2148,0.003354,74.125.130.0-255,2902,202428,92,345783
2149,0.003356,172.31.47.0-255,66,202494,92,345783
2150,0.003358,74.125.130.0-255,1484,203978,92,345783
2151,0.003379,74.125.130.0-255,5738,209716,92,345783
2152,0.003381,172.31.47.0-255,66,209782,92,345783
2153,0.003384,74.125.130.0-255,1484,211266,92,345783
2154,0.003399,74.125.130.0-255,4320,215586,92,345783
2155,0.003401,172.31.47.0-255,66,215652,92,345783
2156,0.003405,74.125.130.0-255,2902,218554,92,345783
2157,0.003407,172.31.47.0-255,66,218620,92,345783
2158,0.003459,74.125.130.0-255,766,219386,92,345783
2159,0.003543,74.125.130.0-255,1484,220870,92,345783
2160,0.003545,172.31.47.0-255,66,220936,92,345783
2161,0.003558,74.125.130.0-255,2902,223838,92,345783
2162,0.00356,172.31.47.0-255,66,223904,92,345783
2163,0.003578,74.125.130.0-255,5738,229642,92,345783
2164,0.00358,172.31.47.0-255,66,229708,92,345783
2165,0.003606,74.125.130.0-255,2902,232610,92,345783
2166,0.003608,172.31.47.0-255,66,232676,92,345783
2167,0.003611,74.125.130.0-255,1484,234160,92,345783
2168,0.003627,74.125.130.0-255,2902,237062,92,345783
2169,0.003629,172.31.47.0-255,66,237128,92,345783
2170,0.003646,74.125.130.0-255,2902,240030,92,345783
2171,0.003648,172.31.47.0-255,66,240096,92,345783
2172,0.003664,74.125.130.0-255,1484,241580,92,345783
2173,0.00367,74.125.130.0-255,5738,247318,92,345783
2174,0.003672,172.31.47.0-255,66,247384,92,345783
2175,0.003688,74.125.130.0-255,1484,248868,92,345783
2176,0.003709,74.125.130.0-255,5020,253888,92,345783
2177,0.003712,172.31.47.0-255,66,253954,92,345783
2178,0.003734,74.125.130.0-255,7156,261110,92,345783
2179,0.003737,172.31.47.0-255,66,261176,92,345783
2180,0.00374,74.125.130.0-255,1484,262660,92,345783
2181,0.003754,74.125.130.0-255,5738,268398,92,345783
2182,0.003757,172.31.47.0-255,66,268464,92,345783
2183,0.003782,74.125.130.0-255,2902,271366,92,345783
2184,0.003784,172.31.47.0-255,66,271432,92,345783
2185,0.003796,172.31.47.0-255,66,271498,92,345783
2186,0.003802,74.125.130.0-255,5020,276518,92,345783
2187,0.003804,172.31.47.0-255,66,276584,92,345783
2188,0.003864,74.125.130.0-255,2902,279486,92,345783
2189,0.003867,172.31.47.0-255,66,279552,92,345783
2190,0.003872,74.125.130.0-255,4320,283872,92,345783
2191,0.003875,172.31.47.0-255,66,283938,92,345783
2192,0.003911,172.31.47.0-255,66,284004,92,345783
2193,0.003916,74.125.130.0-255,4320,288324,92,345783
2194,0.003918,172.31.47.0-255,66,288390,92,345783
2195,0.003954,74.125.130.0-255,2902,291292,92,345783
2196,0.003957,172.31.47.0-255,66,291358,92,345783
2197,0.003986,172.31.47.0-255,66,291424,92,345783
2198,0.004032,74.125.130.0-255,1484,292908,92,345783
2199,0.004058,172.31.47.0-255,66,292974,92,345783
2200,0.004071,172.31.47.0-255,66,293040,92,345783
2201,0.004073,74.125.130.0-255,1484,294524,92,345783
2202,0.004077,74.125.130.0-255,2902,297426,92,345783
2203,0.004079,172.31.47.0-255,66,297492,92,345783
2204,0.0041,74.125.130.0-255,4320,301812,92,345783
2205,0.004103,172.31.47.0-255,66,301878,92,345783
2206,0.004122,74.125.130.0-255,2184,304062,92,345783
2207,0.004124,172.31.47.0-255,66,304128,92,345783
2208,0.00413,74.125.130.0-255,7156,311284,92,345783
2209,0.004132,172.31.47.0-255,66,311350,92,345783
2210,0.004169,172.31.47.0-255,66,311416,92,345783
2211,0.004187,74.125.130.0-255,4320,315736,92,345783
2212,0.00419,172.31.47.0-255,66,315802,92,345783
2213,0.004216,74.125.130.0-255,2902,318704,92,345783
2214,0.004219,172.31.47.0-255,66,318770,92,345783
2215,0.004247,74.125.130.0-255,6438,325208,92,345783
2216,0.00425,172.31.47.0-255,66,325274,92,345783
2217,0.004259,172.31.47.0-255,66,325340,92,345783
2218,0.00427,74.125.130.0-255,1484,326824,92,345783
2219,0.004275,74.125.130.0-255,4320,331144,92,345783
2220,0.004278,172.31.47.0-255,66,331210,92,345783
2221,0.004314,74.125.130.0-255,4320,335530,92,345783
2222,0.004325,74.125.130.0-255,811,336341,92,345783
2223,0.004379,74.125.130.0-255,105,336446,92,345783
2224,0.004436,172.31.47.0-255,66,336512,92,345783
2225,0.007093,172.31.47.0-255,105,336617,92,345783
2226,0.009315,74.125.130.0-255,66,336683,92,345783
2227,0.0327,172.31.47.0-255,172,336855,92,345783
2228,0.032731,172.31.47.0-255,1113,337968,92,345783
2229,0.032794,172.31.47.0-255,1514,339482,92,345783
2230,0.032796,172.31.47.0-255,1514,340996,92,345783
2231,0.032797,172.31.47.0-255,1514,342510,92,345783
2232,0.032798,172.31.47.0-255,1514,344024,92,345783
2233,0.032825,172.31.47.0-255,1495,345519,92,345783
2234,0.034225,104.244.42.0-255,66,345585,92,345783
2235,0.03428,104.244.42.0-255,66,345651,92,345783
2236,0.034364,104.244.42.0-255,66,345717,92,345783
2237,0.034368,104.244.42.0-255,66,345783,92,345783
2238,0.0,74.125.130.0-255,153,153,92,334479
2239,2.5e-05,172.31.47.0-255,66,219,92,334479
2240,6e-05,74.125.130.0-255,1484,1703,92,334479
2241,6.5e-05,172.31.47.0-255,66,1769,92,334479
2242,7e-05,74.125.130.0-255,2902,4671,92,334479
2243,7.5e-05,172.31.47.0-255,66,4737,92,334479
2244,0.000104,74.125.130.0-255,5738,10475,92,334479
2245,0.000107,172.31.47.0-255,66,10541,92,334479
2246,0.000113,74.125.130.0-255,3472,14013,92,334479
2247,0.000115,172.31.47.0-255,66,14079,92,334479
2248,0.000178,74.125.130.0-255,1484,15563,92,334479
2249,0.000182,172.31.47.0-255,66,15629,92,334479
2250,0.000187,74.125.130.0-255,2902,18531,92,334479
2251,0.000189,172.31.47.0-255,66,18597,92,334479
2252,0.000215,74.125.130.0-255,1484,20081,92,334479
2253,0.000218,172.31.47.0-255,66,20147,92,334479
2254,0.000246,74.125.130.0-255,2902,23049,92,334479
2255,0.000249,172.31.47.0-255,66,23115,92,334479
2256,0.000253,74.125.130.0-255,2902,26017,92,334479
2257,0.000255,172.31.47.0-255,66,26083,92,334479
2258,0.000287,74.125.130.0-255,2902,28985,92,334479
2259,0.000291,172.31.47.0-255,66,29051,92,334479
2260,0.000312,74.125.130.0-255,2543,31594,92,334479
2261,0.000315,172.31.47.0-255,66,31660,92,334479
2262,0.000417,74.125.130.0-255,1484,33144,92,334479
2263,0.000421,172.31.47.0-255,66,33210,92,334479
2264,0.000425,74.125.130.0-255,1484,34694,92,334479
2265,0.000427,172.31.47.0-255,66,34760,92,334479
2266,0.000461,74.125.130.0-255,2902,37662,92,334479
2267,0.000464,172.31.47.0-255,66,37728,92,334479
2268,0.000471,74.125.130.0-255,5738,43466,92,334479
2269,0.000473,172.31.47.0-255,66,43532,92,334479
2270,0.000478,74.125.130.0-255,5379,48911,92,334479
2271,0.000481,172.31.47.0-255,66,48977,92,334479
2272,0.000592,74.125.130.0-255,1484,50461,92,334479
2273,0.000596,172.31.47.0-255,66,50527,92,334479
2274,0.00062,74.125.130.0-255,2902,53429,92,334479
2275,0.000623,172.31.47.0-255,66,53495,92,334479
2276,0.000629,74.125.130.0-255,5738,59233,92,334479
2277,0.000632,172.31.47.0-255,66,59299,92,334479
2278,0.000636,74.125.130.0-255,2902,62201,92,334479
2279,0.000638,172.31.47.0-255,66,62267,92,334479
2280,0.000644,74.125.130.0-255,3961,66228,92,334479
2281,0.000646,172.31.47.0-255,66,66294,92,334479
2282,0.000683,74.125.130.0-255,645,66939,92,334479
2283,0.000686,172.31.47.0-255,66,67005,92,334479
2284,0.00081,74.125.130.0-255,1484,68489,92,334479
2285,0.000814,172.31.47.0-255,66,68555,92,334479
2286,0.000831,74.125.130.0-255,2902,71457,92,334479
2287,0.000836,172.31.47.0-255,66,71523,92,334479
2288,0.000856,74.125.130.0-255,4320,75843,92,334479
2289,0.00086,172.31.47.0-255,66,75909,92,334479
2290,0.000894,74.125.130.0-255,5738,81647,92,334479
2291,0.000897,172.31.47.0-255,66,81713,92,334479
2292,0.000925,74.125.130.0-255,2543,84256,92,334479
2293,0.000927,172.31.47.0-255,66,84322,92,334479
2294,0.000931,74.125.130.0-255,1484,85806,92,334479
2295,0.000934,172.31.47.0-255,66,85872,92,334479
2296,0.000961,74.125.130.0-255,7156,93028,92,334479
2297,0.000964,172.31.47.0-255,66,93094,92,334479
2298,0.000967,74.125.130.0-255,1484,94578,92,334479
2299,0.000969,172.31.47.0-255,66,94644,92,334479
2300,0.001002,74.125.130.0-255,1484,96128,92,334479
2301,0.001005,172.31.47.0-255,66,96194,92,334479
2302,0.001011,74.125.130.0-255,2902,99096,92,334479
2303,0.001013,172.31.47.0-255,66,99162,92,334479
2304,0.001055,74.125.130.0-255,2543,101705,92,334479
2305,0.001059,172.31.47.0-255,66,101771,92,334479
2306,0.001442,74.125.130.0-255,1484,103255,92,334479
2307,0.001448,172.31.47.0-255,66,103321,92,334479
2308,0.001458,74.125.130.0-255,2902,106223,92,334479
2309,0.00146,172.31.47.0-255,66,106289,92,334479
2310,0.001473,74.125.130.0-255,5738,112027,92,334479
2311,0.001475,172.31.47.0-255,66,112093,92,334479
2312,0.00151,74.125.130.0-255,4320,116413,92,334479
2313,0.001513,172.31.47.0-255,66,116479,92,334479
2314,0.001542,74.125.130.0-255,1484,117963,92,334479
2315,0.001546,172.31.47.0-255,66,118029,92,334479
2316,0.001553,74.125.130.0-255,7156,125185,92,334479
2317,0.001555,172.31.47.0-255,66,125251,92,334479
2318,0.001561,74.125.130.0-255,5738,130989,92,334479
2319,0.001563,172.31.47.0-255,66,131055,92,334479
2320,0.00161,74.125.130.0-255,2902,133957,92,334479
2321,0.001614,172.31.47.0-255,66,134023,92,334479
2322,0.001642,74.125.130.0-255,2184,136207,92,334479
2323,0.001646,172.31.47.0-255,66,136273,92,334479
2324,0.001698,74.125.130.0-255,1484,137757,92,334479
2325,0.001704,172.31.47.0-255,66,137823,92,334479
2326,0.001708,74.125.130.0-255,2902,140725,92,334479
2327,0.001747,74.125.130.0-255,5738,146463,92,334479
2328,0.001778,74.125.130.0-255,5738,152201,92,334479
2329,0.001798,74.125.130.0-255,2902,155103,92,334479
2330,0.001828,74.125.130.0-255,5020,160123,92,334479
2331,0.001842,172.31.47.0-255,66,160189,92,334479
2332,0.001845,74.125.130.0-255,1484,161673,92,334479
2333,0.001869,74.125.130.0-255,1484,163157,92,334479
2334,0.001898,74.125.130.0-255,4320,167477,92,334479
2335,0.001903,172.31.47.0-255,66,167543,92,334479
2336,0.001916,74.125.130.0-255,5738,173281,92,334479
2337,0.001934,172.31.47.0-255,66,173347,92,334479
2338,0.001939,74.125.130.0-255,2902,176249,92,334479
2339,0.001979,74.125.130.0-255,2902,179151,92,334479
2340,0.001989,172.31.47.0-255,66,179217,92,334479
2341,0.002019,74.125.130.0-255,2902,182119,92,334479
2342,0.002031,74.125.130.0-255,1484,183603,92,334479
2343,0.002044,74.125.130.0-255,2184,185787,92,334479
2344,0.002046,172.31.47.0-255,66,185853,92,334479
2345,0.00205,172.31.47.0-255,66,185919,92,334479
2346,0.004348,74.125.130.0-255,4320,190239,92,334479
2347,0.004354,172.31.47.0-255,66,190305,92,334479
2348,0.00438,74.125.130.0-255,1484,191789,92,334479
2349,0.006654,74.125.130.0-255,4320,196109,92,334479
2350,0.006661,172.31.47.0-255,66,196175,92,334479
2351,0.009018,74.125.130.0-255,5738,201913,92,334479
2352,0.009068,172.31.47.0-255,66,201979,92,334479
2353,0.011382,74.125.130.0-255,5738,207717,92,334479
2354,0.011389,172.31.47.0-255,66,207783,92,334479
2355,0.0137,74.125.130.0-255,5738,213521,92,334479
2356,0.013707,172.31.47.0-255,66,213587,92,334479
2357,0.016062,74.125.130.0-255,5738,219325,92,334479
2358,0.016071,172.31.47.0-255,66,219391,92,334479
2359,0.018384,74.125.130.0-255,5738,225129,92,334479
2360,0.01839,172.31.47.0-255,66,225195,92,334479
2361,0.020708,74.125.130.0-255,5738,230933,92,334479
2362,0.020717,172.31.47.0-255,66,230999,92,334479
2363,0.02307,74.125.130.0-255,5738,236737,92,334479
2364,0.023078,172.31.47.0-255,66,236803,92,334479
2365,0.025425,74.125.130.0-255,5738,242541,92,334479
2366,0.025432,172.31.47.0-255,66,242607,92,334479
2367,0.02775,74.125.130.0-255,5738,248345,92,334479
2368,0.027757,172.31.47.0-255,66,248411,92,334479
2369,0.030074,74.125.130.0-255,5738,254149,92,334479
2370,0.030079,172.31.47.0-255,66,254215,92,334479
2371,0.030408,172.31.47.0-255,172,254387,92,334479
2372,0.030446,172.31.47.0-255,1107,255494,92,334479
2373,0.030659,172.31.47.0-255,1514,257008,92,334479
2374,0.030661,172.31.47.0-255,1514,258522,92,334479
2375,0.030666,172.31.47.0-255,1514,260036,92,334479
2376,0.030667,172.31.47.0-255,1514,261550,92,334479
2377,0.03069,172.31.47.0-255,1499,263049,92,334479
2378,0.031969,104.244.42.0-255,66,263115,92,334479
2379,0.032069,104.244.42.0-255,66,263181,92,334479
2380,0.032219,104.244.42.0-255,66,263247,92,334479
2381,0.032392,74.125.130.0-255,2902,266149,92,334479
2382,0.032396,172.31.47.0-255,66,266215,92,334479
2383,0.032433,74.125.130.0-255,2902,269117,92,334479
2384,0.032453,172.31.47.0-255,66,269183,92,334479
2385,0.034694,74.125.130.0-255,2902,272085,92,334479
2386,0.0347,172.31.47.0-255,66,272151,92,334479
2387,0.034751,74.125.130.0-255,2902,275053,92,334479
2388,0.034782,172.31.47.0-255,66,275119,92,334479
2389,0.037007,74.125.130.0-255,2902,278021,92,334479
2390,0.037013,172.31.47.0-255,66,278087,92,334479
2391,0.037076,74.125.130.0-255,2902,280989,92,334479
2392,0.037092,172.31.47.0-255,66,281055,92,334479
2393,0.039311,74.125.130.0-255,2902,283957,92,334479
2394,0.039317,172.31.47.0-255,66,284023,92,334479
2395,0.039382,74.125.130.0-255,2902,286925,92,334479
2396,0.039398,172.31.47.0-255,66,286991,92,334479
2397,0.041618,74.125.130.0-255,2902,289893,92,334479
2398,0.041623,172.31.47.0-255,66,289959,92,334479
2399,0.041693,74.125.130.0-255,2902,292861,92,334479
2400,0.041701,172.31.47.0-255,66,292927,92,334479
2401,0.043943,74.125.130.0-255,2902,295829,92,334479
2402,0.043948,172.31.47.0-255,66,295895,92,334479
2403,0.044005,74.125.130.0-255,1484,297379,92,334479
2404,0.044019,74.125.130.0-255,1484,298863,92,334479
2405,0.044024,172.31.47.0-255,66,298929,92,334479
2406,0.046263,74.125.130.0-255,2902,301831,92,334479
2407,0.046269,172.31.47.0-255,66,301897,92,334479
2408,0.046334,74.125.130.0-255,2902,304799,92,334479
2409,0.046345,172.31.47.0-255,66,304865,92,334479
2410,0.048569,74.125.130.0-255,2902,307767,92,334479
2411,0.048574,172.31.47.0-255,66,307833,92,334479
2412,0.048665,74.125.130.0-255,2902,310735,92,334479
2413,0.04867,172.31.47.0-255,66,310801,92,334479
2414,0.050881,74.125.130.0-255,2902,313703,92,334479
2415,0.050886,172.31.47.0-255,66,313769,92,334479
2416,0.050974,74.125.130.0-255,2902,316671,92,334479
2417,0.050979,172.31.47.0-255,66,316737,92,334479
2418,0.053181,74.125.130.0-255,2902,319639,92,334479
2419,0.053186,172.31.47.0-255,66,319705,92,334479
2420,0.053286,74.125.130.0-255,2902,322607,92,334479
2421,0.05329,172.31.47.0-255,66,322673,92,334479
2422,0.055484,74.125.130.0-255,1484,324157,92,334479
2423,0.055491,172.31.47.0-255,66,324223,92,334479
2424,0.05563,74.125.130.0-255,4320,328543,92,334479
2425,0.056064,172.31.47.0-255,66,328609,92,334479
2426,0.057795,74.125.130.0-255,1484,330093,92,334479
2427,0.058385,74.125.130.0-255,4320,334413,92,334479
2428,0.058391,172.31.47.0-255,66,334479,92,334479
2429,0.0,74.125.24.0-255,153,153,92,275055
2430,2.1e-05,172.31.47.0-255,66,219,92,275055
2431,2.8e-05,74.125.24.0-255,1484,1703,92,275055
2432,3.1e-05,172.31.47.0-255,66,1769,92,275055
2433,3.6e-05,74.125.24.0-255,2902,4671,92,275055
2434,3.9e-05,172.31.47.0-255,66,4737,92,275055
2435,6.8e-05,74.125.24.0-255,1484,6221,92,275055
2436,7.1e-05,172.31.47.0-255,66,6287,92,275055
2437,0.000101,74.125.24.0-255,4320,10607,92,275055
2438,0.000105,172.31.47.0-255,66,10673,92,275055
2439,0.000109,74.125.24.0-255,3384,14057,92,275055
2440,0.000111,172.31.47.0-255,66,14123,92,275055
2441,0.000146,74.125.24.0-255,1484,15607,92,275055
2442,0.000148,172.31.47.0-255,66,15673,92,275055
2443,0.000162,74.125.24.0-255,2902,18575,92,275055
2444,0.000164,172.31.47.0-255,66,18641,92,275055
2445,0.000167,74.125.24.0-255,1484,20125,92,275055
2446,0.000169,172.31.47.0-255,66,20191,92,275055
2447,0.000194,74.125.24.0-255,4320,24511,92,275055
2448,0.000198,74.125.24.0-255,4320,28831,92,275055
2449,0.000201,172.31.47.0-255,66,28897,92,275055
2450,0.000204,172.31.47.0-255,66,28963,92,275055
2451,0.000241,74.125.24.0-255,2543,31506,92,275055
2452,0.000243,172.31.47.0-255,66,31572,92,275055
2453,0.000347,74.125.24.0-255,1484,33056,92,275055
2454,0.000352,172.31.47.0-255,66,33122,92,275055
2455,0.000357,74.125.24.0-255,2902,36024,92,275055
2456,0.000359,172.31.47.0-255,66,36090,92,275055
2457,0.000376,74.125.24.0-255,1484,37574,92,275055
2458,0.000379,172.31.47.0-255,66,37640,92,275055
2459,0.000404,74.125.24.0-255,4320,41960,92,275055
2460,0.000407,172.31.47.0-255,66,42026,92,275055
2461,0.000413,74.125.24.0-255,6797,48823,92,275055
2462,0.000415,172.31.47.0-255,66,48889,92,275055
2463,0.000417,74.125.24.0-255,1484,50373,92,275055
2464,0.000447,74.125.24.0-255,5738,56111,92,275055
2465,0.00045,172.31.47.0-255,66,56177,92,275055
2466,0.000455,74.125.24.0-255,4320,60497,92,275055
2467,0.000458,172.31.47.0-255,66,60563,92,275055
2468,0.000492,74.125.24.0-255,4320,64883,92,275055
2469,0.000495,172.31.47.0-255,66,64949,92,275055
2470,0.000509,74.125.24.0-255,1125,66074,92,275055
2471,0.000512,74.125.24.0-255,409,66483,92,275055
2472,0.000798,74.125.24.0-255,334,66817,92,275055
2473,0.000802,172.31.47.0-255,66,66883,92,275055
2474,0.000837,74.125.24.0-255,1484,68367,92,275055
2475,0.000842,74.125.24.0-255,4320,72687,92,275055
2476,0.000846,172.31.47.0-255,66,72753,92,275055
2477,0.000858,74.125.24.0-255,5738,78491,92,275055
2478,0.00086,172.31.47.0-255,66,78557,92,275055
2479,0.000877,74.125.24.0-255,2902,81459,92,275055
2480,0.000879,172.31.47.0-255,66,81525,92,275055
2481,0.000902,172.31.47.0-255,66,81591,92,275055
2482,0.000922,74.125.24.0-255,766,82357,92,275055
2483,0.000926,172.31.47.0-255,66,82423,92,275055
2484,0.00101,74.125.24.0-255,1484,83907,92,275055
2485,0.001015,172.31.47.0-255,66,83973,92,275055
2486,0.00102,74.125.24.0-255,2902,86875,92,275055
2487,0.001022,172.31.47.0-255,66,86941,92,275055
2488,0.00104,74.125.24.0-255,5738,92679,92,275055
2489,0.001043,172.31.47.0-255,66,92745,92,275055
2490,0.001048,74.125.24.0-255,5738,98483,92,275055
2491,0.00105,172.31.47.0-255,66,98549,92,275055
2492,0.001053,74.125.24.0-255,1484,100033,92,275055
2493,0.001084,172.31.47.0-255,66,100099,92,275055
2494,0.001103,74.125.24.0-255,5020,105119,92,275055
2495,0.001107,172.31.47.0-255,66,105185,92,275055
2496,0.002261,74.125.24.0-255,1484,106669,92,275055
2497,0.00227,74.125.24.0-255,2902,109571,92,275055
2498,0.002275,172.31.47.0-255,66,109637,92,275055
2499,0.002283,74.125.24.0-255,5738,115375,92,275055
2500,0.002284,172.31.47.0-255,66,115441,92,275055
2501,0.002289,74.125.24.0-255,4320,119761,92,275055
2502,0.002291,172.31.47.0-255,66,119827,92,275055
2503,0.002294,74.125.24.0-255,1484,121311,92,275055
2504,0.002327,172.31.47.0-255,66,121377,92,275055
2505,0.002332,74.125.24.0-255,4320,125697,92,275055
2506,0.002334,172.31.47.0-255,66,125763,92,275055
2507,0.002349,74.125.24.0-255,3602,129365,92,275055
2508,0.002351,172.31.47.0-255,66,129431,92,275055
2509,0.004692,74.125.24.0-255,5738,135169,92,275055
2510,0.004698,172.31.47.0-255,66,135235,92,275055
2511,0.007091,74.125.24.0-255,5738,140973,92,275055
2512,0.007102,172.31.47.0-255,66,141039,92,275055
2513,0.009499,74.125.24.0-255,5738,146777,92,275055
2514,0.009507,172.31.47.0-255,66,146843,92,275055
2515,0.011903,74.125.24.0-255,5738,152581,92,275055
2516,0.011912,172.31.47.0-255,66,152647,92,275055
2517,0.014254,74.125.24.0-255,5738,158385,92,275055
2518,0.014264,172.31.47.0-255,66,158451,92,275055
2519,0.016636,74.125.24.0-255,5738,164189,92,275055
2520,0.016646,172.31.47.0-255,66,164255,92,275055
2521,0.019014,74.125.24.0-255,5738,169993,92,275055
2522,0.01902,172.31.47.0-255,66,170059,92,275055
2523,0.02138,74.125.24.0-255,5738,175797,92,275055
2524,0.021387,172.31.47.0-255,66,175863,92,275055
2525,0.023749,74.125.24.0-255,5738,181601,92,275055
2526,0.023755,172.31.47.0-255,66,181667,92,275055
2527,0.02423,172.31.47.0-255,172,181839,92,275055
2528,0.024264,172.31.47.0-255,1111,182950,92,275055
2529,0.024298,172.31.47.0-255,1514,184464,92,275055
2530,0.0243,172.31.47.0-255,1514,185978,92,275055
2531,0.024301,172.31.47.0-255,1514,187492,92,275055
2532,0.024302,172.31.47.0-255,1514,189006,92,275055
2533,0.024327,172.31.47.0-255,1495,190501,92,275055
2534,0.025795,104.244.42.0-255,66,190567,92,275055
2535,0.025821,104.244.42.0-255,66,190633,92,275055
2536,0.025891,104.244.42.0-255,66,190699,92,275055
2537,0.026108,74.125.24.0-255,5738,196437,92,275055
2538,0.026113,172.31.47.0-255,66,196503,92,275055
2539,0.028488,74.125.24.0-255,5738,202241,92,275055
2540,0.028493,172.31.47.0-255,66,202307,92,275055
2541,0.030874,74.125.24.0-255,5738,208045,92,275055
2542,0.030878,172.31.47.0-255,66,208111,92,275055
2543,0.033232,74.125.24.0-255,5738,213849,92,275055
2544,0.033238,172.31.47.0-255,66,213915,92,275055
2545,0.035604,74.125.24.0-255,5738,219653,92,275055
2546,0.03561,172.31.47.0-255,66,219719,92,275055
2547,0.037957,74.125.24.0-255,5738,225457,92,275055
2548,0.037961,172.31.47.0-255,66,225523,92,275055
2549,0.04031,74.125.24.0-255,4320,229843,92,275055
2550,0.040327,172.31.47.0-255,66,229909,92,275055
2551,0.040344,74.125.24.0-255,1484,231393,92,275055
2552,0.042664,74.125.24.0-255,4320,235713,92,275055
2553,0.042668,172.31.47.0-255,66,235779,92,275055
2554,0.045003,74.125.24.0-255,4320,240099,92,275055
2555,0.045008,172.31.47.0-255,66,240165,92,275055
2556,0.04503,74.125.24.0-255,1484,241649,92,275055
2557,0.04735,74.125.24.0-255,4320,245969,92,275055
2558,0.047355,172.31.47.0-255,66,246035,92,275055
2559,0.049744,74.125.24.0-255,5738,251773,92,275055
2560,0.04976,172.31.47.0-255,66,251839,92,275055
2561,0.052123,74.125.24.0-255,5738,257577,92,275055
2562,0.052128,172.31.47.0-255,66,257643,92,275055
2563,0.054513,74.125.24.0-255,5738,263381,92,275055
2564,0.054517,172.31.47.0-255,66,263447,92,275055
2565,0.056895,74.125.24.0-255,5738,269185,92,275055
2566,0.056901,172.31.47.0-255,66,269251,92,275055
2567,0.059295,74.125.24.0-255,5738,274989,92,275055
2568,0.0593,172.31.47.0-255,66,275055,92,275055
2569,0.0,74.125.200.0-255,298,298,92,374476
2570,2.7e-05,172.31.47.0-255,66,364,92,374476
2571,3.3e-05,74.125.200.0-255,1484,1848,92,374476
2572,3.7e-05,172.31.47.0-255,66,1914,92,374476
2573,4e-05,74.125.200.0-255,1484,3398,92,374476
2574,4.2e-05,172.31.47.0-255,66,3464,92,374476
2575,6e-05,74.125.200.0-255,2902,6366,92,374476
2576,6.3e-05,172.31.47.0-255,66,6432,92,374476
2577,6.6e-05,74.125.200.0-255,1484,7916,92,374476
2578,6.8e-05,172.31.47.0-255,66,7982,92,374476
2579,9.3e-05,74.125.200.0-255,6272,14254,92,374476
2580,9.6e-05,172.31.47.0-255,66,14320,92,374476
2581,0.00014,74.125.200.0-255,1484,15804,92,374476
2582,0.000143,172.31.47.0-255,66,15870,92,374476
2583,0.000146,74.125.200.0-255,1484,17354,92,374476
2584,0.000148,172.31.47.0-255,66,17420,92,374476
2585,0.00016,74.125.200.0-255,1484,18904,92,374476
2586,0.000162,172.31.47.0-255,66,18970,92,374476
2587,0.000165,74.125.200.0-255,1484,20454,92,374476
2588,0.000168,172.31.47.0-255,66,20520,92,374476
2589,0.000179,74.125.200.0-255,1484,22004,92,374476
2590,0.000181,172.31.47.0-255,66,22070,92,374476
2591,0.000198,74.125.200.0-255,4320,26390,92,374476
2592,0.000201,172.31.47.0-255,66,26456,92,374476
2593,0.000219,74.125.200.0-255,4320,30776,92,374476
2594,0.000221,172.31.47.0-255,66,30842,92,374476
2595,0.000241,74.125.200.0-255,1125,31967,92,374476
2596,0.000243,172.31.47.0-255,66,32033,92,374476
2597,0.000273,74.125.200.0-255,4320,36353,92,374476
2598,0.000277,172.31.47.0-255,66,36419,92,374476
2599,0.000297,74.125.200.0-255,2902,39321,92,374476
2600,0.000299,172.31.47.0-255,66,39387,92,374476
2601,0.000316,74.125.200.0-255,2902,42289,92,374476
2602,0.000318,74.125.200.0-255,1484,43773,92,374476
2603,0.000321,172.31.47.0-255,66,43839,92,374476
2604,0.000324,172.31.47.0-255,66,43905,92,374476
2605,0.000344,74.125.200.0-255,4320,48225,92,374476
2606,0.000347,172.31.47.0-255,66,48291,92,374476
2607,0.000365,74.125.200.0-255,1125,49416,92,374476
2608,0.000368,172.31.47.0-255,66,49482,92,374476
2609,0.000435,74.125.200.0-255,1484,50966,92,374476
2610,0.000439,172.31.47.0-255,66,51032,92,374476
2611,0.000453,74.125.200.0-255,2902,53934,92,374476
2612,0.000456,172.31.47.0-255,66,54000,92,374476
2613,0.000472,74.125.200.0-255,1484,55484,92,374476
2614,0.000475,172.31.47.0-255,66,55550,92,374476
2615,0.000494,74.125.200.0-255,2902,58452,92,374476
2616,0.000497,172.31.47.0-255,66,58518,92,374476
2617,0.000501,74.125.200.0-255,2902,61420,92,374476
2618,0.000504,172.31.47.0-255,66,61486,92,374476
2619,0.000522,74.125.200.0-255,2902,64388,92,374476
2620,0.000525,172.31.47.0-255,66,64454,92,374476
2621,0.00053,74.125.200.0-255,2543,66997,92,374476
2622,0.000531,172.31.47.0-255,66,67063,92,374476
2623,0.000562,74.125.200.0-255,647,67710,92,374476
2624,0.000565,172.31.47.0-255,66,67776,92,374476
2625,0.000653,74.125.200.0-255,1484,69260,92,374476
2626,0.000657,172.31.47.0-255,66,69326,92,374476
2627,0.000668,74.125.200.0-255,2902,72228,92,374476
2628,0.000671,172.31.47.0-255,66,72294,92,374476
2629,0.000691,74.125.200.0-255,2902,75196,92,374476
2630,0.000694,172.31.47.0-255,66,75262,92,374476
2631,0.00071,74.125.200.0-255,1484,76746,92,374476
2632,0.000713,172.31.47.0-255,66,76812,92,374476
2633,0.000728,74.125.200.0-255,1484,78296,92,374476
2634,0.00073,172.31.47.0-255,66,78362,92,374476
2635,0.000751,74.125.200.0-255,6797,85159,92,374476
2636,0.000753,172.31.47.0-255,66,85225,92,374476
2637,0.00082,74.125.200.0-255,1484,86709,92,374476
2638,0.000842,74.125.200.0-255,2902,89611,92,374476
2639,0.000845,172.31.47.0-255,66,89677,92,374476
2640,0.000887,74.125.200.0-255,5738,95415,92,374476
2641,0.00089,172.31.47.0-255,66,95481,92,374476
2642,0.000894,74.125.200.0-255,2902,98383,92,374476
2643,0.000896,172.31.47.0-255,66,98449,92,374476
2644,0.000912,74.125.200.0-255,3961,102410,92,374476
2645,0.000916,172.31.47.0-255,66,102476,92,374476
2646,0.001337,74.125.200.0-255,1484,103960,92,374476
2647,0.001356,74.125.200.0-255,2902,106862,92,374476
2648,0.001361,172.31.47.0-255,66,106928,92,374476
2649,0.001385,74.125.200.0-255,5738,112666,92,374476
2650,0.001389,172.31.47.0-255,66,112732,92,374476
2651,0.001392,74.125.200.0-255,1484,114216,92,374476
2652,0.001405,74.125.200.0-255,2902,117118,92,374476
2653,0.001408,172.31.47.0-255,66,117184,92,374476
2654,0.001431,74.125.200.0-255,5738,122922,92,374476
2655,0.001434,172.31.47.0-255,66,122988,92,374476
2656,0.001437,74.125.200.0-255,1484,124472,92,374476
2657,0.001453,74.125.200.0-255,4320,128792,92,374476
2658,0.001456,172.31.47.0-255,66,128858,92,374476
2659,0.001502,74.125.200.0-255,2902,131760,92,374476
2660,0.001506,172.31.47.0-255,66,131826,92,374476
2661,0.001521,74.125.200.0-255,4320,136146,92,374476
2662,0.001523,172.31.47.0-255,66,136212,92,374476
2663,0.001526,74.125.200.0-255,766,136978,92,374476
2664,0.001564,74.125.200.0-255,1484,138462,92,374476
2665,0.001567,172.31.47.0-255,66,138528,92,374476
2666,0.001571,74.125.200.0-255,1484,140012,92,374476
2667,0.001587,74.125.200.0-255,1484,141496,92,374476
2668,0.00159,172.31.47.0-255,66,141562,92,374476
2669,0.001595,74.125.200.0-255,5738,147300,92,374476
2670,0.001597,172.31.47.0-255,66,147366,92,374476
2671,0.001601,74.125.200.0-255,2902,150268,92,374476
2672,0.001603,172.31.47.0-255,66,150334,92,374476
2673,0.001626,74.125.200.0-255,4320,154654,92,374476
2674,0.001628,172.31.47.0-255,66,154720,92,374476
2675,0.00165,74.125.200.0-255,5738,160458,92,374476
2676,0.001653,172.31.47.0-255,66,160524,92,374476
2677,0.001659,74.125.200.0-255,5738,166262,92,374476
2678,0.001662,172.31.47.0-255,66,166328,92,374476
2679,0.001691,74.125.200.0-255,5020,171348,92,374476
2680,0.001694,172.31.47.0-255,66,171414,92,374476
2681,0.001822,74.125.200.0-255,1484,172898,92,374476
2682,0.001837,74.125.200.0-255,2902,175800,92,374476
2683,0.001842,172.31.47.0-255,66,175866,92,374476
2684,0.001845,74.125.200.0-255,1484,177350,92,374476
2685,0.001848,74.125.200.0-255,1484,178834,92,374476
2686,0.00185,172.31.47.0-255,66,178900,92,374476
2687,0.001867,74.125.200.0-255,1484,180384,92,374476
2688,0.001886,74.125.200.0-255,4320,184704,92,374476
2689,0.00189,172.31.47.0-255,66,184770,92,374476
2690,0.001909,74.125.200.0-255,1484,186254,92,374476
2691,0.001915,74.125.200.0-255,2902,189156,92,374476
2692,0.001919,172.31.47.0-255,66,189222,92,374476
2693,0.001924,74.125.200.0-255,4320,193542,92,374476
2694,0.001943,74.125.200.0-255,2902,196444,92,374476
2695,0.00196,74.125.200.0-255,1484,197928,92,374476
2696,0.00198,74.125.200.0-255,2902,200830,92,374476
2697,0.002001,74.125.200.0-255,5020,205850,92,374476
2698,0.002353,74.125.200.0-255,1484,207334,92,374476
2699,0.002374,74.125.200.0-255,2902,210236,92,374476
2700,0.002386,74.125.200.0-255,2902,213138,92,374476
2701,0.002402,74.125.200.0-255,2902,216040,92,374476
2702,0.002405,74.125.200.0-255,1484,217524,92,374476
2703,0.002407,74.125.200.0-255,1484,219008,92,374476
2704,0.002424,74.125.200.0-255,1484,220492,92,374476
2705,0.002427,74.125.200.0-255,1484,221976,92,374476
2706,0.002448,74.125.200.0-255,4320,226296,92,374476
2707,0.002451,74.125.200.0-255,2902,229198,92,374476
2708,0.002467,74.125.200.0-255,4320,233518,92,374476
2709,0.002502,74.125.200.0-255,2902,236420,92,374476
2710,0.002513,74.125.200.0-255,3602,240022,92,374476
2711,0.003466,172.31.47.0-255,66,240088,92,374476
2712,0.005971,74.125.200.0-255,5738,245826,92,374476
2713,0.005977,172.31.47.0-255,66,245892,92,374476
2714,0.008493,74.125.200.0-255,5738,251630,92,374476
2715,0.008499,172.31.47.0-255,66,251696,92,374476
2716,0.011019,74.125.200.0-255,5738,257434,92,374476
2717,0.011032,172.31.47.0-255,66,257500,92,374476
2718,0.013548,74.125.200.0-255,5738,263238,92,374476
2719,0.013556,172.31.47.0-255,66,263304,92,374476
2720,0.016085,74.125.200.0-255,5738,269042,92,374476
2721,0.016092,172.31.47.0-255,66,269108,92,374476
2722,0.018623,74.125.200.0-255,5738,274846,92,374476
2723,0.018637,172.31.47.0-255,66,274912,92,374476
2724,0.021151,74.125.200.0-255,5738,280650,92,374476
2725,0.021159,172.31.47.0-255,66,280716,92,374476
2726,0.023677,74.125.200.0-255,5738,286454,92,374476
2727,0.023685,172.31.47.0-255,66,286520,92,374476
2728,0.026198,74.125.200.0-255,5738,292258,92,374476
2729,0.026207,172.31.47.0-255,66,292324,92,374476
2730,0.02687,172.31.47.0-255,172,292496,92,374476
2731,0.026895,172.31.47.0-255,1107,293603,92,374476
2732,0.026958,172.31.47.0-255,1514,295117,92,374476
2733,0.026959,172.31.47.0-255,1514,296631,92,374476
2734,0.026961,172.31.47.0-255,1514,298145,92,374476
2735,0.026962,172.31.47.0-255,1514,299659,92,374476
2736,0.026963,172.31.47.0-255,1499,301158,92,374476
2737,0.028446,104.244.42.0-255,66,301224,92,374476
2738,0.028453,104.244.42.0-255,66,301290,92,374476
2739,0.028537,104.244.42.0-255,66,301356,92,374476
2740,0.028729,74.125.200.0-255,1484,302840,92,374476
2741,0.028759,74.125.200.0-255,4320,307160,92,374476
2742,0.028764,172.31.47.0-255,66,307226,92,374476
2743,0.029148,104.244.42.0-255,108,307334,92,374476
2744,0.029152,172.31.47.0-255,66,307400,92,374476
2745,0.031269,74.125.200.0-255,4320,311720,92,374476
2746,0.031273,172.31.47.0-255,66,311786,92,374476
2747,0.031294,74.125.200.0-255,1484,313270,92,374476
2748,0.033774,74.125.200.0-255,4320,317590,92,374476
2749,0.033779,172.31.47.0-255,66,317656,92,374476
2750,0.036302,74.125.200.0-255,5738,323394,92,374476
2751,0.036307,172.31.47.0-255,66,323460,92,374476
2752,0.038808,74.125.200.0-255,5738,329198,92,374476
2753,0.038813,172.31.47.0-255,66,329264,92,374476
2754,0.041305,74.125.200.0-255,5738,335002,92,374476
2755,0.04131,172.31.47.0-255,66,335068,92,374476
2756,0.04383,74.125.200.0-255,5738,340806,92,374476
2757,0.043835,172.31.47.0-255,66,340872,92,374476
2758,0.04635,74.125.200.0-255,4320,345192,92,374476
2759,0.046354,172.31.47.0-255,66,345258,92,374476
2760,0.046382,74.125.200.0-255,1484,346742,92,374476
2761,0.048852,74.125.200.0-255,4320,351062,92,374476
2762,0.048857,172.31.47.0-255,66,351128,92,374476
2763,0.05137,74.125.200.0-255,5738,356866,92,374476
2764,0.051376,172.31.47.0-255,66,356932,92,374476
2765,0.053885,74.125.200.0-255,5738,362670,92,374476
2766,0.053889,172.31.47.0-255,66,362736,92,374476
2767,0.056403,74.125.200.0-255,5738,368474,92,374476
2768,0.056408,172.31.47.0-255,66,368540,92,374476
2769,0.0589,74.125.200.0-255,2902,371442,92,374476
2770,0.058905,172.31.47.0-255,66,371508,92,374476
2771,0.058937,74.125.200.0-255,2902,374410,92,374476
2772,0.05894,172.31.47.0-255,66,374476,92,374476
2773,0.0,172.217.194.0-255,153,153,92,218543
2774,2.6e-05,172.31.47.0-255,66,219,92,218543
2775,3.2e-05,172.217.194.0-255,1484,1703,92,218543
2776,3.5e-05,172.31.47.0-255,66,1769,92,218543
2777,3.9e-05,172.217.194.0-255,2902,4671,92,218543
2778,4.1e-05,172.31.47.0-255,66,4737,92,218543
2779,4.8e-05,172.217.194.0-255,7156,11893,92,218543
2780,5e-05,172.31.47.0-255,66,11959,92,218543
2781,7.6e-05,172.217.194.0-255,2130,14089,92,218543
2782,7.8e-05,172.31.47.0-255,66,14155,92,218543
2783,9.1e-05,172.217.194.0-255,2902,17057,92,218543
2784,9.3e-05,172.31.47.0-255,66,17123,92,218543
2785,9.6e-05,172.217.194.0-255,1484,18607,92,218543
2786,9.7e-05,172.31.47.0-255,66,18673,92,218543
2787,0.000117,172.217.194.0-255,5738,24411,92,218543
2788,0.000119,172.31.47.0-255,66,24477,92,218543
2789,0.000133,172.217.194.0-255,6797,31274,92,218543
2790,0.000136,172.31.47.0-255,66,31340,92,218543
2791,0.000206,172.217.194.0-255,1484,32824,92,218543
2792,0.000209,172.31.47.0-255,66,32890,92,218543
2793,0.000213,172.217.194.0-255,2902,35792,92,218543
2794,0.000215,172.31.47.0-255,66,35858,92,218543
2795,0.000229,172.217.194.0-255,4320,40178,92,218543
2796,0.000232,172.31.47.0-255,66,40244,92,218543
2797,0.000243,172.217.194.0-255,1484,41728,92,218543
2798,0.000245,172.31.47.0-255,66,41794,92,218543
2799,0.000289,172.31.47.0-255,66,41860,92,218543
2800,0.000298,172.31.47.0-255,66,41926,92,218543
2801,0.000329,172.217.194.0-255,1419,43345,92,218543
2802,0.000332,172.31.47.0-255,66,43411,92,218543
2803,0.000362,172.217.194.0-255,383,43794,92,218543
2804,0.0004,172.217.194.0-255,1484,45278,92,218543
2805,0.000402,172.31.47.0-255,66,45344,92,218543
2806,0.000414,172.217.194.0-255,1484,46828,92,218543
2807,0.000431,172.217.194.0-255,2902,49730,92,218543
2808,0.000433,172.31.47.0-255,66,49796,92,218543
2809,0.000445,172.31.47.0-255,66,49862,92,218543
2810,0.000462,172.217.194.0-255,1484,51346,92,218543
2811,0.000478,172.31.47.0-255,66,51412,92,218543
2812,0.000513,172.217.194.0-255,6438,57850,92,218543
2813,0.000515,172.31.47.0-255,66,57916,92,218543
2814,0.00053,172.217.194.0-255,2902,60818,92,218543
2815,0.000537,172.31.47.0-255,66,60884,92,218543
2816,0.000556,172.217.194.0-255,4320,65204,92,218543
2817,0.000561,172.217.194.0-255,5738,70942,92,218543
2818,0.000561,172.31.47.0-255,66,71008,92,218543
2819,0.000564,172.217.194.0-255,2902,73910,92,218543
2820,0.000574,172.31.47.0-255,66,73976,92,218543
2821,0.000577,172.217.194.0-255,2902,76878,92,218543
2822,0.000586,172.31.47.0-255,66,76944,92,218543
2823,0.00061,172.31.47.0-255,66,77010,92,218543
2824,0.000624,172.217.194.0-255,1484,78494,92,218543
2825,0.000644,172.217.194.0-255,5020,83514,92,218543
2826,0.000653,172.31.47.0-255,66,83580,92,218543
2827,0.00066,172.217.194.0-255,1484,85064,92,218543
2828,0.000673,172.217.194.0-255,5738,90802,92,218543
2829,0.000676,172.31.47.0-255,66,90868,92,218543
2830,0.000679,172.217.194.0-255,2902,93770,92,218543
2831,0.000689,172.31.47.0-255,66,93836,92,218543
2832,0.000702,172.217.194.0-255,5738,99574,92,218543
2833,0.000716,172.217.194.0-255,2902,102476,92,218543
2834,0.000717,172.31.47.0-255,66,102542,92,218543
2835,0.000721,172.31.47.0-255,66,102608,92,218543
2836,0.00075,172.31.47.0-255,66,102674,92,218543
2837,0.000756,172.217.194.0-255,1484,104158,92,218543
2838,0.000759,172.217.194.0-255,766,104924,92,218543
2839,0.000762,172.31.47.0-255,66,104990,92,218543
2840,0.000769,172.217.194.0-255,1484,106474,92,218543
2841,0.000773,172.217.194.0-255,2902,109376,92,218543
2842,0.000778,172.217.194.0-255,5738,115114,92,218543
2843,0.000784,172.31.47.0-255,66,115180,92,218543
2844,0.000798,172.217.194.0-255,4320,119500,92,218543
2845,0.000802,172.31.47.0-255,66,119566,92,218543
2846,0.000828,172.217.194.0-255,2902,122468,92,218543
2847,0.000829,172.31.47.0-255,66,122534,92,218543
2848,0.000833,172.31.47.0-255,66,122600,92,218543
2849,0.000855,172.217.194.0-255,2902,125502,92,218543
2850,0.000866,172.31.47.0-255,66,125568,92,218543
2851,0.000871,172.217.194.0-255,4471,130039,92,218543
2852,0.000878,172.31.47.0-255,66,130105,92,218543
2853,0.000907,172.217.194.0-255,4320,134425,92,218543
2854,0.000915,172.31.47.0-255,66,134491,92,218543
2855,0.000917,172.217.194.0-255,1484,135975,92,218543
2856,0.000935,172.217.194.0-255,4320,140295,92,218543
2857,0.000944,172.31.47.0-255,66,140361,92,218543
2858,0.000948,172.31.47.0-255,66,140427,92,218543
2859,0.000988,172.31.47.0-255,66,140493,92,218543
2860,0.001001,172.217.194.0-255,1484,141977,92,218543
2861,0.001043,172.31.47.0-255,66,142043,92,218543
2862,0.001066,172.217.194.0-255,5738,147781,92,218543
2863,0.001074,172.31.47.0-255,66,147847,92,218543
2864,0.001085,172.31.47.0-255,66,147913,92,218543
2865,0.001088,172.31.47.0-255,66,147979,92,218543
2866,0.001299,172.217.194.0-255,1484,149463,92,218543
2867,0.001303,172.217.194.0-255,1484,150947,92,218543
2868,0.001306,172.31.47.0-255,66,151013,92,218543
2869,0.001316,172.217.194.0-255,1484,152497,92,218543
2870,0.001333,172.217.194.0-255,5738,158235,92,218543
2871,0.00134,172.31.47.0-255,66,158301,92,218543
2872,0.001379,172.31.47.0-255,66,158367,92,218543
2873,0.001424,172.31.47.0-255,66,158433,92,218543
2874,0.001435,172.31.47.0-255,66,158499,92,218543
2875,0.001487,172.217.194.0-255,7156,165655,92,218543
2876,0.001494,172.31.47.0-255,66,165721,92,218543
2877,0.001508,172.217.194.0-255,5020,170741,92,218543
2878,0.001513,172.31.47.0-255,66,170807,92,218543
2879,0.001523,172.217.194.0-255,2902,173709,92,218543
2880,0.001531,172.31.47.0-255,66,173775,92,218543
2881,0.001546,172.31.47.0-255,66,173841,92,218543
2882,0.001551,172.217.194.0-255,4320,178161,92,218543
2883,0.001554,172.31.47.0-255,66,178227,92,218543
2884,0.001582,172.31.47.0-255,66,178293,92,218543
2885,0.001598,172.217.194.0-255,2902,181195,92,218543
2886,0.001604,172.31.47.0-255,66,181261,92,218543
2887,0.001611,172.217.194.0-255,5738,186999,92,218543
2888,0.001615,172.31.47.0-255,66,187065,92,218543
2889,0.001621,172.217.194.0-255,1484,188549,92,218543
2890,0.001624,172.217.194.0-255,1484,190033,92,218543
2891,0.00163,172.31.47.0-255,66,190099,92,218543
2892,0.001637,172.217.194.0-255,7156,197255,92,218543
2893,0.001642,172.31.47.0-255,66,197321,92,218543
2894,0.00165,172.217.194.0-255,2902,200223,92,218543
2895,0.001653,172.31.47.0-255,66,200289,92,218543
2896,0.001683,172.217.194.0-255,1484,201773,92,218543
2897,0.001702,172.217.194.0-255,7156,208929,92,218543
2898,0.001713,172.31.47.0-255,66,208995,92,218543
2899,0.001719,172.217.194.0-255,105,209100,92,218543
2900,0.001725,172.31.47.0-255,66,209166,92,218543
2901,0.002975,172.31.47.0-255,105,209271,92,218543
2902,0.005016,172.217.194.0-255,66,209337,92,218543
2903,0.027561,172.31.47.0-255,172,209509,92,218543
2904,0.027589,172.31.47.0-255,1112,210621,92,218543
2905,0.027631,172.31.47.0-255,1514,212135,92,218543
2906,0.027632,172.31.47.0-255,1514,213649,92,218543
2907,0.027633,172.31.47.0-255,1514,215163,92,218543
2908,0.027634,172.31.47.0-255,1514,216677,92,218543
2909,0.027635,172.31.47.0-255,1494,218171,92,218543
2910,0.02914,104.244.42.0-255,66,218237,92,218543
2911,0.029176,104.244.42.0-255,66,218303,92,218543
2912,0.029263,104.244.42.0-255,66,218369,92,218543
2913,0.029799,104.244.42.0-255,108,218477,92,218543
2914,0.029804,172.31.47.0-255,66,218543,92,218543
2915,0.0,172.31.47.0-255,105,105,92,276
2916,0.001483,157.240.13.0-255,105,210,92,276
2917,0.001492,172.31.47.0-255,66,276,92,276
2918,0.0,172.217.26.0-255,152,152,92,260402
2919,2e-05,172.31.47.0-255,66,218,92,260402
2920,2.7e-05,172.217.26.0-255,1484,1702,92,260402
2921,3.1e-05,172.31.47.0-255,66,1768,92,260402
2922,3.7e-05,172.217.26.0-255,2902,4670,92,260402
2923,4.8e-05,172.31.47.0-255,66,4736,92,260402
2924,5.6e-05,172.217.26.0-255,7156,11892,92,260402
2925,5.9e-05,172.31.47.0-255,66,11958,92,260402
2926,6.3e-05,172.217.26.0-255,2044,14002,92,260402
2927,6.5e-05,172.31.47.0-255,66,14068,92,260402
2928,0.000135,172.217.26.0-255,1484,15552,92,260402
2929,0.000139,172.31.47.0-255,66,15618,92,260402
2930,0.000144,172.217.26.0-255,2902,18520,92,260402
2931,0.000147,172.31.47.0-255,66,18586,92,260402
2932,0.000178,172.217.26.0-255,5738,24324,92,260402
2933,0.00018,172.31.47.0-255,66,24390,92,260402
2934,0.000215,172.217.26.0-255,6797,31187,92,260402
2935,0.000218,172.31.47.0-255,66,31253,92,260402
2936,0.000262,172.217.26.0-255,1484,32737,92,260402
2937,0.000264,172.31.47.0-255,66,32803,92,260402
2938,0.000269,172.217.26.0-255,2902,35705,92,260402
2939,0.000271,172.31.47.0-255,66,35771,92,260402
2940,0.000277,172.217.26.0-255,4320,40091,92,260402
2941,0.000283,172.31.47.0-255,66,40157,92,260402
2942,0.000318,172.217.26.0-255,1484,41641,92,260402
2943,0.000321,172.31.47.0-255,66,41707,92,260402
2944,0.000328,172.217.26.0-255,6797,48504,92,260402
2945,0.000331,172.31.47.0-255,66,48570,92,260402
2946,0.001362,172.217.26.0-255,1484,50054,92,260402
2947,0.00137,172.31.47.0-255,66,50120,92,260402
2948,0.001379,172.217.26.0-255,2902,53022,92,260402
2949,0.001381,172.31.47.0-255,66,53088,92,260402
2950,0.001393,172.217.26.0-255,5738,58826,92,260402
2951,0.001395,172.31.47.0-255,66,58892,92,260402
2952,0.001424,172.217.26.0-255,5738,64630,92,260402
2953,0.001427,172.31.47.0-255,66,64696,92,260402
2954,0.001461,172.31.47.0-255,66,64762,92,260402
2955,0.001473,172.31.47.0-255,66,64828,92,260402
2956,0.001501,172.217.26.0-255,7156,71984,92,260402
2957,0.001504,172.31.47.0-255,66,72050,92,260402
2958,0.001516,172.217.26.0-255,2902,74952,92,260402
2959,0.001522,172.31.47.0-255,66,75018,92,260402
2960,0.001529,172.217.26.0-255,4320,79338,92,260402
2961,0.001531,172.31.47.0-255,66,79404,92,260402
2962,0.001557,172.217.26.0-255,3122,82526,92,260402
2963,0.00156,172.31.47.0-255,66,82592,92,260402
2964,0.003412,172.217.26.0-255,1484,84076,92,260402
2965,0.003444,172.217.26.0-255,2902,86978,92,260402
2966,0.00345,172.31.47.0-255,66,87044,92,260402
2967,0.003478,172.217.26.0-255,1484,88528,92,260402
2968,0.005353,172.217.26.0-255,4320,92848,92,260402
2969,0.005359,172.31.47.0-255,66,92914,92,260402
2970,0.007278,172.217.26.0-255,5738,98652,92,260402
2971,0.007284,172.31.47.0-255,66,98718,92,260402
2972,0.009279,172.217.26.0-255,5738,104456,92,260402
2973,0.009289,172.31.47.0-255,66,104522,92,260402
2974,0.011222,172.217.26.0-255,4320,108842,92,260402
2975,0.01123,172.31.47.0-255,66,108908,92,260402
2976,0.011256,172.217.26.0-255,1484,110392,92,260402
2977,0.013125,172.217.26.0-255,4320,114712,92,260402
2978,0.013132,172.31.47.0-255,66,114778,92,260402
2979,0.015022,172.217.26.0-255,4320,119098,92,260402
2980,0.015028,172.31.47.0-255,66,119164,92,260402
2981,0.01505,172.217.26.0-255,1484,120648,92,260402
2982,0.016934,172.217.26.0-255,4320,124968,92,260402
2983,0.01694,172.31.47.0-255,66,125034,92,260402
2984,0.018836,172.217.26.0-255,5738,130772,92,260402
2985,0.018844,172.31.47.0-255,66,130838,92,260402
2986,0.02074,172.217.26.0-255,5738,136576,92,260402
2987,0.020747,172.31.47.0-255,66,136642,92,260402
2988,0.022639,172.217.26.0-255,5738,142380,92,260402
2989,0.022645,172.31.47.0-255,66,142446,92,260402
2990,0.024534,172.217.26.0-255,5738,148184,92,260402
2991,0.02454,172.31.47.0-255,66,148250,92,260402
2992,0.026433,172.217.26.0-255,5738,153988,92,260402
2993,0.02644,172.31.47.0-255,66,154054,92,260402
2994,0.028348,172.217.26.0-255,5738,159792,92,260402
2995,0.028359,172.31.47.0-255,66,159858,92,260402
2996,0.030257,172.217.26.0-255,5738,165596,92,260402
2997,0.030263,172.31.47.0-255,66,165662,92,260402
2998,0.032162,172.217.26.0-255,5738,171400,92,260402
2999,0.032168,172.31.47.0-255,66,171466,92,260402
3000,0.034101,172.217.26.0-255,4320,175786,92,260402
3001,0.034107,172.31.47.0-255,66,175852,92,260402
3002,0.03413,172.217.26.0-255,1484,177336,92,260402
3003,0.036055,172.217.26.0-255,4320,181656,92,260402
3004,0.036063,172.31.47.0-255,66,181722,92,260402
3005,0.037985,172.217.26.0-255,5738,187460,92,260402
3006,0.037992,172.31.47.0-255,66,187526,92,260402
3007,0.039899,172.217.26.0-255,5738,193264,92,260402
3008,0.039909,172.31.47.0-255,66,193330,92,260402
3009,0.041821,172.217.26.0-255,5738,199068,92,260402
3010,0.04183,172.31.47.0-255,66,199134,92,260402
3011,0.043735,172.217.26.0-255,5738,204872,92,260402
3012,0.043741,172.31.47.0-255,66,204938,92,260402
3013,0.043842,172.31.47.0-255,172,205110,92,260402
3014,0.04389,172.31.47.0-255,1112,206222,92,260402
3015,0.043976,172.31.47.0-255,1514,207736,92,260402
3016,0.043978,172.31.47.0-255,1514,209250,92,260402
3017,0.043983,172.31.47.0-255,1514,210764,92,260402
3018,0.043984,172.31.47.0-255,1514,212278,92,260402
3019,0.044002,172.31.47.0-255,1494,213772,92,260402
3020,0.045401,104.244.42.0-255,66,213838,92,260402
3021,0.045462,104.244.42.0-255,66,213904,92,260402
3022,0.045577,104.244.42.0-255,66,213970,92,260402
3023,0.045655,172.217.26.0-255,5738,219708,92,260402
3024,0.04566,172.31.47.0-255,66,219774,92,260402
3025,0.047566,172.217.26.0-255,5738,225512,92,260402
3026,0.04757,172.31.47.0-255,66,225578,92,260402
3027,0.049478,172.217.26.0-255,5738,231316,92,260402
3028,0.049486,172.31.47.0-255,66,231382,92,260402
3029,0.051394,172.217.26.0-255,5738,237120,92,260402
3030,0.051401,172.31.47.0-255,66,237186,92,260402
3031,0.053301,172.217.26.0-255,5738,242924,92,260402
3032,0.053307,172.31.47.0-255,66,242990,92,260402
3033,0.055223,172.217.26.0-255,5738,248728,92,260402
3034,0.055229,172.31.47.0-255,66,248794,92,260402
3035,0.05713,172.217.26.0-255,5738,254532,92,260402
3036,0.057136,172.31.47.0-255,66,254598,92,260402
3037,0.059042,172.217.26.0-255,5738,260336,92,260402
3038,0.059048,172.31.47.0-255,66,260402,92,260402
3039,0.0,172.217.194.0-255,153,153,92,331121
3040,2.6e-05,172.31.47.0-255,66,219,92,331121
3041,3.3e-05,172.217.194.0-255,1484,1703,92,331121
3042,3.6e-05,172.31.47.0-255,66,1769,92,331121
3043,4.1e-05,172.217.194.0-255,2902,4671,92,331121
3044,4.3e-05,172.31.47.0-255,66,4737,92,331121
3045,5.6e-05,172.217.194.0-255,4320,9057,92,331121
3046,5.9e-05,172.31.47.0-255,66,9123,92,331121
3047,9.3e-05,172.217.194.0-255,2902,12025,92,331121
3048,9.6e-05,172.31.47.0-255,66,12091,92,331121
3049,0.000102,172.217.194.0-255,3592,15683,92,331121
3050,0.000104,172.31.47.0-255,66,15749,92,331121
3051,0.000123,172.31.47.0-255,66,15815,92,331121
3052,0.000127,172.217.194.0-255,2543,18358,92,331121
3053,0.00013,172.31.47.0-255,66,18424,92,331121
3054,0.000202,172.217.194.0-255,1484,19908,92,331121
3055,0.000205,172.31.47.0-255,66,19974,92,331121
3056,0.000222,172.217.194.0-255,2902,22876,92,331121
3057,0.000225,172.31.47.0-255,66,22942,92,331121
3058,0.000231,172.217.194.0-255,5738,28680,92,331121
3059,0.000233,172.31.47.0-255,66,28746,92,331121
3060,0.000277,172.217.194.0-255,7156,35902,92,331121
3061,0.000282,172.31.47.0-255,66,35968,92,331121
3062,0.000299,172.217.194.0-255,6797,42765,92,331121
3063,0.000306,172.31.47.0-255,66,42831,92,331121
3064,0.000317,172.31.47.0-255,66,42897,92,331121
3065,0.000338,172.217.194.0-255,1746,44643,92,331121
3066,0.000341,172.31.47.0-255,66,44709,92,331121
3067,0.000681,172.217.194.0-255,1484,46193,92,331121
3068,0.000685,172.217.194.0-255,1484,47677,92,331121
3069,0.000687,172.31.47.0-255,66,47743,92,331121
3070,0.000701,172.217.194.0-255,1484,49227,92,331121
3071,0.000708,172.31.47.0-255,66,49293,92,331121
3072,0.000714,172.217.194.0-255,5738,55031,92,331121
3073,0.000717,172.31.47.0-255,66,55097,92,331121
3074,0.000722,172.217.194.0-255,2902,57999,92,331121
3075,0.000724,172.31.47.0-255,66,58065,92,331121
3076,0.000761,172.31.47.0-255,66,58131,92,331121
3077,0.000774,172.31.47.0-255,66,58197,92,331121
3078,0.000808,172.31.47.0-255,66,58263,92,331121
3079,0.000843,172.31.47.0-255,66,58329,92,331121
3080,0.000846,172.217.194.0-255,1484,59813,92,331121
3081,0.00085,172.217.194.0-255,2902,62715,92,331121
3082,0.000852,172.31.47.0-255,66,62781,92,331121
3083,0.000857,172.217.194.0-255,2902,65683,92,331121
3084,0.000859,172.31.47.0-255,66,65749,92,331121
3085,0.000888,172.217.194.0-255,2902,68651,92,331121
3086,0.000892,172.31.47.0-255,66,68717,92,331121
3087,0.000898,172.217.194.0-255,5738,74455,92,331121
3088,0.000903,172.31.47.0-255,66,74521,92,331121
3089,0.000937,172.217.194.0-255,7156,81677,92,331121
3090,0.00094,172.31.47.0-255,66,81743,92,331121
3091,0.000951,172.31.47.0-255,66,81809,92,331121
3092,0.00096,172.217.194.0-255,766,82575,92,331121
3093,0.001029,172.217.194.0-255,1484,84059,92,331121
3094,0.001033,172.31.47.0-255,66,84125,92,331121
3095,0.001038,172.217.194.0-255,2902,87027,92,331121
3096,0.001041,172.31.47.0-255,66,87093,92,331121
3097,0.001076,172.217.194.0-255,5738,92831,92,331121
3098,0.001079,172.31.47.0-255,66,92897,92,331121
3099,0.001082,172.217.194.0-255,1484,94381,92,331121
3100,0.001107,172.217.194.0-255,5379,99760,92,331121
3101,0.00111,172.31.47.0-255,66,99826,92,331121
3102,0.001137,172.217.194.0-255,4320,104146,92,331121
3103,0.00114,172.31.47.0-255,66,104212,92,331121
3104,0.001167,172.217.194.0-255,1484,105696,92,331121
3105,0.001182,172.31.47.0-255,66,105762,92,331121
3106,0.001187,172.217.194.0-255,4320,110082,92,331121
3107,0.001189,172.31.47.0-255,66,110148,92,331121
3108,0.00123,172.217.194.0-255,766,110914,92,331121
3109,0.001233,172.31.47.0-255,66,110980,92,331121
3110,0.001456,172.217.194.0-255,1484,112464,92,331121
3111,0.00146,172.31.47.0-255,66,112530,92,331121
3112,0.001466,172.217.194.0-255,2902,115432,92,331121
3113,0.001468,172.31.47.0-255,66,115498,92,331121
3114,0.001498,172.217.194.0-255,5738,121236,92,331121
3115,0.001501,172.31.47.0-255,66,121302,92,331121
3116,0.00153,172.217.194.0-255,6797,128099,92,331121
3117,0.001533,172.31.47.0-255,66,128165,92,331121
3118,0.00163,172.217.194.0-255,1484,129649,92,331121
3119,0.001636,172.217.194.0-255,2902,132551,92,331121
3120,0.001639,172.31.47.0-255,66,132617,92,331121
3121,0.001643,172.217.194.0-255,1484,134101,92,331121
3122,0.001672,172.217.194.0-255,4320,138421,92,331121
3123,0.001676,172.31.47.0-255,66,138487,92,331121
3124,0.001682,172.217.194.0-255,7156,145643,92,331121
3125,0.001685,172.31.47.0-255,66,145709,92,331121
3126,0.001713,172.217.194.0-255,5738,151447,92,331121
3127,0.001716,172.31.47.0-255,66,151513,92,331121
3128,0.00175,172.31.47.0-255,66,151579,92,331121
3129,0.00176,172.217.194.0-255,2184,153763,92,331121
3130,0.001762,172.31.47.0-255,66,153829,92,331121
3131,0.002011,172.217.194.0-255,1484,155313,92,331121
3132,0.00203,172.217.194.0-255,2902,158215,92,331121
3133,0.002035,172.31.47.0-255,66,158281,92,331121
3134,0.002056,172.217.194.0-255,5738,164019,92,331121
3135,0.002058,172.31.47.0-255,66,164085,92,331121
3136,0.002079,172.217.194.0-255,7156,171241,92,331121
3137,0.002082,172.31.47.0-255,66,171307,92,331121
3138,0.002117,172.217.194.0-255,5738,177045,92,331121
3139,0.002121,172.31.47.0-255,66,177111,92,331121
3140,0.00213,172.31.47.0-255,66,177177,92,331121
3141,0.002138,172.217.194.0-255,2184,179361,92,331121
3142,0.00214,172.31.47.0-255,66,179427,92,331121
3143,0.004463,172.217.194.0-255,2902,182329,92,331121
3144,0.004469,172.31.47.0-255,66,182395,92,331121
3145,0.004494,172.217.194.0-255,2902,185297,92,331121
3146,0.004496,172.31.47.0-255,66,185363,92,331121
3147,0.006783,172.217.194.0-255,2902,188265,92,331121
3148,0.006786,172.31.47.0-255,66,188331,92,331121
3149,0.00681,172.217.194.0-255,1484,189815,92,331121
3150,0.006822,172.217.194.0-255,1484,191299,92,331121
3151,0.006825,172.31.47.0-255,66,191365,92,331121
3152,0.009094,172.217.194.0-255,2902,194267,92,331121
3153,0.009101,172.31.47.0-255,66,194333,92,331121
3154,0.009146,172.217.194.0-255,2902,197235,92,331121
3155,0.00915,172.31.47.0-255,66,197301,92,331121
3156,0.011418,172.217.194.0-255,2902,200203,92,331121
3157,0.011424,172.31.47.0-255,66,200269,92,331121
3158,0.011445,172.217.194.0-255,2902,203171,92,331121
3159,0.011449,172.31.47.0-255,66,203237,92,331121
3160,0.013736,172.217.194.0-255,2902,206139,92,331121
3161,0.013742,172.31.47.0-255,66,206205,92,331121
3162,0.013774,172.217.194.0-255,2902,209107,92,331121
3163,0.013777,172.31.47.0-255,66,209173,92,331121
3164,0.016073,172.217.194.0-255,2902,212075,92,331121
3165,0.016088,172.31.47.0-255,66,212141,92,331121
3166,0.016137,172.217.194.0-255,2902,215043,92,331121
3167,0.01614,172.31.47.0-255,66,215109,92,331121
3168,0.018396,172.217.194.0-255,2902,218011,92,331121
3169,0.018402,172.31.47.0-255,66,218077,92,331121
3170,0.018438,172.217.194.0-255,2902,220979,92,331121
3171,0.018441,172.31.47.0-255,66,221045,92,331121
3172,0.020705,172.217.194.0-255,2902,223947,92,331121
3173,0.020714,172.31.47.0-255,66,224013,92,331121
3174,0.020759,172.217.194.0-255,2902,226915,92,331121
3175,0.020761,172.31.47.0-255,66,226981,92,331121
3176,0.023044,172.217.194.0-255,2902,229883,92,331121
3177,0.02305,172.31.47.0-255,66,229949,92,331121
3178,0.023079,172.217.194.0-255,2902,232851,92,331121
3179,0.023082,172.31.47.0-255,66,232917,92,331121
3180,0.025388,172.217.194.0-255,2902,235819,92,331121
3181,0.025407,172.31.47.0-255,66,235885,92,331121
3182,0.025476,172.217.194.0-255,2902,238787,92,331121
3183,0.025479,172.31.47.0-255,66,238853,92,331121
3184,0.02775,172.217.194.0-255,2902,241755,92,331121
3185,0.027759,172.31.47.0-255,66,241821,92,331121
3186,0.027799,172.217.194.0-255,2902,244723,92,331121
3187,0.027802,172.31.47.0-255,66,244789,92,331121
3188,0.030085,172.217.194.0-255,2902,247691,92,331121
3189,0.030101,172.31.47.0-255,66,247757,92,331121
3190,0.030149,172.217.194.0-255,2902,250659,92,331121
3191,0.030152,172.31.47.0-255,66,250725,92,331121
3192,0.03241,172.217.194.0-255,2902,253627,92,331121
3193,0.032415,172.31.47.0-255,66,253693,92,331121
3194,0.032451,172.217.194.0-255,2902,256595,92,331121
3195,0.032454,172.31.47.0-255,66,256661,92,331121
3196,0.034747,172.217.194.0-255,2902,259563,92,331121
3197,0.034765,172.31.47.0-255,66,259629,92,331121
3198,0.034826,172.217.194.0-255,2902,262531,92,331121
3199,0.03483,172.31.47.0-255,66,262597,92,331121
3200,0.037078,172.217.194.0-255,2902,265499,92,331121
3201,0.037085,172.31.47.0-255,66,265565,92,331121
3202,0.037139,172.217.194.0-255,2902,268467,92,331121
3203,0.037142,172.31.47.0-255,66,268533,92,331121
3204,0.039415,172.217.194.0-255,2902,271435,92,331121
3205,0.039435,172.31.47.0-255,66,271501,92,331121
3206,0.039485,172.217.194.0-255,2902,274403,92,331121
3207,0.039488,172.31.47.0-255,66,274469,92,331121
3208,0.041738,172.217.194.0-255,2902,277371,92,331121
3209,0.041744,172.31.47.0-255,66,277437,92,331121
3210,0.041795,172.217.194.0-255,1484,278921,92,331121
3211,0.041808,172.217.194.0-255,1484,280405,92,331121
3212,0.04181,172.31.47.0-255,66,280471,92,331121
3213,0.042491,172.31.47.0-255,172,280643,92,331121
3214,0.042519,172.31.47.0-255,1103,281746,92,331121
3215,0.042554,172.31.47.0-255,1514,283260,92,331121
3216,0.042556,172.31.47.0-255,1514,284774,92,331121
3217,0.042561,172.31.47.0-255,1514,286288,92,331121
3218,0.042562,172.31.47.0-255,1514,287802,92,331121
3219,0.042591,172.31.47.0-255,1503,289305,92,331121
3220,0.044045,104.244.42.0-255,66,289371,92,331121
3221,0.044052,104.244.42.0-255,66,289437,92,331121
3222,0.044057,172.217.194.0-255,2902,292339,92,331121
3223,0.044061,172.31.47.0-255,66,292405,92,331121
3224,0.044091,104.244.42.0-255,66,292471,92,331121
3225,0.044104,172.217.194.0-255,2902,295373,92,331121
3226,0.044108,172.31.47.0-255,66,295439,92,331121
3227,0.044158,104.244.42.0-255,66,295505,92,331121
3228,0.046423,172.217.194.0-255,2902,298407,92,331121
3229,0.04644,172.31.47.0-255,66,298473,92,331121
3230,0.046533,172.217.194.0-255,2902,301375,92,331121
3231,0.046536,172.31.47.0-255,66,301441,92,331121
3232,0.048789,172.217.194.0-255,2902,304343,92,331121
3233,0.04881,172.31.47.0-255,66,304409,92,331121
3234,0.048859,172.217.194.0-255,2902,307311,92,331121
3235,0.048862,172.31.47.0-255,66,307377,92,331121
3236,0.051136,172.217.194.0-255,2902,310279,92,331121
3237,0.05115,172.31.47.0-255,66,310345,92,331121
3238,0.051206,172.217.194.0-255,2902,313247,92,331121
3239,0.051209,172.31.47.0-255,66,313313,92,331121
3240,0.053486,172.217.194.0-255,2902,316215,92,331121
3241,0.053498,172.31.47.0-255,66,316281,92,331121
3242,0.053547,172.217.194.0-255,2902,319183,92,331121
3243,0.05355,172.31.47.0-255,66,319249,92,331121
3244,0.05582,172.217.194.0-255,2902,322151,92,331121
3245,0.055839,172.31.47.0-255,66,322217,92,331121
3246,0.055888,172.217.194.0-255,2902,325119,92,331121
3247,0.055891,172.31.47.0-255,66,325185,92,331121
3248,0.058177,172.217.194.0-255,2902,328087,92,331121
3249,0.058192,172.31.47.0-255,66,328153,92,331121
3250,0.05824,172.217.194.0-255,2902,331055,92,331121
3251,0.058243,172.31.47.0-255,66,331121,92,331121
3252,0.0,74.125.24.0-255,152,152,92,279824
3253,1.4e-05,172.31.47.0-255,66,218,92,279824
3254,2.1e-05,74.125.24.0-255,1484,1702,92,279824
3255,2.5e-05,172.31.47.0-255,66,1768,92,279824
3256,3.6e-05,74.125.24.0-255,2902,4670,92,279824
3257,3.9e-05,172.31.47.0-255,66,4736,92,279824
3258,4.7e-05,74.125.24.0-255,7156,11892,92,279824
3259,4.9e-05,172.31.47.0-255,66,11958,92,279824
3260,5.9e-05,172.31.47.0-255,66,12024,92,279824
3261,0.000107,74.125.24.0-255,4320,16344,92,279824
3262,0.00011,172.31.47.0-255,66,16410,92,279824
3263,0.000136,74.125.24.0-255,2902,19312,92,279824
3264,0.000138,172.31.47.0-255,66,19378,92,279824
3265,0.000143,74.125.24.0-255,3961,23339,92,279824
3266,0.000145,172.31.47.0-255,66,23405,92,279824
3267,0.000204,74.125.24.0-255,1484,24889,92,279824
3268,0.000207,172.31.47.0-255,66,24955,92,279824
3269,0.000211,74.125.24.0-255,2902,27857,92,279824
3270,0.000213,172.31.47.0-255,66,27923,92,279824
3271,0.000235,74.125.24.0-255,5738,33661,92,279824
3272,0.000237,172.31.47.0-255,66,33727,92,279824
3273,0.00027,172.31.47.0-255,66,33793,92,279824
3274,0.000296,74.125.24.0-255,5379,39172,92,279824
3275,0.000298,172.31.47.0-255,66,39238,92,279824
3276,0.000323,172.31.47.0-255,66,39304,92,279824
3277,0.000737,74.125.24.0-255,129,39433,92,279824
3278,0.000742,172.31.47.0-255,66,39499,92,279824
3279,0.000768,74.125.24.0-255,343,39842,92,279824
3280,0.000771,172.31.47.0-255,66,39908,92,279824
3281,0.000932,74.125.24.0-255,1484,41392,92,279824
3282,0.000945,74.125.24.0-255,1484,42876,92,279824
3283,0.000948,172.31.47.0-255,66,42942,92,279824
3284,0.000965,74.125.24.0-255,1484,44426,92,279824
3285,0.000971,74.125.24.0-255,4320,48746,92,279824
3286,0.000973,172.31.47.0-255,66,48812,92,279824
3287,0.000984,74.125.24.0-255,1484,50296,92,279824
3288,0.000994,74.125.24.0-255,5738,56034,92,279824
3289,0.000997,172.31.47.0-255,66,56100,92,279824
3290,0.001026,74.125.24.0-255,5738,61838,92,279824
3291,0.001028,172.31.47.0-255,66,61904,92,279824
3292,0.001061,172.31.47.0-255,66,61970,92,279824
3293,0.00109,74.125.24.0-255,2184,64154,92,279824
3294,0.001093,172.31.47.0-255,66,64220,92,279824
3295,0.001187,74.125.24.0-255,1484,65704,92,279824
3296,0.001201,74.125.24.0-255,2902,68606,92,279824
3297,0.001204,172.31.47.0-255,66,68672,92,279824
3298,0.001211,74.125.24.0-255,5738,74410,92,279824
3299,0.001213,172.31.47.0-255,66,74476,92,279824
3300,0.001233,74.125.24.0-255,4320,78796,92,279824
3301,0.001235,172.31.47.0-255,66,78862,92,279824
3302,0.001274,172.31.47.0-255,66,78928,92,279824
3303,0.001278,74.125.24.0-255,2902,81830,92,279824
3304,0.00128,172.31.47.0-255,66,81896,92,279824
3305,0.00131,74.125.24.0-255,7156,89052,92,279824
3306,0.001312,172.31.47.0-255,66,89118,92,279824
3307,0.001315,74.125.24.0-255,766,89884,92,279824
3308,0.001568,74.125.24.0-255,1484,91368,92,279824
3309,0.001572,172.31.47.0-255,66,91434,92,279824
3310,0.001576,74.125.24.0-255,1484,92918,92,279824
3311,0.001598,74.125.24.0-255,1484,94402,92,279824
3312,0.0016,172.31.47.0-255,66,94468,92,279824
3313,0.001606,74.125.24.0-255,5738,100206,92,279824
3314,0.001608,172.31.47.0-255,66,100272,92,279824
3315,0.001639,74.125.24.0-255,7156,107428,92,279824
3316,0.001642,172.31.47.0-255,66,107494,92,279824
3317,0.00167,74.125.24.0-255,2902,110396,92,279824
3318,0.001672,172.31.47.0-255,66,110462,92,279824
3319,0.001693,172.31.47.0-255,66,110528,92,279824
3320,0.001709,74.125.24.0-255,766,111294,92,279824
3321,0.002128,172.31.47.0-255,66,111360,92,279824
3322,0.003756,74.125.24.0-255,2902,114262,92,279824
3323,0.003763,172.31.47.0-255,66,114328,92,279824
3324,0.003791,74.125.24.0-255,1484,115812,92,279824
3325,0.004165,74.125.24.0-255,1484,117296,92,279824
3326,0.004168,172.31.47.0-255,66,117362,92,279824
3327,0.005907,74.125.24.0-255,2902,120264,92,279824
3328,0.00591,172.31.47.0-255,66,120330,92,279824
3329,0.006256,74.125.24.0-255,2902,123232,92,279824
3330,0.006258,172.31.47.0-255,66,123298,92,279824
3331,0.007977,74.125.24.0-255,2902,126200,92,279824
3332,0.007984,172.31.47.0-255,66,126266,92,279824
3333,0.008311,74.125.24.0-255,2902,129168,92,279824
3334,0.008317,172.31.47.0-255,66,129234,92,279824
3335,0.010054,74.125.24.0-255,2902,132136,92,279824
3336,0.010061,172.31.47.0-255,66,132202,92,279824
3337,0.010376,74.125.24.0-255,2902,135104,92,279824
3338,0.010383,172.31.47.0-255,66,135170,92,279824
3339,0.012137,74.125.24.0-255,2902,138072,92,279824
3340,0.012144,172.31.47.0-255,66,138138,92,279824
3341,0.012457,74.125.24.0-255,2902,141040,92,279824
3342,0.012461,172.31.47.0-255,66,141106,92,279824
3343,0.014225,74.125.24.0-255,2902,144008,92,279824
3344,0.014232,172.31.47.0-255,66,144074,92,279824
3345,0.014535,74.125.24.0-255,2902,146976,92,279824
3346,0.014541,172.31.47.0-255,66,147042,92,279824
3347,0.016341,74.125.24.0-255,2902,149944,92,279824
3348,0.016351,172.31.47.0-255,66,150010,92,279824
3349,0.016633,74.125.24.0-255,2902,152912,92,279824
3350,0.016639,172.31.47.0-255,66,152978,92,279824
3351,0.018404,74.125.24.0-255,2902,155880,92,279824
3352,0.018411,172.31.47.0-255,66,155946,92,279824
3353,0.018747,74.125.24.0-255,2902,158848,92,279824
3354,0.018754,172.31.47.0-255,66,158914,92,279824
3355,0.020509,74.125.24.0-255,2902,161816,92,279824
3356,0.020519,172.31.47.0-255,66,161882,92,279824
3357,0.020803,74.125.24.0-255,2902,164784,92,279824
3358,0.020809,172.31.47.0-255,66,164850,92,279824
3359,0.022584,74.125.24.0-255,2902,167752,92,279824
3360,0.022592,172.31.47.0-255,66,167818,92,279824
3361,0.022893,74.125.24.0-255,2902,170720,92,279824
3362,0.022898,172.31.47.0-255,66,170786,92,279824
3363,0.024685,74.125.24.0-255,2902,173688,92,279824
3364,0.024692,172.31.47.0-255,66,173754,92,279824
3365,0.024943,74.125.24.0-255,2902,176656,92,279824
3366,0.024949,172.31.47.0-255,66,176722,92,279824
3367,0.026789,74.125.24.0-255,2902,179624,92,279824
3368,0.026796,172.31.47.0-255,66,179690,92,279824
3369,0.027018,74.125.24.0-255,2902,182592,92,279824
3370,0.027023,172.31.47.0-255,66,182658,92,279824
3371,0.028889,74.125.24.0-255,2902,185560,92,279824
3372,0.028896,172.31.47.0-255,66,185626,92,279824
3373,0.029074,74.125.24.0-255,2902,188528,92,279824
3374,0.029079,172.31.47.0-255,66,188594,92,279824
3375,0.030973,74.125.24.0-255,2902,191496,92,279824
3376,0.030981,172.31.47.0-255,66,191562,92,279824
3377,0.031158,74.125.24.0-255,2902,194464,92,279824
3378,0.031164,172.31.47.0-255,66,194530,92,279824
3379,0.033034,74.125.24.0-255,2902,197432,92,279824
3380,0.033041,172.31.47.0-255,66,197498,92,279824
3381,0.033257,74.125.24.0-255,2902,200400,92,279824
3382,0.03327,172.31.47.0-255,66,200466,92,279824
3383,0.034747,172.31.47.0-255,166,200632,92,279824
3384,0.034778,172.31.47.0-255,1136,201768,92,279824
3385,0.034843,172.31.47.0-255,1514,203282,92,279824
3386,0.034844,172.31.47.0-255,1514,204796,92,279824
3387,0.034846,172.31.47.0-255,1514,206310,92,279824
3388,0.034847,172.31.47.0-255,1514,207824,92,279824
3389,0.034848,172.31.47.0-255,330,208154,92,279824
3390,0.035108,74.125.24.0-255,2902,211056,92,279824
3391,0.035113,172.31.47.0-255,66,211122,92,279824
3392,0.03534,74.125.24.0-255,2902,214024,92,279824
3393,0.035347,172.31.47.0-255,66,214090,92,279824
3394,0.036324,104.244.42.0-255,66,214156,92,279824
3395,0.036509,104.244.42.0-255,66,214222,92,279824
3396,0.036516,104.244.42.0-255,66,214288,92,279824
3397,0.036519,104.244.42.0-255,66,214354,92,279824
3398,0.037209,74.125.24.0-255,2902,217256,92,279824
3399,0.037216,172.31.47.0-255,66,217322,92,279824
3400,0.037437,74.125.24.0-255,2902,220224,92,279824
3401,0.037443,172.31.47.0-255,66,220290,92,279824
3402,0.039298,74.125.24.0-255,2902,223192,92,279824
3403,0.039305,172.31.47.0-255,66,223258,92,279824
3404,0.03956,74.125.24.0-255,2902,226160,92,279824
3405,0.039566,172.31.47.0-255,66,226226,92,279824
3406,0.039884,104.244.42.0-255,108,226334,92,279824
3407,0.03989,172.31.47.0-255,66,226400,92,279824
3408,0.041403,74.125.24.0-255,2902,229302,92,279824
3409,0.041409,172.31.47.0-255,66,229368,92,279824
3410,0.041631,74.125.24.0-255,2902,232270,92,279824
3411,0.041636,172.31.47.0-255,66,232336,92,279824
3412,0.043492,74.125.24.0-255,2902,235238,92,279824
3413,0.043501,172.31.47.0-255,66,235304,92,279824
3414,0.043713,74.125.24.0-255,2902,238206,92,279824
3415,0.043718,172.31.47.0-255,66,238272,92,279824
3416,0.045577,74.125.24.0-255,2902,241174,92,279824
3417,0.045582,172.31.47.0-255,66,241240,92,279824
3418,0.045767,74.125.24.0-255,2902,244142,92,279824
3419,0.045772,172.31.47.0-255,66,244208,92,279824
3420,0.047663,74.125.24.0-255,2902,247110,92,279824
3421,0.047669,172.31.47.0-255,66,247176,92,279824
3422,0.04787,74.125.24.0-255,2902,250078,92,279824
3423,0.047876,172.31.47.0-255,66,250144,92,279824
3424,0.049729,74.125.24.0-255,2902,253046,92,279824
3425,0.049735,172.31.47.0-255,66,253112,92,279824
3426,0.049984,74.125.24.0-255,2902,256014,92,279824
3427,0.04999,172.31.47.0-255,66,256080,92,279824
3428,0.051801,74.125.24.0-255,2902,258982,92,279824
3429,0.051806,172.31.47.0-255,66,259048,92,279824
3430,0.052066,74.125.24.0-255,2902,261950,92,279824
3431,0.052071,172.31.47.0-255,66,262016,92,279824
3432,0.053917,74.125.24.0-255,2902,264918,92,279824
3433,0.053923,172.31.47.0-255,66,264984,92,279824
3434,0.054157,74.125.24.0-255,2902,267886,92,279824
3435,0.054165,172.31.47.0-255,66,267952,92,279824
3436,0.055984,74.125.24.0-255,2902,270854,92,279824
3437,0.055991,172.31.47.0-255,66,270920,92,279824
3438,0.056231,74.125.24.0-255,2902,273822,92,279824
3439,0.056237,172.31.47.0-255,66,273888,92,279824
3440,0.058072,74.125.24.0-255,2902,276790,92,279824
3441,0.058078,172.31.47.0-255,66,276856,92,279824
3442,0.058301,74.125.24.0-255,2902,279758,92,279824
3443,0.058307,172.31.47.0-255,66,279824,92,279824
3444,0.0,172.217.194.0-255,298,298,92,304245
3445,3.4e-05,172.31.47.0-255,66,364,92,304245
3446,4e-05,172.217.194.0-255,1484,1848,92,304245
3447,4.5e-05,172.31.47.0-255,66,1914,92,304245
3448,5e-05,172.217.194.0-255,4320,6234,92,304245
3449,5.3e-05,172.31.47.0-255,66,6300,92,304245
3450,0.0001,172.31.47.0-255,66,6366,92,304245
3451,0.000162,172.217.194.0-255,1484,7850,92,304245
3452,0.000166,172.31.47.0-255,66,7916,92,304245
3453,0.000171,172.217.194.0-255,2902,10818,92,304245
3454,0.000173,172.31.47.0-255,66,10884,92,304245
3455,0.000176,172.217.194.0-255,1484,12368,92,304245
3456,0.000179,172.31.47.0-255,66,12434,92,304245
3457,0.0002,172.217.194.0-255,4320,16754,92,304245
3458,0.000202,172.31.47.0-255,66,16820,92,304245
3459,0.000221,172.217.194.0-255,4320,21140,92,304245
3460,0.000224,172.31.47.0-255,66,21206,92,304245
3461,0.000237,172.217.194.0-255,2543,23749,92,304245
3462,0.00024,172.31.47.0-255,66,23815,92,304245
3463,0.000328,172.217.194.0-255,1484,25299,92,304245
3464,0.000332,172.31.47.0-255,66,25365,92,304245
3465,0.000338,172.217.194.0-255,2902,28267,92,304245
3466,0.000341,172.31.47.0-255,66,28333,92,304245
3467,0.000347,172.217.194.0-255,4320,32653,92,304245
3468,0.000349,172.31.47.0-255,66,32719,92,304245
3469,0.000366,172.217.194.0-255,1484,34203,92,304245
3470,0.000368,172.31.47.0-255,66,34269,92,304245
3471,0.000387,172.217.194.0-255,4320,38589,92,304245
3472,0.00039,172.31.47.0-255,66,38655,92,304245
3473,0.000419,172.31.47.0-255,66,38721,92,304245
3474,0.000423,172.217.194.0-255,2902,41623,92,304245
3475,0.00043,172.217.194.0-255,4320,45943,92,304245
3476,0.00044,172.31.47.0-255,66,46009,92,304245
3477,0.000449,172.217.194.0-255,2862,48871,92,304245
3478,0.000457,172.31.47.0-255,66,48937,92,304245
3479,0.00069,172.217.194.0-255,366,49303,92,304245
3480,0.000848,172.31.47.0-255,66,49369,92,304245
3481,0.000909,172.217.194.0-255,1484,50853,92,304245
3482,0.000913,172.31.47.0-255,66,50919,92,304245
3483,0.00092,172.217.194.0-255,2902,53821,92,304245
3484,0.000945,172.217.194.0-255,5738,59559,92,304245
3485,0.000952,172.217.194.0-255,7156,66715,92,304245
3486,0.000962,172.217.194.0-255,1484,68199,92,304245
3487,0.000991,172.217.194.0-255,2184,70383,92,304245
3488,0.001873,172.217.194.0-255,1484,71867,92,304245
3489,0.001881,172.217.194.0-255,2902,74769,92,304245
3490,0.001911,172.217.194.0-255,5738,80507,92,304245
3491,0.001919,172.217.194.0-255,7156,87663,92,304245
3492,0.001941,172.217.194.0-255,5738,93401,92,304245
3493,0.001944,172.217.194.0-255,1484,94885,92,304245
3494,0.001956,172.217.194.0-255,766,95651,92,304245
3495,0.001974,172.217.194.0-255,2902,98553,92,304245
3496,0.001977,172.217.194.0-255,1484,100037,92,304245
3497,0.002,172.217.194.0-255,5738,105775,92,304245
3498,0.002003,172.217.194.0-255,1484,107259,92,304245
3499,0.002028,172.217.194.0-255,7156,114415,92,304245
3500,0.002062,172.217.194.0-255,4320,118735,92,304245
3501,0.002117,172.217.194.0-255,5738,124473,92,304245
3502,0.002129,172.217.194.0-255,4320,128793,92,304245
3503,0.002145,172.217.194.0-255,5738,134531,92,304245
3504,0.002148,172.217.194.0-255,1484,136015,92,304245
3505,0.002199,172.217.194.0-255,7156,143171,92,304245
3506,0.002217,172.217.194.0-255,766,143937,92,304245
3507,0.002236,172.217.194.0-255,1484,145421,92,304245
3508,0.00224,172.217.194.0-255,2902,148323,92,304245
3509,0.002245,172.217.194.0-255,5738,154061,92,304245
3510,0.002248,172.217.194.0-255,1484,155545,92,304245
3511,0.00226,172.217.194.0-255,1484,157029,92,304245
3512,0.002276,172.217.194.0-255,2902,159931,92,304245
3513,0.002294,172.217.194.0-255,7156,167087,92,304245
3514,0.002306,172.217.194.0-255,1484,168571,92,304245
3515,0.004479,172.31.47.0-255,66,168637,92,304245
3516,0.006816,172.217.194.0-255,5738,174375,92,304245
3517,0.006823,172.31.47.0-255,66,174441,92,304245
3518,0.009126,172.217.194.0-255,5738,180179,92,304245
3519,0.009131,172.31.47.0-255,66,180245,92,304245
3520,0.011426,172.217.194.0-255,5738,185983,92,304245
3521,0.011434,172.31.47.0-255,66,186049,92,304245
3522,0.013725,172.217.194.0-255,5738,191787,92,304245
3523,0.016202,172.31.47.0-255,66,191853,92,304245
3524,0.018487,172.217.194.0-255,5738,197591,92,304245
3525,0.018505,172.31.47.0-255,66,197657,92,304245
3526,0.02077,172.217.194.0-255,5738,203395,92,304245
3527,0.020778,172.31.47.0-255,66,203461,92,304245
3528,0.023076,172.217.194.0-255,5738,209199,92,304245
3529,0.023083,172.31.47.0-255,66,209265,92,304245
3530,0.02538,172.217.194.0-255,5738,215003,92,304245
3531,0.025386,172.31.47.0-255,66,215069,92,304245
3532,0.027712,172.217.194.0-255,5738,220807,92,304245
3533,0.027719,172.31.47.0-255,66,220873,92,304245
3534,0.03005,172.217.194.0-255,5738,226611,92,304245
3535,0.030063,172.31.47.0-255,66,226677,92,304245
3536,0.032407,172.217.194.0-255,5738,232415,92,304245
3537,0.032416,172.31.47.0-255,66,232481,92,304245
3538,0.034765,172.31.47.0-255,172,232653,92,304245
3539,0.034767,172.217.194.0-255,5738,238391,92,304245
3540,0.034773,172.31.47.0-255,66,238457,92,304245
3541,0.0348,172.31.47.0-255,1107,239564,92,304245
3542,0.034843,172.31.47.0-255,1514,241078,92,304245
3543,0.034844,172.31.47.0-255,1514,242592,92,304245
3544,0.034846,172.31.47.0-255,1514,244106,92,304245
3545,0.034847,172.31.47.0-255,1514,245620,92,304245
3546,0.034873,172.31.47.0-255,1499,247119,92,304245
3547,0.036313,104.244.42.0-255,66,247185,92,304245
3548,0.036322,104.244.42.0-255,66,247251,92,304245
3549,0.036371,104.244.42.0-255,66,247317,92,304245
3550,0.036429,104.244.42.0-255,66,247383,92,304245
3551,0.037077,172.217.194.0-255,5738,253121,92,304245
3552,0.037085,172.31.47.0-255,66,253187,92,304245
3553,0.037109,104.244.42.0-255,108,253295,92,304245
3554,0.037113,172.31.47.0-255,66,253361,92,304245
3555,0.039372,172.217.194.0-255,5738,259099,92,304245
3556,0.039379,172.31.47.0-255,66,259165,92,304245
3557,0.041685,172.217.194.0-255,4320,263485,92,304245
3558,0.04169,172.31.47.0-255,66,263551,92,304245
3559,0.04172,172.217.194.0-255,1484,265035,92,304245
3560,0.043978,172.217.194.0-255,4320,269355,92,304245
3561,0.043982,172.31.47.0-255,66,269421,92,304245
3562,0.046286,172.217.194.0-255,5738,275159,92,304245
3563,0.046329,172.31.47.0-255,66,275225,92,304245
3564,0.048607,172.217.194.0-255,5738,280963,92,304245
3565,0.048613,172.31.47.0-255,66,281029,92,304245
3566,0.050893,172.217.194.0-255,5738,286767,92,304245
3567,0.050899,172.31.47.0-255,66,286833,92,304245
3568,0.053201,172.217.194.0-255,5738,292571,92,304245
3569,0.053207,172.31.47.0-255,66,292637,92,304245
3570,0.055481,172.217.194.0-255,5738,298375,92,304245
3571,0.055486,172.31.47.0-255,66,298441,92,304245
3572,0.057801,172.217.194.0-255,5738,304179,92,304245
3573,0.057807,172.31.47.0-255,66,304245,92,304245
3574,0.0,172.31.47.0-255,105,105,92,105
3575,0.0,172.31.47.0-255,105,105,92,276
3576,0.001802,157.240.13.0-255,105,210,92,276
3577,0.001816,172.31.47.0-255,66,276,92,276
3578,0.0,172.217.194.0-255,153,153,92,209167
3579,2.7e-05,172.31.47.0-255,66,219,92,209167
3580,3.4e-05,172.217.194.0-255,1484,1703,92,209167
3581,3.8e-05,172.31.47.0-255,66,1769,92,209167
3582,4.3e-05,172.217.194.0-255,2902,4671,92,209167
3583,4.6e-05,172.31.47.0-255,66,4737,92,209167
3584,5.4e-05,172.217.194.0-255,7156,11893,92,209167
3585,5.6e-05,172.31.47.0-255,66,11959,92,209167
3586,8.3e-05,172.217.194.0-255,6264,18223,92,209167
3587,8.6e-05,172.31.47.0-255,66,18289,92,209167
3588,0.000121,172.217.194.0-255,2902,21191,92,209167
3589,0.000126,172.31.47.0-255,66,21257,92,209167
3590,0.000152,172.31.47.0-255,66,21323,92,209167
3591,0.000169,172.217.194.0-255,4320,25643,92,209167
3592,0.000171,172.31.47.0-255,66,25709,92,209167
3593,0.000178,172.217.194.0-255,5738,31447,92,209167
3594,0.000181,172.31.47.0-255,66,31513,92,209167
3595,0.000184,172.217.194.0-255,1484,32997,92,209167
3596,0.000186,172.31.47.0-255,66,33063,92,209167
3597,0.000208,172.31.47.0-255,66,33129,92,209167
3598,0.000248,172.31.47.0-255,66,33195,92,209167
3599,0.000609,172.217.194.0-255,118,33313,92,209167
3600,0.000613,172.31.47.0-255,66,33379,92,209167
3601,0.000679,172.217.194.0-255,1484,34863,92,209167
3602,0.000682,172.31.47.0-255,66,34929,92,209167
3603,0.000702,172.217.194.0-255,2902,37831,92,209167
3604,0.000704,172.31.47.0-255,66,37897,92,209167
3605,0.000708,172.217.194.0-255,1484,39381,92,209167
3606,0.00071,172.31.47.0-255,66,39447,92,209167
3607,0.000727,172.217.194.0-255,4320,43767,92,209167
3608,0.000734,172.217.194.0-255,7088,50855,92,209167
3609,0.000738,172.31.47.0-255,66,50921,92,209167
3610,0.000882,172.217.194.0-255,1484,52405,92,209167
3611,0.000889,172.217.194.0-255,2902,55307,92,209167
3612,0.000892,172.31.47.0-255,66,55373,92,209167
3613,0.000898,172.217.194.0-255,5738,61111,92,209167
3614,0.000942,172.217.194.0-255,1484,62595,92,209167
3615,0.000997,172.217.194.0-255,4320,66915,92,209167
3616,0.001011,172.217.194.0-255,5020,71935,92,209167
3617,0.00104,172.217.194.0-255,1484,73419,92,209167
3618,0.001089,172.217.194.0-255,5738,79157,92,209167
3619,0.001103,172.217.194.0-255,3602,82759,92,209167
3620,0.001141,172.217.194.0-255,1484,84243,92,209167
3621,0.001147,172.217.194.0-255,2902,87145,92,209167
3622,0.001166,172.217.194.0-255,5738,92883,92,209167
3623,0.001194,172.217.194.0-255,2902,95785,92,209167
3624,0.001217,172.217.194.0-255,5738,101523,92,209167
3625,0.001239,172.217.194.0-255,1484,103007,92,209167
3626,0.00125,172.217.194.0-255,3602,106609,92,209167
3627,0.001331,172.217.194.0-255,1484,108093,92,209167
3628,0.001336,172.217.194.0-255,2902,110995,92,209167
3629,0.001352,172.217.194.0-255,5738,116733,92,209167
3630,0.001375,172.217.194.0-255,5738,122471,92,209167
3631,0.001396,172.217.194.0-255,7156,129627,92,209167
3632,0.001443,172.217.194.0-255,2902,132529,92,209167
3633,0.001468,172.217.194.0-255,7156,139685,92,209167
3634,0.001513,172.217.194.0-255,5738,145423,92,209167
3635,0.001525,172.217.194.0-255,5738,151161,92,209167
3636,0.001612,172.217.194.0-255,2902,154063,92,209167
3637,0.001674,172.217.194.0-255,4320,158383,92,209167
3638,0.00168,172.217.194.0-255,5738,164121,92,209167
3639,0.001745,172.217.194.0-255,6438,170559,92,209167
3640,0.001752,172.217.194.0-255,7156,177715,92,209167
3641,0.001769,172.217.194.0-255,5020,182735,92,209167
3642,0.001809,172.217.194.0-255,4320,187055,92,209167
3643,0.001855,172.217.194.0-255,1484,188539,92,209167
3644,0.001862,172.217.194.0-255,7156,195695,92,209167
3645,0.00188,172.217.194.0-255,4098,199793,92,209167
3646,0.001883,172.217.194.0-255,105,199898,92,209167
3647,0.002082,172.31.47.0-255,66,199964,92,209167
3648,0.004416,172.31.47.0-255,105,200069,92,209167
3649,0.006657,172.217.194.0-255,66,200135,92,209167
3650,0.028777,172.31.47.0-255,172,200307,92,209167
3651,0.028806,172.31.47.0-255,1113,201420,92,209167
3652,0.028865,172.31.47.0-255,1514,202934,92,209167
3653,0.028866,172.31.47.0-255,1514,204448,92,209167
3654,0.028868,172.31.47.0-255,1514,205962,92,209167
3655,0.028869,172.31.47.0-255,1514,207476,92,209167
3656,0.02887,172.31.47.0-255,1493,208969,92,209167
3657,0.030302,104.244.42.0-255,66,209035,92,209167
3658,0.030357,104.244.42.0-255,66,209101,92,209167
3659,0.030481,104.244.42.0-255,66,209167,92,209167
3660,0.0,172.217.194.0-255,153,153,92,188415
3661,2.7e-05,172.31.47.0-255,66,219,92,188415
3662,3.4e-05,172.217.194.0-255,1484,1703,92,188415
3663,3.9e-05,172.31.47.0-255,66,1769,92,188415
3664,4.4e-05,172.217.194.0-255,2902,4671,92,188415
3665,4.6e-05,172.31.47.0-255,66,4737,92,188415
3666,5.2e-05,172.217.194.0-255,7156,11893,92,188415
3667,5.5e-05,172.31.47.0-255,66,11959,92,188415
3668,5.8e-05,172.217.194.0-255,1484,13443,92,188415
3669,6e-05,172.31.47.0-255,66,13509,92,188415
3670,9.7e-05,172.31.47.0-255,66,13575,92,188415
3671,0.000103,172.217.194.0-255,6797,20372,92,188415
3672,0.000106,172.31.47.0-255,66,20438,92,188415
3673,0.000202,172.217.194.0-255,1484,21922,92,188415
3674,0.000205,172.31.47.0-255,66,21988,92,188415
3675,0.000211,172.217.194.0-255,2902,24890,92,188415
3676,0.000213,172.31.47.0-255,66,24956,92,188415
3677,0.000216,172.217.194.0-255,1484,26440,92,188415
3678,0.000218,172.31.47.0-255,66,26506,92,188415
3679,0.000245,172.217.194.0-255,4320,30826,92,188415
3680,0.000251,172.31.47.0-255,66,30892,92,188415
3681,0.000252,172.217.194.0-255,6797,37689,92,188415
3682,0.000254,172.31.47.0-255,66,37755,92,188415
3683,0.000288,172.31.47.0-255,66,37821,92,188415
3684,0.000305,172.217.194.0-255,1484,39305,92,188415
3685,0.000309,172.31.47.0-255,66,39371,92,188415
3686,0.000313,172.217.194.0-255,2835,42206,92,188415
3687,0.000315,172.31.47.0-255,66,42272,92,188415
3688,0.000318,172.217.194.0-255,98,42370,92,188415
3689,0.00032,172.31.47.0-255,66,42436,92,188415
3690,0.000374,172.217.194.0-255,1484,43920,92,188415
3691,0.000381,172.217.194.0-255,2902,46822,92,188415
3692,0.000384,172.31.47.0-255,66,46888,92,188415
3693,0.000386,172.217.194.0-255,1484,48372,92,188415
3694,0.000426,172.217.194.0-255,5738,54110,92,188415
3695,0.00043,172.31.47.0-255,66,54176,92,188415
3696,0.000438,172.217.194.0-255,2902,57078,92,188415
3697,0.00044,172.31.47.0-255,66,57144,92,188415
3698,0.000471,172.31.47.0-255,66,57210,92,188415
3699,0.000486,172.217.194.0-255,5738,62948,92,188415
3700,0.000488,172.31.47.0-255,66,63014,92,188415
3701,0.00052,172.217.194.0-255,1484,64498,92,188415
3702,0.000534,172.217.194.0-255,3602,68100,92,188415
3703,0.000537,172.31.47.0-255,66,68166,92,188415
3704,0.000713,172.217.194.0-255,364,68530,92,188415
3705,0.000749,172.217.194.0-255,1484,70014,92,188415
3706,0.000752,172.31.47.0-255,66,70080,92,188415
3707,0.000757,172.217.194.0-255,4320,74400,92,188415
3708,0.000759,172.31.47.0-255,66,74466,92,188415
3709,0.000793,172.31.47.0-255,66,74532,92,188415
3710,0.000824,172.31.47.0-255,66,74598,92,188415
3711,0.000843,172.217.194.0-255,4320,78918,92,188415
3712,0.000846,172.31.47.0-255,66,78984,92,188415
3713,0.000848,172.217.194.0-255,766,79750,92,188415
3714,0.000928,172.217.194.0-255,1484,81234,92,188415
3715,0.000932,172.31.47.0-255,66,81300,92,188415
3716,0.000947,172.217.194.0-255,2902,84202,92,188415
3717,0.000949,172.31.47.0-255,66,84268,92,188415
3718,0.000952,172.217.194.0-255,1484,85752,92,188415
3719,0.000976,172.217.194.0-255,2902,88654,92,188415
3720,0.000978,172.31.47.0-255,66,88720,92,188415
3721,0.000983,172.217.194.0-255,5738,94458,92,188415
3722,0.000985,172.31.47.0-255,66,94524,92,188415
3723,0.001012,172.31.47.0-255,66,94590,92,188415
3724,0.001023,172.217.194.0-255,1484,96074,92,188415
3725,0.00103,172.217.194.0-255,6438,102512,92,188415
3726,0.001032,172.31.47.0-255,66,102578,92,188415
3727,0.001067,172.217.194.0-255,1484,104062,92,188415
3728,0.001082,172.217.194.0-255,2902,106964,92,188415
3729,0.001085,172.31.47.0-255,66,107030,92,188415
3730,0.001091,172.217.194.0-255,5738,112768,92,188415
3731,0.001092,172.31.47.0-255,66,112834,92,188415
3732,0.001108,172.217.194.0-255,2902,115736,92,188415
3733,0.00111,172.31.47.0-255,66,115802,92,188415
3734,0.001133,172.31.47.0-255,66,115868,92,188415
3735,0.001166,172.217.194.0-255,2902,118770,92,188415
3736,0.001169,172.31.47.0-255,66,118836,92,188415
3737,0.0012,172.31.47.0-255,66,118902,92,188415
3738,0.001327,172.217.194.0-255,1484,120386,92,188415
3739,0.00134,172.217.194.0-255,2902,123288,92,188415
3740,0.001343,172.31.47.0-255,66,123354,92,188415
3741,0.001346,172.217.194.0-255,1484,124838,92,188415
3742,0.00137,172.217.194.0-255,4320,129158,92,188415
3743,0.001374,172.31.47.0-255,66,129224,92,188415
3744,0.001374,172.217.194.0-255,5738,134962,92,188415
3745,0.001377,172.31.47.0-255,66,135028,92,188415
3746,0.001394,172.217.194.0-255,4320,139348,92,188415
3747,0.001397,172.31.47.0-255,66,139414,92,188415
3748,0.001426,172.31.47.0-255,66,139480,92,188415
3749,0.001435,172.31.47.0-255,66,139546,92,188415
3750,0.001462,172.217.194.0-255,2902,142448,92,188415
3751,0.001465,172.31.47.0-255,66,142514,92,188415
3752,0.001504,172.31.47.0-255,66,142580,92,188415
3753,0.00151,172.217.194.0-255,5738,148318,92,188415
3754,0.001517,172.31.47.0-255,66,148384,92,188415
3755,0.001524,172.217.194.0-255,2184,150568,92,188415
3756,0.001526,172.31.47.0-255,66,150634,92,188415
3757,0.001539,172.217.194.0-255,4320,154954,92,188415
3758,0.001541,172.31.47.0-255,66,155020,92,188415
3759,0.001601,172.31.47.0-255,66,155086,92,188415
3760,0.001633,172.217.194.0-255,1484,156570,92,188415
3761,0.001651,172.31.47.0-255,66,156636,92,188415
3762,0.001683,172.31.47.0-255,66,156702,92,188415
3763,0.001709,172.31.47.0-255,66,156768,92,188415
3764,0.001751,172.217.194.0-255,7156,163924,92,188415
3765,0.001754,172.31.47.0-255,66,163990,92,188415
3766,0.001778,172.217.194.0-255,766,164756,92,188415
3767,0.001797,172.31.47.0-255,66,164822,92,188415
3768,0.001816,172.217.194.0-255,6438,171260,92,188415
3769,0.001819,172.31.47.0-255,66,171326,92,188415
3770,0.001865,172.217.194.0-255,7156,178482,92,188415
3771,0.001868,172.31.47.0-255,66,178548,92,188415
3772,0.001914,172.31.47.0-255,66,178614,92,188415
3773,0.001986,172.31.47.0-255,66,178680,92,188415
3774,0.001989,172.217.194.0-255,105,178785,92,188415
3775,0.003083,172.31.47.0-255,105,178890,92,188415
3776,0.003267,172.31.47.0-255,90,178980,92,188415
3777,0.003275,172.31.47.0-255,66,179046,92,188415
3778,0.005659,172.217.194.0-255,66,179112,92,188415
3779,0.005816,172.217.194.0-255,66,179178,92,188415
3780,0.00585,172.217.194.0-255,66,179244,92,188415
3781,0.005855,172.31.47.0-255,66,179310,92,188415
3782,0.041777,172.31.47.0-255,176,179486,92,188415
3783,0.041819,172.31.47.0-255,1103,180589,92,188415
3784,0.041841,172.31.47.0-255,1514,182103,92,188415
3785,0.041843,172.31.47.0-255,1514,183617,92,188415
3786,0.041844,172.31.47.0-255,1514,185131,92,188415
3787,0.041845,172.31.47.0-255,1514,186645,92,188415
3788,0.041867,172.31.47.0-255,1506,188151,92,188415
3789,0.043269,104.244.42.0-255,66,188217,92,188415
3790,0.043346,104.244.42.0-255,66,188283,92,188415
3791,0.043382,104.244.42.0-255,66,188349,92,188415
3792,0.043404,104.244.42.0-255,66,188415,92,188415
3793,0.0,74.125.68.0-255,153,153,92,386928
3794,2.3e-05,172.31.47.0-255,66,219,92,386928
3795,3.1e-05,74.125.68.0-255,1484,1703,92,386928
3796,3.6e-05,172.31.47.0-255,66,1769,92,386928
3797,6.9e-05,74.125.68.0-255,2902,4671,92,386928
3798,7.2e-05,172.31.47.0-255,66,4737,92,386928
3799,7.7e-05,74.125.68.0-255,4320,9057,92,386928
3800,8.4e-05,172.31.47.0-255,66,9123,92,386928
3801,9.2e-05,74.125.68.0-255,4776,13899,92,386928
3802,9.5e-05,172.31.47.0-255,66,13965,92,386928
3803,0.000125,74.125.68.0-255,1484,15449,92,386928
3804,0.000128,172.31.47.0-255,66,15515,92,386928
3805,0.000132,74.125.68.0-255,2902,18417,92,386928
3806,0.000135,172.31.47.0-255,66,18483,92,386928
3807,0.000157,74.125.68.0-255,5738,24221,92,386928
3808,0.00016,172.31.47.0-255,66,24287,92,386928
3809,0.000169,74.125.68.0-255,4320,28607,92,386928
3810,0.000172,172.31.47.0-255,66,28673,92,386928
3811,0.000217,74.125.68.0-255,2543,31216,92,386928
3812,0.00022,172.31.47.0-255,66,31282,92,386928
3813,0.000287,74.125.68.0-255,1484,32766,92,386928
3814,0.000289,172.31.47.0-255,66,32832,92,386928
3815,0.000315,74.125.68.0-255,2902,35734,92,386928
3816,0.000318,172.31.47.0-255,66,35800,92,386928
3817,0.00032,74.125.68.0-255,1484,37284,92,386928
3818,0.000322,172.31.47.0-255,66,37350,92,386928
3819,0.000326,74.125.68.0-255,2902,40252,92,386928
3820,0.000329,172.31.47.0-255,66,40318,92,386928
3821,0.000365,74.125.68.0-255,5738,46056,92,386928
3822,0.000368,172.31.47.0-255,66,46122,92,386928
3823,0.000372,74.125.68.0-255,2902,49024,92,386928
3824,0.000374,172.31.47.0-255,66,49090,92,386928
3825,0.000407,74.125.68.0-255,2543,51633,92,386928
3826,0.00043,74.125.68.0-255,5738,57371,92,386928
3827,0.000441,74.125.68.0-255,109,57480,92,386928
3828,0.000573,74.125.68.0-255,1484,58964,92,386928
3829,0.000585,172.31.47.0-255,66,59030,92,386928
3830,0.00059,74.125.68.0-255,2902,61932,92,386928
3831,0.000596,172.31.47.0-255,66,61998,92,386928
3832,0.000637,74.125.68.0-255,5738,67736,92,386928
3833,0.000644,74.125.68.0-255,4320,72056,92,386928
3834,0.00065,74.125.68.0-255,5379,77435,92,386928
3835,0.000674,74.125.68.0-255,2902,80337,92,386928
3836,0.000692,74.125.68.0-255,4320,84657,92,386928
3837,0.000728,74.125.68.0-255,5738,90395,92,386928
3838,0.000743,74.125.68.0-255,1370,91765,92,386928
3839,0.000943,172.31.47.0-255,66,91831,92,386928
3840,0.000993,74.125.68.0-255,1484,93315,92,386928
3841,0.001014,74.125.68.0-255,2902,96217,92,386928
3842,0.001019,74.125.68.0-255,2902,99119,92,386928
3843,0.001034,172.31.47.0-255,66,99185,92,386928
3844,0.001062,74.125.68.0-255,4320,103505,92,386928
3845,0.001066,74.125.68.0-255,1484,104989,92,386928
3846,0.001079,172.31.47.0-255,66,105055,92,386928
3847,0.001088,74.125.68.0-255,2902,107957,92,386928
3848,0.001094,172.31.47.0-255,66,108023,92,386928
3849,0.001118,74.125.68.0-255,5738,113761,92,386928
3850,0.001126,74.125.68.0-255,7156,120917,92,386928
3851,0.001145,172.31.47.0-255,66,120983,92,386928
3852,0.001183,74.125.68.0-255,4320,125303,92,386928
3853,0.001192,172.31.47.0-255,66,125369,92,386928
3854,0.001196,74.125.68.0-255,766,126135,92,386928
3855,0.001388,74.125.68.0-255,1484,127619,92,386928
3856,0.001398,172.31.47.0-255,66,127685,92,386928
3857,0.001404,74.125.68.0-255,2902,130587,92,386928
3858,0.001408,172.31.47.0-255,66,130653,92,386928
3859,0.001427,74.125.68.0-255,5738,136391,92,386928
3860,0.001429,74.125.68.0-255,1484,137875,92,386928
3861,0.001452,74.125.68.0-255,2902,140777,92,386928
3862,0.00146,74.125.68.0-255,5738,146515,92,386928
3863,0.001484,74.125.68.0-255,4320,150835,92,386928
3864,0.00149,172.31.47.0-255,66,150901,92,386928
3865,0.0015,74.125.68.0-255,1484,152385,92,386928
3866,0.001533,74.125.68.0-255,7156,159541,92,386928
3867,0.001536,74.125.68.0-255,766,160307,92,386928
3868,0.001551,172.31.47.0-255,66,160373,92,386928
3869,0.00158,74.125.68.0-255,4320,164693,92,386928
3870,0.001591,172.31.47.0-255,66,164759,92,386928
3871,0.001602,74.125.68.0-255,5738,170497,92,386928
3872,0.001617,74.125.68.0-255,4320,174817,92,386928
3873,0.001624,172.31.47.0-255,66,174883,92,386928
3874,0.001647,74.125.68.0-255,2902,177785,92,386928
3875,0.001652,172.31.47.0-255,66,177851,92,386928
3876,0.001695,172.31.47.0-255,66,177917,92,386928
3877,0.00172,74.125.68.0-255,3602,181519,92,386928
3878,0.001728,172.31.47.0-255,66,181585,92,386928
3879,0.00177,74.125.68.0-255,1484,183069,92,386928
3880,0.001774,74.125.68.0-255,1484,184553,92,386928
3881,0.00179,172.31.47.0-255,66,184619,92,386928
3882,0.001793,74.125.68.0-255,1484,186103,92,386928
3883,0.001796,74.125.68.0-255,1484,187587,92,386928
3884,0.001799,74.125.68.0-255,2902,190489,92,386928
3885,0.001845,172.31.47.0-255,66,190555,92,386928
3886,0.001874,74.125.68.0-255,5738,196293,92,386928
3887,0.00188,74.125.68.0-255,4320,200613,92,386928
3888,0.001893,74.125.68.0-255,2902,203515,92,386928
3889,0.001896,74.125.68.0-255,2902,206417,92,386928
3890,0.001899,172.31.47.0-255,66,206483,92,386928
3891,0.001905,172.31.47.0-255,66,206549,92,386928
3892,0.001926,74.125.68.0-255,4320,210869,92,386928
3893,0.001943,172.31.47.0-255,66,210935,92,386928
3894,0.001957,74.125.68.0-255,5020,215955,92,386928
3895,0.00198,172.31.47.0-255,66,216021,92,386928
3896,0.002044,74.125.68.0-255,1484,217505,92,386928
3897,0.002064,74.125.68.0-255,2902,220407,92,386928
3898,0.002068,74.125.68.0-255,1484,221891,92,386928
3899,0.002079,74.125.68.0-255,1484,223375,92,386928
3900,0.00209,172.31.47.0-255,66,223441,92,386928
3901,0.00415,74.125.68.0-255,5738,229179,92,386928
3902,0.004157,172.31.47.0-255,66,229245,92,386928
3903,0.00621,74.125.68.0-255,5738,234983,92,386928
3904,0.00661,172.31.47.0-255,66,235049,92,386928
3905,0.008666,74.125.68.0-255,5738,240787,92,386928
3906,0.008672,172.31.47.0-255,66,240853,92,386928
3907,0.010726,74.125.68.0-255,5738,246591,92,386928
3908,0.010734,172.31.47.0-255,66,246657,92,386928
3909,0.012785,74.125.68.0-255,5738,252395,92,386928
3910,0.014109,172.31.47.0-255,66,252461,92,386928
3911,0.016182,74.125.68.0-255,5738,258199,92,386928
3912,0.016193,172.31.47.0-255,66,258265,92,386928
3913,0.018251,74.125.68.0-255,5738,264003,92,386928
3914,0.018258,172.31.47.0-255,66,264069,92,386928
3915,0.020324,74.125.68.0-255,5738,269807,92,386928
3916,0.020338,172.31.47.0-255,66,269873,92,386928
3917,0.02239,74.125.68.0-255,5738,275611,92,386928
3918,0.022397,172.31.47.0-255,66,275677,92,386928
3919,0.024453,74.125.68.0-255,5738,281415,92,386928
3920,0.02446,172.31.47.0-255,66,281481,92,386928
3921,0.026515,74.125.68.0-255,5738,287219,92,386928
3922,0.026522,172.31.47.0-255,66,287285,92,386928
3923,0.028579,74.125.68.0-255,5738,293023,92,386928
3924,0.028587,172.31.47.0-255,66,293089,92,386928
3925,0.030643,74.125.68.0-255,5738,298827,92,386928
3926,0.030654,172.31.47.0-255,66,298893,92,386928
3927,0.032716,74.125.68.0-255,5738,304631,92,386928
3928,0.032726,172.31.47.0-255,66,304697,92,386928
3929,0.034769,74.125.68.0-255,4320,309017,92,386928
3930,0.034776,172.31.47.0-255,66,309083,92,386928
3931,0.034795,74.125.68.0-255,1484,310567,92,386928
3932,0.035553,172.31.47.0-255,171,310738,92,386928
3933,0.035601,172.31.47.0-255,1135,311873,92,386928
3934,0.035666,172.31.47.0-255,1514,313387,92,386928
3935,0.035668,172.31.47.0-255,1514,314901,92,386928
3936,0.03567,172.31.47.0-255,1514,316415,92,386928
3937,0.035671,172.31.47.0-255,1514,317929,92,386928
3938,0.035697,172.31.47.0-255,331,318260,92,386928
3939,0.036826,74.125.68.0-255,4320,322580,92,386928
3940,0.036833,172.31.47.0-255,66,322646,92,386928
3941,0.037222,104.244.42.0-255,66,322712,92,386928
3942,0.037274,104.244.42.0-255,66,322778,92,386928
3943,0.037308,104.244.42.0-255,66,322844,92,386928
3944,0.037313,104.244.42.0-255,66,322910,92,386928
3945,0.038043,104.244.42.0-255,108,323018,92,386928
3946,0.03805,172.31.47.0-255,66,323084,92,386928
3947,0.038889,74.125.68.0-255,5738,328822,92,386928
3948,0.038932,172.31.47.0-255,66,328888,92,386928
3949,0.040987,74.125.68.0-255,5738,334626,92,386928
3950,0.040995,172.31.47.0-255,66,334692,92,386928
3951,0.043067,74.125.68.0-255,5738,340430,92,386928
3952,0.043077,172.31.47.0-255,66,340496,92,386928
3953,0.045136,74.125.68.0-255,5738,346234,92,386928
3954,0.045143,172.31.47.0-255,66,346300,92,386928
3955,0.047197,74.125.68.0-255,5738,352038,92,386928
3956,0.047206,172.31.47.0-255,66,352104,92,386928
3957,0.049264,74.125.68.0-255,5738,357842,92,386928
3958,0.049273,172.31.47.0-255,66,357908,92,386928
3959,0.051326,74.125.68.0-255,5738,363646,92,386928
3960,0.051333,172.31.47.0-255,66,363712,92,386928
3961,0.053424,74.125.68.0-255,5738,369450,92,386928
3962,0.053441,172.31.47.0-255,66,369516,92,386928
3963,0.055546,74.125.68.0-255,5738,375254,92,386928
3964,0.055552,172.31.47.0-255,66,375320,92,386928
3965,0.05762,74.125.68.0-255,5738,381058,92,386928
3966,0.057627,172.31.47.0-255,66,381124,92,386928
3967,0.059763,74.125.68.0-255,5738,386862,92,386928
3968,0.059771,172.31.47.0-255,66,386928,92,386928
3969,0.0,74.125.200.0-255,298,298,92,245863
3970,2.2e-05,172.31.47.0-255,66,364,92,245863
3971,2.8e-05,74.125.200.0-255,1484,1848,92,245863
3972,3.1e-05,172.31.47.0-255,66,1914,92,245863
3973,3.6e-05,74.125.200.0-255,4320,6234,92,245863
3974,3.9e-05,172.31.47.0-255,66,6300,92,245863
3975,5.1e-05,74.125.200.0-255,2902,9202,92,245863
3976,5.3e-05,172.31.47.0-255,66,9268,92,245863
3977,5.8e-05,74.125.200.0-255,4320,13588,92,245863
3978,6.1e-05,172.31.47.0-255,66,13654,92,245863
3979,9.2e-05,74.125.200.0-255,358,14012,92,245863
3980,9.8e-05,172.31.47.0-255,66,14078,92,245863
3981,0.000317,74.125.200.0-255,1484,15562,92,245863
3982,0.000323,172.31.47.0-255,66,15628,92,245863
3983,0.000327,74.125.200.0-255,1484,17112,92,245863
3984,0.000329,172.31.47.0-255,66,17178,92,245863
3985,0.000351,74.125.200.0-255,1484,18662,92,245863
3986,0.000354,172.31.47.0-255,66,18728,92,245863
3987,0.000358,74.125.200.0-255,2902,21630,92,245863
3988,0.00036,172.31.47.0-255,66,21696,92,245863
3989,0.000364,74.125.200.0-255,2902,24598,92,245863
3990,0.000366,172.31.47.0-255,66,24664,92,245863
3991,0.000394,74.125.200.0-255,1484,26148,92,245863
3992,0.000397,172.31.47.0-255,66,26214,92,245863
3993,0.000403,74.125.200.0-255,5379,31593,92,245863
3994,0.000405,172.31.47.0-255,66,31659,92,245863
3995,0.00102,74.125.200.0-255,1484,33143,92,245863
3996,0.001027,172.31.47.0-255,66,33209,92,245863
3997,0.001035,74.125.200.0-255,2902,36111,92,245863
3998,0.001037,172.31.47.0-255,66,36177,92,245863
3999,0.00105,74.125.200.0-255,5738,41915,92,245863
4000,0.001053,172.31.47.0-255,66,41981,92,245863
4001,0.001057,74.125.200.0-255,2902,44883,92,245863
4002,0.001059,172.31.47.0-255,66,44949,92,245863
4003,0.001084,74.125.200.0-255,2902,47851,92,245863
4004,0.001087,172.31.47.0-255,66,47917,92,245863
4005,0.001096,74.125.200.0-255,1484,49401,92,245863
4006,0.001115,74.125.200.0-255,5379,54780,92,245863
4007,0.001117,172.31.47.0-255,66,54846,92,245863
4008,0.001122,74.125.200.0-255,2902,57748,92,245863
4009,0.001124,172.31.47.0-255,66,57814,92,245863
4010,0.001177,74.125.200.0-255,5738,63552,92,245863
4011,0.001181,172.31.47.0-255,66,63618,92,245863
4012,0.001208,74.125.200.0-255,2856,66474,92,245863
4013,0.001211,172.31.47.0-255,66,66540,92,245863
4014,0.001214,74.125.200.0-255,109,66649,92,245863
4015,0.001249,74.125.200.0-255,330,66979,92,245863
4016,0.001482,74.125.200.0-255,1484,68463,92,245863
4017,0.001488,172.31.47.0-255,66,68529,92,245863
4018,0.001495,74.125.200.0-255,2902,71431,92,245863
4019,0.001497,172.31.47.0-255,66,71497,92,245863
4020,0.0015,74.125.200.0-255,1484,72981,92,245863
4021,0.001539,74.125.200.0-255,4320,77301,92,245863
4022,0.001543,172.31.47.0-255,66,77367,92,245863
4023,0.001549,74.125.200.0-255,4320,81687,92,245863
4024,0.001551,172.31.47.0-255,66,81753,92,245863
4025,0.001571,74.125.200.0-255,3961,85714,92,245863
4026,0.001574,172.31.47.0-255,66,85780,92,245863
4027,0.001605,74.125.200.0-255,4320,90100,92,245863
4028,0.001609,172.31.47.0-255,66,90166,92,245863
4029,0.001622,172.31.47.0-255,66,90232,92,245863
4030,0.001625,74.125.200.0-255,1125,91357,92,245863
4031,0.001985,172.31.47.0-255,66,91423,92,245863
4032,0.003891,74.125.200.0-255,4320,95743,92,245863
4033,0.003896,172.31.47.0-255,66,95809,92,245863
4034,0.004236,74.125.200.0-255,1484,97293,92,245863
4035,0.006165,74.125.200.0-255,4320,101613,92,245863
4036,0.006169,172.31.47.0-255,66,101679,92,245863
4037,0.00842,74.125.200.0-255,4320,105999,92,245863
4038,0.008426,172.31.47.0-255,66,106065,92,245863
4039,0.008454,74.125.200.0-255,1484,107549,92,245863
4040,0.010694,74.125.200.0-255,4320,111869,92,245863
4041,0.0107,172.31.47.0-255,66,111935,92,245863
4042,0.012998,74.125.200.0-255,5738,117673,92,245863
4043,0.013007,172.31.47.0-255,66,117739,92,245863
4044,0.015259,74.125.200.0-255,2902,120641,92,245863
4045,0.015265,172.31.47.0-255,66,120707,92,245863
4046,0.015293,74.125.200.0-255,2902,123609,92,245863
4047,0.015297,172.31.47.0-255,66,123675,92,245863
4048,0.017527,74.125.200.0-255,2902,126577,92,245863
4049,0.017534,172.31.47.0-255,66,126643,92,245863
4050,0.01756,74.125.200.0-255,2902,129545,92,245863
4051,0.017562,172.31.47.0-255,66,129611,92,245863
4052,0.019792,74.125.200.0-255,2902,132513,92,245863
4053,0.019797,172.31.47.0-255,66,132579,92,245863
4054,0.019821,74.125.200.0-255,2902,135481,92,245863
4055,0.019824,172.31.47.0-255,66,135547,92,245863
4056,0.022062,74.125.200.0-255,2902,138449,92,245863
4057,0.022069,172.31.47.0-255,66,138515,92,245863
4058,0.022103,74.125.200.0-255,2902,141417,92,245863
4059,0.022108,172.31.47.0-255,66,141483,92,245863
4060,0.024321,74.125.200.0-255,2902,144385,92,245863
4061,0.024327,172.31.47.0-255,66,144451,92,245863
4062,0.024387,74.125.200.0-255,2902,147353,92,245863
4063,0.024391,172.31.47.0-255,66,147419,92,245863
4064,0.026578,74.125.200.0-255,2902,150321,92,245863
4065,0.026584,172.31.47.0-255,66,150387,92,245863
4066,0.026633,74.125.200.0-255,2902,153289,92,245863
4067,0.026638,172.31.47.0-255,66,153355,92,245863
4068,0.028842,74.125.200.0-255,2902,156257,92,245863
4069,0.02885,172.31.47.0-255,66,156323,92,245863
4070,0.028892,74.125.200.0-255,2902,159225,92,245863
4071,0.028896,172.31.47.0-255,66,159291,92,245863
4072,0.029804,172.31.47.0-255,172,159463,92,245863
4073,0.029833,172.31.47.0-255,1113,160576,92,245863
4074,0.029879,172.31.47.0-255,1514,162090,92,245863
4075,0.029881,172.31.47.0-255,1514,163604,92,245863
4076,0.029882,172.31.47.0-255,1514,165118,92,245863
4077,0.029886,172.31.47.0-255,1514,166632,92,245863
4078,0.029888,172.31.47.0-255,1493,168125,92,245863
4079,0.03111,74.125.200.0-255,2902,171027,92,245863
4080,0.031117,172.31.47.0-255,66,171093,92,245863
4081,0.031158,74.125.200.0-255,2902,173995,92,245863
4082,0.031161,172.31.47.0-255,66,174061,92,245863
4083,0.031468,104.244.42.0-255,66,174127,92,245863
4084,0.031477,104.244.42.0-255,66,174193,92,245863
4085,0.031523,104.244.42.0-255,66,174259,92,245863
4086,0.031528,104.244.42.0-255,66,174325,92,245863
4087,0.033045,104.244.42.0-255,108,174433,92,245863
4088,0.03305,172.31.47.0-255,66,174499,92,245863
4089,0.033366,74.125.200.0-255,2902,177401,92,245863
4090,0.033369,172.31.47.0-255,66,177467,92,245863
4091,0.033411,74.125.200.0-255,2902,180369,92,245863
4092,0.033414,172.31.47.0-255,66,180435,92,245863
4093,0.035635,74.125.200.0-255,2902,183337,92,245863
4094,0.03564,172.31.47.0-255,66,183403,92,245863
4095,0.035675,74.125.200.0-255,2902,186305,92,245863
4096,0.035678,172.31.47.0-255,66,186371,92,245863
4097,0.037902,74.125.200.0-255,2902,189273,92,245863
4098,0.037907,172.31.47.0-255,66,189339,92,245863
4099,0.037936,74.125.200.0-255,2902,192241,92,245863
4100,0.037939,172.31.47.0-255,66,192307,92,245863
4101,0.040178,74.125.200.0-255,2902,195209,92,245863
4102,0.040182,172.31.47.0-255,66,195275,92,245863
4103,0.040223,74.125.200.0-255,2902,198177,92,245863
4104,0.040226,172.31.47.0-255,66,198243,92,245863
4105,0.042443,74.125.200.0-255,2902,201145,92,245863
4106,0.042449,172.31.47.0-255,66,201211,92,245863
4107,0.042488,74.125.200.0-255,2902,204113,92,245863
4108,0.042491,172.31.47.0-255,66,204179,92,245863
4109,0.044708,74.125.200.0-255,2902,207081,92,245863
4110,0.044712,172.31.47.0-255,66,207147,92,245863
4111,0.044735,74.125.200.0-255,1484,208631,92,245863
4112,0.044745,74.125.200.0-255,1484,210115,92,245863
4113,0.044748,172.31.47.0-255,66,210181,92,245863
4114,0.047023,74.125.200.0-255,2902,213083,92,245863
4115,0.047027,172.31.47.0-255,66,213149,92,245863
4116,0.047053,74.125.200.0-255,2902,216051,92,245863
4117,0.047055,172.31.47.0-255,66,216117,92,245863
4118,0.049276,74.125.200.0-255,2902,219019,92,245863
4119,0.049281,172.31.47.0-255,66,219085,92,245863
4120,0.049308,74.125.200.0-255,2902,221987,92,245863
4121,0.049311,172.31.47.0-255,66,222053,92,245863
4122,0.051547,74.125.200.0-255,2902,224955,92,245863
4123,0.051551,172.31.47.0-255,66,225021,92,245863
4124,0.051575,74.125.200.0-255,2902,227923,92,245863
4125,0.051578,172.31.47.0-255,66,227989,92,245863
4126,0.053802,74.125.200.0-255,1484,229473,92,245863
4127,0.053816,74.125.200.0-255,1484,230957,92,245863
4128,0.053819,172.31.47.0-255,66,231023,92,245863
4129,0.053847,74.125.200.0-255,2902,233925,92,245863
4130,0.05385,172.31.47.0-255,66,233991,92,245863
4131,0.056077,74.125.200.0-255,2902,236893,92,245863
4132,0.056082,172.31.47.0-255,66,236959,92,245863
4133,0.056116,74.125.200.0-255,2902,239861,92,245863
4134,0.056121,172.31.47.0-255,66,239927,92,245863
4135,0.058338,74.125.200.0-255,2902,242829,92,245863
4136,0.058342,172.31.47.0-255,66,242895,92,245863
4137,0.058384,74.125.200.0-255,2902,245797,92,245863
4138,0.058387,172.31.47.0-255,66,245863,92,245863
4139,0.0,74.125.24.0-255,153,153,92,254596
4140,2.9e-05,172.31.47.0-255,66,219,92,254596
4141,3.6e-05,74.125.24.0-255,1484,1703,92,254596
4142,4e-05,172.31.47.0-255,66,1769,92,254596
4143,6.2e-05,74.125.24.0-255,1484,3253,92,254596
4144,6.9e-05,172.31.47.0-255,66,3319,92,254596
4145,7.6e-05,74.125.24.0-255,2902,6221,92,254596
4146,8e-05,172.31.47.0-255,66,6287,92,254596
4147,8.7e-05,74.125.24.0-255,5738,12025,92,254596
4148,8.9e-05,172.31.47.0-255,66,12091,92,254596
4149,9.3e-05,74.125.24.0-255,2140,14231,92,254596
4150,9.5e-05,172.31.47.0-255,66,14297,92,254596
4151,0.000684,74.125.24.0-255,1484,15781,92,254596
4152,0.00069,172.31.47.0-255,66,15847,92,254596
4153,0.0007,74.125.24.0-255,2902,18749,92,254596
4154,0.000703,172.31.47.0-255,66,18815,92,254596
4155,0.000735,74.125.24.0-255,5738,24553,92,254596
4156,0.000738,172.31.47.0-255,66,24619,92,254596
4157,0.000778,172.31.47.0-255,66,24685,92,254596
4158,0.000806,74.125.24.0-255,1125,25810,92,254596
4159,0.000808,172.31.47.0-255,66,25876,92,254596
4160,0.000828,172.31.47.0-255,66,25942,92,254596
4161,0.000841,172.31.47.0-255,66,26008,92,254596
4162,0.000864,74.125.24.0-255,2184,28192,92,254596
4163,0.000867,172.31.47.0-255,66,28258,92,254596
4164,0.000925,74.125.24.0-255,357,28615,92,254596
4165,0.000928,172.31.47.0-255,66,28681,92,254596
4166,0.000939,74.125.24.0-255,386,29067,92,254596
4167,0.000946,172.31.47.0-255,66,29133,92,254596
4168,0.001163,74.125.24.0-255,1484,30617,92,254596
4169,0.00117,74.125.24.0-255,2902,33519,92,254596
4170,0.001175,172.31.47.0-255,66,33585,92,254596
4171,0.00118,74.125.24.0-255,2902,36487,92,254596
4172,0.001182,172.31.47.0-255,66,36553,92,254596
4173,0.001203,74.125.24.0-255,2902,39455,92,254596
4174,0.001205,172.31.47.0-255,66,39521,92,254596
4175,0.001216,74.125.24.0-255,7156,46677,92,254596
4176,0.001218,172.31.47.0-255,66,46743,92,254596
4177,0.001252,74.125.24.0-255,5738,52481,92,254596
4178,0.001255,172.31.47.0-255,66,52547,92,254596
4179,0.001262,74.125.24.0-255,7156,59703,92,254596
4180,0.001265,172.31.47.0-255,66,59769,92,254596
4181,0.001268,74.125.24.0-255,1484,61253,92,254596
4182,0.001288,74.125.24.0-255,2184,63437,92,254596
4183,0.00129,172.31.47.0-255,66,63503,92,254596
4184,0.001649,74.125.24.0-255,1484,64987,92,254596
4185,0.001654,74.125.24.0-255,2902,67889,92,254596
4186,0.001656,172.31.47.0-255,66,67955,92,254596
4187,0.001683,74.125.24.0-255,1484,69439,92,254596
4188,0.001702,74.125.24.0-255,4320,73759,92,254596
4189,0.001704,172.31.47.0-255,66,73825,92,254596
4190,0.001709,74.125.24.0-255,4320,78145,92,254596
4191,0.001711,172.31.47.0-255,66,78211,92,254596
4192,0.001752,172.31.47.0-255,66,78277,92,254596
4193,0.001756,74.125.24.0-255,2902,81179,92,254596
4194,0.001758,172.31.47.0-255,66,81245,92,254596
4195,0.001802,74.125.24.0-255,2902,84147,92,254596
4196,0.001804,172.31.47.0-255,66,84213,92,254596
4197,0.001822,74.125.24.0-255,2184,86397,92,254596
4198,0.001824,172.31.47.0-255,66,86463,92,254596
4199,0.002218,74.125.24.0-255,1484,87947,92,254596
4200,0.002222,74.125.24.0-255,2902,90849,92,254596
4201,0.002224,172.31.47.0-255,66,90915,92,254596
4202,0.00225,74.125.24.0-255,5738,96653,92,254596
4203,0.002253,172.31.47.0-255,66,96719,92,254596
4204,0.002263,172.31.47.0-255,66,96785,92,254596
4205,0.002302,172.31.47.0-255,66,96851,92,254596
4206,0.002322,74.125.24.0-255,2184,99035,92,254596
4207,0.002324,172.31.47.0-255,66,99101,92,254596
4208,0.004545,74.125.24.0-255,2902,102003,92,254596
4209,0.004555,172.31.47.0-255,66,102069,92,254596
4210,0.004582,74.125.24.0-255,2902,104971,92,254596
4211,0.004585,172.31.47.0-255,66,105037,92,254596
4212,0.006805,74.125.24.0-255,2902,107939,92,254596
4213,0.006822,172.31.47.0-255,66,108005,92,254596
4214,0.006866,74.125.24.0-255,2902,110907,92,254596
4215,0.006871,172.31.47.0-255,66,110973,92,254596
4216,0.009089,74.125.24.0-255,2902,113875,92,254596
4217,0.009103,172.31.47.0-255,66,113941,92,254596
4218,0.009134,74.125.24.0-255,2902,116843,92,254596
4219,0.009136,172.31.47.0-255,66,116909,92,254596
4220,0.011344,74.125.24.0-255,2902,119811,92,254596
4221,0.011362,172.31.47.0-255,66,119877,92,254596
4222,0.011421,74.125.24.0-255,2902,122779,92,254596
4223,0.011425,172.31.47.0-255,66,122845,92,254596
4224,0.013626,74.125.24.0-255,2902,125747,92,254596
4225,0.013639,172.31.47.0-255,66,125813,92,254596
4226,0.013713,74.125.24.0-255,2902,128715,92,254596
4227,0.013718,172.31.47.0-255,66,128781,92,254596
4228,0.015891,74.125.24.0-255,2902,131683,92,254596
4229,0.015908,172.31.47.0-255,66,131749,92,254596
4230,0.015957,74.125.24.0-255,2902,134651,92,254596
4231,0.015961,172.31.47.0-255,66,134717,92,254596
4232,0.018148,74.125.24.0-255,2902,137619,92,254596
4233,0.018162,172.31.47.0-255,66,137685,92,254596
4234,0.018211,74.125.24.0-255,2902,140587,92,254596
4235,0.018216,172.31.47.0-255,66,140653,92,254596
4236,0.020404,74.125.24.0-255,2902,143555,92,254596
4237,0.020417,172.31.47.0-255,66,143621,92,254596
4238,0.020458,74.125.24.0-255,2902,146523,92,254596
4239,0.020462,172.31.47.0-255,66,146589,92,254596
4240,0.02269,74.125.24.0-255,2902,149491,92,254596
4241,0.022702,172.31.47.0-255,66,149557,92,254596
4242,0.022743,74.125.24.0-255,2902,152459,92,254596
4243,0.022746,172.31.47.0-255,66,152525,92,254596
4244,0.024973,74.125.24.0-255,5738,158263,92,254596
4245,0.024987,172.31.47.0-255,66,158329,92,254596
4246,0.027238,74.125.24.0-255,5738,164067,92,254596
4247,0.027253,172.31.47.0-255,66,164133,92,254596
4248,0.029494,74.125.24.0-255,5738,169871,92,254596
4249,0.029509,172.31.47.0-255,66,169937,92,254596
4250,0.030363,172.31.47.0-255,172,170109,92,254596
4251,0.030391,172.31.47.0-255,1103,171212,92,254596
4252,0.030463,172.31.47.0-255,1514,172726,92,254596
4253,0.030465,172.31.47.0-255,1514,174240,92,254596
4254,0.030466,172.31.47.0-255,1514,175754,92,254596
4255,0.030467,172.31.47.0-255,1514,177268,92,254596
4256,0.030469,172.31.47.0-255,1504,178772,92,254596
4257,0.031767,74.125.24.0-255,5738,184510,92,254596
4258,0.031779,172.31.47.0-255,66,184576,92,254596
4259,0.03191,104.244.42.0-255,66,184642,92,254596
4260,0.031963,104.244.42.0-255,66,184708,92,254596
4261,0.032112,104.244.42.0-255,66,184774,92,254596
4262,0.032585,104.244.42.0-255,108,184882,92,254596
4263,0.032592,172.31.47.0-255,66,184948,92,254596
4264,0.034044,74.125.24.0-255,5738,190686,92,254596
4265,0.034066,172.31.47.0-255,66,190752,92,254596
4266,0.036395,74.125.24.0-255,5738,196490,92,254596
4267,0.036407,172.31.47.0-255,66,196556,92,254596
4268,0.038662,74.125.24.0-255,5738,202294,92,254596
4269,0.038683,172.31.47.0-255,66,202360,92,254596
4270,0.040996,74.125.24.0-255,5738,208098,92,254596
4271,0.041051,172.31.47.0-255,66,208164,92,254596
4272,0.04333,74.125.24.0-255,5738,213902,92,254596
4273,0.043347,172.31.47.0-255,66,213968,92,254596
4274,0.045621,74.125.24.0-255,5738,219706,92,254596
4275,0.045646,172.31.47.0-255,66,219772,92,254596
4276,0.047927,74.125.24.0-255,5738,225510,92,254596
4277,0.047946,172.31.47.0-255,66,225576,92,254596
4278,0.050237,74.125.24.0-255,5738,231314,92,254596
4279,0.050259,172.31.47.0-255,66,231380,92,254596
4280,0.052541,74.125.24.0-255,5738,237118,92,254596
4281,0.052561,172.31.47.0-255,66,237184,92,254596
4282,0.054793,74.125.24.0-255,5738,242922,92,254596
4283,0.054806,172.31.47.0-255,66,242988,92,254596
4284,0.057046,74.125.24.0-255,5738,248726,92,254596
4285,0.057055,172.31.47.0-255,66,248792,92,254596
4286,0.059296,74.125.24.0-255,5738,254530,92,254596
4287,0.05931,172.31.47.0-255,66,254596,92,254596
4288,0.0,172.253.118.0-255,153,153,92,296967
4289,2.1e-05,172.31.47.0-255,66,219,92,296967
4290,2.8e-05,172.253.118.0-255,1484,1703,92,296967
4291,3.3e-05,172.31.47.0-255,66,1769,92,296967
4292,3.8e-05,172.253.118.0-255,2902,4671,92,296967
4293,4.2e-05,172.31.47.0-255,66,4737,92,296967
4294,6.8e-05,172.253.118.0-255,1484,6221,92,296967
4295,7.2e-05,172.31.47.0-255,66,6287,92,296967
4296,7.9e-05,172.253.118.0-255,5738,12025,92,296967
4297,8.1e-05,172.31.47.0-255,66,12091,92,296967
4298,8.5e-05,172.253.118.0-255,2057,14148,92,296967
4299,8.8e-05,172.31.47.0-255,66,14214,92,296967
4300,0.00012,172.253.118.0-255,2902,17116,92,296967
4301,0.000123,172.31.47.0-255,66,17182,92,296967
4302,0.00014,172.253.118.0-255,2902,20084,92,296967
4303,0.000143,172.31.47.0-255,66,20150,92,296967
4304,0.00015,172.253.118.0-255,7156,27306,92,296967
4305,0.000152,172.31.47.0-255,66,27372,92,296967
4306,0.000179,172.253.118.0-255,3961,31333,92,296967
4307,0.000181,172.31.47.0-255,66,31399,92,296967
4308,0.000428,172.253.118.0-255,1484,32883,92,296967
4309,0.000434,172.31.47.0-255,66,32949,92,296967
4310,0.00044,172.253.118.0-255,2902,35851,92,296967
4311,0.000442,172.31.47.0-255,66,35917,92,296967
4312,0.000471,172.253.118.0-255,5738,41655,92,296967
4313,0.000474,172.31.47.0-255,66,41721,92,296967
4314,0.000503,172.253.118.0-255,5738,47459,92,296967
4315,0.000507,172.31.47.0-255,66,47525,92,296967
4316,0.000527,172.31.47.0-255,66,47591,92,296967
4317,0.000544,172.253.118.0-255,5738,53329,92,296967
4318,0.000546,172.31.47.0-255,66,53395,92,296967
4319,0.00057,172.253.118.0-255,3961,57356,92,296967
4320,0.000573,172.31.47.0-255,66,57422,92,296967
4321,0.000576,172.253.118.0-255,410,57832,92,296967
4322,0.000639,172.253.118.0-255,333,58165,92,296967
4323,0.001015,172.253.118.0-255,1484,59649,92,296967
4324,0.00102,172.31.47.0-255,66,59715,92,296967
4325,0.001039,172.253.118.0-255,2902,62617,92,296967
4326,0.001042,172.31.47.0-255,66,62683,92,296967
4327,0.001075,172.253.118.0-255,5738,68421,92,296967
4328,0.001078,172.31.47.0-255,66,68487,92,296967
4329,0.001085,172.253.118.0-255,5738,74225,92,296967
4330,0.001087,172.31.47.0-255,66,74291,92,296967
4331,0.00111,172.253.118.0-255,2902,77193,92,296967
4332,0.001112,172.31.47.0-255,66,77259,92,296967
4333,0.001136,172.253.118.0-255,7156,84415,92,296967
4334,0.001138,172.31.47.0-255,66,84481,92,296967
4335,0.001163,172.253.118.0-255,7156,91637,92,296967
4336,0.001165,172.31.47.0-255,66,91703,92,296967
4337,0.001179,172.253.118.0-255,766,92469,92,296967
4338,0.001371,172.31.47.0-255,66,92535,92,296967
4339,0.001489,172.253.118.0-255,1484,94019,92,296967
4340,0.001497,172.253.118.0-255,2902,96921,92,296967
4341,0.0015,172.31.47.0-255,66,96987,92,296967
4342,0.001505,172.253.118.0-255,2902,99889,92,296967
4343,0.001506,172.31.47.0-255,66,99955,92,296967
4344,0.001519,172.253.118.0-255,2902,102857,92,296967
4345,0.001521,172.31.47.0-255,66,102923,92,296967
4346,0.001541,172.253.118.0-255,4320,107243,92,296967
4347,0.001543,172.31.47.0-255,66,107309,92,296967
4348,0.00157,172.31.47.0-255,66,107375,92,296967
4349,0.001581,172.31.47.0-255,66,107441,92,296967
4350,0.001727,172.253.118.0-255,1484,108925,92,296967
4351,0.001732,172.253.118.0-255,1484,110409,92,296967
4352,0.001735,172.31.47.0-255,66,110475,92,296967
4353,0.001753,172.253.118.0-255,1484,111959,92,296967
4354,0.001759,172.253.118.0-255,5738,117697,92,296967
4355,0.001761,172.31.47.0-255,66,117763,92,296967
4356,0.001766,172.253.118.0-255,4320,122083,92,296967
4357,0.001768,172.31.47.0-255,66,122149,92,296967
4358,0.001816,172.253.118.0-255,2902,125051,92,296967
4359,0.001818,172.31.47.0-255,66,125117,92,296967
4360,0.001842,172.31.47.0-255,66,125183,92,296967
4361,0.001851,172.31.47.0-255,66,125249,92,296967
4362,0.00385,172.253.118.0-255,5738,130987,92,296967
4363,0.003857,172.31.47.0-255,66,131053,92,296967
4364,0.005883,172.253.118.0-255,5738,136791,92,296967
4365,0.005887,172.31.47.0-255,66,136857,92,296967
4366,0.007886,172.253.118.0-255,5738,142595,92,296967
4367,0.007893,172.31.47.0-255,66,142661,92,296967
4368,0.009905,172.253.118.0-255,5738,148399,92,296967
4369,0.009915,172.31.47.0-255,66,148465,92,296967
4370,0.011934,172.253.118.0-255,5738,154203,92,296967
4371,0.011942,172.31.47.0-255,66,154269,92,296967
4372,0.013966,172.253.118.0-255,5738,160007,92,296967
4373,0.013974,172.31.47.0-255,66,160073,92,296967
4374,0.015994,172.253.118.0-255,5738,165811,92,296967
4375,0.016001,172.31.47.0-255,66,165877,92,296967
4376,0.017993,172.253.118.0-255,5738,171615,92,296967
4377,0.018,172.31.47.0-255,66,171681,92,296967
4378,0.020022,172.253.118.0-255,5738,177419,92,296967
4379,0.020029,172.31.47.0-255,66,177485,92,296967
4380,0.022048,172.253.118.0-255,5738,183223,92,296967
4381,0.022055,172.31.47.0-255,66,183289,92,296967
4382,0.024067,172.253.118.0-255,5738,189027,92,296967
4383,0.024075,172.31.47.0-255,66,189093,92,296967
4384,0.025827,172.31.47.0-255,172,189265,92,296967
4385,0.025859,172.31.47.0-255,1107,190372,92,296967
4386,0.02592,172.31.47.0-255,1514,191886,92,296967
4387,0.025921,172.31.47.0-255,1514,193400,92,296967
4388,0.025923,172.31.47.0-255,1514,194914,92,296967
4389,0.025924,172.31.47.0-255,1514,196428,92,296967
4390,0.025925,172.31.47.0-255,1499,197927,92,296967
4391,0.026078,172.253.118.0-255,5738,203665,92,296967
4392,0.026085,172.31.47.0-255,66,203731,92,296967
4393,0.027376,104.244.42.0-255,66,203797,92,296967
4394,0.027424,104.244.42.0-255,66,203863,92,296967
4395,0.027577,104.244.42.0-255,66,203929,92,296967
4396,0.028095,172.253.118.0-255,5738,209667,92,296967
4397,0.028101,172.31.47.0-255,66,209733,92,296967
4398,0.028194,104.244.42.0-255,108,209841,92,296967
4399,0.028198,172.31.47.0-255,66,209907,92,296967
4400,0.030123,172.253.118.0-255,5738,215645,92,296967
4401,0.030131,172.31.47.0-255,66,215711,92,296967
4402,0.032153,172.253.118.0-255,5738,221449,92,296967
4403,0.032158,172.31.47.0-255,66,221515,92,296967
4404,0.034174,172.253.118.0-255,5738,227253,92,296967
4405,0.034179,172.31.47.0-255,66,227319,92,296967
4406,0.036207,172.253.118.0-255,5738,233057,92,296967
4407,0.036212,172.31.47.0-255,66,233123,92,296967
4408,0.038219,172.253.118.0-255,5738,238861,92,296967
4409,0.038224,172.31.47.0-255,66,238927,92,296967
4410,0.040234,172.253.118.0-255,5738,244665,92,296967
4411,0.040243,172.31.47.0-255,66,244731,92,296967
4412,0.042247,172.253.118.0-255,5738,250469,92,296967
4413,0.042252,172.31.47.0-255,66,250535,92,296967
4414,0.044261,172.253.118.0-255,5738,256273,92,296967
4415,0.044267,172.31.47.0-255,66,256339,92,296967
4416,0.046289,172.253.118.0-255,5738,262077,92,296967
4417,0.046295,172.31.47.0-255,66,262143,92,296967
4418,0.048312,172.253.118.0-255,5738,267881,92,296967
4419,0.048318,172.31.47.0-255,66,267947,92,296967
4420,0.050332,172.253.118.0-255,5738,273685,92,296967
4421,0.050339,172.31.47.0-255,66,273751,92,296967
4422,0.052346,172.253.118.0-255,5738,279489,92,296967
4423,0.052353,172.31.47.0-255,66,279555,92,296967
4424,0.054373,172.253.118.0-255,5738,285293,92,296967
4425,0.054379,172.31.47.0-255,66,285359,92,296967
4426,0.056411,172.253.118.0-255,5738,291097,92,296967
4427,0.056417,172.31.47.0-255,66,291163,92,296967
4428,0.05842,172.253.118.0-255,5738,296901,92,296967
4429,0.058425,172.31.47.0-255,66,296967,92,296967
4430,0.0,74.125.24.0-255,153,153,92,324926
4431,3.4e-05,172.31.47.0-255,66,219,92,324926
4432,3.9e-05,74.125.24.0-255,1484,1703,92,324926
4433,4.4e-05,172.31.47.0-255,66,1769,92,324926
4434,4.9e-05,74.125.24.0-255,2902,4671,92,324926
4435,5.2e-05,172.31.47.0-255,66,4737,92,324926
4436,5.7e-05,74.125.24.0-255,4320,9057,92,324926
4437,5.9e-05,172.31.47.0-255,66,9123,92,324926
4438,6.6e-05,74.125.24.0-255,4923,14046,92,324926
4439,6.9e-05,172.31.47.0-255,66,14112,92,324926
4440,0.000257,74.125.24.0-255,1484,15596,92,324926
4441,0.000261,172.31.47.0-255,66,15662,92,324926
4442,0.000266,74.125.24.0-255,2902,18564,92,324926
4443,0.000268,172.31.47.0-255,66,18630,92,324926
4444,0.000292,74.125.24.0-255,5738,24368,92,324926
4445,0.000295,172.31.47.0-255,66,24434,92,324926
4446,0.000298,74.125.24.0-255,1484,25918,92,324926
4447,0.0003,172.31.47.0-255,66,25984,92,324926
4448,0.00032,74.125.24.0-255,5379,31363,92,324926
4449,0.000323,172.31.47.0-255,66,31429,92,324926
4450,0.000328,74.125.24.0-255,4320,35749,92,324926
4451,0.000331,172.31.47.0-255,66,35815,92,324926
4452,0.000358,74.125.24.0-255,2902,38717,92,324926
4453,0.000361,172.31.47.0-255,66,38783,92,324926
4454,0.000372,172.31.47.0-255,66,38849,92,324926
4455,0.000423,74.125.24.0-255,1484,40333,92,324926
4456,0.000426,172.31.47.0-255,66,40399,92,324926
4457,0.000444,74.125.24.0-255,2902,43301,92,324926
4458,0.000446,172.31.47.0-255,66,43367,92,324926
4459,0.000452,74.125.24.0-255,5738,49105,92,324926
4460,0.000454,172.31.47.0-255,66,49171,92,324926
4461,0.000457,74.125.24.0-255,1484,50655,92,324926
4462,0.000459,172.31.47.0-255,66,50721,92,324926
4463,0.000482,74.125.24.0-255,5658,56379,92,324926
4464,0.000485,172.31.47.0-255,66,56445,92,324926
4465,0.000488,74.125.24.0-255,127,56572,92,324926
4466,0.000489,172.31.47.0-255,66,56638,92,324926
4467,0.000508,74.125.24.0-255,346,56984,92,324926
4468,0.000512,172.31.47.0-255,66,57050,92,324926
4469,0.000819,74.125.24.0-255,1484,58534,92,324926
4470,0.000823,172.31.47.0-255,66,58600,92,324926
4471,0.000832,74.125.24.0-255,2902,61502,92,324926
4472,0.000834,172.31.47.0-255,66,61568,92,324926
4473,0.000838,74.125.24.0-255,2902,64470,92,324926
4474,0.00084,172.31.47.0-255,66,64536,92,324926
4475,0.000865,74.125.24.0-255,2902,67438,92,324926
4476,0.000868,172.31.47.0-255,66,67504,92,324926
4477,0.000879,172.31.47.0-255,66,67570,92,324926
4478,0.000897,74.125.24.0-255,1484,69054,92,324926
4479,0.000908,172.31.47.0-255,66,69120,92,324926
4480,0.00096,74.125.24.0-255,2184,71304,92,324926
4481,0.000964,172.31.47.0-255,66,71370,92,324926
4482,0.000982,74.125.24.0-255,2902,74272,92,324926
4483,0.000985,172.31.47.0-255,66,74338,92,324926
4484,0.00099,74.125.24.0-255,4320,78658,92,324926
4485,0.000992,172.31.47.0-255,66,78724,92,324926
4486,0.000995,74.125.24.0-255,2902,81626,92,324926
4487,0.000997,172.31.47.0-255,66,81692,92,324926
4488,0.001023,74.125.24.0-255,5738,87430,92,324926
4489,0.001025,172.31.47.0-255,66,87496,92,324926
4490,0.00104,74.125.24.0-255,5738,93234,92,324926
4491,0.001043,172.31.47.0-255,66,93300,92,324926
4492,0.001062,172.31.47.0-255,66,93366,92,324926
4493,0.001087,172.31.47.0-255,66,93432,92,324926
4494,0.001113,172.31.47.0-255,66,93498,92,324926
4495,0.001129,74.125.24.0-255,1484,94982,92,324926
4496,0.001145,74.125.24.0-255,7156,102138,92,324926
4497,0.001148,172.31.47.0-255,66,102204,92,324926
4498,0.001171,74.125.24.0-255,6438,108642,92,324926
4499,0.001174,172.31.47.0-255,66,108708,92,324926
4500,0.001366,74.125.24.0-255,1484,110192,92,324926
4501,0.001373,74.125.24.0-255,2902,113094,92,324926
4502,0.001378,172.31.47.0-255,66,113160,92,324926
4503,0.001383,74.125.24.0-255,1484,114644,92,324926
4504,0.001397,74.125.24.0-255,4320,118964,92,324926
4505,0.0014,172.31.47.0-255,66,119030,92,324926
4506,0.001428,172.31.47.0-255,66,119096,92,324926
4507,0.001465,74.125.24.0-255,4320,123416,92,324926
4508,0.001467,172.31.47.0-255,66,123482,92,324926
4509,0.001485,74.125.24.0-255,6438,129920,92,324926
4510,0.001487,172.31.47.0-255,66,129986,92,324926
4511,0.001567,74.125.24.0-255,1484,131470,92,324926
4512,0.001569,74.125.24.0-255,1484,132954,92,324926
4513,0.001571,172.31.47.0-255,66,133020,92,324926
4514,0.001587,74.125.24.0-255,1484,134504,92,324926
4515,0.001592,74.125.24.0-255,5738,140242,92,324926
4516,0.001594,172.31.47.0-255,66,140308,92,324926
4517,0.001597,74.125.24.0-255,1484,141792,92,324926
4518,0.001621,74.125.24.0-255,4320,146112,92,324926
4519,0.001636,74.125.24.0-255,2902,149014,92,324926
4520,0.001668,74.125.24.0-255,3602,152616,92,324926
4521,0.001936,74.125.24.0-255,1484,154100,92,324926
4522,0.001951,74.125.24.0-255,2902,157002,92,324926
4523,0.001965,74.125.24.0-255,5738,162740,92,324926
4524,0.001982,74.125.24.0-255,4320,167060,92,324926
4525,0.001995,74.125.24.0-255,1484,168544,92,324926
4526,0.002022,74.125.24.0-255,1484,170028,92,324926
4527,0.00204,74.125.24.0-255,6438,176466,92,324926
4528,0.00496,172.31.47.0-255,66,176532,92,324926
4529,0.00719,74.125.24.0-255,5738,182270,92,324926
4530,0.007198,172.31.47.0-255,66,182336,92,324926
4531,0.009417,74.125.24.0-255,5738,188074,92,324926
4532,0.009427,172.31.47.0-255,66,188140,92,324926
4533,0.011659,74.125.24.0-255,5738,193878,92,324926
4534,0.01167,172.31.47.0-255,66,193944,92,324926
4535,0.01388,74.125.24.0-255,5738,199682,92,324926
4536,0.013887,172.31.47.0-255,66,199748,92,324926
4537,0.016074,74.125.24.0-255,5738,205486,92,324926
4538,0.016082,172.31.47.0-255,66,205552,92,324926
4539,0.018303,74.125.24.0-255,5738,211290,92,324926
4540,0.018313,172.31.47.0-255,66,211356,92,324926
4541,0.020523,74.125.24.0-255,5738,217094,92,324926
4542,0.02053,172.31.47.0-255,66,217160,92,324926
4543,0.021367,172.31.47.0-255,172,217332,92,324926
4544,0.021403,172.31.47.0-255,1112,218444,92,324926
4545,0.021462,172.31.47.0-255,1514,219958,92,324926
4546,0.021464,172.31.47.0-255,1514,221472,92,324926
4547,0.021496,172.31.47.0-255,1514,222986,92,324926
4548,0.021497,172.31.47.0-255,1514,224500,92,324926
4549,0.021517,172.31.47.0-255,1494,225994,92,324926
4550,0.022733,74.125.24.0-255,5738,231732,92,324926
4551,0.022739,172.31.47.0-255,66,231798,92,324926
4552,0.022901,104.244.42.0-255,66,231864,92,324926
4553,0.02294,104.244.42.0-255,66,231930,92,324926
4554,0.023014,104.244.42.0-255,66,231996,92,324926
4555,0.023069,104.244.42.0-255,66,232062,92,324926
4556,0.024958,74.125.24.0-255,5738,237800,92,324926
4557,0.024964,172.31.47.0-255,66,237866,92,324926
4558,0.027173,74.125.24.0-255,5738,243604,92,324926
4559,0.02718,172.31.47.0-255,66,243670,92,324926
4560,0.029375,74.125.24.0-255,5738,249408,92,324926
4561,0.029382,172.31.47.0-255,66,249474,92,324926
4562,0.031566,74.125.24.0-255,5738,255212,92,324926
4563,0.031573,172.31.47.0-255,66,255278,92,324926
4564,0.033772,74.125.24.0-255,5738,261016,92,324926
4565,0.033778,172.31.47.0-255,66,261082,92,324926
4566,0.035976,74.125.24.0-255,5738,266820,92,324926
4567,0.035983,172.31.47.0-255,66,266886,92,324926
4568,0.038186,74.125.24.0-255,5738,272624,92,324926
4569,0.038191,172.31.47.0-255,66,272690,92,324926
4570,0.040384,74.125.24.0-255,5738,278428,92,324926
4571,0.04039,172.31.47.0-255,66,278494,92,324926
4572,0.042581,74.125.24.0-255,5738,284232,92,324926
4573,0.042589,172.31.47.0-255,66,284298,92,324926
4574,0.0448,74.125.24.0-255,5738,290036,92,324926
4575,0.044805,172.31.47.0-255,66,290102,92,324926
4576,0.047026,74.125.24.0-255,5738,295840,92,324926
4577,0.047033,172.31.47.0-255,66,295906,92,324926
4578,0.049249,74.125.24.0-255,5738,301644,92,324926
4579,0.049256,172.31.47.0-255,66,301710,92,324926
4580,0.051485,74.125.24.0-255,5738,307448,92,324926
4581,0.051492,172.31.47.0-255,66,307514,92,324926
4582,0.053701,74.125.24.0-255,5738,313252,92,324926
4583,0.053707,172.31.47.0-255,66,313318,92,324926
4584,0.055914,74.125.24.0-255,5738,319056,92,324926
4585,0.055921,172.31.47.0-255,66,319122,92,324926
4586,0.058129,74.125.24.0-255,5738,324860,92,324926
4587,0.058135,172.31.47.0-255,66,324926,92,324926
4588,0.0,172.217.194.0-255,153,153,92,316679
4589,2.6e-05,172.31.47.0-255,66,219,92,316679
4590,3.3e-05,172.217.194.0-255,1484,1703,92,316679
4591,3.6e-05,172.31.47.0-255,66,1769,92,316679
4592,4e-05,172.217.194.0-255,2902,4671,92,316679
4593,4.2e-05,172.31.47.0-255,66,4737,92,316679
4594,5.5e-05,172.217.194.0-255,7156,11893,92,316679
4595,5.7e-05,172.31.47.0-255,66,11959,92,316679
4596,7.9e-05,172.217.194.0-255,1484,13443,92,316679
4597,8.1e-05,172.31.47.0-255,66,13509,92,316679
4598,0.000119,172.31.47.0-255,66,13575,92,316679
4599,0.000123,172.217.194.0-255,2902,16477,92,316679
4600,0.000124,172.31.47.0-255,66,16543,92,316679
4601,0.000145,172.217.194.0-255,2543,19086,92,316679
4602,0.000148,172.31.47.0-255,66,19152,92,316679
4603,0.000188,172.217.194.0-255,1484,20636,92,316679
4604,0.00019,172.31.47.0-255,66,20702,92,316679
4605,0.000195,172.217.194.0-255,2902,23604,92,316679
4606,0.000197,172.31.47.0-255,66,23670,92,316679
4607,0.000199,172.217.194.0-255,1484,25154,92,316679
4608,0.000201,172.31.47.0-255,66,25220,92,316679
4609,0.000222,172.217.194.0-255,4320,29540,92,316679
4610,0.000224,172.31.47.0-255,66,29606,92,316679
4611,0.000252,172.217.194.0-255,4320,33926,92,316679
4612,0.000256,172.31.47.0-255,66,33992,92,316679
4613,0.000285,172.217.194.0-255,3961,37953,92,316679
4614,0.000287,172.31.47.0-255,66,38019,92,316679
4615,0.000296,172.31.47.0-255,66,38085,92,316679
4616,0.000307,172.217.194.0-255,7085,45170,92,316679
4617,0.000312,172.31.47.0-255,66,45236,92,316679
4618,0.000347,172.217.194.0-255,366,45602,92,316679
4619,0.000435,172.217.194.0-255,1484,47086,92,316679
4620,0.000438,172.31.47.0-255,66,47152,92,316679
4621,0.000443,172.217.194.0-255,2902,50054,92,316679
4622,0.000446,172.31.47.0-255,66,50120,92,316679
4623,0.000474,172.217.194.0-255,5738,55858,92,316679
4624,0.000477,172.31.47.0-255,66,55924,92,316679
4625,0.00051,172.31.47.0-255,66,55990,92,316679
4626,0.000538,172.217.194.0-255,3961,59951,92,316679
4627,0.00054,172.31.47.0-255,66,60017,92,316679
4628,0.000544,172.217.194.0-255,1484,61501,92,316679
4629,0.000567,172.217.194.0-255,5738,67239,92,316679
4630,0.000569,172.31.47.0-255,66,67305,92,316679
4631,0.000591,172.217.194.0-255,3961,71266,92,316679
4632,0.000594,172.31.47.0-255,66,71332,92,316679
4633,0.000676,172.217.194.0-255,1484,72816,92,316679
4634,0.000679,172.217.194.0-255,1484,74300,92,316679
4635,0.000682,172.31.47.0-255,66,74366,92,316679
4636,0.000692,172.217.194.0-255,1484,75850,92,316679
4637,0.000702,172.217.194.0-255,5738,81588,92,316679
4638,0.000704,172.31.47.0-255,66,81654,92,316679
4639,0.000742,172.31.47.0-255,66,81720,92,316679
4640,0.000747,172.217.194.0-255,5738,87458,92,316679
4641,0.000749,172.31.47.0-255,66,87524,92,316679
4642,0.000777,172.217.194.0-255,5020,92544,92,316679
4643,0.00078,172.31.47.0-255,66,92610,92,316679
4644,0.000859,172.217.194.0-255,1484,94094,92,316679
4645,0.000882,172.217.194.0-255,2902,96996,92,316679
4646,0.000885,172.31.47.0-255,66,97062,92,316679
4647,0.000897,172.217.194.0-255,4320,101382,92,316679
4648,0.000899,172.31.47.0-255,66,101448,92,316679
4649,0.000923,172.217.194.0-255,1484,102932,92,316679
4650,0.000929,172.217.194.0-255,7156,110088,92,316679
4651,0.000931,172.31.47.0-255,66,110154,92,316679
4652,0.000959,172.217.194.0-255,5738,115892,92,316679
4653,0.000962,172.31.47.0-255,66,115958,92,316679
4654,0.000989,172.31.47.0-255,66,116024,92,316679
4655,0.001295,172.217.194.0-255,1484,117508,92,316679
4656,0.001299,172.217.194.0-255,1484,118992,92,316679
4657,0.001302,172.31.47.0-255,66,119058,92,316679
4658,0.00132,172.217.194.0-255,1484,120542,92,316679
4659,0.001327,172.217.194.0-255,5738,126280,92,316679
4660,0.001329,172.31.47.0-255,66,126346,92,316679
4661,0.001355,172.217.194.0-255,2902,129248,92,316679
4662,0.001358,172.31.47.0-255,66,129314,92,316679
4663,0.001384,172.217.194.0-255,7156,136470,92,316679
4664,0.001387,172.31.47.0-255,66,136536,92,316679
4665,0.00139,172.217.194.0-255,1484,138020,92,316679
4666,0.001427,172.31.47.0-255,66,138086,92,316679
4667,0.00143,172.217.194.0-255,2184,140270,92,316679
4668,0.001432,172.31.47.0-255,66,140336,92,316679
4669,0.001893,172.217.194.0-255,1484,141820,92,316679
4670,0.001901,172.217.194.0-255,2902,144722,92,316679
4671,0.001905,172.31.47.0-255,66,144788,92,316679
4672,0.00191,172.217.194.0-255,2902,147690,92,316679
4673,0.001912,172.31.47.0-255,66,147756,92,316679
4674,0.001931,172.217.194.0-255,2902,150658,92,316679
4675,0.001937,172.31.47.0-255,66,150724,92,316679
4676,0.001956,172.217.194.0-255,7156,157880,92,316679
4677,0.001958,172.31.47.0-255,66,157946,92,316679
4678,0.001983,172.217.194.0-255,5738,163684,92,316679
4679,0.001986,172.31.47.0-255,66,163750,92,316679
4680,0.001992,172.217.194.0-255,7156,170906,92,316679
4681,0.001993,172.31.47.0-255,66,170972,92,316679
4682,0.002059,172.217.194.0-255,3602,174574,92,316679
4683,0.002063,172.31.47.0-255,66,174640,92,316679
4684,0.002557,172.217.194.0-255,1484,176124,92,316679
4685,0.002572,172.217.194.0-255,2902,179026,92,316679
4686,0.002573,172.31.47.0-255,66,179092,92,316679
4687,0.002598,172.217.194.0-255,5738,184830,92,316679
4688,0.0026,172.31.47.0-255,66,184896,92,316679
4689,0.002639,172.217.194.0-255,5738,190634,92,316679
4690,0.002641,172.31.47.0-255,66,190700,92,316679
4691,0.002667,172.217.194.0-255,4320,195020,92,316679
4692,0.002669,172.31.47.0-255,66,195086,92,316679
4693,0.002679,172.31.47.0-255,66,195152,92,316679
4694,0.002686,172.217.194.0-255,2184,197336,92,316679
4695,0.002687,172.31.47.0-255,66,197402,92,316679
4696,0.003054,172.217.194.0-255,1484,198886,92,316679
4697,0.003064,172.217.194.0-255,2902,201788,92,316679
4698,0.003066,172.31.47.0-255,66,201854,92,316679
4699,0.003087,172.217.194.0-255,2902,204756,92,316679
4700,0.00309,172.31.47.0-255,66,204822,92,316679
4701,0.003099,172.217.194.0-255,2902,207724,92,316679
4702,0.003101,172.31.47.0-255,66,207790,92,316679
4703,0.003107,172.217.194.0-255,2902,210692,92,316679
4704,0.003109,172.31.47.0-255,66,210758,92,316679
4705,0.003133,172.217.194.0-255,1484,212242,92,316679
4706,0.003139,172.217.194.0-255,5738,217980,92,316679
4707,0.00314,172.31.47.0-255,66,218046,92,316679
4708,0.003163,172.217.194.0-255,7156,225202,92,316679
4709,0.003165,172.31.47.0-255,66,225268,92,316679
4710,0.003176,172.217.194.0-255,2902,228170,92,316679
4711,0.003178,172.31.47.0-255,66,228236,92,316679
4712,0.0032,172.217.194.0-255,3602,231838,92,316679
4713,0.003202,172.31.47.0-255,66,231904,92,316679
4714,0.003223,172.217.194.0-255,5738,237642,92,316679
4715,0.003225,172.31.47.0-255,66,237708,92,316679
4716,0.003246,172.217.194.0-255,1484,239192,92,316679
4717,0.003255,172.31.47.0-255,66,239258,92,316679
4718,0.003265,172.217.194.0-255,1484,240742,92,316679
4719,0.003288,172.217.194.0-255,4320,245062,92,316679
4720,0.00329,172.31.47.0-255,66,245128,92,316679
4721,0.003323,172.31.47.0-255,66,245194,92,316679
4722,0.003343,172.217.194.0-255,1484,246678,92,316679
4723,0.003346,172.217.194.0-255,1484,248162,92,316679
4724,0.003347,172.31.47.0-255,66,248228,92,316679
4725,0.003366,172.217.194.0-255,1484,249712,92,316679
4726,0.003371,172.217.194.0-255,5738,255450,92,316679
4727,0.003373,172.31.47.0-255,66,255516,92,316679
4728,0.003378,172.217.194.0-255,5738,261254,92,316679
4729,0.00338,172.31.47.0-255,66,261320,92,316679
4730,0.003412,172.217.194.0-255,7156,268476,92,316679
4731,0.003414,172.31.47.0-255,66,268542,92,316679
4732,0.003449,172.217.194.0-255,1484,270026,92,316679
4733,0.003462,172.217.194.0-255,1484,271510,92,316679
4734,0.003482,172.217.194.0-255,1484,272994,92,316679
4735,0.003488,172.217.194.0-255,5738,278732,92,316679
4736,0.003492,172.217.194.0-255,4320,283052,92,316679
4737,0.003514,172.217.194.0-255,1484,284536,92,316679
4738,0.003518,172.217.194.0-255,5738,290274,92,316679
4739,0.003537,172.217.194.0-255,3602,293876,92,316679
4740,0.003539,172.217.194.0-255,1484,295360,92,316679
4741,0.003557,172.217.194.0-255,1484,296844,92,316679
4742,0.003568,172.217.194.0-255,1484,298328,92,316679
4743,0.0036,172.217.194.0-255,4320,302648,92,316679
4744,0.003612,172.217.194.0-255,1484,304132,92,316679
4745,0.003615,172.217.194.0-255,2902,307034,92,316679
4746,0.003624,172.217.194.0-255,97,307131,92,316679
4747,0.003664,172.217.194.0-255,105,307236,92,316679
4748,0.006458,172.31.47.0-255,66,307302,92,316679
4749,0.008266,172.31.47.0-255,105,307407,92,316679
4750,0.010903,172.217.194.0-255,66,307473,92,316679
4751,0.0328,172.31.47.0-255,172,307645,92,316679
4752,0.032828,172.31.47.0-255,1112,308757,92,316679
4753,0.032867,172.31.47.0-255,1514,310271,92,316679
4754,0.032869,172.31.47.0-255,1514,311785,92,316679
4755,0.03287,172.31.47.0-255,1514,313299,92,316679
4756,0.032871,172.31.47.0-255,1514,314813,92,316679
4757,0.032894,172.31.47.0-255,1494,316307,92,316679
4758,0.034325,104.244.42.0-255,66,316373,92,316679
4759,0.034386,104.244.42.0-255,66,316439,92,316679
4760,0.034424,104.244.42.0-255,66,316505,92,316679
4761,0.035548,104.244.42.0-255,108,316613,92,316679
4762,0.035552,172.31.47.0-255,66,316679,92,316679
4763,0.0,172.217.194.0-255,298,298,92,242241
4764,2.4e-05,172.31.47.0-255,66,364,92,242241
4765,2.9e-05,172.217.194.0-255,1484,1848,92,242241
4766,3.2e-05,172.31.47.0-255,66,1914,92,242241
4767,3.7e-05,172.217.194.0-255,4320,6234,92,242241
4768,3.9e-05,172.31.47.0-255,66,6300,92,242241
4769,4.1e-05,172.217.194.0-255,1484,7784,92,242241
4770,4.4e-05,172.31.47.0-255,66,7850,92,242241
4771,6.5e-05,172.217.194.0-255,6034,13884,92,242241
4772,6.7e-05,172.31.47.0-255,66,13950,92,242241
4773,7e-05,172.217.194.0-255,1484,15434,92,242241
4774,7.1e-05,172.31.47.0-255,66,15500,92,242241
4775,9.6e-05,172.31.47.0-255,66,15566,92,242241
4776,0.000108,172.217.194.0-255,2902,18468,92,242241
4777,0.00011,172.31.47.0-255,66,18534,92,242241
4778,0.000114,172.217.194.0-255,2543,21077,92,242241
4779,0.000116,172.31.47.0-255,66,21143,92,242241
4780,0.00017,172.217.194.0-255,1484,22627,92,242241
4781,0.000173,172.31.47.0-255,66,22693,92,242241
4782,0.000177,172.217.194.0-255,2902,25595,92,242241
4783,0.000179,172.31.47.0-255,66,25661,92,242241
4784,0.000183,172.217.194.0-255,4320,29981,92,242241
4785,0.000185,172.31.47.0-255,66,30047,92,242241
4786,0.000199,172.217.194.0-255,1484,31531,92,242241
4787,0.000201,172.31.47.0-255,66,31597,92,242241
4788,0.000206,172.217.194.0-255,5738,37335,92,242241
4789,0.000208,172.31.47.0-255,66,37401,92,242241
4790,0.000229,172.217.194.0-255,1125,38526,92,242241
4791,0.00023,172.31.47.0-255,66,38592,92,242241
4792,0.00034,172.217.194.0-255,1484,40076,92,242241
4793,0.000343,172.31.47.0-255,66,40142,92,242241
4794,0.000348,172.217.194.0-255,2902,43044,92,242241
4795,0.00035,172.31.47.0-255,66,43110,92,242241
4796,0.000354,172.217.194.0-255,4320,47430,92,242241
4797,0.000356,172.31.47.0-255,66,47496,92,242241
4798,0.000378,172.217.194.0-255,1484,48980,92,242241
4799,0.000422,172.217.194.0-255,6797,55777,92,242241
4800,0.000425,172.31.47.0-255,66,55843,92,242241
4801,0.000693,172.217.194.0-255,648,56491,92,242241
4802,0.000727,172.31.47.0-255,66,56557,92,242241
4803,0.000897,172.217.194.0-255,1484,58041,92,242241
4804,0.000905,172.217.194.0-255,2902,60943,92,242241
4805,0.000909,172.31.47.0-255,66,61009,92,242241
4806,0.000931,172.217.194.0-255,5738,66747,92,242241
4807,0.000934,172.31.47.0-255,66,66813,92,242241
4808,0.00095,172.217.194.0-255,1484,68297,92,242241
4809,0.000966,172.217.194.0-255,7156,75453,92,242241
4810,0.000968,172.31.47.0-255,66,75519,92,242241
4811,0.000994,172.217.194.0-255,1484,77003,92,242241
4812,0.001005,172.31.47.0-255,66,77069,92,242241
4813,0.001008,172.217.194.0-255,2184,79253,92,242241
4814,0.00101,172.31.47.0-255,66,79319,92,242241
4815,0.001823,172.217.194.0-255,1484,80803,92,242241
4816,0.001829,172.217.194.0-255,2902,83705,92,242241
4817,0.001832,172.31.47.0-255,66,83771,92,242241
4818,0.001837,172.217.194.0-255,2902,86673,92,242241
4819,0.001839,172.31.47.0-255,66,86739,92,242241
4820,0.001855,172.217.194.0-255,2902,89641,92,242241
4821,0.001857,172.31.47.0-255,66,89707,92,242241
4822,0.001914,172.31.47.0-255,66,89773,92,242241
4823,0.001919,172.217.194.0-255,5738,95511,92,242241
4824,0.001921,172.31.47.0-255,66,95577,92,242241
4825,0.001942,172.217.194.0-255,5020,100597,92,242241
4826,0.001944,172.31.47.0-255,66,100663,92,242241
4827,0.002643,172.217.194.0-255,1484,102147,92,242241
4828,0.00265,172.217.194.0-255,2902,105049,92,242241
4829,0.002654,172.31.47.0-255,66,105115,92,242241
4830,0.002657,172.217.194.0-255,1484,106599,92,242241
4831,0.002679,172.217.194.0-255,4320,110919,92,242241
4832,0.002682,172.31.47.0-255,66,110985,92,242241
4833,0.002685,172.217.194.0-255,1484,112469,92,242241
4834,0.005315,172.217.194.0-255,4320,116789,92,242241
4835,0.00532,172.31.47.0-255,66,116855,92,242241
4836,0.007952,172.217.194.0-255,5738,122593,92,242241
4837,0.007959,172.31.47.0-255,66,122659,92,242241
4838,0.01059,172.217.194.0-255,5738,128397,92,242241
4839,0.010598,172.31.47.0-255,66,128463,92,242241
4840,0.013229,172.217.194.0-255,5738,134201,92,242241
4841,0.013239,172.31.47.0-255,66,134267,92,242241
4842,0.015895,172.217.194.0-255,5738,140005,92,242241
4843,0.015904,172.31.47.0-255,66,140071,92,242241
4844,0.018519,172.217.194.0-255,5738,145809,92,242241
4845,0.018526,172.31.47.0-255,66,145875,92,242241
4846,0.021155,172.217.194.0-255,5738,151613,92,242241
4847,0.021161,172.31.47.0-255,66,151679,92,242241
4848,0.023816,172.217.194.0-255,5738,157417,92,242241
4849,0.023825,172.31.47.0-255,66,157483,92,242241
4850,0.026458,172.217.194.0-255,4320,161803,92,242241
4851,0.026465,172.31.47.0-255,66,161869,92,242241
4852,0.026497,172.217.194.0-255,1484,163353,92,242241
4853,0.027061,172.31.47.0-255,172,163525,92,242241
4854,0.02709,172.31.47.0-255,1112,164637,92,242241
4855,0.027135,172.31.47.0-255,1514,166151,92,242241
4856,0.027137,172.31.47.0-255,1514,167665,92,242241
4857,0.027139,172.31.47.0-255,1514,169179,92,242241
4858,0.02714,172.31.47.0-255,1514,170693,92,242241
4859,0.027141,172.31.47.0-255,1494,172187,92,242241
4860,0.028639,104.244.42.0-255,66,172253,92,242241
4861,0.028677,104.244.42.0-255,66,172319,92,242241
4862,0.02874,104.244.42.0-255,66,172385,92,242241
4863,0.029103,172.217.194.0-255,4320,176705,92,242241
4864,0.029106,172.31.47.0-255,66,176771,92,242241
4865,0.029774,104.244.42.0-255,108,176879,92,242241
4866,0.029778,172.31.47.0-255,66,176945,92,242241
4867,0.031703,172.217.194.0-255,2902,179847,92,242241
4868,0.031708,172.31.47.0-255,66,179913,92,242241
4869,0.031735,172.217.194.0-255,2902,182815,92,242241
4870,0.031737,172.31.47.0-255,66,182881,92,242241
4871,0.034355,172.217.194.0-255,2902,185783,92,242241
4872,0.03436,172.31.47.0-255,66,185849,92,242241
4873,0.034378,172.217.194.0-255,2902,188751,92,242241
4874,0.03438,172.31.47.0-255,66,188817,92,242241
4875,0.03698,172.217.194.0-255,2902,191719,92,242241
4876,0.036986,172.31.47.0-255,66,191785,92,242241
4877,0.03702,172.217.194.0-255,2902,194687,92,242241
4878,0.037025,172.31.47.0-255,66,194753,92,242241
4879,0.039591,172.217.194.0-255,2902,197655,92,242241
4880,0.039596,172.31.47.0-255,66,197721,92,242241
4881,0.039646,172.217.194.0-255,2902,200623,92,242241
4882,0.03965,172.31.47.0-255,66,200689,92,242241
4883,0.042192,172.217.194.0-255,2902,203591,92,242241
4884,0.042197,172.31.47.0-255,66,203657,92,242241
4885,0.042254,172.217.194.0-255,2902,206559,92,242241
4886,0.042258,172.31.47.0-255,66,206625,92,242241
4887,0.04482,172.217.194.0-255,2902,209527,92,242241
4888,0.044826,172.31.47.0-255,66,209593,92,242241
4889,0.044857,172.217.194.0-255,2902,212495,92,242241
4890,0.044859,172.31.47.0-255,66,212561,92,242241
4891,0.047459,172.217.194.0-255,2902,215463,92,242241
4892,0.047465,172.31.47.0-255,66,215529,92,242241
4893,0.047496,172.217.194.0-255,2902,218431,92,242241
4894,0.0475,172.31.47.0-255,66,218497,92,242241
4895,0.050071,172.217.194.0-255,2902,221399,92,242241
4896,0.050075,172.31.47.0-255,66,221465,92,242241
4897,0.050147,172.217.194.0-255,2902,224367,92,242241
4898,0.050151,172.31.47.0-255,66,224433,92,242241
4899,0.052686,172.217.194.0-255,2902,227335,92,242241
4900,0.052691,172.31.47.0-255,66,227401,92,242241
4901,0.052766,172.217.194.0-255,2902,230303,92,242241
4902,0.052769,172.31.47.0-255,66,230369,92,242241
4903,0.055309,172.217.194.0-255,2902,233271,92,242241
4904,0.055313,172.31.47.0-255,66,233337,92,242241
4905,0.055378,172.217.194.0-255,2902,236239,92,242241
4906,0.055382,172.31.47.0-255,66,236305,92,242241
4907,0.057971,172.217.194.0-255,2902,239207,92,242241
4908,0.057977,172.31.47.0-255,66,239273,92,242241
4909,0.058027,172.217.194.0-255,2902,242175,92,242241
4910,0.058031,172.31.47.0-255,66,242241,92,242241
4911,0.0,172.217.194.0-255,153,153,92,170965
4912,4.3e-05,172.31.47.0-255,66,219,92,170965
4913,5e-05,172.217.194.0-255,1484,1703,92,170965
4914,5.3e-05,172.31.47.0-255,66,1769,92,170965
4915,8.7e-05,172.217.194.0-255,2902,4671,92,170965
4916,9e-05,172.31.47.0-255,66,4737,92,170965
4917,9.6e-05,172.217.194.0-255,4320,9057,92,170965
4918,0.0001,172.31.47.0-255,66,9123,92,170965
4919,0.000108,172.217.194.0-255,4945,14068,92,170965
4920,0.000109,172.31.47.0-255,66,14134,92,170965
4921,0.000119,172.31.47.0-255,66,14200,92,170965
4922,0.000132,172.31.47.0-255,66,14266,92,170965
4923,0.000164,172.31.47.0-255,66,14332,92,170965
4924,0.000194,172.217.194.0-255,5020,19352,92,170965
4925,0.000198,172.31.47.0-255,66,19418,92,170965
4926,0.000255,172.217.194.0-255,1484,20902,92,170965
4927,0.000258,172.31.47.0-255,66,20968,92,170965
4928,0.000262,172.217.194.0-255,2902,23870,92,170965
4929,0.000264,172.31.47.0-255,66,23936,92,170965
4930,0.000268,172.217.194.0-255,2902,26838,92,170965
4931,0.000275,172.31.47.0-255,66,26904,92,170965
4932,0.000303,172.217.194.0-255,1484,28388,92,170965
4933,0.000309,172.31.47.0-255,66,28454,92,170965
4934,0.000315,172.217.194.0-255,5738,34192,92,170965
4935,0.000317,172.31.47.0-255,66,34258,92,170965
4936,0.000322,172.217.194.0-255,3123,37381,92,170965
4937,0.000323,172.31.47.0-255,66,37447,92,170965
4938,0.000352,172.217.194.0-255,4320,41767,92,170965
4939,0.000359,172.31.47.0-255,66,41833,92,170965
4940,0.000364,172.217.194.0-255,4320,46153,92,170965
4941,0.000366,172.31.47.0-255,66,46219,92,170965
4942,0.000394,172.217.194.0-255,5738,51957,92,170965
4943,0.000397,172.31.47.0-255,66,52023,92,170965
4944,0.000407,172.217.194.0-255,5738,57761,92,170965
4945,0.000409,172.31.47.0-255,66,57827,92,170965
4946,0.000437,172.217.194.0-255,2902,60729,92,170965
4947,0.000445,172.31.47.0-255,66,60795,92,170965
4948,0.000492,172.31.47.0-255,66,60861,92,170965
4949,0.000535,172.217.194.0-255,1484,62345,92,170965
4950,0.000555,172.217.194.0-255,2902,65247,92,170965
4951,0.000568,172.31.47.0-255,66,65313,92,170965
4952,0.000597,172.217.194.0-255,5738,71051,92,170965
4953,0.000605,172.31.47.0-255,66,71117,92,170965
4954,0.000653,172.31.47.0-255,66,71183,92,170965
4955,0.000677,172.217.194.0-255,2902,74085,92,170965
4956,0.00068,172.31.47.0-255,66,74151,92,170965
4957,0.000684,172.217.194.0-255,1484,75635,92,170965
4958,0.000713,172.31.47.0-255,66,75701,92,170965
4959,0.000845,172.217.194.0-255,1484,77185,92,170965
4960,0.000851,172.217.194.0-255,2902,80087,92,170965
4961,0.000854,172.31.47.0-255,66,80153,92,170965
4962,0.000857,172.217.194.0-255,1484,81637,92,170965
4963,0.000883,172.217.194.0-255,4320,85957,92,170965
4964,0.000891,172.31.47.0-255,66,86023,92,170965
4965,0.000896,172.31.47.0-255,66,86089,92,170965
4966,0.00092,172.217.194.0-255,4320,90409,92,170965
4967,0.000934,172.31.47.0-255,66,90475,92,170965
4968,0.000948,172.217.194.0-255,2902,93377,92,170965
4969,0.000958,172.31.47.0-255,66,93443,92,170965
4970,0.000987,172.31.47.0-255,66,93509,92,170965
4971,0.001079,172.217.194.0-255,1484,94993,92,170965
4972,0.001093,172.217.194.0-255,2902,97895,92,170965
4973,0.001097,172.31.47.0-255,66,97961,92,170965
4974,0.001125,172.217.194.0-255,2902,100863,92,170965
4975,0.001132,172.31.47.0-255,66,100929,92,170965
4976,0.00114,172.217.194.0-255,2902,103831,92,170965
4977,0.001148,172.31.47.0-255,66,103897,92,170965
4978,0.00115,172.217.194.0-255,5738,109635,92,170965
4979,0.001163,172.31.47.0-255,66,109701,92,170965
4980,0.001173,172.217.194.0-255,4320,114021,92,170965
4981,0.001184,172.31.47.0-255,66,114087,92,170965
4982,0.001197,172.217.194.0-255,5738,119825,92,170965
4983,0.001207,172.31.47.0-255,66,119891,92,170965
4984,0.001215,172.217.194.0-255,2902,122793,92,170965
4985,0.001223,172.31.47.0-255,66,122859,92,170965
4986,0.001242,172.217.194.0-255,5020,127879,92,170965
4987,0.001245,172.31.47.0-255,66,127945,92,170965
4988,0.001249,172.217.194.0-255,2902,130847,92,170965
4989,0.001261,172.31.47.0-255,66,130913,92,170965
4990,0.001307,172.31.47.0-255,66,130979,92,170965
4991,0.001351,172.217.194.0-255,5738,136717,92,170965
4992,0.00137,172.31.47.0-255,66,136783,92,170965
4993,0.001372,172.217.194.0-255,7156,143939,92,170965
4994,0.001376,172.31.47.0-255,66,144005,92,170965
4995,0.001425,172.31.47.0-255,66,144071,92,170965
4996,0.001453,172.31.47.0-255,66,144137,92,170965
4997,0.001521,172.31.47.0-255,66,144203,92,170965
4998,0.001537,172.217.194.0-255,5020,149223,92,170965
4999,0.001548,172.31.47.0-255,66,149289,92,170965
5000,0.0016,172.31.47.0-255,66,149355,92,170965
5001,0.00161,172.217.194.0-255,5738,155093,92,170965
5002,0.001617,172.31.47.0-255,66,155159,92,170965
5003,0.001661,172.217.194.0-255,5738,160897,92,170965
5004,0.001668,172.31.47.0-255,66,160963,92,170965
5005,0.001711,172.31.47.0-255,66,161029,92,170965
5006,0.001803,172.31.47.0-255,66,161095,92,170965
5007,0.001953,172.31.47.0-255,66,161161,92,170965
5008,0.001988,172.31.47.0-255,66,161227,92,170965
5009,0.002096,172.217.194.0-255,5738,166965,92,170965
5010,0.00211,172.31.47.0-255,66,167031,92,170965
5011,0.002173,172.31.47.0-255,66,167097,92,170965
5012,0.002342,172.217.194.0-255,3631,170728,92,170965
5013,0.002349,172.31.47.0-255,66,170794,92,170965
5014,0.003895,172.31.47.0-255,105,170899,92,170965
5015,0.006135,172.217.194.0-255,66,170965,92,170965
5016,0.0,172.217.194.0-255,153,153,92,304252
5017,2.4e-05,172.31.47.0-255,66,219,92,304252
5018,3e-05,172.217.194.0-255,1484,1703,92,304252
5019,3.4e-05,172.31.47.0-255,66,1769,92,304252
5020,3.8e-05,172.217.194.0-255,2902,4671,92,304252
5021,4e-05,172.31.47.0-255,66,4737,92,304252
5022,5.3e-05,172.217.194.0-255,7156,11893,92,304252
5023,5.6e-05,172.31.47.0-255,66,11959,92,304252
5024,6e-05,172.217.194.0-255,2065,14024,92,304252
5025,6.2e-05,172.31.47.0-255,66,14090,92,304252
5026,9.1e-05,172.217.194.0-255,1484,15574,92,304252
5027,9.4e-05,172.31.47.0-255,66,15640,92,304252
5028,0.000124,172.217.194.0-255,1484,17124,92,304252
5029,0.000127,172.31.47.0-255,66,17190,92,304252
5030,0.000134,172.217.194.0-255,7156,24346,92,304252
5031,0.000136,172.31.47.0-255,66,24412,92,304252
5032,0.000145,172.217.194.0-255,1484,25896,92,304252
5033,0.000147,172.31.47.0-255,66,25962,92,304252
5034,0.000178,172.217.194.0-255,2902,28864,92,304252
5035,0.000182,172.31.47.0-255,66,28930,92,304252
5036,0.000206,172.217.194.0-255,2543,31473,92,304252
5037,0.000209,172.31.47.0-255,66,31539,92,304252
5038,0.000212,172.217.194.0-255,1484,33023,92,304252
5039,0.000214,172.31.47.0-255,66,33089,92,304252
5040,0.000234,172.217.194.0-255,1484,34573,92,304252
5041,0.000238,172.31.47.0-255,66,34639,92,304252
5042,0.000269,172.217.194.0-255,1484,36123,92,304252
5043,0.000273,172.31.47.0-255,66,36189,92,304252
5044,0.000279,172.217.194.0-255,5738,41927,92,304252
5045,0.000283,172.31.47.0-255,66,41993,92,304252
5046,0.000302,172.31.47.0-255,66,42059,92,304252
5047,0.000315,172.31.47.0-255,66,42125,92,304252
5048,0.000319,172.217.194.0-255,3961,46086,92,304252
5049,0.000322,172.31.47.0-255,66,46152,92,304252
5050,0.00035,172.217.194.0-255,677,46829,92,304252
5051,0.000598,172.217.194.0-255,1484,48313,92,304252
5052,0.000602,172.31.47.0-255,66,48379,92,304252
5053,0.000607,172.217.194.0-255,2902,51281,92,304252
5054,0.00061,172.31.47.0-255,66,51347,92,304252
5055,0.000641,172.217.194.0-255,5738,57085,92,304252
5056,0.000645,172.31.47.0-255,66,57151,92,304252
5057,0.000648,172.217.194.0-255,1484,58635,92,304252
5058,0.000654,172.217.194.0-255,5738,64373,92,304252
5059,0.000663,172.31.47.0-255,66,64439,92,304252
5060,0.000681,172.217.194.0-255,2902,67341,92,304252
5061,0.000684,172.31.47.0-255,66,67407,92,304252
5062,0.000689,172.217.194.0-255,4320,71727,92,304252
5063,0.000691,172.31.47.0-255,66,71793,92,304252
5064,0.000725,172.31.47.0-255,66,71859,92,304252
5065,0.001069,172.217.194.0-255,1484,73343,92,304252
5066,0.001076,172.217.194.0-255,2902,76245,92,304252
5067,0.001079,172.31.47.0-255,66,76311,92,304252
5068,0.001085,172.217.194.0-255,4320,80631,92,304252
5069,0.001087,172.31.47.0-255,66,80697,92,304252
5070,0.001107,172.217.194.0-255,1484,82181,92,304252
5071,0.001124,172.31.47.0-255,66,82247,92,304252
5072,0.00115,172.217.194.0-255,7156,89403,92,304252
5073,0.001153,172.31.47.0-255,66,89469,92,304252
5074,0.001171,172.217.194.0-255,3602,93071,92,304252
5075,0.001173,172.31.47.0-255,66,93137,92,304252
5076,0.001286,172.217.194.0-255,1484,94621,92,304252
5077,0.001306,172.217.194.0-255,2902,97523,92,304252
5078,0.001309,172.31.47.0-255,66,97589,92,304252
5079,0.001313,172.217.194.0-255,2902,100491,92,304252
5080,0.001315,172.31.47.0-255,66,100557,92,304252
5081,0.001341,172.217.194.0-255,2902,103459,92,304252
5082,0.001343,172.31.47.0-255,66,103525,92,304252
5083,0.001358,172.31.47.0-255,66,103591,92,304252
5084,0.001363,172.217.194.0-255,4320,107911,92,304252
5085,0.001365,172.31.47.0-255,66,107977,92,304252
5086,0.001386,172.217.194.0-255,6438,114415,92,304252
5087,0.001393,172.31.47.0-255,66,114481,92,304252
5088,0.001413,172.217.194.0-255,1484,115965,92,304252
5089,0.001417,172.217.194.0-255,2902,118867,92,304252
5090,0.001419,172.31.47.0-255,66,118933,92,304252
5091,0.00145,172.217.194.0-255,5738,124671,92,304252
5092,0.001453,172.31.47.0-255,66,124737,92,304252
5093,0.001461,172.217.194.0-255,7156,131893,92,304252
5094,0.001462,172.31.47.0-255,66,131959,92,304252
5095,0.001481,172.217.194.0-255,2902,134861,92,304252
5096,0.001487,172.31.47.0-255,66,134927,92,304252
5097,0.001525,172.31.47.0-255,66,134993,92,304252
5098,0.001528,172.217.194.0-255,2184,137177,92,304252
5099,0.00153,172.31.47.0-255,66,137243,92,304252
5100,0.001547,172.217.194.0-255,2902,140145,92,304252
5101,0.001548,172.31.47.0-255,66,140211,92,304252
5102,0.001584,172.31.47.0-255,66,140277,92,304252
5103,0.001638,172.31.47.0-255,66,140343,92,304252
5104,0.001641,172.217.194.0-255,2184,142527,92,304252
5105,0.001643,172.31.47.0-255,66,142593,92,304252
5106,0.001662,172.217.194.0-255,1484,144077,92,304252
5107,0.001684,172.217.194.0-255,2902,146979,92,304252
5108,0.001686,172.31.47.0-255,66,147045,92,304252
5109,0.001691,172.217.194.0-255,5738,152783,92,304252
5110,0.001692,172.31.47.0-255,66,152849,92,304252
5111,0.001714,172.217.194.0-255,5738,158587,92,304252
5112,0.001717,172.31.47.0-255,66,158653,92,304252
5113,0.001741,172.217.194.0-255,7156,165809,92,304252
5114,0.001743,172.31.47.0-255,66,165875,92,304252
5115,0.001754,172.217.194.0-255,1484,167359,92,304252
5116,0.001776,172.217.194.0-255,5738,173097,92,304252
5117,0.001778,172.31.47.0-255,66,173163,92,304252
5118,0.001798,172.217.194.0-255,6438,179601,92,304252
5119,0.0018,172.31.47.0-255,66,179667,92,304252
5120,0.001804,172.217.194.0-255,4320,183987,92,304252
5121,0.001806,172.31.47.0-255,66,184053,92,304252
5122,0.00184,172.31.47.0-255,66,184119,92,304252
5123,0.001871,172.31.47.0-255,66,184185,92,304252
5124,0.001893,172.217.194.0-255,3602,187787,92,304252
5125,0.001895,172.31.47.0-255,66,187853,92,304252
5126,0.00192,172.217.194.0-255,1484,189337,92,304252
5127,0.00193,172.217.194.0-255,2902,192239,92,304252
5128,0.001932,172.31.47.0-255,66,192305,92,304252
5129,0.001954,172.217.194.0-255,5738,198043,92,304252
5130,0.001993,172.217.194.0-255,1484,199527,92,304252
5131,0.001995,172.217.194.0-255,1484,201011,92,304252
5132,0.002019,172.217.194.0-255,2902,203913,92,304252
5133,0.002033,172.217.194.0-255,6438,210351,92,304252
5134,0.004362,172.31.47.0-255,66,210417,92,304252
5135,0.006383,172.217.194.0-255,5738,216155,92,304252
5136,0.006388,172.31.47.0-255,66,216221,92,304252
5137,0.008406,172.217.194.0-255,5738,221959,92,304252
5138,0.008413,172.31.47.0-255,66,222025,92,304252
5139,0.010466,172.217.194.0-255,5738,227763,92,304252
5140,0.010473,172.31.47.0-255,66,227829,92,304252
5141,0.01249,172.217.194.0-255,5738,233567,92,304252
5142,0.012504,172.31.47.0-255,66,233633,92,304252
5143,0.014525,172.217.194.0-255,5738,239371,92,304252
5144,0.014535,172.31.47.0-255,66,239437,92,304252
5145,0.016537,172.217.194.0-255,5738,245175,92,304252
5146,0.016545,172.31.47.0-255,66,245241,92,304252
5147,0.018563,172.217.194.0-255,5738,250979,92,304252
5148,0.018572,172.31.47.0-255,66,251045,92,304252
5149,0.02059,172.217.194.0-255,5738,256783,92,304252
5150,0.020595,172.31.47.0-255,66,256849,92,304252
5151,0.022605,172.217.194.0-255,5738,262587,92,304252
5152,0.022611,172.31.47.0-255,66,262653,92,304252
5153,0.024632,172.217.194.0-255,5738,268391,92,304252
5154,0.024639,172.31.47.0-255,66,268457,92,304252
5155,0.026674,172.217.194.0-255,5738,274195,92,304252
5156,0.026681,172.31.47.0-255,66,274261,92,304252
5157,0.028806,172.217.194.0-255,5738,279999,92,304252
5158,0.028811,172.31.47.0-255,66,280065,92,304252
5159,0.030709,172.31.47.0-255,172,280237,92,304252
5160,0.030742,172.31.47.0-255,1107,281344,92,304252
5161,0.030775,172.31.47.0-255,574,281918,92,304252
5162,0.030852,172.217.194.0-255,5738,287656,92,304252
5163,0.030858,172.31.47.0-255,66,287722,92,304252
5164,0.032277,104.244.42.0-255,66,287788,92,304252
5165,0.032284,104.244.42.0-255,66,287854,92,304252
5166,0.032322,104.244.42.0-255,66,287920,92,304252
5167,0.032882,172.217.194.0-255,5738,293658,92,304252
5168,0.032887,172.31.47.0-255,66,293724,92,304252
5169,0.034897,172.217.194.0-255,5738,299462,92,304252
5170,0.034902,172.31.47.0-255,66,299528,92,304252
5171,0.036916,172.217.194.0-255,4487,304015,92,304252
5172,0.036921,172.31.47.0-255,66,304081,92,304252
5173,0.037093,172.31.47.0-255,105,304186,92,304252
5174,0.039068,172.217.194.0-255,66,304252,92,304252
5175,0.0,74.125.24.0-255,153,153,92,238380
5176,2.4e-05,172.31.47.0-255,66,219,92,238380
5177,3e-05,74.125.24.0-255,1484,1703,92,238380
5178,3.3e-05,172.31.47.0-255,66,1769,92,238380
5179,3.7e-05,74.125.24.0-255,2902,4671,92,238380
5180,4e-05,172.31.47.0-255,66,4737,92,238380
5181,5.2e-05,74.125.24.0-255,7156,11893,92,238380
5182,5.5e-05,172.31.47.0-255,66,11959,92,238380
5183,8.6e-05,74.125.24.0-255,2136,14095,92,238380
5184,8.8e-05,172.31.47.0-255,66,14161,92,238380
5185,0.000146,74.125.24.0-255,1484,15645,92,238380
5186,0.00015,172.31.47.0-255,66,15711,92,238380
5187,0.000154,74.125.24.0-255,2902,18613,92,238380
5188,0.000157,172.31.47.0-255,66,18679,92,238380
5189,0.00018,74.125.24.0-255,5738,24417,92,238380
5190,0.000183,172.31.47.0-255,66,24483,92,238380
5191,0.000217,74.125.24.0-255,2902,27385,92,238380
5192,0.000219,172.31.47.0-255,66,27451,92,238380
5193,0.000246,74.125.24.0-255,3961,31412,92,238380
5194,0.000249,172.31.47.0-255,66,31478,92,238380
5195,0.000394,74.125.24.0-255,1484,32962,92,238380
5196,0.000398,172.31.47.0-255,66,33028,92,238380
5197,0.000415,74.125.24.0-255,2902,35930,92,238380
5198,0.000418,172.31.47.0-255,66,35996,92,238380
5199,0.000423,74.125.24.0-255,5738,41734,92,238380
5200,0.000425,172.31.47.0-255,66,41800,92,238380
5201,0.00043,74.125.24.0-255,4320,46120,92,238380
5202,0.000432,172.31.47.0-255,66,46186,92,238380
5203,0.000456,74.125.24.0-255,2543,48729,92,238380
5204,0.000463,172.31.47.0-255,66,48795,92,238380
5205,0.000748,74.125.24.0-255,1484,50279,92,238380
5206,0.000753,172.31.47.0-255,66,50345,92,238380
5207,0.000763,74.125.24.0-255,2902,53247,92,238380
5208,0.000772,172.31.47.0-255,66,53313,92,238380
5209,0.000778,74.125.24.0-255,2902,56215,92,238380
5210,0.000781,172.31.47.0-255,66,56281,92,238380
5211,0.000801,74.125.24.0-255,2902,59183,92,238380
5212,0.000804,172.31.47.0-255,66,59249,92,238380
5213,0.000818,74.125.24.0-255,7147,66396,92,238380
5214,0.00082,172.31.47.0-255,66,66462,92,238380
5215,0.001084,74.125.24.0-255,329,66791,92,238380
5216,0.001115,172.31.47.0-255,66,66857,92,238380
5217,0.0013,74.125.24.0-255,1484,68341,92,238380
5218,0.001319,74.125.24.0-255,2902,71243,92,238380
5219,0.001324,172.31.47.0-255,66,71309,92,238380
5220,0.00133,74.125.24.0-255,5738,77047,92,238380
5221,0.001332,172.31.47.0-255,66,77113,92,238380
5222,0.001389,74.125.24.0-255,5738,82851,92,238380
5223,0.001392,172.31.47.0-255,66,82917,92,238380
5224,0.001416,74.125.24.0-255,1125,84042,92,238380
5225,0.001453,74.125.24.0-255,1484,85526,92,238380
5226,0.001456,172.31.47.0-255,66,85592,92,238380
5227,0.00146,74.125.24.0-255,1484,87076,92,238380
5228,0.001483,74.125.24.0-255,1484,88560,92,238380
5229,0.001486,172.31.47.0-255,66,88626,92,238380
5230,0.001492,74.125.24.0-255,5738,94364,92,238380
5231,0.001494,172.31.47.0-255,66,94430,92,238380
5232,0.001498,74.125.24.0-255,2902,97332,92,238380
5233,0.001504,172.31.47.0-255,66,97398,92,238380
5234,0.001535,74.125.24.0-255,3961,101359,92,238380
5235,0.001539,172.31.47.0-255,66,101425,92,238380
5236,0.002524,74.125.24.0-255,1484,102909,92,238380
5237,0.002531,74.125.24.0-255,2902,105811,92,238380
5238,0.002534,172.31.47.0-255,66,105877,92,238380
5239,0.00254,74.125.24.0-255,5738,111615,92,238380
5240,0.002542,172.31.47.0-255,66,111681,92,238380
5241,0.002571,74.125.24.0-255,2902,114583,92,238380
5242,0.002573,172.31.47.0-255,66,114649,92,238380
5243,0.002609,172.31.47.0-255,66,114715,92,238380
5244,0.002614,74.125.24.0-255,3602,118317,92,238380
5245,0.002615,172.31.47.0-255,66,118383,92,238380
5246,0.004814,74.125.24.0-255,1484,119867,92,238380
5247,0.004823,74.125.24.0-255,2902,122769,92,238380
5248,0.004826,172.31.47.0-255,66,122835,92,238380
5249,0.004834,74.125.24.0-255,5738,128573,92,238380
5250,0.004835,172.31.47.0-255,66,128639,92,238380
5251,0.004881,172.31.47.0-255,66,128705,92,238380
5252,0.004898,172.31.47.0-255,66,128771,92,238380
5253,0.005049,74.125.24.0-255,1484,130255,92,238380
5254,0.005075,74.125.24.0-255,2902,133157,92,238380
5255,0.005078,172.31.47.0-255,66,133223,92,238380
5256,0.005084,74.125.24.0-255,5738,138961,92,238380
5257,0.005087,172.31.47.0-255,66,139027,92,238380
5258,0.005111,172.31.47.0-255,66,139093,92,238380
5259,0.005141,74.125.24.0-255,2902,141995,92,238380
5260,0.005144,172.31.47.0-255,66,142061,92,238380
5261,0.005148,74.125.24.0-255,2902,144963,92,238380
5262,0.005151,172.31.47.0-255,66,145029,92,238380
5263,0.005154,74.125.24.0-255,1484,146513,92,238380
5264,0.00516,74.125.24.0-255,1484,147997,92,238380
5265,0.005162,172.31.47.0-255,66,148063,92,238380
5266,0.005185,74.125.24.0-255,2902,150965,92,238380
5267,0.005187,172.31.47.0-255,66,151031,92,238380
5268,0.005211,74.125.24.0-255,2184,153215,92,238380
5269,0.005213,172.31.47.0-255,66,153281,92,238380
5270,0.00525,74.125.24.0-255,1484,154765,92,238380
5271,0.005255,74.125.24.0-255,2902,157667,92,238380
5272,0.005257,172.31.47.0-255,66,157733,92,238380
5273,0.005263,74.125.24.0-255,4320,162053,92,238380
5274,0.005265,172.31.47.0-255,66,162119,92,238380
5275,0.00529,74.125.24.0-255,1484,163603,92,238380
5276,0.005295,74.125.24.0-255,4320,167923,92,238380
5277,0.0053,74.125.24.0-255,7156,175079,92,238380
5278,0.005309,172.31.47.0-255,66,175145,92,238380
5279,0.005311,172.31.47.0-255,66,175211,92,238380
5280,0.005316,74.125.24.0-255,4320,179531,92,238380
5281,0.005319,172.31.47.0-255,66,179597,92,238380
5282,0.005365,172.31.47.0-255,66,179663,92,238380
5283,0.005421,74.125.24.0-255,1484,181147,92,238380
5284,0.005428,74.125.24.0-255,2902,184049,92,238380
5285,0.005432,172.31.47.0-255,66,184115,92,238380
5286,0.005438,74.125.24.0-255,5738,189853,92,238380
5287,0.00544,172.31.47.0-255,66,189919,92,238380
5288,0.005511,172.31.47.0-255,66,189985,92,238380
5289,0.005528,172.31.47.0-255,66,190051,92,238380
5290,0.005617,74.125.24.0-255,1484,191535,92,238380
5291,0.005623,74.125.24.0-255,2902,194437,92,238380
5292,0.005626,172.31.47.0-255,66,194503,92,238380
5293,0.005633,74.125.24.0-255,5738,200241,92,238380
5294,0.005636,172.31.47.0-255,66,200307,92,238380
5295,0.005656,74.125.24.0-255,5738,206045,92,238380
5296,0.00566,172.31.47.0-255,66,206111,92,238380
5297,0.005685,74.125.24.0-255,7156,213267,92,238380
5298,0.005704,74.125.24.0-255,5738,219005,92,238380
5299,0.00571,172.31.47.0-255,66,219071,92,238380
5300,0.005718,172.31.47.0-255,66,219137,92,238380
5301,0.005721,172.31.47.0-255,66,219203,92,238380
5302,0.005733,74.125.24.0-255,5738,224941,92,238380
5303,0.005736,172.31.47.0-255,66,225007,92,238380
5304,0.005786,172.31.47.0-255,66,225073,92,238380
5305,0.005832,172.31.47.0-255,66,225139,92,238380
5306,0.005848,172.31.47.0-255,66,225205,92,238380
5307,0.005858,172.31.47.0-255,66,225271,92,238380
5308,0.00588,172.31.47.0-255,66,225337,92,238380
5309,0.005916,74.125.24.0-255,3602,228939,92,238380
5310,0.005977,74.125.24.0-255,105,229044,92,238380
5311,0.005982,172.31.47.0-255,66,229110,92,238380
5312,0.008342,172.31.47.0-255,66,229176,92,238380
5313,0.008409,172.31.47.0-255,105,229281,92,238380
5314,0.010903,74.125.24.0-255,66,229347,92,238380
5315,0.043053,172.31.47.0-255,172,229519,92,238380
5316,0.043092,172.31.47.0-255,1103,230622,92,238380
5317,0.043178,172.31.47.0-255,1514,232136,92,238380
5318,0.04318,172.31.47.0-255,1514,233650,92,238380
5319,0.043181,172.31.47.0-255,1514,235164,92,238380
5320,0.043182,172.31.47.0-255,1514,236678,92,238380
5321,0.043183,172.31.47.0-255,1504,238182,92,238380
5322,0.044623,104.244.42.0-255,66,238248,92,238380
5323,0.044666,104.244.42.0-255,66,238314,92,238380
5324,0.044809,104.244.42.0-255,66,238380,92,238380
5325,0.0,74.125.24.0-255,153,153,92,229636
5326,2.8e-05,172.31.47.0-255,66,219,92,229636
5327,3.5e-05,74.125.24.0-255,1484,1703,92,229636
5328,4.1e-05,172.31.47.0-255,66,1769,92,229636
5329,5.3e-05,74.125.24.0-255,2902,4671,92,229636
5330,5.7e-05,172.31.47.0-255,66,4737,92,229636
5331,6.5e-05,74.125.24.0-255,7156,11893,92,229636
5332,6.8e-05,172.31.47.0-255,66,11959,92,229636
5333,7.1e-05,74.125.24.0-255,1484,13443,92,229636
5334,7.4e-05,172.31.47.0-255,66,13509,92,229636
5335,0.000123,172.31.47.0-255,66,13575,92,229636
5336,0.000127,74.125.24.0-255,2543,16118,92,229636
5337,0.000129,172.31.47.0-255,66,16184,92,229636
5338,0.000202,74.125.24.0-255,1484,17668,92,229636
5339,0.000205,172.31.47.0-255,66,17734,92,229636
5340,0.00021,74.125.24.0-255,2902,20636,92,229636
5341,0.000213,172.31.47.0-255,66,20702,92,229636
5342,0.000239,74.125.24.0-255,2902,23604,92,229636
5343,0.000241,172.31.47.0-255,66,23670,92,229636
5344,0.000246,74.125.24.0-255,4320,27990,92,229636
5345,0.000249,172.31.47.0-255,66,28056,92,229636
5346,0.000307,74.125.24.0-255,4320,32376,92,229636
5347,0.000311,172.31.47.0-255,66,32442,92,229636
5348,0.000328,74.125.24.0-255,1125,33567,92,229636
5349,0.000331,172.31.47.0-255,66,33633,92,229636
5350,0.000359,74.125.24.0-255,1484,35117,92,229636
5351,0.000364,172.31.47.0-255,66,35183,92,229636
5352,0.000371,74.125.24.0-255,2902,38085,92,229636
5353,0.000373,172.31.47.0-255,66,38151,92,229636
5354,0.000382,74.125.24.0-255,1484,39635,92,229636
5355,0.000385,172.31.47.0-255,66,39701,92,229636
5356,0.000416,74.125.24.0-255,4320,44021,92,229636
5357,0.00042,172.31.47.0-255,66,44087,92,229636
5358,0.000432,74.125.24.0-255,2902,46989,92,229636
5359,0.000439,172.31.47.0-255,66,47055,92,229636
5360,0.000465,74.125.24.0-255,4258,51313,92,229636
5361,0.000467,74.125.24.0-255,381,51694,92,229636
5362,0.00047,172.31.47.0-255,66,51760,92,229636
5363,0.000531,74.125.24.0-255,1484,53244,92,229636
5364,0.000535,172.31.47.0-255,66,53310,92,229636
5365,0.00054,74.125.24.0-255,2902,56212,92,229636
5366,0.000543,172.31.47.0-255,66,56278,92,229636
5367,0.000576,74.125.24.0-255,5738,62016,92,229636
5368,0.00058,172.31.47.0-255,66,62082,92,229636
5369,0.000618,74.125.24.0-255,4320,66402,92,229636
5370,0.000621,172.31.47.0-255,66,66468,92,229636
5371,0.000646,74.125.24.0-255,1993,68461,92,229636
5372,0.000649,172.31.47.0-255,66,68527,92,229636
5373,0.000708,74.125.24.0-255,1484,70011,92,229636
5374,0.000712,74.125.24.0-255,1484,71495,92,229636
5375,0.000715,172.31.47.0-255,66,71561,92,229636
5376,0.00074,74.125.24.0-255,1484,73045,92,229636
5377,0.000749,74.125.24.0-255,5738,78783,92,229636
5378,0.000751,172.31.47.0-255,66,78849,92,229636
5379,0.000757,74.125.24.0-255,4320,83169,92,229636
5380,0.000759,172.31.47.0-255,66,83235,92,229636
5381,0.000788,74.125.24.0-255,7156,90391,92,229636
5382,0.000791,172.31.47.0-255,66,90457,92,229636
5383,0.00082,74.125.24.0-255,4320,94777,92,229636
5384,0.000824,172.31.47.0-255,66,94843,92,229636
5385,0.00083,74.125.24.0-255,7156,101999,92,229636
5386,0.000833,172.31.47.0-255,66,102065,92,229636
5387,0.00087,172.31.47.0-255,66,102131,92,229636
5388,0.000897,74.125.24.0-255,6438,108569,92,229636
5389,0.000901,172.31.47.0-255,66,108635,92,229636
5390,0.000905,74.125.24.0-255,2543,111178,92,229636
5391,0.000908,172.31.47.0-255,66,111244,92,229636
5392,0.000911,74.125.24.0-255,2902,114146,92,229636
5393,0.000913,172.31.47.0-255,66,114212,92,229636
5394,0.000922,74.125.24.0-255,1484,115696,92,229636
5395,0.000946,74.125.24.0-255,5738,121434,92,229636
5396,0.000949,172.31.47.0-255,66,121500,92,229636
5397,0.000957,74.125.24.0-255,7156,128656,92,229636
5398,0.000964,172.31.47.0-255,66,128722,92,229636
5399,0.001009,74.125.24.0-255,766,129488,92,229636
5400,0.001012,172.31.47.0-255,66,129554,92,229636
5401,0.001416,74.125.24.0-255,1484,131038,92,229636
5402,0.00142,172.31.47.0-255,66,131104,92,229636
5403,0.001426,74.125.24.0-255,2902,134006,92,229636
5404,0.001429,172.31.47.0-255,66,134072,92,229636
5405,0.001454,74.125.24.0-255,2902,136974,92,229636
5406,0.001457,172.31.47.0-255,66,137040,92,229636
5407,0.001462,74.125.24.0-255,4320,141360,92,229636
5408,0.001464,172.31.47.0-255,66,141426,92,229636
5409,0.001491,74.125.24.0-255,2902,144328,92,229636
5410,0.001494,74.125.24.0-255,2902,147230,92,229636
5411,0.001495,172.31.47.0-255,66,147296,92,229636
5412,0.001498,172.31.47.0-255,66,147362,92,229636
5413,0.001512,74.125.24.0-255,5738,153100,92,229636
5414,0.001515,172.31.47.0-255,66,153166,92,229636
5415,0.001533,74.125.24.0-255,2902,156068,92,229636
5416,0.001536,172.31.47.0-255,66,156134,92,229636
5417,0.001559,172.31.47.0-255,66,156200,92,229636
5418,0.0016,74.125.24.0-255,1484,157684,92,229636
5419,0.001616,74.125.24.0-255,2902,160586,92,229636
5420,0.001618,172.31.47.0-255,66,160652,92,229636
5421,0.001622,74.125.24.0-255,1484,162136,92,229636
5422,0.001643,74.125.24.0-255,4320,166456,92,229636
5423,0.001645,172.31.47.0-255,66,166522,92,229636
5424,0.00165,74.125.24.0-255,4320,170842,92,229636
5425,0.001652,172.31.47.0-255,66,170908,92,229636
5426,0.001655,74.125.24.0-255,2902,173810,92,229636
5427,0.001657,172.31.47.0-255,66,173876,92,229636
5428,0.001687,74.125.24.0-255,2902,176778,92,229636
5429,0.00169,172.31.47.0-255,66,176844,92,229636
5430,0.0017,172.31.47.0-255,66,176910,92,229636
5431,0.001713,172.31.47.0-255,66,176976,92,229636
5432,0.001723,172.31.47.0-255,66,177042,92,229636
5433,0.001805,74.125.24.0-255,766,177808,92,229636
5434,0.001806,172.31.47.0-255,66,177874,92,229636
5435,0.001847,74.125.24.0-255,1484,179358,92,229636
5436,0.00185,172.31.47.0-255,66,179424,92,229636
5437,0.001853,74.125.24.0-255,1484,180908,92,229636
5438,0.001874,74.125.24.0-255,1484,182392,92,229636
5439,0.001877,172.31.47.0-255,66,182458,92,229636
5440,0.001883,74.125.24.0-255,5738,188196,92,229636
5441,0.001885,172.31.47.0-255,66,188262,92,229636
5442,0.001925,172.31.47.0-255,66,188328,92,229636
5443,0.001934,172.31.47.0-255,66,188394,92,229636
5444,0.00196,74.125.24.0-255,2184,190578,92,229636
5445,0.001963,172.31.47.0-255,66,190644,92,229636
5446,0.002013,74.125.24.0-255,1484,192128,92,229636
5447,0.002018,74.125.24.0-255,2902,195030,92,229636
5448,0.00202,172.31.47.0-255,66,195096,92,229636
5449,0.002047,74.125.24.0-255,5738,200834,92,229636
5450,0.00205,172.31.47.0-255,66,200900,92,229636
5451,0.002055,74.125.24.0-255,5738,206638,92,229636
5452,0.002058,172.31.47.0-255,66,206704,92,229636
5453,0.00209,74.125.24.0-255,7156,213860,92,229636
5454,0.002093,172.31.47.0-255,66,213926,92,229636
5455,0.002106,172.31.47.0-255,66,213992,92,229636
5456,0.002129,74.125.24.0-255,5738,219730,92,229636
5457,0.002134,172.31.47.0-255,66,219796,92,229636
5458,0.002175,172.31.47.0-255,66,219862,92,229636
5459,0.002188,172.31.47.0-255,66,219928,92,229636
5460,0.002217,172.31.47.0-255,66,219994,92,229636
5461,0.002246,172.31.47.0-255,66,220060,92,229636
5462,0.002284,172.31.47.0-255,66,220126,92,229636
5463,0.002318,74.125.24.0-255,105,220231,92,229636
5464,0.002318,172.31.47.0-255,66,220297,92,229636
5465,0.003331,172.31.47.0-255,66,220363,92,229636
5466,0.003358,172.31.47.0-255,105,220468,92,229636
5467,0.00557,74.125.24.0-255,66,220534,92,229636
5468,0.027774,172.31.47.0-255,176,220710,92,229636
5469,0.027802,172.31.47.0-255,1111,221821,92,229636
5470,0.027838,172.31.47.0-255,1514,223335,92,229636
5471,0.027856,172.31.47.0-255,1514,224849,92,229636
5472,0.027857,172.31.47.0-255,1514,226363,92,229636
5473,0.027878,172.31.47.0-255,1514,227877,92,229636
5474,0.027879,172.31.47.0-255,1495,229372,92,229636
5475,0.029299,104.244.42.0-255,66,229438,92,229636
5476,0.029307,104.244.42.0-255,66,229504,92,229636
5477,0.029385,104.244.42.0-255,66,229570,92,229636
5478,0.029441,104.244.42.0-255,66,229636,92,229636
5479,0.0,172.217.194.0-255,153,153,92,290805
5480,2.5e-05,172.31.47.0-255,66,219,92,290805
5481,3.1e-05,172.217.194.0-255,1484,1703,92,290805
5482,3.5e-05,172.31.47.0-255,66,1769,92,290805
5483,4e-05,172.217.194.0-255,2902,4671,92,290805
5484,4.3e-05,172.31.47.0-255,66,4737,92,290805
5485,5.5e-05,172.217.194.0-255,7156,11893,92,290805
5486,5.7e-05,172.31.47.0-255,66,11959,92,290805
5487,8.5e-05,172.217.194.0-255,5011,16970,92,290805
5488,8.8e-05,172.31.47.0-255,66,17036,92,290805
5489,9.3e-05,172.217.194.0-255,5738,22774,92,290805
5490,9.4e-05,172.31.47.0-255,66,22840,92,290805
5491,0.000122,172.217.194.0-255,5738,28578,92,290805
5492,0.000125,172.31.47.0-255,66,28644,92,290805
5493,0.00014,172.217.194.0-255,2543,31187,92,290805
5494,0.000143,172.31.47.0-255,66,31253,92,290805
5495,0.000165,172.217.194.0-255,1484,32737,92,290805
5496,0.000167,172.31.47.0-255,66,32803,92,290805
5497,0.000171,172.217.194.0-255,2902,35705,92,290805
5498,0.000173,172.31.47.0-255,66,35771,92,290805
5499,0.000198,172.217.194.0-255,4320,40091,92,290805
5500,0.000201,172.31.47.0-255,66,40157,92,290805
5501,0.000232,172.217.194.0-255,1484,41641,92,290805
5502,0.000235,172.31.47.0-255,66,41707,92,290805
5503,0.000249,172.31.47.0-255,66,41773,92,290805
5504,0.000254,172.217.194.0-255,5738,47511,92,290805
5505,0.000256,172.31.47.0-255,66,47577,92,290805
5506,0.000299,172.217.194.0-255,4251,51828,92,290805
5507,0.000302,172.31.47.0-255,66,51894,92,290805
5508,0.000462,172.217.194.0-255,98,51992,92,290805
5509,0.000467,172.31.47.0-255,66,52058,92,290805
5510,0.000495,172.217.194.0-255,1484,53542,92,290805
5511,0.0005,172.217.194.0-255,2902,56444,92,290805
5512,0.000502,172.31.47.0-255,66,56510,92,290805
5513,0.000534,172.217.194.0-255,7156,63666,92,290805
5514,0.000538,172.217.194.0-255,5379,69045,92,290805
5515,0.000538,172.31.47.0-255,66,69111,92,290805
5516,0.000541,172.31.47.0-255,66,69177,92,290805
5517,0.000582,172.217.194.0-255,7156,76333,92,290805
5518,0.000586,172.31.47.0-255,66,76399,92,290805
5519,0.000614,172.217.194.0-255,7156,83555,92,290805
5520,0.000617,172.31.47.0-255,66,83621,92,290805
5521,0.000621,172.217.194.0-255,2543,86164,92,290805
5522,0.000623,172.31.47.0-255,66,86230,92,290805
5523,0.001027,172.217.194.0-255,1484,87714,92,290805
5524,0.001034,172.217.194.0-255,1484,89198,92,290805
5525,0.001038,172.31.47.0-255,66,89264,92,290805
5526,0.001054,172.217.194.0-255,1484,90748,92,290805
5527,0.001064,172.217.194.0-255,5738,96486,92,290805
5528,0.001067,172.31.47.0-255,66,96552,92,290805
5529,0.001071,172.217.194.0-255,2902,99454,92,290805
5530,0.001073,172.31.47.0-255,66,99520,92,290805
5531,0.001114,172.217.194.0-255,7156,106676,92,290805
5532,0.001118,172.31.47.0-255,66,106742,92,290805
5533,0.001128,172.31.47.0-255,66,106808,92,290805
5534,0.001131,172.217.194.0-255,2184,108992,92,290805
5535,0.001133,172.31.47.0-255,66,109058,92,290805
5536,0.001169,172.217.194.0-255,1484,110542,92,290805
5537,0.001184,172.217.194.0-255,2902,113444,92,290805
5538,0.001187,172.31.47.0-255,66,113510,92,290805
5539,0.001192,172.217.194.0-255,4320,117830,92,290805
5540,0.001194,172.31.47.0-255,66,117896,92,290805
5541,0.001215,172.217.194.0-255,1484,119380,92,290805
5542,0.001245,172.31.47.0-255,66,119446,92,290805
5543,0.001251,172.217.194.0-255,5738,125184,92,290805
5544,0.001253,172.31.47.0-255,66,125250,92,290805
5545,0.001289,172.217.194.0-255,5738,130988,92,290805
5546,0.001292,172.31.47.0-255,66,131054,92,290805
5547,0.001296,172.217.194.0-255,2184,133238,92,290805
5548,0.001299,172.31.47.0-255,66,133304,92,290805
5549,0.001302,172.217.194.0-255,2902,136206,92,290805
5550,0.001304,172.31.47.0-255,66,136272,92,290805
5551,0.00134,172.217.194.0-255,7156,143428,92,290805
5552,0.001343,172.31.47.0-255,66,143494,92,290805
5553,0.001359,172.31.47.0-255,66,143560,92,290805
5554,0.001362,172.217.194.0-255,1484,145044,92,290805
5555,0.001399,172.217.194.0-255,6438,151482,92,290805
5556,0.001403,172.31.47.0-255,66,151548,92,290805
5557,0.001406,172.217.194.0-255,1484,153032,92,290805
5558,0.001431,172.217.194.0-255,5738,158770,92,290805
5559,0.001435,172.31.47.0-255,66,158836,92,290805
5560,0.001459,172.217.194.0-255,2902,161738,92,290805
5561,0.001464,172.217.194.0-255,4320,166058,92,290805
5562,0.001486,172.217.194.0-255,7156,173214,92,290805
5563,0.001523,172.217.194.0-255,5738,178952,92,290805
5564,0.001541,172.217.194.0-255,2902,181854,92,290805
5565,0.001546,172.217.194.0-255,3602,185456,92,290805
5566,0.001695,172.217.194.0-255,1484,186940,92,290805
5567,0.001701,172.217.194.0-255,2902,189842,92,290805
5568,0.001727,172.217.194.0-255,5738,195580,92,290805
5569,0.001766,172.217.194.0-255,1484,197064,92,290805
5570,0.001797,172.217.194.0-255,5738,202802,92,290805
5571,0.001814,172.217.194.0-255,5020,207822,92,290805
5572,0.001869,172.217.194.0-255,1484,209306,92,290805
5573,0.001885,172.217.194.0-255,2902,212208,92,290805
5574,0.001888,172.217.194.0-255,1484,213692,92,290805
5575,0.001906,172.217.194.0-255,4320,218012,92,290805
5576,0.001922,172.217.194.0-255,2902,220914,92,290805
5577,0.001934,172.217.194.0-255,2902,223816,92,290805
5578,0.001948,172.217.194.0-255,7156,230972,92,290805
5579,0.001967,172.217.194.0-255,4320,235292,92,290805
5580,0.001985,172.217.194.0-255,4320,239612,92,290805
5581,0.002005,172.217.194.0-255,2184,241796,92,290805
5582,0.002011,172.217.194.0-255,5738,247534,92,290805
5583,0.002028,172.217.194.0-255,5738,253272,92,290805
5584,0.002043,172.217.194.0-255,2902,256174,92,290805
5585,0.002064,172.217.194.0-255,2902,259076,92,290805
5586,0.002103,172.217.194.0-255,4320,263396,92,290805
5587,0.002152,172.217.194.0-255,4320,267716,92,290805
5588,0.002215,172.217.194.0-255,2902,270618,92,290805
5589,0.002226,172.217.194.0-255,2902,273520,92,290805
5590,0.002239,172.217.194.0-255,4320,277840,92,290805
5591,0.002266,172.217.194.0-255,4320,282160,92,290805
5592,0.002347,172.217.194.0-255,105,282265,92,290805
5593,0.003705,172.31.47.0-255,66,282331,92,290805
5594,0.005987,172.31.47.0-255,105,282436,92,290805
5595,0.008281,172.217.194.0-255,66,282502,92,290805
5596,0.027084,172.31.47.0-255,167,282669,92,290805
5597,0.027114,172.31.47.0-255,1111,283780,92,290805
5598,0.027155,172.31.47.0-255,1514,285294,92,290805
5599,0.027157,172.31.47.0-255,1514,286808,92,290805
5600,0.027158,172.31.47.0-255,1514,288322,92,290805
5601,0.027159,172.31.47.0-255,1514,289836,92,290805
5602,0.02716,172.31.47.0-255,531,290367,92,290805
5603,0.028659,104.244.42.0-255,66,290433,92,290805
5604,0.028675,104.244.42.0-255,66,290499,92,290805
5605,0.028776,104.244.42.0-255,66,290565,92,290805
5606,0.028778,104.244.42.0-255,66,290631,92,290805
5607,0.02942,104.244.42.0-255,108,290739,92,290805
5608,0.029424,172.31.47.0-255,66,290805,92,290805
5609,0.0,172.217.26.0-255,152,152,92,301981
5610,1.4e-05,172.31.47.0-255,66,218,92,301981
5611,2.1e-05,172.217.26.0-255,1484,1702,92,301981
5612,2.5e-05,172.31.47.0-255,66,1768,92,301981
5613,2.8e-05,172.217.26.0-255,1484,3252,92,301981
5614,3.1e-05,172.31.47.0-255,66,3318,92,301981
5615,7.6e-05,172.217.26.0-255,1484,4802,92,301981
5616,7.8e-05,172.31.47.0-255,66,4868,92,301981
5617,8.6e-05,172.217.26.0-255,5738,10606,92,301981
5618,8.8e-05,172.31.47.0-255,66,10672,92,301981
5619,0.000115,172.217.26.0-255,1484,12156,92,301981
5620,0.000117,172.31.47.0-255,66,12222,92,301981
5621,0.000122,172.217.26.0-255,2174,14396,92,301981
5622,0.000124,172.31.47.0-255,66,14462,92,301981
5623,0.000127,172.217.26.0-255,2902,17364,92,301981
5624,0.000133,172.31.47.0-255,66,17430,92,301981
5625,0.000135,172.217.26.0-255,1484,18914,92,301981
5626,0.000137,172.31.47.0-255,66,18980,92,301981
5627,0.00014,172.217.26.0-255,1484,20464,92,301981
5628,0.000142,172.31.47.0-255,66,20530,92,301981
5629,0.000146,172.217.26.0-255,2902,23432,92,301981
5630,0.000149,172.31.47.0-255,66,23498,92,301981
5631,0.000154,172.217.26.0-255,5738,29236,92,301981
5632,0.000157,172.31.47.0-255,66,29302,92,301981
5633,0.00016,172.217.26.0-255,2543,31845,92,301981
5634,0.000163,172.31.47.0-255,66,31911,92,301981
5635,0.000225,172.217.26.0-255,1484,33395,92,301981
5636,0.000228,172.31.47.0-255,66,33461,92,301981
5637,0.000232,172.217.26.0-255,2902,36363,92,301981
5638,0.000234,172.31.47.0-255,66,36429,92,301981
5639,0.000238,172.217.26.0-255,4320,40749,92,301981
5640,0.00024,172.31.47.0-255,66,40815,92,301981
5641,0.00027,172.217.26.0-255,1484,42299,92,301981
5642,0.000277,172.217.26.0-255,6797,49096,92,301981
5643,0.000279,172.31.47.0-255,66,49162,92,301981
5644,0.000517,172.217.26.0-255,1484,50646,92,301981
5645,0.000531,172.217.26.0-255,2902,53548,92,301981
5646,0.000534,172.31.47.0-255,66,53614,92,301981
5647,0.000539,172.217.26.0-255,2902,56516,92,301981
5648,0.000542,172.31.47.0-255,66,56582,92,301981
5649,0.000562,172.217.26.0-255,2902,59484,92,301981
5650,0.000564,172.31.47.0-255,66,59550,92,301981
5651,0.000591,172.217.26.0-255,5738,65288,92,301981
5652,0.000594,172.31.47.0-255,66,65354,92,301981
5653,0.000596,172.217.26.0-255,1125,66479,92,301981
5654,0.00064,172.217.26.0-255,392,66871,92,301981
5655,0.001016,172.31.47.0-255,66,66937,92,301981
5656,0.001502,172.217.26.0-255,1484,68421,92,301981
5657,0.001513,172.217.26.0-255,2902,71323,92,301981
5658,0.001517,172.31.47.0-255,66,71389,92,301981
5659,0.001525,172.217.26.0-255,5738,77127,92,301981
5660,0.001527,172.31.47.0-255,66,77193,92,301981
5661,0.001549,172.217.26.0-255,4320,81513,92,301981
5662,0.001551,172.31.47.0-255,66,81579,92,301981
5663,0.001574,172.217.26.0-255,2543,84122,92,301981
5664,0.001576,172.31.47.0-255,66,84188,92,301981
5665,0.001583,172.217.26.0-255,5738,89926,92,301981
5666,0.001585,172.31.47.0-255,66,89992,92,301981
5667,0.001625,172.31.47.0-255,66,90058,92,301981
5668,0.001629,172.217.26.0-255,2248,92306,92,301981
5669,0.001631,172.31.47.0-255,66,92372,92,301981
5670,0.00164,172.217.26.0-255,5738,98110,92,301981
5671,0.001641,172.31.47.0-255,66,98176,92,301981
5672,0.00168,172.217.26.0-255,5738,103914,92,301981
5673,0.001683,172.31.47.0-255,66,103980,92,301981
5674,0.001686,172.217.26.0-255,1484,105464,92,301981
5675,0.00171,172.217.26.0-255,3847,109311,92,301981
5676,0.001713,172.31.47.0-255,66,109377,92,301981
5677,0.001867,172.217.26.0-255,1484,110861,92,301981
5678,0.001874,172.217.26.0-255,2902,113763,92,301981
5679,0.001878,172.31.47.0-255,66,113829,92,301981
5680,0.001886,172.217.26.0-255,5738,119567,92,301981
5681,0.001888,172.31.47.0-255,66,119633,92,301981
5682,0.001935,172.217.26.0-255,1484,121117,92,301981
5683,0.00194,172.217.26.0-255,2902,124019,92,301981
5684,0.001943,172.31.47.0-255,66,124085,92,301981
5685,0.001948,172.217.26.0-255,2666,126751,92,301981
5686,0.00195,172.31.47.0-255,66,126817,92,301981
5687,0.00391,172.217.26.0-255,5738,132555,92,301981
5688,0.003917,172.31.47.0-255,66,132621,92,301981
5689,0.005881,172.217.26.0-255,5738,138359,92,301981
5690,0.005886,172.31.47.0-255,66,138425,92,301981
5691,0.007861,172.217.26.0-255,5738,144163,92,301981
5692,0.007867,172.31.47.0-255,66,144229,92,301981
5693,0.009843,172.217.26.0-255,5738,149967,92,301981
5694,0.00985,172.31.47.0-255,66,150033,92,301981
5695,0.011865,172.217.26.0-255,5738,155771,92,301981
5696,0.011877,172.31.47.0-255,66,155837,92,301981
5697,0.013845,172.217.26.0-255,5738,161575,92,301981
5698,0.013853,172.31.47.0-255,66,161641,92,301981
5699,0.01583,172.217.26.0-255,5738,167379,92,301981
5700,0.015839,172.31.47.0-255,66,167445,92,301981
5701,0.017807,172.217.26.0-255,5738,173183,92,301981
5702,0.017812,172.31.47.0-255,66,173249,92,301981
5703,0.019783,172.217.26.0-255,5738,178987,92,301981
5704,0.019789,172.31.47.0-255,66,179053,92,301981
5705,0.021758,172.217.26.0-255,5738,184791,92,301981
5706,0.021764,172.31.47.0-255,66,184857,92,301981
5707,0.023742,172.217.26.0-255,5738,190595,92,301981
5708,0.023747,172.31.47.0-255,66,190661,92,301981
5709,0.024096,172.31.47.0-255,172,190833,92,301981
5710,0.024122,172.31.47.0-255,1111,191944,92,301981
5711,0.024177,172.31.47.0-255,1514,193458,92,301981
5712,0.024178,172.31.47.0-255,1514,194972,92,301981
5713,0.024179,172.31.47.0-255,1514,196486,92,301981
5714,0.02418,172.31.47.0-255,1514,198000,92,301981
5715,0.024181,172.31.47.0-255,531,198531,92,301981
5716,0.025659,104.244.42.0-255,66,198597,92,301981
5717,0.025691,104.244.42.0-255,66,198663,92,301981
5718,0.025712,172.217.26.0-255,5738,204401,92,301981
5719,0.025717,172.31.47.0-255,66,204467,92,301981
5720,0.025745,104.244.42.0-255,66,204533,92,301981
5721,0.025748,104.244.42.0-255,66,204599,92,301981
5722,0.027685,172.217.26.0-255,4320,208919,92,301981
5723,0.027691,172.31.47.0-255,66,208985,92,301981
5724,0.027718,172.217.26.0-255,1484,210469,92,301981
5725,0.029654,172.217.26.0-255,4320,214789,92,301981
5726,0.029659,172.31.47.0-255,66,214855,92,301981
5727,0.031618,172.217.26.0-255,5738,220593,92,301981
5728,0.031624,172.31.47.0-255,66,220659,92,301981
5729,0.033619,172.217.26.0-255,5738,226397,92,301981
5730,0.033626,172.31.47.0-255,66,226463,92,301981
5731,0.0356,172.217.26.0-255,5738,232201,92,301981
5732,0.035606,172.31.47.0-255,66,232267,92,301981
5733,0.037582,172.217.26.0-255,5738,238005,92,301981
5734,0.037587,172.31.47.0-255,66,238071,92,301981
5735,0.03956,172.217.26.0-255,5738,243809,92,301981
5736,0.039567,172.31.47.0-255,66,243875,92,301981
5737,0.04153,172.217.26.0-255,5738,249613,92,301981
5738,0.041535,172.31.47.0-255,66,249679,92,301981
5739,0.0435,172.217.26.0-255,5738,255417,92,301981
5740,0.043507,172.31.47.0-255,66,255483,92,301981
5741,0.04548,172.217.26.0-255,5738,261221,92,301981
5742,0.045487,172.31.47.0-255,66,261287,92,301981
5743,0.047445,172.217.26.0-255,1484,262771,92,301981
5744,0.047468,172.217.26.0-255,4320,267091,92,301981
5745,0.047473,172.31.47.0-255,66,267157,92,301981
5746,0.049463,172.217.26.0-255,5738,272895,92,301981
5747,0.049471,172.31.47.0-255,66,272961,92,301981
5748,0.051453,172.217.26.0-255,5738,278699,92,301981
5749,0.051458,172.31.47.0-255,66,278765,92,301981
5750,0.053435,172.217.26.0-255,5738,284503,92,301981
5751,0.053441,172.31.47.0-255,66,284569,92,301981
5752,0.055417,172.217.26.0-255,5738,290307,92,301981
5753,0.055423,172.31.47.0-255,66,290373,92,301981
5754,0.057395,172.217.26.0-255,5738,296111,92,301981
5755,0.057401,172.31.47.0-255,66,296177,92,301981
5756,0.05937,172.217.26.0-255,5738,301915,92,301981
5757,0.059376,172.31.47.0-255,66,301981,92,301981
5758,0.0,172.31.47.0-255,105,105,92,276
5759,0.001876,157.240.13.0-255,105,210,92,276
5760,0.001886,172.31.47.0-255,66,276,92,276
5761,0.0,74.125.24.0-255,153,153,92,211869
5762,3.1e-05,172.31.47.0-255,66,219,92,211869
5763,3.8e-05,74.125.24.0-255,1484,1703,92,211869
5764,4.2e-05,172.31.47.0-255,66,1769,92,211869
5765,4.6e-05,74.125.24.0-255,2902,4671,92,211869
5766,4.9e-05,172.31.47.0-255,66,4737,92,211869
5767,5.4e-05,74.125.24.0-255,2902,7639,92,211869
5768,5.7e-05,172.31.47.0-255,66,7705,92,211869
5769,7.3e-05,74.125.24.0-255,2902,10607,92,211869
5770,7.6e-05,172.31.47.0-255,66,10673,92,211869
5771,8.3e-05,74.125.24.0-255,6236,16909,92,211869
5772,8.5e-05,172.31.47.0-255,66,16975,92,211869
5773,0.000118,172.31.47.0-255,66,17041,92,211869
5774,0.00053,74.125.24.0-255,1484,18525,92,211869
5775,0.000536,172.31.47.0-255,66,18591,92,211869
5776,0.000542,74.125.24.0-255,2902,21493,92,211869
5777,0.000544,172.31.47.0-255,66,21559,92,211869
5778,0.000548,74.125.24.0-255,2902,24461,92,211869
5779,0.00055,172.31.47.0-255,66,24527,92,211869
5780,0.000568,74.125.24.0-255,2902,27429,92,211869
5781,0.000571,172.31.47.0-255,66,27495,92,211869
5782,0.000579,74.125.24.0-255,6797,34292,92,211869
5783,0.000584,172.31.47.0-255,66,34358,92,211869
5784,0.000586,74.125.24.0-255,7156,41514,92,211869
5785,0.000588,172.31.47.0-255,66,41580,92,211869
5786,0.000635,172.31.47.0-255,66,41646,92,211869
5787,0.000652,74.125.24.0-255,127,41773,92,211869
5788,0.000654,172.31.47.0-255,66,41839,92,211869
5789,0.000691,74.125.24.0-255,1484,43323,92,211869
5790,0.000695,172.31.47.0-255,66,43389,92,211869
5791,0.0007,74.125.24.0-255,2902,46291,92,211869
5792,0.000705,172.31.47.0-255,66,46357,92,211869
5793,0.000717,74.125.24.0-255,5738,52095,92,211869
5794,0.000733,172.31.47.0-255,66,52161,92,211869
5795,0.000736,74.125.24.0-255,5738,57899,92,211869
5796,0.000748,172.31.47.0-255,66,57965,92,211869
5797,0.000751,74.125.24.0-255,4320,62285,92,211869
5798,0.000754,172.31.47.0-255,66,62351,92,211869
5799,0.000806,172.31.47.0-255,66,62417,92,211869
5800,0.000815,74.125.24.0-255,3602,66019,92,211869
5801,0.00082,172.31.47.0-255,66,66085,92,211869
5802,0.000878,74.125.24.0-255,1484,67569,92,211869
5803,0.000883,74.125.24.0-255,2902,70471,92,211869
5804,0.000887,74.125.24.0-255,1484,71955,92,211869
5805,0.000894,172.31.47.0-255,66,72021,92,211869
5806,0.000914,74.125.24.0-255,5738,77759,92,211869
5807,0.000919,172.31.47.0-255,66,77825,92,211869
5808,0.000965,172.31.47.0-255,66,77891,92,211869
5809,0.000967,74.125.24.0-255,5738,83629,92,211869
5810,0.00097,172.31.47.0-255,66,83695,92,211869
5811,0.001022,74.125.24.0-255,3602,87297,92,211869
5812,0.001028,74.125.24.0-255,4320,91617,92,211869
5813,0.001034,74.125.24.0-255,5738,97355,92,211869
5814,0.001034,172.31.47.0-255,66,97421,92,211869
5815,0.001039,172.31.47.0-255,66,97487,92,211869
5816,0.001056,74.125.24.0-255,4320,101807,92,211869
5817,0.001063,74.125.24.0-255,7156,108963,92,211869
5818,0.001063,172.31.47.0-255,66,109029,92,211869
5819,0.001067,172.31.47.0-255,66,109095,92,211869
5820,0.001092,74.125.24.0-255,5738,114833,92,211869
5821,0.001102,172.31.47.0-255,66,114899,92,211869
5822,0.001111,74.125.24.0-255,4320,119219,92,211869
5823,0.001114,172.31.47.0-255,66,119285,92,211869
5824,0.001122,74.125.24.0-255,2184,121469,92,211869
5825,0.001126,172.31.47.0-255,66,121535,92,211869
5826,0.00136,74.125.24.0-255,1484,123019,92,211869
5827,0.001376,74.125.24.0-255,2902,125921,92,211869
5828,0.001379,172.31.47.0-255,66,125987,92,211869
5829,0.001401,74.125.24.0-255,5738,131725,92,211869
5830,0.001409,172.31.47.0-255,66,131791,92,211869
5831,0.001421,74.125.24.0-255,5738,137529,92,211869
5832,0.001427,172.31.47.0-255,66,137595,92,211869
5833,0.001452,74.125.24.0-255,7156,144751,92,211869
5834,0.001454,172.31.47.0-255,66,144817,92,211869
5835,0.001458,74.125.24.0-255,2902,147719,92,211869
5836,0.001471,172.31.47.0-255,66,147785,92,211869
5837,0.00149,74.125.24.0-255,5738,153523,92,211869
5838,0.001494,172.31.47.0-255,66,153589,92,211869
5839,0.0015,74.125.24.0-255,2184,155773,92,211869
5840,0.001505,172.31.47.0-255,66,155839,92,211869
5841,0.001702,74.125.24.0-255,1484,157323,92,211869
5842,0.001706,74.125.24.0-255,1484,158807,92,211869
5843,0.001708,172.31.47.0-255,66,158873,92,211869
5844,0.001728,74.125.24.0-255,1484,160357,92,211869
5845,0.001734,74.125.24.0-255,5738,166095,92,211869
5846,0.001736,172.31.47.0-255,66,166161,92,211869
5847,0.00174,74.125.24.0-255,2902,169063,92,211869
5848,0.001749,172.31.47.0-255,66,169129,92,211869
5849,0.001762,74.125.24.0-255,5738,174867,92,211869
5850,0.001767,172.31.47.0-255,66,174933,92,211869
5851,0.001781,74.125.24.0-255,4320,179253,92,211869
5852,0.001789,172.31.47.0-255,66,179319,92,211869
5853,0.001837,172.31.47.0-255,66,179385,92,211869
5854,0.001841,74.125.24.0-255,1484,180869,92,211869
5855,0.001848,172.31.47.0-255,66,180935,92,211869
5856,0.001877,172.31.47.0-255,66,181001,92,211869
5857,0.001906,74.125.24.0-255,4320,185321,92,211869
5858,0.00191,172.31.47.0-255,66,185387,92,211869
5859,0.001937,74.125.24.0-255,7156,192543,92,211869
5860,0.001941,74.125.24.0-255,1484,194027,92,211869
5861,0.001941,172.31.47.0-255,66,194093,92,211869
5862,0.001989,172.31.47.0-255,66,194159,92,211869
5863,0.002029,172.31.47.0-255,66,194225,92,211869
5864,0.002037,74.125.24.0-255,7156,201381,92,211869
5865,0.002044,172.31.47.0-255,66,201447,92,211869
5866,0.002061,172.31.47.0-255,66,201513,92,211869
5867,0.002066,172.31.47.0-255,66,201579,92,211869
5868,0.00211,172.31.47.0-255,66,201645,92,211869
5869,0.002135,172.31.47.0-255,66,201711,92,211869
5870,0.002151,172.31.47.0-255,66,201777,92,211869
5871,0.002189,74.125.24.0-255,97,201874,92,211869
5872,0.002202,74.125.24.0-255,105,201979,92,211869
5873,0.007568,172.31.47.0-255,66,202045,92,211869
5874,0.00905,172.31.47.0-255,105,202150,92,211869
5875,0.011369,74.125.24.0-255,66,202216,92,211869
5876,0.031719,172.31.47.0-255,172,202388,92,211869
5877,0.031747,172.31.47.0-255,1111,203499,92,211869
5878,0.031816,172.31.47.0-255,1514,205013,92,211869
5879,0.031818,172.31.47.0-255,1514,206527,92,211869
5880,0.031819,172.31.47.0-255,1514,208041,92,211869
5881,0.03182,172.31.47.0-255,1514,209555,92,211869
5882,0.03185,172.31.47.0-255,1514,211069,92,211869
5883,0.031851,172.31.47.0-255,536,211605,92,211869
5884,0.033242,104.244.42.0-255,66,211671,92,211869
5885,0.033288,104.244.42.0-255,66,211737,92,211869
5886,0.033371,104.244.42.0-255,66,211803,92,211869
5887,0.033373,104.244.42.0-255,66,211869,92,211869
5888,0.0,172.217.194.0-255,152,152,92,322330
5889,3.9e-05,172.31.47.0-255,66,218,92,322330
5890,4.6e-05,172.217.194.0-255,1484,1702,92,322330
5891,5.1e-05,172.31.47.0-255,66,1768,92,322330
5892,5.6e-05,172.217.194.0-255,2902,4670,92,322330
5893,5.8e-05,172.31.47.0-255,66,4736,92,322330
5894,6.3e-05,172.217.194.0-255,2902,7638,92,322330
5895,6.6e-05,172.31.47.0-255,66,7704,92,322330
5896,7.1e-05,172.217.194.0-255,4320,12024,92,322330
5897,7.3e-05,172.31.47.0-255,66,12090,92,322330
5898,0.0001,172.217.194.0-255,2145,14235,92,322330
5899,0.000103,172.31.47.0-255,66,14301,92,322330
5900,0.000164,172.217.194.0-255,1484,15785,92,322330
5901,0.000168,172.31.47.0-255,66,15851,92,322330
5902,0.000173,172.217.194.0-255,2902,18753,92,322330
5903,0.000175,172.31.47.0-255,66,18819,92,322330
5904,0.00019,172.217.194.0-255,5738,24557,92,322330
5905,0.000192,172.31.47.0-255,66,24623,92,322330
5906,0.000222,172.217.194.0-255,5738,30361,92,322330
5907,0.000226,172.31.47.0-255,66,30427,92,322330
5908,0.000252,172.217.194.0-255,1125,31552,92,322330
5909,0.000255,172.31.47.0-255,66,31618,92,322330
5910,0.000661,172.217.194.0-255,1484,33102,92,322330
5911,0.000666,172.31.47.0-255,66,33168,92,322330
5912,0.000675,172.217.194.0-255,2902,36070,92,322330
5913,0.000677,172.31.47.0-255,66,36136,92,322330
5914,0.00068,172.217.194.0-255,1484,37620,92,322330
5915,0.000682,172.31.47.0-255,66,37686,92,322330
5916,0.000705,172.217.194.0-255,4320,42006,92,322330
5917,0.000708,172.31.47.0-255,66,42072,92,322330
5918,0.000715,172.217.194.0-255,7156,49228,92,322330
5919,0.000717,172.31.47.0-255,66,49294,92,322330
5920,0.000741,172.217.194.0-255,2543,51837,92,322330
5921,0.000744,172.31.47.0-255,66,51903,92,322330
5922,0.000773,172.31.47.0-255,66,51969,92,322330
5923,0.000792,172.217.194.0-255,5653,57622,92,322330
5924,0.000795,172.31.47.0-255,66,57688,92,322330
5925,0.000883,172.217.194.0-255,120,57808,92,322330
5926,0.000887,172.31.47.0-255,66,57874,92,322330
5927,0.001248,172.217.194.0-255,1484,59358,92,322330
5928,0.001254,172.31.47.0-255,66,59424,92,322330
5929,0.00126,172.217.194.0-255,2902,62326,92,322330
5930,0.001263,172.31.47.0-255,66,62392,92,322330
5931,0.001269,172.217.194.0-255,5738,68130,92,322330
5932,0.001271,172.31.47.0-255,66,68196,92,322330
5933,0.001276,172.217.194.0-255,4320,72516,92,322330
5934,0.001279,172.31.47.0-255,66,72582,92,322330
5935,0.001294,172.217.194.0-255,2543,75125,92,322330
5936,0.001296,172.31.47.0-255,66,75191,92,322330
5937,0.001416,172.217.194.0-255,1484,76675,92,322330
5938,0.001419,172.31.47.0-255,66,76741,92,322330
5939,0.001423,172.217.194.0-255,2902,79643,92,322330
5940,0.001426,172.217.194.0-255,1484,81127,92,322330
5941,0.001459,172.217.194.0-255,4320,85447,92,322330
5942,0.001474,172.217.194.0-255,2902,88349,92,322330
5943,0.00149,172.217.194.0-255,3961,92310,92,322330
5944,0.001704,172.217.194.0-255,1484,93794,92,322330
5945,0.001708,172.217.194.0-255,2902,96696,92,322330
5946,0.001729,172.217.194.0-255,5738,102434,92,322330
5947,0.001732,172.217.194.0-255,1484,103918,92,322330
5948,0.001749,172.217.194.0-255,7156,111074,92,322330
5949,0.001772,172.217.194.0-255,5738,116812,92,322330
5950,0.001855,172.217.194.0-255,4320,121132,92,322330
5951,0.001879,172.217.194.0-255,3602,124734,92,322330
5952,0.001926,172.217.194.0-255,1484,126218,92,322330
5953,0.001943,172.217.194.0-255,2902,129120,92,322330
5954,0.001948,172.217.194.0-255,2902,132022,92,322330
5955,0.001963,172.217.194.0-255,2902,134924,92,322330
5956,0.001966,172.217.194.0-255,1484,136408,92,322330
5957,0.001979,172.217.194.0-255,7156,143564,92,322330
5958,0.001992,172.217.194.0-255,4320,147884,92,322330
5959,0.001998,172.217.194.0-255,5738,153622,92,322330
5960,0.002016,172.217.194.0-255,5020,158642,92,322330
5961,0.002059,172.217.194.0-255,1484,160126,92,322330
5962,0.002072,172.217.194.0-255,2902,163028,92,322330
5963,0.002076,172.217.194.0-255,2902,165930,92,322330
5964,0.002086,172.217.194.0-255,2902,168832,92,322330
5965,0.002156,172.217.194.0-255,1484,170316,92,322330
5966,0.002169,172.217.194.0-255,4320,174636,92,322330
5967,0.002207,172.217.194.0-255,1484,176120,92,322330
5968,0.002224,172.217.194.0-255,2902,179022,92,322330
5969,0.002226,172.217.194.0-255,1484,180506,92,322330
5970,0.002239,172.217.194.0-255,4320,184826,92,322330
5971,0.002262,172.217.194.0-255,7156,191982,92,322330
5972,0.002283,172.217.194.0-255,2902,194884,92,322330
5973,0.002296,172.217.194.0-255,1484,196368,92,322330
5974,0.002328,172.217.194.0-255,5020,201388,92,322330
5975,0.002334,172.217.194.0-255,5738,207126,92,322330
5976,0.002381,172.217.194.0-255,4320,211446,92,322330
5977,0.002478,172.217.194.0-255,1484,212930,92,322330
5978,0.002492,172.217.194.0-255,2902,215832,92,322330
5979,0.002514,172.217.194.0-255,5738,221570,92,322330
5980,0.002518,172.217.194.0-255,2902,224472,92,322330
5981,0.002529,172.217.194.0-255,2902,227374,92,322330
5982,0.002539,172.217.194.0-255,1484,228858,92,322330
5983,0.002612,172.217.194.0-255,5020,233878,92,322330
5984,0.002619,172.217.194.0-255,5738,239616,92,322330
5985,0.002621,172.217.194.0-255,1484,241100,92,322330
5986,0.002636,172.217.194.0-255,4320,245420,92,322330
5987,0.002638,172.217.194.0-255,1484,246904,92,322330
5988,0.002671,172.217.194.0-255,7156,254060,92,322330
5989,0.011427,172.31.47.0-255,66,254126,92,322330
5990,0.012327,172.217.194.0-255,1484,255610,92,322330
5991,0.014088,172.217.194.0-255,4320,259930,92,322330
5992,0.014096,172.31.47.0-255,66,259996,92,322330
5993,0.016721,172.217.194.0-255,5738,265734,92,322330
5994,0.016735,172.31.47.0-255,66,265800,92,322330
5995,0.019339,172.217.194.0-255,5738,271538,92,322330
5996,0.02102,172.31.47.0-255,66,271604,92,322330
5997,0.023653,172.217.194.0-255,5738,277342,92,322330
5998,0.023671,172.31.47.0-255,66,277408,92,322330
5999,0.026277,172.217.194.0-255,5738,283146,92,322330
6000,0.026296,172.31.47.0-255,66,283212,92,322330
6001,0.028921,172.217.194.0-255,5738,288950,92,322330
6002,0.028937,172.31.47.0-255,66,289016,92,322330
6003,0.031559,172.217.194.0-255,5738,294754,92,322330
6004,0.031583,172.31.47.0-255,66,294820,92,322330
6005,0.034246,172.217.194.0-255,5738,300558,92,322330
6006,0.034268,172.31.47.0-255,66,300624,92,322330
6007,0.036925,172.217.194.0-255,5738,306362,92,322330
6008,0.036945,172.31.47.0-255,66,306428,92,322330
6009,0.039583,172.217.194.0-255,5738,312166,92,322330
6010,0.039606,172.31.47.0-255,66,312232,92,322330
6011,0.04224,172.217.194.0-255,828,313060,92,322330
6012,0.042499,172.31.47.0-255,66,313126,92,322330
6013,0.042554,172.31.47.0-255,105,313231,92,322330
6014,0.045148,172.217.194.0-255,66,313297,92,322330
6015,0.053935,172.31.47.0-255,172,313469,92,322330
6016,0.054094,172.31.47.0-255,1103,314572,92,322330
6017,0.054171,172.31.47.0-255,1514,316086,92,322330
6018,0.054173,172.31.47.0-255,1514,317600,92,322330
6019,0.054174,172.31.47.0-255,1514,319114,92,322330
6020,0.054175,172.31.47.0-255,1514,320628,92,322330
6021,0.0542,172.31.47.0-255,1504,322132,92,322330
6022,0.055473,104.244.42.0-255,66,322198,92,322330
6023,0.055682,104.244.42.0-255,66,322264,92,322330
6024,0.0558,104.244.42.0-255,66,322330,92,322330
6025,0.0,74.125.24.0-255,152,152,92,227089
6026,1.7e-05,172.31.47.0-255,66,218,92,227089
6027,2.3e-05,74.125.24.0-255,1484,1702,92,227089
6028,2.7e-05,172.31.47.0-255,66,1768,92,227089
6029,3.1e-05,74.125.24.0-255,2902,4670,92,227089
6030,3.4e-05,172.31.47.0-255,66,4736,92,227089
6031,5.7e-05,74.125.24.0-255,7156,11892,92,227089
6032,6e-05,172.31.47.0-255,66,11958,92,227089
6033,6.3e-05,74.125.24.0-255,3502,15460,92,227089
6034,6.5e-05,172.31.47.0-255,66,15526,92,227089
6035,8.4e-05,74.125.24.0-255,5738,21264,92,227089
6036,8.6e-05,172.31.47.0-255,66,21330,92,227089
6037,0.000112,74.125.24.0-255,7156,28486,92,227089
6038,0.000114,172.31.47.0-255,66,28552,92,227089
6039,0.000117,74.125.24.0-255,2543,31095,92,227089
6040,0.000118,172.31.47.0-255,66,31161,92,227089
6041,0.000153,74.125.24.0-255,2902,34063,92,227089
6042,0.000155,172.31.47.0-255,66,34129,92,227089
6043,0.000173,74.125.24.0-255,4320,38449,92,227089
6044,0.000175,172.31.47.0-255,66,38515,92,227089
6045,0.000201,172.31.47.0-255,66,38581,92,227089
6046,0.000219,74.125.24.0-255,1484,40065,92,227089
6047,0.000221,172.31.47.0-255,66,40131,92,227089
6048,0.00025,172.31.47.0-255,66,40197,92,227089
6049,0.000272,74.125.24.0-255,3897,44094,92,227089
6050,0.000273,172.31.47.0-255,66,44160,92,227089
6051,0.000276,74.125.24.0-255,131,44291,92,227089
6052,0.000278,172.31.47.0-255,66,44357,92,227089
6053,0.0004,74.125.24.0-255,1484,45841,92,227089
6054,0.000405,172.31.47.0-255,66,45907,92,227089
6055,0.000409,74.125.24.0-255,2902,48809,92,227089
6056,0.000411,172.31.47.0-255,66,48875,92,227089
6057,0.000434,74.125.24.0-255,2902,51777,92,227089
6058,0.000437,172.31.47.0-255,66,51843,92,227089
6059,0.000452,74.125.24.0-255,2902,54745,92,227089
6060,0.000454,172.31.47.0-255,66,54811,92,227089
6061,0.000472,74.125.24.0-255,7156,61967,92,227089
6062,0.000475,172.31.47.0-255,66,62033,92,227089
6063,0.000493,74.125.24.0-255,5738,67771,92,227089
6064,0.000496,172.31.47.0-255,66,67837,92,227089
6065,0.000498,74.125.24.0-255,1484,69321,92,227089
6066,0.00052,74.125.24.0-255,4320,73641,92,227089
6067,0.000522,172.31.47.0-255,66,73707,92,227089
6068,0.000539,74.125.24.0-255,5020,78727,92,227089
6069,0.000542,172.31.47.0-255,66,78793,92,227089
6070,0.00058,74.125.24.0-255,1484,80277,92,227089
6071,0.000584,74.125.24.0-255,2902,83179,92,227089
6072,0.000586,172.31.47.0-255,66,83245,92,227089
6073,0.000607,74.125.24.0-255,5738,88983,92,227089
6074,0.00061,172.31.47.0-255,66,89049,92,227089
6075,0.000612,74.125.24.0-255,1484,90533,92,227089
6076,0.00063,74.125.24.0-255,4320,94853,92,227089
6077,0.000632,172.31.47.0-255,66,94919,92,227089
6078,0.000645,74.125.24.0-255,2902,97821,92,227089
6079,0.000647,172.31.47.0-255,66,97887,92,227089
6080,0.000677,172.31.47.0-255,66,97953,92,227089
6081,0.000682,74.125.24.0-255,5020,102973,92,227089
6082,0.000683,172.31.47.0-255,66,103039,92,227089
6083,0.000714,74.125.24.0-255,4320,107359,92,227089
6084,0.000716,172.31.47.0-255,66,107425,92,227089
6085,0.000728,74.125.24.0-255,1484,108909,92,227089
6086,0.000736,172.31.47.0-255,66,108975,92,227089
6087,0.000755,74.125.24.0-255,5738,114713,92,227089
6088,0.000757,172.31.47.0-255,66,114779,92,227089
6089,0.000802,74.125.24.0-255,7156,121935,92,227089
6090,0.000804,172.31.47.0-255,66,122001,92,227089
6091,0.000823,74.125.24.0-255,2902,124903,92,227089
6092,0.000825,172.31.47.0-255,66,124969,92,227089
6093,0.00083,74.125.24.0-255,5020,129989,92,227089
6094,0.000832,172.31.47.0-255,66,130055,92,227089
6095,0.000836,74.125.24.0-255,5738,135793,92,227089
6096,0.000838,172.31.47.0-255,66,135859,92,227089
6097,0.000847,172.31.47.0-255,66,135925,92,227089
6098,0.000857,172.31.47.0-255,66,135991,92,227089
6099,0.000961,74.125.24.0-255,1484,137475,92,227089
6100,0.000965,74.125.24.0-255,2902,140377,92,227089
6101,0.000968,172.31.47.0-255,66,140443,92,227089
6102,0.000986,74.125.24.0-255,5738,146181,92,227089
6103,0.000988,172.31.47.0-255,66,146247,92,227089
6104,0.001022,172.31.47.0-255,66,146313,92,227089
6105,0.001052,74.125.24.0-255,5738,152051,92,227089
6106,0.001055,172.31.47.0-255,66,152117,92,227089
6107,0.001072,74.125.24.0-255,5020,157137,92,227089
6108,0.001074,172.31.47.0-255,66,157203,92,227089
6109,0.001227,74.125.24.0-255,1484,158687,92,227089
6110,0.001241,74.125.24.0-255,2902,161589,92,227089
6111,0.001245,172.31.47.0-255,66,161655,92,227089
6112,0.001258,74.125.24.0-255,5738,167393,92,227089
6113,0.00126,172.31.47.0-255,66,167459,92,227089
6114,0.001277,74.125.24.0-255,4320,171779,92,227089
6115,0.001279,172.31.47.0-255,66,171845,92,227089
6116,0.001317,172.31.47.0-255,66,171911,92,227089
6117,0.001327,172.31.47.0-255,66,171977,92,227089
6118,0.001339,74.125.24.0-255,2184,174161,92,227089
6119,0.001342,172.31.47.0-255,66,174227,92,227089
6120,0.001402,74.125.24.0-255,1484,175711,92,227089
6121,0.001407,74.125.24.0-255,2902,178613,92,227089
6122,0.001411,172.31.47.0-255,66,178679,92,227089
6123,0.001424,74.125.24.0-255,1484,180163,92,227089
6124,0.00144,74.125.24.0-255,4320,184483,92,227089
6125,0.001444,172.31.47.0-255,66,184549,92,227089
6126,0.001449,74.125.24.0-255,5738,190287,92,227089
6127,0.001452,172.31.47.0-255,66,190353,92,227089
6128,0.001465,74.125.24.0-255,2902,193255,92,227089
6129,0.001467,172.31.47.0-255,66,193321,92,227089
6130,0.001483,74.125.24.0-255,2902,196223,92,227089
6131,0.001488,172.31.47.0-255,66,196289,92,227089
6132,0.00152,172.31.47.0-255,66,196355,92,227089
6133,0.00153,172.31.47.0-255,66,196421,92,227089
6134,0.001589,172.31.47.0-255,66,196487,92,227089
6135,0.001624,172.31.47.0-255,66,196553,92,227089
6136,0.00166,172.31.47.0-255,66,196619,92,227089
6137,0.001681,74.125.24.0-255,4320,200939,92,227089
6138,0.001683,172.31.47.0-255,66,201005,92,227089
6139,0.001693,172.31.47.0-255,66,201071,92,227089
6140,0.001703,172.31.47.0-255,66,201137,92,227089
6141,0.001708,74.125.24.0-255,7156,208293,92,227089
6142,0.001711,172.31.47.0-255,66,208359,92,227089
6143,0.001737,74.125.24.0-255,7156,215515,92,227089
6144,0.001741,172.31.47.0-255,66,215581,92,227089
6145,0.001754,172.31.47.0-255,66,215647,92,227089
6146,0.001767,172.31.47.0-255,66,215713,92,227089
6147,0.001791,74.125.24.0-255,1484,217197,92,227089
6148,0.001794,74.125.24.0-255,452,217649,92,227089
6149,0.001796,172.31.47.0-255,66,217715,92,227089
6150,0.001815,74.125.24.0-255,105,217820,92,227089
6151,0.003764,172.31.47.0-255,66,217886,92,227089
6152,0.003794,172.31.47.0-255,105,217991,92,227089
6153,0.006022,74.125.24.0-255,66,218057,92,227089
6154,0.029958,172.31.47.0-255,172,218229,92,227089
6155,0.029995,172.31.47.0-255,1112,219341,92,227089
6156,0.030061,172.31.47.0-255,1514,220855,92,227089
6157,0.030063,172.31.47.0-255,1514,222369,92,227089
6158,0.030067,172.31.47.0-255,1514,223883,92,227089
6159,0.030068,172.31.47.0-255,1514,225397,92,227089
6160,0.030089,172.31.47.0-255,1494,226891,92,227089
6161,0.031524,104.244.42.0-255,66,226957,92,227089
6162,0.031532,104.244.42.0-255,66,227023,92,227089
6163,0.031626,104.244.42.0-255,66,227089,92,227089
6164,0.0,172.31.47.0-255,105,105,92,105
6165,0.0,74.125.24.0-255,146,146,92,255544
6166,3.6e-05,172.31.47.0-255,66,212,92,255544
6167,4.4e-05,74.125.24.0-255,1484,1696,92,255544
6168,4.8e-05,172.31.47.0-255,66,1762,92,255544
6169,5.3e-05,74.125.24.0-255,2902,4664,92,255544
6170,5.6e-05,172.31.47.0-255,66,4730,92,255544
6171,6.4e-05,74.125.24.0-255,7156,11886,92,255544
6172,6.8e-05,172.31.47.0-255,66,11952,92,255544
6173,0.000111,74.125.24.0-255,2171,14123,92,255544
6174,0.000113,172.31.47.0-255,66,14189,92,255544
6175,0.000211,74.125.24.0-255,1484,15673,92,255544
6176,0.000216,172.31.47.0-255,66,15739,92,255544
6177,0.000231,74.125.24.0-255,2902,18641,92,255544
6178,0.000234,172.31.47.0-255,66,18707,92,255544
6179,0.00024,74.125.24.0-255,4320,23027,92,255544
6180,0.000243,172.31.47.0-255,66,23093,92,255544
6181,0.000262,74.125.24.0-255,1484,24577,92,255544
6182,0.000265,172.31.47.0-255,66,24643,92,255544
6183,0.000303,74.125.24.0-255,6797,31440,92,255544
6184,0.000306,172.31.47.0-255,66,31506,92,255544
6185,0.000465,74.125.24.0-255,1484,32990,92,255544
6186,0.000469,172.31.47.0-255,66,33056,92,255544
6187,0.00049,74.125.24.0-255,2902,35958,92,255544
6188,0.000494,172.31.47.0-255,66,36024,92,255544
6189,0.000514,74.125.24.0-255,5738,41762,92,255544
6190,0.000517,172.31.47.0-255,66,41828,92,255544
6191,0.000535,74.125.24.0-255,2902,44730,92,255544
6192,0.000538,172.31.47.0-255,66,44796,92,255544
6193,0.000568,74.125.24.0-255,5738,50534,92,255544
6194,0.000571,172.31.47.0-255,66,50600,92,255544
6195,0.000598,74.125.24.0-255,5379,55979,92,255544
6196,0.000601,172.31.47.0-255,66,56045,92,255544
6197,0.000611,172.31.47.0-255,66,56111,92,255544
6198,0.000614,74.125.24.0-255,401,56512,92,255544
6199,0.000616,172.31.47.0-255,66,56578,92,255544
6200,0.000656,74.125.24.0-255,108,56686,92,255544
6201,0.00066,172.31.47.0-255,66,56752,92,255544
6202,0.000686,74.125.24.0-255,330,57082,92,255544
6203,0.00069,172.31.47.0-255,66,57148,92,255544
6204,0.001788,74.125.24.0-255,1484,58632,92,255544
6205,0.001795,172.31.47.0-255,66,58698,92,255544
6206,0.001806,74.125.24.0-255,2902,61600,92,255544
6207,0.001808,172.31.47.0-255,66,61666,92,255544
6208,0.001814,74.125.24.0-255,5738,67404,92,255544
6209,0.001815,172.31.47.0-255,66,67470,92,255544
6210,0.001835,74.125.24.0-255,1484,68954,92,255544
6211,0.001837,172.31.47.0-255,66,69020,92,255544
6212,0.001861,172.31.47.0-255,66,69086,92,255544
6213,0.001872,74.125.24.0-255,2902,71988,92,255544
6214,0.001874,172.31.47.0-255,66,72054,92,255544
6215,0.00191,74.125.24.0-255,1484,73538,92,255544
6216,0.001913,172.31.47.0-255,66,73604,92,255544
6217,0.001939,172.31.47.0-255,66,73670,92,255544
6218,0.002195,74.125.24.0-255,1484,75154,92,255544
6219,0.002197,172.31.47.0-255,66,75220,92,255544
6220,0.002214,74.125.24.0-255,2902,78122,92,255544
6221,0.002216,172.31.47.0-255,66,78188,92,255544
6222,0.002221,74.125.24.0-255,4320,82508,92,255544
6223,0.002223,172.31.47.0-255,66,82574,92,255544
6224,0.002235,74.125.24.0-255,1484,84058,92,255544
6225,0.002237,172.31.47.0-255,66,84124,92,255544
6226,0.002249,74.125.24.0-255,4320,88444,92,255544
6227,0.002252,172.31.47.0-255,66,88510,92,255544
6228,0.002276,172.31.47.0-255,66,88576,92,255544
6229,0.002285,172.31.47.0-255,66,88642,92,255544
6230,0.002309,74.125.24.0-255,2184,90826,92,255544
6231,0.002311,172.31.47.0-255,66,90892,92,255544
6232,0.002492,74.125.24.0-255,1484,92376,92,255544
6233,0.002494,172.31.47.0-255,66,92442,92,255544
6234,0.002508,74.125.24.0-255,1484,93926,92,255544
6235,0.00251,172.31.47.0-255,66,93992,92,255544
6236,0.002524,74.125.24.0-255,1484,95476,92,255544
6237,0.002526,172.31.47.0-255,66,95542,92,255544
6238,0.002532,74.125.24.0-255,5738,101280,92,255544
6239,0.002534,172.31.47.0-255,66,101346,92,255544
6240,0.002575,74.125.24.0-255,5738,107084,92,255544
6241,0.002578,172.31.47.0-255,66,107150,92,255544
6242,0.002598,74.125.24.0-255,7156,114306,92,255544
6243,0.0026,172.31.47.0-255,66,114372,92,255544
6244,0.002616,74.125.24.0-255,4320,118692,92,255544
6245,0.002618,172.31.47.0-255,66,118758,92,255544
6246,0.002639,74.125.24.0-255,6438,125196,92,255544
6247,0.002641,172.31.47.0-255,66,125262,92,255544
6248,0.00523,74.125.24.0-255,4320,129582,92,255544
6249,0.005233,172.31.47.0-255,66,129648,92,255544
6250,0.005249,74.125.24.0-255,1484,131132,92,255544
6251,0.00525,172.31.47.0-255,66,131198,92,255544
6252,0.007864,74.125.24.0-255,5738,136936,92,255544
6253,0.007873,172.31.47.0-255,66,137002,92,255544
6254,0.010474,74.125.24.0-255,5738,142740,92,255544
6255,0.010483,172.31.47.0-255,66,142806,92,255544
6256,0.013083,74.125.24.0-255,5738,148544,92,255544
6257,0.01309,172.31.47.0-255,66,148610,92,255544
6258,0.01572,74.125.24.0-255,5738,154348,92,255544
6259,0.015727,172.31.47.0-255,66,154414,92,255544
6260,0.018332,74.125.24.0-255,5738,160152,92,255544
6261,0.018338,172.31.47.0-255,66,160218,92,255544
6262,0.020944,74.125.24.0-255,5738,165956,92,255544
6263,0.020956,172.31.47.0-255,66,166022,92,255544
6264,0.023561,74.125.24.0-255,5738,171760,92,255544
6265,0.02357,172.31.47.0-255,66,171826,92,255544
6266,0.02376,172.31.47.0-255,172,171998,92,255544
6267,0.023785,172.31.47.0-255,1111,173109,92,255544
6268,0.023841,172.31.47.0-255,1514,174623,92,255544
6269,0.023842,172.31.47.0-255,1514,176137,92,255544
6270,0.023843,172.31.47.0-255,1514,177651,92,255544
6271,0.023844,172.31.47.0-255,1514,179165,92,255544
6272,0.023845,172.31.47.0-255,531,179696,92,255544
6273,0.025339,104.244.42.0-255,66,179762,92,255544
6274,0.025347,104.244.42.0-255,66,179828,92,255544
6275,0.025388,104.244.42.0-255,66,179894,92,255544
6276,0.025421,104.244.42.0-255,66,179960,92,255544
6277,0.026171,74.125.24.0-255,5738,185698,92,255544
6278,0.026178,172.31.47.0-255,66,185764,92,255544
6279,0.028787,74.125.24.0-255,5738,191502,92,255544
6280,0.028793,172.31.47.0-255,66,191568,92,255544
6281,0.031409,74.125.24.0-255,5738,197306,92,255544
6282,0.031415,172.31.47.0-255,66,197372,92,255544
6283,0.034002,74.125.24.0-255,4320,201692,92,255544
6284,0.03401,172.31.47.0-255,66,201758,92,255544
6285,0.034029,74.125.24.0-255,1484,203242,92,255544
6286,0.034032,172.31.47.0-255,66,203308,92,255544
6287,0.0367,74.125.24.0-255,5738,209046,92,255544
6288,0.03671,172.31.47.0-255,66,209112,92,255544
6289,0.039385,74.125.24.0-255,5738,214850,92,255544
6290,0.039393,172.31.47.0-255,66,214916,92,255544
6291,0.042062,74.125.24.0-255,5738,220654,92,255544
6292,0.042067,172.31.47.0-255,66,220720,92,255544
6293,0.04471,74.125.24.0-255,5738,226458,92,255544
6294,0.044716,172.31.47.0-255,66,226524,92,255544
6295,0.047347,74.125.24.0-255,5738,232262,92,255544
6296,0.047352,172.31.47.0-255,66,232328,92,255544
6297,0.049964,74.125.24.0-255,5738,238066,92,255544
6298,0.049969,172.31.47.0-255,66,238132,92,255544
6299,0.052615,74.125.24.0-255,5738,243870,92,255544
6300,0.052621,172.31.47.0-255,66,243936,92,255544
6301,0.055255,74.125.24.0-255,5738,249674,92,255544
6302,0.055264,172.31.47.0-255,66,249740,92,255544
6303,0.057958,74.125.24.0-255,5738,255478,92,255544
6304,0.05797,172.31.47.0-255,66,255544,92,255544
6305,0.0,172.31.47.0-255,66,66,92,66
6306,0.0,74.125.24.0-255,153,153,92,273561
6307,2.2e-05,172.31.47.0-255,66,219,92,273561
6308,2.9e-05,74.125.24.0-255,1484,1703,92,273561
6309,3.2e-05,172.31.47.0-255,66,1769,92,273561
6310,5.1e-05,74.125.24.0-255,2902,4671,92,273561
6311,5.3e-05,172.31.47.0-255,66,4737,92,273561
6312,5.5e-05,74.125.24.0-255,1484,6221,92,273561
6313,5.7e-05,172.31.47.0-255,66,6287,92,273561
6314,9e-05,74.125.24.0-255,4320,10607,92,273561
6315,9.3e-05,172.31.47.0-255,66,10673,92,273561
6316,0.000109,74.125.24.0-255,1484,12157,92,273561
6317,0.00011,172.31.47.0-255,66,12223,92,273561
6318,0.000113,74.125.24.0-255,1484,13707,92,273561
6319,0.000115,172.31.47.0-255,66,13773,92,273561
6320,0.000156,172.31.47.0-255,66,13839,92,273561
6321,0.000162,74.125.24.0-255,5738,19577,92,273561
6322,0.000163,172.31.47.0-255,66,19643,92,273561
6323,0.000173,74.125.24.0-255,1484,21127,92,273561
6324,0.000175,172.31.47.0-255,66,21193,92,273561
6325,0.000206,74.125.24.0-255,1125,22318,92,273561
6326,0.000208,172.31.47.0-255,66,22384,92,273561
6327,0.000323,74.125.24.0-255,1484,23868,92,273561
6328,0.000327,172.31.47.0-255,66,23934,92,273561
6329,0.00033,74.125.24.0-255,1484,25418,92,273561
6330,0.000332,172.31.47.0-255,66,25484,92,273561
6331,0.000344,74.125.24.0-255,1484,26968,92,273561
6332,0.000346,172.31.47.0-255,66,27034,92,273561
6333,0.000353,74.125.24.0-255,5738,32772,92,273561
6334,0.000355,172.31.47.0-255,66,32838,92,273561
6335,0.000358,74.125.24.0-255,2902,35740,92,273561
6336,0.00036,172.31.47.0-255,66,35806,92,273561
6337,0.000379,74.125.24.0-255,1484,37290,92,273561
6338,0.000402,74.125.24.0-255,2902,40192,92,273561
6339,0.000406,172.31.47.0-255,66,40258,92,273561
6340,0.000421,172.31.47.0-255,66,40324,92,273561
6341,0.000427,74.125.24.0-255,7106,47430,92,273561
6342,0.000428,172.31.47.0-255,66,47496,92,273561
6343,0.000506,74.125.24.0-255,112,47608,92,273561
6344,0.000524,74.125.24.0-255,331,47939,92,273561
6345,0.000688,172.31.47.0-255,66,48005,92,273561
6346,0.00091,74.125.24.0-255,1484,49489,92,273561
6347,0.000921,74.125.24.0-255,2902,52391,92,273561
6348,0.000924,172.31.47.0-255,66,52457,92,273561
6349,0.000942,74.125.24.0-255,5738,58195,92,273561
6350,0.000944,172.31.47.0-255,66,58261,92,273561
6351,0.00098,74.125.24.0-255,5738,63999,92,273561
6352,0.000983,172.31.47.0-255,66,64065,92,273561
6353,0.001007,74.125.24.0-255,7156,71221,92,273561
6354,0.00101,172.31.47.0-255,66,71287,92,273561
6355,0.001014,74.125.24.0-255,2902,74189,92,273561
6356,0.001015,172.31.47.0-255,66,74255,92,273561
6357,0.001035,172.31.47.0-255,66,74321,92,273561
6358,0.001401,74.125.24.0-255,1484,75805,92,273561
6359,0.00141,74.125.24.0-255,1484,77289,92,273561
6360,0.001413,172.31.47.0-255,66,77355,92,273561
6361,0.001435,74.125.24.0-255,1484,78839,92,273561
6362,0.001442,74.125.24.0-255,5738,84577,92,273561
6363,0.001444,172.31.47.0-255,66,84643,92,273561
6364,0.001448,74.125.24.0-255,4320,88963,92,273561
6365,0.00145,172.31.47.0-255,66,89029,92,273561
6366,0.001475,74.125.24.0-255,1484,90513,92,273561
6367,0.001499,172.31.47.0-255,66,90579,92,273561
6368,0.001503,74.125.24.0-255,5738,96317,92,273561
6369,0.001505,172.31.47.0-255,66,96383,92,273561
6370,0.001542,74.125.24.0-255,2184,98567,92,273561
6371,0.001545,172.31.47.0-255,66,98633,92,273561
6372,0.001896,74.125.24.0-255,1484,100117,92,273561
6373,0.001911,74.125.24.0-255,2902,103019,92,273561
6374,0.001914,172.31.47.0-255,66,103085,92,273561
6375,0.001933,74.125.24.0-255,5738,108823,92,273561
6376,0.001935,172.31.47.0-255,66,108889,92,273561
6377,0.001947,74.125.24.0-255,1484,110373,92,273561
6378,0.001968,74.125.24.0-255,7156,117529,92,273561
6379,0.00197,172.31.47.0-255,66,117595,92,273561
6380,0.001978,172.31.47.0-255,66,117661,92,273561
6381,0.002002,74.125.24.0-255,4320,121981,92,273561
6382,0.002004,172.31.47.0-255,66,122047,92,273561
6383,0.002019,74.125.24.0-255,766,122813,92,273561
6384,0.002184,172.31.47.0-255,66,122879,92,273561
6385,0.004321,74.125.24.0-255,2902,125781,92,273561
6386,0.004326,172.31.47.0-255,66,125847,92,273561
6387,0.004342,74.125.24.0-255,1484,127331,92,273561
6388,0.004482,74.125.24.0-255,1484,128815,92,273561
6389,0.004487,172.31.47.0-255,66,128881,92,273561
6390,0.00663,74.125.24.0-255,2902,131783,92,273561
6391,0.006635,172.31.47.0-255,66,131849,92,273561
6392,0.006811,74.125.24.0-255,2902,134751,92,273561
6393,0.006816,172.31.47.0-255,66,134817,92,273561
6394,0.009066,74.125.24.0-255,2902,137719,92,273561
6395,0.009119,172.31.47.0-255,66,137785,92,273561
6396,0.009364,74.125.24.0-255,2902,140687,92,273561
6397,0.009409,172.31.47.0-255,66,140753,92,273561
6398,0.011446,74.125.24.0-255,2902,143655,92,273561
6399,0.011452,172.31.47.0-255,66,143721,92,273561
6400,0.011722,74.125.24.0-255,2902,146623,92,273561
6401,0.011728,172.31.47.0-255,66,146689,92,273561
6402,0.013756,74.125.24.0-255,2902,149591,92,273561
6403,0.013763,172.31.47.0-255,66,149657,92,273561
6404,0.014032,74.125.24.0-255,2902,152559,92,273561
6405,0.014039,172.31.47.0-255,66,152625,92,273561
6406,0.0161,74.125.24.0-255,2902,155527,92,273561
6407,0.016106,172.31.47.0-255,66,155593,92,273561
6408,0.016374,74.125.24.0-255,2902,158495,92,273561
6409,0.016377,172.31.47.0-255,66,158561,92,273561
6410,0.018426,74.125.24.0-255,2902,161463,92,273561
6411,0.01843,172.31.47.0-255,66,161529,92,273561
6412,0.018665,74.125.24.0-255,2902,164431,92,273561
6413,0.018668,172.31.47.0-255,66,164497,92,273561
6414,0.020721,74.125.24.0-255,2902,167399,92,273561
6415,0.020727,172.31.47.0-255,66,167465,92,273561
6416,0.020966,74.125.24.0-255,2902,170367,92,273561
6417,0.020972,172.31.47.0-255,66,170433,92,273561
6418,0.023029,74.125.24.0-255,2902,173335,92,273561
6419,0.023039,172.31.47.0-255,66,173401,92,273561
6420,0.023283,74.125.24.0-255,2902,176303,92,273561
6421,0.023289,172.31.47.0-255,66,176369,92,273561
6422,0.024216,172.31.47.0-255,190,176559,92,273561
6423,0.02426,172.31.47.0-255,1111,177670,92,273561
6424,0.024337,172.31.47.0-255,1514,179184,92,273561
6425,0.024339,172.31.47.0-255,1514,180698,92,273561
6426,0.02434,172.31.47.0-255,1514,182212,92,273561
6427,0.024341,172.31.47.0-255,1514,183726,92,273561
6428,0.024343,172.31.47.0-255,531,184257,92,273561
6429,0.025327,74.125.24.0-255,2902,187159,92,273561
6430,0.025332,172.31.47.0-255,66,187225,92,273561
6431,0.02559,74.125.24.0-255,2902,190127,92,273561
6432,0.025595,172.31.47.0-255,66,190193,92,273561
6433,0.025767,104.244.42.0-255,66,190259,92,273561
6434,0.025832,104.244.42.0-255,66,190325,92,273561
6435,0.025943,104.244.42.0-255,66,190391,92,273561
6436,0.025945,104.244.42.0-255,66,190457,92,273561
6437,0.027653,74.125.24.0-255,2902,193359,92,273561
6438,0.027657,172.31.47.0-255,66,193425,92,273561
6439,0.027888,74.125.24.0-255,2902,196327,92,273561
6440,0.027907,172.31.47.0-255,66,196393,92,273561
6441,0.030011,74.125.24.0-255,2902,199295,92,273561
6442,0.030017,172.31.47.0-255,66,199361,92,273561
6443,0.030203,74.125.24.0-255,2902,202263,92,273561
6444,0.030209,172.31.47.0-255,66,202329,92,273561
6445,0.032324,74.125.24.0-255,2902,205231,92,273561
6446,0.032329,172.31.47.0-255,66,205297,92,273561
6447,0.032507,74.125.24.0-255,2902,208199,92,273561
6448,0.032512,172.31.47.0-255,66,208265,92,273561
6449,0.034628,74.125.24.0-255,2902,211167,92,273561
6450,0.034633,172.31.47.0-255,66,211233,92,273561
6451,0.034818,74.125.24.0-255,2902,214135,92,273561
6452,0.034823,172.31.47.0-255,66,214201,92,273561
6453,0.036937,74.125.24.0-255,2902,217103,92,273561
6454,0.036941,172.31.47.0-255,66,217169,92,273561
6455,0.037165,74.125.24.0-255,2902,220071,92,273561
6456,0.037171,172.31.47.0-255,66,220137,92,273561
6457,0.039246,74.125.24.0-255,2902,223039,92,273561
6458,0.039253,172.31.47.0-255,66,223105,92,273561
6459,0.039482,74.125.24.0-255,2902,226007,92,273561
6460,0.039487,172.31.47.0-255,66,226073,92,273561
6461,0.041571,74.125.24.0-255,2902,228975,92,273561
6462,0.041577,172.31.47.0-255,66,229041,92,273561
6463,0.041789,74.125.24.0-255,2902,231943,92,273561
6464,0.041794,172.31.47.0-255,66,232009,92,273561
6465,0.043904,74.125.24.0-255,2902,234911,92,273561
6466,0.043911,172.31.47.0-255,66,234977,92,273561
6467,0.044077,74.125.24.0-255,2902,237879,92,273561
6468,0.044085,172.31.47.0-255,66,237945,92,273561
6469,0.046231,74.125.24.0-255,2902,240847,92,273561
6470,0.046237,172.31.47.0-255,66,240913,92,273561
6471,0.046398,74.125.24.0-255,2902,243815,92,273561
6472,0.046403,172.31.47.0-255,66,243881,92,273561
6473,0.04852,74.125.24.0-255,2902,246783,92,273561
6474,0.048525,172.31.47.0-255,66,246849,92,273561
6475,0.048717,74.125.24.0-255,2902,249751,92,273561
6476,0.048722,172.31.47.0-255,66,249817,92,273561
6477,0.050822,74.125.24.0-255,2902,252719,92,273561
6478,0.050827,172.31.47.0-255,66,252785,92,273561
6479,0.051039,74.125.24.0-255,2902,255687,92,273561
6480,0.051045,172.31.47.0-255,66,255753,92,273561
6481,0.053176,74.125.24.0-255,2902,258655,92,273561
6482,0.053183,172.31.47.0-255,66,258721,92,273561
6483,0.053339,74.125.24.0-255,2902,261623,92,273561
6484,0.053344,172.31.47.0-255,66,261689,92,273561
6485,0.055496,74.125.24.0-255,2902,264591,92,273561
6486,0.055503,172.31.47.0-255,66,264657,92,273561
6487,0.055652,74.125.24.0-255,2902,267559,92,273561
6488,0.055658,172.31.47.0-255,66,267625,92,273561
6489,0.057838,74.125.24.0-255,2902,270527,92,273561
6490,0.057844,172.31.47.0-255,66,270593,92,273561
6491,0.05798,74.125.24.0-255,2902,273495,92,273561
6492,0.057984,172.31.47.0-255,66,273561,92,273561
6493,0.0,74.125.24.0-255,153,153,92,315396
6494,1.3e-05,172.31.47.0-255,66,219,92,315396
6495,1.9e-05,74.125.24.0-255,1484,1703,92,315396
6496,2.3e-05,172.31.47.0-255,66,1769,92,315396
6497,3e-05,74.125.24.0-255,2902,4671,92,315396
6498,3.3e-05,172.31.47.0-255,66,4737,92,315396
6499,5.9e-05,74.125.24.0-255,5738,10475,92,315396
6500,6.2e-05,172.31.47.0-255,66,10541,92,315396
6501,8.1e-05,74.125.24.0-255,1484,12025,92,315396
6502,8.3e-05,172.31.47.0-255,66,12091,92,315396
6503,9.5e-05,172.31.47.0-255,66,12157,92,315396
6504,0.00011,74.125.24.0-255,2902,15059,92,315396
6505,0.000112,172.31.47.0-255,66,15125,92,315396
6506,0.000135,172.31.47.0-255,66,15191,92,315396
6507,0.000219,74.125.24.0-255,1484,16675,92,315396
6508,0.000223,172.31.47.0-255,66,16741,92,315396
6509,0.000228,74.125.24.0-255,2902,19643,92,315396
6510,0.000231,172.31.47.0-255,66,19709,92,315396
6511,0.000235,74.125.24.0-255,4320,24029,92,315396
6512,0.000238,172.31.47.0-255,66,24095,92,315396
6513,0.000258,74.125.24.0-255,1484,25579,92,315396
6514,0.00026,172.31.47.0-255,66,25645,92,315396
6515,0.000265,74.125.24.0-255,2902,28547,92,315396
6516,0.000267,172.31.47.0-255,66,28613,92,315396
6517,0.000291,172.31.47.0-255,66,28679,92,315396
6518,0.000295,74.125.24.0-255,2902,31581,92,315396
6519,0.000297,172.31.47.0-255,66,31647,92,315396
6520,0.000326,172.31.47.0-255,66,31713,92,315396
6521,0.000329,74.125.24.0-255,1434,33147,92,315396
6522,0.000346,74.125.24.0-255,379,33526,92,315396
6523,0.000348,172.31.47.0-255,66,33592,92,315396
6524,0.000822,74.125.24.0-255,1484,35076,92,315396
6525,0.000829,74.125.24.0-255,2902,37978,92,315396
6526,0.000832,172.31.47.0-255,66,38044,92,315396
6527,0.000839,74.125.24.0-255,5738,43782,92,315396
6528,0.000841,172.31.47.0-255,66,43848,92,315396
6529,0.000863,74.125.24.0-255,5738,49586,92,315396
6530,0.000866,172.31.47.0-255,66,49652,92,315396
6531,0.000888,74.125.24.0-255,7156,56808,92,315396
6532,0.000891,172.31.47.0-255,66,56874,92,315396
6533,0.000898,74.125.24.0-255,7156,64030,92,315396
6534,0.000901,172.31.47.0-255,66,64096,92,315396
6535,0.000919,74.125.24.0-255,1484,65580,92,315396
6536,0.000938,74.125.24.0-255,2184,67764,92,315396
6537,0.000941,172.31.47.0-255,66,67830,92,315396
6538,0.001049,74.125.24.0-255,1484,69314,92,315396
6539,0.001055,74.125.24.0-255,2902,72216,92,315396
6540,0.001058,172.31.47.0-255,66,72282,92,315396
6541,0.001078,74.125.24.0-255,2902,75184,92,315396
6542,0.001081,172.31.47.0-255,66,75250,92,315396
6543,0.001087,74.125.24.0-255,4320,79570,92,315396
6544,0.001089,172.31.47.0-255,66,79636,92,315396
6545,0.00112,172.31.47.0-255,66,79702,92,315396
6546,0.001126,74.125.24.0-255,4320,84022,92,315396
6547,0.001128,172.31.47.0-255,66,84088,92,315396
6548,0.00115,172.31.47.0-255,66,84154,92,315396
6549,0.001163,74.125.24.0-255,766,84920,92,315396
6550,0.001182,74.125.24.0-255,1484,86404,92,315396
6551,0.001185,172.31.47.0-255,66,86470,92,315396
6552,0.00119,74.125.24.0-255,4320,90790,92,315396
6553,0.001193,172.31.47.0-255,66,90856,92,315396
6554,0.001212,74.125.24.0-255,5738,96594,92,315396
6555,0.001216,172.31.47.0-255,66,96660,92,315396
6556,0.001226,74.125.24.0-255,4320,100980,92,315396
6557,0.001228,172.31.47.0-255,66,101046,92,315396
6558,0.001255,74.125.24.0-255,1484,102530,92,315396
6559,0.001283,172.31.47.0-255,66,102596,92,315396
6560,0.00129,74.125.24.0-255,6438,109034,92,315396
6561,0.001293,172.31.47.0-255,66,109100,92,315396
6562,0.001347,74.125.24.0-255,1484,110584,92,315396
6563,0.001353,74.125.24.0-255,2902,113486,92,315396
6564,0.001356,172.31.47.0-255,66,113552,92,315396
6565,0.001361,74.125.24.0-255,2902,116454,92,315396
6566,0.001364,172.31.47.0-255,66,116520,92,315396
6567,0.001395,74.125.24.0-255,2902,119422,92,315396
6568,0.001401,74.125.24.0-255,5738,125160,92,315396
6569,0.001417,172.31.47.0-255,66,125226,92,315396
6570,0.00142,172.31.47.0-255,66,125292,92,315396
6571,0.001423,172.31.47.0-255,66,125358,92,315396
6572,0.001433,74.125.24.0-255,5020,130378,92,315396
6573,0.001436,172.31.47.0-255,66,130444,92,315396
6574,0.001535,74.125.24.0-255,1484,131928,92,315396
6575,0.001541,74.125.24.0-255,2902,134830,92,315396
6576,0.001544,172.31.47.0-255,66,134896,92,315396
6577,0.00155,74.125.24.0-255,4320,139216,92,315396
6578,0.001552,172.31.47.0-255,66,139282,92,315396
6579,0.001564,74.125.24.0-255,1484,140766,92,315396
6580,0.001567,74.125.24.0-255,1484,142250,92,315396
6581,0.001569,172.31.47.0-255,66,142316,92,315396
6582,0.001609,74.125.24.0-255,7156,149472,92,315396
6583,0.001613,172.31.47.0-255,66,149538,92,315396
6584,0.00162,172.31.47.0-255,66,149604,92,315396
6585,0.00164,74.125.24.0-255,3602,153206,92,315396
6586,0.001643,172.31.47.0-255,66,153272,92,315396
6587,0.001754,74.125.24.0-255,1484,154756,92,315396
6588,0.00178,74.125.24.0-255,2902,157658,92,315396
6589,0.001783,172.31.47.0-255,66,157724,92,315396
6590,0.001786,74.125.24.0-255,1484,159208,92,315396
6591,0.001803,74.125.24.0-255,2902,162110,92,315396
6592,0.001806,172.31.47.0-255,66,162176,92,315396
6593,0.00184,172.31.47.0-255,66,162242,92,315396
6594,0.00185,172.31.47.0-255,66,162308,92,315396
6595,0.001874,172.31.47.0-255,66,162374,92,315396
6596,0.004124,74.125.24.0-255,5738,168112,92,315396
6597,0.004132,172.31.47.0-255,66,168178,92,315396
6598,0.006416,74.125.24.0-255,5738,173916,92,315396
6599,0.006423,172.31.47.0-255,66,173982,92,315396
6600,0.00868,74.125.24.0-255,4320,178302,92,315396
6601,0.008684,172.31.47.0-255,66,178368,92,315396
6602,0.008703,74.125.24.0-255,1484,179852,92,315396
6603,0.010972,74.125.24.0-255,4320,184172,92,315396
6604,0.01098,172.31.47.0-255,66,184238,92,315396
6605,0.013294,74.125.24.0-255,5738,189976,92,315396
6606,0.013303,172.31.47.0-255,66,190042,92,315396
6607,0.015555,74.125.24.0-255,5738,195780,92,315396
6608,0.015561,172.31.47.0-255,66,195846,92,315396
6609,0.017844,74.125.24.0-255,5738,201584,92,315396
6610,0.017852,172.31.47.0-255,66,201650,92,315396
6611,0.020119,74.125.24.0-255,5738,207388,92,315396
6612,0.020127,172.31.47.0-255,66,207454,92,315396
6613,0.02241,74.125.24.0-255,5738,213192,92,315396
6614,0.022422,172.31.47.0-255,66,213258,92,315396
6615,0.024686,74.125.24.0-255,5738,218996,92,315396
6616,0.024693,172.31.47.0-255,66,219062,92,315396
6617,0.026954,74.125.24.0-255,5738,224800,92,315396
6618,0.026961,172.31.47.0-255,66,224866,92,315396
6619,0.029254,74.125.24.0-255,5738,230604,92,315396
6620,0.029262,172.31.47.0-255,66,230670,92,315396
6621,0.031542,74.125.24.0-255,5738,236408,92,315396
6622,0.031552,172.31.47.0-255,66,236474,92,315396
6623,0.033827,74.125.24.0-255,5738,242212,92,315396
6624,0.033838,172.31.47.0-255,66,242278,92,315396
6625,0.036032,172.31.47.0-255,172,242450,92,315396
6626,0.036065,172.31.47.0-255,1112,243562,92,315396
6627,0.036125,74.125.24.0-255,5738,249300,92,315396
6628,0.03613,172.31.47.0-255,66,249366,92,315396
6629,0.036157,172.31.47.0-255,1514,250880,92,315396
6630,0.036159,172.31.47.0-255,1514,252394,92,315396
6631,0.03616,172.31.47.0-255,1514,253908,92,315396
6632,0.036161,172.31.47.0-255,1514,255422,92,315396
6633,0.036162,172.31.47.0-255,1496,256918,92,315396
6634,0.037586,104.244.42.0-255,66,256984,92,315396
6635,0.037595,104.244.42.0-255,66,257050,92,315396
6636,0.037713,104.244.42.0-255,66,257116,92,315396
6637,0.037756,104.244.42.0-255,66,257182,92,315396
6638,0.038352,104.244.42.0-255,108,257290,92,315396
6639,0.038359,172.31.47.0-255,66,257356,92,315396
6640,0.03838,74.125.24.0-255,5738,263094,92,315396
6641,0.038382,172.31.47.0-255,66,263160,92,315396
6642,0.040664,74.125.24.0-255,5738,268898,92,315396
6643,0.04067,172.31.47.0-255,66,268964,92,315396
6644,0.04294,74.125.24.0-255,5738,274702,92,315396
6645,0.042947,172.31.47.0-255,66,274768,92,315396
6646,0.045197,74.125.24.0-255,5738,280506,92,315396
6647,0.045205,172.31.47.0-255,66,280572,92,315396
6648,0.047486,74.125.24.0-255,5738,286310,92,315396
6649,0.047492,172.31.47.0-255,66,286376,92,315396
6650,0.049766,74.125.24.0-255,5738,292114,92,315396
6651,0.049772,172.31.47.0-255,66,292180,92,315396
6652,0.052042,74.125.24.0-255,5738,297918,92,315396
6653,0.052049,172.31.47.0-255,66,297984,92,315396
6654,0.054306,74.125.24.0-255,5738,303722,92,315396
6655,0.054312,172.31.47.0-255,66,303788,92,315396
6656,0.056577,74.125.24.0-255,5738,309526,92,315396
6657,0.056584,172.31.47.0-255,66,309592,92,315396
6658,0.05883,74.125.24.0-255,5738,315330,92,315396
6659,0.058835,172.31.47.0-255,66,315396,92,315396
6660,0.0,172.217.194.0-255,152,152,92,249876
6661,2.3e-05,172.31.47.0-255,66,218,92,249876
6662,3.1e-05,172.217.194.0-255,1484,1702,92,249876
6663,3.5e-05,172.31.47.0-255,66,1768,92,249876
6664,4.2e-05,172.217.194.0-255,2902,4670,92,249876
6665,4.5e-05,172.31.47.0-255,66,4736,92,249876
6666,7.6e-05,172.217.194.0-255,1484,6220,92,249876
6667,7.9e-05,172.31.47.0-255,66,6286,92,249876
6668,0.000104,172.217.194.0-255,5738,12024,92,249876
6669,0.000107,172.31.47.0-255,66,12090,92,249876
6670,0.00023,172.217.194.0-255,2042,14132,92,249876
6671,0.000234,172.31.47.0-255,66,14198,92,249876
6672,0.000274,172.217.194.0-255,7156,21354,92,249876
6673,0.000278,172.31.47.0-255,66,21420,92,249876
6674,0.000295,172.217.194.0-255,2902,24322,92,249876
6675,0.000298,172.31.47.0-255,66,24388,92,249876
6676,0.000487,172.217.194.0-255,5738,30126,92,249876
6677,0.000493,172.31.47.0-255,66,30192,92,249876
6678,0.00051,172.217.194.0-255,1125,31317,92,249876
6679,0.000514,172.31.47.0-255,66,31383,92,249876
6680,0.000634,172.217.194.0-255,5738,37121,92,249876
6681,0.000638,172.31.47.0-255,66,37187,92,249876
6682,0.000651,172.217.194.0-255,1484,38671,92,249876
6683,0.000653,172.31.47.0-255,66,38737,92,249876
6684,0.00079,172.31.47.0-255,66,38803,92,249876
6685,0.000964,172.217.194.0-255,1484,40287,92,249876
6686,0.000968,172.31.47.0-255,66,40353,92,249876
6687,0.001011,172.217.194.0-255,2902,43255,92,249876
6688,0.001014,172.31.47.0-255,66,43321,92,249876
6689,0.001069,172.217.194.0-255,5738,49059,92,249876
6690,0.001073,172.31.47.0-255,66,49125,92,249876
6691,0.001193,172.217.194.0-255,6797,55922,92,249876
6692,0.001197,172.31.47.0-255,66,55988,92,249876
6693,0.001305,172.217.194.0-255,365,56353,92,249876
6694,0.001423,172.217.194.0-255,380,56733,92,249876
6695,0.001617,172.217.194.0-255,1484,58217,92,249876
6696,0.001624,172.31.47.0-255,66,58283,92,249876
6697,0.00163,172.217.194.0-255,1484,59767,92,249876
6698,0.001644,172.217.194.0-255,1484,61251,92,249876
6699,0.001646,172.31.47.0-255,66,61317,92,249876
6700,0.001677,172.217.194.0-255,2902,64219,92,249876
6701,0.00168,172.31.47.0-255,66,64285,92,249876
6702,0.001699,172.217.194.0-255,2902,67187,92,249876
6703,0.001701,172.31.47.0-255,66,67253,92,249876
6704,0.001815,172.217.194.0-255,4320,71573,92,249876
6705,0.001819,172.31.47.0-255,66,71639,92,249876
6706,0.001837,172.217.194.0-255,2543,74182,92,249876
6707,0.001839,172.31.47.0-255,66,74248,92,249876
6708,0.00195,172.217.194.0-255,2902,77150,92,249876
6709,0.001954,172.31.47.0-255,66,77216,92,249876
6710,0.002,172.217.194.0-255,2902,80118,92,249876
6711,0.002002,172.31.47.0-255,66,80184,92,249876
6712,0.002019,172.31.47.0-255,66,80250,92,249876
6713,0.00224,172.217.194.0-255,2543,82793,92,249876
6714,0.002244,172.31.47.0-255,66,82859,92,249876
6715,0.004122,172.217.194.0-255,2902,85761,92,249876
6716,0.004127,172.31.47.0-255,66,85827,92,249876
6717,0.004357,172.217.194.0-255,2902,88729,92,249876
6718,0.00436,172.31.47.0-255,66,88795,92,249876
6719,0.006207,172.217.194.0-255,2902,91697,92,249876
6720,0.00621,172.31.47.0-255,66,91763,92,249876
6721,0.006445,172.217.194.0-255,2902,94665,92,249876
6722,0.006451,172.31.47.0-255,66,94731,92,249876
6723,0.008312,172.217.194.0-255,2902,97633,92,249876
6724,0.008318,172.31.47.0-255,66,97699,92,249876
6725,0.008556,172.217.194.0-255,2902,100601,92,249876
6726,0.00856,172.31.47.0-255,66,100667,92,249876
6727,0.010424,172.217.194.0-255,2902,103569,92,249876
6728,0.010432,172.31.47.0-255,66,103635,92,249876
6729,0.010658,172.217.194.0-255,2902,106537,92,249876
6730,0.010664,172.31.47.0-255,66,106603,92,249876
6731,0.012555,172.217.194.0-255,2902,109505,92,249876
6732,0.012562,172.31.47.0-255,66,109571,92,249876
6733,0.012794,172.217.194.0-255,2902,112473,92,249876
6734,0.0128,172.31.47.0-255,66,112539,92,249876
6735,0.014699,172.217.194.0-255,2902,115441,92,249876
6736,0.014708,172.31.47.0-255,66,115507,92,249876
6737,0.014912,172.217.194.0-255,2902,118409,92,249876
6738,0.014918,172.31.47.0-255,66,118475,92,249876
6739,0.016836,172.217.194.0-255,2902,121377,92,249876
6740,0.016844,172.31.47.0-255,66,121443,92,249876
6741,0.017031,172.217.194.0-255,1484,122927,92,249876
6742,0.017049,172.217.194.0-255,1484,124411,92,249876
6743,0.017053,172.31.47.0-255,66,124477,92,249876
6744,0.018957,172.217.194.0-255,2902,127379,92,249876
6745,0.018964,172.31.47.0-255,66,127445,92,249876
6746,0.019148,172.217.194.0-255,2902,130347,92,249876
6747,0.019153,172.31.47.0-255,66,130413,92,249876
6748,0.021099,172.217.194.0-255,2902,133315,92,249876
6749,0.021108,172.31.47.0-255,66,133381,92,249876
6750,0.021251,172.217.194.0-255,2902,136283,92,249876
6751,0.021256,172.31.47.0-255,66,136349,92,249876
6752,0.02323,172.217.194.0-255,2902,139251,92,249876
6753,0.023238,172.31.47.0-255,66,139317,92,249876
6754,0.023349,172.217.194.0-255,2902,142219,92,249876
6755,0.023356,172.31.47.0-255,66,142285,92,249876
6756,0.025354,172.217.194.0-255,2902,145187,92,249876
6757,0.025362,172.31.47.0-255,66,145253,92,249876
6758,0.025469,172.217.194.0-255,2902,148155,92,249876
6759,0.025473,172.31.47.0-255,66,148221,92,249876
6760,0.027483,172.217.194.0-255,2902,151123,92,249876
6761,0.027491,172.31.47.0-255,66,151189,92,249876
6762,0.027584,172.217.194.0-255,2902,154091,92,249876
6763,0.02759,172.31.47.0-255,66,154157,92,249876
6764,0.029624,172.217.194.0-255,2902,157059,92,249876
6765,0.029632,172.31.47.0-255,66,157125,92,249876
6766,0.029692,172.217.194.0-255,2902,160027,92,249876
6767,0.029696,172.31.47.0-255,66,160093,92,249876
6768,0.031733,172.217.194.0-255,2902,162995,92,249876
6769,0.031741,172.31.47.0-255,66,163061,92,249876
6770,0.031776,172.217.194.0-255,2902,165963,92,249876
6771,0.031779,172.31.47.0-255,66,166029,92,249876
6772,0.033113,172.31.47.0-255,171,166200,92,249876
6773,0.033142,172.31.47.0-255,1136,167336,92,249876
6774,0.033212,172.31.47.0-255,1514,168850,92,249876
6775,0.033214,172.31.47.0-255,1514,170364,92,249876
6776,0.033215,172.31.47.0-255,1514,171878,92,249876
6777,0.033216,172.31.47.0-255,1514,173392,92,249876
6778,0.033217,172.31.47.0-255,330,173722,92,249876
6779,0.033855,172.217.194.0-255,2902,176624,92,249876
6780,0.033861,172.31.47.0-255,66,176690,92,249876
6781,0.033883,172.217.194.0-255,2902,179592,92,249876
6782,0.033885,172.31.47.0-255,66,179658,92,249876
6783,0.034664,104.244.42.0-255,66,179724,92,249876
6784,0.034712,104.244.42.0-255,66,179790,92,249876
6785,0.034816,104.244.42.0-255,66,179856,92,249876
6786,0.034822,104.244.42.0-255,66,179922,92,249876
6787,0.035396,104.244.42.0-255,108,180030,92,249876
6788,0.035403,172.31.47.0-255,66,180096,92,249876
6789,0.035995,172.217.194.0-255,2902,182998,92,249876
6790,0.036002,172.31.47.0-255,66,183064,92,249876
6791,0.036019,172.217.194.0-255,2902,185966,92,249876
6792,0.036022,172.31.47.0-255,66,186032,92,249876
6793,0.038121,172.217.194.0-255,5738,191770,92,249876
6794,0.038128,172.31.47.0-255,66,191836,92,249876
6795,0.040245,172.217.194.0-255,5738,197574,92,249876
6796,0.040251,172.31.47.0-255,66,197640,92,249876
6797,0.042383,172.217.194.0-255,5738,203378,92,249876
6798,0.042391,172.31.47.0-255,66,203444,92,249876
6799,0.044504,172.217.194.0-255,5738,209182,92,249876
6800,0.04451,172.31.47.0-255,66,209248,92,249876
6801,0.046652,172.217.194.0-255,5738,214986,92,249876
6802,0.046657,172.31.47.0-255,66,215052,92,249876
6803,0.048777,172.217.194.0-255,5738,220790,92,249876
6804,0.048783,172.31.47.0-255,66,220856,92,249876
6805,0.050909,172.217.194.0-255,5738,226594,92,249876
6806,0.050914,172.31.47.0-255,66,226660,92,249876
6807,0.053045,172.217.194.0-255,5738,232398,92,249876
6808,0.053052,172.31.47.0-255,66,232464,92,249876
6809,0.055176,172.217.194.0-255,5738,238202,92,249876
6810,0.055182,172.31.47.0-255,66,238268,92,249876
6811,0.057313,172.217.194.0-255,5738,244006,92,249876
6812,0.057327,172.31.47.0-255,66,244072,92,249876
6813,0.059465,172.217.194.0-255,5738,249810,92,249876
6814,0.059473,172.31.47.0-255,66,249876,92,249876
6815,0.0,74.125.24.0-255,153,153,92,240559
6816,2.9e-05,172.31.47.0-255,66,219,92,240559
6817,3.5e-05,74.125.24.0-255,1484,1703,92,240559
6818,4e-05,172.31.47.0-255,66,1769,92,240559
6819,5.2e-05,74.125.24.0-255,2902,4671,92,240559
6820,5.6e-05,172.31.47.0-255,66,4737,92,240559
6821,6.1e-05,74.125.24.0-255,5738,10475,92,240559
6822,6.4e-05,172.31.47.0-255,66,10541,92,240559
6823,9.8e-05,74.125.24.0-255,3556,14097,92,240559
6824,0.000101,172.31.47.0-255,66,14163,92,240559
6825,0.001175,74.125.24.0-255,1484,15647,92,240559
6826,0.001182,172.31.47.0-255,66,15713,92,240559
6827,0.001192,74.125.24.0-255,2902,18615,92,240559
6828,0.001194,172.31.47.0-255,66,18681,92,240559
6829,0.001205,74.125.24.0-255,5738,24419,92,240559
6830,0.001207,172.31.47.0-255,66,24485,92,240559
6831,0.001211,74.125.24.0-255,2902,27387,92,240559
6832,0.001213,172.31.47.0-255,66,27453,92,240559
6833,0.00124,74.125.24.0-255,2902,30355,92,240559
6834,0.001246,172.31.47.0-255,66,30421,92,240559
6835,0.001283,172.31.47.0-255,66,30487,92,240559
6836,0.001289,74.125.24.0-255,5738,36225,92,240559
6837,0.001291,172.31.47.0-255,66,36291,92,240559
6838,0.001295,74.125.24.0-255,2902,39193,92,240559
6839,0.001297,172.31.47.0-255,66,39259,92,240559
6840,0.001344,172.31.47.0-255,66,39325,92,240559
6841,0.001348,74.125.24.0-255,2184,41509,92,240559
6842,0.00135,172.31.47.0-255,66,41575,92,240559
6843,0.001352,74.125.24.0-255,363,41938,92,240559
6844,0.001354,172.31.47.0-255,66,42004,92,240559
6845,0.001519,74.125.24.0-255,380,42384,92,240559
6846,0.001716,74.125.24.0-255,1484,43868,92,240559
6847,0.00172,172.31.47.0-255,66,43934,92,240559
6848,0.001724,74.125.24.0-255,1484,45418,92,240559
6849,0.001748,74.125.24.0-255,1484,46902,92,240559
6850,0.001752,74.125.24.0-255,4320,51222,92,240559
6851,0.001757,172.31.47.0-255,66,51288,92,240559
6852,0.00176,172.31.47.0-255,66,51354,92,240559
6853,0.00178,74.125.24.0-255,1484,52838,92,240559
6854,0.001785,74.125.24.0-255,4320,57158,92,240559
6855,0.001787,172.31.47.0-255,66,57224,92,240559
6856,0.001798,172.31.47.0-255,66,57290,92,240559
6857,0.00184,172.31.47.0-255,66,57356,92,240559
6858,0.00193,74.125.24.0-255,1484,58840,92,240559
6859,0.001951,74.125.24.0-255,2902,61742,92,240559
6860,0.001955,172.31.47.0-255,66,61808,92,240559
6861,0.001958,74.125.24.0-255,1484,63292,92,240559
6862,0.001986,74.125.24.0-255,4320,67612,92,240559
6863,0.001988,172.31.47.0-255,66,67678,92,240559
6864,0.001993,74.125.24.0-255,5738,73416,92,240559
6865,0.001995,172.31.47.0-255,66,73482,92,240559
6866,0.001999,74.125.24.0-255,4320,77802,92,240559
6867,0.002007,172.31.47.0-255,66,77868,92,240559
6868,0.002049,172.31.47.0-255,66,77934,92,240559
6869,0.002054,74.125.24.0-255,5020,82954,92,240559
6870,0.002056,172.31.47.0-255,66,83020,92,240559
6871,0.002254,74.125.24.0-255,1484,84504,92,240559
6872,0.00228,74.125.24.0-255,2902,87406,92,240559
6873,0.002283,172.31.47.0-255,66,87472,92,240559
6874,0.002289,74.125.24.0-255,5738,93210,92,240559
6875,0.002291,172.31.47.0-255,66,93276,92,240559
6876,0.002373,172.31.47.0-255,66,93342,92,240559
6877,0.002384,172.31.47.0-255,66,93408,92,240559
6878,0.004729,74.125.24.0-255,5738,99146,92,240559
6879,0.004736,172.31.47.0-255,66,99212,92,240559
6880,0.00709,74.125.24.0-255,5738,104950,92,240559
6881,0.007097,172.31.47.0-255,66,105016,92,240559
6882,0.00951,74.125.24.0-255,5738,110754,92,240559
6883,0.009519,172.31.47.0-255,66,110820,92,240559
6884,0.01185,74.125.24.0-255,5738,116558,92,240559
6885,0.011857,172.31.47.0-255,66,116624,92,240559
6886,0.014192,74.125.24.0-255,5738,122362,92,240559
6887,0.014202,172.31.47.0-255,66,122428,92,240559
6888,0.016585,74.125.24.0-255,4320,126748,92,240559
6889,0.016592,172.31.47.0-255,66,126814,92,240559
6890,0.016622,74.125.24.0-255,1484,128298,92,240559
6891,0.01896,74.125.24.0-255,4320,132618,92,240559
6892,0.018967,172.31.47.0-255,66,132684,92,240559
6893,0.02132,74.125.24.0-255,5738,138422,92,240559
6894,0.021328,172.31.47.0-255,66,138488,92,240559
6895,0.023666,74.125.24.0-255,5738,144226,92,240559
6896,0.023673,172.31.47.0-255,66,144292,92,240559
6897,0.026022,74.125.24.0-255,5738,150030,92,240559
6898,0.026028,172.31.47.0-255,66,150096,92,240559
6899,0.026416,172.31.47.0-255,172,150268,92,240559
6900,0.026648,172.31.47.0-255,1103,151371,92,240559
6901,0.026713,172.31.47.0-255,1514,152885,92,240559
6902,0.026715,172.31.47.0-255,1514,154399,92,240559
6903,0.026716,172.31.47.0-255,1514,155913,92,240559
6904,0.026717,172.31.47.0-255,1514,157427,92,240559
6905,0.026743,172.31.47.0-255,1504,158931,92,240559
6906,0.027971,104.244.42.0-255,66,158997,92,240559
6907,0.028195,104.244.42.0-255,66,159063,92,240559
6908,0.028294,104.244.42.0-255,66,159129,92,240559
6909,0.0284,74.125.24.0-255,5738,164867,92,240559
6910,0.028406,172.31.47.0-255,66,164933,92,240559
6911,0.028734,104.244.42.0-255,108,165041,92,240559
6912,0.02874,172.31.47.0-255,66,165107,92,240559
6913,0.030761,74.125.24.0-255,5738,170845,92,240559
6914,0.030766,172.31.47.0-255,66,170911,92,240559
6915,0.033103,74.125.24.0-255,5738,176649,92,240559
6916,0.033108,172.31.47.0-255,66,176715,92,240559
6917,0.035478,74.125.24.0-255,5738,182453,92,240559
6918,0.035484,172.31.47.0-255,66,182519,92,240559
6919,0.037902,74.125.24.0-255,5738,188257,92,240559
6920,0.037922,172.31.47.0-255,66,188323,92,240559
6921,0.040303,74.125.24.0-255,5738,194061,92,240559
6922,0.040317,172.31.47.0-255,66,194127,92,240559
6923,0.042685,74.125.24.0-255,5738,199865,92,240559
6924,0.042696,172.31.47.0-255,66,199931,92,240559
6925,0.045054,74.125.24.0-255,5738,205669,92,240559
6926,0.045067,172.31.47.0-255,66,205735,92,240559
6927,0.047437,74.125.24.0-255,5738,211473,92,240559
6928,0.047453,172.31.47.0-255,66,211539,92,240559
6929,0.049822,74.125.24.0-255,5738,217277,92,240559
6930,0.04984,172.31.47.0-255,66,217343,92,240559
6931,0.052195,74.125.24.0-255,5738,223081,92,240559
6932,0.05221,172.31.47.0-255,66,223147,92,240559
6933,0.054591,74.125.24.0-255,5738,228885,92,240559
6934,0.054629,172.31.47.0-255,66,228951,92,240559
6935,0.057015,74.125.24.0-255,5738,234689,92,240559
6936,0.057028,172.31.47.0-255,66,234755,92,240559
6937,0.059365,74.125.24.0-255,5738,240493,92,240559
6938,0.059373,172.31.47.0-255,66,240559,92,240559
6939,0.0,74.125.24.0-255,153,153,92,242502
6940,1.6e-05,172.31.47.0-255,66,219,92,242502
6941,2.4e-05,74.125.24.0-255,1484,1703,92,242502
6942,2.8e-05,172.31.47.0-255,66,1769,92,242502
6943,3.3e-05,74.125.24.0-255,2902,4671,92,242502
6944,3.6e-05,172.31.47.0-255,66,4737,92,242502
6945,4.3e-05,74.125.24.0-255,7156,11893,92,242502
6946,4.6e-05,172.31.47.0-255,66,11959,92,242502
6947,7.4e-05,74.125.24.0-255,1983,13942,92,242502
6948,7.6e-05,172.31.47.0-255,66,14008,92,242502
6949,0.000125,74.125.24.0-255,1484,15492,92,242502
6950,0.000127,172.31.47.0-255,66,15558,92,242502
6951,0.000132,74.125.24.0-255,2902,18460,92,242502
6952,0.000134,172.31.47.0-255,66,18526,92,242502
6953,0.000164,74.125.24.0-255,5738,24264,92,242502
6954,0.000167,172.31.47.0-255,66,24330,92,242502
6955,0.000172,74.125.24.0-255,4320,28650,92,242502
6956,0.000174,172.31.47.0-255,66,28716,92,242502
6957,0.000191,74.125.24.0-255,1484,30200,92,242502
6958,0.000194,172.31.47.0-255,66,30266,92,242502
6959,0.000233,172.31.47.0-255,66,30332,92,242502
6960,0.00024,74.125.24.0-255,6797,37129,92,242502
6961,0.000242,172.31.47.0-255,66,37195,92,242502
6962,0.000767,74.125.24.0-255,1484,38679,92,242502
6963,0.000774,172.31.47.0-255,66,38745,92,242502
6964,0.00078,74.125.24.0-255,2902,41647,92,242502
6965,0.000782,172.31.47.0-255,66,41713,92,242502
6966,0.000785,74.125.24.0-255,1484,43197,92,242502
6967,0.000787,172.31.47.0-255,66,43263,92,242502
6968,0.000791,74.125.24.0-255,2902,46165,92,242502
6969,0.000794,172.31.47.0-255,66,46231,92,242502
6970,0.000814,74.125.24.0-255,1484,47715,92,242502
6971,0.000834,74.125.24.0-255,4320,52035,92,242502
6972,0.000837,172.31.47.0-255,66,52101,92,242502
6973,0.000858,74.125.24.0-255,2543,54644,92,242502
6974,0.000861,172.31.47.0-255,66,54710,92,242502
6975,0.000865,74.125.24.0-255,2902,57612,92,242502
6976,0.000867,172.31.47.0-255,66,57678,92,242502
6977,0.000878,74.125.24.0-255,1484,59162,92,242502
6978,0.000895,74.125.24.0-255,5738,64900,92,242502
6979,0.000898,172.31.47.0-255,66,64966,92,242502
6980,0.000903,74.125.24.0-255,4320,69286,92,242502
6981,0.000906,172.31.47.0-255,66,69352,92,242502
6982,0.000908,74.125.24.0-255,1484,70836,92,242502
6983,0.000943,172.31.47.0-255,66,70902,92,242502
6984,0.000952,74.125.24.0-255,6438,77340,92,242502
6985,0.000954,172.31.47.0-255,66,77406,92,242502
6986,0.001645,74.125.24.0-255,647,78053,92,242502
6987,0.001683,74.125.24.0-255,1484,79537,92,242502
6988,0.001688,172.31.47.0-255,66,79603,92,242502
6989,0.001693,74.125.24.0-255,1484,81087,92,242502
6990,0.001708,74.125.24.0-255,1484,82571,92,242502
6991,0.00171,172.31.47.0-255,66,82637,92,242502
6992,0.001716,74.125.24.0-255,2902,85539,92,242502
6993,0.001718,172.31.47.0-255,66,85605,92,242502
6994,0.00173,74.125.24.0-255,2902,88507,92,242502
6995,0.001733,172.31.47.0-255,66,88573,92,242502
6996,0.001767,74.125.24.0-255,1484,90057,92,242502
6997,0.001795,172.31.47.0-255,66,90123,92,242502
6998,0.001851,172.31.47.0-255,66,90189,92,242502
6999,0.003193,74.125.24.0-255,1484,91673,92,242502
7000,0.003201,74.125.24.0-255,2902,94575,92,242502
7001,0.003205,172.31.47.0-255,66,94641,92,242502
7002,0.003211,74.125.24.0-255,2902,97543,92,242502
7003,0.003212,172.31.47.0-255,66,97609,92,242502
7004,0.003218,74.125.24.0-255,4320,101929,92,242502
7005,0.00322,172.31.47.0-255,66,101995,92,242502
7006,0.003255,172.31.47.0-255,66,102061,92,242502
7007,0.003261,74.125.24.0-255,4320,106381,92,242502
7008,0.003263,172.31.47.0-255,66,106447,92,242502
7009,0.00331,172.31.47.0-255,66,106513,92,242502
7010,0.003593,74.125.24.0-255,1484,107997,92,242502
7011,0.003598,74.125.24.0-255,2902,110899,92,242502
7012,0.0036,172.31.47.0-255,66,110965,92,242502
7013,0.003622,74.125.24.0-255,5738,116703,92,242502
7014,0.003625,172.31.47.0-255,66,116769,92,242502
7015,0.003656,172.31.47.0-255,66,116835,92,242502
7016,0.003671,74.125.24.0-255,1484,118319,92,242502
7017,0.003682,172.31.47.0-255,66,118385,92,242502
7018,0.003699,74.125.24.0-255,1484,119869,92,242502
7019,0.003706,74.125.24.0-255,5738,125607,92,242502
7020,0.003709,172.31.47.0-255,66,125673,92,242502
7021,0.003729,74.125.24.0-255,5020,130693,92,242502
7022,0.003732,172.31.47.0-255,66,130759,92,242502
7023,0.003735,74.125.24.0-255,1484,132243,92,242502
7024,0.00376,172.31.47.0-255,66,132309,92,242502
7025,0.003762,74.125.24.0-255,1484,133793,92,242502
7026,0.003786,172.31.47.0-255,66,133859,92,242502
7027,0.003804,74.125.24.0-255,2902,136761,92,242502
7028,0.003806,172.31.47.0-255,66,136827,92,242502
7029,0.00383,74.125.24.0-255,4320,141147,92,242502
7030,0.003832,172.31.47.0-255,66,141213,92,242502
7031,0.003859,74.125.24.0-255,1484,142697,92,242502
7032,0.003888,74.125.24.0-255,7156,149853,92,242502
7033,0.003892,172.31.47.0-255,66,149919,92,242502
7034,0.003902,172.31.47.0-255,66,149985,92,242502
7035,0.003913,172.31.47.0-255,66,150051,92,242502
7036,0.00393,74.125.24.0-255,4320,154371,92,242502
7037,0.003933,172.31.47.0-255,66,154437,92,242502
7038,0.003954,172.31.47.0-255,66,154503,92,242502
7039,0.003961,74.125.24.0-255,7156,161659,92,242502
7040,0.003964,172.31.47.0-255,66,161725,92,242502
7041,0.003997,172.31.47.0-255,66,161791,92,242502
7042,0.004042,74.125.24.0-255,7156,168947,92,242502
7043,0.004045,172.31.47.0-255,66,169013,92,242502
7044,0.004061,74.125.24.0-255,2902,171915,92,242502
7045,0.004063,172.31.47.0-255,66,171981,92,242502
7046,0.004083,172.31.47.0-255,66,172047,92,242502
7047,0.004087,74.125.24.0-255,2184,174231,92,242502
7048,0.004089,172.31.47.0-255,66,174297,92,242502
7049,0.004093,74.125.24.0-255,2902,177199,92,242502
7050,0.004095,172.31.47.0-255,66,177265,92,242502
7051,0.004097,74.125.24.0-255,1484,178749,92,242502
7052,0.004104,74.125.24.0-255,5738,184487,92,242502
7053,0.004106,172.31.47.0-255,66,184553,92,242502
7054,0.004124,74.125.24.0-255,1484,186037,92,242502
7055,0.00415,74.125.24.0-255,7156,193193,92,242502
7056,0.004152,172.31.47.0-255,66,193259,92,242502
7057,0.004158,74.125.24.0-255,5738,198997,92,242502
7058,0.00416,172.31.47.0-255,66,199063,92,242502
7059,0.004176,74.125.24.0-255,4320,203383,92,242502
7060,0.004179,172.31.47.0-255,66,203449,92,242502
7061,0.004181,74.125.24.0-255,1484,204933,92,242502
7062,0.004203,74.125.24.0-255,3602,208535,92,242502
7063,0.004206,172.31.47.0-255,66,208601,92,242502
7064,0.004222,74.125.24.0-255,1484,210085,92,242502
7065,0.004226,74.125.24.0-255,2902,212987,92,242502
7066,0.004228,172.31.47.0-255,66,213053,92,242502
7067,0.004254,74.125.24.0-255,5738,218791,92,242502
7068,0.004257,172.31.47.0-255,66,218857,92,242502
7069,0.004262,74.125.24.0-255,4320,223177,92,242502
7070,0.004264,172.31.47.0-255,66,223243,92,242502
7071,0.004282,172.31.47.0-255,66,223309,92,242502
7072,0.004288,74.125.24.0-255,5738,229047,92,242502
7073,0.00429,172.31.47.0-255,66,229113,92,242502
7074,0.004305,74.125.24.0-255,1484,230597,92,242502
7075,0.00432,74.125.24.0-255,1484,232081,92,242502
7076,0.004322,172.31.47.0-255,66,232147,92,242502
7077,0.004353,172.31.47.0-255,66,232213,92,242502
7078,0.00438,172.31.47.0-255,66,232279,92,242502
7079,0.004382,74.125.24.0-255,849,233128,92,242502
7080,0.004386,74.125.24.0-255,105,233233,92,242502
7081,0.006689,172.31.47.0-255,66,233299,92,242502
7082,0.006723,172.31.47.0-255,105,233404,92,242502
7083,0.008769,74.125.24.0-255,66,233470,92,242502
7084,0.030983,172.31.47.0-255,172,233642,92,242502
7085,0.031014,172.31.47.0-255,1111,234753,92,242502
7086,0.031073,172.31.47.0-255,1514,236267,92,242502
7087,0.031074,172.31.47.0-255,1514,237781,92,242502
7088,0.031076,172.31.47.0-255,1514,239295,92,242502
7089,0.031076,172.31.47.0-255,1514,240809,92,242502
7090,0.031078,172.31.47.0-255,1495,242304,92,242502
7091,0.032561,104.244.42.0-255,66,242370,92,242502
7092,0.032598,104.244.42.0-255,66,242436,92,242502
7093,0.032654,104.244.42.0-255,66,242502,92,242502
7094,0.0,74.125.68.0-255,152,152,92,321612
7095,3.8e-05,172.31.47.0-255,66,218,92,321612
7096,4.5e-05,74.125.68.0-255,1484,1702,92,321612
7097,5.1e-05,172.31.47.0-255,66,1768,92,321612
7098,5.7e-05,74.125.68.0-255,2902,4670,92,321612
7099,5.9e-05,172.31.47.0-255,66,4736,92,321612
7100,8.4e-05,74.125.68.0-255,1484,6220,92,321612
7101,8.6e-05,172.31.47.0-255,66,6286,92,321612
7102,9.1e-05,74.125.68.0-255,2902,9188,92,321612
7103,9.3e-05,172.31.47.0-255,66,9254,92,321612
7104,0.000142,74.125.68.0-255,4964,14218,92,321612
7105,0.000145,172.31.47.0-255,66,14284,92,321612
7106,0.000186,74.125.68.0-255,1484,15768,92,321612
7107,0.000188,172.31.47.0-255,66,15834,92,321612
7108,0.000219,74.125.68.0-255,2902,18736,92,321612
7109,0.000222,172.31.47.0-255,66,18802,92,321612
7110,0.000226,74.125.68.0-255,1484,20286,92,321612
7111,0.000228,172.31.47.0-255,66,20352,92,321612
7112,0.000244,74.125.68.0-255,2902,23254,92,321612
7113,0.000247,172.31.47.0-255,66,23320,92,321612
7114,0.000263,74.125.68.0-255,1484,24804,92,321612
7115,0.000265,172.31.47.0-255,66,24870,92,321612
7116,0.000291,74.125.68.0-255,4320,29190,92,321612
7117,0.000293,172.31.47.0-255,66,29256,92,321612
7118,0.000298,74.125.68.0-255,2543,31799,92,321612
7119,0.000301,172.31.47.0-255,66,31865,92,321612
7120,0.000433,74.125.68.0-255,1484,33349,92,321612
7121,0.000438,172.31.47.0-255,66,33415,92,321612
7122,0.000457,74.125.68.0-255,2902,36317,92,321612
7123,0.00046,172.31.47.0-255,66,36383,92,321612
7124,0.000488,74.125.68.0-255,5738,42121,92,321612
7125,0.000491,172.31.47.0-255,66,42187,92,321612
7126,0.000495,74.125.68.0-255,2902,45089,92,321612
7127,0.000497,172.31.47.0-255,66,45155,92,321612
7128,0.000501,74.125.68.0-255,1484,46639,92,321612
7129,0.000527,74.125.68.0-255,2543,49182,92,321612
7130,0.00053,172.31.47.0-255,66,49248,92,321612
7131,0.000634,74.125.68.0-255,1484,50732,92,321612
7132,0.000639,74.125.68.0-255,1484,52216,92,321612
7133,0.000644,172.31.47.0-255,66,52282,92,321612
7134,0.000655,74.125.68.0-255,1484,53766,92,321612
7135,0.000671,74.125.68.0-255,4320,58086,92,321612
7136,0.000674,172.31.47.0-255,66,58152,92,321612
7137,0.00069,74.125.68.0-255,1484,59636,92,321612
7138,0.000699,74.125.68.0-255,6797,66433,92,321612
7139,0.000702,172.31.47.0-255,66,66499,92,321612
7140,0.000724,74.125.68.0-255,676,67175,92,321612
7141,0.000867,74.125.68.0-255,1484,68659,92,321612
7142,0.000872,172.31.47.0-255,66,68725,92,321612
7143,0.000881,74.125.68.0-255,2902,71627,92,321612
7144,0.000883,172.31.47.0-255,66,71693,92,321612
7145,0.00091,74.125.68.0-255,4320,76013,92,321612
7146,0.000914,172.31.47.0-255,66,76079,92,321612
7147,0.000918,74.125.68.0-255,4320,80399,92,321612
7148,0.00092,172.31.47.0-255,66,80465,92,321612
7149,0.000934,74.125.68.0-255,1484,81949,92,321612
7150,0.000949,74.125.68.0-255,1484,83433,92,321612
7151,0.000952,172.31.47.0-255,66,83499,92,321612
7152,0.000984,172.31.47.0-255,66,83565,92,321612
7153,0.001022,172.31.47.0-255,66,83631,92,321612
7154,0.001427,74.125.68.0-255,1484,85115,92,321612
7155,0.001439,74.125.68.0-255,2902,88017,92,321612
7156,0.001443,172.31.47.0-255,66,88083,92,321612
7157,0.00145,74.125.68.0-255,4320,92403,92,321612
7158,0.001453,172.31.47.0-255,66,92469,92,321612
7159,0.001471,74.125.68.0-255,1484,93953,92,321612
7160,0.00149,74.125.68.0-255,5738,99691,92,321612
7161,0.001494,172.31.47.0-255,66,99757,92,321612
7162,0.001511,74.125.68.0-255,1484,101241,92,321612
7163,0.001525,74.125.68.0-255,1484,102725,92,321612
7164,0.001528,172.31.47.0-255,66,102791,92,321612
7165,0.001558,74.125.68.0-255,1484,104275,92,321612
7166,0.001572,74.125.68.0-255,1484,105759,92,321612
7167,0.001575,172.31.47.0-255,66,105825,92,321612
7168,0.00159,74.125.68.0-255,1484,107309,92,321612
7169,0.001614,74.125.68.0-255,5738,113047,92,321612
7170,0.001617,172.31.47.0-255,66,113113,92,321612
7171,0.001622,74.125.68.0-255,2902,116015,92,321612
7172,0.001624,172.31.47.0-255,66,116081,92,321612
7173,0.001655,74.125.68.0-255,2184,118265,92,321612
7174,0.001657,172.31.47.0-255,66,118331,92,321612
7175,0.001769,74.125.68.0-255,1484,119815,92,321612
7176,0.001791,74.125.68.0-255,2902,122717,92,321612
7177,0.001794,172.31.47.0-255,66,122783,92,321612
7178,0.001801,74.125.68.0-255,4320,127103,92,321612
7179,0.001803,172.31.47.0-255,66,127169,92,321612
7180,0.001815,74.125.68.0-255,1484,128653,92,321612
7181,0.00182,74.125.68.0-255,2902,131555,92,321612
7182,0.001823,172.31.47.0-255,66,131621,92,321612
7183,0.001828,74.125.68.0-255,4320,135941,92,321612
7184,0.001832,172.31.47.0-255,66,136007,92,321612
7185,0.00186,74.125.68.0-255,2902,138909,92,321612
7186,0.001863,172.31.47.0-255,66,138975,92,321612
7187,0.001883,74.125.68.0-255,5738,144713,92,321612
7188,0.001887,172.31.47.0-255,66,144779,92,321612
7189,0.001916,74.125.68.0-255,1484,146263,92,321612
7190,0.001947,74.125.68.0-255,6438,152701,92,321612
7191,0.001952,172.31.47.0-255,66,152767,92,321612
7192,0.003929,74.125.68.0-255,5738,158505,92,321612
7193,0.003948,172.31.47.0-255,66,158571,92,321612
7194,0.005937,74.125.68.0-255,5738,164309,92,321612
7195,0.005948,172.31.47.0-255,66,164375,92,321612
7196,0.007966,74.125.68.0-255,5738,170113,92,321612
7197,0.007982,172.31.47.0-255,66,170179,92,321612
7198,0.010014,74.125.68.0-255,5738,175917,92,321612
7199,0.010034,172.31.47.0-255,66,175983,92,321612
7200,0.012025,74.125.68.0-255,5738,181721,92,321612
7201,0.012048,172.31.47.0-255,66,181787,92,321612
7202,0.014035,74.125.68.0-255,5738,187525,92,321612
7203,0.01405,172.31.47.0-255,66,187591,92,321612
7204,0.016049,74.125.68.0-255,5738,193329,92,321612
7205,0.01607,172.31.47.0-255,66,193395,92,321612
7206,0.018057,74.125.68.0-255,5738,199133,92,321612
7207,0.018073,172.31.47.0-255,66,199199,92,321612
7208,0.020064,74.125.68.0-255,5738,204937,92,321612
7209,0.020082,172.31.47.0-255,66,205003,92,321612
7210,0.022067,74.125.68.0-255,5738,210741,92,321612
7211,0.022082,172.31.47.0-255,66,210807,92,321612
7212,0.024061,74.125.68.0-255,5738,216545,92,321612
7213,0.02408,172.31.47.0-255,66,216611,92,321612
7214,0.026084,74.125.68.0-255,5738,222349,92,321612
7215,0.026109,172.31.47.0-255,66,222415,92,321612
7216,0.028109,74.125.68.0-255,5738,228153,92,321612
7217,0.028127,172.31.47.0-255,66,228219,92,321612
7218,0.030132,74.125.68.0-255,5738,233957,92,321612
7219,0.03015,172.31.47.0-255,66,234023,92,321612
7220,0.032159,74.125.68.0-255,5738,239761,92,321612
7221,0.03218,172.31.47.0-255,66,239827,92,321612
7222,0.034203,74.125.68.0-255,5738,245565,92,321612
7223,0.034224,172.31.47.0-255,66,245631,92,321612
7224,0.036214,74.125.68.0-255,5738,251369,92,321612
7225,0.036231,172.31.47.0-255,66,251435,92,321612
7226,0.038202,74.125.68.0-255,5738,257173,92,321612
7227,0.038213,172.31.47.0-255,66,257239,92,321612
7228,0.038387,172.31.47.0-255,176,257415,92,321612
7229,0.038416,172.31.47.0-255,1111,258526,92,321612
7230,0.038531,172.31.47.0-255,1514,260040,92,321612
7231,0.038533,172.31.47.0-255,1514,261554,92,321612
7232,0.038534,172.31.47.0-255,1514,263068,92,321612
7233,0.038535,172.31.47.0-255,1514,264582,92,321612
7234,0.038536,172.31.47.0-255,1496,266078,92,321612
7235,0.04,104.244.42.0-255,66,266144,92,321612
7236,0.040012,104.244.42.0-255,66,266210,92,321612
7237,0.04015,104.244.42.0-255,66,266276,92,321612
7238,0.040182,74.125.68.0-255,4320,270596,92,321612
7239,0.04019,172.31.47.0-255,66,270662,92,321612
7240,0.040208,74.125.68.0-255,1484,272146,92,321612
7241,0.042207,74.125.68.0-255,4320,276466,92,321612
7242,0.042222,172.31.47.0-255,66,276532,92,321612
7243,0.044221,74.125.68.0-255,5738,282270,92,321612
7244,0.044237,172.31.47.0-255,66,282336,92,321612
7245,0.04622,74.125.68.0-255,5738,288074,92,321612
7246,0.046235,172.31.47.0-255,66,288140,92,321612
7247,0.048213,74.125.68.0-255,4320,292460,92,321612
7248,0.048225,172.31.47.0-255,66,292526,92,321612
7249,0.048254,74.125.68.0-255,1484,294010,92,321612
7250,0.050205,74.125.68.0-255,4320,298330,92,321612
7251,0.050214,172.31.47.0-255,66,298396,92,321612
7252,0.052197,74.125.68.0-255,5738,304134,92,321612
7253,0.052203,172.31.47.0-255,66,304200,92,321612
7254,0.054189,74.125.68.0-255,5738,309938,92,321612
7255,0.054195,172.31.47.0-255,66,310004,92,321612
7256,0.056176,74.125.68.0-255,5738,315742,92,321612
7257,0.056181,172.31.47.0-255,66,315808,92,321612
7258,0.058149,74.125.68.0-255,5738,321546,92,321612
7259,0.058176,172.31.47.0-255,66,321612,92,321612
7260,0.0,172.253.118.0-255,97,97,92,229
7261,0.007217,172.253.118.0-255,66,163,92,229
7262,0.039365,172.31.47.0-255,66,229,92,229
7263,0.0,74.125.68.0-255,152,152,92,298103
7264,4.1e-05,172.31.47.0-255,66,218,92,298103
7265,4.7e-05,74.125.68.0-255,1484,1702,92,298103
7266,5.1e-05,172.31.47.0-255,66,1768,92,298103
7267,5.6e-05,74.125.68.0-255,2902,4670,92,298103
7268,5.9e-05,172.31.47.0-255,66,4736,92,298103
7269,6.5e-05,74.125.68.0-255,7156,11892,92,298103
7270,6.8e-05,172.31.47.0-255,66,11958,92,298103
7271,8.8e-05,74.125.68.0-255,2067,14025,92,298103
7272,9.1e-05,172.31.47.0-255,66,14091,92,298103
7273,0.000123,74.125.68.0-255,1484,15575,92,298103
7274,0.000125,172.31.47.0-255,66,15641,92,298103
7275,0.000141,74.125.68.0-255,2902,18543,92,298103
7276,0.000144,172.31.47.0-255,66,18609,92,298103
7277,0.000149,74.125.68.0-255,1484,20093,92,298103
7278,0.00015,172.31.47.0-255,66,20159,92,298103
7279,0.00017,74.125.68.0-255,4320,24479,92,298103
7280,0.000173,172.31.47.0-255,66,24545,92,298103
7281,0.000177,74.125.68.0-255,2902,27447,92,298103
7282,0.000179,172.31.47.0-255,66,27513,92,298103
7283,0.000183,74.125.68.0-255,3961,31474,92,298103
7284,0.000186,172.31.47.0-255,66,31540,92,298103
7285,0.00036,74.125.68.0-255,1484,33024,92,298103
7286,0.000365,172.31.47.0-255,66,33090,92,298103
7287,0.000368,74.125.68.0-255,1484,34574,92,298103
7288,0.000369,172.31.47.0-255,66,34640,92,298103
7289,0.000388,74.125.68.0-255,2902,37542,92,298103
7290,0.000391,172.31.47.0-255,66,37608,92,298103
7291,0.000412,74.125.68.0-255,5738,43346,92,298103
7292,0.000417,172.31.47.0-255,66,43412,92,298103
7293,0.000423,74.125.68.0-255,2902,46314,92,298103
7294,0.000425,172.31.47.0-255,66,46380,92,298103
7295,0.000443,74.125.68.0-255,2543,48923,92,298103
7296,0.000446,172.31.47.0-255,66,48989,92,298103
7297,0.000451,74.125.68.0-255,5738,54727,92,298103
7298,0.000454,172.31.47.0-255,66,54793,92,298103
7299,0.000496,74.125.68.0-255,4320,59113,92,298103
7300,0.000499,172.31.47.0-255,66,59179,92,298103
7301,0.00052,74.125.68.0-255,7071,66250,92,298103
7302,0.000523,172.31.47.0-255,66,66316,92,298103
7303,0.000526,74.125.68.0-255,132,66448,92,298103
7304,0.00066,172.31.47.0-255,66,66514,92,298103
7305,0.00097,74.125.68.0-255,346,66860,92,298103
7306,0.001003,172.31.47.0-255,66,66926,92,298103
7307,0.001263,74.125.68.0-255,1484,68410,92,298103
7308,0.00127,74.125.68.0-255,1484,69894,92,298103
7309,0.001273,172.31.47.0-255,66,69960,92,298103
7310,0.001294,74.125.68.0-255,1484,71444,92,298103
7311,0.001299,74.125.68.0-255,4320,75764,92,298103
7312,0.001301,172.31.47.0-255,66,75830,92,298103
7313,0.001331,172.31.47.0-255,66,75896,92,298103
7314,0.001336,74.125.68.0-255,5738,81634,92,298103
7315,0.001337,172.31.47.0-255,66,81700,92,298103
7316,0.001366,74.125.68.0-255,7156,88856,92,298103
7317,0.001369,172.31.47.0-255,66,88922,92,298103
7318,0.001389,74.125.68.0-255,3602,92524,92,298103
7319,0.001391,172.31.47.0-255,66,92590,92,298103
7320,0.001703,74.125.68.0-255,1484,94074,92,298103
7321,0.001729,74.125.68.0-255,2902,96976,92,298103
7322,0.001732,172.31.47.0-255,66,97042,92,298103
7323,0.001736,74.125.68.0-255,2902,99944,92,298103
7324,0.001737,172.31.47.0-255,66,100010,92,298103
7325,0.00174,74.125.68.0-255,1484,101494,92,298103
7326,0.001751,74.125.68.0-255,2902,104396,92,298103
7327,0.001753,172.31.47.0-255,66,104462,92,298103
7328,0.001786,74.125.68.0-255,4320,108782,92,298103
7329,0.001788,172.31.47.0-255,66,108848,92,298103
7330,0.001809,74.125.68.0-255,4320,113168,92,298103
7331,0.001811,172.31.47.0-255,66,113234,92,298103
7332,0.001832,74.125.68.0-255,7156,120390,92,298103
7333,0.001834,172.31.47.0-255,66,120456,92,298103
7334,0.001854,74.125.68.0-255,5738,126194,92,298103
7335,0.001856,172.31.47.0-255,66,126260,92,298103
7336,0.001876,74.125.68.0-255,766,127026,92,298103
7337,0.002031,172.31.47.0-255,66,127092,92,298103
7338,0.003891,74.125.68.0-255,4320,131412,92,298103
7339,0.003896,172.31.47.0-255,66,131478,92,298103
7340,0.004073,74.125.68.0-255,1484,132962,92,298103
7341,0.00595,74.125.68.0-255,4320,137282,92,298103
7342,0.005957,172.31.47.0-255,66,137348,92,298103
7343,0.008014,74.125.68.0-255,5738,143086,92,298103
7344,0.008039,172.31.47.0-255,66,143152,92,298103
7345,0.010091,74.125.68.0-255,5738,148890,92,298103
7346,0.010097,172.31.47.0-255,66,148956,92,298103
7347,0.012144,74.125.68.0-255,5738,154694,92,298103
7348,0.012149,172.31.47.0-255,66,154760,92,298103
7349,0.014193,74.125.68.0-255,5738,160498,92,298103
7350,0.014199,172.31.47.0-255,66,160564,92,298103
7351,0.016232,74.125.68.0-255,5738,166302,92,298103
7352,0.016237,172.31.47.0-255,66,166368,92,298103
7353,0.018309,74.125.68.0-255,5738,172106,92,298103
7354,0.018315,172.31.47.0-255,66,172172,92,298103
7355,0.019345,172.31.47.0-255,172,172344,92,298103
7356,0.019379,172.31.47.0-255,1107,173451,92,298103
7357,0.019442,172.31.47.0-255,1514,174965,92,298103
7358,0.019444,172.31.47.0-255,1514,176479,92,298103
7359,0.019445,172.31.47.0-255,1514,177993,92,298103
7360,0.019446,172.31.47.0-255,1514,179507,92,298103
7361,0.019447,172.31.47.0-255,536,180043,92,298103
7362,0.020374,74.125.68.0-255,5738,185781,92,298103
7363,0.020379,172.31.47.0-255,66,185847,92,298103
7364,0.020892,104.244.42.0-255,66,185913,92,298103
7365,0.020943,104.244.42.0-255,66,185979,92,298103
7366,0.02099,104.244.42.0-255,66,186045,92,298103
7367,0.020992,104.244.42.0-255,66,186111,92,298103
7368,0.022429,74.125.68.0-255,5738,191849,92,298103
7369,0.022434,172.31.47.0-255,66,191915,92,298103
7370,0.024486,74.125.68.0-255,5738,197653,92,298103
7371,0.024491,172.31.47.0-255,66,197719,92,298103
7372,0.026554,74.125.68.0-255,5738,203457,92,298103
7373,0.02656,172.31.47.0-255,66,203523,92,298103
7374,0.028623,74.125.68.0-255,5738,209261,92,298103
7375,0.028629,172.31.47.0-255,66,209327,92,298103
7376,0.030683,74.125.68.0-255,2902,212229,92,298103
7377,0.030687,172.31.47.0-255,66,212295,92,298103
7378,0.030713,74.125.68.0-255,2902,215197,92,298103
7379,0.030716,172.31.47.0-255,66,215263,92,298103
7380,0.03273,74.125.68.0-255,2902,218165,92,298103
7381,0.032734,172.31.47.0-255,66,218231,92,298103
7382,0.032763,74.125.68.0-255,2902,221133,92,298103
7383,0.032766,172.31.47.0-255,66,221199,92,298103
7384,0.034783,74.125.68.0-255,2902,224101,92,298103
7385,0.034788,172.31.47.0-255,66,224167,92,298103
7386,0.034813,74.125.68.0-255,2902,227069,92,298103
7387,0.034816,172.31.47.0-255,66,227135,92,298103
7388,0.036826,74.125.68.0-255,2902,230037,92,298103
7389,0.036831,172.31.47.0-255,66,230103,92,298103
7390,0.03686,74.125.68.0-255,2902,233005,92,298103
7391,0.036863,172.31.47.0-255,66,233071,92,298103
7392,0.038913,74.125.68.0-255,2902,235973,92,298103
7393,0.038918,172.31.47.0-255,66,236039,92,298103
7394,0.038949,74.125.68.0-255,2902,238941,92,298103
7395,0.038951,172.31.47.0-255,66,239007,92,298103
7396,0.040978,74.125.68.0-255,2902,241909,92,298103
7397,0.040984,172.31.47.0-255,66,241975,92,298103
7398,0.041002,74.125.68.0-255,2902,244877,92,298103
7399,0.041005,172.31.47.0-255,66,244943,92,298103
7400,0.043059,74.125.68.0-255,1484,246427,92,298103
7401,0.043076,74.125.68.0-255,1484,247911,92,298103
7402,0.043082,172.31.47.0-255,66,247977,92,298103
7403,0.043111,74.125.68.0-255,1484,249461,92,298103
7404,0.043121,74.125.68.0-255,1484,250945,92,298103
7405,0.043123,172.31.47.0-255,66,251011,92,298103
7406,0.045119,74.125.68.0-255,2902,253913,92,298103
7407,0.045124,172.31.47.0-255,66,253979,92,298103
7408,0.045163,74.125.68.0-255,2902,256881,92,298103
7409,0.045166,172.31.47.0-255,66,256947,92,298103
7410,0.047177,74.125.68.0-255,2902,259849,92,298103
7411,0.047182,172.31.47.0-255,66,259915,92,298103
7412,0.047214,74.125.68.0-255,2902,262817,92,298103
7413,0.047217,172.31.47.0-255,66,262883,92,298103
7414,0.049221,74.125.68.0-255,1484,264367,92,298103
7415,0.049251,74.125.68.0-255,4320,268687,92,298103
7416,0.049256,172.31.47.0-255,66,268753,92,298103
7417,0.051305,74.125.68.0-255,1484,270237,92,298103
7418,0.051337,74.125.68.0-255,4320,274557,92,298103
7419,0.051341,172.31.47.0-255,66,274623,92,298103
7420,0.053397,74.125.68.0-255,5738,280361,92,298103
7421,0.053402,172.31.47.0-255,66,280427,92,298103
7422,0.055453,74.125.68.0-255,5738,286165,92,298103
7423,0.055458,172.31.47.0-255,66,286231,92,298103
7424,0.057484,74.125.68.0-255,2902,289133,92,298103
7425,0.057489,172.31.47.0-255,66,289199,92,298103
7426,0.05752,74.125.68.0-255,2902,292101,92,298103
7427,0.057523,172.31.47.0-255,66,292167,92,298103
7428,0.059531,74.125.68.0-255,2902,295069,92,298103
7429,0.059537,172.31.47.0-255,66,295135,92,298103
7430,0.059569,74.125.68.0-255,2902,298037,92,298103
7431,0.059572,172.31.47.0-255,66,298103,92,298103
7432,0.0,74.125.24.0-255,298,298,92,302934
7433,2.9e-05,172.31.47.0-255,66,364,92,302934
7434,3.5e-05,74.125.24.0-255,1484,1848,92,302934
7435,3.9e-05,172.31.47.0-255,66,1914,92,302934
7436,4.1e-05,74.125.24.0-255,1484,3398,92,302934
7437,4.3e-05,172.31.47.0-255,66,3464,92,302934
7438,4.9e-05,74.125.24.0-255,2902,6366,92,302934
7439,5.2e-05,172.31.47.0-255,66,6432,92,302934
7440,7.4e-05,74.125.24.0-255,1484,7916,92,302934
7441,7.5e-05,172.31.47.0-255,66,7982,92,302934
7442,8e-05,74.125.24.0-255,2902,10884,92,302934
7443,8.4e-05,172.31.47.0-255,66,10950,92,302934
7444,9.8e-05,74.125.24.0-255,3243,14193,92,302934
7445,0.000101,172.31.47.0-255,66,14259,92,302934
7446,0.000119,74.125.24.0-255,1484,15743,92,302934
7447,0.000121,172.31.47.0-255,66,15809,92,302934
7448,0.000141,74.125.24.0-255,5738,21547,92,302934
7449,0.000144,172.31.47.0-255,66,21613,92,302934
7450,0.000147,74.125.24.0-255,1484,23097,92,302934
7451,0.000149,172.31.47.0-255,66,23163,92,302934
7452,0.000194,74.125.24.0-255,2902,26065,92,302934
7453,0.000197,172.31.47.0-255,66,26131,92,302934
7454,0.000221,74.125.24.0-255,5379,31510,92,302934
7455,0.000224,172.31.47.0-255,66,31576,92,302934
7456,0.000535,74.125.24.0-255,1484,33060,92,302934
7457,0.000539,172.31.47.0-255,66,33126,92,302934
7458,0.000544,74.125.24.0-255,1484,34610,92,302934
7459,0.000546,172.31.47.0-255,66,34676,92,302934
7460,0.000558,74.125.24.0-255,1484,36160,92,302934
7461,0.000561,172.31.47.0-255,66,36226,92,302934
7462,0.000565,74.125.24.0-255,2902,39128,92,302934
7463,0.000567,172.31.47.0-255,66,39194,92,302934
7464,0.000591,74.125.24.0-255,2902,42096,92,302934
7465,0.000595,172.31.47.0-255,66,42162,92,302934
7466,0.000602,74.125.24.0-255,5738,47900,92,302934
7467,0.000604,172.31.47.0-255,66,47966,92,302934
7468,0.00062,74.125.24.0-255,3961,51927,92,302934
7469,0.000623,172.31.47.0-255,66,51993,92,302934
7470,0.000652,74.125.24.0-255,5738,57731,92,302934
7471,0.000655,172.31.47.0-255,66,57797,92,302934
7472,0.00068,172.31.47.0-255,66,57863,92,302934
7473,0.001023,74.125.24.0-255,646,58509,92,302934
7474,0.001152,74.125.24.0-255,1484,59993,92,302934
7475,0.001157,172.31.47.0-255,66,60059,92,302934
7476,0.001162,74.125.24.0-255,1484,61543,92,302934
7477,0.001176,74.125.24.0-255,1484,63027,92,302934
7478,0.001178,172.31.47.0-255,66,63093,92,302934
7479,0.001184,74.125.24.0-255,2902,65995,92,302934
7480,0.001186,172.31.47.0-255,66,66061,92,302934
7481,0.001202,74.125.24.0-255,2902,68963,92,302934
7482,0.001204,172.31.47.0-255,66,69029,92,302934
7483,0.001212,74.125.24.0-255,7156,76185,92,302934
7484,0.001214,172.31.47.0-255,66,76251,92,302934
7485,0.001235,74.125.24.0-255,2902,79153,92,302934
7486,0.001237,172.31.47.0-255,66,79219,92,302934
7487,0.001268,172.31.47.0-255,66,79285,92,302934
7488,0.001272,74.125.24.0-255,2184,81469,92,302934
7489,0.001274,172.31.47.0-255,66,81535,92,302934
7490,0.001473,74.125.24.0-255,1484,83019,92,302934
7491,0.00148,74.125.24.0-255,2902,85921,92,302934
7492,0.001484,172.31.47.0-255,66,85987,92,302934
7493,0.001508,74.125.24.0-255,5738,91725,92,302934
7494,0.001511,172.31.47.0-255,66,91791,92,302934
7495,0.001516,74.125.24.0-255,4320,96111,92,302934
7496,0.001518,172.31.47.0-255,66,96177,92,302934
7497,0.001535,74.125.24.0-255,2902,99079,92,302934
7498,0.001537,172.31.47.0-255,66,99145,92,302934
7499,0.001553,74.125.24.0-255,1484,100629,92,302934
7500,0.001566,74.125.24.0-255,4320,104949,92,302934
7501,0.00157,172.31.47.0-255,66,105015,92,302934
7502,0.001588,74.125.24.0-255,2902,107917,92,302934
7503,0.001591,172.31.47.0-255,66,107983,92,302934
7504,0.001619,172.31.47.0-255,66,108049,92,302934
7505,0.001775,74.125.24.0-255,1484,109533,92,302934
7506,0.001782,74.125.24.0-255,2902,112435,92,302934
7507,0.001787,172.31.47.0-255,66,112501,92,302934
7508,0.001791,74.125.24.0-255,1484,113985,92,302934
7509,0.001806,74.125.24.0-255,4320,118305,92,302934
7510,0.001808,172.31.47.0-255,66,118371,92,302934
7511,0.001836,74.125.24.0-255,7156,125527,92,302934
7512,0.001838,172.31.47.0-255,66,125593,92,302934
7513,0.001841,74.125.24.0-255,1484,127077,92,302934
7514,0.001858,74.125.24.0-255,5738,132815,92,302934
7515,0.00186,172.31.47.0-255,66,132881,92,302934
7516,0.001877,74.125.24.0-255,7156,140037,92,302934
7517,0.001879,172.31.47.0-255,66,140103,92,302934
7518,0.001882,74.125.24.0-255,2184,142287,92,302934
7519,0.001884,172.31.47.0-255,66,142353,92,302934
7520,0.002152,74.125.24.0-255,1484,143837,92,302934
7521,0.002157,74.125.24.0-255,2902,146739,92,302934
7522,0.002159,172.31.47.0-255,66,146805,92,302934
7523,0.002185,74.125.24.0-255,2902,149707,92,302934
7524,0.002187,172.31.47.0-255,66,149773,92,302934
7525,0.002202,74.125.24.0-255,2902,152675,92,302934
7526,0.002204,172.31.47.0-255,66,152741,92,302934
7527,0.002207,74.125.24.0-255,1484,154225,92,302934
7528,0.00224,172.31.47.0-255,66,154291,92,302934
7529,0.002247,74.125.24.0-255,7156,161447,92,302934
7530,0.002249,172.31.47.0-255,66,161513,92,302934
7531,0.002268,74.125.24.0-255,3602,165115,92,302934
7532,0.002271,172.31.47.0-255,66,165181,92,302934
7533,0.004559,74.125.24.0-255,1484,166665,92,302934
7534,0.004631,74.125.24.0-255,4320,170985,92,302934
7535,0.004637,172.31.47.0-255,66,171051,92,302934
7536,0.006963,74.125.24.0-255,4320,175371,92,302934
7537,0.006967,172.31.47.0-255,66,175437,92,302934
7538,0.00698,74.125.24.0-255,1484,176921,92,302934
7539,0.009286,74.125.24.0-255,4320,181241,92,302934
7540,0.009293,172.31.47.0-255,66,181307,92,302934
7541,0.011691,74.125.24.0-255,5738,187045,92,302934
7542,0.011699,172.31.47.0-255,66,187111,92,302934
7543,0.014006,74.125.24.0-255,5738,192849,92,302934
7544,0.014013,172.31.47.0-255,66,192915,92,302934
7545,0.016338,74.125.24.0-255,5738,198653,92,302934
7546,0.016347,172.31.47.0-255,66,198719,92,302934
7547,0.018647,74.125.24.0-255,5738,204457,92,302934
7548,0.018653,172.31.47.0-255,66,204523,92,302934
7549,0.020959,74.125.24.0-255,4320,208843,92,302934
7550,0.020966,172.31.47.0-255,66,208909,92,302934
7551,0.021006,74.125.24.0-255,1484,210393,92,302934
7552,0.023339,74.125.24.0-255,4320,214713,92,302934
7553,0.023346,172.31.47.0-255,66,214779,92,302934
7554,0.02568,74.125.24.0-255,5738,220517,92,302934
7555,0.025686,172.31.47.0-255,66,220583,92,302934
7556,0.027991,74.125.24.0-255,4320,224903,92,302934
7557,0.027998,172.31.47.0-255,66,224969,92,302934
7558,0.028034,74.125.24.0-255,1484,226453,92,302934
7559,0.030346,74.125.24.0-255,4320,230773,92,302934
7560,0.030356,172.31.47.0-255,66,230839,92,302934
7561,0.032734,74.125.24.0-255,4320,235159,92,302934
7562,0.032741,172.31.47.0-255,66,235225,92,302934
7563,0.032773,74.125.24.0-255,1484,236709,92,302934
7564,0.033643,172.31.47.0-255,172,236881,92,302934
7565,0.033674,172.31.47.0-255,1112,237993,92,302934
7566,0.033717,172.31.47.0-255,1514,239507,92,302934
7567,0.033719,172.31.47.0-255,1514,241021,92,302934
7568,0.03372,172.31.47.0-255,1514,242535,92,302934
7569,0.033721,172.31.47.0-255,1514,244049,92,302934
7570,0.033722,172.31.47.0-255,1495,245544,92,302934
7571,0.035071,74.125.24.0-255,4320,249864,92,302934
7572,0.035077,172.31.47.0-255,66,249930,92,302934
7573,0.035161,104.244.42.0-255,66,249996,92,302934
7574,0.035222,104.244.42.0-255,66,250062,92,302934
7575,0.035382,104.244.42.0-255,66,250128,92,302934
7576,0.037433,74.125.24.0-255,5738,255866,92,302934
7577,0.037437,172.31.47.0-255,66,255932,92,302934
7578,0.039749,74.125.24.0-255,4320,260252,92,302934
7579,0.039754,172.31.47.0-255,66,260318,92,302934
7580,0.03978,74.125.24.0-255,1484,261802,92,302934
7581,0.039949,104.244.42.0-255,108,261910,92,302934
7582,0.039954,172.31.47.0-255,66,261976,92,302934
7583,0.042115,74.125.24.0-255,4320,266296,92,302934
7584,0.042119,172.31.47.0-255,66,266362,92,302934
7585,0.044448,74.125.24.0-255,4320,270682,92,302934
7586,0.044454,172.31.47.0-255,66,270748,92,302934
7587,0.044479,74.125.24.0-255,1484,272232,92,302934
7588,0.046771,74.125.24.0-255,4320,276552,92,302934
7589,0.046776,172.31.47.0-255,66,276618,92,302934
7590,0.049136,74.125.24.0-255,4320,280938,92,302934
7591,0.04914,172.31.47.0-255,66,281004,92,302934
7592,0.04917,74.125.24.0-255,1484,282488,92,302934
7593,0.051435,74.125.24.0-255,4320,286808,92,302934
7594,0.051439,172.31.47.0-255,66,286874,92,302934
7595,0.053744,74.125.24.0-255,5738,292612,92,302934
7596,0.053748,172.31.47.0-255,66,292678,92,302934
7597,0.056059,74.125.24.0-255,4320,296998,92,302934
7598,0.056065,172.31.47.0-255,66,297064,92,302934
7599,0.056086,74.125.24.0-255,1484,298548,92,302934
7600,0.058397,74.125.24.0-255,4320,302868,92,302934
7601,0.058401,172.31.47.0-255,66,302934,92,302934
7602,0.0,74.125.68.0-255,153,153,92,398153
7603,2.8e-05,172.31.47.0-255,66,219,92,398153
7604,3.5e-05,74.125.68.0-255,1484,1703,92,398153
7605,3.9e-05,172.31.47.0-255,66,1769,92,398153
7606,4.5e-05,74.125.68.0-255,2902,4671,92,398153
7607,4.9e-05,172.31.47.0-255,66,4737,92,398153
7608,8.1e-05,74.125.68.0-255,7156,11893,92,398153
7609,8.4e-05,172.31.47.0-255,66,11959,92,398153
7610,0.000111,74.125.68.0-255,2044,14003,92,398153
7611,0.000114,172.31.47.0-255,66,14069,92,398153
7612,0.000133,74.125.68.0-255,2902,16971,92,398153
7613,0.000136,172.31.47.0-255,66,17037,92,398153
7614,0.000163,74.125.68.0-255,7156,24193,92,398153
7615,0.000166,172.31.47.0-255,66,24259,92,398153
7616,0.000171,74.125.68.0-255,4320,28579,92,398153
7617,0.000173,172.31.47.0-255,66,28645,92,398153
7618,0.000234,74.125.68.0-255,2543,31188,92,398153
7619,0.000237,172.31.47.0-255,66,31254,92,398153
7620,0.000274,74.125.68.0-255,1484,32738,92,398153
7621,0.000278,172.31.47.0-255,66,32804,92,398153
7622,0.000294,74.125.68.0-255,2902,35706,92,398153
7623,0.000298,172.31.47.0-255,66,35772,92,398153
7624,0.000332,74.125.68.0-255,5738,41510,92,398153
7625,0.000335,172.31.47.0-255,66,41576,92,398153
7626,0.000338,74.125.68.0-255,1484,43060,92,398153
7627,0.00034,172.31.47.0-255,66,43126,92,398153
7628,0.000356,74.125.68.0-255,4320,47446,92,398153
7629,0.000359,172.31.47.0-255,66,47512,92,398153
7630,0.000385,74.125.68.0-255,1484,48996,92,398153
7631,0.000388,172.31.47.0-255,66,49062,92,398153
7632,0.00041,74.125.68.0-255,5379,54441,92,398153
7633,0.000413,172.31.47.0-255,66,54507,92,398153
7634,0.000424,172.31.47.0-255,66,54573,92,398153
7635,0.000427,74.125.68.0-255,1439,56012,92,398153
7636,0.000555,74.125.68.0-255,111,56123,92,398153
7637,0.000659,74.125.68.0-255,1484,57607,92,398153
7638,0.000664,172.31.47.0-255,66,57673,92,398153
7639,0.000668,74.125.68.0-255,1484,59157,92,398153
7640,0.000682,74.125.68.0-255,2902,62059,92,398153
7641,0.000685,172.31.47.0-255,66,62125,92,398153
7642,0.000689,74.125.68.0-255,2902,65027,92,398153
7643,0.000691,172.31.47.0-255,66,65093,92,398153
7644,0.000709,74.125.68.0-255,2902,67995,92,398153
7645,0.000713,172.31.47.0-255,66,68061,92,398153
7646,0.00073,74.125.68.0-255,5379,73440,92,398153
7647,0.000733,172.31.47.0-255,66,73506,92,398153
7648,0.000774,74.125.68.0-255,1484,74990,92,398153
7649,0.000789,74.125.68.0-255,2902,77892,92,398153
7650,0.000792,172.31.47.0-255,66,77958,92,398153
7651,0.00081,74.125.68.0-255,5738,83696,92,398153
7652,0.000814,172.31.47.0-255,66,83762,92,398153
7653,0.000821,74.125.68.0-255,5738,89500,92,398153
7654,0.000823,172.31.47.0-255,66,89566,92,398153
7655,0.00084,74.125.68.0-255,1125,90691,92,398153
7656,0.000985,74.125.68.0-255,1484,92175,92,398153
7657,0.000991,172.31.47.0-255,66,92241,92,398153
7658,0.000997,74.125.68.0-255,2902,95143,92,398153
7659,0.001,172.31.47.0-255,66,95209,92,398153
7660,0.001022,74.125.68.0-255,5738,100947,92,398153
7661,0.001025,172.31.47.0-255,66,101013,92,398153
7662,0.001029,74.125.68.0-255,2902,103915,92,398153
7663,0.001031,172.31.47.0-255,66,103981,92,398153
7664,0.001034,74.125.68.0-255,1484,105465,92,398153
7665,0.00106,74.125.68.0-255,2902,108367,92,398153
7666,0.001063,172.31.47.0-255,66,108433,92,398153
7667,0.00107,74.125.68.0-255,7156,115589,92,398153
7668,0.001072,172.31.47.0-255,66,115655,92,398153
7669,0.001096,74.125.68.0-255,1484,117139,92,398153
7670,0.001102,74.125.68.0-255,5738,122877,92,398153
7671,0.001105,172.31.47.0-255,66,122943,92,398153
7672,0.001128,74.125.68.0-255,6438,129381,92,398153
7673,0.001131,172.31.47.0-255,66,129447,92,398153
7674,0.001151,74.125.68.0-255,7156,136603,92,398153
7675,0.001153,172.31.47.0-255,66,136669,92,398153
7676,0.001186,74.125.68.0-255,4320,140989,92,398153
7677,0.001189,172.31.47.0-255,66,141055,92,398153
7678,0.001217,172.31.47.0-255,66,141121,92,398153
7679,0.001246,172.31.47.0-255,66,141187,92,398153
7680,0.001278,74.125.68.0-255,2902,144089,92,398153
7681,0.00128,172.31.47.0-255,66,144155,92,398153
7682,0.001297,74.125.68.0-255,4320,148475,92,398153
7683,0.001299,172.31.47.0-255,66,148541,92,398153
7684,0.001321,74.125.68.0-255,4320,152861,92,398153
7685,0.001323,172.31.47.0-255,66,152927,92,398153
7686,0.001342,74.125.68.0-255,4320,157247,92,398153
7687,0.001343,172.31.47.0-255,66,157313,92,398153
7688,0.001348,74.125.68.0-255,5738,163051,92,398153
7689,0.00135,172.31.47.0-255,66,163117,92,398153
7690,0.001359,74.125.68.0-255,1484,164601,92,398153
7691,0.001374,74.125.68.0-255,5738,170339,92,398153
7692,0.001376,172.31.47.0-255,66,170405,92,398153
7693,0.00139,74.125.68.0-255,1484,171889,92,398153
7694,0.001405,74.125.68.0-255,3602,175491,92,398153
7695,0.001406,172.31.47.0-255,66,175557,92,398153
7696,0.001443,74.125.68.0-255,2902,178459,92,398153
7697,0.001445,172.31.47.0-255,66,178525,92,398153
7698,0.001449,74.125.68.0-255,4320,182845,92,398153
7699,0.001451,172.31.47.0-255,66,182911,92,398153
7700,0.001502,74.125.68.0-255,5738,188649,92,398153
7701,0.001504,172.31.47.0-255,66,188715,92,398153
7702,0.00152,74.125.68.0-255,2902,191617,92,398153
7703,0.001522,172.31.47.0-255,66,191683,92,398153
7704,0.001526,74.125.68.0-255,4320,196003,92,398153
7705,0.001528,172.31.47.0-255,66,196069,92,398153
7706,0.001532,74.125.68.0-255,5738,201807,92,398153
7707,0.001595,74.125.68.0-255,1484,203291,92,398153
7708,0.001613,74.125.68.0-255,2902,206193,92,398153
7709,0.001635,74.125.68.0-255,5738,211931,92,398153
7710,0.001643,74.125.68.0-255,4320,216251,92,398153
7711,0.001645,74.125.68.0-255,1484,217735,92,398153
7712,0.001659,74.125.68.0-255,4320,222055,92,398153
7713,0.001682,74.125.68.0-255,2902,224957,92,398153
7714,0.0017,74.125.68.0-255,2184,227141,92,398153
7715,0.001784,74.125.68.0-255,1484,228625,92,398153
7716,0.001798,74.125.68.0-255,2902,231527,92,398153
7717,0.001818,74.125.68.0-255,4320,235847,92,398153
7718,0.00183,74.125.68.0-255,1484,237331,92,398153
7719,0.001844,74.125.68.0-255,5738,243069,92,398153
7720,0.001857,74.125.68.0-255,1484,244553,92,398153
7721,0.001861,74.125.68.0-255,5738,250291,92,398153
7722,0.001875,74.125.68.0-255,1484,251775,92,398153
7723,0.001877,74.125.68.0-255,1484,253259,92,398153
7724,0.001891,74.125.68.0-255,7156,260415,92,398153
7725,0.001893,74.125.68.0-255,766,261181,92,398153
7726,0.002015,74.125.68.0-255,1484,262665,92,398153
7727,0.002033,74.125.68.0-255,2902,265567,92,398153
7728,0.002049,74.125.68.0-255,2902,268469,92,398153
7729,0.002058,74.125.68.0-255,1484,269953,92,398153
7730,0.004967,172.31.47.0-255,66,270019,92,398153
7731,0.007008,74.125.68.0-255,5738,275757,92,398153
7732,0.007013,172.31.47.0-255,66,275823,92,398153
7733,0.009024,74.125.68.0-255,5738,281561,92,398153
7734,0.009029,172.31.47.0-255,66,281627,92,398153
7735,0.01107,74.125.68.0-255,5738,287365,92,398153
7736,0.011076,172.31.47.0-255,66,287431,92,398153
7737,0.013094,74.125.68.0-255,5738,293169,92,398153
7738,0.013101,172.31.47.0-255,66,293235,92,398153
7739,0.015138,74.125.68.0-255,5738,298973,92,398153
7740,0.015152,172.31.47.0-255,66,299039,92,398153
7741,0.017179,74.125.68.0-255,5738,304777,92,398153
7742,0.017186,172.31.47.0-255,66,304843,92,398153
7743,0.019217,74.125.68.0-255,5738,310581,92,398153
7744,0.019228,172.31.47.0-255,66,310647,92,398153
7745,0.021248,74.125.68.0-255,5738,316385,92,398153
7746,0.021257,172.31.47.0-255,66,316451,92,398153
7747,0.023275,74.125.68.0-255,5738,322189,92,398153
7748,0.023283,172.31.47.0-255,66,322255,92,398153
7749,0.025305,74.125.68.0-255,4320,326575,92,398153
7750,0.025311,172.31.47.0-255,66,326641,92,398153
7751,0.025332,74.125.68.0-255,1484,328125,92,398153
7752,0.027321,74.125.68.0-255,4320,332445,92,398153
7753,0.027327,172.31.47.0-255,66,332511,92,398153
7754,0.029349,74.125.68.0-255,2902,335413,92,398153
7755,0.029355,172.31.47.0-255,66,335479,92,398153
7756,0.029376,74.125.68.0-255,2902,338381,92,398153
7757,0.029378,172.31.47.0-255,66,338447,92,398153
7758,0.031367,74.125.68.0-255,2902,341349,92,398153
7759,0.031375,172.31.47.0-255,66,341415,92,398153
7760,0.031393,74.125.68.0-255,2902,344317,92,398153
7761,0.031396,172.31.47.0-255,66,344383,92,398153
7762,0.031488,172.31.47.0-255,172,344555,92,398153
7763,0.031525,172.31.47.0-255,1112,345667,92,398153
7764,0.031588,172.31.47.0-255,1514,347181,92,398153
7765,0.03159,172.31.47.0-255,1514,348695,92,398153
7766,0.031595,172.31.47.0-255,1514,350209,92,398153
7767,0.031595,172.31.47.0-255,1514,351723,92,398153
7768,0.031614,172.31.47.0-255,1494,353217,92,398153
7769,0.03301,104.244.42.0-255,66,353283,92,398153
7770,0.03306,104.244.42.0-255,66,353349,92,398153
7771,0.033154,104.244.42.0-255,66,353415,92,398153
7772,0.033179,104.244.42.0-255,66,353481,92,398153
7773,0.033432,74.125.68.0-255,5738,359219,92,398153
7774,0.033436,172.31.47.0-255,66,359285,92,398153
7775,0.035453,74.125.68.0-255,1484,360769,92,398153
7776,0.035476,74.125.68.0-255,2902,363671,92,398153
7777,0.03548,172.31.47.0-255,66,363737,92,398153
7778,0.035492,74.125.68.0-255,1484,365221,92,398153
7779,0.037517,74.125.68.0-255,4320,369541,92,398153
7780,0.037523,172.31.47.0-255,66,369607,92,398153
7781,0.039537,74.125.68.0-255,5738,375345,92,398153
7782,0.039541,172.31.47.0-255,66,375411,92,398153
7783,0.041571,74.125.68.0-255,4320,379731,92,398153
7784,0.041576,172.31.47.0-255,66,379797,92,398153
7785,0.041602,74.125.68.0-255,1484,381281,92,398153
7786,0.043579,74.125.68.0-255,2902,384183,92,398153
7787,0.043583,172.31.47.0-255,66,384249,92,398153
7788,0.043607,74.125.68.0-255,1484,385733,92,398153
7789,0.045589,74.125.68.0-255,4320,390053,92,398153
7790,0.045593,172.31.47.0-255,66,390119,92,398153
7791,0.047617,74.125.68.0-255,5738,395857,92,398153
7792,0.047621,172.31.47.0-255,66,395923,92,398153
7793,0.049654,74.125.68.0-255,1993,397916,92,398153
7794,0.049659,172.31.47.0-255,66,397982,92,398153
7795,0.049826,172.31.47.0-255,105,398087,92,398153
7796,0.051839,74.125.68.0-255,66,398153,92,398153
7797,0.0,74.125.24.0-255,153,153,92,240906
7798,2.5e-05,172.31.47.0-255,66,219,92,240906
7799,3e-05,74.125.24.0-255,1484,1703,92,240906
7800,3.4e-05,172.31.47.0-255,66,1769,92,240906
7801,3.7e-05,74.125.24.0-255,2902,4671,92,240906
7802,4.1e-05,172.31.47.0-255,66,4737,92,240906
7803,4.6e-05,74.125.24.0-255,7156,11893,92,240906
7804,4.9e-05,172.31.47.0-255,66,11959,92,240906
7805,7.1e-05,74.125.24.0-255,1985,13944,92,240906
7806,7.3e-05,172.31.47.0-255,66,14010,92,240906
7807,0.00021,74.125.24.0-255,1484,15494,92,240906
7808,0.000214,172.31.47.0-255,66,15560,92,240906
7809,0.000218,74.125.24.0-255,1484,17044,92,240906
7810,0.000221,172.31.47.0-255,66,17110,92,240906
7811,0.000234,74.125.24.0-255,1484,18594,92,240906
7812,0.000236,172.31.47.0-255,66,18660,92,240906
7813,0.000242,74.125.24.0-255,5738,24398,92,240906
7814,0.000244,172.31.47.0-255,66,24464,92,240906
7815,0.000281,74.125.24.0-255,7156,31620,92,240906
7816,0.000284,172.31.47.0-255,66,31686,92,240906
7817,0.000303,74.125.24.0-255,1125,32811,92,240906
7818,0.000305,172.31.47.0-255,66,32877,92,240906
7819,0.000314,172.31.47.0-255,66,32943,92,240906
7820,0.000341,74.125.24.0-255,4320,37263,92,240906
7821,0.000344,172.31.47.0-255,66,37329,92,240906
7822,0.000362,74.125.24.0-255,2543,39872,92,240906
7823,0.000364,172.31.47.0-255,66,39938,92,240906
7824,0.001727,74.125.24.0-255,1484,41422,92,240906
7825,0.001734,172.31.47.0-255,66,41488,92,240906
7826,0.001744,74.125.24.0-255,2902,44390,92,240906
7827,0.001746,172.31.47.0-255,66,44456,92,240906
7828,0.001751,74.125.24.0-255,2902,47358,92,240906
7829,0.001753,172.31.47.0-255,66,47424,92,240906
7830,0.001782,74.125.24.0-255,2902,50326,92,240906
7831,0.001784,172.31.47.0-255,66,50392,92,240906
7832,0.001791,74.125.24.0-255,6797,57189,92,240906
7833,0.001793,172.31.47.0-255,66,57255,92,240906
7834,0.00186,74.125.24.0-255,1484,58739,92,240906
7835,0.001877,74.125.24.0-255,2902,61641,92,240906
7836,0.00188,172.31.47.0-255,66,61707,92,240906
7837,0.001886,74.125.24.0-255,5738,67445,92,240906
7838,0.001888,172.31.47.0-255,66,67511,92,240906
7839,0.001936,74.125.24.0-255,5738,73249,92,240906
7840,0.001939,172.31.47.0-255,66,73315,92,240906
7841,0.001959,74.125.24.0-255,6797,80112,92,240906
7842,0.001961,172.31.47.0-255,66,80178,92,240906
7843,0.001967,74.125.24.0-255,5738,85916,92,240906
7844,0.001969,172.31.47.0-255,66,85982,92,240906
7845,0.001989,74.125.24.0-255,5959,91941,92,240906
7846,0.001992,172.31.47.0-255,66,92007,92,240906
7847,0.004265,74.125.24.0-255,5738,97745,92,240906
7848,0.004272,172.31.47.0-255,66,97811,92,240906
7849,0.006547,74.125.24.0-255,4320,102131,92,240906
7850,0.006552,172.31.47.0-255,66,102197,92,240906
7851,0.00657,74.125.24.0-255,1484,103681,92,240906
7852,0.008832,74.125.24.0-255,4320,108001,92,240906
7853,0.008841,172.31.47.0-255,66,108067,92,240906
7854,0.011123,74.125.24.0-255,5738,113805,92,240906
7855,0.011132,172.31.47.0-255,66,113871,92,240906
7856,0.013421,74.125.24.0-255,5738,119609,92,240906
7857,0.013432,172.31.47.0-255,66,119675,92,240906
7858,0.01573,74.125.24.0-255,5738,125413,92,240906
7859,0.015747,172.31.47.0-255,66,125479,92,240906
7860,0.018038,74.125.24.0-255,5738,131217,92,240906
7861,0.018046,172.31.47.0-255,66,131283,92,240906
7862,0.020315,74.125.24.0-255,5738,137021,92,240906
7863,0.020322,172.31.47.0-255,66,137087,92,240906
7864,0.022609,74.125.24.0-255,5738,142825,92,240906
7865,0.022617,172.31.47.0-255,66,142891,92,240906
7866,0.024923,74.125.24.0-255,5738,148629,92,240906
7867,0.024932,172.31.47.0-255,66,148695,92,240906
7868,0.026004,172.31.47.0-255,172,148867,92,240906
7869,0.026052,172.31.47.0-255,1112,149979,92,240906
7870,0.026126,172.31.47.0-255,1514,151493,92,240906
7871,0.026128,172.31.47.0-255,1514,153007,92,240906
7872,0.026129,172.31.47.0-255,1514,154521,92,240906
7873,0.02613,172.31.47.0-255,1514,156035,92,240906
7874,0.026131,172.31.47.0-255,1495,157530,92,240906
7875,0.027192,74.125.24.0-255,5738,163268,92,240906
7876,0.027198,172.31.47.0-255,66,163334,92,240906
7877,0.027583,104.244.42.0-255,66,163400,92,240906
7878,0.027748,104.244.42.0-255,66,163466,92,240906
7879,0.027797,104.244.42.0-255,66,163532,92,240906
7880,0.029319,104.244.42.0-255,108,163640,92,240906
7881,0.029326,172.31.47.0-255,66,163706,92,240906
7882,0.029479,74.125.24.0-255,5738,169444,92,240906
7883,0.029483,172.31.47.0-255,66,169510,92,240906
7884,0.031757,74.125.24.0-255,5738,175248,92,240906
7885,0.031763,172.31.47.0-255,66,175314,92,240906
7886,0.03404,74.125.24.0-255,5738,181052,92,240906
7887,0.034046,172.31.47.0-255,66,181118,92,240906
7888,0.036333,74.125.24.0-255,5738,186856,92,240906
7889,0.03634,172.31.47.0-255,66,186922,92,240906
7890,0.038613,74.125.24.0-255,5738,192660,92,240906
7891,0.038619,172.31.47.0-255,66,192726,92,240906
7892,0.040869,74.125.24.0-255,4320,197046,92,240906
7893,0.040874,172.31.47.0-255,66,197112,92,240906
7894,0.040897,74.125.24.0-255,1484,198596,92,240906
7895,0.043141,74.125.24.0-255,4320,202916,92,240906
7896,0.043148,172.31.47.0-255,66,202982,92,240906
7897,0.045424,74.125.24.0-255,5738,208720,92,240906
7898,0.045429,172.31.47.0-255,66,208786,92,240906
7899,0.047713,74.125.24.0-255,5738,214524,92,240906
7900,0.047722,172.31.47.0-255,66,214590,92,240906
7901,0.049998,74.125.24.0-255,5738,220328,92,240906
7902,0.050004,172.31.47.0-255,66,220394,92,240906
7903,0.052278,74.125.24.0-255,4320,224714,92,240906
7904,0.052283,172.31.47.0-255,66,224780,92,240906
7905,0.05231,74.125.24.0-255,1484,226264,92,240906
7906,0.054562,74.125.24.0-255,4320,230584,92,240906
7907,0.054568,172.31.47.0-255,66,230650,92,240906
7908,0.056838,74.125.24.0-255,4320,234970,92,240906
7909,0.056843,172.31.47.0-255,66,235036,92,240906
7910,0.056872,74.125.24.0-255,1484,236520,92,240906
7911,0.059107,74.125.24.0-255,4320,240840,92,240906
7912,0.059112,172.31.47.0-255,66,240906,92,240906
7913,0.0,172.217.194.0-255,153,153,92,287807
7914,2.2e-05,172.31.47.0-255,66,219,92,287807
7915,2.8e-05,172.217.194.0-255,1484,1703,92,287807
7916,3.1e-05,172.31.47.0-255,66,1769,92,287807
7917,3.5e-05,172.217.194.0-255,2902,4671,92,287807
7918,3.7e-05,172.31.47.0-255,66,4737,92,287807
7919,5.8e-05,172.217.194.0-255,7156,11893,92,287807
7920,6e-05,172.31.47.0-255,66,11959,92,287807
7921,6.5e-05,172.217.194.0-255,4320,16279,92,287807
7922,6.9e-05,172.31.47.0-255,66,16345,92,287807
7923,8.2e-05,172.217.194.0-255,2015,18360,92,287807
7924,8.5e-05,172.31.47.0-255,66,18426,92,287807
7925,0.000167,172.217.194.0-255,7156,25582,92,287807
7926,0.000171,172.31.47.0-255,66,25648,92,287807
7927,0.000188,172.217.194.0-255,5379,31027,92,287807
7928,0.000191,172.31.47.0-255,66,31093,92,287807
7929,0.000223,172.217.194.0-255,1484,32577,92,287807
7930,0.000226,172.31.47.0-255,66,32643,92,287807
7931,0.00023,172.217.194.0-255,2902,35545,92,287807
7932,0.000232,172.31.47.0-255,66,35611,92,287807
7933,0.000237,172.217.194.0-255,5738,41349,92,287807
7934,0.000239,172.31.47.0-255,66,41415,92,287807
7935,0.000279,172.31.47.0-255,66,41481,92,287807
7936,0.000297,172.217.194.0-255,1125,42606,92,287807
7937,0.0003,172.31.47.0-255,66,42672,92,287807
7938,0.000309,172.31.47.0-255,66,42738,92,287807
7939,0.00033,172.217.194.0-255,1439,44177,92,287807
7940,0.000332,172.31.47.0-255,66,44243,92,287807
7941,0.000402,172.217.194.0-255,99,44342,92,287807
7942,0.000405,172.31.47.0-255,66,44408,92,287807
7943,0.000533,172.217.194.0-255,365,44773,92,287807
7944,0.000708,172.31.47.0-255,66,44839,92,287807
7945,0.000945,172.217.194.0-255,1484,46323,92,287807
7946,0.000953,172.217.194.0-255,2902,49225,92,287807
7947,0.000956,172.31.47.0-255,66,49291,92,287807
7948,0.000963,172.217.194.0-255,5738,55029,92,287807
7949,0.000964,172.31.47.0-255,66,55095,92,287807
7950,0.001002,172.31.47.0-255,66,55161,92,287807
7951,0.001032,172.31.47.0-255,66,55227,92,287807
7952,0.001134,172.217.194.0-255,1484,56711,92,287807
7953,0.001137,172.217.194.0-255,1484,58195,92,287807
7954,0.001148,172.31.47.0-255,66,58261,92,287807
7955,0.001152,172.217.194.0-255,1484,59745,92,287807
7956,0.001177,172.217.194.0-255,5738,65483,92,287807
7957,0.001181,172.31.47.0-255,66,65549,92,287807
7958,0.001185,172.217.194.0-255,4320,69869,92,287807
7959,0.001187,172.31.47.0-255,66,69935,92,287807
7960,0.001193,172.217.194.0-255,7156,77091,92,287807
7961,0.001194,172.31.47.0-255,66,77157,92,287807
7962,0.001221,172.217.194.0-255,4320,81477,92,287807
7963,0.001224,172.31.47.0-255,66,81543,92,287807
7964,0.001233,172.31.47.0-255,66,81609,92,287807
7965,0.001703,172.217.194.0-255,1484,83093,92,287807
7966,0.00171,172.217.194.0-255,2902,85995,92,287807
7967,0.001713,172.31.47.0-255,66,86061,92,287807
7968,0.001719,172.217.194.0-255,4320,90381,92,287807
7969,0.00172,172.31.47.0-255,66,90447,92,287807
7970,0.00173,172.217.194.0-255,1484,91931,92,287807
7971,0.001733,172.217.194.0-255,2902,94833,92,287807
7972,0.001735,172.31.47.0-255,66,94899,92,287807
7973,0.001751,172.217.194.0-255,4320,99219,92,287807
7974,0.001753,172.31.47.0-255,66,99285,92,287807
7975,0.001756,172.217.194.0-255,1484,100769,92,287807
7976,0.001791,172.31.47.0-255,66,100835,92,287807
7977,0.001794,172.217.194.0-255,2184,103019,92,287807
7978,0.001796,172.31.47.0-255,66,103085,92,287807
7979,0.001852,172.217.194.0-255,1484,104569,92,287807
7980,0.001857,172.217.194.0-255,2902,107471,92,287807
7981,0.001859,172.31.47.0-255,66,107537,92,287807
7982,0.001875,172.217.194.0-255,1484,109021,92,287807
7983,0.00189,172.217.194.0-255,4320,113341,92,287807
7984,0.001892,172.31.47.0-255,66,113407,92,287807
7985,0.001895,172.217.194.0-255,1484,114891,92,287807
7986,0.001923,172.31.47.0-255,66,114957,92,287807
7987,0.001933,172.217.194.0-255,1484,116441,92,287807
7988,0.001959,172.217.194.0-255,7156,123597,92,287807
7989,0.001962,172.31.47.0-255,66,123663,92,287807
7990,0.001972,172.217.194.0-255,3602,127265,92,287807
7991,0.001973,172.31.47.0-255,66,127331,92,287807
7992,0.002135,172.217.194.0-255,1484,128815,92,287807
7993,0.002151,172.217.194.0-255,2902,131717,92,287807
7994,0.002153,172.31.47.0-255,66,131783,92,287807
7995,0.002201,172.217.194.0-255,5738,137521,92,287807
7996,0.002203,172.31.47.0-255,66,137587,92,287807
7997,0.002212,172.31.47.0-255,66,137653,92,287807
7998,0.002226,172.217.194.0-255,1484,139137,92,287807
7999,0.002252,172.31.47.0-255,66,139203,92,287807
8000,0.004491,172.217.194.0-255,5738,144941,92,287807
8001,0.004496,172.31.47.0-255,66,145007,92,287807
8002,0.006755,172.217.194.0-255,5738,150745,92,287807
8003,0.006761,172.31.47.0-255,66,150811,92,287807
8004,0.009031,172.217.194.0-255,5738,156549,92,287807
8005,0.009039,172.31.47.0-255,66,156615,92,287807
8006,0.011292,172.217.194.0-255,5738,162353,92,287807
8007,0.0113,172.31.47.0-255,66,162419,92,287807
8008,0.013539,172.217.194.0-255,5738,168157,92,287807
8009,0.013547,172.31.47.0-255,66,168223,92,287807
8010,0.015802,172.217.194.0-255,5738,173961,92,287807
8011,0.01581,172.31.47.0-255,66,174027,92,287807
8012,0.018053,172.217.194.0-255,5738,179765,92,287807
8013,0.018058,172.31.47.0-255,66,179831,92,287807
8014,0.02032,172.217.194.0-255,5738,185569,92,287807
8015,0.020326,172.31.47.0-255,66,185635,92,287807
8016,0.022559,172.217.194.0-255,5738,191373,92,287807
8017,0.022565,172.31.47.0-255,66,191439,92,287807
8018,0.024834,172.217.194.0-255,5738,197177,92,287807
8019,0.02484,172.31.47.0-255,66,197243,92,287807
8020,0.027083,172.217.194.0-255,5738,202981,92,287807
8021,0.027091,172.31.47.0-255,66,203047,92,287807
8022,0.028998,172.31.47.0-255,172,203219,92,287807
8023,0.029026,172.31.47.0-255,1112,204331,92,287807
8024,0.029052,172.31.47.0-255,570,204901,92,287807
8025,0.029351,172.217.194.0-255,5738,210639,92,287807
8026,0.029356,172.31.47.0-255,66,210705,92,287807
8027,0.030491,104.244.42.0-255,66,210771,92,287807
8028,0.030577,104.244.42.0-255,66,210837,92,287807
8029,0.03058,104.244.42.0-255,66,210903,92,287807
8030,0.031605,172.217.194.0-255,2902,213805,92,287807
8031,0.031609,172.31.47.0-255,66,213871,92,287807
8032,0.031628,172.217.194.0-255,2902,216773,92,287807
8033,0.03163,172.31.47.0-255,66,216839,92,287807
8034,0.033839,172.217.194.0-255,2902,219741,92,287807
8035,0.033843,172.31.47.0-255,66,219807,92,287807
8036,0.033927,172.217.194.0-255,2902,222709,92,287807
8037,0.03393,172.31.47.0-255,66,222775,92,287807
8038,0.036084,172.217.194.0-255,2902,225677,92,287807
8039,0.036089,172.31.47.0-255,66,225743,92,287807
8040,0.036155,172.217.194.0-255,2902,228645,92,287807
8041,0.03616,172.31.47.0-255,66,228711,92,287807
8042,0.038329,172.217.194.0-255,2902,231613,92,287807
8043,0.038335,172.31.47.0-255,66,231679,92,287807
8044,0.038375,172.217.194.0-255,2902,234581,92,287807
8045,0.038379,172.31.47.0-255,66,234647,92,287807
8046,0.040592,172.217.194.0-255,2902,237549,92,287807
8047,0.040597,172.31.47.0-255,66,237615,92,287807
8048,0.040626,172.217.194.0-255,2902,240517,92,287807
8049,0.040629,172.31.47.0-255,66,240583,92,287807
8050,0.042818,172.217.194.0-255,2902,243485,92,287807
8051,0.042834,172.31.47.0-255,66,243551,92,287807
8052,0.042852,172.217.194.0-255,2902,246453,92,287807
8053,0.042855,172.31.47.0-255,66,246519,92,287807
8054,0.045079,172.217.194.0-255,5738,252257,92,287807
8055,0.045085,172.31.47.0-255,66,252323,92,287807
8056,0.047342,172.217.194.0-255,5738,258061,92,287807
8057,0.047348,172.31.47.0-255,66,258127,92,287807
8058,0.049587,172.217.194.0-255,2902,261029,92,287807
8059,0.049592,172.31.47.0-255,66,261095,92,287807
8060,0.049615,172.217.194.0-255,2902,263997,92,287807
8061,0.049618,172.31.47.0-255,66,264063,92,287807
8062,0.051822,172.217.194.0-255,2902,266965,92,287807
8063,0.051827,172.31.47.0-255,66,267031,92,287807
8064,0.051861,172.217.194.0-255,2902,269933,92,287807
8065,0.051864,172.31.47.0-255,66,269999,92,287807
8066,0.054064,172.217.194.0-255,2902,272901,92,287807
8067,0.05407,172.31.47.0-255,66,272967,92,287807
8068,0.054173,172.217.194.0-255,2902,275869,92,287807
8069,0.054175,172.31.47.0-255,66,275935,92,287807
8070,0.056312,172.217.194.0-255,2902,278837,92,287807
8071,0.056317,172.31.47.0-255,66,278903,92,287807
8072,0.056402,172.217.194.0-255,2902,281805,92,287807
8073,0.056407,172.31.47.0-255,66,281871,92,287807
8074,0.058563,172.217.194.0-255,2902,284773,92,287807
8075,0.058568,172.31.47.0-255,66,284839,92,287807
8076,0.058671,172.217.194.0-255,2902,287741,92,287807
8077,0.058676,172.31.47.0-255,66,287807,92,287807
8078,0.0,74.125.200.0-255,153,153,92,383719
8079,2.9e-05,172.31.47.0-255,66,219,92,383719
8080,3.6e-05,74.125.200.0-255,1484,1703,92,383719
8081,4e-05,172.31.47.0-255,66,1769,92,383719
8082,4.4e-05,74.125.200.0-255,2902,4671,92,383719
8083,4.6e-05,172.31.47.0-255,66,4737,92,383719
8084,7.1e-05,74.125.200.0-255,7156,11893,92,383719
8085,7.3e-05,172.31.47.0-255,66,11959,92,383719
8086,7.6e-05,74.125.200.0-255,1484,13443,92,383719
8087,8e-05,172.31.47.0-255,66,13509,92,383719
8088,9.8e-05,74.125.200.0-255,2083,15592,92,383719
8089,0.0001,172.31.47.0-255,66,15658,92,383719
8090,0.000124,74.125.200.0-255,4320,19978,92,383719
8091,0.000127,172.31.47.0-255,66,20044,92,383719
8092,0.000145,74.125.200.0-255,1484,21528,92,383719
8093,0.000147,172.31.47.0-255,66,21594,92,383719
8094,0.000151,74.125.200.0-255,4320,25914,92,383719
8095,0.000153,172.31.47.0-255,66,25980,92,383719
8096,0.000166,74.125.200.0-255,2902,28882,92,383719
8097,0.000168,172.31.47.0-255,66,28948,92,383719
8098,0.000191,74.125.200.0-255,2543,31491,92,383719
8099,0.000193,172.31.47.0-255,66,31557,92,383719
8100,0.000344,74.125.200.0-255,1484,33041,92,383719
8101,0.000349,172.31.47.0-255,66,33107,92,383719
8102,0.000367,74.125.200.0-255,1484,34591,92,383719
8103,0.000369,172.31.47.0-255,66,34657,92,383719
8104,0.000384,74.125.200.0-255,1484,36141,92,383719
8105,0.000387,172.31.47.0-255,66,36207,92,383719
8106,0.000416,74.125.200.0-255,1484,37691,92,383719
8107,0.000418,172.31.47.0-255,66,37757,92,383719
8108,0.000423,74.125.200.0-255,2902,40659,92,383719
8109,0.000425,172.31.47.0-255,66,40725,92,383719
8110,0.00046,74.125.200.0-255,1484,42209,92,383719
8111,0.000465,74.125.200.0-255,2902,45111,92,383719
8112,0.000468,172.31.47.0-255,66,45177,92,383719
8113,0.000475,74.125.200.0-255,1484,46661,92,383719
8114,0.000486,74.125.200.0-255,2543,49204,92,383719
8115,0.000488,172.31.47.0-255,66,49270,92,383719
8116,0.000491,74.125.200.0-255,1484,50754,92,383719
8117,0.000508,74.125.200.0-255,2902,53656,92,383719
8118,0.000511,172.31.47.0-255,66,53722,92,383719
8119,0.000547,74.125.200.0-255,1484,55206,92,383719
8120,0.00056,74.125.200.0-255,1484,56690,92,383719
8121,0.000563,172.31.47.0-255,66,56756,92,383719
8122,0.000574,74.125.200.0-255,1484,58240,92,383719
8123,0.000592,74.125.200.0-255,2902,61142,92,383719
8124,0.000595,172.31.47.0-255,66,61208,92,383719
8125,0.000598,74.125.200.0-255,1484,62692,92,383719
8126,0.000601,74.125.200.0-255,2902,65594,92,383719
8127,0.000603,172.31.47.0-255,66,65660,92,383719
8128,0.000631,74.125.200.0-255,1399,67059,92,383719
8129,0.000656,74.125.200.0-255,130,67189,92,383719
8130,0.000707,172.31.47.0-255,66,67255,92,383719
8131,0.000822,74.125.200.0-255,1484,68739,92,383719
8132,0.000847,74.125.200.0-255,2902,71641,92,383719
8133,0.000851,172.31.47.0-255,66,71707,92,383719
8134,0.000869,74.125.200.0-255,2902,74609,92,383719
8135,0.000872,172.31.47.0-255,66,74675,92,383719
8136,0.00089,74.125.200.0-255,2902,77577,92,383719
8137,0.000892,172.31.47.0-255,66,77643,92,383719
8138,0.000896,74.125.200.0-255,2902,80545,92,383719
8139,0.000898,172.31.47.0-255,66,80611,92,383719
8140,0.000901,74.125.200.0-255,2902,83513,92,383719
8141,0.000903,172.31.47.0-255,66,83579,92,383719
8142,0.000918,74.125.200.0-255,1484,85063,92,383719
8143,0.000939,74.125.200.0-255,4320,89383,92,383719
8144,0.000942,172.31.47.0-255,66,89449,92,383719
8145,0.00096,74.125.200.0-255,2902,92351,92,383719
8146,0.000963,172.31.47.0-255,66,92417,92,383719
8147,0.000967,74.125.200.0-255,2902,95319,92,383719
8148,0.000969,172.31.47.0-255,66,95385,92,383719
8149,0.000986,74.125.200.0-255,5738,101123,92,383719
8150,0.000988,172.31.47.0-255,66,101189,92,383719
8151,0.000991,74.125.200.0-255,766,101955,92,383719
8152,0.001038,74.125.200.0-255,348,102303,92,383719
8153,0.001089,74.125.200.0-255,1484,103787,92,383719
8154,0.001092,172.31.47.0-255,66,103853,92,383719
8155,0.001105,74.125.200.0-255,2902,106755,92,383719
8156,0.001108,172.31.47.0-255,66,106821,92,383719
8157,0.001133,74.125.200.0-255,4320,111141,92,383719
8158,0.001136,172.31.47.0-255,66,111207,92,383719
8159,0.001152,74.125.200.0-255,1484,112691,92,383719
8160,0.001156,74.125.200.0-255,2902,115593,92,383719
8161,0.001158,172.31.47.0-255,66,115659,92,383719
8162,0.001162,74.125.200.0-255,4320,119979,92,383719
8163,0.001163,172.31.47.0-255,66,120045,92,383719
8164,0.001187,74.125.200.0-255,2902,122947,92,383719
8165,0.001189,172.31.47.0-255,66,123013,92,383719
8166,0.001199,74.125.200.0-255,1484,124497,92,383719
8167,0.001209,74.125.200.0-255,1484,125981,92,383719
8168,0.001211,172.31.47.0-255,66,126047,92,383719
8169,0.001224,74.125.200.0-255,4320,130367,92,383719
8170,0.001227,172.31.47.0-255,66,130433,92,383719
8171,0.001255,74.125.200.0-255,6438,136871,92,383719
8172,0.001257,172.31.47.0-255,66,136937,92,383719
8173,0.001399,74.125.200.0-255,1484,138421,92,383719
8174,0.00142,74.125.200.0-255,2902,141323,92,383719
8175,0.001422,172.31.47.0-255,66,141389,92,383719
8176,0.001443,74.125.200.0-255,5738,147127,92,383719
8177,0.001446,172.31.47.0-255,66,147193,92,383719
8178,0.001449,74.125.200.0-255,2902,150095,92,383719
8179,0.00145,172.31.47.0-255,66,150161,92,383719
8180,0.001454,74.125.200.0-255,4320,154481,92,383719
8181,0.001456,172.31.47.0-255,66,154547,92,383719
8182,0.00147,74.125.200.0-255,1484,156031,92,383719
8183,0.001496,74.125.200.0-255,7156,163187,92,383719
8184,0.001498,172.31.47.0-255,66,163253,92,383719
8185,0.001504,74.125.200.0-255,7156,170409,92,383719
8186,0.001506,172.31.47.0-255,66,170475,92,383719
8187,0.001521,74.125.200.0-255,766,171241,92,383719
8188,0.001735,74.125.200.0-255,1484,172725,92,383719
8189,0.001737,172.31.47.0-255,66,172791,92,383719
8190,0.001748,74.125.200.0-255,2902,175693,92,383719
8191,0.00175,172.31.47.0-255,66,175759,92,383719
8192,0.001781,74.125.200.0-255,5738,181497,92,383719
8193,0.001782,172.31.47.0-255,66,181563,92,383719
8194,0.001797,74.125.200.0-255,1484,183047,92,383719
8195,0.001818,74.125.200.0-255,5738,188785,92,383719
8196,0.00182,172.31.47.0-255,66,188851,92,383719
8197,0.001853,172.31.47.0-255,66,188917,92,383719
8198,0.001904,172.31.47.0-255,66,188983,92,383719
8199,0.00205,74.125.200.0-255,1484,190467,92,383719
8200,0.00206,74.125.200.0-255,2902,193369,92,383719
8201,0.002062,172.31.47.0-255,66,193435,92,383719
8202,0.002086,74.125.200.0-255,1484,194919,92,383719
8203,0.002097,74.125.200.0-255,2902,197821,92,383719
8204,0.002099,172.31.47.0-255,66,197887,92,383719
8205,0.002114,74.125.200.0-255,1484,199371,92,383719
8206,0.002118,74.125.200.0-255,2902,202273,92,383719
8207,0.00212,172.31.47.0-255,66,202339,92,383719
8208,0.002138,74.125.200.0-255,4320,206659,92,383719
8209,0.00214,172.31.47.0-255,66,206725,92,383719
8210,0.002175,74.125.200.0-255,4320,211045,92,383719
8211,0.002177,172.31.47.0-255,66,211111,92,383719
8212,0.002195,74.125.200.0-255,1484,212595,92,383719
8213,0.002197,74.125.200.0-255,1484,214079,92,383719
8214,0.002198,172.31.47.0-255,66,214145,92,383719
8215,0.002211,74.125.200.0-255,2902,217047,92,383719
8216,0.002213,172.31.47.0-255,66,217113,92,383719
8217,0.002238,74.125.200.0-255,2902,220015,92,383719
8218,0.002239,172.31.47.0-255,66,220081,92,383719
8219,0.002256,74.125.200.0-255,2902,222983,92,383719
8220,0.002257,172.31.47.0-255,66,223049,92,383719
8221,0.002259,74.125.200.0-255,766,223815,92,383719
8222,0.002285,74.125.200.0-255,1484,225299,92,383719
8223,0.002287,172.31.47.0-255,66,225365,92,383719
8224,0.002296,74.125.200.0-255,1484,226849,92,383719
8225,0.002309,74.125.200.0-255,2902,229751,92,383719
8226,0.002311,172.31.47.0-255,66,229817,92,383719
8227,0.004572,74.125.200.0-255,1484,231301,92,383719
8228,0.004597,74.125.200.0-255,2902,234203,92,383719
8229,0.0046,172.31.47.0-255,66,234269,92,383719
8230,0.004618,74.125.200.0-255,1484,235753,92,383719
8231,0.006901,74.125.200.0-255,4320,240073,92,383719
8232,0.006907,172.31.47.0-255,66,240139,92,383719
8233,0.009205,74.125.200.0-255,5738,245877,92,383719
8234,0.009212,172.31.47.0-255,66,245943,92,383719
8235,0.011513,74.125.200.0-255,5738,251681,92,383719
8236,0.011522,172.31.47.0-255,66,251747,92,383719
8237,0.013822,74.125.200.0-255,5738,257485,92,383719
8238,0.013835,172.31.47.0-255,66,257551,92,383719
8239,0.016142,74.125.200.0-255,5738,263289,92,383719
8240,0.016149,172.31.47.0-255,66,263355,92,383719
8241,0.018448,74.125.200.0-255,5738,269093,92,383719
8242,0.018454,172.31.47.0-255,66,269159,92,383719
8243,0.020753,74.125.200.0-255,5738,274897,92,383719
8244,0.02076,172.31.47.0-255,66,274963,92,383719
8245,0.02306,74.125.200.0-255,5738,280701,92,383719
8246,0.023067,172.31.47.0-255,66,280767,92,383719
8247,0.025373,74.125.200.0-255,5738,286505,92,383719
8248,0.025381,172.31.47.0-255,66,286571,92,383719
8249,0.027687,74.125.200.0-255,5738,292309,92,383719
8250,0.027697,172.31.47.0-255,66,292375,92,383719
8251,0.028782,172.31.47.0-255,172,292547,92,383719
8252,0.028813,172.31.47.0-255,1112,293659,92,383719
8253,0.028844,172.31.47.0-255,1514,295173,92,383719
8254,0.028845,172.31.47.0-255,1514,296687,92,383719
8255,0.02885,172.31.47.0-255,1514,298201,92,383719
8256,0.028851,172.31.47.0-255,1514,299715,92,383719
8257,0.028878,172.31.47.0-255,1494,301209,92,383719
8258,0.029985,74.125.200.0-255,2902,304111,92,383719
8259,0.02999,172.31.47.0-255,66,304177,92,383719
8260,0.030015,74.125.200.0-255,2902,307079,92,383719
8261,0.030017,172.31.47.0-255,66,307145,92,383719
8262,0.030281,104.244.42.0-255,66,307211,92,383719
8263,0.030314,104.244.42.0-255,66,307277,92,383719
8264,0.03036,104.244.42.0-255,66,307343,92,383719
8265,0.030395,104.244.42.0-255,66,307409,92,383719
8266,0.032283,74.125.200.0-255,2902,310311,92,383719
8267,0.032287,172.31.47.0-255,66,310377,92,383719
8268,0.03231,74.125.200.0-255,2902,313279,92,383719
8269,0.032312,172.31.47.0-255,66,313345,92,383719
8270,0.034576,74.125.200.0-255,2902,316247,92,383719
8271,0.034581,172.31.47.0-255,66,316313,92,383719
8272,0.034606,74.125.200.0-255,2902,319215,92,383719
8273,0.034608,172.31.47.0-255,66,319281,92,383719
8274,0.036885,74.125.200.0-255,5738,325019,92,383719
8275,0.036892,172.31.47.0-255,66,325085,92,383719
8276,0.039203,74.125.200.0-255,5738,330823,92,383719
8277,0.03921,172.31.47.0-255,66,330889,92,383719
8278,0.04151,74.125.200.0-255,5738,336627,92,383719
8279,0.041525,172.31.47.0-255,66,336693,92,383719
8280,0.043837,74.125.200.0-255,5738,342431,92,383719
8281,0.043845,172.31.47.0-255,66,342497,92,383719
8282,0.04613,74.125.200.0-255,2902,345399,92,383719
8283,0.046135,172.31.47.0-255,66,345465,92,383719
8284,0.046162,74.125.200.0-255,2902,348367,92,383719
8285,0.046166,172.31.47.0-255,66,348433,92,383719
8286,0.048425,74.125.200.0-255,2902,351335,92,383719
8287,0.048431,172.31.47.0-255,66,351401,92,383719
8288,0.048458,74.125.200.0-255,2902,354303,92,383719
8289,0.048461,172.31.47.0-255,66,354369,92,383719
8290,0.050735,74.125.200.0-255,2902,357271,92,383719
8291,0.05074,172.31.47.0-255,66,357337,92,383719
8292,0.050769,74.125.200.0-255,2902,360239,92,383719
8293,0.050772,172.31.47.0-255,66,360305,92,383719
8294,0.053027,74.125.200.0-255,2902,363207,92,383719
8295,0.053032,172.31.47.0-255,66,363273,92,383719
8296,0.05306,74.125.200.0-255,2902,366175,92,383719
8297,0.053063,172.31.47.0-255,66,366241,92,383719
8298,0.055322,74.125.200.0-255,1484,367725,92,383719
8299,0.055356,74.125.200.0-255,4320,372045,92,383719
8300,0.05536,172.31.47.0-255,66,372111,92,383719
8301,0.057645,74.125.200.0-255,5738,377849,92,383719
8302,0.057651,172.31.47.0-255,66,377915,92,383719
8303,0.059952,74.125.200.0-255,5738,383653,92,383719
8304,0.059957,172.31.47.0-255,66,383719,92,383719
8305,0.0,74.125.200.0-255,153,153,92,193680
8306,2e-05,172.31.47.0-255,66,219,92,193680
8307,2.7e-05,74.125.200.0-255,1484,1703,92,193680
8308,3.2e-05,172.31.47.0-255,66,1769,92,193680
8309,3.6e-05,74.125.200.0-255,2902,4671,92,193680
8310,4e-05,172.31.47.0-255,66,4737,92,193680
8311,4.7e-05,74.125.200.0-255,7156,11893,92,193680
8312,5.8e-05,172.31.47.0-255,66,11959,92,193680
8313,6.2e-05,74.125.200.0-255,2063,14022,92,193680
8314,6.4e-05,172.31.47.0-255,66,14088,92,193680
8315,6.9e-05,74.125.200.0-255,2902,16990,92,193680
8316,7.1e-05,172.31.47.0-255,66,17056,92,193680
8317,9.4e-05,74.125.200.0-255,2902,19958,92,193680
8318,9.7e-05,172.31.47.0-255,66,20024,92,193680
8319,0.000119,74.125.200.0-255,4320,24344,92,193680
8320,0.000122,172.31.47.0-255,66,24410,92,193680
8321,0.000129,74.125.200.0-255,6797,31207,92,193680
8322,0.000131,172.31.47.0-255,66,31273,92,193680
8323,0.00022,74.125.200.0-255,1484,32757,92,193680
8324,0.000223,172.31.47.0-255,66,32823,92,193680
8325,0.000249,74.125.200.0-255,2902,35725,92,193680
8326,0.000251,172.31.47.0-255,66,35791,92,193680
8327,0.000276,74.125.200.0-255,4320,40111,92,193680
8328,0.000279,172.31.47.0-255,66,40177,92,193680
8329,0.000312,172.31.47.0-255,66,40243,92,193680
8330,0.000315,74.125.200.0-255,1484,41727,92,193680
8331,0.000316,172.31.47.0-255,66,41793,92,193680
8332,0.000342,74.125.200.0-255,7156,48949,92,193680
8333,0.000345,172.31.47.0-255,66,49015,92,193680
8334,0.000349,74.125.200.0-255,2902,51917,92,193680
8335,0.00035,172.31.47.0-255,66,51983,92,193680
8336,0.000385,74.125.200.0-255,5692,57675,92,193680
8337,0.000389,74.125.200.0-255,107,57782,92,193680
8338,0.000534,74.125.200.0-255,332,58114,92,193680
8339,0.000576,172.31.47.0-255,66,58180,92,193680
8340,0.00408,74.125.200.0-255,1484,59664,92,193680
8341,0.004097,74.125.200.0-255,2902,62566,92,193680
8342,0.004107,172.31.47.0-255,66,62632,92,193680
8343,0.004113,74.125.200.0-255,1484,64116,92,193680
8344,0.006657,74.125.200.0-255,4320,68436,92,193680
8345,0.006727,172.31.47.0-255,66,68502,92,193680
8346,0.009269,74.125.200.0-255,5738,74240,92,193680
8347,0.009282,172.31.47.0-255,66,74306,92,193680
8348,0.011827,74.125.200.0-255,5738,80044,92,193680
8349,0.011843,172.31.47.0-255,66,80110,92,193680
8350,0.014392,74.125.200.0-255,5738,85848,92,193680
8351,0.014407,172.31.47.0-255,66,85914,92,193680
8352,0.016968,74.125.200.0-255,5738,91652,92,193680
8353,0.016989,172.31.47.0-255,66,91718,92,193680
8354,0.019533,74.125.200.0-255,5738,97456,92,193680
8355,0.019552,172.31.47.0-255,66,97522,92,193680
8356,0.022111,74.125.200.0-255,5738,103260,92,193680
8357,0.022131,172.31.47.0-255,66,103326,92,193680
8358,0.02467,74.125.200.0-255,5738,109064,92,193680
8359,0.02469,172.31.47.0-255,66,109130,92,193680
8360,0.027258,74.125.200.0-255,5738,114868,92,193680
8361,0.02728,172.31.47.0-255,66,114934,92,193680
8362,0.029837,74.125.200.0-255,5738,120672,92,193680
8363,0.029859,172.31.47.0-255,66,120738,92,193680
8364,0.032416,74.125.200.0-255,5738,126476,92,193680
8365,0.032436,172.31.47.0-255,66,126542,92,193680
8366,0.034991,74.125.200.0-255,5738,132280,92,193680
8367,0.03501,172.31.47.0-255,66,132346,92,193680
8368,0.036062,172.31.47.0-255,172,132518,92,193680
8369,0.036097,172.31.47.0-255,1107,133625,92,193680
8370,0.036174,172.31.47.0-255,1514,135139,92,193680
8371,0.036175,172.31.47.0-255,1514,136653,92,193680
8372,0.036177,172.31.47.0-255,1514,138167,92,193680
8373,0.036178,172.31.47.0-255,1514,139681,92,193680
8374,0.036206,172.31.47.0-255,1499,141180,92,193680
8375,0.037539,74.125.200.0-255,5738,146918,92,193680
8376,0.037548,172.31.47.0-255,66,146984,92,193680
8377,0.037609,104.244.42.0-255,66,147050,92,193680
8378,0.037617,104.244.42.0-255,66,147116,92,193680
8379,0.037722,104.244.42.0-255,66,147182,92,193680
8380,0.037805,104.244.42.0-255,66,147248,92,193680
8381,0.040099,74.125.200.0-255,5738,152986,92,193680
8382,0.040106,172.31.47.0-255,66,153052,92,193680
8383,0.042666,74.125.200.0-255,5738,158790,92,193680
8384,0.042677,172.31.47.0-255,66,158856,92,193680
8385,0.045222,74.125.200.0-255,5738,164594,92,193680
8386,0.045228,172.31.47.0-255,66,164660,92,193680
8387,0.047763,74.125.200.0-255,5738,170398,92,193680
8388,0.04777,172.31.47.0-255,66,170464,92,193680
8389,0.050303,74.125.200.0-255,5738,176202,92,193680
8390,0.050308,172.31.47.0-255,66,176268,92,193680
8391,0.052847,74.125.200.0-255,5738,182006,92,193680
8392,0.052854,172.31.47.0-255,66,182072,92,193680
8393,0.055383,74.125.200.0-255,5738,187810,92,193680
8394,0.05539,172.31.47.0-255,66,187876,92,193680
8395,0.057934,74.125.200.0-255,5738,193614,92,193680
8396,0.05794,172.31.47.0-255,66,193680,92,193680
8397,0.0,172.31.47.0-255,105,105,92,381
8398,6.2e-05,172.31.47.0-255,105,210,92,381
8399,0.002447,157.240.13.0-255,105,315,92,381
8400,0.00246,172.31.47.0-255,66,381,92,381
8401,0.0,172.31.47.0-255,105,105,92,105
8402,0.0,172.217.194.0-255,298,298,92,259273
8403,1.5e-05,172.31.47.0-255,66,364,92,259273
8404,2.1e-05,172.217.194.0-255,1484,1848,92,259273
8405,2.5e-05,172.31.47.0-255,66,1914,92,259273
8406,3.2e-05,172.217.194.0-255,4320,6234,92,259273
8407,3.6e-05,172.31.47.0-255,66,6300,92,259273
8408,6.3e-05,172.217.194.0-255,5738,12038,92,259273
8409,6.6e-05,172.31.47.0-255,66,12104,92,259273
8410,0.000113,172.217.194.0-255,1881,13985,92,259273
8411,0.000115,172.31.47.0-255,66,14051,92,259273
8412,0.000292,172.217.194.0-255,1484,15535,92,259273
8413,0.000298,172.31.47.0-255,66,15601,92,259273
8414,0.000304,172.217.194.0-255,2902,18503,92,259273
8415,0.000307,172.31.47.0-255,66,18569,92,259273
8416,0.00031,172.217.194.0-255,1484,20053,92,259273
8417,0.000312,172.31.47.0-255,66,20119,92,259273
8418,0.000338,172.217.194.0-255,4320,24439,92,259273
8419,0.000341,172.31.47.0-255,66,24505,92,259273
8420,0.000344,172.217.194.0-255,1484,25989,92,259273
8421,0.000346,172.31.47.0-255,66,26055,92,259273
8422,0.000373,172.31.47.0-255,66,26121,92,259273
8423,0.00038,172.217.194.0-255,7156,33277,92,259273
8424,0.000383,172.31.47.0-255,66,33343,92,259273
8425,0.0004,172.217.194.0-255,2902,36245,92,259273
8426,0.000402,172.31.47.0-255,66,36311,92,259273
8427,0.000447,172.31.47.0-255,66,36377,92,259273
8428,0.000451,172.217.194.0-255,2184,38561,92,259273
8429,0.000453,172.31.47.0-255,66,38627,92,259273
8430,0.000456,172.217.194.0-255,365,38992,92,259273
8431,0.000458,172.31.47.0-255,66,39058,92,259273
8432,0.000676,172.217.194.0-255,377,39435,92,259273
8433,0.000701,172.217.194.0-255,1484,40919,92,259273
8434,0.000707,172.31.47.0-255,66,40985,92,259273
8435,0.000753,172.217.194.0-255,2902,43887,92,259273
8436,0.000756,172.31.47.0-255,66,43953,92,259273
8437,0.000763,172.217.194.0-255,5738,49691,92,259273
8438,0.000765,172.31.47.0-255,66,49757,92,259273
8439,0.000777,172.31.47.0-255,66,49823,92,259273
8440,0.00079,172.217.194.0-255,4320,54143,92,259273
8441,0.000792,172.31.47.0-255,66,54209,92,259273
8442,0.000797,172.217.194.0-255,5738,59947,92,259273
8443,0.0008,172.31.47.0-255,66,60013,92,259273
8444,0.000835,172.217.194.0-255,5020,65033,92,259273
8445,0.000837,172.31.47.0-255,66,65099,92,259273
8446,0.001546,172.217.194.0-255,1484,66583,92,259273
8447,0.001566,172.217.194.0-255,2902,69485,92,259273
8448,0.00157,172.31.47.0-255,66,69551,92,259273
8449,0.001576,172.217.194.0-255,5738,75289,92,259273
8450,0.001578,172.31.47.0-255,66,75355,92,259273
8451,0.001603,172.31.47.0-255,66,75421,92,259273
8452,0.001646,172.217.194.0-255,5738,81159,92,259273
8453,0.001649,172.31.47.0-255,66,81225,92,259273
8454,0.001671,172.217.194.0-255,6438,87663,92,259273
8455,0.001673,172.31.47.0-255,66,87729,92,259273
8456,0.003662,172.217.194.0-255,5738,93467,92,259273
8457,0.003668,172.31.47.0-255,66,93533,92,259273
8458,0.005672,172.217.194.0-255,5738,99271,92,259273
8459,0.005677,172.31.47.0-255,66,99337,92,259273
8460,0.007704,172.217.194.0-255,5738,105075,92,259273
8461,0.007708,172.31.47.0-255,66,105141,92,259273
8462,0.009702,172.217.194.0-255,5738,110879,92,259273
8463,0.00971,172.31.47.0-255,66,110945,92,259273
8464,0.011719,172.217.194.0-255,5738,116683,92,259273
8465,0.011724,172.31.47.0-255,66,116749,92,259273
8466,0.013745,172.217.194.0-255,5738,122487,92,259273
8467,0.013752,172.31.47.0-255,66,122553,92,259273
8468,0.015771,172.217.194.0-255,5738,128291,92,259273
8469,0.015777,172.31.47.0-255,66,128357,92,259273
8470,0.017792,172.217.194.0-255,5738,134095,92,259273
8471,0.017799,172.31.47.0-255,66,134161,92,259273
8472,0.019837,172.217.194.0-255,5738,139899,92,259273
8473,0.019845,172.31.47.0-255,66,139965,92,259273
8474,0.021832,172.217.194.0-255,5738,145703,92,259273
8475,0.021841,172.31.47.0-255,66,145769,92,259273
8476,0.023865,172.217.194.0-255,5738,151507,92,259273
8477,0.023872,172.31.47.0-255,66,151573,92,259273
8478,0.025892,172.217.194.0-255,5738,157311,92,259273
8479,0.025898,172.31.47.0-255,66,157377,92,259273
8480,0.02791,172.217.194.0-255,5738,163115,92,259273
8481,0.027917,172.31.47.0-255,66,163181,92,259273
8482,0.029945,172.217.194.0-255,5738,168919,92,259273
8483,0.029952,172.31.47.0-255,66,168985,92,259273
8484,0.031954,172.217.194.0-255,5738,174723,92,259273
8485,0.03196,172.31.47.0-255,66,174789,92,259273
8486,0.033952,172.217.194.0-255,5738,180527,92,259273
8487,0.033962,172.31.47.0-255,66,180593,92,259273
8488,0.035946,172.217.194.0-255,5738,186331,92,259273
8489,0.035955,172.31.47.0-255,66,186397,92,259273
8490,0.037939,172.217.194.0-255,5738,192135,92,259273
8491,0.037947,172.31.47.0-255,66,192201,92,259273
8492,0.039941,172.217.194.0-255,5738,197939,92,259273
8493,0.039949,172.31.47.0-255,66,198005,92,259273
8494,0.040737,172.31.47.0-255,172,198177,92,259273
8495,0.04077,172.31.47.0-255,1112,199289,92,259273
8496,0.04083,172.31.47.0-255,1514,200803,92,259273
8497,0.040832,172.31.47.0-255,1514,202317,92,259273
8498,0.040836,172.31.47.0-255,1514,203831,92,259273
8499,0.040838,172.31.47.0-255,1514,205345,92,259273
8500,0.040861,172.31.47.0-255,1494,206839,92,259273
8501,0.042012,172.217.194.0-255,5738,212577,92,259273
8502,0.042019,172.31.47.0-255,66,212643,92,259273
8503,0.042266,104.244.42.0-255,66,212709,92,259273
8504,0.042358,104.244.42.0-255,66,212775,92,259273
8505,0.04246,104.244.42.0-255,66,212841,92,259273
8506,0.044053,172.217.194.0-255,5738,218579,92,259273
8507,0.044061,172.31.47.0-255,66,218645,92,259273
8508,0.046072,172.217.194.0-255,5738,224383,92,259273
8509,0.046078,172.31.47.0-255,66,224449,92,259273
8510,0.048072,172.217.194.0-255,5738,230187,92,259273
8511,0.048079,172.31.47.0-255,66,230253,92,259273
8512,0.050062,172.217.194.0-255,5738,235991,92,259273
8513,0.05007,172.31.47.0-255,66,236057,92,259273
8514,0.052081,172.217.194.0-255,5738,241795,92,259273
8515,0.052087,172.31.47.0-255,66,241861,92,259273
8516,0.054122,172.217.194.0-255,5738,247599,92,259273
8517,0.054129,172.31.47.0-255,66,247665,92,259273
8518,0.056128,172.217.194.0-255,5738,253403,92,259273
8519,0.056133,172.31.47.0-255,66,253469,92,259273
8520,0.058131,172.217.194.0-255,5738,259207,92,259273
8521,0.058137,172.31.47.0-255,66,259273,92,259273
8522,0.0,172.217.194.0-255,225,225,92,180980
8523,1.6e-05,172.31.47.0-255,66,291,92,180980
8524,2.3e-05,172.217.194.0-255,1484,1775,92,180980
8525,2.7e-05,172.31.47.0-255,66,1841,92,180980
8526,5.7e-05,172.217.194.0-255,4320,6161,92,180980
8527,6.5e-05,172.31.47.0-255,66,6227,92,180980
8528,0.000252,172.31.47.0-255,66,6293,92,180980
8529,0.000587,172.217.194.0-255,1484,7777,92,180980
8530,0.000593,172.31.47.0-255,66,7843,92,180980
8531,0.000658,172.217.194.0-255,2902,10745,92,180980
8532,0.000663,172.31.47.0-255,66,10811,92,180980
8533,0.000778,172.217.194.0-255,4320,15131,92,180980
8534,0.000783,172.31.47.0-255,66,15197,92,180980
8535,0.000799,172.217.194.0-255,1484,16681,92,180980
8536,0.000801,172.31.47.0-255,66,16747,92,180980
8537,0.001047,172.217.194.0-255,6797,23544,92,180980
8538,0.001053,172.31.47.0-255,66,23610,92,180980
8539,0.003398,172.217.194.0-255,5738,29348,92,180980
8540,0.003404,172.31.47.0-255,66,29414,92,180980
8541,0.005744,172.217.194.0-255,5738,35152,92,180980
8542,0.005751,172.31.47.0-255,66,35218,92,180980
8543,0.008081,172.217.194.0-255,2902,38120,92,180980
8544,0.008088,172.31.47.0-255,66,38186,92,180980
8545,0.00812,172.217.194.0-255,2902,41088,92,180980
8546,0.008123,172.31.47.0-255,66,41154,92,180980
8547,0.010398,172.217.194.0-255,2902,44056,92,180980
8548,0.010407,172.31.47.0-255,66,44122,92,180980
8549,0.010446,172.217.194.0-255,2902,47024,92,180980
8550,0.01045,172.31.47.0-255,66,47090,92,180980
8551,0.012763,172.217.194.0-255,2902,49992,92,180980
8552,0.012778,172.31.47.0-255,66,50058,92,180980
8553,0.012817,172.217.194.0-255,2902,52960,92,180980
8554,0.012822,172.31.47.0-255,66,53026,92,180980
8555,0.015078,172.217.194.0-255,2902,55928,92,180980
8556,0.015085,172.31.47.0-255,66,55994,92,180980
8557,0.015118,172.217.194.0-255,2902,58896,92,180980
8558,0.015122,172.31.47.0-255,66,58962,92,180980
8559,0.017426,172.217.194.0-255,2902,61864,92,180980
8560,0.017433,172.31.47.0-255,66,61930,92,180980
8561,0.017476,172.217.194.0-255,2902,64832,92,180980
8562,0.01748,172.31.47.0-255,66,64898,92,180980
8563,0.019774,172.217.194.0-255,2902,67800,92,180980
8564,0.019782,172.31.47.0-255,66,67866,92,180980
8565,0.01982,172.217.194.0-255,2902,70768,92,180980
8566,0.019823,172.31.47.0-255,66,70834,92,180980
8567,0.021396,172.31.47.0-255,176,71010,92,180980
8568,0.021452,172.31.47.0-255,1103,72113,92,180980
8569,0.021532,172.31.47.0-255,1514,73627,92,180980
8570,0.021534,172.31.47.0-255,1514,75141,92,180980
8571,0.021535,172.31.47.0-255,1514,76655,92,180980
8572,0.021536,172.31.47.0-255,1514,78169,92,180980
8573,0.021572,172.31.47.0-255,1503,79672,92,180980
8574,0.022097,172.217.194.0-255,2902,82574,92,180980
8575,0.022105,172.31.47.0-255,66,82640,92,180980
8576,0.022144,172.217.194.0-255,2902,85542,92,180980
8577,0.022148,172.31.47.0-255,66,85608,92,180980
8578,0.02293,104.244.42.0-255,66,85674,92,180980
8579,0.023026,104.244.42.0-255,66,85740,92,180980
8580,0.023117,104.244.42.0-255,66,85806,92,180980
8581,0.024422,172.217.194.0-255,2902,88708,92,180980
8582,0.024427,172.31.47.0-255,66,88774,92,180980
8583,0.024469,172.217.194.0-255,2902,91676,92,180980
8584,0.024473,172.31.47.0-255,66,91742,92,180980
8585,0.026719,172.217.194.0-255,2902,94644,92,180980
8586,0.026724,172.31.47.0-255,66,94710,92,180980
8587,0.026785,172.217.194.0-255,2902,97612,92,180980
8588,0.026789,172.31.47.0-255,66,97678,92,180980
8589,0.029078,172.217.194.0-255,2902,100580,92,180980
8590,0.029083,172.31.47.0-255,66,100646,92,180980
8591,0.029124,172.217.194.0-255,2902,103548,92,180980
8592,0.029128,172.31.47.0-255,66,103614,92,180980
8593,0.031374,172.217.194.0-255,2902,106516,92,180980
8594,0.03138,172.31.47.0-255,66,106582,92,180980
8595,0.031443,172.217.194.0-255,1484,108066,92,180980
8596,0.031459,172.217.194.0-255,1484,109550,92,180980
8597,0.031462,172.31.47.0-255,66,109616,92,180980
8598,0.033658,172.217.194.0-255,2902,112518,92,180980
8599,0.033663,172.31.47.0-255,66,112584,92,180980
8600,0.033779,172.217.194.0-255,2902,115486,92,180980
8601,0.033785,172.31.47.0-255,66,115552,92,180980
8602,0.035972,172.217.194.0-255,2902,118454,92,180980
8603,0.035978,172.31.47.0-255,66,118520,92,180980
8604,0.036079,172.217.194.0-255,2902,121422,92,180980
8605,0.036084,172.31.47.0-255,66,121488,92,180980
8606,0.038301,172.217.194.0-255,2902,124390,92,180980
8607,0.038308,172.31.47.0-255,66,124456,92,180980
8608,0.038372,172.217.194.0-255,2902,127358,92,180980
8609,0.038377,172.31.47.0-255,66,127424,92,180980
8610,0.040642,172.217.194.0-255,2902,130326,92,180980
8611,0.040647,172.31.47.0-255,66,130392,92,180980
8612,0.040719,172.217.194.0-255,2902,133294,92,180980
8613,0.040723,172.31.47.0-255,66,133360,92,180980
8614,0.042976,172.217.194.0-255,2902,136262,92,180980
8615,0.04298,172.31.47.0-255,66,136328,92,180980
8616,0.043043,172.217.194.0-255,2902,139230,92,180980
8617,0.043047,172.31.47.0-255,66,139296,92,180980
8618,0.045331,172.217.194.0-255,2902,142198,92,180980
8619,0.045336,172.31.47.0-255,66,142264,92,180980
8620,0.04538,172.217.194.0-255,2902,145166,92,180980
8621,0.045383,172.31.47.0-255,66,145232,92,180980
8622,0.047659,172.217.194.0-255,2902,148134,92,180980
8623,0.047664,172.31.47.0-255,66,148200,92,180980
8624,0.047715,172.217.194.0-255,2902,151102,92,180980
8625,0.047719,172.31.47.0-255,66,151168,92,180980
8626,0.049973,172.217.194.0-255,2902,154070,92,180980
8627,0.049978,172.31.47.0-255,66,154136,92,180980
8628,0.050048,172.217.194.0-255,2902,157038,92,180980
8629,0.050052,172.31.47.0-255,66,157104,92,180980
8630,0.052303,172.217.194.0-255,2902,160006,92,180980
8631,0.052309,172.31.47.0-255,66,160072,92,180980
8632,0.052408,172.217.194.0-255,2902,162974,92,180980
8633,0.052413,172.31.47.0-255,66,163040,92,180980
8634,0.054589,172.217.194.0-255,1484,164524,92,180980
8635,0.054594,172.31.47.0-255,66,164590,92,180980
8636,0.054631,172.217.194.0-255,1484,166074,92,180980
8637,0.054634,172.31.47.0-255,66,166140,92,180980
8638,0.054736,172.217.194.0-255,2902,169042,92,180980
8639,0.054741,172.31.47.0-255,66,169108,92,180980
8640,0.056875,172.217.194.0-255,1484,170592,92,180980
8641,0.056881,172.31.47.0-255,66,170658,92,180980
8642,0.057062,172.217.194.0-255,4320,174978,92,180980
8643,0.057068,172.31.47.0-255,66,175044,92,180980
8644,0.059169,172.217.194.0-255,1484,176528,92,180980
8645,0.059173,172.31.47.0-255,66,176594,92,180980
8646,0.059363,172.217.194.0-255,4320,180914,92,180980
8647,0.059368,172.31.47.0-255,66,180980,92,180980
8648,0.0,172.217.194.0-255,153,153,92,219594
8649,3.6e-05,172.31.47.0-255,66,219,92,219594
8650,4.4e-05,172.217.194.0-255,1484,1703,92,219594
8651,6.5e-05,172.31.47.0-255,66,1769,92,219594
8652,6.8e-05,172.217.194.0-255,1484,3253,92,219594
8653,7.1e-05,172.31.47.0-255,66,3319,92,219594
8654,7.6e-05,172.217.194.0-255,2902,6221,92,219594
8655,7.8e-05,172.31.47.0-255,66,6287,92,219594
8656,8.5e-05,172.217.194.0-255,5738,12025,92,219594
8657,8.7e-05,172.31.47.0-255,66,12091,92,219594
8658,9.1e-05,172.217.194.0-255,2064,14155,92,219594
8659,9.3e-05,172.31.47.0-255,66,14221,92,219594
8660,0.000126,172.217.194.0-255,2902,17123,92,219594
8661,0.000129,172.31.47.0-255,66,17189,92,219594
8662,0.000137,172.217.194.0-255,7156,24345,92,219594
8663,0.000139,172.31.47.0-255,66,24411,92,219594
8664,0.000188,172.217.194.0-255,4320,28731,92,219594
8665,0.000192,172.31.47.0-255,66,28797,92,219594
8666,0.000209,172.217.194.0-255,2543,31340,92,219594
8667,0.000211,172.31.47.0-255,66,31406,92,219594
8668,0.000449,172.217.194.0-255,1484,32890,92,219594
8669,0.000454,172.217.194.0-255,2902,35792,92,219594
8670,0.000457,172.31.47.0-255,66,35858,92,219594
8671,0.00046,172.217.194.0-255,5738,41596,92,219594
8672,0.000462,172.31.47.0-255,66,41662,92,219594
8673,0.000466,172.31.47.0-255,66,41728,92,219594
8674,0.000511,172.217.194.0-255,6797,48525,92,219594
8675,0.000516,172.31.47.0-255,66,48591,92,219594
8676,0.000552,172.217.194.0-255,1484,50075,92,219594
8677,0.000556,172.217.194.0-255,2902,52977,92,219594
8678,0.000558,172.31.47.0-255,66,53043,92,219594
8679,0.000562,172.31.47.0-255,66,53109,92,219594
8680,0.000569,172.217.194.0-255,2902,56011,92,219594
8681,0.000578,172.31.47.0-255,66,56077,92,219594
8682,0.000605,172.217.194.0-255,2902,58979,92,219594
8683,0.00061,172.31.47.0-255,66,59045,92,219594
8684,0.000613,172.217.194.0-255,7110,66155,92,219594
8685,0.000625,172.31.47.0-255,66,66221,92,219594
8686,0.000913,172.217.194.0-255,98,66319,92,219594
8687,0.00092,172.31.47.0-255,66,66385,92,219594
8688,0.001283,172.217.194.0-255,362,66747,92,219594
8689,0.001831,172.217.194.0-255,1484,68231,92,219594
8690,0.001839,172.217.194.0-255,2902,71133,92,219594
8691,0.001861,172.217.194.0-255,5738,76871,92,219594
8692,0.001866,172.217.194.0-255,4320,81191,92,219594
8693,0.001886,172.217.194.0-255,5738,86929,92,219594
8694,0.001919,172.217.194.0-255,4320,91249,92,219594
8695,0.004729,172.31.47.0-255,66,91315,92,219594
8696,0.007322,172.217.194.0-255,5738,97053,92,219594
8697,0.007329,172.31.47.0-255,66,97119,92,219594
8698,0.009927,172.217.194.0-255,5738,102857,92,219594
8699,0.00994,172.31.47.0-255,66,102923,92,219594
8700,0.012562,172.217.194.0-255,5738,108661,92,219594
8701,0.012573,172.31.47.0-255,66,108727,92,219594
8702,0.015205,172.217.194.0-255,5738,114465,92,219594
8703,0.015222,172.31.47.0-255,66,114531,92,219594
8704,0.017825,172.217.194.0-255,5738,120269,92,219594
8705,0.017837,172.31.47.0-255,66,120335,92,219594
8706,0.020452,172.217.194.0-255,5738,126073,92,219594
8707,0.020464,172.31.47.0-255,66,126139,92,219594
8708,0.023078,172.217.194.0-255,5738,131877,92,219594
8709,0.023091,172.31.47.0-255,66,131943,92,219594
8710,0.025703,172.217.194.0-255,5738,137681,92,219594
8711,0.025714,172.31.47.0-255,66,137747,92,219594
8712,0.026642,172.31.47.0-255,172,137919,92,219594
8713,0.026674,172.31.47.0-255,1107,139026,92,219594
8714,0.026727,172.31.47.0-255,1514,140540,92,219594
8715,0.026729,172.31.47.0-255,1514,142054,92,219594
8716,0.02673,172.31.47.0-255,1514,143568,92,219594
8717,0.026731,172.31.47.0-255,1514,145082,92,219594
8718,0.026757,172.31.47.0-255,1500,146582,92,219594
8719,0.02821,104.244.42.0-255,66,146648,92,219594
8720,0.028227,104.244.42.0-255,66,146714,92,219594
8721,0.028304,172.217.194.0-255,4320,151034,92,219594
8722,0.028313,172.31.47.0-255,66,151100,92,219594
8723,0.028336,104.244.42.0-255,66,151166,92,219594
8724,0.028345,172.217.194.0-255,1484,152650,92,219594
8725,0.028367,104.244.42.0-255,66,152716,92,219594
8726,0.030955,172.217.194.0-255,4320,157036,92,219594
8727,0.030961,172.31.47.0-255,66,157102,92,219594
8728,0.03355,172.217.194.0-255,5738,162840,92,219594
8729,0.033615,172.31.47.0-255,66,162906,92,219594
8730,0.036202,172.217.194.0-255,5738,168644,92,219594
8731,0.036208,172.31.47.0-255,66,168710,92,219594
8732,0.038822,172.217.194.0-255,5738,174448,92,219594
8733,0.038828,172.31.47.0-255,66,174514,92,219594
8734,0.041439,172.217.194.0-255,5738,180252,92,219594
8735,0.041446,172.31.47.0-255,66,180318,92,219594
8736,0.044044,172.217.194.0-255,4320,184638,92,219594
8737,0.04405,172.31.47.0-255,66,184704,92,219594
8738,0.044091,172.217.194.0-255,1484,186188,92,219594
8739,0.046681,172.217.194.0-255,4320,190508,92,219594
8740,0.046688,172.31.47.0-255,66,190574,92,219594
8741,0.049294,172.217.194.0-255,5738,196312,92,219594
8742,0.049349,172.31.47.0-255,66,196378,92,219594
8743,0.051943,172.217.194.0-255,5738,202116,92,219594
8744,0.051949,172.31.47.0-255,66,202182,92,219594
8745,0.054539,172.217.194.0-255,5738,207920,92,219594
8746,0.054546,172.31.47.0-255,66,207986,92,219594
8747,0.057206,172.217.194.0-255,5738,213724,92,219594
8748,0.057214,172.31.47.0-255,66,213790,92,219594
8749,0.059804,172.217.194.0-255,5738,219528,92,219594
8750,0.059817,172.31.47.0-255,66,219594,92,219594
8751,0.0,74.125.200.0-255,153,153,92,336320
8752,2.3e-05,172.31.47.0-255,66,219,92,336320
8753,3.1e-05,74.125.200.0-255,1484,1703,92,336320
8754,3.5e-05,172.31.47.0-255,66,1769,92,336320
8755,4.9e-05,74.125.200.0-255,2902,4671,92,336320
8756,5.2e-05,172.31.47.0-255,66,4737,92,336320
8757,5.8e-05,74.125.200.0-255,5738,10475,92,336320
8758,6.1e-05,172.31.47.0-255,66,10541,92,336320
8759,6.6e-05,74.125.200.0-255,3393,13934,92,336320
8760,6.9e-05,172.31.47.0-255,66,14000,92,336320
8761,0.000118,74.125.200.0-255,1484,15484,92,336320
8762,0.000122,172.31.47.0-255,66,15550,92,336320
8763,0.000127,74.125.200.0-255,2902,18452,92,336320
8764,0.000129,172.31.47.0-255,66,18518,92,336320
8765,0.000134,74.125.200.0-255,2902,21420,92,336320
8766,0.00014,172.31.47.0-255,66,21486,92,336320
8767,0.000163,74.125.200.0-255,2902,24388,92,336320
8768,0.000165,172.31.47.0-255,66,24454,92,336320
8769,0.000177,74.125.200.0-255,6797,31251,92,336320
8770,0.000179,172.31.47.0-255,66,31317,92,336320
8771,0.000387,74.125.200.0-255,1484,32801,92,336320
8772,0.000393,172.31.47.0-255,66,32867,92,336320
8773,0.000398,74.125.200.0-255,1484,34351,92,336320
8774,0.0004,172.31.47.0-255,66,34417,92,336320
8775,0.000429,74.125.200.0-255,1484,35901,92,336320
8776,0.000432,172.31.47.0-255,66,35967,92,336320
8777,0.000437,74.125.200.0-255,2902,38869,92,336320
8778,0.000439,172.31.47.0-255,66,38935,92,336320
8779,0.000449,74.125.200.0-255,4320,43255,92,336320
8780,0.000451,172.31.47.0-255,66,43321,92,336320
8781,0.000482,74.125.200.0-255,6797,50118,92,336320
8782,0.000485,172.31.47.0-255,66,50184,92,336320
8783,0.000489,74.125.200.0-255,2902,53086,92,336320
8784,0.000491,172.31.47.0-255,66,53152,92,336320
8785,0.000523,74.125.200.0-255,4320,57472,92,336320
8786,0.000526,172.31.47.0-255,66,57538,92,336320
8787,0.000533,74.125.200.0-255,5738,63276,92,336320
8788,0.000535,172.31.47.0-255,66,63342,92,336320
8789,0.000552,74.125.200.0-255,2543,65885,92,336320
8790,0.000559,172.31.47.0-255,66,65951,92,336320
8791,0.000562,74.125.200.0-255,413,66364,92,336320
8792,0.000685,74.125.200.0-255,330,66694,92,336320
8793,0.000955,74.125.200.0-255,1484,68178,92,336320
8794,0.00096,172.31.47.0-255,66,68244,92,336320
8795,0.000965,74.125.200.0-255,2902,71146,92,336320
8796,0.000968,172.31.47.0-255,66,71212,92,336320
8797,0.000971,74.125.200.0-255,1484,72696,92,336320
8798,0.000996,74.125.200.0-255,1484,74180,92,336320
8799,0.000999,172.31.47.0-255,66,74246,92,336320
8800,0.001004,74.125.200.0-255,4320,78566,92,336320
8801,0.001005,172.31.47.0-255,66,78632,92,336320
8802,0.00101,74.125.200.0-255,4320,82952,92,336320
8803,0.001016,172.31.47.0-255,66,83018,92,336320
8804,0.001027,74.125.200.0-255,4320,87338,92,336320
8805,0.001029,172.31.47.0-255,66,87404,92,336320
8806,0.001033,74.125.200.0-255,2902,90306,92,336320
8807,0.001034,172.31.47.0-255,66,90372,92,336320
8808,0.001061,74.125.200.0-255,7156,97528,92,336320
8809,0.001063,172.31.47.0-255,66,97594,92,336320
8810,0.001084,74.125.200.0-255,1484,99078,92,336320
8811,0.001099,74.125.200.0-255,2184,101262,92,336320
8812,0.001102,172.31.47.0-255,66,101328,92,336320
8813,0.001128,74.125.200.0-255,4320,105648,92,336320
8814,0.001131,172.31.47.0-255,66,105714,92,336320
8815,0.001135,74.125.200.0-255,2902,108616,92,336320
8816,0.001136,172.31.47.0-255,66,108682,92,336320
8817,0.001178,172.31.47.0-255,66,108748,92,336320
8818,0.001207,74.125.200.0-255,1484,110232,92,336320
8819,0.001227,172.31.47.0-255,66,110298,92,336320
8820,0.001229,74.125.200.0-255,1484,111782,92,336320
8821,0.00125,74.125.200.0-255,2184,113966,92,336320
8822,0.001252,172.31.47.0-255,66,114032,92,336320
8823,0.00127,74.125.200.0-255,4320,118352,92,336320
8824,0.001272,172.31.47.0-255,66,118418,92,336320
8825,0.001276,74.125.200.0-255,2902,121320,92,336320
8826,0.001277,172.31.47.0-255,66,121386,92,336320
8827,0.001281,74.125.200.0-255,2902,124288,92,336320
8828,0.001283,172.31.47.0-255,66,124354,92,336320
8829,0.001304,74.125.200.0-255,1484,125838,92,336320
8830,0.001317,172.31.47.0-255,66,125904,92,336320
8831,0.00135,172.31.47.0-255,66,125970,92,336320
8832,0.001385,74.125.200.0-255,3602,129572,92,336320
8833,0.001388,172.31.47.0-255,66,129638,92,336320
8834,0.001427,74.125.200.0-255,1484,131122,92,336320
8835,0.001444,74.125.200.0-255,2902,134024,92,336320
8836,0.001447,172.31.47.0-255,66,134090,92,336320
8837,0.001464,74.125.200.0-255,5738,139828,92,336320
8838,0.001467,172.31.47.0-255,66,139894,92,336320
8839,0.001501,74.125.200.0-255,5738,145632,92,336320
8840,0.001504,172.31.47.0-255,66,145698,92,336320
8841,0.00151,74.125.200.0-255,7156,152854,92,336320
8842,0.001512,172.31.47.0-255,66,152920,92,336320
8843,0.00156,172.31.47.0-255,66,152986,92,336320
8844,0.001601,74.125.200.0-255,1484,154470,92,336320
8845,0.001615,74.125.200.0-255,2902,157372,92,336320
8846,0.001618,172.31.47.0-255,66,157438,92,336320
8847,0.001622,74.125.200.0-255,1484,158922,92,336320
8848,0.001644,74.125.200.0-255,2902,161824,92,336320
8849,0.001646,172.31.47.0-255,66,161890,92,336320
8850,0.001652,74.125.200.0-255,5738,167628,92,336320
8851,0.001654,172.31.47.0-255,66,167694,92,336320
8852,0.001692,172.31.47.0-255,66,167760,92,336320
8853,0.001697,74.125.200.0-255,4320,172080,92,336320
8854,0.001699,172.31.47.0-255,66,172146,92,336320
8855,0.001746,74.125.200.0-255,5738,177884,92,336320
8856,0.001751,172.31.47.0-255,66,177950,92,336320
8857,0.001792,172.31.47.0-255,66,178016,92,336320
8858,0.001806,172.31.47.0-255,66,178082,92,336320
8859,0.001831,74.125.200.0-255,4320,182402,92,336320
8860,0.001833,172.31.47.0-255,66,182468,92,336320
8861,0.001835,74.125.200.0-255,766,183234,92,336320
8862,0.003011,172.31.47.0-255,66,183300,92,336320
8863,0.004059,74.125.200.0-255,4320,187620,92,336320
8864,0.004065,172.31.47.0-255,66,187686,92,336320
8865,0.00522,74.125.200.0-255,1484,189170,92,336320
8866,0.006294,74.125.200.0-255,4320,193490,92,336320
8867,0.006298,172.31.47.0-255,66,193556,92,336320
8868,0.008536,74.125.200.0-255,5738,199294,92,336320
8869,0.008542,172.31.47.0-255,66,199360,92,336320
8870,0.010769,74.125.200.0-255,5738,205098,92,336320
8871,0.010779,172.31.47.0-255,66,205164,92,336320
8872,0.013001,74.125.200.0-255,5738,210902,92,336320
8873,0.01301,172.31.47.0-255,66,210968,92,336320
8874,0.015278,74.125.200.0-255,5738,216706,92,336320
8875,0.015291,172.31.47.0-255,66,216772,92,336320
8876,0.01751,74.125.200.0-255,5738,222510,92,336320
8877,0.017517,172.31.47.0-255,66,222576,92,336320
8878,0.019743,74.125.200.0-255,5738,228314,92,336320
8879,0.01975,172.31.47.0-255,66,228380,92,336320
8880,0.021977,74.125.200.0-255,5738,234118,92,336320
8881,0.021985,172.31.47.0-255,66,234184,92,336320
8882,0.023767,172.31.47.0-255,172,234356,92,336320
8883,0.023797,172.31.47.0-255,1113,235469,92,336320
8884,0.023861,172.31.47.0-255,1514,236983,92,336320
8885,0.023863,172.31.47.0-255,1514,238497,92,336320
8886,0.023864,172.31.47.0-255,1514,240011,92,336320
8887,0.023865,172.31.47.0-255,1514,241525,92,336320
8888,0.023866,172.31.47.0-255,1493,243018,92,336320
8889,0.024206,74.125.200.0-255,5738,248756,92,336320
8890,0.024212,172.31.47.0-255,66,248822,92,336320
8891,0.025369,104.244.42.0-255,66,248888,92,336320
8892,0.025406,104.244.42.0-255,66,248954,92,336320
8893,0.025536,104.244.42.0-255,66,249020,92,336320
8894,0.026038,104.244.42.0-255,108,249128,92,336320
8895,0.026043,172.31.47.0-255,66,249194,92,336320
8896,0.026429,74.125.200.0-255,5738,254932,92,336320
8897,0.026434,172.31.47.0-255,66,254998,92,336320
8898,0.028663,74.125.200.0-255,5738,260736,92,336320
8899,0.028669,172.31.47.0-255,66,260802,92,336320
8900,0.030893,74.125.200.0-255,5738,266540,92,336320
8901,0.0309,172.31.47.0-255,66,266606,92,336320
8902,0.033129,74.125.200.0-255,5738,272344,92,336320
8903,0.033135,172.31.47.0-255,66,272410,92,336320
8904,0.035372,74.125.200.0-255,5738,278148,92,336320
8905,0.035378,172.31.47.0-255,66,278214,92,336320
8906,0.037623,74.125.200.0-255,5738,283952,92,336320
8907,0.037629,172.31.47.0-255,66,284018,92,336320
8908,0.039885,74.125.200.0-255,5738,289756,92,336320
8909,0.039891,172.31.47.0-255,66,289822,92,336320
8910,0.042122,74.125.200.0-255,5738,295560,92,336320
8911,0.042127,172.31.47.0-255,66,295626,92,336320
8912,0.044342,74.125.200.0-255,5738,301364,92,336320
8913,0.04435,172.31.47.0-255,66,301430,92,336320
8914,0.046553,74.125.200.0-255,1484,302914,92,336320
8915,0.046576,74.125.200.0-255,4320,307234,92,336320
8916,0.04658,172.31.47.0-255,66,307300,92,336320
8917,0.048805,74.125.200.0-255,5738,313038,92,336320
8918,0.048811,172.31.47.0-255,66,313104,92,336320
8919,0.051027,74.125.200.0-255,5738,318842,92,336320
8920,0.051032,172.31.47.0-255,66,318908,92,336320
8921,0.053263,74.125.200.0-255,5738,324646,92,336320
8922,0.05327,172.31.47.0-255,66,324712,92,336320
8923,0.05551,74.125.200.0-255,5738,330450,92,336320
8924,0.055516,172.31.47.0-255,66,330516,92,336320
8925,0.057804,74.125.200.0-255,5738,336254,92,336320
8926,0.057809,172.31.47.0-255,66,336320,92,336320
8927,0.0,172.31.47.0-255,105,105,92,276
8928,0.001773,157.240.13.0-255,105,210,92,276
8929,0.001782,172.31.47.0-255,66,276,92,276
8930,0.0,74.125.68.0-255,153,153,92,364478
8931,2.6e-05,172.31.47.0-255,66,219,92,364478
8932,3.3e-05,74.125.68.0-255,1484,1703,92,364478
8933,3.8e-05,172.31.47.0-255,66,1769,92,364478
8934,6e-05,74.125.68.0-255,2902,4671,92,364478
8935,6.8e-05,172.31.47.0-255,66,4737,92,364478
8936,7.5e-05,74.125.68.0-255,5738,10475,92,364478
8937,7.7e-05,172.31.47.0-255,66,10541,92,364478
8938,8e-05,74.125.68.0-255,1484,12025,92,364478
8939,8.2e-05,172.31.47.0-255,66,12091,92,364478
8940,0.000114,74.125.68.0-255,2136,14227,92,364478
8941,0.000116,172.31.47.0-255,66,14293,92,364478
8942,0.000164,74.125.68.0-255,1484,15777,92,364478
8943,0.000169,172.31.47.0-255,66,15843,92,364478
8944,0.000174,74.125.68.0-255,2902,18745,92,364478
8945,0.000176,172.31.47.0-255,66,18811,92,364478
8946,0.000203,74.125.68.0-255,4320,23131,92,364478
8947,0.000206,172.31.47.0-255,66,23197,92,364478
8948,0.000231,74.125.68.0-255,1484,24681,92,364478
8949,0.000234,172.31.47.0-255,66,24747,92,364478
8950,0.000268,74.125.68.0-255,6797,31544,92,364478
8951,0.000273,172.31.47.0-255,66,31610,92,364478
8952,0.00054,74.125.68.0-255,1484,33094,92,364478
8953,0.000545,172.31.47.0-255,66,33160,92,364478
8954,0.00055,74.125.68.0-255,2902,36062,92,364478
8955,0.000552,172.31.47.0-255,66,36128,92,364478
8956,0.000577,74.125.68.0-255,4320,40448,92,364478
8957,0.00058,172.31.47.0-255,66,40514,92,364478
8958,0.000607,74.125.68.0-255,1484,41998,92,364478
8959,0.000611,172.31.47.0-255,66,42064,92,364478
8960,0.000615,74.125.68.0-255,2902,44966,92,364478
8961,0.000617,172.31.47.0-255,66,45032,92,364478
8962,0.000623,74.125.68.0-255,3961,48993,92,364478
8963,0.000625,172.31.47.0-255,66,49059,92,364478
8964,0.000631,74.125.68.0-255,5738,54797,92,364478
8965,0.000635,172.31.47.0-255,66,54863,92,364478
8966,0.000669,74.125.68.0-255,2902,57765,92,364478
8967,0.000672,172.31.47.0-255,66,57831,92,364478
8968,0.000676,74.125.68.0-255,2902,60733,92,364478
8969,0.000679,172.31.47.0-255,66,60799,92,364478
8970,0.000691,74.125.68.0-255,4320,65119,92,364478
8971,0.000693,172.31.47.0-255,66,65185,92,364478
8972,0.000696,74.125.68.0-255,1125,66310,92,364478
8973,0.00088,74.125.68.0-255,414,66724,92,364478
8974,0.000917,74.125.68.0-255,329,67053,92,364478
8975,0.000922,172.31.47.0-255,66,67119,92,364478
8976,0.001251,74.125.68.0-255,1484,68603,92,364478
8977,0.001275,74.125.68.0-255,2902,71505,92,364478
8978,0.00128,172.31.47.0-255,66,71571,92,364478
8979,0.001284,74.125.68.0-255,1484,73055,92,364478
8980,0.001317,74.125.68.0-255,2902,75957,92,364478
8981,0.00132,172.31.47.0-255,66,76023,92,364478
8982,0.001326,74.125.68.0-255,5738,81761,92,364478
8983,0.001328,172.31.47.0-255,66,81827,92,364478
8984,0.001331,74.125.68.0-255,1484,83311,92,364478
8985,0.001358,74.125.68.0-255,2902,86213,92,364478
8986,0.00136,172.31.47.0-255,66,86279,92,364478
8987,0.001384,74.125.68.0-255,5738,92017,92,364478
8988,0.001387,172.31.47.0-255,66,92083,92,364478
8989,0.001389,74.125.68.0-255,1484,93567,92,364478
8990,0.00141,74.125.68.0-255,2902,96469,92,364478
8991,0.001412,172.31.47.0-255,66,96535,92,364478
8992,0.001438,74.125.68.0-255,2902,99437,92,364478
8993,0.00144,172.31.47.0-255,66,99503,92,364478
8994,0.001463,74.125.68.0-255,2184,101687,92,364478
8995,0.001466,172.31.47.0-255,66,101753,92,364478
8996,0.001788,74.125.68.0-255,1484,103237,92,364478
8997,0.001807,74.125.68.0-255,2902,106139,92,364478
8998,0.001809,172.31.47.0-255,66,106205,92,364478
8999,0.001839,74.125.68.0-255,5738,111943,92,364478
9000,0.001841,172.31.47.0-255,66,112009,92,364478
9001,0.001844,74.125.68.0-255,1484,113493,92,364478
9002,0.00187,74.125.68.0-255,2902,116395,92,364478
9003,0.001873,172.31.47.0-255,66,116461,92,364478
9004,0.001895,74.125.68.0-255,4320,120781,92,364478
9005,0.001898,172.31.47.0-255,66,120847,92,364478
9006,0.00192,74.125.68.0-255,1484,122331,92,364478
9007,0.001924,74.125.68.0-255,2902,125233,92,364478
9008,0.001926,172.31.47.0-255,66,125299,92,364478
9009,0.001953,172.31.47.0-255,66,125365,92,364478
9010,0.001956,74.125.68.0-255,766,126131,92,364478
9011,0.002035,74.125.68.0-255,1484,127615,92,364478
9012,0.002038,172.31.47.0-255,66,127681,92,364478
9013,0.002041,74.125.68.0-255,1484,129165,92,364478
9014,0.002065,74.125.68.0-255,1484,130649,92,364478
9015,0.002067,172.31.47.0-255,66,130715,92,364478
9016,0.002071,74.125.68.0-255,4320,135035,92,364478
9017,0.002073,172.31.47.0-255,66,135101,92,364478
9018,0.002076,74.125.68.0-255,1484,136585,92,364478
9019,0.002103,74.125.68.0-255,7156,143741,92,364478
9020,0.002106,172.31.47.0-255,66,143807,92,364478
9021,0.002112,74.125.68.0-255,5738,149545,92,364478
9022,0.002114,172.31.47.0-255,66,149611,92,364478
9023,0.002151,74.125.68.0-255,7156,156767,92,364478
9024,0.002154,172.31.47.0-255,66,156833,92,364478
9025,0.002158,74.125.68.0-255,3602,160435,92,364478
9026,0.00216,172.31.47.0-255,66,160501,92,364478
9027,0.00222,74.125.68.0-255,1484,161985,92,364478
9028,0.002238,74.125.68.0-255,2902,164887,92,364478
9029,0.00224,172.31.47.0-255,66,164953,92,364478
9030,0.002266,74.125.68.0-255,4320,169273,92,364478
9031,0.002268,172.31.47.0-255,66,169339,92,364478
9032,0.002274,74.125.68.0-255,5738,175077,92,364478
9033,0.002276,172.31.47.0-255,66,175143,92,364478
9034,0.002302,74.125.68.0-255,4320,179463,92,364478
9035,0.002304,172.31.47.0-255,66,179529,92,364478
9036,0.002329,74.125.68.0-255,7156,186685,92,364478
9037,0.002331,172.31.47.0-255,66,186751,92,364478
9038,0.002335,74.125.68.0-255,4320,191071,92,364478
9039,0.002337,172.31.47.0-255,66,191137,92,364478
9040,0.002363,74.125.68.0-255,1484,192621,92,364478
9041,0.002377,74.125.68.0-255,2184,194805,92,364478
9042,0.00238,172.31.47.0-255,66,194871,92,364478
9043,0.002448,74.125.68.0-255,1484,196355,92,364478
9044,0.00246,74.125.68.0-255,2902,199257,92,364478
9045,0.002462,172.31.47.0-255,66,199323,92,364478
9046,0.002489,74.125.68.0-255,5738,205061,92,364478
9047,0.002492,172.31.47.0-255,66,205127,92,364478
9048,0.002517,74.125.68.0-255,5738,210865,92,364478
9049,0.00252,172.31.47.0-255,66,210931,92,364478
9050,0.002551,74.125.68.0-255,7156,218087,92,364478
9051,0.002553,172.31.47.0-255,66,218153,92,364478
9052,0.002558,74.125.68.0-255,5738,223891,92,364478
9053,0.00256,172.31.47.0-255,66,223957,92,364478
9054,0.00258,74.125.68.0-255,5020,228977,92,364478
9055,0.002582,172.31.47.0-255,66,229043,92,364478
9056,0.005157,74.125.68.0-255,5738,234781,92,364478
9057,0.005163,172.31.47.0-255,66,234847,92,364478
9058,0.007742,74.125.68.0-255,5738,240585,92,364478
9059,0.00775,172.31.47.0-255,66,240651,92,364478
9060,0.010363,74.125.68.0-255,5738,246389,92,364478
9061,0.010385,172.31.47.0-255,66,246455,92,364478
9062,0.013012,74.125.68.0-255,5738,252193,92,364478
9063,0.013031,172.31.47.0-255,66,252259,92,364478
9064,0.015633,74.125.68.0-255,5738,257997,92,364478
9065,0.015651,172.31.47.0-255,66,258063,92,364478
9066,0.018226,74.125.68.0-255,5738,263801,92,364478
9067,0.018234,172.31.47.0-255,66,263867,92,364478
9068,0.02081,74.125.68.0-255,5738,269605,92,364478
9069,0.020817,172.31.47.0-255,66,269671,92,364478
9070,0.023426,74.125.68.0-255,5738,275409,92,364478
9071,0.023446,172.31.47.0-255,66,275475,92,364478
9072,0.026023,74.125.68.0-255,5738,281213,92,364478
9073,0.026033,172.31.47.0-255,66,281279,92,364478
9074,0.028666,74.125.68.0-255,5738,287017,92,364478
9075,0.028689,172.31.47.0-255,66,287083,92,364478
9076,0.031297,74.125.68.0-255,5738,292821,92,364478
9077,0.031317,172.31.47.0-255,66,292887,92,364478
9078,0.033896,74.125.68.0-255,5738,298625,92,364478
9079,0.033913,172.31.47.0-255,66,298691,92,364478
9080,0.036523,74.125.68.0-255,5738,304429,92,364478
9081,0.036543,172.31.47.0-255,66,304495,92,364478
9082,0.039145,74.125.68.0-255,5738,310233,92,364478
9083,0.039165,172.31.47.0-255,66,310299,92,364478
9084,0.041752,74.125.68.0-255,5738,316037,92,364478
9085,0.04179,172.31.47.0-255,66,316103,92,364478
9086,0.044362,74.125.68.0-255,5738,321841,92,364478
9087,0.044368,172.31.47.0-255,66,321907,92,364478
9088,0.046612,172.31.47.0-255,172,322079,92,364478
9089,0.046636,172.31.47.0-255,1103,323182,92,364478
9090,0.046681,172.31.47.0-255,1514,324696,92,364478
9091,0.046682,172.31.47.0-255,1514,326210,92,364478
9092,0.046683,172.31.47.0-255,1514,327724,92,364478
9093,0.046684,172.31.47.0-255,1514,329238,92,364478
9094,0.046685,172.31.47.0-255,1504,330742,92,364478
9095,0.046949,74.125.68.0-255,5738,336480,92,364478
9096,0.046954,172.31.47.0-255,66,336546,92,364478
9097,0.048184,104.244.42.0-255,66,336612,92,364478
9098,0.048191,104.244.42.0-255,66,336678,92,364478
9099,0.04828,104.244.42.0-255,66,336744,92,364478
9100,0.049536,74.125.68.0-255,5738,342482,92,364478
9101,0.049542,172.31.47.0-255,66,342548,92,364478
9102,0.052111,74.125.68.0-255,4320,346868,92,364478
9103,0.052115,172.31.47.0-255,66,346934,92,364478
9104,0.05218,74.125.68.0-255,1484,348418,92,364478
9105,0.054687,74.125.68.0-255,4320,352738,92,364478
9106,0.054692,172.31.47.0-255,66,352804,92,364478
9107,0.057259,74.125.68.0-255,5738,358542,92,364478
9108,0.057264,172.31.47.0-255,66,358608,92,364478
9109,0.059829,74.125.68.0-255,4320,362928,92,364478
9110,0.059835,172.31.47.0-255,66,362994,92,364478
9111,0.059865,74.125.68.0-255,1484,364478,92,364478
9112,0.0,74.125.200.0-255,153,153,92,342424
9113,1.5e-05,172.31.47.0-255,66,219,92,342424
9114,2e-05,74.125.200.0-255,1484,1703,92,342424
9115,2.4e-05,172.31.47.0-255,66,1769,92,342424
9116,4.4e-05,74.125.200.0-255,2902,4671,92,342424
9117,4.6e-05,172.31.47.0-255,66,4737,92,342424
9118,6e-05,74.125.200.0-255,5738,10475,92,342424
9119,6.3e-05,172.31.47.0-255,66,10541,92,342424
9120,8.1e-05,74.125.200.0-255,1484,12025,92,342424
9121,8.2e-05,172.31.47.0-255,66,12091,92,342424
9122,0.000106,74.125.200.0-255,2175,14266,92,342424
9123,0.000108,172.31.47.0-255,66,14332,92,342424
9124,0.000156,74.125.200.0-255,2902,17234,92,342424
9125,0.000158,172.31.47.0-255,66,17300,92,342424
9126,0.000164,74.125.200.0-255,4320,21620,92,342424
9127,0.000166,172.31.47.0-255,66,21686,92,342424
9128,0.000218,172.31.47.0-255,66,21752,92,342424
9129,0.000221,74.125.200.0-255,1125,22877,92,342424
9130,0.000224,172.31.47.0-255,66,22943,92,342424
9131,0.000227,74.125.200.0-255,1484,24427,92,342424
9132,0.000229,172.31.47.0-255,66,24493,92,342424
9133,0.000234,74.125.200.0-255,2902,27395,92,342424
9134,0.000236,172.31.47.0-255,66,27461,92,342424
9135,0.00026,74.125.200.0-255,1484,28945,92,342424
9136,0.000262,172.31.47.0-255,66,29011,92,342424
9137,0.000273,172.31.47.0-255,66,29077,92,342424
9138,0.000294,74.125.200.0-255,1125,30202,92,342424
9139,0.000296,172.31.47.0-255,66,30268,92,342424
9140,0.000352,74.125.200.0-255,1484,31752,92,342424
9141,0.000354,172.31.47.0-255,66,31818,92,342424
9142,0.000358,74.125.200.0-255,1484,33302,92,342424
9143,0.000374,74.125.200.0-255,2902,36204,92,342424
9144,0.000377,172.31.47.0-255,66,36270,92,342424
9145,0.000382,74.125.200.0-255,4320,40590,92,342424
9146,0.000384,172.31.47.0-255,66,40656,92,342424
9147,0.000395,74.125.200.0-255,1484,42140,92,342424
9148,0.000411,74.125.200.0-255,5379,47519,92,342424
9149,0.000413,172.31.47.0-255,66,47585,92,342424
9150,0.000448,74.125.200.0-255,680,48265,92,342424
9151,0.000659,74.125.200.0-255,1484,49749,92,342424
9152,0.000662,172.31.47.0-255,66,49815,92,342424
9153,0.000667,74.125.200.0-255,2902,52717,92,342424
9154,0.000669,172.31.47.0-255,66,52783,92,342424
9155,0.000695,74.125.200.0-255,5738,58521,92,342424
9156,0.000698,172.31.47.0-255,66,58587,92,342424
9157,0.000715,74.125.200.0-255,4320,62907,92,342424
9158,0.000717,172.31.47.0-255,66,62973,92,342424
9159,0.000748,172.31.47.0-255,66,63039,92,342424
9160,0.000766,74.125.200.0-255,2902,65941,92,342424
9161,0.000768,172.31.47.0-255,66,66007,92,342424
9162,0.000798,172.31.47.0-255,66,66073,92,342424
9163,0.000814,74.125.200.0-255,2902,68975,92,342424
9164,0.000817,172.31.47.0-255,66,69041,92,342424
9165,0.000832,74.125.200.0-255,4320,73361,92,342424
9166,0.000836,172.31.47.0-255,66,73427,92,342424
9167,0.000855,74.125.200.0-255,7156,80583,92,342424
9168,0.000857,172.31.47.0-255,66,80649,92,342424
9169,0.000886,74.125.200.0-255,1484,82133,92,342424
9170,0.00089,74.125.200.0-255,4320,86453,92,342424
9171,0.000893,172.31.47.0-255,66,86519,92,342424
9172,0.000899,74.125.200.0-255,5738,92257,92,342424
9173,0.000901,172.31.47.0-255,66,92323,92,342424
9174,0.000912,74.125.200.0-255,1484,93807,92,342424
9175,0.000933,74.125.200.0-255,6438,100245,92,342424
9176,0.000936,172.31.47.0-255,66,100311,92,342424
9177,0.000968,74.125.200.0-255,4320,104631,92,342424
9178,0.000971,172.31.47.0-255,66,104697,92,342424
9179,0.000974,74.125.200.0-255,1484,106181,92,342424
9180,0.000989,74.125.200.0-255,4320,110501,92,342424
9181,0.000993,172.31.47.0-255,66,110567,92,342424
9182,0.001006,74.125.200.0-255,1484,112051,92,342424
9183,0.00103,172.31.47.0-255,66,112117,92,342424
9184,0.001034,74.125.200.0-255,2902,115019,92,342424
9185,0.001036,172.31.47.0-255,66,115085,92,342424
9186,0.001047,74.125.200.0-255,1484,116569,92,342424
9187,0.001107,74.125.200.0-255,5738,122307,92,342424
9188,0.00111,172.31.47.0-255,66,122373,92,342424
9189,0.001126,74.125.200.0-255,2184,124557,92,342424
9190,0.001128,172.31.47.0-255,66,124623,92,342424
9191,0.001182,74.125.200.0-255,1484,126107,92,342424
9192,0.001186,74.125.200.0-255,1484,127591,92,342424
9193,0.001188,172.31.47.0-255,66,127657,92,342424
9194,0.0012,74.125.200.0-255,1484,129141,92,342424
9195,0.001202,74.125.200.0-255,1484,130625,92,342424
9196,0.001204,172.31.47.0-255,66,130691,92,342424
9197,0.001217,74.125.200.0-255,4320,135011,92,342424
9198,0.00122,172.31.47.0-255,66,135077,92,342424
9199,0.001228,74.125.200.0-255,2902,137979,92,342424
9200,0.00123,172.31.47.0-255,66,138045,92,342424
9201,0.001234,74.125.200.0-255,2902,140947,92,342424
9202,0.001236,172.31.47.0-255,66,141013,92,342424
9203,0.001261,74.125.200.0-255,1484,142497,92,342424
9204,0.001271,172.31.47.0-255,66,142563,92,342424
9205,0.001276,74.125.200.0-255,4320,146883,92,342424
9206,0.001278,172.31.47.0-255,66,146949,92,342424
9207,0.001325,74.125.200.0-255,3602,150551,92,342424
9208,0.001329,172.31.47.0-255,66,150617,92,342424
9209,0.001429,74.125.200.0-255,1484,152101,92,342424
9210,0.001435,74.125.200.0-255,2902,155003,92,342424
9211,0.001438,172.31.47.0-255,66,155069,92,342424
9212,0.001489,74.125.200.0-255,5738,160807,92,342424
9213,0.001492,172.31.47.0-255,66,160873,92,342424
9214,0.001499,74.125.200.0-255,7156,168029,92,342424
9215,0.001501,172.31.47.0-255,66,168095,92,342424
9216,0.001511,172.31.47.0-255,66,168161,92,342424
9217,0.001527,74.125.200.0-255,4320,172481,92,342424
9218,0.001529,172.31.47.0-255,66,172547,92,342424
9219,0.001544,74.125.200.0-255,3602,176149,92,342424
9220,0.001546,172.31.47.0-255,66,176215,92,342424
9221,0.001589,74.125.200.0-255,1484,177699,92,342424
9222,0.001592,74.125.200.0-255,1484,179183,92,342424
9223,0.001595,172.31.47.0-255,66,179249,92,342424
9224,0.00161,74.125.200.0-255,1484,180733,92,342424
9225,0.001616,74.125.200.0-255,5738,186471,92,342424
9226,0.001618,172.31.47.0-255,66,186537,92,342424
9227,0.001626,74.125.200.0-255,2902,189439,92,342424
9228,0.001628,172.31.47.0-255,66,189505,92,342424
9229,0.001631,74.125.200.0-255,1484,190989,92,342424
9230,0.001648,74.125.200.0-255,2902,193891,92,342424
9231,0.001651,172.31.47.0-255,66,193957,92,342424
9232,0.001664,74.125.200.0-255,4320,198277,92,342424
9233,0.001666,172.31.47.0-255,66,198343,92,342424
9234,0.001685,74.125.200.0-255,4320,202663,92,342424
9235,0.00169,74.125.200.0-255,5738,208401,92,342424
9236,0.001693,172.31.47.0-255,66,208467,92,342424
9237,0.0017,172.31.47.0-255,66,208533,92,342424
9238,0.001723,74.125.200.0-255,2184,210717,92,342424
9239,0.001726,172.31.47.0-255,66,210783,92,342424
9240,0.001785,74.125.200.0-255,1484,212267,92,342424
9241,0.001796,74.125.200.0-255,2902,215169,92,342424
9242,0.001799,172.31.47.0-255,66,215235,92,342424
9243,0.001823,74.125.200.0-255,5738,220973,92,342424
9244,0.001826,172.31.47.0-255,66,221039,92,342424
9245,0.00183,74.125.200.0-255,2902,223941,92,342424
9246,0.001832,172.31.47.0-255,66,224007,92,342424
9247,0.001836,74.125.200.0-255,4320,228327,92,342424
9248,0.001838,172.31.47.0-255,66,228393,92,342424
9249,0.001861,74.125.200.0-255,5738,234131,92,342424
9250,0.001864,172.31.47.0-255,66,234197,92,342424
9251,0.001881,74.125.200.0-255,2902,237099,92,342424
9252,0.001883,172.31.47.0-255,66,237165,92,342424
9253,0.001889,74.125.200.0-255,7156,244321,92,342424
9254,0.001891,172.31.47.0-255,66,244387,92,342424
9255,0.001907,74.125.200.0-255,2902,247289,92,342424
9256,0.001909,172.31.47.0-255,66,247355,92,342424
9257,0.001925,74.125.200.0-255,5020,252375,92,342424
9258,0.001927,172.31.47.0-255,66,252441,92,342424
9259,0.001934,74.125.200.0-255,7156,259597,92,342424
9260,0.001936,172.31.47.0-255,66,259663,92,342424
9261,0.001962,172.31.47.0-255,66,259729,92,342424
9262,0.001983,74.125.200.0-255,2902,262631,92,342424
9263,0.001985,172.31.47.0-255,66,262697,92,342424
9264,0.00201,172.31.47.0-255,66,262763,92,342424
9265,0.002045,74.125.200.0-255,1484,264247,92,342424
9266,0.002065,74.125.200.0-255,2902,267149,92,342424
9267,0.002067,172.31.47.0-255,66,267215,92,342424
9268,0.002072,74.125.200.0-255,2902,270117,92,342424
9269,0.002073,172.31.47.0-255,66,270183,92,342424
9270,0.002088,74.125.200.0-255,2902,273085,92,342424
9271,0.00209,172.31.47.0-255,66,273151,92,342424
9272,0.002094,74.125.200.0-255,2902,276053,92,342424
9273,0.002096,172.31.47.0-255,66,276119,92,342424
9274,0.002098,74.125.200.0-255,1484,277603,92,342424
9275,0.002127,172.31.47.0-255,66,277669,92,342424
9276,0.002156,172.31.47.0-255,66,277735,92,342424
9277,0.002179,74.125.200.0-255,1484,279219,92,342424
9278,0.002192,74.125.200.0-255,2902,282121,92,342424
9279,0.002195,172.31.47.0-255,66,282187,92,342424
9280,0.002211,74.125.200.0-255,4320,286507,92,342424
9281,0.002213,172.31.47.0-255,66,286573,92,342424
9282,0.002225,74.125.200.0-255,1484,288057,92,342424
9283,0.002228,74.125.200.0-255,1484,289541,92,342424
9284,0.00223,172.31.47.0-255,66,289607,92,342424
9285,0.002258,74.125.200.0-255,5738,295345,92,342424
9286,0.002261,172.31.47.0-255,66,295411,92,342424
9287,0.002267,74.125.200.0-255,5738,301149,92,342424
9288,0.002269,172.31.47.0-255,66,301215,92,342424
9289,0.004508,74.125.200.0-255,5738,306953,92,342424
9290,0.004513,172.31.47.0-255,66,307019,92,342424
9291,0.006748,74.125.200.0-255,5738,312757,92,342424
9292,0.006754,172.31.47.0-255,66,312823,92,342424
9293,0.008997,74.125.200.0-255,5738,318561,92,342424
9294,0.009003,172.31.47.0-255,66,318627,92,342424
9295,0.011241,74.125.200.0-255,5738,324365,92,342424
9296,0.011248,172.31.47.0-255,66,324431,92,342424
9297,0.013487,74.125.200.0-255,5738,330169,92,342424
9298,0.013494,172.31.47.0-255,66,330235,92,342424
9299,0.015736,74.125.200.0-255,2918,333153,92,342424
9300,0.015744,172.31.47.0-255,66,333219,92,342424
9301,0.02161,172.31.47.0-255,105,333324,92,342424
9302,0.023812,74.125.200.0-255,66,333390,92,342424
9303,0.031234,172.31.47.0-255,172,333562,92,342424
9304,0.031265,172.31.47.0-255,1111,334673,92,342424
9305,0.031318,172.31.47.0-255,1514,336187,92,342424
9306,0.03132,172.31.47.0-255,1514,337701,92,342424
9307,0.031321,172.31.47.0-255,1514,339215,92,342424
9308,0.031322,172.31.47.0-255,1514,340729,92,342424
9309,0.031346,172.31.47.0-255,1497,342226,92,342424
9310,0.03272,104.244.42.0-255,66,342292,92,342424
9311,0.032757,104.244.42.0-255,66,342358,92,342424
9312,0.032857,104.244.42.0-255,66,342424,92,342424
9313,0.0,74.125.24.0-255,153,153,92,282995
9314,2.9e-05,172.31.47.0-255,66,219,92,282995
9315,3.5e-05,74.125.24.0-255,1484,1703,92,282995
9316,4e-05,172.31.47.0-255,66,1769,92,282995
9317,4.4e-05,74.125.24.0-255,2902,4671,92,282995
9318,5.3e-05,172.31.47.0-255,66,4737,92,282995
9319,6e-05,74.125.24.0-255,7156,11893,92,282995
9320,6.3e-05,172.31.47.0-255,66,11959,92,282995
9321,6.7e-05,74.125.24.0-255,1959,13918,92,282995
9322,6.9e-05,172.31.47.0-255,66,13984,92,282995
9323,0.000213,74.125.24.0-255,1484,15468,92,282995
9324,0.000217,172.31.47.0-255,66,15534,92,282995
9325,0.000222,74.125.24.0-255,2902,18436,92,282995
9326,0.000225,172.31.47.0-255,66,18502,92,282995
9327,0.000228,74.125.24.0-255,1484,19986,92,282995
9328,0.000229,172.31.47.0-255,66,20052,92,282995
9329,0.000263,74.125.24.0-255,4320,24372,92,282995
9330,0.000266,172.31.47.0-255,66,24438,92,282995
9331,0.000273,74.125.24.0-255,7156,31594,92,282995
9332,0.000274,172.31.47.0-255,66,31660,92,282995
9333,0.000303,74.125.24.0-255,6797,38457,92,282995
9334,0.000306,172.31.47.0-255,66,38523,92,282995
9335,0.000323,74.125.24.0-255,7156,45679,92,282995
9336,0.00033,172.31.47.0-255,66,45745,92,282995
9337,0.000352,74.125.24.0-255,2543,48288,92,282995
9338,0.000355,172.31.47.0-255,66,48354,92,282995
9339,0.00081,74.125.24.0-255,1484,49838,92,282995
9340,0.000815,172.31.47.0-255,66,49904,92,282995
9341,0.000823,74.125.24.0-255,2902,52806,92,282995
9342,0.000825,172.31.47.0-255,66,52872,92,282995
9343,0.000837,74.125.24.0-255,5738,58610,92,282995
9344,0.00084,172.31.47.0-255,66,58676,92,282995
9345,0.000882,172.31.47.0-255,66,58742,92,282995
9346,0.000887,74.125.24.0-255,4320,63062,92,282995
9347,0.000889,172.31.47.0-255,66,63128,92,282995
9348,0.000926,74.125.24.0-255,5960,69088,92,282995
9349,0.00093,172.31.47.0-255,66,69154,92,282995
9350,0.000978,74.125.24.0-255,1484,70638,92,282995
9351,0.000984,74.125.24.0-255,2902,73540,92,282995
9352,0.000989,74.125.24.0-255,4320,77860,92,282995
9353,0.001002,74.125.24.0-255,1484,79344,92,282995
9354,0.001018,74.125.24.0-255,2902,82246,92,282995
9355,0.001023,172.31.47.0-255,66,82312,92,282995
9356,0.001033,74.125.24.0-255,3961,86273,92,282995
9357,0.001047,172.31.47.0-255,66,86339,92,282995
9358,0.002051,74.125.24.0-255,1484,87823,92,282995
9359,0.002056,172.31.47.0-255,66,87889,92,282995
9360,0.002063,74.125.24.0-255,2902,90791,92,282995
9361,0.00208,172.31.47.0-255,66,90857,92,282995
9362,0.002106,74.125.24.0-255,5738,96595,92,282995
9363,0.002112,74.125.24.0-255,7156,103751,92,282995
9364,0.002136,172.31.47.0-255,66,103817,92,282995
9365,0.002149,74.125.24.0-255,2184,106001,92,282995
9366,0.002154,172.31.47.0-255,66,106067,92,282995
9367,0.002206,74.125.24.0-255,1484,107551,92,282995
9368,0.002233,74.125.24.0-255,2902,110453,92,282995
9369,0.002238,74.125.24.0-255,5738,116191,92,282995
9370,0.002286,172.31.47.0-255,66,116257,92,282995
9371,0.0023,74.125.24.0-255,7156,123413,92,282995
9372,0.002322,74.125.24.0-255,6438,129851,92,282995
9373,0.002325,172.31.47.0-255,66,129917,92,282995
9374,0.002329,172.31.47.0-255,66,129983,92,282995
9375,0.004561,74.125.24.0-255,4320,134303,92,282995
9376,0.004566,172.31.47.0-255,66,134369,92,282995
9377,0.004588,74.125.24.0-255,1484,135853,92,282995
9378,0.006831,74.125.24.0-255,4320,140173,92,282995
9379,0.006838,172.31.47.0-255,66,140239,92,282995
9380,0.009083,74.125.24.0-255,5738,145977,92,282995
9381,0.009125,172.31.47.0-255,66,146043,92,282995
9382,0.011402,74.125.24.0-255,5738,151781,92,282995
9383,0.011419,172.31.47.0-255,66,151847,92,282995
9384,0.013686,74.125.24.0-255,5738,157585,92,282995
9385,0.013696,172.31.47.0-255,66,157651,92,282995
9386,0.015956,74.125.24.0-255,5738,163389,92,282995
9387,0.015964,172.31.47.0-255,66,163455,92,282995
9388,0.018277,74.125.24.0-255,5738,169193,92,282995
9389,0.018294,172.31.47.0-255,66,169259,92,282995
9390,0.020585,74.125.24.0-255,5738,174997,92,282995
9391,0.020596,172.31.47.0-255,66,175063,92,282995
9392,0.02285,74.125.24.0-255,5738,180801,92,282995
9393,0.022856,172.31.47.0-255,66,180867,92,282995
9394,0.022919,172.31.47.0-255,172,181039,92,282995
9395,0.022943,172.31.47.0-255,1112,182151,92,282995
9396,0.022995,172.31.47.0-255,1514,183665,92,282995
9397,0.022997,172.31.47.0-255,1514,185179,92,282995
9398,0.022998,172.31.47.0-255,1514,186693,92,282995
9399,0.022999,172.31.47.0-255,1514,188207,92,282995
9400,0.023022,172.31.47.0-255,1494,189701,92,282995
9401,0.024489,104.244.42.0-255,66,189767,92,282995
9402,0.024528,104.244.42.0-255,66,189833,92,282995
9403,0.024591,104.244.42.0-255,66,189899,92,282995
9404,0.025098,74.125.24.0-255,5738,195637,92,282995
9405,0.025102,172.31.47.0-255,66,195703,92,282995
9406,0.027342,74.125.24.0-255,2902,198605,92,282995
9407,0.027347,172.31.47.0-255,66,198671,92,282995
9408,0.02738,74.125.24.0-255,2902,201573,92,282995
9409,0.027392,172.31.47.0-255,66,201639,92,282995
9410,0.029604,74.125.24.0-255,2902,204541,92,282995
9411,0.029608,172.31.47.0-255,66,204607,92,282995
9412,0.029637,74.125.24.0-255,2902,207509,92,282995
9413,0.029652,172.31.47.0-255,66,207575,92,282995
9414,0.031838,74.125.24.0-255,2902,210477,92,282995
9415,0.031844,172.31.47.0-255,66,210543,92,282995
9416,0.031885,74.125.24.0-255,2902,213445,92,282995
9417,0.031894,172.31.47.0-255,66,213511,92,282995
9418,0.034131,74.125.24.0-255,2902,216413,92,282995
9419,0.034137,172.31.47.0-255,66,216479,92,282995
9420,0.034161,74.125.24.0-255,2902,219381,92,282995
9421,0.034457,172.31.47.0-255,66,219447,92,282995
9422,0.036374,74.125.24.0-255,2902,222349,92,282995
9423,0.03638,172.31.47.0-255,66,222415,92,282995
9424,0.036721,74.125.24.0-255,2902,225317,92,282995
9425,0.036726,172.31.47.0-255,66,225383,92,282995
9426,0.038696,74.125.24.0-255,2902,228285,92,282995
9427,0.038701,172.31.47.0-255,66,228351,92,282995
9428,0.038976,74.125.24.0-255,2902,231253,92,282995
9429,0.038981,172.31.47.0-255,66,231319,92,282995
9430,0.040948,74.125.24.0-255,2902,234221,92,282995
9431,0.040954,172.31.47.0-255,66,234287,92,282995
9432,0.041262,74.125.24.0-255,2902,237189,92,282995
9433,0.041267,172.31.47.0-255,66,237255,92,282995
9434,0.043207,74.125.24.0-255,2902,240157,92,282995
9435,0.043212,172.31.47.0-255,66,240223,92,282995
9436,0.043527,74.125.24.0-255,2902,243125,92,282995
9437,0.043532,172.31.47.0-255,66,243191,92,282995
9438,0.045497,74.125.24.0-255,2902,246093,92,282995
9439,0.045504,172.31.47.0-255,66,246159,92,282995
9440,0.04585,74.125.24.0-255,2902,249061,92,282995
9441,0.045855,172.31.47.0-255,66,249127,92,282995
9442,0.047762,74.125.24.0-255,2902,252029,92,282995
9443,0.047767,172.31.47.0-255,66,252095,92,282995
9444,0.048119,74.125.24.0-255,2902,254997,92,282995
9445,0.048124,172.31.47.0-255,66,255063,92,282995
9446,0.050045,74.125.24.0-255,1484,256547,92,282995
9447,0.050049,172.31.47.0-255,66,256613,92,282995
9448,0.050075,74.125.24.0-255,1484,258097,92,282995
9449,0.050393,74.125.24.0-255,2902,260999,92,282995
9450,0.050436,172.31.47.0-255,66,261065,92,282995
9451,0.052303,74.125.24.0-255,1484,262549,92,282995
9452,0.052681,74.125.24.0-255,4320,266869,92,282995
9453,0.053037,172.31.47.0-255,66,266935,92,282995
9454,0.055337,74.125.24.0-255,5738,272673,92,282995
9455,0.055386,172.31.47.0-255,66,272739,92,282995
9456,0.057665,74.125.24.0-255,4320,277059,92,282995
9457,0.057669,172.31.47.0-255,66,277125,92,282995
9458,0.057695,74.125.24.0-255,1484,278609,92,282995
9459,0.059936,74.125.24.0-255,4320,282929,92,282995
9460,0.059942,172.31.47.0-255,66,282995,92,282995
9461,0.0,172.217.194.0-255,153,153,92,336262
9462,2.1e-05,172.31.47.0-255,66,219,92,336262
9463,2.7e-05,172.217.194.0-255,1484,1703,92,336262
9464,3.1e-05,172.31.47.0-255,66,1769,92,336262
9465,3.7e-05,172.217.194.0-255,2902,4671,92,336262
9466,4e-05,172.31.47.0-255,66,4737,92,336262
9467,4.7e-05,172.217.194.0-255,7156,11893,92,336262
9468,5e-05,172.31.47.0-255,66,11959,92,336262
9469,5.3e-05,172.217.194.0-255,2091,14050,92,336262
9470,5.6e-05,172.31.47.0-255,66,14116,92,336262
9471,0.000138,172.217.194.0-255,1484,15600,92,336262
9472,0.000141,172.31.47.0-255,66,15666,92,336262
9473,0.000152,172.217.194.0-255,1484,17150,92,336262
9474,0.000154,172.31.47.0-255,66,17216,92,336262
9475,0.000171,172.217.194.0-255,1484,18700,92,336262
9476,0.000173,172.31.47.0-255,66,18766,92,336262
9477,0.00018,172.217.194.0-255,5738,24504,92,336262
9478,0.000182,172.31.47.0-255,66,24570,92,336262
9479,0.000202,172.217.194.0-255,2902,27472,92,336262
9480,0.000204,172.31.47.0-255,66,27538,92,336262
9481,0.000223,172.217.194.0-255,3961,31499,92,336262
9482,0.000225,172.31.47.0-255,66,31565,92,336262
9483,0.000359,172.217.194.0-255,1484,33049,92,336262
9484,0.000363,172.31.47.0-255,66,33115,92,336262
9485,0.000382,172.217.194.0-255,2902,36017,92,336262
9486,0.000384,172.31.47.0-255,66,36083,92,336262
9487,0.000387,172.217.194.0-255,1484,37567,92,336262
9488,0.00039,172.31.47.0-255,66,37633,92,336262
9489,0.000415,172.217.194.0-255,4320,41953,92,336262
9490,0.000417,172.31.47.0-255,66,42019,92,336262
9491,0.000421,172.217.194.0-255,2902,44921,92,336262
9492,0.000422,172.31.47.0-255,66,44987,92,336262
9493,0.000452,172.217.194.0-255,4320,49307,92,336262
9494,0.000454,172.31.47.0-255,66,49373,92,336262
9495,0.000471,172.217.194.0-255,6797,56170,92,336262
9496,0.000474,172.31.47.0-255,66,56236,92,336262
9497,0.000479,172.217.194.0-255,4320,60556,92,336262
9498,0.000497,172.31.47.0-255,66,60622,92,336262
9499,0.000509,172.217.194.0-255,1484,62106,92,336262
9500,0.000522,172.217.194.0-255,4214,66320,92,336262
9501,0.000533,172.217.194.0-255,114,66434,92,336262
9502,0.000536,172.31.47.0-255,66,66500,92,336262
9503,0.000595,172.217.194.0-255,384,66884,92,336262
9504,0.000691,172.217.194.0-255,1484,68368,92,336262
9505,0.000721,172.31.47.0-255,66,68434,92,336262
9506,0.00073,172.217.194.0-255,2902,71336,92,336262
9507,0.000736,172.217.194.0-255,5738,77074,92,336262
9508,0.000742,172.31.47.0-255,66,77140,92,336262
9509,0.000771,172.217.194.0-255,4320,81460,92,336262
9510,0.000775,172.31.47.0-255,66,81526,92,336262
9511,0.000781,172.217.194.0-255,1484,83010,92,336262
9512,0.000796,172.217.194.0-255,4320,87330,92,336262
9513,0.000808,172.31.47.0-255,66,87396,92,336262
9514,0.000812,172.217.194.0-255,2902,90298,92,336262
9515,0.000817,172.217.194.0-255,5738,96036,92,336262
9516,0.000821,172.31.47.0-255,66,96102,92,336262
9517,0.000841,172.217.194.0-255,5020,101122,92,336262
9518,0.000847,172.31.47.0-255,66,101188,92,336262
9519,0.000987,172.217.194.0-255,1484,102672,92,336262
9520,0.000991,172.217.194.0-255,1484,104156,92,336262
9521,0.000998,172.31.47.0-255,66,104222,92,336262
9522,0.001006,172.217.194.0-255,1484,105706,92,336262
9523,0.00101,172.217.194.0-255,2902,108608,92,336262
9524,0.001013,172.31.47.0-255,66,108674,92,336262
9525,0.001024,172.217.194.0-255,2902,111576,92,336262
9526,0.001028,172.217.194.0-255,2902,114478,92,336262
9527,0.001048,172.217.194.0-255,4320,118798,92,336262
9528,0.001058,172.31.47.0-255,66,118864,92,336262
9529,0.001064,172.217.194.0-255,5738,124602,92,336262
9530,0.001077,172.217.194.0-255,2902,127504,92,336262
9531,0.00108,172.31.47.0-255,66,127570,92,336262
9532,0.001097,172.217.194.0-255,2902,130472,92,336262
9533,0.001115,172.31.47.0-255,66,130538,92,336262
9534,0.001132,172.217.194.0-255,5020,135558,92,336262
9535,0.001142,172.31.47.0-255,66,135624,92,336262
9536,0.001178,172.217.194.0-255,4320,139944,92,336262
9537,0.001185,172.31.47.0-255,66,140010,92,336262
9538,0.001194,172.217.194.0-255,1484,141494,92,336262
9539,0.001196,172.217.194.0-255,1484,142978,92,336262
9540,0.00121,172.217.194.0-255,5738,148716,92,336262
9541,0.001227,172.31.47.0-255,66,148782,92,336262
9542,0.001232,172.217.194.0-255,4320,153102,92,336262
9543,0.001237,172.31.47.0-255,66,153168,92,336262
9544,0.001253,172.217.194.0-255,5738,158906,92,336262
9545,0.001269,172.31.47.0-255,66,158972,92,336262
9546,0.001288,172.217.194.0-255,5738,164710,92,336262
9547,0.001299,172.31.47.0-255,66,164776,92,336262
9548,0.00131,172.217.194.0-255,5020,169796,92,336262
9549,0.001319,172.31.47.0-255,66,169862,92,336262
9550,0.001409,172.217.194.0-255,1484,171346,92,336262
9551,0.001412,172.217.194.0-255,1484,172830,92,336262
9552,0.001429,172.217.194.0-255,1484,174314,92,336262
9553,0.001436,172.217.194.0-255,5738,180052,92,336262
9554,0.001449,172.217.194.0-255,2902,182954,92,336262
9555,0.001453,172.31.47.0-255,66,183020,92,336262
9556,0.001464,172.217.194.0-255,4320,187340,92,336262
9557,0.001472,172.31.47.0-255,66,187406,92,336262
9558,0.001476,172.217.194.0-255,2902,190308,92,336262
9559,0.001504,172.217.194.0-255,4320,194628,92,336262
9560,0.001512,172.31.47.0-255,66,194694,92,336262
9561,0.001531,172.31.47.0-255,66,194760,92,336262
9562,0.004033,172.217.194.0-255,1484,196244,92,336262
9563,0.004043,172.217.194.0-255,2902,199146,92,336262
9564,0.004047,172.31.47.0-255,66,199212,92,336262
9565,0.004052,172.217.194.0-255,1484,200696,92,336262
9566,0.006544,172.217.194.0-255,4320,205016,92,336262
9567,0.006547,172.31.47.0-255,66,205082,92,336262
9568,0.009018,172.217.194.0-255,5738,210820,92,336262
9569,0.009025,172.31.47.0-255,66,210886,92,336262
9570,0.011524,172.217.194.0-255,5738,216624,92,336262
9571,0.011533,172.31.47.0-255,66,216690,92,336262
9572,0.014028,172.217.194.0-255,5738,222428,92,336262
9573,0.014036,172.31.47.0-255,66,222494,92,336262
9574,0.016552,172.217.194.0-255,5738,228232,92,336262
9575,0.016561,172.31.47.0-255,66,228298,92,336262
9576,0.019049,172.217.194.0-255,5738,234036,92,336262
9577,0.019058,172.31.47.0-255,66,234102,92,336262
9578,0.021572,172.217.194.0-255,5738,239840,92,336262
9579,0.021579,172.31.47.0-255,66,239906,92,336262
9580,0.024128,172.217.194.0-255,5738,245644,92,336262
9581,0.024136,172.31.47.0-255,66,245710,92,336262
9582,0.026642,172.217.194.0-255,5738,251448,92,336262
9583,0.026648,172.31.47.0-255,66,251514,92,336262
9584,0.029128,172.217.194.0-255,5738,257252,92,336262
9585,0.029135,172.31.47.0-255,66,257318,92,336262
9586,0.031631,172.217.194.0-255,5738,263056,92,336262
9587,0.031638,172.31.47.0-255,66,263122,92,336262
9588,0.032589,172.31.47.0-255,172,263294,92,336262
9589,0.032622,172.31.47.0-255,1112,264406,92,336262
9590,0.03268,172.31.47.0-255,1514,265920,92,336262
9591,0.032682,172.31.47.0-255,1514,267434,92,336262
9592,0.032687,172.31.47.0-255,1514,268948,92,336262
9593,0.032688,172.31.47.0-255,1514,270462,92,336262
9594,0.032706,172.31.47.0-255,1494,271956,92,336262
9595,0.034112,172.217.194.0-255,5738,277694,92,336262
9596,0.034119,172.31.47.0-255,66,277760,92,336262
9597,0.03414,104.244.42.0-255,66,277826,92,336262
9598,0.034184,104.244.42.0-255,66,277892,92,336262
9599,0.034279,104.244.42.0-255,66,277958,92,336262
9600,0.036622,172.217.194.0-255,5738,283696,92,336262
9601,0.03663,172.31.47.0-255,66,283762,92,336262
9602,0.039135,172.217.194.0-255,5738,289500,92,336262
9603,0.039143,172.31.47.0-255,66,289566,92,336262
9604,0.041628,172.217.194.0-255,5738,295304,92,336262
9605,0.041634,172.31.47.0-255,66,295370,92,336262
9606,0.044123,172.217.194.0-255,5738,301108,92,336262
9607,0.044137,172.31.47.0-255,66,301174,92,336262
9608,0.04665,172.217.194.0-255,5738,306912,92,336262
9609,0.046657,172.31.47.0-255,66,306978,92,336262
9610,0.049156,172.217.194.0-255,5738,312716,92,336262
9611,0.049162,172.31.47.0-255,66,312782,92,336262
9612,0.051669,172.217.194.0-255,5738,318520,92,336262
9613,0.051675,172.31.47.0-255,66,318586,92,336262
9614,0.054156,172.217.194.0-255,2902,321488,92,336262
9615,0.054163,172.31.47.0-255,66,321554,92,336262
9616,0.054183,172.217.194.0-255,2902,324456,92,336262
9617,0.054186,172.31.47.0-255,66,324522,92,336262
9618,0.056645,172.217.194.0-255,2902,327424,92,336262
9619,0.056651,172.31.47.0-255,66,327490,92,336262
9620,0.056681,172.217.194.0-255,2902,330392,92,336262
9621,0.056684,172.31.47.0-255,66,330458,92,336262
9622,0.059183,172.217.194.0-255,5738,336196,92,336262
9623,0.05919,172.31.47.0-255,66,336262,92,336262
9624,0.0,172.31.47.0-255,105,105,92,276
9625,0.001765,157.240.13.0-255,105,210,92,276
9626,0.001775,172.31.47.0-255,66,276,92,276
9627,0.0,74.125.130.0-255,153,153,92,271440
9628,3.1e-05,172.31.47.0-255,66,219,92,271440
9629,3.8e-05,74.125.130.0-255,1484,1703,92,271440
9630,4.2e-05,172.31.47.0-255,66,1769,92,271440
9631,4.6e-05,74.125.130.0-255,2902,4671,92,271440
9632,5.6e-05,172.31.47.0-255,66,4737,92,271440
9633,7.9e-05,74.125.130.0-255,4320,9057,92,271440
9634,8.2e-05,172.31.47.0-255,66,9123,92,271440
9635,0.000106,74.125.130.0-255,2902,12025,92,271440
9636,0.000108,172.31.47.0-255,66,12091,92,271440
9637,0.000185,74.125.130.0-255,2207,14298,92,271440
9638,0.000189,172.31.47.0-255,66,14364,92,271440
9639,0.000232,74.125.130.0-255,2902,17266,92,271440
9640,0.000235,172.31.47.0-255,66,17332,92,271440
9641,0.000268,74.125.130.0-255,5738,23070,92,271440
9642,0.000272,172.31.47.0-255,66,23136,92,271440
9643,0.000287,74.125.130.0-255,1484,24620,92,271440
9644,0.00029,172.31.47.0-255,66,24686,92,271440
9645,0.000378,74.125.130.0-255,1484,26170,92,271440
9646,0.000381,172.31.47.0-255,66,26236,92,271440
9647,0.000409,172.31.47.0-255,66,26302,92,271440
9648,0.000605,74.125.130.0-255,4320,30622,92,271440
9649,0.000609,172.31.47.0-255,66,30688,92,271440
9650,0.000651,74.125.130.0-255,6797,37485,92,271440
9651,0.000654,172.31.47.0-255,66,37551,92,271440
9652,0.000767,74.125.130.0-255,1484,39035,92,271440
9653,0.000771,172.31.47.0-255,66,39101,92,271440
9654,0.000803,172.31.47.0-255,66,39167,92,271440
9655,0.00105,172.31.47.0-255,66,39233,92,271440
9656,0.001172,74.125.130.0-255,4320,43553,92,271440
9657,0.001177,172.31.47.0-255,66,43619,92,271440
9658,0.001205,74.125.130.0-255,4831,48450,92,271440
9659,0.001209,172.31.47.0-255,66,48516,92,271440
9660,0.001319,74.125.130.0-255,1484,50000,92,271440
9661,0.001354,74.125.130.0-255,2902,52902,92,271440
9662,0.001356,172.31.47.0-255,66,52968,92,271440
9663,0.001384,74.125.130.0-255,4320,57288,92,271440
9664,0.001386,172.31.47.0-255,66,57354,92,271440
9665,0.001421,74.125.130.0-255,1484,58838,92,271440
9666,0.00143,74.125.130.0-255,1484,60322,92,271440
9667,0.001431,172.31.47.0-255,66,60388,92,271440
9668,0.001456,74.125.130.0-255,5738,66126,92,271440
9669,0.001458,172.31.47.0-255,66,66192,92,271440
9670,0.001605,74.125.130.0-255,2902,69094,92,271440
9671,0.001608,172.31.47.0-255,66,69160,92,271440
9672,0.001633,74.125.130.0-255,5738,74898,92,271440
9673,0.001635,172.31.47.0-255,66,74964,92,271440
9674,0.001713,74.125.130.0-255,5738,80702,92,271440
9675,0.001715,172.31.47.0-255,66,80768,92,271440
9676,0.00173,74.125.130.0-255,2184,82952,92,271440
9677,0.001732,172.31.47.0-255,66,83018,92,271440
9678,0.001827,74.125.130.0-255,1484,84502,92,271440
9679,0.001846,74.125.130.0-255,1484,85986,92,271440
9680,0.001848,172.31.47.0-255,66,86052,92,271440
9681,0.001867,74.125.130.0-255,1484,87536,92,271440
9682,0.001908,74.125.130.0-255,4320,91856,92,271440
9683,0.001911,172.31.47.0-255,66,91922,92,271440
9684,0.001934,74.125.130.0-255,1484,93406,92,271440
9685,0.001983,74.125.130.0-255,1484,94890,92,271440
9686,0.001985,172.31.47.0-255,66,94956,92,271440
9687,0.002023,172.31.47.0-255,66,95022,92,271440
9688,0.002198,74.125.130.0-255,2902,97924,92,271440
9689,0.0022,172.31.47.0-255,66,97990,92,271440
9690,0.002234,172.31.47.0-255,66,98056,92,271440
9691,0.002432,74.125.130.0-255,4320,102376,92,271440
9692,0.002434,172.31.47.0-255,66,102442,92,271440
9693,0.002475,172.31.47.0-255,66,102508,92,271440
9694,0.00447,74.125.130.0-255,5738,108246,92,271440
9695,0.004476,172.31.47.0-255,66,108312,92,271440
9696,0.006496,74.125.130.0-255,5738,114050,92,271440
9697,0.006501,172.31.47.0-255,66,114116,92,271440
9698,0.008506,74.125.130.0-255,5738,119854,92,271440
9699,0.008513,172.31.47.0-255,66,119920,92,271440
9700,0.010624,74.125.130.0-255,5738,125658,92,271440
9701,0.01063,172.31.47.0-255,66,125724,92,271440
9702,0.012657,74.125.130.0-255,5738,131462,92,271440
9703,0.012663,172.31.47.0-255,66,131528,92,271440
9704,0.014666,74.125.130.0-255,5738,137266,92,271440
9705,0.014673,172.31.47.0-255,66,137332,92,271440
9706,0.016695,74.125.130.0-255,5738,143070,92,271440
9707,0.016701,172.31.47.0-255,66,143136,92,271440
9708,0.018707,74.125.130.0-255,5738,148874,92,271440
9709,0.018715,172.31.47.0-255,66,148940,92,271440
9710,0.020718,74.125.130.0-255,5738,154678,92,271440
9711,0.020725,172.31.47.0-255,66,154744,92,271440
9712,0.022733,74.125.130.0-255,5738,160482,92,271440
9713,0.022739,172.31.47.0-255,66,160548,92,271440
9714,0.023441,172.31.47.0-255,172,160720,92,271440
9715,0.023471,172.31.47.0-255,1111,161831,92,271440
9716,0.02352,172.31.47.0-255,1514,163345,92,271440
9717,0.023521,172.31.47.0-255,1514,164859,92,271440
9718,0.023523,172.31.47.0-255,1514,166373,92,271440
9719,0.023524,172.31.47.0-255,1514,167887,92,271440
9720,0.023525,172.31.47.0-255,531,168418,92,271440
9721,0.024756,74.125.130.0-255,5738,174156,92,271440
9722,0.024764,172.31.47.0-255,66,174222,92,271440
9723,0.024963,104.244.42.0-255,66,174288,92,271440
9724,0.025076,104.244.42.0-255,66,174354,92,271440
9725,0.025082,104.244.42.0-255,66,174420,92,271440
9726,0.025084,104.244.42.0-255,66,174486,92,271440
9727,0.026785,74.125.130.0-255,5738,180224,92,271440
9728,0.026791,172.31.47.0-255,66,180290,92,271440
9729,0.028804,74.125.130.0-255,5738,186028,92,271440
9730,0.02881,172.31.47.0-255,66,186094,92,271440
9731,0.030823,74.125.130.0-255,5738,191832,92,271440
9732,0.030828,172.31.47.0-255,66,191898,92,271440
9733,0.032873,74.125.130.0-255,5738,197636,92,271440
9734,0.032879,172.31.47.0-255,66,197702,92,271440
9735,0.034899,74.125.130.0-255,5738,203440,92,271440
9736,0.034905,172.31.47.0-255,66,203506,92,271440
9737,0.036915,74.125.130.0-255,5738,209244,92,271440
9738,0.036921,172.31.47.0-255,66,209310,92,271440
9739,0.038924,74.125.130.0-255,4320,213630,92,271440
9740,0.03893,172.31.47.0-255,66,213696,92,271440
9741,0.038964,74.125.130.0-255,1484,215180,92,271440
9742,0.040937,74.125.130.0-255,1484,216664,92,271440
9743,0.040942,172.31.47.0-255,66,216730,92,271440
9744,0.040977,74.125.130.0-255,2902,219632,92,271440
9745,0.04098,172.31.47.0-255,66,219698,92,271440
9746,0.042954,74.125.130.0-255,2902,222600,92,271440
9747,0.042959,172.31.47.0-255,66,222666,92,271440
9748,0.042995,74.125.130.0-255,2902,225568,92,271440
9749,0.042998,172.31.47.0-255,66,225634,92,271440
9750,0.044948,74.125.130.0-255,1484,227118,92,271440
9751,0.044971,74.125.130.0-255,1484,228602,92,271440
9752,0.044975,172.31.47.0-255,66,228668,92,271440
9753,0.045004,74.125.130.0-255,1484,230152,92,271440
9754,0.045018,74.125.130.0-255,1484,231636,92,271440
9755,0.045021,172.31.47.0-255,66,231702,92,271440
9756,0.04704,74.125.130.0-255,2902,234604,92,271440
9757,0.047044,172.31.47.0-255,66,234670,92,271440
9758,0.047078,74.125.130.0-255,2902,237572,92,271440
9759,0.047081,172.31.47.0-255,66,237638,92,271440
9760,0.04906,74.125.130.0-255,1484,239122,92,271440
9761,0.049085,74.125.130.0-255,4320,243442,92,271440
9762,0.049089,172.31.47.0-255,66,243508,92,271440
9763,0.051126,74.125.130.0-255,4320,247828,92,271440
9764,0.051131,172.31.47.0-255,66,247894,92,271440
9765,0.051161,74.125.130.0-255,1484,249378,92,271440
9766,0.053141,74.125.130.0-255,4320,253698,92,271440
9767,0.053146,172.31.47.0-255,66,253764,92,271440
9768,0.055155,74.125.130.0-255,5738,259502,92,271440
9769,0.05516,172.31.47.0-255,66,259568,92,271440
9770,0.057211,74.125.130.0-255,2902,262470,92,271440
9771,0.057217,172.31.47.0-255,66,262536,92,271440
9772,0.057245,74.125.130.0-255,2902,265438,92,271440
9773,0.057248,172.31.47.0-255,66,265504,92,271440
9774,0.059219,74.125.130.0-255,2902,268406,92,271440
9775,0.059223,172.31.47.0-255,66,268472,92,271440
9776,0.059252,74.125.130.0-255,2902,271374,92,271440
9777,0.059255,172.31.47.0-255,66,271440,92,271440
9778,0.0,172.31.47.0-255,105,105,92,276
9779,0.001758,157.240.13.0-255,105,210,92,276
9780,0.001769,172.31.47.0-255,66,276,92,276
9781,0.0,172.31.47.0-255,105,105,92,105
9782,0.0,74.125.200.0-255,153,153,92,386897
9783,2.4e-05,172.31.47.0-255,66,219,92,386897
9784,2.9e-05,74.125.200.0-255,1484,1703,92,386897
9785,3.3e-05,172.31.47.0-255,66,1769,92,386897
9786,4.3e-05,74.125.200.0-255,1484,3253,92,386897
9787,4.6e-05,172.31.47.0-255,66,3319,92,386897
9788,6.6e-05,74.125.200.0-255,1484,4803,92,386897
9789,6.9e-05,172.31.47.0-255,66,4869,92,386897
9790,7.5e-05,74.125.200.0-255,7156,12025,92,386897
9791,7.7e-05,172.31.47.0-255,66,12091,92,386897
9792,9.9e-05,74.125.200.0-255,2101,14192,92,386897
9793,0.0001,172.31.47.0-255,66,14258,92,386897
9794,0.000104,74.125.200.0-255,2902,17160,92,386897
9795,0.000106,172.31.47.0-255,66,17226,92,386897
9796,0.000109,74.125.200.0-255,2902,20128,92,386897
9797,0.000111,172.31.47.0-255,66,20194,92,386897
9798,0.000136,74.125.200.0-255,4320,24514,92,386897
9799,0.000138,172.31.47.0-255,66,24580,92,386897
9800,0.000142,74.125.200.0-255,2902,27482,92,386897
9801,0.000143,172.31.47.0-255,66,27548,92,386897
9802,0.000148,74.125.200.0-255,3961,31509,92,386897
9803,0.000151,172.31.47.0-255,66,31575,92,386897
9804,0.000447,74.125.200.0-255,1484,33059,92,386897
9805,0.000452,172.31.47.0-255,66,33125,92,386897
9806,0.000457,74.125.200.0-255,2902,36027,92,386897
9807,0.000459,172.31.47.0-255,66,36093,92,386897
9808,0.000482,74.125.200.0-255,2902,38995,92,386897
9809,0.000484,172.31.47.0-255,66,39061,92,386897
9810,0.000514,74.125.200.0-255,4320,43381,92,386897
9811,0.000517,172.31.47.0-255,66,43447,92,386897
9812,0.000532,74.125.200.0-255,1484,44931,92,386897
9813,0.000534,172.31.47.0-255,66,44997,92,386897
9814,0.000561,74.125.200.0-255,3961,48958,92,386897
9815,0.000564,172.31.47.0-255,66,49024,92,386897
9816,0.00057,74.125.200.0-255,5738,54762,92,386897
9817,0.000572,172.31.47.0-255,66,54828,92,386897
9818,0.000585,74.125.200.0-255,1484,56312,92,386897
9819,0.000603,74.125.200.0-255,7156,63468,92,386897
9820,0.000607,172.31.47.0-255,66,63534,92,386897
9821,0.000633,74.125.200.0-255,2543,66077,92,386897
9822,0.000635,172.31.47.0-255,66,66143,92,386897
9823,0.00066,74.125.200.0-255,413,66556,92,386897
9824,0.000701,74.125.200.0-255,1484,68040,92,386897
9825,0.000704,172.31.47.0-255,66,68106,92,386897
9826,0.000719,74.125.200.0-255,4320,72426,92,386897
9827,0.000722,172.31.47.0-255,66,72492,92,386897
9828,0.000742,74.125.200.0-255,4320,76812,92,386897
9829,0.000744,172.31.47.0-255,66,76878,92,386897
9830,0.00075,74.125.200.0-255,5738,82616,92,386897
9831,0.000752,172.31.47.0-255,66,82682,92,386897
9832,0.000775,74.125.200.0-255,4320,87002,92,386897
9833,0.000779,172.31.47.0-255,66,87068,92,386897
9834,0.0008,74.125.200.0-255,7156,94224,92,386897
9835,0.000803,172.31.47.0-255,66,94290,92,386897
9836,0.000808,74.125.200.0-255,4320,98610,92,386897
9837,0.000809,172.31.47.0-255,66,98676,92,386897
9838,0.000845,74.125.200.0-255,2449,101125,92,386897
9839,0.000847,172.31.47.0-255,66,101191,92,386897
9840,0.001043,74.125.200.0-255,1484,102675,92,386897
9841,0.001057,74.125.200.0-255,1484,104159,92,386897
9842,0.00106,172.31.47.0-255,66,104225,92,386897
9843,0.001077,74.125.200.0-255,1484,105709,92,386897
9844,0.001079,74.125.200.0-255,1484,107193,92,386897
9845,0.001081,172.31.47.0-255,66,107259,92,386897
9846,0.0011,74.125.200.0-255,4320,111579,92,386897
9847,0.001103,172.31.47.0-255,66,111645,92,386897
9848,0.001112,74.125.200.0-255,1484,113129,92,386897
9849,0.00114,74.125.200.0-255,7156,120285,92,386897
9850,0.001143,172.31.47.0-255,66,120351,92,386897
9851,0.001152,172.31.47.0-255,66,120417,92,386897
9852,0.001172,74.125.200.0-255,1484,121901,92,386897
9853,0.001178,74.125.200.0-255,4470,126371,92,386897
9854,0.00118,172.31.47.0-255,66,126437,92,386897
9855,0.001213,74.125.200.0-255,1484,127921,92,386897
9856,0.001217,74.125.200.0-255,2902,130823,92,386897
9857,0.001219,172.31.47.0-255,66,130889,92,386897
9858,0.001252,74.125.200.0-255,4320,135209,92,386897
9859,0.001254,172.31.47.0-255,66,135275,92,386897
9860,0.00127,74.125.200.0-255,1484,136759,92,386897
9861,0.00128,172.31.47.0-255,66,136825,92,386897
9862,0.001289,172.31.47.0-255,66,136891,92,386897
9863,0.001312,74.125.200.0-255,2902,139793,92,386897
9864,0.001314,172.31.47.0-255,66,139859,92,386897
9865,0.001318,74.125.200.0-255,2184,142043,92,386897
9866,0.001321,172.31.47.0-255,66,142109,92,386897
9867,0.00135,74.125.200.0-255,1484,143593,92,386897
9868,0.00136,74.125.200.0-255,1484,145077,92,386897
9869,0.001362,172.31.47.0-255,66,145143,92,386897
9870,0.001378,74.125.200.0-255,1484,146627,92,386897
9871,0.001383,74.125.200.0-255,5738,152365,92,386897
9872,0.001385,172.31.47.0-255,66,152431,92,386897
9873,0.001389,74.125.200.0-255,2902,155333,92,386897
9874,0.001391,172.31.47.0-255,66,155399,92,386897
9875,0.001426,74.125.200.0-255,5738,161137,92,386897
9876,0.00143,172.31.47.0-255,66,161203,92,386897
9877,0.001453,74.125.200.0-255,4320,165523,92,386897
9878,0.001456,172.31.47.0-255,66,165589,92,386897
9879,0.001461,74.125.200.0-255,5738,171327,92,386897
9880,0.001463,172.31.47.0-255,66,171393,92,386897
9881,0.001502,74.125.200.0-255,2902,174295,92,386897
9882,0.001506,172.31.47.0-255,66,174361,92,386897
9883,0.001512,74.125.200.0-255,2184,176545,92,386897
9884,0.001514,172.31.47.0-255,66,176611,92,386897
9885,0.001526,74.125.200.0-255,5738,182349,92,386897
9886,0.001528,172.31.47.0-255,66,182415,92,386897
9887,0.001552,74.125.200.0-255,5738,188153,92,386897
9888,0.001555,172.31.47.0-255,66,188219,92,386897
9889,0.00156,74.125.200.0-255,5738,193957,92,386897
9890,0.001562,172.31.47.0-255,66,194023,92,386897
9891,0.001572,74.125.200.0-255,1484,195507,92,386897
9892,0.001598,74.125.200.0-255,2902,198409,92,386897
9893,0.0016,172.31.47.0-255,66,198475,92,386897
9894,0.001625,172.31.47.0-255,66,198541,92,386897
9895,0.001648,74.125.200.0-255,3602,202143,92,386897
9896,0.001651,172.31.47.0-255,66,202209,92,386897
9897,0.001953,74.125.200.0-255,1484,203693,92,386897
9898,0.00198,74.125.200.0-255,2902,206595,92,386897
9899,0.001983,172.31.47.0-255,66,206661,92,386897
9900,0.001987,74.125.200.0-255,2902,209563,92,386897
9901,0.001989,172.31.47.0-255,66,209629,92,386897
9902,0.002003,74.125.200.0-255,2902,212531,92,386897
9903,0.002006,172.31.47.0-255,66,212597,92,386897
9904,0.002014,74.125.200.0-255,2902,215499,92,386897
9905,0.002016,172.31.47.0-255,66,215565,92,386897
9906,0.002038,74.125.200.0-255,4320,219885,92,386897
9907,0.00204,172.31.47.0-255,66,219951,92,386897
9908,0.002063,172.31.47.0-255,66,220017,92,386897
9909,0.002099,74.125.200.0-255,2902,222919,92,386897
9910,0.002101,172.31.47.0-255,66,222985,92,386897
9911,0.002118,74.125.200.0-255,3602,226587,92,386897
9912,0.00212,172.31.47.0-255,66,226653,92,386897
9913,0.004301,74.125.200.0-255,1484,228137,92,386897
9914,0.004315,74.125.200.0-255,1484,229621,92,386897
9915,0.004319,172.31.47.0-255,66,229687,92,386897
9916,0.004337,74.125.200.0-255,2902,232589,92,386897
9917,0.004338,172.31.47.0-255,66,232655,92,386897
9918,0.006532,74.125.200.0-255,2902,235557,92,386897
9919,0.006535,172.31.47.0-255,66,235623,92,386897
9920,0.006554,74.125.200.0-255,2902,238525,92,386897
9921,0.006556,172.31.47.0-255,66,238591,92,386897
9922,0.008749,74.125.200.0-255,2902,241493,92,386897
9923,0.008757,172.31.47.0-255,66,241559,92,386897
9924,0.00879,74.125.200.0-255,2902,244461,92,386897
9925,0.008793,172.31.47.0-255,66,244527,92,386897
9926,0.010964,74.125.200.0-255,2902,247429,92,386897
9927,0.01097,172.31.47.0-255,66,247495,92,386897
9928,0.01099,74.125.200.0-255,1484,248979,92,386897
9929,0.011002,74.125.200.0-255,1484,250463,92,386897
9930,0.011004,172.31.47.0-255,66,250529,92,386897
9931,0.013187,74.125.200.0-255,2902,253431,92,386897
9932,0.013196,172.31.47.0-255,66,253497,92,386897
9933,0.013222,74.125.200.0-255,2902,256399,92,386897
9934,0.013225,172.31.47.0-255,66,256465,92,386897
9935,0.015423,74.125.200.0-255,2902,259367,92,386897
9936,0.015433,172.31.47.0-255,66,259433,92,386897
9937,0.015463,74.125.200.0-255,2902,262335,92,386897
9938,0.015465,172.31.47.0-255,66,262401,92,386897
9939,0.017655,74.125.200.0-255,2902,265303,92,386897
9940,0.017669,172.31.47.0-255,66,265369,92,386897
9941,0.01771,74.125.200.0-255,2902,268271,92,386897
9942,0.017713,172.31.47.0-255,66,268337,92,386897
9943,0.019886,74.125.200.0-255,2902,271239,92,386897
9944,0.019893,172.31.47.0-255,66,271305,92,386897
9945,0.019938,74.125.200.0-255,2902,274207,92,386897
9946,0.019942,172.31.47.0-255,66,274273,92,386897
9947,0.022114,74.125.200.0-255,2902,277175,92,386897
9948,0.022123,172.31.47.0-255,66,277241,92,386897
9949,0.02215,74.125.200.0-255,2902,280143,92,386897
9950,0.022153,172.31.47.0-255,66,280209,92,386897
9951,0.024337,74.125.200.0-255,2902,283111,92,386897
9952,0.024344,172.31.47.0-255,66,283177,92,386897
9953,0.024403,74.125.200.0-255,2902,286079,92,386897
9954,0.024407,172.31.47.0-255,66,286145,92,386897
9955,0.026563,74.125.200.0-255,2902,289047,92,386897
9956,0.02658,172.31.47.0-255,66,289113,92,386897
9957,0.026621,74.125.200.0-255,1484,290597,92,386897
9958,0.026637,74.125.200.0-255,1484,292081,92,386897
9959,0.026639,172.31.47.0-255,66,292147,92,386897
9960,0.028809,74.125.200.0-255,2902,295049,92,386897
9961,0.028825,172.31.47.0-255,66,295115,92,386897
9962,0.028864,74.125.200.0-255,2902,298017,92,386897
9963,0.028867,172.31.47.0-255,66,298083,92,386897
9964,0.031058,74.125.200.0-255,2902,300985,92,386897
9965,0.031063,172.31.47.0-255,66,301051,92,386897
9966,0.031088,74.125.200.0-255,2902,303953,92,386897
9967,0.03109,172.31.47.0-255,66,304019,92,386897
9968,0.033298,74.125.200.0-255,5738,309757,92,386897
9969,0.033316,172.31.47.0-255,66,309823,92,386897
9970,0.035536,74.125.200.0-255,5738,315561,92,386897
9971,0.035547,172.31.47.0-255,66,315627,92,386897
9972,0.037778,74.125.200.0-255,5738,321365,92,386897
9973,0.037789,172.31.47.0-255,66,321431,92,386897
9974,0.039593,172.31.47.0-255,172,321603,92,386897
9975,0.039626,172.31.47.0-255,1106,322709,92,386897
9976,0.039658,172.31.47.0-255,1514,324223,92,386897
9977,0.039659,172.31.47.0-255,1514,325737,92,386897
9978,0.03966,172.31.47.0-255,1514,327251,92,386897
9979,0.039661,172.31.47.0-255,1514,328765,92,386897
9980,0.039684,172.31.47.0-255,1500,330265,92,386897
9981,0.040002,74.125.200.0-255,5738,336003,92,386897
9982,0.040007,172.31.47.0-255,66,336069,92,386897
9983,0.04119,104.244.42.0-255,66,336135,92,386897
9984,0.041197,104.244.42.0-255,66,336201,92,386897
9985,0.041263,104.244.42.0-255,66,336267,92,386897
9986,0.041941,104.244.42.0-255,108,336375,92,386897
9987,0.041946,172.31.47.0-255,66,336441,92,386897
9988,0.042225,74.125.200.0-255,2902,339343,92,386897
9989,0.042228,172.31.47.0-255,66,339409,92,386897
9990,0.042256,74.125.200.0-255,2902,342311,92,386897
9991,0.042259,172.31.47.0-255,66,342377,92,386897
9992,0.044444,74.125.200.0-255,2902,345279,92,386897
9993,0.044449,172.31.47.0-255,66,345345,92,386897
9994,0.04448,74.125.200.0-255,2902,348247,92,386897
9995,0.044483,172.31.47.0-255,66,348313,92,386897
9996,0.046667,74.125.200.0-255,2902,351215,92,386897
9997,0.046673,172.31.47.0-255,66,351281,92,386897
9998,0.046702,74.125.200.0-255,2902,354183,92,386897
9999,0.046705,172.31.47.0-255,66,354249,92,386897
10000,0.048883,74.125.200.0-255,2902,357151,92,386897
10001,0.048888,172.31.47.0-255,66,357217,92,386897
10002,0.048918,74.125.200.0-255,2902,360119,92,386897
10003,0.048921,172.31.47.0-255,66,360185,92,386897
10004,0.051098,74.125.200.0-255,2902,363087,92,386897
10005,0.051104,172.31.47.0-255,66,363153,92,386897
10006,0.051135,74.125.200.0-255,2902,366055,92,386897
10007,0.051138,172.31.47.0-255,66,366121,92,386897
10008,0.05331,74.125.200.0-255,2902,369023,92,386897
10009,0.053314,172.31.47.0-255,66,369089,92,386897
10010,0.053345,74.125.200.0-255,2902,371991,92,386897
10011,0.053348,172.31.47.0-255,66,372057,92,386897
10012,0.055537,74.125.200.0-255,2902,374959,92,386897
10013,0.055542,172.31.47.0-255,66,375025,92,386897
10014,0.055565,74.125.200.0-255,2902,377927,92,386897
10015,0.055568,172.31.47.0-255,66,377993,92,386897
10016,0.057766,74.125.200.0-255,2902,380895,92,386897
10017,0.057772,172.31.47.0-255,66,380961,92,386897
10018,0.0578,74.125.200.0-255,2902,383863,92,386897
10019,0.057803,172.31.47.0-255,66,383929,92,386897
10020,0.059982,74.125.200.0-255,2902,386831,92,386897
10021,0.059987,172.31.47.0-255,66,386897,92,386897
10022,0.0,172.217.194.0-255,153,153,92,220540
10023,2.5e-05,172.31.47.0-255,66,219,92,220540
10024,3.2e-05,172.217.194.0-255,1484,1703,92,220540
10025,3.7e-05,172.31.47.0-255,66,1769,92,220540
10026,4.1e-05,172.217.194.0-255,2902,4671,92,220540
10027,5e-05,172.31.47.0-255,66,4737,92,220540
10028,5.6e-05,172.217.194.0-255,4320,9057,92,220540
10029,5.8e-05,172.31.47.0-255,66,9123,92,220540
10030,6.1e-05,172.217.194.0-255,1484,10607,92,220540
10031,6.2e-05,172.31.47.0-255,66,10673,92,220540
10032,0.000103,172.31.47.0-255,66,10739,92,220540
10033,0.000116,172.31.47.0-255,66,10805,92,220540
10034,0.000181,172.217.194.0-255,5738,16543,92,220540
10035,0.000185,172.31.47.0-255,66,16609,92,220540
10036,0.000221,172.31.47.0-255,66,16675,92,220540
10037,0.000254,172.217.194.0-255,1484,18159,92,220540
10038,0.000257,172.31.47.0-255,66,18225,92,220540
10039,0.000262,172.217.194.0-255,2902,21127,92,220540
10040,0.000267,172.31.47.0-255,66,21193,92,220540
10041,0.000289,172.217.194.0-255,5738,26931,92,220540
10042,0.000293,172.31.47.0-255,66,26997,92,220540
10043,0.000294,172.217.194.0-255,5738,32735,92,220540
10044,0.000297,172.31.47.0-255,66,32801,92,220540
10045,0.000328,172.217.194.0-255,1125,33926,92,220540
10046,0.000332,172.31.47.0-255,66,33992,92,220540
10047,0.000335,172.217.194.0-255,647,34639,92,220540
10048,0.000337,172.31.47.0-255,66,34705,92,220540
10049,0.000415,172.217.194.0-255,1484,36189,92,220540
10050,0.000418,172.31.47.0-255,66,36255,92,220540
10051,0.000425,172.217.194.0-255,2902,39157,92,220540
10052,0.000427,172.31.47.0-255,66,39223,92,220540
10053,0.00043,172.217.194.0-255,1484,40707,92,220540
10054,0.000432,172.31.47.0-255,66,40773,92,220540
10055,0.000469,172.217.194.0-255,4320,45093,92,220540
10056,0.000472,172.31.47.0-255,66,45159,92,220540
10057,0.000478,172.217.194.0-255,4320,49479,92,220540
10058,0.00048,172.31.47.0-255,66,49545,92,220540
10059,0.000493,172.31.47.0-255,66,49611,92,220540
10060,0.000497,172.217.194.0-255,2902,52513,92,220540
10061,0.000499,172.31.47.0-255,66,52579,92,220540
10062,0.000529,172.217.194.0-255,5020,57599,92,220540
10063,0.000533,172.31.47.0-255,66,57665,92,220540
10064,0.000641,172.217.194.0-255,1484,59149,92,220540
10065,0.000647,172.217.194.0-255,2902,62051,92,220540
10066,0.00065,172.31.47.0-255,66,62117,92,220540
10067,0.000653,172.217.194.0-255,1484,63601,92,220540
10068,0.000679,172.217.194.0-255,4320,67921,92,220540
10069,0.000683,172.31.47.0-255,66,67987,92,220540
10070,0.000684,172.217.194.0-255,4320,72307,92,220540
10071,0.000686,172.31.47.0-255,66,72373,92,220540
10072,0.000718,172.31.47.0-255,66,72439,92,220540
10073,0.000725,172.31.47.0-255,66,72505,92,220540
10074,0.00076,172.217.194.0-255,1484,73989,92,220540
10075,0.000801,172.31.47.0-255,66,74055,92,220540
10076,0.000805,172.217.194.0-255,4320,78375,92,220540
10077,0.000826,172.217.194.0-255,3602,81977,92,220540
10078,0.000827,172.31.47.0-255,66,82043,92,220540
10079,0.000831,172.31.47.0-255,66,82109,92,220540
10080,0.000855,172.217.194.0-255,1484,83593,92,220540
10081,0.000858,172.217.194.0-255,1484,85077,92,220540
10082,0.000862,172.31.47.0-255,66,85143,92,220540
10083,0.000869,172.217.194.0-255,1484,86627,92,220540
10084,0.000874,172.217.194.0-255,4320,90947,92,220540
10085,0.00088,172.31.47.0-255,66,91013,92,220540
10086,0.000886,172.217.194.0-255,1484,92497,92,220540
10087,0.000902,172.217.194.0-255,5738,98235,92,220540
10088,0.000905,172.31.47.0-255,66,98301,92,220540
10089,0.000919,172.217.194.0-255,7156,105457,92,220540
10090,0.000928,172.217.194.0-255,5738,111195,92,220540
10091,0.000928,172.31.47.0-255,66,111261,92,220540
10092,0.000931,172.31.47.0-255,66,111327,92,220540
10093,0.000953,172.217.194.0-255,5020,116347,92,220540
10094,0.000966,172.31.47.0-255,66,116413,92,220540
10095,0.000987,172.217.194.0-255,1484,117897,92,220540
10096,0.001005,172.217.194.0-255,2902,120799,92,220540
10097,0.00101,172.217.194.0-255,5738,126537,92,220540
10098,0.001011,172.31.47.0-255,66,126603,92,220540
10099,0.001015,172.31.47.0-255,66,126669,92,220540
10100,0.001047,172.217.194.0-255,7156,133825,92,220540
10101,0.001053,172.31.47.0-255,66,133891,92,220540
10102,0.00111,172.217.194.0-255,2184,136075,92,220540
10103,0.001111,172.31.47.0-255,66,136141,92,220540
10104,0.001113,172.217.194.0-255,4320,140461,92,220540
10105,0.001115,172.31.47.0-255,66,140527,92,220540
10106,0.001128,172.31.47.0-255,66,140593,92,220540
10107,0.001173,172.31.47.0-255,66,140659,92,220540
10108,0.001185,172.217.194.0-255,2902,143561,92,220540
10109,0.001189,172.31.47.0-255,66,143627,92,220540
10110,0.001225,172.31.47.0-255,66,143693,92,220540
10111,0.001277,172.217.194.0-255,1484,145177,92,220540
10112,0.00128,172.217.194.0-255,1484,146661,92,220540
10113,0.001282,172.31.47.0-255,66,146727,92,220540
10114,0.0013,172.217.194.0-255,1484,148211,92,220540
10115,0.001305,172.217.194.0-255,5738,153949,92,220540
10116,0.00131,172.217.194.0-255,4320,158269,92,220540
10117,0.001314,172.31.47.0-255,66,158335,92,220540
10118,0.001335,172.217.194.0-255,1484,159819,92,220540
10119,0.001347,172.31.47.0-255,66,159885,92,220540
10120,0.001367,172.31.47.0-255,66,159951,92,220540
10121,0.001376,172.217.194.0-255,2902,162853,92,220540
10122,0.001384,172.31.47.0-255,66,162919,92,220540
10123,0.001391,172.217.194.0-255,2902,165821,92,220540
10124,0.001395,172.31.47.0-255,66,165887,92,220540
10125,0.001424,172.31.47.0-255,66,165953,92,220540
10126,0.001437,172.217.194.0-255,5738,171691,92,220540
10127,0.00144,172.217.194.0-255,1484,173175,92,220540
10128,0.001445,172.31.47.0-255,66,173241,92,220540
10129,0.001472,172.217.194.0-255,5738,178979,92,220540
10130,0.001478,172.31.47.0-255,66,179045,92,220540
10131,0.00149,172.217.194.0-255,4320,183365,92,220540
10132,0.00149,172.31.47.0-255,66,183431,92,220540
10133,0.001494,172.31.47.0-255,66,183497,92,220540
10134,0.00152,172.217.194.0-255,1484,184981,92,220540
10135,0.001527,172.217.194.0-255,6438,191419,92,220540
10136,0.00153,172.31.47.0-255,66,191485,92,220540
10137,0.001552,172.217.194.0-255,4320,195805,92,220540
10138,0.001558,172.31.47.0-255,66,195871,92,220540
10139,0.001568,172.217.194.0-255,4320,200191,92,220540
10140,0.001571,172.31.47.0-255,66,200257,92,220540
10141,0.001616,172.217.194.0-255,1484,201741,92,220540
10142,0.001618,172.217.194.0-255,1484,203225,92,220540
10143,0.001618,172.31.47.0-255,66,203291,92,220540
10144,0.001622,172.217.194.0-255,2902,206193,92,220540
10145,0.001623,172.31.47.0-255,66,206259,92,220540
10146,0.001635,172.31.47.0-255,66,206325,92,220540
10147,0.001664,172.31.47.0-255,66,206391,92,220540
10148,0.001715,172.217.194.0-255,4643,211034,92,220540
10149,0.001715,172.31.47.0-255,66,211100,92,220540
10150,0.001717,172.217.194.0-255,105,211205,92,220540
10151,0.001718,172.31.47.0-255,66,211271,92,220540
10152,0.003242,172.31.47.0-255,66,211337,92,220540
10153,0.003266,172.31.47.0-255,105,211442,92,220540
10154,0.005294,172.217.194.0-255,66,211508,92,220540
10155,0.031536,172.31.47.0-255,172,211680,92,220540
10156,0.031566,172.31.47.0-255,1111,212791,92,220540
10157,0.031601,172.31.47.0-255,1514,214305,92,220540
10158,0.031602,172.31.47.0-255,1514,215819,92,220540
10159,0.031609,172.31.47.0-255,1514,217333,92,220540
10160,0.03161,172.31.47.0-255,1514,218847,92,220540
10161,0.031637,172.31.47.0-255,1495,220342,92,220540
10162,0.0331,104.244.42.0-255,66,220408,92,220540
10163,0.033132,104.244.42.0-255,66,220474,92,220540
10164,0.033203,104.244.42.0-255,66,220540,92,220540
10165,0.0,172.217.194.0-255,153,153,92,304481
10166,2e-05,172.31.47.0-255,66,219,92,304481
10167,2.8e-05,172.217.194.0-255,1484,1703,92,304481
10168,3.3e-05,172.31.47.0-255,66,1769,92,304481
10169,4.5e-05,172.217.194.0-255,2902,4671,92,304481
10170,4.9e-05,172.31.47.0-255,66,4737,92,304481
10171,5.8e-05,172.217.194.0-255,7156,11893,92,304481
10172,6.1e-05,172.31.47.0-255,66,11959,92,304481
10173,6.8e-05,172.217.194.0-255,6353,18312,92,304481
10174,7.1e-05,172.31.47.0-255,66,18378,92,304481
10175,0.000123,172.31.47.0-255,66,18444,92,304481
10176,0.000162,172.217.194.0-255,1484,19928,92,304481
10177,0.000164,172.31.47.0-255,66,19994,92,304481
10178,0.00017,172.217.194.0-255,2902,22896,92,304481
10179,0.000172,172.31.47.0-255,66,22962,92,304481
10180,0.000184,172.217.194.0-255,5738,28700,92,304481
10181,0.000186,172.31.47.0-255,66,28766,92,304481
10182,0.000227,172.31.47.0-255,66,28832,92,304481
10183,0.000269,172.217.194.0-255,4320,33152,92,304481
10184,0.000271,172.31.47.0-255,66,33218,92,304481
10185,0.000293,172.217.194.0-255,5669,38887,92,304481
10186,0.000296,172.31.47.0-255,66,38953,92,304481
10187,0.000299,172.217.194.0-255,98,39051,92,304481
10188,0.000301,172.31.47.0-255,66,39117,92,304481
10189,0.000351,172.217.194.0-255,1484,40601,92,304481
10190,0.000353,172.31.47.0-255,66,40667,92,304481
10191,0.000358,172.217.194.0-255,2902,43569,92,304481
10192,0.000361,172.31.47.0-255,66,43635,92,304481
10193,0.000371,172.217.194.0-255,5738,49373,92,304481
10194,0.000374,172.31.47.0-255,66,49439,92,304481
10195,0.000412,172.217.194.0-255,2902,52341,92,304481
10196,0.000414,172.31.47.0-255,66,52407,92,304481
10197,0.000447,172.217.194.0-255,3961,56368,92,304481
10198,0.000455,172.217.194.0-255,7156,63524,92,304481
10199,0.000484,172.217.194.0-255,5738,69262,92,304481
10200,0.000496,172.217.194.0-255,4320,73582,92,304481
10201,0.000501,172.217.194.0-255,2902,76484,92,304481
10202,0.000557,172.217.194.0-255,4320,80804,92,304481
10203,0.000576,172.217.194.0-255,5020,85824,92,304481
10204,0.000627,172.217.194.0-255,1484,87308,92,304481
10205,0.00064,172.217.194.0-255,2902,90210,92,304481
10206,0.000661,172.217.194.0-255,5738,95948,92,304481
10207,0.000668,172.217.194.0-255,5738,101686,92,304481
10208,0.000691,172.217.194.0-255,4320,106006,92,304481
10209,0.000723,172.217.194.0-255,5020,111026,92,304481
10210,0.000747,172.31.47.0-255,66,111092,92,304481
10211,0.000821,172.217.194.0-255,1484,112576,92,304481
10212,0.000827,172.217.194.0-255,2902,115478,92,304481
10213,0.000846,172.217.194.0-255,5738,121216,92,304481
10214,0.000913,172.217.194.0-255,7156,128372,92,304481
10215,0.000918,172.217.194.0-255,3602,131974,92,304481
10216,0.000928,172.31.47.0-255,66,132040,92,304481
10217,0.001472,172.217.194.0-255,1484,133524,92,304481
10218,0.00149,172.217.194.0-255,2902,136426,92,304481
10219,0.001496,172.217.194.0-255,4320,140746,92,304481
10220,0.001512,172.217.194.0-255,1484,142230,92,304481
10221,0.001525,172.217.194.0-255,2902,145132,92,304481
10222,0.001531,172.31.47.0-255,66,145198,92,304481
10223,0.001544,172.217.194.0-255,7156,152354,92,304481
10224,0.001566,172.217.194.0-255,2902,155256,92,304481
10225,0.001589,172.217.194.0-255,5738,160994,92,304481
10226,0.001592,172.31.47.0-255,66,161060,92,304481
10227,0.0016,172.31.47.0-255,66,161126,92,304481
10228,0.001611,172.217.194.0-255,5020,166146,92,304481
10229,0.001633,172.217.194.0-255,1484,167630,92,304481
10230,0.001637,172.217.194.0-255,2902,170532,92,304481
10231,0.001654,172.31.47.0-255,66,170598,92,304481
10232,0.001661,172.217.194.0-255,5738,176336,92,304481
10233,0.001665,172.31.47.0-255,66,176402,92,304481
10234,0.001705,172.217.194.0-255,2902,179304,92,304481
10235,0.001724,172.217.194.0-255,7156,186460,92,304481
10236,0.001738,172.217.194.0-255,766,187226,92,304481
10237,0.00174,172.31.47.0-255,66,187292,92,304481
10238,0.00184,172.217.194.0-255,1484,188776,92,304481
10239,0.001843,172.217.194.0-255,1484,190260,92,304481
10240,0.001852,172.31.47.0-255,66,190326,92,304481
10241,0.00186,172.217.194.0-255,1484,191810,92,304481
10242,0.001865,172.217.194.0-255,5738,197548,92,304481
10243,0.001874,172.31.47.0-255,66,197614,92,304481
10244,0.001881,172.217.194.0-255,1484,199098,92,304481
10245,0.001913,172.217.194.0-255,1484,200582,92,304481
10246,0.001924,172.31.47.0-255,66,200648,92,304481
10247,0.001929,172.31.47.0-255,66,200714,92,304481
10248,0.002126,172.217.194.0-255,1484,202198,92,304481
10249,0.002145,172.217.194.0-255,2902,205100,92,304481
10250,0.002148,172.31.47.0-255,66,205166,92,304481
10251,0.00216,172.217.194.0-255,2902,208068,92,304481
10252,0.00217,172.31.47.0-255,66,208134,92,304481
10253,0.002186,172.217.194.0-255,2902,211036,92,304481
10254,0.002211,172.31.47.0-255,66,211102,92,304481
10255,0.002221,172.217.194.0-255,2902,214004,92,304481
10256,0.002256,172.217.194.0-255,2184,216188,92,304481
10257,0.002261,172.31.47.0-255,66,216254,92,304481
10258,0.002266,172.217.194.0-255,1484,217738,92,304481
10259,0.00227,172.217.194.0-255,2902,220640,92,304481
10260,0.002275,172.31.47.0-255,66,220706,92,304481
10261,0.002287,172.217.194.0-255,2902,223608,92,304481
10262,0.002303,172.217.194.0-255,2902,226510,92,304481
10263,0.002309,172.217.194.0-255,5738,232248,92,304481
10264,0.002318,172.31.47.0-255,66,232314,92,304481
10265,0.002326,172.217.194.0-255,4320,236634,92,304481
10266,0.002331,172.31.47.0-255,66,236700,92,304481
10267,0.002364,172.217.194.0-255,5020,241720,92,304481
10268,0.002405,172.31.47.0-255,66,241786,92,304481
10269,0.004715,172.217.194.0-255,5738,247524,92,304481
10270,0.004722,172.31.47.0-255,66,247590,92,304481
10271,0.007092,172.217.194.0-255,5738,253328,92,304481
10272,0.013524,172.31.47.0-255,66,253394,92,304481
10273,0.014075,172.217.194.0-255,1484,254878,92,304481
10274,0.015861,172.217.194.0-255,4320,259198,92,304481
10275,0.015867,172.31.47.0-255,66,259264,92,304481
10276,0.018258,172.217.194.0-255,5738,265002,92,304481
10277,0.018348,172.31.47.0-255,66,265068,92,304481
10278,0.020664,172.217.194.0-255,5738,270806,92,304481
10279,0.020672,172.31.47.0-255,66,270872,92,304481
10280,0.023064,172.217.194.0-255,5738,276610,92,304481
10281,0.023072,172.31.47.0-255,66,276676,92,304481
10282,0.02544,172.217.194.0-255,5738,282414,92,304481
10283,0.025447,172.31.47.0-255,66,282480,92,304481
10284,0.027815,172.217.194.0-255,5738,288218,92,304481
10285,0.027822,172.31.47.0-255,66,288284,92,304481
10286,0.030161,172.217.194.0-255,5738,294022,92,304481
10287,0.030167,172.31.47.0-255,66,294088,92,304481
10288,0.032553,172.217.194.0-255,2030,296118,92,304481
10289,0.032563,172.31.47.0-255,66,296184,92,304481
10290,0.032829,172.31.47.0-255,105,296289,92,304481
10291,0.03519,172.217.194.0-255,66,296355,92,304481
10292,0.054577,172.31.47.0-255,166,296521,92,304481
10293,0.054607,172.31.47.0-255,1127,297648,92,304481
10294,0.054683,172.31.47.0-255,1514,299162,92,304481
10295,0.054684,172.31.47.0-255,1514,300676,92,304481
10296,0.054686,172.31.47.0-255,1514,302190,92,304481
10297,0.054686,172.31.47.0-255,1514,303704,92,304481
10298,0.054711,172.31.47.0-255,339,304043,92,304481
10299,0.056161,104.244.42.0-255,66,304109,92,304481
10300,0.056194,104.244.42.0-255,66,304175,92,304481
10301,0.056266,104.244.42.0-255,66,304241,92,304481
10302,0.056287,104.244.42.0-255,66,304307,92,304481
10303,0.057066,104.244.42.0-255,108,304415,92,304481
10304,0.057072,172.31.47.0-255,66,304481,92,304481
10305,0.0,172.31.47.0-255,105,105,92,276
10306,0.001473,157.240.13.0-255,105,210,92,276
10307,0.038978,172.31.47.0-255,66,276,92,276
10308,0.0,74.125.130.0-255,153,153,92,202173
10309,3.6e-05,172.31.47.0-255,66,219,92,202173
10310,4.5e-05,74.125.130.0-255,1484,1703,92,202173
10311,5.1e-05,172.31.47.0-255,66,1769,92,202173
10312,7.1e-05,74.125.130.0-255,2902,4671,92,202173
10313,7.4e-05,172.31.47.0-255,66,4737,92,202173
10314,8.4e-05,74.125.130.0-255,7156,11893,92,202173
10315,8.8e-05,172.31.47.0-255,66,11959,92,202173
10316,9.3e-05,74.125.130.0-255,2101,14060,92,202173
10317,9.6e-05,172.31.47.0-255,66,14126,92,202173
10318,0.000153,74.125.130.0-255,1484,15610,92,202173
10319,0.000158,172.31.47.0-255,66,15676,92,202173
10320,0.000164,74.125.130.0-255,2902,18578,92,202173
10321,0.000167,172.31.47.0-255,66,18644,92,202173
10322,0.000177,74.125.130.0-255,1484,20128,92,202173
10323,0.00018,172.31.47.0-255,66,20194,92,202173
10324,0.000187,74.125.130.0-255,2902,23096,92,202173
10325,0.000191,172.31.47.0-255,66,23162,92,202173
10326,0.000199,74.125.130.0-255,5738,28900,92,202173
10327,0.000202,172.31.47.0-255,66,28966,92,202173
10328,0.000229,74.125.130.0-255,2543,31509,92,202173
10329,0.000233,172.31.47.0-255,66,31575,92,202173
10330,0.000673,74.125.130.0-255,1484,33059,92,202173
10331,0.00068,172.31.47.0-255,66,33125,92,202173
10332,0.000687,74.125.130.0-255,2902,36027,92,202173
10333,0.00069,172.31.47.0-255,66,36093,92,202173
10334,0.000704,74.125.130.0-255,5738,41831,92,202173
10335,0.000708,172.31.47.0-255,66,41897,92,202173
10336,0.000713,74.125.130.0-255,4320,46217,92,202173
10337,0.000716,172.31.47.0-255,66,46283,92,202173
10338,0.000747,74.125.130.0-255,2543,48826,92,202173
10339,0.00075,172.31.47.0-255,66,48892,92,202173
10340,0.00076,74.125.130.0-255,7156,56048,92,202173
10341,0.000768,74.125.130.0-255,4320,60368,92,202173
10342,0.000771,74.125.130.0-255,1484,61852,92,202173
10343,0.000802,74.125.130.0-255,3961,65813,92,202173
10344,0.000812,172.31.47.0-255,66,65879,92,202173
10345,0.000856,74.125.130.0-255,364,66243,92,202173
10346,0.000919,74.125.130.0-255,378,66621,92,202173
10347,0.00107,74.125.130.0-255,1484,68105,92,202173
10348,0.001079,172.31.47.0-255,66,68171,92,202173
10349,0.001087,74.125.130.0-255,2902,71073,92,202173
10350,0.001091,172.31.47.0-255,66,71139,92,202173
10351,0.001103,74.125.130.0-255,1484,72623,92,202173
10352,0.00114,74.125.130.0-255,4320,76943,92,202173
10353,0.001147,74.125.130.0-255,2902,79845,92,202173
10354,0.001154,74.125.130.0-255,4320,84165,92,202173
10355,0.001174,74.125.130.0-255,4320,88485,92,202173
10356,0.00119,172.31.47.0-255,66,88551,92,202173
10357,0.001229,74.125.130.0-255,3602,92153,92,202173
10358,0.001267,172.31.47.0-255,66,92219,92,202173
10359,0.001301,74.125.130.0-255,1484,93703,92,202173
10360,0.001307,74.125.130.0-255,2902,96605,92,202173
10361,0.001325,74.125.130.0-255,4320,100925,92,202173
10362,0.00133,74.125.130.0-255,1484,102409,92,202173
10363,0.001349,74.125.130.0-255,4320,106729,92,202173
10364,0.00136,172.31.47.0-255,66,106795,92,202173
10365,0.001401,74.125.130.0-255,2902,109697,92,202173
10366,0.001421,172.31.47.0-255,66,109763,92,202173
10367,0.001457,74.125.130.0-255,5020,114783,92,202173
10368,0.001469,172.31.47.0-255,66,114849,92,202173
10369,0.002092,74.125.130.0-255,1484,116333,92,202173
10370,0.002119,74.125.130.0-255,2902,119235,92,202173
10371,0.002124,172.31.47.0-255,66,119301,92,202173
10372,0.00213,74.125.130.0-255,4320,123621,92,202173
10373,0.002136,172.31.47.0-255,66,123687,92,202173
10374,0.002155,74.125.130.0-255,1484,125171,92,202173
10375,0.002162,74.125.130.0-255,5738,130909,92,202173
10376,0.002168,172.31.47.0-255,66,130975,92,202173
10377,0.00219,74.125.130.0-255,7156,138131,92,202173
10378,0.002291,172.31.47.0-255,66,138197,92,202173
10379,0.004933,74.125.130.0-255,5738,143935,92,202173
10380,0.004954,172.31.47.0-255,66,144001,92,202173
10381,0.007595,74.125.130.0-255,5738,149739,92,202173
10382,0.013742,172.31.47.0-255,66,149805,92,202173
10383,0.015446,74.125.130.0-255,1484,151289,92,202173
10384,0.016375,74.125.130.0-255,4320,155609,92,202173
10385,0.016388,172.31.47.0-255,66,155675,92,202173
10386,0.01903,74.125.130.0-255,5738,161413,92,202173
10387,0.025751,172.31.47.0-255,66,161479,92,202173
10388,0.028394,74.125.130.0-255,5738,167217,92,202173
10389,0.028415,172.31.47.0-255,66,167283,92,202173
10390,0.03105,74.125.130.0-255,5738,173021,92,202173
10391,0.031069,172.31.47.0-255,66,173087,92,202173
10392,0.033862,74.125.130.0-255,5738,178825,92,202173
10393,0.041696,172.31.47.0-255,66,178891,92,202173
10394,0.04343,74.125.130.0-255,1484,180375,92,202173
10395,0.04432,74.125.130.0-255,4320,184695,92,202173
10396,0.044331,172.31.47.0-255,66,184761,92,202173
10397,0.046958,74.125.130.0-255,5738,190499,92,202173
10398,0.053725,172.31.47.0-255,66,190565,92,202173
10399,0.056357,74.125.130.0-255,5738,196303,92,202173
10400,0.056368,172.31.47.0-255,66,196369,92,202173
10401,0.058983,74.125.130.0-255,5738,202107,92,202173
10402,0.058995,172.31.47.0-255,66,202173,92,202173
10403,0.0,74.125.24.0-255,153,153,92,324338
10404,1.7e-05,172.31.47.0-255,66,219,92,324338
10405,2.4e-05,74.125.24.0-255,1484,1703,92,324338
10406,2.9e-05,172.31.47.0-255,66,1769,92,324338
10407,3.5e-05,74.125.24.0-255,2902,4671,92,324338
10408,3.8e-05,172.31.47.0-255,66,4737,92,324338
10409,4.5e-05,74.125.24.0-255,7156,11893,92,324338
10410,4.8e-05,172.31.47.0-255,66,11959,92,324338
10411,8.8e-05,74.125.24.0-255,7156,19115,92,324338
10412,9.1e-05,172.31.47.0-255,66,19181,92,324338
10413,0.000121,172.31.47.0-255,66,19247,92,324338
10414,0.000125,74.125.24.0-255,2543,21790,92,324338
10415,0.000128,172.31.47.0-255,66,21856,92,324338
10416,0.000151,74.125.24.0-255,2902,24758,92,324338
10417,0.000153,172.31.47.0-255,66,24824,92,324338
10418,0.000156,74.125.24.0-255,1484,26308,92,324338
10419,0.000158,172.31.47.0-255,66,26374,92,324338
10420,0.000175,74.125.24.0-255,5738,32112,92,324338
10421,0.000177,172.31.47.0-255,66,32178,92,324338
10422,0.00019,74.125.24.0-255,4320,36498,92,324338
10423,0.000193,172.31.47.0-255,66,36564,92,324338
10424,0.000217,172.31.47.0-255,66,36630,92,324338
10425,0.000223,74.125.24.0-255,5738,42368,92,324338
10426,0.000225,172.31.47.0-255,66,42434,92,324338
10427,0.000245,74.125.24.0-255,5020,47454,92,324338
10428,0.000247,172.31.47.0-255,66,47520,92,324338
10429,0.000249,74.125.24.0-255,397,47917,92,324338
10430,0.000251,172.31.47.0-255,66,47983,92,324338
10431,0.000299,74.125.24.0-255,346,48329,92,324338
10432,0.000302,172.31.47.0-255,66,48395,92,324338
10433,0.000428,74.125.24.0-255,1484,49879,92,324338
10434,0.000446,74.125.24.0-255,2902,52781,92,324338
10435,0.00045,172.31.47.0-255,66,52847,92,324338
10436,0.000456,74.125.24.0-255,4320,57167,92,324338
10437,0.000459,172.31.47.0-255,66,57233,92,324338
10438,0.000483,74.125.24.0-255,1484,58717,92,324338
10439,0.000491,74.125.24.0-255,6797,65514,92,324338
10440,0.000493,172.31.47.0-255,66,65580,92,324338
10441,0.000513,74.125.24.0-255,2902,68482,92,324338
10442,0.000515,172.31.47.0-255,66,68548,92,324338
10443,0.000545,172.31.47.0-255,66,68614,92,324338
10444,0.000548,74.125.24.0-255,1994,70608,92,324338
10445,0.000551,172.31.47.0-255,66,70674,92,324338
10446,0.000649,74.125.24.0-255,1484,72158,92,324338
10447,0.000655,74.125.24.0-255,2902,75060,92,324338
10448,0.000659,172.31.47.0-255,66,75126,92,324338
10449,0.000662,74.125.24.0-255,1484,76610,92,324338
10450,0.000681,74.125.24.0-255,4320,80930,92,324338
10451,0.000684,172.31.47.0-255,66,80996,92,324338
10452,0.000689,74.125.24.0-255,4320,85316,92,324338
10453,0.000692,172.31.47.0-255,66,85382,92,324338
10454,0.000703,74.125.24.0-255,1484,86866,92,324338
10455,0.000735,74.125.24.0-255,2902,89768,92,324338
10456,0.000738,172.31.47.0-255,66,89834,92,324338
10457,0.000751,74.125.24.0-255,4320,94154,92,324338
10458,0.000754,172.31.47.0-255,66,94220,92,324338
10459,0.000771,74.125.24.0-255,5738,99958,92,324338
10460,0.000774,172.31.47.0-255,66,100024,92,324338
10461,0.000778,74.125.24.0-255,2902,102926,92,324338
10462,0.00078,172.31.47.0-255,66,102992,92,324338
10463,0.0008,74.125.24.0-255,2184,105176,92,324338
10464,0.000802,172.31.47.0-255,66,105242,92,324338
10465,0.000846,74.125.24.0-255,1484,106726,92,324338
10466,0.000863,74.125.24.0-255,2902,109628,92,324338
10467,0.000866,172.31.47.0-255,66,109694,92,324338
10468,0.000871,74.125.24.0-255,2902,112596,92,324338
10469,0.000873,172.31.47.0-255,66,112662,92,324338
10470,0.00089,74.125.24.0-255,2902,115564,92,324338
10471,0.000893,172.31.47.0-255,66,115630,92,324338
10472,0.0009,74.125.24.0-255,7156,122786,92,324338
10473,0.000902,172.31.47.0-255,66,122852,92,324338
10474,0.000931,172.31.47.0-255,66,122918,92,324338
10475,0.000956,74.125.24.0-255,5738,128656,92,324338
10476,0.000958,172.31.47.0-255,66,128722,92,324338
10477,0.000962,74.125.24.0-255,2184,130906,92,324338
10478,0.000964,172.31.47.0-255,66,130972,92,324338
10479,0.000991,74.125.24.0-255,2902,133874,92,324338
10480,0.000994,172.31.47.0-255,66,133940,92,324338
10481,0.001019,74.125.24.0-255,1484,135424,92,324338
10482,0.001023,172.31.47.0-255,66,135490,92,324338
10483,0.00104,172.31.47.0-255,66,135556,92,324338
10484,0.001054,74.125.24.0-255,4320,139876,92,324338
10485,0.001057,172.31.47.0-255,66,139942,92,324338
10486,0.001064,74.125.24.0-255,6438,146380,92,324338
10487,0.001066,172.31.47.0-255,66,146446,92,324338
10488,0.001114,74.125.24.0-255,1484,147930,92,324338
10489,0.001118,74.125.24.0-255,2902,150832,92,324338
10490,0.00112,172.31.47.0-255,66,150898,92,324338
10491,0.001126,74.125.24.0-255,5738,156636,92,324338
10492,0.001129,172.31.47.0-255,66,156702,92,324338
10493,0.001134,74.125.24.0-255,4320,161022,92,324338
10494,0.001137,172.31.47.0-255,66,161088,92,324338
10495,0.00116,172.31.47.0-255,66,161154,92,324338
10496,0.001178,74.125.24.0-255,7156,168310,92,324338
10497,0.001181,172.31.47.0-255,66,168376,92,324338
10498,0.001184,74.125.24.0-255,1484,169860,92,324338
10499,0.001202,74.125.24.0-255,2184,172044,92,324338
10500,0.001205,172.31.47.0-255,66,172110,92,324338
10501,0.00126,74.125.24.0-255,1484,173594,92,324338
10502,0.001266,74.125.24.0-255,2902,176496,92,324338
10503,0.001269,172.31.47.0-255,66,176562,92,324338
10504,0.001273,74.125.24.0-255,1484,178046,92,324338
10505,0.001298,74.125.24.0-255,4320,182366,92,324338
10506,0.001301,172.31.47.0-255,66,182432,92,324338
10507,0.001311,74.125.24.0-255,7156,189588,92,324338
10508,0.001313,172.31.47.0-255,66,189654,92,324338
10509,0.001337,74.125.24.0-255,4320,193974,92,324338
10510,0.00134,172.31.47.0-255,66,194040,92,324338
10511,0.001346,74.125.24.0-255,5738,199778,92,324338
10512,0.001349,172.31.47.0-255,66,199844,92,324338
10513,0.001378,74.125.24.0-255,6438,206282,92,324338
10514,0.001392,74.125.24.0-255,1484,207766,92,324338
10515,0.001413,74.125.24.0-255,2902,210668,92,324338
10516,0.001417,74.125.24.0-255,2902,213570,92,324338
10517,0.001432,74.125.24.0-255,2902,216472,92,324338
10518,0.001471,74.125.24.0-255,2902,219374,92,324338
10519,0.001499,74.125.24.0-255,7156,226530,92,324338
10520,0.001519,74.125.24.0-255,5020,231550,92,324338
10521,0.001531,74.125.24.0-255,1484,233034,92,324338
10522,0.001541,74.125.24.0-255,1484,234518,92,324338
10523,0.001575,74.125.24.0-255,5738,240256,92,324338
10524,0.001591,74.125.24.0-255,1484,241740,92,324338
10525,0.001611,74.125.24.0-255,7156,248896,92,324338
10526,0.001628,74.125.24.0-255,6438,255334,92,324338
10527,0.001651,74.125.24.0-255,4320,259654,92,324338
10528,0.001711,74.125.24.0-255,2902,262556,92,324338
10529,0.001731,74.125.24.0-255,6438,268994,92,324338
10530,0.001762,74.125.24.0-255,1484,270478,92,324338
10531,0.001766,74.125.24.0-255,1484,271962,92,324338
10532,0.001781,74.125.24.0-255,1484,273446,92,324338
10533,0.001789,74.125.24.0-255,5738,279184,92,324338
10534,0.001843,74.125.24.0-255,2902,282086,92,324338
10535,0.001867,74.125.24.0-255,7156,289242,92,324338
10536,0.001869,74.125.24.0-255,1484,290726,92,324338
10537,0.001887,74.125.24.0-255,2184,292910,92,324338
10538,0.001906,74.125.24.0-255,4320,297230,92,324338
10539,0.001912,74.125.24.0-255,4320,301550,92,324338
10540,0.001931,74.125.24.0-255,5738,307288,92,324338
10541,0.001936,74.125.24.0-255,4320,311608,92,324338
10542,0.001963,74.125.24.0-255,3355,314963,92,324338
10543,0.001992,74.125.24.0-255,105,315068,92,324338
10544,0.004527,172.31.47.0-255,66,315134,92,324338
10545,0.007622,172.31.47.0-255,105,315239,92,324338
10546,0.010004,74.125.24.0-255,66,315305,92,324338
10547,0.03086,172.31.47.0-255,172,315477,92,324338
10548,0.030893,172.31.47.0-255,1112,316589,92,324338
10549,0.030973,172.31.47.0-255,1514,318103,92,324338
10550,0.030975,172.31.47.0-255,1514,319617,92,324338
10551,0.03098,172.31.47.0-255,1514,321131,92,324338
10552,0.030981,172.31.47.0-255,1514,322645,92,324338
10553,0.031001,172.31.47.0-255,1495,324140,92,324338
10554,0.032449,104.244.42.0-255,66,324206,92,324338
10555,0.03246,104.244.42.0-255,66,324272,92,324338
10556,0.032578,104.244.42.0-255,66,324338,92,324338
10557,0.0,74.125.24.0-255,153,153,92,220522
10558,2.5e-05,172.31.47.0-255,66,219,92,220522
10559,3.2e-05,74.125.24.0-255,1484,1703,92,220522
10560,3.5e-05,172.31.47.0-255,66,1769,92,220522
10561,3.9e-05,74.125.24.0-255,2902,4671,92,220522
10562,4.1e-05,172.31.47.0-255,66,4737,92,220522
10563,4.7e-05,74.125.24.0-255,7156,11893,92,220522
10564,4.9e-05,172.31.47.0-255,66,11959,92,220522
10565,7.7e-05,172.31.47.0-255,66,12025,92,220522
10566,9.6e-05,74.125.24.0-255,6260,18285,92,220522
10567,9.8e-05,172.31.47.0-255,66,18351,92,220522
10568,0.000101,74.125.24.0-255,2543,20894,92,220522
10569,0.000103,172.31.47.0-255,66,20960,92,220522
10570,0.000162,74.125.24.0-255,1484,22444,92,220522
10571,0.000165,172.31.47.0-255,66,22510,92,220522
10572,0.00018,74.125.24.0-255,1484,23994,92,220522
10573,0.000182,172.31.47.0-255,66,24060,92,220522
10574,0.000186,74.125.24.0-255,2902,26962,92,220522
10575,0.000188,172.31.47.0-255,66,27028,92,220522
10576,0.00021,74.125.24.0-255,5738,32766,92,220522
10577,0.000212,172.31.47.0-255,66,32832,92,220522
10578,0.000227,74.125.24.0-255,2902,35734,92,220522
10579,0.000229,172.31.47.0-255,66,35800,92,220522
10580,0.000254,172.31.47.0-255,66,35866,92,220522
10581,0.000281,74.125.24.0-255,2902,38768,92,220522
10582,0.000284,172.31.47.0-255,66,38834,92,220522
10583,0.0003,74.125.24.0-255,5645,44479,92,220522
10584,0.000302,172.31.47.0-255,66,44545,92,220522
10585,0.000305,74.125.24.0-255,140,44685,92,220522
10586,0.000307,172.31.47.0-255,66,44751,92,220522
10587,0.000396,74.125.24.0-255,1484,46235,92,220522
10588,0.000412,74.125.24.0-255,2902,49137,92,220522
10589,0.000415,172.31.47.0-255,66,49203,92,220522
10590,0.00042,74.125.24.0-255,5738,54941,92,220522
10591,0.000423,172.31.47.0-255,66,55007,92,220522
10592,0.000447,74.125.24.0-255,4320,59327,92,220522
10593,0.00045,172.31.47.0-255,66,59393,92,220522
10594,0.000476,74.125.24.0-255,2543,61936,92,220522
10595,0.000478,172.31.47.0-255,66,62002,92,220522
10596,0.000493,74.125.24.0-255,2543,64545,92,220522
10597,0.000493,172.31.47.0-255,66,64611,92,220522
10598,0.000496,172.31.47.0-255,66,64677,92,220522
10599,0.000543,74.125.24.0-255,1484,66161,92,220522
10600,0.000548,74.125.24.0-255,2902,69063,92,220522
10601,0.00055,172.31.47.0-255,66,69129,92,220522
10602,0.00057,74.125.24.0-255,5738,74867,92,220522
10603,0.000573,172.31.47.0-255,66,74933,92,220522
10604,0.000578,74.125.24.0-255,4320,79253,92,220522
10605,0.00058,172.31.47.0-255,66,79319,92,220522
10606,0.000604,172.31.47.0-255,66,79385,92,220522
10607,0.00061,74.125.24.0-255,7156,86541,92,220522
10608,0.000612,172.31.47.0-255,66,86607,92,220522
10609,0.000637,74.125.24.0-255,1484,88091,92,220522
10610,0.000654,74.125.24.0-255,5020,93111,92,220522
10611,0.000657,172.31.47.0-255,66,93177,92,220522
10612,0.000662,74.125.24.0-255,7156,100333,92,220522
10613,0.000664,172.31.47.0-255,66,100399,92,220522
10614,0.000687,172.31.47.0-255,66,100465,92,220522
10615,0.0007,74.125.24.0-255,5738,106203,92,220522
10616,0.000703,172.31.47.0-255,66,106269,92,220522
10617,0.000733,172.31.47.0-255,66,106335,92,220522
10618,0.000737,74.125.24.0-255,4320,110655,92,220522
10619,0.000739,172.31.47.0-255,66,110721,92,220522
10620,0.000754,74.125.24.0-255,4320,115041,92,220522
10621,0.000757,172.31.47.0-255,66,115107,92,220522
10622,0.000763,74.125.24.0-255,7156,122263,92,220522
10623,0.000765,172.31.47.0-255,66,122329,92,220522
10624,0.000788,74.125.24.0-255,2902,125231,92,220522
10625,0.000791,74.125.24.0-255,2902,128133,92,220522
10626,0.000791,172.31.47.0-255,66,128199,92,220522
10627,0.000794,172.31.47.0-255,66,128265,92,220522
10628,0.000823,172.31.47.0-255,66,128331,92,220522
10629,0.000854,74.125.24.0-255,7156,135487,92,220522
10630,0.000857,172.31.47.0-255,66,135553,92,220522
10631,0.000881,74.125.24.0-255,2902,138455,92,220522
10632,0.000882,172.31.47.0-255,66,138521,92,220522
10633,0.000884,172.31.47.0-255,66,138587,92,220522
10634,0.0009,74.125.24.0-255,2902,141489,92,220522
10635,0.000903,172.31.47.0-255,66,141555,92,220522
10636,0.000937,172.31.47.0-255,66,141621,92,220522
10637,0.000975,74.125.24.0-255,1484,143105,92,220522
10638,0.000996,74.125.24.0-255,2902,146007,92,220522
10639,0.001,172.31.47.0-255,66,146073,92,220522
10640,0.001005,74.125.24.0-255,5738,151811,92,220522
10641,0.001007,172.31.47.0-255,66,151877,92,220522
10642,0.00101,74.125.24.0-255,1484,153361,92,220522
10643,0.001034,172.31.47.0-255,66,153427,92,220522
10644,0.001048,74.125.24.0-255,1484,154911,92,220522
10645,0.001092,172.31.47.0-255,66,154977,92,220522
10646,0.001106,74.125.24.0-255,2184,157161,92,220522
10647,0.001109,172.31.47.0-255,66,157227,92,220522
10648,0.001148,74.125.24.0-255,1484,158711,92,220522
10649,0.001153,74.125.24.0-255,2902,161613,92,220522
10650,0.001156,172.31.47.0-255,66,161679,92,220522
10651,0.001177,74.125.24.0-255,5738,167417,92,220522
10652,0.00118,172.31.47.0-255,66,167483,92,220522
10653,0.001209,172.31.47.0-255,66,167549,92,220522
10654,0.001215,74.125.24.0-255,5738,173287,92,220522
10655,0.001217,172.31.47.0-255,66,173353,92,220522
10656,0.001229,74.125.24.0-255,2902,176255,92,220522
10657,0.001231,172.31.47.0-255,66,176321,92,220522
10658,0.001246,74.125.24.0-255,1484,177805,92,220522
10659,0.001263,74.125.24.0-255,2184,179989,92,220522
10660,0.001267,172.31.47.0-255,66,180055,92,220522
10661,0.001267,74.125.24.0-255,4320,184375,92,220522
10662,0.00127,172.31.47.0-255,66,184441,92,220522
10663,0.001272,74.125.24.0-255,4320,188761,92,220522
10664,0.001274,172.31.47.0-255,66,188827,92,220522
10665,0.00129,74.125.24.0-255,5738,194565,92,220522
10666,0.001293,172.31.47.0-255,66,194631,92,220522
10667,0.001331,172.31.47.0-255,66,194697,92,220522
10668,0.001348,74.125.24.0-255,766,195463,92,220522
10669,0.001401,74.125.24.0-255,5738,201201,92,220522
10670,0.001451,74.125.24.0-255,4320,205521,92,220522
10671,0.001547,74.125.24.0-255,766,206287,92,220522
10672,0.001592,74.125.24.0-255,4859,211146,92,220522
10673,0.00163,74.125.24.0-255,105,211251,92,220522
10674,0.005681,172.31.47.0-255,66,211317,92,220522
10675,0.007526,172.31.47.0-255,105,211422,92,220522
10676,0.009765,74.125.24.0-255,66,211488,92,220522
10677,0.031664,172.31.47.0-255,172,211660,92,220522
10678,0.031689,172.31.47.0-255,1112,212772,92,220522
10679,0.031735,172.31.47.0-255,1514,214286,92,220522
10680,0.031736,172.31.47.0-255,1514,215800,92,220522
10681,0.031737,172.31.47.0-255,1514,217314,92,220522
10682,0.031738,172.31.47.0-255,1514,218828,92,220522
10683,0.031739,172.31.47.0-255,1496,220324,92,220522
10684,0.033157,104.244.42.0-255,66,220390,92,220522
10685,0.033172,104.244.42.0-255,66,220456,92,220522
10686,0.033266,104.244.42.0-255,66,220522,92,220522
10687,0.0,172.217.194.0-255,153,153,92,274900
10688,1.4e-05,172.31.47.0-255,66,219,92,274900
10689,2e-05,172.217.194.0-255,1484,1703,92,274900
10690,2.4e-05,172.31.47.0-255,66,1769,92,274900
10691,2.9e-05,172.217.194.0-255,2902,4671,92,274900
10692,3.7e-05,172.31.47.0-255,66,4737,92,274900
10693,4.3e-05,172.217.194.0-255,5738,10475,92,274900
10694,4.5e-05,172.31.47.0-255,66,10541,92,274900
10695,9.1e-05,172.217.194.0-255,3585,14126,92,274900
10696,9.4e-05,172.31.47.0-255,66,14192,92,274900
10697,0.000158,172.217.194.0-255,1484,15676,92,274900
10698,0.000162,172.31.47.0-255,66,15742,92,274900
10699,0.000173,172.217.194.0-255,2902,18644,92,274900
10700,0.000179,172.31.47.0-255,66,18710,92,274900
10701,0.000182,172.217.194.0-255,2902,21612,92,274900
10702,0.000184,172.31.47.0-255,66,21678,92,274900
10703,0.000204,172.217.194.0-255,2902,24580,92,274900
10704,0.000206,172.31.47.0-255,66,24646,92,274900
10705,0.000217,172.217.194.0-255,6797,31443,92,274900
10706,0.000219,172.31.47.0-255,66,31509,92,274900
10707,0.000238,172.217.194.0-255,2902,34411,92,274900
10708,0.00024,172.31.47.0-255,66,34477,92,274900
10709,0.000273,172.217.194.0-255,2902,37379,92,274900
10710,0.000275,172.31.47.0-255,66,37445,92,274900
10711,0.000282,172.217.194.0-255,7156,44601,92,274900
10712,0.000283,172.31.47.0-255,66,44667,92,274900
10713,0.000287,172.217.194.0-255,3961,48628,92,274900
10714,0.000289,172.31.47.0-255,66,48694,92,274900
10715,0.00056,172.217.194.0-255,1484,50178,92,274900
10716,0.000564,172.31.47.0-255,66,50244,92,274900
10717,0.000569,172.217.194.0-255,2902,53146,92,274900
10718,0.000571,172.31.47.0-255,66,53212,92,274900
10719,0.000574,172.217.194.0-255,1484,54696,92,274900
10720,0.000595,172.217.194.0-255,4320,59016,92,274900
10721,0.000603,172.217.194.0-255,6797,65813,92,274900
10722,0.000607,172.31.47.0-255,66,65879,92,274900
10723,0.000614,172.31.47.0-255,66,65945,92,274900
10724,0.000616,172.217.194.0-255,1484,67429,92,274900
10725,0.000647,172.31.47.0-255,66,67495,92,274900
10726,0.000662,172.31.47.0-255,66,67561,92,274900
10727,0.000681,172.217.194.0-255,5738,73299,92,274900
10728,0.000686,172.31.47.0-255,66,73365,92,274900
10729,0.000702,172.217.194.0-255,1377,74742,92,274900
10730,0.00079,172.217.194.0-255,1484,76226,92,274900
10731,0.000793,172.31.47.0-255,66,76292,92,274900
10732,0.000797,172.217.194.0-255,2902,79194,92,274900
10733,0.000799,172.31.47.0-255,66,79260,92,274900
10734,0.000834,172.217.194.0-255,5738,84998,92,274900
10735,0.000836,172.31.47.0-255,66,85064,92,274900
10736,0.000867,172.31.47.0-255,66,85130,92,274900
10737,0.000897,172.217.194.0-255,4320,89450,92,274900
10738,0.0009,172.31.47.0-255,66,89516,92,274900
10739,0.000914,172.31.47.0-255,66,89582,92,274900
10740,0.000939,172.217.194.0-255,1484,91066,92,274900
10741,0.000942,172.217.194.0-255,2902,93968,92,274900
10742,0.000944,172.31.47.0-255,66,94034,92,274900
10743,0.00095,172.217.194.0-255,5738,99772,92,274900
10744,0.000952,172.31.47.0-255,66,99838,92,274900
10745,0.000974,172.217.194.0-255,5738,105576,92,274900
10746,0.000976,172.31.47.0-255,66,105642,92,274900
10747,0.001026,172.31.47.0-255,66,105708,92,274900
10748,0.001031,172.217.194.0-255,5020,110728,92,274900
10749,0.001034,172.31.47.0-255,66,110794,92,274900
10750,0.001179,172.217.194.0-255,1484,112278,92,274900
10751,0.001194,172.217.194.0-255,2902,115180,92,274900
10752,0.001198,172.31.47.0-255,66,115246,92,274900
10753,0.001258,172.217.194.0-255,5738,120984,92,274900
10754,0.001261,172.31.47.0-255,66,121050,92,274900
10755,0.001266,172.217.194.0-255,4320,125370,92,274900
10756,0.001268,172.31.47.0-255,66,125436,92,274900
10757,0.001281,172.31.47.0-255,66,125502,92,274900
10758,0.001289,172.31.47.0-255,66,125568,92,274900
10759,0.001328,172.217.194.0-255,1484,127052,92,274900
10760,0.001347,172.217.194.0-255,2902,129954,92,274900
10761,0.00135,172.31.47.0-255,66,130020,92,274900
10762,0.001355,172.217.194.0-255,5738,135758,92,274900
10763,0.001358,172.31.47.0-255,66,135824,92,274900
10764,0.001374,172.217.194.0-255,2902,138726,92,274900
10765,0.001376,172.31.47.0-255,66,138792,92,274900
10766,0.001418,172.217.194.0-255,4320,143112,92,274900
10767,0.001422,172.31.47.0-255,66,143178,92,274900
10768,0.001431,172.31.47.0-255,66,143244,92,274900
10769,0.00144,172.31.47.0-255,66,143310,92,274900
10770,0.001474,172.217.194.0-255,1484,144794,92,274900
10771,0.001488,172.217.194.0-255,2902,147696,92,274900
10772,0.001491,172.31.47.0-255,66,147762,92,274900
10773,0.001495,172.217.194.0-255,2902,150664,92,274900
10774,0.001497,172.31.47.0-255,66,150730,92,274900
10775,0.001515,172.217.194.0-255,2902,153632,92,274900
10776,0.001518,172.31.47.0-255,66,153698,92,274900
10777,0.001525,172.217.194.0-255,2902,156600,92,274900
10778,0.001527,172.31.47.0-255,66,156666,92,274900
10779,0.001563,172.31.47.0-255,66,156732,92,274900
10780,0.001573,172.31.47.0-255,66,156798,92,274900
10781,0.001593,172.217.194.0-255,5020,161818,92,274900
10782,0.001595,172.31.47.0-255,66,161884,92,274900
10783,0.001604,172.31.47.0-255,66,161950,92,274900
10784,0.001644,172.217.194.0-255,4320,166270,92,274900
10785,0.001647,172.31.47.0-255,66,166336,92,274900
10786,0.001688,172.31.47.0-255,66,166402,92,274900
10787,0.001691,172.217.194.0-255,1484,167886,92,274900
10788,0.001712,172.217.194.0-255,2902,170788,92,274900
10789,0.001715,172.31.47.0-255,66,170854,92,274900
10790,0.00172,172.217.194.0-255,5738,176592,92,274900
10791,0.001722,172.31.47.0-255,66,176658,92,274900
10792,0.001752,172.217.194.0-255,4320,180978,92,274900
10793,0.001754,172.31.47.0-255,66,181044,92,274900
10794,0.001777,172.31.47.0-255,66,181110,92,274900
10795,0.001782,172.217.194.0-255,4320,185430,92,274900
10796,0.001783,172.31.47.0-255,66,185496,92,274900
10797,0.001813,172.217.194.0-255,6438,191934,92,274900
10798,0.001815,172.31.47.0-255,66,192000,92,274900
10799,0.00184,172.217.194.0-255,1484,193484,92,274900
10800,0.001854,172.217.194.0-255,2902,196386,92,274900
10801,0.001856,172.31.47.0-255,66,196452,92,274900
10802,0.001859,172.217.194.0-255,1484,197936,92,274900
10803,0.00188,172.217.194.0-255,4320,202256,92,274900
10804,0.001882,172.31.47.0-255,66,202322,92,274900
10805,0.001886,172.217.194.0-255,4320,206642,92,274900
10806,0.001888,172.31.47.0-255,66,206708,92,274900
10807,0.001902,172.217.194.0-255,1484,208192,92,274900
10808,0.001927,172.31.47.0-255,66,208258,92,274900
10809,0.001972,172.217.194.0-255,2902,211160,92,274900
10810,0.001974,172.31.47.0-255,66,211226,92,274900
10811,0.002,172.217.194.0-255,5020,216246,92,274900
10812,0.002002,172.31.47.0-255,66,216312,92,274900
10813,0.002005,172.217.194.0-255,1484,217796,92,274900
10814,0.002007,172.217.194.0-255,1484,219280,92,274900
10815,0.002009,172.31.47.0-255,66,219346,92,274900
10816,0.002035,172.217.194.0-255,1484,220830,92,274900
10817,0.00204,172.217.194.0-255,5738,226568,92,274900
10818,0.002042,172.31.47.0-255,66,226634,92,274900
10819,0.002047,172.217.194.0-255,4320,230954,92,274900
10820,0.002049,172.31.47.0-255,66,231020,92,274900
10821,0.002071,172.217.194.0-255,1484,232504,92,274900
10822,0.00209,172.217.194.0-255,2902,235406,92,274900
10823,0.002093,172.31.47.0-255,66,235472,92,274900
10824,0.002115,172.217.194.0-255,5738,241210,92,274900
10825,0.002118,172.31.47.0-255,66,241276,92,274900
10826,0.002127,172.31.47.0-255,66,241342,92,274900
10827,0.002152,172.217.194.0-255,1484,242826,92,274900
10828,0.002169,172.217.194.0-255,2902,245728,92,274900
10829,0.002172,172.31.47.0-255,66,245794,92,274900
10830,0.002176,172.217.194.0-255,4320,250114,92,274900
10831,0.002178,172.31.47.0-255,66,250180,92,274900
10832,0.002181,172.217.194.0-255,1484,251664,92,274900
10833,0.002203,172.217.194.0-255,2902,254566,92,274900
10834,0.002205,172.31.47.0-255,66,254632,92,274900
10835,0.002228,172.217.194.0-255,1484,256116,92,274900
10836,0.00223,172.217.194.0-255,1484,257600,92,274900
10837,0.002232,172.31.47.0-255,66,257666,92,274900
10838,0.002244,172.217.194.0-255,4320,261986,92,274900
10839,0.002247,172.31.47.0-255,66,262052,92,274900
10840,0.002259,172.217.194.0-255,3234,265286,92,274900
10841,0.002265,172.31.47.0-255,66,265352,92,274900
10842,0.002311,172.217.194.0-255,105,265457,92,274900
10843,0.007825,172.31.47.0-255,66,265523,92,274900
10844,0.007861,172.31.47.0-255,105,265628,92,274900
10845,0.00984,172.217.194.0-255,66,265694,92,274900
10846,0.035251,172.31.47.0-255,172,265866,92,274900
10847,0.035279,172.31.47.0-255,1111,266977,92,274900
10848,0.035334,172.31.47.0-255,1514,268491,92,274900
10849,0.035336,172.31.47.0-255,1514,270005,92,274900
10850,0.035337,172.31.47.0-255,1514,271519,92,274900
10851,0.035338,172.31.47.0-255,1514,273033,92,274900
10852,0.035339,172.31.47.0-255,1495,274528,92,274900
10853,0.036795,104.244.42.0-255,66,274594,92,274900
10854,0.036822,104.244.42.0-255,66,274660,92,274900
10855,0.036921,104.244.42.0-255,66,274726,92,274900
10856,0.037568,104.244.42.0-255,108,274834,92,274900
10857,0.037574,172.31.47.0-255,66,274900,92,274900
10858,0.0,74.125.24.0-255,153,153,92,211410
10859,3.3e-05,172.31.47.0-255,66,219,92,211410
10860,4e-05,74.125.24.0-255,1484,1703,92,211410
10861,4.5e-05,172.31.47.0-255,66,1769,92,211410
10862,5e-05,74.125.24.0-255,2902,4671,92,211410
10863,6e-05,172.31.47.0-255,66,4737,92,211410
10864,6.6e-05,74.125.24.0-255,4320,9057,92,211410
10865,6.9e-05,172.31.47.0-255,66,9123,92,211410
10866,9e-05,74.125.24.0-255,2902,12025,92,211410
10867,9.3e-05,172.31.47.0-255,66,12091,92,211410
10868,0.000117,74.125.24.0-255,2137,14228,92,211410
10869,0.00012,172.31.47.0-255,66,14294,92,211410
10870,0.000372,74.125.24.0-255,1484,15778,92,211410
10871,0.000377,172.31.47.0-255,66,15844,92,211410
10872,0.000381,74.125.24.0-255,1484,17328,92,211410
10873,0.000383,172.31.47.0-255,66,17394,92,211410
10874,0.000417,74.125.24.0-255,1484,18878,92,211410
10875,0.000428,74.125.24.0-255,5738,24616,92,211410
10876,0.000423,172.31.47.0-255,66,24682,92,211410
10877,0.000431,172.31.47.0-255,66,24748,92,211410
10878,0.000447,74.125.24.0-255,4320,29068,92,211410
10879,0.00045,172.31.47.0-255,66,29134,92,211410
10880,0.000472,74.125.24.0-255,2543,31677,92,211410
10881,0.000475,172.31.47.0-255,66,31743,92,211410
10882,0.000489,74.125.24.0-255,4320,36063,92,211410
10883,0.000497,172.31.47.0-255,66,36129,92,211410
10884,0.000521,74.125.24.0-255,2902,39031,92,211410
10885,0.000524,172.31.47.0-255,66,39097,92,211410
10886,0.000527,74.125.24.0-255,1484,40581,92,211410
10887,0.000529,172.31.47.0-255,66,40647,92,211410
10888,0.000558,172.31.47.0-255,66,40713,92,211410
10889,0.002689,74.125.24.0-255,5738,46451,92,211410
10890,0.002696,172.31.47.0-255,66,46517,92,211410
10891,0.004752,74.125.24.0-255,5738,52255,92,211410
10892,0.004756,172.31.47.0-255,66,52321,92,211410
10893,0.006803,74.125.24.0-255,5738,58059,92,211410
10894,0.00681,172.31.47.0-255,66,58125,92,211410
10895,0.008884,74.125.24.0-255,5738,63863,92,211410
10896,0.008893,172.31.47.0-255,66,63929,92,211410
10897,0.010974,74.125.24.0-255,5738,69667,92,211410
10898,0.010982,172.31.47.0-255,66,69733,92,211410
10899,0.013062,74.125.24.0-255,5738,75471,92,211410
10900,0.013078,172.31.47.0-255,66,75537,92,211410
10901,0.015168,74.125.24.0-255,5738,81275,92,211410
10902,0.015176,172.31.47.0-255,66,81341,92,211410
10903,0.017259,74.125.24.0-255,5738,87079,92,211410
10904,0.017266,172.31.47.0-255,66,87145,92,211410
10905,0.019342,74.125.24.0-255,5738,92883,92,211410
10906,0.019349,172.31.47.0-255,66,92949,92,211410
10907,0.021447,74.125.24.0-255,5738,98687,92,211410
10908,0.021455,172.31.47.0-255,66,98753,92,211410
10909,0.023501,74.125.24.0-255,5738,104491,92,211410
10910,0.023508,172.31.47.0-255,66,104557,92,211410
10911,0.025588,74.125.24.0-255,5738,110295,92,211410
10912,0.025595,172.31.47.0-255,66,110361,92,211410
10913,0.027497,172.31.47.0-255,172,110533,92,211410
10914,0.027526,172.31.47.0-255,1103,111636,92,211410
10915,0.027575,172.31.47.0-255,1514,113150,92,211410
10916,0.027577,172.31.47.0-255,1514,114664,92,211410
10917,0.027578,172.31.47.0-255,1514,116178,92,211410
10918,0.027579,172.31.47.0-255,1514,117692,92,211410
10919,0.027603,172.31.47.0-255,1504,119196,92,211410
10920,0.027643,74.125.24.0-255,5738,124934,92,211410
10921,0.027647,172.31.47.0-255,66,125000,92,211410
10922,0.02905,104.244.42.0-255,66,125066,92,211410
10923,0.029086,104.244.42.0-255,66,125132,92,211410
10924,0.029133,104.244.42.0-255,66,125198,92,211410
10925,0.029677,74.125.24.0-255,2902,128100,92,211410
10926,0.029681,172.31.47.0-255,66,128166,92,211410
10927,0.029721,74.125.24.0-255,2902,131068,92,211410
10928,0.029725,172.31.47.0-255,66,131134,92,211410
10929,0.029765,104.244.42.0-255,108,131242,92,211410
10930,0.029769,172.31.47.0-255,66,131308,92,211410
10931,0.031745,74.125.24.0-255,2902,134210,92,211410
10932,0.031751,172.31.47.0-255,66,134276,92,211410
10933,0.031784,74.125.24.0-255,2902,137178,92,211410
10934,0.031787,172.31.47.0-255,66,137244,92,211410
10935,0.03382,74.125.24.0-255,5738,142982,92,211410
10936,0.033826,172.31.47.0-255,66,143048,92,211410
10937,0.035896,74.125.24.0-255,5738,148786,92,211410
10938,0.035901,172.31.47.0-255,66,148852,92,211410
10939,0.037946,74.125.24.0-255,5738,154590,92,211410
10940,0.037953,172.31.47.0-255,66,154656,92,211410
10941,0.039994,74.125.24.0-255,5738,160394,92,211410
10942,0.040001,172.31.47.0-255,66,160460,92,211410
10943,0.042058,74.125.24.0-255,5738,166198,92,211410
10944,0.042064,172.31.47.0-255,66,166264,92,211410
10945,0.044155,74.125.24.0-255,5738,172002,92,211410
10946,0.04416,172.31.47.0-255,66,172068,92,211410
10947,0.046245,74.125.24.0-255,5738,177806,92,211410
10948,0.046251,172.31.47.0-255,66,177872,92,211410
10949,0.048322,74.125.24.0-255,5738,183610,92,211410
10950,0.048327,172.31.47.0-255,66,183676,92,211410
10951,0.05039,74.125.24.0-255,5738,189414,92,211410
10952,0.050396,172.31.47.0-255,66,189480,92,211410
10953,0.052474,74.125.24.0-255,5738,195218,92,211410
10954,0.052479,172.31.47.0-255,66,195284,92,211410
10955,0.054542,74.125.24.0-255,5738,201022,92,211410
10956,0.054548,172.31.47.0-255,66,201088,92,211410
10957,0.056599,74.125.24.0-255,4320,205408,92,211410
10958,0.056604,172.31.47.0-255,66,205474,92,211410
10959,0.056638,74.125.24.0-255,1484,206958,92,211410
10960,0.058647,74.125.24.0-255,2902,209860,92,211410
10961,0.058652,172.31.47.0-255,66,209926,92,211410
10962,0.058687,74.125.24.0-255,1484,211410,92,211410
10963,0.0,172.217.194.0-255,153,153,92,252270
10964,3e-05,172.31.47.0-255,66,219,92,252270
10965,3.7e-05,172.217.194.0-255,1484,1703,92,252270
10966,4.1e-05,172.31.47.0-255,66,1769,92,252270
10967,4.6e-05,172.217.194.0-255,2902,4671,92,252270
10968,4.8e-05,172.31.47.0-255,66,4737,92,252270
10969,6.3e-05,172.217.194.0-255,7156,11893,92,252270
10970,6.5e-05,172.31.47.0-255,66,11959,92,252270
10971,7.7e-05,172.31.47.0-255,66,12025,92,252270
10972,0.00012,172.31.47.0-255,66,12091,92,252270
10973,0.000157,172.217.194.0-255,7156,19247,92,252270
10974,0.00016,172.31.47.0-255,66,19313,92,252270
10975,0.000188,172.31.47.0-255,66,19379,92,252270
10976,0.000191,172.217.194.0-255,1125,20504,92,252270
10977,0.000193,172.31.47.0-255,66,20570,92,252270
10978,0.000268,172.217.194.0-255,1484,22054,92,252270
10979,0.000272,172.31.47.0-255,66,22120,92,252270
10980,0.000275,172.217.194.0-255,1484,23604,92,252270
10981,0.000277,172.31.47.0-255,66,23670,92,252270
10982,0.000315,172.217.194.0-255,1484,25154,92,252270
10983,0.000318,172.31.47.0-255,66,25220,92,252270
10984,0.000325,172.217.194.0-255,5738,30958,92,252270
10985,0.000328,172.31.47.0-255,66,31024,92,252270
10986,0.000346,172.217.194.0-255,2902,33926,92,252270
10987,0.000349,172.31.47.0-255,66,33992,92,252270
10988,0.000361,172.217.194.0-255,3961,37953,92,252270
10989,0.000368,172.31.47.0-255,66,38019,92,252270
10990,0.000654,172.217.194.0-255,645,38664,92,252270
10991,0.000659,172.31.47.0-255,66,38730,92,252270
10992,0.001134,172.217.194.0-255,1484,40214,92,252270
10993,0.001139,172.31.47.0-255,66,40280,92,252270
10994,0.001148,172.217.194.0-255,2902,43182,92,252270
10995,0.001151,172.31.47.0-255,66,43248,92,252270
10996,0.001165,172.217.194.0-255,5738,48986,92,252270
10997,0.001167,172.31.47.0-255,66,49052,92,252270
10998,0.001215,172.31.47.0-255,66,49118,92,252270
10999,0.001228,172.31.47.0-255,66,49184,92,252270
11000,0.001827,172.217.194.0-255,1484,50668,92,252270
11001,0.001834,172.31.47.0-255,66,50734,92,252270
11002,0.00184,172.217.194.0-255,2902,53636,92,252270
11003,0.001842,172.31.47.0-255,66,53702,92,252270
11004,0.001848,172.217.194.0-255,5738,59440,92,252270
11005,0.00185,172.31.47.0-255,66,59506,92,252270
11006,0.001854,172.217.194.0-255,2902,62408,92,252270
11007,0.001855,172.31.47.0-255,66,62474,92,252270
11008,0.001885,172.217.194.0-255,2902,65376,92,252270
11009,0.001887,172.31.47.0-255,66,65442,92,252270
11010,0.001904,172.31.47.0-255,66,65508,92,252270
11011,0.00191,172.217.194.0-255,4320,69828,92,252270
11012,0.001912,172.31.47.0-255,66,69894,92,252270
11013,0.001932,172.217.194.0-255,766,70660,92,252270
11014,0.001935,172.31.47.0-255,66,70726,92,252270
11015,0.002215,172.217.194.0-255,1484,72210,92,252270
11016,0.002217,172.31.47.0-255,66,72276,92,252270
11017,0.002243,172.217.194.0-255,2902,75178,92,252270
11018,0.002245,172.31.47.0-255,66,75244,92,252270
11019,0.002251,172.217.194.0-255,5738,80982,92,252270
11020,0.002253,172.31.47.0-255,66,81048,92,252270
11021,0.002291,172.217.194.0-255,5738,86786,92,252270
11022,0.002293,172.31.47.0-255,66,86852,92,252270
11023,0.002318,172.217.194.0-255,7156,94008,92,252270
11024,0.00232,172.31.47.0-255,66,94074,92,252270
11025,0.002331,172.31.47.0-255,66,94140,92,252270
11026,0.002336,172.217.194.0-255,5020,99160,92,252270
11027,0.002338,172.31.47.0-255,66,99226,92,252270
11028,0.004538,172.217.194.0-255,4320,103546,92,252270
11029,0.004541,172.31.47.0-255,66,103612,92,252270
11030,0.00456,172.217.194.0-255,1484,105096,92,252270
11031,0.004561,172.31.47.0-255,66,105162,92,252270
11032,0.00675,172.217.194.0-255,4320,109482,92,252270
11033,0.006755,172.31.47.0-255,66,109548,92,252270
11034,0.006781,172.217.194.0-255,1484,111032,92,252270
11035,0.006783,172.31.47.0-255,66,111098,92,252270
11036,0.009101,172.217.194.0-255,5738,116836,92,252270
11037,0.009114,172.31.47.0-255,66,116902,92,252270
11038,0.011348,172.217.194.0-255,5738,122640,92,252270
11039,0.011365,172.31.47.0-255,66,122706,92,252270
11040,0.013604,172.217.194.0-255,5738,128444,92,252270
11041,0.013618,172.31.47.0-255,66,128510,92,252270
11042,0.01584,172.217.194.0-255,5738,134248,92,252270
11043,0.015852,172.31.47.0-255,66,134314,92,252270
11044,0.018116,172.217.194.0-255,5738,140052,92,252270
11045,0.018133,172.31.47.0-255,66,140118,92,252270
11046,0.020332,172.217.194.0-255,5738,145856,92,252270
11047,0.020342,172.31.47.0-255,66,145922,92,252270
11048,0.022584,172.217.194.0-255,5738,151660,92,252270
11049,0.022606,172.31.47.0-255,66,151726,92,252270
11050,0.024826,172.217.194.0-255,5738,157464,92,252270
11051,0.024843,172.31.47.0-255,66,157530,92,252270
11052,0.027078,172.217.194.0-255,5738,163268,92,252270
11053,0.027094,172.31.47.0-255,66,163334,92,252270
11054,0.029326,172.217.194.0-255,5738,169072,92,252270
11055,0.029342,172.31.47.0-255,66,169138,92,252270
11056,0.031571,172.217.194.0-255,5738,174876,92,252270
11057,0.031583,172.31.47.0-255,66,174942,92,252270
11058,0.03385,172.217.194.0-255,5738,180680,92,252270
11059,0.033858,172.31.47.0-255,66,180746,92,252270
11060,0.034631,172.31.47.0-255,172,180918,92,252270
11061,0.034657,172.31.47.0-255,1111,182029,92,252270
11062,0.0347,172.31.47.0-255,1514,183543,92,252270
11063,0.034702,172.31.47.0-255,1514,185057,92,252270
11064,0.034703,172.31.47.0-255,1514,186571,92,252270
11065,0.034704,172.31.47.0-255,1514,188085,92,252270
11066,0.034705,172.31.47.0-255,1495,189580,92,252270
11067,0.036063,172.217.194.0-255,5738,195318,92,252270
11068,0.036069,172.31.47.0-255,66,195384,92,252270
11069,0.036187,104.244.42.0-255,66,195450,92,252270
11070,0.036212,104.244.42.0-255,66,195516,92,252270
11071,0.036291,104.244.42.0-255,66,195582,92,252270
11072,0.038286,172.217.194.0-255,5738,201320,92,252270
11073,0.038293,172.31.47.0-255,66,201386,92,252270
11074,0.040506,172.217.194.0-255,5738,207124,92,252270
11075,0.040513,172.31.47.0-255,66,207190,92,252270
11076,0.042732,172.217.194.0-255,4320,211510,92,252270
11077,0.042739,172.31.47.0-255,66,211576,92,252270
11078,0.042762,172.217.194.0-255,1484,213060,92,252270
11079,0.044966,172.217.194.0-255,4320,217380,92,252270
11080,0.044972,172.31.47.0-255,66,217446,92,252270
11081,0.047186,172.217.194.0-255,5738,223184,92,252270
11082,0.04723,172.31.47.0-255,66,223250,92,252270
11083,0.049447,172.217.194.0-255,5738,228988,92,252270
11084,0.049455,172.31.47.0-255,66,229054,92,252270
11085,0.051675,172.217.194.0-255,5738,234792,92,252270
11086,0.051681,172.31.47.0-255,66,234858,92,252270
11087,0.053878,172.217.194.0-255,5738,240596,92,252270
11088,0.053884,172.31.47.0-255,66,240662,92,252270
11089,0.056089,172.217.194.0-255,5738,246400,92,252270
11090,0.056094,172.31.47.0-255,66,246466,92,252270
11091,0.058352,172.217.194.0-255,5738,252204,92,252270
11092,0.058358,172.31.47.0-255,66,252270,92,252270
11093,0.0,74.125.24.0-255,153,153,92,227920
11094,3e-05,172.31.47.0-255,66,219,92,227920
11095,3.6e-05,74.125.24.0-255,1484,1703,92,227920
11096,4e-05,172.31.47.0-255,66,1769,92,227920
11097,4.5e-05,74.125.24.0-255,2902,4671,92,227920
11098,4.7e-05,172.31.47.0-255,66,4737,92,227920
11099,6e-05,74.125.24.0-255,7156,11893,92,227920
11100,6.2e-05,172.31.47.0-255,66,11959,92,227920
11101,6.5e-05,74.125.24.0-255,2256,14215,92,227920
11102,6.7e-05,172.31.47.0-255,66,14281,92,227920
11103,0.000105,172.31.47.0-255,66,14347,92,227920
11104,0.00011,74.125.24.0-255,5379,19726,92,227920
11105,0.000112,172.31.47.0-255,66,19792,92,227920
11106,0.000649,74.125.24.0-255,1484,21276,92,227920
11107,0.000655,172.31.47.0-255,66,21342,92,227920
11108,0.000686,74.125.24.0-255,2902,24244,92,227920
11109,0.000691,172.31.47.0-255,66,24310,92,227920
11110,0.000698,74.125.24.0-255,5738,30048,92,227920
11111,0.0007,172.31.47.0-255,66,30114,92,227920
11112,0.000703,74.125.24.0-255,1484,31598,92,227920
11113,0.000711,172.31.47.0-255,66,31664,92,227920
11114,0.000754,172.31.47.0-255,66,31730,92,227920
11115,0.000759,74.125.24.0-255,2902,34632,92,227920
11116,0.000761,172.31.47.0-255,66,34698,92,227920
11117,0.000797,172.31.47.0-255,66,34764,92,227920
11118,0.000986,74.125.24.0-255,646,35410,92,227920
11119,0.000992,172.31.47.0-255,66,35476,92,227920
11120,0.001017,74.125.24.0-255,1484,36960,92,227920
11121,0.00102,172.31.47.0-255,66,37026,92,227920
11122,0.001027,74.125.24.0-255,4320,41346,92,227920
11123,0.001031,172.31.47.0-255,66,41412,92,227920
11124,0.001077,172.31.47.0-255,66,41478,92,227920
11125,0.001112,74.125.24.0-255,5738,47216,92,227920
11126,0.001118,172.31.47.0-255,66,47282,92,227920
11127,0.001154,172.31.47.0-255,66,47348,92,227920
11128,0.001156,74.125.24.0-255,766,48114,92,227920
11129,0.002072,74.125.24.0-255,1484,49598,92,227920
11130,0.002074,172.31.47.0-255,66,49664,92,227920
11131,0.002079,74.125.24.0-255,2902,52566,92,227920
11132,0.002081,172.31.47.0-255,66,52632,92,227920
11133,0.002115,74.125.24.0-255,5738,58370,92,227920
11134,0.002118,172.31.47.0-255,66,58436,92,227920
11135,0.002131,172.31.47.0-255,66,58502,92,227920
11136,0.002164,74.125.24.0-255,2902,61404,92,227920
11137,0.002167,172.31.47.0-255,66,61470,92,227920
11138,0.002188,74.125.24.0-255,5738,67208,92,227920
11139,0.00219,172.31.47.0-255,66,67274,92,227920
11140,0.002205,172.31.47.0-255,66,67340,92,227920
11141,0.002229,74.125.24.0-255,6438,73778,92,227920
11142,0.002232,172.31.47.0-255,66,73844,92,227920
11143,0.002235,74.125.24.0-255,1484,75328,92,227920
11144,0.002265,172.31.47.0-255,66,75394,92,227920
11145,0.004564,74.125.24.0-255,2902,78296,92,227920
11146,0.004567,172.31.47.0-255,66,78362,92,227920
11147,0.004583,74.125.24.0-255,2902,81264,92,227920
11148,0.004585,172.31.47.0-255,66,81330,92,227920
11149,0.006872,74.125.24.0-255,4320,85650,92,227920
11150,0.006879,172.31.47.0-255,66,85716,92,227920
11151,0.006913,74.125.24.0-255,1484,87200,92,227920
11152,0.009146,74.125.24.0-255,4320,91520,92,227920
11153,0.009152,172.31.47.0-255,66,91586,92,227920
11154,0.011618,74.125.24.0-255,5738,97324,92,227920
11155,0.011626,172.31.47.0-255,66,97390,92,227920
11156,0.013931,74.125.24.0-255,5738,103128,92,227920
11157,0.013941,172.31.47.0-255,66,103194,92,227920
11158,0.016208,74.125.24.0-255,5738,108932,92,227920
11159,0.016219,172.31.47.0-255,66,108998,92,227920
11160,0.0185,74.125.24.0-255,5738,114736,92,227920
11161,0.018507,172.31.47.0-255,66,114802,92,227920
11162,0.020822,74.125.24.0-255,5738,120540,92,227920
11163,0.020828,172.31.47.0-255,66,120606,92,227920
11164,0.023099,74.125.24.0-255,5738,126344,92,227920
11165,0.023105,172.31.47.0-255,66,126410,92,227920
11166,0.025434,74.125.24.0-255,5738,132148,92,227920
11167,0.025441,172.31.47.0-255,66,132214,92,227920
11168,0.027383,172.31.47.0-255,172,132386,92,227920
11169,0.027418,172.31.47.0-255,1107,133493,92,227920
11170,0.02748,172.31.47.0-255,1514,135007,92,227920
11171,0.027481,172.31.47.0-255,1514,136521,92,227920
11172,0.027482,172.31.47.0-255,1514,138035,92,227920
11173,0.027483,172.31.47.0-255,1514,139549,92,227920
11174,0.027514,172.31.47.0-255,1499,141048,92,227920
11175,0.027733,74.125.24.0-255,5738,146786,92,227920
11176,0.027739,172.31.47.0-255,66,146852,92,227920
11177,0.028913,104.244.42.0-255,66,146918,92,227920
11178,0.028956,104.244.42.0-255,66,146984,92,227920
11179,0.029055,104.244.42.0-255,66,147050,92,227920
11180,0.029675,104.244.42.0-255,108,147158,92,227920
11181,0.029678,172.31.47.0-255,66,147224,92,227920
11182,0.030011,74.125.24.0-255,2902,150126,92,227920
11183,0.030015,172.31.47.0-255,66,150192,92,227920
11184,0.030042,74.125.24.0-255,2902,153094,92,227920
11185,0.030047,172.31.47.0-255,66,153160,92,227920
11186,0.032289,74.125.24.0-255,2902,156062,92,227920
11187,0.032294,172.31.47.0-255,66,156128,92,227920
11188,0.032323,74.125.24.0-255,2902,159030,92,227920
11189,0.032326,172.31.47.0-255,66,159096,92,227920
11190,0.034607,74.125.24.0-255,2902,161998,92,227920
11191,0.034613,172.31.47.0-255,66,162064,92,227920
11192,0.034636,74.125.24.0-255,2902,164966,92,227920
11193,0.034639,172.31.47.0-255,66,165032,92,227920
11194,0.03693,74.125.24.0-255,2902,167934,92,227920
11195,0.036939,172.31.47.0-255,66,168000,92,227920
11196,0.03697,74.125.24.0-255,2902,170902,92,227920
11197,0.036973,172.31.47.0-255,66,170968,92,227920
11198,0.039217,74.125.24.0-255,2902,173870,92,227920
11199,0.039223,172.31.47.0-255,66,173936,92,227920
11200,0.039255,74.125.24.0-255,2902,176838,92,227920
11201,0.039258,172.31.47.0-255,66,176904,92,227920
11202,0.041503,74.125.24.0-255,2902,179806,92,227920
11203,0.041508,172.31.47.0-255,66,179872,92,227920
11204,0.041535,74.125.24.0-255,2902,182774,92,227920
11205,0.041537,172.31.47.0-255,66,182840,92,227920
11206,0.043794,74.125.24.0-255,5738,188578,92,227920
11207,0.0438,172.31.47.0-255,66,188644,92,227920
11208,0.046067,74.125.24.0-255,4320,192964,92,227920
11209,0.046073,172.31.47.0-255,66,193030,92,227920
11210,0.046104,74.125.24.0-255,1484,194514,92,227920
11211,0.048366,74.125.24.0-255,4320,198834,92,227920
11212,0.048371,172.31.47.0-255,66,198900,92,227920
11213,0.050647,74.125.24.0-255,5738,204638,92,227920
11214,0.050652,172.31.47.0-255,66,204704,92,227920
11215,0.052932,74.125.24.0-255,5738,210442,92,227920
11216,0.052936,172.31.47.0-255,66,210508,92,227920
11217,0.055219,74.125.24.0-255,5738,216246,92,227920
11218,0.055224,172.31.47.0-255,66,216312,92,227920
11219,0.057489,74.125.24.0-255,5738,222050,92,227920
11220,0.057493,172.31.47.0-255,66,222116,92,227920
11221,0.059791,74.125.24.0-255,5738,227854,92,227920
11222,0.059796,172.31.47.0-255,66,227920,92,227920
11223,0.0,74.125.68.0-255,153,153,92,260757
11224,3.5e-05,172.31.47.0-255,66,219,92,260757
11225,4.2e-05,74.125.68.0-255,1484,1703,92,260757
11226,4.6e-05,172.31.47.0-255,66,1769,92,260757
11227,5.8e-05,74.125.68.0-255,2902,4671,92,260757
11228,6.1e-05,172.31.47.0-255,66,4737,92,260757
11229,6.7e-05,74.125.68.0-255,4320,9057,92,260757
11230,6.9e-05,172.31.47.0-255,66,9123,92,260757
11231,9.1e-05,74.125.68.0-255,2902,12025,92,260757
11232,9.4e-05,172.31.47.0-255,66,12091,92,260757
11233,0.000116,74.125.68.0-255,2217,14308,92,260757
11234,0.000119,172.31.47.0-255,66,14374,92,260757
11235,0.000121,74.125.68.0-255,1484,15858,92,260757
11236,0.000123,172.31.47.0-255,66,15924,92,260757
11237,0.00015,74.125.68.0-255,2902,18826,92,260757
11238,0.000154,172.31.47.0-255,66,18892,92,260757
11239,0.000158,74.125.68.0-255,1484,20376,92,260757
11240,0.00016,172.31.47.0-255,66,20442,92,260757
11241,0.00019,74.125.68.0-255,2902,23344,92,260757
11242,0.000193,172.31.47.0-255,66,23410,92,260757
11243,0.0002,74.125.68.0-255,5738,29148,92,260757
11244,0.000201,172.31.47.0-255,66,29214,92,260757
11245,0.000206,74.125.68.0-255,2543,31757,92,260757
11246,0.000208,172.31.47.0-255,66,31823,92,260757
11247,0.000495,74.125.68.0-255,1484,33307,92,260757
11248,0.000505,172.31.47.0-255,66,33373,92,260757
11249,0.00051,74.125.68.0-255,2902,36275,92,260757
11250,0.000512,172.31.47.0-255,66,36341,92,260757
11251,0.000516,74.125.68.0-255,1484,37825,92,260757
11252,0.000524,172.31.47.0-255,66,37891,92,260757
11253,0.000547,74.125.68.0-255,2902,40793,92,260757
11254,0.00055,172.31.47.0-255,66,40859,92,260757
11255,0.000586,74.125.68.0-255,2902,43761,92,260757
11256,0.000587,172.31.47.0-255,66,43827,92,260757
11257,0.000591,172.31.47.0-255,66,43893,92,260757
11258,0.000636,74.125.68.0-255,2902,46795,92,260757
11259,0.00064,172.31.47.0-255,66,46861,92,260757
11260,0.000682,172.31.47.0-255,66,46927,92,260757
11261,0.000704,74.125.68.0-255,134,47061,92,260757
11262,0.000816,172.31.47.0-255,66,47127,92,260757
11263,0.000817,74.125.68.0-255,1484,48611,92,260757
11264,0.000833,74.125.68.0-255,1484,50095,92,260757
11265,0.000836,172.31.47.0-255,66,50161,92,260757
11266,0.000861,74.125.68.0-255,2902,53063,92,260757
11267,0.000864,172.31.47.0-255,66,53129,92,260757
11268,0.00087,74.125.68.0-255,2902,56031,92,260757
11269,0.000873,172.31.47.0-255,66,56097,92,260757
11270,0.000903,74.125.68.0-255,4320,60417,92,260757
11271,0.000906,172.31.47.0-255,66,60483,92,260757
11272,0.000911,74.125.68.0-255,2902,63385,92,260757
11273,0.000913,172.31.47.0-255,66,63451,92,260757
11274,0.000936,74.125.68.0-255,5738,69189,92,260757
11275,0.000945,172.31.47.0-255,66,69255,92,260757
11276,0.000949,74.125.68.0-255,2902,72157,92,260757
11277,0.000951,172.31.47.0-255,66,72223,92,260757
11278,0.000955,74.125.68.0-255,2902,75125,92,260757
11279,0.00096,172.31.47.0-255,66,75191,92,260757
11280,0.000979,74.125.68.0-255,1484,76675,92,260757
11281,0.001006,74.125.68.0-255,4320,80995,92,260757
11282,0.001009,172.31.47.0-255,66,81061,92,260757
11283,0.001034,74.125.68.0-255,766,81827,92,260757
11284,0.001139,172.31.47.0-255,66,81893,92,260757
11285,0.002124,74.125.68.0-255,344,82237,92,260757
11286,0.002149,74.125.68.0-255,1484,83721,92,260757
11287,0.002154,172.31.47.0-255,66,83787,92,260757
11288,0.002177,74.125.68.0-255,4320,88107,92,260757
11289,0.00218,172.31.47.0-255,66,88173,92,260757
11290,0.002205,74.125.68.0-255,1484,89657,92,260757
11291,0.002209,74.125.68.0-255,2902,92559,92,260757
11292,0.002211,172.31.47.0-255,66,92625,92,260757
11293,0.002243,74.125.68.0-255,1484,94109,92,260757
11294,0.002255,74.125.68.0-255,2902,97011,92,260757
11295,0.002257,172.31.47.0-255,66,97077,92,260757
11296,0.002279,74.125.68.0-255,1484,98561,92,260757
11297,0.002286,74.125.68.0-255,7156,105717,92,260757
11298,0.002289,172.31.47.0-255,66,105783,92,260757
11299,0.002294,74.125.68.0-255,4320,110103,92,260757
11300,0.002295,172.31.47.0-255,66,110169,92,260757
11301,0.002321,74.125.68.0-255,4320,114489,92,260757
11302,0.002323,172.31.47.0-255,66,114555,92,260757
11303,0.002349,74.125.68.0-255,2184,116739,92,260757
11304,0.002352,172.31.47.0-255,66,116805,92,260757
11305,0.004642,74.125.68.0-255,2902,119707,92,260757
11306,0.004645,172.31.47.0-255,66,119773,92,260757
11307,0.004672,74.125.68.0-255,1484,121257,92,260757
11308,0.004687,74.125.68.0-255,1484,122741,92,260757
11309,0.004689,172.31.47.0-255,66,122807,92,260757
11310,0.006965,74.125.68.0-255,2902,125709,92,260757
11311,0.006971,172.31.47.0-255,66,125775,92,260757
11312,0.007002,74.125.68.0-255,2902,128677,92,260757
11313,0.007006,172.31.47.0-255,66,128743,92,260757
11314,0.009293,74.125.68.0-255,2902,131645,92,260757
11315,0.009299,172.31.47.0-255,66,131711,92,260757
11316,0.009323,74.125.68.0-255,1484,133195,92,260757
11317,0.009334,74.125.68.0-255,1484,134679,92,260757
11318,0.009336,172.31.47.0-255,66,134745,92,260757
11319,0.01166,74.125.68.0-255,5738,140483,92,260757
11320,0.011678,172.31.47.0-255,66,140549,92,260757
11321,0.01407,74.125.68.0-255,5738,146287,92,260757
11322,0.014079,172.31.47.0-255,66,146353,92,260757
11323,0.016405,74.125.68.0-255,4320,150673,92,260757
11324,0.016413,172.31.47.0-255,66,150739,92,260757
11325,0.016447,74.125.68.0-255,1484,152223,92,260757
11326,0.018751,74.125.68.0-255,4320,156543,92,260757
11327,0.018762,172.31.47.0-255,66,156609,92,260757
11328,0.021097,74.125.68.0-255,5738,162347,92,260757
11329,0.021103,172.31.47.0-255,66,162413,92,260757
11330,0.02345,74.125.68.0-255,5738,168151,92,260757
11331,0.02346,172.31.47.0-255,66,168217,92,260757
11332,0.025797,74.125.68.0-255,5738,173955,92,260757
11333,0.025806,172.31.47.0-255,66,174021,92,260757
11334,0.027081,172.31.47.0-255,172,174193,92,260757
11335,0.02711,172.31.47.0-255,1111,175304,92,260757
11336,0.027153,172.31.47.0-255,1514,176818,92,260757
11337,0.027173,172.31.47.0-255,1514,178332,92,260757
11338,0.027175,172.31.47.0-255,1514,179846,92,260757
11339,0.027195,172.31.47.0-255,1514,181360,92,260757
11340,0.027196,172.31.47.0-255,1495,182855,92,260757
11341,0.028145,74.125.68.0-255,5738,188593,92,260757
11342,0.028151,172.31.47.0-255,66,188659,92,260757
11343,0.028617,104.244.42.0-255,66,188725,92,260757
11344,0.028624,104.244.42.0-255,66,188791,92,260757
11345,0.028688,104.244.42.0-255,66,188857,92,260757
11346,0.028692,104.244.42.0-255,66,188923,92,260757
11347,0.02874,104.244.42.0-255,66,188989,92,260757
11348,0.029714,104.244.42.0-255,108,189097,92,260757
11349,0.029718,172.31.47.0-255,66,189163,92,260757
11350,0.030467,74.125.68.0-255,1484,190647,92,260757
11351,0.030497,74.125.68.0-255,4320,194967,92,260757
11352,0.030501,172.31.47.0-255,66,195033,92,260757
11353,0.032823,74.125.68.0-255,5738,200771,92,260757
11354,0.032828,172.31.47.0-255,66,200837,92,260757
11355,0.035153,74.125.68.0-255,5738,206575,92,260757
11356,0.035158,172.31.47.0-255,66,206641,92,260757
11357,0.037487,74.125.68.0-255,5738,212379,92,260757
11358,0.037492,172.31.47.0-255,66,212445,92,260757
11359,0.039814,74.125.68.0-255,4320,216765,92,260757
11360,0.039819,172.31.47.0-255,66,216831,92,260757
11361,0.039849,74.125.68.0-255,1484,218315,92,260757
11362,0.042136,74.125.68.0-255,4320,222635,92,260757
11363,0.042142,172.31.47.0-255,66,222701,92,260757
11364,0.044466,74.125.68.0-255,4320,227021,92,260757
11365,0.044471,172.31.47.0-255,66,227087,92,260757
11366,0.044499,74.125.68.0-255,1484,228571,92,260757
11367,0.046819,74.125.68.0-255,4320,232891,92,260757
11368,0.046825,172.31.47.0-255,66,232957,92,260757
11369,0.049154,74.125.68.0-255,5738,238695,92,260757
11370,0.04916,172.31.47.0-255,66,238761,92,260757
11371,0.051488,74.125.68.0-255,4320,243081,92,260757
11372,0.051494,172.31.47.0-255,66,243147,92,260757
11373,0.051528,74.125.68.0-255,1484,244631,92,260757
11374,0.053815,74.125.68.0-255,4320,248951,92,260757
11375,0.053821,172.31.47.0-255,66,249017,92,260757
11376,0.056143,74.125.68.0-255,5738,254755,92,260757
11377,0.056148,172.31.47.0-255,66,254821,92,260757
11378,0.058476,74.125.68.0-255,2902,257723,92,260757
11379,0.058481,172.31.47.0-255,66,257789,92,260757
11380,0.058514,74.125.68.0-255,2902,260691,92,260757
11381,0.058517,172.31.47.0-255,66,260757,92,260757
11382,0.0,74.125.68.0-255,153,153,92,359767
11383,1.3e-05,172.31.47.0-255,66,219,92,359767
11384,1.9e-05,74.125.68.0-255,1484,1703,92,359767
11385,2.3e-05,172.31.47.0-255,66,1769,92,359767
11386,4.3e-05,74.125.68.0-255,2902,4671,92,359767
11387,4.9e-05,172.31.47.0-255,66,4737,92,359767
11388,7e-05,74.125.68.0-255,7156,11893,92,359767
11389,7.2e-05,172.31.47.0-255,66,11959,92,359767
11390,7.6e-05,74.125.68.0-255,2170,14129,92,359767
11391,7.9e-05,172.31.47.0-255,66,14195,92,359767
11392,0.000245,74.125.68.0-255,1484,15679,92,359767
11393,0.000249,172.31.47.0-255,66,15745,92,359767
11394,0.000254,74.125.68.0-255,1484,17229,92,359767
11395,0.000256,172.31.47.0-255,66,17295,92,359767
11396,0.000271,74.125.68.0-255,1484,18779,92,359767
11397,0.000273,172.31.47.0-255,66,18845,92,359767
11398,0.000278,74.125.68.0-255,4320,23165,92,359767
11399,0.00028,172.31.47.0-255,66,23231,92,359767
11400,0.000323,74.125.68.0-255,5738,28969,92,359767
11401,0.000326,172.31.47.0-255,66,29035,92,359767
11402,0.000351,74.125.68.0-255,2543,31578,92,359767
11403,0.000353,172.31.47.0-255,66,31644,92,359767
11404,0.000363,172.31.47.0-255,66,31710,92,359767
11405,0.00037,74.125.68.0-255,1484,33194,92,359767
11406,0.000371,172.31.47.0-255,66,33260,92,359767
11407,0.000398,74.125.68.0-255,6797,40057,92,359767
11408,0.000403,172.31.47.0-255,66,40123,92,359767
11409,0.001072,74.125.68.0-255,1484,41607,92,359767
11410,0.001079,172.31.47.0-255,66,41673,92,359767
11411,0.001088,74.125.68.0-255,2902,44575,92,359767
11412,0.00109,172.31.47.0-255,66,44641,92,359767
11413,0.001103,74.125.68.0-255,5738,50379,92,359767
11414,0.001105,172.31.47.0-255,66,50445,92,359767
11415,0.001138,74.125.68.0-255,6797,57242,92,359767
11416,0.00114,172.31.47.0-255,66,57308,92,359767
11417,0.001144,74.125.68.0-255,1484,58792,92,359767
11418,0.001172,74.125.68.0-255,5738,64530,92,359767
11419,0.001174,172.31.47.0-255,66,64596,92,359767
11420,0.001185,172.31.47.0-255,66,64662,92,359767
11421,0.001233,74.125.68.0-255,4320,68982,92,359767
11422,0.001236,172.31.47.0-255,66,69048,92,359767
11423,0.001262,74.125.68.0-255,1704,70752,92,359767
11424,0.001264,172.31.47.0-255,66,70818,92,359767
11425,0.001273,74.125.68.0-255,7156,77974,92,359767
11426,0.001279,172.31.47.0-255,66,78040,92,359767
11427,0.001305,74.125.68.0-255,5379,83419,92,359767
11428,0.001308,172.31.47.0-255,66,83485,92,359767
11429,0.001378,74.125.68.0-255,1484,84969,92,359767
11430,0.001395,74.125.68.0-255,2902,87871,92,359767
11431,0.001399,172.31.47.0-255,66,87937,92,359767
11432,0.001448,74.125.68.0-255,5738,93675,92,359767
11433,0.001451,172.31.47.0-255,66,93741,92,359767
11434,0.001457,74.125.68.0-255,5738,99479,92,359767
11435,0.001459,172.31.47.0-255,66,99545,92,359767
11436,0.001471,74.125.68.0-255,7156,106701,92,359767
11437,0.001474,172.31.47.0-255,66,106767,92,359767
11438,0.001477,74.125.68.0-255,1484,108251,92,359767
11439,0.001522,172.31.47.0-255,66,108317,92,359767
11440,0.001547,74.125.68.0-255,1484,109801,92,359767
11441,0.001552,74.125.68.0-255,2902,112703,92,359767
11442,0.001555,172.31.47.0-255,66,112769,92,359767
11443,0.001561,74.125.68.0-255,5738,118507,92,359767
11444,0.001563,172.31.47.0-255,66,118573,92,359767
11445,0.00159,74.125.68.0-255,7156,125729,92,359767
11446,0.001593,172.31.47.0-255,66,125795,92,359767
11447,0.001598,74.125.68.0-255,2902,128697,92,359767
11448,0.0016,172.31.47.0-255,66,128763,92,359767
11449,0.001635,74.125.68.0-255,5738,134501,92,359767
11450,0.001638,172.31.47.0-255,66,134567,92,359767
11451,0.001649,172.31.47.0-255,66,134633,92,359767
11452,0.001689,74.125.68.0-255,1484,136117,92,359767
11453,0.001711,74.125.68.0-255,2902,139019,92,359767
11454,0.001714,172.31.47.0-255,66,139085,92,359767
11455,0.001722,74.125.68.0-255,5738,144823,92,359767
11456,0.001725,172.31.47.0-255,66,144889,92,359767
11457,0.001735,74.125.68.0-255,4320,149209,92,359767
11458,0.001737,172.31.47.0-255,66,149275,92,359767
11459,0.001743,74.125.68.0-255,4320,153595,92,359767
11460,0.001748,172.31.47.0-255,66,153661,92,359767
11461,0.001755,74.125.68.0-255,1484,155145,92,359767
11462,0.001782,74.125.68.0-255,2902,158047,92,359767
11463,0.001785,172.31.47.0-255,66,158113,92,359767
11464,0.001812,172.31.47.0-255,66,158179,92,359767
11465,0.001815,74.125.68.0-255,1484,159663,92,359767
11466,0.001838,74.125.68.0-255,766,160429,92,359767
11467,0.001841,172.31.47.0-255,66,160495,92,359767
11468,0.001889,74.125.68.0-255,1484,161979,92,359767
11469,0.001904,74.125.68.0-255,2902,164881,92,359767
11470,0.001908,172.31.47.0-255,66,164947,92,359767
11471,0.001918,74.125.68.0-255,1484,166431,92,359767
11472,0.001936,74.125.68.0-255,4320,170751,92,359767
11473,0.001939,172.31.47.0-255,66,170817,92,359767
11474,0.001951,74.125.68.0-255,2902,173719,92,359767
11475,0.001958,172.31.47.0-255,66,173785,92,359767
11476,0.001977,74.125.68.0-255,5738,179523,92,359767
11477,0.00198,172.31.47.0-255,66,179589,92,359767
11478,0.001985,74.125.68.0-255,4320,183909,92,359767
11479,0.001987,172.31.47.0-255,66,183975,92,359767
11480,0.00392,74.125.68.0-255,2902,186877,92,359767
11481,0.003926,172.31.47.0-255,66,186943,92,359767
11482,0.003943,74.125.68.0-255,2902,189845,92,359767
11483,0.003958,172.31.47.0-255,66,189911,92,359767
11484,0.005891,74.125.68.0-255,2902,192813,92,359767
11485,0.005897,172.31.47.0-255,66,192879,92,359767
11486,0.005927,74.125.68.0-255,2902,195781,92,359767
11487,0.00593,172.31.47.0-255,66,195847,92,359767
11488,0.007847,74.125.68.0-255,2902,198749,92,359767
11489,0.007853,172.31.47.0-255,66,198815,92,359767
11490,0.007899,74.125.68.0-255,2902,201717,92,359767
11491,0.007902,172.31.47.0-255,66,201783,92,359767
11492,0.009804,74.125.68.0-255,2902,204685,92,359767
11493,0.009812,172.31.47.0-255,66,204751,92,359767
11494,0.009841,74.125.68.0-255,2902,207653,92,359767
11495,0.009843,172.31.47.0-255,66,207719,92,359767
11496,0.011779,74.125.68.0-255,2902,210621,92,359767
11497,0.011787,172.31.47.0-255,66,210687,92,359767
11498,0.011821,74.125.68.0-255,2902,213589,92,359767
11499,0.011824,172.31.47.0-255,66,213655,92,359767
11500,0.013734,74.125.68.0-255,2902,216557,92,359767
11501,0.01374,172.31.47.0-255,66,216623,92,359767
11502,0.013766,74.125.68.0-255,2902,219525,92,359767
11503,0.013768,172.31.47.0-255,66,219591,92,359767
11504,0.015686,74.125.68.0-255,2902,222493,92,359767
11505,0.015693,172.31.47.0-255,66,222559,92,359767
11506,0.01572,74.125.68.0-255,2902,225461,92,359767
11507,0.015722,172.31.47.0-255,66,225527,92,359767
11508,0.017651,74.125.68.0-255,2902,228429,92,359767
11509,0.017659,172.31.47.0-255,66,228495,92,359767
11510,0.017692,74.125.68.0-255,2902,231397,92,359767
11511,0.017694,172.31.47.0-255,66,231463,92,359767
11512,0.019608,74.125.68.0-255,2902,234365,92,359767
11513,0.019614,172.31.47.0-255,66,234431,92,359767
11514,0.019642,74.125.68.0-255,1484,235915,92,359767
11515,0.019654,74.125.68.0-255,1484,237399,92,359767
11516,0.019656,172.31.47.0-255,66,237465,92,359767
11517,0.021575,74.125.68.0-255,2902,240367,92,359767
11518,0.021581,172.31.47.0-255,66,240433,92,359767
11519,0.021616,74.125.68.0-255,2902,243335,92,359767
11520,0.021618,172.31.47.0-255,66,243401,92,359767
11521,0.023526,74.125.68.0-255,2902,246303,92,359767
11522,0.023532,172.31.47.0-255,66,246369,92,359767
11523,0.023587,74.125.68.0-255,2902,249271,92,359767
11524,0.02359,172.31.47.0-255,66,249337,92,359767
11525,0.025494,74.125.68.0-255,2902,252239,92,359767
11526,0.025502,172.31.47.0-255,66,252305,92,359767
11527,0.025549,74.125.68.0-255,2902,255207,92,359767
11528,0.025552,172.31.47.0-255,66,255273,92,359767
11529,0.02747,74.125.68.0-255,2902,258175,92,359767
11530,0.027477,172.31.47.0-255,66,258241,92,359767
11531,0.027502,74.125.68.0-255,2902,261143,92,359767
11532,0.027505,172.31.47.0-255,66,261209,92,359767
11533,0.029039,172.31.47.0-255,172,261381,92,359767
11534,0.029068,172.31.47.0-255,1111,262492,92,359767
11535,0.029123,172.31.47.0-255,1514,264006,92,359767
11536,0.029125,172.31.47.0-255,1514,265520,92,359767
11537,0.029126,172.31.47.0-255,1514,267034,92,359767
11538,0.029127,172.31.47.0-255,1514,268548,92,359767
11539,0.029128,172.31.47.0-255,531,269079,92,359767
11540,0.02943,74.125.68.0-255,2902,271981,92,359767
11541,0.029436,172.31.47.0-255,66,272047,92,359767
11542,0.029455,74.125.68.0-255,2902,274949,92,359767
11543,0.029458,172.31.47.0-255,66,275015,92,359767
11544,0.030603,104.244.42.0-255,66,275081,92,359767
11545,0.030611,104.244.42.0-255,66,275147,92,359767
11546,0.030683,104.244.42.0-255,66,275213,92,359767
11547,0.030686,104.244.42.0-255,66,275279,92,359767
11548,0.031397,74.125.68.0-255,4320,279599,92,359767
11549,0.031402,172.31.47.0-255,66,279665,92,359767
11550,0.03143,74.125.68.0-255,1484,281149,92,359767
11551,0.033375,74.125.68.0-255,4320,285469,92,359767
11552,0.033382,172.31.47.0-255,66,285535,92,359767
11553,0.035355,74.125.68.0-255,5738,291273,92,359767
11554,0.035361,172.31.47.0-255,66,291339,92,359767
11555,0.037316,74.125.68.0-255,5738,297077,92,359767
11556,0.037327,172.31.47.0-255,66,297143,92,359767
11557,0.039286,74.125.68.0-255,5738,302881,92,359767
11558,0.039292,172.31.47.0-255,66,302947,92,359767
11559,0.041256,74.125.68.0-255,5738,308685,92,359767
11560,0.041261,172.31.47.0-255,66,308751,92,359767
11561,0.043237,74.125.68.0-255,5738,314489,92,359767
11562,0.043242,172.31.47.0-255,66,314555,92,359767
11563,0.045198,74.125.68.0-255,5738,320293,92,359767
11564,0.045204,172.31.47.0-255,66,320359,92,359767
11565,0.047174,74.125.68.0-255,5738,326097,92,359767
11566,0.047181,172.31.47.0-255,66,326163,92,359767
11567,0.049125,74.125.68.0-255,4320,330483,92,359767
11568,0.049131,172.31.47.0-255,66,330549,92,359767
11569,0.049155,74.125.68.0-255,1484,332033,92,359767
11570,0.051081,74.125.68.0-255,4320,336353,92,359767
11571,0.051087,172.31.47.0-255,66,336419,92,359767
11572,0.053058,74.125.68.0-255,2902,339321,92,359767
11573,0.053064,172.31.47.0-255,66,339387,92,359767
11574,0.05309,74.125.68.0-255,2902,342289,92,359767
11575,0.053093,172.31.47.0-255,66,342355,92,359767
11576,0.055031,74.125.68.0-255,5738,348093,92,359767
11577,0.055036,172.31.47.0-255,66,348159,92,359767
11578,0.057017,74.125.68.0-255,5738,353897,92,359767
11579,0.057027,172.31.47.0-255,66,353963,92,359767
11580,0.058992,74.125.68.0-255,5738,359701,92,359767
11581,0.058997,172.31.47.0-255,66,359767,92,359767
11582,0.0,172.217.194.0-255,153,153,92,227703
11583,2.4e-05,172.31.47.0-255,66,219,92,227703
11584,3.1e-05,172.217.194.0-255,1484,1703,92,227703
11585,3.4e-05,172.31.47.0-255,66,1769,92,227703
11586,3.9e-05,172.217.194.0-255,2902,4671,92,227703
11587,4.1e-05,172.31.47.0-255,66,4737,92,227703
11588,4.5e-05,172.217.194.0-255,4320,9057,92,227703
11589,4.7e-05,172.31.47.0-255,66,9123,92,227703
11590,7.2e-05,172.217.194.0-255,2902,12025,92,227703
11591,7.4e-05,172.31.47.0-255,66,12091,92,227703
11592,7.8e-05,172.217.194.0-255,2208,14299,92,227703
11593,7.9e-05,172.31.47.0-255,66,14365,92,227703
11594,0.000107,172.217.194.0-255,2902,17267,92,227703
11595,0.000109,172.31.47.0-255,66,17333,92,227703
11596,0.000135,172.31.47.0-255,66,17399,92,227703
11597,0.000138,172.217.194.0-255,1484,18883,92,227703
11598,0.000139,172.31.47.0-255,66,18949,92,227703
11599,0.000178,172.217.194.0-255,3961,22910,92,227703
11600,0.000181,172.31.47.0-255,66,22976,92,227703
11601,0.000217,172.217.194.0-255,4320,27296,92,227703
11602,0.00022,172.31.47.0-255,66,27362,92,227703
11603,0.000223,172.217.194.0-255,2902,30264,92,227703
11604,0.000225,172.31.47.0-255,66,30330,92,227703
11605,0.000242,172.217.194.0-255,7156,37486,92,227703
11606,0.000244,172.31.47.0-255,66,37552,92,227703
11607,0.000247,172.217.194.0-255,1484,39036,92,227703
11608,0.000248,172.31.47.0-255,66,39102,92,227703
11609,0.000295,172.217.194.0-255,4320,43422,92,227703
11610,0.000298,172.31.47.0-255,66,43488,92,227703
11611,0.000329,172.31.47.0-255,66,43554,92,227703
11612,0.000357,172.217.194.0-255,119,43673,92,227703
11613,0.000425,172.217.194.0-255,380,44053,92,227703
11614,0.000644,172.31.47.0-255,66,44119,92,227703
11615,0.000654,172.217.194.0-255,1484,45603,92,227703
11616,0.000658,172.217.194.0-255,2902,48505,92,227703
11617,0.00066,172.31.47.0-255,66,48571,92,227703
11618,0.000686,172.217.194.0-255,1484,50055,92,227703
11619,0.0007,172.217.194.0-255,4320,54375,92,227703
11620,0.000702,172.31.47.0-255,66,54441,92,227703
11621,0.000713,172.31.47.0-255,66,54507,92,227703
11622,0.000736,172.217.194.0-255,4320,58827,92,227703
11623,0.000739,172.31.47.0-255,66,58893,92,227703
11624,0.000764,172.31.47.0-255,66,58959,92,227703
11625,0.001832,172.217.194.0-255,1484,60443,92,227703
11626,0.001841,172.217.194.0-255,2902,63345,92,227703
11627,0.001845,172.31.47.0-255,66,63411,92,227703
11628,0.001851,172.217.194.0-255,4320,67731,92,227703
11629,0.001853,172.31.47.0-255,66,67797,92,227703
11630,0.001864,172.217.194.0-255,1484,69281,92,227703
11631,0.001868,172.217.194.0-255,4320,73601,92,227703
11632,0.00187,172.31.47.0-255,66,73667,92,227703
11633,0.001894,172.31.47.0-255,66,73733,92,227703
11634,0.001931,172.217.194.0-255,2902,76635,92,227703
11635,0.001934,172.31.47.0-255,66,76701,92,227703
11636,0.001959,172.31.47.0-255,66,76767,92,227703
11637,0.004262,172.217.194.0-255,5738,82505,92,227703
11638,0.004266,172.31.47.0-255,66,82571,92,227703
11639,0.006555,172.217.194.0-255,5738,88309,92,227703
11640,0.00656,172.31.47.0-255,66,88375,92,227703
11641,0.008866,172.217.194.0-255,5738,94113,92,227703
11642,0.008872,172.31.47.0-255,66,94179,92,227703
11643,0.011194,172.217.194.0-255,5738,99917,92,227703
11644,0.011201,172.31.47.0-255,66,99983,92,227703
11645,0.013541,172.217.194.0-255,5738,105721,92,227703
11646,0.013548,172.31.47.0-255,66,105787,92,227703
11647,0.015861,172.217.194.0-255,5738,111525,92,227703
11648,0.015867,172.31.47.0-255,66,111591,92,227703
11649,0.018166,172.217.194.0-255,5738,117329,92,227703
11650,0.018173,172.31.47.0-255,66,117395,92,227703
11651,0.019659,172.31.47.0-255,172,117567,92,227703
11652,0.019687,172.31.47.0-255,1111,118678,92,227703
11653,0.019725,172.31.47.0-255,1514,120192,92,227703
11654,0.019727,172.31.47.0-255,1514,121706,92,227703
11655,0.019728,172.31.47.0-255,1514,123220,92,227703
11656,0.019729,172.31.47.0-255,1514,124734,92,227703
11657,0.01973,172.31.47.0-255,531,125265,92,227703
11658,0.020484,172.217.194.0-255,4320,129585,92,227703
11659,0.020489,172.31.47.0-255,66,129651,92,227703
11660,0.020516,172.217.194.0-255,1484,131135,92,227703
11661,0.021196,104.244.42.0-255,66,131201,92,227703
11662,0.021202,104.244.42.0-255,66,131267,92,227703
11663,0.021318,104.244.42.0-255,66,131333,92,227703
11664,0.02132,104.244.42.0-255,66,131399,92,227703
11665,0.022085,104.244.42.0-255,108,131507,92,227703
11666,0.022088,172.31.47.0-255,66,131573,92,227703
11667,0.022805,172.217.194.0-255,4320,135893,92,227703
11668,0.02281,172.31.47.0-255,66,135959,92,227703
11669,0.025105,172.217.194.0-255,2902,138861,92,227703
11670,0.02511,172.31.47.0-255,66,138927,92,227703
11671,0.025136,172.217.194.0-255,2902,141829,92,227703
11672,0.025138,172.31.47.0-255,66,141895,92,227703
11673,0.027414,172.217.194.0-255,2902,144797,92,227703
11674,0.027418,172.31.47.0-255,66,144863,92,227703
11675,0.02745,172.217.194.0-255,2902,147765,92,227703
11676,0.027453,172.31.47.0-255,66,147831,92,227703
11677,0.029715,172.217.194.0-255,2902,150733,92,227703
11678,0.029719,172.31.47.0-255,66,150799,92,227703
11679,0.029746,172.217.194.0-255,2902,153701,92,227703
11680,0.029748,172.31.47.0-255,66,153767,92,227703
11681,0.032048,172.217.194.0-255,2902,156669,92,227703
11682,0.032054,172.31.47.0-255,66,156735,92,227703
11683,0.032088,172.217.194.0-255,2902,159637,92,227703
11684,0.03209,172.31.47.0-255,66,159703,92,227703
11685,0.03436,172.217.194.0-255,2902,162605,92,227703
11686,0.034366,172.31.47.0-255,66,162671,92,227703
11687,0.034396,172.217.194.0-255,2902,165573,92,227703
11688,0.034399,172.31.47.0-255,66,165639,92,227703
11689,0.036683,172.217.194.0-255,4320,169959,92,227703
11690,0.036687,172.31.47.0-255,66,170025,92,227703
11691,0.036713,172.217.194.0-255,1484,171509,92,227703
11692,0.039011,172.217.194.0-255,4320,175829,92,227703
11693,0.039016,172.31.47.0-255,66,175895,92,227703
11694,0.041313,172.217.194.0-255,5738,181633,92,227703
11695,0.041318,172.31.47.0-255,66,181699,92,227703
11696,0.043621,172.217.194.0-255,4320,186019,92,227703
11697,0.043625,172.31.47.0-255,66,186085,92,227703
11698,0.043654,172.217.194.0-255,1484,187569,92,227703
11699,0.045953,172.217.194.0-255,1484,189053,92,227703
11700,0.045958,172.31.47.0-255,66,189119,92,227703
11701,0.045989,172.217.194.0-255,2902,192021,92,227703
11702,0.045992,172.31.47.0-255,66,192087,92,227703
11703,0.04827,172.217.194.0-255,2902,194989,92,227703
11704,0.048276,172.31.47.0-255,66,195055,92,227703
11705,0.048331,172.217.194.0-255,2902,197957,92,227703
11706,0.048335,172.31.47.0-255,66,198023,92,227703
11707,0.050621,172.217.194.0-255,2902,200925,92,227703
11708,0.050627,172.31.47.0-255,66,200991,92,227703
11709,0.050656,172.217.194.0-255,2902,203893,92,227703
11710,0.050659,172.31.47.0-255,66,203959,92,227703
11711,0.052933,172.217.194.0-255,2902,206861,92,227703
11712,0.052938,172.31.47.0-255,66,206927,92,227703
11713,0.052967,172.217.194.0-255,2902,209829,92,227703
11714,0.05297,172.31.47.0-255,66,209895,92,227703
11715,0.055255,172.217.194.0-255,2902,212797,92,227703
11716,0.055259,172.31.47.0-255,66,212863,92,227703
11717,0.055292,172.217.194.0-255,2902,215765,92,227703
11718,0.055294,172.31.47.0-255,66,215831,92,227703
11719,0.057563,172.217.194.0-255,2902,218733,92,227703
11720,0.057568,172.31.47.0-255,66,218799,92,227703
11721,0.057611,172.217.194.0-255,2902,221701,92,227703
11722,0.057614,172.31.47.0-255,66,221767,92,227703
11723,0.059876,172.217.194.0-255,2902,224669,92,227703
11724,0.05988,172.31.47.0-255,66,224735,92,227703
11725,0.059912,172.217.194.0-255,2902,227637,92,227703
11726,0.059915,172.31.47.0-255,66,227703,92,227703
11727,0.0,74.125.68.0-255,298,298,92,335807
11728,2e-05,172.31.47.0-255,66,364,92,335807
11729,2.7e-05,74.125.68.0-255,1484,1848,92,335807
11730,3.2e-05,172.31.47.0-255,66,1914,92,335807
11731,4.7e-05,74.125.68.0-255,4320,6234,92,335807
11732,5.1e-05,172.31.47.0-255,66,6300,92,335807
11733,6.3e-05,172.31.47.0-255,66,6366,92,335807
11734,0.000184,74.125.68.0-255,1484,7850,92,335807
11735,0.000189,172.31.47.0-255,66,7916,92,335807
11736,0.000195,74.125.68.0-255,2902,10818,92,335807
11737,0.000197,172.31.47.0-255,66,10884,92,335807
11738,0.000201,74.125.68.0-255,1484,12368,92,335807
11739,0.000208,172.31.47.0-255,66,12434,92,335807
11740,0.000241,74.125.68.0-255,4320,16754,92,335807
11741,0.000244,172.31.47.0-255,66,16820,92,335807
11742,0.000249,74.125.68.0-255,2902,19722,92,335807
11743,0.000251,172.31.47.0-255,66,19788,92,335807
11744,0.000283,74.125.68.0-255,3961,23749,92,335807
11745,0.000286,172.31.47.0-255,66,23815,92,335807
11746,0.000522,74.125.68.0-255,1484,25299,92,335807
11747,0.000528,172.31.47.0-255,66,25365,92,335807
11748,0.000558,74.125.68.0-255,1484,26849,92,335807
11749,0.000562,172.31.47.0-255,66,26915,92,335807
11750,0.000567,74.125.68.0-255,2902,29817,92,335807
11751,0.00057,172.31.47.0-255,66,29883,92,335807
11752,0.00058,74.125.68.0-255,5738,35621,92,335807
11753,0.000583,172.31.47.0-255,66,35687,92,335807
11754,0.000585,74.125.68.0-255,1484,37171,92,335807
11755,0.000587,172.31.47.0-255,66,37237,92,335807
11756,0.000621,74.125.68.0-255,3961,41198,92,335807
11757,0.000625,172.31.47.0-255,66,41264,92,335807
11758,0.000631,74.125.68.0-255,5738,47002,92,335807
11759,0.000669,74.125.68.0-255,1125,48127,92,335807
11760,0.000682,74.125.68.0-255,410,48537,92,335807
11761,0.000685,172.31.47.0-255,66,48603,92,335807
11762,0.001296,74.125.68.0-255,1484,50087,92,335807
11763,0.001304,74.125.68.0-255,2902,52989,92,335807
11764,0.001317,74.125.68.0-255,1484,54473,92,335807
11765,0.001333,74.125.68.0-255,4320,58793,92,335807
11766,0.001367,74.125.68.0-255,2902,61695,92,335807
11767,0.00138,74.125.68.0-255,2902,64597,92,335807
11768,0.001383,74.125.68.0-255,1484,66081,92,335807
11769,0.001405,74.125.68.0-255,5738,71819,92,335807
11770,0.001412,74.125.68.0-255,7156,78975,92,335807
11771,0.001431,74.125.68.0-255,3602,82577,92,335807
11772,0.001454,74.125.68.0-255,333,82910,92,335807
11773,0.001499,74.125.68.0-255,1484,84394,92,335807
11774,0.001504,74.125.68.0-255,2902,87296,92,335807
11775,0.001543,74.125.68.0-255,1484,88780,92,335807
11776,0.001559,74.125.68.0-255,4320,93100,92,335807
11777,0.001575,74.125.68.0-255,2902,96002,92,335807
11778,0.001589,74.125.68.0-255,5738,101740,92,335807
11779,0.001599,74.125.68.0-255,1484,103224,92,335807
11780,0.001604,74.125.68.0-255,4320,107544,92,335807
11781,0.001628,74.125.68.0-255,7156,114700,92,335807
11782,0.001632,74.125.68.0-255,2184,116884,92,335807
11783,0.001774,74.125.68.0-255,1484,118368,92,335807
11784,0.001799,74.125.68.0-255,2902,121270,92,335807
11785,0.001802,74.125.68.0-255,1484,122754,92,335807
11786,0.001818,74.125.68.0-255,4320,127074,92,335807
11787,0.001835,74.125.68.0-255,2902,129976,92,335807
11788,0.001856,74.125.68.0-255,1484,131460,92,335807
11789,0.001862,74.125.68.0-255,5738,137198,92,335807
11790,0.001877,74.125.68.0-255,2184,139382,92,335807
11791,0.001972,74.125.68.0-255,1484,140866,92,335807
11792,0.001996,74.125.68.0-255,2902,143768,92,335807
11793,0.002021,74.125.68.0-255,5738,149506,92,335807
11794,0.002028,74.125.68.0-255,5738,155244,92,335807
11795,0.002043,74.125.68.0-255,1484,156728,92,335807
11796,0.002057,74.125.68.0-255,1484,158212,92,335807
11797,0.002068,74.125.68.0-255,4320,162532,92,335807
11798,0.002117,74.125.68.0-255,2184,164716,92,335807
11799,0.002239,74.125.68.0-255,1484,166200,92,335807
11800,0.002264,74.125.68.0-255,2902,169102,92,335807
11801,0.002267,74.125.68.0-255,1484,170586,92,335807
11802,0.002271,74.125.68.0-255,2902,173488,92,335807
11803,0.002294,74.125.68.0-255,1484,174972,92,335807
11804,0.002309,74.125.68.0-255,4320,179292,92,335807
11805,0.002347,74.125.68.0-255,1484,180776,92,335807
11806,0.002373,74.125.68.0-255,6438,187214,92,335807
11807,0.002426,74.125.68.0-255,1484,188698,92,335807
11808,0.00245,74.125.68.0-255,2902,191600,92,335807
11809,0.002475,74.125.68.0-255,1484,193084,92,335807
11810,0.0025,74.125.68.0-255,4320,197404,92,335807
11811,0.002505,74.125.68.0-255,4320,201724,92,335807
11812,0.002516,74.125.68.0-255,5738,207462,92,335807
11813,0.00253,74.125.68.0-255,2184,209646,92,335807
11814,0.0026,74.125.68.0-255,2902,212548,92,335807
11815,0.002607,74.125.68.0-255,7156,219704,92,335807
11816,0.002636,74.125.68.0-255,2902,222606,92,335807
11817,0.002653,74.125.68.0-255,7156,229762,92,335807
11818,0.002679,74.125.68.0-255,3602,233364,92,335807
11819,0.002682,74.125.68.0-255,1484,234848,92,335807
11820,0.009475,172.31.47.0-255,66,234914,92,335807
11821,0.012127,74.125.68.0-255,5738,240652,92,335807
11822,0.012139,172.31.47.0-255,66,240718,92,335807
11823,0.014743,74.125.68.0-255,5738,246456,92,335807
11824,0.021013,172.31.47.0-255,66,246522,92,335807
11825,0.023622,74.125.68.0-255,5738,252260,92,335807
11826,0.023631,172.31.47.0-255,66,252326,92,335807
11827,0.026236,74.125.68.0-255,5738,258064,92,335807
11828,0.026243,172.31.47.0-255,66,258130,92,335807
11829,0.028856,74.125.68.0-255,5738,263868,92,335807
11830,0.028864,172.31.47.0-255,66,263934,92,335807
11831,0.031489,74.125.68.0-255,1484,265418,92,335807
11832,0.031524,74.125.68.0-255,4320,269738,92,335807
11833,0.031529,172.31.47.0-255,66,269804,92,335807
11834,0.034144,74.125.68.0-255,5738,275542,92,335807
11835,0.034155,172.31.47.0-255,66,275608,92,335807
11836,0.036824,74.125.68.0-255,5738,281346,92,335807
11837,0.036832,172.31.47.0-255,66,281412,92,335807
11838,0.039484,74.125.68.0-255,5738,287150,92,335807
11839,0.039501,172.31.47.0-255,66,287216,92,335807
11840,0.042144,74.125.68.0-255,5738,292954,92,335807
11841,0.042162,172.31.47.0-255,66,293020,92,335807
11842,0.044763,74.125.68.0-255,5738,298758,92,335807
11843,0.04477,172.31.47.0-255,66,298824,92,335807
11844,0.047393,74.125.68.0-255,5738,304562,92,335807
11845,0.047412,172.31.47.0-255,66,304628,92,335807
11846,0.050023,74.125.68.0-255,5738,310366,92,335807
11847,0.05003,172.31.47.0-255,66,310432,92,335807
11848,0.052661,74.125.68.0-255,5738,316170,92,335807
11849,0.052678,172.31.47.0-255,66,316236,92,335807
11850,0.055283,74.125.68.0-255,5738,321974,92,335807
11851,0.05529,172.31.47.0-255,66,322040,92,335807
11852,0.057024,172.31.47.0-255,175,322215,92,335807
11853,0.057056,172.31.47.0-255,1127,323342,92,335807
11854,0.057126,172.31.47.0-255,1514,324856,92,335807
11855,0.057128,172.31.47.0-255,1514,326370,92,335807
11856,0.057129,172.31.47.0-255,1514,327884,92,335807
11857,0.057131,172.31.47.0-255,1514,329398,92,335807
11858,0.057165,172.31.47.0-255,341,329739,92,335807
11859,0.05791,74.125.68.0-255,5738,335477,92,335807
11860,0.057917,172.31.47.0-255,66,335543,92,335807
11861,0.058564,104.244.42.0-255,66,335609,92,335807
11862,0.058598,104.244.42.0-255,66,335675,92,335807
11863,0.058734,104.244.42.0-255,66,335741,92,335807
11864,0.058739,104.244.42.0-255,66,335807,92,335807
11865,0.0,172.217.194.0-255,153,153,92,205945
11866,2.6e-05,172.31.47.0-255,66,219,92,205945
11867,3.2e-05,172.217.194.0-255,1484,1703,92,205945
11868,3.5e-05,172.31.47.0-255,66,1769,92,205945
11869,3.9e-05,172.217.194.0-255,2902,4671,92,205945
11870,4.1e-05,172.31.47.0-255,66,4737,92,205945
11871,7.4e-05,172.217.194.0-255,7156,11893,92,205945
11872,7.7e-05,172.31.47.0-255,66,11959,92,205945
11873,9e-05,172.31.47.0-255,66,12025,92,205945
11874,0.000119,172.217.194.0-255,3544,15569,92,205945
11875,0.000122,172.31.47.0-255,66,15635,92,205945
11876,0.000126,172.217.194.0-255,2543,18178,92,205945
11877,0.000128,172.31.47.0-255,66,18244,92,205945
11878,0.000152,172.217.194.0-255,1484,19728,92,205945
11879,0.000154,172.31.47.0-255,66,19794,92,205945
11880,0.000158,172.217.194.0-255,2902,22696,92,205945
11881,0.00016,172.31.47.0-255,66,22762,92,205945
11882,0.000181,172.217.194.0-255,5738,28500,92,205945
11883,0.000184,172.31.47.0-255,66,28566,92,205945
11884,0.000228,172.31.47.0-255,66,28632,92,205945
11885,0.000259,172.217.194.0-255,2902,31534,92,205945
11886,0.000261,172.31.47.0-255,66,31600,92,205945
11887,0.000298,172.31.47.0-255,66,31666,92,205945
11888,0.0003,172.217.194.0-255,364,32030,92,205945
11889,0.000301,172.31.47.0-255,66,32096,92,205945
11890,0.000335,172.217.194.0-255,1484,33580,92,205945
11891,0.000337,172.31.47.0-255,66,33646,92,205945
11892,0.000362,172.217.194.0-255,2902,36548,92,205945
11893,0.000365,172.31.47.0-255,66,36614,92,205945
11894,0.000371,172.217.194.0-255,5738,42352,92,205945
11895,0.000373,172.31.47.0-255,66,42418,92,205945
11896,0.000394,172.217.194.0-255,2902,45320,92,205945
11897,0.000397,172.31.47.0-255,66,45386,92,205945
11898,0.000421,172.217.194.0-255,3961,49347,92,205945
11899,0.000427,172.31.47.0-255,66,49413,92,205945
11900,0.000428,172.217.194.0-255,7156,56569,92,205945
11901,0.000439,172.31.47.0-255,66,56635,92,205945
11902,0.000468,172.31.47.0-255,66,56701,92,205945
11903,0.000636,172.217.194.0-255,1484,58185,92,205945
11904,0.000642,172.217.194.0-255,2902,61087,92,205945
11905,0.000644,172.31.47.0-255,66,61153,92,205945
11906,0.000647,172.217.194.0-255,1484,62637,92,205945
11907,0.00067,172.217.194.0-255,4320,66957,92,205945
11908,0.000679,172.31.47.0-255,66,67023,92,205945
11909,0.000692,172.31.47.0-255,66,67089,92,205945
11910,0.000706,172.217.194.0-255,4320,71409,92,205945
11911,0.000715,172.31.47.0-255,66,71475,92,205945
11912,0.000719,172.31.47.0-255,66,71541,92,205945
11913,0.000739,172.217.194.0-255,2184,73725,92,205945
11914,0.000747,172.31.47.0-255,66,73791,92,205945
11915,0.000898,172.217.194.0-255,1484,75275,92,205945
11916,0.000902,172.217.194.0-255,1484,76759,92,205945
11917,0.000904,172.31.47.0-255,66,76825,92,205945
11918,0.000929,172.217.194.0-255,1484,78309,92,205945
11919,0.000935,172.217.194.0-255,5738,84047,92,205945
11920,0.000938,172.217.194.0-255,1484,85531,92,205945
11921,0.000947,172.31.47.0-255,66,85597,92,205945
11922,0.000966,172.31.47.0-255,66,85663,92,205945
11923,0.000988,172.217.194.0-255,1484,87147,92,205945
11924,0.001003,172.31.47.0-255,66,87213,92,205945
11925,0.00101,172.217.194.0-255,1484,88697,92,205945
11926,0.001014,172.217.194.0-255,2902,91599,92,205945
11927,0.001022,172.31.47.0-255,66,91665,92,205945
11928,0.001035,172.217.194.0-255,5738,97403,92,205945
11929,0.001039,172.31.47.0-255,66,97469,92,205945
11930,0.001044,172.217.194.0-255,4320,101789,92,205945
11931,0.001051,172.31.47.0-255,66,101855,92,205945
11932,0.001087,172.31.47.0-255,66,101921,92,205945
11933,0.0011,172.31.47.0-255,66,101987,92,205945
11934,0.001144,172.217.194.0-255,1484,103471,92,205945
11935,0.001149,172.217.194.0-255,2902,106373,92,205945
11936,0.001159,172.31.47.0-255,66,106439,92,205945
11937,0.001176,172.217.194.0-255,1484,107923,92,205945
11938,0.001199,172.217.194.0-255,4320,112243,92,205945
11939,0.001203,172.217.194.0-255,1484,113727,92,205945
11940,0.001203,172.31.47.0-255,66,113793,92,205945
11941,0.00125,172.31.47.0-255,66,113859,92,205945
11942,0.001276,172.217.194.0-255,2902,116761,92,205945
11943,0.001278,172.31.47.0-255,66,116827,92,205945
11944,0.00131,172.217.194.0-255,6438,123265,92,205945
11945,0.001314,172.31.47.0-255,66,123331,92,205945
11946,0.001326,172.31.47.0-255,66,123397,92,205945
11947,0.001328,172.217.194.0-255,7156,130553,92,205945
11948,0.00134,172.31.47.0-255,66,130619,92,205945
11949,0.001369,172.217.194.0-255,4320,134939,92,205945
11950,0.001369,172.31.47.0-255,66,135005,92,205945
11951,0.001373,172.31.47.0-255,66,135071,92,205945
11952,0.001406,172.217.194.0-255,7156,142227,92,205945
11953,0.001417,172.217.194.0-255,1484,143711,92,205945
11954,0.001418,172.31.47.0-255,66,143777,92,205945
11955,0.001422,172.31.47.0-255,66,143843,92,205945
11956,0.001467,172.31.47.0-255,66,143909,92,205945
11957,0.001491,172.217.194.0-255,1484,145393,92,205945
11958,0.001496,172.217.194.0-255,2902,148295,92,205945
11959,0.001503,172.31.47.0-255,66,148361,92,205945
11960,0.001523,172.217.194.0-255,5738,154099,92,205945
11961,0.001529,172.217.194.0-255,5738,159837,92,205945
11962,0.00153,172.31.47.0-255,66,159903,92,205945
11963,0.001534,172.31.47.0-255,66,159969,92,205945
11964,0.001586,172.31.47.0-255,66,160035,92,205945
11965,0.001601,172.31.47.0-255,66,160101,92,205945
11966,0.001624,172.217.194.0-255,6438,166539,92,205945
11967,0.00163,172.217.194.0-255,7156,173695,92,205945
11968,0.001629,172.31.47.0-255,66,173761,92,205945
11969,0.001633,172.31.47.0-255,66,173827,92,205945
11970,0.001651,172.31.47.0-255,66,173893,92,205945
11971,0.001675,172.217.194.0-255,2184,176077,92,205945
11972,0.001685,172.31.47.0-255,66,176143,92,205945
11973,0.001697,172.31.47.0-255,66,176209,92,205945
11974,0.001701,172.31.47.0-255,66,176275,92,205945
11975,0.001727,172.217.194.0-255,5020,181295,92,205945
11976,0.00173,172.217.194.0-255,1484,182779,92,205945
11977,0.001733,172.217.194.0-255,2902,185681,92,205945
11978,0.001735,172.217.194.0-255,1484,187165,92,205945
11979,0.001735,172.31.47.0-255,66,187231,92,205945
11980,0.001741,172.31.47.0-255,66,187297,92,205945
11981,0.001751,172.217.194.0-255,4320,191617,92,205945
11982,0.001759,172.217.194.0-255,2902,194519,92,205945
11983,0.001761,172.31.47.0-255,66,194585,92,205945
11984,0.001765,172.31.47.0-255,66,194651,92,205945
11985,0.001801,172.217.194.0-255,1517,196168,92,205945
11986,0.001801,172.31.47.0-255,66,196234,92,205945
11987,0.001802,172.217.194.0-255,97,196331,92,205945
11988,0.001804,172.31.47.0-255,66,196397,92,205945
11989,0.00183,172.217.194.0-255,105,196502,92,205945
11990,0.003156,172.31.47.0-255,66,196568,92,205945
11991,0.003179,172.31.47.0-255,105,196673,92,205945
11992,0.005748,172.217.194.0-255,66,196739,92,205945
11993,0.024512,172.31.47.0-255,172,196911,92,205945
11994,0.024539,172.31.47.0-255,1111,198022,92,205945
11995,0.024576,172.31.47.0-255,1514,199536,92,205945
11996,0.024596,172.31.47.0-255,1514,201050,92,205945
11997,0.024597,172.31.47.0-255,1514,202564,92,205945
11998,0.024614,172.31.47.0-255,1514,204078,92,205945
11999,0.024615,172.31.47.0-255,1495,205573,92,205945
12000,0.026037,104.244.42.0-255,66,205639,92,205945
12001,0.026044,104.244.42.0-255,66,205705,92,205945
12002,0.026145,104.244.42.0-255,66,205771,92,205945
12003,0.026692,104.244.42.0-255,108,205879,92,205945
12004,0.026696,172.31.47.0-255,66,205945,92,205945
12005,0.0,172.217.194.0-255,153,153,92,303432
12006,2.3e-05,172.31.47.0-255,66,219,92,303432
12007,2.9e-05,172.217.194.0-255,1484,1703,92,303432
12008,3.2e-05,172.31.47.0-255,66,1769,92,303432
12009,3.7e-05,172.217.194.0-255,2902,4671,92,303432
12010,3.9e-05,172.31.47.0-255,66,4737,92,303432
12011,4.1e-05,172.217.194.0-255,1484,6221,92,303432
12012,4.4e-05,172.31.47.0-255,66,6287,92,303432
12013,6e-05,172.217.194.0-255,5738,12025,92,303432
12014,6.3e-05,172.31.47.0-255,66,12091,92,303432
12015,9.7e-05,172.217.194.0-255,1967,14058,92,303432
12016,0.0001,172.31.47.0-255,66,14124,92,303432
12017,0.000192,172.217.194.0-255,1484,15608,92,303432
12018,0.000196,172.31.47.0-255,66,15674,92,303432
12019,0.0002,172.217.194.0-255,2902,18576,92,303432
12020,0.000202,172.31.47.0-255,66,18642,92,303432
12021,0.000235,172.217.194.0-255,1484,20126,92,303432
12022,0.000239,172.31.47.0-255,66,20192,92,303432
12023,0.00026,172.217.194.0-255,4320,24512,92,303432
12024,0.000263,172.31.47.0-255,66,24578,92,303432
12025,0.000268,172.217.194.0-255,6797,31375,92,303432
12026,0.00027,172.31.47.0-255,66,31441,92,303432
12027,0.000323,172.217.194.0-255,1484,32925,92,303432
12028,0.000326,172.31.47.0-255,66,32991,92,303432
12029,0.000338,172.217.194.0-255,2902,35893,92,303432
12030,0.000341,172.31.47.0-255,66,35959,92,303432
12031,0.000343,172.217.194.0-255,1484,37443,92,303432
12032,0.000345,172.31.47.0-255,66,37509,92,303432
12033,0.000357,172.217.194.0-255,4320,41829,92,303432
12034,0.00036,172.31.47.0-255,66,41895,92,303432
12035,0.000364,172.217.194.0-255,2902,44797,92,303432
12036,0.000366,172.31.47.0-255,66,44863,92,303432
12037,0.000393,172.217.194.0-255,3961,48824,92,303432
12038,0.000396,172.31.47.0-255,66,48890,92,303432
12039,0.000409,172.31.47.0-255,66,48956,92,303432
12040,0.000414,172.217.194.0-255,2866,51822,92,303432
12041,0.000416,172.31.47.0-255,66,51888,92,303432
12042,0.000458,172.217.194.0-255,364,52252,92,303432
12043,0.000695,172.217.194.0-255,1484,53736,92,303432
12044,0.000699,172.31.47.0-255,66,53802,92,303432
12045,0.000702,172.217.194.0-255,1484,55286,92,303432
12046,0.000716,172.217.194.0-255,1484,56770,92,303432
12047,0.000719,172.31.47.0-255,66,56836,92,303432
12048,0.000723,172.217.194.0-255,2902,59738,92,303432
12049,0.000725,172.31.47.0-255,66,59804,92,303432
12050,0.000739,172.217.194.0-255,2902,62706,92,303432
12051,0.000741,172.31.47.0-255,66,62772,92,303432
12052,0.000747,172.217.194.0-255,7156,69928,92,303432
12053,0.000749,172.31.47.0-255,66,69994,92,303432
12054,0.000751,172.217.194.0-255,1484,71478,92,303432
12055,0.000788,172.31.47.0-255,66,71544,92,303432
12056,0.000791,172.217.194.0-255,2184,73728,92,303432
12057,0.000793,172.31.47.0-255,66,73794,92,303432
12058,0.001078,172.217.194.0-255,1484,75278,92,303432
12059,0.001089,172.217.194.0-255,2902,78180,92,303432
12060,0.001093,172.31.47.0-255,66,78246,92,303432
12061,0.0011,172.217.194.0-255,5738,83984,92,303432
12062,0.001102,172.31.47.0-255,66,84050,92,303432
12063,0.001106,172.217.194.0-255,2902,86952,92,303432
12064,0.001108,172.31.47.0-255,66,87018,92,303432
12065,0.001136,172.31.47.0-255,66,87084,92,303432
12066,0.001142,172.217.194.0-255,4320,91404,92,303432
12067,0.001144,172.31.47.0-255,66,91470,92,303432
12068,0.001167,172.217.194.0-255,5738,97208,92,303432
12069,0.001171,172.31.47.0-255,66,97274,92,303432
12070,0.001176,172.217.194.0-255,3602,100876,92,303432
12071,0.001178,172.31.47.0-255,66,100942,92,303432
12072,0.001204,172.217.194.0-255,4320,105262,92,303432
12073,0.001208,172.31.47.0-255,66,105328,92,303432
12074,0.001218,172.31.47.0-255,66,105394,92,303432
12075,0.001253,172.31.47.0-255,66,105460,92,303432
12076,0.001274,172.217.194.0-255,5020,110480,92,303432
12077,0.001278,172.31.47.0-255,66,110546,92,303432
12078,0.001282,172.217.194.0-255,2902,113448,92,303432
12079,0.001284,172.31.47.0-255,66,113514,92,303432
12080,0.001301,172.217.194.0-255,5738,119252,92,303432
12081,0.001304,172.31.47.0-255,66,119318,92,303432
12082,0.001314,172.31.47.0-255,66,119384,92,303432
12083,0.001353,172.31.47.0-255,66,119450,92,303432
12084,0.001421,172.217.194.0-255,1484,120934,92,303432
12085,0.001437,172.217.194.0-255,2902,123836,92,303432
12086,0.001442,172.31.47.0-255,66,123902,92,303432
12087,0.001448,172.217.194.0-255,4320,128222,92,303432
12088,0.001451,172.31.47.0-255,66,128288,92,303432
12089,0.001465,172.217.194.0-255,1484,129772,92,303432
12090,0.00147,172.217.194.0-255,5738,135510,92,303432
12091,0.001473,172.31.47.0-255,66,135576,92,303432
12092,0.001495,172.217.194.0-255,7156,142732,92,303432
12093,0.001498,172.31.47.0-255,66,142798,92,303432
12094,0.001512,172.31.47.0-255,66,142864,92,303432
12095,0.001611,172.217.194.0-255,1484,144348,92,303432
12096,0.001616,172.217.194.0-255,2902,147250,92,303432
12097,0.001618,172.31.47.0-255,66,147316,92,303432
12098,0.00164,172.217.194.0-255,5738,153054,92,303432
12099,0.001643,172.31.47.0-255,66,153120,92,303432
12100,0.001667,172.217.194.0-255,5738,158858,92,303432
12101,0.001669,172.31.47.0-255,66,158924,92,303432
12102,0.001675,172.217.194.0-255,7156,166080,92,303432
12103,0.001678,172.31.47.0-255,66,166146,92,303432
12104,0.001739,172.31.47.0-255,66,166212,92,303432
12105,0.001836,172.217.194.0-255,1484,167696,92,303432
12106,0.001839,172.217.194.0-255,1484,169180,92,303432
12107,0.001841,172.31.47.0-255,66,169246,92,303432
12108,0.00185,172.217.194.0-255,1484,170730,92,303432
12109,0.00187,172.217.194.0-255,5738,176468,92,303432
12110,0.001873,172.31.47.0-255,66,176534,92,303432
12111,0.001883,172.31.47.0-255,66,176600,92,303432
12112,0.001895,172.217.194.0-255,4320,180920,92,303432
12113,0.001898,172.31.47.0-255,66,180986,92,303432
12114,0.001904,172.217.194.0-255,5738,186724,92,303432
12115,0.001906,172.31.47.0-255,66,186790,92,303432
12116,0.001928,172.217.194.0-255,5020,191810,92,303432
12117,0.00193,172.31.47.0-255,66,191876,92,303432
12118,0.001952,172.217.194.0-255,1484,193360,92,303432
12119,0.001965,172.217.194.0-255,2902,196262,92,303432
12120,0.001967,172.31.47.0-255,66,196328,92,303432
12121,0.001973,172.217.194.0-255,5738,202066,92,303432
12122,0.001975,172.31.47.0-255,66,202132,92,303432
12123,0.00201,172.31.47.0-255,66,202198,92,303432
12124,0.002015,172.217.194.0-255,4320,206518,92,303432
12125,0.002032,172.217.194.0-255,6438,212956,92,303432
12126,0.002036,172.217.194.0-255,2902,215858,92,303432
12127,0.004001,172.31.47.0-255,66,215924,92,303432
12128,0.005997,172.217.194.0-255,5738,221662,92,303432
12129,0.006002,172.31.47.0-255,66,221728,92,303432
12130,0.008004,172.217.194.0-255,5738,227466,92,303432
12131,0.008009,172.31.47.0-255,66,227532,92,303432
12132,0.010018,172.217.194.0-255,5738,233270,92,303432
12133,0.010024,172.31.47.0-255,66,233336,92,303432
12134,0.012034,172.217.194.0-255,5738,239074,92,303432
12135,0.012043,172.31.47.0-255,66,239140,92,303432
12136,0.014049,172.217.194.0-255,5738,244878,92,303432
12137,0.014056,172.31.47.0-255,66,244944,92,303432
12138,0.016095,172.217.194.0-255,5738,250682,92,303432
12139,0.016102,172.31.47.0-255,66,250748,92,303432
12140,0.018112,172.217.194.0-255,5738,256486,92,303432
12141,0.018121,172.31.47.0-255,66,256552,92,303432
12142,0.020145,172.217.194.0-255,5738,262290,92,303432
12143,0.020151,172.31.47.0-255,66,262356,92,303432
12144,0.022158,172.217.194.0-255,5738,268094,92,303432
12145,0.022165,172.31.47.0-255,66,268160,92,303432
12146,0.024154,172.217.194.0-255,5738,273898,92,303432
12147,0.024159,172.31.47.0-255,66,273964,92,303432
12148,0.026168,172.217.194.0-255,5738,279702,92,303432
12149,0.026175,172.31.47.0-255,66,279768,92,303432
12150,0.028207,172.217.194.0-255,5738,285506,92,303432
12151,0.028215,172.31.47.0-255,66,285572,92,303432
12152,0.030164,172.31.47.0-255,172,285744,92,303432
12153,0.030194,172.31.47.0-255,1112,286856,92,303432
12154,0.030223,172.217.194.0-255,5738,292594,92,303432
12155,0.030227,172.31.47.0-255,66,292660,92,303432
12156,0.030236,172.31.47.0-255,569,293229,92,303432
12157,0.031719,104.244.42.0-255,66,293295,92,303432
12158,0.031727,104.244.42.0-255,66,293361,92,303432
12159,0.031775,104.244.42.0-255,66,293427,92,303432
12160,0.032224,172.217.194.0-255,4320,297747,92,303432
12161,0.032231,172.31.47.0-255,66,297813,92,303432
12162,0.032249,172.217.194.0-255,1484,299297,92,303432
12163,0.034249,172.217.194.0-255,3898,303195,92,303432
12164,0.034254,172.31.47.0-255,66,303261,92,303432
12165,0.034413,172.31.47.0-255,105,303366,92,303432
12166,0.036363,172.217.194.0-255,66,303432,92,303432
12167,0.0,172.217.194.0-255,153,153,92,255784
12168,3.3e-05,172.31.47.0-255,66,219,92,255784
12169,4.1e-05,172.217.194.0-255,1484,1703,92,255784
12170,4.5e-05,172.31.47.0-255,66,1769,92,255784
12171,4.9e-05,172.217.194.0-255,2902,4671,92,255784
12172,5.2e-05,172.31.47.0-255,66,4737,92,255784
12173,5.4e-05,172.217.194.0-255,1484,6221,92,255784
12174,5.6e-05,172.31.47.0-255,66,6287,92,255784
12175,7.6e-05,172.217.194.0-255,5738,12025,92,255784
12176,7.8e-05,172.31.47.0-255,66,12091,92,255784
12177,8.2e-05,172.217.194.0-255,1998,14089,92,255784
12178,8.4e-05,172.31.47.0-255,66,14155,92,255784
12179,0.000137,172.217.194.0-255,1484,15639,92,255784
12180,0.000142,172.31.47.0-255,66,15705,92,255784
12181,0.000146,172.217.194.0-255,2902,18607,92,255784
12182,0.000149,172.31.47.0-255,66,18673,92,255784
12183,0.000163,172.217.194.0-255,5738,24411,92,255784
12184,0.000165,172.31.47.0-255,66,24477,92,255784
12185,0.000189,172.217.194.0-255,6797,31274,92,255784
12186,0.000192,172.31.47.0-255,66,31340,92,255784
12187,0.000227,172.217.194.0-255,5738,37078,92,255784
12188,0.00023,172.31.47.0-255,66,37144,92,255784
12189,0.000251,172.31.47.0-255,66,37210,92,255784
12190,0.000254,172.217.194.0-255,2543,39753,92,255784
12191,0.000256,172.31.47.0-255,66,39819,92,255784
12192,0.001379,172.217.194.0-255,1484,41303,92,255784
12193,0.001384,172.31.47.0-255,66,41369,92,255784
12194,0.001393,172.217.194.0-255,2902,44271,92,255784
12195,0.001394,172.31.47.0-255,66,44337,92,255784
12196,0.001412,172.217.194.0-255,4320,48657,92,255784
12197,0.001414,172.31.47.0-255,66,48723,92,255784
12198,0.001425,172.217.194.0-255,1484,50207,92,255784
12199,0.001427,172.31.47.0-255,66,50273,92,255784
12200,0.001463,172.217.194.0-255,6797,57070,92,255784
12201,0.001465,172.31.47.0-255,66,57136,92,255784
12202,0.001551,172.217.194.0-255,1484,58620,92,255784
12203,0.001554,172.31.47.0-255,66,58686,92,255784
12204,0.001558,172.217.194.0-255,2902,61588,92,255784
12205,0.00156,172.31.47.0-255,66,61654,92,255784
12206,0.001578,172.217.194.0-255,5738,67392,92,255784
12207,0.00158,172.31.47.0-255,66,67458,92,255784
12208,0.00161,172.217.194.0-255,4320,71778,92,255784
12209,0.001612,172.31.47.0-255,66,71844,92,255784
12210,0.001635,172.217.194.0-255,6797,78641,92,255784
12211,0.001637,172.31.47.0-255,66,78707,92,255784
12212,0.001647,172.31.47.0-255,66,78773,92,255784
12213,0.001651,172.217.194.0-255,1707,80480,92,255784
12214,0.001653,172.31.47.0-255,66,80546,92,255784
12215,0.002086,172.217.194.0-255,1484,82030,92,255784
12216,0.00209,172.31.47.0-255,66,82096,92,255784
12217,0.002117,172.217.194.0-255,2902,84998,92,255784
12218,0.00212,172.31.47.0-255,66,85064,92,255784
12219,0.002126,172.217.194.0-255,5738,90802,92,255784
12220,0.002127,172.31.47.0-255,66,90868,92,255784
12221,0.002131,172.217.194.0-255,2902,93770,92,255784
12222,0.002132,172.31.47.0-255,66,93836,92,255784
12223,0.004235,172.217.194.0-255,5738,99574,92,255784
12224,0.004239,172.31.47.0-255,66,99640,92,255784
12225,0.006378,172.217.194.0-255,5738,105378,92,255784
12226,0.006384,172.31.47.0-255,66,105444,92,255784
12227,0.008488,172.217.194.0-255,5738,111182,92,255784
12228,0.008494,172.31.47.0-255,66,111248,92,255784
12229,0.010608,172.217.194.0-255,5738,116986,92,255784
12230,0.010616,172.31.47.0-255,66,117052,92,255784
12231,0.012715,172.217.194.0-255,5738,122790,92,255784
12232,0.012726,172.31.47.0-255,66,122856,92,255784
12233,0.014817,172.217.194.0-255,5738,128594,92,255784
12234,0.014825,172.31.47.0-255,66,128660,92,255784
12235,0.016924,172.217.194.0-255,5738,134398,92,255784
12236,0.01693,172.31.47.0-255,66,134464,92,255784
12237,0.019045,172.217.194.0-255,5738,140202,92,255784
12238,0.019055,172.31.47.0-255,66,140268,92,255784
12239,0.021157,172.217.194.0-255,5738,146006,92,255784
12240,0.021167,172.31.47.0-255,66,146072,92,255784
12241,0.02329,172.217.194.0-255,5738,151810,92,255784
12242,0.023296,172.31.47.0-255,66,151876,92,255784
12243,0.025406,172.217.194.0-255,5738,157614,92,255784
12244,0.025413,172.31.47.0-255,66,157680,92,255784
12245,0.026328,172.31.47.0-255,172,157852,92,255784
12246,0.026363,172.31.47.0-255,1112,158964,92,255784
12247,0.026436,172.31.47.0-255,1514,160478,92,255784
12248,0.026439,172.31.47.0-255,1514,161992,92,255784
12249,0.02644,172.31.47.0-255,1514,163506,92,255784
12250,0.026441,172.31.47.0-255,1514,165020,92,255784
12251,0.026442,172.31.47.0-255,1494,166514,92,255784
12252,0.027499,172.217.194.0-255,5738,172252,92,255784
12253,0.027506,172.31.47.0-255,66,172318,92,255784
12254,0.027868,104.244.42.0-255,66,172384,92,255784
12255,0.027953,104.244.42.0-255,66,172450,92,255784
12256,0.0281,104.244.42.0-255,66,172516,92,255784
12257,0.029641,172.217.194.0-255,4320,176836,92,255784
12258,0.029647,172.31.47.0-255,66,176902,92,255784
12259,0.029679,172.217.194.0-255,1484,178386,92,255784
12260,0.031761,172.217.194.0-255,4320,182706,92,255784
12261,0.031766,172.31.47.0-255,66,182772,92,255784
12262,0.033885,172.217.194.0-255,5738,188510,92,255784
12263,0.03389,172.31.47.0-255,66,188576,92,255784
12264,0.035984,172.217.194.0-255,2902,191478,92,255784
12265,0.035988,172.31.47.0-255,66,191544,92,255784
12266,0.036014,172.217.194.0-255,2902,194446,92,255784
12267,0.036016,172.31.47.0-255,66,194512,92,255784
12268,0.038089,172.217.194.0-255,5738,200250,92,255784
12269,0.038093,172.31.47.0-255,66,200316,92,255784
12270,0.040215,172.217.194.0-255,5738,206054,92,255784
12271,0.04022,172.31.47.0-255,66,206120,92,255784
12272,0.042323,172.217.194.0-255,4320,210440,92,255784
12273,0.042328,172.31.47.0-255,66,210506,92,255784
12274,0.042353,172.217.194.0-255,1484,211990,92,255784
12275,0.044443,172.217.194.0-255,4320,216310,92,255784
12276,0.044449,172.31.47.0-255,66,216376,92,255784
12277,0.046533,172.217.194.0-255,2902,219278,92,255784
12278,0.046538,172.31.47.0-255,66,219344,92,255784
12279,0.046561,172.217.194.0-255,2902,222246,92,255784
12280,0.046563,172.31.47.0-255,66,222312,92,255784
12281,0.048641,172.217.194.0-255,5738,228050,92,255784
12282,0.048646,172.31.47.0-255,66,228116,92,255784
12283,0.050764,172.217.194.0-255,5738,233854,92,255784
12284,0.050769,172.31.47.0-255,66,233920,92,255784
12285,0.052873,172.217.194.0-255,5738,239658,92,255784
12286,0.052878,172.31.47.0-255,66,239724,92,255784
12287,0.054986,172.217.194.0-255,4320,244044,92,255784
12288,0.054992,172.31.47.0-255,66,244110,92,255784
12289,0.055023,172.217.194.0-255,1484,245594,92,255784
12290,0.057086,172.217.194.0-255,4320,249914,92,255784
12291,0.057091,172.31.47.0-255,66,249980,92,255784
12292,0.059219,172.217.194.0-255,5738,255718,92,255784
12293,0.059224,172.31.47.0-255,66,255784,92,255784
12294,0.0,172.31.47.0-255,105,105,92,105
12295,0.0,172.31.47.0-255,105,105,92,105
12296,0.0,74.125.68.0-255,153,153,92,320406
12297,2.5e-05,172.31.47.0-255,66,219,92,320406
12298,3.3e-05,74.125.68.0-255,1484,1703,92,320406
12299,3.7e-05,172.31.47.0-255,66,1769,92,320406
12300,4.2e-05,74.125.68.0-255,2902,4671,92,320406
12301,4.4e-05,172.31.47.0-255,66,4737,92,320406
12302,5.1e-05,74.125.68.0-255,7156,11893,92,320406
12303,5.3e-05,172.31.47.0-255,66,11959,92,320406
12304,5.7e-05,74.125.68.0-255,2063,14022,92,320406
12305,6e-05,172.31.47.0-255,66,14088,92,320406
12306,9.6e-05,74.125.68.0-255,2902,16990,92,320406
12307,9.9e-05,172.31.47.0-255,66,17056,92,320406
12308,0.000102,74.125.68.0-255,1484,18540,92,320406
12309,0.000103,172.31.47.0-255,66,18606,92,320406
12310,0.000121,74.125.68.0-255,2902,21508,92,320406
12311,0.000123,172.31.47.0-255,66,21574,92,320406
12312,0.000129,74.125.68.0-255,5738,27312,92,320406
12313,0.000131,172.31.47.0-255,66,27378,92,320406
12314,0.00018,172.31.47.0-255,66,27444,92,320406
12315,0.00022,172.31.47.0-255,66,27510,92,320406
12316,0.000303,74.125.68.0-255,1484,28994,92,320406
12317,0.000307,172.31.47.0-255,66,29060,92,320406
12318,0.000331,74.125.68.0-255,2902,31962,92,320406
12319,0.000333,172.31.47.0-255,66,32028,92,320406
12320,0.000339,74.125.68.0-255,5738,37766,92,320406
12321,0.000341,172.31.47.0-255,66,37832,92,320406
12322,0.000397,172.31.47.0-255,66,37898,92,320406
12323,0.000416,74.125.68.0-255,1484,39382,92,320406
12324,0.000418,172.31.47.0-255,66,39448,92,320406
12325,0.000445,172.31.47.0-255,66,39514,92,320406
12326,0.000462,74.125.68.0-255,2902,42416,92,320406
12327,0.000478,74.125.68.0-255,2902,45318,92,320406
12328,0.000495,74.125.68.0-255,1484,46802,92,320406
12329,0.000499,74.125.68.0-255,2902,49704,92,320406
12330,0.000522,74.125.68.0-255,5738,55442,92,320406
12331,0.000526,74.125.68.0-255,2902,58344,92,320406
12332,0.000598,74.125.68.0-255,1484,59828,92,320406
12333,0.000602,74.125.68.0-255,2184,62012,92,320406
12334,0.000648,172.31.47.0-255,66,62078,92,320406
12335,0.000714,74.125.68.0-255,1484,63562,92,320406
12336,0.00072,74.125.68.0-255,2902,66464,92,320406
12337,0.000744,74.125.68.0-255,5738,72202,92,320406
12338,0.000748,172.31.47.0-255,66,72268,92,320406
12339,0.000758,74.125.68.0-255,1484,73752,92,320406
12340,0.000763,172.31.47.0-255,66,73818,92,320406
12341,0.000779,74.125.68.0-255,7156,80974,92,320406
12342,0.00079,74.125.68.0-255,1484,82458,92,320406
12343,0.000827,74.125.68.0-255,1484,83942,92,320406
12344,0.000833,172.31.47.0-255,66,84008,92,320406
12345,0.000848,74.125.68.0-255,3602,87610,92,320406
12346,0.000872,172.31.47.0-255,66,87676,92,320406
12347,0.001088,74.125.68.0-255,1484,89160,92,320406
12348,0.001094,74.125.68.0-255,2902,92062,92,320406
12349,0.001119,74.125.68.0-255,5738,97800,92,320406
12350,0.001125,74.125.68.0-255,4320,102120,92,320406
12351,0.001141,172.31.47.0-255,66,102186,92,320406
12352,0.001153,74.125.68.0-255,5738,107924,92,320406
12353,0.001158,172.31.47.0-255,66,107990,92,320406
12354,0.00118,74.125.68.0-255,7156,115146,92,320406
12355,0.001196,74.125.68.0-255,4320,119466,92,320406
12356,0.0012,74.125.68.0-255,2184,121650,92,320406
12357,0.001211,172.31.47.0-255,66,121716,92,320406
12358,0.00123,74.125.68.0-255,1484,123200,92,320406
12359,0.001248,74.125.68.0-255,5738,128938,92,320406
12360,0.001313,172.31.47.0-255,66,129004,92,320406
12361,0.001325,74.125.68.0-255,5738,134742,92,320406
12362,0.001328,74.125.68.0-255,766,135508,92,320406
12363,0.001334,172.31.47.0-255,66,135574,92,320406
12364,0.001343,74.125.68.0-255,1484,137058,92,320406
12365,0.001361,74.125.68.0-255,2902,139960,92,320406
12366,0.001382,74.125.68.0-255,5738,145698,92,320406
12367,0.001388,172.31.47.0-255,66,145764,92,320406
12368,0.001408,74.125.68.0-255,5738,151502,92,320406
12369,0.001416,74.125.68.0-255,7156,158658,92,320406
12370,0.001439,74.125.68.0-255,4320,162978,92,320406
12371,0.001444,172.31.47.0-255,66,163044,92,320406
12372,0.001457,74.125.68.0-255,6438,169482,92,320406
12373,0.001483,74.125.68.0-255,1484,170966,92,320406
12374,0.001493,172.31.47.0-255,66,171032,92,320406
12375,0.001506,74.125.68.0-255,2902,173934,92,320406
12376,0.001511,74.125.68.0-255,2902,176836,92,320406
12377,0.001518,172.31.47.0-255,66,176902,92,320406
12378,0.001529,74.125.68.0-255,2902,179804,92,320406
12379,0.001531,74.125.68.0-255,1484,181288,92,320406
12380,0.001561,74.125.68.0-255,7156,188444,92,320406
12381,0.001577,74.125.68.0-255,5738,194182,92,320406
12382,0.001583,172.31.47.0-255,66,194248,92,320406
12383,0.001596,74.125.68.0-255,4320,198568,92,320406
12384,0.0016,74.125.68.0-255,2902,201470,92,320406
12385,0.00163,172.31.47.0-255,66,201536,92,320406
12386,0.001672,172.31.47.0-255,66,201602,92,320406
12387,0.001679,74.125.68.0-255,3602,205204,92,320406
12388,0.001721,74.125.68.0-255,5738,210942,92,320406
12389,0.001728,172.31.47.0-255,66,211008,92,320406
12390,0.001741,74.125.68.0-255,7156,218164,92,320406
12391,0.001747,74.125.68.0-255,7156,225320,92,320406
12392,0.001753,74.125.68.0-255,5020,230340,92,320406
12393,0.001758,74.125.68.0-255,5738,236078,92,320406
12394,0.001807,172.31.47.0-255,66,236144,92,320406
12395,0.001822,74.125.68.0-255,4320,240464,92,320406
12396,0.00183,74.125.68.0-255,7156,247620,92,320406
12397,0.001856,74.125.68.0-255,6438,254058,92,320406
12398,0.001865,172.31.47.0-255,66,254124,92,320406
12399,0.002249,74.125.68.0-255,1484,255608,92,320406
12400,0.002256,74.125.68.0-255,2902,258510,92,320406
12401,0.002268,74.125.68.0-255,4320,262830,92,320406
12402,0.002278,74.125.68.0-255,1484,264314,92,320406
12403,0.002289,172.31.47.0-255,66,264380,92,320406
12404,0.002304,74.125.68.0-255,5738,270118,92,320406
12405,0.002316,172.31.47.0-255,66,270184,92,320406
12406,0.002333,74.125.68.0-255,7156,277340,92,320406
12407,0.002349,74.125.68.0-255,5738,283078,92,320406
12408,0.002364,74.125.68.0-255,5020,288098,92,320406
12409,0.002383,172.31.47.0-255,66,288164,92,320406
12410,0.002402,74.125.68.0-255,5738,293902,92,320406
12411,0.00241,172.31.47.0-255,66,293968,92,320406
12412,0.002419,74.125.68.0-255,4320,298288,92,320406
12413,0.002423,172.31.47.0-255,66,298354,92,320406
12414,0.002455,74.125.68.0-255,7156,305510,92,320406
12415,0.002464,172.31.47.0-255,66,305576,92,320406
12416,0.002495,74.125.68.0-255,2902,308478,92,320406
12417,0.002503,172.31.47.0-255,66,308544,92,320406
12418,0.002512,74.125.68.0-255,2184,310728,92,320406
12419,0.002534,172.31.47.0-255,66,310794,92,320406
12420,0.005017,74.125.68.0-255,2902,313696,92,320406
12421,0.005032,172.31.47.0-255,66,313762,92,320406
12422,0.005056,74.125.68.0-255,2902,316664,92,320406
12423,0.005077,172.31.47.0-255,66,316730,92,320406
12424,0.00756,74.125.68.0-255,1387,318117,92,320406
12425,0.007573,172.31.47.0-255,66,318183,92,320406
12426,0.007755,172.31.47.0-255,105,318288,92,320406
12427,0.010218,74.125.68.0-255,66,318354,92,320406
12428,0.040776,172.31.47.0-255,172,318526,92,320406
12429,0.040821,172.31.47.0-255,1107,319633,92,320406
12430,0.040889,172.31.47.0-255,575,320208,92,320406
12431,0.04236,104.244.42.0-255,66,320274,92,320406
12432,0.042374,104.244.42.0-255,66,320340,92,320406
12433,0.042445,104.244.42.0-255,66,320406,92,320406
12434,0.0,172.217.160.0-255,153,153,92,275605
12435,2.2e-05,172.31.47.0-255,66,219,92,275605
12436,3e-05,172.217.160.0-255,1484,1703,92,275605
12437,3.4e-05,172.31.47.0-255,66,1769,92,275605
12438,4.6e-05,172.217.160.0-255,2902,4671,92,275605
12439,5e-05,172.31.47.0-255,66,4737,92,275605
12440,5.9e-05,172.217.160.0-255,7156,11893,92,275605
12441,6.3e-05,172.31.47.0-255,66,11959,92,275605
12442,7.6e-05,172.31.47.0-255,66,12025,92,275605
12443,8.3e-05,172.217.160.0-255,7156,19181,92,275605
12444,8.6e-05,172.31.47.0-255,66,19247,92,275605
12445,0.00012,172.217.160.0-255,2902,22149,92,275605
12446,0.000123,172.31.47.0-255,66,22215,92,275605
12447,0.000145,172.31.47.0-255,66,22281,92,275605
12448,0.000162,172.31.47.0-255,66,22347,92,275605
12449,0.000486,172.217.160.0-255,120,22467,92,275605
12450,0.000492,172.31.47.0-255,66,22533,92,275605
12451,0.000636,172.217.160.0-255,1484,24017,92,275605
12452,0.00064,172.31.47.0-255,66,24083,92,275605
12453,0.000646,172.217.160.0-255,2902,26985,92,275605
12454,0.000649,172.31.47.0-255,66,27051,92,275605
12455,0.000652,172.217.160.0-255,1484,28535,92,275605
12456,0.000659,172.31.47.0-255,66,28601,92,275605
12457,0.000697,172.217.160.0-255,4320,32921,92,275605
12458,0.000701,172.31.47.0-255,66,32987,92,275605
12459,0.000706,172.217.160.0-255,4320,37307,92,275605
12460,0.000709,172.31.47.0-255,66,37373,92,275605
12461,0.000725,172.31.47.0-255,66,37439,92,275605
12462,0.000757,172.217.160.0-255,5738,43177,92,275605
12463,0.00076,172.31.47.0-255,66,43243,92,275605
12464,0.000772,172.217.160.0-255,2184,45427,92,275605
12465,0.000774,172.31.47.0-255,66,45493,92,275605
12466,0.00127,172.217.160.0-255,1484,46977,92,275605
12467,0.001277,172.217.160.0-255,2902,49879,92,275605
12468,0.001279,172.31.47.0-255,66,49945,92,275605
12469,0.001284,172.217.160.0-255,2902,52847,92,275605
12470,0.001286,172.31.47.0-255,66,52913,92,275605
12471,0.00131,172.217.160.0-255,2902,55815,92,275605
12472,0.001312,172.31.47.0-255,66,55881,92,275605
12473,0.001317,172.217.160.0-255,4320,60201,92,275605
12474,0.001319,172.31.47.0-255,66,60267,92,275605
12475,0.00133,172.217.160.0-255,7156,67423,92,275605
12476,0.001331,172.31.47.0-255,66,67489,92,275605
12477,0.001354,172.217.160.0-255,4320,71809,92,275605
12478,0.00136,172.31.47.0-255,66,71875,92,275605
12479,0.001369,172.31.47.0-255,66,71941,92,275605
12480,0.003025,172.217.160.0-255,5738,77679,92,275605
12481,0.003031,172.31.47.0-255,66,77745,92,275605
12482,0.004682,172.217.160.0-255,4320,82065,92,275605
12483,0.004685,172.31.47.0-255,66,82131,92,275605
12484,0.004706,172.217.160.0-255,1484,83615,92,275605
12485,0.006356,172.217.160.0-255,4320,87935,92,275605
12486,0.006361,172.31.47.0-255,66,88001,92,275605
12487,0.008055,172.217.160.0-255,5738,93739,92,275605
12488,0.008062,172.31.47.0-255,66,93805,92,275605
12489,0.009748,172.217.160.0-255,5738,99543,92,275605
12490,0.009756,172.31.47.0-255,66,99609,92,275605
12491,0.011418,172.217.160.0-255,5738,105347,92,275605
12492,0.011424,172.31.47.0-255,66,105413,92,275605
12493,0.013086,172.217.160.0-255,5738,111151,92,275605
12494,0.013092,172.31.47.0-255,66,111217,92,275605
12495,0.014776,172.217.160.0-255,5738,116955,92,275605
12496,0.014785,172.31.47.0-255,66,117021,92,275605
12497,0.016448,172.217.160.0-255,5738,122759,92,275605
12498,0.016456,172.31.47.0-255,66,122825,92,275605
12499,0.018115,172.217.160.0-255,5738,128563,92,275605
12500,0.018122,172.31.47.0-255,66,128629,92,275605
12501,0.019783,172.217.160.0-255,5738,134367,92,275605
12502,0.019795,172.31.47.0-255,66,134433,92,275605
12503,0.021461,172.217.160.0-255,5738,140171,92,275605
12504,0.021468,172.31.47.0-255,66,140237,92,275605
12505,0.023129,172.217.160.0-255,5738,145975,92,275605
12506,0.023136,172.31.47.0-255,66,146041,92,275605
12507,0.02486,172.217.160.0-255,5738,151779,92,275605
12508,0.024866,172.31.47.0-255,66,151845,92,275605
12509,0.026538,172.217.160.0-255,5738,157583,92,275605
12510,0.026545,172.31.47.0-255,66,157649,92,275605
12511,0.028212,172.217.160.0-255,5738,163387,92,275605
12512,0.028219,172.31.47.0-255,66,163453,92,275605
12513,0.029868,172.217.160.0-255,5738,169191,92,275605
12514,0.029873,172.31.47.0-255,66,169257,92,275605
12515,0.030777,172.31.47.0-255,172,169429,92,275605
12516,0.030808,172.31.47.0-255,1112,170541,92,275605
12517,0.030865,172.31.47.0-255,1514,172055,92,275605
12518,0.030867,172.31.47.0-255,1514,173569,92,275605
12519,0.030872,172.31.47.0-255,1514,175083,92,275605
12520,0.030873,172.31.47.0-255,1514,176597,92,275605
12521,0.030891,172.31.47.0-255,1494,178091,92,275605
12522,0.031532,172.217.160.0-255,4320,182411,92,275605
12523,0.031538,172.31.47.0-255,66,182477,92,275605
12524,0.031564,172.217.160.0-255,1484,183961,92,275605
12525,0.032344,104.244.42.0-255,66,184027,92,275605
12526,0.032351,104.244.42.0-255,66,184093,92,275605
12527,0.032474,104.244.42.0-255,66,184159,92,275605
12528,0.033205,172.217.160.0-255,4320,188479,92,275605
12529,0.033212,172.31.47.0-255,66,188545,92,275605
12530,0.034881,172.217.160.0-255,5738,194283,92,275605
12531,0.034887,172.31.47.0-255,66,194349,92,275605
12532,0.036558,172.217.160.0-255,5738,200087,92,275605
12533,0.036563,172.31.47.0-255,66,200153,92,275605
12534,0.038228,172.217.160.0-255,5738,205891,92,275605
12535,0.038233,172.31.47.0-255,66,205957,92,275605
12536,0.039912,172.217.160.0-255,5738,211695,92,275605
12537,0.039919,172.31.47.0-255,66,211761,92,275605
12538,0.041587,172.217.160.0-255,5738,217499,92,275605
12539,0.041594,172.31.47.0-255,66,217565,92,275605
12540,0.043301,172.217.160.0-255,5738,223303,92,275605
12541,0.043307,172.31.47.0-255,66,223369,92,275605
12542,0.044978,172.217.160.0-255,5738,229107,92,275605
12543,0.044985,172.31.47.0-255,66,229173,92,275605
12544,0.046663,172.217.160.0-255,5738,234911,92,275605
12545,0.04667,172.31.47.0-255,66,234977,92,275605
12546,0.048347,172.217.160.0-255,5738,240715,92,275605
12547,0.048353,172.31.47.0-255,66,240781,92,275605
12548,0.050016,172.217.160.0-255,5738,246519,92,275605
12549,0.050024,172.31.47.0-255,66,246585,92,275605
12550,0.051696,172.217.160.0-255,5738,252323,92,275605
12551,0.051705,172.31.47.0-255,66,252389,92,275605
12552,0.053379,172.217.160.0-255,5738,258127,92,275605
12553,0.053384,172.31.47.0-255,66,258193,92,275605
12554,0.05505,172.217.160.0-255,5738,263931,92,275605
12555,0.055055,172.31.47.0-255,66,263997,92,275605
12556,0.056728,172.217.160.0-255,5738,269735,92,275605
12557,0.056734,172.31.47.0-255,66,269801,92,275605
12558,0.058403,172.217.160.0-255,5738,275539,92,275605
12559,0.058408,172.31.47.0-255,66,275605,92,275605
12560,0.0,172.31.47.0-255,105,105,92,105
12561,0.0,74.125.24.0-255,298,298,92,163333
12562,2.7e-05,172.31.47.0-255,66,364,92,163333
12563,3.3e-05,74.125.24.0-255,1484,1848,92,163333
12564,3.7e-05,172.31.47.0-255,66,1914,92,163333
12565,4.3e-05,74.125.24.0-255,4320,6234,92,163333
12566,4.5e-05,172.31.47.0-255,66,6300,92,163333
12567,4.8e-05,74.125.24.0-255,1484,7784,92,163333
12568,5.1e-05,172.31.47.0-255,66,7850,92,163333
12569,7.8e-05,74.125.24.0-255,5738,13588,92,163333
12570,8.2e-05,172.31.47.0-255,66,13654,92,163333
12571,0.000106,172.31.47.0-255,66,13720,92,163333
12572,0.000124,74.125.24.0-255,4667,18387,92,163333
12573,0.000127,172.31.47.0-255,66,18453,92,163333
12574,0.000145,172.31.47.0-255,66,18519,92,163333
12575,0.00015,74.125.24.0-255,3602,22121,92,163333
12576,0.000152,172.31.47.0-255,66,22187,92,163333
12577,0.000196,74.125.24.0-255,2902,25089,92,163333
12578,0.000199,172.31.47.0-255,66,25155,92,163333
12579,0.000227,172.31.47.0-255,66,25221,92,163333
12580,0.00025,74.125.24.0-255,2854,28075,92,163333
12581,0.000253,172.31.47.0-255,66,28141,92,163333
12582,0.000319,74.125.24.0-255,110,28251,92,163333
12583,0.000325,172.31.47.0-255,66,28317,92,163333
12584,0.000507,74.125.24.0-255,1484,29801,92,163333
12585,0.000511,172.31.47.0-255,66,29867,92,163333
12586,0.000526,74.125.24.0-255,2902,32769,92,163333
12587,0.000529,172.31.47.0-255,66,32835,92,163333
12588,0.000542,74.125.24.0-255,4320,37155,92,163333
12589,0.000545,172.31.47.0-255,66,37221,92,163333
12590,0.000551,74.125.24.0-255,4320,41541,92,163333
12591,0.000553,172.31.47.0-255,66,41607,92,163333
12592,0.00058,74.125.24.0-255,4320,45927,92,163333
12593,0.000584,172.31.47.0-255,66,45993,92,163333
12594,0.000587,74.125.24.0-255,1484,47477,92,163333
12595,0.000619,172.31.47.0-255,66,47543,92,163333
12596,0.000804,74.125.24.0-255,1484,49027,92,163333
12597,0.00082,74.125.24.0-255,2902,51929,92,163333
12598,0.000824,172.31.47.0-255,66,51995,92,163333
12599,0.000832,74.125.24.0-255,5738,57733,92,163333
12600,0.000835,172.31.47.0-255,66,57799,92,163333
12601,0.000854,74.125.24.0-255,4320,62119,92,163333
12602,0.000857,172.31.47.0-255,66,62185,92,163333
12603,0.000883,74.125.24.0-255,5738,67923,92,163333
12604,0.000885,172.31.47.0-255,66,67989,92,163333
12605,0.000903,74.125.24.0-255,1484,69473,92,163333
12606,0.000919,74.125.24.0-255,5738,75211,92,163333
12607,0.000923,172.31.47.0-255,66,75277,92,163333
12608,0.000946,74.125.24.0-255,6438,81715,92,163333
12609,0.00095,172.31.47.0-255,66,81781,92,163333
12610,0.001052,74.125.24.0-255,1484,83265,92,163333
12611,0.00107,74.125.24.0-255,2902,86167,92,163333
12612,0.001074,172.31.47.0-255,66,86233,92,163333
12613,0.001078,74.125.24.0-255,2902,89135,92,163333
12614,0.001081,172.31.47.0-255,66,89201,92,163333
12615,0.001109,74.125.24.0-255,2902,92103,92,163333
12616,0.001112,172.31.47.0-255,66,92169,92,163333
12617,0.001124,172.31.47.0-255,66,92235,92,163333
12618,0.001145,74.125.24.0-255,2902,95137,92,163333
12619,0.001148,172.31.47.0-255,66,95203,92,163333
12620,0.001178,172.31.47.0-255,66,95269,92,163333
12621,0.001184,74.125.24.0-255,5738,101007,92,163333
12622,0.001187,172.31.47.0-255,66,101073,92,163333
12623,0.001223,172.31.47.0-255,66,101139,92,163333
12624,0.00123,74.125.24.0-255,6438,107577,92,163333
12625,0.001232,172.31.47.0-255,66,107643,92,163333
12626,0.001315,74.125.24.0-255,1484,109127,92,163333
12627,0.00132,74.125.24.0-255,2902,112029,92,163333
12628,0.001324,172.31.47.0-255,66,112095,92,163333
12629,0.001329,74.125.24.0-255,2902,114997,92,163333
12630,0.001331,172.31.47.0-255,66,115063,92,163333
12631,0.001349,74.125.24.0-255,2902,117965,92,163333
12632,0.001351,172.31.47.0-255,66,118031,92,163333
12633,0.001356,74.125.24.0-255,5738,123769,92,163333
12634,0.001358,172.31.47.0-255,66,123835,92,163333
12635,0.001401,172.31.47.0-255,66,123901,92,163333
12636,0.001442,74.125.24.0-255,2902,126803,92,163333
12637,0.001446,172.31.47.0-255,66,126869,92,163333
12638,0.001462,74.125.24.0-255,2184,129053,92,163333
12639,0.001465,172.31.47.0-255,66,129119,92,163333
12640,0.001468,74.125.24.0-255,1484,130603,92,163333
12641,0.001473,74.125.24.0-255,2902,133505,92,163333
12642,0.001476,172.31.47.0-255,66,133571,92,163333
12643,0.001481,74.125.24.0-255,5738,139309,92,163333
12644,0.001484,172.31.47.0-255,66,139375,92,163333
12645,0.001524,172.31.47.0-255,66,139441,92,163333
12646,0.00154,74.125.24.0-255,1484,140925,92,163333
12647,0.001554,172.31.47.0-255,66,140991,92,163333
12648,0.001558,74.125.24.0-255,2902,143893,92,163333
12649,0.00156,172.31.47.0-255,66,143959,92,163333
12650,0.001614,172.31.47.0-255,66,144025,92,163333
12651,0.001625,172.31.47.0-255,66,144091,92,163333
12652,0.001643,74.125.24.0-255,2902,146993,92,163333
12653,0.001646,172.31.47.0-255,66,147059,92,163333
12654,0.001697,172.31.47.0-255,66,147125,92,163333
12655,0.001708,172.31.47.0-255,66,147191,92,163333
12656,0.001738,172.31.47.0-255,66,147257,92,163333
12657,0.001773,172.31.47.0-255,66,147323,92,163333
12658,0.001803,74.125.24.0-255,5020,152343,92,163333
12659,0.001807,172.31.47.0-255,66,152409,92,163333
12660,0.001825,172.31.47.0-255,66,152475,92,163333
12661,0.001827,74.125.24.0-255,766,153241,92,163333
12662,0.001846,74.125.24.0-255,1484,154725,92,163333
12663,0.001849,172.31.47.0-255,66,154791,92,163333
12664,0.001888,172.31.47.0-255,66,154857,92,163333
12665,0.001892,74.125.24.0-255,105,154962,92,163333
12666,0.008027,172.31.47.0-255,66,155028,92,163333
12667,0.008053,172.31.47.0-255,105,155133,92,163333
12668,0.01004,74.125.24.0-255,66,155199,92,163333
12669,0.029264,172.31.47.0-255,172,155371,92,163333
12670,0.029293,172.31.47.0-255,1107,156478,92,163333
12671,0.029342,172.31.47.0-255,1514,157992,92,163333
12672,0.029344,172.31.47.0-255,1514,159506,92,163333
12673,0.029345,172.31.47.0-255,1514,161020,92,163333
12674,0.029346,172.31.47.0-255,1514,162534,92,163333
12675,0.02937,172.31.47.0-255,535,163069,92,163333
12676,0.030833,104.244.42.0-255,66,163135,92,163333
12677,0.030843,104.244.42.0-255,66,163201,92,163333
12678,0.030928,104.244.42.0-255,66,163267,92,163333
12679,0.030931,104.244.42.0-255,66,163333,92,163333
12680,0.0,172.31.47.0-255,105,105,92,105
12681,0.0,74.125.24.0-255,153,153,92,267816
12682,2.3e-05,172.31.47.0-255,66,219,92,267816
12683,2.9e-05,74.125.24.0-255,1484,1703,92,267816
12684,3.2e-05,172.31.47.0-255,66,1769,92,267816
12685,3.6e-05,74.125.24.0-255,2902,4671,92,267816
12686,3.9e-05,172.31.47.0-255,66,4737,92,267816
12687,7.2e-05,74.125.24.0-255,5738,10475,92,267816
12688,7.4e-05,172.31.47.0-255,66,10541,92,267816
12689,0.000101,74.125.24.0-255,3635,14176,92,267816
12690,0.000103,172.31.47.0-255,66,14242,92,267816
12691,0.000126,74.125.24.0-255,4320,18562,92,267816
12692,0.000128,172.31.47.0-255,66,18628,92,267816
12693,0.000159,172.31.47.0-255,66,18694,92,267816
12694,0.000177,74.125.24.0-255,1484,20178,92,267816
12695,0.000179,172.31.47.0-255,66,20244,92,267816
12696,0.000211,74.125.24.0-255,2543,22787,92,267816
12697,0.000213,172.31.47.0-255,66,22853,92,267816
12698,0.000276,74.125.24.0-255,1484,24337,92,267816
12699,0.000279,172.31.47.0-255,66,24403,92,267816
12700,0.000284,74.125.24.0-255,2902,27305,92,267816
12701,0.000286,172.31.47.0-255,66,27371,92,267816
12702,0.000302,74.125.24.0-255,2902,30273,92,267816
12703,0.000305,172.31.47.0-255,66,30339,92,267816
12704,0.000315,74.125.24.0-255,7156,37495,92,267816
12705,0.000317,172.31.47.0-255,66,37561,92,267816
12706,0.000351,74.125.24.0-255,2543,40104,92,267816
12707,0.000354,172.31.47.0-255,66,40170,92,267816
12708,0.000392,74.125.24.0-255,2902,43072,92,267816
12709,0.000394,172.31.47.0-255,66,43138,92,267816
12710,0.000421,74.125.24.0-255,4320,47458,92,267816
12711,0.000423,172.31.47.0-255,66,47524,92,267816
12712,0.000456,172.31.47.0-255,66,47590,92,267816
12713,0.000458,74.125.24.0-255,1456,49046,92,267816
12714,0.000472,74.125.24.0-255,377,49423,92,267816
12715,0.000474,172.31.47.0-255,66,49489,92,267816
12716,0.000624,74.125.24.0-255,1484,50973,92,267816
12717,0.000628,74.125.24.0-255,2902,53875,92,267816
12718,0.00063,172.31.47.0-255,66,53941,92,267816
12719,0.000658,74.125.24.0-255,5738,59679,92,267816
12720,0.00066,172.31.47.0-255,66,59745,92,267816
12721,0.000663,74.125.24.0-255,1484,61229,92,267816
12722,0.0007,74.125.24.0-255,2902,64131,92,267816
12723,0.000702,172.31.47.0-255,66,64197,92,267816
12724,0.000733,74.125.24.0-255,6797,70994,92,267816
12725,0.000736,172.31.47.0-255,66,71060,92,267816
12726,0.00074,74.125.24.0-255,1484,72544,92,267816
12727,0.000768,172.31.47.0-255,66,72610,92,267816
12728,0.001528,74.125.24.0-255,1484,74094,92,267816
12729,0.001537,74.125.24.0-255,2902,76996,92,267816
12730,0.001541,172.31.47.0-255,66,77062,92,267816
12731,0.001546,74.125.24.0-255,2902,79964,92,267816
12732,0.001548,172.31.47.0-255,66,80030,92,267816
12733,0.001575,74.125.24.0-255,7156,87186,92,267816
12734,0.001581,172.31.47.0-255,66,87252,92,267816
12735,0.001586,74.125.24.0-255,2902,90154,92,267816
12736,0.001588,172.31.47.0-255,66,90220,92,267816
12737,0.001626,172.31.47.0-255,66,90286,92,267816
12738,0.00163,74.125.24.0-255,3602,93888,92,267816
12739,0.001632,172.31.47.0-255,66,93954,92,267816
12740,0.003582,74.125.24.0-255,1484,95438,92,267816
12741,0.003599,74.125.24.0-255,4320,99758,92,267816
12742,0.003603,172.31.47.0-255,66,99824,92,267816
12743,0.005598,74.125.24.0-255,4320,104144,92,267816
12744,0.005601,172.31.47.0-255,66,104210,92,267816
12745,0.005624,74.125.24.0-255,1484,105694,92,267816
12746,0.007575,74.125.24.0-255,4320,110014,92,267816
12747,0.007583,172.31.47.0-255,66,110080,92,267816
12748,0.009531,74.125.24.0-255,5738,115818,92,267816
12749,0.009539,172.31.47.0-255,66,115884,92,267816
12750,0.011515,74.125.24.0-255,5738,121622,92,267816
12751,0.011524,172.31.47.0-255,66,121688,92,267816
12752,0.01353,74.125.24.0-255,5738,127426,92,267816
12753,0.013538,172.31.47.0-255,66,127492,92,267816
12754,0.015508,74.125.24.0-255,5738,133230,92,267816
12755,0.015518,172.31.47.0-255,66,133296,92,267816
12756,0.017479,74.125.24.0-255,5738,139034,92,267816
12757,0.017487,172.31.47.0-255,66,139100,92,267816
12758,0.019423,74.125.24.0-255,5738,144838,92,267816
12759,0.019428,172.31.47.0-255,66,144904,92,267816
12760,0.021387,74.125.24.0-255,5738,150642,92,267816
12761,0.021393,172.31.47.0-255,66,150708,92,267816
12762,0.023398,74.125.24.0-255,5738,156446,92,267816
12763,0.023404,172.31.47.0-255,66,156512,92,267816
12764,0.025397,74.125.24.0-255,5738,162250,92,267816
12765,0.025404,172.31.47.0-255,66,162316,92,267816
12766,0.027368,74.125.24.0-255,5738,168054,92,267816
12767,0.027379,172.31.47.0-255,66,168120,92,267816
12768,0.027398,172.31.47.0-255,172,168292,92,267816
12769,0.027421,172.31.47.0-255,1107,169399,92,267816
12770,0.027484,172.31.47.0-255,1514,170913,92,267816
12771,0.027486,172.31.47.0-255,1514,172427,92,267816
12772,0.027487,172.31.47.0-255,1514,173941,92,267816
12773,0.027488,172.31.47.0-255,1514,175455,92,267816
12774,0.027518,172.31.47.0-255,1499,176954,92,267816
12775,0.028987,104.244.42.0-255,66,177020,92,267816
12776,0.029014,104.244.42.0-255,66,177086,92,267816
12777,0.02905,104.244.42.0-255,66,177152,92,267816
12778,0.029094,104.244.42.0-255,66,177218,92,267816
12779,0.02936,74.125.24.0-255,5738,182956,92,267816
12780,0.029365,172.31.47.0-255,66,183022,92,267816
12781,0.031388,74.125.24.0-255,5738,188760,92,267816
12782,0.031395,172.31.47.0-255,66,188826,92,267816
12783,0.031563,104.244.42.0-255,108,188934,92,267816
12784,0.031568,172.31.47.0-255,66,189000,92,267816
12785,0.033366,74.125.24.0-255,5738,194738,92,267816
12786,0.033373,172.31.47.0-255,66,194804,92,267816
12787,0.035319,74.125.24.0-255,5738,200542,92,267816
12788,0.035324,172.31.47.0-255,66,200608,92,267816
12789,0.037303,74.125.24.0-255,5738,206346,92,267816
12790,0.037309,172.31.47.0-255,66,206412,92,267816
12791,0.039281,74.125.24.0-255,5738,212150,92,267816
12792,0.039286,172.31.47.0-255,66,212216,92,267816
12793,0.041273,74.125.24.0-255,5738,217954,92,267816
12794,0.041284,172.31.47.0-255,66,218020,92,267816
12795,0.043275,74.125.24.0-255,5738,223758,92,267816
12796,0.043284,172.31.47.0-255,66,223824,92,267816
12797,0.045273,74.125.24.0-255,5738,229562,92,267816
12798,0.045278,172.31.47.0-255,66,229628,92,267816
12799,0.047294,74.125.24.0-255,2902,232530,92,267816
12800,0.0473,172.31.47.0-255,66,232596,92,267816
12801,0.047351,74.125.24.0-255,2902,235498,92,267816
12802,0.047354,172.31.47.0-255,66,235564,92,267816
12803,0.049265,74.125.24.0-255,1484,237048,92,267816
12804,0.049332,74.125.24.0-255,4320,241368,92,267816
12805,0.049338,172.31.47.0-255,66,241434,92,267816
12806,0.051332,74.125.24.0-255,5738,247172,92,267816
12807,0.051337,172.31.47.0-255,66,247238,92,267816
12808,0.053358,74.125.24.0-255,5738,252976,92,267816
12809,0.053364,172.31.47.0-255,66,253042,92,267816
12810,0.055341,74.125.24.0-255,4320,257362,92,267816
12811,0.055345,172.31.47.0-255,66,257428,92,267816
12812,0.055374,74.125.24.0-255,1484,258912,92,267816
12813,0.057296,74.125.24.0-255,2902,261814,92,267816
12814,0.057302,172.31.47.0-255,66,261880,92,267816
12815,0.057337,74.125.24.0-255,1484,263364,92,267816
12816,0.059287,74.125.24.0-255,2902,266266,92,267816
12817,0.059292,172.31.47.0-255,66,266332,92,267816
12818,0.059322,74.125.24.0-255,1484,267816,92,267816
12819,0.0,74.125.24.0-255,153,153,92,226349
12820,3.1e-05,172.31.47.0-255,66,219,92,226349
12821,3.7e-05,74.125.24.0-255,1484,1703,92,226349
12822,4.1e-05,172.31.47.0-255,66,1769,92,226349
12823,4.5e-05,74.125.24.0-255,2902,4671,92,226349
12824,4.7e-05,172.31.47.0-255,66,4737,92,226349
12825,6.3e-05,74.125.24.0-255,7156,11893,92,226349
12826,6.6e-05,172.31.47.0-255,66,11959,92,226349
12827,6.9e-05,74.125.24.0-255,2172,14131,92,226349
12828,7.2e-05,172.31.47.0-255,66,14197,92,226349
12829,0.000112,74.125.24.0-255,7156,21353,92,226349
12830,0.000116,172.31.47.0-255,66,21419,92,226349
12831,0.000148,172.31.47.0-255,66,21485,92,226349
12832,0.000152,74.125.24.0-255,1484,22969,92,226349
12833,0.000154,172.31.47.0-255,66,23035,92,226349
12834,0.000157,74.125.24.0-255,2902,25937,92,226349
12835,0.000159,172.31.47.0-255,66,26003,92,226349
12836,0.000169,74.125.24.0-255,4320,30323,92,226349
12837,0.000171,172.31.47.0-255,66,30389,92,226349
12838,0.000196,74.125.24.0-255,1484,31873,92,226349
12839,0.000199,172.31.47.0-255,66,31939,92,226349
12840,0.000216,172.31.47.0-255,66,32005,92,226349
12841,0.000251,74.125.24.0-255,4320,36325,92,226349
12842,0.000255,172.31.47.0-255,66,36391,92,226349
12843,0.000281,74.125.24.0-255,5711,42102,92,226349
12844,0.000284,172.31.47.0-255,66,42168,92,226349
12845,0.000304,74.125.24.0-255,376,42544,92,226349
12846,0.000307,172.31.47.0-255,66,42610,92,226349
12847,0.000597,74.125.24.0-255,1484,44094,92,226349
12848,0.000601,172.31.47.0-255,66,44160,92,226349
12849,0.000627,74.125.24.0-255,2902,47062,92,226349
12850,0.00063,172.31.47.0-255,66,47128,92,226349
12851,0.000636,74.125.24.0-255,5738,52866,92,226349
12852,0.000638,172.31.47.0-255,66,52932,92,226349
12853,0.000641,74.125.24.0-255,2902,55834,92,226349
12854,0.000648,172.31.47.0-255,66,55900,92,226349
12855,0.000676,74.125.24.0-255,4320,60220,92,226349
12856,0.000679,172.31.47.0-255,66,60286,92,226349
12857,0.000718,172.31.47.0-255,66,60352,92,226349
12858,0.000725,74.125.24.0-255,6438,66790,92,226349
12859,0.000727,172.31.47.0-255,66,66856,92,226349
12860,0.001655,74.125.24.0-255,1484,68340,92,226349
12861,0.001665,74.125.24.0-255,2902,71242,92,226349
12862,0.001668,172.31.47.0-255,66,71308,92,226349
12863,0.001674,74.125.24.0-255,5738,77046,92,226349
12864,0.001676,172.31.47.0-255,66,77112,92,226349
12865,0.001725,172.31.47.0-255,66,77178,92,226349
12866,0.001762,74.125.24.0-255,7156,84334,92,226349
12867,0.001764,172.31.47.0-255,66,84400,92,226349
12868,0.00178,74.125.24.0-255,3602,88002,92,226349
12869,0.001782,172.31.47.0-255,66,88068,92,226349
12870,0.004271,74.125.24.0-255,1484,89552,92,226349
12871,0.004285,74.125.24.0-255,4320,93872,92,226349
12872,0.004287,172.31.47.0-255,66,93938,92,226349
12873,0.00679,74.125.24.0-255,5738,99676,92,226349
12874,0.006796,172.31.47.0-255,66,99742,92,226349
12875,0.009346,74.125.24.0-255,5738,105480,92,226349
12876,0.009354,172.31.47.0-255,66,105546,92,226349
12877,0.011915,74.125.24.0-255,5738,111284,92,226349
12878,0.011922,172.31.47.0-255,66,111350,92,226349
12879,0.014467,74.125.24.0-255,5738,117088,92,226349
12880,0.014476,172.31.47.0-255,66,117154,92,226349
12881,0.017012,74.125.24.0-255,5738,122892,92,226349
12882,0.017019,172.31.47.0-255,66,122958,92,226349
12883,0.019533,74.125.24.0-255,5738,128696,92,226349
12884,0.01954,172.31.47.0-255,66,128762,92,226349
12885,0.022065,74.125.24.0-255,5738,134500,92,226349
12886,0.022071,172.31.47.0-255,66,134566,92,226349
12887,0.024586,74.125.24.0-255,5738,140304,92,226349
12888,0.024593,172.31.47.0-255,66,140370,92,226349
12889,0.027109,74.125.24.0-255,5738,146108,92,226349
12890,0.027115,172.31.47.0-255,66,146174,92,226349
12891,0.029651,74.125.24.0-255,5738,151912,92,226349
12892,0.029663,172.31.47.0-255,66,151978,92,226349
12893,0.031785,172.31.47.0-255,172,152150,92,226349
12894,0.031819,172.31.47.0-255,1111,153261,92,226349
12895,0.031887,172.31.47.0-255,1514,154775,92,226349
12896,0.031889,172.31.47.0-255,1514,156289,92,226349
12897,0.03189,172.31.47.0-255,1514,157803,92,226349
12898,0.031891,172.31.47.0-255,1514,159317,92,226349
12899,0.031892,172.31.47.0-255,1496,160813,92,226349
12900,0.032197,74.125.24.0-255,5738,166551,92,226349
12901,0.032202,172.31.47.0-255,66,166617,92,226349
12902,0.033332,104.244.42.0-255,66,166683,92,226349
12903,0.033365,104.244.42.0-255,66,166749,92,226349
12904,0.03347,104.244.42.0-255,66,166815,92,226349
12905,0.034213,104.244.42.0-255,108,166923,92,226349
12906,0.034216,172.31.47.0-255,66,166989,92,226349
12907,0.034724,74.125.24.0-255,2902,169891,92,226349
12908,0.034728,172.31.47.0-255,66,169957,92,226349
12909,0.034779,74.125.24.0-255,2902,172859,92,226349
12910,0.034783,172.31.47.0-255,66,172925,92,226349
12911,0.037265,74.125.24.0-255,2902,175827,92,226349
12912,0.03727,172.31.47.0-255,66,175893,92,226349
12913,0.037313,74.125.24.0-255,2902,178795,92,226349
12914,0.037317,172.31.47.0-255,66,178861,92,226349
12915,0.039801,74.125.24.0-255,2902,181763,92,226349
12916,0.039805,172.31.47.0-255,66,181829,92,226349
12917,0.039836,74.125.24.0-255,2902,184731,92,226349
12918,0.039839,172.31.47.0-255,66,184797,92,226349
12919,0.04232,74.125.24.0-255,2902,187699,92,226349
12920,0.042327,172.31.47.0-255,66,187765,92,226349
12921,0.042358,74.125.24.0-255,2902,190667,92,226349
12922,0.042361,172.31.47.0-255,66,190733,92,226349
12923,0.044861,74.125.24.0-255,2902,193635,92,226349
12924,0.044872,172.31.47.0-255,66,193701,92,226349
12925,0.044891,74.125.24.0-255,2902,196603,92,226349
12926,0.044895,172.31.47.0-255,66,196669,92,226349
12927,0.047374,74.125.24.0-255,2902,199571,92,226349
12928,0.04738,172.31.47.0-255,66,199637,92,226349
12929,0.047426,74.125.24.0-255,2902,202539,92,226349
12930,0.047432,172.31.47.0-255,66,202605,92,226349
12931,0.049888,74.125.24.0-255,2902,205507,92,226349
12932,0.049911,172.31.47.0-255,66,205573,92,226349
12933,0.049939,74.125.24.0-255,2902,208475,92,226349
12934,0.049943,172.31.47.0-255,66,208541,92,226349
12935,0.052444,74.125.24.0-255,2902,211443,92,226349
12936,0.052448,172.31.47.0-255,66,211509,92,226349
12937,0.052477,74.125.24.0-255,2902,214411,92,226349
12938,0.052479,172.31.47.0-255,66,214477,92,226349
12939,0.05495,74.125.24.0-255,2902,217379,92,226349
12940,0.054955,172.31.47.0-255,66,217445,92,226349
12941,0.054985,74.125.24.0-255,2902,220347,92,226349
12942,0.054988,172.31.47.0-255,66,220413,92,226349
12943,0.057461,74.125.24.0-255,2902,223315,92,226349
12944,0.057467,172.31.47.0-255,66,223381,92,226349
12945,0.057512,74.125.24.0-255,2902,226283,92,226349
12946,0.057515,172.31.47.0-255,66,226349,92,226349
12947,0.0,74.125.24.0-255,153,153,92,314226
12948,2.4e-05,172.31.47.0-255,66,219,92,314226
12949,2.9e-05,74.125.24.0-255,1484,1703,92,314226
12950,3.3e-05,172.31.47.0-255,66,1769,92,314226
12951,3.7e-05,74.125.24.0-255,2902,4671,92,314226
12952,3.9e-05,172.31.47.0-255,66,4737,92,314226
12953,6.4e-05,74.125.24.0-255,1484,6221,92,314226
12954,6.9e-05,172.31.47.0-255,66,6287,92,314226
12955,9.7e-05,74.125.24.0-255,2902,9189,92,314226
12956,0.0001,172.31.47.0-255,66,9255,92,314226
12957,0.000125,74.125.24.0-255,2902,12157,92,314226
12958,0.000127,172.31.47.0-255,66,12223,92,314226
12959,0.000158,74.125.24.0-255,2209,14432,92,314226
12960,0.000162,172.31.47.0-255,66,14498,92,314226
12961,0.000166,74.125.24.0-255,1484,15982,92,314226
12962,0.000168,172.31.47.0-255,66,16048,92,314226
12963,0.000172,74.125.24.0-255,2902,18950,92,314226
12964,0.000173,172.31.47.0-255,66,19016,92,314226
12965,0.000207,74.125.24.0-255,5738,24754,92,314226
12966,0.00021,172.31.47.0-255,66,24820,92,314226
12967,0.000216,74.125.24.0-255,6797,31617,92,314226
12968,0.000218,172.31.47.0-255,66,31683,92,314226
12969,0.00022,74.125.24.0-255,1484,33167,92,314226
12970,0.000222,172.31.47.0-255,66,33233,92,314226
12971,0.000251,74.125.24.0-255,5738,38971,92,314226
12972,0.000254,172.31.47.0-255,66,39037,92,314226
12973,0.00026,74.125.24.0-255,5738,44775,92,314226
12974,0.000262,172.31.47.0-255,66,44841,92,314226
12975,0.000287,74.125.24.0-255,3961,48802,92,314226
12976,0.00029,172.31.47.0-255,66,48868,92,314226
12977,0.000326,74.125.24.0-255,1484,50352,92,314226
12978,0.000329,172.31.47.0-255,66,50418,92,314226
12979,0.000333,74.125.24.0-255,2902,53320,92,314226
12980,0.000335,172.31.47.0-255,66,53386,92,314226
12981,0.000354,74.125.24.0-255,4320,57706,92,314226
12982,0.000357,172.31.47.0-255,66,57772,92,314226
12983,0.00038,74.125.24.0-255,4320,62092,92,314226
12984,0.000383,172.31.47.0-255,66,62158,92,314226
12985,0.000403,74.125.24.0-255,1484,63642,92,314226
12986,0.000405,172.31.47.0-255,66,63708,92,314226
12987,0.000408,74.125.24.0-255,2818,66526,92,314226
12988,0.000414,172.31.47.0-255,66,66592,92,314226
12989,0.000703,74.125.24.0-255,130,66722,92,314226
12990,0.000708,172.31.47.0-255,66,66788,92,314226
12991,0.000832,74.125.24.0-255,1484,68272,92,314226
12992,0.000837,172.31.47.0-255,66,68338,92,314226
12993,0.000846,74.125.24.0-255,2902,71240,92,314226
12994,0.000855,172.31.47.0-255,66,71306,92,314226
12995,0.00086,74.125.24.0-255,2902,74208,92,314226
12996,0.000862,172.31.47.0-255,66,74274,92,314226
12997,0.000895,74.125.24.0-255,2902,77176,92,314226
12998,0.000897,172.31.47.0-255,66,77242,92,314226
12999,0.000919,74.125.24.0-255,1484,78726,92,314226
13000,0.000939,172.31.47.0-255,66,78792,92,314226
13001,0.000944,74.125.24.0-255,2902,81694,92,314226
13002,0.000946,172.31.47.0-255,66,81760,92,314226
13003,0.000973,74.125.24.0-255,7156,88916,92,314226
13004,0.000977,172.31.47.0-255,66,88982,92,314226
13005,0.001004,74.125.24.0-255,2543,91525,92,314226
13006,0.001008,172.31.47.0-255,66,91591,92,314226
13007,0.001072,74.125.24.0-255,1484,93075,92,314226
13008,0.001079,74.125.24.0-255,2902,95977,92,314226
13009,0.001082,172.31.47.0-255,66,96043,92,314226
13010,0.001085,74.125.24.0-255,1484,97527,92,314226
13011,0.001112,74.125.24.0-255,4320,101847,92,314226
13012,0.001115,172.31.47.0-255,66,101913,92,314226
13013,0.001121,74.125.24.0-255,4320,106233,92,314226
13014,0.001123,172.31.47.0-255,66,106299,92,314226
13015,0.001148,74.125.24.0-255,4320,110619,92,314226
13016,0.001152,172.31.47.0-255,66,110685,92,314226
13017,0.001193,74.125.24.0-255,5301,115986,92,314226
13018,0.00122,172.31.47.0-255,66,116052,92,314226
13019,0.001476,74.125.24.0-255,1484,117536,92,314226
13020,0.001482,74.125.24.0-255,1484,119020,92,314226
13021,0.001486,172.31.47.0-255,66,119086,92,314226
13022,0.001504,74.125.24.0-255,1484,120570,92,314226
13023,0.001511,74.125.24.0-255,5738,126308,92,314226
13024,0.001513,172.31.47.0-255,66,126374,92,314226
13025,0.001555,74.125.24.0-255,2902,129276,92,314226
13026,0.001558,172.31.47.0-255,66,129342,92,314226
13027,0.001569,74.125.24.0-255,5738,135080,92,314226
13028,0.001576,172.31.47.0-255,66,135146,92,314226
13029,0.001588,74.125.24.0-255,1484,136630,92,314226
13030,0.001597,74.125.24.0-255,5020,141650,92,314226
13031,0.00161,172.31.47.0-255,66,141716,92,314226
13032,0.002301,74.125.24.0-255,1484,143200,92,314226
13033,0.00231,74.125.24.0-255,2902,146102,92,314226
13034,0.002313,172.31.47.0-255,66,146168,92,314226
13035,0.002345,74.125.24.0-255,5738,151906,92,314226
13036,0.002347,172.31.47.0-255,66,151972,92,314226
13037,0.002373,74.125.24.0-255,7156,159128,92,314226
13038,0.002375,172.31.47.0-255,66,159194,92,314226
13039,0.0024,74.125.24.0-255,5738,164932,92,314226
13040,0.002403,74.125.24.0-255,2902,167834,92,314226
13041,0.002406,172.31.47.0-255,66,167900,92,314226
13042,0.002408,172.31.47.0-255,66,167966,92,314226
13043,0.004759,74.125.24.0-255,1484,169450,92,314226
13044,0.004783,74.125.24.0-255,4320,173770,92,314226
13045,0.004787,172.31.47.0-255,66,173836,92,314226
13046,0.007173,74.125.24.0-255,5738,179574,92,314226
13047,0.007179,172.31.47.0-255,66,179640,92,314226
13048,0.009514,74.125.24.0-255,5738,185378,92,314226
13049,0.009527,172.31.47.0-255,66,185444,92,314226
13050,0.011855,74.125.24.0-255,5738,191182,92,314226
13051,0.011866,172.31.47.0-255,66,191248,92,314226
13052,0.014191,74.125.24.0-255,5738,196986,92,314226
13053,0.014199,172.31.47.0-255,66,197052,92,314226
13054,0.016574,74.125.24.0-255,5738,202790,92,314226
13055,0.016582,172.31.47.0-255,66,202856,92,314226
13056,0.018936,74.125.24.0-255,5738,208594,92,314226
13057,0.018943,172.31.47.0-255,66,208660,92,314226
13058,0.021254,74.125.24.0-255,5738,214398,92,314226
13059,0.021261,172.31.47.0-255,66,214464,92,314226
13060,0.02359,74.125.24.0-255,5738,220202,92,314226
13061,0.023597,172.31.47.0-255,66,220268,92,314226
13062,0.02595,74.125.24.0-255,5738,226006,92,314226
13063,0.025957,172.31.47.0-255,66,226072,92,314226
13064,0.028344,74.125.24.0-255,5738,231810,92,314226
13065,0.02835,172.31.47.0-255,66,231876,92,314226
13066,0.030734,74.125.24.0-255,5738,237614,92,314226
13067,0.03074,172.31.47.0-255,66,237680,92,314226
13068,0.030833,172.31.47.0-255,172,237852,92,314226
13069,0.030881,172.31.47.0-255,1111,238963,92,314226
13070,0.030944,172.31.47.0-255,1514,240477,92,314226
13071,0.030946,172.31.47.0-255,1514,241991,92,314226
13072,0.030947,172.31.47.0-255,1514,243505,92,314226
13073,0.030948,172.31.47.0-255,1514,245019,92,314226
13074,0.030977,172.31.47.0-255,1495,246514,92,314226
13075,0.032371,104.244.42.0-255,66,246580,92,314226
13076,0.032429,104.244.42.0-255,66,246646,92,314226
13077,0.032601,104.244.42.0-255,66,246712,92,314226
13078,0.032623,104.244.42.0-255,66,246778,92,314226
13079,0.033063,74.125.24.0-255,2902,249680,92,314226
13080,0.033066,172.31.47.0-255,66,249746,92,314226
13081,0.0331,74.125.24.0-255,2902,252648,92,314226
13082,0.033104,172.31.47.0-255,66,252714,92,314226
13083,0.033166,104.244.42.0-255,108,252822,92,314226
13084,0.033169,172.31.47.0-255,66,252888,92,314226
13085,0.035406,74.125.24.0-255,4320,257208,92,314226
13086,0.035411,172.31.47.0-255,66,257274,92,314226
13087,0.035445,74.125.24.0-255,1484,258758,92,314226
13088,0.037744,74.125.24.0-255,4320,263078,92,314226
13089,0.037749,172.31.47.0-255,66,263144,92,314226
13090,0.040095,74.125.24.0-255,5738,268882,92,314226
13091,0.0401,172.31.47.0-255,66,268948,92,314226
13092,0.042451,74.125.24.0-255,1484,270432,92,314226
13093,0.042469,74.125.24.0-255,4320,274752,92,314226
13094,0.042473,172.31.47.0-255,66,274818,92,314226
13095,0.04479,74.125.24.0-255,5738,280556,92,314226
13096,0.044796,172.31.47.0-255,66,280622,92,314226
13097,0.047138,74.125.24.0-255,5738,286360,92,314226
13098,0.047141,172.31.47.0-255,66,286426,92,314226
13099,0.049503,74.125.24.0-255,4320,290746,92,314226
13100,0.049508,172.31.47.0-255,66,290812,92,314226
13101,0.049536,74.125.24.0-255,1484,292296,92,314226
13102,0.05188,74.125.24.0-255,4320,296616,92,314226
13103,0.051884,172.31.47.0-255,66,296682,92,314226
13104,0.05422,74.125.24.0-255,5738,302420,92,314226
13105,0.054224,172.31.47.0-255,66,302486,92,314226
13106,0.05657,74.125.24.0-255,5738,308224,92,314226
13107,0.056575,172.31.47.0-255,66,308290,92,314226
13108,0.05893,74.125.24.0-255,2902,311192,92,314226
13109,0.058935,172.31.47.0-255,66,311258,92,314226
13110,0.058965,74.125.24.0-255,2902,314160,92,314226
13111,0.058967,172.31.47.0-255,66,314226,92,314226
13112,0.0,172.217.194.0-255,153,153,92,214062
13113,2.4e-05,172.31.47.0-255,66,219,92,214062
13114,3.1e-05,172.217.194.0-255,1484,1703,92,214062
13115,3.6e-05,172.31.47.0-255,66,1769,92,214062
13116,4.2e-05,172.217.194.0-255,2902,4671,92,214062
13117,4.5e-05,172.31.47.0-255,66,4737,92,214062
13118,5.3e-05,172.217.194.0-255,7156,11893,92,214062
13119,5.5e-05,172.31.47.0-255,66,11959,92,214062
13120,6e-05,172.217.194.0-255,2100,14059,92,214062
13121,6.2e-05,172.31.47.0-255,66,14125,92,214062
13122,0.000123,172.217.194.0-255,1484,15609,92,214062
13123,0.000125,172.31.47.0-255,66,15675,92,214062
13124,0.00013,172.217.194.0-255,2902,18577,92,214062
13125,0.000132,172.31.47.0-255,66,18643,92,214062
13126,0.000152,172.217.194.0-255,5738,24381,92,214062
13127,0.000154,172.31.47.0-255,66,24447,92,214062
13128,0.000193,172.217.194.0-255,2902,27349,92,214062
13129,0.000196,172.31.47.0-255,66,27415,92,214062
13130,0.000215,172.217.194.0-255,6797,34212,92,214062
13131,0.000218,172.31.47.0-255,66,34278,92,214062
13132,0.000229,172.31.47.0-255,66,34344,92,214062
13133,0.000256,172.217.194.0-255,3961,38305,92,214062
13134,0.000259,172.31.47.0-255,66,38371,92,214062
13135,0.000426,172.217.194.0-255,1484,39855,92,214062
13136,0.00043,172.31.47.0-255,66,39921,92,214062
13137,0.000447,172.217.194.0-255,2902,42823,92,214062
13138,0.00045,172.31.47.0-255,66,42889,92,214062
13139,0.000457,172.217.194.0-255,5738,48627,92,214062
13140,0.00046,172.31.47.0-255,66,48693,92,214062
13141,0.000511,172.217.194.0-255,4320,53013,92,214062
13142,0.000515,172.31.47.0-255,66,53079,92,214062
13143,0.000535,172.217.194.0-255,3124,56203,92,214062
13144,0.000539,172.217.194.0-255,1484,57687,92,214062
13145,0.000549,172.31.47.0-255,66,57753,92,214062
13146,0.000566,172.217.194.0-255,2902,60655,92,214062
13147,0.000572,172.217.194.0-255,5738,66393,92,214062
13148,0.000583,172.31.47.0-255,66,66459,92,214062
13149,0.000628,172.31.47.0-255,66,66525,92,214062
13150,0.000705,172.217.194.0-255,1484,68009,92,214062
13151,0.00071,172.217.194.0-255,2902,70911,92,214062
13152,0.000715,172.217.194.0-255,4320,75231,92,214062
13153,0.000739,172.31.47.0-255,66,75297,92,214062
13154,0.000743,172.217.194.0-255,1484,76781,92,214062
13155,0.00076,172.31.47.0-255,66,76847,92,214062
13156,0.000843,172.217.194.0-255,1484,78331,92,214062
13157,0.000847,172.217.194.0-255,2902,81233,92,214062
13158,0.000853,172.217.194.0-255,5738,86971,92,214062
13159,0.000858,172.217.194.0-255,2902,89873,92,214062
13160,0.000866,172.31.47.0-255,66,89939,92,214062
13161,0.000903,172.31.47.0-255,66,90005,92,214062
13162,0.000951,172.31.47.0-255,66,90071,92,214062
13163,0.000963,172.217.194.0-255,3602,93673,92,214062
13164,0.000965,172.217.194.0-255,1484,95157,92,214062
13165,0.000976,172.217.194.0-255,4320,99477,92,214062
13166,0.000988,172.217.194.0-255,4320,103797,92,214062
13167,0.000997,172.217.194.0-255,1484,105281,92,214062
13168,0.001001,172.217.194.0-255,2902,108183,92,214062
13169,0.001026,172.31.47.0-255,66,108249,92,214062
13170,0.001056,172.217.194.0-255,2902,111151,92,214062
13171,0.001059,172.217.194.0-255,2902,114053,92,214062
13172,0.001068,172.217.194.0-255,1484,115537,92,214062
13173,0.001081,172.31.47.0-255,66,115603,92,214062
13174,0.001105,172.217.194.0-255,5738,121341,92,214062
13175,0.001114,172.31.47.0-255,66,121407,92,214062
13176,0.001124,172.217.194.0-255,4320,125727,92,214062
13177,0.001142,172.31.47.0-255,66,125793,92,214062
13178,0.001158,172.217.194.0-255,5738,131531,92,214062
13179,0.00117,172.217.194.0-255,2184,133715,92,214062
13180,0.001179,172.31.47.0-255,66,133781,92,214062
13181,0.001815,172.217.194.0-255,1484,135265,92,214062
13182,0.001821,172.217.194.0-255,2902,138167,92,214062
13183,0.001824,172.31.47.0-255,66,138233,92,214062
13184,0.001848,172.217.194.0-255,5738,143971,92,214062
13185,0.001851,172.31.47.0-255,66,144037,92,214062
13186,0.001855,172.217.194.0-255,2902,146939,92,214062
13187,0.001863,172.31.47.0-255,66,147005,92,214062
13188,0.001875,172.217.194.0-255,2902,149907,92,214062
13189,0.001887,172.217.194.0-255,7156,157063,92,214062
13190,0.001904,172.31.47.0-255,66,157129,92,214062
13191,0.001912,172.217.194.0-255,2902,160031,92,214062
13192,0.001916,172.31.47.0-255,66,160097,92,214062
13193,0.001927,172.217.194.0-255,5738,165835,92,214062
13194,0.001947,172.217.194.0-255,2184,168019,92,214062
13195,0.001951,172.217.194.0-255,4320,172339,92,214062
13196,0.001961,172.31.47.0-255,66,172405,92,214062
13197,0.00198,172.217.194.0-255,7156,179561,92,214062
13198,0.001985,172.217.194.0-255,4320,183881,92,214062
13199,0.00199,172.31.47.0-255,66,183947,92,214062
13200,0.002087,172.31.47.0-255,66,184013,92,214062
13201,0.00211,172.217.194.0-255,766,184779,92,214062
13202,0.002116,172.217.194.0-255,5738,190517,92,214062
13203,0.002141,172.217.194.0-255,1484,192001,92,214062
13204,0.002191,172.31.47.0-255,66,192067,92,214062
13205,0.002227,172.31.47.0-255,66,192133,92,214062
13206,0.002265,172.217.194.0-255,7156,199289,92,214062
13207,0.002285,172.31.47.0-255,66,199355,92,214062
13208,0.002291,172.217.194.0-255,5158,204513,92,214062
13209,0.002294,172.217.194.0-255,105,204618,92,214062
13210,0.002305,172.31.47.0-255,66,204684,92,214062
13211,0.021815,172.31.47.0-255,105,204789,92,214062
13212,0.024107,172.217.194.0-255,66,204855,92,214062
13213,0.049541,172.31.47.0-255,172,205027,92,214062
13214,0.049577,172.31.47.0-255,1103,206130,92,214062
13215,0.049661,172.31.47.0-255,1514,207644,92,214062
13216,0.049663,172.31.47.0-255,1514,209158,92,214062
13217,0.049664,172.31.47.0-255,1514,210672,92,214062
13218,0.049665,172.31.47.0-255,1514,212186,92,214062
13219,0.049666,172.31.47.0-255,1504,213690,92,214062
13220,0.051078,104.244.42.0-255,66,213756,92,214062
13221,0.051201,104.244.42.0-255,66,213822,92,214062
13222,0.051271,104.244.42.0-255,66,213888,92,214062
13223,0.051856,104.244.42.0-255,108,213996,92,214062
13224,0.051865,172.31.47.0-255,66,214062,92,214062
13225,0.0,172.217.194.0-255,153,153,92,250858
13226,1.5e-05,172.31.47.0-255,66,219,92,250858
13227,2.1e-05,172.217.194.0-255,1484,1703,92,250858
13228,2.5e-05,172.31.47.0-255,66,1769,92,250858
13229,3.7e-05,172.217.194.0-255,2902,4671,92,250858
13230,4e-05,172.31.47.0-255,66,4737,92,250858
13231,7.7e-05,172.217.194.0-255,7156,11893,92,250858
13232,7.9e-05,172.31.47.0-255,66,11959,92,250858
13233,8.3e-05,172.217.194.0-255,2254,14213,92,250858
13234,8.5e-05,172.31.47.0-255,66,14279,92,250858
13235,0.000126,172.31.47.0-255,66,14345,92,250858
13236,0.000156,172.217.194.0-255,2902,17247,92,250858
13237,0.000158,172.31.47.0-255,66,17313,92,250858
13238,0.000179,172.217.194.0-255,2543,19856,92,250858
13239,0.000181,172.31.47.0-255,66,19922,92,250858
13240,0.000186,172.217.194.0-255,4320,24242,92,250858
13241,0.000188,172.31.47.0-255,66,24308,92,250858
13242,0.000218,172.217.194.0-255,1484,25792,92,250858
13243,0.00022,172.31.47.0-255,66,25858,92,250858
13244,0.000233,172.31.47.0-255,66,25924,92,250858
13245,0.000246,172.31.47.0-255,66,25990,92,250858
13246,0.000274,172.217.194.0-255,2902,28892,92,250858
13247,0.000276,172.31.47.0-255,66,28958,92,250858
13248,0.000282,172.217.194.0-255,5650,34608,92,250858
13249,0.000284,172.31.47.0-255,66,34674,92,250858
13250,0.000438,172.217.194.0-255,119,34793,92,250858
13251,0.000442,172.31.47.0-255,66,34859,92,250858
13252,0.000466,172.217.194.0-255,383,35242,92,250858
13253,0.000468,172.31.47.0-255,66,35308,92,250858
13254,0.000697,172.217.194.0-255,1484,36792,92,250858
13255,0.000703,172.217.194.0-255,2902,39694,92,250858
13256,0.000708,172.217.194.0-255,5738,45432,92,250858
13257,0.000741,172.31.47.0-255,66,45498,92,250858
13258,0.000748,172.217.194.0-255,7156,52654,92,250858
13259,0.00075,172.217.194.0-255,1484,54138,92,250858
13260,0.000755,172.31.47.0-255,66,54204,92,250858
13261,0.000795,172.217.194.0-255,2184,56388,92,250858
13262,0.000805,172.31.47.0-255,66,56454,92,250858
13263,0.001014,172.217.194.0-255,1484,57938,92,250858
13264,0.001027,172.217.194.0-255,2902,60840,92,250858
13265,0.00103,172.31.47.0-255,66,60906,92,250858
13266,0.001033,172.217.194.0-255,1484,62390,92,250858
13267,0.001055,172.217.194.0-255,4320,66710,92,250858
13268,0.001068,172.217.194.0-255,2902,69612,92,250858
13269,0.001071,172.31.47.0-255,66,69678,92,250858
13270,0.00111,172.31.47.0-255,66,69744,92,250858
13271,0.001119,172.217.194.0-255,4320,74064,92,250858
13272,0.001131,172.217.194.0-255,2902,76966,92,250858
13273,0.001143,172.217.194.0-255,3602,80568,92,250858
13274,0.001149,172.31.47.0-255,66,80634,92,250858
13275,0.001178,172.217.194.0-255,1484,82118,92,250858
13276,0.001181,172.217.194.0-255,1484,83602,92,250858
13277,0.001195,172.217.194.0-255,1484,85086,92,250858
13278,0.001197,172.31.47.0-255,66,85152,92,250858
13279,0.001213,172.217.194.0-255,2902,88054,92,250858
13280,0.00122,172.217.194.0-255,5738,93792,92,250858
13281,0.001225,172.31.47.0-255,66,93858,92,250858
13282,0.001231,172.217.194.0-255,1484,95342,92,250858
13283,0.001236,172.217.194.0-255,5738,101080,92,250858
13284,0.00126,172.217.194.0-255,3602,104682,92,250858
13285,0.001269,172.31.47.0-255,66,104748,92,250858
13286,0.001334,172.217.194.0-255,1484,106232,92,250858
13287,0.001345,172.217.194.0-255,1484,107716,92,250858
13288,0.001356,172.217.194.0-255,1484,109200,92,250858
13289,0.001359,172.217.194.0-255,2902,112102,92,250858
13290,0.001366,172.31.47.0-255,66,112168,92,250858
13291,0.001376,172.217.194.0-255,2902,115070,92,250858
13292,0.001388,172.31.47.0-255,66,115136,92,250858
13293,0.001416,172.31.47.0-255,66,115202,92,250858
13294,0.001423,172.217.194.0-255,2902,118104,92,250858
13295,0.00144,172.217.194.0-255,1484,119588,92,250858
13296,0.001444,172.31.47.0-255,66,119654,92,250858
13297,0.001482,172.217.194.0-255,1484,121138,92,250858
13298,0.001488,172.31.47.0-255,66,121204,92,250858
13299,0.001502,172.217.194.0-255,2902,124106,92,250858
13300,0.001505,172.217.194.0-255,1484,125590,92,250858
13301,0.001521,172.217.194.0-255,4320,129910,92,250858
13302,0.001524,172.31.47.0-255,66,129976,92,250858
13303,0.001532,172.217.194.0-255,2902,132878,92,250858
13304,0.001535,172.31.47.0-255,66,132944,92,250858
13305,0.001569,172.31.47.0-255,66,133010,92,250858
13306,0.001576,172.217.194.0-255,2902,135912,92,250858
13307,0.001579,172.31.47.0-255,66,135978,92,250858
13308,0.001599,172.217.194.0-255,7156,143134,92,250858
13309,0.001609,172.31.47.0-255,66,143200,92,250858
13310,0.001663,172.217.194.0-255,2184,145384,92,250858
13311,0.001669,172.31.47.0-255,66,145450,92,250858
13312,0.001731,172.217.194.0-255,1484,146934,92,250858
13313,0.001735,172.217.194.0-255,2902,149836,92,250858
13314,0.001737,172.217.194.0-255,1484,151320,92,250858
13315,0.001747,172.31.47.0-255,66,151386,92,250858
13316,0.001755,172.217.194.0-255,4320,155706,92,250858
13317,0.001759,172.217.194.0-255,4320,160026,92,250858
13318,0.001771,172.217.194.0-255,4320,164346,92,250858
13319,0.001788,172.217.194.0-255,7156,171502,92,250858
13320,0.001819,172.217.194.0-255,2902,174404,92,250858
13321,0.001831,172.217.194.0-255,5020,179424,92,250858
13322,0.001893,172.217.194.0-255,1484,180908,92,250858
13323,0.001905,172.217.194.0-255,2902,183810,92,250858
13324,0.001917,172.217.194.0-255,2902,186712,92,250858
13325,0.001935,172.217.194.0-255,2902,189614,92,250858
13326,0.001938,172.217.194.0-255,1484,191098,92,250858
13327,0.00207,172.217.194.0-255,5738,196836,92,250858
13328,0.002096,172.217.194.0-255,2184,199020,92,250858
13329,0.0021,172.217.194.0-255,1484,200504,92,250858
13330,0.002106,172.217.194.0-255,2902,203406,92,250858
13331,0.002115,172.217.194.0-255,5738,209144,92,250858
13332,0.002136,172.217.194.0-255,1484,210628,92,250858
13333,0.002156,172.217.194.0-255,5738,216366,92,250858
13334,0.002178,172.217.194.0-255,2902,219268,92,250858
13335,0.002182,172.217.194.0-255,766,220034,92,250858
13336,0.002236,172.217.194.0-255,1484,221518,92,250858
13337,0.002252,172.217.194.0-255,2902,224420,92,250858
13338,0.002257,172.217.194.0-255,4320,228740,92,250858
13339,0.002272,172.217.194.0-255,1484,230224,92,250858
13340,0.002281,172.217.194.0-255,7156,237380,92,250858
13341,0.002291,172.217.194.0-255,1484,238864,92,250858
13342,0.002371,172.217.194.0-255,2329,241193,92,250858
13343,0.002395,172.217.194.0-255,105,241298,92,250858
13344,0.012221,172.217.194.0-255,105,241403,92,250858
13345,0.012242,172.31.47.0-255,78,241481,92,250858
13346,0.017031,172.31.47.0-255,105,241586,92,250858
13347,0.019569,172.217.194.0-255,66,241652,92,250858
13348,0.031727,172.31.47.0-255,172,241824,92,250858
13349,0.031752,172.31.47.0-255,1107,242931,92,250858
13350,0.031821,172.31.47.0-255,1514,244445,92,250858
13351,0.031842,172.31.47.0-255,1514,245959,92,250858
13352,0.031843,172.31.47.0-255,1514,247473,92,250858
13353,0.031861,172.31.47.0-255,1514,248987,92,250858
13354,0.031862,172.31.47.0-255,1499,250486,92,250858
13355,0.033254,104.244.42.0-255,66,250552,92,250858
13356,0.033319,104.244.42.0-255,66,250618,92,250858
13357,0.033399,104.244.42.0-255,66,250684,92,250858
13358,0.03781,104.244.42.0-255,108,250792,92,250858
13359,0.037815,172.31.47.0-255,66,250858,92,250858
13360,0.0,172.31.47.0-255,105,105,92,276
13361,0.00149,157.240.13.0-255,105,210,92,276
13362,0.001504,172.31.47.0-255,66,276,92,276
13363,0.0,172.31.47.0-255,66,66,92,66
13364,0.0,74.125.68.0-255,153,153,92,311195
13365,2.3e-05,172.31.47.0-255,66,219,92,311195
13366,3.1e-05,74.125.68.0-255,1484,1703,92,311195
13367,3.5e-05,172.31.47.0-255,66,1769,92,311195
13368,4.1e-05,74.125.68.0-255,2902,4671,92,311195
13369,5.1e-05,172.31.47.0-255,66,4737,92,311195
13370,5.7e-05,74.125.68.0-255,4320,9057,92,311195
13371,5.9e-05,172.31.47.0-255,66,9123,92,311195
13372,6.7e-05,74.125.68.0-255,7156,16279,92,311195
13373,7e-05,172.31.47.0-255,66,16345,92,311195
13374,9e-05,74.125.68.0-255,2006,18351,92,311195
13375,9.3e-05,172.31.47.0-255,66,18417,92,311195
13376,0.000103,74.125.68.0-255,4320,22737,92,311195
13377,0.000105,172.31.47.0-255,66,22803,92,311195
13378,0.000149,172.31.47.0-255,66,22869,92,311195
13379,0.00021,74.125.68.0-255,1484,24353,92,311195
13380,0.000213,172.31.47.0-255,66,24419,92,311195
13381,0.000218,74.125.68.0-255,1484,25903,92,311195
13382,0.00022,172.31.47.0-255,66,25969,92,311195
13383,0.000248,74.125.68.0-255,2902,28871,92,311195
13384,0.00025,172.31.47.0-255,66,28937,92,311195
13385,0.000257,74.125.68.0-255,5738,34675,92,311195
13386,0.000259,172.31.47.0-255,66,34741,92,311195
13387,0.000286,74.125.68.0-255,6797,41538,92,311195
13388,0.000289,172.31.47.0-255,66,41604,92,311195
13389,0.000294,74.125.68.0-255,4320,45924,92,311195
13390,0.000297,172.31.47.0-255,66,45990,92,311195
13391,0.000318,74.125.68.0-255,2902,48892,92,311195
13392,0.000325,172.31.47.0-255,66,48958,92,311195
13393,0.000331,74.125.68.0-255,5738,54696,92,311195
13394,0.000334,172.31.47.0-255,66,54762,92,311195
13395,0.000366,74.125.68.0-255,2814,57576,92,311195
13396,0.000368,172.31.47.0-255,66,57642,92,311195
13397,0.000371,74.125.68.0-255,385,58027,92,311195
13398,0.000422,74.125.68.0-255,1484,59511,92,311195
13399,0.000424,172.31.47.0-255,66,59577,92,311195
13400,0.000442,74.125.68.0-255,2902,62479,92,311195
13401,0.000445,172.31.47.0-255,66,62545,92,311195
13402,0.00045,74.125.68.0-255,4320,66865,92,311195
13403,0.000453,172.31.47.0-255,66,66931,92,311195
13404,0.000481,74.125.68.0-255,1484,68415,92,311195
13405,0.000489,74.125.68.0-255,6797,75212,92,311195
13406,0.000492,172.31.47.0-255,66,75278,92,311195
13407,0.000495,74.125.68.0-255,1484,76762,92,311195
13408,0.000523,74.125.68.0-255,5738,82500,92,311195
13409,0.000525,172.31.47.0-255,66,82566,92,311195
13410,0.000533,74.125.68.0-255,7156,89722,92,311195
13411,0.000535,172.31.47.0-255,66,89788,92,311195
13412,0.000554,74.125.68.0-255,2543,92331,92,311195
13413,0.000557,172.31.47.0-255,66,92397,92,311195
13414,0.000914,74.125.68.0-255,1484,93881,92,311195
13415,0.000931,74.125.68.0-255,2902,96783,92,311195
13416,0.000935,172.31.47.0-255,66,96849,92,311195
13417,0.000969,74.125.68.0-255,5738,102587,92,311195
13418,0.000971,172.31.47.0-255,66,102653,92,311195
13419,0.000976,74.125.68.0-255,2902,105555,92,311195
13420,0.000978,172.31.47.0-255,66,105621,92,311195
13421,0.000988,74.125.68.0-255,4320,109941,92,311195
13422,0.000991,172.31.47.0-255,66,110007,92,311195
13423,0.000996,74.125.68.0-255,4320,114327,92,311195
13424,0.000998,172.31.47.0-255,66,114393,92,311195
13425,0.001033,74.125.68.0-255,4320,118713,92,311195
13426,0.001037,172.31.47.0-255,66,118779,92,311195
13427,0.001043,74.125.68.0-255,4320,123099,92,311195
13428,0.001045,172.31.47.0-255,66,123165,92,311195
13429,0.001074,74.125.68.0-255,3602,126767,92,311195
13430,0.001076,172.31.47.0-255,66,126833,92,311195
13431,0.0011,74.125.68.0-255,4320,131153,92,311195
13432,0.001103,74.125.68.0-255,1484,132637,92,311195
13433,0.001107,172.31.47.0-255,66,132703,92,311195
13434,0.001116,74.125.68.0-255,1484,134187,92,311195
13435,0.001118,172.31.47.0-255,66,134253,92,311195
13436,0.001127,74.125.68.0-255,4320,138573,92,311195
13437,0.00113,172.31.47.0-255,66,138639,92,311195
13438,0.001168,172.31.47.0-255,66,138705,92,311195
13439,0.001173,74.125.68.0-255,2902,141607,92,311195
13440,0.001175,172.31.47.0-255,66,141673,92,311195
13441,0.001181,74.125.68.0-255,4320,145993,92,311195
13442,0.001183,172.31.47.0-255,66,146059,92,311195
13443,0.001214,74.125.68.0-255,6438,152497,92,311195
13444,0.001217,172.31.47.0-255,66,152563,92,311195
13445,0.001279,74.125.68.0-255,1484,154047,92,311195
13446,0.001293,74.125.68.0-255,2902,156949,92,311195
13447,0.001296,172.31.47.0-255,66,157015,92,311195
13448,0.001326,74.125.68.0-255,4320,161335,92,311195
13449,0.001329,172.31.47.0-255,66,161401,92,311195
13450,0.001336,74.125.68.0-255,5738,167139,92,311195
13451,0.001338,172.31.47.0-255,66,167205,92,311195
13452,0.001365,172.31.47.0-255,66,167271,92,311195
13453,0.001385,74.125.68.0-255,1484,168755,92,311195
13454,0.001395,74.125.68.0-255,4320,173075,92,311195
13455,0.001398,172.31.47.0-255,66,173141,92,311195
13456,0.001431,74.125.68.0-255,3602,176743,92,311195
13457,0.001436,172.31.47.0-255,66,176809,92,311195
13458,0.001475,74.125.68.0-255,1484,178293,92,311195
13459,0.00149,74.125.68.0-255,2902,181195,92,311195
13460,0.001533,172.31.47.0-255,66,181261,92,311195
13461,0.001563,74.125.68.0-255,5738,186999,92,311195
13462,0.001567,172.31.47.0-255,66,187065,92,311195
13463,0.001572,74.125.68.0-255,2902,189967,92,311195
13464,0.001574,172.31.47.0-255,66,190033,92,311195
13465,0.001591,172.31.47.0-255,66,190099,92,311195
13466,0.001601,172.31.47.0-255,66,190165,92,311195
13467,0.001604,74.125.68.0-255,766,190931,92,311195
13468,0.001747,74.125.68.0-255,1484,192415,92,311195
13469,0.001751,172.31.47.0-255,66,192481,92,311195
13470,0.001757,74.125.68.0-255,2902,195383,92,311195
13471,0.001759,172.31.47.0-255,66,195449,92,311195
13472,0.001768,74.125.68.0-255,2902,198351,92,311195
13473,0.00177,172.31.47.0-255,66,198417,92,311195
13474,0.001801,74.125.68.0-255,4320,202737,92,311195
13475,0.001803,172.31.47.0-255,66,202803,92,311195
13476,0.001824,172.31.47.0-255,66,202869,92,311195
13477,0.001831,74.125.68.0-255,5738,208607,92,311195
13478,0.001833,172.31.47.0-255,66,208673,92,311195
13479,0.001836,74.125.68.0-255,1484,210157,92,311195
13480,0.001872,74.125.68.0-255,5738,215895,92,311195
13481,0.001875,172.31.47.0-255,66,215961,92,311195
13482,0.001882,74.125.68.0-255,5020,220981,92,311195
13483,0.001884,172.31.47.0-255,66,221047,92,311195
13484,0.001895,74.125.68.0-255,5738,226785,92,311195
13485,0.001898,172.31.47.0-255,66,226851,92,311195
13486,0.001955,172.31.47.0-255,66,226917,92,311195
13487,0.00198,74.125.68.0-255,2902,229819,92,311195
13488,0.001983,172.31.47.0-255,66,229885,92,311195
13489,0.002018,172.31.47.0-255,66,229951,92,311195
13490,0.002028,172.31.47.0-255,66,230017,92,311195
13491,0.002044,74.125.68.0-255,2902,232919,92,311195
13492,0.002046,172.31.47.0-255,66,232985,92,311195
13493,0.002049,74.125.68.0-255,1484,234469,92,311195
13494,0.002087,172.31.47.0-255,66,234535,92,311195
13495,0.002094,74.125.68.0-255,7156,241691,92,311195
13496,0.002096,172.31.47.0-255,66,241757,92,311195
13497,0.002113,74.125.68.0-255,4320,246077,92,311195
13498,0.002115,172.31.47.0-255,66,246143,92,311195
13499,0.002139,74.125.68.0-255,3602,249745,92,311195
13500,0.002146,172.31.47.0-255,66,249811,92,311195
13501,0.002151,74.125.68.0-255,2902,252713,92,311195
13502,0.002153,172.31.47.0-255,66,252779,92,311195
13503,0.00218,172.31.47.0-255,66,252845,92,311195
13504,0.002208,74.125.68.0-255,1484,254329,92,311195
13505,0.002214,74.125.68.0-255,4320,258649,92,311195
13506,0.002216,172.31.47.0-255,66,258715,92,311195
13507,0.002245,74.125.68.0-255,7156,265871,92,311195
13508,0.002248,172.31.47.0-255,66,265937,92,311195
13509,0.002273,172.31.47.0-255,66,266003,92,311195
13510,0.002317,172.31.47.0-255,66,266069,92,311195
13511,0.002349,74.125.68.0-255,5738,271807,92,311195
13512,0.002353,172.31.47.0-255,66,271873,92,311195
13513,0.002359,74.125.68.0-255,5738,277611,92,311195
13514,0.002361,172.31.47.0-255,66,277677,92,311195
13515,0.002365,74.125.68.0-255,2902,280579,92,311195
13516,0.002367,172.31.47.0-255,66,280645,92,311195
13517,0.004662,74.125.68.0-255,5738,286383,92,311195
13518,0.004669,172.31.47.0-255,66,286449,92,311195
13519,0.006953,74.125.68.0-255,2902,289351,92,311195
13520,0.006956,172.31.47.0-255,66,289417,92,311195
13521,0.006974,74.125.68.0-255,2902,292319,92,311195
13522,0.006975,172.31.47.0-255,66,292385,92,311195
13523,0.009248,74.125.68.0-255,2902,295287,92,311195
13524,0.009253,172.31.47.0-255,66,295353,92,311195
13525,0.009281,74.125.68.0-255,2902,298255,92,311195
13526,0.009284,172.31.47.0-255,66,298321,92,311195
13527,0.011534,74.125.68.0-255,2902,301223,92,311195
13528,0.011542,172.31.47.0-255,66,301289,92,311195
13529,0.011576,74.125.68.0-255,1709,302998,92,311195
13530,0.011578,172.31.47.0-255,66,303064,92,311195
13531,0.019382,172.31.47.0-255,105,303169,92,311195
13532,0.021629,74.125.68.0-255,66,303235,92,311195
13533,0.038875,172.31.47.0-255,171,303406,92,311195
13534,0.038905,172.31.47.0-255,1135,304541,92,311195
13535,0.038963,172.31.47.0-255,1514,306055,92,311195
13536,0.038965,172.31.47.0-255,1514,307569,92,311195
13537,0.038969,172.31.47.0-255,1514,309083,92,311195
13538,0.038971,172.31.47.0-255,1514,310597,92,311195
13539,0.038996,172.31.47.0-255,334,310931,92,311195
13540,0.040408,104.244.42.0-255,66,310997,92,311195
13541,0.04043,104.244.42.0-255,66,311063,92,311195
13542,0.040517,104.244.42.0-255,66,311129,92,311195
13543,0.040523,104.244.42.0-255,66,311195,92,311195
13544,0.0,74.125.24.0-255,373,373,92,183812
13545,3.1e-05,172.31.47.0-255,66,439,92,183812
13546,3.7e-05,74.125.24.0-255,1484,1923,92,183812
13547,4.2e-05,172.31.47.0-255,66,1989,92,183812
13548,5.8e-05,74.125.24.0-255,4320,6309,92,183812
13549,6e-05,172.31.47.0-255,66,6375,92,183812
13550,0.000224,74.125.24.0-255,4320,10695,92,183812
13551,0.000229,172.31.47.0-255,66,10761,92,183812
13552,0.000395,74.125.24.0-255,4320,15081,92,183812
13553,0.000401,172.31.47.0-255,66,15147,92,183812
13554,0.000413,74.125.24.0-255,6153,21300,92,183812
13555,0.000416,172.31.47.0-255,66,21366,92,183812
13556,0.000822,74.125.24.0-255,5738,27104,92,183812
13557,0.000827,172.31.47.0-255,66,27170,92,183812
13558,0.001045,74.125.24.0-255,4156,31326,92,183812
13559,0.00105,172.31.47.0-255,66,31392,92,183812
13560,0.003175,74.125.24.0-255,1484,32876,92,183812
13561,0.003182,172.31.47.0-255,66,32942,92,183812
13562,0.003404,74.125.24.0-255,2902,35844,92,183812
13563,0.003408,172.31.47.0-255,66,35910,92,183812
13564,0.003425,74.125.24.0-255,1484,37394,92,183812
13565,0.003427,172.31.47.0-255,66,37460,92,183812
13566,0.005538,74.125.24.0-255,1484,38944,92,183812
13567,0.005545,172.31.47.0-255,66,39010,92,183812
13568,0.005751,74.125.24.0-255,2902,41912,92,183812
13569,0.005755,172.31.47.0-255,66,41978,92,183812
13570,0.005793,74.125.24.0-255,1484,43462,92,183812
13571,0.005796,172.31.47.0-255,66,43528,92,183812
13572,0.007897,74.125.24.0-255,1484,45012,92,183812
13573,0.007904,172.31.47.0-255,66,45078,92,183812
13574,0.008074,74.125.24.0-255,1484,46562,92,183812
13575,0.00808,172.31.47.0-255,66,46628,92,183812
13576,0.008126,74.125.24.0-255,2902,49530,92,183812
13577,0.008131,172.31.47.0-255,66,49596,92,183812
13578,0.010336,74.125.24.0-255,1484,51080,92,183812
13579,0.010396,172.31.47.0-255,66,51146,92,183812
13580,0.01067,74.125.24.0-255,4320,55466,92,183812
13581,0.010711,172.31.47.0-255,66,55532,92,183812
13582,0.012768,74.125.24.0-255,1484,57016,92,183812
13583,0.012775,172.31.47.0-255,66,57082,92,183812
13584,0.013049,74.125.24.0-255,4320,61402,92,183812
13585,0.013056,172.31.47.0-255,66,61468,92,183812
13586,0.015126,74.125.24.0-255,1484,62952,92,183812
13587,0.015134,172.31.47.0-255,66,63018,92,183812
13588,0.015382,74.125.24.0-255,4320,67338,92,183812
13589,0.015387,172.31.47.0-255,66,67404,92,183812
13590,0.017456,74.125.24.0-255,1484,68888,92,183812
13591,0.017461,172.31.47.0-255,66,68954,92,183812
13592,0.017705,74.125.24.0-255,1484,70438,92,183812
13593,0.017709,172.31.47.0-255,66,70504,92,183812
13594,0.017726,74.125.24.0-255,2902,73406,92,183812
13595,0.017728,172.31.47.0-255,66,73472,92,183812
13596,0.019778,74.125.24.0-255,1484,74956,92,183812
13597,0.019785,172.31.47.0-255,66,75022,92,183812
13598,0.020118,74.125.24.0-255,4320,79342,92,183812
13599,0.020125,172.31.47.0-255,66,79408,92,183812
13600,0.022123,74.125.24.0-255,1484,80892,92,183812
13601,0.02213,172.31.47.0-255,66,80958,92,183812
13602,0.022491,74.125.24.0-255,4320,85278,92,183812
13603,0.022497,172.31.47.0-255,66,85344,92,183812
13604,0.024475,74.125.24.0-255,1484,86828,92,183812
13605,0.024881,74.125.24.0-255,4320,91148,92,183812
13606,0.024887,172.31.47.0-255,66,91214,92,183812
13607,0.02725,74.125.24.0-255,5738,96952,92,183812
13608,0.027257,172.31.47.0-255,66,97018,92,183812
13609,0.029624,74.125.24.0-255,1484,98502,92,183812
13610,0.029643,74.125.24.0-255,4320,102822,92,183812
13611,0.029649,172.31.47.0-255,66,102888,92,183812
13612,0.030757,172.31.47.0-255,172,103060,92,183812
13613,0.03079,172.31.47.0-255,1107,104167,92,183812
13614,0.030835,172.31.47.0-255,1514,105681,92,183812
13615,0.030838,172.31.47.0-255,1514,107195,92,183812
13616,0.030843,172.31.47.0-255,1514,108709,92,183812
13617,0.030844,172.31.47.0-255,1514,110223,92,183812
13618,0.03086,172.31.47.0-255,1499,111722,92,183812
13619,0.031985,74.125.24.0-255,5738,117460,92,183812
13620,0.03199,172.31.47.0-255,66,117526,92,183812
13621,0.032292,104.244.42.0-255,66,117592,92,183812
13622,0.03237,104.244.42.0-255,66,117658,92,183812
13623,0.032414,104.244.42.0-255,66,117724,92,183812
13624,0.034363,74.125.24.0-255,4320,122044,92,183812
13625,0.034368,172.31.47.0-255,66,122110,92,183812
13626,0.034387,74.125.24.0-255,1484,123594,92,183812
13627,0.03439,172.31.47.0-255,66,123660,92,183812
13628,0.036755,74.125.24.0-255,4320,127980,92,183812
13629,0.03676,172.31.47.0-255,66,128046,92,183812
13630,0.036805,74.125.24.0-255,1484,129530,92,183812
13631,0.036809,172.31.47.0-255,66,129596,92,183812
13632,0.039122,74.125.24.0-255,4320,133916,92,183812
13633,0.039129,172.31.47.0-255,66,133982,92,183812
13634,0.039186,74.125.24.0-255,1484,135466,92,183812
13635,0.03919,172.31.47.0-255,66,135532,92,183812
13636,0.041475,74.125.24.0-255,4320,139852,92,183812
13637,0.041482,172.31.47.0-255,66,139918,92,183812
13638,0.041548,74.125.24.0-255,1484,141402,92,183812
13639,0.041553,172.31.47.0-255,66,141468,92,183812
13640,0.043829,74.125.24.0-255,4320,145788,92,183812
13641,0.043834,172.31.47.0-255,66,145854,92,183812
13642,0.043902,74.125.24.0-255,1484,147338,92,183812
13643,0.043907,172.31.47.0-255,66,147404,92,183812
13644,0.046179,74.125.24.0-255,4320,151724,92,183812
13645,0.046184,172.31.47.0-255,66,151790,92,183812
13646,0.046249,74.125.24.0-255,1484,153274,92,183812
13647,0.046253,172.31.47.0-255,66,153340,92,183812
13648,0.048504,74.125.24.0-255,1484,154824,92,183812
13649,0.04851,172.31.47.0-255,66,154890,92,183812
13650,0.048549,74.125.24.0-255,2902,157792,92,183812
13651,0.048553,172.31.47.0-255,66,157858,92,183812
13652,0.048634,74.125.24.0-255,1484,159342,92,183812
13653,0.048638,172.31.47.0-255,66,159408,92,183812
13654,0.050827,74.125.24.0-255,1484,160892,92,183812
13655,0.05083,172.31.47.0-255,66,160958,92,183812
13656,0.05087,74.125.24.0-255,2902,163860,92,183812
13657,0.050872,172.31.47.0-255,66,163926,92,183812
13658,0.050954,74.125.24.0-255,1484,165410,92,183812
13659,0.050956,172.31.47.0-255,66,165476,92,183812
13660,0.053144,74.125.24.0-255,1484,166960,92,183812
13661,0.05315,172.31.47.0-255,66,167026,92,183812
13662,0.053194,74.125.24.0-255,1484,168510,92,183812
13663,0.053198,172.31.47.0-255,66,168576,92,183812
13664,0.053216,74.125.24.0-255,1484,170060,92,183812
13665,0.053219,172.31.47.0-255,66,170126,92,183812
13666,0.053284,74.125.24.0-255,1484,171610,92,183812
13667,0.053288,172.31.47.0-255,66,171676,92,183812
13668,0.055482,74.125.24.0-255,1484,173160,92,183812
13669,0.055487,172.31.47.0-255,66,173226,92,183812
13670,0.055562,74.125.24.0-255,2902,176128,92,183812
13671,0.055567,172.31.47.0-255,66,176194,92,183812
13672,0.055616,74.125.24.0-255,1484,177678,92,183812
13673,0.05562,172.31.47.0-255,66,177744,92,183812
13674,0.057841,74.125.24.0-255,1484,179228,92,183812
13675,0.057855,172.31.47.0-255,66,179294,92,183812
13676,0.05791,74.125.24.0-255,2902,182196,92,183812
13677,0.057914,172.31.47.0-255,66,182262,92,183812
13678,0.057959,74.125.24.0-255,1484,183746,92,183812
13679,0.057962,172.31.47.0-255,66,183812,92,183812
13680,0.0,74.125.24.0-255,152,152,92,244996
13681,2.5e-05,172.31.47.0-255,66,218,92,244996
13682,3.2e-05,74.125.24.0-255,1484,1702,92,244996
13683,3.6e-05,172.31.47.0-255,66,1768,92,244996
13684,4e-05,74.125.24.0-255,2902,4670,92,244996
13685,4.9e-05,172.31.47.0-255,66,4736,92,244996
13686,5.3e-05,74.125.24.0-255,2902,7638,92,244996
13687,5.5e-05,172.31.47.0-255,66,7704,92,244996
13688,7.8e-05,74.125.24.0-255,4320,12024,92,244996
13689,8.1e-05,172.31.47.0-255,66,12090,92,244996
13690,0.000102,74.125.24.0-255,2172,14262,92,244996
13691,0.000105,172.31.47.0-255,66,14328,92,244996
13692,0.000108,74.125.24.0-255,2902,17230,92,244996
13693,0.00011,172.31.47.0-255,66,17296,92,244996
13694,0.000134,74.125.24.0-255,4320,21616,92,244996
13695,0.000141,172.31.47.0-255,66,21682,92,244996
13696,0.000159,74.125.24.0-255,2902,24584,92,244996
13697,0.000162,172.31.47.0-255,66,24650,92,244996
13698,0.000169,74.125.24.0-255,6797,31447,92,244996
13699,0.000171,172.31.47.0-255,66,31513,92,244996
13700,0.000305,74.125.24.0-255,1484,32997,92,244996
13701,0.00031,172.31.47.0-255,66,33063,92,244996
13702,0.000316,74.125.24.0-255,2902,35965,92,244996
13703,0.000318,172.31.47.0-255,66,36031,92,244996
13704,0.000329,74.125.24.0-255,4320,40351,92,244996
13705,0.000333,172.31.47.0-255,66,40417,92,244996
13706,0.000358,74.125.24.0-255,1484,41901,92,244996
13707,0.000361,172.31.47.0-255,66,41967,92,244996
13708,0.000374,172.31.47.0-255,66,42033,92,244996
13709,0.0004,74.125.24.0-255,5738,47771,92,244996
13710,0.000405,172.31.47.0-255,66,47837,92,244996
13711,0.000432,74.125.24.0-255,4320,52157,92,244996
13712,0.000436,172.31.47.0-255,66,52223,92,244996
13713,0.000441,74.125.24.0-255,3961,56184,92,244996
13714,0.000443,172.31.47.0-255,66,56250,92,244996
13715,0.000749,74.125.24.0-255,412,56662,92,244996
13716,0.000785,172.31.47.0-255,66,56728,92,244996
13717,0.000788,74.125.24.0-255,332,57060,92,244996
13718,0.000802,172.31.47.0-255,66,57126,92,244996
13719,0.001322,74.125.24.0-255,1484,58610,92,244996
13720,0.001332,74.125.24.0-255,2902,61512,92,244996
13721,0.001336,172.31.47.0-255,66,61578,92,244996
13722,0.001343,74.125.24.0-255,5738,67316,92,244996
13723,0.001346,172.31.47.0-255,66,67382,92,244996
13724,0.001382,172.31.47.0-255,66,67448,92,244996
13725,0.001389,74.125.24.0-255,5738,73186,92,244996
13726,0.001391,172.31.47.0-255,66,73252,92,244996
13727,0.001422,74.125.24.0-255,5020,78272,92,244996
13728,0.001425,172.31.47.0-255,66,78338,92,244996
13729,0.003618,74.125.24.0-255,5738,84076,92,244996
13730,0.003682,172.31.47.0-255,66,84142,92,244996
13731,0.005714,74.125.24.0-255,4320,88462,92,244996
13732,0.00572,172.31.47.0-255,66,88528,92,244996
13733,0.00575,74.125.24.0-255,1484,90012,92,244996
13734,0.00774,74.125.24.0-255,4320,94332,92,244996
13735,0.007746,172.31.47.0-255,66,94398,92,244996
13736,0.009754,74.125.24.0-255,5738,100136,92,244996
13737,0.009759,172.31.47.0-255,66,100202,92,244996
13738,0.011767,74.125.24.0-255,5738,105940,92,244996
13739,0.011772,172.31.47.0-255,66,106006,92,244996
13740,0.013976,74.125.24.0-255,5738,111744,92,244996
13741,0.01403,172.31.47.0-255,66,111810,92,244996
13742,0.016042,74.125.24.0-255,5738,117548,92,244996
13743,0.016047,172.31.47.0-255,66,117614,92,244996
13744,0.018066,74.125.24.0-255,5738,123352,92,244996
13745,0.018071,172.31.47.0-255,66,123418,92,244996
13746,0.020108,74.125.24.0-255,5738,129156,92,244996
13747,0.020116,172.31.47.0-255,66,129222,92,244996
13748,0.022116,74.125.24.0-255,5738,134960,92,244996
13749,0.022122,172.31.47.0-255,66,135026,92,244996
13750,0.024135,74.125.24.0-255,5738,140764,92,244996
13751,0.024144,172.31.47.0-255,66,140830,92,244996
13752,0.026198,74.125.24.0-255,5738,146568,92,244996
13753,0.026206,172.31.47.0-255,66,146634,92,244996
13754,0.028246,74.125.24.0-255,5738,152372,92,244996
13755,0.028257,172.31.47.0-255,66,152438,92,244996
13756,0.030281,74.125.24.0-255,5738,158176,92,244996
13757,0.030288,172.31.47.0-255,66,158242,92,244996
13758,0.03183,172.31.47.0-255,172,158414,92,244996
13759,0.031876,172.31.47.0-255,1111,159525,92,244996
13760,0.031948,172.31.47.0-255,1514,161039,92,244996
13761,0.03195,172.31.47.0-255,1514,162553,92,244996
13762,0.031951,172.31.47.0-255,1514,164067,92,244996
13763,0.031952,172.31.47.0-255,1514,165581,92,244996
13764,0.031953,172.31.47.0-255,533,166114,92,244996
13765,0.032291,74.125.24.0-255,5738,171852,92,244996
13766,0.032296,172.31.47.0-255,66,171918,92,244996
13767,0.033367,104.244.42.0-255,66,171984,92,244996
13768,0.033388,104.244.42.0-255,66,172050,92,244996
13769,0.033512,104.244.42.0-255,66,172116,92,244996
13770,0.033514,104.244.42.0-255,66,172182,92,244996
13771,0.033516,104.244.42.0-255,66,172248,92,244996
13772,0.034321,74.125.24.0-255,5738,177986,92,244996
13773,0.034326,172.31.47.0-255,66,178052,92,244996
13774,0.036338,74.125.24.0-255,5738,183790,92,244996
13775,0.036345,172.31.47.0-255,66,183856,92,244996
13776,0.038399,74.125.24.0-255,5738,189594,92,244996
13777,0.038405,172.31.47.0-255,66,189660,92,244996
13778,0.040429,74.125.24.0-255,5738,195398,92,244996
13779,0.040434,172.31.47.0-255,66,195464,92,244996
13780,0.042452,74.125.24.0-255,5738,201202,92,244996
13781,0.042462,172.31.47.0-255,66,201268,92,244996
13782,0.044479,74.125.24.0-255,5738,207006,92,244996
13783,0.044485,172.31.47.0-255,66,207072,92,244996
13784,0.046515,74.125.24.0-255,5738,212810,92,244996
13785,0.046533,172.31.47.0-255,66,212876,92,244996
13786,0.048555,74.125.24.0-255,4320,217196,92,244996
13787,0.048559,172.31.47.0-255,66,217262,92,244996
13788,0.048586,74.125.24.0-255,1484,218746,92,244996
13789,0.050578,74.125.24.0-255,2902,221648,92,244996
13790,0.050583,172.31.47.0-255,66,221714,92,244996
13791,0.050617,74.125.24.0-255,1484,223198,92,244996
13792,0.052665,74.125.24.0-255,4320,227518,92,244996
13793,0.05267,172.31.47.0-255,66,227584,92,244996
13794,0.054719,74.125.24.0-255,5738,233322,92,244996
13795,0.054724,172.31.47.0-255,66,233388,92,244996
13796,0.056715,74.125.24.0-255,5738,239126,92,244996
13797,0.05672,172.31.47.0-255,66,239192,92,244996
13798,0.058733,74.125.24.0-255,5738,244930,92,244996
13799,0.058737,172.31.47.0-255,66,244996,92,244996
13800,0.0,172.217.194.0-255,153,153,92,292824
13801,1.6e-05,172.31.47.0-255,66,219,92,292824
13802,2.3e-05,172.217.194.0-255,1484,1703,92,292824
13803,2.7e-05,172.31.47.0-255,66,1769,92,292824
13804,3.3e-05,172.217.194.0-255,2902,4671,92,292824
13805,4.4e-05,172.31.47.0-255,66,4737,92,292824
13806,4.8e-05,172.217.194.0-255,2902,7639,92,292824
13807,5.1e-05,172.31.47.0-255,66,7705,92,292824
13808,7.3e-05,172.217.194.0-255,2902,10607,92,292824
13809,8.1e-05,172.31.47.0-255,66,10673,92,292824
13810,0.000107,172.217.194.0-255,7156,17829,92,292824
13811,0.000111,172.31.47.0-255,66,17895,92,292824
13812,0.000142,172.217.194.0-255,3589,21484,92,292824
13813,0.000146,172.31.47.0-255,66,21550,92,292824
13814,0.000153,172.217.194.0-255,7156,28706,92,292824
13815,0.000155,172.31.47.0-255,66,28772,92,292824
13816,0.000162,172.217.194.0-255,2543,31315,92,292824
13817,0.000164,172.31.47.0-255,66,31381,92,292824
13818,0.000238,172.217.194.0-255,1484,32865,92,292824
13819,0.000241,172.31.47.0-255,66,32931,92,292824
13820,0.000267,172.217.194.0-255,2902,35833,92,292824
13821,0.00027,172.31.47.0-255,66,35899,92,292824
13822,0.000277,172.217.194.0-255,5738,41637,92,292824
13823,0.000279,172.31.47.0-255,66,41703,92,292824
13824,0.000323,172.31.47.0-255,66,41769,92,292824
13825,0.000349,172.217.194.0-255,3961,45730,92,292824
13826,0.000352,172.31.47.0-255,66,45796,92,292824
13827,0.000383,172.217.194.0-255,7156,52952,92,292824
13828,0.000386,172.31.47.0-255,66,53018,92,292824
13829,0.000411,172.217.194.0-255,3132,56150,92,292824
13830,0.000414,172.31.47.0-255,66,56216,92,292824
13831,0.000586,172.217.194.0-255,1484,57700,92,292824
13832,0.000591,172.31.47.0-255,66,57766,92,292824
13833,0.000596,172.217.194.0-255,2902,60668,92,292824
13834,0.000599,172.31.47.0-255,66,60734,92,292824
13835,0.000633,172.217.194.0-255,5738,66472,92,292824
13836,0.000637,172.31.47.0-255,66,66538,92,292824
13837,0.000643,172.217.194.0-255,7156,73694,92,292824
13838,0.000646,172.31.47.0-255,66,73760,92,292824
13839,0.000659,172.217.194.0-255,7156,80916,92,292824
13840,0.000665,172.31.47.0-255,66,80982,92,292824
13841,0.000689,172.217.194.0-255,7156,88138,92,292824
13842,0.000693,172.217.194.0-255,2184,90322,92,292824
13843,0.000748,172.217.194.0-255,1484,91806,92,292824
13844,0.000753,172.217.194.0-255,2902,94708,92,292824
13845,0.000758,172.217.194.0-255,4320,99028,92,292824
13846,0.000773,172.217.194.0-255,1484,100512,92,292824
13847,0.000793,172.31.47.0-255,66,100578,92,292824
13848,0.000827,172.217.194.0-255,4320,104898,92,292824
13849,0.000856,172.31.47.0-255,66,104964,92,292824
13850,0.000868,172.217.194.0-255,4320,109284,92,292824
13851,0.000875,172.31.47.0-255,66,109350,92,292824
13852,0.00093,172.31.47.0-255,66,109416,92,292824
13853,0.000982,172.217.194.0-255,5738,115154,92,292824
13854,0.001008,172.31.47.0-255,66,115220,92,292824
13855,0.001016,172.217.194.0-255,1484,116704,92,292824
13856,0.001021,172.31.47.0-255,66,116770,92,292824
13857,0.001044,172.217.194.0-255,2184,118954,92,292824
13858,0.00105,172.217.194.0-255,4320,123274,92,292824
13859,0.001055,172.217.194.0-255,4320,127594,92,292824
13860,0.001078,172.217.194.0-255,5738,133332,92,292824
13861,0.001085,172.217.194.0-255,5738,139070,92,292824
13862,0.001097,172.31.47.0-255,66,139136,92,292824
13863,0.001104,172.217.194.0-255,7156,146292,92,292824
13864,0.001114,172.31.47.0-255,66,146358,92,292824
13865,0.001134,172.217.194.0-255,6438,152796,92,292824
13866,0.001152,172.31.47.0-255,66,152862,92,292824
13867,0.001173,172.217.194.0-255,7156,160018,92,292824
13868,0.001177,172.217.194.0-255,2902,162920,92,292824
13869,0.001194,172.217.194.0-255,2902,165822,92,292824
13870,0.001197,172.217.194.0-255,1484,167306,92,292824
13871,0.001208,172.31.47.0-255,66,167372,92,292824
13872,0.001242,172.217.194.0-255,6438,173810,92,292824
13873,0.001257,172.217.194.0-255,1484,175294,92,292824
13874,0.001277,172.217.194.0-255,5738,181032,92,292824
13875,0.001281,172.217.194.0-255,2902,183934,92,292824
13876,0.001297,172.217.194.0-255,5738,189672,92,292824
13877,0.001333,172.31.47.0-255,66,189738,92,292824
13878,0.001341,172.31.47.0-255,66,189804,92,292824
13879,0.001374,172.217.194.0-255,766,190570,92,292824
13880,0.001396,172.31.47.0-255,66,190636,92,292824
13881,0.001421,172.217.194.0-255,1484,192120,92,292824
13882,0.001426,172.217.194.0-255,2902,195022,92,292824
13883,0.00143,172.217.194.0-255,2902,197924,92,292824
13884,0.001449,172.217.194.0-255,2902,200826,92,292824
13885,0.001454,172.31.47.0-255,66,200892,92,292824
13886,0.001467,172.217.194.0-255,5738,206630,92,292824
13887,0.00149,172.217.194.0-255,7156,213786,92,292824
13888,0.001511,172.217.194.0-255,2184,215970,92,292824
13889,0.001522,172.31.47.0-255,66,216036,92,292824
13890,0.00187,172.217.194.0-255,1484,217520,92,292824
13891,0.001876,172.217.194.0-255,2902,220422,92,292824
13892,0.001879,172.217.194.0-255,1484,221906,92,292824
13893,0.001891,172.31.47.0-255,66,221972,92,292824
13894,0.001902,172.217.194.0-255,4320,226292,92,292824
13895,0.001913,172.217.194.0-255,4320,230612,92,292824
13896,0.001918,172.31.47.0-255,66,230678,92,292824
13897,0.001971,172.217.194.0-255,766,231444,92,292824
13898,0.001982,172.31.47.0-255,66,231510,92,292824
13899,0.002021,172.217.194.0-255,1484,232994,92,292824
13900,0.003983,172.217.194.0-255,4320,237314,92,292824
13901,0.00399,172.31.47.0-255,66,237380,92,292824
13902,0.006012,172.217.194.0-255,5738,243118,92,292824
13903,0.006633,172.31.47.0-255,66,243184,92,292824
13904,0.008641,172.217.194.0-255,5738,248922,92,292824
13905,0.008646,172.31.47.0-255,66,248988,92,292824
13906,0.010729,172.217.194.0-255,5738,254726,92,292824
13907,0.010736,172.31.47.0-255,66,254792,92,292824
13908,0.012784,172.217.194.0-255,5738,260530,92,292824
13909,0.012791,172.31.47.0-255,66,260596,92,292824
13910,0.014826,172.217.194.0-255,5738,266334,92,292824
13911,0.014833,172.31.47.0-255,66,266400,92,292824
13912,0.016863,172.217.194.0-255,5738,272138,92,292824
13913,0.016869,172.31.47.0-255,66,272204,92,292824
13914,0.018881,172.217.194.0-255,5738,277942,92,292824
13915,0.018888,172.31.47.0-255,66,278008,92,292824
13916,0.020919,172.217.194.0-255,5306,283314,92,292824
13917,0.020926,172.31.47.0-255,66,283380,92,292824
13918,0.021179,172.31.47.0-255,105,283485,92,292824
13919,0.023175,172.217.194.0-255,66,283551,92,292824
13920,0.037641,172.31.47.0-255,172,283723,92,292824
13921,0.037676,172.31.47.0-255,1111,284834,92,292824
13922,0.037788,172.31.47.0-255,1514,286348,92,292824
13923,0.037789,172.31.47.0-255,1514,287862,92,292824
13924,0.037794,172.31.47.0-255,1514,289376,92,292824
13925,0.037795,172.31.47.0-255,1514,290890,92,292824
13926,0.037835,172.31.47.0-255,1496,292386,92,292824
13927,0.039208,104.244.42.0-255,66,292452,92,292824
13928,0.039265,104.244.42.0-255,66,292518,92,292824
13929,0.039407,104.244.42.0-255,66,292584,92,292824
13930,0.039445,104.244.42.0-255,66,292650,92,292824
13931,0.040074,104.244.42.0-255,108,292758,92,292824
13932,0.040082,172.31.47.0-255,66,292824,92,292824
13933,0.0,172.31.47.0-255,105,105,92,276
13934,0.001467,157.240.13.0-255,105,210,92,276
13935,0.039582,172.31.47.0-255,66,276,92,276
13936,0.0,74.125.68.0-255,290,290,92,362110
13937,2.1e-05,172.31.47.0-255,66,356,92,362110
13938,2.6e-05,74.125.68.0-255,1484,1840,92,362110
13939,3.1e-05,172.31.47.0-255,66,1906,92,362110
13940,3.8e-05,74.125.68.0-255,4320,6226,92,362110
13941,4.8e-05,172.31.47.0-255,66,6292,92,362110
13942,5.2e-05,74.125.68.0-255,2902,9194,92,362110
13943,5.5e-05,172.31.47.0-255,66,9260,92,362110
13944,6e-05,74.125.68.0-255,4320,13580,92,362110
13945,6.3e-05,172.31.47.0-255,66,13646,92,362110
13946,0.000101,172.31.47.0-255,66,13712,92,362110
13947,0.00014,74.125.68.0-255,1484,15196,92,362110
13948,0.000142,172.31.47.0-255,66,15262,92,362110
13949,0.000171,74.125.68.0-255,6797,22059,92,362110
13950,0.000173,172.31.47.0-255,66,22125,92,362110
13951,0.000232,74.125.68.0-255,1484,23609,92,362110
13952,0.000234,172.31.47.0-255,66,23675,92,362110
13953,0.00026,74.125.68.0-255,2902,26577,92,362110
13954,0.000263,172.31.47.0-255,66,26643,92,362110
13955,0.000295,74.125.68.0-255,5738,32381,92,362110
13956,0.000297,172.31.47.0-255,66,32447,92,362110
13957,0.000302,74.125.68.0-255,4320,36767,92,362110
13958,0.000304,172.31.47.0-255,66,36833,92,362110
13959,0.000327,74.125.68.0-255,2902,39735,92,362110
13960,0.000329,172.31.47.0-255,66,39801,92,362110
13961,0.000351,74.125.68.0-255,2543,42344,92,362110
13962,0.000353,172.31.47.0-255,66,42410,92,362110
13963,0.000357,74.125.68.0-255,2902,45312,92,362110
13964,0.000359,172.31.47.0-255,66,45378,92,362110
13965,0.000364,74.125.68.0-255,4320,49698,92,362110
13966,0.000366,172.31.47.0-255,66,49764,92,362110
13967,0.000404,74.125.68.0-255,7070,56834,92,362110
13968,0.000407,172.31.47.0-255,66,56900,92,362110
13969,0.000428,74.125.68.0-255,132,57032,92,362110
13970,0.00043,172.31.47.0-255,66,57098,92,362110
13971,0.000514,74.125.68.0-255,1484,58582,92,362110
13972,0.000518,172.31.47.0-255,66,58648,92,362110
13973,0.000523,74.125.68.0-255,2902,61550,92,362110
13974,0.000525,172.31.47.0-255,66,61616,92,362110
13975,0.000541,74.125.68.0-255,2902,64518,92,362110
13976,0.000546,172.31.47.0-255,66,64584,92,362110
13977,0.000568,74.125.68.0-255,2902,67486,92,362110
13978,0.00057,172.31.47.0-255,66,67552,92,362110
13979,0.000577,74.125.68.0-255,7156,74708,92,362110
13980,0.000579,172.31.47.0-255,66,74774,92,362110
13981,0.000598,74.125.68.0-255,5738,80512,92,362110
13982,0.000601,172.31.47.0-255,66,80578,92,362110
13983,0.000641,172.31.47.0-255,66,80644,92,362110
13984,0.000646,74.125.68.0-255,2184,82828,92,362110
13985,0.000648,172.31.47.0-255,66,82894,92,362110
13986,0.001075,74.125.68.0-255,1484,84378,92,362110
13987,0.00108,172.31.47.0-255,66,84444,92,362110
13988,0.001086,74.125.68.0-255,2902,87346,92,362110
13989,0.001089,172.31.47.0-255,66,87412,92,362110
13990,0.001117,74.125.68.0-255,5738,93150,92,362110
13991,0.00112,172.31.47.0-255,66,93216,92,362110
13992,0.001123,74.125.68.0-255,1484,94700,92,362110
13993,0.001124,172.31.47.0-255,66,94766,92,362110
13994,0.001152,74.125.68.0-255,2902,97668,92,362110
13995,0.001159,172.31.47.0-255,66,97734,92,362110
13996,0.00117,74.125.68.0-255,1484,99218,92,362110
13997,0.001177,172.31.47.0-255,66,99284,92,362110
13998,0.001203,74.125.68.0-255,2902,102186,92,362110
13999,0.00121,74.125.68.0-255,5738,107924,92,362110
14000,0.001216,74.125.68.0-255,2902,110826,92,362110
14001,0.001221,74.125.68.0-255,4320,115146,92,362110
14002,0.001239,172.31.47.0-255,66,115212,92,362110
14003,0.001262,74.125.68.0-255,2184,117396,92,362110
14004,0.001279,172.31.47.0-255,66,117462,92,362110
14005,0.001307,74.125.68.0-255,1484,118946,92,362110
14006,0.001321,74.125.68.0-255,2902,121848,92,362110
14007,0.001336,74.125.68.0-255,1484,123332,92,362110
14008,0.001338,172.31.47.0-255,66,123398,92,362110
14009,0.001356,74.125.68.0-255,4320,127718,92,362110
14010,0.00139,74.125.68.0-255,2902,130620,92,362110
14011,0.001434,74.125.68.0-255,2184,132804,92,362110
14012,0.001438,172.31.47.0-255,66,132870,92,362110
14013,0.001446,172.31.47.0-255,66,132936,92,362110
14014,0.001562,74.125.68.0-255,1484,134420,92,362110
14015,0.001583,74.125.68.0-255,2902,137322,92,362110
14016,0.001589,74.125.68.0-255,4320,141642,92,362110
14017,0.001593,172.31.47.0-255,66,141708,92,362110
14018,0.0016,74.125.68.0-255,1484,143192,92,362110
14019,0.001626,74.125.68.0-255,4320,147512,92,362110
14020,0.001633,172.31.47.0-255,66,147578,92,362110
14021,0.001657,74.125.68.0-255,7156,154734,92,362110
14022,0.001691,172.31.47.0-255,66,154800,92,362110
14023,0.001838,74.125.68.0-255,1484,156284,92,362110
14024,0.001852,74.125.68.0-255,2902,159186,92,362110
14025,0.001856,172.31.47.0-255,66,159252,92,362110
14026,0.00186,74.125.68.0-255,1484,160736,92,362110
14027,0.001884,74.125.68.0-255,2902,163638,92,362110
14028,0.00189,74.125.68.0-255,5738,169376,92,362110
14029,0.001917,74.125.68.0-255,4320,173696,92,362110
14030,0.001925,172.31.47.0-255,66,173762,92,362110
14031,0.001936,74.125.68.0-255,7156,180918,92,362110
14032,0.001945,74.125.68.0-255,2902,183820,92,362110
14033,0.001951,172.31.47.0-255,66,183886,92,362110
14034,0.001979,74.125.68.0-255,5020,188906,92,362110
14035,0.001987,172.31.47.0-255,66,188972,92,362110
14036,0.002165,74.125.68.0-255,1484,190456,92,362110
14037,0.00217,74.125.68.0-255,1484,191940,92,362110
14038,0.002173,172.31.47.0-255,66,192006,92,362110
14039,0.0022,74.125.68.0-255,1484,193490,92,362110
14040,0.002206,74.125.68.0-255,4320,197810,92,362110
14041,0.002246,74.125.68.0-255,4320,202130,92,362110
14042,0.002273,74.125.68.0-255,4320,206450,92,362110
14043,0.002277,74.125.68.0-255,2902,209352,92,362110
14044,0.002282,74.125.68.0-255,4320,213672,92,362110
14045,0.002291,74.125.68.0-255,766,214438,92,362110
14046,0.00232,172.31.47.0-255,66,214504,92,362110
14047,0.004605,74.125.68.0-255,5738,220242,92,362110
14048,0.004612,172.31.47.0-255,66,220308,92,362110
14049,0.006893,74.125.68.0-255,5738,226046,92,362110
14050,0.006899,172.31.47.0-255,66,226112,92,362110
14051,0.009191,74.125.68.0-255,5738,231850,92,362110
14052,0.009196,172.31.47.0-255,66,231916,92,362110
14053,0.011663,74.125.68.0-255,5738,237654,92,362110
14054,0.011729,172.31.47.0-255,66,237720,92,362110
14055,0.014033,74.125.68.0-255,5738,243458,92,362110
14056,0.014041,172.31.47.0-255,66,243524,92,362110
14057,0.016351,74.125.68.0-255,5738,249262,92,362110
14058,0.016359,172.31.47.0-255,66,249328,92,362110
14059,0.01865,74.125.68.0-255,5738,255066,92,362110
14060,0.018659,172.31.47.0-255,66,255132,92,362110
14061,0.020944,74.125.68.0-255,5738,260870,92,362110
14062,0.02095,172.31.47.0-255,66,260936,92,362110
14063,0.021898,172.31.47.0-255,172,261108,92,362110
14064,0.021928,172.31.47.0-255,1111,262219,92,362110
14065,0.021994,172.31.47.0-255,1514,263733,92,362110
14066,0.021995,172.31.47.0-255,1514,265247,92,362110
14067,0.021997,172.31.47.0-255,1514,266761,92,362110
14068,0.021998,172.31.47.0-255,1514,268275,92,362110
14069,0.022023,172.31.47.0-255,533,268808,92,362110
14070,0.02324,74.125.68.0-255,5738,274546,92,362110
14071,0.023246,172.31.47.0-255,66,274612,92,362110
14072,0.023416,104.244.42.0-255,66,274678,92,362110
14073,0.023532,104.244.42.0-255,66,274744,92,362110
14074,0.023537,104.244.42.0-255,66,274810,92,362110
14075,0.02354,104.244.42.0-255,66,274876,92,362110
14076,0.024166,104.244.42.0-255,108,274984,92,362110
14077,0.024171,172.31.47.0-255,66,275050,92,362110
14078,0.025524,74.125.68.0-255,5738,280788,92,362110
14079,0.025529,172.31.47.0-255,66,280854,92,362110
14080,0.027815,74.125.68.0-255,5738,286592,92,362110
14081,0.02782,172.31.47.0-255,66,286658,92,362110
14082,0.030106,74.125.68.0-255,5738,292396,92,362110
14083,0.030111,172.31.47.0-255,66,292462,92,362110
14084,0.032403,74.125.68.0-255,5738,298200,92,362110
14085,0.032409,172.31.47.0-255,66,298266,92,362110
14086,0.034712,74.125.68.0-255,5738,304004,92,362110
14087,0.034718,172.31.47.0-255,66,304070,92,362110
14088,0.037009,74.125.68.0-255,5738,309808,92,362110
14089,0.037014,172.31.47.0-255,66,309874,92,362110
14090,0.039306,74.125.68.0-255,5738,315612,92,362110
14091,0.039313,172.31.47.0-255,66,315678,92,362110
14092,0.041609,74.125.68.0-255,5738,321416,92,362110
14093,0.041623,172.31.47.0-255,66,321482,92,362110
14094,0.043907,74.125.68.0-255,5738,327220,92,362110
14095,0.043914,172.31.47.0-255,66,327286,92,362110
14096,0.046202,74.125.68.0-255,5738,333024,92,362110
14097,0.046208,172.31.47.0-255,66,333090,92,362110
14098,0.048513,74.125.68.0-255,5738,338828,92,362110
14099,0.048519,172.31.47.0-255,66,338894,92,362110
14100,0.050807,74.125.68.0-255,5738,344632,92,362110
14101,0.050814,172.31.47.0-255,66,344698,92,362110
14102,0.053115,74.125.68.0-255,5738,350436,92,362110
14103,0.053121,172.31.47.0-255,66,350502,92,362110
14104,0.055413,74.125.68.0-255,5738,356240,92,362110
14105,0.055419,172.31.47.0-255,66,356306,92,362110
14106,0.057735,74.125.68.0-255,5738,362044,92,362110
14107,0.057742,172.31.47.0-255,66,362110,92,362110
14108,0.0,172.217.194.0-255,152,152,92,331645
14109,2.5e-05,172.31.47.0-255,66,218,92,331645
14110,3.2e-05,172.217.194.0-255,1484,1702,92,331645
14111,3.6e-05,172.31.47.0-255,66,1768,92,331645
14112,4.1e-05,172.217.194.0-255,2902,4670,92,331645
14113,4.4e-05,172.31.47.0-255,66,4736,92,331645
14114,5.1e-05,172.217.194.0-255,7156,11892,92,331645
14115,5.4e-05,172.31.47.0-255,66,11958,92,331645
14116,7.1e-05,172.217.194.0-255,1484,13442,92,331645
14117,7.3e-05,172.31.47.0-255,66,13508,92,331645
14118,0.000101,172.217.194.0-255,6416,19924,92,331645
14119,0.000104,172.31.47.0-255,66,19990,92,331645
14120,0.000125,172.217.194.0-255,4320,24310,92,331645
14121,0.000128,172.31.47.0-255,66,24376,92,331645
14122,0.000151,172.217.194.0-255,6797,31173,92,331645
14123,0.000153,172.31.47.0-255,66,31239,92,331645
14124,0.000613,172.217.194.0-255,1484,32723,92,331645
14125,0.000617,172.31.47.0-255,66,32789,92,331645
14126,0.000633,172.217.194.0-255,2902,35691,92,331645
14127,0.000635,172.31.47.0-255,66,35757,92,331645
14128,0.000638,172.217.194.0-255,1484,37241,92,331645
14129,0.00064,172.31.47.0-255,66,37307,92,331645
14130,0.000663,172.217.194.0-255,4320,41627,92,331645
14131,0.000665,172.31.47.0-255,66,41693,92,331645
14132,0.000695,172.217.194.0-255,1484,43177,92,331645
14133,0.000697,172.31.47.0-255,66,43243,92,331645
14134,0.000714,172.217.194.0-255,5738,48981,92,331645
14135,0.000717,172.31.47.0-255,66,49047,92,331645
14136,0.000745,172.217.194.0-255,3961,53008,92,331645
14137,0.000748,172.31.47.0-255,66,53074,92,331645
14138,0.000758,172.31.47.0-255,66,53140,92,331645
14139,0.000779,172.217.194.0-255,1484,54624,92,331645
14140,0.000783,172.217.194.0-255,1379,56003,92,331645
14141,0.000786,172.31.47.0-255,66,56069,92,331645
14142,0.001195,172.217.194.0-255,121,56190,92,331645
14143,0.001492,172.217.194.0-255,1484,57674,92,331645
14144,0.001495,172.31.47.0-255,66,57740,92,331645
14145,0.001499,172.217.194.0-255,1484,59224,92,331645
14146,0.001512,172.217.194.0-255,1484,60708,92,331645
14147,0.001513,172.31.47.0-255,66,60774,92,331645
14148,0.001528,172.217.194.0-255,5738,66512,92,331645
14149,0.00153,172.31.47.0-255,66,66578,92,331645
14150,0.001548,172.217.194.0-255,1484,68062,92,331645
14151,0.001574,172.31.47.0-255,66,68128,92,331645
14152,0.001607,172.217.194.0-255,4320,72448,92,331645
14153,0.001609,172.31.47.0-255,66,72514,92,331645
14154,0.001651,172.217.194.0-255,7156,79670,92,331645
14155,0.001653,172.31.47.0-255,66,79736,92,331645
14156,0.001668,172.217.194.0-255,2184,81920,92,331645
14157,0.00167,172.31.47.0-255,66,81986,92,331645
14158,0.001796,172.217.194.0-255,1484,83470,92,331645
14159,0.001806,172.217.194.0-255,2902,86372,92,331645
14160,0.001808,172.31.47.0-255,66,86438,92,331645
14161,0.001818,172.217.194.0-255,1484,87922,92,331645
14162,0.001833,172.217.194.0-255,4320,92242,92,331645
14163,0.001835,172.31.47.0-255,66,92308,92,331645
14164,0.001854,172.217.194.0-255,4320,96628,92,331645
14165,0.001856,172.31.47.0-255,66,96694,92,331645
14166,0.001868,172.217.194.0-255,4320,101014,92,331645
14167,0.00187,172.31.47.0-255,66,101080,92,331645
14168,0.001895,172.217.194.0-255,7156,108236,92,331645
14169,0.001897,172.31.47.0-255,66,108302,92,331645
14170,0.001899,172.217.194.0-255,1484,109786,92,331645
14171,0.001918,172.217.194.0-255,2902,112688,92,331645
14172,0.00192,172.31.47.0-255,66,112754,92,331645
14173,0.001928,172.217.194.0-255,1484,114238,92,331645
14174,0.001938,172.217.194.0-255,2184,116422,92,331645
14175,0.00194,172.31.47.0-255,66,116488,92,331645
14176,0.00201,172.217.194.0-255,4320,120808,92,331645
14177,0.002012,172.31.47.0-255,66,120874,92,331645
14178,0.002029,172.217.194.0-255,2902,123776,92,331645
14179,0.00203,172.31.47.0-255,66,123842,92,331645
14180,0.002046,172.217.194.0-255,2902,126744,92,331645
14181,0.002048,172.31.47.0-255,66,126810,92,331645
14182,0.002063,172.217.194.0-255,5738,132548,92,331645
14183,0.002065,172.31.47.0-255,66,132614,92,331645
14184,0.002085,172.217.194.0-255,7156,139770,92,331645
14185,0.002087,172.31.47.0-255,66,139836,92,331645
14186,0.002112,172.31.47.0-255,66,139902,92,331645
14187,0.002114,172.217.194.0-255,766,140668,92,331645
14188,0.002138,172.217.194.0-255,1484,142152,92,331645
14189,0.00214,172.31.47.0-255,66,142218,92,331645
14190,0.002143,172.217.194.0-255,1484,143702,92,331645
14191,0.002156,172.217.194.0-255,1484,145186,92,331645
14192,0.002158,172.31.47.0-255,66,145252,92,331645
14193,0.002168,172.217.194.0-255,1484,146736,92,331645
14194,0.002182,172.217.194.0-255,2902,149638,92,331645
14195,0.002184,172.31.47.0-255,66,149704,92,331645
14196,0.002199,172.217.194.0-255,1484,151188,92,331645
14197,0.002208,172.217.194.0-255,1484,152672,92,331645
14198,0.00221,172.31.47.0-255,66,152738,92,331645
14199,0.002227,172.217.194.0-255,1484,154222,92,331645
14200,0.002241,172.217.194.0-255,4320,158542,92,331645
14201,0.002243,172.31.47.0-255,66,158608,92,331645
14202,0.002263,172.217.194.0-255,5738,164346,92,331645
14203,0.002265,172.31.47.0-255,66,164412,92,331645
14204,0.002289,172.217.194.0-255,4320,168732,92,331645
14205,0.002291,172.31.47.0-255,66,168798,92,331645
14206,0.00231,172.217.194.0-255,5738,174536,92,331645
14207,0.002312,172.31.47.0-255,66,174602,92,331645
14208,0.002314,172.217.194.0-255,766,175368,92,331645
14209,0.002331,172.217.194.0-255,1484,176852,92,331645
14210,0.002333,172.31.47.0-255,66,176918,92,331645
14211,0.002355,172.217.194.0-255,1484,178402,92,331645
14212,0.004521,172.217.194.0-255,1484,179886,92,331645
14213,0.004525,172.31.47.0-255,66,179952,92,331645
14214,0.004559,172.217.194.0-255,2902,182854,92,331645
14215,0.004561,172.31.47.0-255,66,182920,92,331645
14216,0.006775,172.217.194.0-255,2902,185822,92,331645
14217,0.006781,172.31.47.0-255,66,185888,92,331645
14218,0.006803,172.217.194.0-255,1484,187372,92,331645
14219,0.006815,172.217.194.0-255,1484,188856,92,331645
14220,0.006818,172.31.47.0-255,66,188922,92,331645
14221,0.009146,172.217.194.0-255,5738,194660,92,331645
14222,0.009153,172.31.47.0-255,66,194726,92,331645
14223,0.011422,172.217.194.0-255,5738,200464,92,331645
14224,0.01143,172.31.47.0-255,66,200530,92,331645
14225,0.013732,172.217.194.0-255,5738,206268,92,331645
14226,0.013741,172.31.47.0-255,66,206334,92,331645
14227,0.016003,172.217.194.0-255,5738,212072,92,331645
14228,0.016013,172.31.47.0-255,66,212138,92,331645
14229,0.018274,172.217.194.0-255,5738,217876,92,331645
14230,0.01828,172.31.47.0-255,66,217942,92,331645
14231,0.020527,172.217.194.0-255,5738,223680,92,331645
14232,0.020535,172.31.47.0-255,66,223746,92,331645
14233,0.022794,172.217.194.0-255,5738,229484,92,331645
14234,0.022804,172.31.47.0-255,66,229550,92,331645
14235,0.025072,172.217.194.0-255,5738,235288,92,331645
14236,0.025081,172.31.47.0-255,66,235354,92,331645
14237,0.027318,172.217.194.0-255,5738,241092,92,331645
14238,0.027325,172.31.47.0-255,66,241158,92,331645
14239,0.029576,172.217.194.0-255,5738,246896,92,331645
14240,0.029581,172.31.47.0-255,66,246962,92,331645
14241,0.030035,172.31.47.0-255,172,247134,92,331645
14242,0.03008,172.31.47.0-255,1111,248245,92,331645
14243,0.030108,172.31.47.0-255,1514,249759,92,331645
14244,0.030109,172.31.47.0-255,1514,251273,92,331645
14245,0.030111,172.31.47.0-255,1514,252787,92,331645
14246,0.030112,172.31.47.0-255,1514,254301,92,331645
14247,0.030113,172.31.47.0-255,1496,255797,92,331645
14248,0.031599,104.244.42.0-255,66,255863,92,331645
14249,0.031641,104.244.42.0-255,66,255929,92,331645
14250,0.031689,104.244.42.0-255,66,255995,92,331645
14251,0.031832,172.217.194.0-255,5738,261733,92,331645
14252,0.031837,172.31.47.0-255,66,261799,92,331645
14253,0.03413,172.217.194.0-255,2902,264701,92,331645
14254,0.034136,172.31.47.0-255,66,264767,92,331645
14255,0.034157,172.217.194.0-255,2902,267669,92,331645
14256,0.034159,172.31.47.0-255,66,267735,92,331645
14257,0.036375,172.217.194.0-255,5738,273473,92,331645
14258,0.036383,172.31.47.0-255,66,273539,92,331645
14259,0.038618,172.217.194.0-255,5738,279277,92,331645
14260,0.038623,172.31.47.0-255,66,279343,92,331645
14261,0.040843,172.217.194.0-255,5738,285081,92,331645
14262,0.040849,172.31.47.0-255,66,285147,92,331645
14263,0.043101,172.217.194.0-255,5738,290885,92,331645
14264,0.043107,172.31.47.0-255,66,290951,92,331645
14265,0.045358,172.217.194.0-255,5738,296689,92,331645
14266,0.045364,172.31.47.0-255,66,296755,92,331645
14267,0.047613,172.217.194.0-255,5738,302493,92,331645
14268,0.047619,172.31.47.0-255,66,302559,92,331645
14269,0.049867,172.217.194.0-255,5738,308297,92,331645
14270,0.049874,172.31.47.0-255,66,308363,92,331645
14271,0.052153,172.217.194.0-255,5738,314101,92,331645
14272,0.052161,172.31.47.0-255,66,314167,92,331645
14273,0.054417,172.217.194.0-255,5738,319905,92,331645
14274,0.054424,172.31.47.0-255,66,319971,92,331645
14275,0.056652,172.217.194.0-255,1484,321455,92,331645
14276,0.056684,172.217.194.0-255,4320,325775,92,331645
14277,0.056689,172.31.47.0-255,66,325841,92,331645
14278,0.058924,172.217.194.0-255,5738,331579,92,331645
14279,0.058929,172.31.47.0-255,66,331645,92,331645
14280,0.0,172.217.194.0-255,153,153,92,192663
14281,2.1e-05,172.31.47.0-255,66,219,92,192663
14282,2.7e-05,172.217.194.0-255,1484,1703,92,192663
14283,3e-05,172.31.47.0-255,66,1769,92,192663
14284,3.5e-05,172.217.194.0-255,2902,4671,92,192663
14285,3.7e-05,172.31.47.0-255,66,4737,92,192663
14286,4.3e-05,172.217.194.0-255,5738,10475,92,192663
14287,4.5e-05,172.31.47.0-255,66,10541,92,192663
14288,5.8e-05,172.217.194.0-255,1484,12025,92,192663
14289,6e-05,172.31.47.0-255,66,12091,92,192663
14290,6.6e-05,172.217.194.0-255,4927,17018,92,192663
14291,6.8e-05,172.31.47.0-255,66,17084,92,192663
14292,7.2e-05,172.217.194.0-255,2902,19986,92,192663
14293,7.3e-05,172.31.47.0-255,66,20052,92,192663
14294,0.000105,172.31.47.0-255,66,20118,92,192663
14295,0.000131,172.217.194.0-255,1484,21602,92,192663
14296,0.000133,172.31.47.0-255,66,21668,92,192663
14297,0.000137,172.217.194.0-255,2902,24570,92,192663
14298,0.000138,172.31.47.0-255,66,24636,92,192663
14299,0.000158,172.217.194.0-255,5738,30374,92,192663
14300,0.00016,172.31.47.0-255,66,30440,92,192663
14301,0.000162,172.217.194.0-255,1484,31924,92,192663
14302,0.000163,172.31.47.0-255,66,31990,92,192663
14303,0.000198,172.31.47.0-255,66,32056,92,192663
14304,0.000222,172.217.194.0-255,2902,34958,92,192663
14305,0.000224,172.31.47.0-255,66,35024,92,192663
14306,0.000247,172.31.47.0-255,66,35090,92,192663
14307,0.000249,172.217.194.0-255,119,35209,92,192663
14308,0.000251,172.31.47.0-255,66,35275,92,192663
14309,0.000253,172.217.194.0-255,381,35656,92,192663
14310,0.000542,172.217.194.0-255,1484,37140,92,192663
14311,0.000546,172.31.47.0-255,66,37206,92,192663
14312,0.00055,172.217.194.0-255,2902,40108,92,192663
14313,0.000552,172.31.47.0-255,66,40174,92,192663
14314,0.000573,172.217.194.0-255,5738,45912,92,192663
14315,0.000575,172.31.47.0-255,66,45978,92,192663
14316,0.000609,172.31.47.0-255,66,46044,92,192663
14317,0.000619,172.31.47.0-255,66,46110,92,192663
14318,0.00066,172.217.194.0-255,7156,53266,92,192663
14319,0.000665,172.31.47.0-255,66,53332,92,192663
14320,0.000678,172.217.194.0-255,2902,56234,92,192663
14321,0.000681,172.31.47.0-255,66,56300,92,192663
14322,0.00069,172.31.47.0-255,66,56366,92,192663
14323,0.000716,172.217.194.0-255,7156,63522,92,192663
14324,0.000719,172.31.47.0-255,66,63588,92,192663
14325,0.00074,172.217.194.0-255,4471,68059,92,192663
14326,0.000742,172.31.47.0-255,66,68125,92,192663
14327,0.000756,172.217.194.0-255,2902,71027,92,192663
14328,0.000759,172.31.47.0-255,66,71093,92,192663
14329,0.000795,172.31.47.0-255,66,71159,92,192663
14330,0.000797,172.217.194.0-255,1484,72643,92,192663
14331,0.000812,172.217.194.0-255,3602,76245,92,192663
14332,0.000844,172.217.194.0-255,1484,77729,92,192663
14333,0.000857,172.217.194.0-255,2902,80631,92,192663
14334,0.000891,172.217.194.0-255,4320,84951,92,192663
14335,0.000896,172.31.47.0-255,66,85017,92,192663
14336,0.000911,172.217.194.0-255,3602,88619,92,192663
14337,0.000927,172.31.47.0-255,66,88685,92,192663
14338,0.000961,172.217.194.0-255,4320,93005,92,192663
14339,0.000965,172.217.194.0-255,1484,94489,92,192663
14340,0.000972,172.31.47.0-255,66,94555,92,192663
14341,0.000983,172.217.194.0-255,4320,98875,92,192663
14342,0.000987,172.217.194.0-255,4320,103195,92,192663
14343,0.001002,172.217.194.0-255,7156,110351,92,192663
14344,0.001004,172.217.194.0-255,1484,111835,92,192663
14345,0.001022,172.31.47.0-255,66,111901,92,192663
14346,0.001038,172.31.47.0-255,66,111967,92,192663
14347,0.001065,172.217.194.0-255,4320,116287,92,192663
14348,0.001072,172.31.47.0-255,66,116353,92,192663
14349,0.001111,172.217.194.0-255,2902,119255,92,192663
14350,0.001117,172.31.47.0-255,66,119321,92,192663
14351,0.001147,172.31.47.0-255,66,119387,92,192663
14352,0.001172,172.217.194.0-255,766,120153,92,192663
14353,0.001213,172.31.47.0-255,66,120219,92,192663
14354,0.001246,172.217.194.0-255,1484,121703,92,192663
14355,0.001251,172.217.194.0-255,2902,124605,92,192663
14356,0.001262,172.31.47.0-255,66,124671,92,192663
14357,0.001267,172.217.194.0-255,4320,128991,92,192663
14358,0.001272,172.31.47.0-255,66,129057,92,192663
14359,0.001279,172.217.194.0-255,1484,130541,92,192663
14360,0.001281,172.217.194.0-255,1484,132025,92,192663
14361,0.001315,172.217.194.0-255,1484,133509,92,192663
14362,0.001327,172.31.47.0-255,66,133575,92,192663
14363,0.001345,172.31.47.0-255,66,133641,92,192663
14364,0.001375,172.217.194.0-255,2902,136543,92,192663
14365,0.00138,172.31.47.0-255,66,136609,92,192663
14366,0.001399,172.217.194.0-255,2902,139511,92,192663
14367,0.001406,172.217.194.0-255,7156,146667,92,192663
14368,0.00145,172.217.194.0-255,1484,148151,92,192663
14369,0.001471,172.217.194.0-255,5020,153171,92,192663
14370,0.001486,172.31.47.0-255,66,153237,92,192663
14371,0.001512,172.217.194.0-255,1484,154721,92,192663
14372,0.001517,172.217.194.0-255,2902,157623,92,192663
14373,0.001532,172.217.194.0-255,4320,161943,92,192663
14374,0.001542,172.217.194.0-255,1484,163427,92,192663
14375,0.001553,172.217.194.0-255,2902,166329,92,192663
14376,0.001569,172.217.194.0-255,1484,167813,92,192663
14377,0.001573,172.31.47.0-255,66,167879,92,192663
14378,0.001578,172.31.47.0-255,66,167945,92,192663
14379,0.001616,172.31.47.0-255,66,168011,92,192663
14380,0.001627,172.217.194.0-255,5738,173749,92,192663
14381,0.001633,172.31.47.0-255,66,173815,92,192663
14382,0.001659,172.217.194.0-255,6438,180253,92,192663
14383,0.001672,172.217.194.0-255,2902,183155,92,192663
14384,0.001683,172.31.47.0-255,66,183221,92,192663
14385,0.001705,172.217.194.0-255,105,183326,92,192663
14386,0.001733,172.31.47.0-255,66,183392,92,192663
14387,0.010184,172.31.47.0-255,105,183497,92,192663
14388,0.012486,172.217.194.0-255,66,183563,92,192663
14389,0.036858,172.31.47.0-255,172,183735,92,192663
14390,0.036904,172.31.47.0-255,1112,184847,92,192663
14391,0.036978,172.31.47.0-255,1514,186361,92,192663
14392,0.03698,172.31.47.0-255,1514,187875,92,192663
14393,0.036985,172.31.47.0-255,1514,189389,92,192663
14394,0.036986,172.31.47.0-255,1514,190903,92,192663
14395,0.037007,172.31.47.0-255,1496,192399,92,192663
14396,0.03835,104.244.42.0-255,66,192465,92,192663
14397,0.038387,104.244.42.0-255,66,192531,92,192663
14398,0.038494,104.244.42.0-255,66,192597,92,192663
14399,0.03852,104.244.42.0-255,66,192663,92,192663
14400,0.0,172.31.47.0-255,105,105,92,105
14401,0.0,172.217.194.0-255,153,153,92,282228
14402,2.4e-05,172.31.47.0-255,66,219,92,282228
14403,3e-05,172.217.194.0-255,1484,1703,92,282228
14404,3.3e-05,172.31.47.0-255,66,1769,92,282228
14405,3.8e-05,172.217.194.0-255,2902,4671,92,282228
14406,3.9e-05,172.31.47.0-255,66,4737,92,282228
14407,4.5e-05,172.217.194.0-255,7156,11893,92,282228
14408,4.7e-05,172.31.47.0-255,66,11959,92,282228
14409,8.1e-05,172.31.47.0-255,66,12025,92,282228
14410,0.000112,172.217.194.0-255,2902,14927,92,282228
14411,0.000114,172.31.47.0-255,66,14993,92,282228
14412,0.000133,172.217.194.0-255,3961,18954,92,282228
14413,0.000135,172.31.47.0-255,66,19020,92,282228
14414,0.000151,172.217.194.0-255,1484,20504,92,282228
14415,0.000153,172.31.47.0-255,66,20570,92,282228
14416,0.000174,172.217.194.0-255,2902,23472,92,282228
14417,0.000176,172.31.47.0-255,66,23538,92,282228
14418,0.000181,172.217.194.0-255,5738,29276,92,282228
14419,0.000183,172.31.47.0-255,66,29342,92,282228
14420,0.000205,172.217.194.0-255,4320,33662,92,282228
14421,0.000208,172.31.47.0-255,66,33728,92,282228
14422,0.000243,172.217.194.0-255,2543,36271,92,282228
14423,0.000245,172.31.47.0-255,66,36337,92,282228
14424,0.000394,172.217.194.0-255,1484,37821,92,282228
14425,0.000397,172.31.47.0-255,66,37887,92,282228
14426,0.000402,172.217.194.0-255,2902,40789,92,282228
14427,0.000404,172.31.47.0-255,66,40855,92,282228
14428,0.000421,172.217.194.0-255,5738,46593,92,282228
14429,0.000423,172.31.47.0-255,66,46659,92,282228
14430,0.000443,172.217.194.0-255,7112,53771,92,282228
14431,0.000448,172.31.47.0-255,66,53837,92,282228
14432,0.000679,172.217.194.0-255,363,54200,92,282228
14433,0.000707,172.31.47.0-255,66,54266,92,282228
14434,0.000956,172.217.194.0-255,1484,55750,92,282228
14435,0.000963,172.217.194.0-255,2902,58652,92,282228
14436,0.000967,172.31.47.0-255,66,58718,92,282228
14437,0.000973,172.217.194.0-255,2902,61620,92,282228
14438,0.000974,172.31.47.0-255,66,61686,92,282228
14439,0.000989,172.217.194.0-255,2902,64588,92,282228
14440,0.000991,172.31.47.0-255,66,64654,92,282228
14441,0.000998,172.217.194.0-255,7156,71810,92,282228
14442,0.000999,172.31.47.0-255,66,71876,92,282228
14443,0.001027,172.217.194.0-255,5738,77614,92,282228
14444,0.00103,172.31.47.0-255,66,77680,92,282228
14445,0.001039,172.31.47.0-255,66,77746,92,282228
14446,0.001065,172.217.194.0-255,766,78512,92,282228
14447,0.001289,172.217.194.0-255,1484,79996,92,282228
14448,0.001294,172.31.47.0-255,66,80062,92,282228
14449,0.001298,172.217.194.0-255,2902,82964,92,282228
14450,0.0013,172.31.47.0-255,66,83030,92,282228
14451,0.001305,172.217.194.0-255,5738,88768,92,282228
14452,0.001307,172.31.47.0-255,66,88834,92,282228
14453,0.001346,172.217.194.0-255,7156,95990,92,282228
14454,0.001348,172.31.47.0-255,66,96056,92,282228
14455,0.001357,172.31.47.0-255,66,96122,92,282228
14456,0.001369,172.217.194.0-255,4320,100442,92,282228
14457,0.001371,172.31.47.0-255,66,100508,92,282228
14458,0.001375,172.217.194.0-255,2184,102692,92,282228
14459,0.001376,172.31.47.0-255,66,102758,92,282228
14460,0.002006,172.217.194.0-255,1484,104242,92,282228
14461,0.002039,172.217.194.0-255,2902,107144,92,282228
14462,0.002043,172.31.47.0-255,66,107210,92,282228
14463,0.002048,172.217.194.0-255,4320,111530,92,282228
14464,0.00205,172.31.47.0-255,66,111596,92,282228
14465,0.002063,172.217.194.0-255,1484,113080,92,282228
14466,0.002072,172.217.194.0-255,1484,114564,92,282228
14467,0.002074,172.31.47.0-255,66,114630,92,282228
14468,0.002094,172.217.194.0-255,7156,121786,92,282228
14469,0.002097,172.31.47.0-255,66,121852,92,282228
14470,0.002134,172.217.194.0-255,4320,126172,92,282228
14471,0.002137,172.31.47.0-255,66,126238,92,282228
14472,0.002153,172.217.194.0-255,2902,129140,92,282228
14473,0.002155,172.31.47.0-255,66,129206,92,282228
14474,0.002163,172.31.47.0-255,66,129272,92,282228
14475,0.004459,172.217.194.0-255,5738,135010,92,282228
14476,0.004463,172.31.47.0-255,66,135076,92,282228
14477,0.006765,172.217.194.0-255,5738,140814,92,282228
14478,0.006773,172.31.47.0-255,66,140880,92,282228
14479,0.009088,172.217.194.0-255,5738,146618,92,282228
14480,0.009097,172.31.47.0-255,66,146684,92,282228
14481,0.011406,172.217.194.0-255,5738,152422,92,282228
14482,0.011415,172.31.47.0-255,66,152488,92,282228
14483,0.013698,172.217.194.0-255,5738,158226,92,282228
14484,0.013706,172.31.47.0-255,66,158292,92,282228
14485,0.015993,172.217.194.0-255,5738,164030,92,282228
14486,0.016,172.31.47.0-255,66,164096,92,282228
14487,0.018308,172.217.194.0-255,5738,169834,92,282228
14488,0.018314,172.31.47.0-255,66,169900,92,282228
14489,0.020614,172.217.194.0-255,5738,175638,92,282228
14490,0.02062,172.31.47.0-255,66,175704,92,282228
14491,0.022899,172.217.194.0-255,5738,181442,92,282228
14492,0.022905,172.31.47.0-255,66,181508,92,282228
14493,0.02519,172.217.194.0-255,5738,187246,92,282228
14494,0.025197,172.31.47.0-255,66,187312,92,282228
14495,0.02714,172.31.47.0-255,172,187484,92,282228
14496,0.027184,172.31.47.0-255,1107,188591,92,282228
14497,0.027263,172.31.47.0-255,1514,190105,92,282228
14498,0.027265,172.31.47.0-255,1514,191619,92,282228
14499,0.027266,172.31.47.0-255,1514,193133,92,282228
14500,0.027267,172.31.47.0-255,1514,194647,92,282228
14501,0.027297,172.31.47.0-255,1501,196148,92,282228
14502,0.027518,172.217.194.0-255,5738,201886,92,282228
14503,0.027525,172.31.47.0-255,66,201952,92,282228
14504,0.028629,104.244.42.0-255,66,202018,92,282228
14505,0.028675,104.244.42.0-255,66,202084,92,282228
14506,0.028808,104.244.42.0-255,66,202150,92,282228
14507,0.02944,104.244.42.0-255,108,202258,92,282228
14508,0.029444,172.31.47.0-255,66,202324,92,282228
14509,0.029808,172.217.194.0-255,4320,206644,92,282228
14510,0.029812,172.31.47.0-255,66,206710,92,282228
14511,0.029834,172.217.194.0-255,1484,208194,92,282228
14512,0.032128,172.217.194.0-255,4320,212514,92,282228
14513,0.032133,172.31.47.0-255,66,212580,92,282228
14514,0.034425,172.217.194.0-255,5738,218318,92,282228
14515,0.034432,172.31.47.0-255,66,218384,92,282228
14516,0.03671,172.217.194.0-255,5738,224122,92,282228
14517,0.036715,172.31.47.0-255,66,224188,92,282228
14518,0.038994,172.217.194.0-255,5738,229926,92,282228
14519,0.038998,172.31.47.0-255,66,229992,92,282228
14520,0.041289,172.217.194.0-255,5738,235730,92,282228
14521,0.041293,172.31.47.0-255,66,235796,92,282228
14522,0.043611,172.217.194.0-255,5738,241534,92,282228
14523,0.043617,172.31.47.0-255,66,241600,92,282228
14524,0.04591,172.217.194.0-255,5738,247338,92,282228
14525,0.045916,172.31.47.0-255,66,247404,92,282228
14526,0.048215,172.217.194.0-255,5738,253142,92,282228
14527,0.048219,172.31.47.0-255,66,253208,92,282228
14528,0.050512,172.217.194.0-255,5738,258946,92,282228
14529,0.050516,172.31.47.0-255,66,259012,92,282228
14530,0.052795,172.217.194.0-255,5738,264750,92,282228
14531,0.052799,172.31.47.0-255,66,264816,92,282228
14532,0.055168,172.217.194.0-255,5738,270554,92,282228
14533,0.055173,172.31.47.0-255,66,270620,92,282228
14534,0.057448,172.217.194.0-255,5738,276358,92,282228
14535,0.057453,172.31.47.0-255,66,276424,92,282228
14536,0.059763,172.217.194.0-255,5738,282162,92,282228
14537,0.059767,172.31.47.0-255,66,282228,92,282228
14538,0.0,172.217.194.0-255,153,153,92,336929
14539,3.3e-05,172.31.47.0-255,66,219,92,336929
14540,3.9e-05,172.217.194.0-255,1484,1703,92,336929
14541,4.4e-05,172.31.47.0-255,66,1769,92,336929
14542,4.9e-05,172.217.194.0-255,2902,4671,92,336929
14543,5.1e-05,172.31.47.0-255,66,4737,92,336929
14544,5.8e-05,172.217.194.0-255,7156,11893,92,336929
14545,6.1e-05,172.31.47.0-255,66,11959,92,336929
14546,8.6e-05,172.31.47.0-255,66,12025,92,336929
14547,0.000108,172.217.194.0-255,3497,15522,92,336929
14548,0.00011,172.31.47.0-255,66,15588,92,336929
14549,0.000116,172.217.194.0-255,6797,22385,92,336929
14550,0.000119,172.31.47.0-255,66,22451,92,336929
14551,0.000208,172.217.194.0-255,1484,23935,92,336929
14552,0.000213,172.31.47.0-255,66,24001,92,336929
14553,0.000217,172.217.194.0-255,1484,25485,92,336929
14554,0.000219,172.31.47.0-255,66,25551,92,336929
14555,0.000236,172.217.194.0-255,1484,27035,92,336929
14556,0.000239,172.31.47.0-255,66,27101,92,336929
14557,0.000246,172.217.194.0-255,5738,32839,92,336929
14558,0.000248,172.31.47.0-255,66,32905,92,336929
14559,0.000255,172.217.194.0-255,6797,39702,92,336929
14560,0.000257,172.31.47.0-255,66,39768,92,336929
14561,0.000262,172.217.194.0-255,2902,42670,92,336929
14562,0.000265,172.31.47.0-255,66,42736,92,336929
14563,0.000285,172.217.194.0-255,4320,47056,92,336929
14564,0.000289,172.31.47.0-255,66,47122,92,336929
14565,0.00031,172.217.194.0-255,4320,51442,92,336929
14566,0.000314,172.31.47.0-255,66,51508,92,336929
14567,0.00034,172.217.194.0-255,5636,57144,92,336929
14568,0.000344,172.31.47.0-255,66,57210,92,336929
14569,0.000346,172.217.194.0-255,428,57638,92,336929
14570,0.00042,172.217.194.0-255,1484,59122,92,336929
14571,0.000423,172.31.47.0-255,66,59188,92,336929
14572,0.000456,172.217.194.0-255,2902,62090,92,336929
14573,0.00046,172.31.47.0-255,66,62156,92,336929
14574,0.000467,172.217.194.0-255,5738,67894,92,336929
14575,0.000471,172.217.194.0-255,2902,70796,92,336929
14576,0.000472,172.31.47.0-255,66,70862,92,336929
14577,0.000476,172.31.47.0-255,66,70928,92,336929
14578,0.000504,172.217.194.0-255,3961,74889,92,336929
14579,0.000507,172.31.47.0-255,66,74955,92,336929
14580,0.000514,172.217.194.0-255,7156,82111,92,336929
14581,0.000517,172.31.47.0-255,66,82177,92,336929
14582,0.000527,172.31.47.0-255,66,82243,92,336929
14583,0.001,172.217.194.0-255,1484,83727,92,336929
14584,0.001007,172.217.194.0-255,2902,86629,92,336929
14585,0.001011,172.31.47.0-255,66,86695,92,336929
14586,0.001032,172.217.194.0-255,5738,92433,92,336929
14587,0.001034,172.31.47.0-255,66,92499,92,336929
14588,0.001085,172.31.47.0-255,66,92565,92,336929
14589,0.001107,172.217.194.0-255,4320,96885,92,336929
14590,0.00111,172.31.47.0-255,66,96951,92,336929
14591,0.001121,172.31.47.0-255,66,97017,92,336929
14592,0.001124,172.217.194.0-255,766,97783,92,336929
14593,0.001127,172.217.194.0-255,1484,99267,92,336929
14594,0.001129,172.31.47.0-255,66,99333,92,336929
14595,0.001134,172.217.194.0-255,4320,103653,92,336929
14596,0.001137,172.31.47.0-255,66,103719,92,336929
14597,0.001172,172.31.47.0-255,66,103785,92,336929
14598,0.001182,172.31.47.0-255,66,103851,92,336929
14599,0.001217,172.217.194.0-255,2902,106753,92,336929
14600,0.001221,172.31.47.0-255,66,106819,92,336929
14601,0.001244,172.217.194.0-255,6438,113257,92,336929
14602,0.001247,172.31.47.0-255,66,113323,92,336929
14603,0.001259,172.31.47.0-255,66,113389,92,336929
14604,0.001263,172.217.194.0-255,2902,116291,92,336929
14605,0.001266,172.31.47.0-255,66,116357,92,336929
14606,0.001285,172.217.194.0-255,7156,123513,92,336929
14607,0.001287,172.31.47.0-255,66,123579,92,336929
14608,0.001327,172.217.194.0-255,7156,130735,92,336929
14609,0.00133,172.31.47.0-255,66,130801,92,336929
14610,0.001354,172.217.194.0-255,6438,137239,92,336929
14611,0.001357,172.31.47.0-255,66,137305,92,336929
14612,0.001722,172.217.194.0-255,1484,138789,92,336929
14613,0.001727,172.217.194.0-255,2902,141691,92,336929
14614,0.001731,172.31.47.0-255,66,141757,92,336929
14615,0.00175,172.217.194.0-255,1484,143241,92,336929
14616,0.001755,172.217.194.0-255,2902,146143,92,336929
14617,0.001757,172.31.47.0-255,66,146209,92,336929
14618,0.001776,172.217.194.0-255,2902,149111,92,336929
14619,0.001779,172.31.47.0-255,66,149177,92,336929
14620,0.001783,172.217.194.0-255,2902,152079,92,336929
14621,0.001785,172.31.47.0-255,66,152145,92,336929
14622,0.001818,172.31.47.0-255,66,152211,92,336929
14623,0.001824,172.217.194.0-255,5738,157949,92,336929
14624,0.001826,172.31.47.0-255,66,158015,92,336929
14625,0.001844,172.217.194.0-255,1484,159499,92,336929
14626,0.001856,172.217.194.0-255,2184,161683,92,336929
14627,0.001859,172.31.47.0-255,66,161749,92,336929
14628,0.002402,172.217.194.0-255,1484,163233,92,336929
14629,0.002407,172.217.194.0-255,1484,164717,92,336929
14630,0.00241,172.31.47.0-255,66,164783,92,336929
14631,0.002429,172.217.194.0-255,1484,166267,92,336929
14632,0.002435,172.217.194.0-255,5738,172005,92,336929
14633,0.002437,172.31.47.0-255,66,172071,92,336929
14634,0.002442,172.217.194.0-255,4320,176391,92,336929
14635,0.002444,172.31.47.0-255,66,176457,92,336929
14636,0.002481,172.31.47.0-255,66,176523,92,336929
14637,0.002491,172.31.47.0-255,66,176589,92,336929
14638,0.002514,172.217.194.0-255,2184,178773,92,336929
14639,0.002516,172.31.47.0-255,66,178839,92,336929
14640,0.002532,172.217.194.0-255,2902,181741,92,336929
14641,0.002535,172.31.47.0-255,66,181807,92,336929
14642,0.00255,172.217.194.0-255,1484,183291,92,336929
14643,0.002569,172.217.194.0-255,5738,189029,92,336929
14644,0.002573,172.31.47.0-255,66,189095,92,336929
14645,0.002579,172.217.194.0-255,4320,193415,92,336929
14646,0.002581,172.31.47.0-255,66,193481,92,336929
14647,0.002601,172.217.194.0-255,7156,200637,92,336929
14648,0.002605,172.31.47.0-255,66,200703,92,336929
14649,0.002608,172.217.194.0-255,1484,202187,92,336929
14650,0.002639,172.31.47.0-255,66,202253,92,336929
14651,0.005201,172.217.194.0-255,4320,206573,92,336929
14652,0.005208,172.31.47.0-255,66,206639,92,336929
14653,0.005223,172.217.194.0-255,1484,208123,92,336929
14654,0.00778,172.217.194.0-255,4320,212443,92,336929
14655,0.007785,172.31.47.0-255,66,212509,92,336929
14656,0.01037,172.217.194.0-255,4320,216829,92,336929
14657,0.010378,172.31.47.0-255,66,216895,92,336929
14658,0.010395,172.217.194.0-255,1484,218379,92,336929
14659,0.012959,172.217.194.0-255,4320,222699,92,336929
14660,0.012968,172.31.47.0-255,66,222765,92,336929
14661,0.015559,172.217.194.0-255,5738,228503,92,336929
14662,0.015566,172.31.47.0-255,66,228569,92,336929
14663,0.018139,172.217.194.0-255,5738,234307,92,336929
14664,0.018149,172.31.47.0-255,66,234373,92,336929
14665,0.020728,172.217.194.0-255,5738,240111,92,336929
14666,0.020737,172.31.47.0-255,66,240177,92,336929
14667,0.023408,172.217.194.0-255,5738,245915,92,336929
14668,0.023418,172.31.47.0-255,66,245981,92,336929
14669,0.026002,172.217.194.0-255,5738,251719,92,336929
14670,0.026009,172.31.47.0-255,66,251785,92,336929
14671,0.028587,172.217.194.0-255,5738,257523,92,336929
14672,0.028595,172.31.47.0-255,66,257589,92,336929
14673,0.031163,172.217.194.0-255,5738,263327,92,336929
14674,0.031171,172.31.47.0-255,66,263393,92,336929
14675,0.033734,172.217.194.0-255,5738,269131,92,336929
14676,0.033741,172.31.47.0-255,66,269197,92,336929
14677,0.036324,172.217.194.0-255,5738,274935,92,336929
14678,0.036332,172.31.47.0-255,66,275001,92,336929
14679,0.036441,172.31.47.0-255,172,275173,92,336929
14680,0.036499,172.31.47.0-255,1112,276285,92,336929
14681,0.036578,172.31.47.0-255,1514,277799,92,336929
14682,0.03658,172.31.47.0-255,1514,279313,92,336929
14683,0.036584,172.31.47.0-255,1514,280827,92,336929
14684,0.036585,172.31.47.0-255,1514,282341,92,336929
14685,0.036607,172.31.47.0-255,1494,283835,92,336929
14686,0.037983,104.244.42.0-255,66,283901,92,336929
14687,0.03808,104.244.42.0-255,66,283967,92,336929
14688,0.038174,104.244.42.0-255,66,284033,92,336929
14689,0.0389,172.217.194.0-255,2902,286935,92,336929
14690,0.038904,172.31.47.0-255,66,287001,92,336929
14691,0.038937,172.217.194.0-255,2902,289903,92,336929
14692,0.03894,172.31.47.0-255,66,289969,92,336929
14693,0.041464,172.217.194.0-255,2902,292871,92,336929
14694,0.041469,172.31.47.0-255,66,292937,92,336929
14695,0.041497,172.217.194.0-255,2902,295839,92,336929
14696,0.041499,172.31.47.0-255,66,295905,92,336929
14697,0.044021,172.217.194.0-255,2902,298807,92,336929
14698,0.044026,172.31.47.0-255,66,298873,92,336929
14699,0.044059,172.217.194.0-255,2902,301775,92,336929
14700,0.044062,172.31.47.0-255,66,301841,92,336929
14701,0.046593,172.217.194.0-255,2902,304743,92,336929
14702,0.046598,172.31.47.0-255,66,304809,92,336929
14703,0.046635,172.217.194.0-255,2902,307711,92,336929
14704,0.046638,172.31.47.0-255,66,307777,92,336929
14705,0.049169,172.217.194.0-255,2902,310679,92,336929
14706,0.049186,172.31.47.0-255,66,310745,92,336929
14707,0.049199,172.217.194.0-255,2902,313647,92,336929
14708,0.049202,172.31.47.0-255,66,313713,92,336929
14709,0.05175,172.217.194.0-255,5738,319451,92,336929
14710,0.051758,172.31.47.0-255,66,319517,92,336929
14711,0.054311,172.217.194.0-255,5738,325255,92,336929
14712,0.054317,172.31.47.0-255,66,325321,92,336929
14713,0.056871,172.217.194.0-255,5738,331059,92,336929
14714,0.056877,172.31.47.0-255,66,331125,92,336929
14715,0.059448,172.217.194.0-255,5738,336863,92,336929
14716,0.059453,172.31.47.0-255,66,336929,92,336929
14717,0.0,172.217.194.0-255,153,153,92,319390
14718,2e-05,172.31.47.0-255,66,219,92,319390
14719,2.5e-05,172.217.194.0-255,1484,1703,92,319390
14720,2.9e-05,172.31.47.0-255,66,1769,92,319390
14721,3.4e-05,172.217.194.0-255,2902,4671,92,319390
14722,3.7e-05,172.31.47.0-255,66,4737,92,319390
14723,4.2e-05,172.217.194.0-255,5738,10475,92,319390
14724,4.4e-05,172.31.47.0-255,66,10541,92,319390
14725,6.9e-05,172.217.194.0-255,1484,12025,92,319390
14726,7e-05,172.31.47.0-255,66,12091,92,319390
14727,7.4e-05,172.217.194.0-255,2205,14296,92,319390
14728,7.6e-05,172.31.47.0-255,66,14362,92,319390
14729,0.000168,172.217.194.0-255,1484,15846,92,319390
14730,0.000171,172.31.47.0-255,66,15912,92,319390
14731,0.000175,172.217.194.0-255,2902,18814,92,319390
14732,0.000177,172.31.47.0-255,66,18880,92,319390
14733,0.000179,172.217.194.0-255,1484,20364,92,319390
14734,0.000181,172.31.47.0-255,66,20430,92,319390
14735,0.000209,172.217.194.0-255,4320,24750,92,319390
14736,0.000212,172.31.47.0-255,66,24816,92,319390
14737,0.000217,172.217.194.0-255,5738,30554,92,319390
14738,0.000218,172.31.47.0-255,66,30620,92,319390
14739,0.000239,172.217.194.0-255,1125,31745,92,319390
14740,0.000241,172.31.47.0-255,66,31811,92,319390
14741,0.000359,172.217.194.0-255,1484,33295,92,319390
14742,0.000362,172.31.47.0-255,66,33361,92,319390
14743,0.000367,172.217.194.0-255,2902,36263,92,319390
14744,0.000369,172.31.47.0-255,66,36329,92,319390
14745,0.00038,172.217.194.0-255,2902,39231,92,319390
14746,0.000382,172.31.47.0-255,66,39297,92,319390
14747,0.000404,172.217.194.0-255,2902,42199,92,319390
14748,0.000407,172.31.47.0-255,66,42265,92,319390
14749,0.000423,172.217.194.0-255,2902,45167,92,319390
14750,0.000425,172.31.47.0-255,66,45233,92,319390
14751,0.000446,172.217.194.0-255,3961,49194,92,319390
14752,0.000448,172.31.47.0-255,66,49260,92,319390
14753,0.000454,172.217.194.0-255,7156,56416,92,319390
14754,0.000455,172.31.47.0-255,66,56482,92,319390
14755,0.000459,172.217.194.0-255,4320,60802,92,319390
14756,0.000461,172.31.47.0-255,66,60868,92,319390
14757,0.000485,172.217.194.0-255,5637,66505,92,319390
14758,0.000488,172.31.47.0-255,66,66571,92,319390
14759,0.000535,172.217.194.0-255,119,66690,92,319390
14760,0.000605,172.217.194.0-255,376,67066,92,319390
14761,0.00073,172.217.194.0-255,1484,68550,92,319390
14762,0.000733,172.31.47.0-255,66,68616,92,319390
14763,0.000736,172.217.194.0-255,1484,70100,92,319390
14764,0.000751,172.217.194.0-255,1484,71584,92,319390
14765,0.000753,172.31.47.0-255,66,71650,92,319390
14766,0.000755,172.217.194.0-255,1484,73134,92,319390
14767,0.000775,172.217.194.0-255,4320,77454,92,319390
14768,0.000778,172.217.194.0-255,2902,80356,92,319390
14769,0.000781,172.31.47.0-255,66,80422,92,319390
14770,0.000787,172.31.47.0-255,66,80488,92,319390
14771,0.00079,172.217.194.0-255,1484,81972,92,319390
14772,0.000793,172.217.194.0-255,2902,84874,92,319390
14773,0.000795,172.31.47.0-255,66,84940,92,319390
14774,0.000821,172.31.47.0-255,66,85006,92,319390
14775,0.00085,172.31.47.0-255,66,85072,92,319390
14776,0.001027,172.217.194.0-255,1484,86556,92,319390
14777,0.00103,172.217.194.0-255,1484,88040,92,319390
14778,0.001033,172.31.47.0-255,66,88106,92,319390
14779,0.001047,172.217.194.0-255,1484,89590,92,319390
14780,0.001053,172.217.194.0-255,5738,95328,92,319390
14781,0.001054,172.31.47.0-255,66,95394,92,319390
14782,0.001059,172.217.194.0-255,4320,99714,92,319390
14783,0.001061,172.31.47.0-255,66,99780,92,319390
14784,0.001093,172.31.47.0-255,66,99846,92,319390
14785,0.001097,172.217.194.0-255,2902,102748,92,319390
14786,0.001098,172.31.47.0-255,66,102814,92,319390
14787,0.001112,172.217.194.0-255,2902,105716,92,319390
14788,0.001113,172.31.47.0-255,66,105782,92,319390
14789,0.001128,172.217.194.0-255,5020,110802,92,319390
14790,0.00113,172.31.47.0-255,66,110868,92,319390
14791,0.001355,172.217.194.0-255,1484,112352,92,319390
14792,0.00136,172.217.194.0-255,2902,115254,92,319390
14793,0.001362,172.31.47.0-255,66,115320,92,319390
14794,0.001365,172.217.194.0-255,1484,116804,92,319390
14795,0.001381,172.217.194.0-255,4320,121124,92,319390
14796,0.001383,172.31.47.0-255,66,121190,92,319390
14797,0.001395,172.217.194.0-255,2902,124092,92,319390
14798,0.001397,172.31.47.0-255,66,124158,92,319390
14799,0.001423,172.31.47.0-255,66,124224,92,319390
14800,0.001425,172.217.194.0-255,1484,125708,92,319390
14801,0.001446,172.217.194.0-255,7156,132864,92,319390
14802,0.001449,172.31.47.0-255,66,132930,92,319390
14803,0.00146,172.217.194.0-255,2184,135114,92,319390
14804,0.001462,172.31.47.0-255,66,135180,92,319390
14805,0.002032,172.217.194.0-255,1484,136664,92,319390
14806,0.00204,172.217.194.0-255,2902,139566,92,319390
14807,0.002043,172.31.47.0-255,66,139632,92,319390
14808,0.002048,172.217.194.0-255,2902,142534,92,319390
14809,0.00205,172.31.47.0-255,66,142600,92,319390
14810,0.002063,172.217.194.0-255,2902,145502,92,319390
14811,0.002065,172.31.47.0-255,66,145568,92,319390
14812,0.002069,172.217.194.0-255,4320,149888,92,319390
14813,0.002071,172.31.47.0-255,66,149954,92,319390
14814,0.002102,172.31.47.0-255,66,150020,92,319390
14815,0.002112,172.31.47.0-255,66,150086,92,319390
14816,0.002247,172.217.194.0-255,1484,151570,92,319390
14817,0.002262,172.217.194.0-255,2902,154472,92,319390
14818,0.002265,172.31.47.0-255,66,154538,92,319390
14819,0.002271,172.217.194.0-255,5738,160276,92,319390
14820,0.002272,172.31.47.0-255,66,160342,92,319390
14821,0.002285,172.217.194.0-255,2902,163244,92,319390
14822,0.002287,172.31.47.0-255,66,163310,92,319390
14823,0.002299,172.217.194.0-255,2902,166212,92,319390
14824,0.0023,172.31.47.0-255,66,166278,92,319390
14825,0.002307,172.217.194.0-255,7156,173434,92,319390
14826,0.002308,172.31.47.0-255,66,173500,92,319390
14827,0.002351,172.31.47.0-255,66,173566,92,319390
14828,0.004714,172.217.194.0-255,5738,179304,92,319390
14829,0.00472,172.31.47.0-255,66,179370,92,319390
14830,0.007132,172.217.194.0-255,5738,185108,92,319390
14831,0.007143,172.31.47.0-255,66,185174,92,319390
14832,0.009565,172.217.194.0-255,5738,190912,92,319390
14833,0.009571,172.31.47.0-255,66,190978,92,319390
14834,0.011967,172.217.194.0-255,5738,196716,92,319390
14835,0.011976,172.31.47.0-255,66,196782,92,319390
14836,0.014365,172.217.194.0-255,5738,202520,92,319390
14837,0.014372,172.31.47.0-255,66,202586,92,319390
14838,0.016776,172.217.194.0-255,5738,208324,92,319390
14839,0.016783,172.31.47.0-255,66,208390,92,319390
14840,0.019167,172.217.194.0-255,5738,214128,92,319390
14841,0.019174,172.31.47.0-255,66,214194,92,319390
14842,0.021573,172.217.194.0-255,2902,217096,92,319390
14843,0.021578,172.31.47.0-255,66,217162,92,319390
14844,0.0216,172.217.194.0-255,2902,220064,92,319390
14845,0.021603,172.31.47.0-255,66,220130,92,319390
14846,0.022304,172.31.47.0-255,172,220302,92,319390
14847,0.02233,172.31.47.0-255,1111,221413,92,319390
14848,0.022368,172.31.47.0-255,1514,222927,92,319390
14849,0.022369,172.31.47.0-255,1514,224441,92,319390
14850,0.02237,172.31.47.0-255,1514,225955,92,319390
14851,0.022371,172.31.47.0-255,1514,227469,92,319390
14852,0.022372,172.31.47.0-255,531,228000,92,319390
14853,0.023845,104.244.42.0-255,66,228066,92,319390
14854,0.023873,104.244.42.0-255,66,228132,92,319390
14855,0.023919,104.244.42.0-255,66,228198,92,319390
14856,0.023929,104.244.42.0-255,66,228264,92,319390
14857,0.023959,172.217.194.0-255,1484,229748,92,319390
14858,0.02398,172.217.194.0-255,4320,234068,92,319390
14859,0.023984,172.31.47.0-255,66,234134,92,319390
14860,0.024549,104.244.42.0-255,108,234242,92,319390
14861,0.024554,172.31.47.0-255,66,234308,92,319390
14862,0.026398,172.217.194.0-255,5738,240046,92,319390
14863,0.026404,172.31.47.0-255,66,240112,92,319390
14864,0.028759,172.217.194.0-255,5738,245850,92,319390
14865,0.028764,172.31.47.0-255,66,245916,92,319390
14866,0.031127,172.217.194.0-255,1484,247400,92,319390
14867,0.031157,172.217.194.0-255,4320,251720,92,319390
14868,0.031162,172.31.47.0-255,66,251786,92,319390
14869,0.033543,172.217.194.0-255,2902,254688,92,319390
14870,0.033548,172.31.47.0-255,66,254754,92,319390
14871,0.033574,172.217.194.0-255,2902,257656,92,319390
14872,0.033577,172.31.47.0-255,66,257722,92,319390
14873,0.035933,172.217.194.0-255,2902,260624,92,319390
14874,0.035938,172.31.47.0-255,66,260690,92,319390
14875,0.035963,172.217.194.0-255,2902,263592,92,319390
14876,0.035966,172.31.47.0-255,66,263658,92,319390
14877,0.038334,172.217.194.0-255,4320,267978,92,319390
14878,0.038339,172.31.47.0-255,66,268044,92,319390
14879,0.038355,172.217.194.0-255,1484,269528,92,319390
14880,0.040736,172.217.194.0-255,4320,273848,92,319390
14881,0.040742,172.31.47.0-255,66,273914,92,319390
14882,0.043112,172.217.194.0-255,2902,276816,92,319390
14883,0.043117,172.31.47.0-255,66,276882,92,319390
14884,0.043138,172.217.194.0-255,2902,279784,92,319390
14885,0.04314,172.31.47.0-255,66,279850,92,319390
14886,0.045495,172.217.194.0-255,5738,285588,92,319390
14887,0.045501,172.31.47.0-255,66,285654,92,319390
14888,0.047877,172.217.194.0-255,5738,291392,92,319390
14889,0.047883,172.31.47.0-255,66,291458,92,319390
14890,0.050263,172.217.194.0-255,4320,295778,92,319390
14891,0.050268,172.31.47.0-255,66,295844,92,319390
14892,0.050282,172.217.194.0-255,1484,297328,92,319390
14893,0.052648,172.217.194.0-255,4320,301648,92,319390
14894,0.052653,172.31.47.0-255,66,301714,92,319390
14895,0.055086,172.217.194.0-255,5738,307452,92,319390
14896,0.055091,172.31.47.0-255,66,307518,92,319390
14897,0.057484,172.217.194.0-255,2902,310420,92,319390
14898,0.057489,172.31.47.0-255,66,310486,92,319390
14899,0.057516,172.217.194.0-255,2902,313388,92,319390
14900,0.057519,172.31.47.0-255,66,313454,92,319390
14901,0.059839,172.217.194.0-255,2902,316356,92,319390
14902,0.059844,172.31.47.0-255,66,316422,92,319390
14903,0.059898,172.217.194.0-255,2902,319324,92,319390
14904,0.059901,172.31.47.0-255,66,319390,92,319390
14905,0.0,172.253.118.0-255,153,153,92,344140
14906,2.2e-05,172.31.47.0-255,66,219,92,344140
14907,2.9e-05,172.253.118.0-255,1484,1703,92,344140
14908,3.3e-05,172.31.47.0-255,66,1769,92,344140
14909,3.8e-05,172.253.118.0-255,2902,4671,92,344140
14910,4.1e-05,172.31.47.0-255,66,4737,92,344140
14911,4.8e-05,172.253.118.0-255,7156,11893,92,344140
14912,5.1e-05,172.31.47.0-255,66,11959,92,344140
14913,7.6e-05,172.31.47.0-255,66,12025,92,344140
14914,9.6e-05,172.253.118.0-255,2004,14029,92,344140
14915,9.9e-05,172.31.47.0-255,66,14095,92,344140
14916,0.000113,172.253.118.0-255,5738,19833,92,344140
14917,0.000115,172.31.47.0-255,66,19899,92,344140
14918,0.000133,172.253.118.0-255,1125,21024,92,344140
14919,0.000135,172.31.47.0-255,66,21090,92,344140
14920,0.000214,172.253.118.0-255,1484,22574,92,344140
14921,0.000217,172.31.47.0-255,66,22640,92,344140
14922,0.000229,172.253.118.0-255,2902,25542,92,344140
14923,0.000232,172.31.47.0-255,66,25608,92,344140
14924,0.000236,172.253.118.0-255,2902,28510,92,344140
14925,0.000238,172.31.47.0-255,66,28576,92,344140
14926,0.000256,172.253.118.0-255,2902,31478,92,344140
14927,0.000258,172.31.47.0-255,66,31544,92,344140
14928,0.000265,172.253.118.0-255,6797,38341,92,344140
14929,0.000267,172.31.47.0-255,66,38407,92,344140
14930,0.000295,172.253.118.0-255,7156,45563,92,344140
14931,0.000297,172.31.47.0-255,66,45629,92,344140
14932,0.000314,172.253.118.0-255,4320,49949,92,344140
14933,0.000316,172.31.47.0-255,66,50015,92,344140
14934,0.000337,172.253.118.0-255,5379,55394,92,344140
14935,0.000339,172.31.47.0-255,66,55460,92,344140
14936,0.000341,172.253.118.0-255,364,55824,92,344140
14937,0.000372,172.253.118.0-255,380,56204,92,344140
14938,0.000459,172.253.118.0-255,1484,57688,92,344140
14939,0.000462,172.31.47.0-255,66,57754,92,344140
14940,0.000487,172.253.118.0-255,2902,60656,92,344140
14941,0.000489,172.31.47.0-255,66,60722,92,344140
14942,0.000495,172.253.118.0-255,5738,66460,92,344140
14943,0.000497,172.31.47.0-255,66,66526,92,344140
14944,0.000522,172.253.118.0-255,6247,72773,92,344140
14945,0.000524,172.31.47.0-255,66,72839,92,344140
14946,0.000693,172.253.118.0-255,1484,74323,92,344140
14947,0.000707,172.253.118.0-255,1484,75807,92,344140
14948,0.00071,172.31.47.0-255,66,75873,92,344140
14949,0.000713,172.253.118.0-255,1484,77357,92,344140
14950,0.000723,172.253.118.0-255,1484,78841,92,344140
14951,0.000725,172.31.47.0-255,66,78907,92,344140
14952,0.00073,172.253.118.0-255,2902,81809,92,344140
14953,0.000731,172.31.47.0-255,66,81875,92,344140
14954,0.000743,172.253.118.0-255,2902,84777,92,344140
14955,0.000745,172.31.47.0-255,66,84843,92,344140
14956,0.000762,172.253.118.0-255,7156,91999,92,344140
14957,0.000764,172.31.47.0-255,66,92065,92,344140
14958,0.00079,172.253.118.0-255,5738,97803,92,344140
14959,0.000792,172.31.47.0-255,66,97869,92,344140
14960,0.000797,172.253.118.0-255,5738,103607,92,344140
14961,0.000799,172.31.47.0-255,66,103673,92,344140
14962,0.000848,172.253.118.0-255,3602,107275,92,344140
14963,0.000852,172.31.47.0-255,66,107341,92,344140
14964,0.001344,172.253.118.0-255,1484,108825,92,344140
14965,0.001349,172.253.118.0-255,1484,110309,92,344140
14966,0.001352,172.31.47.0-255,66,110375,92,344140
14967,0.001364,172.253.118.0-255,1484,111859,92,344140
14968,0.001371,172.253.118.0-255,5738,117597,92,344140
14969,0.001373,172.31.47.0-255,66,117663,92,344140
14970,0.001376,172.253.118.0-255,1484,119147,92,344140
14971,0.001411,172.31.47.0-255,66,119213,92,344140
14972,0.001437,172.253.118.0-255,4320,123533,92,344140
14973,0.001439,172.31.47.0-255,66,123599,92,344140
14974,0.001467,172.31.47.0-255,66,123665,92,344140
14975,0.001531,172.253.118.0-255,1484,125149,92,344140
14976,0.001544,172.253.118.0-255,2902,128051,92,344140
14977,0.001547,172.31.47.0-255,66,128117,92,344140
14978,0.00157,172.253.118.0-255,5738,133855,92,344140
14979,0.001572,172.31.47.0-255,66,133921,92,344140
14980,0.001577,172.253.118.0-255,2902,136823,92,344140
14981,0.001579,172.31.47.0-255,66,136889,92,344140
14982,0.001607,172.31.47.0-255,66,136955,92,344140
14983,0.001637,172.253.118.0-255,4320,141275,92,344140
14984,0.001641,172.31.47.0-255,66,141341,92,344140
14985,0.001657,172.253.118.0-255,6438,147779,92,344140
14986,0.001659,172.31.47.0-255,66,147845,92,344140
14987,0.001776,172.253.118.0-255,1484,149329,92,344140
14988,0.001782,172.253.118.0-255,2902,152231,92,344140
14989,0.001785,172.31.47.0-255,66,152297,92,344140
14990,0.001804,172.253.118.0-255,1484,153781,92,344140
14991,0.001822,172.253.118.0-255,4320,158101,92,344140
14992,0.001825,172.31.47.0-255,66,158167,92,344140
14993,0.001836,172.31.47.0-255,66,158233,92,344140
14994,0.001851,172.253.118.0-255,4320,162553,92,344140
14995,0.001854,172.31.47.0-255,66,162619,92,344140
14996,0.001865,172.31.47.0-255,66,162685,92,344140
14997,0.001882,172.253.118.0-255,2184,164869,92,344140
14998,0.001884,172.31.47.0-255,66,164935,92,344140
14999,0.001905,172.253.118.0-255,2902,167837,92,344140
15000,0.001907,172.31.47.0-255,66,167903,92,344140
15001,0.001935,172.253.118.0-255,7156,175059,92,344140
15002,0.001939,172.31.47.0-255,66,175125,92,344140
15003,0.00195,172.31.47.0-255,66,175191,92,344140
15004,0.002015,172.31.47.0-255,66,175257,92,344140
15005,0.00204,172.253.118.0-255,3602,178859,92,344140
15006,0.002043,172.31.47.0-255,66,178925,92,344140
15007,0.002103,172.253.118.0-255,1484,180409,92,344140
15008,0.002117,172.253.118.0-255,2902,183311,92,344140
15009,0.00212,172.31.47.0-255,66,183377,92,344140
15010,0.002144,172.253.118.0-255,5738,189115,92,344140
15011,0.002146,172.31.47.0-255,66,189181,92,344140
15012,0.002151,172.253.118.0-255,2902,192083,92,344140
15013,0.002153,172.31.47.0-255,66,192149,92,344140
15014,0.002197,172.31.47.0-255,66,192215,92,344140
15015,0.00221,172.31.47.0-255,66,192281,92,344140
15016,0.004472,172.253.118.0-255,5738,198019,92,344140
15017,0.004479,172.31.47.0-255,66,198085,92,344140
15018,0.006778,172.253.118.0-255,5738,203823,92,344140
15019,0.006785,172.31.47.0-255,66,203889,92,344140
15020,0.00906,172.253.118.0-255,5738,209627,92,344140
15021,0.009067,172.31.47.0-255,66,209693,92,344140
15022,0.011347,172.253.118.0-255,5738,215431,92,344140
15023,0.011356,172.31.47.0-255,66,215497,92,344140
15024,0.013653,172.253.118.0-255,5738,221235,92,344140
15025,0.013664,172.31.47.0-255,66,221301,92,344140
15026,0.015952,172.253.118.0-255,5738,227039,92,344140
15027,0.01596,172.31.47.0-255,66,227105,92,344140
15028,0.018245,172.253.118.0-255,5738,232843,92,344140
15029,0.018254,172.31.47.0-255,66,232909,92,344140
15030,0.020539,172.253.118.0-255,5738,238647,92,344140
15031,0.020545,172.31.47.0-255,66,238713,92,344140
15032,0.022843,172.253.118.0-255,5738,244451,92,344140
15033,0.022852,172.31.47.0-255,66,244517,92,344140
15034,0.025131,172.253.118.0-255,5738,250255,92,344140
15035,0.025137,172.31.47.0-255,66,250321,92,344140
15036,0.027401,172.253.118.0-255,5738,256059,92,344140
15037,0.027407,172.31.47.0-255,66,256125,92,344140
15038,0.029682,172.253.118.0-255,5738,261863,92,344140
15039,0.029689,172.31.47.0-255,66,261929,92,344140
15040,0.031976,172.253.118.0-255,5738,267667,92,344140
15041,0.031984,172.31.47.0-255,66,267733,92,344140
15042,0.034253,172.253.118.0-255,5738,273471,92,344140
15043,0.034259,172.31.47.0-255,66,273537,92,344140
15044,0.03656,172.253.118.0-255,5738,279275,92,344140
15045,0.036568,172.31.47.0-255,66,279341,92,344140
15046,0.038856,172.253.118.0-255,5738,285079,92,344140
15047,0.038868,172.31.47.0-255,66,285145,92,344140
15048,0.041143,172.253.118.0-255,5738,290883,92,344140
15049,0.041148,172.31.47.0-255,66,290949,92,344140
15050,0.041576,172.31.47.0-255,172,291121,92,344140
15051,0.041606,172.31.47.0-255,1112,292233,92,344140
15052,0.041675,172.31.47.0-255,1514,293747,92,344140
15053,0.041677,172.31.47.0-255,1514,295261,92,344140
15054,0.041678,172.31.47.0-255,1514,296775,92,344140
15055,0.041679,172.31.47.0-255,1514,298289,92,344140
15056,0.041711,172.31.47.0-255,1494,299783,92,344140
15057,0.043113,104.244.42.0-255,66,299849,92,344140
15058,0.043142,104.244.42.0-255,66,299915,92,344140
15059,0.043259,104.244.42.0-255,66,299981,92,344140
15060,0.043282,104.244.42.0-255,66,300047,92,344140
15061,0.043412,172.253.118.0-255,4320,304367,92,344140
15062,0.043419,172.31.47.0-255,66,304433,92,344140
15063,0.043432,172.253.118.0-255,1484,305917,92,344140
15064,0.043997,104.244.42.0-255,108,306025,92,344140
15065,0.044002,172.31.47.0-255,66,306091,92,344140
15066,0.045693,172.253.118.0-255,4320,310411,92,344140
15067,0.045697,172.31.47.0-255,66,310477,92,344140
15068,0.047981,172.253.118.0-255,5738,316215,92,344140
15069,0.047989,172.31.47.0-255,66,316281,92,344140
15070,0.050276,172.253.118.0-255,5738,322019,92,344140
15071,0.050284,172.31.47.0-255,66,322085,92,344140
15072,0.052558,172.253.118.0-255,5738,327823,92,344140
15073,0.052565,172.31.47.0-255,66,327889,92,344140
15074,0.054832,172.253.118.0-255,5738,333627,92,344140
15075,0.05484,172.31.47.0-255,66,333693,92,344140
15076,0.057117,172.253.118.0-255,5738,339431,92,344140
15077,0.057124,172.31.47.0-255,66,339497,92,344140
15078,0.059441,172.253.118.0-255,4472,343969,92,344140
15079,0.059448,172.31.47.0-255,66,344035,92,344140
15080,0.059645,172.31.47.0-255,105,344140,92,344140
15081,0.0,74.125.24.0-255,153,153,92,282929
15082,2.7e-05,172.31.47.0-255,66,219,92,282929
15083,3.4e-05,74.125.24.0-255,1484,1703,92,282929
15084,3.8e-05,172.31.47.0-255,66,1769,92,282929
15085,4.3e-05,74.125.24.0-255,2902,4671,92,282929
15086,5.2e-05,172.31.47.0-255,66,4737,92,282929
15087,5.7e-05,74.125.24.0-255,2902,7639,92,282929
15088,6e-05,172.31.47.0-255,66,7705,92,282929
15089,6.6e-05,74.125.24.0-255,2902,10607,92,282929
15090,6.8e-05,172.31.47.0-255,66,10673,92,282929
15091,9.8e-05,74.125.24.0-255,1484,12157,92,282929
15092,0.0001,172.31.47.0-255,66,12223,92,282929
15093,0.000105,74.125.24.0-255,2127,14350,92,282929
15094,0.000107,172.31.47.0-255,66,14416,92,282929
15095,0.000201,74.125.24.0-255,1484,15900,92,282929
15096,0.000205,172.31.47.0-255,66,15966,92,282929
15097,0.000228,74.125.24.0-255,1484,17450,92,282929
15098,0.000232,172.31.47.0-255,66,17516,92,282929
15099,0.000236,74.125.24.0-255,2902,20418,92,282929
15100,0.000238,172.31.47.0-255,66,20484,92,282929
15101,0.000244,74.125.24.0-255,5738,26222,92,282929
15102,0.000252,172.31.47.0-255,66,26288,92,282929
15103,0.000257,74.125.24.0-255,4320,30608,92,282929
15104,0.000259,172.31.47.0-255,66,30674,92,282929
15105,0.000291,74.125.24.0-255,1125,31799,92,282929
15106,0.000295,172.31.47.0-255,66,31865,92,282929
15107,0.000302,74.125.24.0-255,5738,37603,92,282929
15108,0.000305,172.31.47.0-255,66,37669,92,282929
15109,0.00031,74.125.24.0-255,4320,41989,92,282929
15110,0.000313,172.31.47.0-255,66,42055,92,282929
15111,0.000344,74.125.24.0-255,6797,48852,92,282929
15112,0.000347,172.31.47.0-255,66,48918,92,282929
15113,0.000355,74.125.24.0-255,7156,56074,92,282929
15114,0.000358,172.31.47.0-255,66,56140,92,282929
15115,0.000383,74.125.24.0-255,4320,60460,92,282929
15116,0.000386,172.31.47.0-255,66,60526,92,282929
15117,0.000392,74.125.24.0-255,5379,65905,92,282929
15118,0.000395,172.31.47.0-255,66,65971,92,282929
15119,0.000397,74.125.24.0-255,450,66421,92,282929
15120,0.000602,74.125.24.0-255,327,66748,92,282929
15121,0.000749,172.31.47.0-255,66,66814,92,282929
15122,0.001047,74.125.24.0-255,1484,68298,92,282929
15123,0.001057,74.125.24.0-255,2902,71200,92,282929
15124,0.001061,172.31.47.0-255,66,71266,92,282929
15125,0.001071,74.125.24.0-255,5738,77004,92,282929
15126,0.001073,172.31.47.0-255,66,77070,92,282929
15127,0.001084,74.125.24.0-255,4320,81390,92,282929
15128,0.001086,172.31.47.0-255,66,81456,92,282929
15129,0.001094,74.125.24.0-255,7156,88612,92,282929
15130,0.001096,172.31.47.0-255,66,88678,92,282929
15131,0.001126,74.125.24.0-255,4320,92998,92,282929
15132,0.001129,172.31.47.0-255,66,93064,92,282929
15133,0.001139,172.31.47.0-255,66,93130,92,282929
15134,0.001412,74.125.24.0-255,1484,94614,92,282929
15135,0.001419,74.125.24.0-255,2902,97516,92,282929
15136,0.001424,172.31.47.0-255,66,97582,92,282929
15137,0.001431,74.125.24.0-255,5738,103320,92,282929
15138,0.001433,172.31.47.0-255,66,103386,92,282929
15139,0.001453,172.31.47.0-255,66,103452,92,282929
15140,0.00146,74.125.24.0-255,7156,110608,92,282929
15141,0.001462,172.31.47.0-255,66,110674,92,282929
15142,0.001489,74.125.24.0-255,3602,114276,92,282929
15143,0.001493,172.31.47.0-255,66,114342,92,282929
15144,0.002178,74.125.24.0-255,1484,115826,92,282929
15145,0.002189,74.125.24.0-255,2902,118728,92,282929
15146,0.002194,172.31.47.0-255,66,118794,92,282929
15147,0.002225,74.125.24.0-255,5738,124532,92,282929
15148,0.002227,172.31.47.0-255,66,124598,92,282929
15149,0.002232,74.125.24.0-255,2902,127500,92,282929
15150,0.002234,172.31.47.0-255,66,127566,92,282929
15151,0.002279,172.31.47.0-255,66,127632,92,282929
15152,0.002285,74.125.24.0-255,5738,133370,92,282929
15153,0.002287,172.31.47.0-255,66,133436,92,282929
15154,0.002315,74.125.24.0-255,5020,138456,92,282929
15155,0.002317,172.31.47.0-255,66,138522,92,282929
15156,0.00464,74.125.24.0-255,5738,144260,92,282929
15157,0.004646,172.31.47.0-255,66,144326,92,282929
15158,0.006969,74.125.24.0-255,4320,148646,92,282929
15159,0.006975,172.31.47.0-255,66,148712,92,282929
15160,0.006998,74.125.24.0-255,1484,150196,92,282929
15161,0.009294,74.125.24.0-255,4320,154516,92,282929
15162,0.0093,172.31.47.0-255,66,154582,92,282929
15163,0.011634,74.125.24.0-255,5738,160320,92,282929
15164,0.011641,172.31.47.0-255,66,160386,92,282929
15165,0.014001,74.125.24.0-255,5738,166124,92,282929
15166,0.014012,172.31.47.0-255,66,166190,92,282929
15167,0.016318,74.125.24.0-255,5738,171928,92,282929
15168,0.016326,172.31.47.0-255,66,171994,92,282929
15169,0.018648,74.125.24.0-255,5738,177732,92,282929
15170,0.018654,172.31.47.0-255,66,177798,92,282929
15171,0.020989,74.125.24.0-255,5738,183536,92,282929
15172,0.02101,172.31.47.0-255,66,183602,92,282929
15173,0.023343,74.125.24.0-255,5738,189340,92,282929
15174,0.02335,172.31.47.0-255,66,189406,92,282929
15175,0.02568,74.125.24.0-255,5738,195144,92,282929
15176,0.025686,172.31.47.0-255,66,195210,92,282929
15177,0.027687,172.31.47.0-255,172,195382,92,282929
15178,0.027719,172.31.47.0-255,1103,196485,92,282929
15179,0.027763,172.31.47.0-255,1514,197999,92,282929
15180,0.027785,172.31.47.0-255,1514,199513,92,282929
15181,0.027787,172.31.47.0-255,1514,201027,92,282929
15182,0.027808,172.31.47.0-255,1514,202541,92,282929
15183,0.02781,172.31.47.0-255,1506,204047,92,282929
15184,0.028006,74.125.24.0-255,5738,209785,92,282929
15185,0.028012,172.31.47.0-255,66,209851,92,282929
15186,0.029172,104.244.42.0-255,66,209917,92,282929
15187,0.029205,104.244.42.0-255,66,209983,92,282929
15188,0.029278,104.244.42.0-255,66,210049,92,282929
15189,0.029311,104.244.42.0-255,66,210115,92,282929
15190,0.03032,74.125.24.0-255,4320,214435,92,282929
15191,0.030326,172.31.47.0-255,66,214501,92,282929
15192,0.03036,74.125.24.0-255,1484,215985,92,282929
15193,0.032629,74.125.24.0-255,4320,220305,92,282929
15194,0.032635,172.31.47.0-255,66,220371,92,282929
15195,0.034942,74.125.24.0-255,4320,224691,92,282929
15196,0.03495,172.31.47.0-255,66,224757,92,282929
15197,0.034973,74.125.24.0-255,1484,226241,92,282929
15198,0.037267,74.125.24.0-255,4320,230561,92,282929
15199,0.037284,172.31.47.0-255,66,230627,92,282929
15200,0.039623,74.125.24.0-255,5738,236365,92,282929
15201,0.039641,172.31.47.0-255,66,236431,92,282929
15202,0.041976,74.125.24.0-255,5738,242169,92,282929
15203,0.041995,172.31.47.0-255,66,242235,92,282929
15204,0.044331,74.125.24.0-255,5738,247973,92,282929
15205,0.044349,172.31.47.0-255,66,248039,92,282929
15206,0.046679,74.125.24.0-255,5738,253777,92,282929
15207,0.0467,172.31.47.0-255,66,253843,92,282929
15208,0.049052,74.125.24.0-255,5738,259581,92,282929
15209,0.04907,172.31.47.0-255,66,259647,92,282929
15210,0.051479,74.125.24.0-255,5738,265385,92,282929
15211,0.051503,172.31.47.0-255,66,265451,92,282929
15212,0.05383,74.125.24.0-255,5738,271189,92,282929
15213,0.053844,172.31.47.0-255,66,271255,92,282929
15214,0.056134,74.125.24.0-255,5738,276993,92,282929
15215,0.056139,172.31.47.0-255,66,277059,92,282929
15216,0.058445,74.125.24.0-255,4320,281379,92,282929
15217,0.058449,172.31.47.0-255,66,281445,92,282929
15218,0.058481,74.125.24.0-255,1484,282929,92,282929
15219,0.0,74.125.24.0-255,153,153,92,265918
15220,9.2e-05,172.31.47.0-255,66,219,92,265918
15221,9.9e-05,74.125.24.0-255,1484,1703,92,265918
15222,0.000104,172.31.47.0-255,66,1769,92,265918
15223,0.000109,74.125.24.0-255,2902,4671,92,265918
15224,0.000111,172.31.47.0-255,66,4737,92,265918
15225,0.000118,74.125.24.0-255,7156,11893,92,265918
15226,0.000121,172.31.47.0-255,66,11959,92,265918
15227,0.000124,74.125.24.0-255,2173,14132,92,265918
15228,0.000127,172.31.47.0-255,66,14198,92,265918
15229,0.00014,172.31.47.0-255,66,14264,92,265918
15230,0.000145,74.125.24.0-255,5379,19643,92,265918
15231,0.000148,172.31.47.0-255,66,19709,92,265918
15232,0.000423,74.125.24.0-255,1484,21193,92,265918
15233,0.000428,172.31.47.0-255,66,21259,92,265918
15234,0.000435,74.125.24.0-255,2902,24161,92,265918
15235,0.000437,74.125.24.0-255,1484,25645,92,265918
15236,0.000439,172.31.47.0-255,66,25711,92,265918
15237,0.000444,172.31.47.0-255,66,25777,92,265918
15238,0.000454,74.125.24.0-255,4320,30097,92,265918
15239,0.000457,172.31.47.0-255,66,30163,92,265918
15240,0.000495,172.31.47.0-255,66,30229,92,265918
15241,0.000536,172.31.47.0-255,66,30295,92,265918
15242,0.000565,74.125.24.0-255,4320,34615,92,265918
15243,0.000569,172.31.47.0-255,66,34681,92,265918
15244,0.000588,74.125.24.0-255,1434,36115,92,265918
15245,0.000591,172.31.47.0-255,66,36181,92,265918
15246,0.000593,74.125.24.0-255,113,36294,92,265918
15247,0.000595,172.31.47.0-255,66,36360,92,265918
15248,0.000811,74.125.24.0-255,1484,37844,92,265918
15249,0.000833,74.125.24.0-255,2902,40746,92,265918
15250,0.000836,172.31.47.0-255,66,40812,92,265918
15251,0.000843,74.125.24.0-255,5738,46550,92,265918
15252,0.000851,172.31.47.0-255,66,46616,92,265918
15253,0.000878,74.125.24.0-255,4320,50936,92,265918
15254,0.000883,172.31.47.0-255,66,51002,92,265918
15255,0.000907,74.125.24.0-255,7156,58158,92,265918
15256,0.00091,74.125.24.0-255,1484,59642,92,265918
15257,0.000911,172.31.47.0-255,66,59708,92,265918
15258,0.000922,74.125.24.0-255,2902,62610,92,265918
15259,0.000926,172.31.47.0-255,66,62676,92,265918
15260,0.000951,172.31.47.0-255,66,62742,92,265918
15261,0.001077,74.125.24.0-255,1484,64226,92,265918
15262,0.001099,74.125.24.0-255,2902,67128,92,265918
15263,0.001102,172.31.47.0-255,66,67194,92,265918
15264,0.001122,74.125.24.0-255,2902,70096,92,265918
15265,0.001127,172.31.47.0-255,66,70162,92,265918
15266,0.001136,74.125.24.0-255,2902,73064,92,265918
15267,0.001141,172.31.47.0-255,66,73130,92,265918
15268,0.001142,74.125.24.0-255,5738,78868,92,265918
15269,0.001156,172.31.47.0-255,66,78934,92,265918
15270,0.001169,74.125.24.0-255,7156,86090,92,265918
15271,0.001174,172.31.47.0-255,66,86156,92,265918
15272,0.001185,74.125.24.0-255,5738,91894,92,265918
15273,0.001189,74.125.24.0-255,2902,94796,92,265918
15274,0.001189,172.31.47.0-255,66,94862,92,265918
15275,0.001204,172.31.47.0-255,66,94928,92,265918
15276,0.001206,74.125.24.0-255,2184,97112,92,265918
15277,0.001216,172.31.47.0-255,66,97178,92,265918
15278,0.001301,74.125.24.0-255,1484,98662,92,265918
15279,0.001316,74.125.24.0-255,2902,101564,92,265918
15280,0.001319,172.31.47.0-255,66,101630,92,265918
15281,0.001326,74.125.24.0-255,4320,105950,92,265918
15282,0.001338,74.125.24.0-255,1484,107434,92,265918
15283,0.001338,172.31.47.0-255,66,107500,92,265918
15284,0.001356,74.125.24.0-255,5738,113238,92,265918
15285,0.001365,172.31.47.0-255,66,113304,92,265918
15286,0.00138,74.125.24.0-255,7156,120460,92,265918
15287,0.001383,74.125.24.0-255,1484,121944,92,265918
15288,0.001388,172.31.47.0-255,66,122010,92,265918
15289,0.001423,172.31.47.0-255,66,122076,92,265918
15290,0.001781,74.125.24.0-255,1484,123560,92,265918
15291,0.001785,172.31.47.0-255,66,123626,92,265918
15292,0.001793,74.125.24.0-255,2902,126528,92,265918
15293,0.001808,74.125.24.0-255,5738,132266,92,265918
15294,0.001899,74.125.24.0-255,5738,138004,92,265918
15295,0.001912,74.125.24.0-255,5020,143024,92,265918
15296,0.001915,74.125.24.0-255,1484,144508,92,265918
15297,0.001933,74.125.24.0-255,7156,151664,92,265918
15298,0.001943,74.125.24.0-255,2902,154566,92,265918
15299,0.001968,74.125.24.0-255,7156,161722,92,265918
15300,0.001985,74.125.24.0-255,6438,168160,92,265918
15301,0.00202,74.125.24.0-255,2902,171062,92,265918
15302,0.002061,74.125.24.0-255,4320,175382,92,265918
15303,0.002066,74.125.24.0-255,2184,177566,92,265918
15304,0.002164,74.125.24.0-255,1484,179050,92,265918
15305,0.002178,74.125.24.0-255,2902,181952,92,265918
15306,0.002189,74.125.24.0-255,2902,184854,92,265918
15307,0.002198,74.125.24.0-255,1484,186338,92,265918
15308,0.002215,74.125.24.0-255,4320,190658,92,265918
15309,0.00223,74.125.24.0-255,4320,194978,92,265918
15310,0.002246,74.125.24.0-255,1484,196462,92,265918
15311,0.002291,74.125.24.0-255,7156,203618,92,265918
15312,0.002302,74.125.24.0-255,766,204384,92,265918
15313,0.002306,74.125.24.0-255,2902,207286,92,265918
15314,0.00233,74.125.24.0-255,2902,210188,92,265918
15315,0.002387,74.125.24.0-255,7156,217344,92,265918
15316,0.002421,74.125.24.0-255,5020,222364,92,265918
15317,0.002485,74.125.24.0-255,1484,223848,92,265918
15318,0.002497,74.125.24.0-255,1484,225332,92,265918
15319,0.002507,74.125.24.0-255,1484,226816,92,265918
15320,0.002519,74.125.24.0-255,2902,229718,92,265918
15321,0.002529,74.125.24.0-255,2902,232620,92,265918
15322,0.002549,74.125.24.0-255,2902,235522,92,265918
15323,0.002576,74.125.24.0-255,1484,237006,92,265918
15324,0.00259,74.125.24.0-255,4320,241326,92,265918
15325,0.002618,74.125.24.0-255,2184,243510,92,265918
15326,0.002627,74.125.24.0-255,2902,246412,92,265918
15327,0.002643,74.125.24.0-255,7156,253568,92,265918
15328,0.002645,74.125.24.0-255,1484,255052,92,265918
15329,0.005443,172.31.47.0-255,66,255118,92,265918
15330,0.008026,74.125.24.0-255,2429,257547,92,265918
15331,0.008032,172.31.47.0-255,66,257613,92,265918
15332,0.00912,172.31.47.0-255,105,257718,92,265918
15333,0.011641,74.125.24.0-255,66,257784,92,265918
15334,0.026007,172.31.47.0-255,172,257956,92,265918
15335,0.026036,172.31.47.0-255,1111,259067,92,265918
15336,0.026075,172.31.47.0-255,1514,260581,92,265918
15337,0.026077,172.31.47.0-255,1514,262095,92,265918
15338,0.026078,172.31.47.0-255,1514,263609,92,265918
15339,0.026079,172.31.47.0-255,1514,265123,92,265918
15340,0.02608,172.31.47.0-255,531,265654,92,265918
15341,0.027543,104.244.42.0-255,66,265720,92,265918
15342,0.027578,104.244.42.0-255,66,265786,92,265918
15343,0.027622,104.244.42.0-255,66,265852,92,265918
15344,0.027624,104.244.42.0-255,66,265918,92,265918
15345,0.0,74.125.24.0-255,152,152,92,231055
15346,2.6e-05,172.31.47.0-255,66,218,92,231055
15347,5.3e-05,74.125.24.0-255,1484,1702,92,231055
15348,5.7e-05,172.31.47.0-255,66,1768,92,231055
15349,6e-05,74.125.24.0-255,1484,3252,92,231055
15350,6.3e-05,172.31.47.0-255,66,3318,92,231055
15351,8.7e-05,74.125.24.0-255,1484,4802,92,231055
15352,8.9e-05,172.31.47.0-255,66,4868,92,231055
15353,9.9e-05,74.125.24.0-255,7156,12024,92,231055
15354,0.000103,74.125.24.0-255,2065,14089,92,231055
15355,0.000105,172.31.47.0-255,66,14155,92,231055
15356,0.000108,172.31.47.0-255,66,14221,92,231055
15357,0.000115,172.31.47.0-255,66,14287,92,231055
15358,0.000128,172.31.47.0-255,66,14353,92,231055
15359,0.000167,172.31.47.0-255,66,14419,92,231055
15360,0.000172,74.125.24.0-255,3602,18021,92,231055
15361,0.000174,172.31.47.0-255,66,18087,92,231055
15362,0.000675,74.125.24.0-255,1484,19571,92,231055
15363,0.000681,172.31.47.0-255,66,19637,92,231055
15364,0.000687,74.125.24.0-255,2902,22539,92,231055
15365,0.000691,172.31.47.0-255,66,22605,92,231055
15366,0.000696,74.125.24.0-255,4320,26925,92,231055
15367,0.000698,172.31.47.0-255,66,26991,92,231055
15368,0.000717,74.125.24.0-255,1484,28475,92,231055
15369,0.00072,74.125.24.0-255,1484,29959,92,231055
15370,0.000722,172.31.47.0-255,66,30025,92,231055
15371,0.000725,172.31.47.0-255,66,30091,92,231055
15372,0.000747,74.125.24.0-255,5689,35780,92,231055
15373,0.00075,172.31.47.0-255,66,35846,92,231055
15374,0.000753,74.125.24.0-255,111,35957,92,231055
15375,0.000889,172.31.47.0-255,66,36023,92,231055
15376,0.002014,74.125.24.0-255,1484,37507,92,231055
15377,0.002028,74.125.24.0-255,2902,40409,92,231055
15378,0.002036,172.31.47.0-255,66,40475,92,231055
15379,0.002045,74.125.24.0-255,5738,46213,92,231055
15380,0.002048,172.31.47.0-255,66,46279,92,231055
15381,0.002055,74.125.24.0-255,7156,53435,92,231055
15382,0.002057,172.31.47.0-255,66,53501,92,231055
15383,0.002069,172.31.47.0-255,66,53567,92,231055
15384,0.002086,74.125.24.0-255,2902,56469,92,231055
15385,0.002087,172.31.47.0-255,66,56535,92,231055
15386,0.002092,74.125.24.0-255,2184,58719,92,231055
15387,0.002093,172.31.47.0-255,66,58785,92,231055
15388,0.004094,74.125.24.0-255,2902,61687,92,231055
15389,0.004103,172.31.47.0-255,66,61753,92,231055
15390,0.004122,74.125.24.0-255,2902,64655,92,231055
15391,0.004124,172.31.47.0-255,66,64721,92,231055
15392,0.006087,74.125.24.0-255,2902,67623,92,231055
15393,0.006099,172.31.47.0-255,66,67689,92,231055
15394,0.006134,74.125.24.0-255,2902,70591,92,231055
15395,0.006138,172.31.47.0-255,66,70657,92,231055
15396,0.008077,74.125.24.0-255,2902,73559,92,231055
15397,0.008087,172.31.47.0-255,66,73625,92,231055
15398,0.008149,74.125.24.0-255,2902,76527,92,231055
15399,0.008153,172.31.47.0-255,66,76593,92,231055
15400,0.010461,74.125.24.0-255,2902,79495,92,231055
15401,0.010477,172.31.47.0-255,66,79561,92,231055
15402,0.010501,74.125.24.0-255,2902,82463,92,231055
15403,0.010505,172.31.47.0-255,66,82529,92,231055
15404,0.012455,74.125.24.0-255,2902,85431,92,231055
15405,0.012463,172.31.47.0-255,66,85497,92,231055
15406,0.012486,74.125.24.0-255,2902,88399,92,231055
15407,0.012489,172.31.47.0-255,66,88465,92,231055
15408,0.014504,74.125.24.0-255,5738,94203,92,231055
15409,0.01451,172.31.47.0-255,66,94269,92,231055
15410,0.016565,74.125.24.0-255,5738,100007,92,231055
15411,0.016572,172.31.47.0-255,66,100073,92,231055
15412,0.018584,74.125.24.0-255,5738,105811,92,231055
15413,0.0186,172.31.47.0-255,66,105877,92,231055
15414,0.020607,74.125.24.0-255,5738,111615,92,231055
15415,0.020623,172.31.47.0-255,66,111681,92,231055
15416,0.022644,74.125.24.0-255,5738,117419,92,231055
15417,0.022657,172.31.47.0-255,66,117485,92,231055
15418,0.024698,74.125.24.0-255,5738,123223,92,231055
15419,0.02472,172.31.47.0-255,66,123289,92,231055
15420,0.026748,74.125.24.0-255,5738,129027,92,231055
15421,0.02677,172.31.47.0-255,66,129093,92,231055
15422,0.028789,74.125.24.0-255,5738,134831,92,231055
15423,0.028805,172.31.47.0-255,66,134897,92,231055
15424,0.030783,74.125.24.0-255,5738,140635,92,231055
15425,0.030796,172.31.47.0-255,66,140701,92,231055
15426,0.032803,74.125.24.0-255,5738,146439,92,231055
15427,0.032825,172.31.47.0-255,66,146505,92,231055
15428,0.034854,74.125.24.0-255,5738,152243,92,231055
15429,0.034873,172.31.47.0-255,66,152309,92,231055
15430,0.03688,74.125.24.0-255,5738,158047,92,231055
15431,0.036901,172.31.47.0-255,66,158113,92,231055
15432,0.038935,74.125.24.0-255,5738,163851,92,231055
15433,0.038951,172.31.47.0-255,66,163917,92,231055
15434,0.04099,74.125.24.0-255,5738,169655,92,231055
15435,0.041013,172.31.47.0-255,66,169721,92,231055
15436,0.043049,74.125.24.0-255,5738,175459,92,231055
15437,0.043075,172.31.47.0-255,66,175525,92,231055
15438,0.043826,172.31.47.0-255,172,175697,92,231055
15439,0.043856,172.31.47.0-255,1107,176804,92,231055
15440,0.04391,172.31.47.0-255,1514,178318,92,231055
15441,0.043912,172.31.47.0-255,1514,179832,92,231055
15442,0.043913,172.31.47.0-255,1514,181346,92,231055
15443,0.043914,172.31.47.0-255,1514,182860,92,231055
15444,0.043939,172.31.47.0-255,1499,184359,92,231055
15445,0.045104,74.125.24.0-255,5738,190097,92,231055
15446,0.045113,172.31.47.0-255,66,190163,92,231055
15447,0.045366,104.244.42.0-255,66,190229,92,231055
15448,0.045438,104.244.42.0-255,66,190295,92,231055
15449,0.04549,104.244.42.0-255,66,190361,92,231055
15450,0.045538,104.244.42.0-255,66,190427,92,231055
15451,0.047124,74.125.24.0-255,5738,196165,92,231055
15452,0.047137,172.31.47.0-255,66,196231,92,231055
15453,0.049158,74.125.24.0-255,5738,201969,92,231055
15454,0.049171,172.31.47.0-255,66,202035,92,231055
15455,0.051178,74.125.24.0-255,5738,207773,92,231055
15456,0.051192,172.31.47.0-255,66,207839,92,231055
15457,0.053255,74.125.24.0-255,5738,213577,92,231055
15458,0.053276,172.31.47.0-255,66,213643,92,231055
15459,0.055274,74.125.24.0-255,5738,219381,92,231055
15460,0.055284,172.31.47.0-255,66,219447,92,231055
15461,0.057306,74.125.24.0-255,5738,225185,92,231055
15462,0.057316,172.31.47.0-255,66,225251,92,231055
15463,0.059323,74.125.24.0-255,5738,230989,92,231055
15464,0.059339,172.31.47.0-255,66,231055,92,231055
15465,0.0,172.31.47.0-255,105,105,92,105
15466,0.0,172.31.47.0-255,74,74,92,3023
15467,0.001654,172.217.27.0-255,74,148,92,3023
15468,0.001677,172.31.47.0-255,66,214,92,3023
15469,0.003268,172.31.47.0-255,697,911,92,3023
15470,0.004888,172.217.27.0-255,66,977,92,3023
15471,0.005258,172.217.27.0-255,278,1255,92,3023
15472,0.005268,172.31.47.0-255,66,1321,92,3023
15473,0.012381,172.31.47.0-255,130,1451,92,3023
15474,0.013821,172.31.47.0-255,236,1687,92,3023
15475,0.013853,172.31.47.0-255,380,2067,92,3023
15476,0.014339,172.217.27.0-255,630,2697,92,3023
15477,0.014692,172.31.47.0-255,97,2794,92,3023
15478,0.015463,172.217.27.0-255,97,2891,92,3023
15479,0.016297,172.217.27.0-255,66,2957,92,3023
15480,0.051758,172.31.47.0-255,66,3023,92,3023
15481,0.0,172.31.47.0-255,105,105,92,276
15482,0.001647,157.240.13.0-255,105,210,92,276
15483,0.001655,172.31.47.0-255,66,276,92,276
15484,0.0,74.125.130.0-255,225,225,92,191224
15485,1.6e-05,172.31.47.0-255,66,291,92,191224
15486,2.2e-05,74.125.130.0-255,1484,1775,92,191224
15487,2.5e-05,172.31.47.0-255,66,1841,92,191224
15488,5e-05,74.125.130.0-255,2902,4743,92,191224
15489,5.4e-05,172.31.47.0-255,66,4809,92,191224
15490,7.9e-05,74.125.130.0-255,1484,6293,92,191224
15491,8.1e-05,172.31.47.0-255,66,6359,92,191224
15492,0.00024,74.125.130.0-255,5738,12097,92,191224
15493,0.000245,172.31.47.0-255,66,12163,92,191224
15494,0.000263,74.125.130.0-255,1957,14120,92,191224
15495,0.000265,172.31.47.0-255,66,14186,92,191224
15496,0.000595,74.125.130.0-255,5738,19924,92,191224
15497,0.0006,172.31.47.0-255,66,19990,92,191224
15498,0.000626,74.125.130.0-255,2902,22892,92,191224
15499,0.000629,172.31.47.0-255,66,22958,92,191224
15500,0.000957,74.125.130.0-255,5738,28696,92,191224
15501,0.000963,172.31.47.0-255,66,28762,92,191224
15502,0.00099,74.125.130.0-255,2543,31305,92,191224
15503,0.000993,172.31.47.0-255,66,31371,92,191224
15504,0.002293,74.125.130.0-255,1534,32905,92,191224
15505,0.002296,172.31.47.0-255,66,32971,92,191224
15506,0.003234,74.125.130.0-255,2902,35873,92,191224
15507,0.00324,172.31.47.0-255,66,35939,92,191224
15508,0.004551,74.125.130.0-255,2902,38841,92,191224
15509,0.004557,172.31.47.0-255,66,38907,92,191224
15510,0.005485,74.125.130.0-255,2902,41809,92,191224
15511,0.005493,172.31.47.0-255,66,41875,92,191224
15512,0.006802,74.125.130.0-255,2902,44777,92,191224
15513,0.006809,172.31.47.0-255,66,44843,92,191224
15514,0.007756,74.125.130.0-255,1434,46277,92,191224
15515,0.007761,172.31.47.0-255,66,46343,92,191224
15516,0.007791,74.125.130.0-255,1484,47827,92,191224
15517,0.007794,172.31.47.0-255,66,47893,92,191224
15518,0.009043,74.125.130.0-255,2902,50795,92,191224
15519,0.009049,172.31.47.0-255,66,50861,92,191224
15520,0.010057,74.125.130.0-255,2902,53763,92,191224
15521,0.010063,172.31.47.0-255,66,53829,92,191224
15522,0.011295,74.125.130.0-255,2902,56731,92,191224
15523,0.011302,172.31.47.0-255,66,56797,92,191224
15524,0.012319,74.125.130.0-255,2902,59699,92,191224
15525,0.012325,172.31.47.0-255,66,59765,92,191224
15526,0.013534,74.125.130.0-255,1484,61249,92,191224
15527,0.01354,172.31.47.0-255,66,61315,92,191224
15528,0.013569,74.125.130.0-255,1484,62799,92,191224
15529,0.013572,172.31.47.0-255,66,62865,92,191224
15530,0.014578,74.125.130.0-255,2902,65767,92,191224
15531,0.014585,172.31.47.0-255,66,65833,92,191224
15532,0.015789,74.125.130.0-255,1484,67317,92,191224
15533,0.015795,172.31.47.0-255,66,67383,92,191224
15534,0.01685,74.125.130.0-255,4320,71703,92,191224
15535,0.016858,172.31.47.0-255,66,71769,92,191224
15536,0.018046,74.125.130.0-255,1484,73253,92,191224
15537,0.018055,172.31.47.0-255,66,73319,92,191224
15538,0.019104,74.125.130.0-255,2902,76221,92,191224
15539,0.019111,172.31.47.0-255,66,76287,92,191224
15540,0.019143,74.125.130.0-255,1484,77771,92,191224
15541,0.020298,74.125.130.0-255,1484,79255,92,191224
15542,0.020304,172.31.47.0-255,66,79321,92,191224
15543,0.021378,74.125.130.0-255,2902,82223,92,191224
15544,0.021385,172.31.47.0-255,66,82289,92,191224
15545,0.02256,74.125.130.0-255,2902,85191,92,191224
15546,0.022566,172.31.47.0-255,66,85257,92,191224
15547,0.02364,74.125.130.0-255,2902,88159,92,191224
15548,0.023647,172.31.47.0-255,66,88225,92,191224
15549,0.024802,74.125.130.0-255,2902,91127,92,191224
15550,0.024808,172.31.47.0-255,66,91193,92,191224
15551,0.025206,172.31.47.0-255,171,91364,92,191224
15552,0.025236,172.31.47.0-255,1136,92500,92,191224
15553,0.025297,172.31.47.0-255,1514,94014,92,191224
15554,0.025299,172.31.47.0-255,1514,95528,92,191224
15555,0.025303,172.31.47.0-255,1514,97042,92,191224
15556,0.025305,172.31.47.0-255,1514,98556,92,191224
15557,0.025323,172.31.47.0-255,330,98886,92,191224
15558,0.025903,74.125.130.0-255,1484,100370,92,191224
15559,0.025923,74.125.130.0-255,1484,101854,92,191224
15560,0.025928,172.31.47.0-255,66,101920,92,191224
15561,0.026746,104.244.42.0-255,66,101986,92,191224
15562,0.02679,104.244.42.0-255,66,102052,92,191224
15563,0.026888,104.244.42.0-255,66,102118,92,191224
15564,0.026893,104.244.42.0-255,66,102184,92,191224
15565,0.027064,74.125.130.0-255,2902,105086,92,191224
15566,0.02707,172.31.47.0-255,66,105152,92,191224
15567,0.028178,74.125.130.0-255,2902,108054,92,191224
15568,0.028184,172.31.47.0-255,66,108120,92,191224
15569,0.029327,74.125.130.0-255,2902,111022,92,191224
15570,0.029333,172.31.47.0-255,66,111088,92,191224
15571,0.030453,74.125.130.0-255,2902,113990,92,191224
15572,0.030459,172.31.47.0-255,66,114056,92,191224
15573,0.031584,74.125.130.0-255,2902,116958,92,191224
15574,0.031589,172.31.47.0-255,66,117024,92,191224
15575,0.032718,74.125.130.0-255,2902,119926,92,191224
15576,0.032724,172.31.47.0-255,66,119992,92,191224
15577,0.033834,74.125.130.0-255,2902,122894,92,191224
15578,0.03384,172.31.47.0-255,66,122960,92,191224
15579,0.034993,74.125.130.0-255,2902,125862,92,191224
15580,0.034999,172.31.47.0-255,66,125928,92,191224
15581,0.036104,74.125.130.0-255,2902,128830,92,191224
15582,0.03611,172.31.47.0-255,66,128896,92,191224
15583,0.03725,74.125.130.0-255,2902,131798,92,191224
15584,0.037256,172.31.47.0-255,66,131864,92,191224
15585,0.03836,74.125.130.0-255,2902,134766,92,191224
15586,0.038365,172.31.47.0-255,66,134832,92,191224
15587,0.039501,74.125.130.0-255,2902,137734,92,191224
15588,0.039506,172.31.47.0-255,66,137800,92,191224
15589,0.040633,74.125.130.0-255,2902,140702,92,191224
15590,0.04064,172.31.47.0-255,66,140768,92,191224
15591,0.04177,74.125.130.0-255,2902,143670,92,191224
15592,0.041776,172.31.47.0-255,66,143736,92,191224
15593,0.042886,74.125.130.0-255,2902,146638,92,191224
15594,0.042892,172.31.47.0-255,66,146704,92,191224
15595,0.044022,74.125.130.0-255,2902,149606,92,191224
15596,0.044028,172.31.47.0-255,66,149672,92,191224
15597,0.045136,74.125.130.0-255,2902,152574,92,191224
15598,0.045143,172.31.47.0-255,66,152640,92,191224
15599,0.046284,74.125.130.0-255,2902,155542,92,191224
15600,0.046289,172.31.47.0-255,66,155608,92,191224
15601,0.047394,74.125.130.0-255,2902,158510,92,191224
15602,0.047399,172.31.47.0-255,66,158576,92,191224
15603,0.04856,74.125.130.0-255,2902,161478,92,191224
15604,0.048565,172.31.47.0-255,66,161544,92,191224
15605,0.049642,74.125.130.0-255,2902,164446,92,191224
15606,0.049648,172.31.47.0-255,66,164512,92,191224
15607,0.050821,74.125.130.0-255,2902,167414,92,191224
15608,0.050826,172.31.47.0-255,66,167480,92,191224
15609,0.051904,74.125.130.0-255,2902,170382,92,191224
15610,0.051909,172.31.47.0-255,66,170448,92,191224
15611,0.053074,74.125.130.0-255,2902,173350,92,191224
15612,0.053079,172.31.47.0-255,66,173416,92,191224
15613,0.05417,74.125.130.0-255,2902,176318,92,191224
15614,0.054175,172.31.47.0-255,66,176384,92,191224
15615,0.055342,74.125.130.0-255,2902,179286,92,191224
15616,0.055348,172.31.47.0-255,66,179352,92,191224
15617,0.056418,74.125.130.0-255,2902,182254,92,191224
15618,0.056424,172.31.47.0-255,66,182320,92,191224
15619,0.057622,74.125.130.0-255,2902,185222,92,191224
15620,0.057627,172.31.47.0-255,66,185288,92,191224
15621,0.058684,74.125.130.0-255,2902,188190,92,191224
15622,0.058691,172.31.47.0-255,66,188256,92,191224
15623,0.05987,74.125.130.0-255,2902,191158,92,191224
15624,0.059875,172.31.47.0-255,66,191224,92,191224
15625,0.0,172.31.47.0-255,105,105,92,828
15626,4.1e-05,172.31.47.0-255,105,210,92,828
15627,7.8e-05,172.31.47.0-255,105,315,92,828
15628,0.001513,157.240.13.0-255,105,420,92,828
15629,0.001844,157.240.13.0-255,105,525,92,828
15630,0.002119,157.240.13.0-255,105,630,92,828
15631,0.039456,172.31.47.0-255,66,696,92,828
15632,0.039462,172.31.47.0-255,66,762,92,828
15633,0.039465,172.31.47.0-255,66,828,92,828
15634,0.0,172.217.24.0-255,153,153,92,294291
15635,2.8e-05,172.31.47.0-255,66,219,92,294291
15636,3.4e-05,172.217.24.0-255,1484,1703,92,294291
15637,3.8e-05,172.31.47.0-255,66,1769,92,294291
15638,4.2e-05,172.217.24.0-255,2902,4671,92,294291
15639,4.5e-05,172.31.47.0-255,66,4737,92,294291
15640,5.8e-05,172.217.24.0-255,7156,11893,92,294291
15641,6.1e-05,172.31.47.0-255,66,11959,92,294291
15642,6.4e-05,172.217.24.0-255,1484,13443,92,294291
15643,6.5e-05,172.31.47.0-255,66,13509,92,294291
15644,9.9e-05,172.217.24.0-255,605,14114,92,294291
15645,0.000101,172.31.47.0-255,66,14180,92,294291
15646,0.000139,172.217.24.0-255,1484,15664,92,294291
15647,0.000142,172.31.47.0-255,66,15730,92,294291
15648,0.000146,172.217.24.0-255,1484,17214,92,294291
15649,0.000148,172.31.47.0-255,66,17280,92,294291
15650,0.000176,172.217.24.0-255,2902,20182,92,294291
15651,0.000179,172.31.47.0-255,66,20248,92,294291
15652,0.000184,172.217.24.0-255,5738,25986,92,294291
15653,0.000186,172.31.47.0-255,66,26052,92,294291
15654,0.000206,172.217.24.0-255,5379,31431,92,294291
15655,0.000209,172.31.47.0-255,66,31497,92,294291
15656,0.000374,172.217.24.0-255,1484,32981,92,294291
15657,0.00038,172.31.47.0-255,66,33047,92,294291
15658,0.000385,172.217.24.0-255,2902,35949,92,294291
15659,0.000386,172.31.47.0-255,66,36015,92,294291
15660,0.000392,172.217.24.0-255,5738,41753,92,294291
15661,0.000394,172.31.47.0-255,66,41819,92,294291
15662,0.000403,172.217.24.0-255,4320,46139,92,294291
15663,0.000405,172.31.47.0-255,66,46205,92,294291
15664,0.000454,172.217.24.0-255,2543,48748,92,294291
15665,0.000458,172.31.47.0-255,66,48814,92,294291
15666,0.000493,172.217.24.0-255,2902,51716,92,294291
15667,0.000497,172.31.47.0-255,66,51782,92,294291
15668,0.000501,172.217.24.0-255,2902,54684,92,294291
15669,0.000513,172.31.47.0-255,66,54750,92,294291
15670,0.000529,172.217.24.0-255,4320,59070,92,294291
15671,0.000538,172.31.47.0-255,66,59136,92,294291
15672,0.000567,172.217.24.0-255,7088,66224,92,294291
15673,0.000578,172.31.47.0-255,66,66290,92,294291
15674,0.001115,172.217.24.0-255,132,66422,92,294291
15675,0.001166,172.31.47.0-255,66,66488,92,294291
15676,0.001213,172.217.24.0-255,1484,67972,92,294291
15677,0.001218,172.31.47.0-255,66,68038,92,294291
15678,0.00124,172.217.24.0-255,2902,70940,92,294291
15679,0.001246,172.217.24.0-255,5738,76678,92,294291
15680,0.001255,172.31.47.0-255,66,76744,92,294291
15681,0.001284,172.217.24.0-255,6797,83541,92,294291
15682,0.001299,172.217.24.0-255,7156,90697,92,294291
15683,0.001299,172.31.47.0-255,66,90763,92,294291
15684,0.001304,172.31.47.0-255,66,90829,92,294291
15685,0.001335,172.31.47.0-255,66,90895,92,294291
15686,0.001359,172.217.24.0-255,1125,92020,92,294291
15687,0.001466,172.217.24.0-255,1484,93504,92,294291
15688,0.001469,172.31.47.0-255,66,93570,92,294291
15689,0.001473,172.217.24.0-255,2902,96472,92,294291
15690,0.001481,172.31.47.0-255,66,96538,92,294291
15691,0.0015,172.217.24.0-255,5738,102276,92,294291
15692,0.001505,172.217.24.0-255,2902,105178,92,294291
15693,0.001505,172.31.47.0-255,66,105244,92,294291
15694,0.001509,172.31.47.0-255,66,105310,92,294291
15695,0.001552,172.31.47.0-255,66,105376,92,294291
15696,0.001565,172.31.47.0-255,66,105442,92,294291
15697,0.001603,172.217.24.0-255,2184,107626,92,294291
15698,0.001606,172.31.47.0-255,66,107692,92,294291
15699,0.001619,172.217.24.0-255,2902,110594,92,294291
15700,0.001628,172.217.24.0-255,4320,114914,92,294291
15701,0.001632,172.31.47.0-255,66,114980,92,294291
15702,0.001645,172.217.24.0-255,5738,120718,92,294291
15703,0.001653,172.31.47.0-255,66,120784,92,294291
15704,0.00166,172.217.24.0-255,2902,123686,92,294291
15705,0.001665,172.31.47.0-255,66,123752,92,294291
15706,0.001675,172.217.24.0-255,5738,129490,92,294291
15707,0.00168,172.31.47.0-255,66,129556,92,294291
15708,0.001709,172.31.47.0-255,66,129622,92,294291
15709,0.003655,172.217.24.0-255,5738,135360,92,294291
15710,0.003661,172.31.47.0-255,66,135426,92,294291
15711,0.005603,172.217.24.0-255,5738,141164,92,294291
15712,0.005609,172.31.47.0-255,66,141230,92,294291
15713,0.007573,172.217.24.0-255,5738,146968,92,294291
15714,0.00758,172.31.47.0-255,66,147034,92,294291
15715,0.009542,172.217.24.0-255,5738,152772,92,294291
15716,0.011432,172.31.47.0-255,66,152838,92,294291
15717,0.011643,172.31.47.0-255,105,152943,92,294291
15718,0.013418,172.217.24.0-255,5738,158681,92,294291
15719,0.013428,172.31.47.0-255,66,158747,92,294291
15720,0.015407,172.217.24.0-255,5738,164485,92,294291
15721,0.015416,172.31.47.0-255,66,164551,92,294291
15722,0.017378,172.217.24.0-255,5738,170289,92,294291
15723,0.017387,172.31.47.0-255,66,170355,92,294291
15724,0.019341,172.217.24.0-255,5738,176093,92,294291
15725,0.019348,172.31.47.0-255,66,176159,92,294291
15726,0.021321,172.217.24.0-255,5738,181897,92,294291
15727,0.021331,172.31.47.0-255,66,181963,92,294291
15728,0.023288,172.217.24.0-255,5738,187701,92,294291
15729,0.023298,172.31.47.0-255,66,187767,92,294291
15730,0.02525,172.217.24.0-255,5738,193505,92,294291
15731,0.025257,172.31.47.0-255,66,193571,92,294291
15732,0.026829,172.31.47.0-255,172,193743,92,294291
15733,0.026857,172.31.47.0-255,1112,194855,92,294291
15734,0.026904,172.31.47.0-255,570,195425,92,294291
15735,0.027217,172.217.24.0-255,5738,201163,92,294291
15736,0.027223,172.31.47.0-255,66,201229,92,294291
15737,0.028364,104.244.42.0-255,66,201295,92,294291
15738,0.028517,104.244.42.0-255,66,201361,92,294291
15739,0.028539,104.244.42.0-255,66,201427,92,294291
15740,0.029186,172.217.24.0-255,5738,207165,92,294291
15741,0.029193,172.31.47.0-255,66,207231,92,294291
15742,0.031155,172.217.24.0-255,5738,212969,92,294291
15743,0.031162,172.31.47.0-255,66,213035,92,294291
15744,0.03312,172.217.24.0-255,5738,218773,92,294291
15745,0.033127,172.31.47.0-255,66,218839,92,294291
15746,0.035083,172.217.24.0-255,5738,224577,92,294291
15747,0.035089,172.31.47.0-255,66,224643,92,294291
15748,0.037047,172.217.24.0-255,5738,230381,92,294291
15749,0.037054,172.31.47.0-255,66,230447,92,294291
15750,0.039012,172.217.24.0-255,5738,236185,92,294291
15751,0.039019,172.31.47.0-255,66,236251,92,294291
15752,0.040975,172.217.24.0-255,5738,241989,92,294291
15753,0.040981,172.31.47.0-255,66,242055,92,294291
15754,0.042934,172.217.24.0-255,5738,247793,92,294291
15755,0.04294,172.31.47.0-255,66,247859,92,294291
15756,0.044897,172.217.24.0-255,5738,253597,92,294291
15757,0.044902,172.31.47.0-255,66,253663,92,294291
15758,0.046864,172.217.24.0-255,5738,259401,92,294291
15759,0.046871,172.31.47.0-255,66,259467,92,294291
15760,0.048832,172.217.24.0-255,5738,265205,92,294291
15761,0.048842,172.31.47.0-255,66,265271,92,294291
15762,0.050797,172.217.24.0-255,5738,271009,92,294291
15763,0.050804,172.31.47.0-255,66,271075,92,294291
15764,0.052755,172.217.24.0-255,5738,276813,92,294291
15765,0.052761,172.31.47.0-255,66,276879,92,294291
15766,0.05474,172.217.24.0-255,5738,282617,92,294291
15767,0.054745,172.31.47.0-255,66,282683,92,294291
15768,0.056723,172.217.24.0-255,5738,288421,92,294291
15769,0.056729,172.31.47.0-255,66,288487,92,294291
15770,0.058683,172.217.24.0-255,5738,294225,92,294291
15771,0.058689,172.31.47.0-255,66,294291,92,294291
15772,0.0,74.125.24.0-255,225,225,92,164987
15773,3e-05,172.31.47.0-255,66,291,92,164987
15774,3.6e-05,74.125.24.0-255,1484,1775,92,164987
15775,3.9e-05,172.31.47.0-255,66,1841,92,164987
15776,7.3e-05,74.125.24.0-255,4320,6161,92,164987
15777,7.9e-05,172.31.47.0-255,66,6227,92,164987
15778,0.000248,172.31.47.0-255,66,6293,92,164987
15779,0.000615,74.125.24.0-255,5738,12031,92,164987
15780,0.00062,172.31.47.0-255,66,12097,92,164987
15781,0.000849,74.125.24.0-255,1484,13581,92,164987
15782,0.000854,172.31.47.0-255,66,13647,92,164987
15783,0.000891,172.31.47.0-255,66,13713,92,164987
15784,0.003187,74.125.24.0-255,5738,19451,92,164987
15785,0.003193,172.31.47.0-255,66,19517,92,164987
15786,0.005519,74.125.24.0-255,5738,25255,92,164987
15787,0.00553,172.31.47.0-255,66,25321,92,164987
15788,0.00783,74.125.24.0-255,2902,28223,92,164987
15789,0.007837,172.31.47.0-255,66,28289,92,164987
15790,0.007871,74.125.24.0-255,2902,31191,92,164987
15791,0.007874,172.31.47.0-255,66,31257,92,164987
15792,0.010173,74.125.24.0-255,2902,34159,92,164987
15793,0.010188,172.31.47.0-255,66,34225,92,164987
15794,0.010226,74.125.24.0-255,2902,37127,92,164987
15795,0.01023,172.31.47.0-255,66,37193,92,164987
15796,0.012516,74.125.24.0-255,2902,40095,92,164987
15797,0.012526,172.31.47.0-255,66,40161,92,164987
15798,0.01256,74.125.24.0-255,2902,43063,92,164987
15799,0.012564,172.31.47.0-255,66,43129,92,164987
15800,0.014863,74.125.24.0-255,2902,46031,92,164987
15801,0.014873,172.31.47.0-255,66,46097,92,164987
15802,0.014918,74.125.24.0-255,2902,48999,92,164987
15803,0.014921,172.31.47.0-255,66,49065,92,164987
15804,0.017199,74.125.24.0-255,2902,51967,92,164987
15805,0.017206,172.31.47.0-255,66,52033,92,164987
15806,0.017245,74.125.24.0-255,2902,54935,92,164987
15807,0.017249,172.31.47.0-255,66,55001,92,164987
15808,0.019529,74.125.24.0-255,2902,57903,92,164987
15809,0.019537,172.31.47.0-255,66,57969,92,164987
15810,0.019573,74.125.24.0-255,2902,60871,92,164987
15811,0.019576,172.31.47.0-255,66,60937,92,164987
15812,0.021851,74.125.24.0-255,2902,63839,92,164987
15813,0.02186,172.31.47.0-255,66,63905,92,164987
15814,0.0219,74.125.24.0-255,2902,66807,92,164987
15815,0.021903,172.31.47.0-255,66,66873,92,164987
15816,0.023328,172.31.47.0-255,172,67045,92,164987
15817,0.023356,172.31.47.0-255,1112,68157,92,164987
15818,0.023409,172.31.47.0-255,1514,69671,92,164987
15819,0.023411,172.31.47.0-255,1514,71185,92,164987
15820,0.023412,172.31.47.0-255,1514,72699,92,164987
15821,0.023414,172.31.47.0-255,1514,74213,92,164987
15822,0.023415,172.31.47.0-255,1494,75707,92,164987
15823,0.024183,74.125.24.0-255,2902,78609,92,164987
15824,0.02419,172.31.47.0-255,66,78675,92,164987
15825,0.024227,74.125.24.0-255,1484,80159,92,164987
15826,0.02423,172.31.47.0-255,66,80225,92,164987
15827,0.024257,74.125.24.0-255,1484,81709,92,164987
15828,0.024874,104.244.42.0-255,66,81775,92,164987
15829,0.024882,104.244.42.0-255,66,81841,92,164987
15830,0.025013,104.244.42.0-255,66,81907,92,164987
15831,0.025582,104.244.42.0-255,108,82015,92,164987
15832,0.025587,172.31.47.0-255,66,82081,92,164987
15833,0.026488,74.125.24.0-255,2902,84983,92,164987
15834,0.026493,172.31.47.0-255,66,85049,92,164987
15835,0.028811,74.125.24.0-255,1484,86533,92,164987
15836,0.028838,74.125.24.0-255,4320,90853,92,164987
15837,0.028843,172.31.47.0-255,66,90919,92,164987
15838,0.03114,74.125.24.0-255,4320,95239,92,164987
15839,0.031146,172.31.47.0-255,66,95305,92,164987
15840,0.031176,74.125.24.0-255,1484,96789,92,164987
15841,0.033465,74.125.24.0-255,2902,99691,92,164987
15842,0.03347,172.31.47.0-255,66,99757,92,164987
15843,0.0335,74.125.24.0-255,1484,101241,92,164987
15844,0.035767,74.125.24.0-255,4320,105561,92,164987
15845,0.035773,172.31.47.0-255,66,105627,92,164987
15846,0.038079,74.125.24.0-255,4320,109947,92,164987
15847,0.038084,172.31.47.0-255,66,110013,92,164987
15848,0.038115,74.125.24.0-255,1484,111497,92,164987
15849,0.038117,172.31.47.0-255,66,111563,92,164987
15850,0.040411,74.125.24.0-255,4320,115883,92,164987
15851,0.040418,172.31.47.0-255,66,115949,92,164987
15852,0.040471,74.125.24.0-255,1484,117433,92,164987
15853,0.040475,172.31.47.0-255,66,117499,92,164987
15854,0.042733,74.125.24.0-255,4320,121819,92,164987
15855,0.042739,172.31.47.0-255,66,121885,92,164987
15856,0.042809,74.125.24.0-255,1484,123369,92,164987
15857,0.042814,172.31.47.0-255,66,123435,92,164987
15858,0.045064,74.125.24.0-255,2902,126337,92,164987
15859,0.045076,172.31.47.0-255,66,126403,92,164987
15860,0.045121,74.125.24.0-255,2902,129305,92,164987
15861,0.045125,172.31.47.0-255,66,129371,92,164987
15862,0.047385,74.125.24.0-255,2902,132273,92,164987
15863,0.04739,172.31.47.0-255,66,132339,92,164987
15864,0.047469,74.125.24.0-255,2902,135241,92,164987
15865,0.047473,172.31.47.0-255,66,135307,92,164987
15866,0.049696,74.125.24.0-255,2902,138209,92,164987
15867,0.049701,172.31.47.0-255,66,138275,92,164987
15868,0.049782,74.125.24.0-255,2902,141177,92,164987
15869,0.049787,172.31.47.0-255,66,141243,92,164987
15870,0.052031,74.125.24.0-255,2902,144145,92,164987
15871,0.052036,172.31.47.0-255,66,144211,92,164987
15872,0.052119,74.125.24.0-255,2902,147113,92,164987
15873,0.052123,172.31.47.0-255,66,147179,92,164987
15874,0.054347,74.125.24.0-255,2902,150081,92,164987
15875,0.054352,172.31.47.0-255,66,150147,92,164987
15876,0.054444,74.125.24.0-255,2902,153049,92,164987
15877,0.054449,172.31.47.0-255,66,153115,92,164987
15878,0.05667,74.125.24.0-255,2902,156017,92,164987
15879,0.056675,172.31.47.0-255,66,156083,92,164987
15880,0.056755,74.125.24.0-255,2902,158985,92,164987
15881,0.05676,172.31.47.0-255,66,159051,92,164987
15882,0.059031,74.125.24.0-255,2902,161953,92,164987
15883,0.059035,172.31.47.0-255,66,162019,92,164987
15884,0.059079,74.125.24.0-255,2902,164921,92,164987
15885,0.059083,172.31.47.0-255,66,164987,92,164987
15886,0.0,74.125.200.0-255,153,153,92,267793
15887,2.4e-05,172.31.47.0-255,66,219,92,267793
15888,3.1e-05,74.125.200.0-255,1484,1703,92,267793
15889,3.4e-05,172.31.47.0-255,66,1769,92,267793
15890,5.9e-05,74.125.200.0-255,2902,4671,92,267793
15891,6.2e-05,172.31.47.0-255,66,4737,92,267793
15892,7.4e-05,74.125.200.0-255,7156,11893,92,267793
15893,7.6e-05,172.31.47.0-255,66,11959,92,267793
15894,8e-05,74.125.200.0-255,2220,14179,92,267793
15895,8.4e-05,172.31.47.0-255,66,14245,92,267793
15896,0.000267,74.125.200.0-255,1484,15729,92,267793
15897,0.000272,172.31.47.0-255,66,15795,92,267793
15898,0.000278,74.125.200.0-255,2902,18697,92,267793
15899,0.000282,172.31.47.0-255,66,18763,92,267793
15900,0.000302,74.125.200.0-255,4320,23083,92,267793
15901,0.000305,172.31.47.0-255,66,23149,92,267793
15902,0.000328,74.125.200.0-255,1484,24633,92,267793
15903,0.000331,172.31.47.0-255,66,24699,92,267793
15904,0.000338,74.125.200.0-255,6797,31496,92,267793
15905,0.000342,172.31.47.0-255,66,31562,92,267793
15906,0.000376,74.125.200.0-255,7156,38718,92,267793
15907,0.00038,172.31.47.0-255,66,38784,92,267793
15908,0.000385,74.125.200.0-255,2902,41686,92,267793
15909,0.000388,172.31.47.0-255,66,41752,92,267793
15910,0.000422,74.125.200.0-255,6797,48549,92,267793
15911,0.000426,172.31.47.0-255,66,48615,92,267793
15912,0.000445,74.125.200.0-255,2902,51517,92,267793
15913,0.000448,172.31.47.0-255,66,51583,92,267793
15914,0.000453,74.125.200.0-255,4320,55903,92,267793
15915,0.000455,172.31.47.0-255,66,55969,92,267793
15916,0.00046,74.125.200.0-255,4320,60289,92,267793
15917,0.000463,172.31.47.0-255,66,60355,92,267793
15918,0.000491,74.125.200.0-255,4320,64675,92,267793
15919,0.000494,172.31.47.0-255,66,64741,92,267793
15920,0.000497,74.125.200.0-255,1395,66136,92,267793
15921,0.000624,74.125.200.0-255,137,66273,92,267793
15922,0.000661,74.125.200.0-255,346,66619,92,267793
15923,0.000664,172.31.47.0-255,66,66685,92,267793
15924,0.000922,74.125.200.0-255,1484,68169,92,267793
15925,0.000931,74.125.200.0-255,2902,71071,92,267793
15926,0.000934,172.31.47.0-255,66,71137,92,267793
15927,0.000939,74.125.200.0-255,2902,74039,92,267793
15928,0.000941,172.31.47.0-255,66,74105,92,267793
15929,0.000962,74.125.200.0-255,2902,77007,92,267793
15930,0.000969,172.31.47.0-255,66,77073,92,267793
15931,0.000974,74.125.200.0-255,2902,79975,92,267793
15932,0.000976,172.31.47.0-255,66,80041,92,267793
15933,0.001019,74.125.200.0-255,4320,84361,92,267793
15934,0.001024,172.31.47.0-255,66,84427,92,267793
15935,0.001026,172.31.47.0-255,66,84493,92,267793
15936,0.001066,74.125.200.0-255,6438,90931,92,267793
15937,0.00107,172.31.47.0-255,66,90997,92,267793
15938,0.001859,74.125.200.0-255,1484,92481,92,267793
15939,0.001866,74.125.200.0-255,1484,93965,92,267793
15940,0.001869,172.31.47.0-255,66,94031,92,267793
15941,0.001892,74.125.200.0-255,1484,95515,92,267793
15942,0.001897,74.125.200.0-255,5738,101253,92,267793
15943,0.001899,172.31.47.0-255,66,101319,92,267793
15944,0.001903,74.125.200.0-255,2902,104221,92,267793
15945,0.001904,172.31.47.0-255,66,104287,92,267793
15946,0.001925,74.125.200.0-255,4320,108607,92,267793
15947,0.001931,172.31.47.0-255,66,108673,92,267793
15948,0.00196,172.31.47.0-255,66,108739,92,267793
15949,0.001998,74.125.200.0-255,4320,113059,92,267793
15950,0.002,172.31.47.0-255,66,113125,92,267793
15951,0.002025,74.125.200.0-255,3602,116727,92,267793
15952,0.002027,172.31.47.0-255,66,116793,92,267793
15953,0.004279,74.125.200.0-255,1484,118277,92,267793
15954,0.004296,74.125.200.0-255,4320,122597,92,267793
15955,0.004299,172.31.47.0-255,66,122663,92,267793
15956,0.006584,74.125.200.0-255,5738,128401,92,267793
15957,0.006589,172.31.47.0-255,66,128467,92,267793
15958,0.008871,74.125.200.0-255,5738,134205,92,267793
15959,0.008879,172.31.47.0-255,66,134271,92,267793
15960,0.011175,74.125.200.0-255,5738,140009,92,267793
15961,0.011184,172.31.47.0-255,66,140075,92,267793
15962,0.013487,74.125.200.0-255,5738,145813,92,267793
15963,0.013498,172.31.47.0-255,66,145879,92,267793
15964,0.015782,74.125.200.0-255,5738,151617,92,267793
15965,0.01579,172.31.47.0-255,66,151683,92,267793
15966,0.018121,74.125.200.0-255,5738,157421,92,267793
15967,0.018128,172.31.47.0-255,66,157487,92,267793
15968,0.020422,74.125.200.0-255,5738,163225,92,267793
15969,0.020429,172.31.47.0-255,66,163291,92,267793
15970,0.022722,74.125.200.0-255,5738,169029,92,267793
15971,0.02273,172.31.47.0-255,66,169095,92,267793
15972,0.02371,172.31.47.0-255,172,169267,92,267793
15973,0.023743,172.31.47.0-255,1111,170378,92,267793
15974,0.023801,172.31.47.0-255,1514,171892,92,267793
15975,0.023803,172.31.47.0-255,1514,173406,92,267793
15976,0.023804,172.31.47.0-255,1514,174920,92,267793
15977,0.023807,172.31.47.0-255,1514,176434,92,267793
15978,0.023808,172.31.47.0-255,1495,177929,92,267793
15979,0.025004,74.125.200.0-255,4320,182249,92,267793
15980,0.02501,172.31.47.0-255,66,182315,92,267793
15981,0.025035,74.125.200.0-255,1484,183799,92,267793
15982,0.025276,104.244.42.0-255,66,183865,92,267793
15983,0.02532,104.244.42.0-255,66,183931,92,267793
15984,0.025375,104.244.42.0-255,66,183997,92,267793
15985,0.027291,74.125.200.0-255,4320,188317,92,267793
15986,0.027296,172.31.47.0-255,66,188383,92,267793
15987,0.029572,74.125.200.0-255,1484,189867,92,267793
15988,0.029598,74.125.200.0-255,4320,194187,92,267793
15989,0.029602,172.31.47.0-255,66,194253,92,267793
15990,0.03188,74.125.200.0-255,5738,199991,92,267793
15991,0.031884,172.31.47.0-255,66,200057,92,267793
15992,0.034157,74.125.200.0-255,4320,204377,92,267793
15993,0.034161,172.31.47.0-255,66,204443,92,267793
15994,0.034187,74.125.200.0-255,1484,205927,92,267793
15995,0.036445,74.125.200.0-255,4320,210247,92,267793
15996,0.03645,172.31.47.0-255,66,210313,92,267793
15997,0.038737,74.125.200.0-255,5738,216051,92,267793
15998,0.038742,172.31.47.0-255,66,216117,92,267793
15999,0.041018,74.125.200.0-255,4320,220437,92,267793
16000,0.041022,172.31.47.0-255,66,220503,92,267793
16001,0.041051,74.125.200.0-255,1484,221987,92,267793
16002,0.043294,74.125.200.0-255,4320,226307,92,267793
16003,0.043298,172.31.47.0-255,66,226373,92,267793
16004,0.045576,74.125.200.0-255,5738,232111,92,267793
16005,0.045581,172.31.47.0-255,66,232177,92,267793
16006,0.047877,74.125.200.0-255,2902,235079,92,267793
16007,0.047883,172.31.47.0-255,66,235145,92,267793
16008,0.047914,74.125.200.0-255,2902,238047,92,267793
16009,0.047917,172.31.47.0-255,66,238113,92,267793
16010,0.050155,74.125.200.0-255,2902,241015,92,267793
16011,0.050159,172.31.47.0-255,66,241081,92,267793
16012,0.050195,74.125.200.0-255,2902,243983,92,267793
16013,0.050197,172.31.47.0-255,66,244049,92,267793
16014,0.052447,74.125.200.0-255,2902,246951,92,267793
16015,0.052452,172.31.47.0-255,66,247017,92,267793
16016,0.052486,74.125.200.0-255,2902,249919,92,267793
16017,0.052489,172.31.47.0-255,66,249985,92,267793
16018,0.054743,74.125.200.0-255,2902,252887,92,267793
16019,0.054748,172.31.47.0-255,66,252953,92,267793
16020,0.054781,74.125.200.0-255,2902,255855,92,267793
16021,0.054784,172.31.47.0-255,66,255921,92,267793
16022,0.057022,74.125.200.0-255,2902,258823,92,267793
16023,0.057027,172.31.47.0-255,66,258889,92,267793
16024,0.057057,74.125.200.0-255,2902,261791,92,267793
16025,0.057059,172.31.47.0-255,66,261857,92,267793
16026,0.059314,74.125.200.0-255,2902,264759,92,267793
16027,0.05932,172.31.47.0-255,66,264825,92,267793
16028,0.059347,74.125.200.0-255,2902,267727,92,267793
16029,0.059351,172.31.47.0-255,66,267793,92,267793
16030,0.0,74.125.68.0-255,297,297,92,357462
16031,2.5e-05,172.31.47.0-255,66,363,92,357462
16032,3.1e-05,74.125.68.0-255,1484,1847,92,357462
16033,3.6e-05,172.31.47.0-255,66,1913,92,357462
16034,3.9e-05,74.125.68.0-255,1484,3397,92,357462
16035,5e-05,172.31.47.0-255,66,3463,92,357462
16036,5.6e-05,74.125.68.0-255,2902,6365,92,357462
16037,5.9e-05,172.31.47.0-255,66,6431,92,357462
16038,6.5e-05,74.125.68.0-255,5738,12169,92,357462
16039,6.8e-05,172.31.47.0-255,66,12235,92,357462
16040,7e-05,74.125.68.0-255,1484,13719,92,357462
16041,7.3e-05,172.31.47.0-255,66,13785,92,357462
16042,0.000103,74.125.68.0-255,488,14273,92,357462
16043,0.000105,172.31.47.0-255,66,14339,92,357462
16044,0.000152,74.125.68.0-255,1484,15823,92,357462
16045,0.000155,172.31.47.0-255,66,15889,92,357462
16046,0.000186,74.125.68.0-255,2902,18791,92,357462
16047,0.000189,172.31.47.0-255,66,18857,92,357462
16048,0.000196,74.125.68.0-255,5738,24595,92,357462
16049,0.000198,172.31.47.0-255,66,24661,92,357462
16050,0.000226,74.125.68.0-255,6797,31458,92,357462
16051,0.000228,172.31.47.0-255,66,31524,92,357462
16052,0.000284,74.125.68.0-255,7156,38680,92,357462
16053,0.000291,74.125.68.0-255,7156,45836,92,357462
16054,0.000295,172.31.47.0-255,66,45902,92,357462
16055,0.000298,172.31.47.0-255,66,45968,92,357462
16056,0.00035,74.125.68.0-255,2543,48511,92,357462
16057,0.000353,172.31.47.0-255,66,48577,92,357462
16058,0.000589,74.125.68.0-255,1484,50061,92,357462
16059,0.000594,172.31.47.0-255,66,50127,92,357462
16060,0.000626,74.125.68.0-255,1484,51611,92,357462
16061,0.00063,172.31.47.0-255,66,51677,92,357462
16062,0.000665,74.125.68.0-255,2902,54579,92,357462
16063,0.000668,172.31.47.0-255,66,54645,92,357462
16064,0.000675,74.125.68.0-255,5738,60383,92,357462
16065,0.000678,172.31.47.0-255,66,60449,92,357462
16066,0.000683,74.125.68.0-255,5379,65828,92,357462
16067,0.00069,74.125.68.0-255,5738,71566,92,357462
16068,0.000716,74.125.68.0-255,4320,75886,92,357462
16069,0.000728,74.125.68.0-255,2902,78788,92,357462
16070,0.000756,74.125.68.0-255,2902,81690,92,357462
16071,0.000768,74.125.68.0-255,1705,83395,92,357462
16072,0.000787,74.125.68.0-255,4320,87715,92,357462
16073,0.000802,74.125.68.0-255,1484,89199,92,357462
16074,0.000805,74.125.68.0-255,1484,90683,92,357462
16075,0.00083,74.125.68.0-255,5738,96421,92,357462
16076,0.000859,74.125.68.0-255,3961,100382,92,357462
16077,0.000978,172.31.47.0-255,66,100448,92,357462
16078,0.001371,74.125.68.0-255,1484,101932,92,357462
16079,0.001377,74.125.68.0-255,1484,103416,92,357462
16080,0.00138,172.31.47.0-255,66,103482,92,357462
16081,0.001417,74.125.68.0-255,1484,104966,92,357462
16082,0.001426,74.125.68.0-255,5738,110704,92,357462
16083,0.001428,74.125.68.0-255,1484,112188,92,357462
16084,0.001432,74.125.68.0-255,2902,115090,92,357462
16085,0.001455,74.125.68.0-255,5738,120828,92,357462
16086,0.001468,172.31.47.0-255,66,120894,92,357462
16087,0.001513,172.31.47.0-255,66,120960,92,357462
16088,0.00158,74.125.68.0-255,5020,125980,92,357462
16089,0.0016,172.31.47.0-255,66,126046,92,357462
16090,0.001603,74.125.68.0-255,1484,127530,92,357462
16091,0.001606,74.125.68.0-255,1484,129014,92,357462
16092,0.001611,172.31.47.0-255,66,129080,92,357462
16093,0.001642,74.125.68.0-255,1484,130564,92,357462
16094,0.001649,74.125.68.0-255,5738,136302,92,357462
16095,0.001659,74.125.68.0-255,7156,143458,92,357462
16096,0.001671,74.125.68.0-255,2902,146360,92,357462
16097,0.001684,74.125.68.0-255,4320,150680,92,357462
16098,0.001689,172.31.47.0-255,66,150746,92,357462
16099,0.001725,74.125.68.0-255,2902,153648,92,357462
16100,0.001738,74.125.68.0-255,2184,155832,92,357462
16101,0.00174,74.125.68.0-255,1484,157316,92,357462
16102,0.001752,74.125.68.0-255,4320,161636,92,357462
16103,0.001771,172.31.47.0-255,66,161702,92,357462
16104,0.001777,74.125.68.0-255,4320,166022,92,357462
16105,0.001782,172.31.47.0-255,66,166088,92,357462
16106,0.001804,74.125.68.0-255,5738,171826,92,357462
16107,0.001807,74.125.68.0-255,1484,173310,92,357462
16108,0.00182,172.31.47.0-255,66,173376,92,357462
16109,0.001862,74.125.68.0-255,2184,175560,92,357462
16110,0.001885,172.31.47.0-255,66,175626,92,357462
16111,0.001929,74.125.68.0-255,1484,177110,92,357462
16112,0.00195,74.125.68.0-255,2902,180012,92,357462
16113,0.001966,172.31.47.0-255,66,180078,92,357462
16114,0.001972,74.125.68.0-255,5738,185816,92,357462
16115,0.002015,74.125.68.0-255,1484,187300,92,357462
16116,0.002022,172.31.47.0-255,66,187366,92,357462
16117,0.002032,74.125.68.0-255,2902,190268,92,357462
16118,0.002037,74.125.68.0-255,5738,196006,92,357462
16119,0.002043,74.125.68.0-255,1484,197490,92,357462
16120,0.002071,74.125.68.0-255,4320,201810,92,357462
16121,0.002078,172.31.47.0-255,66,201876,92,357462
16122,0.002107,74.125.68.0-255,4320,206196,92,357462
16123,0.002112,74.125.68.0-255,2902,209098,92,357462
16124,0.002114,74.125.68.0-255,766,209864,92,357462
16125,0.002139,172.31.47.0-255,66,209930,92,357462
16126,0.004274,74.125.68.0-255,5738,215668,92,357462
16127,0.004287,172.31.47.0-255,66,215734,92,357462
16128,0.006383,74.125.68.0-255,5738,221472,92,357462
16129,0.009993,172.31.47.0-255,66,221538,92,357462
16130,0.012122,74.125.68.0-255,5738,227276,92,357462
16131,0.012139,172.31.47.0-255,66,227342,92,357462
16132,0.014252,74.125.68.0-255,5738,233080,92,357462
16133,0.014694,172.31.47.0-255,66,233146,92,357462
16134,0.01682,74.125.68.0-255,5738,238884,92,357462
16135,0.016837,172.31.47.0-255,66,238950,92,357462
16136,0.018958,74.125.68.0-255,5738,244688,92,357462
16137,0.018975,172.31.47.0-255,66,244754,92,357462
16138,0.021119,74.125.68.0-255,5738,250492,92,357462
16139,0.021137,172.31.47.0-255,66,250558,92,357462
16140,0.023281,74.125.68.0-255,5738,256296,92,357462
16141,0.024855,172.31.47.0-255,66,256362,92,357462
16142,0.026987,74.125.68.0-255,5738,262100,92,357462
16143,0.027004,172.31.47.0-255,66,262166,92,357462
16144,0.029127,74.125.68.0-255,5738,267904,92,357462
16145,0.029137,172.31.47.0-255,66,267970,92,357462
16146,0.029601,172.31.47.0-255,171,268141,92,357462
16147,0.02963,172.31.47.0-255,1131,269272,92,357462
16148,0.029692,172.31.47.0-255,1514,270786,92,357462
16149,0.029695,172.31.47.0-255,1514,272300,92,357462
16150,0.029696,172.31.47.0-255,1514,273814,92,357462
16151,0.029697,172.31.47.0-255,1514,275328,92,357462
16152,0.029698,172.31.47.0-255,335,275663,92,357462
16153,0.031141,104.244.42.0-255,66,275729,92,357462
16154,0.031207,104.244.42.0-255,66,275795,92,357462
16155,0.031242,74.125.68.0-255,5738,281533,92,357462
16156,0.031254,172.31.47.0-255,66,281599,92,357462
16157,0.031275,104.244.42.0-255,66,281665,92,357462
16158,0.031283,104.244.42.0-255,66,281731,92,357462
16159,0.031899,104.244.42.0-255,108,281839,92,357462
16160,0.031907,172.31.47.0-255,66,281905,92,357462
16161,0.033368,74.125.68.0-255,5738,287643,92,357462
16162,0.033375,172.31.47.0-255,66,287709,92,357462
16163,0.035489,74.125.68.0-255,5738,293447,92,357462
16164,0.035503,172.31.47.0-255,66,293513,92,357462
16165,0.037626,74.125.68.0-255,5738,299251,92,357462
16166,0.037637,172.31.47.0-255,66,299317,92,357462
16167,0.039747,74.125.68.0-255,5738,305055,92,357462
16168,0.039759,172.31.47.0-255,66,305121,92,357462
16169,0.041875,74.125.68.0-255,5738,310859,92,357462
16170,0.041888,172.31.47.0-255,66,310925,92,357462
16171,0.044002,74.125.68.0-255,5738,316663,92,357462
16172,0.044015,172.31.47.0-255,66,316729,92,357462
16173,0.046107,74.125.68.0-255,5738,322467,92,357462
16174,0.046115,172.31.47.0-255,66,322533,92,357462
16175,0.048222,74.125.68.0-255,5738,328271,92,357462
16176,0.048253,172.31.47.0-255,66,328337,92,357462
16177,0.049787,172.31.47.0-255,105,328442,92,357462
16178,0.050362,74.125.68.0-255,5738,334180,92,357462
16179,0.050372,172.31.47.0-255,66,334246,92,357462
16180,0.05249,74.125.68.0-255,5738,339984,92,357462
16181,0.052504,172.31.47.0-255,66,340050,92,357462
16182,0.054613,74.125.68.0-255,5738,345788,92,357462
16183,0.054629,172.31.47.0-255,66,345854,92,357462
16184,0.056746,74.125.68.0-255,5738,351592,92,357462
16185,0.056762,172.31.47.0-255,66,351658,92,357462
16186,0.058881,74.125.68.0-255,5738,357396,92,357462
16187,0.058897,172.31.47.0-255,66,357462,92,357462
16188,0.0,74.125.200.0-255,153,153,92,381396
16189,1.5e-05,172.31.47.0-255,66,219,92,381396
16190,2.1e-05,74.125.200.0-255,1484,1703,92,381396
16191,2.5e-05,172.31.47.0-255,66,1769,92,381396
16192,4.1e-05,74.125.200.0-255,2902,4671,92,381396
16193,4.4e-05,172.31.47.0-255,66,4737,92,381396
16194,6.7e-05,74.125.200.0-255,1484,6221,92,381396
16195,6.9e-05,172.31.47.0-255,66,6287,92,381396
16196,9.3e-05,74.125.200.0-255,5738,12025,92,381396
16197,9.5e-05,172.31.47.0-255,66,12091,92,381396
16198,0.000113,74.125.200.0-255,2144,14235,92,381396
16199,0.000115,172.31.47.0-255,66,14301,92,381396
16200,0.000212,74.125.200.0-255,1484,15785,92,381396
16201,0.000216,172.31.47.0-255,66,15851,92,381396
16202,0.000221,74.125.200.0-255,2902,18753,92,381396
16203,0.000223,172.31.47.0-255,66,18819,92,381396
16204,0.000242,74.125.200.0-255,2902,21721,92,381396
16205,0.000244,172.31.47.0-255,66,21787,92,381396
16206,0.000256,74.125.200.0-255,2902,24689,92,381396
16207,0.000258,172.31.47.0-255,66,24755,92,381396
16208,0.000263,74.125.200.0-255,5738,30493,92,381396
16209,0.000266,172.31.47.0-255,66,30559,92,381396
16210,0.000294,74.125.200.0-255,2902,33461,92,381396
16211,0.000297,172.31.47.0-255,66,33527,92,381396
16212,0.000319,74.125.200.0-255,3961,37488,92,381396
16213,0.000322,172.31.47.0-255,66,37554,92,381396
16214,0.000327,74.125.200.0-255,4320,41874,92,381396
16215,0.000329,172.31.47.0-255,66,41940,92,381396
16216,0.000332,74.125.200.0-255,1484,43424,92,381396
16217,0.000334,172.31.47.0-255,66,43490,92,381396
16218,0.000361,74.125.200.0-255,4320,47810,92,381396
16219,0.000364,172.31.47.0-255,66,47876,92,381396
16220,0.000371,74.125.200.0-255,5738,53614,92,381396
16221,0.000373,172.31.47.0-255,66,53680,92,381396
16222,0.000403,74.125.200.0-255,7156,60836,92,381396
16223,0.000406,172.31.47.0-255,66,60902,92,381396
16224,0.000414,74.125.200.0-255,5020,65922,92,381396
16225,0.000417,172.31.47.0-255,66,65988,92,381396
16226,0.000441,74.125.200.0-255,433,66421,92,381396
16227,0.000516,74.125.200.0-255,1484,67905,92,381396
16228,0.000521,172.31.47.0-255,66,67971,92,381396
16229,0.000525,74.125.200.0-255,2902,70873,92,381396
16230,0.000528,172.31.47.0-255,66,70939,92,381396
16231,0.000532,74.125.200.0-255,2902,73841,92,381396
16232,0.000535,172.31.47.0-255,66,73907,92,381396
16233,0.000551,74.125.200.0-255,2902,76809,92,381396
16234,0.000554,172.31.47.0-255,66,76875,92,381396
16235,0.000571,74.125.200.0-255,4320,81195,92,381396
16236,0.000573,172.31.47.0-255,66,81261,92,381396
16237,0.000597,172.31.47.0-255,66,81327,92,381396
16238,0.000655,74.125.200.0-255,5738,87065,92,381396
16239,0.000657,172.31.47.0-255,66,87131,92,381396
16240,0.000678,74.125.200.0-255,5297,92428,92,381396
16241,0.000681,172.31.47.0-255,66,92494,92,381396
16242,0.000684,74.125.200.0-255,1484,93978,92,381396
16243,0.000709,74.125.200.0-255,2902,96880,92,381396
16244,0.000712,172.31.47.0-255,66,96946,92,381396
16245,0.000715,74.125.200.0-255,1484,98430,92,381396
16246,0.000731,74.125.200.0-255,4320,102750,92,381396
16247,0.000733,172.31.47.0-255,66,102816,92,381396
16248,0.000754,74.125.200.0-255,2902,105718,92,381396
16249,0.000757,172.31.47.0-255,66,105784,92,381396
16250,0.00078,74.125.200.0-255,2902,108686,92,381396
16251,0.000782,172.31.47.0-255,66,108752,92,381396
16252,0.00079,74.125.200.0-255,7156,115908,92,381396
16253,0.000792,172.31.47.0-255,66,115974,92,381396
16254,0.000797,74.125.200.0-255,2902,118876,92,381396
16255,0.000799,172.31.47.0-255,66,118942,92,381396
16256,0.000829,172.31.47.0-255,66,119008,92,381396
16257,0.000845,74.125.200.0-255,1484,120492,92,381396
16258,0.000849,74.125.200.0-255,1484,121976,92,381396
16259,0.000851,172.31.47.0-255,66,122042,92,381396
16260,0.000871,74.125.200.0-255,1484,123526,92,381396
16261,0.000877,74.125.200.0-255,5738,129264,92,381396
16262,0.00088,172.31.47.0-255,66,129330,92,381396
16263,0.000882,74.125.200.0-255,1484,130814,92,381396
16264,0.000886,74.125.200.0-255,2902,133716,92,381396
16265,0.000889,172.31.47.0-255,66,133782,92,381396
16266,0.000911,74.125.200.0-255,5738,139520,92,381396
16267,0.000914,172.31.47.0-255,66,139586,92,381396
16268,0.000941,172.31.47.0-255,66,139652,92,381396
16269,0.000963,74.125.200.0-255,2184,141836,92,381396
16270,0.000966,172.31.47.0-255,66,141902,92,381396
16271,0.001198,74.125.200.0-255,1484,143386,92,381396
16272,0.001215,74.125.200.0-255,2902,146288,92,381396
16273,0.001219,172.31.47.0-255,66,146354,92,381396
16274,0.001239,74.125.200.0-255,4320,150674,92,381396
16275,0.001242,172.31.47.0-255,66,150740,92,381396
16276,0.001267,74.125.200.0-255,2902,153642,92,381396
16277,0.00127,172.31.47.0-255,66,153708,92,381396
16278,0.001295,74.125.200.0-255,5738,159446,92,381396
16279,0.001298,172.31.47.0-255,66,159512,92,381396
16280,0.001301,74.125.200.0-255,1484,160996,92,381396
16281,0.00132,74.125.200.0-255,7156,168152,92,381396
16282,0.001323,172.31.47.0-255,66,168218,92,381396
16283,0.001341,74.125.200.0-255,4320,172538,92,381396
16284,0.001344,172.31.47.0-255,66,172604,92,381396
16285,0.001349,74.125.200.0-255,2902,175506,92,381396
16286,0.001351,172.31.47.0-255,66,175572,92,381396
16287,0.001371,74.125.200.0-255,766,176338,92,381396
16288,0.001468,74.125.200.0-255,1484,177822,92,381396
16289,0.001472,172.31.47.0-255,66,177888,92,381396
16290,0.001476,74.125.200.0-255,1484,179372,92,381396
16291,0.001491,74.125.200.0-255,1484,180856,92,381396
16292,0.001494,172.31.47.0-255,66,180922,92,381396
16293,0.001508,74.125.200.0-255,5738,186660,92,381396
16294,0.001511,172.31.47.0-255,66,186726,92,381396
16295,0.00155,172.31.47.0-255,66,186792,92,381396
16296,0.001555,74.125.200.0-255,2902,189694,92,381396
16297,0.001556,172.31.47.0-255,66,189760,92,381396
16298,0.001577,172.31.47.0-255,66,189826,92,381396
16299,0.001582,74.125.200.0-255,2184,192010,92,381396
16300,0.001583,172.31.47.0-255,66,192076,92,381396
16301,0.001769,74.125.200.0-255,1484,193560,92,381396
16302,0.001789,74.125.200.0-255,1484,195044,92,381396
16303,0.001793,172.31.47.0-255,66,195110,92,381396
16304,0.001799,74.125.200.0-255,2902,198012,92,381396
16305,0.001801,172.31.47.0-255,66,198078,92,381396
16306,0.001825,74.125.200.0-255,5738,203816,92,381396
16307,0.001828,172.31.47.0-255,66,203882,92,381396
16308,0.001838,74.125.200.0-255,2902,206784,92,381396
16309,0.00184,172.31.47.0-255,66,206850,92,381396
16310,0.001861,172.31.47.0-255,66,206916,92,381396
16311,0.001893,74.125.200.0-255,4320,211236,92,381396
16312,0.001896,172.31.47.0-255,66,211302,92,381396
16313,0.001917,74.125.200.0-255,5020,216322,92,381396
16314,0.001921,172.31.47.0-255,66,216388,92,381396
16315,0.003966,74.125.200.0-255,5738,222126,92,381396
16316,0.003973,172.31.47.0-255,66,222192,92,381396
16317,0.006081,74.125.200.0-255,5738,227930,92,381396
16318,0.006098,172.31.47.0-255,66,227996,92,381396
16319,0.00817,74.125.200.0-255,5738,233734,92,381396
16320,0.008183,172.31.47.0-255,66,233800,92,381396
16321,0.010232,74.125.200.0-255,5738,239538,92,381396
16322,0.010245,172.31.47.0-255,66,239604,92,381396
16323,0.012305,74.125.200.0-255,5738,245342,92,381396
16324,0.012313,172.31.47.0-255,66,245408,92,381396
16325,0.014389,74.125.200.0-255,5738,251146,92,381396
16326,0.014396,172.31.47.0-255,66,251212,92,381396
16327,0.016465,74.125.200.0-255,5738,256950,92,381396
16328,0.016473,172.31.47.0-255,66,257016,92,381396
16329,0.018539,74.125.200.0-255,5738,262754,92,381396
16330,0.018545,172.31.47.0-255,66,262820,92,381396
16331,0.020636,74.125.200.0-255,5738,268558,92,381396
16332,0.02065,172.31.47.0-255,66,268624,92,381396
16333,0.022707,74.125.200.0-255,5738,274362,92,381396
16334,0.022714,172.31.47.0-255,66,274428,92,381396
16335,0.024799,74.125.200.0-255,5738,280166,92,381396
16336,0.024807,172.31.47.0-255,66,280232,92,381396
16337,0.026925,74.125.200.0-255,5738,285970,92,381396
16338,0.026942,172.31.47.0-255,66,286036,92,381396
16339,0.029019,74.125.200.0-255,5738,291774,92,381396
16340,0.029027,172.31.47.0-255,66,291840,92,381396
16341,0.031118,74.125.200.0-255,5738,297578,92,381396
16342,0.031125,172.31.47.0-255,66,297644,92,381396
16343,0.033175,74.125.200.0-255,5738,303382,92,381396
16344,0.033185,172.31.47.0-255,66,303448,92,381396
16345,0.035256,74.125.200.0-255,5738,309186,92,381396
16346,0.035268,172.31.47.0-255,66,309252,92,381396
16347,0.037335,74.125.200.0-255,5738,314990,92,381396
16348,0.037342,172.31.47.0-255,66,315056,92,381396
16349,0.039427,74.125.200.0-255,5738,320794,92,381396
16350,0.039443,172.31.47.0-255,66,320860,92,381396
16351,0.041517,74.125.200.0-255,5738,326598,92,381396
16352,0.041528,172.31.47.0-255,66,326664,92,381396
16353,0.043598,74.125.200.0-255,5738,332402,92,381396
16354,0.043613,172.31.47.0-255,66,332468,92,381396
16355,0.045676,74.125.200.0-255,5738,338206,92,381396
16356,0.045684,172.31.47.0-255,66,338272,92,381396
16357,0.047733,74.125.200.0-255,2902,341174,92,381396
16358,0.04774,172.31.47.0-255,66,341240,92,381396
16359,0.04776,74.125.200.0-255,2902,344142,92,381396
16360,0.047763,172.31.47.0-255,66,344208,92,381396
16361,0.049809,74.125.200.0-255,5738,349946,92,381396
16362,0.049825,172.31.47.0-255,66,350012,92,381396
16363,0.051905,74.125.200.0-255,5738,355750,92,381396
16364,0.051912,172.31.47.0-255,66,355816,92,381396
16365,0.05252,172.31.47.0-255,172,355988,92,381396
16366,0.052551,172.31.47.0-255,1103,357091,92,381396
16367,0.052615,172.31.47.0-255,1514,358605,92,381396
16368,0.052617,172.31.47.0-255,1514,360119,92,381396
16369,0.052618,172.31.47.0-255,1514,361633,92,381396
16370,0.052619,172.31.47.0-255,1514,363147,92,381396
16371,0.052649,172.31.47.0-255,1504,364651,92,381396
16372,0.053968,74.125.200.0-255,5738,370389,92,381396
16373,0.053975,172.31.47.0-255,66,370455,92,381396
16374,0.054072,104.244.42.0-255,66,370521,92,381396
16375,0.054095,104.244.42.0-255,66,370587,92,381396
16376,0.054234,104.244.42.0-255,66,370653,92,381396
16377,0.054818,104.244.42.0-255,108,370761,92,381396
16378,0.054824,172.31.47.0-255,66,370827,92,381396
16379,0.05604,74.125.200.0-255,5738,376565,92,381396
16380,0.056052,172.31.47.0-255,66,376631,92,381396
16381,0.058111,74.125.200.0-255,4594,381225,92,381396
16382,0.058118,172.31.47.0-255,66,381291,92,381396
16383,0.058331,172.31.47.0-255,105,381396,92,381396
16384,0.0,74.125.24.0-255,153,153,92,281404
16385,1.6e-05,172.31.47.0-255,66,219,92,281404
16386,2.2e-05,74.125.24.0-255,1484,1703,92,281404
16387,2.5e-05,172.31.47.0-255,66,1769,92,281404
16388,3.1e-05,74.125.24.0-255,2902,4671,92,281404
16389,3.4e-05,172.31.47.0-255,66,4737,92,281404
16390,5.5e-05,74.125.24.0-255,5738,10475,92,281404
16391,5.8e-05,172.31.47.0-255,66,10541,92,281404
16392,8e-05,74.125.24.0-255,3546,14087,92,281404
16393,8.2e-05,172.31.47.0-255,66,14153,92,281404
16394,0.000819,74.125.24.0-255,1484,15637,92,281404
16395,0.000825,172.31.47.0-255,66,15703,92,281404
16396,0.000834,74.125.24.0-255,2902,18605,92,281404
16397,0.000836,172.31.47.0-255,66,18671,92,281404
16398,0.000864,74.125.24.0-255,5738,24409,92,281404
16399,0.000867,172.31.47.0-255,66,24475,92,281404
16400,0.00087,74.125.24.0-255,1484,25959,92,281404
16401,0.000871,172.31.47.0-255,66,26025,92,281404
16402,0.000876,74.125.24.0-255,2902,28927,92,281404
16403,0.000878,172.31.47.0-255,66,28993,92,281404
16404,0.000908,74.125.24.0-255,6797,35790,92,281404
16405,0.000911,172.31.47.0-255,66,35856,92,281404
16406,0.000954,172.31.47.0-255,66,35922,92,281404
16407,0.000984,74.125.24.0-255,5738,41660,92,281404
16408,0.000987,172.31.47.0-255,66,41726,92,281404
16409,0.000998,172.31.47.0-255,66,41792,92,281404
16410,0.001492,74.125.24.0-255,136,41928,92,281404
16411,0.001498,172.31.47.0-255,66,41994,92,281404
16412,0.001535,74.125.24.0-255,1484,43478,92,281404
16413,0.001538,172.31.47.0-255,66,43544,92,281404
16414,0.001545,74.125.24.0-255,2902,46446,92,281404
16415,0.001562,74.125.24.0-255,7156,53602,92,281404
16416,0.001569,74.125.24.0-255,5738,59340,92,281404
16417,0.001591,74.125.24.0-255,2902,62242,92,281404
16418,0.001612,74.125.24.0-255,2902,65144,92,281404
16419,0.001627,74.125.24.0-255,5738,70882,92,281404
16420,0.001664,74.125.24.0-255,7156,78038,92,281404
16421,0.001693,74.125.24.0-255,5738,83776,92,281404
16422,0.001734,172.31.47.0-255,66,83842,92,281404
16423,0.00174,172.31.47.0-255,66,83908,92,281404
16424,0.001791,74.125.24.0-255,6438,90346,92,281404
16425,0.001814,172.31.47.0-255,66,90412,92,281404
16426,0.001859,74.125.24.0-255,1484,91896,92,281404
16427,0.001876,74.125.24.0-255,2902,94798,92,281404
16428,0.00188,74.125.24.0-255,1484,96282,92,281404
16429,0.0019,74.125.24.0-255,4320,100602,92,281404
16430,0.001904,172.31.47.0-255,66,100668,92,281404
16431,0.00191,172.31.47.0-255,66,100734,92,281404
16432,0.001921,74.125.24.0-255,1484,102218,92,281404
16433,0.001955,74.125.24.0-255,5738,107956,92,281404
16434,0.001977,172.31.47.0-255,66,108022,92,281404
16435,0.002011,74.125.24.0-255,5738,113760,92,281404
16436,0.002023,74.125.24.0-255,2184,115944,92,281404
16437,0.002032,172.31.47.0-255,66,116010,92,281404
16438,0.002309,74.125.24.0-255,1484,117494,92,281404
16439,0.002315,74.125.24.0-255,2902,120396,92,281404
16440,0.002321,74.125.24.0-255,5738,126134,92,281404
16441,0.00234,172.31.47.0-255,66,126200,92,281404
16442,0.002357,172.31.47.0-255,66,126266,92,281404
16443,0.002375,74.125.24.0-255,4320,130586,92,281404
16444,0.002384,172.31.47.0-255,66,130652,92,281404
16445,0.002394,74.125.24.0-255,4320,134972,92,281404
16446,0.002397,172.31.47.0-255,66,135038,92,281404
16447,0.002419,74.125.24.0-255,5738,140776,92,281404
16448,0.002501,74.125.24.0-255,3602,144378,92,281404
16449,0.002504,172.31.47.0-255,66,144444,92,281404
16450,0.002511,172.31.47.0-255,66,144510,92,281404
16451,0.005068,74.125.24.0-255,5738,150248,92,281404
16452,0.005075,172.31.47.0-255,66,150314,92,281404
16453,0.007617,74.125.24.0-255,5738,156052,92,281404
16454,0.008851,172.31.47.0-255,66,156118,92,281404
16455,0.0114,74.125.24.0-255,5738,161856,92,281404
16456,0.011409,172.31.47.0-255,66,161922,92,281404
16457,0.013949,74.125.24.0-255,5738,167660,92,281404
16458,0.013959,172.31.47.0-255,66,167726,92,281404
16459,0.016521,74.125.24.0-255,5738,173464,92,281404
16460,0.016537,172.31.47.0-255,66,173530,92,281404
16461,0.019062,74.125.24.0-255,5738,179268,92,281404
16462,0.019068,172.31.47.0-255,66,179334,92,281404
16463,0.021635,74.125.24.0-255,5738,185072,92,281404
16464,0.021642,172.31.47.0-255,66,185138,92,281404
16465,0.024173,74.125.24.0-255,5738,190876,92,281404
16466,0.024185,172.31.47.0-255,66,190942,92,281404
16467,0.026693,74.125.24.0-255,5738,196680,92,281404
16468,0.026701,172.31.47.0-255,66,196746,92,281404
16469,0.029244,74.125.24.0-255,5738,202484,92,281404
16470,0.029252,172.31.47.0-255,66,202550,92,281404
16471,0.031117,172.31.47.0-255,172,202722,92,281404
16472,0.031149,172.31.47.0-255,1112,203834,92,281404
16473,0.031208,172.31.47.0-255,1514,205348,92,281404
16474,0.03121,172.31.47.0-255,1514,206862,92,281404
16475,0.031215,172.31.47.0-255,1514,208376,92,281404
16476,0.031217,172.31.47.0-255,1514,209890,92,281404
16477,0.031239,172.31.47.0-255,1494,211384,92,281404
16478,0.03177,74.125.24.0-255,5738,217122,92,281404
16479,0.031777,172.31.47.0-255,66,217188,92,281404
16480,0.032673,104.244.42.0-255,66,217254,92,281404
16481,0.03268,104.244.42.0-255,66,217320,92,281404
16482,0.032785,104.244.42.0-255,66,217386,92,281404
16483,0.034283,74.125.24.0-255,5738,223124,92,281404
16484,0.034288,172.31.47.0-255,66,223190,92,281404
16485,0.036465,104.244.42.0-255,108,223298,92,281404
16486,0.036471,172.31.47.0-255,66,223364,92,281404
16487,0.036855,74.125.24.0-255,5738,229102,92,281404
16488,0.036859,172.31.47.0-255,66,229168,92,281404
16489,0.039367,74.125.24.0-255,5738,234906,92,281404
16490,0.039372,172.31.47.0-255,66,234972,92,281404
16491,0.04188,74.125.24.0-255,5738,240710,92,281404
16492,0.041887,172.31.47.0-255,66,240776,92,281404
16493,0.044457,74.125.24.0-255,5738,246514,92,281404
16494,0.044462,172.31.47.0-255,66,246580,92,281404
16495,0.046999,74.125.24.0-255,5738,252318,92,281404
16496,0.047008,172.31.47.0-255,66,252384,92,281404
16497,0.049551,74.125.24.0-255,5738,258122,92,281404
16498,0.049557,172.31.47.0-255,66,258188,92,281404
16499,0.052113,74.125.24.0-255,5738,263926,92,281404
16500,0.05212,172.31.47.0-255,66,263992,92,281404
16501,0.05467,74.125.24.0-255,5738,269730,92,281404
16502,0.054677,172.31.47.0-255,66,269796,92,281404
16503,0.057216,74.125.24.0-255,5738,275534,92,281404
16504,0.057222,172.31.47.0-255,66,275600,92,281404
16505,0.059724,74.125.24.0-255,5738,281338,92,281404
16506,0.059729,172.31.47.0-255,66,281404,92,281404
16507,0.0,172.217.194.0-255,153,153,92,312476
16508,2.8e-05,172.31.47.0-255,66,219,92,312476
16509,3.4e-05,172.217.194.0-255,1484,1703,92,312476
16510,3.8e-05,172.31.47.0-255,66,1769,92,312476
16511,4.2e-05,172.217.194.0-255,2902,4671,92,312476
16512,4.4e-05,172.31.47.0-255,66,4737,92,312476
16513,7.2e-05,172.217.194.0-255,7156,11893,92,312476
16514,7.4e-05,172.31.47.0-255,66,11959,92,312476
16515,7.7e-05,172.217.194.0-255,1484,13443,92,312476
16516,8.1e-05,172.31.47.0-255,66,13509,92,312476
16517,9.6e-05,172.217.194.0-255,5009,18518,92,312476
16518,9.8e-05,172.31.47.0-255,66,18584,92,312476
16519,0.000103,172.217.194.0-255,7156,25740,92,312476
16520,0.000105,172.31.47.0-255,66,25806,92,312476
16521,0.000143,172.31.47.0-255,66,25872,92,312476
16522,0.000149,172.217.194.0-255,6438,32310,92,312476
16523,0.000151,172.31.47.0-255,66,32376,92,312476
16524,0.000209,172.217.194.0-255,4320,36696,92,312476
16525,0.000212,172.31.47.0-255,66,36762,92,312476
16526,0.000244,172.31.47.0-255,66,36828,92,312476
16527,0.000289,172.217.194.0-255,1484,38312,92,312476
16528,0.000292,172.31.47.0-255,66,38378,92,312476
16529,0.000296,172.217.194.0-255,2902,41280,92,312476
16530,0.000298,172.31.47.0-255,66,41346,92,312476
16531,0.000301,172.217.194.0-255,1484,42830,92,312476
16532,0.000302,172.31.47.0-255,66,42896,92,312476
16533,0.000324,172.217.194.0-255,4320,47216,92,312476
16534,0.000327,172.31.47.0-255,66,47282,92,312476
16535,0.000336,172.31.47.0-255,66,47348,92,312476
16536,0.000364,172.217.194.0-255,4320,51668,92,312476
16537,0.000367,172.31.47.0-255,66,51734,92,312476
16538,0.000377,172.31.47.0-255,66,51800,92,312476
16539,0.000393,172.217.194.0-255,1484,53284,92,312476
16540,0.000395,172.31.47.0-255,66,53350,92,312476
16541,0.000423,172.217.194.0-255,4320,57670,92,312476
16542,0.000426,172.31.47.0-255,66,57736,92,312476
16543,0.000432,172.217.194.0-255,7156,64892,92,312476
16544,0.000435,172.31.47.0-255,66,64958,92,312476
16545,0.00044,172.217.194.0-255,4320,69278,92,312476
16546,0.000442,172.31.47.0-255,66,69344,92,312476
16547,0.000478,172.31.47.0-255,66,69410,92,312476
16548,0.000484,172.217.194.0-255,6438,75848,92,312476
16549,0.000486,172.31.47.0-255,66,75914,92,312476
16550,0.000499,172.217.194.0-255,5738,81652,92,312476
16551,0.000502,172.31.47.0-255,66,81718,92,312476
16552,0.000524,172.31.47.0-255,66,81784,92,312476
16553,0.000534,172.217.194.0-255,5738,87522,92,312476
16554,0.000536,172.31.47.0-255,66,87588,92,312476
16555,0.000547,172.217.194.0-255,1484,89072,92,312476
16556,0.000548,172.31.47.0-255,66,89138,92,312476
16557,0.000551,172.217.194.0-255,1484,90622,92,312476
16558,0.000553,172.31.47.0-255,66,90688,92,312476
16559,0.000566,172.217.194.0-255,4320,95008,92,312476
16560,0.000568,172.31.47.0-255,66,95074,92,312476
16561,0.000587,172.217.194.0-255,5320,100394,92,312476
16562,0.000591,172.31.47.0-255,66,100460,92,312476
16563,0.000667,172.217.194.0-255,1484,101944,92,312476
16564,0.00067,172.217.194.0-255,1484,103428,92,312476
16565,0.000671,172.31.47.0-255,66,103494,92,312476
16566,0.000678,172.217.194.0-255,1484,104978,92,312476
16567,0.000684,172.217.194.0-255,5738,110716,92,312476
16568,0.000685,172.31.47.0-255,66,110782,92,312476
16569,0.000689,172.31.47.0-255,66,110848,92,312476
16570,0.00075,172.31.47.0-255,66,110914,92,312476
16571,0.000757,172.217.194.0-255,7156,118070,92,312476
16572,0.000761,172.31.47.0-255,66,118136,92,312476
16573,0.000769,172.217.194.0-255,2902,121038,92,312476
16574,0.000776,172.31.47.0-255,66,121104,92,312476
16575,0.000779,172.217.194.0-255,766,121870,92,312476
16576,0.001536,172.31.47.0-255,66,121936,92,312476
16577,0.001688,172.217.194.0-255,1484,123420,92,312476
16578,0.001693,172.31.47.0-255,66,123486,92,312476
16579,0.0017,172.217.194.0-255,2902,126388,92,312476
16580,0.001703,172.31.47.0-255,66,126454,92,312476
16581,0.001709,172.217.194.0-255,5738,132192,92,312476
16582,0.001711,172.31.47.0-255,66,132258,92,312476
16583,0.001743,172.217.194.0-255,5738,137996,92,312476
16584,0.001746,172.31.47.0-255,66,138062,92,312476
16585,0.001768,172.217.194.0-255,7156,145218,92,312476
16586,0.001771,172.31.47.0-255,66,145284,92,312476
16587,0.00179,172.217.194.0-255,5738,151022,92,312476
16588,0.001792,172.31.47.0-255,66,151088,92,312476
16589,0.001816,172.217.194.0-255,5020,156108,92,312476
16590,0.001818,172.31.47.0-255,66,156174,92,312476
16591,0.003868,172.217.194.0-255,5738,161912,92,312476
16592,0.006473,172.31.47.0-255,66,161978,92,312476
16593,0.008539,172.217.194.0-255,5738,167716,92,312476
16594,0.008547,172.31.47.0-255,66,167782,92,312476
16595,0.010596,172.217.194.0-255,5738,173520,92,312476
16596,0.010603,172.31.47.0-255,66,173586,92,312476
16597,0.012648,172.217.194.0-255,5738,179324,92,312476
16598,0.012654,172.31.47.0-255,66,179390,92,312476
16599,0.014706,172.217.194.0-255,5738,185128,92,312476
16600,0.014713,172.31.47.0-255,66,185194,92,312476
16601,0.016761,172.217.194.0-255,5738,190932,92,312476
16602,0.016768,172.31.47.0-255,66,190998,92,312476
16603,0.018817,172.217.194.0-255,5738,196736,92,312476
16604,0.018822,172.31.47.0-255,66,196802,92,312476
16605,0.020859,172.217.194.0-255,1484,198286,92,312476
16606,0.020865,172.31.47.0-255,66,198352,92,312476
16607,0.020894,172.217.194.0-255,4320,202672,92,312476
16608,0.020906,172.31.47.0-255,66,202738,92,312476
16609,0.022885,172.217.194.0-255,1484,204222,92,312476
16610,0.02289,172.31.47.0-255,66,204288,92,312476
16611,0.022918,172.217.194.0-255,4320,208608,92,312476
16612,0.022929,172.31.47.0-255,66,208674,92,312476
16613,0.024288,172.31.47.0-255,172,208846,92,312476
16614,0.024322,172.31.47.0-255,1111,209957,92,312476
16615,0.024353,172.31.47.0-255,1514,211471,92,312476
16616,0.024354,172.31.47.0-255,1514,212985,92,312476
16617,0.024355,172.31.47.0-255,1514,214499,92,312476
16618,0.024357,172.31.47.0-255,1514,216013,92,312476
16619,0.024358,172.31.47.0-255,531,216544,92,312476
16620,0.024925,172.217.194.0-255,1484,218028,92,312476
16621,0.024931,172.31.47.0-255,66,218094,92,312476
16622,0.024954,172.217.194.0-255,4320,222414,92,312476
16623,0.024966,172.31.47.0-255,66,222480,92,312476
16624,0.025849,104.244.42.0-255,66,222546,92,312476
16625,0.025856,104.244.42.0-255,66,222612,92,312476
16626,0.025954,104.244.42.0-255,66,222678,92,312476
16627,0.025957,104.244.42.0-255,66,222744,92,312476
16628,0.026942,172.217.194.0-255,1484,224228,92,312476
16629,0.026979,172.217.194.0-255,4320,228548,92,312476
16630,0.027471,172.31.47.0-255,66,228614,92,312476
16631,0.029497,172.217.194.0-255,2902,231516,92,312476
16632,0.029502,172.31.47.0-255,66,231582,92,312476
16633,0.029528,172.217.194.0-255,2902,234484,92,312476
16634,0.029552,172.31.47.0-255,66,234550,92,312476
16635,0.031531,172.217.194.0-255,1484,236034,92,312476
16636,0.031552,172.217.194.0-255,1484,237518,92,312476
16637,0.031555,172.31.47.0-255,66,237584,92,312476
16638,0.031582,172.217.194.0-255,2902,240486,92,312476
16639,0.03159,172.31.47.0-255,66,240552,92,312476
16640,0.033575,172.217.194.0-255,2902,243454,92,312476
16641,0.03358,172.31.47.0-255,66,243520,92,312476
16642,0.033622,172.217.194.0-255,2902,246422,92,312476
16643,0.033632,172.31.47.0-255,66,246488,92,312476
16644,0.035591,172.217.194.0-255,2902,249390,92,312476
16645,0.035595,172.31.47.0-255,66,249456,92,312476
16646,0.03566,172.217.194.0-255,2902,252358,92,312476
16647,0.035666,172.31.47.0-255,66,252424,92,312476
16648,0.037642,172.217.194.0-255,2902,255326,92,312476
16649,0.037647,172.31.47.0-255,66,255392,92,312476
16650,0.03768,172.217.194.0-255,2902,258294,92,312476
16651,0.037699,172.31.47.0-255,66,258360,92,312476
16652,0.039673,172.217.194.0-255,2902,261262,92,312476
16653,0.039678,172.31.47.0-255,66,261328,92,312476
16654,0.039717,172.217.194.0-255,2902,264230,92,312476
16655,0.039722,172.31.47.0-255,66,264296,92,312476
16656,0.04175,172.217.194.0-255,4320,268616,92,312476
16657,0.041754,172.31.47.0-255,66,268682,92,312476
16658,0.041778,172.217.194.0-255,1484,270166,92,312476
16659,0.043808,172.217.194.0-255,4320,274486,92,312476
16660,0.043812,172.31.47.0-255,66,274552,92,312476
16661,0.045819,172.217.194.0-255,5738,280290,92,312476
16662,0.045859,172.31.47.0-255,66,280356,92,312476
16663,0.047975,172.217.194.0-255,5738,286094,92,312476
16664,0.047981,172.31.47.0-255,66,286160,92,312476
16665,0.050004,172.217.194.0-255,5738,291898,92,312476
16666,0.05001,172.31.47.0-255,66,291964,92,312476
16667,0.05207,172.217.194.0-255,5738,297702,92,312476
16668,0.052075,172.31.47.0-255,66,297768,92,312476
16669,0.05412,172.217.194.0-255,4320,302088,92,312476
16670,0.054124,172.31.47.0-255,66,302154,92,312476
16671,0.054147,172.217.194.0-255,1484,303638,92,312476
16672,0.056134,172.217.194.0-255,2902,306540,92,312476
16673,0.056138,172.31.47.0-255,66,306606,92,312476
16674,0.056163,172.217.194.0-255,1484,308090,92,312476
16675,0.058157,172.217.194.0-255,4320,312410,92,312476
16676,0.058218,172.31.47.0-255,66,312476,92,312476
16677,0.0,74.125.200.0-255,152,152,92,348321
16678,3.3e-05,172.31.47.0-255,66,218,92,348321
16679,4e-05,74.125.200.0-255,1484,1702,92,348321
16680,4.5e-05,172.31.47.0-255,66,1768,92,348321
16681,5.6e-05,74.125.200.0-255,2902,4670,92,348321
16682,5.9e-05,172.31.47.0-255,66,4736,92,348321
16683,6.5e-05,74.125.200.0-255,5738,10474,92,348321
16684,6.7e-05,172.31.47.0-255,66,10540,92,348321
16685,7.2e-05,74.125.200.0-255,2902,13442,92,348321
16686,7.4e-05,172.31.47.0-255,66,13508,92,348321
16687,0.0001,74.125.200.0-255,639,14147,92,348321
16688,0.000102,172.31.47.0-255,66,14213,92,348321
16689,0.000284,74.125.200.0-255,1484,15697,92,348321
16690,0.00029,172.31.47.0-255,66,15763,92,348321
16691,0.000294,74.125.200.0-255,2902,18665,92,348321
16692,0.000296,172.31.47.0-255,66,18731,92,348321
16693,0.000331,74.125.200.0-255,5738,24469,92,348321
16694,0.000334,172.31.47.0-255,66,24535,92,348321
16695,0.000338,74.125.200.0-255,2902,27437,92,348321
16696,0.00034,172.31.47.0-255,66,27503,92,348321
16697,0.000344,74.125.200.0-255,3961,31464,92,348321
16698,0.000351,172.31.47.0-255,66,31530,92,348321
16699,0.000479,74.125.200.0-255,1484,33014,92,348321
16700,0.000483,172.31.47.0-255,66,33080,92,348321
16701,0.000487,74.125.200.0-255,1484,34564,92,348321
16702,0.000489,172.31.47.0-255,66,34630,92,348321
16703,0.000509,74.125.200.0-255,1484,36114,92,348321
16704,0.000512,172.31.47.0-255,66,36180,92,348321
16705,0.000538,74.125.200.0-255,5738,41918,92,348321
16706,0.000541,172.31.47.0-255,66,41984,92,348321
16707,0.000545,74.125.200.0-255,2902,44886,92,348321
16708,0.000546,172.31.47.0-255,66,44952,92,348321
16709,0.000574,74.125.200.0-255,3961,48913,92,348321
16710,0.000576,172.31.47.0-255,66,48979,92,348321
16711,0.000581,74.125.200.0-255,4320,53299,92,348321
16712,0.000583,172.31.47.0-255,66,53365,92,348321
16713,0.000613,74.125.200.0-255,2902,56267,92,348321
16714,0.000616,172.31.47.0-255,66,56333,92,348321
16715,0.000621,74.125.200.0-255,5738,62071,92,348321
16716,0.000623,172.31.47.0-255,66,62137,92,348321
16717,0.000671,74.125.200.0-255,2902,65039,92,348321
16718,0.000676,172.31.47.0-255,66,65105,92,348321
16719,0.000683,74.125.200.0-255,1477,66582,92,348321
16720,0.00076,74.125.200.0-255,333,66915,92,348321
16721,0.000764,172.31.47.0-255,66,66981,92,348321
16722,0.00115,74.125.200.0-255,1484,68465,92,348321
16723,0.001166,74.125.200.0-255,2902,71367,92,348321
16724,0.00117,172.31.47.0-255,66,71433,92,348321
16725,0.001175,74.125.200.0-255,2902,74335,92,348321
16726,0.001176,172.31.47.0-255,66,74401,92,348321
16727,0.001196,74.125.200.0-255,2902,77303,92,348321
16728,0.001199,172.31.47.0-255,66,77369,92,348321
16729,0.001209,74.125.200.0-255,7156,84525,92,348321
16730,0.001211,172.31.47.0-255,66,84591,92,348321
16731,0.001273,172.31.47.0-255,66,84657,92,348321
16732,0.001285,74.125.200.0-255,2184,86841,92,348321
16733,0.00129,172.31.47.0-255,66,86907,92,348321
16734,0.001437,74.125.200.0-255,1484,88391,92,348321
16735,0.001453,74.125.200.0-255,2902,91293,92,348321
16736,0.001456,172.31.47.0-255,66,91359,92,348321
16737,0.001481,74.125.200.0-255,5738,97097,92,348321
16738,0.001483,172.31.47.0-255,66,97163,92,348321
16739,0.001488,74.125.200.0-255,4320,101483,92,348321
16740,0.00149,172.31.47.0-255,66,101549,92,348321
16741,0.001493,74.125.200.0-255,1484,103033,92,348321
16742,0.001522,74.125.200.0-255,4320,107353,92,348321
16743,0.001524,172.31.47.0-255,66,107419,92,348321
16744,0.001527,74.125.200.0-255,1484,108903,92,348321
16745,0.001552,172.31.47.0-255,66,108969,92,348321
16746,0.001598,74.125.200.0-255,2184,111153,92,348321
16747,0.0016,172.31.47.0-255,66,111219,92,348321
16748,0.001719,74.125.200.0-255,1484,112703,92,348321
16749,0.001736,74.125.200.0-255,2902,115605,92,348321
16750,0.001739,172.31.47.0-255,66,115671,92,348321
16751,0.001748,74.125.200.0-255,1484,117155,92,348321
16752,0.001751,74.125.200.0-255,1484,118639,92,348321
16753,0.001755,172.31.47.0-255,66,118705,92,348321
16754,0.001776,74.125.200.0-255,1484,120189,92,348321
16755,0.001782,74.125.200.0-255,5738,125927,92,348321
16756,0.001784,172.31.47.0-255,66,125993,92,348321
16757,0.001796,74.125.200.0-255,2902,128895,92,348321
16758,0.001802,172.31.47.0-255,66,128961,92,348321
16759,0.001815,74.125.200.0-255,7156,136117,92,348321
16760,0.001824,172.31.47.0-255,66,136183,92,348321
16761,0.001844,74.125.200.0-255,1484,137667,92,348321
16762,0.001856,74.125.200.0-255,4320,141987,92,348321
16763,0.001858,172.31.47.0-255,66,142053,92,348321
16764,0.001876,74.125.200.0-255,5020,147073,92,348321
16765,0.001879,172.31.47.0-255,66,147139,92,348321
16766,0.001881,74.125.200.0-255,1484,148623,92,348321
16767,0.001905,74.125.200.0-255,1484,150107,92,348321
16768,0.001919,74.125.200.0-255,5738,155845,92,348321
16769,0.001949,74.125.200.0-255,1484,157329,92,348321
16770,0.001986,74.125.200.0-255,1484,158813,92,348321
16771,0.002007,74.125.200.0-255,2184,160997,92,348321
16772,0.002083,74.125.200.0-255,1484,162481,92,348321
16773,0.0021,74.125.200.0-255,1484,163965,92,348321
16774,0.00212,74.125.200.0-255,2902,166867,92,348321
16775,0.002139,74.125.200.0-255,5738,172605,92,348321
16776,0.002167,74.125.200.0-255,7156,179761,92,348321
16777,0.002188,74.125.200.0-255,5738,185499,92,348321
16778,0.002205,74.125.200.0-255,2902,188401,92,348321
16779,0.002209,74.125.200.0-255,2902,191303,92,348321
16780,0.002227,74.125.200.0-255,3602,194905,92,348321
16781,0.002331,74.125.200.0-255,1484,196389,92,348321
16782,0.002334,74.125.200.0-255,1484,197873,92,348321
16783,0.002344,74.125.200.0-255,1484,199357,92,348321
16784,0.002361,74.125.200.0-255,1484,200841,92,348321
16785,0.003528,172.31.47.0-255,66,200907,92,348321
16786,0.005845,74.125.200.0-255,5738,206645,92,348321
16787,0.005852,172.31.47.0-255,66,206711,92,348321
16788,0.008173,74.125.200.0-255,5738,212449,92,348321
16789,0.008179,172.31.47.0-255,66,212515,92,348321
16790,0.010524,74.125.200.0-255,5738,218253,92,348321
16791,0.010532,172.31.47.0-255,66,218319,92,348321
16792,0.012862,74.125.200.0-255,5738,224057,92,348321
16793,0.012868,172.31.47.0-255,66,224123,92,348321
16794,0.015215,74.125.200.0-255,5738,229861,92,348321
16795,0.015224,172.31.47.0-255,66,229927,92,348321
16796,0.017541,74.125.200.0-255,5738,235665,92,348321
16797,0.01755,172.31.47.0-255,66,235731,92,348321
16798,0.019871,74.125.200.0-255,5738,241469,92,348321
16799,0.019879,172.31.47.0-255,66,241535,92,348321
16800,0.02219,74.125.200.0-255,5738,247273,92,348321
16801,0.022198,172.31.47.0-255,66,247339,92,348321
16802,0.024503,74.125.200.0-255,5738,253077,92,348321
16803,0.02451,172.31.47.0-255,66,253143,92,348321
16804,0.026824,74.125.200.0-255,2902,256045,92,348321
16805,0.026833,172.31.47.0-255,66,256111,92,348321
16806,0.026859,74.125.200.0-255,2902,259013,92,348321
16807,0.026862,172.31.47.0-255,66,259079,92,348321
16808,0.02858,172.31.47.0-255,172,259251,92,348321
16809,0.028612,172.31.47.0-255,1107,260358,92,348321
16810,0.028677,172.31.47.0-255,1514,261872,92,348321
16811,0.028679,172.31.47.0-255,1514,263386,92,348321
16812,0.028681,172.31.47.0-255,1514,264900,92,348321
16813,0.028682,172.31.47.0-255,1514,266414,92,348321
16814,0.028683,172.31.47.0-255,1499,267913,92,348321
16815,0.029154,74.125.200.0-255,5738,273651,92,348321
16816,0.02916,172.31.47.0-255,66,273717,92,348321
16817,0.030144,104.244.42.0-255,66,273783,92,348321
16818,0.030151,104.244.42.0-255,66,273849,92,348321
16819,0.030253,104.244.42.0-255,66,273915,92,348321
16820,0.031475,74.125.200.0-255,5738,279653,92,348321
16821,0.031483,172.31.47.0-255,66,279719,92,348321
16822,0.031539,104.244.42.0-255,108,279827,92,348321
16823,0.031543,172.31.47.0-255,66,279893,92,348321
16824,0.033788,74.125.200.0-255,4320,284213,92,348321
16825,0.033793,172.31.47.0-255,66,284279,92,348321
16826,0.033819,74.125.200.0-255,1484,285763,92,348321
16827,0.036106,74.125.200.0-255,4320,290083,92,348321
16828,0.036113,172.31.47.0-255,66,290149,92,348321
16829,0.038417,74.125.200.0-255,5738,295887,92,348321
16830,0.038423,172.31.47.0-255,66,295953,92,348321
16831,0.040739,74.125.200.0-255,5738,301691,92,348321
16832,0.040744,172.31.47.0-255,66,301757,92,348321
16833,0.043046,74.125.200.0-255,2902,304659,92,348321
16834,0.043052,172.31.47.0-255,66,304725,92,348321
16835,0.04307,74.125.200.0-255,2902,307627,92,348321
16836,0.043072,172.31.47.0-255,66,307693,92,348321
16837,0.045379,74.125.200.0-255,5738,313431,92,348321
16838,0.045383,172.31.47.0-255,66,313497,92,348321
16839,0.047719,74.125.200.0-255,5738,319235,92,348321
16840,0.047725,172.31.47.0-255,66,319301,92,348321
16841,0.050037,74.125.200.0-255,5738,325039,92,348321
16842,0.050044,172.31.47.0-255,66,325105,92,348321
16843,0.052359,74.125.200.0-255,5738,330843,92,348321
16844,0.052366,172.31.47.0-255,66,330909,92,348321
16845,0.054663,74.125.200.0-255,5738,336647,92,348321
16846,0.05467,172.31.47.0-255,66,336713,92,348321
16847,0.056977,74.125.200.0-255,5738,342451,92,348321
16848,0.056983,172.31.47.0-255,66,342517,92,348321
16849,0.05929,74.125.200.0-255,5738,348255,92,348321
16850,0.059297,172.31.47.0-255,66,348321,92,348321
16851,0.0,172.31.47.0-255,105,105,92,459
16852,0.000295,172.31.47.0-255,90,195,92,459
16853,0.000304,172.31.47.0-255,66,261,92,459
16854,0.002591,74.125.24.0-255,66,327,92,459
16855,0.002603,74.125.24.0-255,66,393,92,459
16856,0.002615,172.31.47.0-255,66,459,92,459
16857,0.0,172.217.194.0-255,153,153,92,184843
16858,2.2e-05,172.31.47.0-255,66,219,92,184843
16859,2.9e-05,172.217.194.0-255,1484,1703,92,184843
16860,3.3e-05,172.31.47.0-255,66,1769,92,184843
16861,4.7e-05,172.217.194.0-255,2902,4671,92,184843
16862,5e-05,172.31.47.0-255,66,4737,92,184843
16863,5.8e-05,172.217.194.0-255,7156,11893,92,184843
16864,6.1e-05,172.31.47.0-255,66,11959,92,184843
16865,9.7e-05,172.217.194.0-255,2098,14057,92,184843
16866,0.0001,172.31.47.0-255,66,14123,92,184843
16867,0.000133,172.217.194.0-255,1484,15607,92,184843
16868,0.000135,172.31.47.0-255,66,15673,92,184843
16869,0.000149,172.217.194.0-255,2902,18575,92,184843
16870,0.000156,172.31.47.0-255,66,18641,92,184843
16871,0.000163,172.217.194.0-255,5738,24379,92,184843
16872,0.000165,172.31.47.0-255,66,24445,92,184843
16873,0.000202,172.217.194.0-255,6797,31242,92,184843
16874,0.000204,172.31.47.0-255,66,31308,92,184843
16875,0.000212,172.217.194.0-255,7156,38464,92,184843
16876,0.000214,172.31.47.0-255,66,38530,92,184843
16877,0.000245,172.31.47.0-255,66,38596,92,184843
16878,0.000289,172.217.194.0-255,7156,45752,92,184843
16879,0.000291,172.31.47.0-255,66,45818,92,184843
16880,0.000296,172.217.194.0-255,2902,48720,92,184843
16881,0.000299,172.31.47.0-255,66,48786,92,184843
16882,0.000326,172.217.194.0-255,5738,54524,92,184843
16883,0.000333,172.31.47.0-255,66,54590,92,184843
16884,0.000336,172.217.194.0-255,1406,55996,92,184843
16885,0.000338,172.31.47.0-255,66,56062,92,184843
16886,0.000516,172.217.194.0-255,116,56178,92,184843
16887,0.00052,172.31.47.0-255,66,56244,92,184843
16888,0.000524,172.217.194.0-255,377,56621,92,184843
16889,0.000673,172.217.194.0-255,1484,58105,92,184843
16890,0.000677,172.31.47.0-255,66,58171,92,184843
16891,0.000683,172.217.194.0-255,2902,61073,92,184843
16892,0.000685,172.31.47.0-255,66,61139,92,184843
16893,0.000696,172.217.194.0-255,4320,65459,92,184843
16894,0.000698,172.31.47.0-255,66,65525,92,184843
16895,0.000729,172.217.194.0-255,1484,67009,92,184843
16896,0.000742,172.31.47.0-255,66,67075,92,184843
16897,0.000749,172.217.194.0-255,5738,72813,92,184843
16898,0.000751,172.31.47.0-255,66,72879,92,184843
16899,0.000792,172.31.47.0-255,66,72945,92,184843
16900,0.000867,172.217.194.0-255,1484,74429,92,184843
16901,0.000882,172.217.194.0-255,2902,77331,92,184843
16902,0.000885,172.31.47.0-255,66,77397,92,184843
16903,0.000892,172.217.194.0-255,5738,83135,92,184843
16904,0.000895,172.31.47.0-255,66,83201,92,184843
16905,0.000948,172.31.47.0-255,66,83267,92,184843
16906,0.00096,172.31.47.0-255,66,83333,92,184843
16907,0.000983,172.217.194.0-255,766,84099,92,184843
16908,0.001083,172.217.194.0-255,1484,85583,92,184843
16909,0.001087,172.31.47.0-255,66,85649,92,184843
16910,0.001092,172.217.194.0-255,2902,88551,92,184843
16911,0.001094,172.31.47.0-255,66,88617,92,184843
16912,0.001105,172.217.194.0-255,4320,92937,92,184843
16913,0.001107,172.31.47.0-255,66,93003,92,184843
16914,0.001118,172.217.194.0-255,1484,94487,92,184843
16915,0.001143,172.217.194.0-255,4320,98807,92,184843
16916,0.001145,172.31.47.0-255,66,98873,92,184843
16917,0.001178,172.31.47.0-255,66,98939,92,184843
16918,0.001195,172.31.47.0-255,66,99005,92,184843
16919,0.001594,172.217.194.0-255,1484,100489,92,184843
16920,0.001598,172.217.194.0-255,1484,101973,92,184843
16921,0.001603,172.31.47.0-255,66,102039,92,184843
16922,0.001632,172.217.194.0-255,1484,103523,92,184843
16923,0.001639,172.217.194.0-255,5738,109261,92,184843
16924,0.001641,172.31.47.0-255,66,109327,92,184843
16925,0.001652,172.31.47.0-255,66,109393,92,184843
16926,0.001693,172.217.194.0-255,2902,112295,92,184843
16927,0.001696,172.31.47.0-255,66,112361,92,184843
16928,0.001711,172.31.47.0-255,66,112427,92,184843
16929,0.001715,172.217.194.0-255,2184,114611,92,184843
16930,0.001717,172.31.47.0-255,66,114677,92,184843
16931,0.001783,172.217.194.0-255,1484,116161,92,184843
16932,0.001788,172.217.194.0-255,2902,119063,92,184843
16933,0.001791,172.31.47.0-255,66,119129,92,184843
16934,0.001795,172.217.194.0-255,2902,122031,92,184843
16935,0.001797,172.31.47.0-255,66,122097,92,184843
16936,0.001825,172.217.194.0-255,2902,124999,92,184843
16937,0.001828,172.31.47.0-255,66,125065,92,184843
16938,0.001834,172.217.194.0-255,5738,130803,92,184843
16939,0.001836,172.31.47.0-255,66,130869,92,184843
16940,0.001841,172.217.194.0-255,2902,133771,92,184843
16941,0.001843,172.31.47.0-255,66,133837,92,184843
16942,0.001891,172.31.47.0-255,66,133903,92,184843
16943,0.001897,172.217.194.0-255,5020,138923,92,184843
16944,0.0019,172.31.47.0-255,66,138989,92,184843
16945,0.001967,172.217.194.0-255,1484,140473,92,184843
16946,0.001981,172.217.194.0-255,2902,143375,92,184843
16947,0.001985,172.31.47.0-255,66,143441,92,184843
16948,0.001992,172.217.194.0-255,5738,149179,92,184843
16949,0.001994,172.31.47.0-255,66,149245,92,184843
16950,0.002037,172.31.47.0-255,66,149311,92,184843
16951,0.002069,172.217.194.0-255,7156,156467,92,184843
16952,0.002072,172.31.47.0-255,66,156533,92,184843
16953,0.0021,172.217.194.0-255,3602,160135,92,184843
16954,0.002103,172.31.47.0-255,66,160201,92,184843
16955,0.00212,172.31.47.0-255,66,160267,92,184843
16956,0.002123,172.217.194.0-255,1484,161751,92,184843
16957,0.002162,172.31.47.0-255,66,161817,92,184843
16958,0.002189,172.31.47.0-255,66,161883,92,184843
16959,0.002228,172.31.47.0-255,66,161949,92,184843
16960,0.002233,172.217.194.0-255,4320,166269,92,184843
16961,0.002235,172.31.47.0-255,66,166335,92,184843
16962,0.00227,172.217.194.0-255,7156,173491,92,184843
16963,0.002273,172.31.47.0-255,66,173557,92,184843
16964,0.002276,172.217.194.0-255,1484,175041,92,184843
16965,0.002324,172.31.47.0-255,66,175107,92,184843
16966,0.002389,172.31.47.0-255,66,175173,92,184843
16967,0.002431,172.31.47.0-255,66,175239,92,184843
16968,0.002521,172.31.47.0-255,66,175305,92,184843
16969,0.002563,172.31.47.0-255,66,175371,92,184843
16970,0.002591,172.217.194.0-255,97,175468,92,184843
16971,0.004849,172.217.194.0-255,105,175573,92,184843
16972,0.009579,172.31.47.0-255,66,175639,92,184843
16973,0.009615,172.31.47.0-255,105,175744,92,184843
16974,0.011904,172.217.194.0-255,66,175810,92,184843
16975,0.039122,172.31.47.0-255,172,175982,92,184843
16976,0.039156,172.31.47.0-255,1107,177089,92,184843
16977,0.039237,172.31.47.0-255,1514,178603,92,184843
16978,0.039238,172.31.47.0-255,1514,180117,92,184843
16979,0.03924,172.31.47.0-255,1514,181631,92,184843
16980,0.039241,172.31.47.0-255,1514,183145,92,184843
16981,0.039242,172.31.47.0-255,1500,184645,92,184843
16982,0.040638,104.244.42.0-255,66,184711,92,184843
16983,0.0407,104.244.42.0-255,66,184777,92,184843
16984,0.040831,104.244.42.0-255,66,184843,92,184843
16985,0.0,172.31.47.0-255,66,66,92,66
16986,0.0,74.125.24.0-255,153,153,92,228358
16987,2.5e-05,172.31.47.0-255,66,219,92,228358
16988,3.1e-05,74.125.24.0-255,1484,1703,92,228358
16989,3.4e-05,172.31.47.0-255,66,1769,92,228358
16990,3.9e-05,74.125.24.0-255,2902,4671,92,228358
16991,4.1e-05,172.31.47.0-255,66,4737,92,228358
16992,5.4e-05,74.125.24.0-255,7156,11893,92,228358
16993,5.7e-05,172.31.47.0-255,66,11959,92,228358
16994,6.1e-05,74.125.24.0-255,2013,13972,92,228358
16995,6.4e-05,172.31.47.0-255,66,14038,92,228358
16996,0.000362,74.125.24.0-255,1484,15522,92,228358
16997,0.000367,172.31.47.0-255,66,15588,92,228358
16998,0.000373,74.125.24.0-255,2902,18490,92,228358
16999,0.000375,172.31.47.0-255,66,18556,92,228358
17000,0.000386,74.125.24.0-255,2902,21458,92,228358
17001,0.000388,172.31.47.0-255,66,21524,92,228358
17002,0.0004,74.125.24.0-255,2902,24426,92,228358
17003,0.000403,172.31.47.0-255,66,24492,92,228358
17004,0.000407,74.125.24.0-255,2902,27394,92,228358
17005,0.000414,172.31.47.0-255,66,27460,92,228358
17006,0.000443,74.125.24.0-255,3961,31421,92,228358
17007,0.000447,172.31.47.0-255,66,31487,92,228358
17008,0.000454,74.125.24.0-255,7156,38643,92,228358
17009,0.000457,172.31.47.0-255,66,38709,92,228358
17010,0.000485,74.125.24.0-255,2902,41611,92,228358
17011,0.000488,172.31.47.0-255,66,41677,92,228358
17012,0.000522,74.125.24.0-255,6797,48474,92,228358
17013,0.000528,172.31.47.0-255,66,48540,92,228358
17014,0.001366,74.125.24.0-255,1484,50024,92,228358
17015,0.001374,172.31.47.0-255,66,50090,92,228358
17016,0.001385,74.125.24.0-255,2902,52992,92,228358
17017,0.001388,172.31.47.0-255,66,53058,92,228358
17018,0.001401,74.125.24.0-255,5738,58796,92,228358
17019,0.001403,172.31.47.0-255,66,58862,92,228358
17020,0.001425,74.125.24.0-255,4320,63182,92,228358
17021,0.001428,172.31.47.0-255,66,63248,92,228358
17022,0.001465,172.31.47.0-255,66,63314,92,228358
17023,0.001483,172.31.47.0-255,66,63380,92,228358
17024,0.001551,172.31.47.0-255,66,63446,92,228358
17025,0.001554,74.125.24.0-255,646,64092,92,228358
17026,0.001556,172.31.47.0-255,66,64158,92,228358
17027,0.003675,74.125.24.0-255,5738,69896,92,228358
17028,0.00368,172.31.47.0-255,66,69962,92,228358
17029,0.005798,74.125.24.0-255,5738,75700,92,228358
17030,0.005803,172.31.47.0-255,66,75766,92,228358
17031,0.007913,74.125.24.0-255,5738,81504,92,228358
17032,0.00792,172.31.47.0-255,66,81570,92,228358
17033,0.01006,74.125.24.0-255,5738,87308,92,228358
17034,0.010066,172.31.47.0-255,66,87374,92,228358
17035,0.012202,74.125.24.0-255,5738,93112,92,228358
17036,0.012207,172.31.47.0-255,66,93178,92,228358
17037,0.01434,74.125.24.0-255,5738,98916,92,228358
17038,0.014347,172.31.47.0-255,66,98982,92,228358
17039,0.016511,74.125.24.0-255,5738,104720,92,228358
17040,0.016533,172.31.47.0-255,66,104786,92,228358
17041,0.018668,74.125.24.0-255,5738,110524,92,228358
17042,0.018676,172.31.47.0-255,66,110590,92,228358
17043,0.020818,74.125.24.0-255,5738,116328,92,228358
17044,0.020825,172.31.47.0-255,66,116394,92,228358
17045,0.022957,74.125.24.0-255,5738,122132,92,228358
17046,0.022964,172.31.47.0-255,66,122198,92,228358
17047,0.025095,74.125.24.0-255,5738,127936,92,228358
17048,0.025101,172.31.47.0-255,66,128002,92,228358
17049,0.027209,74.125.24.0-255,5738,133740,92,228358
17050,0.027215,172.31.47.0-255,66,133806,92,228358
17051,0.029316,74.125.24.0-255,1484,135290,92,228358
17052,0.029344,74.125.24.0-255,4320,139610,92,228358
17053,0.02935,172.31.47.0-255,66,139676,92,228358
17054,0.029697,172.31.47.0-255,172,139848,92,228358
17055,0.02974,172.31.47.0-255,1113,140961,92,228358
17056,0.029828,172.31.47.0-255,1514,142475,92,228358
17057,0.02983,172.31.47.0-255,1514,143989,92,228358
17058,0.029831,172.31.47.0-255,1514,145503,92,228358
17059,0.029832,172.31.47.0-255,1514,147017,92,228358
17060,0.029833,172.31.47.0-255,1493,148510,92,228358
17061,0.031278,104.244.42.0-255,66,148576,92,228358
17062,0.031333,104.244.42.0-255,66,148642,92,228358
17063,0.031428,104.244.42.0-255,66,148708,92,228358
17064,0.031446,74.125.24.0-255,2902,151610,92,228358
17065,0.031451,172.31.47.0-255,66,151676,92,228358
17066,0.031487,74.125.24.0-255,2902,154578,92,228358
17067,0.031491,172.31.47.0-255,66,154644,92,228358
17068,0.033588,74.125.24.0-255,5738,160382,92,228358
17069,0.033594,172.31.47.0-255,66,160448,92,228358
17070,0.035689,74.125.24.0-255,5738,166186,92,228358
17071,0.035694,172.31.47.0-255,66,166252,92,228358
17072,0.037788,74.125.24.0-255,5738,171990,92,228358
17073,0.037794,172.31.47.0-255,66,172056,92,228358
17074,0.037819,104.244.42.0-255,108,172164,92,228358
17075,0.037822,172.31.47.0-255,66,172230,92,228358
17076,0.03989,74.125.24.0-255,4320,176550,92,228358
17077,0.039895,172.31.47.0-255,66,176616,92,228358
17078,0.039927,74.125.24.0-255,1484,178100,92,228358
17079,0.042013,74.125.24.0-255,1484,179584,92,228358
17080,0.042019,172.31.47.0-255,66,179650,92,228358
17081,0.042053,74.125.24.0-255,2902,182552,92,228358
17082,0.042056,172.31.47.0-255,66,182618,92,228358
17083,0.04414,74.125.24.0-255,2902,185520,92,228358
17084,0.044146,172.31.47.0-255,66,185586,92,228358
17085,0.044175,74.125.24.0-255,2902,188488,92,228358
17086,0.044179,172.31.47.0-255,66,188554,92,228358
17087,0.046282,74.125.24.0-255,2902,191456,92,228358
17088,0.046287,172.31.47.0-255,66,191522,92,228358
17089,0.046318,74.125.24.0-255,2902,194424,92,228358
17090,0.046321,172.31.47.0-255,66,194490,92,228358
17091,0.048398,74.125.24.0-255,2902,197392,92,228358
17092,0.048403,172.31.47.0-255,66,197458,92,228358
17093,0.048432,74.125.24.0-255,2902,200360,92,228358
17094,0.048435,172.31.47.0-255,66,200426,92,228358
17095,0.05052,74.125.24.0-255,2902,203328,92,228358
17096,0.050526,172.31.47.0-255,66,203394,92,228358
17097,0.050563,74.125.24.0-255,2902,206296,92,228358
17098,0.050566,172.31.47.0-255,66,206362,92,228358
17099,0.052641,74.125.24.0-255,1484,207846,92,228358
17100,0.052676,74.125.24.0-255,2902,210748,92,228358
17101,0.052681,172.31.47.0-255,66,210814,92,228358
17102,0.052702,74.125.24.0-255,1484,212298,92,228358
17103,0.054797,74.125.24.0-255,4320,216618,92,228358
17104,0.054803,172.31.47.0-255,66,216684,92,228358
17105,0.056914,74.125.24.0-255,1484,218168,92,228358
17106,0.05694,74.125.24.0-255,4320,222488,92,228358
17107,0.056945,172.31.47.0-255,66,222554,92,228358
17108,0.059055,74.125.24.0-255,5738,228292,92,228358
17109,0.059059,172.31.47.0-255,66,228358,92,228358
17110,0.0,74.125.24.0-255,431,431,92,107300
17111,2.1e-05,74.125.24.0-255,1484,1915,92,107300
17112,2.8e-05,172.31.47.0-255,66,1981,92,107300
17113,3.6e-05,74.125.24.0-255,4320,6301,92,107300
17114,3.8e-05,172.31.47.0-255,66,6367,92,107300
17115,0.000176,74.125.24.0-255,7156,13523,92,107300
17116,0.000181,172.31.47.0-255,66,13589,92,107300
17117,0.00045,74.125.24.0-255,686,14275,92,107300
17118,0.000495,74.125.24.0-255,7156,21431,92,107300
17119,0.000499,172.31.47.0-255,66,21497,92,107300
17120,0.000517,74.125.24.0-255,1484,22981,92,107300
17121,0.000841,74.125.24.0-255,7156,30137,92,107300
17122,0.000848,172.31.47.0-255,66,30203,92,107300
17123,0.00208,74.125.24.0-255,5738,35941,92,107300
17124,0.002337,74.125.24.0-255,2902,38843,92,107300
17125,0.002346,74.125.24.0-255,1484,40327,92,107300
17126,0.002511,74.125.24.0-255,2902,43229,92,107300
17127,0.002536,74.125.24.0-255,7156,50385,92,107300
17128,0.002929,74.125.24.0-255,4320,54705,92,107300
17129,0.003062,172.31.47.0-255,66,54771,92,107300
17130,0.003401,172.31.47.0-255,66,54837,92,107300
17131,0.003886,74.125.24.0-255,2902,57739,92,107300
17132,0.003892,172.31.47.0-255,66,57805,92,107300
17133,0.003975,74.125.24.0-255,1484,59289,92,107300
17134,0.005112,172.31.47.0-255,66,59355,92,107300
17135,0.005169,172.31.47.0-255,66,59421,92,107300
17136,0.005462,74.125.24.0-255,7156,66577,92,107300
17137,0.005468,172.31.47.0-255,66,66643,92,107300
17138,0.005483,74.125.24.0-255,2118,68761,92,107300
17139,0.005486,172.31.47.0-255,66,68827,92,107300
17140,0.005506,74.125.24.0-255,7156,75983,92,107300
17141,0.005508,172.31.47.0-255,66,76049,92,107300
17142,0.005551,172.31.47.0-255,66,76115,92,107300
17143,0.005573,74.125.24.0-255,2766,78881,92,107300
17144,0.005577,172.31.47.0-255,66,78947,92,107300
17145,0.00595,172.31.47.0-255,66,79013,92,107300
17146,0.007153,172.31.47.0-255,66,79079,92,107300
17147,0.007192,172.31.47.0-255,66,79145,92,107300
17148,0.00721,74.125.24.0-255,1926,81071,92,107300
17149,0.007212,172.31.47.0-255,66,81137,92,107300
17150,0.007343,74.125.24.0-255,2902,84039,92,107300
17151,0.007347,172.31.47.0-255,66,84105,92,107300
17152,0.00738,172.31.47.0-255,66,84171,92,107300
17153,0.007582,74.125.24.0-255,7156,91327,92,107300
17154,0.00759,172.31.47.0-255,66,91393,92,107300
17155,0.007651,172.31.47.0-255,66,91459,92,107300
17156,0.007675,172.31.47.0-255,66,91525,92,107300
17157,0.008306,172.31.47.0-255,66,91591,92,107300
17158,0.008361,172.31.47.0-255,66,91657,92,107300
17159,0.008843,172.31.47.0-255,66,91723,92,107300
17160,0.00887,172.31.47.0-255,66,91789,92,107300
17161,0.009181,172.31.47.0-255,66,91855,92,107300
17162,0.009231,172.31.47.0-255,66,91921,92,107300
17163,0.009359,172.31.47.0-255,66,91987,92,107300
17164,0.009418,172.31.47.0-255,66,92053,92,107300
17165,0.009526,74.125.24.0-255,5738,97791,92,107300
17166,0.009534,172.31.47.0-255,66,97857,92,107300
17167,0.009579,172.31.47.0-255,66,97923,92,107300
17168,0.010145,172.31.47.0-255,105,98028,92,107300
17169,0.016946,74.125.24.0-255,66,98094,92,107300
17170,0.031653,172.31.47.0-255,172,98266,92,107300
17171,0.031699,172.31.47.0-255,1106,99372,92,107300
17172,0.03177,172.31.47.0-255,1514,100886,92,107300
17173,0.031772,172.31.47.0-255,1514,102400,92,107300
17174,0.031774,172.31.47.0-255,1514,103914,92,107300
17175,0.031775,172.31.47.0-255,1514,105428,92,107300
17176,0.031776,172.31.47.0-255,1500,106928,92,107300
17177,0.033239,104.244.42.0-255,66,106994,92,107300
17178,0.033248,104.244.42.0-255,66,107060,92,107300
17179,0.033334,104.244.42.0-255,66,107126,92,107300
17180,0.033694,104.244.42.0-255,108,107234,92,107300
17181,0.033698,172.31.47.0-255,66,107300,92,107300
17182,0.0,172.31.47.0-255,105,105,92,276
17183,0.001775,157.240.13.0-255,105,210,92,276
17184,0.001787,172.31.47.0-255,66,276,92,276
17185,0.0,172.217.194.0-255,152,152,92,271799
17186,2.3e-05,172.31.47.0-255,66,218,92,271799
17187,2.9e-05,172.217.194.0-255,1484,1702,92,271799
17188,3.3e-05,172.31.47.0-255,66,1768,92,271799
17189,3.9e-05,172.217.194.0-255,2902,4670,92,271799
17190,4.1e-05,172.31.47.0-255,66,4736,92,271799
17191,4.4e-05,172.217.194.0-255,1484,6220,92,271799
17192,4.6e-05,172.31.47.0-255,66,6286,92,271799
17193,7.4e-05,172.217.194.0-255,4320,10606,92,271799
17194,7.7e-05,172.31.47.0-255,66,10672,92,271799
17195,8.2e-05,172.217.194.0-255,3410,14082,92,271799
17196,8.4e-05,172.31.47.0-255,66,14148,92,271799
17197,0.000124,172.31.47.0-255,66,14214,92,271799
17198,0.000129,172.217.194.0-255,5379,19593,92,271799
17199,0.000131,172.31.47.0-255,66,19659,92,271799
17200,0.000197,172.217.194.0-255,1484,21143,92,271799
17201,0.0002,172.31.47.0-255,66,21209,92,271799
17202,0.000204,172.217.194.0-255,2902,24111,92,271799
17203,0.000206,172.31.47.0-255,66,24177,92,271799
17204,0.000218,172.217.194.0-255,1484,25661,92,271799
17205,0.000219,172.31.47.0-255,66,25727,92,271799
17206,0.000238,172.217.194.0-255,4320,30047,92,271799
17207,0.00024,172.31.47.0-255,66,30113,92,271799
17208,0.000258,172.217.194.0-255,5738,35851,92,271799
17209,0.00026,172.31.47.0-255,66,35917,92,271799
17210,0.000297,172.31.47.0-255,66,35983,92,271799
17211,0.000308,172.31.47.0-255,66,36049,92,271799
17212,0.00031,172.217.194.0-255,432,36481,92,271799
17213,0.000313,172.31.47.0-255,66,36547,92,271799
17214,0.000404,172.217.194.0-255,1484,38031,92,271799
17215,0.000408,172.31.47.0-255,66,38097,92,271799
17216,0.000413,172.217.194.0-255,2902,40999,92,271799
17217,0.000415,172.31.47.0-255,66,41065,92,271799
17218,0.000422,172.217.194.0-255,5738,46803,92,271799
17219,0.000424,172.31.47.0-255,66,46869,92,271799
17220,0.000473,172.217.194.0-255,1484,48353,92,271799
17221,0.000476,172.31.47.0-255,66,48419,92,271799
17222,0.000491,172.217.194.0-255,4830,53249,92,271799
17223,0.000547,172.31.47.0-255,66,53315,92,271799
17224,0.000875,172.217.194.0-255,1484,54799,92,271799
17225,0.000898,172.217.194.0-255,2902,57701,92,271799
17226,0.000901,172.31.47.0-255,66,57767,92,271799
17227,0.000909,172.217.194.0-255,5738,63505,92,271799
17228,0.000927,172.31.47.0-255,66,63571,92,271799
17229,0.000939,172.217.194.0-255,7156,70727,92,271799
17230,0.000949,172.31.47.0-255,66,70793,92,271799
17231,0.000955,172.217.194.0-255,5738,76531,92,271799
17232,0.00099,172.217.194.0-255,7156,83687,92,271799
17233,0.000993,172.31.47.0-255,66,83753,92,271799
17234,0.001003,172.217.194.0-255,3602,87355,92,271799
17235,0.001044,172.31.47.0-255,66,87421,92,271799
17236,0.001724,172.217.194.0-255,1484,88905,92,271799
17237,0.001735,172.217.194.0-255,2902,91807,92,271799
17238,0.001739,172.31.47.0-255,66,91873,92,271799
17239,0.001748,172.217.194.0-255,5738,97611,92,271799
17240,0.00175,172.31.47.0-255,66,97677,92,271799
17241,0.001753,172.217.194.0-255,1484,99161,92,271799
17242,0.00178,172.217.194.0-255,5738,104899,92,271799
17243,0.001782,172.31.47.0-255,66,104965,92,271799
17244,0.001787,172.217.194.0-255,2902,107867,92,271799
17245,0.001789,172.31.47.0-255,66,107933,92,271799
17246,0.001812,172.31.47.0-255,66,107999,92,271799
17247,0.001817,172.217.194.0-255,2184,110183,92,271799
17248,0.001819,172.31.47.0-255,66,110249,92,271799
17249,0.002232,172.217.194.0-255,1484,111733,92,271799
17250,0.00224,172.217.194.0-255,2902,114635,92,271799
17251,0.002244,172.31.47.0-255,66,114701,92,271799
17252,0.002252,172.217.194.0-255,5738,120439,92,271799
17253,0.002254,172.31.47.0-255,66,120505,92,271799
17254,0.00226,172.217.194.0-255,4320,124825,92,271799
17255,0.002262,172.31.47.0-255,66,124891,92,271799
17256,0.002329,172.217.194.0-255,4320,129211,92,271799
17257,0.002349,172.217.194.0-255,3602,132813,92,271799
17258,0.005019,172.31.47.0-255,66,132879,92,271799
17259,0.007335,172.217.194.0-255,4320,137199,92,271799
17260,0.00734,172.31.47.0-255,66,137265,92,271799
17261,0.007358,172.217.194.0-255,1484,138749,92,271799
17262,0.009651,172.217.194.0-255,4320,143069,92,271799
17263,0.009658,172.31.47.0-255,66,143135,92,271799
17264,0.011993,172.217.194.0-255,5738,148873,92,271799
17265,0.012002,172.31.47.0-255,66,148939,92,271799
17266,0.014309,172.217.194.0-255,5738,154677,92,271799
17267,0.014317,172.31.47.0-255,66,154743,92,271799
17268,0.016623,172.217.194.0-255,5738,160481,92,271799
17269,0.016635,172.31.47.0-255,66,160547,92,271799
17270,0.018936,172.217.194.0-255,5738,166285,92,271799
17271,0.018942,172.31.47.0-255,66,166351,92,271799
17272,0.021264,172.217.194.0-255,5738,172089,92,271799
17273,0.021272,172.31.47.0-255,66,172155,92,271799
17274,0.023607,172.217.194.0-255,5738,177893,92,271799
17275,0.023616,172.31.47.0-255,66,177959,92,271799
17276,0.025915,172.217.194.0-255,5738,183697,92,271799
17277,0.025922,172.31.47.0-255,66,183763,92,271799
17278,0.028244,172.217.194.0-255,5738,189501,92,271799
17279,0.028251,172.31.47.0-255,66,189567,92,271799
17280,0.030589,172.217.194.0-255,5738,195305,92,271799
17281,0.030597,172.31.47.0-255,66,195371,92,271799
17282,0.032039,172.31.47.0-255,171,195542,92,271799
17283,0.032067,172.31.47.0-255,1135,196677,92,271799
17284,0.032125,172.31.47.0-255,1514,198191,92,271799
17285,0.032127,172.31.47.0-255,1514,199705,92,271799
17286,0.032132,172.31.47.0-255,1514,201219,92,271799
17287,0.032133,172.31.47.0-255,1514,202733,92,271799
17288,0.032158,172.31.47.0-255,332,203065,92,271799
17289,0.03291,172.217.194.0-255,5738,208803,92,271799
17290,0.032916,172.31.47.0-255,66,208869,92,271799
17291,0.033593,104.244.42.0-255,66,208935,92,271799
17292,0.033646,104.244.42.0-255,66,209001,92,271799
17293,0.033727,104.244.42.0-255,66,209067,92,271799
17294,0.033732,104.244.42.0-255,66,209133,92,271799
17295,0.035229,172.217.194.0-255,5738,214871,92,271799
17296,0.035235,172.31.47.0-255,66,214937,92,271799
17297,0.035976,104.244.42.0-255,108,215045,92,271799
17298,0.035981,172.31.47.0-255,66,215111,92,271799
17299,0.037559,172.217.194.0-255,4320,219431,92,271799
17300,0.037563,172.31.47.0-255,66,219497,92,271799
17301,0.037582,172.217.194.0-255,1484,220981,92,271799
17302,0.039851,172.217.194.0-255,4320,225301,92,271799
17303,0.039856,172.31.47.0-255,66,225367,92,271799
17304,0.042187,172.217.194.0-255,5738,231105,92,271799
17305,0.042197,172.31.47.0-255,66,231171,92,271799
17306,0.044509,172.217.194.0-255,5738,236909,92,271799
17307,0.044516,172.31.47.0-255,66,236975,92,271799
17308,0.046849,172.217.194.0-255,5738,242713,92,271799
17309,0.046855,172.31.47.0-255,66,242779,92,271799
17310,0.049144,172.217.194.0-255,5738,248517,92,271799
17311,0.049149,172.31.47.0-255,66,248583,92,271799
17312,0.051425,172.217.194.0-255,5738,254321,92,271799
17313,0.051431,172.31.47.0-255,66,254387,92,271799
17314,0.053775,172.217.194.0-255,5738,260125,92,271799
17315,0.053782,172.31.47.0-255,66,260191,92,271799
17316,0.056094,172.217.194.0-255,5738,265929,92,271799
17317,0.0561,172.31.47.0-255,66,265995,92,271799
17318,0.058479,172.217.194.0-255,5738,271733,92,271799
17319,0.058488,172.31.47.0-255,66,271799,92,271799
17320,0.0,172.31.47.0-255,105,105,92,276
17321,0.001857,157.240.7.0-255,105,210,92,276
17322,0.00187,172.31.47.0-255,66,276,92,276
17323,0.0,172.31.47.0-255,130,130,92,1747
17324,0.001743,172.31.47.0-255,236,366,92,1747
17325,0.00178,172.31.47.0-255,359,725,92,1747
17326,0.00247,74.125.24.0-255,630,1355,92,1747
17327,0.003844,74.125.24.0-255,66,1421,92,1747
17328,0.004804,74.125.24.0-255,97,1518,92,1747
17329,0.004815,172.31.47.0-255,66,1584,92,1747
17330,0.015708,172.31.47.0-255,97,1681,92,1747
17331,0.023191,74.125.24.0-255,66,1747,92,1747
17332,0.0,172.217.194.0-255,152,152,92,294237
17333,3.5e-05,172.31.47.0-255,66,218,92,294237
17334,4.2e-05,172.217.194.0-255,1484,1702,92,294237
17335,4.6e-05,172.31.47.0-255,66,1768,92,294237
17336,5.8e-05,172.217.194.0-255,2902,4670,92,294237
17337,6.1e-05,172.31.47.0-255,66,4736,92,294237
17338,6.7e-05,172.217.194.0-255,7156,11892,92,294237
17339,7.1e-05,172.31.47.0-255,66,11958,92,294237
17340,7.5e-05,172.217.194.0-255,2095,14053,92,294237
17341,7.8e-05,172.31.47.0-255,66,14119,92,294237
17342,0.000106,172.217.194.0-255,2902,17021,92,294237
17343,0.000109,172.31.47.0-255,66,17087,92,294237
17344,0.000144,172.217.194.0-255,7156,24243,92,294237
17345,0.000147,172.31.47.0-255,66,24309,92,294237
17346,0.00015,172.217.194.0-255,1484,25793,92,294237
17347,0.000152,172.31.47.0-255,66,25859,92,294237
17348,0.000179,172.217.194.0-255,2902,28761,92,294237
17349,0.000187,172.31.47.0-255,66,28827,92,294237
17350,0.000215,172.217.194.0-255,2543,31370,92,294237
17351,0.000217,172.31.47.0-255,66,31436,92,294237
17352,0.000245,172.217.194.0-255,5738,37174,92,294237
17353,0.000248,172.31.47.0-255,66,37240,92,294237
17354,0.000251,172.217.194.0-255,1484,38724,92,294237
17355,0.000254,172.31.47.0-255,66,38790,92,294237
17356,0.000265,172.31.47.0-255,66,38856,92,294237
17357,0.000299,172.217.194.0-255,5738,44594,92,294237
17358,0.000306,172.31.47.0-255,66,44660,92,294237
17359,0.000346,172.31.47.0-255,66,44726,92,294237
17360,0.00035,172.217.194.0-255,677,45403,92,294237
17361,0.000352,172.31.47.0-255,66,45469,92,294237
17362,0.000612,172.217.194.0-255,1484,46953,92,294237
17363,0.000619,172.217.194.0-255,2902,49855,92,294237
17364,0.000622,172.31.47.0-255,66,49921,92,294237
17365,0.000644,172.217.194.0-255,5738,55659,92,294237
17366,0.000647,172.31.47.0-255,66,55725,92,294237
17367,0.000652,172.217.194.0-255,2902,58627,92,294237
17368,0.000654,172.31.47.0-255,66,58693,92,294237
17369,0.000678,172.217.194.0-255,2902,61595,92,294237
17370,0.000686,172.31.47.0-255,66,61661,92,294237
17371,0.000691,172.217.194.0-255,2902,64563,92,294237
17372,0.000692,172.31.47.0-255,66,64629,92,294237
17373,0.000739,172.31.47.0-255,66,64695,92,294237
17374,0.000743,172.217.194.0-255,766,65461,92,294237
17375,0.000809,172.217.194.0-255,1484,66945,92,294237
17376,0.000812,172.31.47.0-255,66,67011,92,294237
17377,0.000838,172.217.194.0-255,2902,69913,92,294237
17378,0.000841,172.31.47.0-255,66,69979,92,294237
17379,0.000848,172.217.194.0-255,5738,75717,92,294237
17380,0.00085,172.31.47.0-255,66,75783,92,294237
17381,0.000853,172.217.194.0-255,1484,77267,92,294237
17382,0.000905,172.31.47.0-255,66,77333,92,294237
17383,0.000915,172.31.47.0-255,66,77399,92,294237
17384,0.000919,172.217.194.0-255,2184,79583,92,294237
17385,0.000924,172.31.47.0-255,66,79649,92,294237
17386,0.001487,172.217.194.0-255,1484,81133,92,294237
17387,0.001498,172.217.194.0-255,2902,84035,92,294237
17388,0.001501,172.31.47.0-255,66,84101,92,294237
17389,0.001506,172.217.194.0-255,2902,87003,92,294237
17390,0.001508,172.31.47.0-255,66,87069,92,294237
17391,0.001533,172.217.194.0-255,2902,89971,92,294237
17392,0.001544,172.31.47.0-255,66,90037,92,294237
17393,0.001556,172.31.47.0-255,66,90103,92,294237
17394,0.001579,172.217.194.0-255,2902,93005,92,294237
17395,0.001582,172.31.47.0-255,66,93071,92,294237
17396,0.001618,172.31.47.0-255,66,93137,92,294237
17397,0.001717,172.217.194.0-255,1484,94621,92,294237
17398,0.001723,172.217.194.0-255,2902,97523,92,294237
17399,0.001726,172.31.47.0-255,66,97589,92,294237
17400,0.001729,172.217.194.0-255,1484,99073,92,294237
17401,0.00175,172.217.194.0-255,4320,103393,92,294237
17402,0.001752,172.31.47.0-255,66,103459,92,294237
17403,0.001759,172.217.194.0-255,5738,109197,92,294237
17404,0.001761,172.31.47.0-255,66,109263,92,294237
17405,0.001785,172.217.194.0-255,7156,116419,92,294237
17406,0.001789,172.31.47.0-255,66,116485,92,294237
17407,0.001818,172.31.47.0-255,66,116551,92,294237
17408,0.001823,172.217.194.0-255,2902,119453,92,294237
17409,0.001825,172.31.47.0-255,66,119519,92,294237
17410,0.00187,172.31.47.0-255,66,119585,92,294237
17411,0.001883,172.31.47.0-255,66,119651,92,294237
17412,0.001902,172.217.194.0-255,1484,121135,92,294237
17413,0.001916,172.31.47.0-255,66,121201,92,294237
17414,0.001991,172.217.194.0-255,1484,122685,92,294237
17415,0.001997,172.217.194.0-255,2902,125587,92,294237
17416,0.002,172.31.47.0-255,66,125653,92,294237
17417,0.002003,172.217.194.0-255,1484,127137,92,294237
17418,0.002024,172.217.194.0-255,4320,131457,92,294237
17419,0.002028,172.31.47.0-255,66,131523,92,294237
17420,0.002034,172.217.194.0-255,4320,135843,92,294237
17421,0.002036,172.31.47.0-255,66,135909,92,294237
17422,0.00207,172.31.47.0-255,66,135975,92,294237
17423,0.002073,172.217.194.0-255,1484,137459,92,294237
17424,0.002094,172.217.194.0-255,766,138225,92,294237
17425,0.006441,172.31.47.0-255,66,138291,92,294237
17426,0.008502,172.217.194.0-255,5738,144029,92,294237
17427,0.008509,172.31.47.0-255,66,144095,92,294237
17428,0.010545,172.217.194.0-255,5738,149833,92,294237
17429,0.010553,172.31.47.0-255,66,149899,92,294237
17430,0.01264,172.217.194.0-255,5738,155637,92,294237
17431,0.012648,172.31.47.0-255,66,155703,92,294237
17432,0.01472,172.217.194.0-255,5738,161441,92,294237
17433,0.014735,172.31.47.0-255,66,161507,92,294237
17434,0.016796,172.217.194.0-255,5738,167245,92,294237
17435,0.016804,172.31.47.0-255,66,167311,92,294237
17436,0.018846,172.217.194.0-255,5738,173049,92,294237
17437,0.018853,172.31.47.0-255,66,173115,92,294237
17438,0.020911,172.217.194.0-255,4320,177435,92,294237
17439,0.020919,172.31.47.0-255,66,177501,92,294237
17440,0.020959,172.217.194.0-255,1484,178985,92,294237
17441,0.022961,172.217.194.0-255,4320,183305,92,294237
17442,0.022967,172.31.47.0-255,66,183371,92,294237
17443,0.025004,172.217.194.0-255,5738,189109,92,294237
17444,0.025009,172.31.47.0-255,66,189175,92,294237
17445,0.02705,172.217.194.0-255,4320,193495,92,294237
17446,0.027056,172.31.47.0-255,66,193561,92,294237
17447,0.027089,172.217.194.0-255,1484,195045,92,294237
17448,0.029119,172.217.194.0-255,4320,199365,92,294237
17449,0.029126,172.31.47.0-255,66,199431,92,294237
17450,0.031186,172.217.194.0-255,5738,205169,92,294237
17451,0.031194,172.31.47.0-255,66,205235,92,294237
17452,0.033211,172.217.194.0-255,5738,210973,92,294237
17453,0.033218,172.31.47.0-255,66,211039,92,294237
17454,0.034983,172.31.47.0-255,172,211211,92,294237
17455,0.035014,172.31.47.0-255,1107,212318,92,294237
17456,0.035047,172.31.47.0-255,1514,213832,92,294237
17457,0.035049,172.31.47.0-255,1514,215346,92,294237
17458,0.03505,172.31.47.0-255,1514,216860,92,294237
17459,0.035051,172.31.47.0-255,1514,218374,92,294237
17460,0.035052,172.31.47.0-255,1499,219873,92,294237
17461,0.035265,172.217.194.0-255,5738,225611,92,294237
17462,0.035271,172.31.47.0-255,66,225677,92,294237
17463,0.036558,104.244.42.0-255,66,225743,92,294237
17464,0.036595,104.244.42.0-255,66,225809,92,294237
17465,0.036645,104.244.42.0-255,66,225875,92,294237
17466,0.037329,172.217.194.0-255,5738,231613,92,294237
17467,0.037333,172.31.47.0-255,66,231679,92,294237
17468,0.039354,172.217.194.0-255,5738,237417,92,294237
17469,0.03936,172.31.47.0-255,66,237483,92,294237
17470,0.041421,172.217.194.0-255,5738,243221,92,294237
17471,0.041427,172.31.47.0-255,66,243287,92,294237
17472,0.043453,172.217.194.0-255,5738,249025,92,294237
17473,0.043458,172.31.47.0-255,66,249091,92,294237
17474,0.045498,172.217.194.0-255,4320,253411,92,294237
17475,0.045504,172.31.47.0-255,66,253477,92,294237
17476,0.04554,172.217.194.0-255,1484,254961,92,294237
17477,0.047544,172.217.194.0-255,4320,259281,92,294237
17478,0.04755,172.31.47.0-255,66,259347,92,294237
17479,0.049599,172.217.194.0-255,5738,265085,92,294237
17480,0.049604,172.31.47.0-255,66,265151,92,294237
17481,0.051631,172.217.194.0-255,5738,270889,92,294237
17482,0.051637,172.31.47.0-255,66,270955,92,294237
17483,0.05369,172.217.194.0-255,5738,276693,92,294237
17484,0.053695,172.31.47.0-255,66,276759,92,294237
17485,0.055761,172.217.194.0-255,5738,282497,92,294237
17486,0.055768,172.31.47.0-255,66,282563,92,294237
17487,0.05783,172.217.194.0-255,5738,288301,92,294237
17488,0.057837,172.31.47.0-255,66,288367,92,294237
17489,0.059885,172.217.194.0-255,4320,292687,92,294237
17490,0.059889,172.31.47.0-255,66,292753,92,294237
17491,0.059919,172.217.194.0-255,1484,294237,92,294237
17492,0.0,74.125.24.0-255,153,153,92,216678
17493,2.3e-05,172.31.47.0-255,66,219,92,216678
17494,3e-05,74.125.24.0-255,1484,1703,92,216678
17495,3.5e-05,172.31.47.0-255,66,1769,92,216678
17496,4.1e-05,74.125.24.0-255,2902,4671,92,216678
17497,4.3e-05,172.31.47.0-255,66,4737,92,216678
17498,4.7e-05,74.125.24.0-255,1484,6221,92,216678
17499,4.9e-05,172.31.47.0-255,66,6287,92,216678
17500,7.6e-05,74.125.24.0-255,5738,12025,92,216678
17501,7.9e-05,172.31.47.0-255,66,12091,92,216678
17502,8.3e-05,74.125.24.0-255,2156,14247,92,216678
17503,8.5e-05,172.31.47.0-255,66,14313,92,216678
17504,0.0001,74.125.24.0-255,1484,15797,92,216678
17505,0.000102,172.31.47.0-255,66,15863,92,216678
17506,0.000128,172.31.47.0-255,66,15929,92,216678
17507,0.000133,74.125.24.0-255,2902,18831,92,216678
17508,0.000135,172.31.47.0-255,66,18897,92,216678
17509,0.000158,74.125.24.0-255,2543,21440,92,216678
17510,0.00016,172.31.47.0-255,66,21506,92,216678
17511,0.000172,74.125.24.0-255,1484,22990,92,216678
17512,0.000175,172.31.47.0-255,66,23056,92,216678
17513,0.000204,74.125.24.0-255,2902,25958,92,216678
17514,0.000206,172.31.47.0-255,66,26024,92,216678
17515,0.000212,74.125.24.0-255,5738,31762,92,216678
17516,0.000214,172.31.47.0-255,66,31828,92,216678
17517,0.00022,74.125.24.0-255,4320,36148,92,216678
17518,0.000222,172.31.47.0-255,66,36214,92,216678
17519,0.000248,172.31.47.0-255,66,36280,92,216678
17520,0.000285,172.31.47.0-255,66,36346,92,216678
17521,0.0003,74.125.24.0-255,1435,37781,92,216678
17522,0.000303,172.31.47.0-255,66,37847,92,216678
17523,0.000334,74.125.24.0-255,111,37958,92,216678
17524,0.000337,172.31.47.0-255,66,38024,92,216678
17525,0.000485,74.125.24.0-255,1484,39508,92,216678
17526,0.00049,172.31.47.0-255,66,39574,92,216678
17527,0.000496,74.125.24.0-255,2902,42476,92,216678
17528,0.000499,172.31.47.0-255,66,42542,92,216678
17529,0.000503,74.125.24.0-255,1484,44026,92,216678
17530,0.000506,172.31.47.0-255,66,44092,92,216678
17531,0.000525,74.125.24.0-255,4320,48412,92,216678
17532,0.000543,172.31.47.0-255,66,48478,92,216678
17533,0.000556,172.31.47.0-255,66,48544,92,216678
17534,0.000579,74.125.24.0-255,4320,52864,92,216678
17535,0.000582,172.31.47.0-255,66,52930,92,216678
17536,0.000595,74.125.24.0-255,2902,55832,92,216678
17537,0.000598,172.31.47.0-255,66,55898,92,216678
17538,0.00062,74.125.24.0-255,2809,58707,92,216678
17539,0.000623,172.31.47.0-255,66,58773,92,216678
17540,0.00074,74.125.24.0-255,1484,60257,92,216678
17541,0.000745,74.125.24.0-255,1484,61741,92,216678
17542,0.000747,172.31.47.0-255,66,61807,92,216678
17543,0.000767,74.125.24.0-255,1484,63291,92,216678
17544,0.000773,74.125.24.0-255,5738,69029,92,216678
17545,0.000785,74.125.24.0-255,1484,70513,92,216678
17546,0.000788,172.31.47.0-255,66,70579,92,216678
17547,0.000823,172.31.47.0-255,66,70645,92,216678
17548,0.000861,74.125.24.0-255,4320,74965,92,216678
17549,0.000871,172.31.47.0-255,66,75031,92,216678
17550,0.000882,74.125.24.0-255,5888,80919,92,216678
17551,0.000897,172.31.47.0-255,66,80985,92,216678
17552,0.00093,74.125.24.0-255,2902,83887,92,216678
17553,0.000936,172.31.47.0-255,66,83953,92,216678
17554,0.000996,74.125.24.0-255,5738,89691,92,216678
17555,0.001013,172.31.47.0-255,66,89757,92,216678
17556,0.001018,74.125.24.0-255,2184,91941,92,216678
17557,0.001026,172.31.47.0-255,66,92007,92,216678
17558,0.001144,74.125.24.0-255,1484,93491,92,216678
17559,0.001156,74.125.24.0-255,2902,96393,92,216678
17560,0.001161,74.125.24.0-255,5738,102131,92,216678
17561,0.001178,74.125.24.0-255,5738,107869,92,216678
17562,0.001191,74.125.24.0-255,7156,115025,92,216678
17563,0.001197,172.31.47.0-255,66,115091,92,216678
17564,0.001222,74.125.24.0-255,4320,119411,92,216678
17565,0.00123,172.31.47.0-255,66,119477,92,216678
17566,0.001249,74.125.24.0-255,6438,125915,92,216678
17567,0.001254,172.31.47.0-255,66,125981,92,216678
17568,0.001486,74.125.24.0-255,1484,127465,92,216678
17569,0.001491,74.125.24.0-255,2902,130367,92,216678
17570,0.001494,172.31.47.0-255,66,130433,92,216678
17571,0.001516,74.125.24.0-255,5738,136171,92,216678
17572,0.001526,74.125.24.0-255,1484,137655,92,216678
17573,0.001541,74.125.24.0-255,5738,143393,92,216678
17574,0.001547,172.31.47.0-255,66,143459,92,216678
17575,0.001565,74.125.24.0-255,4320,147779,92,216678
17576,0.001569,172.31.47.0-255,66,147845,92,216678
17577,0.001575,74.125.24.0-255,1484,149329,92,216678
17578,0.001608,172.31.47.0-255,66,149395,92,216678
17579,0.001659,74.125.24.0-255,1484,150879,92,216678
17580,0.001664,74.125.24.0-255,2902,153781,92,216678
17581,0.001669,74.125.24.0-255,5738,159519,92,216678
17582,0.001679,172.31.47.0-255,66,159585,92,216678
17583,0.001696,74.125.24.0-255,2902,162487,92,216678
17584,0.001706,74.125.24.0-255,5738,168225,92,216678
17585,0.00172,74.125.24.0-255,4320,172545,92,216678
17586,0.001724,172.31.47.0-255,66,172611,92,216678
17587,0.001777,172.31.47.0-255,66,172677,92,216678
17588,0.001796,74.125.24.0-255,4320,176997,92,216678
17589,0.001807,172.31.47.0-255,66,177063,92,216678
17590,0.001817,74.125.24.0-255,7156,184219,92,216678
17591,0.001824,172.31.47.0-255,66,184285,92,216678
17592,0.00184,74.125.24.0-255,1484,185769,92,216678
17593,0.00188,172.31.47.0-255,66,185835,92,216678
17594,0.001909,74.125.24.0-255,4320,190155,92,216678
17595,0.001916,172.31.47.0-255,66,190221,92,216678
17596,0.001949,172.31.47.0-255,66,190287,92,216678
17597,0.001968,74.125.24.0-255,4320,194607,92,216678
17598,0.001974,172.31.47.0-255,66,194673,92,216678
17599,0.002018,74.125.24.0-255,3602,198275,92,216678
17600,0.002022,172.31.47.0-255,66,198341,92,216678
17601,0.002127,74.125.24.0-255,4320,202661,92,216678
17602,0.002165,172.31.47.0-255,66,202727,92,216678
17603,0.002224,74.125.24.0-255,2902,205629,92,216678
17604,0.002236,74.125.24.0-255,2184,207813,92,216678
17605,0.002239,172.31.47.0-255,66,207879,92,216678
17606,0.002248,74.125.24.0-255,2902,210781,92,216678
17607,0.002251,172.31.47.0-255,66,210847,92,216678
17608,0.002263,172.31.47.0-255,66,210913,92,216678
17609,0.00229,172.31.47.0-255,66,210979,92,216678
17610,0.002338,172.31.47.0-255,66,211045,92,216678
17611,0.002406,74.125.24.0-255,2902,213947,92,216678
17612,0.002417,172.31.47.0-255,66,214013,92,216678
17613,0.002449,172.31.47.0-255,66,214079,92,216678
17614,0.002456,74.125.24.0-255,136,214215,92,216678
17615,0.019061,172.31.47.0-255,66,214281,92,216678
17616,0.019111,172.31.47.0-255,105,214386,92,216678
17617,0.021391,74.125.24.0-255,66,214452,92,216678
17618,0.049719,172.31.47.0-255,172,214624,92,216678
17619,0.049753,172.31.47.0-255,1103,215727,92,216678
17620,0.049807,172.31.47.0-255,579,216306,92,216678
17621,0.051286,104.244.42.0-255,66,216372,92,216678
17622,0.051319,104.244.42.0-255,66,216438,92,216678
17623,0.05136,104.244.42.0-255,66,216504,92,216678
17624,0.052148,104.244.42.0-255,108,216612,92,216678
17625,0.052158,172.31.47.0-255,66,216678,92,216678
17626,0.0,172.31.47.0-255,105,105,92,276
17627,0.001502,157.240.13.0-255,105,210,92,276
17628,0.001513,172.31.47.0-255,66,276,92,276
17629,0.0,74.125.24.0-255,146,146,92,252479
17630,2.5e-05,172.31.47.0-255,66,212,92,252479
17631,3.1e-05,74.125.24.0-255,1484,1696,92,252479
17632,3.4e-05,172.31.47.0-255,66,1762,92,252479
17633,3.9e-05,74.125.24.0-255,2902,4664,92,252479
17634,4.7e-05,172.31.47.0-255,66,4730,92,252479
17635,5.2e-05,74.125.24.0-255,5738,10468,92,252479
17636,5.4e-05,172.31.47.0-255,66,10534,92,252479
17637,8.3e-05,74.125.24.0-255,3590,14124,92,252479
17638,8.5e-05,172.31.47.0-255,66,14190,92,252479
17639,0.00023,74.125.24.0-255,1484,15674,92,252479
17640,0.000235,172.31.47.0-255,66,15740,92,252479
17641,0.000239,74.125.24.0-255,2902,18642,92,252479
17642,0.000243,172.31.47.0-255,66,18708,92,252479
17643,0.000245,74.125.24.0-255,1484,20192,92,252479
17644,0.000252,172.31.47.0-255,66,20258,92,252479
17645,0.000277,74.125.24.0-255,4320,24578,92,252479
17646,0.000283,172.31.47.0-255,66,24644,92,252479
17647,0.000286,74.125.24.0-255,1484,26128,92,252479
17648,0.000288,172.31.47.0-255,66,26194,92,252479
17649,0.00032,74.125.24.0-255,5379,31573,92,252479
17650,0.000323,172.31.47.0-255,66,31639,92,252479
17651,0.000354,74.125.24.0-255,1484,33123,92,252479
17652,0.000357,172.31.47.0-255,66,33189,92,252479
17653,0.000361,74.125.24.0-255,2902,36091,92,252479
17654,0.000363,172.31.47.0-255,66,36157,92,252479
17655,0.000382,74.125.24.0-255,2902,39059,92,252479
17656,0.00039,172.31.47.0-255,66,39125,92,252479
17657,0.000416,74.125.24.0-255,2902,42027,92,252479
17658,0.000418,172.31.47.0-255,66,42093,92,252479
17659,0.000425,74.125.24.0-255,6797,48890,92,252479
17660,0.000426,172.31.47.0-255,66,48956,92,252479
17661,0.001177,74.125.24.0-255,1484,50440,92,252479
17662,0.001183,172.31.47.0-255,66,50506,92,252479
17663,0.001193,74.125.24.0-255,2902,53408,92,252479
17664,0.001205,74.125.24.0-255,5738,59146,92,252479
17665,0.001228,74.125.24.0-255,1484,60630,92,252479
17666,0.001241,74.125.24.0-255,4320,64950,92,252479
17667,0.001254,74.125.24.0-255,5379,70329,92,252479
17668,0.001296,74.125.24.0-255,1484,71813,92,252479
17669,0.001314,74.125.24.0-255,2902,74715,92,252479
17670,0.00134,74.125.24.0-255,2902,77617,92,252479
17671,0.001357,74.125.24.0-255,2902,80519,92,252479
17672,0.001363,74.125.24.0-255,5738,86257,92,252479
17673,0.001379,74.125.24.0-255,1705,87962,92,252479
17674,0.001822,172.31.47.0-255,66,88028,92,252479
17675,0.002074,74.125.24.0-255,1484,89512,92,252479
17676,0.002079,74.125.24.0-255,1484,90996,92,252479
17677,0.002081,172.31.47.0-255,66,91062,92,252479
17678,0.002118,74.125.24.0-255,1484,92546,92,252479
17679,0.002124,74.125.24.0-255,5738,98284,92,252479
17680,0.002131,172.31.47.0-255,66,98350,92,252479
17681,0.002141,172.31.47.0-255,66,98416,92,252479
17682,0.002172,74.125.24.0-255,5738,104154,92,252479
17683,0.002182,172.31.47.0-255,66,104220,92,252479
17684,0.002199,172.31.47.0-255,66,104286,92,252479
17685,0.004399,74.125.24.0-255,4320,108606,92,252479
17686,0.004403,172.31.47.0-255,66,108672,92,252479
17687,0.004429,74.125.24.0-255,1484,110156,92,252479
17688,0.006615,74.125.24.0-255,4320,114476,92,252479
17689,0.006621,172.31.47.0-255,66,114542,92,252479
17690,0.009015,74.125.24.0-255,5738,120280,92,252479
17691,0.010233,172.31.47.0-255,66,120346,92,252479
17692,0.012433,74.125.24.0-255,5738,126084,92,252479
17693,0.01244,172.31.47.0-255,66,126150,92,252479
17694,0.014677,74.125.24.0-255,5738,131888,92,252479
17695,0.014683,172.31.47.0-255,66,131954,92,252479
17696,0.016897,74.125.24.0-255,5738,137692,92,252479
17697,0.016903,172.31.47.0-255,66,137758,92,252479
17698,0.019107,74.125.24.0-255,5738,143496,92,252479
17699,0.019113,172.31.47.0-255,66,143562,92,252479
17700,0.020068,172.31.47.0-255,167,143729,92,252479
17701,0.020097,172.31.47.0-255,1111,144840,92,252479
17702,0.020127,172.31.47.0-255,1514,146354,92,252479
17703,0.020129,172.31.47.0-255,1514,147868,92,252479
17704,0.02013,172.31.47.0-255,1514,149382,92,252479
17705,0.020131,172.31.47.0-255,1514,150896,92,252479
17706,0.020132,172.31.47.0-255,531,151427,92,252479
17707,0.021318,74.125.24.0-255,5738,157165,92,252479
17708,0.021323,172.31.47.0-255,66,157231,92,252479
17709,0.021617,104.244.42.0-255,66,157297,92,252479
17710,0.021624,104.244.42.0-255,66,157363,92,252479
17711,0.021726,104.244.42.0-255,66,157429,92,252479
17712,0.021728,104.244.42.0-255,66,157495,92,252479
17713,0.02309,104.244.42.0-255,108,157603,92,252479
17714,0.023095,172.31.47.0-255,66,157669,92,252479
17715,0.023504,74.125.24.0-255,1484,159153,92,252479
17716,0.023507,172.31.47.0-255,66,159219,92,252479
17717,0.023537,74.125.24.0-255,4320,163539,92,252479
17718,0.023544,172.31.47.0-255,66,163605,92,252479
17719,0.025708,74.125.24.0-255,1484,165089,92,252479
17720,0.02575,74.125.24.0-255,4320,169409,92,252479
17721,0.025757,172.31.47.0-255,66,169475,92,252479
17722,0.027963,74.125.24.0-255,5738,175213,92,252479
17723,0.027968,172.31.47.0-255,66,175279,92,252479
17724,0.03016,74.125.24.0-255,5738,181017,92,252479
17725,0.030164,172.31.47.0-255,66,181083,92,252479
17726,0.032383,74.125.24.0-255,5738,186821,92,252479
17727,0.032388,172.31.47.0-255,66,186887,92,252479
17728,0.034586,74.125.24.0-255,4320,191207,92,252479
17729,0.034591,172.31.47.0-255,66,191273,92,252479
17730,0.034617,74.125.24.0-255,1484,192757,92,252479
17731,0.036806,74.125.24.0-255,4320,197077,92,252479
17732,0.036811,172.31.47.0-255,66,197143,92,252479
17733,0.039039,74.125.24.0-255,5738,202881,92,252479
17734,0.03909,172.31.47.0-255,66,202947,92,252479
17735,0.041294,74.125.24.0-255,5738,208685,92,252479
17736,0.041298,172.31.47.0-255,66,208751,92,252479
17737,0.043507,74.125.24.0-255,5738,214489,92,252479
17738,0.043511,172.31.47.0-255,66,214555,92,252479
17739,0.04574,74.125.24.0-255,5738,220293,92,252479
17740,0.045745,172.31.47.0-255,66,220359,92,252479
17741,0.048004,74.125.24.0-255,4320,224679,92,252479
17742,0.048009,172.31.47.0-255,66,224745,92,252479
17743,0.048032,74.125.24.0-255,1484,226229,92,252479
17744,0.050195,74.125.24.0-255,4320,230549,92,252479
17745,0.0502,172.31.47.0-255,66,230615,92,252479
17746,0.052445,74.125.24.0-255,4320,234935,92,252479
17747,0.05245,172.31.47.0-255,66,235001,92,252479
17748,0.05248,74.125.24.0-255,1484,236485,92,252479
17749,0.054661,74.125.24.0-255,4320,240805,92,252479
17750,0.054666,172.31.47.0-255,66,240871,92,252479
17751,0.056904,74.125.24.0-255,5738,246609,92,252479
17752,0.056958,172.31.47.0-255,66,246675,92,252479
17753,0.05926,74.125.24.0-255,5738,252413,92,252479
17754,0.059264,172.31.47.0-255,66,252479,92,252479
17755,0.0,172.31.47.0-255,105,105,92,276
17756,0.001757,157.240.13.0-255,105,210,92,276
17757,0.001768,172.31.47.0-255,66,276,92,276
17758,0.0,172.31.47.0-255,66,66,92,66
17759,0.0,74.125.200.0-255,153,153,92,350331
17760,2.7e-05,172.31.47.0-255,66,219,92,350331
17761,6.9e-05,74.125.200.0-255,1484,1703,92,350331
17762,7.4e-05,172.31.47.0-255,66,1769,92,350331
17763,7.9e-05,74.125.200.0-255,2902,4671,92,350331
17764,8.2e-05,172.31.47.0-255,66,4737,92,350331
17765,0.000129,74.125.200.0-255,5738,10475,92,350331
17766,0.000133,172.31.47.0-255,66,10541,92,350331
17767,0.000137,74.125.200.0-255,1484,12025,92,350331
17768,0.000139,172.31.47.0-255,66,12091,92,350331
17769,0.000143,74.125.200.0-255,2109,14200,92,350331
17770,0.000146,172.31.47.0-255,66,14266,92,350331
17771,0.000279,74.125.200.0-255,1484,15750,92,350331
17772,0.000284,172.31.47.0-255,66,15816,92,350331
17773,0.000315,74.125.200.0-255,2902,18718,92,350331
17774,0.000319,172.31.47.0-255,66,18784,92,350331
17775,0.000324,74.125.200.0-255,4320,23104,92,350331
17776,0.000327,172.31.47.0-255,66,23170,92,350331
17777,0.000335,74.125.200.0-255,1484,24654,92,350331
17778,0.000337,172.31.47.0-255,66,24720,92,350331
17779,0.000363,74.125.200.0-255,4320,29040,92,350331
17780,0.000371,172.31.47.0-255,66,29106,92,350331
17781,0.00038,74.125.200.0-255,7156,36262,92,350331
17782,0.000382,172.31.47.0-255,66,36328,92,350331
17783,0.000421,74.125.200.0-255,3961,40289,92,350331
17784,0.000424,172.31.47.0-255,66,40355,92,350331
17785,0.000437,172.31.47.0-255,66,40421,92,350331
17786,0.000454,172.31.47.0-255,66,40487,92,350331
17787,0.000485,74.125.200.0-255,3935,44422,92,350331
17788,0.000488,172.31.47.0-255,66,44488,92,350331
17789,0.000492,74.125.200.0-255,109,44597,92,350331
17790,0.000494,172.31.47.0-255,66,44663,92,350331
17791,0.000553,74.125.200.0-255,1484,46147,92,350331
17792,0.000556,172.31.47.0-255,66,46213,92,350331
17793,0.000577,74.125.200.0-255,2902,49115,92,350331
17794,0.00058,172.31.47.0-255,66,49181,92,350331
17795,0.000586,74.125.200.0-255,4320,53501,92,350331
17796,0.000588,172.31.47.0-255,66,53567,92,350331
17797,0.00063,172.31.47.0-255,66,53633,92,350331
17798,0.000637,74.125.200.0-255,7156,60789,92,350331
17799,0.000639,172.31.47.0-255,66,60855,92,350331
17800,0.000656,172.31.47.0-255,66,60921,92,350331
17801,0.000659,74.125.200.0-255,1033,61954,92,350331
17802,0.000661,172.31.47.0-255,66,62020,92,350331
17803,0.000738,74.125.200.0-255,1484,63504,92,350331
17804,0.000741,172.31.47.0-255,66,63570,92,350331
17805,0.000746,74.125.200.0-255,2902,66472,92,350331
17806,0.000748,172.31.47.0-255,66,66538,92,350331
17807,0.000784,74.125.200.0-255,5738,72276,92,350331
17808,0.000788,74.125.200.0-255,2902,75178,92,350331
17809,0.000789,172.31.47.0-255,66,75244,92,350331
17810,0.000792,74.125.200.0-255,4320,79564,92,350331
17811,0.000792,172.31.47.0-255,66,79630,92,350331
17812,0.000795,172.31.47.0-255,66,79696,92,350331
17813,0.000864,172.31.47.0-255,66,79762,92,350331
17814,0.000874,172.31.47.0-255,66,79828,92,350331
17815,0.000909,74.125.200.0-255,1484,81312,92,350331
17816,0.000913,172.31.47.0-255,66,81378,92,350331
17817,0.000917,74.125.200.0-255,2902,84280,92,350331
17818,0.00092,172.31.47.0-255,66,84346,92,350331
17819,0.000925,74.125.200.0-255,5738,90084,92,350331
17820,0.000927,172.31.47.0-255,66,90150,92,350331
17821,0.000937,74.125.200.0-255,2902,93052,92,350331
17822,0.000939,172.31.47.0-255,66,93118,92,350331
17823,0.000945,74.125.200.0-255,4320,97438,92,350331
17824,0.000947,172.31.47.0-255,66,97504,92,350331
17825,0.000958,74.125.200.0-255,1484,98988,92,350331
17826,0.000961,172.31.47.0-255,66,99054,92,350331
17827,0.000991,74.125.200.0-255,7156,106210,92,350331
17828,0.000994,172.31.47.0-255,66,106276,92,350331
17829,0.001011,172.31.47.0-255,66,106342,92,350331
17830,0.001271,74.125.200.0-255,1484,107826,92,350331
17831,0.001276,172.31.47.0-255,66,107892,92,350331
17832,0.001302,74.125.200.0-255,2902,110794,92,350331
17833,0.001305,172.31.47.0-255,66,110860,92,350331
17834,0.00131,74.125.200.0-255,4320,115180,92,350331
17835,0.001312,172.31.47.0-255,66,115246,92,350331
17836,0.001317,74.125.200.0-255,4320,119566,92,350331
17837,0.001319,172.31.47.0-255,66,119632,92,350331
17838,0.00136,74.125.200.0-255,4320,123952,92,350331
17839,0.001364,172.31.47.0-255,66,124018,92,350331
17840,0.00137,74.125.200.0-255,5738,129756,92,350331
17841,0.001373,172.31.47.0-255,66,129822,92,350331
17842,0.001385,74.125.200.0-255,7156,136978,92,350331
17843,0.001389,172.31.47.0-255,66,137044,92,350331
17844,0.001394,74.125.200.0-255,3602,140646,92,350331
17845,0.001396,172.31.47.0-255,66,140712,92,350331
17846,0.001568,74.125.200.0-255,1484,142196,92,350331
17847,0.001575,74.125.200.0-255,2902,145098,92,350331
17848,0.00158,172.31.47.0-255,66,145164,92,350331
17849,0.001586,74.125.200.0-255,4320,149484,92,350331
17850,0.001588,172.31.47.0-255,66,149550,92,350331
17851,0.001603,74.125.200.0-255,1484,151034,92,350331
17852,0.001608,74.125.200.0-255,2902,153936,92,350331
17853,0.001615,172.31.47.0-255,66,154002,92,350331
17854,0.001636,74.125.200.0-255,4320,158322,92,350331
17855,0.001639,172.31.47.0-255,66,158388,92,350331
17856,0.001643,74.125.200.0-255,4320,162708,92,350331
17857,0.001645,172.31.47.0-255,66,162774,92,350331
17858,0.001681,172.31.47.0-255,66,162840,92,350331
17859,0.001698,74.125.200.0-255,2184,165024,92,350331
17860,0.001701,172.31.47.0-255,66,165090,92,350331
17861,0.001744,74.125.200.0-255,1484,166574,92,350331
17862,0.001748,74.125.200.0-255,1484,168058,92,350331
17863,0.001751,172.31.47.0-255,66,168124,92,350331
17864,0.001777,74.125.200.0-255,1484,169608,92,350331
17865,0.001784,74.125.200.0-255,5738,175346,92,350331
17866,0.001787,172.31.47.0-255,66,175412,92,350331
17867,0.001796,74.125.200.0-255,4320,179732,92,350331
17868,0.001806,172.31.47.0-255,66,179798,92,350331
17869,0.001828,74.125.200.0-255,2902,182700,92,350331
17870,0.001831,172.31.47.0-255,66,182766,92,350331
17871,0.001841,172.31.47.0-255,66,182832,92,350331
17872,0.001846,74.125.200.0-255,4320,187152,92,350331
17873,0.001851,172.31.47.0-255,66,187218,92,350331
17874,0.001871,74.125.200.0-255,3602,190820,92,350331
17875,0.001873,172.31.47.0-255,66,190886,92,350331
17876,0.002222,74.125.200.0-255,1484,192370,92,350331
17877,0.002226,74.125.200.0-255,1484,193854,92,350331
17878,0.002229,172.31.47.0-255,66,193920,92,350331
17879,0.002253,74.125.200.0-255,1484,195404,92,350331
17880,0.002257,74.125.200.0-255,2902,198306,92,350331
17881,0.002259,172.31.47.0-255,66,198372,92,350331
17882,0.002264,74.125.200.0-255,4320,202692,92,350331
17883,0.002266,172.31.47.0-255,66,202758,92,350331
17884,0.002291,172.31.47.0-255,66,202824,92,350331
17885,0.002294,74.125.200.0-255,1484,204308,92,350331
17886,0.00232,74.125.200.0-255,4320,208628,92,350331
17887,0.002323,172.31.47.0-255,66,208694,92,350331
17888,0.002349,74.125.200.0-255,7156,215850,92,350331
17889,0.002351,172.31.47.0-255,66,215916,92,350331
17890,0.002354,74.125.200.0-255,766,216682,92,350331
17891,0.002406,74.125.200.0-255,1484,218166,92,350331
17892,0.002408,172.31.47.0-255,66,218232,92,350331
17893,0.002413,74.125.200.0-255,4320,222552,92,350331
17894,0.002416,172.31.47.0-255,66,222618,92,350331
17895,0.002418,74.125.200.0-255,1484,224102,92,350331
17896,0.002427,74.125.200.0-255,2902,227004,92,350331
17897,0.002429,172.31.47.0-255,66,227070,92,350331
17898,0.002454,74.125.200.0-255,4320,231390,92,350331
17899,0.002456,172.31.47.0-255,66,231456,92,350331
17900,0.002461,74.125.200.0-255,5738,237194,92,350331
17901,0.002467,172.31.47.0-255,66,237260,92,350331
17902,0.002496,74.125.200.0-255,7156,244416,92,350331
17903,0.002498,172.31.47.0-255,66,244482,92,350331
17904,0.002507,74.125.200.0-255,4320,248802,92,350331
17905,0.002509,172.31.47.0-255,66,248868,92,350331
17906,0.00255,74.125.200.0-255,2184,251052,92,350331
17907,0.002553,172.31.47.0-255,66,251118,92,350331
17908,0.005057,74.125.200.0-255,2902,254020,92,350331
17909,0.00506,172.31.47.0-255,66,254086,92,350331
17910,0.005086,74.125.200.0-255,1484,255570,92,350331
17911,0.005096,74.125.200.0-255,1484,257054,92,350331
17912,0.005098,172.31.47.0-255,66,257120,92,350331
17913,0.007639,74.125.200.0-255,5738,262858,92,350331
17914,0.007659,172.31.47.0-255,66,262924,92,350331
17915,0.010233,74.125.200.0-255,5738,268662,92,350331
17916,0.010246,172.31.47.0-255,66,268728,92,350331
17917,0.012835,74.125.200.0-255,5738,274466,92,350331
17918,0.012844,172.31.47.0-255,66,274532,92,350331
17919,0.015429,74.125.200.0-255,5738,280270,92,350331
17920,0.015443,172.31.47.0-255,66,280336,92,350331
17921,0.018034,74.125.200.0-255,5738,286074,92,350331
17922,0.018049,172.31.47.0-255,66,286140,92,350331
17923,0.020614,74.125.200.0-255,5738,291878,92,350331
17924,0.020623,172.31.47.0-255,66,291944,92,350331
17925,0.023187,74.125.200.0-255,5738,297682,92,350331
17926,0.023198,172.31.47.0-255,66,297748,92,350331
17927,0.025753,74.125.200.0-255,5738,303486,92,350331
17928,0.025761,172.31.47.0-255,66,303552,92,350331
17929,0.028325,74.125.200.0-255,5738,309290,92,350331
17930,0.028332,172.31.47.0-255,66,309356,92,350331
17931,0.030892,74.125.200.0-255,5738,315094,92,350331
17932,0.030899,172.31.47.0-255,66,315160,92,350331
17933,0.033462,74.125.200.0-255,5738,320898,92,350331
17934,0.033468,172.31.47.0-255,66,320964,92,350331
17935,0.036051,74.125.200.0-255,5738,326702,92,350331
17936,0.036063,172.31.47.0-255,66,326768,92,350331
17937,0.038623,74.125.200.0-255,5738,332506,92,350331
17938,0.03863,172.31.47.0-255,66,332572,92,350331
17939,0.041242,74.125.200.0-255,5738,338310,92,350331
17940,0.041287,172.31.47.0-255,66,338376,92,350331
17941,0.043866,74.125.200.0-255,2445,340821,92,350331
17942,0.043884,172.31.47.0-255,66,340887,92,350331
17943,0.044197,172.31.47.0-255,105,340992,92,350331
17944,0.04672,74.125.200.0-255,66,341058,92,350331
17945,0.053591,172.31.47.0-255,172,341230,92,350331
17946,0.053671,172.31.47.0-255,1103,342333,92,350331
17947,0.053771,172.31.47.0-255,1514,343847,92,350331
17948,0.053796,172.31.47.0-255,1514,345361,92,350331
17949,0.053798,172.31.47.0-255,1514,346875,92,350331
17950,0.053827,172.31.47.0-255,1514,348389,92,350331
17951,0.053831,172.31.47.0-255,1504,349893,92,350331
17952,0.055133,104.244.42.0-255,66,349959,92,350331
17953,0.055205,104.244.42.0-255,66,350025,92,350331
17954,0.055313,104.244.42.0-255,66,350091,92,350331
17955,0.05536,104.244.42.0-255,66,350157,92,350331
17956,0.056491,104.244.42.0-255,108,350265,92,350331
17957,0.056497,172.31.47.0-255,66,350331,92,350331
17958,0.0,172.31.47.0-255,66,66,92,66
17959,0.0,74.125.24.0-255,153,153,92,256073
17960,3e-05,172.31.47.0-255,66,219,92,256073
17961,3.7e-05,74.125.24.0-255,1484,1703,92,256073
17962,4e-05,172.31.47.0-255,66,1769,92,256073
17963,4.5e-05,74.125.24.0-255,2902,4671,92,256073
17964,4.6e-05,172.31.47.0-255,66,4737,92,256073
17965,5.2e-05,74.125.24.0-255,7156,11893,92,256073
17966,5.5e-05,172.31.47.0-255,66,11959,92,256073
17967,5.8e-05,74.125.24.0-255,2102,14061,92,256073
17968,6e-05,172.31.47.0-255,66,14127,92,256073
17969,0.0001,172.31.47.0-255,66,14193,92,256073
17970,0.000119,74.125.24.0-255,1484,15677,92,256073
17971,0.000121,172.31.47.0-255,66,15743,92,256073
17972,0.000139,74.125.24.0-255,3961,19704,92,256073
17973,0.000141,172.31.47.0-255,66,19770,92,256073
17974,0.000182,74.125.24.0-255,1484,21254,92,256073
17975,0.000185,172.31.47.0-255,66,21320,92,256073
17976,0.000188,74.125.24.0-255,1484,22804,92,256073
17977,0.000189,172.31.47.0-255,66,22870,92,256073
17978,0.000205,74.125.24.0-255,1484,24354,92,256073
17979,0.000208,172.31.47.0-255,66,24420,92,256073
17980,0.000214,74.125.24.0-255,5738,30158,92,256073
17981,0.000215,172.31.47.0-255,66,30224,92,256073
17982,0.000219,74.125.24.0-255,4320,34544,92,256073
17983,0.000221,172.31.47.0-255,66,34610,92,256073
17984,0.000267,172.31.47.0-255,66,34676,92,256073
17985,0.000273,74.125.24.0-255,5738,40414,92,256073
17986,0.000275,172.31.47.0-255,66,40480,92,256073
17987,0.000316,74.125.24.0-255,1437,41917,92,256073
17988,0.000319,172.31.47.0-255,66,41983,92,256073
17989,0.000334,74.125.24.0-255,112,42095,92,256073
17990,0.000465,74.125.24.0-255,330,42425,92,256073
17991,0.000783,172.31.47.0-255,66,42491,92,256073
17992,0.000877,74.125.24.0-255,1484,43975,92,256073
17993,0.000888,74.125.24.0-255,2902,46877,92,256073
17994,0.000891,172.31.47.0-255,66,46943,92,256073
17995,0.000895,74.125.24.0-255,1484,48427,92,256073
17996,0.000918,74.125.24.0-255,4320,52747,92,256073
17997,0.000938,172.31.47.0-255,66,52813,92,256073
17998,0.000946,74.125.24.0-255,7156,59969,92,256073
17999,0.000949,172.31.47.0-255,66,60035,92,256073
18000,0.000954,74.125.24.0-255,2902,62937,92,256073
18001,0.000956,172.31.47.0-255,66,63003,92,256073
18002,0.000997,172.31.47.0-255,66,63069,92,256073
18003,0.001002,74.125.24.0-255,2184,65253,92,256073
18004,0.001004,172.31.47.0-255,66,65319,92,256073
18005,0.001611,74.125.24.0-255,1484,66803,92,256073
18006,0.001622,74.125.24.0-255,2902,69705,92,256073
18007,0.001627,172.31.47.0-255,66,69771,92,256073
18008,0.001635,74.125.24.0-255,5738,75509,92,256073
18009,0.001637,172.31.47.0-255,66,75575,92,256073
18010,0.001679,172.31.47.0-255,66,75641,92,256073
18011,0.001686,74.125.24.0-255,7156,82797,92,256073
18012,0.001688,172.31.47.0-255,66,82863,92,256073
18013,0.001718,74.125.24.0-255,3602,86465,92,256073
18014,0.001721,172.31.47.0-255,66,86531,92,256073
18015,0.001966,74.125.24.0-255,1484,88015,92,256073
18016,0.001986,74.125.24.0-255,2902,90917,92,256073
18017,0.001989,172.31.47.0-255,66,90983,92,256073
18018,0.001997,74.125.24.0-255,5738,96721,92,256073
18019,0.001999,172.31.47.0-255,66,96787,92,256073
18020,0.002028,74.125.24.0-255,5738,102525,92,256073
18021,0.002032,172.31.47.0-255,66,102591,92,256073
18022,0.002035,74.125.24.0-255,1484,104075,92,256073
18023,0.002055,74.125.24.0-255,5738,109813,92,256073
18024,0.002059,172.31.47.0-255,66,109879,92,256073
18025,0.00207,74.125.24.0-255,2902,112781,92,256073
18026,0.002072,172.31.47.0-255,66,112847,92,256073
18027,0.002093,172.31.47.0-255,66,112913,92,256073
18028,0.004419,74.125.24.0-255,5738,118651,92,256073
18029,0.004423,172.31.47.0-255,66,118717,92,256073
18030,0.006763,74.125.24.0-255,5738,124455,92,256073
18031,0.00677,172.31.47.0-255,66,124521,92,256073
18032,0.009123,74.125.24.0-255,5738,130259,92,256073
18033,0.009131,172.31.47.0-255,66,130325,92,256073
18034,0.011493,74.125.24.0-255,5738,136063,92,256073
18035,0.011503,172.31.47.0-255,66,136129,92,256073
18036,0.013841,74.125.24.0-255,5738,141867,92,256073
18037,0.013852,172.31.47.0-255,66,141933,92,256073
18038,0.016186,74.125.24.0-255,5738,147671,92,256073
18039,0.016194,172.31.47.0-255,66,147737,92,256073
18040,0.018555,74.125.24.0-255,5738,153475,92,256073
18041,0.018563,172.31.47.0-255,66,153541,92,256073
18042,0.020906,74.125.24.0-255,5738,159279,92,256073
18043,0.020913,172.31.47.0-255,66,159345,92,256073
18044,0.023249,74.125.24.0-255,5738,165083,92,256073
18045,0.023256,172.31.47.0-255,66,165149,92,256073
18046,0.025601,74.125.24.0-255,5738,170887,92,256073
18047,0.025608,172.31.47.0-255,66,170953,92,256073
18048,0.025923,172.31.47.0-255,172,171125,92,256073
18049,0.025957,172.31.47.0-255,1106,172231,92,256073
18050,0.026025,172.31.47.0-255,1514,173745,92,256073
18051,0.026027,172.31.47.0-255,1514,175259,92,256073
18052,0.026028,172.31.47.0-255,1514,176773,92,256073
18053,0.026028,172.31.47.0-255,1514,178287,92,256073
18054,0.026029,172.31.47.0-255,1500,179787,92,256073
18055,0.027451,104.244.42.0-255,66,179853,92,256073
18056,0.027558,104.244.42.0-255,66,179919,92,256073
18057,0.027561,104.244.42.0-255,66,179985,92,256073
18058,0.027969,74.125.24.0-255,4320,184305,92,256073
18059,0.027972,172.31.47.0-255,66,184371,92,256073
18060,0.028003,74.125.24.0-255,1484,185855,92,256073
18061,0.028316,104.244.42.0-255,108,185963,92,256073
18062,0.028321,172.31.47.0-255,66,186029,92,256073
18063,0.030304,74.125.24.0-255,2902,188931,92,256073
18064,0.030308,172.31.47.0-255,66,188997,92,256073
18065,0.032643,74.125.24.0-255,5738,194735,92,256073
18066,0.03265,172.31.47.0-255,66,194801,92,256073
18067,0.035012,74.125.24.0-255,4320,199121,92,256073
18068,0.035018,172.31.47.0-255,66,199187,92,256073
18069,0.035034,74.125.24.0-255,1484,200671,92,256073
18070,0.037375,74.125.24.0-255,4320,204991,92,256073
18071,0.037394,172.31.47.0-255,66,205057,92,256073
18072,0.039734,74.125.24.0-255,5738,210795,92,256073
18073,0.039748,172.31.47.0-255,66,210861,92,256073
18074,0.042112,74.125.24.0-255,5738,216599,92,256073
18075,0.042128,172.31.47.0-255,66,216665,92,256073
18076,0.044467,74.125.24.0-255,5738,222403,92,256073
18077,0.044472,172.31.47.0-255,66,222469,92,256073
18078,0.046821,74.125.24.0-255,5738,228207,92,256073
18079,0.046826,172.31.47.0-255,66,228273,92,256073
18080,0.049172,74.125.24.0-255,4320,232593,92,256073
18081,0.049177,172.31.47.0-255,66,232659,92,256073
18082,0.049204,74.125.24.0-255,1484,234143,92,256073
18083,0.051575,74.125.24.0-255,4320,238463,92,256073
18084,0.05158,172.31.47.0-255,66,238529,92,256073
18085,0.053905,74.125.24.0-255,2902,241431,92,256073
18086,0.053909,172.31.47.0-255,66,241497,92,256073
18087,0.053936,74.125.24.0-255,2902,244399,92,256073
18088,0.053938,172.31.47.0-255,66,244465,92,256073
18089,0.056265,74.125.24.0-255,5738,250203,92,256073
18090,0.05627,172.31.47.0-255,66,250269,92,256073
18091,0.058605,74.125.24.0-255,5738,256007,92,256073
18092,0.05861,172.31.47.0-255,66,256073,92,256073
18093,0.0,74.125.68.0-255,153,153,92,358070
18094,1.6e-05,172.31.47.0-255,66,219,92,358070
18095,2.2e-05,74.125.68.0-255,1484,1703,92,358070
18096,2.6e-05,172.31.47.0-255,66,1769,92,358070
18097,3.1e-05,74.125.68.0-255,2902,4671,92,358070
18098,4.1e-05,172.31.47.0-255,66,4737,92,358070
18099,7.2e-05,74.125.68.0-255,5738,10475,92,358070
18100,7.5e-05,172.31.47.0-255,66,10541,92,358070
18101,7.9e-05,74.125.68.0-255,2902,13443,92,358070
18102,8.1e-05,172.31.47.0-255,66,13509,92,358070
18103,0.000106,74.125.68.0-255,3518,17027,92,358070
18104,0.000108,172.31.47.0-255,66,17093,92,358070
18105,0.000112,74.125.68.0-255,2902,19995,92,358070
18106,0.000114,172.31.47.0-255,66,20061,92,358070
18107,0.000144,74.125.68.0-255,2902,22963,92,358070
18108,0.000146,172.31.47.0-255,66,23029,92,358070
18109,0.000152,74.125.68.0-255,7156,30185,92,358070
18110,0.000154,172.31.47.0-255,66,30251,92,358070
18111,0.000157,74.125.68.0-255,1125,31376,92,358070
18112,0.000159,172.31.47.0-255,66,31442,92,358070
18113,0.000288,74.125.68.0-255,1484,32926,92,358070
18114,0.000292,172.31.47.0-255,66,32992,92,358070
18115,0.000297,74.125.68.0-255,2902,35894,92,358070
18116,0.000299,172.31.47.0-255,66,35960,92,358070
18117,0.000326,74.125.68.0-255,5738,41698,92,358070
18118,0.000328,172.31.47.0-255,66,41764,92,358070
18119,0.000355,74.125.68.0-255,7156,48920,92,358070
18120,0.000357,172.31.47.0-255,66,48986,92,358070
18121,0.000375,74.125.68.0-255,5738,54724,92,358070
18122,0.000377,172.31.47.0-255,66,54790,92,358070
18123,0.00041,74.125.68.0-255,2902,57692,92,358070
18124,0.000412,172.31.47.0-255,66,57758,92,358070
18125,0.000437,74.125.68.0-255,4320,62078,92,358070
18126,0.00044,172.31.47.0-255,66,62144,92,358070
18127,0.000442,74.125.68.0-255,1484,63628,92,358070
18128,0.000444,172.31.47.0-255,66,63694,92,358070
18129,0.000472,74.125.68.0-255,2521,66215,92,358070
18130,0.000496,74.125.68.0-255,110,66325,92,358070
18131,0.000499,172.31.47.0-255,66,66391,92,358070
18132,0.000604,74.125.68.0-255,1484,67875,92,358070
18133,0.000613,172.31.47.0-255,66,67941,92,358070
18134,0.000623,74.125.68.0-255,2902,70843,92,358070
18135,0.000629,74.125.68.0-255,1484,72327,92,358070
18136,0.000645,74.125.68.0-255,2902,75229,92,358070
18137,0.00066,74.125.68.0-255,4320,79549,92,358070
18138,0.000662,172.31.47.0-255,66,79615,92,358070
18139,0.000667,172.31.47.0-255,66,79681,92,358070
18140,0.000676,74.125.68.0-255,1484,81165,92,358070
18141,0.000684,74.125.68.0-255,4320,85485,92,358070
18142,0.000686,74.125.68.0-255,1484,86969,92,358070
18143,0.000711,74.125.68.0-255,4320,91289,92,358070
18144,0.000718,172.31.47.0-255,66,91355,92,358070
18145,0.000743,74.125.68.0-255,5738,97093,92,358070
18146,0.00075,172.31.47.0-255,66,97159,92,358070
18147,0.000759,74.125.68.0-255,3602,100761,92,358070
18148,0.000783,172.31.47.0-255,66,100827,92,358070
18149,0.000873,74.125.68.0-255,1484,102311,92,358070
18150,0.000877,74.125.68.0-255,1484,103795,92,358070
18151,0.00089,74.125.68.0-255,1484,105279,92,358070
18152,0.000905,74.125.68.0-255,5738,111017,92,358070
18153,0.00091,172.31.47.0-255,66,111083,92,358070
18154,0.000934,74.125.68.0-255,7156,118239,92,358070
18155,0.000944,172.31.47.0-255,66,118305,92,358070
18156,0.000951,74.125.68.0-255,1484,119789,92,358070
18157,0.000988,74.125.68.0-255,1484,121273,92,358070
18158,0.001019,74.125.68.0-255,2902,124175,92,358070
18159,0.001022,74.125.68.0-255,766,124941,92,358070
18160,0.00103,172.31.47.0-255,66,125007,92,358070
18161,0.001248,74.125.68.0-255,1484,126491,92,358070
18162,0.001262,74.125.68.0-255,2902,129393,92,358070
18163,0.001268,172.31.47.0-255,66,129459,92,358070
18164,0.001297,74.125.68.0-255,5738,135197,92,358070
18165,0.001307,172.31.47.0-255,66,135263,92,358070
18166,0.001317,74.125.68.0-255,4320,139583,92,358070
18167,0.001321,172.31.47.0-255,66,139649,92,358070
18168,0.001337,74.125.68.0-255,2902,142551,92,358070
18169,0.00136,74.125.68.0-255,1484,144035,92,358070
18170,0.001365,74.125.68.0-255,2902,146937,92,358070
18171,0.001382,74.125.68.0-255,1484,148421,92,358070
18172,0.001397,74.125.68.0-255,2902,151323,92,358070
18173,0.001409,74.125.68.0-255,1484,152807,92,358070
18174,0.001414,172.31.47.0-255,66,152873,92,358070
18175,0.001425,74.125.68.0-255,4320,157193,92,358070
18176,0.001434,74.125.68.0-255,2184,159377,92,358070
18177,0.00149,172.31.47.0-255,66,159443,92,358070
18178,0.001757,74.125.68.0-255,1484,160927,92,358070
18179,0.001772,74.125.68.0-255,2902,163829,92,358070
18180,0.001776,172.31.47.0-255,66,163895,92,358070
18181,0.001779,74.125.68.0-255,1484,165379,92,358070
18182,0.001803,74.125.68.0-255,1484,166863,92,358070
18183,0.001809,74.125.68.0-255,4320,171183,92,358070
18184,0.001822,74.125.68.0-255,2902,174085,92,358070
18185,0.001834,172.31.47.0-255,66,174151,92,358070
18186,0.001841,74.125.68.0-255,5738,179889,92,358070
18187,0.001845,74.125.68.0-255,2902,182791,92,358070
18188,0.001855,172.31.47.0-255,66,182857,92,358070
18189,0.001899,74.125.68.0-255,4320,187177,92,358070
18190,0.001904,172.31.47.0-255,66,187243,92,358070
18191,0.001916,74.125.68.0-255,6438,193681,92,358070
18192,0.00194,172.31.47.0-255,66,193747,92,358070
18193,0.002021,74.125.68.0-255,1484,195231,92,358070
18194,0.002047,74.125.68.0-255,2902,198133,92,358070
18195,0.00205,172.31.47.0-255,66,198199,92,358070
18196,0.002057,74.125.68.0-255,4320,202519,92,358070
18197,0.002066,172.31.47.0-255,66,202585,92,358070
18198,0.002111,74.125.68.0-255,4320,206905,92,358070
18199,0.002135,172.31.47.0-255,66,206971,92,358070
18200,0.002185,172.31.47.0-255,66,207037,92,358070
18201,0.002229,172.31.47.0-255,66,207103,92,358070
18202,0.00225,74.125.68.0-255,5738,212841,92,358070
18203,0.002276,74.125.68.0-255,2902,215743,92,358070
18204,0.002307,74.125.68.0-255,1484,217227,92,358070
18205,0.002336,74.125.68.0-255,2902,220129,92,358070
18206,0.00236,74.125.68.0-255,4320,224449,92,358070
18207,0.002411,74.125.68.0-255,5738,230187,92,358070
18208,0.002432,74.125.68.0-255,5020,235207,92,358070
18209,0.002449,74.125.68.0-255,4320,239527,92,358070
18210,0.002475,74.125.68.0-255,7156,246683,92,358070
18211,0.00248,74.125.68.0-255,4320,251003,92,358070
18212,0.002525,74.125.68.0-255,7156,258159,92,358070
18213,0.002546,74.125.68.0-255,766,258925,92,358070
18214,0.002574,74.125.68.0-255,5738,264663,92,358070
18215,0.002588,74.125.68.0-255,4320,268983,92,358070
18216,0.004923,172.31.47.0-255,66,269049,92,358070
18217,0.007501,74.125.68.0-255,5738,274787,92,358070
18218,0.007507,172.31.47.0-255,66,274853,92,358070
18219,0.010059,74.125.68.0-255,5738,280591,92,358070
18220,0.010066,172.31.47.0-255,66,280657,92,358070
18221,0.012642,74.125.68.0-255,5738,286395,92,358070
18222,0.012661,172.31.47.0-255,66,286461,92,358070
18223,0.01523,74.125.68.0-255,5738,292199,92,358070
18224,0.01524,172.31.47.0-255,66,292265,92,358070
18225,0.017789,74.125.68.0-255,5738,298003,92,358070
18226,0.022752,172.31.47.0-255,66,298069,92,358070
18227,0.025328,74.125.68.0-255,5738,303807,92,358070
18228,0.025344,172.31.47.0-255,66,303873,92,358070
18229,0.027903,74.125.68.0-255,5738,309611,92,358070
18230,0.027916,172.31.47.0-255,66,309677,92,358070
18231,0.030474,74.125.68.0-255,5738,315415,92,358070
18232,0.030482,172.31.47.0-255,66,315481,92,358070
18233,0.033064,74.125.68.0-255,5738,321219,92,358070
18234,0.033082,172.31.47.0-255,66,321285,92,358070
18235,0.035638,74.125.68.0-255,5738,327023,92,358070
18236,0.035645,172.31.47.0-255,66,327089,92,358070
18237,0.038242,74.125.68.0-255,5738,332827,92,358070
18238,0.038261,172.31.47.0-255,66,332893,92,358070
18239,0.04082,74.125.68.0-255,5738,338631,92,358070
18240,0.040827,172.31.47.0-255,66,338697,92,358070
18241,0.043387,74.125.68.0-255,5738,344435,92,358070
18242,0.043397,172.31.47.0-255,66,344501,92,358070
18243,0.044864,172.31.47.0-255,172,344673,92,358070
18244,0.044893,172.31.47.0-255,1103,345776,92,358070
18245,0.044948,172.31.47.0-255,1514,347290,92,358070
18246,0.044949,172.31.47.0-255,1514,348804,92,358070
18247,0.044955,172.31.47.0-255,1514,350318,92,358070
18248,0.044955,172.31.47.0-255,1514,351832,92,358070
18249,0.044978,172.31.47.0-255,1505,353337,92,358070
18250,0.045943,74.125.68.0-255,4058,357395,92,358070
18251,0.045949,172.31.47.0-255,66,357461,92,358070
18252,0.0461,172.31.47.0-255,105,357566,92,358070
18253,0.046391,104.244.42.0-255,66,357632,92,358070
18254,0.0464,104.244.42.0-255,66,357698,92,358070
18255,0.046503,104.244.42.0-255,66,357764,92,358070
18256,0.04654,104.244.42.0-255,66,357830,92,358070
18257,0.047723,104.244.42.0-255,108,357938,92,358070
18258,0.047731,172.31.47.0-255,66,358004,92,358070
18259,0.048627,74.125.68.0-255,66,358070,92,358070
18260,0.0,74.125.130.0-255,153,153,92,351081
18261,2.2e-05,172.31.47.0-255,66,219,92,351081
18262,2.8e-05,74.125.130.0-255,1484,1703,92,351081
18263,3.2e-05,172.31.47.0-255,66,1769,92,351081
18264,3.5e-05,74.125.130.0-255,1484,3253,92,351081
18265,3.8e-05,172.31.47.0-255,66,3319,92,351081
18266,4.3e-05,74.125.130.0-255,2902,6221,92,351081
18267,4.6e-05,172.31.47.0-255,66,6287,92,351081
18268,7.5e-05,74.125.130.0-255,5738,12025,92,351081
18269,7.7e-05,172.31.47.0-255,66,12091,92,351081
18270,8e-05,74.125.130.0-255,1484,13575,92,351081
18271,8.1e-05,172.31.47.0-255,66,13641,92,351081
18272,0.000104,74.125.130.0-255,675,14316,92,351081
18273,0.000106,172.31.47.0-255,66,14382,92,351081
18274,0.000288,74.125.130.0-255,1484,15866,92,351081
18275,0.000293,172.31.47.0-255,66,15932,92,351081
18276,0.000298,74.125.130.0-255,2902,18834,92,351081
18277,0.0003,172.31.47.0-255,66,18900,92,351081
18278,0.000305,74.125.130.0-255,2902,21802,92,351081
18279,0.000307,172.31.47.0-255,66,21868,92,351081
18280,0.000333,74.125.130.0-255,2902,24770,92,351081
18281,0.000336,172.31.47.0-255,66,24836,92,351081
18282,0.000342,74.125.130.0-255,5738,30574,92,351081
18283,0.000344,172.31.47.0-255,66,30640,92,351081
18284,0.000372,74.125.130.0-255,6797,37437,92,351081
18285,0.000375,172.31.47.0-255,66,37503,92,351081
18286,0.000378,74.125.130.0-255,1484,38987,92,351081
18287,0.000379,172.31.47.0-255,66,39053,92,351081
18288,0.000397,74.125.130.0-255,4320,43373,92,351081
18289,0.0004,172.31.47.0-255,66,43439,92,351081
18290,0.000406,74.125.130.0-255,7156,50595,92,351081
18291,0.000408,172.31.47.0-255,66,50661,92,351081
18292,0.000451,172.31.47.0-255,66,50727,92,351081
18293,0.000513,74.125.130.0-255,5020,55747,92,351081
18294,0.000516,172.31.47.0-255,66,55813,92,351081
18295,0.000519,74.125.130.0-255,376,56189,92,351081
18296,0.000914,172.31.47.0-255,66,56255,92,351081
18297,0.000979,74.125.130.0-255,1484,57739,92,351081
18298,0.000998,74.125.130.0-255,2902,60641,92,351081
18299,0.001001,172.31.47.0-255,66,60707,92,351081
18300,0.001021,74.125.130.0-255,5738,66445,92,351081
18301,0.001023,172.31.47.0-255,66,66511,92,351081
18302,0.001028,74.125.130.0-255,2902,69413,92,351081
18303,0.001029,172.31.47.0-255,66,69479,92,351081
18304,0.001051,74.125.130.0-255,4320,73799,92,351081
18305,0.001053,172.31.47.0-255,66,73865,92,351081
18306,0.00106,74.125.130.0-255,7156,81021,92,351081
18307,0.001061,172.31.47.0-255,66,81087,92,351081
18308,0.001079,74.125.130.0-255,1484,82571,92,351081
18309,0.001084,74.125.130.0-255,2902,85473,92,351081
18310,0.001085,172.31.47.0-255,66,85539,92,351081
18311,0.001107,74.125.130.0-255,5020,90559,92,351081
18312,0.001109,172.31.47.0-255,66,90625,92,351081
18313,0.001282,74.125.130.0-255,366,90991,92,351081
18314,0.001324,74.125.130.0-255,1484,92475,92,351081
18315,0.001328,172.31.47.0-255,66,92541,92,351081
18316,0.001332,74.125.130.0-255,1484,94025,92,351081
18317,0.001336,74.125.130.0-255,2902,96927,92,351081
18318,0.001338,172.31.47.0-255,66,96993,92,351081
18319,0.001358,74.125.130.0-255,2902,99895,92,351081
18320,0.001361,172.31.47.0-255,66,99961,92,351081
18321,0.001377,74.125.130.0-255,2902,102863,92,351081
18322,0.001379,172.31.47.0-255,66,102929,92,351081
18323,0.001384,74.125.130.0-255,2902,105831,92,351081
18324,0.001385,172.31.47.0-255,66,105897,92,351081
18325,0.001407,74.125.130.0-255,4320,110217,92,351081
18326,0.00141,172.31.47.0-255,66,110283,92,351081
18327,0.001413,74.125.130.0-255,2902,113185,92,351081
18328,0.001415,172.31.47.0-255,66,113251,92,351081
18329,0.00143,74.125.130.0-255,5738,118989,92,351081
18330,0.001432,172.31.47.0-255,66,119055,92,351081
18331,0.001451,74.125.130.0-255,6438,125493,92,351081
18332,0.001453,172.31.47.0-255,66,125559,92,351081
18333,0.001585,74.125.130.0-255,1484,127043,92,351081
18334,0.001604,74.125.130.0-255,2902,129945,92,351081
18335,0.001608,172.31.47.0-255,66,130011,92,351081
18336,0.001613,74.125.130.0-255,2902,132913,92,351081
18337,0.001615,172.31.47.0-255,66,132979,92,351081
18338,0.001628,74.125.130.0-255,2902,135881,92,351081
18339,0.00163,172.31.47.0-255,66,135947,92,351081
18340,0.001633,74.125.130.0-255,1484,137431,92,351081
18341,0.001656,74.125.130.0-255,5738,143169,92,351081
18342,0.001659,172.31.47.0-255,66,143235,92,351081
18343,0.001672,74.125.130.0-255,1484,144719,92,351081
18344,0.001698,74.125.130.0-255,7156,151875,92,351081
18345,0.001701,172.31.47.0-255,66,151941,92,351081
18346,0.001705,74.125.130.0-255,2902,154843,92,351081
18347,0.001707,172.31.47.0-255,66,154909,92,351081
18348,0.00171,74.125.130.0-255,1484,156393,92,351081
18349,0.001731,74.125.130.0-255,2902,159295,92,351081
18350,0.001733,172.31.47.0-255,66,159361,92,351081
18351,0.001736,74.125.130.0-255,766,160127,92,351081
18352,0.001896,74.125.130.0-255,1484,161611,92,351081
18353,0.001899,172.31.47.0-255,66,161677,92,351081
18354,0.001903,74.125.130.0-255,1484,163161,92,351081
18355,0.001917,74.125.130.0-255,1484,164645,92,351081
18356,0.001919,172.31.47.0-255,66,164711,92,351081
18357,0.001935,74.125.130.0-255,1484,166195,92,351081
18358,0.001947,74.125.130.0-255,2902,169097,92,351081
18359,0.001949,172.31.47.0-255,66,169163,92,351081
18360,0.001965,74.125.130.0-255,1484,170647,92,351081
18361,0.001968,74.125.130.0-255,1484,172131,92,351081
18362,0.001969,172.31.47.0-255,66,172197,92,351081
18363,0.001986,74.125.130.0-255,5738,177935,92,351081
18364,0.001988,172.31.47.0-255,66,178001,92,351081
18365,0.001993,74.125.130.0-255,4320,182321,92,351081
18366,0.001996,172.31.47.0-255,66,182387,92,351081
18367,0.00201,74.125.130.0-255,1484,183871,92,351081
18368,0.002038,74.125.130.0-255,4320,188191,92,351081
18369,0.002041,172.31.47.0-255,66,188257,92,351081
18370,0.002046,74.125.130.0-255,4320,192577,92,351081
18371,0.002048,172.31.47.0-255,66,192643,92,351081
18372,0.002098,74.125.130.0-255,2184,194827,92,351081
18373,0.002099,172.31.47.0-255,66,194893,92,351081
18374,0.004147,74.125.130.0-255,2902,197795,92,351081
18375,0.00415,172.31.47.0-255,66,197861,92,351081
18376,0.004167,74.125.130.0-255,2902,200763,92,351081
18377,0.004169,172.31.47.0-255,66,200829,92,351081
18378,0.006215,74.125.130.0-255,5738,206567,92,351081
18379,0.006221,172.31.47.0-255,66,206633,92,351081
18380,0.008286,74.125.130.0-255,5738,212371,92,351081
18381,0.008292,172.31.47.0-255,66,212437,92,351081
18382,0.010352,74.125.130.0-255,5738,218175,92,351081
18383,0.010359,172.31.47.0-255,66,218241,92,351081
18384,0.012432,74.125.130.0-255,5738,223979,92,351081
18385,0.01244,172.31.47.0-255,66,224045,92,351081
18386,0.014499,74.125.130.0-255,5738,229783,92,351081
18387,0.014508,172.31.47.0-255,66,229849,92,351081
18388,0.016609,74.125.130.0-255,5738,235587,92,351081
18389,0.016616,172.31.47.0-255,66,235653,92,351081
18390,0.0187,74.125.130.0-255,5738,241391,92,351081
18391,0.018706,172.31.47.0-255,66,241457,92,351081
18392,0.020772,74.125.130.0-255,5738,247195,92,351081
18393,0.020777,172.31.47.0-255,66,247261,92,351081
18394,0.022845,74.125.130.0-255,5738,252999,92,351081
18395,0.022853,172.31.47.0-255,66,253065,92,351081
18396,0.024926,74.125.130.0-255,5738,258803,92,351081
18397,0.024932,172.31.47.0-255,66,258869,92,351081
18398,0.027,74.125.130.0-255,5738,264607,92,351081
18399,0.027007,172.31.47.0-255,66,264673,92,351081
18400,0.029078,74.125.130.0-255,4320,268993,92,351081
18401,0.029084,172.31.47.0-255,66,269059,92,351081
18402,0.029103,74.125.130.0-255,1484,270543,92,351081
18403,0.031163,74.125.130.0-255,4320,274863,92,351081
18404,0.031171,172.31.47.0-255,66,274929,92,351081
18405,0.033235,74.125.130.0-255,5738,280667,92,351081
18406,0.033248,172.31.47.0-255,66,280733,92,351081
18407,0.034406,172.31.47.0-255,172,280905,92,351081
18408,0.034443,172.31.47.0-255,1112,282017,92,351081
18409,0.034493,172.31.47.0-255,570,282587,92,351081
18410,0.035316,74.125.130.0-255,5738,288325,92,351081
18411,0.035322,172.31.47.0-255,66,288391,92,351081
18412,0.035944,104.244.42.0-255,66,288457,92,351081
18413,0.036006,104.244.42.0-255,66,288523,92,351081
18414,0.036011,104.244.42.0-255,66,288589,92,351081
18415,0.037395,74.125.130.0-255,5738,294327,92,351081
18416,0.037401,172.31.47.0-255,66,294393,92,351081
18417,0.039463,74.125.130.0-255,5738,300131,92,351081
18418,0.039469,172.31.47.0-255,66,300197,92,351081
18419,0.041526,74.125.130.0-255,4320,304517,92,351081
18420,0.041531,172.31.47.0-255,66,304583,92,351081
18421,0.041544,74.125.130.0-255,1484,306067,92,351081
18422,0.043595,74.125.130.0-255,4320,310387,92,351081
18423,0.0436,172.31.47.0-255,66,310453,92,351081
18424,0.045682,74.125.130.0-255,5738,316191,92,351081
18425,0.045689,172.31.47.0-255,66,316257,92,351081
18426,0.047757,74.125.130.0-255,5738,321995,92,351081
18427,0.047762,172.31.47.0-255,66,322061,92,351081
18428,0.049828,74.125.130.0-255,5738,327799,92,351081
18429,0.049834,172.31.47.0-255,66,327865,92,351081
18430,0.051946,74.125.130.0-255,5738,333603,92,351081
18431,0.051951,172.31.47.0-255,66,333669,92,351081
18432,0.054043,74.125.130.0-255,5738,339407,92,351081
18433,0.054049,172.31.47.0-255,66,339473,92,351081
18434,0.056119,74.125.130.0-255,5738,345211,92,351081
18435,0.056125,172.31.47.0-255,66,345277,92,351081
18436,0.058197,74.125.130.0-255,5738,351015,92,351081
18437,0.058204,172.31.47.0-255,66,351081,92,351081
18438,0.0,172.217.194.0-255,153,153,92,298493
18439,3.2e-05,172.31.47.0-255,66,219,92,298493
18440,3.9e-05,172.217.194.0-255,1484,1703,92,298493
18441,4.3e-05,172.31.47.0-255,66,1769,92,298493
18442,4.8e-05,172.217.194.0-255,2902,4671,92,298493
18443,5e-05,172.31.47.0-255,66,4737,92,298493
18444,5.6e-05,172.217.194.0-255,7156,11893,92,298493
18445,5.9e-05,172.31.47.0-255,66,11959,92,298493
18446,6.2e-05,172.217.194.0-255,2165,14124,92,298493
18447,6.4e-05,172.31.47.0-255,66,14190,92,298493
18448,8.4e-05,172.217.194.0-255,1484,15674,92,298493
18449,8.6e-05,172.31.47.0-255,66,15740,92,298493
18450,0.000104,172.217.194.0-255,2902,18642,92,298493
18451,0.000106,172.31.47.0-255,66,18708,92,298493
18452,0.000111,172.217.194.0-255,5738,24446,92,298493
18453,0.000112,172.31.47.0-255,66,24512,92,298493
18454,0.000132,172.217.194.0-255,1484,25996,92,298493
18455,0.000135,172.31.47.0-255,66,26062,92,298493
18456,0.000156,172.217.194.0-255,5379,31441,92,298493
18457,0.000159,172.31.47.0-255,66,31507,92,298493
18458,0.000201,172.217.194.0-255,1484,32991,92,298493
18459,0.000204,172.31.47.0-255,66,33057,92,298493
18460,0.000207,172.217.194.0-255,1484,34541,92,298493
18461,0.000208,172.31.47.0-255,66,34607,92,298493
18462,0.000221,172.217.194.0-255,1484,36091,92,298493
18463,0.000223,172.31.47.0-255,66,36157,92,298493
18464,0.000227,172.217.194.0-255,2902,39059,92,298493
18465,0.000229,172.31.47.0-255,66,39125,92,298493
18466,0.000249,172.217.194.0-255,2902,42027,92,298493
18467,0.000251,172.31.47.0-255,66,42093,92,298493
18468,0.000254,172.217.194.0-255,1484,43577,92,298493
18469,0.000256,172.31.47.0-255,66,43643,92,298493
18470,0.000275,172.217.194.0-255,5379,49022,92,298493
18471,0.000278,172.31.47.0-255,66,49088,92,298493
18472,0.000319,172.31.47.0-255,66,49154,92,298493
18473,0.000322,172.217.194.0-255,2543,51697,92,298493
18474,0.000324,172.31.47.0-255,66,51763,92,298493
18475,0.000326,172.217.194.0-255,363,52126,92,298493
18476,0.000328,172.31.47.0-255,66,52192,92,298493
18477,0.00033,172.217.194.0-255,380,52572,92,298493
18478,0.000332,172.31.47.0-255,66,52638,92,298493
18479,0.00066,172.217.194.0-255,1484,54122,92,298493
18480,0.000664,172.31.47.0-255,66,54188,92,298493
18481,0.00067,172.217.194.0-255,2902,57090,92,298493
18482,0.000672,172.31.47.0-255,66,57156,92,298493
18483,0.000687,172.217.194.0-255,5738,62894,92,298493
18484,0.000694,172.31.47.0-255,66,62960,92,298493
18485,0.000703,172.217.194.0-255,4320,67280,92,298493
18486,0.000709,172.31.47.0-255,66,67346,92,298493
18487,0.000731,172.217.194.0-255,4320,71666,92,298493
18488,0.000739,172.31.47.0-255,66,71732,92,298493
18489,0.000777,172.217.194.0-255,4320,76052,92,298493
18490,0.000782,172.31.47.0-255,66,76118,92,298493
18491,0.000798,172.217.194.0-255,2184,78302,92,298493
18492,0.0008,172.31.47.0-255,66,78368,92,298493
18493,0.000905,172.217.194.0-255,1484,79852,92,298493
18494,0.00091,172.217.194.0-255,2902,82754,92,298493
18495,0.000921,172.31.47.0-255,66,82820,92,298493
18496,0.000932,172.217.194.0-255,5738,88558,92,298493
18497,0.000935,172.31.47.0-255,66,88624,92,298493
18498,0.000971,172.31.47.0-255,66,88690,92,298493
18499,0.000988,172.31.47.0-255,66,88756,92,298493
18500,0.001025,172.217.194.0-255,1484,90240,92,298493
18501,0.001029,172.217.194.0-255,1484,91724,92,298493
18502,0.00104,172.217.194.0-255,1484,93208,92,298493
18503,0.001041,172.31.47.0-255,66,93274,92,298493
18504,0.001044,172.217.194.0-255,2902,96176,92,298493
18505,0.001055,172.217.194.0-255,2902,99078,92,298493
18506,0.001079,172.217.194.0-255,7156,106234,92,298493
18507,0.001084,172.31.47.0-255,66,106300,92,298493
18508,0.001106,172.217.194.0-255,5738,112038,92,298493
18509,0.001111,172.31.47.0-255,66,112104,92,298493
18510,0.001147,172.31.47.0-255,66,112170,92,298493
18511,0.001286,172.217.194.0-255,1484,113654,92,298493
18512,0.001302,172.217.194.0-255,2902,116556,92,298493
18513,0.001308,172.31.47.0-255,66,116622,92,298493
18514,0.001318,172.217.194.0-255,1484,118106,92,298493
18515,0.001333,172.217.194.0-255,4320,122426,92,298493
18516,0.001336,172.31.47.0-255,66,122492,92,298493
18517,0.001378,172.31.47.0-255,66,122558,92,298493
18518,0.001379,172.217.194.0-255,2902,125460,92,298493
18519,0.001382,172.31.47.0-255,66,125526,92,298493
18520,0.001391,172.217.194.0-255,2902,128428,92,298493
18521,0.001395,172.31.47.0-255,66,128494,92,298493
18522,0.001423,172.31.47.0-255,66,128560,92,298493
18523,0.001742,172.217.194.0-255,1484,130044,92,298493
18524,0.001747,172.217.194.0-255,2902,132946,92,298493
18525,0.00175,172.31.47.0-255,66,133012,92,298493
18526,0.001755,172.217.194.0-255,2902,135914,92,298493
18527,0.001764,172.31.47.0-255,66,135980,92,298493
18528,0.001771,172.217.194.0-255,2902,138882,92,298493
18529,0.001782,172.31.47.0-255,66,138948,92,298493
18530,0.001786,172.217.194.0-255,7156,146104,92,298493
18531,0.001796,172.31.47.0-255,66,146170,92,298493
18532,0.001809,172.217.194.0-255,5738,151908,92,298493
18533,0.001814,172.217.194.0-255,2902,154810,92,298493
18534,0.001822,172.31.47.0-255,66,154876,92,298493
18535,0.001846,172.31.47.0-255,66,154942,92,298493
18536,0.001897,172.217.194.0-255,1484,156426,92,298493
18537,0.001902,172.217.194.0-255,2902,159328,92,298493
18538,0.001905,172.31.47.0-255,66,159394,92,298493
18539,0.00191,172.217.194.0-255,4320,163714,92,298493
18540,0.001919,172.31.47.0-255,66,163780,92,298493
18541,0.001926,172.217.194.0-255,1484,165264,92,298493
18542,0.001931,172.217.194.0-255,4320,169584,92,298493
18543,0.001945,172.31.47.0-255,66,169650,92,298493
18544,0.001961,172.31.47.0-255,66,169716,92,298493
18545,0.001975,172.31.47.0-255,66,169782,92,298493
18546,0.001983,172.217.194.0-255,2184,171966,92,298493
18547,0.001991,172.31.47.0-255,66,172032,92,298493
18548,0.002261,172.217.194.0-255,1484,173516,92,298493
18549,0.002267,172.217.194.0-255,2902,176418,92,298493
18550,0.002271,172.31.47.0-255,66,176484,92,298493
18551,0.002292,172.217.194.0-255,4320,180804,92,298493
18552,0.002295,172.217.194.0-255,1484,182288,92,298493
18553,0.002297,172.31.47.0-255,66,182354,92,298493
18554,0.002317,172.217.194.0-255,4320,186674,92,298493
18555,0.002322,172.31.47.0-255,66,186740,92,298493
18556,0.002332,172.217.194.0-255,4320,191060,92,298493
18557,0.002352,172.31.47.0-255,66,191126,92,298493
18558,0.002356,172.217.194.0-255,7156,198282,92,298493
18559,0.002367,172.31.47.0-255,66,198348,92,298493
18560,0.00248,172.217.194.0-255,1484,199832,92,298493
18561,0.002486,172.217.194.0-255,2902,202734,92,298493
18562,0.00249,172.31.47.0-255,66,202800,92,298493
18563,0.002494,172.217.194.0-255,1484,204284,92,298493
18564,0.002508,172.217.194.0-255,4320,208604,92,298493
18565,0.002514,172.31.47.0-255,66,208670,92,298493
18566,0.002529,172.217.194.0-255,4320,212990,92,298493
18567,0.002539,172.31.47.0-255,66,213056,92,298493
18568,0.002551,172.217.194.0-255,2902,215958,92,298493
18569,0.002552,172.31.47.0-255,66,216024,92,298493
18570,0.002556,172.31.47.0-255,66,216090,92,298493
18571,0.002571,172.31.47.0-255,66,216156,92,298493
18572,0.002631,172.31.47.0-255,66,216222,92,298493
18573,0.005184,172.217.194.0-255,5738,221960,92,298493
18574,0.005191,172.31.47.0-255,66,222026,92,298493
18575,0.007756,172.217.194.0-255,5738,227764,92,298493
18576,0.007761,172.31.47.0-255,66,227830,92,298493
18577,0.010317,172.217.194.0-255,5738,233568,92,298493
18578,0.010326,172.31.47.0-255,66,233634,92,298493
18579,0.012878,172.217.194.0-255,5738,239372,92,298493
18580,0.012886,172.31.47.0-255,66,239438,92,298493
18581,0.015448,172.217.194.0-255,5738,245176,92,298493
18582,0.015459,172.31.47.0-255,66,245242,92,298493
18583,0.018032,172.217.194.0-255,5738,250980,92,298493
18584,0.01804,172.31.47.0-255,66,251046,92,298493
18585,0.020576,172.217.194.0-255,5738,256784,92,298493
18586,0.02058,172.31.47.0-255,66,256850,92,298493
18587,0.02311,172.217.194.0-255,5738,262588,92,298493
18588,0.023117,172.31.47.0-255,66,262654,92,298493
18589,0.025667,172.217.194.0-255,5738,268392,92,298493
18590,0.025673,172.31.47.0-255,66,268458,92,298493
18591,0.028213,172.217.194.0-255,5738,274196,92,298493
18592,0.02822,172.31.47.0-255,66,274262,92,298493
18593,0.030794,172.217.194.0-255,5738,280000,92,298493
18594,0.030802,172.31.47.0-255,66,280066,92,298493
18595,0.032178,172.31.47.0-255,172,280238,92,298493
18596,0.032218,172.31.47.0-255,1111,281349,92,298493
18597,0.032285,172.31.47.0-255,1514,282863,92,298493
18598,0.032287,172.31.47.0-255,1514,284377,92,298493
18599,0.032288,172.31.47.0-255,1514,285891,92,298493
18600,0.032289,172.31.47.0-255,1514,287405,92,298493
18601,0.03229,172.31.47.0-255,1495,288900,92,298493
18602,0.033361,172.217.194.0-255,5738,294638,92,298493
18603,0.033367,172.31.47.0-255,66,294704,92,298493
18604,0.033713,104.244.42.0-255,66,294770,92,298493
18605,0.033761,104.244.42.0-255,66,294836,92,298493
18606,0.033813,104.244.42.0-255,66,294902,92,298493
18607,0.033846,104.244.42.0-255,66,294968,92,298493
18608,0.03592,172.217.194.0-255,3288,298256,92,298493
18609,0.035924,172.31.47.0-255,66,298322,92,298493
18610,0.036066,172.31.47.0-255,105,298427,92,298493
18611,0.038559,172.217.194.0-255,66,298493,92,298493
18612,0.0,74.125.24.0-255,153,153,92,271572
18613,2.9e-05,172.31.47.0-255,66,219,92,271572
18614,3.5e-05,74.125.24.0-255,1484,1703,92,271572
18615,3.9e-05,172.31.47.0-255,66,1769,92,271572
18616,4.4e-05,74.125.24.0-255,2902,4671,92,271572
18617,4.6e-05,172.31.47.0-255,66,4737,92,271572
18618,6.8e-05,74.125.24.0-255,7156,11893,92,271572
18619,7e-05,172.31.47.0-255,66,11959,92,271572
18620,7.3e-05,74.125.24.0-255,2182,14141,92,271572
18621,7.5e-05,172.31.47.0-255,66,14207,92,271572
18622,0.000103,74.125.24.0-255,4320,18527,92,271572
18623,0.000106,172.31.47.0-255,66,18593,92,271572
18624,0.000122,74.125.24.0-255,7156,25749,92,271572
18625,0.000125,172.31.47.0-255,66,25815,92,271572
18626,0.00013,74.125.24.0-255,5379,31194,92,271572
18627,0.000132,172.31.47.0-255,66,31260,92,271572
18628,0.000381,74.125.24.0-255,1484,32744,92,271572
18629,0.000385,172.31.47.0-255,66,32810,92,271572
18630,0.00039,74.125.24.0-255,2902,35712,92,271572
18631,0.000392,172.31.47.0-255,66,35778,92,271572
18632,0.000395,74.125.24.0-255,1484,37262,92,271572
18633,0.000396,172.31.47.0-255,66,37328,92,271572
18634,0.000411,74.125.24.0-255,4320,41648,92,271572
18635,0.000413,172.31.47.0-255,66,41714,92,271572
18636,0.000432,74.125.24.0-255,5738,47452,92,271572
18637,0.000434,172.31.47.0-255,66,47518,92,271572
18638,0.000455,74.125.24.0-255,1125,48643,92,271572
18639,0.000458,172.31.47.0-255,66,48709,92,271572
18640,0.000465,74.125.24.0-255,7156,55865,92,271572
18641,0.000466,172.31.47.0-255,66,55931,92,271572
18642,0.000472,74.125.24.0-255,4320,60251,92,271572
18643,0.000474,172.31.47.0-255,66,60317,92,271572
18644,0.000499,74.125.24.0-255,5688,66005,92,271572
18645,0.000503,74.125.24.0-255,113,66118,92,271572
18646,0.000504,172.31.47.0-255,66,66184,92,271572
18647,0.000603,74.125.24.0-255,1484,67668,92,271572
18648,0.000607,172.31.47.0-255,66,67734,92,271572
18649,0.000611,74.125.24.0-255,2902,70636,92,271572
18650,0.00062,172.31.47.0-255,66,70702,92,271572
18651,0.000635,74.125.24.0-255,5738,76440,92,271572
18652,0.000643,172.31.47.0-255,66,76506,92,271572
18653,0.000675,74.125.24.0-255,4320,80826,92,271572
18654,0.000679,172.31.47.0-255,66,80892,92,271572
18655,0.000709,172.31.47.0-255,66,80958,92,271572
18656,0.000752,172.31.47.0-255,66,81024,92,271572
18657,0.001808,74.125.24.0-255,1484,82508,92,271572
18658,0.001817,74.125.24.0-255,2902,85410,92,271572
18659,0.00182,172.31.47.0-255,66,85476,92,271572
18660,0.001827,74.125.24.0-255,5738,91214,92,271572
18661,0.001848,74.125.24.0-255,2902,94116,92,271572
18662,0.001866,74.125.24.0-255,7156,101272,92,271572
18663,0.001883,74.125.24.0-255,2902,104174,92,271572
18664,0.00225,74.125.24.0-255,1484,105658,92,271572
18665,0.002264,74.125.24.0-255,2902,108560,92,271572
18666,0.002276,74.125.24.0-255,4320,112880,92,271572
18667,0.002287,74.125.24.0-255,1484,114364,92,271572
18668,0.002304,74.125.24.0-255,5738,120102,92,271572
18669,0.002324,74.125.24.0-255,7156,127258,92,271572
18670,0.002327,74.125.24.0-255,1484,128742,92,271572
18671,0.006517,172.31.47.0-255,66,128808,92,271572
18672,0.008785,74.125.24.0-255,5738,134546,92,271572
18673,0.008795,172.31.47.0-255,66,134612,92,271572
18674,0.011058,74.125.24.0-255,5738,140350,92,271572
18675,0.011067,172.31.47.0-255,66,140416,92,271572
18676,0.013344,74.125.24.0-255,5738,146154,92,271572
18677,0.013353,172.31.47.0-255,66,146220,92,271572
18678,0.015659,74.125.24.0-255,5738,151958,92,271572
18679,0.015668,172.31.47.0-255,66,152024,92,271572
18680,0.017953,74.125.24.0-255,5738,157762,92,271572
18681,0.017961,172.31.47.0-255,66,157828,92,271572
18682,0.020226,74.125.24.0-255,5738,163566,92,271572
18683,0.020233,172.31.47.0-255,66,163632,92,271572
18684,0.022529,74.125.24.0-255,5738,169370,92,271572
18685,0.022537,172.31.47.0-255,66,169436,92,271572
18686,0.024693,172.31.47.0-255,172,169608,92,271572
18687,0.024718,172.31.47.0-255,1111,170719,92,271572
18688,0.024773,172.31.47.0-255,1514,172233,92,271572
18689,0.024775,172.31.47.0-255,1514,173747,92,271572
18690,0.02478,172.31.47.0-255,1514,175261,92,271572
18691,0.024781,172.31.47.0-255,1514,176775,92,271572
18692,0.024798,172.31.47.0-255,1495,178270,92,271572
18693,0.024812,74.125.24.0-255,1484,179754,92,271572
18694,0.024833,74.125.24.0-255,4320,184074,92,271572
18695,0.024837,172.31.47.0-255,66,184140,92,271572
18696,0.026231,104.244.42.0-255,66,184206,92,271572
18697,0.026352,104.244.42.0-255,66,184272,92,271572
18698,0.026373,104.244.42.0-255,66,184338,92,271572
18699,0.027005,104.244.42.0-255,108,184446,92,271572
18700,0.027011,172.31.47.0-255,66,184512,92,271572
18701,0.027125,74.125.24.0-255,5738,190250,92,271572
18702,0.02713,172.31.47.0-255,66,190316,92,271572
18703,0.029456,74.125.24.0-255,5738,196054,92,271572
18704,0.029463,172.31.47.0-255,66,196120,92,271572
18705,0.031754,74.125.24.0-255,5738,201858,92,271572
18706,0.03176,172.31.47.0-255,66,201924,92,271572
18707,0.034024,74.125.24.0-255,5738,207662,92,271572
18708,0.034031,172.31.47.0-255,66,207728,92,271572
18709,0.036336,74.125.24.0-255,5738,213466,92,271572
18710,0.036342,172.31.47.0-255,66,213532,92,271572
18711,0.038637,74.125.24.0-255,5738,219270,92,271572
18712,0.038644,172.31.47.0-255,66,219336,92,271572
18713,0.040961,74.125.24.0-255,5738,225074,92,271572
18714,0.040969,172.31.47.0-255,66,225140,92,271572
18715,0.043222,74.125.24.0-255,5738,230878,92,271572
18716,0.043229,172.31.47.0-255,66,230944,92,271572
18717,0.045509,74.125.24.0-255,5738,236682,92,271572
18718,0.045516,172.31.47.0-255,66,236748,92,271572
18719,0.047819,74.125.24.0-255,5738,242486,92,271572
18720,0.047825,172.31.47.0-255,66,242552,92,271572
18721,0.050072,74.125.24.0-255,5738,248290,92,271572
18722,0.050078,172.31.47.0-255,66,248356,92,271572
18723,0.052366,74.125.24.0-255,5738,254094,92,271572
18724,0.052371,172.31.47.0-255,66,254160,92,271572
18725,0.054664,74.125.24.0-255,5738,259898,92,271572
18726,0.054671,172.31.47.0-255,66,259964,92,271572
18727,0.056943,74.125.24.0-255,5738,265702,92,271572
18728,0.056952,172.31.47.0-255,66,265768,92,271572
18729,0.05925,74.125.24.0-255,5738,271506,92,271572
18730,0.059257,172.31.47.0-255,66,271572,92,271572
18731,0.0,172.217.194.0-255,153,153,92,283305
18732,1.3e-05,172.31.47.0-255,66,219,92,283305
18733,3.7e-05,172.217.194.0-255,1484,1703,92,283305
18734,4.1e-05,172.31.47.0-255,66,1769,92,283305
18735,4.6e-05,172.217.194.0-255,2902,4671,92,283305
18736,4.8e-05,172.31.47.0-255,66,4737,92,283305
18737,5e-05,172.217.194.0-255,1484,6221,92,283305
18738,5.3e-05,172.31.47.0-255,66,6287,92,283305
18739,8.6e-05,172.217.194.0-255,1484,7771,92,283305
18740,8.8e-05,172.31.47.0-255,66,7837,92,283305
18741,9.3e-05,172.217.194.0-255,4320,12157,92,283305
18742,9.6e-05,172.31.47.0-255,66,12223,92,283305
18743,0.000115,172.217.194.0-255,2253,14476,92,283305
18744,0.000121,172.31.47.0-255,66,14542,92,283305
18745,0.000247,172.217.194.0-255,1484,16026,92,283305
18746,0.000252,172.31.47.0-255,66,16092,92,283305
18747,0.000257,172.217.194.0-255,2902,18994,92,283305
18748,0.000259,172.31.47.0-255,66,19060,92,283305
18749,0.000264,172.217.194.0-255,4320,23380,92,283305
18750,0.000265,172.31.47.0-255,66,23446,92,283305
18751,0.000288,172.217.194.0-255,1484,24930,92,283305
18752,0.00029,172.31.47.0-255,66,24996,92,283305
18753,0.000313,172.217.194.0-255,4320,29316,92,283305
18754,0.000316,172.31.47.0-255,66,29382,92,283305
18755,0.000348,172.31.47.0-255,66,29448,92,283305
18756,0.00035,172.217.194.0-255,1484,30932,92,283305
18757,0.000352,172.31.47.0-255,66,30998,92,283305
18758,0.000368,172.31.47.0-255,66,31064,92,283305
18759,0.000401,172.217.194.0-255,1484,32548,92,283305
18760,0.000403,172.31.47.0-255,66,32614,92,283305
18761,0.000412,172.31.47.0-255,66,32680,92,283305
18762,0.000417,172.217.194.0-255,709,33389,92,283305
18763,0.000419,172.31.47.0-255,66,33455,92,283305
18764,0.000659,172.217.194.0-255,1484,34939,92,283305
18765,0.000665,172.31.47.0-255,66,35005,92,283305
18766,0.00067,172.217.194.0-255,2902,37907,92,283305
18767,0.000672,172.31.47.0-255,66,37973,92,283305
18768,0.0007,172.217.194.0-255,5738,43711,92,283305
18769,0.000702,172.31.47.0-255,66,43777,92,283305
18770,0.000721,172.217.194.0-255,5738,49515,92,283305
18771,0.000723,172.31.47.0-255,66,49581,92,283305
18772,0.000743,172.217.194.0-255,7156,56737,92,283305
18773,0.000749,172.217.194.0-255,5738,62475,92,283305
18774,0.000774,172.31.47.0-255,66,62541,92,283305
18775,0.000793,172.217.194.0-255,5020,67561,92,283305
18776,0.000809,172.31.47.0-255,66,67627,92,283305
18777,0.000837,172.217.194.0-255,4320,71947,92,283305
18778,0.00084,172.217.194.0-255,1484,73431,92,283305
18779,0.00086,172.217.194.0-255,4320,77751,92,283305
18780,0.000867,172.31.47.0-255,66,77817,92,283305
18781,0.000904,172.31.47.0-255,66,77883,92,283305
18782,0.000912,172.217.194.0-255,1484,79367,92,283305
18783,0.000931,172.217.194.0-255,4320,83687,92,283305
18784,0.000938,172.31.47.0-255,66,83753,92,283305
18785,0.000955,172.217.194.0-255,6438,90191,92,283305
18786,0.000974,172.217.194.0-255,5738,95929,92,283305
18787,0.00098,172.31.47.0-255,66,95995,92,283305
18788,0.00099,172.217.194.0-255,7156,103151,92,283305
18789,0.000998,172.217.194.0-255,4320,107471,92,283305
18790,0.001003,172.31.47.0-255,66,107537,92,283305
18791,0.001046,172.217.194.0-255,2902,110439,92,283305
18792,0.00105,172.31.47.0-255,66,110505,92,283305
18793,0.001093,172.31.47.0-255,66,110571,92,283305
18794,0.001114,172.217.194.0-255,5738,116309,92,283305
18795,0.001121,172.217.194.0-255,7156,123465,92,283305
18796,0.001161,172.217.194.0-255,7156,130621,92,283305
18797,0.001179,172.217.194.0-255,7156,137777,92,283305
18798,0.001185,172.217.194.0-255,6438,144215,92,283305
18799,0.001192,172.31.47.0-255,66,144281,92,283305
18800,0.0012,172.217.194.0-255,1484,145765,92,283305
18801,0.001211,172.217.194.0-255,1484,147249,92,283305
18802,0.001223,172.217.194.0-255,1484,148733,92,283305
18803,0.001228,172.217.194.0-255,4320,153053,92,283305
18804,0.001238,172.217.194.0-255,1484,154537,92,283305
18805,0.001242,172.31.47.0-255,66,154603,92,283305
18806,0.001267,172.217.194.0-255,1484,156087,92,283305
18807,0.001282,172.31.47.0-255,66,156153,92,283305
18808,0.001302,172.217.194.0-255,2184,158337,92,283305
18809,0.001321,172.217.194.0-255,1484,159821,92,283305
18810,0.001327,172.31.47.0-255,66,159887,92,283305
18811,0.001336,172.217.194.0-255,1484,161371,92,283305
18812,0.001345,172.217.194.0-255,5738,167109,92,283305
18813,0.001356,172.31.47.0-255,66,167175,92,283305
18814,0.001363,172.217.194.0-255,1484,168659,92,283305
18815,0.001367,172.217.194.0-255,2902,171561,92,283305
18816,0.001375,172.31.47.0-255,66,171627,92,283305
18817,0.001424,172.31.47.0-255,66,171693,92,283305
18818,0.001449,172.217.194.0-255,1484,173177,92,283305
18819,0.001479,172.217.194.0-255,2902,176079,92,283305
18820,0.001504,172.31.47.0-255,66,176145,92,283305
18821,0.001529,172.217.194.0-255,2902,179047,92,283305
18822,0.001535,172.217.194.0-255,6438,185485,92,283305
18823,0.001547,172.31.47.0-255,66,185551,92,283305
18824,0.001799,172.217.194.0-255,1484,187035,92,283305
18825,0.001816,172.217.194.0-255,2902,189937,92,283305
18826,0.001836,172.217.194.0-255,5738,195675,92,283305
18827,0.001839,172.31.47.0-255,66,195741,92,283305
18828,0.001849,172.31.47.0-255,66,195807,92,283305
18829,0.001894,172.217.194.0-255,4320,200127,92,283305
18830,0.001901,172.31.47.0-255,66,200193,92,283305
18831,0.001928,172.217.194.0-255,4320,204513,92,283305
18832,0.001937,172.31.47.0-255,66,204579,92,283305
18833,0.001964,172.217.194.0-255,6438,211017,92,283305
18834,0.001976,172.31.47.0-255,66,211083,92,283305
18835,0.003459,172.217.194.0-255,1484,212567,92,283305
18836,0.003484,172.217.194.0-255,2902,215469,92,283305
18837,0.00349,172.31.47.0-255,66,215535,92,283305
18838,0.003504,172.217.194.0-255,5738,221273,92,283305
18839,0.003514,172.217.194.0-255,4320,225593,92,283305
18840,0.003529,172.217.194.0-255,4320,229913,92,283305
18841,0.003537,172.31.47.0-255,66,229979,92,283305
18842,0.003545,172.217.194.0-255,1484,231463,92,283305
18843,0.003573,172.217.194.0-255,4320,235783,92,283305
18844,0.003616,172.217.194.0-255,1484,237267,92,283305
18845,0.00362,172.31.47.0-255,66,237333,92,283305
18846,0.003649,172.217.194.0-255,7156,244489,92,283305
18847,0.003674,172.31.47.0-255,66,244555,92,283305
18848,0.003682,172.217.194.0-255,7156,251711,92,283305
18849,0.003687,172.31.47.0-255,66,251777,92,283305
18850,0.003714,172.217.194.0-255,5020,256797,92,283305
18851,0.003727,172.31.47.0-255,66,256863,92,283305
18852,0.004087,172.217.194.0-255,1484,258347,92,283305
18853,0.004093,172.217.194.0-255,2902,261249,92,283305
18854,0.004099,172.31.47.0-255,66,261315,92,283305
18855,0.004117,172.217.194.0-255,5738,267053,92,283305
18856,0.00412,172.217.194.0-255,2902,269955,92,283305
18857,0.004138,172.217.194.0-255,3639,273594,92,283305
18858,0.004141,172.217.194.0-255,97,273691,92,283305
18859,0.004153,172.31.47.0-255,66,273757,92,283305
18860,0.004211,172.217.194.0-255,105,273862,92,283305
18861,0.0046,172.31.47.0-255,66,273928,92,283305
18862,0.004642,172.31.47.0-255,105,274033,92,283305
18863,0.006633,172.217.194.0-255,66,274099,92,283305
18864,0.032996,172.31.47.0-255,172,274271,92,283305
18865,0.033048,172.31.47.0-255,1107,275378,92,283305
18866,0.033125,172.31.47.0-255,1514,276892,92,283305
18867,0.033126,172.31.47.0-255,1514,278406,92,283305
18868,0.033132,172.31.47.0-255,1514,279920,92,283305
18869,0.033134,172.31.47.0-255,1514,281434,92,283305
18870,0.033154,172.31.47.0-255,1499,282933,92,283305
18871,0.034542,104.244.42.0-255,66,282999,92,283305
18872,0.034587,104.244.42.0-255,66,283065,92,283305
18873,0.0347,104.244.42.0-255,66,283131,92,283305
18874,0.035318,104.244.42.0-255,108,283239,92,283305
18875,0.035324,172.31.47.0-255,66,283305,92,283305
18876,0.0,172.217.26.0-255,153,153,92,238941
18877,3.2e-05,172.31.47.0-255,66,219,92,238941
18878,3.9e-05,172.217.26.0-255,1484,1703,92,238941
18879,4.3e-05,172.31.47.0-255,66,1769,92,238941
18880,4.7e-05,172.217.26.0-255,2902,4671,92,238941
18881,5.9e-05,172.31.47.0-255,66,4737,92,238941
18882,0.000102,172.217.26.0-255,7156,11893,92,238941
18883,0.000105,172.31.47.0-255,66,11959,92,238941
18884,0.000224,172.217.26.0-255,2101,14060,92,238941
18885,0.000228,172.31.47.0-255,66,14126,92,238941
18886,0.000266,172.217.26.0-255,2902,17028,92,238941
18887,0.000272,172.31.47.0-255,66,17094,92,238941
18888,0.000298,172.31.47.0-255,66,17160,92,238941
18889,0.000488,172.217.26.0-255,2902,20062,92,238941
18890,0.000492,172.31.47.0-255,66,20128,92,238941
18891,0.000517,172.217.26.0-255,2543,22671,92,238941
18892,0.000521,172.31.47.0-255,66,22737,92,238941
18893,0.000593,172.217.26.0-255,4320,27057,92,238941
18894,0.000598,172.31.47.0-255,66,27123,92,238941
18895,0.000644,172.31.47.0-255,66,27189,92,238941
18896,0.001037,172.217.26.0-255,7156,34345,92,238941
18897,0.001043,172.31.47.0-255,66,34411,92,238941
18898,0.001173,172.217.26.0-255,3961,38372,92,238941
18899,0.001178,172.31.47.0-255,66,38438,92,238941
18900,0.001218,172.217.26.0-255,398,38836,92,238941
18901,0.00122,172.31.47.0-255,66,38902,92,238941
18902,0.001306,172.217.26.0-255,117,39019,92,238941
18903,0.001309,172.31.47.0-255,66,39085,92,238941
18904,0.001564,172.217.26.0-255,1484,40569,92,238941
18905,0.001567,172.31.47.0-255,66,40635,92,238941
18906,0.001595,172.217.26.0-255,2902,43537,92,238941
18907,0.001598,172.31.47.0-255,66,43603,92,238941
18908,0.001627,172.217.26.0-255,1484,45087,92,238941
18909,0.001656,172.217.26.0-255,2902,47989,92,238941
18910,0.001659,172.31.47.0-255,66,48055,92,238941
18911,0.001708,172.217.26.0-255,2902,50957,92,238941
18912,0.001712,172.31.47.0-255,66,51023,92,238941
18913,0.001736,172.217.26.0-255,2902,53925,92,238941
18914,0.001739,172.31.47.0-255,66,53991,92,238941
18915,0.001832,172.31.47.0-255,66,54057,92,238941
18916,0.001856,172.217.26.0-255,5379,59436,92,238941
18917,0.001859,172.31.47.0-255,66,59502,92,238941
18918,0.0021,172.217.26.0-255,2902,62404,92,238941
18919,0.002106,172.31.47.0-255,66,62470,92,238941
18920,0.002129,172.217.26.0-255,2543,65013,92,238941
18921,0.002132,172.31.47.0-255,66,65079,92,238941
18922,0.004045,172.217.26.0-255,2902,67981,92,238941
18923,0.00405,172.31.47.0-255,66,68047,92,238941
18924,0.004078,172.217.26.0-255,2902,70949,92,238941
18925,0.004081,172.31.47.0-255,66,71015,92,238941
18926,0.006002,172.217.26.0-255,4320,75335,92,238941
18927,0.006008,172.31.47.0-255,66,75401,92,238941
18928,0.006058,172.217.26.0-255,1484,76885,92,238941
18929,0.007978,172.217.26.0-255,4320,81205,92,238941
18930,0.007985,172.31.47.0-255,66,81271,92,238941
18931,0.009942,172.217.26.0-255,5738,87009,92,238941
18932,0.009948,172.31.47.0-255,66,87075,92,238941
18933,0.011911,172.217.26.0-255,5738,92813,92,238941
18934,0.011917,172.31.47.0-255,66,92879,92,238941
18935,0.013863,172.217.26.0-255,5738,98617,92,238941
18936,0.013871,172.31.47.0-255,66,98683,92,238941
18937,0.015834,172.217.26.0-255,5738,104421,92,238941
18938,0.015843,172.31.47.0-255,66,104487,92,238941
18939,0.017787,172.217.26.0-255,5738,110225,92,238941
18940,0.017793,172.31.47.0-255,66,110291,92,238941
18941,0.019765,172.217.26.0-255,5738,116029,92,238941
18942,0.019771,172.31.47.0-255,66,116095,92,238941
18943,0.021728,172.217.26.0-255,5738,121833,92,238941
18944,0.02174,172.31.47.0-255,66,121899,92,238941
18945,0.023697,172.217.26.0-255,5738,127637,92,238941
18946,0.023708,172.31.47.0-255,66,127703,92,238941
18947,0.025646,172.31.47.0-255,172,127875,92,238941
18948,0.025659,172.217.26.0-255,5738,133613,92,238941
18949,0.025671,172.31.47.0-255,66,133679,92,238941
18950,0.025736,172.31.47.0-255,1106,134785,92,238941
18951,0.025816,172.31.47.0-255,1514,136299,92,238941
18952,0.025818,172.31.47.0-255,1514,137813,92,238941
18953,0.025818,172.31.47.0-255,1514,139327,92,238941
18954,0.025819,172.31.47.0-255,1514,140841,92,238941
18955,0.02582,172.31.47.0-255,1500,142341,92,238941
18956,0.02723,104.244.42.0-255,66,142407,92,238941
18957,0.027326,104.244.42.0-255,66,142473,92,238941
18958,0.02742,104.244.42.0-255,66,142539,92,238941
18959,0.027624,172.217.26.0-255,5738,148277,92,238941
18960,0.02763,172.31.47.0-255,66,148343,92,238941
18961,0.028346,104.244.42.0-255,108,148451,92,238941
18962,0.028352,172.31.47.0-255,66,148517,92,238941
18963,0.029573,172.217.26.0-255,5738,154255,92,238941
18964,0.029578,172.31.47.0-255,66,154321,92,238941
18965,0.031533,172.217.26.0-255,5738,160059,92,238941
18966,0.03154,172.31.47.0-255,66,160125,92,238941
18967,0.033488,172.217.26.0-255,5738,165863,92,238941
18968,0.033494,172.31.47.0-255,66,165929,92,238941
18969,0.035439,172.217.26.0-255,5738,171667,92,238941
18970,0.035445,172.31.47.0-255,66,171733,92,238941
18971,0.037401,172.217.26.0-255,5738,177471,92,238941
18972,0.037405,172.31.47.0-255,66,177537,92,238941
18973,0.039346,172.217.26.0-255,5738,183275,92,238941
18974,0.039351,172.31.47.0-255,66,183341,92,238941
18975,0.041325,172.217.26.0-255,5738,189079,92,238941
18976,0.041331,172.31.47.0-255,66,189145,92,238941
18977,0.043284,172.217.26.0-255,4320,193465,92,238941
18978,0.043289,172.31.47.0-255,66,193531,92,238941
18979,0.04332,172.217.26.0-255,1484,195015,92,238941
18980,0.045229,172.217.26.0-255,4320,199335,92,238941
18981,0.045234,172.31.47.0-255,66,199401,92,238941
18982,0.04717,172.217.26.0-255,2902,202303,92,238941
18983,0.047176,172.31.47.0-255,66,202369,92,238941
18984,0.047208,172.217.26.0-255,2902,205271,92,238941
18985,0.047212,172.31.47.0-255,66,205337,92,238941
18986,0.049112,172.217.26.0-255,2902,208239,92,238941
18987,0.049117,172.31.47.0-255,66,208305,92,238941
18988,0.049146,172.217.26.0-255,2902,211207,92,238941
18989,0.049149,172.31.47.0-255,66,211273,92,238941
18990,0.051074,172.217.26.0-255,4320,215593,92,238941
18991,0.051079,172.31.47.0-255,66,215659,92,238941
18992,0.051113,172.217.26.0-255,1484,217143,92,238941
18993,0.053076,172.217.26.0-255,4320,221463,92,238941
18994,0.053095,172.31.47.0-255,66,221529,92,238941
18995,0.055058,172.217.26.0-255,5738,227267,92,238941
18996,0.055072,172.31.47.0-255,66,227333,92,238941
18997,0.057027,172.217.26.0-255,5738,233071,92,238941
18998,0.057038,172.31.47.0-255,66,233137,92,238941
18999,0.058985,172.217.26.0-255,5738,238875,92,238941
19000,0.058991,172.31.47.0-255,66,238941,92,238941
19001,0.0,216.58.221.0-255,153,153,92,224430
19002,3e-05,172.31.47.0-255,66,219,92,224430
19003,3.7e-05,216.58.221.0-255,1484,1703,92,224430
19004,4e-05,172.31.47.0-255,66,1769,92,224430
19005,5.3e-05,216.58.221.0-255,2902,4671,92,224430
19006,5.6e-05,172.31.47.0-255,66,4737,92,224430
19007,9.9e-05,216.58.221.0-255,7156,11893,92,224430
19008,0.000102,172.31.47.0-255,66,11959,92,224430
19009,0.000257,216.58.221.0-255,2148,14107,92,224430
19010,0.000262,172.31.47.0-255,66,14173,92,224430
19011,0.000307,216.58.221.0-255,4320,18493,92,224430
19012,0.000311,172.31.47.0-255,66,18559,92,224430
19013,0.000338,216.58.221.0-255,7156,25715,92,224430
19014,0.000342,172.31.47.0-255,66,25781,92,224430
19015,0.000564,216.58.221.0-255,2902,28683,92,224430
19016,0.000568,172.31.47.0-255,66,28749,92,224430
19017,0.000604,172.31.47.0-255,66,28815,92,224430
19018,0.000831,172.31.47.0-255,66,28881,92,224430
19019,0.00086,216.58.221.0-255,2543,31424,92,224430
19020,0.000863,172.31.47.0-255,66,31490,92,224430
19021,0.001093,172.31.47.0-255,66,31556,92,224430
19022,0.001129,172.31.47.0-255,66,31622,92,224430
19023,0.001435,216.58.221.0-255,356,31978,92,224430
19024,0.00144,172.31.47.0-255,66,32044,92,224430
19025,0.001457,216.58.221.0-255,1550,33594,92,224430
19026,0.00146,172.31.47.0-255,66,33660,92,224430
19027,0.001491,216.58.221.0-255,4320,37980,92,224430
19028,0.001494,172.31.47.0-255,66,38046,92,224430
19029,0.001598,216.58.221.0-255,1484,39530,92,224430
19030,0.001818,216.58.221.0-255,2902,42432,92,224430
19031,0.002295,216.58.221.0-255,2902,45334,92,224430
19032,0.003,216.58.221.0-255,4320,49654,92,224430
19033,0.003756,172.31.47.0-255,66,49720,92,224430
19034,0.005648,216.58.221.0-255,5738,55458,92,224430
19035,0.005654,172.31.47.0-255,66,55524,92,224430
19036,0.007547,216.58.221.0-255,5738,61262,92,224430
19037,0.007553,172.31.47.0-255,66,61328,92,224430
19038,0.00945,216.58.221.0-255,5738,67066,92,224430
19039,0.009457,172.31.47.0-255,66,67132,92,224430
19040,0.011352,216.58.221.0-255,5738,72870,92,224430
19041,0.011803,172.31.47.0-255,66,72936,92,224430
19042,0.013704,216.58.221.0-255,5738,78674,92,224430
19043,0.013714,172.31.47.0-255,66,78740,92,224430
19044,0.015604,216.58.221.0-255,5738,84478,92,224430
19045,0.01561,172.31.47.0-255,66,84544,92,224430
19046,0.017509,216.58.221.0-255,5738,90282,92,224430
19047,0.017517,172.31.47.0-255,66,90348,92,224430
19048,0.019417,216.58.221.0-255,5738,96086,92,224430
19049,0.019426,172.31.47.0-255,66,96152,92,224430
19050,0.021316,216.58.221.0-255,5738,101890,92,224430
19051,0.021324,172.31.47.0-255,66,101956,92,224430
19052,0.023218,216.58.221.0-255,4320,106276,92,224430
19053,0.023225,172.31.47.0-255,66,106342,92,224430
19054,0.023252,216.58.221.0-255,1484,107826,92,224430
19055,0.02512,216.58.221.0-255,4320,112146,92,224430
19056,0.025127,172.31.47.0-255,66,112212,92,224430
19057,0.027006,216.58.221.0-255,1484,113696,92,224430
19058,0.027026,216.58.221.0-255,4320,118016,92,224430
19059,0.027049,172.31.47.0-255,66,118082,92,224430
19060,0.028488,172.31.47.0-255,172,118254,92,224430
19061,0.028524,172.31.47.0-255,1103,119357,92,224430
19062,0.028583,172.31.47.0-255,1514,120871,92,224430
19063,0.028584,172.31.47.0-255,1514,122385,92,224430
19064,0.028585,172.31.47.0-255,1514,123899,92,224430
19065,0.028586,172.31.47.0-255,1514,125413,92,224430
19066,0.028587,172.31.47.0-255,1503,126916,92,224430
19067,0.028939,216.58.221.0-255,5738,132654,92,224430
19068,0.028945,172.31.47.0-255,66,132720,92,224430
19069,0.030053,104.244.42.0-255,66,132786,92,224430
19070,0.03006,104.244.42.0-255,66,132852,92,224430
19071,0.030163,104.244.42.0-255,66,132918,92,224430
19072,0.030846,216.58.221.0-255,5738,138656,92,224430
19073,0.030854,172.31.47.0-255,66,138722,92,224430
19074,0.032764,216.58.221.0-255,5738,144460,92,224430
19075,0.032784,172.31.47.0-255,66,144526,92,224430
19076,0.034702,216.58.221.0-255,5738,150264,92,224430
19077,0.034719,172.31.47.0-255,66,150330,92,224430
19078,0.036629,216.58.221.0-255,5738,156068,92,224430
19079,0.036644,172.31.47.0-255,66,156134,92,224430
19080,0.0386,216.58.221.0-255,5738,161872,92,224430
19081,0.038616,172.31.47.0-255,66,161938,92,224430
19082,0.040521,216.58.221.0-255,5738,167676,92,224430
19083,0.040534,172.31.47.0-255,66,167742,92,224430
19084,0.042439,216.58.221.0-255,5738,173480,92,224430
19085,0.042452,172.31.47.0-255,66,173546,92,224430
19086,0.044362,216.58.221.0-255,5738,179284,92,224430
19087,0.044376,172.31.47.0-255,66,179350,92,224430
19088,0.046307,216.58.221.0-255,5738,185088,92,224430
19089,0.046323,172.31.47.0-255,66,185154,92,224430
19090,0.048262,216.58.221.0-255,4320,189474,92,224430
19091,0.048267,172.31.47.0-255,66,189540,92,224430
19092,0.048299,216.58.221.0-255,1484,191024,92,224430
19093,0.050174,216.58.221.0-255,4320,195344,92,224430
19094,0.050179,172.31.47.0-255,66,195410,92,224430
19095,0.052074,216.58.221.0-255,5738,201148,92,224430
19096,0.052121,172.31.47.0-255,66,201214,92,224430
19097,0.054012,216.58.221.0-255,5738,206952,92,224430
19098,0.054017,172.31.47.0-255,66,207018,92,224430
19099,0.055922,216.58.221.0-255,5738,212756,92,224430
19100,0.055926,172.31.47.0-255,66,212822,92,224430
19101,0.057818,216.58.221.0-255,5738,218560,92,224430
19102,0.057823,172.31.47.0-255,66,218626,92,224430
19103,0.059717,216.58.221.0-255,5738,224364,92,224430
19104,0.059723,172.31.47.0-255,66,224430,92,224430
19105,0.0,74.125.24.0-255,152,152,92,315005
19106,2.9e-05,172.31.47.0-255,66,218,92,315005
19107,3.5e-05,74.125.24.0-255,1484,1702,92,315005
19108,3.9e-05,172.31.47.0-255,66,1768,92,315005
19109,4.3e-05,74.125.24.0-255,2902,4670,92,315005
19110,4.6e-05,172.31.47.0-255,66,4736,92,315005
19111,6e-05,74.125.24.0-255,7156,11892,92,315005
19112,6.3e-05,172.31.47.0-255,66,11958,92,315005
19113,6.6e-05,74.125.24.0-255,2176,14134,92,315005
19114,6.9e-05,172.31.47.0-255,66,14200,92,315005
19115,0.000101,74.125.24.0-255,7156,21356,92,315005
19116,0.000104,172.31.47.0-255,66,21422,92,315005
19117,0.000128,74.125.24.0-255,4320,25742,92,315005
19118,0.000131,172.31.47.0-255,66,25808,92,315005
19119,0.000137,74.125.24.0-255,5379,31187,92,315005
19120,0.000139,172.31.47.0-255,66,31253,92,315005
19121,0.000186,74.125.24.0-255,1484,32737,92,315005
19122,0.000189,172.31.47.0-255,66,32803,92,315005
19123,0.000194,74.125.24.0-255,2902,35705,92,315005
19124,0.000196,172.31.47.0-255,66,35771,92,315005
19125,0.000218,74.125.24.0-255,5738,41509,92,315005
19126,0.000221,172.31.47.0-255,66,41575,92,315005
19127,0.000224,74.125.24.0-255,1484,43059,92,315005
19128,0.000226,172.31.47.0-255,66,43125,92,315005
19129,0.000255,172.31.47.0-255,66,43191,92,315005
19130,0.00026,74.125.24.0-255,4320,47511,92,315005
19131,0.000264,172.31.47.0-255,66,47577,92,315005
19132,0.000296,74.125.24.0-255,6438,54015,92,315005
19133,0.0003,172.31.47.0-255,66,54081,92,315005
19134,0.000302,74.125.24.0-255,425,54506,92,315005
19135,0.000304,172.31.47.0-255,66,54572,92,315005
19136,0.000359,74.125.24.0-255,1484,56056,92,315005
19137,0.000365,74.125.24.0-255,2902,58958,92,315005
19138,0.000368,172.31.47.0-255,66,59024,92,315005
19139,0.000378,74.125.24.0-255,1484,60508,92,315005
19140,0.000395,74.125.24.0-255,4320,64828,92,315005
19141,0.000399,172.31.47.0-255,66,64894,92,315005
19142,0.000401,74.125.24.0-255,1484,66378,92,315005
19143,0.000427,74.125.24.0-255,5082,71460,92,315005
19144,0.000429,172.31.47.0-255,66,71526,92,315005
19145,0.000843,74.125.24.0-255,1484,73010,92,315005
19146,0.000849,74.125.24.0-255,2902,75912,92,315005
19147,0.000853,172.31.47.0-255,66,75978,92,315005
19148,0.000857,74.125.24.0-255,2902,78880,92,315005
19149,0.000859,172.31.47.0-255,66,78946,92,315005
19150,0.00088,74.125.24.0-255,2902,81848,92,315005
19151,0.000883,172.31.47.0-255,66,81914,92,315005
19152,0.000889,74.125.24.0-255,7156,89070,92,315005
19153,0.000891,172.31.47.0-255,66,89136,92,315005
19154,0.000915,74.125.24.0-255,5738,94874,92,315005
19155,0.000917,172.31.47.0-255,66,94940,92,315005
19156,0.000941,74.125.24.0-255,2902,97842,92,315005
19157,0.000943,172.31.47.0-255,66,97908,92,315005
19158,0.000976,172.31.47.0-255,66,97974,92,315005
19159,0.001303,74.125.24.0-255,1484,99458,92,315005
19160,0.00132,74.125.24.0-255,2902,102360,92,315005
19161,0.001323,172.31.47.0-255,66,102426,92,315005
19162,0.001335,74.125.24.0-255,4320,106746,92,315005
19163,0.001341,172.31.47.0-255,66,106812,92,315005
19164,0.001344,74.125.24.0-255,2902,109714,92,315005
19165,0.001346,172.31.47.0-255,66,109780,92,315005
19166,0.001367,74.125.24.0-255,5738,115518,92,315005
19167,0.001369,172.31.47.0-255,66,115584,92,315005
19168,0.001374,74.125.24.0-255,7156,122740,92,315005
19169,0.001376,172.31.47.0-255,66,122806,92,315005
19170,0.0014,74.125.24.0-255,5738,128544,92,315005
19171,0.001402,172.31.47.0-255,66,128610,92,315005
19172,0.001414,74.125.24.0-255,1484,130094,92,315005
19173,0.00143,74.125.24.0-255,2184,132278,92,315005
19174,0.001432,172.31.47.0-255,66,132344,92,315005
19175,0.001463,74.125.24.0-255,1484,133828,92,315005
19176,0.001473,74.125.24.0-255,2902,136730,92,315005
19177,0.001475,172.31.47.0-255,66,136796,92,315005
19178,0.001486,74.125.24.0-255,1484,138280,92,315005
19179,0.0015,74.125.24.0-255,4320,142600,92,315005
19180,0.001502,172.31.47.0-255,66,142666,92,315005
19181,0.001524,74.125.24.0-255,4320,146986,92,315005
19182,0.001526,172.31.47.0-255,66,147052,92,315005
19183,0.001556,172.31.47.0-255,66,147118,92,315005
19184,0.001568,74.125.24.0-255,2902,150020,92,315005
19185,0.001569,172.31.47.0-255,66,150086,92,315005
19186,0.001598,172.31.47.0-255,66,150152,92,315005
19187,0.001625,74.125.24.0-255,1484,151636,92,315005
19188,0.001635,74.125.24.0-255,1484,153120,92,315005
19189,0.001636,172.31.47.0-255,66,153186,92,315005
19190,0.001663,74.125.24.0-255,1484,154670,92,315005
19191,0.001669,74.125.24.0-255,5738,160408,92,315005
19192,0.00167,172.31.47.0-255,66,160474,92,315005
19193,0.001675,74.125.24.0-255,4320,164794,92,315005
19194,0.001676,172.31.47.0-255,66,164860,92,315005
19195,0.001697,74.125.24.0-255,2902,167762,92,315005
19196,0.001699,172.31.47.0-255,66,167828,92,315005
19197,0.001707,172.31.47.0-255,66,167894,92,315005
19198,0.001766,172.31.47.0-255,66,167960,92,315005
19199,0.004106,74.125.24.0-255,5738,173698,92,315005
19200,0.004108,172.31.47.0-255,66,173764,92,315005
19201,0.006454,74.125.24.0-255,5738,179502,92,315005
19202,0.006461,172.31.47.0-255,66,179568,92,315005
19203,0.008779,74.125.24.0-255,5738,185306,92,315005
19204,0.008785,172.31.47.0-255,66,185372,92,315005
19205,0.011121,74.125.24.0-255,5738,191110,92,315005
19206,0.011127,172.31.47.0-255,66,191176,92,315005
19207,0.013469,74.125.24.0-255,5738,196914,92,315005
19208,0.013477,172.31.47.0-255,66,196980,92,315005
19209,0.015846,74.125.24.0-255,5738,202718,92,315005
19210,0.015854,172.31.47.0-255,66,202784,92,315005
19211,0.018208,74.125.24.0-255,5738,208522,92,315005
19212,0.018226,172.31.47.0-255,66,208588,92,315005
19213,0.020592,74.125.24.0-255,5738,214326,92,315005
19214,0.020606,172.31.47.0-255,66,214392,92,315005
19215,0.022953,74.125.24.0-255,5738,220130,92,315005
19216,0.022971,172.31.47.0-255,66,220196,92,315005
19217,0.025323,74.125.24.0-255,5738,225934,92,315005
19218,0.025329,172.31.47.0-255,66,226000,92,315005
19219,0.027685,74.125.24.0-255,5738,231738,92,315005
19220,0.027699,172.31.47.0-255,66,231804,92,315005
19221,0.030032,74.125.24.0-255,5738,237542,92,315005
19222,0.030039,172.31.47.0-255,66,237608,92,315005
19223,0.032379,74.125.24.0-255,5738,243346,92,315005
19224,0.032387,172.31.47.0-255,66,243412,92,315005
19225,0.034753,74.125.24.0-255,5738,249150,92,315005
19226,0.034771,172.31.47.0-255,66,249216,92,315005
19227,0.037112,74.125.24.0-255,5738,254954,92,315005
19228,0.03712,172.31.47.0-255,66,255020,92,315005
19229,0.039473,74.125.24.0-255,5738,260758,92,315005
19230,0.039492,172.31.47.0-255,66,260824,92,315005
19231,0.041812,74.125.24.0-255,5738,266562,92,315005
19232,0.041837,172.31.47.0-255,66,266628,92,315005
19233,0.044192,74.125.24.0-255,5738,272366,92,315005
19234,0.044201,172.31.47.0-255,66,272432,92,315005
19235,0.046561,74.125.24.0-255,5738,278170,92,315005
19236,0.04658,172.31.47.0-255,66,278236,92,315005
19237,0.048907,74.125.24.0-255,5738,283974,92,315005
19238,0.048914,172.31.47.0-255,66,284040,92,315005
19239,0.049082,172.31.47.0-255,172,284212,92,315005
19240,0.049108,172.31.47.0-255,1103,285315,92,315005
19241,0.04916,172.31.47.0-255,1514,286829,92,315005
19242,0.049162,172.31.47.0-255,1514,288343,92,315005
19243,0.049163,172.31.47.0-255,1514,289857,92,315005
19244,0.049164,172.31.47.0-255,1514,291371,92,315005
19245,0.049188,172.31.47.0-255,1506,292877,92,315005
19246,0.05065,104.244.42.0-255,66,292943,92,315005
19247,0.050657,104.244.42.0-255,66,293009,92,315005
19248,0.050737,104.244.42.0-255,66,293075,92,315005
19249,0.050742,104.244.42.0-255,66,293141,92,315005
19250,0.051246,74.125.24.0-255,4320,297461,92,315005
19251,0.051252,172.31.47.0-255,66,297527,92,315005
19252,0.051277,74.125.24.0-255,1484,299011,92,315005
19253,0.053605,74.125.24.0-255,4320,303331,92,315005
19254,0.053621,172.31.47.0-255,66,303397,92,315005
19255,0.055941,74.125.24.0-255,5738,309135,92,315005
19256,0.055947,172.31.47.0-255,66,309201,92,315005
19257,0.058301,74.125.24.0-255,5738,314939,92,315005
19258,0.058319,172.31.47.0-255,66,315005,92,315005
19259,0.0,172.31.47.0-255,105,105,92,105
19260,0.0,172.217.194.0-255,152,152,92,255295
19261,1.6e-05,172.31.47.0-255,66,218,92,255295
19262,2.3e-05,172.217.194.0-255,1484,1702,92,255295
19263,2.8e-05,172.31.47.0-255,66,1768,92,255295
19264,3.3e-05,172.217.194.0-255,2902,4670,92,255295
19265,3.5e-05,172.31.47.0-255,66,4736,92,255295
19266,4.1e-05,172.217.194.0-255,7156,11892,92,255295
19267,4.4e-05,172.31.47.0-255,66,11958,92,255295
19268,4.7e-05,172.217.194.0-255,2022,13980,92,255295
19269,4.9e-05,172.31.47.0-255,66,14046,92,255295
19270,9.7e-05,172.217.194.0-255,4320,18366,92,255295
19271,0.0001,172.31.47.0-255,66,18432,92,255295
19272,0.000117,172.217.194.0-255,2902,21334,92,255295
19273,0.000119,172.31.47.0-255,66,21400,92,255295
19274,0.000129,172.31.47.0-255,66,21466,92,255295
19275,0.000143,172.217.194.0-255,1125,22591,92,255295
19276,0.000144,172.31.47.0-255,66,22657,92,255295
19277,0.000202,172.217.194.0-255,1484,24141,92,255295
19278,0.000205,172.31.47.0-255,66,24207,92,255295
19279,0.000221,172.217.194.0-255,2902,27109,92,255295
19280,0.000223,172.31.47.0-255,66,27175,92,255295
19281,0.000227,172.217.194.0-255,2902,30077,92,255295
19282,0.000228,172.31.47.0-255,66,30143,92,255295
19283,0.00025,172.217.194.0-255,2902,33045,92,255295
19284,0.000252,172.31.47.0-255,66,33111,92,255295
19285,0.000255,172.217.194.0-255,1484,34595,92,255295
19286,0.000256,172.31.47.0-255,66,34661,92,255295
19287,0.000275,172.217.194.0-255,5379,40040,92,255295
19288,0.000277,172.31.47.0-255,66,40106,92,255295
19289,0.000334,172.217.194.0-255,1484,41590,92,255295
19290,0.000336,172.31.47.0-255,66,41656,92,255295
19291,0.000352,172.217.194.0-255,2902,44558,92,255295
19292,0.000354,172.31.47.0-255,66,44624,92,255295
19293,0.000357,172.217.194.0-255,1484,46108,92,255295
19294,0.000359,172.31.47.0-255,66,46174,92,255295
19295,0.000364,172.217.194.0-255,4320,50494,92,255295
19296,0.000366,172.31.47.0-255,66,50560,92,255295
19297,0.000378,172.217.194.0-255,1484,52044,92,255295
19298,0.000379,172.31.47.0-255,66,52110,92,255295
19299,0.000401,172.217.194.0-255,2902,55012,92,255295
19300,0.000403,172.31.47.0-255,66,55078,92,255295
19301,0.00042,172.217.194.0-255,2543,57621,92,255295
19302,0.000422,172.31.47.0-255,66,57687,92,255295
19303,0.000851,172.217.194.0-255,646,58333,92,255295
19304,0.000856,172.31.47.0-255,66,58399,92,255295
19305,0.001176,172.217.194.0-255,1484,59883,92,255295
19306,0.001182,172.217.194.0-255,2902,62785,92,255295
19307,0.001186,172.31.47.0-255,66,62851,92,255295
19308,0.00119,172.217.194.0-255,1484,64335,92,255295
19309,0.001208,172.217.194.0-255,4320,68655,92,255295
19310,0.001211,172.31.47.0-255,66,68721,92,255295
19311,0.001237,172.31.47.0-255,66,68787,92,255295
19312,0.001244,172.217.194.0-255,5738,74525,92,255295
19313,0.001246,172.31.47.0-255,66,74591,92,255295
19314,0.00127,172.217.194.0-255,6438,81029,92,255295
19315,0.001293,172.31.47.0-255,66,81095,92,255295
19316,0.001694,172.217.194.0-255,1484,82579,92,255295
19317,0.0017,172.217.194.0-255,2902,85481,92,255295
19318,0.001703,172.31.47.0-255,66,85547,92,255295
19319,0.001721,172.217.194.0-255,2902,88449,92,255295
19320,0.001723,172.31.47.0-255,66,88515,92,255295
19321,0.001743,172.217.194.0-255,2902,91417,92,255295
19322,0.001745,172.31.47.0-255,66,91483,92,255295
19323,0.001769,172.217.194.0-255,1484,92967,92,255295
19324,0.001783,172.217.194.0-255,5738,98705,92,255295
19325,0.001785,172.31.47.0-255,66,98771,92,255295
19326,0.001796,172.31.47.0-255,66,98837,92,255295
19327,0.001799,172.217.194.0-255,2184,101021,92,255295
19328,0.0018,172.31.47.0-255,66,101087,92,255295
19329,0.002014,172.217.194.0-255,1484,102571,92,255295
19330,0.002019,172.217.194.0-255,2902,105473,92,255295
19331,0.002021,172.31.47.0-255,66,105539,92,255295
19332,0.002024,172.217.194.0-255,1484,107023,92,255295
19333,0.002043,172.217.194.0-255,4320,111343,92,255295
19334,0.002045,172.31.47.0-255,66,111409,92,255295
19335,0.002071,172.31.47.0-255,66,111475,92,255295
19336,0.002073,172.217.194.0-255,1484,112959,92,255295
19337,0.002097,172.31.47.0-255,66,113025,92,255295
19338,0.004438,172.217.194.0-255,5738,118763,92,255295
19339,0.004445,172.31.47.0-255,66,118829,92,255295
19340,0.006793,172.217.194.0-255,5738,124567,92,255295
19341,0.0068,172.31.47.0-255,66,124633,92,255295
19342,0.00911,172.217.194.0-255,5738,130371,92,255295
19343,0.009118,172.31.47.0-255,66,130437,92,255295
19344,0.011432,172.217.194.0-255,4320,134757,92,255295
19345,0.011439,172.31.47.0-255,66,134823,92,255295
19346,0.011455,172.217.194.0-255,1484,136307,92,255295
19347,0.013802,172.217.194.0-255,4320,140627,92,255295
19348,0.013811,172.31.47.0-255,66,140693,92,255295
19349,0.016156,172.217.194.0-255,5738,146431,92,255295
19350,0.016163,172.31.47.0-255,66,146497,92,255295
19351,0.018507,172.217.194.0-255,4320,150817,92,255295
19352,0.018513,172.31.47.0-255,66,150883,92,255295
19353,0.018531,172.217.194.0-255,1484,152367,92,255295
19354,0.020819,172.217.194.0-255,4320,156687,92,255295
19355,0.020824,172.31.47.0-255,66,156753,92,255295
19356,0.023181,172.217.194.0-255,5738,162491,92,255295
19357,0.023187,172.31.47.0-255,66,162557,92,255295
19358,0.025533,172.217.194.0-255,5738,168295,92,255295
19359,0.025542,172.31.47.0-255,66,168361,92,255295
19360,0.027876,172.217.194.0-255,5738,174099,92,255295
19361,0.027884,172.31.47.0-255,66,174165,92,255295
19362,0.028283,172.31.47.0-255,172,174337,92,255295
19363,0.028329,172.31.47.0-255,1112,175449,92,255295
19364,0.028413,172.31.47.0-255,1514,176963,92,255295
19365,0.028416,172.31.47.0-255,1514,178477,92,255295
19366,0.028417,172.31.47.0-255,1514,179991,92,255295
19367,0.028418,172.31.47.0-255,1514,181505,92,255295
19368,0.028445,172.31.47.0-255,1494,182999,92,255295
19369,0.029883,104.244.42.0-255,66,183065,92,255295
19370,0.029892,104.244.42.0-255,66,183131,92,255295
19371,0.030026,104.244.42.0-255,66,183197,92,255295
19372,0.030194,172.217.194.0-255,2902,186099,92,255295
19373,0.0302,172.31.47.0-255,66,186165,92,255295
19374,0.03022,172.217.194.0-255,2902,189067,92,255295
19375,0.030222,172.31.47.0-255,66,189133,92,255295
19376,0.030871,104.244.42.0-255,108,189241,92,255295
19377,0.030878,172.31.47.0-255,66,189307,92,255295
19378,0.032541,172.217.194.0-255,2902,192209,92,255295
19379,0.032548,172.31.47.0-255,66,192275,92,255295
19380,0.032573,172.217.194.0-255,2902,195177,92,255295
19381,0.032576,172.31.47.0-255,66,195243,92,255295
19382,0.034912,172.217.194.0-255,5738,200981,92,255295
19383,0.034921,172.31.47.0-255,66,201047,92,255295
19384,0.037263,172.217.194.0-255,5738,206785,92,255295
19385,0.037269,172.31.47.0-255,66,206851,92,255295
19386,0.039598,172.217.194.0-255,2902,209753,92,255295
19387,0.039604,172.31.47.0-255,66,209819,92,255295
19388,0.039635,172.217.194.0-255,2902,212721,92,255295
19389,0.039638,172.31.47.0-255,66,212787,92,255295
19390,0.041947,172.217.194.0-255,4320,217107,92,255295
19391,0.041951,172.31.47.0-255,66,217173,92,255295
19392,0.04198,172.217.194.0-255,1484,218657,92,255295
19393,0.04428,172.217.194.0-255,2902,221559,92,255295
19394,0.044285,172.31.47.0-255,66,221625,92,255295
19395,0.044315,172.217.194.0-255,1484,223109,92,255295
19396,0.046642,172.217.194.0-255,4320,227429,92,255295
19397,0.046648,172.31.47.0-255,66,227495,92,255295
19398,0.048991,172.217.194.0-255,4320,231815,92,255295
19399,0.048996,172.31.47.0-255,66,231881,92,255295
19400,0.049014,172.217.194.0-255,1484,233365,92,255295
19401,0.051349,172.217.194.0-255,4320,237685,92,255295
19402,0.051356,172.31.47.0-255,66,237751,92,255295
19403,0.053689,172.217.194.0-255,5738,243489,92,255295
19404,0.053694,172.31.47.0-255,66,243555,92,255295
19405,0.056017,172.217.194.0-255,5738,249293,92,255295
19406,0.056022,172.31.47.0-255,66,249359,92,255295
19407,0.058345,172.217.194.0-255,2902,252261,92,255295
19408,0.058351,172.31.47.0-255,66,252327,92,255295
19409,0.058377,172.217.194.0-255,2902,255229,92,255295
19410,0.05838,172.31.47.0-255,66,255295,92,255295
19411,0.0,74.125.24.0-255,153,153,92,173829
19412,3.5e-05,172.31.47.0-255,66,219,92,173829
19413,4.2e-05,74.125.24.0-255,1484,1703,92,173829
19414,4.7e-05,172.31.47.0-255,66,1769,92,173829
19415,5.1e-05,74.125.24.0-255,2902,4671,92,173829
19416,5.4e-05,172.31.47.0-255,66,4737,92,173829
19417,6.1e-05,74.125.24.0-255,5738,10475,92,173829
19418,6.3e-05,172.31.47.0-255,66,10541,92,173829
19419,9.7e-05,74.125.24.0-255,3545,14086,92,173829
19420,0.0001,172.31.47.0-255,66,14152,92,173829
19421,0.000133,74.125.24.0-255,4320,18472,92,173829
19422,0.000136,172.31.47.0-255,66,18538,92,173829
19423,0.00014,74.125.24.0-255,4320,22858,92,173829
19424,0.000142,172.31.47.0-255,66,22924,92,173829
19425,0.000153,74.125.24.0-255,1484,24408,92,173829
19426,0.000155,172.31.47.0-255,66,24474,92,173829
19427,0.000175,74.125.24.0-255,4320,28794,92,173829
19428,0.000177,172.31.47.0-255,66,28860,92,173829
19429,0.000184,74.125.24.0-255,2902,31762,92,173829
19430,0.000186,172.31.47.0-255,66,31828,92,173829
19431,0.000213,172.31.47.0-255,66,31894,92,173829
19432,0.00022,74.125.24.0-255,7156,39050,92,173829
19433,0.000223,172.31.47.0-255,66,39116,92,173829
19434,0.000242,74.125.24.0-255,766,39882,92,173829
19435,0.000245,172.31.47.0-255,66,39948,92,173829
19436,0.000497,74.125.24.0-255,1484,41432,92,173829
19437,0.000503,74.125.24.0-255,2902,44334,92,173829
19438,0.000504,172.31.47.0-255,66,44400,92,173829
19439,0.000509,172.31.47.0-255,66,44466,92,173829
19440,0.00053,74.125.24.0-255,5738,50204,92,173829
19441,0.000534,172.31.47.0-255,66,50270,92,173829
19442,0.000556,74.125.24.0-255,2902,53172,92,173829
19443,0.000559,172.31.47.0-255,66,53238,92,173829
19444,0.000575,74.125.24.0-255,4273,57511,92,173829
19445,0.000578,172.31.47.0-255,66,57577,92,173829
19446,0.000712,74.125.24.0-255,109,57686,92,173829
19447,0.00075,74.125.24.0-255,1484,59170,92,173829
19448,0.000754,172.31.47.0-255,66,59236,92,173829
19449,0.000759,74.125.24.0-255,2902,62138,92,173829
19450,0.000761,172.31.47.0-255,66,62204,92,173829
19451,0.000791,74.125.24.0-255,7156,69360,92,173829
19452,0.000794,172.31.47.0-255,66,69426,92,173829
19453,0.000819,172.31.47.0-255,66,69492,92,173829
19454,0.000849,74.125.24.0-255,7156,76648,92,173829
19455,0.000852,172.31.47.0-255,66,76714,92,173829
19456,0.000856,74.125.24.0-255,2902,79616,92,173829
19457,0.000858,172.31.47.0-255,66,79682,92,173829
19458,0.000863,74.125.24.0-255,2902,82584,92,173829
19459,0.000865,172.31.47.0-255,66,82650,92,173829
19460,0.000887,74.125.24.0-255,766,83416,92,173829
19461,0.001114,172.31.47.0-255,66,83482,92,173829
19462,0.001433,74.125.24.0-255,1484,84966,92,173829
19463,0.001442,74.125.24.0-255,2902,87868,92,173829
19464,0.001445,172.31.47.0-255,66,87934,92,173829
19465,0.00145,74.125.24.0-255,2902,90836,92,173829
19466,0.001452,172.31.47.0-255,66,90902,92,173829
19467,0.001468,74.125.24.0-255,2902,93804,92,173829
19468,0.00147,172.31.47.0-255,66,93870,92,173829
19469,0.001473,74.125.24.0-255,1484,95354,92,173829
19470,0.001492,172.31.47.0-255,66,95420,92,173829
19471,0.001549,172.31.47.0-255,66,95486,92,173829
19472,0.001754,74.125.24.0-255,1484,96970,92,173829
19473,0.00176,74.125.24.0-255,2902,99872,92,173829
19474,0.001763,172.31.47.0-255,66,99938,92,173829
19475,0.001782,74.125.24.0-255,5738,105676,92,173829
19476,0.001783,172.31.47.0-255,66,105742,92,173829
19477,0.001807,172.31.47.0-255,66,105808,92,173829
19478,0.001825,74.125.24.0-255,4320,110128,92,173829
19479,0.001827,172.31.47.0-255,66,110194,92,173829
19480,0.001833,74.125.24.0-255,7156,117350,92,173829
19481,0.001834,172.31.47.0-255,66,117416,92,173829
19482,0.001861,74.125.24.0-255,4320,121736,92,173829
19483,0.001863,172.31.47.0-255,66,121802,92,173829
19484,0.001888,172.31.47.0-255,66,121868,92,173829
19485,0.001909,74.125.24.0-255,3602,125470,92,173829
19486,0.001911,172.31.47.0-255,66,125536,92,173829
19487,0.001925,74.125.24.0-255,1484,127020,92,173829
19488,0.001948,172.31.47.0-255,66,127086,92,173829
19489,0.001991,172.31.47.0-255,66,127152,92,173829
19490,0.002002,74.125.24.0-255,2902,130054,92,173829
19491,0.002004,172.31.47.0-255,66,130120,92,173829
19492,0.00203,172.31.47.0-255,66,130186,92,173829
19493,0.002039,74.125.24.0-255,2902,133088,92,173829
19494,0.002041,172.31.47.0-255,66,133154,92,173829
19495,0.002084,74.125.24.0-255,3602,136756,92,173829
19496,0.002086,172.31.47.0-255,66,136822,92,173829
19497,0.00213,172.31.47.0-255,66,136888,92,173829
19498,0.002154,172.31.47.0-255,66,136954,92,173829
19499,0.002212,74.125.24.0-255,4320,141274,92,173829
19500,0.002214,172.31.47.0-255,66,141340,92,173829
19501,0.002268,172.31.47.0-255,66,141406,92,173829
19502,0.002337,74.125.24.0-255,5738,147144,92,173829
19503,0.002339,172.31.47.0-255,66,147210,92,173829
19504,0.002371,172.31.47.0-255,66,147276,92,173829
19505,0.002415,74.125.24.0-255,4320,151596,92,173829
19506,0.002417,172.31.47.0-255,66,151662,92,173829
19507,0.002476,172.31.47.0-255,66,151728,92,173829
19508,0.002593,172.31.47.0-255,66,151794,92,173829
19509,0.002629,172.31.47.0-255,66,151860,92,173829
19510,0.002665,74.125.24.0-255,1484,153344,92,173829
19511,0.002672,74.125.24.0-255,7156,160500,92,173829
19512,0.002674,172.31.47.0-255,66,160566,92,173829
19513,0.002698,172.31.47.0-255,66,160632,92,173829
19514,0.002723,74.125.24.0-255,3691,164323,92,173829
19515,0.002725,172.31.47.0-255,66,164389,92,173829
19516,0.002728,74.125.24.0-255,105,164494,92,173829
19517,0.008846,172.31.47.0-255,66,164560,92,173829
19518,0.008874,172.31.47.0-255,105,164665,92,173829
19519,0.011102,74.125.24.0-255,66,164731,92,173829
19520,0.032788,172.31.47.0-255,172,164903,92,173829
19521,0.032814,172.31.47.0-255,1111,166014,92,173829
19522,0.032851,172.31.47.0-255,1514,167528,92,173829
19523,0.032853,172.31.47.0-255,1514,169042,92,173829
19524,0.032857,172.31.47.0-255,1514,170556,92,173829
19525,0.032858,172.31.47.0-255,1514,172070,92,173829
19526,0.032885,172.31.47.0-255,1495,173565,92,173829
19527,0.034328,104.244.42.0-255,66,173631,92,173829
19528,0.034365,104.244.42.0-255,66,173697,92,173829
19529,0.034399,104.244.42.0-255,66,173763,92,173829
19530,0.034425,104.244.42.0-255,66,173829,92,173829
19531,0.0,172.31.47.0-255,105,105,92,276
19532,0.001768,157.240.13.0-255,105,210,92,276
19533,0.001778,172.31.47.0-255,66,276,92,276
19534,0.0,172.31.47.0-255,233,233,92,299
19535,0.005804,172.217.194.0-255,66,299,92,299
19536,0.0,74.125.24.0-255,153,153,92,246905
19537,2.7e-05,172.31.47.0-255,66,219,92,246905
19538,3.5e-05,74.125.24.0-255,1484,1703,92,246905
19539,4e-05,172.31.47.0-255,66,1769,92,246905
19540,5.3e-05,74.125.24.0-255,2902,4671,92,246905
19541,5.6e-05,172.31.47.0-255,66,4737,92,246905
19542,6.5e-05,74.125.24.0-255,7156,11893,92,246905
19543,6.7e-05,172.31.47.0-255,66,11959,92,246905
19544,7.3e-05,74.125.24.0-255,4784,16743,92,246905
19545,7.6e-05,172.31.47.0-255,66,16809,92,246905
19546,9.1e-05,172.31.47.0-255,66,16875,92,246905
19547,0.000131,74.125.24.0-255,1484,18359,92,246905
19548,0.000134,172.31.47.0-255,66,18425,92,246905
19549,0.000138,74.125.24.0-255,1484,19909,92,246905
19550,0.00014,172.31.47.0-255,66,19975,92,246905
19551,0.000172,74.125.24.0-255,1484,21459,92,246905
19552,0.000175,172.31.47.0-255,66,21525,92,246905
19553,0.000182,74.125.24.0-255,5738,27263,92,246905
19554,0.000185,172.31.47.0-255,66,27329,92,246905
19555,0.000199,172.31.47.0-255,66,27395,92,246905
19556,0.000213,172.31.47.0-255,66,27461,92,246905
19557,0.000271,74.125.24.0-255,647,28108,92,246905
19558,0.000274,172.31.47.0-255,66,28174,92,246905
19559,0.000736,74.125.24.0-255,1484,29658,92,246905
19560,0.000741,74.125.24.0-255,2902,32560,92,246905
19561,0.000742,172.31.47.0-255,66,32626,92,246905
19562,0.000747,172.31.47.0-255,66,32692,92,246905
19563,0.000754,74.125.24.0-255,1484,34176,92,246905
19564,0.000762,172.31.47.0-255,66,34242,92,246905
19565,0.000787,74.125.24.0-255,4320,38562,92,246905
19566,0.000791,172.31.47.0-255,66,38628,92,246905
19567,0.000805,172.31.47.0-255,66,38694,92,246905
19568,0.000817,172.31.47.0-255,66,38760,92,246905
19569,0.001464,74.125.24.0-255,1484,40244,92,246905
19570,0.001475,74.125.24.0-255,2902,43146,92,246905
19571,0.001479,172.31.47.0-255,66,43212,92,246905
19572,0.001485,74.125.24.0-255,5738,48950,92,246905
19573,0.001487,172.31.47.0-255,66,49016,92,246905
19574,0.00153,172.31.47.0-255,66,49082,92,246905
19575,0.00154,172.31.47.0-255,66,49148,92,246905
19576,0.001547,74.125.24.0-255,766,49914,92,246905
19577,0.001643,74.125.24.0-255,1484,51398,92,246905
19578,0.001647,172.31.47.0-255,66,51464,92,246905
19579,0.001652,74.125.24.0-255,2902,54366,92,246905
19580,0.001653,172.31.47.0-255,66,54432,92,246905
19581,0.001657,74.125.24.0-255,2902,57334,92,246905
19582,0.001664,172.31.47.0-255,66,57400,92,246905
19583,0.001695,74.125.24.0-255,1484,58884,92,246905
19584,0.001705,172.31.47.0-255,66,58950,92,246905
19585,0.001708,74.125.24.0-255,1484,60434,92,246905
19586,0.001748,172.31.47.0-255,66,60500,92,246905
19587,0.00178,74.125.24.0-255,1484,61984,92,246905
19588,0.001795,74.125.24.0-255,2902,64886,92,246905
19589,0.0018,172.31.47.0-255,66,64952,92,246905
19590,0.001838,74.125.24.0-255,4320,69272,92,246905
19591,0.00184,172.31.47.0-255,66,69338,92,246905
19592,0.001859,74.125.24.0-255,1484,70822,92,246905
19593,0.001861,74.125.24.0-255,1484,72306,92,246905
19594,0.001863,172.31.47.0-255,66,72372,92,246905
19595,0.001871,172.31.47.0-255,66,72438,92,246905
19596,0.001886,172.31.47.0-255,66,72504,92,246905
19597,0.001926,74.125.24.0-255,1484,73988,92,246905
19598,0.001945,74.125.24.0-255,2902,76890,92,246905
19599,0.001947,172.31.47.0-255,66,76956,92,246905
19600,0.001952,74.125.24.0-255,5738,82694,92,246905
19601,0.001954,172.31.47.0-255,66,82760,92,246905
19602,0.001983,172.31.47.0-255,66,82826,92,246905
19603,0.002018,74.125.24.0-255,2902,85728,92,246905
19604,0.00202,172.31.47.0-255,66,85794,92,246905
19605,0.002053,172.31.47.0-255,66,85860,92,246905
19606,0.002072,74.125.24.0-255,1484,87344,92,246905
19607,0.002085,74.125.24.0-255,2902,90246,92,246905
19608,0.002086,172.31.47.0-255,66,90312,92,246905
19609,0.002089,74.125.24.0-255,1484,91796,92,246905
19610,0.00211,74.125.24.0-255,4320,96116,92,246905
19611,0.002112,172.31.47.0-255,66,96182,92,246905
19612,0.002118,74.125.24.0-255,7156,103338,92,246905
19613,0.00212,172.31.47.0-255,66,103404,92,246905
19614,0.002152,74.125.24.0-255,5738,109142,92,246905
19615,0.002154,172.31.47.0-255,66,109208,92,246905
19616,0.002165,74.125.24.0-255,1484,110692,92,246905
19617,0.00219,172.31.47.0-255,66,110758,92,246905
19618,0.002224,172.31.47.0-255,66,110824,92,246905
19619,0.002229,74.125.24.0-255,5738,116562,92,246905
19620,0.002231,172.31.47.0-255,66,116628,92,246905
19621,0.002253,74.125.24.0-255,1484,118112,92,246905
19622,0.002257,74.125.24.0-255,2902,121014,92,246905
19623,0.002258,172.31.47.0-255,66,121080,92,246905
19624,0.00229,172.31.47.0-255,66,121146,92,246905
19625,0.002292,74.125.24.0-255,1484,122630,92,246905
19626,0.002298,74.125.24.0-255,5738,128368,92,246905
19627,0.002307,172.31.47.0-255,66,128434,92,246905
19628,0.004548,74.125.24.0-255,5738,134172,92,246905
19629,0.004551,172.31.47.0-255,66,134238,92,246905
19630,0.006809,74.125.24.0-255,4320,138558,92,246905
19631,0.006813,172.31.47.0-255,66,138624,92,246905
19632,0.006836,74.125.24.0-255,1484,140108,92,246905
19633,0.009068,74.125.24.0-255,4320,144428,92,246905
19634,0.009074,172.31.47.0-255,66,144494,92,246905
19635,0.011309,74.125.24.0-255,5738,150232,92,246905
19636,0.011316,172.31.47.0-255,66,150298,92,246905
19637,0.013574,74.125.24.0-255,5738,156036,92,246905
19638,0.013586,172.31.47.0-255,66,156102,92,246905
19639,0.015857,74.125.24.0-255,5738,161840,92,246905
19640,0.015868,172.31.47.0-255,66,161906,92,246905
19641,0.018123,74.125.24.0-255,5738,167644,92,246905
19642,0.01813,172.31.47.0-255,66,167710,92,246905
19643,0.020393,74.125.24.0-255,5738,173448,92,246905
19644,0.020399,172.31.47.0-255,66,173514,92,246905
19645,0.022636,74.125.24.0-255,5738,179252,92,246905
19646,0.022642,172.31.47.0-255,66,179318,92,246905
19647,0.024909,74.125.24.0-255,5738,185056,92,246905
19648,0.024915,172.31.47.0-255,66,185122,92,246905
19649,0.027167,74.125.24.0-255,5738,190860,92,246905
19650,0.027173,172.31.47.0-255,66,190926,92,246905
19651,0.029427,74.125.24.0-255,5738,196664,92,246905
19652,0.029433,172.31.47.0-255,66,196730,92,246905
19653,0.031679,74.125.24.0-255,5738,202468,92,246905
19654,0.031686,172.31.47.0-255,66,202534,92,246905
19655,0.033009,172.31.47.0-255,172,202706,92,246905
19656,0.033037,172.31.47.0-255,1111,203817,92,246905
19657,0.033075,172.31.47.0-255,1514,205331,92,246905
19658,0.033076,172.31.47.0-255,1514,206845,92,246905
19659,0.033077,172.31.47.0-255,1514,208359,92,246905
19660,0.033078,172.31.47.0-255,1514,209873,92,246905
19661,0.033079,172.31.47.0-255,1497,211370,92,246905
19662,0.033945,74.125.24.0-255,5738,217108,92,246905
19663,0.033951,172.31.47.0-255,66,217174,92,246905
19664,0.034485,104.244.42.0-255,66,217240,92,246905
19665,0.034511,104.244.42.0-255,66,217306,92,246905
19666,0.03461,104.244.42.0-255,66,217372,92,246905
19667,0.036206,74.125.24.0-255,5738,223110,92,246905
19668,0.036211,172.31.47.0-255,66,223176,92,246905
19669,0.038452,74.125.24.0-255,5738,228914,92,246905
19670,0.038456,172.31.47.0-255,66,228980,92,246905
19671,0.040688,74.125.24.0-255,5738,234718,92,246905
19672,0.040694,172.31.47.0-255,66,234784,92,246905
19673,0.042939,74.125.24.0-255,5738,240522,92,246905
19674,0.042945,172.31.47.0-255,66,240588,92,246905
19675,0.045189,74.125.24.0-255,5738,246326,92,246905
19676,0.045197,172.31.47.0-255,66,246392,92,246905
19677,0.047422,74.125.24.0-255,276,246668,92,246905
19678,0.047545,172.31.47.0-255,66,246734,92,246905
19679,0.047568,172.31.47.0-255,105,246839,92,246905
19680,0.049777,74.125.24.0-255,66,246905,92,246905
19681,0.0,74.125.24.0-255,153,153,92,279013
19682,2.8e-05,172.31.47.0-255,66,219,92,279013
19683,3.4e-05,74.125.24.0-255,1484,1703,92,279013
19684,3.7e-05,172.31.47.0-255,66,1769,92,279013
19685,4.1e-05,74.125.24.0-255,2902,4671,92,279013
19686,4.3e-05,172.31.47.0-255,66,4737,92,279013
19687,6.9e-05,74.125.24.0-255,7156,11893,92,279013
19688,7.1e-05,172.31.47.0-255,66,11959,92,279013
19689,8.9e-05,74.125.24.0-255,2065,14024,92,279013
19690,9.1e-05,172.31.47.0-255,66,14090,92,279013
19691,0.000423,74.125.24.0-255,1484,15574,92,279013
19692,0.000428,172.31.47.0-255,66,15640,92,279013
19693,0.000434,74.125.24.0-255,2902,18542,92,279013
19694,0.000436,172.31.47.0-255,66,18608,92,279013
19695,0.00045,74.125.24.0-255,5738,24346,92,279013
19696,0.000452,172.31.47.0-255,66,24412,92,279013
19697,0.000488,74.125.24.0-255,4320,28732,92,279013
19698,0.000491,172.31.47.0-255,66,28798,92,279013
19699,0.000506,74.125.24.0-255,2543,31341,92,279013
19700,0.00051,172.31.47.0-255,66,31407,92,279013
19701,0.000634,74.125.24.0-255,1484,32891,92,279013
19702,0.000638,172.31.47.0-255,66,32957,92,279013
19703,0.000643,74.125.24.0-255,2902,35859,92,279013
19704,0.000645,172.31.47.0-255,66,35925,92,279013
19705,0.000665,74.125.24.0-255,2902,38827,92,279013
19706,0.000667,172.31.47.0-255,66,38893,92,279013
19707,0.000689,74.125.24.0-255,2902,41795,92,279013
19708,0.000692,172.31.47.0-255,66,41861,92,279013
19709,0.000697,74.125.24.0-255,5738,47599,92,279013
19710,0.000699,172.31.47.0-255,66,47665,92,279013
19711,0.000717,74.125.24.0-255,6797,54462,92,279013
19712,0.000719,172.31.47.0-255,66,54528,92,279013
19713,0.000743,74.125.24.0-255,5738,60266,92,279013
19714,0.000745,172.31.47.0-255,66,60332,92,279013
19715,0.000763,74.125.24.0-255,5687,66019,92,279013
19716,0.000765,172.31.47.0-255,66,66085,92,279013
19717,0.000768,74.125.24.0-255,112,66197,92,279013
19718,0.000913,74.125.24.0-255,1484,67681,92,279013
19719,0.000918,172.31.47.0-255,66,67747,92,279013
19720,0.000922,74.125.24.0-255,2902,70649,92,279013
19721,0.000924,172.31.47.0-255,66,70715,92,279013
19722,0.000953,74.125.24.0-255,5738,76453,92,279013
19723,0.000956,172.31.47.0-255,66,76519,92,279013
19724,0.000981,74.125.24.0-255,2902,79421,92,279013
19725,0.000982,172.31.47.0-255,66,79487,92,279013
19726,0.001009,172.31.47.0-255,66,79553,92,279013
19727,0.001014,74.125.24.0-255,7156,86709,92,279013
19728,0.001016,172.31.47.0-255,66,86775,92,279013
19729,0.001032,74.125.24.0-255,4320,91095,92,279013
19730,0.001034,172.31.47.0-255,66,91161,92,279013
19731,0.001037,74.125.24.0-255,1368,92529,92,279013
19732,0.001395,74.125.24.0-255,1484,94013,92,279013
19733,0.001396,172.31.47.0-255,66,94079,92,279013
19734,0.001411,74.125.24.0-255,2902,96981,92,279013
19735,0.001413,172.31.47.0-255,66,97047,92,279013
19736,0.001429,74.125.24.0-255,5738,102785,92,279013
19737,0.001431,172.31.47.0-255,66,102851,92,279013
19738,0.001443,74.125.24.0-255,2902,105753,92,279013
19739,0.001445,172.31.47.0-255,66,105819,92,279013
19740,0.001464,74.125.24.0-255,5738,111557,92,279013
19741,0.001465,172.31.47.0-255,66,111623,92,279013
19742,0.001514,172.31.47.0-255,66,111689,92,279013
19743,0.003549,74.125.24.0-255,5738,117427,92,279013
19744,0.003558,172.31.47.0-255,66,117493,92,279013
19745,0.00557,74.125.24.0-255,5738,123231,92,279013
19746,0.005576,172.31.47.0-255,66,123297,92,279013
19747,0.007606,74.125.24.0-255,4320,127617,92,279013
19748,0.007611,172.31.47.0-255,66,127683,92,279013
19749,0.007641,74.125.24.0-255,1484,129167,92,279013
19750,0.009634,74.125.24.0-255,4320,133487,92,279013
19751,0.00964,172.31.47.0-255,66,133553,92,279013
19752,0.011659,74.125.24.0-255,5738,139291,92,279013
19753,0.011666,172.31.47.0-255,66,139357,92,279013
19754,0.013691,74.125.24.0-255,5738,145095,92,279013
19755,0.013699,172.31.47.0-255,66,145161,92,279013
19756,0.015714,74.125.24.0-255,5738,150899,92,279013
19757,0.015721,172.31.47.0-255,66,150965,92,279013
19758,0.017747,74.125.24.0-255,4320,155285,92,279013
19759,0.017753,172.31.47.0-255,66,155351,92,279013
19760,0.01777,74.125.24.0-255,1484,156835,92,279013
19761,0.019804,74.125.24.0-255,4320,161155,92,279013
19762,0.019811,172.31.47.0-255,66,161221,92,279013
19763,0.021827,74.125.24.0-255,5738,166959,92,279013
19764,0.021835,172.31.47.0-255,66,167025,92,279013
19765,0.023844,74.125.24.0-255,5738,172763,92,279013
19766,0.023849,172.31.47.0-255,66,172829,92,279013
19767,0.023984,172.31.47.0-255,172,173001,92,279013
19768,0.024009,172.31.47.0-255,1107,174108,92,279013
19769,0.024053,172.31.47.0-255,1514,175622,92,279013
19770,0.024055,172.31.47.0-255,1514,177136,92,279013
19771,0.024056,172.31.47.0-255,1514,178650,92,279013
19772,0.024057,172.31.47.0-255,1514,180164,92,279013
19773,0.024058,172.31.47.0-255,1499,181663,92,279013
19774,0.025553,104.244.42.0-255,66,181729,92,279013
19775,0.02556,104.244.42.0-255,66,181795,92,279013
19776,0.025662,104.244.42.0-255,66,181861,92,279013
19777,0.025838,74.125.24.0-255,5738,187599,92,279013
19778,0.025842,172.31.47.0-255,66,187665,92,279013
19779,0.02787,74.125.24.0-255,4320,191985,92,279013
19780,0.027875,172.31.47.0-255,66,192051,92,279013
19781,0.027896,74.125.24.0-255,1484,193535,92,279013
19782,0.029875,74.125.24.0-255,1484,195019,92,279013
19783,0.029879,172.31.47.0-255,66,195085,92,279013
19784,0.029904,74.125.24.0-255,2902,197987,92,279013
19785,0.029907,172.31.47.0-255,66,198053,92,279013
19786,0.031882,74.125.24.0-255,2902,200955,92,279013
19787,0.031886,172.31.47.0-255,66,201021,92,279013
19788,0.031913,74.125.24.0-255,2902,203923,92,279013
19789,0.031915,172.31.47.0-255,66,203989,92,279013
19790,0.033933,74.125.24.0-255,2902,206891,92,279013
19791,0.03394,172.31.47.0-255,66,206957,92,279013
19792,0.033963,74.125.24.0-255,2902,209859,92,279013
19793,0.033966,172.31.47.0-255,66,209925,92,279013
19794,0.035979,74.125.24.0-255,5738,215663,92,279013
19795,0.035984,172.31.47.0-255,66,215729,92,279013
19796,0.037986,74.125.24.0-255,5738,221467,92,279013
19797,0.037991,172.31.47.0-255,66,221533,92,279013
19798,0.040019,74.125.24.0-255,4320,225853,92,279013
19799,0.040023,172.31.47.0-255,66,225919,92,279013
19800,0.040046,74.125.24.0-255,1484,227403,92,279013
19801,0.042038,74.125.24.0-255,4320,231723,92,279013
19802,0.042044,172.31.47.0-255,66,231789,92,279013
19803,0.044064,74.125.24.0-255,5738,237527,92,279013
19804,0.044069,172.31.47.0-255,66,237593,92,279013
19805,0.046072,74.125.24.0-255,5738,243331,92,279013
19806,0.046078,172.31.47.0-255,66,243397,92,279013
19807,0.04809,74.125.24.0-255,2902,246299,92,279013
19808,0.048094,172.31.47.0-255,66,246365,92,279013
19809,0.048122,74.125.24.0-255,2902,249267,92,279013
19810,0.048124,172.31.47.0-255,66,249333,92,279013
19811,0.050081,74.125.24.0-255,2902,252235,92,279013
19812,0.050086,172.31.47.0-255,66,252301,92,279013
19813,0.050122,74.125.24.0-255,2902,255203,92,279013
19814,0.050125,172.31.47.0-255,66,255269,92,279013
19815,0.052103,74.125.24.0-255,2902,258171,92,279013
19816,0.052109,172.31.47.0-255,66,258237,92,279013
19817,0.05214,74.125.24.0-255,2902,261139,92,279013
19818,0.052143,172.31.47.0-255,66,261205,92,279013
19819,0.054118,74.125.24.0-255,2902,264107,92,279013
19820,0.054124,172.31.47.0-255,66,264173,92,279013
19821,0.054164,74.125.24.0-255,2902,267075,92,279013
19822,0.054167,172.31.47.0-255,66,267141,92,279013
19823,0.056139,74.125.24.0-255,2902,270043,92,279013
19824,0.056144,172.31.47.0-255,66,270109,92,279013
19825,0.056173,74.125.24.0-255,2902,273011,92,279013
19826,0.056176,172.31.47.0-255,66,273077,92,279013
19827,0.058126,74.125.24.0-255,2902,275979,92,279013
19828,0.05813,172.31.47.0-255,66,276045,92,279013
19829,0.058168,74.125.24.0-255,2902,278947,92,279013
19830,0.058171,172.31.47.0-255,66,279013,92,279013
19831,0.0,74.125.200.0-255,153,153,92,385200
19832,3.5e-05,172.31.47.0-255,66,219,92,385200
19833,4.3e-05,74.125.200.0-255,1484,1703,92,385200
19834,4.7e-05,172.31.47.0-255,66,1769,92,385200
19835,5.1e-05,74.125.200.0-255,2902,4671,92,385200
19836,5.4e-05,172.31.47.0-255,66,4737,92,385200
19837,6e-05,74.125.200.0-255,5738,10475,92,385200
19838,6.2e-05,172.31.47.0-255,66,10541,92,385200
19839,8.7e-05,74.125.200.0-255,4320,14861,92,385200
19840,8.9e-05,172.31.47.0-255,66,14927,92,385200
19841,0.000106,74.125.200.0-255,3579,18506,92,385200
19842,0.000109,172.31.47.0-255,66,18572,92,385200
19843,0.000133,74.125.200.0-255,4320,22892,92,385200
19844,0.000136,172.31.47.0-255,66,22958,92,385200
19845,0.000161,74.125.200.0-255,4320,27278,92,385200
19846,0.000164,172.31.47.0-255,66,27344,92,385200
19847,0.00017,74.125.200.0-255,3961,31305,92,385200
19848,0.000172,172.31.47.0-255,66,31371,92,385200
19849,0.000186,74.125.200.0-255,4320,35691,92,385200
19850,0.000188,172.31.47.0-255,66,35757,92,385200
19851,0.000196,74.125.200.0-255,5738,41495,92,385200
19852,0.000198,172.31.47.0-255,66,41561,92,385200
19853,0.000243,74.125.200.0-255,6797,48358,92,385200
19854,0.000247,172.31.47.0-255,66,48424,92,385200
19855,0.000454,74.125.200.0-255,1484,49908,92,385200
19856,0.000458,172.31.47.0-255,66,49974,92,385200
19857,0.000476,74.125.200.0-255,2902,52876,92,385200
19858,0.000479,172.31.47.0-255,66,52942,92,385200
19859,0.000488,74.125.200.0-255,5738,58680,92,385200
19860,0.00049,172.31.47.0-255,66,58746,92,385200
19861,0.000493,74.125.200.0-255,1484,60230,92,385200
19862,0.000495,172.31.47.0-255,66,60296,92,385200
19863,0.000527,74.125.200.0-255,5379,65675,92,385200
19864,0.000537,172.31.47.0-255,66,65741,92,385200
19865,0.000601,74.125.200.0-255,1484,67225,92,385200
19866,0.000616,74.125.200.0-255,2902,70127,92,385200
19867,0.000639,74.125.200.0-255,5738,75865,92,385200
19868,0.000646,172.31.47.0-255,66,75931,92,385200
19869,0.000664,74.125.200.0-255,6797,82728,92,385200
19870,0.000672,172.31.47.0-255,66,82794,92,385200
19871,0.000834,74.125.200.0-255,1484,84278,92,385200
19872,0.000838,74.125.200.0-255,1484,85762,92,385200
19873,0.000842,172.31.47.0-255,66,85828,92,385200
19874,0.000858,74.125.200.0-255,1484,87312,92,385200
19875,0.000861,74.125.200.0-255,1484,88796,92,385200
19876,0.000864,172.31.47.0-255,66,88862,92,385200
19877,0.000885,74.125.200.0-255,4320,93182,92,385200
19878,0.000888,74.125.200.0-255,1484,94666,92,385200
19879,0.000892,172.31.47.0-255,66,94732,92,385200
19880,0.000906,74.125.200.0-255,5738,100470,92,385200
19881,0.000915,172.31.47.0-255,66,100536,92,385200
19882,0.000921,74.125.200.0-255,4320,104856,92,385200
19883,0.000924,74.125.200.0-255,2902,107758,92,385200
19884,0.000928,172.31.47.0-255,66,107824,92,385200
19885,0.000939,74.125.200.0-255,5738,113562,92,385200
19886,0.00095,172.31.47.0-255,66,113628,92,385200
19887,0.000951,74.125.200.0-255,3602,117230,92,385200
19888,0.000953,172.31.47.0-255,66,117296,92,385200
19889,0.001026,74.125.200.0-255,1484,118780,92,385200
19890,0.001041,74.125.200.0-255,2902,121682,92,385200
19891,0.001043,172.31.47.0-255,66,121748,92,385200
19892,0.001046,74.125.200.0-255,1484,123232,92,385200
19893,0.001062,74.125.200.0-255,2902,126134,92,385200
19894,0.001066,74.125.200.0-255,4320,130454,92,385200
19895,0.001067,172.31.47.0-255,66,130520,92,385200
19896,0.001081,74.125.200.0-255,4320,134840,92,385200
19897,0.001083,172.31.47.0-255,66,134906,92,385200
19898,0.001087,172.31.47.0-255,66,134972,92,385200
19899,0.001091,74.125.200.0-255,2902,137874,92,385200
19900,0.001099,172.31.47.0-255,66,137940,92,385200
19901,0.001109,74.125.200.0-255,5738,143678,92,385200
19902,0.001128,172.31.47.0-255,66,143744,92,385200
19903,0.001142,74.125.200.0-255,1484,145228,92,385200
19904,0.001166,74.125.200.0-255,6438,151666,92,385200
19905,0.001172,172.31.47.0-255,66,151732,92,385200
19906,0.001551,74.125.200.0-255,1484,153216,92,385200
19907,0.001574,74.125.200.0-255,2902,156118,92,385200
19908,0.001577,172.31.47.0-255,66,156184,92,385200
19909,0.001583,74.125.200.0-255,5738,161922,92,385200
19910,0.001585,74.125.200.0-255,1484,163406,92,385200
19911,0.001597,74.125.200.0-255,4320,167726,92,385200
19912,0.001625,74.125.200.0-255,7156,174882,92,385200
19913,0.001648,74.125.200.0-255,2902,177784,92,385200
19914,0.001669,74.125.200.0-255,5738,183522,92,385200
19915,0.001695,74.125.200.0-255,2184,185706,92,385200
19916,0.001787,74.125.200.0-255,1484,187190,92,385200
19917,0.001791,74.125.200.0-255,1484,188674,92,385200
19918,0.001805,74.125.200.0-255,1484,190158,92,385200
19919,0.001816,74.125.200.0-255,4320,194478,92,385200
19920,0.001824,74.125.200.0-255,1484,195962,92,385200
19921,0.001838,74.125.200.0-255,1484,197446,92,385200
19922,0.001859,74.125.200.0-255,7156,204602,92,385200
19923,0.001881,74.125.200.0-255,4320,208922,92,385200
19924,0.001896,74.125.200.0-255,4320,213242,92,385200
19925,0.001917,74.125.200.0-255,6438,219680,92,385200
19926,0.00195,74.125.200.0-255,7156,226836,92,385200
19927,0.002006,74.125.200.0-255,6438,233274,92,385200
19928,0.002104,74.125.200.0-255,1484,234758,92,385200
19929,0.002108,74.125.200.0-255,2902,237660,92,385200
19930,0.002136,74.125.200.0-255,2902,240562,92,385200
19931,0.00215,74.125.200.0-255,2902,243464,92,385200
19932,0.002153,74.125.200.0-255,2902,246366,92,385200
19933,0.002187,74.125.200.0-255,1484,247850,92,385200
19934,0.002207,74.125.200.0-255,4320,252170,92,385200
19935,0.002222,74.125.200.0-255,4320,256490,92,385200
19936,0.002326,74.125.200.0-255,1484,257974,92,385200
19937,0.002341,74.125.200.0-255,2902,260876,92,385200
19938,0.002344,74.125.200.0-255,1484,262360,92,385200
19939,0.002356,74.125.200.0-255,1484,263844,92,385200
19940,0.002367,74.125.200.0-255,1484,265328,92,385200
19941,0.002371,74.125.200.0-255,4320,269648,92,385200
19942,0.002387,74.125.200.0-255,1484,271132,92,385200
19943,0.002407,74.125.200.0-255,4320,275452,92,385200
19944,0.002427,74.125.200.0-255,4320,279772,92,385200
19945,0.00243,74.125.200.0-255,1484,281256,92,385200
19946,0.002455,74.125.200.0-255,2902,284158,92,385200
19947,0.002467,74.125.200.0-255,2184,286342,92,385200
19948,0.00247,74.125.200.0-255,1484,287826,92,385200
19949,0.002488,74.125.200.0-255,4320,292146,92,385200
19950,0.002491,74.125.200.0-255,1484,293630,92,385200
19951,0.002523,74.125.200.0-255,4320,297950,92,385200
19952,0.002549,74.125.200.0-255,6438,304388,92,385200
19953,0.008871,172.31.47.0-255,66,304454,92,385200
19954,0.011405,74.125.200.0-255,5738,310192,92,385200
19955,0.011417,172.31.47.0-255,66,310258,92,385200
19956,0.013937,74.125.200.0-255,5738,315996,92,385200
19957,0.013956,172.31.47.0-255,66,316062,92,385200
19958,0.016458,74.125.200.0-255,5738,321800,92,385200
19959,0.01647,172.31.47.0-255,66,321866,92,385200
19960,0.018976,74.125.200.0-255,5738,327604,92,385200
19961,0.019928,172.31.47.0-255,66,327670,92,385200
19962,0.022443,74.125.200.0-255,5738,333408,92,385200
19963,0.022461,172.31.47.0-255,66,333474,92,385200
19964,0.024971,74.125.200.0-255,5738,339212,92,385200
19965,0.024989,172.31.47.0-255,66,339278,92,385200
19966,0.027479,74.125.200.0-255,5738,345016,92,385200
19967,0.02749,172.31.47.0-255,66,345082,92,385200
19968,0.029985,74.125.200.0-255,5738,350820,92,385200
19969,0.029996,172.31.47.0-255,66,350886,92,385200
19970,0.032507,74.125.200.0-255,5738,356624,92,385200
19971,0.032525,172.31.47.0-255,66,356690,92,385200
19972,0.035041,74.125.200.0-255,5738,362428,92,385200
19973,0.035061,172.31.47.0-255,66,362494,92,385200
19974,0.037551,74.125.200.0-255,5738,368232,92,385200
19975,0.037558,172.31.47.0-255,66,368298,92,385200
19976,0.040148,74.125.200.0-255,5738,374036,92,385200
19977,0.040164,172.31.47.0-255,66,374102,92,385200
19978,0.042671,74.125.200.0-255,1654,375756,92,385200
19979,0.04269,172.31.47.0-255,66,375822,92,385200
19980,0.042984,172.31.47.0-255,105,375927,92,385200
19981,0.04545,74.125.200.0-255,66,375993,92,385200
19982,0.053224,172.31.47.0-255,172,376165,92,385200
19983,0.053264,172.31.47.0-255,1103,377268,92,385200
19984,0.05332,172.31.47.0-255,1514,378782,92,385200
19985,0.053321,172.31.47.0-255,1514,380296,92,385200
19986,0.053322,172.31.47.0-255,1514,381810,92,385200
19987,0.053323,172.31.47.0-255,1514,383324,92,385200
19988,0.053324,172.31.47.0-255,1504,384828,92,385200
19989,0.054776,104.244.42.0-255,66,384894,92,385200
19990,0.054829,104.244.42.0-255,66,384960,92,385200
19991,0.054929,104.244.42.0-255,66,385026,92,385200
19992,0.055907,104.244.42.0-255,108,385134,92,385200
19993,0.055914,172.31.47.0-255,66,385200,92,385200
19994,0.0,74.125.24.0-255,66,66,92,66
19995,0.0,74.125.24.0-255,298,298,92,215177
19996,3.6e-05,172.31.47.0-255,66,364,92,215177
19997,4.3e-05,74.125.24.0-255,1484,1848,92,215177
19998,4.8e-05,172.31.47.0-255,66,1914,92,215177
19999,6.7e-05,74.125.24.0-255,4320,6234,92,215177
20000,7.2e-05,172.31.47.0-255,66,6300,92,215177
20001,7.9e-05,74.125.24.0-255,4320,10620,92,215177
20002,8.2e-05,172.31.47.0-255,66,10686,92,215177
20003,9.8e-05,172.31.47.0-255,66,10752,92,215177
20004,0.000112,172.31.47.0-255,66,10818,92,215177
20005,0.000168,74.125.24.0-255,1484,12302,92,215177
20006,0.000172,172.31.47.0-255,66,12368,92,215177
20007,0.000178,74.125.24.0-255,2902,15270,92,215177
20008,0.00018,172.31.47.0-255,66,15336,92,215177
20009,0.000192,74.125.24.0-255,2902,18238,92,215177
20010,0.000195,172.31.47.0-255,66,18304,92,215177
20011,0.000234,74.125.24.0-255,2902,21206,92,215177
20012,0.000238,172.31.47.0-255,66,21272,92,215177
20013,0.000265,172.31.47.0-255,66,21338,92,215177
20014,0.000274,74.125.24.0-255,7156,28494,92,215177
20015,0.000277,172.31.47.0-255,66,28560,92,215177
20016,0.00028,74.125.24.0-255,1484,30044,92,215177
20017,0.000283,172.31.47.0-255,66,30110,92,215177
20018,0.000318,74.125.24.0-255,1745,31855,92,215177
20019,0.000321,172.31.47.0-255,66,31921,92,215177
20020,0.000459,74.125.24.0-255,1484,33405,92,215177
20021,0.000464,172.31.47.0-255,66,33471,92,215177
20022,0.000468,74.125.24.0-255,2902,36373,92,215177
20023,0.00047,172.31.47.0-255,66,36439,92,215177
20024,0.000502,74.125.24.0-255,5738,42177,92,215177
20025,0.000504,172.31.47.0-255,66,42243,92,215177
20026,0.000513,172.31.47.0-255,66,42309,92,215177
20027,0.00054,74.125.24.0-255,1484,43793,92,215177
20028,0.00058,172.31.47.0-255,66,43859,92,215177
20029,0.000901,74.125.24.0-255,1484,45343,92,215177
20030,0.000918,74.125.24.0-255,2902,48245,92,215177
20031,0.000922,172.31.47.0-255,66,48311,92,215177
20032,0.000948,74.125.24.0-255,5738,54049,92,215177
20033,0.00095,172.31.47.0-255,66,54115,92,215177
20034,0.000954,74.125.24.0-255,2902,57017,92,215177
20035,0.000955,172.31.47.0-255,66,57083,92,215177
20036,0.000992,172.31.47.0-255,66,57149,92,215177
20037,0.001002,74.125.24.0-255,5738,62887,92,215177
20038,0.001003,172.31.47.0-255,66,62953,92,215177
20039,0.001027,74.125.24.0-255,4320,67273,92,215177
20040,0.001028,172.31.47.0-255,66,67339,92,215177
20041,0.001031,74.125.24.0-255,766,68105,92,215177
20042,0.001613,172.31.47.0-255,66,68171,92,215177
20043,0.002067,74.125.24.0-255,1484,69655,92,215177
20044,0.002079,74.125.24.0-255,2902,72557,92,215177
20045,0.002083,172.31.47.0-255,66,72623,92,215177
20046,0.002091,74.125.24.0-255,5738,78361,92,215177
20047,0.002093,172.31.47.0-255,66,78427,92,215177
20048,0.002136,172.31.47.0-255,66,78493,92,215177
20049,0.002169,74.125.24.0-255,2902,81395,92,215177
20050,0.002171,172.31.47.0-255,66,81461,92,215177
20051,0.002203,172.31.47.0-255,66,81527,92,215177
20052,0.002312,74.125.24.0-255,1484,83011,92,215177
20053,0.002333,74.125.24.0-255,2902,85913,92,215177
20054,0.002336,172.31.47.0-255,66,85979,92,215177
20055,0.002343,74.125.24.0-255,5738,91717,92,215177
20056,0.002344,172.31.47.0-255,66,91783,92,215177
20057,0.002381,172.31.47.0-255,66,91849,92,215177
20058,0.002383,74.125.24.0-255,1484,93333,92,215177
20059,0.002408,172.31.47.0-255,66,93399,92,215177
20060,0.002433,74.125.24.0-255,766,94165,92,215177
20061,0.002731,74.125.24.0-255,1484,95649,92,215177
20062,0.002737,172.31.47.0-255,66,95715,92,215177
20063,0.002782,74.125.24.0-255,1484,97199,92,215177
20064,0.002815,74.125.24.0-255,1484,98683,92,215177
20065,0.002817,172.31.47.0-255,66,98749,92,215177
20066,0.00282,74.125.24.0-255,1484,100233,92,215177
20067,0.002843,74.125.24.0-255,2902,103135,92,215177
20068,0.002845,172.31.47.0-255,66,103201,92,215177
20069,0.002858,74.125.24.0-255,4320,107521,92,215177
20070,0.002863,172.31.47.0-255,66,107587,92,215177
20071,0.002866,74.125.24.0-255,1484,109071,92,215177
20072,0.002898,74.125.24.0-255,7156,116227,92,215177
20073,0.0029,172.31.47.0-255,66,116293,92,215177
20074,0.002936,172.31.47.0-255,66,116359,92,215177
20075,0.00294,74.125.24.0-255,2184,118543,92,215177
20076,0.002941,172.31.47.0-255,66,118609,92,215177
20077,0.003151,74.125.24.0-255,1484,120093,92,215177
20078,0.003167,74.125.24.0-255,2902,122995,92,215177
20079,0.003169,172.31.47.0-255,66,123061,92,215177
20080,0.003196,74.125.24.0-255,5738,128799,92,215177
20081,0.003199,172.31.47.0-255,66,128865,92,215177
20082,0.003203,74.125.24.0-255,4320,133185,92,215177
20083,0.003206,172.31.47.0-255,66,133251,92,215177
20084,0.003231,74.125.24.0-255,1484,134735,92,215177
20085,0.003266,74.125.24.0-255,7156,141891,92,215177
20086,0.003269,172.31.47.0-255,66,141957,92,215177
20087,0.00328,172.31.47.0-255,66,142023,92,215177
20088,0.003293,172.31.47.0-255,66,142089,92,215177
20089,0.003298,74.125.24.0-255,4320,146409,92,215177
20090,0.0033,74.125.24.0-255,1484,147893,92,215177
20091,0.003302,74.125.24.0-255,1484,149377,92,215177
20092,0.00333,74.125.24.0-255,1484,150861,92,215177
20093,0.003349,74.125.24.0-255,4320,155181,92,215177
20094,0.003365,74.125.24.0-255,5020,160201,92,215177
20095,0.003367,74.125.24.0-255,1484,161685,92,215177
20096,0.003404,74.125.24.0-255,4320,166005,92,215177
20097,0.00343,74.125.24.0-255,1484,167489,92,215177
20098,0.003444,74.125.24.0-255,2902,170391,92,215177
20099,0.003503,74.125.24.0-255,4320,174711,92,215177
20100,0.003539,74.125.24.0-255,766,175477,92,215177
20101,0.003551,74.125.24.0-255,1484,176961,92,215177
20102,0.00359,74.125.24.0-255,7156,184117,92,215177
20103,0.003632,74.125.24.0-255,2902,187019,92,215177
20104,0.003646,74.125.24.0-255,5738,192757,92,215177
20105,0.003656,74.125.24.0-255,1484,194241,92,215177
20106,0.003661,74.125.24.0-255,4320,198561,92,215177
20107,0.003675,74.125.24.0-255,1484,200045,92,215177
20108,0.003702,74.125.24.0-255,2902,202947,92,215177
20109,0.003716,74.125.24.0-255,2550,205497,92,215177
20110,0.003747,74.125.24.0-255,105,205602,92,215177
20111,0.005723,172.31.47.0-255,66,205668,92,215177
20112,0.007994,172.31.47.0-255,105,205773,92,215177
20113,0.010249,74.125.24.0-255,66,205839,92,215177
20114,0.033015,172.31.47.0-255,172,206011,92,215177
20115,0.033042,172.31.47.0-255,1112,207123,92,215177
20116,0.033124,172.31.47.0-255,1514,208637,92,215177
20117,0.033171,172.31.47.0-255,1514,210151,92,215177
20118,0.033173,172.31.47.0-255,1514,211665,92,215177
20119,0.033193,172.31.47.0-255,1514,213179,92,215177
20120,0.033194,172.31.47.0-255,1494,214673,92,215177
20121,0.034547,104.244.42.0-255,66,214739,92,215177
20122,0.034605,104.244.42.0-255,66,214805,92,215177
20123,0.034664,104.244.42.0-255,66,214871,92,215177
20124,0.034714,104.244.42.0-255,66,214937,92,215177
20125,0.034765,104.244.42.0-255,66,215003,92,215177
20126,0.035356,104.244.42.0-255,108,215111,92,215177
20127,0.035363,172.31.47.0-255,66,215177,92,215177
20128,0.0,74.125.200.0-255,153,153,92,352487
20129,3.3e-05,172.31.47.0-255,66,219,92,352487
20130,4e-05,74.125.200.0-255,1484,1703,92,352487
20131,4.4e-05,172.31.47.0-255,66,1769,92,352487
20132,4.7e-05,74.125.200.0-255,1484,3253,92,352487
20133,5.8e-05,172.31.47.0-255,66,3319,92,352487
20134,6.4e-05,74.125.200.0-255,2902,6221,92,352487
20135,6.6e-05,172.31.47.0-255,66,6287,92,352487
20136,7.3e-05,74.125.200.0-255,5738,12025,92,352487
20137,7.5e-05,172.31.47.0-255,66,12091,92,352487
20138,9.8e-05,74.125.200.0-255,2148,14239,92,352487
20139,0.000107,172.31.47.0-255,66,14305,92,352487
20140,0.000134,74.125.200.0-255,2902,17207,92,352487
20141,0.000138,172.31.47.0-255,66,17273,92,352487
20142,0.000142,74.125.200.0-255,2902,20175,92,352487
20143,0.000144,172.31.47.0-255,66,20241,92,352487
20144,0.000176,74.125.200.0-255,4320,24561,92,352487
20145,0.000179,172.31.47.0-255,66,24627,92,352487
20146,0.00021,74.125.200.0-255,6797,31424,92,352487
20147,0.000213,172.31.47.0-255,66,31490,92,352487
20148,0.000317,74.125.200.0-255,1484,32974,92,352487
20149,0.000321,172.31.47.0-255,66,33040,92,352487
20150,0.000328,74.125.200.0-255,2902,35942,92,352487
20151,0.00033,172.31.47.0-255,66,36008,92,352487
20152,0.00034,74.125.200.0-255,2902,38910,92,352487
20153,0.000343,172.31.47.0-255,66,38976,92,352487
20154,0.000372,74.125.200.0-255,2902,41878,92,352487
20155,0.000375,172.31.47.0-255,66,41944,92,352487
20156,0.000383,74.125.200.0-255,6797,48741,92,352487
20157,0.000386,172.31.47.0-255,66,48807,92,352487
20158,0.000394,74.125.200.0-255,1484,50291,92,352487
20159,0.000396,172.31.47.0-255,66,50357,92,352487
20160,0.000438,74.125.200.0-255,2902,53259,92,352487
20161,0.000442,172.31.47.0-255,66,53325,92,352487
20162,0.000468,74.125.200.0-255,1484,54809,92,352487
20163,0.000472,74.125.200.0-255,2902,57711,92,352487
20164,0.000472,172.31.47.0-255,66,57777,92,352487
20165,0.000479,172.31.47.0-255,66,57843,92,352487
20166,0.000502,74.125.200.0-255,4320,62163,92,352487
20167,0.000506,172.31.47.0-255,66,62229,92,352487
20168,0.000522,74.125.200.0-255,1484,63713,92,352487
20169,0.000547,74.125.200.0-255,2816,66529,92,352487
20170,0.000554,172.31.47.0-255,66,66595,92,352487
20171,0.000566,74.125.200.0-255,132,66727,92,352487
20172,0.000662,74.125.200.0-255,1484,68211,92,352487
20173,0.000668,172.31.47.0-255,66,68277,92,352487
20174,0.000675,74.125.200.0-255,2902,71179,92,352487
20175,0.000678,172.31.47.0-255,66,71245,92,352487
20176,0.000706,74.125.200.0-255,4320,75565,92,352487
20177,0.000711,172.31.47.0-255,66,75631,92,352487
20178,0.000741,74.125.200.0-255,5738,81369,92,352487
20179,0.000746,172.31.47.0-255,66,81435,92,352487
20180,0.000757,74.125.200.0-255,4320,85755,92,352487
20181,0.000763,172.31.47.0-255,66,85821,92,352487
20182,0.000775,74.125.200.0-255,5738,91559,92,352487
20183,0.000787,172.31.47.0-255,66,91625,92,352487
20184,0.000821,172.31.47.0-255,66,91691,92,352487
20185,0.000827,74.125.200.0-255,766,92457,92,352487
20186,0.000847,74.125.200.0-255,348,92805,92,352487
20187,0.001113,172.31.47.0-255,66,92871,92,352487
20188,0.001171,74.125.200.0-255,1484,94355,92,352487
20189,0.001175,172.31.47.0-255,66,94421,92,352487
20190,0.001183,74.125.200.0-255,2902,97323,92,352487
20191,0.001185,172.31.47.0-255,66,97389,92,352487
20192,0.001219,74.125.200.0-255,4320,101709,92,352487
20193,0.001222,74.125.200.0-255,1484,103193,92,352487
20194,0.001239,74.125.200.0-255,4320,107513,92,352487
20195,0.001263,74.125.200.0-255,4320,111833,92,352487
20196,0.001277,74.125.200.0-255,1484,113317,92,352487
20197,0.001299,74.125.200.0-255,4320,117637,92,352487
20198,0.001313,74.125.200.0-255,2902,120539,92,352487
20199,0.001317,74.125.200.0-255,2902,123441,92,352487
20200,0.001339,74.125.200.0-255,1484,124925,92,352487
20201,0.001356,74.125.200.0-255,2184,127109,92,352487
20202,0.001441,74.125.200.0-255,1484,128593,92,352487
20203,0.001446,74.125.200.0-255,1484,130077,92,352487
20204,0.001462,74.125.200.0-255,1484,131561,92,352487
20205,0.001477,74.125.200.0-255,4320,135881,92,352487
20206,0.001512,74.125.200.0-255,1484,137365,92,352487
20207,0.00154,74.125.200.0-255,7156,144521,92,352487
20208,0.001562,74.125.200.0-255,1484,146005,92,352487
20209,0.001584,74.125.200.0-255,5738,151743,92,352487
20210,0.001641,74.125.200.0-255,766,152509,92,352487
20211,0.001745,74.125.200.0-255,1484,153993,92,352487
20212,0.001757,74.125.200.0-255,2902,156895,92,352487
20213,0.001776,74.125.200.0-255,1484,158379,92,352487
20214,0.001781,74.125.200.0-255,2902,161281,92,352487
20215,0.001783,74.125.200.0-255,1484,162765,92,352487
20216,0.001796,74.125.200.0-255,4320,167085,92,352487
20217,0.001821,74.125.200.0-255,1484,168569,92,352487
20218,0.001842,74.125.200.0-255,7156,175725,92,352487
20219,0.001852,74.125.200.0-255,2902,178627,92,352487
20220,0.001868,74.125.200.0-255,5738,184365,92,352487
20221,0.00188,74.125.200.0-255,2184,186549,92,352487
20222,0.00204,74.125.200.0-255,1484,188033,92,352487
20223,0.002062,74.125.200.0-255,2902,190935,92,352487
20224,0.002081,74.125.200.0-255,1484,192419,92,352487
20225,0.002091,74.125.200.0-255,2902,195321,92,352487
20226,0.002106,74.125.200.0-255,1484,196805,92,352487
20227,0.002117,74.125.200.0-255,1484,198289,92,352487
20228,0.004211,172.31.47.0-255,66,198355,92,352487
20229,0.006312,74.125.200.0-255,5738,204093,92,352487
20230,0.006316,172.31.47.0-255,66,204159,92,352487
20231,0.008394,74.125.200.0-255,5738,209897,92,352487
20232,0.008401,172.31.47.0-255,66,209963,92,352487
20233,0.010474,74.125.200.0-255,5738,215701,92,352487
20234,0.01048,172.31.47.0-255,66,215767,92,352487
20235,0.012548,74.125.200.0-255,5738,221505,92,352487
20236,0.012554,172.31.47.0-255,66,221571,92,352487
20237,0.014631,74.125.200.0-255,5738,227309,92,352487
20238,0.014637,172.31.47.0-255,66,227375,92,352487
20239,0.016707,74.125.200.0-255,5738,233113,92,352487
20240,0.016714,172.31.47.0-255,66,233179,92,352487
20241,0.018815,74.125.200.0-255,5738,238917,92,352487
20242,0.018825,172.31.47.0-255,66,238983,92,352487
20243,0.020937,74.125.200.0-255,5738,244721,92,352487
20244,0.02261,172.31.47.0-255,66,244787,92,352487
20245,0.024734,74.125.200.0-255,5738,250525,92,352487
20246,0.02475,172.31.47.0-255,66,250591,92,352487
20247,0.026827,74.125.200.0-255,5738,256329,92,352487
20248,0.026838,172.31.47.0-255,66,256395,92,352487
20249,0.028942,74.125.200.0-255,5738,262133,92,352487
20250,0.028961,172.31.47.0-255,66,262199,92,352487
20251,0.031033,74.125.200.0-255,5738,267937,92,352487
20252,0.031038,172.31.47.0-255,66,268003,92,352487
20253,0.033121,74.125.200.0-255,5738,273741,92,352487
20254,0.033127,172.31.47.0-255,66,273807,92,352487
20255,0.035216,74.125.200.0-255,5738,279545,92,352487
20256,0.035231,172.31.47.0-255,66,279611,92,352487
20257,0.037298,74.125.200.0-255,5738,285349,92,352487
20258,0.037304,172.31.47.0-255,66,285415,92,352487
20259,0.039394,74.125.200.0-255,5738,291153,92,352487
20260,0.039407,172.31.47.0-255,66,291219,92,352487
20261,0.041488,74.125.200.0-255,5738,296957,92,352487
20262,0.041494,172.31.47.0-255,66,297023,92,352487
20263,0.043597,74.125.200.0-255,5738,302761,92,352487
20264,0.043619,172.31.47.0-255,66,302827,92,352487
20265,0.045739,74.125.200.0-255,5738,308565,92,352487
20266,0.045747,172.31.47.0-255,66,308631,92,352487
20267,0.047835,74.125.200.0-255,5738,314369,92,352487
20268,0.047851,172.31.47.0-255,66,314435,92,352487
20269,0.049937,74.125.200.0-255,5738,320173,92,352487
20270,0.049947,172.31.47.0-255,66,320239,92,352487
20271,0.052028,74.125.200.0-255,5738,325977,92,352487
20272,0.052034,172.31.47.0-255,66,326043,92,352487
20273,0.054183,74.125.200.0-255,5738,331781,92,352487
20274,0.054205,172.31.47.0-255,66,331847,92,352487
20275,0.056286,74.125.200.0-255,5738,337585,92,352487
20276,0.056293,172.31.47.0-255,66,337651,92,352487
20277,0.058008,172.31.47.0-255,172,337823,92,352487
20278,0.058036,172.31.47.0-255,1103,338926,92,352487
20279,0.058088,172.31.47.0-255,1514,340440,92,352487
20280,0.05809,172.31.47.0-255,1514,341954,92,352487
20281,0.058091,172.31.47.0-255,1514,343468,92,352487
20282,0.058092,172.31.47.0-255,1514,344982,92,352487
20283,0.058117,172.31.47.0-255,1503,346485,92,352487
20284,0.058368,74.125.200.0-255,5738,352223,92,352487
20285,0.058379,172.31.47.0-255,66,352289,92,352487
20286,0.059555,104.244.42.0-255,66,352355,92,352487
20287,0.059616,104.244.42.0-255,66,352421,92,352487
20288,0.059677,104.244.42.0-255,66,352487,92,352487
20289,0.0,172.31.47.0-255,105,105,92,342
20290,0.001732,157.240.13.0-255,66,171,92,342
20291,0.001795,157.240.13.0-255,105,276,92,342
20292,0.0018,172.31.47.0-255,66,342,92,342
20293,0.0,74.125.68.0-255,153,153,92,360004
20294,2e-05,172.31.47.0-255,66,219,92,360004
20295,2.7e-05,74.125.68.0-255,1484,1703,92,360004
20296,3.1e-05,172.31.47.0-255,66,1769,92,360004
20297,3.5e-05,74.125.68.0-255,2902,4671,92,360004
20298,4.5e-05,172.31.47.0-255,66,4737,92,360004
20299,8e-05,74.125.68.0-255,5738,10475,92,360004
20300,8.3e-05,74.125.68.0-255,3430,13905,92,360004
20301,8.4e-05,172.31.47.0-255,66,13971,92,360004
20302,8.7e-05,172.31.47.0-255,66,14037,92,360004
20303,0.000121,74.125.68.0-255,1484,15521,92,360004
20304,0.000124,172.31.47.0-255,66,15587,92,360004
20305,0.000143,74.125.68.0-255,2902,18489,92,360004
20306,0.000145,172.31.47.0-255,66,18555,92,360004
20307,0.000148,74.125.68.0-255,1484,20039,92,360004
20308,0.00015,172.31.47.0-255,66,20105,92,360004
20309,0.000179,74.125.68.0-255,4320,24425,92,360004
20310,0.000182,172.31.47.0-255,66,24491,92,360004
20311,0.000195,74.125.68.0-255,5738,30229,92,360004
20312,0.000197,172.31.47.0-255,66,30295,92,360004
20313,0.000231,74.125.68.0-255,1125,31420,92,360004
20314,0.000233,172.31.47.0-255,66,31486,92,360004
20315,0.000299,74.125.68.0-255,1484,32970,92,360004
20316,0.000302,172.31.47.0-255,66,33036,92,360004
20317,0.000307,74.125.68.0-255,2902,35938,92,360004
20318,0.000309,172.31.47.0-255,66,36004,92,360004
20319,0.000341,74.125.68.0-255,4320,40324,92,360004
20320,0.000344,172.31.47.0-255,66,40390,92,360004
20321,0.000349,74.125.68.0-255,5738,46128,92,360004
20322,0.000352,172.31.47.0-255,66,46194,92,360004
20323,0.000383,74.125.68.0-255,7156,53350,92,360004
20324,0.000386,172.31.47.0-255,66,53416,92,360004
20325,0.000412,74.125.68.0-255,2543,55959,92,360004
20326,0.000415,172.31.47.0-255,66,56025,92,360004
20327,0.000427,172.31.47.0-255,66,56091,92,360004
20328,0.000434,74.125.68.0-255,114,56205,92,360004
20329,0.000437,172.31.47.0-255,66,56271,92,360004
20330,0.000585,74.125.68.0-255,331,56602,92,360004
20331,0.000588,172.31.47.0-255,66,56668,92,360004
20332,0.000921,74.125.68.0-255,1484,58152,92,360004
20333,0.000927,172.31.47.0-255,66,58218,92,360004
20334,0.000935,74.125.68.0-255,1484,59702,92,360004
20335,0.000938,172.31.47.0-255,66,59768,92,360004
20336,0.000978,74.125.68.0-255,1484,61252,92,360004
20337,0.000981,172.31.47.0-255,66,61318,92,360004
20338,0.000988,74.125.68.0-255,5738,67056,92,360004
20339,0.000991,172.31.47.0-255,66,67122,92,360004
20340,0.001001,74.125.68.0-255,2902,70024,92,360004
20341,0.001004,172.31.47.0-255,66,70090,92,360004
20342,0.00101,74.125.68.0-255,4320,74410,92,360004
20343,0.001025,74.125.68.0-255,5738,80148,92,360004
20344,0.001051,172.31.47.0-255,66,80214,92,360004
20345,0.001053,172.31.47.0-255,66,80280,92,360004
20346,0.001054,172.31.47.0-255,66,80346,92,360004
20347,0.001078,74.125.68.0-255,2184,82530,92,360004
20348,0.001086,172.31.47.0-255,66,82596,92,360004
20349,0.001092,74.125.68.0-255,2902,85498,92,360004
20350,0.001094,172.31.47.0-255,66,85564,92,360004
20351,0.001127,74.125.68.0-255,4320,89884,92,360004
20352,0.00113,172.31.47.0-255,66,89950,92,360004
20353,0.001136,74.125.68.0-255,5738,95688,92,360004
20354,0.001173,74.125.68.0-255,4320,100008,92,360004
20355,0.001216,74.125.68.0-255,5020,105028,92,360004
20356,0.001259,74.125.68.0-255,1484,106512,92,360004
20357,0.001274,74.125.68.0-255,2902,109414,92,360004
20358,0.00129,74.125.68.0-255,2902,112316,92,360004
20359,0.001305,74.125.68.0-255,2902,115218,92,360004
20360,0.001316,74.125.68.0-255,2902,118120,92,360004
20361,0.001334,74.125.68.0-255,2902,121022,92,360004
20362,0.001341,74.125.68.0-255,7156,128178,92,360004
20363,0.001365,74.125.68.0-255,4320,132498,92,360004
20364,0.00139,74.125.68.0-255,6438,138936,92,360004
20365,0.001442,74.125.68.0-255,1484,140420,92,360004
20366,0.001446,74.125.68.0-255,1484,141904,92,360004
20367,0.001457,74.125.68.0-255,1484,143388,92,360004
20368,0.001477,74.125.68.0-255,1484,144872,92,360004
20369,0.001493,74.125.68.0-255,2902,147774,92,360004
20370,0.001515,74.125.68.0-255,5738,153512,92,360004
20371,0.001531,74.125.68.0-255,1484,154996,92,360004
20372,0.001547,74.125.68.0-255,5738,160734,92,360004
20373,0.001568,74.125.68.0-255,4320,165054,92,360004
20374,0.001599,74.125.68.0-255,1484,166538,92,360004
20375,0.001616,74.125.68.0-255,4320,170858,92,360004
20376,0.001626,74.125.68.0-255,2184,173042,92,360004
20377,0.001665,74.125.68.0-255,2902,175944,92,360004
20378,0.001676,74.125.68.0-255,4320,180264,92,360004
20379,0.001693,74.125.68.0-255,2902,183166,92,360004
20380,0.001705,74.125.68.0-255,3602,186768,92,360004
20381,0.001997,74.125.68.0-255,1484,188252,92,360004
20382,0.002011,74.125.68.0-255,2902,191154,92,360004
20383,0.002013,74.125.68.0-255,1484,192638,92,360004
20384,0.002037,74.125.68.0-255,2902,195540,92,360004
20385,0.003253,172.31.47.0-255,66,195606,92,360004
20386,0.005298,74.125.68.0-255,5738,201344,92,360004
20387,0.005305,172.31.47.0-255,66,201410,92,360004
20388,0.007344,74.125.68.0-255,4320,205730,92,360004
20389,0.00735,172.31.47.0-255,66,205796,92,360004
20390,0.007377,74.125.68.0-255,1484,207280,92,360004
20391,0.009397,74.125.68.0-255,4320,211600,92,360004
20392,0.009404,172.31.47.0-255,66,211666,92,360004
20393,0.011439,74.125.68.0-255,5738,217404,92,360004
20394,0.011446,172.31.47.0-255,66,217470,92,360004
20395,0.013481,74.125.68.0-255,5738,223208,92,360004
20396,0.013488,172.31.47.0-255,66,223274,92,360004
20397,0.015527,74.125.68.0-255,5738,229012,92,360004
20398,0.015535,172.31.47.0-255,66,229078,92,360004
20399,0.017612,74.125.68.0-255,5738,234816,92,360004
20400,0.017621,172.31.47.0-255,66,234882,92,360004
20401,0.019643,74.125.68.0-255,5738,240620,92,360004
20402,0.019649,172.31.47.0-255,66,240686,92,360004
20403,0.021671,74.125.68.0-255,5738,246424,92,360004
20404,0.02168,172.31.47.0-255,66,246490,92,360004
20405,0.023712,74.125.68.0-255,5738,252228,92,360004
20406,0.023718,172.31.47.0-255,66,252294,92,360004
20407,0.025734,74.125.68.0-255,5738,258032,92,360004
20408,0.02574,172.31.47.0-255,66,258098,92,360004
20409,0.027762,74.125.68.0-255,5738,263836,92,360004
20410,0.027769,172.31.47.0-255,66,263902,92,360004
20411,0.029798,74.125.68.0-255,5738,269640,92,360004
20412,0.029804,172.31.47.0-255,66,269706,92,360004
20413,0.031848,74.125.68.0-255,5738,275444,92,360004
20414,0.031855,172.31.47.0-255,66,275510,92,360004
20415,0.033458,172.31.47.0-255,172,275682,92,360004
20416,0.033506,172.31.47.0-255,1112,276794,92,360004
20417,0.033586,172.31.47.0-255,1514,278308,92,360004
20418,0.033588,172.31.47.0-255,1514,279822,92,360004
20419,0.033589,172.31.47.0-255,1514,281336,92,360004
20420,0.03359,172.31.47.0-255,1514,282850,92,360004
20421,0.033591,172.31.47.0-255,1494,284344,92,360004
20422,0.033876,74.125.68.0-255,5738,290082,92,360004
20423,0.033882,172.31.47.0-255,66,290148,92,360004
20424,0.034997,104.244.42.0-255,66,290214,92,360004
20425,0.035161,104.244.42.0-255,66,290280,92,360004
20426,0.035216,104.244.42.0-255,66,290346,92,360004
20427,0.035897,74.125.68.0-255,2902,293248,92,360004
20428,0.035901,172.31.47.0-255,66,293314,92,360004
20429,0.035933,74.125.68.0-255,2902,296216,92,360004
20430,0.035936,172.31.47.0-255,66,296282,92,360004
20431,0.036321,104.244.42.0-255,108,296390,92,360004
20432,0.036326,172.31.47.0-255,66,296456,92,360004
20433,0.037941,74.125.68.0-255,2902,299358,92,360004
20434,0.037946,172.31.47.0-255,66,299424,92,360004
20435,0.03798,74.125.68.0-255,2902,302326,92,360004
20436,0.037983,172.31.47.0-255,66,302392,92,360004
20437,0.039961,74.125.68.0-255,2902,305294,92,360004
20438,0.039966,172.31.47.0-255,66,305360,92,360004
20439,0.039992,74.125.68.0-255,2902,308262,92,360004
20440,0.039995,172.31.47.0-255,66,308328,92,360004
20441,0.041993,74.125.68.0-255,2902,311230,92,360004
20442,0.041997,172.31.47.0-255,66,311296,92,360004
20443,0.04202,74.125.68.0-255,2902,314198,92,360004
20444,0.042022,172.31.47.0-255,66,314264,92,360004
20445,0.044017,74.125.68.0-255,1484,315748,92,360004
20446,0.04405,74.125.68.0-255,4320,320068,92,360004
20447,0.044054,172.31.47.0-255,66,320134,92,360004
20448,0.046083,74.125.68.0-255,5738,325872,92,360004
20449,0.046088,172.31.47.0-255,66,325938,92,360004
20450,0.048113,74.125.68.0-255,4320,330258,92,360004
20451,0.048118,172.31.47.0-255,66,330324,92,360004
20452,0.048145,74.125.68.0-255,1484,331808,92,360004
20453,0.050145,74.125.68.0-255,4320,336128,92,360004
20454,0.050151,172.31.47.0-255,66,336194,92,360004
20455,0.05219,74.125.68.0-255,2902,339096,92,360004
20456,0.052195,172.31.47.0-255,66,339162,92,360004
20457,0.052223,74.125.68.0-255,2902,342064,92,360004
20458,0.052226,172.31.47.0-255,66,342130,92,360004
20459,0.05422,74.125.68.0-255,2902,345032,92,360004
20460,0.054226,172.31.47.0-255,66,345098,92,360004
20461,0.054255,74.125.68.0-255,2902,348000,92,360004
20462,0.054259,172.31.47.0-255,66,348066,92,360004
20463,0.056243,74.125.68.0-255,1484,349550,92,360004
20464,0.056276,74.125.68.0-255,1484,351034,92,360004
20465,0.056281,172.31.47.0-255,66,351100,92,360004
20466,0.056307,74.125.68.0-255,2902,354002,92,360004
20467,0.05631,172.31.47.0-255,66,354068,92,360004
20468,0.058295,74.125.68.0-255,2902,356970,92,360004
20469,0.058299,172.31.47.0-255,66,357036,92,360004
20470,0.058332,74.125.68.0-255,2902,359938,92,360004
20471,0.058335,172.31.47.0-255,66,360004,92,360004
20472,0.0,74.125.24.0-255,153,153,92,236818
20473,2.3e-05,172.31.47.0-255,66,219,92,236818
20474,3e-05,74.125.24.0-255,1484,1703,92,236818
20475,3.5e-05,172.31.47.0-255,66,1769,92,236818
20476,4.1e-05,74.125.24.0-255,2902,4671,92,236818
20477,4.5e-05,172.31.47.0-255,66,4737,92,236818
20478,5.8e-05,74.125.24.0-255,5738,10475,92,236818
20479,6.2e-05,172.31.47.0-255,66,10541,92,236818
20480,9e-05,74.125.24.0-255,3481,14022,92,236818
20481,9.3e-05,172.31.47.0-255,66,14088,92,236818
20482,0.000122,74.125.24.0-255,4320,18408,92,236818
20483,0.000125,172.31.47.0-255,66,18474,92,236818
20484,0.000131,74.125.24.0-255,5738,24212,92,236818
20485,0.000133,172.31.47.0-255,66,24278,92,236818
20486,0.000175,74.125.24.0-255,5738,30016,92,236818
20487,0.000177,172.31.47.0-255,66,30082,92,236818
20488,0.000202,74.125.24.0-255,1125,31207,92,236818
20489,0.000204,172.31.47.0-255,66,31273,92,236818
20490,0.000282,74.125.24.0-255,1484,32757,92,236818
20491,0.000285,172.31.47.0-255,66,32823,92,236818
20492,0.000313,74.125.24.0-255,2902,35725,92,236818
20493,0.000316,172.31.47.0-255,66,35791,92,236818
20494,0.000322,74.125.24.0-255,5738,41529,92,236818
20495,0.000324,172.31.47.0-255,66,41595,92,236818
20496,0.000327,74.125.24.0-255,1484,43079,92,236818
20497,0.000333,172.31.47.0-255,66,43145,92,236818
20498,0.000366,74.125.24.0-255,4320,47465,92,236818
20499,0.000369,172.31.47.0-255,66,47531,92,236818
20500,0.000376,74.125.24.0-255,6797,54328,92,236818
20501,0.000378,172.31.47.0-255,66,54394,92,236818
20502,0.000393,172.31.47.0-255,66,54460,92,236818
20503,0.000414,74.125.24.0-255,677,55137,92,236818
20504,0.000971,74.125.24.0-255,1484,56621,92,236818
20505,0.000977,172.31.47.0-255,66,56687,92,236818
20506,0.000984,74.125.24.0-255,2902,59589,92,236818
20507,0.000986,172.31.47.0-255,66,59655,92,236818
20508,0.000997,74.125.24.0-255,5738,65393,92,236818
20509,0.000999,172.31.47.0-255,66,65459,92,236818
20510,0.001026,74.125.24.0-255,2902,68361,92,236818
20511,0.001029,172.31.47.0-255,66,68427,92,236818
20512,0.001063,172.31.47.0-255,66,68493,92,236818
20513,0.001074,172.31.47.0-255,66,68559,92,236818
20514,0.001077,74.125.24.0-255,766,69325,92,236818
20515,0.001523,172.31.47.0-255,66,69391,92,236818
20516,0.001741,74.125.24.0-255,1484,70875,92,236818
20517,0.001751,74.125.24.0-255,2902,73777,92,236818
20518,0.001755,172.31.47.0-255,66,73843,92,236818
20519,0.001791,74.125.24.0-255,4320,78163,92,236818
20520,0.001794,172.31.47.0-255,66,78229,92,236818
20521,0.001798,74.125.24.0-255,1484,79713,92,236818
20522,0.001831,74.125.24.0-255,7156,86869,92,236818
20523,0.001834,172.31.47.0-255,66,86935,92,236818
20524,0.001841,74.125.24.0-255,7156,94091,92,236818
20525,0.001843,172.31.47.0-255,66,94157,92,236818
20526,0.001883,172.31.47.0-255,66,94223,92,236818
20527,0.004393,74.125.24.0-255,5738,99961,92,236818
20528,0.0044,172.31.47.0-255,66,100027,92,236818
20529,0.006917,74.125.24.0-255,5738,105765,92,236818
20530,0.006921,172.31.47.0-255,66,105831,92,236818
20531,0.009379,74.125.24.0-255,5738,111569,92,236818
20532,0.009386,172.31.47.0-255,66,111635,92,236818
20533,0.011859,74.125.24.0-255,5738,117373,92,236818
20534,0.01187,172.31.47.0-255,66,117439,92,236818
20535,0.014411,74.125.24.0-255,5738,123177,92,236818
20536,0.014421,172.31.47.0-255,66,123243,92,236818
20537,0.016905,74.125.24.0-255,5738,128981,92,236818
20538,0.016914,172.31.47.0-255,66,129047,92,236818
20539,0.019434,74.125.24.0-255,5738,134785,92,236818
20540,0.019444,172.31.47.0-255,66,134851,92,236818
20541,0.021942,74.125.24.0-255,5738,140589,92,236818
20542,0.021955,172.31.47.0-255,66,140655,92,236818
20543,0.02444,74.125.24.0-255,5738,146393,92,236818
20544,0.024452,172.31.47.0-255,66,146459,92,236818
20545,0.026932,74.125.24.0-255,5738,152197,92,236818
20546,0.02694,172.31.47.0-255,66,152263,92,236818
20547,0.029424,74.125.24.0-255,5738,158001,92,236818
20548,0.029432,172.31.47.0-255,66,158067,92,236818
20549,0.029469,172.31.47.0-255,176,158243,92,236818
20550,0.029497,172.31.47.0-255,1107,159350,92,236818
20551,0.029568,172.31.47.0-255,1514,160864,92,236818
20552,0.029591,172.31.47.0-255,1514,162378,92,236818
20553,0.029592,172.31.47.0-255,1514,163892,92,236818
20554,0.029612,172.31.47.0-255,1514,165406,92,236818
20555,0.029615,172.31.47.0-255,1500,166906,92,236818
20556,0.031036,104.244.42.0-255,66,166972,92,236818
20557,0.031044,104.244.42.0-255,66,167038,92,236818
20558,0.031176,104.244.42.0-255,66,167104,92,236818
20559,0.031181,104.244.42.0-255,66,167170,92,236818
20560,0.031907,74.125.24.0-255,5738,172908,92,236818
20561,0.031914,172.31.47.0-255,66,172974,92,236818
20562,0.034431,74.125.24.0-255,5738,178712,92,236818
20563,0.034436,172.31.47.0-255,66,178778,92,236818
20564,0.036927,74.125.24.0-255,5738,184516,92,236818
20565,0.036932,172.31.47.0-255,66,184582,92,236818
20566,0.039404,74.125.24.0-255,5738,190320,92,236818
20567,0.039412,172.31.47.0-255,66,190386,92,236818
20568,0.041905,74.125.24.0-255,5738,196124,92,236818
20569,0.041912,172.31.47.0-255,66,196190,92,236818
20570,0.044412,74.125.24.0-255,5738,201928,92,236818
20571,0.044419,172.31.47.0-255,66,201994,92,236818
20572,0.046891,74.125.24.0-255,5738,207732,92,236818
20573,0.046899,172.31.47.0-255,66,207798,92,236818
20574,0.049376,74.125.24.0-255,5738,213536,92,236818
20575,0.049382,172.31.47.0-255,66,213602,92,236818
20576,0.051846,74.125.24.0-255,5738,219340,92,236818
20577,0.051853,172.31.47.0-255,66,219406,92,236818
20578,0.054349,74.125.24.0-255,5738,225144,92,236818
20579,0.054355,172.31.47.0-255,66,225210,92,236818
20580,0.056826,74.125.24.0-255,5738,230948,92,236818
20581,0.056832,172.31.47.0-255,66,231014,92,236818
20582,0.059332,74.125.24.0-255,5738,236752,92,236818
20583,0.059338,172.31.47.0-255,66,236818,92,236818
20584,0.0,172.31.47.0-255,105,105,92,276
20585,0.00174,157.240.13.0-255,105,210,92,276
20586,0.001748,172.31.47.0-255,66,276,92,276
20587,0.0,172.253.118.0-255,153,153,92,220183
20588,3e-05,172.31.47.0-255,66,219,92,220183
20589,3.7e-05,172.253.118.0-255,1484,1703,92,220183
20590,4.2e-05,172.31.47.0-255,66,1769,92,220183
20591,4.6e-05,172.253.118.0-255,2902,4671,92,220183
20592,4.8e-05,172.31.47.0-255,66,4737,92,220183
20593,6.2e-05,172.253.118.0-255,7156,11893,92,220183
20594,6.5e-05,172.31.47.0-255,66,11959,92,220183
20595,0.000102,172.253.118.0-255,2902,14861,92,220183
20596,0.000105,172.31.47.0-255,66,14927,92,220183
20597,0.00012,172.253.118.0-255,3553,18480,92,220183
20598,0.000123,172.31.47.0-255,66,18546,92,220183
20599,0.000135,172.253.118.0-255,7156,25702,92,220183
20600,0.000138,172.31.47.0-255,66,25768,92,220183
20601,0.000143,172.253.118.0-255,5379,31147,92,220183
20602,0.000146,172.31.47.0-255,66,31213,92,220183
20603,0.001258,172.253.118.0-255,1484,32697,92,220183
20604,0.001263,172.31.47.0-255,66,32763,92,220183
20605,0.001271,172.253.118.0-255,2902,35665,92,220183
20606,0.001272,172.31.47.0-255,66,35731,92,220183
20607,0.001299,172.253.118.0-255,5738,41469,92,220183
20608,0.001301,172.31.47.0-255,66,41535,92,220183
20609,0.001315,172.253.118.0-255,1484,43019,92,220183
20610,0.001317,172.31.47.0-255,66,43085,92,220183
20611,0.001356,172.31.47.0-255,66,43151,92,220183
20612,0.001378,172.253.118.0-255,2902,46053,92,220183
20613,0.001379,172.31.47.0-255,66,46119,92,220183
20614,0.001406,172.253.118.0-255,6797,52916,92,220183
20615,0.001408,172.31.47.0-255,66,52982,92,220183
20616,0.001537,172.253.118.0-255,1484,54466,92,220183
20617,0.001539,172.31.47.0-255,66,54532,92,220183
20618,0.001542,172.253.118.0-255,1484,56016,92,220183
20619,0.001543,172.31.47.0-255,66,56082,92,220183
20620,0.001569,172.253.118.0-255,1484,57566,92,220183
20621,0.001571,172.31.47.0-255,66,57632,92,220183
20622,0.001576,172.253.118.0-255,5738,63370,92,220183
20623,0.001578,172.31.47.0-255,66,63436,92,220183
20624,0.001607,172.253.118.0-255,4320,67756,92,220183
20625,0.001609,172.31.47.0-255,66,67822,92,220183
20626,0.001641,172.253.118.0-255,1484,69306,92,220183
20627,0.001654,172.253.118.0-255,1125,70431,92,220183
20628,0.001656,172.253.118.0-255,1484,71915,92,220183
20629,0.00167,172.253.118.0-255,1484,73399,92,220183
20630,0.001682,172.253.118.0-255,7156,80555,92,220183
20631,0.0017,172.253.118.0-255,6797,87352,92,220183
20632,0.004591,172.31.47.0-255,66,87418,92,220183
20633,0.007198,172.253.118.0-255,5738,93156,92,220183
20634,0.007205,172.31.47.0-255,66,93222,92,220183
20635,0.009817,172.253.118.0-255,5738,98960,92,220183
20636,0.009824,172.31.47.0-255,66,99026,92,220183
20637,0.012431,172.253.118.0-255,5738,104764,92,220183
20638,0.012626,172.31.47.0-255,66,104830,92,220183
20639,0.015235,172.253.118.0-255,5738,110568,92,220183
20640,0.015241,172.31.47.0-255,66,110634,92,220183
20641,0.017851,172.253.118.0-255,5738,116372,92,220183
20642,0.01786,172.31.47.0-255,66,116438,92,220183
20643,0.020473,172.253.118.0-255,5738,122176,92,220183
20644,0.020479,172.31.47.0-255,66,122242,92,220183
20645,0.023077,172.253.118.0-255,5738,127980,92,220183
20646,0.023084,172.31.47.0-255,66,128046,92,220183
20647,0.025694,172.253.118.0-255,2902,130948,92,220183
20648,0.025699,172.31.47.0-255,66,131014,92,220183
20649,0.025733,172.253.118.0-255,2902,133916,92,220183
20650,0.025933,172.31.47.0-255,66,133982,92,220183
20651,0.026155,172.31.47.0-255,172,134154,92,220183
20652,0.026181,172.31.47.0-255,1103,135257,92,220183
20653,0.026227,172.31.47.0-255,1514,136771,92,220183
20654,0.026228,172.31.47.0-255,1514,138285,92,220183
20655,0.026229,172.31.47.0-255,1514,139799,92,220183
20656,0.02623,172.31.47.0-255,1514,141313,92,220183
20657,0.026232,172.31.47.0-255,1504,142817,92,220183
20658,0.027714,104.244.42.0-255,66,142883,92,220183
20659,0.027757,104.244.42.0-255,66,142949,92,220183
20660,0.027841,104.244.42.0-255,66,143015,92,220183
20661,0.028295,172.253.118.0-255,2902,145917,92,220183
20662,0.0283,172.31.47.0-255,66,145983,92,220183
20663,0.028525,172.253.118.0-255,2902,148885,92,220183
20664,0.02853,172.31.47.0-255,66,148951,92,220183
20665,0.030904,172.253.118.0-255,2902,151853,92,220183
20666,0.03091,172.31.47.0-255,66,151919,92,220183
20667,0.031127,172.253.118.0-255,2902,154821,92,220183
20668,0.031133,172.31.47.0-255,66,154887,92,220183
20669,0.0335,172.253.118.0-255,2902,157789,92,220183
20670,0.033505,172.31.47.0-255,66,157855,92,220183
20671,0.03374,172.253.118.0-255,2902,160757,92,220183
20672,0.033745,172.31.47.0-255,66,160823,92,220183
20673,0.036114,172.253.118.0-255,2902,163725,92,220183
20674,0.036118,172.31.47.0-255,66,163791,92,220183
20675,0.036331,172.253.118.0-255,2902,166693,92,220183
20676,0.036335,172.31.47.0-255,66,166759,92,220183
20677,0.038718,172.253.118.0-255,2902,169661,92,220183
20678,0.038722,172.31.47.0-255,66,169727,92,220183
20679,0.03895,172.253.118.0-255,2902,172629,92,220183
20680,0.038956,172.31.47.0-255,66,172695,92,220183
20681,0.041321,172.253.118.0-255,2902,175597,92,220183
20682,0.041325,172.31.47.0-255,66,175663,92,220183
20683,0.041547,172.253.118.0-255,2902,178565,92,220183
20684,0.041552,172.31.47.0-255,66,178631,92,220183
20685,0.043929,172.253.118.0-255,2902,181533,92,220183
20686,0.043935,172.31.47.0-255,66,181599,92,220183
20687,0.044144,172.253.118.0-255,2902,184501,92,220183
20688,0.044149,172.31.47.0-255,66,184567,92,220183
20689,0.046533,172.253.118.0-255,2902,187469,92,220183
20690,0.046537,172.31.47.0-255,66,187535,92,220183
20691,0.046758,172.253.118.0-255,2902,190437,92,220183
20692,0.046763,172.31.47.0-255,66,190503,92,220183
20693,0.049166,172.253.118.0-255,2902,193405,92,220183
20694,0.049171,172.31.47.0-255,66,193471,92,220183
20695,0.049369,172.253.118.0-255,2902,196373,92,220183
20696,0.049374,172.31.47.0-255,66,196439,92,220183
20697,0.051777,172.253.118.0-255,2902,199341,92,220183
20698,0.051781,172.31.47.0-255,66,199407,92,220183
20699,0.051974,172.253.118.0-255,2902,202309,92,220183
20700,0.051978,172.31.47.0-255,66,202375,92,220183
20701,0.054381,172.253.118.0-255,2902,205277,92,220183
20702,0.054387,172.31.47.0-255,66,205343,92,220183
20703,0.054573,172.253.118.0-255,2902,208245,92,220183
20704,0.054578,172.31.47.0-255,66,208311,92,220183
20705,0.056972,172.253.118.0-255,1484,209795,92,220183
20706,0.056977,172.31.47.0-255,66,209861,92,220183
20707,0.057005,172.253.118.0-255,1484,211345,92,220183
20708,0.057172,172.253.118.0-255,2902,214247,92,220183
20709,0.057216,172.31.47.0-255,66,214313,92,220183
20710,0.059574,172.253.118.0-255,1484,215797,92,220183
20711,0.059816,172.253.118.0-255,4320,220117,92,220183
20712,0.059882,172.31.47.0-255,66,220183,92,220183
20713,0.0,172.217.194.0-255,153,153,92,274678
20714,1.6e-05,172.31.47.0-255,66,219,92,274678
20715,3.5e-05,172.217.194.0-255,1484,1703,92,274678
20716,4e-05,172.31.47.0-255,66,1769,92,274678
20717,4.5e-05,172.217.194.0-255,2902,4671,92,274678
20718,4.7e-05,172.31.47.0-255,66,4737,92,274678
20719,4.9e-05,172.217.194.0-255,1484,6221,92,274678
20720,5.1e-05,172.31.47.0-255,66,6287,92,274678
20721,8.7e-05,172.217.194.0-255,5738,12025,92,274678
20722,9e-05,172.31.47.0-255,66,12091,92,274678
20723,9.4e-05,172.217.194.0-255,2111,14202,92,274678
20724,9.6e-05,172.31.47.0-255,66,14268,92,274678
20725,0.00025,172.217.194.0-255,1484,15752,92,274678
20726,0.000257,172.31.47.0-255,66,15818,92,274678
20727,0.000263,172.217.194.0-255,2902,18720,92,274678
20728,0.000266,172.31.47.0-255,66,18786,92,274678
20729,0.00027,172.217.194.0-255,2902,21688,92,274678
20730,0.000273,172.31.47.0-255,66,21754,92,274678
20731,0.000296,172.217.194.0-255,7156,28910,92,274678
20732,0.000299,172.31.47.0-255,66,28976,92,274678
20733,0.00033,172.31.47.0-255,66,29042,92,274678
20734,0.000355,172.31.47.0-255,66,29108,92,274678
20735,0.000379,172.217.194.0-255,4320,33428,92,274678
20736,0.000381,172.31.47.0-255,66,33494,92,274678
20737,0.00041,172.31.47.0-255,66,33560,92,274678
20738,0.000424,172.217.194.0-255,2795,36355,92,274678
20739,0.000427,172.31.47.0-255,66,36421,92,274678
20740,0.00056,172.217.194.0-255,1484,37905,92,274678
20741,0.000566,172.31.47.0-255,66,37971,92,274678
20742,0.000573,172.217.194.0-255,2902,40873,92,274678
20743,0.00058,172.217.194.0-255,5738,46611,92,274678
20744,0.000602,172.31.47.0-255,66,46677,92,274678
20745,0.000626,172.31.47.0-255,66,46743,92,274678
20746,0.000639,172.217.194.0-255,7156,53899,92,274678
20747,0.000654,172.217.194.0-255,3602,57501,92,274678
20748,0.000687,172.31.47.0-255,66,57567,92,274678
20749,0.001206,172.217.194.0-255,1484,59051,92,274678
20750,0.001215,172.217.194.0-255,2902,61953,92,274678
20751,0.001219,172.31.47.0-255,66,62019,92,274678
20752,0.001242,172.217.194.0-255,5738,67757,92,274678
20753,0.001245,172.217.194.0-255,1484,69241,92,274678
20754,0.00126,172.217.194.0-255,1484,70725,92,274678
20755,0.001273,172.217.194.0-255,4320,75045,92,274678
20756,0.001275,172.31.47.0-255,66,75111,92,274678
20757,0.001289,172.217.194.0-255,7156,82267,92,274678
20758,0.001293,172.31.47.0-255,66,82333,92,274678
20759,0.001324,172.31.47.0-255,66,82399,92,274678
20760,0.001331,172.217.194.0-255,766,83165,92,274678
20761,0.001585,172.217.194.0-255,1484,84649,92,274678
20762,0.00159,172.31.47.0-255,66,84715,92,274678
20763,0.001595,172.217.194.0-255,2902,87617,92,274678
20764,0.001607,172.217.194.0-255,2902,90519,92,274678
20765,0.001622,172.217.194.0-255,2902,93421,92,274678
20766,0.001628,172.31.47.0-255,66,93487,92,274678
20767,0.001638,172.217.194.0-255,4320,97807,92,274678
20768,0.001642,172.31.47.0-255,66,97873,92,274678
20769,0.00166,172.217.194.0-255,5738,103611,92,274678
20770,0.001681,172.31.47.0-255,66,103677,92,274678
20771,0.001713,172.217.194.0-255,5020,108697,92,274678
20772,0.001724,172.31.47.0-255,66,108763,92,274678
20773,0.003796,172.217.194.0-255,5738,114501,92,274678
20774,0.003801,172.31.47.0-255,66,114567,92,274678
20775,0.005853,172.217.194.0-255,5738,120305,92,274678
20776,0.005859,172.31.47.0-255,66,120371,92,274678
20777,0.007985,172.217.194.0-255,5738,126109,92,274678
20778,0.007993,172.31.47.0-255,66,126175,92,274678
20779,0.010062,172.217.194.0-255,5738,131913,92,274678
20780,0.010069,172.31.47.0-255,66,131979,92,274678
20781,0.012139,172.217.194.0-255,5738,137717,92,274678
20782,0.01215,172.31.47.0-255,66,137783,92,274678
20783,0.014229,172.217.194.0-255,5738,143521,92,274678
20784,0.014237,172.31.47.0-255,66,143587,92,274678
20785,0.016291,172.217.194.0-255,5738,149325,92,274678
20786,0.016297,172.31.47.0-255,66,149391,92,274678
20787,0.018395,172.217.194.0-255,5738,155129,92,274678
20788,0.018402,172.31.47.0-255,66,155195,92,274678
20789,0.0205,172.217.194.0-255,5738,160933,92,274678
20790,0.020507,172.31.47.0-255,66,160999,92,274678
20791,0.02258,172.217.194.0-255,5738,166737,92,274678
20792,0.022588,172.31.47.0-255,66,166803,92,274678
20793,0.024637,172.217.194.0-255,5738,172541,92,274678
20794,0.024643,172.31.47.0-255,66,172607,92,274678
20795,0.026719,172.217.194.0-255,5738,178345,92,274678
20796,0.026727,172.31.47.0-255,66,178411,92,274678
20797,0.027112,172.31.47.0-255,172,178583,92,274678
20798,0.027142,172.31.47.0-255,1103,179686,92,274678
20799,0.027196,172.31.47.0-255,1514,181200,92,274678
20800,0.027198,172.31.47.0-255,1514,182714,92,274678
20801,0.0272,172.31.47.0-255,1514,184228,92,274678
20802,0.027201,172.31.47.0-255,1514,185742,92,274678
20803,0.027228,172.31.47.0-255,1504,187246,92,274678
20804,0.028655,104.244.42.0-255,66,187312,92,274678
20805,0.028685,104.244.42.0-255,66,187378,92,274678
20806,0.028761,172.217.194.0-255,5738,193116,92,274678
20807,0.028769,172.31.47.0-255,66,193182,92,274678
20808,0.028805,104.244.42.0-255,66,193248,92,274678
20809,0.029465,104.244.42.0-255,108,193356,92,274678
20810,0.029476,172.31.47.0-255,66,193422,92,274678
20811,0.030871,172.217.194.0-255,5738,199160,92,274678
20812,0.030884,172.31.47.0-255,66,199226,92,274678
20813,0.032937,172.217.194.0-255,5738,204964,92,274678
20814,0.033552,172.31.47.0-255,66,205030,92,274678
20815,0.035592,172.217.194.0-255,5738,210768,92,274678
20816,0.035605,172.31.47.0-255,66,210834,92,274678
20817,0.037691,172.217.194.0-255,5738,216572,92,274678
20818,0.037706,172.31.47.0-255,66,216638,92,274678
20819,0.039768,172.217.194.0-255,5738,222376,92,274678
20820,0.039787,172.31.47.0-255,66,222442,92,274678
20821,0.041844,172.217.194.0-255,5738,228180,92,274678
20822,0.04185,172.31.47.0-255,66,228246,92,274678
20823,0.043911,172.217.194.0-255,5738,233984,92,274678
20824,0.043925,172.31.47.0-255,66,234050,92,274678
20825,0.046005,172.217.194.0-255,5738,239788,92,274678
20826,0.046023,172.31.47.0-255,66,239854,92,274678
20827,0.048099,172.217.194.0-255,5738,245592,92,274678
20828,0.048116,172.31.47.0-255,66,245658,92,274678
20829,0.050227,172.217.194.0-255,5738,251396,92,274678
20830,0.050243,172.31.47.0-255,66,251462,92,274678
20831,0.05235,172.217.194.0-255,5738,257200,92,274678
20832,0.05237,172.31.47.0-255,66,257266,92,274678
20833,0.05446,172.217.194.0-255,5738,263004,92,274678
20834,0.054474,172.31.47.0-255,66,263070,92,274678
20835,0.056558,172.217.194.0-255,5738,268808,92,274678
20836,0.056568,172.31.47.0-255,66,268874,92,274678
20837,0.058635,172.217.194.0-255,5738,274612,92,274678
20838,0.058641,172.31.47.0-255,66,274678,92,274678
20839,0.0,172.217.194.0-255,153,153,92,274231
20840,2.4e-05,172.31.47.0-255,66,219,92,274231
20841,3.1e-05,172.217.194.0-255,1484,1703,92,274231
20842,3.5e-05,172.31.47.0-255,66,1769,92,274231
20843,5.8e-05,172.217.194.0-255,1484,3253,92,274231
20844,6e-05,172.31.47.0-255,66,3319,92,274231
20845,7.6e-05,172.217.194.0-255,1484,4803,92,274231
20846,7.8e-05,172.31.47.0-255,66,4869,92,274231
20847,8e-05,172.217.194.0-255,1484,6353,92,274231
20848,8.1e-05,172.31.47.0-255,66,6419,92,274231
20849,9.9e-05,172.217.194.0-255,4320,10739,92,274231
20850,0.000101,172.31.47.0-255,66,10805,92,274231
20851,0.000106,172.217.194.0-255,3508,14313,92,274231
20852,0.000108,172.31.47.0-255,66,14379,92,274231
20853,0.000134,172.31.47.0-255,66,14445,92,274231
20854,0.000154,172.217.194.0-255,5379,19824,92,274231
20855,0.000156,172.31.47.0-255,66,19890,92,274231
20856,0.000231,172.217.194.0-255,1484,21374,92,274231
20857,0.000233,172.31.47.0-255,66,21440,92,274231
20858,0.000236,172.217.194.0-255,1484,22924,92,274231
20859,0.000237,172.31.47.0-255,66,22990,92,274231
20860,0.000251,172.217.194.0-255,1484,24474,92,274231
20861,0.000252,172.31.47.0-255,66,24540,92,274231
20862,0.000257,172.217.194.0-255,2902,27442,92,274231
20863,0.00026,172.31.47.0-255,66,27508,92,274231
20864,0.000281,172.217.194.0-255,2902,30410,92,274231
20865,0.000284,172.31.47.0-255,66,30476,92,274231
20866,0.000297,172.217.194.0-255,4320,34796,92,274231
20867,0.000301,172.31.47.0-255,66,34862,92,274231
20868,0.000314,172.217.194.0-255,2543,37405,92,274231
20869,0.000317,172.31.47.0-255,66,37471,92,274231
20870,0.000335,172.217.194.0-255,4320,41791,92,274231
20871,0.000337,172.31.47.0-255,66,41857,92,274231
20872,0.000349,172.217.194.0-255,2902,44759,92,274231
20873,0.000351,172.31.47.0-255,66,44825,92,274231
20874,0.000358,172.217.194.0-255,7156,51981,92,274231
20875,0.000362,172.31.47.0-255,66,52047,92,274231
20876,0.000371,172.217.194.0-255,2543,54590,92,274231
20877,0.000373,172.31.47.0-255,66,54656,92,274231
20878,0.000618,172.217.194.0-255,645,55301,92,274231
20879,0.000721,172.217.194.0-255,1484,56785,92,274231
20880,0.000725,172.31.47.0-255,66,56851,92,274231
20881,0.000729,172.217.194.0-255,1484,58335,92,274231
20882,0.000743,172.217.194.0-255,1484,59819,92,274231
20883,0.000745,172.31.47.0-255,66,59885,92,274231
20884,0.000752,172.217.194.0-255,5738,65623,92,274231
20885,0.000755,172.31.47.0-255,66,65689,92,274231
20886,0.000762,172.217.194.0-255,6797,72486,92,274231
20887,0.000765,172.31.47.0-255,66,72552,92,274231
20888,0.000821,172.217.194.0-255,7156,79708,92,274231
20889,0.000825,172.31.47.0-255,66,79774,92,274231
20890,0.000842,172.217.194.0-255,7156,86930,92,274231
20891,0.000844,172.31.47.0-255,66,86996,92,274231
20892,0.000858,172.217.194.0-255,2543,89539,92,274231
20893,0.000861,172.31.47.0-255,66,89605,92,274231
20894,0.001643,172.217.194.0-255,1484,91089,92,274231
20895,0.001654,172.217.194.0-255,2902,93991,92,274231
20896,0.00166,172.31.47.0-255,66,94057,92,274231
20897,0.001668,172.217.194.0-255,5738,99795,92,274231
20898,0.00167,172.31.47.0-255,66,99861,92,274231
20899,0.001676,172.217.194.0-255,5738,105599,92,274231
20900,0.001678,172.31.47.0-255,66,105665,92,274231
20901,0.001695,172.217.194.0-255,2902,108567,92,274231
20902,0.001698,172.31.47.0-255,66,108633,92,274231
20903,0.001733,172.31.47.0-255,66,108699,92,274231
20904,0.00174,172.217.194.0-255,5020,113719,92,274231
20905,0.001741,172.31.47.0-255,66,113785,92,274231
20906,0.001906,172.217.194.0-255,1484,115269,92,274231
20907,0.001909,172.217.194.0-255,1484,116753,92,274231
20908,0.001911,172.31.47.0-255,66,116819,92,274231
20909,0.001929,172.217.194.0-255,1484,118303,92,274231
20910,0.001936,172.217.194.0-255,5738,124041,92,274231
20911,0.001938,172.31.47.0-255,66,124107,92,274231
20912,0.001954,172.217.194.0-255,4320,128427,92,274231
20913,0.001956,172.31.47.0-255,66,128493,92,274231
20914,0.001979,172.31.47.0-255,66,128559,92,274231
20915,0.001984,172.217.194.0-255,2902,131461,92,274231
20916,0.001986,172.31.47.0-255,66,131527,92,274231
20917,0.002012,172.31.47.0-255,66,131593,92,274231
20918,0.002132,172.217.194.0-255,1484,133077,92,274231
20919,0.002147,172.217.194.0-255,2902,135979,92,274231
20920,0.002149,172.31.47.0-255,66,136045,92,274231
20921,0.002154,172.217.194.0-255,4320,140365,92,274231
20922,0.002156,172.31.47.0-255,66,140431,92,274231
20923,0.002167,172.217.194.0-255,1484,141915,92,274231
20924,0.002175,172.217.194.0-255,7156,149071,92,274231
20925,0.002177,172.31.47.0-255,66,149137,92,274231
20926,0.002197,172.217.194.0-255,2902,152039,92,274231
20927,0.0022,172.31.47.0-255,66,152105,92,274231
20928,0.002239,172.217.194.0-255,4320,156425,92,274231
20929,0.002242,172.31.47.0-255,66,156491,92,274231
20930,0.002259,172.217.194.0-255,7156,163647,92,274231
20931,0.002262,172.31.47.0-255,66,163713,92,274231
20932,0.002285,172.217.194.0-255,2184,165897,92,274231
20933,0.002287,172.31.47.0-255,66,165963,92,274231
20934,0.00229,172.217.194.0-255,2902,168865,92,274231
20935,0.002293,172.31.47.0-255,66,168931,92,274231
20936,0.002297,172.217.194.0-255,4320,173251,92,274231
20937,0.002299,172.31.47.0-255,66,173317,92,274231
20938,0.002305,172.217.194.0-255,4320,177637,92,274231
20939,0.002307,172.31.47.0-255,66,177703,92,274231
20940,0.00232,172.217.194.0-255,4320,182023,92,274231
20941,0.002322,172.31.47.0-255,66,182089,92,274231
20942,0.00236,172.31.47.0-255,66,182155,92,274231
20943,0.0024,172.31.47.0-255,66,182221,92,274231
20944,0.002424,172.31.47.0-255,66,182287,92,274231
20945,0.002468,172.31.47.0-255,66,182353,92,274231
20946,0.002518,172.217.194.0-255,1484,183837,92,274231
20947,0.002522,172.217.194.0-255,2902,186739,92,274231
20948,0.002524,172.31.47.0-255,66,186805,92,274231
20949,0.002527,172.217.194.0-255,1484,188289,92,274231
20950,0.002534,172.217.194.0-255,7156,195445,92,274231
20951,0.002536,172.31.47.0-255,66,195511,92,274231
20952,0.002547,172.217.194.0-255,1484,196995,92,274231
20953,0.002552,172.217.194.0-255,4320,201315,92,274231
20954,0.002554,172.31.47.0-255,66,201381,92,274231
20955,0.002557,172.217.194.0-255,1484,202865,92,274231
20956,0.002586,172.217.194.0-255,4320,207185,92,274231
20957,0.002588,172.31.47.0-255,66,207251,92,274231
20958,0.002609,172.31.47.0-255,66,207317,92,274231
20959,0.002659,172.217.194.0-255,1484,208801,92,274231
20960,0.002676,172.217.194.0-255,2902,211703,92,274231
20961,0.002678,172.31.47.0-255,66,211769,92,274231
20962,0.002682,172.217.194.0-255,2902,214671,92,274231
20963,0.002683,172.31.47.0-255,66,214737,92,274231
20964,0.002699,172.217.194.0-255,2902,217639,92,274231
20965,0.002701,172.31.47.0-255,66,217705,92,274231
20966,0.002705,172.217.194.0-255,5738,223443,92,274231
20967,0.002707,172.31.47.0-255,66,223509,92,274231
20968,0.002721,172.217.194.0-255,4320,227829,92,274231
20969,0.00274,172.217.194.0-255,5020,232849,92,274231
20970,0.002781,172.217.194.0-255,2902,235751,92,274231
20971,0.002792,172.217.194.0-255,2902,238653,92,274231
20972,0.002801,172.217.194.0-255,1484,240137,92,274231
20973,0.002816,172.217.194.0-255,5738,245875,92,274231
20974,0.002852,172.217.194.0-255,4320,250195,92,274231
20975,0.002881,172.217.194.0-255,1484,251679,92,274231
20976,0.002887,172.217.194.0-255,5020,256699,92,274231
20977,0.00289,172.217.194.0-255,2902,259601,92,274231
20978,0.00291,172.217.194.0-255,2902,262503,92,274231
20979,0.003008,172.217.194.0-255,2354,264857,92,274231
20980,0.003061,172.217.194.0-255,105,264962,92,274231
20981,0.00571,172.31.47.0-255,66,265028,92,274231
20982,0.008123,172.31.47.0-255,105,265133,92,274231
20983,0.010609,172.217.194.0-255,66,265199,92,274231
20984,0.037202,172.31.47.0-255,172,265371,92,274231
20985,0.037231,172.31.47.0-255,1107,266478,92,274231
20986,0.037277,172.31.47.0-255,1514,267992,92,274231
20987,0.037279,172.31.47.0-255,1514,269506,92,274231
20988,0.037283,172.31.47.0-255,1514,271020,92,274231
20989,0.037285,172.31.47.0-255,1514,272534,92,274231
20990,0.037301,172.31.47.0-255,1499,274033,92,274231
20991,0.038761,104.244.42.0-255,66,274099,92,274231
20992,0.038771,104.244.42.0-255,66,274165,92,274231
20993,0.038906,104.244.42.0-255,66,274231,92,274231
20994,0.0,172.217.194.0-255,153,153,92,205044
20995,3.4e-05,172.31.47.0-255,66,219,92,205044
20996,4e-05,172.217.194.0-255,1484,1703,92,205044
20997,4.5e-05,172.31.47.0-255,66,1769,92,205044
20998,5e-05,172.217.194.0-255,2902,4671,92,205044
20999,5.2e-05,172.31.47.0-255,66,4737,92,205044
21000,5.9e-05,172.217.194.0-255,7156,11893,92,205044
21001,6.2e-05,172.31.47.0-255,66,11959,92,205044
21002,6.9e-05,172.217.194.0-255,7156,19115,92,205044
21003,7.1e-05,172.31.47.0-255,66,19181,92,205044
21004,0.0001,172.217.194.0-255,2128,21309,92,205044
21005,0.000105,172.31.47.0-255,66,21375,92,205044
21006,0.000117,172.31.47.0-255,66,21441,92,205044
21007,0.000153,172.217.194.0-255,1484,22925,92,205044
21008,0.000156,172.31.47.0-255,66,22991,92,205044
21009,0.000175,172.217.194.0-255,2902,25893,92,205044
21010,0.000177,172.31.47.0-255,66,25959,92,205044
21011,0.000203,172.217.194.0-255,5738,31697,92,205044
21012,0.000206,172.31.47.0-255,66,31763,92,205044
21013,0.000232,172.31.47.0-255,66,31829,92,205044
21014,0.000258,172.217.194.0-255,2543,34372,92,205044
21015,0.00026,172.31.47.0-255,66,34438,92,205044
21016,0.000271,172.31.47.0-255,66,34504,92,205044
21017,0.000274,172.217.194.0-255,376,34880,92,205044
21018,0.000275,172.31.47.0-255,66,34946,92,205044
21019,0.000301,172.217.194.0-255,367,35313,92,205044
21020,0.000304,172.31.47.0-255,66,35379,92,205044
21021,0.000439,172.217.194.0-255,1484,36863,92,205044
21022,0.000443,172.31.47.0-255,66,36929,92,205044
21023,0.000448,172.217.194.0-255,2902,39831,92,205044
21024,0.00045,172.31.47.0-255,66,39897,92,205044
21025,0.000457,172.217.194.0-255,5738,45635,92,205044
21026,0.000459,172.31.47.0-255,66,45701,92,205044
21027,0.000496,172.31.47.0-255,66,45767,92,205044
21028,0.000507,172.31.47.0-255,66,45833,92,205044
21029,0.000528,172.217.194.0-255,1635,47468,92,205044
21030,0.000533,172.31.47.0-255,66,47534,92,205044
21031,0.000563,172.217.194.0-255,1484,49018,92,205044
21032,0.000569,172.217.194.0-255,2902,51920,92,205044
21033,0.000572,172.31.47.0-255,66,51986,92,205044
21034,0.000595,172.217.194.0-255,5738,57724,92,205044
21035,0.000598,172.31.47.0-255,66,57790,92,205044
21036,0.000603,172.217.194.0-255,4320,62110,92,205044
21037,0.000605,172.31.47.0-255,66,62176,92,205044
21038,0.000652,172.217.194.0-255,2543,64719,92,205044
21039,0.000656,172.31.47.0-255,66,64785,92,205044
21040,0.0007,172.217.194.0-255,1484,66269,92,205044
21041,0.000705,172.217.194.0-255,2902,69171,92,205044
21042,0.000707,172.31.47.0-255,66,69237,92,205044
21043,0.000722,172.217.194.0-255,5738,74975,92,205044
21044,0.000724,172.31.47.0-255,66,75041,92,205044
21045,0.000768,172.31.47.0-255,66,75107,92,205044
21046,0.00078,172.31.47.0-255,66,75173,92,205044
21047,0.000805,172.217.194.0-255,2902,78075,92,205044
21048,0.000808,172.31.47.0-255,66,78141,92,205044
21049,0.000829,172.217.194.0-255,7156,85297,92,205044
21050,0.000832,172.31.47.0-255,66,85363,92,205044
21051,0.000845,172.31.47.0-255,66,85429,92,205044
21052,0.000848,172.217.194.0-255,1484,86913,92,205044
21053,0.000881,172.31.47.0-255,66,86979,92,205044
21054,0.000893,172.217.194.0-255,766,87745,92,205044
21055,0.000905,172.31.47.0-255,66,87811,92,205044
21056,0.000932,172.217.194.0-255,2902,90713,92,205044
21057,0.000935,172.31.47.0-255,66,90779,92,205044
21058,0.000947,172.31.47.0-255,66,90845,92,205044
21059,0.000963,172.217.194.0-255,7156,98001,92,205044
21060,0.000966,172.31.47.0-255,66,98067,92,205044
21061,0.000986,172.217.194.0-255,2184,100251,92,205044
21062,0.000989,172.31.47.0-255,66,100317,92,205044
21063,0.000998,172.31.47.0-255,66,100383,92,205044
21064,0.001018,172.217.194.0-255,1484,101867,92,205044
21065,0.001029,172.31.47.0-255,66,101933,92,205044
21066,0.001046,172.217.194.0-255,4320,106253,92,205044
21067,0.001049,172.31.47.0-255,66,106319,92,205044
21068,0.001066,172.217.194.0-255,5738,112057,92,205044
21069,0.001071,172.31.47.0-255,66,112123,92,205044
21070,0.001084,172.217.194.0-255,5020,117143,92,205044
21071,0.001086,172.31.47.0-255,66,117209,92,205044
21072,0.001438,172.217.194.0-255,1484,118693,92,205044
21073,0.001444,172.217.194.0-255,2902,121595,92,205044
21074,0.001448,172.31.47.0-255,66,121661,92,205044
21075,0.001449,172.217.194.0-255,5738,127399,92,205044
21076,0.001451,172.31.47.0-255,66,127465,92,205044
21077,0.001481,172.31.47.0-255,66,127531,92,205044
21078,0.00152,172.217.194.0-255,4320,131851,92,205044
21079,0.001523,172.31.47.0-255,66,131917,92,205044
21080,0.001552,172.31.47.0-255,66,131983,92,205044
21081,0.001568,172.217.194.0-255,1484,133467,92,205044
21082,0.001572,172.217.194.0-255,2902,136369,92,205044
21083,0.001575,172.31.47.0-255,66,136435,92,205044
21084,0.001599,172.217.194.0-255,5738,142173,92,205044
21085,0.001602,172.31.47.0-255,66,142239,92,205044
21086,0.001615,172.31.47.0-255,66,142305,92,205044
21087,0.001658,172.217.194.0-255,5738,148043,92,205044
21088,0.001661,172.31.47.0-255,66,148109,92,205044
21089,0.001684,172.217.194.0-255,4320,152429,92,205044
21090,0.001687,172.31.47.0-255,66,152495,92,205044
21091,0.00169,172.217.194.0-255,766,153261,92,205044
21092,0.001692,172.217.194.0-255,1484,154745,92,205044
21093,0.001694,172.31.47.0-255,66,154811,92,205044
21094,0.001698,172.217.194.0-255,4320,159131,92,205044
21095,0.0017,172.31.47.0-255,66,159197,92,205044
21096,0.001704,172.217.194.0-255,2902,162099,92,205044
21097,0.001707,172.31.47.0-255,66,162165,92,205044
21098,0.00177,172.217.194.0-255,7156,169321,92,205044
21099,0.001774,172.31.47.0-255,66,169387,92,205044
21100,0.001789,172.31.47.0-255,66,169453,92,205044
21101,0.001792,172.217.194.0-255,6438,175891,92,205044
21102,0.001794,172.31.47.0-255,66,175957,92,205044
21103,0.001795,172.217.194.0-255,2902,178859,92,205044
21104,0.001797,172.31.47.0-255,66,178925,92,205044
21105,0.00182,172.217.194.0-255,4320,183245,92,205044
21106,0.001823,172.31.47.0-255,66,183311,92,205044
21107,0.001836,172.31.47.0-255,66,183377,92,205044
21108,0.001859,172.217.194.0-255,4320,187697,92,205044
21109,0.001862,172.31.47.0-255,66,187763,92,205044
21110,0.001864,172.217.194.0-255,1484,189247,92,205044
21111,0.001868,172.217.194.0-255,1484,190731,92,205044
21112,0.001869,172.31.47.0-255,66,190797,92,205044
21113,0.001885,172.217.194.0-255,5738,196535,92,205044
21114,0.001891,172.31.47.0-255,66,196601,92,205044
21115,0.001923,172.31.47.0-255,66,196667,92,205044
21116,0.001926,172.217.194.0-255,1484,198151,92,205044
21117,0.001945,172.31.47.0-255,66,198217,92,205044
21118,0.001949,172.217.194.0-255,4193,202410,92,205044
21119,0.001953,172.31.47.0-255,66,202476,92,205044
21120,0.001976,172.217.194.0-255,105,202581,92,205044
21121,0.007551,172.31.47.0-255,66,202647,92,205044
21122,0.007576,172.31.47.0-255,105,202752,92,205044
21123,0.010069,172.217.194.0-255,66,202818,92,205044
21124,0.039653,172.31.47.0-255,172,202990,92,205044
21125,0.039685,172.31.47.0-255,1111,204101,92,205044
21126,0.03972,172.31.47.0-255,571,204672,92,205044
21127,0.041173,104.244.42.0-255,66,204738,92,205044
21128,0.041222,104.244.42.0-255,66,204804,92,205044
21129,0.041268,104.244.42.0-255,66,204870,92,205044
21130,0.041837,104.244.42.0-255,108,204978,92,205044
21131,0.041843,172.31.47.0-255,66,205044,92,205044
21132,0.0,74.125.130.0-255,297,297,92,310350
21133,2.2e-05,172.31.47.0-255,66,363,92,310350
21134,2.8e-05,74.125.130.0-255,1484,1847,92,310350
21135,3.1e-05,172.31.47.0-255,66,1913,92,310350
21136,3.6e-05,74.125.130.0-255,2902,4815,92,310350
21137,3.8e-05,172.31.47.0-255,66,4881,92,310350
21138,6.1e-05,74.125.130.0-255,2902,7783,92,310350
21139,6.4e-05,172.31.47.0-255,66,7849,92,310350
21140,8.6e-05,74.125.130.0-255,1484,9333,92,310350
21141,8.8e-05,172.31.47.0-255,66,9399,92,310350
21142,9.5e-05,74.125.130.0-255,2902,12301,92,310350
21143,9.7e-05,172.31.47.0-255,66,12367,92,310350
21144,0.00012,74.125.130.0-255,3283,15650,92,310350
21145,0.000122,172.31.47.0-255,66,15716,92,310350
21146,0.00015,172.31.47.0-255,66,15782,92,310350
21147,0.000186,74.125.130.0-255,5738,21520,92,310350
21148,0.000188,172.31.47.0-255,66,21586,92,310350
21149,0.000212,74.125.130.0-255,1125,22711,92,310350
21150,0.000214,172.31.47.0-255,66,22777,92,310350
21151,0.000309,74.125.130.0-255,1484,24261,92,310350
21152,0.000312,172.31.47.0-255,66,24327,92,310350
21153,0.000316,74.125.130.0-255,2902,27229,92,310350
21154,0.000319,172.31.47.0-255,66,27295,92,310350
21155,0.000321,74.125.130.0-255,1484,28779,92,310350
21156,0.000323,172.31.47.0-255,66,28845,92,310350
21157,0.000361,74.125.130.0-255,5738,34583,92,310350
21158,0.000364,172.31.47.0-255,66,34649,92,310350
21159,0.000388,74.125.130.0-255,5379,40028,92,310350
21160,0.00039,172.31.47.0-255,66,40094,92,310350
21161,0.00042,74.125.130.0-255,5738,45832,92,310350
21162,0.000423,172.31.47.0-255,66,45898,92,310350
21163,0.000425,74.125.130.0-255,1484,47382,92,310350
21164,0.00045,74.125.130.0-255,4320,51702,92,310350
21165,0.000452,172.31.47.0-255,66,51768,92,310350
21166,0.000503,74.125.130.0-255,5669,57437,92,310350
21167,0.000506,172.31.47.0-255,66,57503,92,310350
21168,0.00056,74.125.130.0-255,365,57868,92,310350
21169,0.000762,74.125.130.0-255,1484,59352,92,310350
21170,0.000767,172.31.47.0-255,66,59418,92,310350
21171,0.000772,74.125.130.0-255,1484,60902,92,310350
21172,0.000796,74.125.130.0-255,1484,62386,92,310350
21173,0.000799,74.125.130.0-255,1484,63870,92,310350
21174,0.000805,172.31.47.0-255,66,63936,92,310350
21175,0.000829,74.125.130.0-255,2902,66838,92,310350
21176,0.000832,172.31.47.0-255,66,66904,92,310350
21177,0.000835,74.125.130.0-255,1484,68388,92,310350
21178,0.000859,74.125.130.0-255,2902,71290,92,310350
21179,0.000862,172.31.47.0-255,66,71356,92,310350
21180,0.000887,74.125.130.0-255,5738,77094,92,310350
21181,0.00089,172.31.47.0-255,66,77160,92,310350
21182,0.000892,74.125.130.0-255,1484,78644,92,310350
21183,0.000938,172.31.47.0-255,66,78710,92,310350
21184,0.000942,74.125.130.0-255,2902,81612,92,310350
21185,0.000944,172.31.47.0-255,66,81678,92,310350
21186,0.000991,74.125.130.0-255,2184,83862,92,310350
21187,0.000995,172.31.47.0-255,66,83928,92,310350
21188,0.001136,74.125.130.0-255,1484,85412,92,310350
21189,0.001155,74.125.130.0-255,2902,88314,92,310350
21190,0.001159,172.31.47.0-255,66,88380,92,310350
21191,0.001188,74.125.130.0-255,5738,94118,92,310350
21192,0.001191,172.31.47.0-255,66,94184,92,310350
21193,0.001196,74.125.130.0-255,2902,97086,92,310350
21194,0.001199,172.31.47.0-255,66,97152,92,310350
21195,0.001203,74.125.130.0-255,2902,100054,92,310350
21196,0.00121,172.31.47.0-255,66,100120,92,310350
21197,0.00124,74.125.130.0-255,1484,101604,92,310350
21198,0.001252,172.31.47.0-255,66,101670,92,310350
21199,0.001263,172.31.47.0-255,66,101736,92,310350
21200,0.001295,74.125.130.0-255,4320,106056,92,310350
21201,0.001298,172.31.47.0-255,66,106122,92,310350
21202,0.001318,74.125.130.0-255,2902,109024,92,310350
21203,0.001321,172.31.47.0-255,66,109090,92,310350
21204,0.00133,172.31.47.0-255,66,109156,92,310350
21205,0.00138,172.31.47.0-255,66,109222,92,310350
21206,0.001405,74.125.130.0-255,5020,114242,92,310350
21207,0.001409,172.31.47.0-255,66,114308,92,310350
21208,0.00146,74.125.130.0-255,1484,115792,92,310350
21209,0.001474,74.125.130.0-255,2902,118694,92,310350
21210,0.001479,172.31.47.0-255,66,118760,92,310350
21211,0.001499,74.125.130.0-255,5738,124498,92,310350
21212,0.001501,172.31.47.0-255,66,124564,92,310350
21213,0.001504,74.125.130.0-255,2902,127466,92,310350
21214,0.001507,172.31.47.0-255,66,127532,92,310350
21215,0.001531,74.125.130.0-255,4320,131852,92,310350
21216,0.001536,172.31.47.0-255,66,131918,92,310350
21217,0.001542,74.125.130.0-255,5738,137656,92,310350
21218,0.001543,172.31.47.0-255,66,137722,92,310350
21219,0.001566,74.125.130.0-255,2902,140624,92,310350
21220,0.001568,172.31.47.0-255,66,140690,92,310350
21221,0.001572,74.125.130.0-255,4320,145010,92,310350
21222,0.001574,172.31.47.0-255,66,145076,92,310350
21223,0.001609,74.125.130.0-255,3602,148678,92,310350
21224,0.001612,172.31.47.0-255,66,148744,92,310350
21225,0.00196,74.125.130.0-255,1484,150228,92,310350
21226,0.001964,74.125.130.0-255,1484,151712,92,310350
21227,0.001966,172.31.47.0-255,66,151778,92,310350
21228,0.001988,74.125.130.0-255,1484,153262,92,310350
21229,0.001993,74.125.130.0-255,4320,157582,92,310350
21230,0.001994,172.31.47.0-255,66,157648,92,310350
21231,0.002016,74.125.130.0-255,1484,159132,92,310350
21232,0.002021,74.125.130.0-255,5738,164870,92,310350
21233,0.002023,172.31.47.0-255,66,164936,92,310350
21234,0.002047,74.125.130.0-255,1484,166420,92,310350
21235,0.002056,172.31.47.0-255,66,166486,92,310350
21236,0.002058,74.125.130.0-255,1484,167970,92,310350
21237,0.002077,74.125.130.0-255,2902,170872,92,310350
21238,0.002079,172.31.47.0-255,66,170938,92,310350
21239,0.00211,74.125.130.0-255,3602,174540,92,310350
21240,0.002112,172.31.47.0-255,66,174606,92,310350
21241,0.002557,74.125.130.0-255,1484,176090,92,310350
21242,0.002583,74.125.130.0-255,1484,177574,92,310350
21243,0.002586,172.31.47.0-255,66,177640,92,310350
21244,0.004676,74.125.130.0-255,2902,180542,92,310350
21245,0.004681,172.31.47.0-255,66,180608,92,310350
21246,0.005146,74.125.130.0-255,2902,183510,92,310350
21247,0.005148,172.31.47.0-255,66,183576,92,310350
21248,0.007244,74.125.130.0-255,2902,186478,92,310350
21249,0.007255,172.31.47.0-255,66,186544,92,310350
21250,0.007712,74.125.130.0-255,2902,189446,92,310350
21251,0.007719,172.31.47.0-255,66,189512,92,310350
21252,0.00981,74.125.130.0-255,2902,192414,92,310350
21253,0.009817,172.31.47.0-255,66,192480,92,310350
21254,0.010267,74.125.130.0-255,2902,195382,92,310350
21255,0.010272,172.31.47.0-255,66,195448,92,310350
21256,0.012384,74.125.130.0-255,2902,198350,92,310350
21257,0.01239,172.31.47.0-255,66,198416,92,310350
21258,0.012833,74.125.130.0-255,2902,201318,92,310350
21259,0.012838,172.31.47.0-255,66,201384,92,310350
21260,0.014939,74.125.130.0-255,2902,204286,92,310350
21261,0.014945,172.31.47.0-255,66,204352,92,310350
21262,0.015381,74.125.130.0-255,2902,207254,92,310350
21263,0.015386,172.31.47.0-255,66,207320,92,310350
21264,0.017528,74.125.130.0-255,2902,210222,92,310350
21265,0.017535,172.31.47.0-255,66,210288,92,310350
21266,0.01794,74.125.130.0-255,2902,213190,92,310350
21267,0.017946,172.31.47.0-255,66,213256,92,310350
21268,0.020082,74.125.130.0-255,2902,216158,92,310350
21269,0.020087,172.31.47.0-255,66,216224,92,310350
21270,0.020484,74.125.130.0-255,2902,219126,92,310350
21271,0.020489,172.31.47.0-255,66,219192,92,310350
21272,0.02266,74.125.130.0-255,2902,222094,92,310350
21273,0.022667,172.31.47.0-255,66,222160,92,310350
21274,0.023053,74.125.130.0-255,2902,225062,92,310350
21275,0.023058,172.31.47.0-255,66,225128,92,310350
21276,0.025216,74.125.130.0-255,2902,228030,92,310350
21277,0.025222,172.31.47.0-255,66,228096,92,310350
21278,0.025603,74.125.130.0-255,2902,230998,92,310350
21279,0.025608,172.31.47.0-255,66,231064,92,310350
21280,0.027779,74.125.130.0-255,2902,233966,92,310350
21281,0.027784,172.31.47.0-255,66,234032,92,310350
21282,0.028159,74.125.130.0-255,2902,236934,92,310350
21283,0.028165,172.31.47.0-255,66,237000,92,310350
21284,0.030346,74.125.130.0-255,2902,239902,92,310350
21285,0.030358,172.31.47.0-255,66,239968,92,310350
21286,0.030708,74.125.130.0-255,2902,242870,92,310350
21287,0.030715,172.31.47.0-255,66,242936,92,310350
21288,0.032914,74.125.130.0-255,2902,245838,92,310350
21289,0.032925,172.31.47.0-255,66,245904,92,310350
21290,0.033305,74.125.130.0-255,2902,248806,92,310350
21291,0.033311,172.31.47.0-255,66,248872,92,310350
21292,0.035401,172.31.47.0-255,172,249044,92,310350
21293,0.035456,172.31.47.0-255,1107,250151,92,310350
21294,0.035496,74.125.130.0-255,2902,253053,92,310350
21295,0.035501,172.31.47.0-255,66,253119,92,310350
21296,0.035553,172.31.47.0-255,575,253694,92,310350
21297,0.03586,74.125.130.0-255,2902,256596,92,310350
21298,0.035866,172.31.47.0-255,66,256662,92,310350
21299,0.036967,104.244.42.0-255,66,256728,92,310350
21300,0.036985,104.244.42.0-255,66,256794,92,310350
21301,0.037069,104.244.42.0-255,66,256860,92,310350
21302,0.038061,74.125.130.0-255,2902,259762,92,310350
21303,0.038066,172.31.47.0-255,66,259828,92,310350
21304,0.038416,74.125.130.0-255,2902,262730,92,310350
21305,0.038422,172.31.47.0-255,66,262796,92,310350
21306,0.040618,74.125.130.0-255,2902,265698,92,310350
21307,0.040637,172.31.47.0-255,66,265764,92,310350
21308,0.04097,74.125.130.0-255,2902,268666,92,310350
21309,0.040976,172.31.47.0-255,66,268732,92,310350
21310,0.043188,74.125.130.0-255,2902,271634,92,310350
21311,0.043194,172.31.47.0-255,66,271700,92,310350
21312,0.043527,74.125.130.0-255,2902,274602,92,310350
21313,0.043534,172.31.47.0-255,66,274668,92,310350
21314,0.045745,74.125.130.0-255,2902,277570,92,310350
21315,0.045752,172.31.47.0-255,66,277636,92,310350
21316,0.046088,74.125.130.0-255,2902,280538,92,310350
21317,0.046094,172.31.47.0-255,66,280604,92,310350
21318,0.048305,74.125.130.0-255,2902,283506,92,310350
21319,0.04831,172.31.47.0-255,66,283572,92,310350
21320,0.048643,74.125.130.0-255,2902,286474,92,310350
21321,0.048648,172.31.47.0-255,66,286540,92,310350
21322,0.050865,74.125.130.0-255,2902,289442,92,310350
21323,0.050872,172.31.47.0-255,66,289508,92,310350
21324,0.051194,74.125.130.0-255,2902,292410,92,310350
21325,0.051199,172.31.47.0-255,66,292476,92,310350
21326,0.053426,74.125.130.0-255,2902,295378,92,310350
21327,0.053431,172.31.47.0-255,66,295444,92,310350
21328,0.053754,74.125.130.0-255,2902,298346,92,310350
21329,0.053758,172.31.47.0-255,66,298412,92,310350
21330,0.055974,74.125.130.0-255,2902,301314,92,310350
21331,0.05598,172.31.47.0-255,66,301380,92,310350
21332,0.056306,74.125.130.0-255,1484,302864,92,310350
21333,0.056337,74.125.130.0-255,1484,304348,92,310350
21334,0.056342,172.31.47.0-255,66,304414,92,310350
21335,0.058525,74.125.130.0-255,2902,307316,92,310350
21336,0.05853,172.31.47.0-255,66,307382,92,310350
21337,0.058882,74.125.130.0-255,2902,310284,92,310350
21338,0.058887,172.31.47.0-255,66,310350,92,310350
21339,0.0,172.217.194.0-255,153,153,92,157058
21340,3e-05,172.31.47.0-255,66,219,92,157058
21341,3.7e-05,172.217.194.0-255,1484,1703,92,157058
21342,4.1e-05,172.31.47.0-255,66,1769,92,157058
21343,4.6e-05,172.217.194.0-255,2902,4671,92,157058
21344,4.8e-05,172.31.47.0-255,66,4737,92,157058
21345,7e-05,172.217.194.0-255,1484,6221,92,157058
21346,7.2e-05,172.31.47.0-255,66,6287,92,157058
21347,9.3e-05,172.217.194.0-255,5738,12025,92,157058
21348,9.5e-05,172.31.47.0-255,66,12091,92,157058
21349,9.9e-05,172.217.194.0-255,1949,14040,92,157058
21350,0.0001,172.31.47.0-255,66,14106,92,157058
21351,0.000137,172.31.47.0-255,66,14172,92,157058
21352,0.000143,172.217.194.0-255,5379,19551,92,157058
21353,0.000145,172.31.47.0-255,66,19617,92,157058
21354,0.000233,172.217.194.0-255,1484,21101,92,157058
21355,0.000236,172.31.47.0-255,66,21167,92,157058
21356,0.000239,172.217.194.0-255,1484,22651,92,157058
21357,0.000241,172.31.47.0-255,66,22717,92,157058
21358,0.000255,172.217.194.0-255,2902,25619,92,157058
21359,0.000262,172.31.47.0-255,66,25685,92,157058
21360,0.000266,172.217.194.0-255,1484,27169,92,157058
21361,0.000269,172.31.47.0-255,66,27235,92,157058
21362,0.00029,172.217.194.0-255,4320,31555,92,157058
21363,0.000293,172.31.47.0-255,66,31621,92,157058
21364,0.000329,172.217.194.0-255,1484,33105,92,157058
21365,0.000332,172.31.47.0-255,66,33171,92,157058
21366,0.000354,172.217.194.0-255,5379,38550,92,157058
21367,0.000357,172.31.47.0-255,66,38616,92,157058
21368,0.000364,172.217.194.0-255,7156,45772,92,157058
21369,0.000366,172.31.47.0-255,66,45838,92,157058
21370,0.000376,172.31.47.0-255,66,45904,92,157058
21371,0.000378,172.217.194.0-255,398,46302,92,157058
21372,0.000659,172.217.194.0-255,1484,47786,92,157058
21373,0.000663,172.31.47.0-255,66,47852,92,157058
21374,0.000668,172.217.194.0-255,2902,50754,92,157058
21375,0.00067,172.31.47.0-255,66,50820,92,157058
21376,0.000689,172.217.194.0-255,5738,56558,92,157058
21377,0.000692,172.31.47.0-255,66,56624,92,157058
21378,0.000698,172.217.194.0-255,5738,62362,92,157058
21379,0.0007,172.31.47.0-255,66,62428,92,157058
21380,0.000738,172.31.47.0-255,66,62494,92,157058
21381,0.000743,172.217.194.0-255,4320,66814,92,157058
21382,0.000745,172.31.47.0-255,66,66880,92,157058
21383,0.000757,172.217.194.0-255,766,67646,92,157058
21384,0.000911,172.31.47.0-255,66,67712,92,157058
21385,0.001032,172.217.194.0-255,1484,69196,92,157058
21386,0.00104,172.217.194.0-255,2902,72098,92,157058
21387,0.001043,172.31.47.0-255,66,72164,92,157058
21388,0.00105,172.217.194.0-255,5738,77902,92,157058
21389,0.001052,172.31.47.0-255,66,77968,92,157058
21390,0.001069,172.217.194.0-255,4320,82288,92,157058
21391,0.001072,172.31.47.0-255,66,82354,92,157058
21392,0.001092,172.31.47.0-255,66,82420,92,157058
21393,0.001096,172.217.194.0-255,1484,83904,92,157058
21394,0.001123,172.31.47.0-255,66,83970,92,157058
21395,0.001155,172.31.47.0-255,66,84036,92,157058
21396,0.001167,172.31.47.0-255,66,84102,92,157058
21397,0.001227,172.217.194.0-255,2902,87004,92,157058
21398,0.001231,172.31.47.0-255,66,87070,92,157058
21399,0.001263,172.31.47.0-255,66,87136,92,157058
21400,0.001277,172.31.47.0-255,66,87202,92,157058
21401,0.00129,172.31.47.0-255,66,87268,92,157058
21402,0.001321,172.217.194.0-255,6438,93706,92,157058
21403,0.001324,172.31.47.0-255,66,93772,92,157058
21404,0.001364,172.217.194.0-255,1484,95256,92,157058
21405,0.001379,172.217.194.0-255,2902,98158,92,157058
21406,0.001383,172.31.47.0-255,66,98224,92,157058
21407,0.001386,172.217.194.0-255,1484,99708,92,157058
21408,0.001407,172.217.194.0-255,4320,104028,92,157058
21409,0.001411,172.31.47.0-255,66,104094,92,157058
21410,0.001418,172.217.194.0-255,7156,111250,92,157058
21411,0.00142,172.31.47.0-255,66,111316,92,157058
21412,0.001446,172.217.194.0-255,5738,117054,92,157058
21413,0.001449,172.31.47.0-255,66,117120,92,157058
21414,0.001461,172.31.47.0-255,66,117186,92,157058
21415,0.001526,172.31.47.0-255,66,117252,92,157058
21416,0.001543,172.31.47.0-255,66,117318,92,157058
21417,0.001562,172.31.47.0-255,66,117384,92,157058
21418,0.00161,172.31.47.0-255,66,117450,92,157058
21419,0.001626,172.31.47.0-255,66,117516,92,157058
21420,0.001628,172.217.194.0-255,766,118282,92,157058
21421,0.001661,172.217.194.0-255,1484,119766,92,157058
21422,0.001665,172.31.47.0-255,66,119832,92,157058
21423,0.00167,172.217.194.0-255,4320,124152,92,157058
21424,0.001673,172.31.47.0-255,66,124218,92,157058
21425,0.001677,172.217.194.0-255,2902,127120,92,157058
21426,0.001679,172.31.47.0-255,66,127186,92,157058
21427,0.001695,172.217.194.0-255,4320,131506,92,157058
21428,0.001698,172.31.47.0-255,66,131572,92,157058
21429,0.001707,172.31.47.0-255,66,131638,92,157058
21430,0.001753,172.31.47.0-255,66,131704,92,157058
21431,0.001791,172.217.194.0-255,7156,138860,92,157058
21432,0.001794,172.31.47.0-255,66,138926,92,157058
21433,0.001803,172.31.47.0-255,66,138992,92,157058
21434,0.001824,172.217.194.0-255,1484,140476,92,157058
21435,0.001856,172.31.47.0-255,66,140542,92,157058
21436,0.001859,172.217.194.0-255,766,141308,92,157058
21437,0.00189,172.217.194.0-255,5738,147046,92,157058
21438,0.001894,172.31.47.0-255,66,147112,92,157058
21439,0.001914,172.217.194.0-255,5738,152850,92,157058
21440,0.001917,172.31.47.0-255,66,152916,92,157058
21441,0.001928,172.31.47.0-255,66,152982,92,157058
21442,0.001931,172.217.194.0-255,1484,154466,92,157058
21443,0.001964,172.31.47.0-255,66,154532,92,157058
21444,0.001975,172.31.47.0-255,66,154598,92,157058
21445,0.002008,172.31.47.0-255,66,154664,92,157058
21446,0.002055,172.217.194.0-255,105,154769,92,157058
21447,0.008572,172.31.47.0-255,66,154835,92,157058
21448,0.008594,172.31.47.0-255,105,154940,92,157058
21449,0.010699,172.217.194.0-255,66,155006,92,157058
21450,0.035086,172.31.47.0-255,172,155178,92,157058
21451,0.035127,172.31.47.0-255,1111,156289,92,157058
21452,0.035148,172.31.47.0-255,571,156860,92,157058
21453,0.03657,104.244.42.0-255,66,156926,92,157058
21454,0.036644,104.244.42.0-255,66,156992,92,157058
21455,0.036647,104.244.42.0-255,66,157058,92,157058
21456,0.0,172.31.47.0-255,66,66,92,66
21457,0.0,172.217.27.0-255,298,298,92,361151
21458,1.6e-05,172.31.47.0-255,66,364,92,361151
21459,2.1e-05,172.217.27.0-255,1484,1848,92,361151
21460,2.5e-05,172.31.47.0-255,66,1914,92,361151
21461,2.8e-05,172.217.27.0-255,1484,3398,92,361151
21462,3e-05,172.31.47.0-255,66,3464,92,361151
21463,5.4e-05,172.217.27.0-255,1484,4948,92,361151
21464,5.7e-05,172.31.47.0-255,66,5014,92,361151
21465,6.4e-05,172.217.27.0-255,5738,10752,92,361151
21466,6.6e-05,172.31.47.0-255,66,10818,92,361151
21467,0.0001,172.31.47.0-255,66,10884,92,361151
21468,0.000105,172.217.27.0-255,4320,15204,92,361151
21469,0.000107,172.31.47.0-255,66,15270,92,361151
21470,0.000128,172.217.27.0-255,5738,21008,92,361151
21471,0.00013,172.31.47.0-255,66,21074,92,361151
21472,0.000133,172.217.27.0-255,1125,22199,92,361151
21473,0.000135,172.31.47.0-255,66,22265,92,361151
21474,0.000236,172.217.27.0-255,1484,23749,92,361151
21475,0.000241,172.31.47.0-255,66,23815,92,361151
21476,0.000245,172.217.27.0-255,2902,26717,92,361151
21477,0.000247,172.31.47.0-255,66,26783,92,361151
21478,0.000255,172.217.27.0-255,4320,31103,92,361151
21479,0.000257,172.31.47.0-255,66,31169,92,361151
21480,0.00027,172.217.27.0-255,1484,32653,92,361151
21481,0.000272,172.31.47.0-255,66,32719,92,361151
21482,0.000289,172.217.27.0-255,4320,37039,92,361151
21483,0.000292,172.31.47.0-255,66,37105,92,361151
21484,0.000321,172.217.27.0-255,6797,43902,92,361151
21485,0.000324,172.31.47.0-255,66,43968,92,361151
21486,0.000336,172.31.47.0-255,66,44034,92,361151
21487,0.000338,172.217.27.0-255,1395,45429,92,361151
21488,0.000564,172.217.27.0-255,385,45814,92,361151
21489,0.000569,172.31.47.0-255,66,45880,92,361151
21490,0.000767,172.217.27.0-255,1484,47364,92,361151
21491,0.000774,172.217.27.0-255,2902,50266,92,361151
21492,0.000777,172.31.47.0-255,66,50332,92,361151
21493,0.000784,172.217.27.0-255,5738,56070,92,361151
21494,0.000786,172.31.47.0-255,66,56136,92,361151
21495,0.000809,172.217.27.0-255,2902,59038,92,361151
21496,0.000812,172.31.47.0-255,66,59104,92,361151
21497,0.000843,172.31.47.0-255,66,59170,92,361151
21498,0.000865,172.217.27.0-255,7156,66326,92,361151
21499,0.000868,172.31.47.0-255,66,66392,92,361151
21500,0.000893,172.217.27.0-255,3961,70353,92,361151
21501,0.000896,172.217.27.0-255,1484,71837,92,361151
21502,0.000899,172.217.27.0-255,2902,74739,92,361151
21503,0.000904,172.31.47.0-255,66,74805,92,361151
21504,0.000911,172.31.47.0-255,66,74871,92,361151
21505,0.000916,172.217.27.0-255,4320,79191,92,361151
21506,0.000918,172.31.47.0-255,66,79257,92,361151
21507,0.000934,172.217.27.0-255,1484,80741,92,361151
21508,0.00094,172.217.27.0-255,5738,86479,92,361151
21509,0.000943,172.31.47.0-255,66,86545,92,361151
21510,0.000948,172.217.27.0-255,5738,92283,92,361151
21511,0.00095,172.31.47.0-255,66,92349,92,361151
21512,0.000969,172.217.27.0-255,1484,93833,92,361151
21513,0.000983,172.217.27.0-255,1484,95317,92,361151
21514,0.000987,172.31.47.0-255,66,95383,92,361151
21515,0.000999,172.217.27.0-255,5738,101121,92,361151
21516,0.001002,172.31.47.0-255,66,101187,92,361151
21517,0.001017,172.217.27.0-255,3053,104240,92,361151
21518,0.00102,172.31.47.0-255,66,104306,92,361151
21519,0.001061,172.217.27.0-255,1484,105790,92,361151
21520,0.001079,172.217.27.0-255,2902,108692,92,361151
21521,0.001083,172.31.47.0-255,66,108758,92,361151
21522,0.001086,172.217.27.0-255,1484,110242,92,361151
21523,0.001106,172.217.27.0-255,4320,114562,92,361151
21524,0.00111,172.31.47.0-255,66,114628,92,361151
21525,0.001118,172.217.27.0-255,7156,121784,92,361151
21526,0.00112,172.31.47.0-255,66,121850,92,361151
21527,0.001184,172.31.47.0-255,66,121916,92,361151
21528,0.001198,172.217.27.0-255,2902,124818,92,361151
21529,0.001201,172.31.47.0-255,66,124884,92,361151
21530,0.001205,172.217.27.0-255,2184,127068,92,361151
21531,0.001207,172.31.47.0-255,66,127134,92,361151
21532,0.001468,172.217.27.0-255,1484,128618,92,361151
21533,0.001474,172.217.27.0-255,2902,131520,92,361151
21534,0.001478,172.31.47.0-255,66,131586,92,361151
21535,0.00151,172.217.27.0-255,4320,135906,92,361151
21536,0.001513,172.31.47.0-255,66,135972,92,361151
21537,0.001527,172.217.27.0-255,1484,137456,92,361151
21538,0.001543,172.217.27.0-255,4320,141776,92,361151
21539,0.001546,172.31.47.0-255,66,141842,92,361151
21540,0.00157,172.217.27.0-255,2902,144744,92,361151
21541,0.001573,172.31.47.0-255,66,144810,92,361151
21542,0.001586,172.31.47.0-255,66,144876,92,361151
21543,0.001589,172.217.27.0-255,2184,147060,92,361151
21544,0.001592,172.31.47.0-255,66,147126,92,361151
21545,0.001663,172.217.27.0-255,1484,148610,92,361151
21546,0.001666,172.217.27.0-255,1484,150094,92,361151
21547,0.001669,172.31.47.0-255,66,150160,92,361151
21548,0.003224,172.217.27.0-255,2902,153062,92,361151
21549,0.00323,172.31.47.0-255,66,153128,92,361151
21550,0.003297,172.217.27.0-255,1484,154612,92,361151
21551,0.003309,172.217.27.0-255,1484,156096,92,361151
21552,0.003311,172.31.47.0-255,66,156162,92,361151
21553,0.004865,172.217.27.0-255,2902,159064,92,361151
21554,0.004868,172.31.47.0-255,66,159130,92,361151
21555,0.004936,172.217.27.0-255,2902,162032,92,361151
21556,0.004938,172.31.47.0-255,66,162098,92,361151
21557,0.006517,172.217.27.0-255,2902,165000,92,361151
21558,0.006522,172.31.47.0-255,66,165066,92,361151
21559,0.006571,172.217.27.0-255,2902,167968,92,361151
21560,0.006574,172.31.47.0-255,66,168034,92,361151
21561,0.008173,172.217.27.0-255,2902,170936,92,361151
21562,0.008179,172.31.47.0-255,66,171002,92,361151
21563,0.008207,172.217.27.0-255,2902,173904,92,361151
21564,0.00821,172.31.47.0-255,66,173970,92,361151
21565,0.009824,172.217.27.0-255,2902,176872,92,361151
21566,0.00983,172.31.47.0-255,66,176938,92,361151
21567,0.009849,172.217.27.0-255,2902,179840,92,361151
21568,0.009852,172.31.47.0-255,66,179906,92,361151
21569,0.011483,172.217.27.0-255,2902,182808,92,361151
21570,0.011488,172.31.47.0-255,66,182874,92,361151
21571,0.011508,172.217.27.0-255,2902,185776,92,361151
21572,0.011511,172.31.47.0-255,66,185842,92,361151
21573,0.013148,172.217.27.0-255,5738,191580,92,361151
21574,0.013154,172.31.47.0-255,66,191646,92,361151
21575,0.014818,172.217.27.0-255,5738,197384,92,361151
21576,0.014826,172.31.47.0-255,66,197450,92,361151
21577,0.016482,172.217.27.0-255,5738,203188,92,361151
21578,0.016488,172.31.47.0-255,66,203254,92,361151
21579,0.01817,172.217.27.0-255,5738,208992,92,361151
21580,0.018176,172.31.47.0-255,66,209058,92,361151
21581,0.019821,172.217.27.0-255,5738,214796,92,361151
21582,0.019827,172.31.47.0-255,66,214862,92,361151
21583,0.021477,172.217.27.0-255,5738,220600,92,361151
21584,0.021484,172.31.47.0-255,66,220666,92,361151
21585,0.023127,172.217.27.0-255,4320,224986,92,361151
21586,0.023133,172.31.47.0-255,66,225052,92,361151
21587,0.023155,172.217.27.0-255,1484,226536,92,361151
21588,0.024784,172.217.27.0-255,4320,230856,92,361151
21589,0.02479,172.31.47.0-255,66,230922,92,361151
21590,0.026446,172.217.27.0-255,5738,236660,92,361151
21591,0.026453,172.31.47.0-255,66,236726,92,361151
21592,0.028115,172.217.27.0-255,5738,242464,92,361151
21593,0.028122,172.31.47.0-255,66,242530,92,361151
21594,0.029768,172.217.27.0-255,5738,248268,92,361151
21595,0.029774,172.31.47.0-255,66,248334,92,361151
21596,0.031439,172.217.27.0-255,5738,254072,92,361151
21597,0.031445,172.31.47.0-255,66,254138,92,361151
21598,0.033124,172.217.27.0-255,4320,258458,92,361151
21599,0.033131,172.31.47.0-255,66,258524,92,361151
21600,0.033149,172.217.27.0-255,1484,260008,92,361151
21601,0.034802,172.217.27.0-255,4320,264328,92,361151
21602,0.034809,172.31.47.0-255,66,264394,92,361151
21603,0.036461,172.217.27.0-255,5738,270132,92,361151
21604,0.036467,172.31.47.0-255,66,270198,92,361151
21605,0.038141,172.217.27.0-255,5738,275936,92,361151
21606,0.038148,172.31.47.0-255,66,276002,92,361151
21607,0.039876,172.217.27.0-255,5738,281740,92,361151
21608,0.039886,172.31.47.0-255,66,281806,92,361151
21609,0.041548,172.217.27.0-255,5738,287544,92,361151
21610,0.041557,172.31.47.0-255,66,287610,92,361151
21611,0.043197,172.217.27.0-255,5738,293348,92,361151
21612,0.043202,172.31.47.0-255,66,293414,92,361151
21613,0.044943,172.217.27.0-255,5738,299152,92,361151
21614,0.044948,172.31.47.0-255,66,299218,92,361151
21615,0.045703,172.31.47.0-255,176,299394,92,361151
21616,0.045731,172.31.47.0-255,1111,300505,92,361151
21617,0.045767,172.31.47.0-255,1514,302019,92,361151
21618,0.045768,172.31.47.0-255,1514,303533,92,361151
21619,0.045769,172.31.47.0-255,1514,305047,92,361151
21620,0.04577,172.31.47.0-255,1514,306561,92,361151
21621,0.045794,172.31.47.0-255,1496,308057,92,361151
21622,0.046592,172.217.27.0-255,5738,313795,92,361151
21623,0.046597,172.31.47.0-255,66,313861,92,361151
21624,0.047246,104.244.42.0-255,66,313927,92,361151
21625,0.047281,104.244.42.0-255,66,313993,92,361151
21626,0.047373,104.244.42.0-255,66,314059,92,361151
21627,0.048243,172.217.27.0-255,2902,316961,92,361151
21628,0.048246,172.31.47.0-255,66,317027,92,361151
21629,0.048285,172.217.27.0-255,2902,319929,92,361151
21630,0.048289,172.31.47.0-255,66,319995,92,361151
21631,0.049887,172.217.27.0-255,2902,322897,92,361151
21632,0.049892,172.31.47.0-255,66,322963,92,361151
21633,0.049926,172.217.27.0-255,2902,325865,92,361151
21634,0.049929,172.31.47.0-255,66,325931,92,361151
21635,0.051529,172.217.27.0-255,2902,328833,92,361151
21636,0.051534,172.31.47.0-255,66,328899,92,361151
21637,0.05156,172.217.27.0-255,2902,331801,92,361151
21638,0.051563,172.31.47.0-255,66,331867,92,361151
21639,0.053171,172.217.27.0-255,2902,334769,92,361151
21640,0.053176,172.31.47.0-255,66,334835,92,361151
21641,0.053196,172.217.27.0-255,2902,337737,92,361151
21642,0.053199,172.31.47.0-255,66,337803,92,361151
21643,0.054817,172.217.27.0-255,2902,340705,92,361151
21644,0.054822,172.31.47.0-255,66,340771,92,361151
21645,0.05484,172.217.27.0-255,2902,343673,92,361151
21646,0.054842,172.31.47.0-255,66,343739,92,361151
21647,0.056488,172.217.27.0-255,5738,349477,92,361151
21648,0.056499,172.31.47.0-255,66,349543,92,361151
21649,0.058141,172.217.27.0-255,5738,355281,92,361151
21650,0.058147,172.31.47.0-255,66,355347,92,361151
21651,0.059788,172.217.27.0-255,5738,361085,92,361151
21652,0.059793,172.31.47.0-255,66,361151,92,361151
21653,0.0,172.31.47.0-255,105,105,92,276
21654,0.001791,157.240.13.0-255,105,210,92,276
21655,0.001804,172.31.47.0-255,66,276,92,276
21656,0.0,74.125.24.0-255,152,152,92,255238
21657,1.4e-05,172.31.47.0-255,66,218,92,255238
21658,2e-05,74.125.24.0-255,1484,1702,92,255238
21659,2.4e-05,172.31.47.0-255,66,1768,92,255238
21660,2.7e-05,74.125.24.0-255,1484,3252,92,255238
21661,2.9e-05,172.31.47.0-255,66,3318,92,255238
21662,6e-05,74.125.24.0-255,1484,4802,92,255238
21663,6.3e-05,172.31.47.0-255,66,4868,92,255238
21664,6.6e-05,74.125.24.0-255,1484,6352,92,255238
21665,6.7e-05,172.31.47.0-255,66,6418,92,255238
21666,7.2e-05,74.125.24.0-255,2902,9320,92,255238
21667,7.4e-05,172.31.47.0-255,66,9386,92,255238
21668,9.4e-05,74.125.24.0-255,6394,15780,92,255238
21669,0.0001,172.31.47.0-255,66,15846,92,255238
21670,0.00011,74.125.24.0-255,4320,20166,92,255238
21671,0.000114,172.31.47.0-255,66,20232,92,255238
21672,0.000135,74.125.24.0-255,2902,23134,92,255238
21673,0.000137,172.31.47.0-255,66,23200,92,255238
21674,0.000147,172.31.47.0-255,66,23266,92,255238
21675,0.000181,74.125.24.0-255,7156,30422,92,255238
21676,0.000184,172.31.47.0-255,66,30488,92,255238
21677,0.000193,172.31.47.0-255,66,30554,92,255238
21678,0.000195,74.125.24.0-255,766,31320,92,255238
21679,0.000197,172.31.47.0-255,66,31386,92,255238
21680,0.000227,74.125.24.0-255,1484,32870,92,255238
21681,0.000233,172.31.47.0-255,66,32936,92,255238
21682,0.000238,74.125.24.0-255,4320,37256,92,255238
21683,0.000241,172.31.47.0-255,66,37322,92,255238
21684,0.000243,74.125.24.0-255,1484,38806,92,255238
21685,0.000245,172.31.47.0-255,66,38872,92,255238
21686,0.000278,74.125.24.0-255,5738,44610,92,255238
21687,0.000281,172.31.47.0-255,66,44676,92,255238
21688,0.000303,74.125.24.0-255,2902,47578,92,255238
21689,0.000305,172.31.47.0-255,66,47644,92,255238
21690,0.000319,74.125.24.0-255,1707,49351,92,255238
21691,0.000321,172.31.47.0-255,66,49417,92,255238
21692,0.000529,74.125.24.0-255,1484,50901,92,255238
21693,0.000534,74.125.24.0-255,1484,52385,92,255238
21694,0.000537,172.31.47.0-255,66,52451,92,255238
21695,0.000561,74.125.24.0-255,1484,53935,92,255238
21696,0.000567,74.125.24.0-255,5738,59673,92,255238
21697,0.000569,172.31.47.0-255,66,59739,92,255238
21698,0.000574,74.125.24.0-255,4320,64059,92,255238
21699,0.000576,172.31.47.0-255,66,64125,92,255238
21700,0.000581,74.125.24.0-255,5738,69863,92,255238
21701,0.000583,172.31.47.0-255,66,69929,92,255238
21702,0.000611,74.125.24.0-255,5738,75667,92,255238
21703,0.000614,172.31.47.0-255,66,75733,92,255238
21704,0.000624,172.31.47.0-255,66,75799,92,255238
21705,0.000655,74.125.24.0-255,1484,77283,92,255238
21706,0.000669,74.125.24.0-255,2902,80185,92,255238
21707,0.000671,74.125.24.0-255,1484,81669,92,255238
21708,0.000673,172.31.47.0-255,66,81735,92,255238
21709,0.000702,74.125.24.0-255,4320,86055,92,255238
21710,0.000704,172.31.47.0-255,66,86121,92,255238
21711,0.000716,172.31.47.0-255,66,86187,92,255238
21712,0.000731,172.31.47.0-255,66,86253,92,255238
21713,0.000758,74.125.24.0-255,2184,88437,92,255238
21714,0.000761,172.31.47.0-255,66,88503,92,255238
21715,0.000797,74.125.24.0-255,2902,91405,92,255238
21716,0.0008,172.31.47.0-255,66,91471,92,255238
21717,0.000804,74.125.24.0-255,2902,94373,92,255238
21718,0.000806,172.31.47.0-255,66,94439,92,255238
21719,0.000826,74.125.24.0-255,4320,98759,92,255238
21720,0.000829,172.31.47.0-255,66,98825,92,255238
21721,0.000845,172.31.47.0-255,66,98891,92,255238
21722,0.000879,172.31.47.0-255,66,98957,92,255238
21723,0.001009,74.125.24.0-255,1484,100441,92,255238
21724,0.001015,74.125.24.0-255,2902,103343,92,255238
21725,0.001017,172.31.47.0-255,66,103409,92,255238
21726,0.00102,74.125.24.0-255,1484,104893,92,255238
21727,0.001042,74.125.24.0-255,4320,109213,92,255238
21728,0.001045,172.31.47.0-255,66,109279,92,255238
21729,0.001049,74.125.24.0-255,4320,113599,92,255238
21730,0.001052,172.31.47.0-255,66,113665,92,255238
21731,0.001083,172.31.47.0-255,66,113731,92,255238
21732,0.001089,74.125.24.0-255,7156,120887,92,255238
21733,0.001091,172.31.47.0-255,66,120953,92,255238
21734,0.001116,74.125.24.0-255,1484,122437,92,255238
21735,0.001131,74.125.24.0-255,2184,124621,92,255238
21736,0.001134,172.31.47.0-255,66,124687,92,255238
21737,0.001259,74.125.24.0-255,1484,126171,92,255238
21738,0.001262,74.125.24.0-255,1484,127655,92,255238
21739,0.001266,172.31.47.0-255,66,127721,92,255238
21740,0.001273,74.125.24.0-255,1484,129205,92,255238
21741,0.001277,74.125.24.0-255,2902,132107,92,255238
21742,0.001279,172.31.47.0-255,66,132173,92,255238
21743,0.001306,74.125.24.0-255,2902,135075,92,255238
21744,0.001309,172.31.47.0-255,66,135141,92,255238
21745,0.001319,172.31.47.0-255,66,135207,92,255238
21746,0.001345,74.125.24.0-255,4320,139527,92,255238
21747,0.001348,172.31.47.0-255,66,139593,92,255238
21748,0.001354,74.125.24.0-255,5738,145331,92,255238
21749,0.001355,172.31.47.0-255,66,145397,92,255238
21750,0.001416,74.125.24.0-255,5020,150417,92,255238
21751,0.00142,172.31.47.0-255,66,150483,92,255238
21752,0.001482,74.125.24.0-255,1484,151967,92,255238
21753,0.001497,74.125.24.0-255,2902,154869,92,255238
21754,0.0015,172.31.47.0-255,66,154935,92,255238
21755,0.001504,74.125.24.0-255,4320,159255,92,255238
21756,0.001506,172.31.47.0-255,66,159321,92,255238
21757,0.001535,74.125.24.0-255,1484,160805,92,255238
21758,0.001551,172.31.47.0-255,66,160871,92,255238
21759,0.001556,74.125.24.0-255,5738,166609,92,255238
21760,0.001559,172.31.47.0-255,66,166675,92,255238
21761,0.001584,74.125.24.0-255,6438,173113,92,255238
21762,0.001587,172.31.47.0-255,66,173179,92,255238
21763,0.001589,74.125.24.0-255,1484,174663,92,255238
21764,0.001608,74.125.24.0-255,2902,177565,92,255238
21765,0.00161,172.31.47.0-255,66,177631,92,255238
21766,0.001635,74.125.24.0-255,5738,183369,92,255238
21767,0.001637,172.31.47.0-255,66,183435,92,255238
21768,0.001643,74.125.24.0-255,7156,190591,92,255238
21769,0.001645,172.31.47.0-255,66,190657,92,255238
21770,0.001649,74.125.24.0-255,4320,194977,92,255238
21771,0.001656,172.31.47.0-255,66,195043,92,255238
21772,0.001697,172.31.47.0-255,66,195109,92,255238
21773,0.001703,74.125.24.0-255,6438,201547,92,255238
21774,0.001705,172.31.47.0-255,66,201613,92,255238
21775,0.001708,74.125.24.0-255,1484,203097,92,255238
21776,0.001751,172.31.47.0-255,66,203163,92,255238
21777,0.001752,74.125.24.0-255,6438,209601,92,255238
21778,0.001755,172.31.47.0-255,66,209667,92,255238
21779,0.001791,74.125.24.0-255,5738,215405,92,255238
21780,0.001794,172.31.47.0-255,66,215471,92,255238
21781,0.001844,172.31.47.0-255,66,215537,92,255238
21782,0.001847,74.125.24.0-255,2184,217721,92,255238
21783,0.001849,172.31.47.0-255,66,217787,92,255238
21784,0.00187,74.125.24.0-255,2902,220689,92,255238
21785,0.001873,172.31.47.0-255,66,220755,92,255238
21786,0.00188,74.125.24.0-255,1484,222239,92,255238
21787,0.001902,74.125.24.0-255,2902,225141,92,255238
21788,0.001905,172.31.47.0-255,66,225207,92,255238
21789,0.001915,172.31.47.0-255,66,225273,92,255238
21790,0.001936,74.125.24.0-255,7156,232429,92,255238
21791,0.001939,172.31.47.0-255,66,232495,92,255238
21792,0.001967,74.125.24.0-255,5738,238233,92,255238
21793,0.00197,172.31.47.0-255,66,238299,92,255238
21794,0.001981,172.31.47.0-255,66,238365,92,255238
21795,0.002006,74.125.24.0-255,2184,240549,92,255238
21796,0.002009,172.31.47.0-255,66,240615,92,255238
21797,0.002015,74.125.24.0-255,7156,247771,92,255238
21798,0.002017,172.31.47.0-255,66,247837,92,255238
21799,0.002048,74.125.24.0-255,1484,249321,92,255238
21800,0.002074,74.125.24.0-255,3457,252778,92,255238
21801,0.002077,172.31.47.0-255,66,252844,92,255238
21802,0.00208,74.125.24.0-255,105,252949,92,255238
21803,0.012832,172.31.47.0-255,66,253015,92,255238
21804,0.012865,172.31.47.0-255,105,253120,92,255238
21805,0.015407,74.125.24.0-255,66,253186,92,255238
21806,0.05254,172.31.47.0-255,172,253358,92,255238
21807,0.052571,172.31.47.0-255,1103,254461,92,255238
21808,0.052605,172.31.47.0-255,579,255040,92,255238
21809,0.054034,104.244.42.0-255,66,255106,92,255238
21810,0.054154,104.244.42.0-255,66,255172,92,255238
21811,0.054159,104.244.42.0-255,66,255238,92,255238
21812,0.0,74.125.24.0-255,153,153,92,243418
21813,3.8e-05,172.31.47.0-255,66,219,92,243418
21814,4.6e-05,74.125.24.0-255,1484,1703,92,243418
21815,5e-05,172.31.47.0-255,66,1769,92,243418
21816,5.6e-05,74.125.24.0-255,2902,4671,92,243418
21817,5.9e-05,172.31.47.0-255,66,4737,92,243418
21818,6.6e-05,74.125.24.0-255,7156,11893,92,243418
21819,6.9e-05,172.31.47.0-255,66,11959,92,243418
21820,7.4e-05,74.125.24.0-255,2014,13973,92,243418
21821,7.7e-05,172.31.47.0-255,66,14039,92,243418
21822,0.000549,74.125.24.0-255,1484,15523,92,243418
21823,0.000555,172.31.47.0-255,66,15589,92,243418
21824,0.000564,74.125.24.0-255,2902,18491,92,243418
21825,0.000566,172.31.47.0-255,66,18557,92,243418
21826,0.000573,74.125.24.0-255,5738,24295,92,243418
21827,0.000575,172.31.47.0-255,66,24361,92,243418
21828,0.000597,74.125.24.0-255,1484,25845,92,243418
21829,0.000599,172.31.47.0-255,66,25911,92,243418
21830,0.000629,172.31.47.0-255,66,25977,92,243418
21831,0.000639,172.31.47.0-255,66,26043,92,243418
21832,0.000677,172.31.47.0-255,66,26109,92,243418
21833,0.000688,172.31.47.0-255,66,26175,92,243418
21834,0.000709,74.125.24.0-255,1437,27612,92,243418
21835,0.000713,172.31.47.0-255,66,27678,92,243418
21836,0.000757,74.125.24.0-255,112,27790,92,243418
21837,0.00076,172.31.47.0-255,66,27856,92,243418
21838,0.000903,74.125.24.0-255,1484,29340,92,243418
21839,0.000909,172.31.47.0-255,66,29406,92,243418
21840,0.000915,74.125.24.0-255,2902,32308,92,243418
21841,0.000917,172.31.47.0-255,66,32374,92,243418
21842,0.000923,74.125.24.0-255,5738,38112,92,243418
21843,0.000925,172.31.47.0-255,66,38178,92,243418
21844,0.00097,74.125.24.0-255,2902,41080,92,243418
21845,0.000973,172.31.47.0-255,66,41146,92,243418
21846,0.00102,74.125.24.0-255,1484,42630,92,243418
21847,0.001609,74.125.24.0-255,1484,44114,92,243418
21848,0.001624,74.125.24.0-255,2902,47016,92,243418
21849,0.001644,74.125.24.0-255,5738,52754,92,243418
21850,0.001666,74.125.24.0-255,7156,59910,92,243418
21851,0.001674,74.125.24.0-255,1484,61394,92,243418
21852,0.001712,74.125.24.0-255,5738,67132,92,243418
21853,0.001724,74.125.24.0-255,4320,71452,92,243418
21854,0.001738,74.125.24.0-255,5020,76472,92,243418
21855,0.001827,74.125.24.0-255,1484,77956,92,243418
21856,0.001831,74.125.24.0-255,1484,79440,92,243418
21857,0.00184,74.125.24.0-255,1484,80924,92,243418
21858,0.001847,74.125.24.0-255,5738,86662,92,243418
21859,0.001883,74.125.24.0-255,1484,88146,92,243418
21860,0.001903,74.125.24.0-255,4320,92466,92,243418
21861,0.00192,74.125.24.0-255,5020,97486,92,243418
21862,0.003898,172.31.47.0-255,66,97552,92,243418
21863,0.006182,74.125.24.0-255,5738,103290,92,243418
21864,0.006193,172.31.47.0-255,66,103356,92,243418
21865,0.008656,74.125.24.0-255,5738,109094,92,243418
21866,0.008717,172.31.47.0-255,66,109160,92,243418
21867,0.011026,74.125.24.0-255,5738,114898,92,243418
21868,0.011037,172.31.47.0-255,66,114964,92,243418
21869,0.013325,74.125.24.0-255,5738,120702,92,243418
21870,0.013336,172.31.47.0-255,66,120768,92,243418
21871,0.0156,74.125.24.0-255,5738,126506,92,243418
21872,0.01561,172.31.47.0-255,66,126572,92,243418
21873,0.017872,74.125.24.0-255,5738,132310,92,243418
21874,0.017887,172.31.47.0-255,66,132376,92,243418
21875,0.020165,74.125.24.0-255,5738,138114,92,243418
21876,0.020172,172.31.47.0-255,66,138180,92,243418
21877,0.022474,74.125.24.0-255,5738,143918,92,243418
21878,0.022481,172.31.47.0-255,66,143984,92,243418
21879,0.024758,74.125.24.0-255,5738,149722,92,243418
21880,0.024767,172.31.47.0-255,66,149788,92,243418
21881,0.027049,74.125.24.0-255,5738,155526,92,243418
21882,0.027058,172.31.47.0-255,66,155592,92,243418
21883,0.029353,74.125.24.0-255,5738,161330,92,243418
21884,0.029367,172.31.47.0-255,66,161396,92,243418
21885,0.030424,172.31.47.0-255,172,161568,92,243418
21886,0.030456,172.31.47.0-255,1112,162680,92,243418
21887,0.030515,172.31.47.0-255,1514,164194,92,243418
21888,0.030517,172.31.47.0-255,1514,165708,92,243418
21889,0.030518,172.31.47.0-255,1514,167222,92,243418
21890,0.030519,172.31.47.0-255,1514,168736,92,243418
21891,0.030548,172.31.47.0-255,1496,170232,92,243418
21892,0.031636,74.125.24.0-255,5738,175970,92,243418
21893,0.031642,172.31.47.0-255,66,176036,92,243418
21894,0.031958,104.244.42.0-255,66,176102,92,243418
21895,0.032025,104.244.42.0-255,66,176168,92,243418
21896,0.032059,104.244.42.0-255,66,176234,92,243418
21897,0.032111,104.244.42.0-255,66,176300,92,243418
21898,0.033786,104.244.42.0-255,108,176408,92,243418
21899,0.033792,172.31.47.0-255,66,176474,92,243418
21900,0.033901,74.125.24.0-255,5738,182212,92,243418
21901,0.033905,172.31.47.0-255,66,182278,92,243418
21902,0.036188,74.125.24.0-255,4320,186598,92,243418
21903,0.036195,172.31.47.0-255,66,186664,92,243418
21904,0.036213,74.125.24.0-255,1484,188148,92,243418
21905,0.038448,74.125.24.0-255,4320,192468,92,243418
21906,0.038456,172.31.47.0-255,66,192534,92,243418
21907,0.040731,74.125.24.0-255,5738,198272,92,243418
21908,0.040784,172.31.47.0-255,66,198338,92,243418
21909,0.043054,74.125.24.0-255,5738,204076,92,243418
21910,0.04306,172.31.47.0-255,66,204142,92,243418
21911,0.045317,74.125.24.0-255,5738,209880,92,243418
21912,0.045323,172.31.47.0-255,66,209946,92,243418
21913,0.047614,74.125.24.0-255,5738,215684,92,243418
21914,0.047618,172.31.47.0-255,66,215750,92,243418
21915,0.049903,74.125.24.0-255,5738,221488,92,243418
21916,0.049909,172.31.47.0-255,66,221554,92,243418
21917,0.052157,74.125.24.0-255,5738,227292,92,243418
21918,0.052162,172.31.47.0-255,66,227358,92,243418
21919,0.054437,74.125.24.0-255,4320,231678,92,243418
21920,0.054442,172.31.47.0-255,66,231744,92,243418
21921,0.054467,74.125.24.0-255,1484,233228,92,243418
21922,0.056705,74.125.24.0-255,4320,237548,92,243418
21923,0.056717,172.31.47.0-255,66,237614,92,243418
21924,0.058979,74.125.24.0-255,5738,243352,92,243418
21925,0.059037,172.31.47.0-255,66,243418,92,243418
21926,0.0,172.31.47.0-255,105,105,92,276
21927,0.00206,157.240.13.0-255,105,210,92,276
21928,0.002075,172.31.47.0-255,66,276,92,276
21929,0.0,172.217.194.0-255,153,153,92,244124
21930,1.4e-05,172.31.47.0-255,66,219,92,244124
21931,2e-05,172.217.194.0-255,1484,1703,92,244124
21932,2.3e-05,172.31.47.0-255,66,1769,92,244124
21933,2.8e-05,172.217.194.0-255,2902,4671,92,244124
21934,3e-05,172.31.47.0-255,66,4737,92,244124
21935,4.2e-05,172.217.194.0-255,7156,11893,92,244124
21936,4.4e-05,172.31.47.0-255,66,11959,92,244124
21937,9.3e-05,172.31.47.0-255,66,12025,92,244124
21938,9.7e-05,172.217.194.0-255,2543,14568,92,244124
21939,9.9e-05,172.31.47.0-255,66,14634,92,244124
21940,0.000137,172.217.194.0-255,1484,16118,92,244124
21941,0.000139,172.31.47.0-255,66,16184,92,244124
21942,0.000143,172.217.194.0-255,2902,19086,92,244124
21943,0.000145,172.31.47.0-255,66,19152,92,244124
21944,0.00015,172.217.194.0-255,5738,24890,92,244124
21945,0.000151,172.31.47.0-255,66,24956,92,244124
21946,0.000203,172.31.47.0-255,66,25022,92,244124
21947,0.000212,172.31.47.0-255,66,25088,92,244124
21948,0.000226,172.217.194.0-255,1484,26572,92,244124
21949,0.000228,172.31.47.0-255,66,26638,92,244124
21950,0.00023,172.217.194.0-255,1484,28122,92,244124
21951,0.000232,172.31.47.0-255,66,28188,92,244124
21952,0.00025,172.217.194.0-255,2543,30731,92,244124
21953,0.000252,172.31.47.0-255,66,30797,92,244124
21954,0.000447,172.217.194.0-255,369,31166,92,244124
21955,0.000452,172.31.47.0-255,66,31232,92,244124
21956,0.000456,172.217.194.0-255,375,31607,92,244124
21957,0.000458,172.31.47.0-255,66,31673,92,244124
21958,0.000573,172.217.194.0-255,1484,33157,92,244124
21959,0.000577,172.217.194.0-255,2902,36059,92,244124
21960,0.000593,172.217.194.0-255,5738,41797,92,244124
21961,0.000603,172.31.47.0-255,66,41863,92,244124
21962,0.000612,172.217.194.0-255,4320,46183,92,244124
21963,0.000623,172.31.47.0-255,66,46249,92,244124
21964,0.000645,172.217.194.0-255,4320,50569,92,244124
21965,0.000679,172.31.47.0-255,66,50635,92,244124
21966,0.000723,172.31.47.0-255,66,50701,92,244124
21967,0.000749,172.217.194.0-255,5379,56080,92,244124
21968,0.000755,172.31.47.0-255,66,56146,92,244124
21969,0.00077,172.217.194.0-255,1484,57630,92,244124
21970,0.000783,172.217.194.0-255,4320,61950,92,244124
21971,0.000787,172.217.194.0-255,4320,66270,92,244124
21972,0.000804,172.217.194.0-255,2902,69172,92,244124
21973,0.000807,172.31.47.0-255,66,69238,92,244124
21974,0.000812,172.31.47.0-255,66,69304,92,244124
21975,0.000856,172.217.194.0-255,3961,73265,92,244124
21976,0.000869,172.31.47.0-255,66,73331,92,244124
21977,0.00093,172.217.194.0-255,1484,74815,92,244124
21978,0.000934,172.217.194.0-255,2902,77717,92,244124
21979,0.000942,172.31.47.0-255,66,77783,92,244124
21980,0.000952,172.217.194.0-255,5738,83521,92,244124
21981,0.000975,172.217.194.0-255,7156,90677,92,244124
21982,0.000978,172.31.47.0-255,66,90743,92,244124
21983,0.001003,172.217.194.0-255,5738,96481,92,244124
21984,0.001044,172.217.194.0-255,5738,102219,92,244124
21985,0.001047,172.31.47.0-255,66,102285,92,244124
21986,0.001052,172.31.47.0-255,66,102351,92,244124
21987,0.001072,172.217.194.0-255,5738,108089,92,244124
21988,0.001158,172.217.194.0-255,1484,109573,92,244124
21989,0.001167,172.31.47.0-255,66,109639,92,244124
21990,0.001192,172.31.47.0-255,66,109705,92,244124
21991,0.001228,172.31.47.0-255,66,109771,92,244124
21992,0.001268,172.217.194.0-255,7156,116927,92,244124
21993,0.001293,172.217.194.0-255,2902,119829,92,244124
21994,0.001298,172.217.194.0-255,4320,124149,92,244124
21995,0.001306,172.31.47.0-255,66,124215,92,244124
21996,0.001316,172.217.194.0-255,2543,126758,92,244124
21997,0.001322,172.31.47.0-255,66,126824,92,244124
21998,0.001342,172.217.194.0-255,7156,133980,92,244124
21999,0.001395,172.31.47.0-255,66,134046,92,244124
22000,0.001408,172.217.194.0-255,5738,139784,92,244124
22001,0.001426,172.217.194.0-255,5020,144804,92,244124
22002,0.001431,172.31.47.0-255,66,144870,92,244124
22003,0.001462,172.217.194.0-255,7156,152026,92,244124
22004,0.001466,172.217.194.0-255,1484,153510,92,244124
22005,0.001489,172.217.194.0-255,7156,160666,92,244124
22006,0.0015,172.31.47.0-255,66,160732,92,244124
22007,0.001507,172.31.47.0-255,66,160798,92,244124
22008,0.001527,172.217.194.0-255,766,161564,92,244124
22009,0.001553,172.217.194.0-255,1484,163048,92,244124
22010,0.001573,172.217.194.0-255,2902,165950,92,244124
22011,0.001577,172.217.194.0-255,1484,167434,92,244124
22012,0.001593,172.217.194.0-255,4320,171754,92,244124
22013,0.0016,172.217.194.0-255,7156,178910,92,244124
22014,0.001616,172.31.47.0-255,66,178976,92,244124
22015,0.001623,172.217.194.0-255,5738,184714,92,244124
22016,0.001632,172.217.194.0-255,7156,191870,92,244124
22017,0.001639,172.31.47.0-255,66,191936,92,244124
22018,0.001665,172.217.194.0-255,7156,199092,92,244124
22019,0.001677,172.217.194.0-255,3602,202694,92,244124
22020,0.001683,172.217.194.0-255,7156,209850,92,244124
22021,0.001692,172.31.47.0-255,66,209916,92,244124
22022,0.001701,172.217.194.0-255,4320,214236,92,244124
22023,0.001745,172.217.194.0-255,5738,219974,92,244124
22024,0.001773,172.31.47.0-255,66,220040,92,244124
22025,0.001889,172.217.194.0-255,1484,221524,92,244124
22026,0.001894,172.217.194.0-255,2902,224426,92,244124
22027,0.001906,172.31.47.0-255,66,224492,92,244124
22028,0.001922,172.217.194.0-255,5738,230230,92,244124
22029,0.001937,172.31.47.0-255,66,230296,92,244124
22030,0.00198,172.217.194.0-255,4320,234616,92,244124
22031,0.001987,172.31.47.0-255,66,234682,92,244124
22032,0.00201,172.217.194.0-255,105,234787,92,244124
22033,0.002028,172.31.47.0-255,66,234853,92,244124
22034,0.012762,172.31.47.0-255,105,234958,92,244124
22035,0.015034,172.217.194.0-255,66,235024,92,244124
22036,0.039455,172.31.47.0-255,172,235196,92,244124
22037,0.039507,172.31.47.0-255,1112,236308,92,244124
22038,0.041005,104.244.42.0-255,66,236374,92,244124
22039,0.041049,104.244.42.0-255,66,236440,92,244124
22040,0.042068,172.31.47.0-255,1514,237954,92,244124
22041,0.042071,172.31.47.0-255,1514,239468,92,244124
22042,0.042076,172.31.47.0-255,1514,240982,92,244124
22043,0.042077,172.31.47.0-255,1514,242496,92,244124
22044,0.042097,172.31.47.0-255,1496,243992,92,244124
22045,0.043623,104.244.42.0-255,66,244058,92,244124
22046,0.043665,104.244.42.0-255,66,244124,92,244124
22047,0.0,74.125.68.0-255,153,153,92,320619
22048,2.4e-05,172.31.47.0-255,66,219,92,320619
22049,3.2e-05,74.125.68.0-255,1484,1703,92,320619
22050,3.7e-05,172.31.47.0-255,66,1769,92,320619
22051,4.3e-05,74.125.68.0-255,2902,4671,92,320619
22052,5.3e-05,172.31.47.0-255,66,4737,92,320619
22053,9e-05,74.125.68.0-255,1484,6221,92,320619
22054,9.3e-05,172.31.47.0-255,66,6287,92,320619
22055,9.8e-05,74.125.68.0-255,2902,9189,92,320619
22056,0.000101,172.31.47.0-255,66,9255,92,320619
22057,0.000108,74.125.68.0-255,6382,15637,92,320619
22058,0.000111,172.31.47.0-255,66,15703,92,320619
22059,0.000114,74.125.68.0-255,1484,17187,92,320619
22060,0.000116,172.31.47.0-255,66,17253,92,320619
22061,0.000121,74.125.68.0-255,2902,20155,92,320619
22062,0.000124,172.31.47.0-255,66,20221,92,320619
22063,0.000158,74.125.68.0-255,5738,25959,92,320619
22064,0.000161,172.31.47.0-255,66,26025,92,320619
22065,0.000165,74.125.68.0-255,2902,28927,92,320619
22066,0.000168,172.31.47.0-255,66,28993,92,320619
22067,0.000199,74.125.68.0-255,2543,31536,92,320619
22068,0.000202,172.31.47.0-255,66,31602,92,320619
22069,0.000268,74.125.68.0-255,1484,33086,92,320619
22070,0.000271,172.31.47.0-255,66,33152,92,320619
22071,0.0003,74.125.68.0-255,2902,36054,92,320619
22072,0.000304,172.31.47.0-255,66,36120,92,320619
22073,0.000311,74.125.68.0-255,5738,41858,92,320619
22074,0.000313,172.31.47.0-255,66,41924,92,320619
22075,0.000317,74.125.68.0-255,2902,44826,92,320619
22076,0.000319,172.31.47.0-255,66,44892,92,320619
22077,0.00037,74.125.68.0-255,5379,50271,92,320619
22078,0.000373,172.31.47.0-255,66,50337,92,320619
22079,0.00038,74.125.68.0-255,5738,56075,92,320619
22080,0.000445,74.125.68.0-255,112,56187,92,320619
22081,0.000531,74.125.68.0-255,1484,57671,92,320619
22082,0.000535,74.125.68.0-255,1484,59155,92,320619
22083,0.000551,74.125.68.0-255,1484,60639,92,320619
22084,0.000564,74.125.68.0-255,2902,63541,92,320619
22085,0.000586,74.125.68.0-255,2902,66443,92,320619
22086,0.000594,74.125.68.0-255,7156,73599,92,320619
22087,0.000639,74.125.68.0-255,2902,76501,92,320619
22088,0.000665,172.31.47.0-255,66,76567,92,320619
22089,0.000672,74.125.68.0-255,3288,79855,92,320619
22090,0.000678,172.31.47.0-255,66,79921,92,320619
22091,0.000711,74.125.68.0-255,4320,84241,92,320619
22092,0.000715,74.125.68.0-255,1484,85725,92,320619
22093,0.000728,74.125.68.0-255,1484,87209,92,320619
22094,0.000742,74.125.68.0-255,4320,91529,92,320619
22095,0.000758,74.125.68.0-255,1484,93013,92,320619
22096,0.000765,172.31.47.0-255,66,93079,92,320619
22097,0.000788,74.125.68.0-255,2902,95981,92,320619
22098,0.000802,172.31.47.0-255,66,96047,92,320619
22099,0.000828,172.31.47.0-255,66,96113,92,320619
22100,0.000855,74.125.68.0-255,6438,102551,92,320619
22101,0.000872,172.31.47.0-255,66,102617,92,320619
22102,0.000901,74.125.68.0-255,1484,104101,92,320619
22103,0.000914,74.125.68.0-255,2902,107003,92,320619
22104,0.000917,74.125.68.0-255,1484,108487,92,320619
22105,0.000931,74.125.68.0-255,2902,111389,92,320619
22106,0.000935,172.31.47.0-255,66,111455,92,320619
22107,0.00094,172.31.47.0-255,66,111521,92,320619
22108,0.000955,74.125.68.0-255,5738,117259,92,320619
22109,0.000995,172.31.47.0-255,66,117325,92,320619
22110,0.00103,74.125.68.0-255,2902,120227,92,320619
22111,0.001037,172.31.47.0-255,66,120293,92,320619
22112,0.001066,74.125.68.0-255,6438,126731,92,320619
22113,0.001075,172.31.47.0-255,66,126797,92,320619
22114,0.001102,74.125.68.0-255,2902,129699,92,320619
22115,0.001107,74.125.68.0-255,4320,134019,92,320619
22116,0.001113,74.125.68.0-255,4320,138339,92,320619
22117,0.001128,172.31.47.0-255,66,138405,92,320619
22118,0.001148,74.125.68.0-255,4320,142725,92,320619
22119,0.001153,74.125.68.0-255,4320,147045,92,320619
22120,0.00116,74.125.68.0-255,5738,152783,92,320619
22121,0.001176,172.31.47.0-255,66,152849,92,320619
22122,0.001215,172.31.47.0-255,66,152915,92,320619
22123,0.00128,74.125.68.0-255,1484,154399,92,320619
22124,0.001284,74.125.68.0-255,1484,155883,92,320619
22125,0.001303,74.125.68.0-255,1484,157367,92,320619
22126,0.001313,172.31.47.0-255,66,157433,92,320619
22127,0.001334,74.125.68.0-255,5738,163171,92,320619
22128,0.001341,74.125.68.0-255,7156,170327,92,320619
22129,0.001358,74.125.68.0-255,4320,174647,92,320619
22130,0.001368,172.31.47.0-255,66,174713,92,320619
22131,0.001374,74.125.68.0-255,4320,179033,92,320619
22132,0.001437,172.31.47.0-255,66,179099,92,320619
22133,0.001464,172.31.47.0-255,66,179165,92,320619
22134,0.003737,74.125.68.0-255,5738,184903,92,320619
22135,0.003749,172.31.47.0-255,66,184969,92,320619
22136,0.006006,74.125.68.0-255,5738,190707,92,320619
22137,0.007605,172.31.47.0-255,66,190773,92,320619
22138,0.009877,74.125.68.0-255,5738,196511,92,320619
22139,0.009888,172.31.47.0-255,66,196577,92,320619
22140,0.012159,74.125.68.0-255,5738,202315,92,320619
22141,0.014846,172.31.47.0-255,66,202381,92,320619
22142,0.017134,74.125.68.0-255,5738,208119,92,320619
22143,0.017152,172.31.47.0-255,66,208185,92,320619
22144,0.019419,74.125.68.0-255,5738,213923,92,320619
22145,0.019431,172.31.47.0-255,66,213989,92,320619
22146,0.021702,74.125.68.0-255,5738,219727,92,320619
22147,0.02171,172.31.47.0-255,66,219793,92,320619
22148,0.023974,74.125.68.0-255,5738,225531,92,320619
22149,0.023984,172.31.47.0-255,66,225597,92,320619
22150,0.026252,74.125.68.0-255,5738,231335,92,320619
22151,0.026263,172.31.47.0-255,66,231401,92,320619
22152,0.028516,74.125.68.0-255,5738,237139,92,320619
22153,0.028528,172.31.47.0-255,66,237205,92,320619
22154,0.030806,74.125.68.0-255,5738,242943,92,320619
22155,0.030819,172.31.47.0-255,66,243009,92,320619
22156,0.033104,74.125.68.0-255,5738,248747,92,320619
22157,0.033121,172.31.47.0-255,66,248813,92,320619
22158,0.035405,74.125.68.0-255,5738,254551,92,320619
22159,0.035423,172.31.47.0-255,66,254617,92,320619
22160,0.036552,172.31.47.0-255,175,254792,92,320619
22161,0.036586,172.31.47.0-255,1135,255927,92,320619
22162,0.036653,172.31.47.0-255,1514,257441,92,320619
22163,0.036655,172.31.47.0-255,1514,258955,92,320619
22164,0.036656,172.31.47.0-255,1514,260469,92,320619
22165,0.036657,172.31.47.0-255,1514,261983,92,320619
22166,0.036658,172.31.47.0-255,332,262315,92,320619
22167,0.037685,74.125.68.0-255,5738,268053,92,320619
22168,0.037697,172.31.47.0-255,66,268119,92,320619
22169,0.038076,104.244.42.0-255,66,268185,92,320619
22170,0.038119,104.244.42.0-255,66,268251,92,320619
22171,0.038233,104.244.42.0-255,66,268317,92,320619
22172,0.038239,104.244.42.0-255,66,268383,92,320619
22173,0.039957,74.125.68.0-255,5738,274121,92,320619
22174,0.039969,172.31.47.0-255,66,274187,92,320619
22175,0.042235,74.125.68.0-255,5738,279925,92,320619
22176,0.042246,172.31.47.0-255,66,279991,92,320619
22177,0.044521,74.125.68.0-255,5738,285729,92,320619
22178,0.044539,172.31.47.0-255,66,285795,92,320619
22179,0.046822,74.125.68.0-255,5738,291533,92,320619
22180,0.046838,172.31.47.0-255,66,291599,92,320619
22181,0.049121,74.125.68.0-255,5738,297337,92,320619
22182,0.049136,172.31.47.0-255,66,297403,92,320619
22183,0.051413,74.125.68.0-255,5738,303141,92,320619
22184,0.051425,172.31.47.0-255,66,303207,92,320619
22185,0.053698,74.125.68.0-255,5738,308945,92,320619
22186,0.053709,172.31.47.0-255,66,309011,92,320619
22187,0.055991,74.125.68.0-255,5738,314749,92,320619
22188,0.056001,172.31.47.0-255,66,314815,92,320619
22189,0.058279,74.125.68.0-255,5738,320553,92,320619
22190,0.058291,172.31.47.0-255,66,320619,92,320619
22191,0.0,172.217.194.0-255,297,297,92,204538
22192,1.5e-05,172.31.47.0-255,66,363,92,204538
22193,2.1e-05,172.217.194.0-255,1484,1847,92,204538
22194,2.5e-05,172.31.47.0-255,66,1913,92,204538
22195,3.9e-05,172.217.194.0-255,4320,6233,92,204538
22196,4.2e-05,172.31.47.0-255,66,6299,92,204538
22197,4.5e-05,172.217.194.0-255,1484,7783,92,204538
22198,4.7e-05,172.31.47.0-255,66,7849,92,204538
22199,8.1e-05,172.31.47.0-255,66,7915,92,204538
22200,9.7e-05,172.31.47.0-255,66,7981,92,204538
22201,0.000145,172.217.194.0-255,6797,14778,92,204538
22202,0.00015,172.31.47.0-255,66,14844,92,204538
22203,0.000185,172.217.194.0-255,1484,16328,92,204538
22204,0.000187,172.31.47.0-255,66,16394,92,204538
22205,0.000192,172.217.194.0-255,2902,19296,92,204538
22206,0.000194,172.31.47.0-255,66,19362,92,204538
22207,0.000197,172.217.194.0-255,1484,20846,92,204538
22208,0.000199,172.31.47.0-255,66,20912,92,204538
22209,0.000233,172.217.194.0-255,4320,25232,92,204538
22210,0.000236,172.31.47.0-255,66,25298,92,204538
22211,0.000243,172.217.194.0-255,6797,32095,92,204538
22212,0.000246,172.31.47.0-255,66,32161,92,204538
22213,0.000254,172.217.194.0-255,1484,33645,92,204538
22214,0.000257,172.31.47.0-255,66,33711,92,204538
22215,0.000305,172.217.194.0-255,2796,36507,92,204538
22216,0.000306,172.31.47.0-255,66,36573,92,204538
22217,0.000307,172.217.194.0-255,118,36691,92,204538
22218,0.00031,172.31.47.0-255,66,36757,92,204538
22219,0.000313,172.31.47.0-255,66,36823,92,204538
22220,0.000342,172.217.194.0-255,1484,38307,92,204538
22221,0.000348,172.217.194.0-255,2902,41209,92,204538
22222,0.000351,172.31.47.0-255,66,41275,92,204538
22223,0.000357,172.217.194.0-255,4320,45595,92,204538
22224,0.00036,172.31.47.0-255,66,45661,92,204538
22225,0.000384,172.217.194.0-255,2902,48563,92,204538
22226,0.000388,172.31.47.0-255,66,48629,92,204538
22227,0.000394,172.217.194.0-255,5379,54008,92,204538
22228,0.000398,172.31.47.0-255,66,54074,92,204538
22229,0.000425,172.217.194.0-255,1799,55873,92,204538
22230,0.000429,172.31.47.0-255,66,55939,92,204538
22231,0.000433,172.217.194.0-255,2902,58841,92,204538
22232,0.000435,172.31.47.0-255,66,58907,92,204538
22233,0.000438,172.217.194.0-255,1484,60391,92,204538
22234,0.000467,172.217.194.0-255,5738,66129,92,204538
22235,0.00047,172.31.47.0-255,66,66195,92,204538
22236,0.00049,172.217.194.0-255,5379,71574,92,204538
22237,0.000494,172.31.47.0-255,66,71640,92,204538
22238,0.000808,172.217.194.0-255,1484,73124,92,204538
22239,0.000813,172.217.194.0-255,2902,76026,92,204538
22240,0.000816,172.31.47.0-255,66,76092,92,204538
22241,0.000819,172.217.194.0-255,1484,77576,92,204538
22242,0.000836,172.217.194.0-255,4320,81896,92,204538
22243,0.000838,172.31.47.0-255,66,81962,92,204538
22244,0.000844,172.217.194.0-255,5738,87700,92,204538
22245,0.000846,172.31.47.0-255,66,87766,92,204538
22246,0.000898,172.217.194.0-255,4320,92086,92,204538
22247,0.000901,172.31.47.0-255,66,92152,92,204538
22248,0.000935,172.31.47.0-255,66,92218,92,204538
22249,0.000961,172.31.47.0-255,66,92284,92,204538
22250,0.000991,172.31.47.0-255,66,92350,92,204538
22251,0.001015,172.217.194.0-255,7156,99506,92,204538
22252,0.001018,172.31.47.0-255,66,99572,92,204538
22253,0.001049,172.31.47.0-255,66,99638,92,204538
22254,0.001077,172.217.194.0-255,1484,101122,92,204538
22255,0.001088,172.217.194.0-255,2902,104024,92,204538
22256,0.001091,172.31.47.0-255,66,104090,92,204538
22257,0.001094,172.217.194.0-255,2902,106992,92,204538
22258,0.001096,172.31.47.0-255,66,107058,92,204538
22259,0.001118,172.217.194.0-255,2902,109960,92,204538
22260,0.001125,172.31.47.0-255,66,110026,92,204538
22261,0.001137,172.31.47.0-255,66,110092,92,204538
22262,0.001139,172.217.194.0-255,1484,111576,92,204538
22263,0.001178,172.31.47.0-255,66,111642,92,204538
22264,0.001201,172.217.194.0-255,1484,113126,92,204538
22265,0.001215,172.217.194.0-255,2902,116028,92,204538
22266,0.001218,172.31.47.0-255,66,116094,92,204538
22267,0.00128,172.217.194.0-255,5738,121832,92,204538
22268,0.001283,172.31.47.0-255,66,121898,92,204538
22269,0.001293,172.31.47.0-255,66,121964,92,204538
22270,0.001328,172.31.47.0-255,66,122030,92,204538
22271,0.001374,172.217.194.0-255,1484,123514,92,204538
22272,0.001378,172.217.194.0-255,1484,124998,92,204538
22273,0.00138,172.31.47.0-255,66,125064,92,204538
22274,0.001405,172.217.194.0-255,1484,126548,92,204538
22275,0.001411,172.217.194.0-255,5738,132286,92,204538
22276,0.001413,172.31.47.0-255,66,132352,92,204538
22277,0.001419,172.217.194.0-255,5738,138090,92,204538
22278,0.001421,172.31.47.0-255,66,138156,92,204538
22279,0.001423,172.217.194.0-255,1484,139640,92,204538
22280,0.001453,172.31.47.0-255,66,139706,92,204538
22281,0.001459,172.217.194.0-255,5020,144726,92,204538
22282,0.00146,172.31.47.0-255,66,144792,92,204538
22283,0.001509,172.217.194.0-255,1484,146276,92,204538
22284,0.001513,172.217.194.0-255,1484,147760,92,204538
22285,0.001515,172.31.47.0-255,66,147826,92,204538
22286,0.001538,172.217.194.0-255,1484,149310,92,204538
22287,0.001544,172.217.194.0-255,5738,155048,92,204538
22288,0.001546,172.31.47.0-255,66,155114,92,204538
22289,0.00155,172.217.194.0-255,2902,158016,92,204538
22290,0.001552,172.31.47.0-255,66,158082,92,204538
22291,0.001578,172.217.194.0-255,5738,163820,92,204538
22292,0.001577,172.31.47.0-255,66,163886,92,204538
22293,0.001584,172.31.47.0-255,66,163952,92,204538
22294,0.001606,172.217.194.0-255,5020,168972,92,204538
22295,0.001613,172.31.47.0-255,66,169038,92,204538
22296,0.001694,172.217.194.0-255,1484,170522,92,204538
22297,0.001699,172.217.194.0-255,2902,173424,92,204538
22298,0.001703,172.31.47.0-255,66,173490,92,204538
22299,0.001703,172.217.194.0-255,5738,179228,92,204538
22300,0.001706,172.31.47.0-255,66,179294,92,204538
22301,0.001707,172.217.194.0-255,4320,183614,92,204538
22302,0.001709,172.31.47.0-255,66,183680,92,204538
22303,0.001742,172.31.47.0-255,66,183746,92,204538
22304,0.001745,172.217.194.0-255,1484,185230,92,204538
22305,0.00179,172.31.47.0-255,66,185296,92,204538
22306,0.001793,172.217.194.0-255,1484,186780,92,204538
22307,0.001833,172.31.47.0-255,66,186846,92,204538
22308,0.001867,172.217.194.0-255,2902,189748,92,204538
22309,0.00187,172.31.47.0-255,66,189814,92,204538
22310,0.001924,172.31.47.0-255,66,189880,92,204538
22311,0.00196,172.217.194.0-255,5020,194900,92,204538
22312,0.001962,172.31.47.0-255,66,194966,92,204538
22313,0.001965,172.31.47.0-255,66,195032,92,204538
22314,0.001983,172.31.47.0-255,66,195098,92,204538
22315,0.001985,172.217.194.0-255,105,195203,92,204538
22316,0.003173,172.31.47.0-255,66,195269,92,204538
22317,0.008061,172.31.47.0-255,105,195374,92,204538
22318,0.010362,172.217.194.0-255,66,195440,92,204538
22319,0.041186,172.31.47.0-255,172,195612,92,204538
22320,0.041216,172.31.47.0-255,1112,196724,92,204538
22321,0.041258,172.31.47.0-255,1514,198238,92,204538
22322,0.041278,172.31.47.0-255,1514,199752,92,204538
22323,0.041281,172.31.47.0-255,1514,201266,92,204538
22324,0.041295,172.31.47.0-255,1514,202780,92,204538
22325,0.041298,172.31.47.0-255,1494,204274,92,204538
22326,0.042705,104.244.42.0-255,66,204340,92,204538
22327,0.042743,104.244.42.0-255,66,204406,92,204538
22328,0.0428,104.244.42.0-255,66,204472,92,204538
22329,0.042858,104.244.42.0-255,66,204538,92,204538
22330,0.0,172.217.194.0-255,153,153,92,261745
22331,2.6e-05,172.31.47.0-255,66,219,92,261745
22332,3.3e-05,172.217.194.0-255,1484,1703,92,261745
22333,3.7e-05,172.31.47.0-255,66,1769,92,261745
22334,4.3e-05,172.217.194.0-255,2902,4671,92,261745
22335,4.8e-05,172.31.47.0-255,66,4737,92,261745
22336,5.5e-05,172.217.194.0-255,7156,11893,92,261745
22337,5.8e-05,172.31.47.0-255,66,11959,92,261745
22338,6.2e-05,172.217.194.0-255,2173,14132,92,261745
22339,6.5e-05,172.31.47.0-255,66,14198,92,261745
22340,9.1e-05,172.217.194.0-255,5738,19936,92,261745
22341,9.4e-05,172.31.47.0-255,66,20002,92,261745
22342,0.000108,172.217.194.0-255,5738,25740,92,261745
22343,0.00011,172.31.47.0-255,66,25806,92,261745
22344,0.000116,172.217.194.0-255,5379,31185,92,261745
22345,0.000118,172.31.47.0-255,66,31251,92,261745
22346,0.000209,172.217.194.0-255,1484,32735,92,261745
22347,0.000212,172.31.47.0-255,66,32801,92,261745
22348,0.000231,172.217.194.0-255,2902,35703,92,261745
22349,0.000234,172.31.47.0-255,66,35769,92,261745
22350,0.00024,172.217.194.0-255,5738,41507,92,261745
22351,0.000242,172.31.47.0-255,66,41573,92,261745
22352,0.000272,172.31.47.0-255,66,41639,92,261745
22353,0.000314,172.217.194.0-255,2902,44541,92,261745
22354,0.000316,172.31.47.0-255,66,44607,92,261745
22355,0.000349,172.31.47.0-255,66,44673,92,261745
22356,0.000352,172.217.194.0-255,646,45319,92,261745
22357,0.000353,172.31.47.0-255,66,45385,92,261745
22358,0.00123,172.217.194.0-255,1484,46869,92,261745
22359,0.001237,172.31.47.0-255,66,46935,92,261745
22360,0.001258,172.217.194.0-255,2902,49837,92,261745
22361,0.001266,172.217.194.0-255,5738,55575,92,261745
22362,0.001268,172.217.194.0-255,1484,57059,92,261745
22363,0.00128,172.217.194.0-255,1484,58543,92,261745
22364,0.001308,172.217.194.0-255,7156,65699,92,261745
22365,0.001331,172.217.194.0-255,2902,68601,92,261745
22366,0.001338,172.217.194.0-255,7156,75757,92,261745
22367,0.001396,172.217.194.0-255,3602,79359,92,261745
22368,0.001553,172.217.194.0-255,1484,80843,92,261745
22369,0.001573,172.217.194.0-255,2902,83745,92,261745
22370,0.001584,172.217.194.0-255,1484,85229,92,261745
22371,0.001597,172.217.194.0-255,4320,89549,92,261745
22372,0.001622,172.217.194.0-255,2902,92451,92,261745
22373,0.002029,172.217.194.0-255,1484,93935,92,261745
22374,0.002046,172.217.194.0-255,2902,96837,92,261745
22375,0.002063,172.217.194.0-255,4320,101157,92,261745
22376,0.002073,172.217.194.0-255,1484,102641,92,261745
22377,0.00616,172.31.47.0-255,66,102707,92,261745
22378,0.008205,172.217.194.0-255,5738,108445,92,261745
22379,0.008214,172.31.47.0-255,66,108511,92,261745
22380,0.010173,172.217.194.0-255,5738,114249,92,261745
22381,0.01075,172.31.47.0-255,66,114315,92,261745
22382,0.012713,172.217.194.0-255,5738,120053,92,261745
22383,0.01272,172.31.47.0-255,66,120119,92,261745
22384,0.014694,172.217.194.0-255,5738,125857,92,261745
22385,0.014707,172.31.47.0-255,66,125923,92,261745
22386,0.016703,172.217.194.0-255,5738,131661,92,261745
22387,0.016715,172.31.47.0-255,66,131727,92,261745
22388,0.018718,172.217.194.0-255,5738,137465,92,261745
22389,0.018727,172.31.47.0-255,66,137531,92,261745
22390,0.020709,172.217.194.0-255,5738,143269,92,261745
22391,0.020727,172.31.47.0-255,66,143335,92,261745
22392,0.022745,172.217.194.0-255,5738,149073,92,261745
22393,0.022758,172.31.47.0-255,66,149139,92,261745
22394,0.024756,172.217.194.0-255,5738,154877,92,261745
22395,0.024767,172.31.47.0-255,66,154943,92,261745
22396,0.026544,172.31.47.0-255,172,155115,92,261745
22397,0.026615,172.31.47.0-255,1111,156226,92,261745
22398,0.026689,172.31.47.0-255,1514,157740,92,261745
22399,0.026691,172.31.47.0-255,1514,159254,92,261745
22400,0.026692,172.31.47.0-255,1514,160768,92,261745
22401,0.026693,172.31.47.0-255,1514,162282,92,261745
22402,0.026694,172.31.47.0-255,531,162813,92,261745
22403,0.026748,172.217.194.0-255,5738,168551,92,261745
22404,0.026755,172.31.47.0-255,66,168617,92,261745
22405,0.0281,104.244.42.0-255,66,168683,92,261745
22406,0.028194,104.244.42.0-255,66,168749,92,261745
22407,0.028292,104.244.42.0-255,66,168815,92,261745
22408,0.028296,104.244.42.0-255,66,168881,92,261745
22409,0.028724,172.217.194.0-255,5738,174619,92,261745
22410,0.028734,172.31.47.0-255,66,174685,92,261745
22411,0.030719,172.217.194.0-255,5738,180423,92,261745
22412,0.030729,172.31.47.0-255,66,180489,92,261745
22413,0.03272,172.217.194.0-255,5738,186227,92,261745
22414,0.032731,172.31.47.0-255,66,186293,92,261745
22415,0.03469,172.217.194.0-255,5738,192031,92,261745
22416,0.034696,172.31.47.0-255,66,192097,92,261745
22417,0.036702,172.217.194.0-255,5738,197835,92,261745
22418,0.036708,172.31.47.0-255,66,197901,92,261745
22419,0.038694,172.217.194.0-255,5738,203639,92,261745
22420,0.038701,172.31.47.0-255,66,203705,92,261745
22421,0.040684,172.217.194.0-255,5738,209443,92,261745
22422,0.040691,172.31.47.0-255,66,209509,92,261745
22423,0.042685,172.217.194.0-255,5738,215247,92,261745
22424,0.042691,172.31.47.0-255,66,215313,92,261745
22425,0.044679,172.217.194.0-255,5738,221051,92,261745
22426,0.044685,172.31.47.0-255,66,221117,92,261745
22427,0.046643,172.217.194.0-255,5738,226855,92,261745
22428,0.046657,172.31.47.0-255,66,226921,92,261745
22429,0.048668,172.217.194.0-255,5738,232659,92,261745
22430,0.048683,172.31.47.0-255,66,232725,92,261745
22431,0.050694,172.217.194.0-255,5738,238463,92,261745
22432,0.050711,172.31.47.0-255,66,238529,92,261745
22433,0.052698,172.217.194.0-255,5738,244267,92,261745
22434,0.052705,172.31.47.0-255,66,244333,92,261745
22435,0.054716,172.217.194.0-255,5738,250071,92,261745
22436,0.054723,172.31.47.0-255,66,250137,92,261745
22437,0.056699,172.217.194.0-255,5738,255875,92,261745
22438,0.056705,172.31.47.0-255,66,255941,92,261745
22439,0.058672,172.217.194.0-255,5738,261679,92,261745
22440,0.05868,172.31.47.0-255,66,261745,92,261745
22441,0.0,74.125.24.0-255,153,153,92,309323
22442,3.2e-05,172.31.47.0-255,66,219,92,309323
22443,4e-05,74.125.24.0-255,1484,1703,92,309323
22444,4.4e-05,172.31.47.0-255,66,1769,92,309323
22445,4.8e-05,74.125.24.0-255,2902,4671,92,309323
22446,5e-05,172.31.47.0-255,66,4737,92,309323
22447,5.2e-05,74.125.24.0-255,1484,6221,92,309323
22448,5.4e-05,172.31.47.0-255,66,6287,92,309323
22449,8.4e-05,74.125.24.0-255,4320,10607,92,309323
22450,8.7e-05,172.31.47.0-255,66,10673,92,309323
22451,9.3e-05,74.125.24.0-255,6414,17087,92,309323
22452,9.5e-05,172.31.47.0-255,66,17153,92,309323
22453,0.000122,74.125.24.0-255,7156,24309,92,309323
22454,0.000124,172.31.47.0-255,66,24375,92,309323
22455,0.000146,74.125.24.0-255,6797,31172,92,309323
22456,0.000148,172.31.47.0-255,66,31238,92,309323
22457,0.000157,74.125.24.0-255,1484,32722,92,309323
22458,0.000159,172.31.47.0-255,66,32788,92,309323
22459,0.000173,74.125.24.0-255,2902,35690,92,309323
22460,0.000175,172.31.47.0-255,66,35756,92,309323
22461,0.00018,74.125.24.0-255,1484,37240,92,309323
22462,0.000182,172.31.47.0-255,66,37306,92,309323
22463,0.000206,74.125.24.0-255,4320,41626,92,309323
22464,0.000209,172.31.47.0-255,66,41692,92,309323
22465,0.000226,172.31.47.0-255,66,41758,92,309323
22466,0.00028,172.31.47.0-255,66,41824,92,309323
22467,0.000282,74.125.24.0-255,367,42191,92,309323
22468,0.000286,172.31.47.0-255,66,42257,92,309323
22469,0.000537,74.125.24.0-255,129,42386,92,309323
22470,0.00054,172.31.47.0-255,66,42452,92,309323
22471,0.000574,74.125.24.0-255,1484,43936,92,309323
22472,0.00058,74.125.24.0-255,2902,46838,92,309323
22473,0.000582,172.31.47.0-255,66,46904,92,309323
22474,0.000585,74.125.24.0-255,1484,48388,92,309323
22475,0.000603,74.125.24.0-255,5738,54126,92,309323
22476,0.000605,172.31.47.0-255,66,54192,92,309323
22477,0.000621,74.125.24.0-255,2902,57094,92,309323
22478,0.000623,172.31.47.0-255,66,57160,92,309323
22479,0.000637,74.125.24.0-255,2543,59703,92,309323
22480,0.00064,172.31.47.0-255,66,59769,92,309323
22481,0.000671,74.125.24.0-255,2902,62671,92,309323
22482,0.000673,172.31.47.0-255,66,62737,92,309323
22483,0.000676,74.125.24.0-255,1484,64221,92,309323
22484,0.00069,74.125.24.0-255,2902,67123,92,309323
22485,0.000692,172.31.47.0-255,66,67189,92,309323
22486,0.000713,74.125.24.0-255,2902,70091,92,309323
22487,0.000715,172.31.47.0-255,66,70157,92,309323
22488,0.00072,74.125.24.0-255,4320,74477,92,309323
22489,0.000721,172.31.47.0-255,66,74543,92,309323
22490,0.000733,172.31.47.0-255,66,74609,92,309323
22491,0.000756,74.125.24.0-255,6136,80745,92,309323
22492,0.000759,172.31.47.0-255,66,80811,92,309323
22493,0.000905,74.125.24.0-255,1484,82295,92,309323
22494,0.000918,74.125.24.0-255,2902,85197,92,309323
22495,0.000922,172.31.47.0-255,66,85263,92,309323
22496,0.000925,74.125.24.0-255,2902,88165,92,309323
22497,0.000927,172.31.47.0-255,66,88231,92,309323
22498,0.000948,74.125.24.0-255,2902,91133,92,309323
22499,0.000952,172.31.47.0-255,66,91199,92,309323
22500,0.000953,74.125.24.0-255,7156,98355,92,309323
22501,0.000955,172.31.47.0-255,66,98421,92,309323
22502,0.000972,74.125.24.0-255,2902,101323,92,309323
22503,0.000975,172.31.47.0-255,66,101389,92,309323
22504,0.001005,172.31.47.0-255,66,101455,92,309323
22505,0.001044,74.125.24.0-255,2184,103639,92,309323
22506,0.001049,172.31.47.0-255,66,103705,92,309323
22507,0.001159,74.125.24.0-255,1484,105189,92,309323
22508,0.001176,74.125.24.0-255,2902,108091,92,309323
22509,0.001178,172.31.47.0-255,66,108157,92,309323
22510,0.001198,74.125.24.0-255,5738,113895,92,309323
22511,0.001201,172.31.47.0-255,66,113961,92,309323
22512,0.001223,74.125.24.0-255,1484,115445,92,309323
22513,0.001237,74.125.24.0-255,7156,122601,92,309323
22514,0.001239,172.31.47.0-255,66,122667,92,309323
22515,0.001258,74.125.24.0-255,4320,126987,92,309323
22516,0.00126,172.31.47.0-255,66,127053,92,309323
22517,0.001264,74.125.24.0-255,4320,131373,92,309323
22518,0.001266,172.31.47.0-255,66,131439,92,309323
22519,0.001284,74.125.24.0-255,6438,137877,92,309323
22520,0.001286,172.31.47.0-255,66,137943,92,309323
22521,0.001854,74.125.24.0-255,1484,139427,92,309323
22522,0.001874,74.125.24.0-255,2902,142329,92,309323
22523,0.001878,172.31.47.0-255,66,142395,92,309323
22524,0.001882,74.125.24.0-255,1484,143879,92,309323
22525,0.0019,74.125.24.0-255,4320,148199,92,309323
22526,0.001902,172.31.47.0-255,66,148265,92,309323
22527,0.001931,172.31.47.0-255,66,148331,92,309323
22528,0.001994,172.31.47.0-255,66,148397,92,309323
22529,0.002242,74.125.24.0-255,1484,149881,92,309323
22530,0.00226,74.125.24.0-255,2902,152783,92,309323
22531,0.002262,172.31.47.0-255,66,152849,92,309323
22532,0.002267,74.125.24.0-255,4320,157169,92,309323
22533,0.002269,172.31.47.0-255,66,157235,92,309323
22534,0.00228,74.125.24.0-255,1484,158719,92,309323
22535,0.002304,74.125.24.0-255,1484,160203,92,309323
22536,0.002306,172.31.47.0-255,66,160269,92,309323
22537,0.002336,172.31.47.0-255,66,160335,92,309323
22538,0.002339,74.125.24.0-255,1484,161819,92,309323
22539,0.002353,74.125.24.0-255,1484,163303,92,309323
22540,0.002355,172.31.47.0-255,66,163369,92,309323
22541,0.002383,172.31.47.0-255,66,163435,92,309323
22542,0.004701,74.125.24.0-255,5738,169173,92,309323
22543,0.004706,172.31.47.0-255,66,169239,92,309323
22544,0.00699,74.125.24.0-255,2902,172141,92,309323
22545,0.006996,172.31.47.0-255,66,172207,92,309323
22546,0.007017,74.125.24.0-255,2902,175109,92,309323
22547,0.00702,172.31.47.0-255,66,175175,92,309323
22548,0.009318,74.125.24.0-255,5738,180913,92,309323
22549,0.009327,172.31.47.0-255,66,180979,92,309323
22550,0.011616,74.125.24.0-255,5738,186717,92,309323
22551,0.011626,172.31.47.0-255,66,186783,92,309323
22552,0.013928,74.125.24.0-255,5738,192521,92,309323
22553,0.013938,172.31.47.0-255,66,192587,92,309323
22554,0.016218,74.125.24.0-255,5738,198325,92,309323
22555,0.016226,172.31.47.0-255,66,198391,92,309323
22556,0.018507,74.125.24.0-255,5738,204129,92,309323
22557,0.018513,172.31.47.0-255,66,204195,92,309323
22558,0.020807,74.125.24.0-255,5738,209933,92,309323
22559,0.020814,172.31.47.0-255,66,209999,92,309323
22560,0.023142,74.125.24.0-255,5738,215737,92,309323
22561,0.02315,172.31.47.0-255,66,215803,92,309323
22562,0.02543,74.125.24.0-255,5738,221541,92,309323
22563,0.025436,172.31.47.0-255,66,221607,92,309323
22564,0.027736,74.125.24.0-255,5738,227345,92,309323
22565,0.027746,172.31.47.0-255,66,227411,92,309323
22566,0.030031,74.125.24.0-255,5738,233149,92,309323
22567,0.03004,172.31.47.0-255,66,233215,92,309323
22568,0.03098,172.31.47.0-255,172,233387,92,309323
22569,0.031021,172.31.47.0-255,1111,234498,92,309323
22570,0.031119,172.31.47.0-255,1514,236012,92,309323
22571,0.031121,172.31.47.0-255,1514,237526,92,309323
22572,0.031122,172.31.47.0-255,1514,239040,92,309323
22573,0.031123,172.31.47.0-255,1514,240554,92,309323
22574,0.031124,172.31.47.0-255,1495,242049,92,309323
22575,0.03235,74.125.24.0-255,4320,246369,92,309323
22576,0.032356,172.31.47.0-255,66,246435,92,309323
22577,0.032376,74.125.24.0-255,1484,247919,92,309323
22578,0.032523,104.244.42.0-255,66,247985,92,309323
22579,0.032542,104.244.42.0-255,66,248051,92,309323
22580,0.032712,104.244.42.0-255,66,248117,92,309323
22581,0.034651,74.125.24.0-255,4320,252437,92,309323
22582,0.034658,172.31.47.0-255,66,252503,92,309323
22583,0.036974,74.125.24.0-255,5738,258241,92,309323
22584,0.036987,172.31.47.0-255,66,258307,92,309323
22585,0.039289,74.125.24.0-255,4320,262627,92,309323
22586,0.039301,172.31.47.0-255,66,262693,92,309323
22587,0.039325,74.125.24.0-255,1484,264177,92,309323
22588,0.04162,74.125.24.0-255,4320,268497,92,309323
22589,0.041635,172.31.47.0-255,66,268563,92,309323
22590,0.043943,74.125.24.0-255,5738,274301,92,309323
22591,0.043951,172.31.47.0-255,66,274367,92,309323
22592,0.046246,74.125.24.0-255,5738,280105,92,309323
22593,0.04625,172.31.47.0-255,66,280171,92,309323
22594,0.048565,74.125.24.0-255,5738,285909,92,309323
22595,0.048574,172.31.47.0-255,66,285975,92,309323
22596,0.050858,74.125.24.0-255,5738,291713,92,309323
22597,0.05087,172.31.47.0-255,66,291779,92,309323
22598,0.053196,74.125.24.0-255,5738,297517,92,309323
22599,0.053208,172.31.47.0-255,66,297583,92,309323
22600,0.055495,74.125.24.0-255,5738,303321,92,309323
22601,0.055501,172.31.47.0-255,66,303387,92,309323
22602,0.057784,74.125.24.0-255,2902,306289,92,309323
22603,0.05779,172.31.47.0-255,66,306355,92,309323
22604,0.057854,74.125.24.0-255,2902,309257,92,309323
22605,0.057859,172.31.47.0-255,66,309323,92,309323
22606,0.0,172.31.47.0-255,105,105,92,105
22607,0.0,216.58.221.0-255,153,153,92,347660
22608,1.2e-05,172.31.47.0-255,66,219,92,347660
22609,3.9e-05,216.58.221.0-255,1484,1703,92,347660
22610,4.2e-05,172.31.47.0-255,66,1769,92,347660
22611,8.8e-05,216.58.221.0-255,2902,4671,92,347660
22612,9.2e-05,172.31.47.0-255,66,4737,92,347660
22613,9.7e-05,216.58.221.0-255,4320,9057,92,347660
22614,0.000101,172.31.47.0-255,66,9123,92,347660
22615,0.000105,216.58.221.0-255,1484,10607,92,347660
22616,0.000107,172.31.47.0-255,66,10673,92,347660
22617,0.000132,216.58.221.0-255,6509,17182,92,347660
22618,0.000134,172.31.47.0-255,66,17248,92,347660
22619,0.000173,216.58.221.0-255,7156,24404,92,347660
22620,0.000176,172.31.47.0-255,66,24470,92,347660
22621,0.000214,216.58.221.0-255,6797,31267,92,347660
22622,0.000217,172.31.47.0-255,66,31333,92,347660
22623,0.000325,216.58.221.0-255,1484,32817,92,347660
22624,0.000329,172.31.47.0-255,66,32883,92,347660
22625,0.000333,216.58.221.0-255,1484,34367,92,347660
22626,0.000336,172.31.47.0-255,66,34433,92,347660
22627,0.000349,216.58.221.0-255,1484,35917,92,347660
22628,0.000352,172.31.47.0-255,66,35983,92,347660
22629,0.000359,216.58.221.0-255,5738,41721,92,347660
22630,0.000361,172.31.47.0-255,66,41787,92,347660
22631,0.000391,216.58.221.0-255,6797,48584,92,347660
22632,0.000394,172.31.47.0-255,66,48650,92,347660
22633,0.000532,216.58.221.0-255,1484,50134,92,347660
22634,0.000536,172.31.47.0-255,66,50200,92,347660
22635,0.00054,216.58.221.0-255,1484,51684,92,347660
22636,0.000543,172.31.47.0-255,66,51750,92,347660
22637,0.000566,216.58.221.0-255,1484,53234,92,347660
22638,0.000569,172.31.47.0-255,66,53300,92,347660
22639,0.000576,216.58.221.0-255,5738,59038,92,347660
22640,0.000578,172.31.47.0-255,66,59104,92,347660
22641,0.000583,216.58.221.0-255,4320,63424,92,347660
22642,0.000586,172.31.47.0-255,66,63490,92,347660
22643,0.000622,216.58.221.0-255,2833,66323,92,347660
22644,0.000625,172.31.47.0-255,66,66389,92,347660
22645,0.001147,216.58.221.0-255,387,66776,92,347660
22646,0.001329,216.58.221.0-255,1484,68260,92,347660
22647,0.001336,172.31.47.0-255,66,68326,92,347660
22648,0.001342,216.58.221.0-255,2902,71228,92,347660
22649,0.001344,172.31.47.0-255,66,71294,92,347660
22650,0.001369,216.58.221.0-255,5738,77032,92,347660
22651,0.001372,172.31.47.0-255,66,77098,92,347660
22652,0.001379,216.58.221.0-255,6797,83895,92,347660
22653,0.001381,172.31.47.0-255,66,83961,92,347660
22654,0.001395,216.58.221.0-255,1484,85445,92,347660
22655,0.001413,216.58.221.0-255,5738,91183,92,347660
22656,0.001416,172.31.47.0-255,66,91249,92,347660
22657,0.001469,216.58.221.0-255,7156,98405,92,347660
22658,0.001472,172.31.47.0-255,66,98471,92,347660
22659,0.001532,216.58.221.0-255,2543,101014,92,347660
22660,0.001535,172.31.47.0-255,66,101080,92,347660
22661,0.001614,216.58.221.0-255,1484,102564,92,347660
22662,0.001619,216.58.221.0-255,1484,104048,92,347660
22663,0.001622,172.31.47.0-255,66,104114,92,347660
22664,0.001626,216.58.221.0-255,1484,105598,92,347660
22665,0.001641,216.58.221.0-255,1484,107082,92,347660
22666,0.001644,172.31.47.0-255,66,107148,92,347660
22667,0.00165,216.58.221.0-255,4320,111468,92,347660
22668,0.001653,172.31.47.0-255,66,111534,92,347660
22669,0.00166,216.58.221.0-255,5738,117272,92,347660
22670,0.001662,172.31.47.0-255,66,117338,92,347660
22671,0.001698,172.31.47.0-255,66,117404,92,347660
22672,0.001726,216.58.221.0-255,2902,120306,92,347660
22673,0.001728,172.31.47.0-255,66,120372,92,347660
22674,0.001746,216.58.221.0-255,3602,123974,92,347660
22675,0.001748,172.31.47.0-255,66,124040,92,347660
22676,0.001762,216.58.221.0-255,2902,126942,92,347660
22677,0.001765,172.31.47.0-255,66,127008,92,347660
22678,0.001782,216.58.221.0-255,4320,131328,92,347660
22679,0.001784,172.31.47.0-255,66,131394,92,347660
22680,0.001789,216.58.221.0-255,5738,137132,92,347660
22681,0.001791,172.31.47.0-255,66,137198,92,347660
22682,0.001798,216.58.221.0-255,7156,144354,92,347660
22683,0.0018,172.31.47.0-255,66,144420,92,347660
22684,0.001834,216.58.221.0-255,1484,145904,92,347660
22685,0.001852,216.58.221.0-255,4320,150224,92,347660
22686,0.001854,172.31.47.0-255,66,150290,92,347660
22687,0.001857,216.58.221.0-255,1484,151774,92,347660
22688,0.001876,216.58.221.0-255,5738,157512,92,347660
22689,0.001878,172.31.47.0-255,66,157578,92,347660
22690,0.00188,216.58.221.0-255,766,158344,92,347660
22691,0.001904,216.58.221.0-255,1484,159828,92,347660
22692,0.001906,172.31.47.0-255,66,159894,92,347660
22693,0.001923,216.58.221.0-255,2902,162796,92,347660
22694,0.001926,172.31.47.0-255,66,162862,92,347660
22695,0.00193,216.58.221.0-255,2902,165764,92,347660
22696,0.001933,172.31.47.0-255,66,165830,92,347660
22697,0.001938,216.58.221.0-255,4320,170150,92,347660
22698,0.00194,172.31.47.0-255,66,170216,92,347660
22699,0.001966,172.31.47.0-255,66,170282,92,347660
22700,0.001972,216.58.221.0-255,7156,177438,92,347660
22701,0.001974,172.31.47.0-255,66,177504,92,347660
22702,0.001977,216.58.221.0-255,1484,178988,92,347660
22703,0.001996,216.58.221.0-255,5020,184008,92,347660
22704,0.001998,172.31.47.0-255,66,184074,92,347660
22705,0.002147,216.58.221.0-255,1484,185558,92,347660
22706,0.002157,216.58.221.0-255,1484,187042,92,347660
22707,0.002159,172.31.47.0-255,66,187108,92,347660
22708,0.002178,216.58.221.0-255,1484,188592,92,347660
22709,0.002184,216.58.221.0-255,5738,194330,92,347660
22710,0.002186,172.31.47.0-255,66,194396,92,347660
22711,0.002191,216.58.221.0-255,4320,198716,92,347660
22712,0.002193,172.31.47.0-255,66,198782,92,347660
22713,0.002199,216.58.221.0-255,5738,204520,92,347660
22714,0.002201,172.31.47.0-255,66,204586,92,347660
22715,0.002237,172.31.47.0-255,66,204652,92,347660
22716,0.002239,216.58.221.0-255,1484,206136,92,347660
22717,0.002242,216.58.221.0-255,766,206902,92,347660
22718,0.002244,172.31.47.0-255,66,206968,92,347660
22719,0.002624,216.58.221.0-255,1484,208452,92,347660
22720,0.002644,216.58.221.0-255,1484,209936,92,347660
22721,0.002646,172.31.47.0-255,66,210002,92,347660
22722,0.002661,216.58.221.0-255,2902,212904,92,347660
22723,0.002663,172.31.47.0-255,66,212970,92,347660
22724,0.002692,216.58.221.0-255,5738,218708,92,347660
22725,0.002694,172.31.47.0-255,66,218774,92,347660
22726,0.002736,216.58.221.0-255,2902,221676,92,347660
22727,0.002738,172.31.47.0-255,66,221742,92,347660
22728,0.002761,216.58.221.0-255,7156,228898,92,347660
22729,0.002763,172.31.47.0-255,66,228964,92,347660
22730,0.002774,172.31.47.0-255,66,229030,92,347660
22731,0.002777,216.58.221.0-255,766,229796,92,347660
22732,0.002889,216.58.221.0-255,1484,231280,92,347660
22733,0.002891,172.31.47.0-255,66,231346,92,347660
22734,0.002902,216.58.221.0-255,1484,232830,92,347660
22735,0.002918,216.58.221.0-255,1484,234314,92,347660
22736,0.002921,172.31.47.0-255,66,234380,92,347660
22737,0.002926,216.58.221.0-255,5738,240118,92,347660
22738,0.002928,172.31.47.0-255,66,240184,92,347660
22739,0.002934,216.58.221.0-255,5738,245922,92,347660
22740,0.002936,172.31.47.0-255,66,245988,92,347660
22741,0.002957,216.58.221.0-255,7156,253144,92,347660
22742,0.00296,172.31.47.0-255,66,253210,92,347660
22743,0.002964,216.58.221.0-255,4320,257530,92,347660
22744,0.002966,172.31.47.0-255,66,257596,92,347660
22745,0.002985,216.58.221.0-255,4320,261916,92,347660
22746,0.002988,172.31.47.0-255,66,261982,92,347660
22747,0.003021,216.58.221.0-255,2902,264884,92,347660
22748,0.003024,172.31.47.0-255,66,264950,92,347660
22749,0.003043,216.58.221.0-255,6438,271388,92,347660
22750,0.003045,172.31.47.0-255,66,271454,92,347660
22751,0.003051,216.58.221.0-255,7156,278610,92,347660
22752,0.003053,172.31.47.0-255,66,278676,92,347660
22753,0.003078,216.58.221.0-255,2902,281578,92,347660
22754,0.00308,172.31.47.0-255,66,281644,92,347660
22755,0.003086,216.58.221.0-255,7156,288800,92,347660
22756,0.003088,172.31.47.0-255,66,288866,92,347660
22757,0.003122,172.31.47.0-255,66,288932,92,347660
22758,0.003147,216.58.221.0-255,1484,290416,92,347660
22759,0.00317,172.31.47.0-255,66,290482,92,347660
22760,0.003172,216.58.221.0-255,1484,291966,92,347660
22761,0.003187,216.58.221.0-255,2902,294868,92,347660
22762,0.003189,172.31.47.0-255,66,294934,92,347660
22763,0.003207,216.58.221.0-255,7156,302090,92,347660
22764,0.003209,172.31.47.0-255,66,302156,92,347660
22765,0.00324,172.31.47.0-255,66,302222,92,347660
22766,0.003257,216.58.221.0-255,1484,303706,92,347660
22767,0.003261,216.58.221.0-255,2902,306608,92,347660
22768,0.003263,172.31.47.0-255,66,306674,92,347660
22769,0.003267,216.58.221.0-255,2902,309576,92,347660
22770,0.003269,172.31.47.0-255,66,309642,92,347660
22771,0.003282,216.58.221.0-255,2902,312544,92,347660
22772,0.003285,172.31.47.0-255,66,312610,92,347660
22773,0.003314,172.31.47.0-255,66,312676,92,347660
22774,0.003316,216.58.221.0-255,1484,314160,92,347660
22775,0.003335,216.58.221.0-255,7156,321316,92,347660
22776,0.003337,172.31.47.0-255,66,321382,92,347660
22777,0.003352,216.58.221.0-255,1484,322866,92,347660
22778,0.003355,216.58.221.0-255,1484,324350,92,347660
22779,0.003356,172.31.47.0-255,66,324416,92,347660
22780,0.00336,216.58.221.0-255,2902,327318,92,347660
22781,0.003362,172.31.47.0-255,66,327384,92,347660
22782,0.00338,216.58.221.0-255,2902,330286,92,347660
22783,0.003382,172.31.47.0-255,66,330352,92,347660
22784,0.003403,216.58.221.0-255,3602,333954,92,347660
22785,0.003406,172.31.47.0-255,66,334020,92,347660
22786,0.003412,216.58.221.0-255,7156,341176,92,347660
22787,0.003414,172.31.47.0-255,66,341242,92,347660
22788,0.003418,216.58.221.0-255,3684,344926,92,347660
22789,0.003421,172.31.47.0-255,66,344992,92,347660
22790,0.003423,216.58.221.0-255,97,345089,92,347660
22791,0.003467,216.58.221.0-255,105,345194,92,347660
22792,0.01084,172.31.47.0-255,66,345260,92,347660
22793,0.010871,172.31.47.0-255,105,345365,92,347660
22794,0.011539,216.58.221.0-255,105,345470,92,347660
22795,0.011549,172.31.47.0-255,78,345548,92,347660
22796,0.01273,216.58.221.0-255,66,345614,92,347660
22797,0.040702,172.31.47.0-255,167,345781,92,347660
22798,0.040737,172.31.47.0-255,1107,346888,92,347660
22799,0.040766,172.31.47.0-255,574,347462,92,347660
22800,0.042228,104.244.42.0-255,66,347528,92,347660
22801,0.042336,104.244.42.0-255,66,347594,92,347660
22802,0.042342,104.244.42.0-255,66,347660,92,347660
22803,0.0,74.125.68.0-255,153,153,92,303298
22804,2.7e-05,172.31.47.0-255,66,219,92,303298
22805,3.3e-05,74.125.68.0-255,1484,1703,92,303298
22806,3.8e-05,172.31.47.0-255,66,1769,92,303298
22807,5.1e-05,74.125.68.0-255,2902,4671,92,303298
22808,5.5e-05,172.31.47.0-255,66,4737,92,303298
22809,6.3e-05,74.125.68.0-255,7156,11893,92,303298
22810,6.6e-05,172.31.47.0-255,66,11959,92,303298
22811,7.1e-05,74.125.68.0-255,3463,15422,92,303298
22812,7.3e-05,172.31.47.0-255,66,15488,92,303298
22813,0.000109,74.125.68.0-255,4320,19808,92,303298
22814,0.000113,172.31.47.0-255,66,19874,92,303298
22815,0.000125,172.31.47.0-255,66,19940,92,303298
22816,0.000137,74.125.68.0-255,1125,21065,92,303298
22817,0.00014,172.31.47.0-255,66,21131,92,303298
22818,0.000526,74.125.68.0-255,1484,22615,92,303298
22819,0.000531,74.125.68.0-255,2902,25517,92,303298
22820,0.000534,172.31.47.0-255,66,25583,92,303298
22821,0.000538,172.31.47.0-255,66,25649,92,303298
22822,0.000563,74.125.68.0-255,5738,31387,92,303298
22823,0.000571,172.31.47.0-255,66,31453,92,303298
22824,0.000574,74.125.68.0-255,1484,32937,92,303298
22825,0.000577,172.31.47.0-255,66,33003,92,303298
22826,0.000621,172.31.47.0-255,66,33069,92,303298
22827,0.000624,74.125.68.0-255,1484,34553,92,303298
22828,0.000626,172.31.47.0-255,66,34619,92,303298
22829,0.000665,74.125.68.0-255,645,35264,92,303298
22830,0.000667,172.31.47.0-255,66,35330,92,303298
22831,0.00067,172.31.47.0-255,66,35396,92,303298
22832,0.000781,74.125.68.0-255,1484,36880,92,303298
22833,0.000796,74.125.68.0-255,2902,39782,92,303298
22834,0.0008,172.31.47.0-255,66,39848,92,303298
22835,0.000804,74.125.68.0-255,1484,41332,92,303298
22836,0.000829,74.125.68.0-255,4320,45652,92,303298
22837,0.000832,172.31.47.0-255,66,45718,92,303298
22838,0.000839,74.125.68.0-255,7156,52874,92,303298
22839,0.000841,172.31.47.0-255,66,52940,92,303298
22840,0.000857,74.125.68.0-255,1484,54424,92,303298
22841,0.000872,172.31.47.0-255,66,54490,92,303298
22842,0.0009,74.125.68.0-255,1484,55974,92,303298
22843,0.000908,74.125.68.0-255,5020,60994,92,303298
22844,0.000911,172.31.47.0-255,66,61060,92,303298
22845,0.000951,74.125.68.0-255,1484,62544,92,303298
22846,0.000965,74.125.68.0-255,2902,65446,92,303298
22847,0.000969,172.31.47.0-255,66,65512,92,303298
22848,0.000972,74.125.68.0-255,1484,66996,92,303298
22849,0.000995,74.125.68.0-255,2902,69898,92,303298
22850,0.000998,172.31.47.0-255,66,69964,92,303298
22851,0.001001,74.125.68.0-255,1484,71448,92,303298
22852,0.001027,74.125.68.0-255,4320,75768,92,303298
22853,0.001029,74.125.68.0-255,1484,77252,92,303298
22854,0.001031,172.31.47.0-255,66,77318,92,303298
22855,0.00107,172.31.47.0-255,66,77384,92,303298
22856,0.001094,74.125.68.0-255,6438,83822,92,303298
22857,0.001097,172.31.47.0-255,66,83888,92,303298
22858,0.001159,74.125.68.0-255,1484,85372,92,303298
22859,0.001164,74.125.68.0-255,2902,88274,92,303298
22860,0.001167,172.31.47.0-255,66,88340,92,303298
22861,0.001197,74.125.68.0-255,4320,92660,92,303298
22862,0.001201,172.31.47.0-255,66,92726,92,303298
22863,0.001206,74.125.68.0-255,5738,98464,92,303298
22864,0.001209,172.31.47.0-255,66,98530,92,303298
22865,0.001243,172.31.47.0-255,66,98596,92,303298
22866,0.001248,74.125.68.0-255,4320,102916,92,303298
22867,0.00125,172.31.47.0-255,66,102982,92,303298
22868,0.001318,74.125.68.0-255,3602,106584,92,303298
22869,0.001323,172.31.47.0-255,66,106650,92,303298
22870,0.001395,74.125.68.0-255,1484,108134,92,303298
22871,0.001408,74.125.68.0-255,2902,111036,92,303298
22872,0.001411,172.31.47.0-255,66,111102,92,303298
22873,0.001468,74.125.68.0-255,4320,115422,92,303298
22874,0.001472,172.31.47.0-255,66,115488,92,303298
22875,0.001496,74.125.68.0-255,1484,116972,92,303298
22876,0.0015,74.125.68.0-255,2902,119874,92,303298
22877,0.001503,172.31.47.0-255,66,119940,92,303298
22878,0.001513,172.31.47.0-255,66,120006,92,303298
22879,0.001529,172.31.47.0-255,66,120072,92,303298
22880,0.001531,74.125.68.0-255,766,120838,92,303298
22881,0.001782,74.125.68.0-255,1484,122322,92,303298
22882,0.001786,172.31.47.0-255,66,122388,92,303298
22883,0.00179,74.125.68.0-255,1484,123872,92,303298
22884,0.001813,74.125.68.0-255,1484,125356,92,303298
22885,0.001816,172.31.47.0-255,66,125422,92,303298
22886,0.001821,74.125.68.0-255,4320,129742,92,303298
22887,0.001823,172.31.47.0-255,66,129808,92,303298
22888,0.001826,74.125.68.0-255,1484,131292,92,303298
22889,0.001853,74.125.68.0-255,7156,138448,92,303298
22890,0.001856,172.31.47.0-255,66,138514,92,303298
22891,0.001861,74.125.68.0-255,4320,142834,92,303298
22892,0.001863,172.31.47.0-255,66,142900,92,303298
22893,0.001899,74.125.68.0-255,4320,147220,92,303298
22894,0.001902,172.31.47.0-255,66,147286,92,303298
22895,0.001937,172.31.47.0-255,66,147352,92,303298
22896,0.002232,74.125.68.0-255,1484,148836,92,303298
22897,0.004161,74.125.68.0-255,4320,153156,92,303298
22898,0.004167,172.31.47.0-255,66,153222,92,303298
22899,0.006384,74.125.68.0-255,4320,157542,92,303298
22900,0.006389,172.31.47.0-255,66,157608,92,303298
22901,0.006417,74.125.68.0-255,1484,159092,92,303298
22902,0.008607,74.125.68.0-255,4320,163412,92,303298
22903,0.008612,172.31.47.0-255,66,163478,92,303298
22904,0.010834,74.125.68.0-255,5738,169216,92,303298
22905,0.01084,172.31.47.0-255,66,169282,92,303298
22906,0.013059,74.125.68.0-255,5738,175020,92,303298
22907,0.013067,172.31.47.0-255,66,175086,92,303298
22908,0.015291,74.125.68.0-255,5738,180824,92,303298
22909,0.0153,172.31.47.0-255,66,180890,92,303298
22910,0.01754,74.125.68.0-255,5738,186628,92,303298
22911,0.017549,172.31.47.0-255,66,186694,92,303298
22912,0.01978,74.125.68.0-255,5738,192432,92,303298
22913,0.019788,172.31.47.0-255,66,192498,92,303298
22914,0.022011,74.125.68.0-255,5738,198236,92,303298
22915,0.022019,172.31.47.0-255,66,198302,92,303298
22916,0.024237,74.125.68.0-255,4320,202622,92,303298
22917,0.024245,172.31.47.0-255,66,202688,92,303298
22918,0.024277,74.125.68.0-255,1484,204172,92,303298
22919,0.026459,74.125.68.0-255,4320,208492,92,303298
22920,0.026466,172.31.47.0-255,66,208558,92,303298
22921,0.028695,74.125.68.0-255,5738,214296,92,303298
22922,0.028703,172.31.47.0-255,66,214362,92,303298
22923,0.030943,74.125.68.0-255,5738,220100,92,303298
22924,0.030951,172.31.47.0-255,66,220166,92,303298
22925,0.032605,172.31.47.0-255,172,220338,92,303298
22926,0.032653,172.31.47.0-255,1112,221450,92,303298
22927,0.03274,172.31.47.0-255,1514,222964,92,303298
22928,0.032742,172.31.47.0-255,1514,224478,92,303298
22929,0.032743,172.31.47.0-255,1514,225992,92,303298
22930,0.032744,172.31.47.0-255,1514,227506,92,303298
22931,0.032745,172.31.47.0-255,1494,229000,92,303298
22932,0.033161,74.125.68.0-255,5738,234738,92,303298
22933,0.033169,172.31.47.0-255,66,234804,92,303298
22934,0.034136,104.244.42.0-255,66,234870,92,303298
22935,0.034217,104.244.42.0-255,66,234936,92,303298
22936,0.034364,104.244.42.0-255,66,235002,92,303298
22937,0.035381,74.125.68.0-255,4320,239322,92,303298
22938,0.035386,172.31.47.0-255,66,239388,92,303298
22939,0.035415,74.125.68.0-255,1484,240872,92,303298
22940,0.037613,74.125.68.0-255,4320,245192,92,303298
22941,0.037623,172.31.47.0-255,66,245258,92,303298
22942,0.039848,74.125.68.0-255,5738,250996,92,303298
22943,0.039855,172.31.47.0-255,66,251062,92,303298
22944,0.042078,74.125.68.0-255,5738,256800,92,303298
22945,0.042085,172.31.47.0-255,66,256866,92,303298
22946,0.044306,74.125.68.0-255,5738,262604,92,303298
22947,0.044314,172.31.47.0-255,66,262670,92,303298
22948,0.046531,74.125.68.0-255,5738,268408,92,303298
22949,0.046536,172.31.47.0-255,66,268474,92,303298
22950,0.048757,74.125.68.0-255,5738,274212,92,303298
22951,0.048764,172.31.47.0-255,66,274278,92,303298
22952,0.051027,74.125.68.0-255,5738,280016,92,303298
22953,0.051034,172.31.47.0-255,66,280082,92,303298
22954,0.053267,74.125.68.0-255,5738,285820,92,303298
22955,0.053276,172.31.47.0-255,66,285886,92,303298
22956,0.055507,74.125.68.0-255,5738,291624,92,303298
22957,0.055513,172.31.47.0-255,66,291690,92,303298
22958,0.057736,74.125.68.0-255,5738,297428,92,303298
22959,0.057742,172.31.47.0-255,66,297494,92,303298
22960,0.059956,74.125.68.0-255,5738,303232,92,303298
22961,0.059963,172.31.47.0-255,66,303298,92,303298
22962,0.0,74.125.24.0-255,153,153,92,289727
22963,3.7e-05,172.31.47.0-255,66,219,92,289727
22964,4.4e-05,74.125.24.0-255,1484,1703,92,289727
22965,4.8e-05,172.31.47.0-255,66,1769,92,289727
22966,5.3e-05,74.125.24.0-255,2902,4671,92,289727
22967,5.5e-05,172.31.47.0-255,66,4737,92,289727
22968,6.8e-05,74.125.24.0-255,4320,9057,92,289727
22969,7.1e-05,172.31.47.0-255,66,9123,92,289727
22970,7.8e-05,74.125.24.0-255,7156,16279,92,289727
22971,8.1e-05,172.31.47.0-255,66,16345,92,289727
22972,0.000109,74.125.24.0-255,4853,21198,92,289727
22973,0.000112,172.31.47.0-255,66,21264,92,289727
22974,0.00013,172.31.47.0-255,66,21330,92,289727
22975,0.000155,74.125.24.0-255,1484,22814,92,289727
22976,0.000158,172.31.47.0-255,66,22880,92,289727
22977,0.000168,74.125.24.0-255,2902,25782,92,289727
22978,0.00017,172.31.47.0-255,66,25848,92,289727
22979,0.000178,74.125.24.0-255,5738,31586,92,289727
22980,0.000181,172.31.47.0-255,66,31652,92,289727
22981,0.000211,74.125.24.0-255,6797,38449,92,289727
22982,0.000215,172.31.47.0-255,66,38515,92,289727
22983,0.000236,172.31.47.0-255,66,38581,92,289727
22984,0.00024,74.125.24.0-255,2816,41397,92,289727
22985,0.000243,172.31.47.0-255,66,41463,92,289727
22986,0.000291,74.125.24.0-255,134,41597,92,289727
22987,0.000295,172.31.47.0-255,66,41663,92,289727
22988,0.000298,74.125.24.0-255,348,42011,92,289727
22989,0.000301,172.31.47.0-255,66,42077,92,289727
22990,0.000598,74.125.24.0-255,1484,43561,92,289727
22991,0.000603,172.31.47.0-255,66,43627,92,289727
22992,0.000609,74.125.24.0-255,2902,46529,92,289727
22993,0.000612,172.31.47.0-255,66,46595,92,289727
22994,0.000617,74.125.24.0-255,4320,50915,92,289727
22995,0.000626,172.31.47.0-255,66,50981,92,289727
22996,0.000657,74.125.24.0-255,1484,52465,92,289727
22997,0.000673,172.31.47.0-255,66,52531,92,289727
22998,0.00068,74.125.24.0-255,7156,59687,92,289727
22999,0.000683,172.31.47.0-255,66,59753,92,289727
23000,0.000693,74.125.24.0-255,3602,63355,92,289727
23001,0.000696,172.31.47.0-255,66,63421,92,289727
23002,0.001567,74.125.24.0-255,1484,64905,92,289727
23003,0.001578,74.125.24.0-255,2902,67807,92,289727
23004,0.001583,172.31.47.0-255,66,67873,92,289727
23005,0.001591,74.125.24.0-255,5738,73611,92,289727
23006,0.001593,172.31.47.0-255,66,73677,92,289727
23007,0.001613,172.31.47.0-255,66,73743,92,289727
23008,0.001634,74.125.24.0-255,4320,78063,92,289727
23009,0.001637,172.31.47.0-255,66,78129,92,289727
23010,0.001646,74.125.24.0-255,1484,79613,92,289727
23011,0.001649,74.125.24.0-255,1484,81097,92,289727
23012,0.001651,172.31.47.0-255,66,81163,92,289727
23013,0.001689,172.31.47.0-255,66,81229,92,289727
23014,0.00176,74.125.24.0-255,1484,82713,92,289727
23015,0.001764,74.125.24.0-255,1484,84197,92,289727
23016,0.001771,172.31.47.0-255,66,84263,92,289727
23017,0.001775,74.125.24.0-255,1484,85747,92,289727
23018,0.00178,74.125.24.0-255,5738,91485,92,289727
23019,0.001782,172.31.47.0-255,66,91551,92,289727
23020,0.001806,74.125.24.0-255,5738,97289,92,289727
23021,0.001808,172.31.47.0-255,66,97355,92,289727
23022,0.001835,74.125.24.0-255,7156,104511,92,289727
23023,0.001838,172.31.47.0-255,66,104577,92,289727
23024,0.001843,74.125.24.0-255,5738,110315,92,289727
23025,0.001845,172.31.47.0-255,66,110381,92,289727
23026,0.001863,74.125.24.0-255,2902,113283,92,289727
23027,0.001865,172.31.47.0-255,66,113349,92,289727
23028,0.001903,172.31.47.0-255,66,113415,92,289727
23029,0.001911,172.31.47.0-255,66,113481,92,289727
23030,0.001913,74.125.24.0-255,1484,114965,92,289727
23031,0.001939,172.31.47.0-255,66,115031,92,289727
23032,0.001944,74.125.24.0-255,4320,119351,92,289727
23033,0.001945,172.31.47.0-255,66,119417,92,289727
23034,0.001965,74.125.24.0-255,5738,125155,92,289727
23035,0.001968,172.31.47.0-255,66,125221,92,289727
23036,0.001973,74.125.24.0-255,7156,132377,92,289727
23037,0.001975,172.31.47.0-255,66,132443,92,289727
23038,0.002014,172.31.47.0-255,66,132509,92,289727
23039,0.002017,74.125.24.0-255,2184,134693,92,289727
23040,0.002019,172.31.47.0-255,66,134759,92,289727
23041,0.002291,74.125.24.0-255,1484,136243,92,289727
23042,0.002295,74.125.24.0-255,1484,137727,92,289727
23043,0.002297,172.31.47.0-255,66,137793,92,289727
23044,0.002322,74.125.24.0-255,1484,139277,92,289727
23045,0.002327,74.125.24.0-255,5738,145015,92,289727
23046,0.002365,172.31.47.0-255,66,145081,92,289727
23047,0.002367,74.125.24.0-255,1484,146565,92,289727
23048,0.004641,74.125.24.0-255,4320,150885,92,289727
23049,0.004646,172.31.47.0-255,66,150951,92,289727
23050,0.00693,74.125.24.0-255,5738,156689,92,289727
23051,0.006937,172.31.47.0-255,66,156755,92,289727
23052,0.009214,74.125.24.0-255,5738,162493,92,289727
23053,0.009222,172.31.47.0-255,66,162559,92,289727
23054,0.011497,74.125.24.0-255,5738,168297,92,289727
23055,0.011504,172.31.47.0-255,66,168363,92,289727
23056,0.013776,74.125.24.0-255,5738,174101,92,289727
23057,0.013786,172.31.47.0-255,66,174167,92,289727
23058,0.016091,74.125.24.0-255,5738,179905,92,289727
23059,0.016098,172.31.47.0-255,66,179971,92,289727
23060,0.018385,74.125.24.0-255,5738,185709,92,289727
23061,0.018391,172.31.47.0-255,66,185775,92,289727
23062,0.020661,74.125.24.0-255,5738,191513,92,289727
23063,0.020666,172.31.47.0-255,66,191579,92,289727
23064,0.022988,74.125.24.0-255,5738,197317,92,289727
23065,0.022995,172.31.47.0-255,66,197383,92,289727
23066,0.02529,74.125.24.0-255,5738,203121,92,289727
23067,0.025298,172.31.47.0-255,66,203187,92,289727
23068,0.027581,74.125.24.0-255,5738,208925,92,289727
23069,0.027588,172.31.47.0-255,66,208991,92,289727
23070,0.027674,172.31.47.0-255,172,209163,92,289727
23071,0.027724,172.31.47.0-255,1112,210275,92,289727
23072,0.027785,172.31.47.0-255,570,210845,92,289727
23073,0.029235,104.244.42.0-255,66,210911,92,289727
23074,0.029275,104.244.42.0-255,66,210977,92,289727
23075,0.029327,104.244.42.0-255,66,211043,92,289727
23076,0.029869,74.125.24.0-255,4320,215363,92,289727
23077,0.029873,172.31.47.0-255,66,215429,92,289727
23078,0.0299,74.125.24.0-255,1484,216913,92,289727
23079,0.032144,74.125.24.0-255,4320,221233,92,289727
23080,0.032154,172.31.47.0-255,66,221299,92,289727
23081,0.034433,74.125.24.0-255,5738,227037,92,289727
23082,0.034443,172.31.47.0-255,66,227103,92,289727
23083,0.036737,74.125.24.0-255,5738,232841,92,289727
23084,0.036741,172.31.47.0-255,66,232907,92,289727
23085,0.039046,74.125.24.0-255,5738,238645,92,289727
23086,0.039051,172.31.47.0-255,66,238711,92,289727
23087,0.041307,74.125.24.0-255,5738,244449,92,289727
23088,0.041312,172.31.47.0-255,66,244515,92,289727
23089,0.043592,74.125.24.0-255,4320,248835,92,289727
23090,0.043596,172.31.47.0-255,66,248901,92,289727
23091,0.04362,74.125.24.0-255,1484,250385,92,289727
23092,0.045867,74.125.24.0-255,4320,254705,92,289727
23093,0.045872,172.31.47.0-255,66,254771,92,289727
23094,0.048172,74.125.24.0-255,5738,260509,92,289727
23095,0.048178,172.31.47.0-255,66,260575,92,289727
23096,0.050473,74.125.24.0-255,5738,266313,92,289727
23097,0.050483,172.31.47.0-255,66,266379,92,289727
23098,0.052745,74.125.24.0-255,1484,267863,92,289727
23099,0.052775,74.125.24.0-255,4320,272183,92,289727
23100,0.052779,172.31.47.0-255,66,272249,92,289727
23101,0.055078,74.125.24.0-255,5738,277987,92,289727
23102,0.055084,172.31.47.0-255,66,278053,92,289727
23103,0.057351,74.125.24.0-255,1484,279537,92,289727
23104,0.057377,74.125.24.0-255,4320,283857,92,289727
23105,0.057381,172.31.47.0-255,66,283923,92,289727
23106,0.059712,74.125.24.0-255,5738,289661,92,289727
23107,0.059717,172.31.47.0-255,66,289727,92,289727
23108,0.0,74.125.24.0-255,152,152,92,240805
23109,3.1e-05,172.31.47.0-255,66,218,92,240805
23110,4e-05,74.125.24.0-255,1484,1702,92,240805
23111,4.5e-05,172.31.47.0-255,66,1768,92,240805
23112,5.1e-05,74.125.24.0-255,2902,4670,92,240805
23113,5.4e-05,172.31.47.0-255,66,4736,92,240805
23114,6.2e-05,74.125.24.0-255,7156,11892,92,240805
23115,6.5e-05,172.31.47.0-255,66,11958,92,240805
23116,7e-05,74.125.24.0-255,2161,14119,92,240805
23117,7.3e-05,172.31.47.0-255,66,14185,92,240805
23118,0.000179,74.125.24.0-255,1484,15669,92,240805
23119,0.000184,74.125.24.0-255,2902,18571,92,240805
23120,0.000193,172.31.47.0-255,66,18637,92,240805
23121,0.000197,172.31.47.0-255,66,18703,92,240805
23122,0.000206,74.125.24.0-255,5738,24441,92,240805
23123,0.000208,172.31.47.0-255,66,24507,92,240805
23124,0.000242,74.125.24.0-255,6797,31304,92,240805
23125,0.000245,172.31.47.0-255,66,31370,92,240805
23126,0.000258,172.31.47.0-255,66,31436,92,240805
23127,0.000274,74.125.24.0-255,5738,37174,92,240805
23128,0.000277,172.31.47.0-255,66,37240,92,240805
23129,0.000285,74.125.24.0-255,7156,44396,92,240805
23130,0.000288,172.31.47.0-255,66,44462,92,240805
23131,0.000316,74.125.24.0-255,2902,47364,92,240805
23132,0.000319,172.31.47.0-255,66,47430,92,240805
23133,0.000349,172.31.47.0-255,66,47496,92,240805
23134,0.000352,74.125.24.0-255,131,47627,92,240805
23135,0.000354,172.31.47.0-255,66,47693,92,240805
23136,0.000579,74.125.24.0-255,348,48041,92,240805
23137,0.000584,172.31.47.0-255,66,48107,92,240805
23138,0.001089,74.125.24.0-255,1484,49591,92,240805
23139,0.001107,74.125.24.0-255,2902,52493,92,240805
23140,0.001111,172.31.47.0-255,66,52559,92,240805
23141,0.001117,74.125.24.0-255,2902,55461,92,240805
23142,0.001133,74.125.24.0-255,2902,58363,92,240805
23143,0.001141,74.125.24.0-255,4320,62683,92,240805
23144,0.001155,172.31.47.0-255,66,62749,92,240805
23145,0.001189,74.125.24.0-255,1994,64743,92,240805
23146,0.001202,172.31.47.0-255,66,64809,92,240805
23147,0.001705,74.125.24.0-255,1484,66293,92,240805
23148,0.001718,74.125.24.0-255,2902,69195,92,240805
23149,0.001723,172.31.47.0-255,66,69261,92,240805
23150,0.001733,74.125.24.0-255,5738,74999,92,240805
23151,0.001862,172.31.47.0-255,66,75065,92,240805
23152,0.003969,74.125.24.0-255,5738,80803,92,240805
23153,0.003988,172.31.47.0-255,66,80869,92,240805
23154,0.00604,74.125.24.0-255,5738,86607,92,240805
23155,0.006047,172.31.47.0-255,66,86673,92,240805
23156,0.008119,74.125.24.0-255,5738,92411,92,240805
23157,0.008137,172.31.47.0-255,66,92477,92,240805
23158,0.010233,74.125.24.0-255,5738,98215,92,240805
23159,0.010252,172.31.47.0-255,66,98281,92,240805
23160,0.012309,74.125.24.0-255,5738,104019,92,240805
23161,0.014036,172.31.47.0-255,66,104085,92,240805
23162,0.016145,74.125.24.0-255,5738,109823,92,240805
23163,0.016164,172.31.47.0-255,66,109889,92,240805
23164,0.018219,74.125.24.0-255,5738,115627,92,240805
23165,0.018229,172.31.47.0-255,66,115693,92,240805
23166,0.020297,74.125.24.0-255,5738,121431,92,240805
23167,0.020308,172.31.47.0-255,66,121497,92,240805
23168,0.022393,74.125.24.0-255,5738,127235,92,240805
23169,0.022409,172.31.47.0-255,66,127301,92,240805
23170,0.02448,74.125.24.0-255,5738,133039,92,240805
23171,0.024493,172.31.47.0-255,66,133105,92,240805
23172,0.026586,74.125.24.0-255,5738,138843,92,240805
23173,0.026604,172.31.47.0-255,66,138909,92,240805
23174,0.028666,74.125.24.0-255,5738,144647,92,240805
23175,0.028684,172.31.47.0-255,66,144713,92,240805
23176,0.030769,74.125.24.0-255,5738,150451,92,240805
23177,0.030788,172.31.47.0-255,66,150517,92,240805
23178,0.032843,74.125.24.0-255,5738,156255,92,240805
23179,0.032852,172.31.47.0-255,66,156321,92,240805
23180,0.034312,172.31.47.0-255,172,156493,92,240805
23181,0.034347,172.31.47.0-255,1111,157604,92,240805
23182,0.034417,172.31.47.0-255,1514,159118,92,240805
23183,0.034419,172.31.47.0-255,1514,160632,92,240805
23184,0.03442,172.31.47.0-255,1514,162146,92,240805
23185,0.034421,172.31.47.0-255,1514,163660,92,240805
23186,0.034454,172.31.47.0-255,1495,165155,92,240805
23187,0.034905,74.125.24.0-255,5738,170893,92,240805
23188,0.034912,172.31.47.0-255,66,170959,92,240805
23189,0.035865,104.244.42.0-255,66,171025,92,240805
23190,0.035935,104.244.42.0-255,66,171091,92,240805
23191,0.036082,104.244.42.0-255,66,171157,92,240805
23192,0.036958,74.125.24.0-255,5738,176895,92,240805
23193,0.036964,172.31.47.0-255,66,176961,92,240805
23194,0.039056,74.125.24.0-255,5738,182699,92,240805
23195,0.039063,172.31.47.0-255,66,182765,92,240805
23196,0.041136,74.125.24.0-255,5738,188503,92,240805
23197,0.041143,172.31.47.0-255,66,188569,92,240805
23198,0.043234,74.125.24.0-255,5738,194307,92,240805
23199,0.043243,172.31.47.0-255,66,194373,92,240805
23200,0.04531,74.125.24.0-255,5738,200111,92,240805
23201,0.045318,172.31.47.0-255,66,200177,92,240805
23202,0.047389,74.125.24.0-255,5738,205915,92,240805
23203,0.047396,172.31.47.0-255,66,205981,92,240805
23204,0.049454,74.125.24.0-255,5738,211719,92,240805
23205,0.049461,172.31.47.0-255,66,211785,92,240805
23206,0.051522,74.125.24.0-255,5738,217523,92,240805
23207,0.051529,172.31.47.0-255,66,217589,92,240805
23208,0.053573,74.125.24.0-255,5738,223327,92,240805
23209,0.05358,172.31.47.0-255,66,223393,92,240805
23210,0.055645,74.125.24.0-255,5738,229131,92,240805
23211,0.055659,172.31.47.0-255,66,229197,92,240805
23212,0.057716,74.125.24.0-255,5738,234935,92,240805
23213,0.057728,172.31.47.0-255,66,235001,92,240805
23214,0.059817,74.125.24.0-255,5738,240739,92,240805
23215,0.059827,172.31.47.0-255,66,240805,92,240805
23216,0.0,172.31.47.0-255,105,105,92,276
23217,0.001776,157.240.13.0-255,105,210,92,276
23218,0.001788,172.31.47.0-255,66,276,92,276
23219,0.0,74.125.68.0-255,153,153,92,281358
23220,1.7e-05,172.31.47.0-255,66,219,92,281358
23221,2.3e-05,74.125.68.0-255,1484,1703,92,281358
23222,2.7e-05,172.31.47.0-255,66,1769,92,281358
23223,7.1e-05,74.125.68.0-255,2902,4671,92,281358
23224,7.6e-05,172.31.47.0-255,66,4737,92,281358
23225,7.9e-05,74.125.68.0-255,1484,6221,92,281358
23226,8.1e-05,172.31.47.0-255,66,6287,92,281358
23227,8.6e-05,74.125.68.0-255,2902,9189,92,281358
23228,8.9e-05,172.31.47.0-255,66,9255,92,281358
23229,0.000117,74.125.68.0-255,4891,14146,92,281358
23230,0.000123,172.31.47.0-255,66,14212,92,281358
23231,0.000222,74.125.68.0-255,1484,15696,92,281358
23232,0.000226,172.31.47.0-255,66,15762,92,281358
23233,0.000232,74.125.68.0-255,2902,18664,92,281358
23234,0.000233,172.31.47.0-255,66,18730,92,281358
23235,0.00024,74.125.68.0-255,5738,24468,92,281358
23236,0.000249,172.31.47.0-255,66,24534,92,281358
23237,0.000254,74.125.68.0-255,4320,28854,92,281358
23238,0.000256,172.31.47.0-255,66,28920,92,281358
23239,0.000289,74.125.68.0-255,5379,34299,92,281358
23240,0.000293,172.31.47.0-255,66,34365,92,281358
23241,0.000333,172.31.47.0-255,66,34431,92,281358
23242,0.00034,74.125.68.0-255,7156,41587,92,281358
23243,0.000342,172.31.47.0-255,66,41653,92,281358
23244,0.000362,74.125.68.0-255,2902,44555,92,281358
23245,0.000364,172.31.47.0-255,66,44621,92,281358
23246,0.000374,172.31.47.0-255,66,44687,92,281358
23247,0.000405,74.125.68.0-255,2563,47250,92,281358
23248,0.000407,172.31.47.0-255,66,47316,92,281358
23249,0.000836,74.125.68.0-255,329,47645,92,281358
23250,0.001088,74.125.68.0-255,1484,49129,92,281358
23251,0.001095,172.31.47.0-255,66,49195,92,281358
23252,0.0011,74.125.68.0-255,2902,52097,92,281358
23253,0.001102,172.31.47.0-255,66,52163,92,281358
23254,0.001107,74.125.68.0-255,2902,55065,92,281358
23255,0.001114,172.31.47.0-255,66,55131,92,281358
23256,0.001118,74.125.68.0-255,2902,58033,92,281358
23257,0.00112,172.31.47.0-255,66,58099,92,281358
23258,0.001149,74.125.68.0-255,1484,59583,92,281358
23259,0.00116,172.31.47.0-255,66,59649,92,281358
23260,0.001167,74.125.68.0-255,5738,65387,92,281358
23261,0.001169,172.31.47.0-255,66,65453,92,281358
23262,0.001184,74.125.68.0-255,4320,69773,92,281358
23263,0.001186,172.31.47.0-255,66,69839,92,281358
23264,0.001218,74.125.68.0-255,2902,72741,92,281358
23265,0.001221,172.31.47.0-255,66,72807,92,281358
23266,0.001224,74.125.68.0-255,766,73573,92,281358
23267,0.001457,74.125.68.0-255,1484,75057,92,281358
23268,0.001461,172.31.47.0-255,66,75123,92,281358
23269,0.00148,74.125.68.0-255,2902,78025,92,281358
23270,0.001482,172.31.47.0-255,66,78091,92,281358
23271,0.001485,74.125.68.0-255,1484,79575,92,281358
23272,0.001512,74.125.68.0-255,4320,83895,92,281358
23273,0.001514,172.31.47.0-255,66,83961,92,281358
23274,0.001521,74.125.68.0-255,6248,90209,92,281358
23275,0.001523,172.31.47.0-255,66,90275,92,281358
23276,0.00161,74.125.68.0-255,1484,91759,92,281358
23277,0.001627,74.125.68.0-255,1484,93243,92,281358
23278,0.001629,172.31.47.0-255,66,93309,92,281358
23279,0.001651,74.125.68.0-255,1484,94793,92,281358
23280,0.001657,74.125.68.0-255,5738,100531,92,281358
23281,0.001659,172.31.47.0-255,66,100597,92,281358
23282,0.001663,74.125.68.0-255,2902,103499,92,281358
23283,0.001665,172.31.47.0-255,66,103565,92,281358
23284,0.001693,74.125.68.0-255,5738,109303,92,281358
23285,0.001695,172.31.47.0-255,66,109369,92,281358
23286,0.001706,172.31.47.0-255,66,109435,92,281358
23287,0.001713,74.125.68.0-255,1484,110919,92,281358
23288,0.001734,74.125.68.0-255,3602,114521,92,281358
23289,0.001736,172.31.47.0-255,66,114587,92,281358
23290,0.001758,74.125.68.0-255,1484,116071,92,281358
23291,0.00177,74.125.68.0-255,2902,118973,92,281358
23292,0.001772,172.31.47.0-255,66,119039,92,281358
23293,0.001794,74.125.68.0-255,2902,121941,92,281358
23294,0.001796,172.31.47.0-255,66,122007,92,281358
23295,0.001813,74.125.68.0-255,2902,124909,92,281358
23296,0.001815,172.31.47.0-255,66,124975,92,281358
23297,0.001822,74.125.68.0-255,7156,132131,92,281358
23298,0.001824,172.31.47.0-255,66,132197,92,281358
23299,0.001827,74.125.68.0-255,1484,133681,92,281358
23300,0.001861,74.125.68.0-255,7156,140837,92,281358
23301,0.001864,172.31.47.0-255,66,140903,92,281358
23302,0.00191,74.125.68.0-255,7156,148059,92,281358
23303,0.001913,172.31.47.0-255,66,148125,92,281358
23304,0.001936,74.125.68.0-255,766,148891,92,281358
23305,0.002151,74.125.68.0-255,1484,150375,92,281358
23306,0.002154,172.31.47.0-255,66,150441,92,281358
23307,0.002176,74.125.68.0-255,1484,151925,92,281358
23308,0.00218,74.125.68.0-255,2902,154827,92,281358
23309,0.002182,172.31.47.0-255,66,154893,92,281358
23310,0.002213,74.125.68.0-255,5738,160631,92,281358
23311,0.002215,172.31.47.0-255,66,160697,92,281358
23312,0.002219,74.125.68.0-255,2902,163599,92,281358
23313,0.002221,172.31.47.0-255,66,163665,92,281358
23314,0.002255,74.125.68.0-255,5738,169403,92,281358
23315,0.002257,172.31.47.0-255,66,169469,92,281358
23316,0.002268,172.31.47.0-255,66,169535,92,281358
23317,0.002277,74.125.68.0-255,3602,173137,92,281358
23318,0.002279,172.31.47.0-255,66,173203,92,281358
23319,0.002361,74.125.68.0-255,1484,174687,92,281358
23320,0.002372,74.125.68.0-255,2902,177589,92,281358
23321,0.002374,172.31.47.0-255,66,177655,92,281358
23322,0.002399,74.125.68.0-255,5738,183393,92,281358
23323,0.002401,172.31.47.0-255,66,183459,92,281358
23324,0.002427,74.125.68.0-255,4320,187779,92,281358
23325,0.002429,172.31.47.0-255,66,187845,92,281358
23326,0.002457,74.125.68.0-255,5738,193583,92,281358
23327,0.00246,172.31.47.0-255,66,193649,92,281358
23328,0.002469,172.31.47.0-255,66,193715,92,281358
23329,0.0025,74.125.68.0-255,2902,196617,92,281358
23330,0.002503,172.31.47.0-255,66,196683,92,281358
23331,0.002508,74.125.68.0-255,2184,198867,92,281358
23332,0.00251,172.31.47.0-255,66,198933,92,281358
23333,0.002946,74.125.68.0-255,1484,200417,92,281358
23334,0.002964,74.125.68.0-255,2902,203319,92,281358
23335,0.002968,172.31.47.0-255,66,203385,92,281358
23336,0.002971,74.125.68.0-255,1484,204869,92,281358
23337,0.002991,74.125.68.0-255,2902,207771,92,281358
23338,0.002995,172.31.47.0-255,66,207837,92,281358
23339,0.003001,74.125.68.0-255,5738,213575,92,281358
23340,0.003003,172.31.47.0-255,66,213641,92,281358
23341,0.003041,74.125.68.0-255,2902,216543,92,281358
23342,0.003044,172.31.47.0-255,66,216609,92,281358
23343,0.003079,172.31.47.0-255,66,216675,92,281358
23344,0.003084,74.125.68.0-255,2902,219577,92,281358
23345,0.003086,172.31.47.0-255,66,219643,92,281358
23346,0.003125,74.125.68.0-255,1484,221127,92,281358
23347,0.003128,172.31.47.0-255,66,221193,92,281358
23348,0.003151,172.31.47.0-255,66,221259,92,281358
23349,0.003154,74.125.68.0-255,1484,222743,92,281358
23350,0.003181,172.31.47.0-255,66,222809,92,281358
23351,0.003185,74.125.68.0-255,2184,224993,92,281358
23352,0.003187,172.31.47.0-255,66,225059,92,281358
23353,0.003276,74.125.68.0-255,1484,226543,92,281358
23354,0.003291,74.125.68.0-255,2902,229445,92,281358
23355,0.003294,172.31.47.0-255,66,229511,92,281358
23356,0.003329,74.125.68.0-255,2902,232413,92,281358
23357,0.003332,172.31.47.0-255,66,232479,92,281358
23358,0.00336,74.125.68.0-255,2902,235381,92,281358
23359,0.003364,172.31.47.0-255,66,235447,92,281358
23360,0.003381,172.31.47.0-255,66,235513,92,281358
23361,0.003386,74.125.68.0-255,2902,238415,92,281358
23362,0.003389,172.31.47.0-255,66,238481,92,281358
23363,0.00343,172.31.47.0-255,66,238547,92,281358
23364,0.003435,74.125.68.0-255,2184,240731,92,281358
23365,0.003438,74.125.68.0-255,2902,243633,92,281358
23366,0.003439,172.31.47.0-255,66,243699,92,281358
23367,0.003442,74.125.68.0-255,2902,246601,92,281358
23368,0.003442,172.31.47.0-255,66,246667,92,281358
23369,0.003445,172.31.47.0-255,66,246733,92,281358
23370,0.003484,74.125.68.0-255,4320,251053,92,281358
23371,0.003488,172.31.47.0-255,66,251119,92,281358
23372,0.003493,74.125.68.0-255,4320,255439,92,281358
23373,0.003495,172.31.47.0-255,66,255505,92,281358
23374,0.003507,74.125.68.0-255,5738,261243,92,281358
23375,0.00351,172.31.47.0-255,66,261309,92,281358
23376,0.00352,172.31.47.0-255,66,261375,92,281358
23377,0.003587,74.125.68.0-255,6438,267813,92,281358
23378,0.003591,172.31.47.0-255,66,267879,92,281358
23379,0.003597,74.125.68.0-255,7156,275035,92,281358
23380,0.0036,172.31.47.0-255,66,275101,92,281358
23381,0.003621,172.31.47.0-255,66,275167,92,281358
23382,0.00366,74.125.68.0-255,1484,276651,92,281358
23383,0.003665,172.31.47.0-255,66,276717,92,281358
23384,0.003673,74.125.68.0-255,1484,278201,92,281358
23385,0.003676,74.125.68.0-255,698,278899,92,281358
23386,0.00369,172.31.47.0-255,66,278965,92,281358
23387,0.003741,74.125.68.0-255,105,279070,92,281358
23388,0.009709,172.31.47.0-255,66,279136,92,281358
23389,0.009736,172.31.47.0-255,105,279241,92,281358
23390,0.01227,74.125.68.0-255,66,279307,92,281358
23391,0.036912,172.31.47.0-255,172,279479,92,281358
23392,0.036938,172.31.47.0-255,1107,280586,92,281358
23393,0.036967,172.31.47.0-255,574,281160,92,281358
23394,0.038435,104.244.42.0-255,66,281226,92,281358
23395,0.038472,104.244.42.0-255,66,281292,92,281358
23396,0.038514,104.244.42.0-255,66,281358,92,281358
23397,0.0,172.31.47.0-255,66,66,92,66
23398,0.0,172.31.47.0-255,105,105,92,105
23399,0.0,172.31.47.0-255,105,105,92,105
23400,0.0,172.217.194.0-255,153,153,92,231418
23401,3.2e-05,172.31.47.0-255,66,219,92,231418
23402,4e-05,172.217.194.0-255,1484,1703,92,231418
23403,4.4e-05,172.31.47.0-255,66,1769,92,231418
23404,4.9e-05,172.217.194.0-255,2902,4671,92,231418
23405,5.1e-05,172.31.47.0-255,66,4737,92,231418
23406,5.7e-05,172.217.194.0-255,7156,11893,92,231418
23407,6e-05,172.31.47.0-255,66,11959,92,231418
23408,6.3e-05,172.217.194.0-255,2215,14174,92,231418
23409,6.6e-05,172.31.47.0-255,66,14240,92,231418
23410,0.000165,172.217.194.0-255,1484,15724,92,231418
23411,0.000169,172.31.47.0-255,66,15790,92,231418
23412,0.000175,172.217.194.0-255,2902,18692,92,231418
23413,0.000177,172.31.47.0-255,66,18758,92,231418
23414,0.000185,172.217.194.0-255,5738,24496,92,231418
23415,0.000187,172.31.47.0-255,66,24562,92,231418
23416,0.000245,172.217.194.0-255,6797,31359,92,231418
23417,0.000249,172.31.47.0-255,66,31425,92,231418
23418,0.0003,172.217.194.0-255,1484,32909,92,231418
23419,0.000304,172.31.47.0-255,66,32975,92,231418
23420,0.000309,172.217.194.0-255,2902,35877,92,231418
23421,0.000311,172.31.47.0-255,66,35943,92,231418
23422,0.000332,172.217.194.0-255,5738,41681,92,231418
23423,0.000336,172.31.47.0-255,66,41747,92,231418
23424,0.000372,172.31.47.0-255,66,41813,92,231418
23425,0.000397,172.217.194.0-255,5379,47192,92,231418
23426,0.0004,172.31.47.0-255,66,47258,92,231418
23427,0.000411,172.31.47.0-255,66,47324,92,231418
23428,0.000564,172.217.194.0-255,364,47688,92,231418
23429,0.000568,172.31.47.0-255,66,47754,92,231418
23430,0.001929,172.217.194.0-255,1484,49238,92,231418
23431,0.00194,172.217.194.0-255,2902,52140,92,231418
23432,0.001944,172.31.47.0-255,66,52206,92,231418
23433,0.001952,172.217.194.0-255,5738,57944,92,231418
23434,0.001954,172.31.47.0-255,66,58010,92,231418
23435,0.001987,172.31.47.0-255,66,58076,92,231418
23436,0.002014,172.31.47.0-255,66,58142,92,231418
23437,0.002032,172.217.194.0-255,2902,61044,92,231418
23438,0.002034,172.31.47.0-255,66,61110,92,231418
23439,0.002045,172.217.194.0-255,2184,63294,92,231418
23440,0.002047,172.31.47.0-255,66,63360,92,231418
23441,0.002249,172.217.194.0-255,1484,64844,92,231418
23442,0.00229,172.217.194.0-255,2902,67746,92,231418
23443,0.002293,172.31.47.0-255,66,67812,92,231418
23444,0.002298,172.217.194.0-255,5738,73550,92,231418
23445,0.0023,172.31.47.0-255,66,73616,92,231418
23446,0.002306,172.217.194.0-255,5738,79354,92,231418
23447,0.002308,172.31.47.0-255,66,79420,92,231418
23448,0.00456,172.217.194.0-255,5738,85158,92,231418
23449,0.004565,172.31.47.0-255,66,85224,92,231418
23450,0.006831,172.217.194.0-255,5738,90962,92,231418
23451,0.006836,172.31.47.0-255,66,91028,92,231418
23452,0.0091,172.217.194.0-255,5738,96766,92,231418
23453,0.009105,172.31.47.0-255,66,96832,92,231418
23454,0.011347,172.217.194.0-255,5738,102570,92,231418
23455,0.011354,172.31.47.0-255,66,102636,92,231418
23456,0.013645,172.217.194.0-255,5738,108374,92,231418
23457,0.013659,172.31.47.0-255,66,108440,92,231418
23458,0.015934,172.217.194.0-255,5738,114178,92,231418
23459,0.015942,172.31.47.0-255,66,114244,92,231418
23460,0.018207,172.217.194.0-255,5738,119982,92,231418
23461,0.018219,172.31.47.0-255,66,120048,92,231418
23462,0.020453,172.217.194.0-255,5738,125786,92,231418
23463,0.02046,172.31.47.0-255,66,125852,92,231418
23464,0.022697,172.217.194.0-255,5738,131590,92,231418
23465,0.022703,172.31.47.0-255,66,131656,92,231418
23466,0.024918,172.217.194.0-255,5738,137394,92,231418
23467,0.024925,172.31.47.0-255,66,137460,92,231418
23468,0.02627,172.31.47.0-255,172,137632,92,231418
23469,0.026297,172.31.47.0-255,1107,138739,92,231418
23470,0.026332,172.31.47.0-255,1514,140253,92,231418
23471,0.026334,172.31.47.0-255,1514,141767,92,231418
23472,0.026335,172.31.47.0-255,1514,143281,92,231418
23473,0.026336,172.31.47.0-255,1514,144795,92,231418
23474,0.026357,172.31.47.0-255,1499,146294,92,231418
23475,0.027199,172.217.194.0-255,5738,152032,92,231418
23476,0.027205,172.31.47.0-255,66,152098,92,231418
23477,0.027798,104.244.42.0-255,66,152164,92,231418
23478,0.027842,104.244.42.0-255,66,152230,92,231418
23479,0.027896,104.244.42.0-255,66,152296,92,231418
23480,0.028793,104.244.42.0-255,108,152404,92,231418
23481,0.028798,172.31.47.0-255,66,152470,92,231418
23482,0.02945,172.217.194.0-255,2902,155372,92,231418
23483,0.029454,172.31.47.0-255,66,155438,92,231418
23484,0.029484,172.217.194.0-255,2902,158340,92,231418
23485,0.029486,172.31.47.0-255,66,158406,92,231418
23486,0.031693,172.217.194.0-255,2902,161308,92,231418
23487,0.031698,172.31.47.0-255,66,161374,92,231418
23488,0.031725,172.217.194.0-255,2902,164276,92,231418
23489,0.031728,172.31.47.0-255,66,164342,92,231418
23490,0.033938,172.217.194.0-255,2902,167244,92,231418
23491,0.033942,172.31.47.0-255,66,167310,92,231418
23492,0.033971,172.217.194.0-255,2902,170212,92,231418
23493,0.033974,172.31.47.0-255,66,170278,92,231418
23494,0.036179,172.217.194.0-255,4320,174598,92,231418
23495,0.036184,172.31.47.0-255,66,174664,92,231418
23496,0.036209,172.217.194.0-255,1484,176148,92,231418
23497,0.038442,172.217.194.0-255,4320,180468,92,231418
23498,0.038447,172.31.47.0-255,66,180534,92,231418
23499,0.040702,172.217.194.0-255,5738,186272,92,231418
23500,0.040709,172.31.47.0-255,66,186338,92,231418
23501,0.042939,172.217.194.0-255,5738,192076,92,231418
23502,0.042944,172.31.47.0-255,66,192142,92,231418
23503,0.045197,172.217.194.0-255,5738,197880,92,231418
23504,0.045203,172.31.47.0-255,66,197946,92,231418
23505,0.047463,172.217.194.0-255,4320,202266,92,231418
23506,0.047468,172.31.47.0-255,66,202332,92,231418
23507,0.047497,172.217.194.0-255,1484,203816,92,231418
23508,0.049724,172.217.194.0-255,4320,208136,92,231418
23509,0.049728,172.31.47.0-255,66,208202,92,231418
23510,0.051974,172.217.194.0-255,5738,213940,92,231418
23511,0.051984,172.31.47.0-255,66,214006,92,231418
23512,0.05429,172.217.194.0-255,5738,219744,92,231418
23513,0.054295,172.31.47.0-255,66,219810,92,231418
23514,0.056523,172.217.194.0-255,5738,225548,92,231418
23515,0.056537,172.31.47.0-255,66,225614,92,231418
23516,0.058776,172.217.194.0-255,5738,231352,92,231418
23517,0.058786,172.31.47.0-255,66,231418,92,231418
23518,0.0,172.217.194.0-255,153,153,92,252980
23519,2.6e-05,172.31.47.0-255,66,219,92,252980
23520,3e-05,172.217.194.0-255,1484,1703,92,252980
23521,3.4e-05,172.31.47.0-255,66,1769,92,252980
23522,3.9e-05,172.217.194.0-255,2902,4671,92,252980
23523,4.7e-05,172.31.47.0-255,66,4737,92,252980
23524,5.7e-05,172.217.194.0-255,2902,7639,92,252980
23525,5.9e-05,172.31.47.0-255,66,7705,92,252980
23526,8.7e-05,172.217.194.0-255,4320,12025,92,252980
23527,8.9e-05,172.31.47.0-255,66,12091,92,252980
23528,9.6e-05,172.217.194.0-255,1484,13575,92,252980
23529,9.9e-05,172.31.47.0-255,66,13641,92,252980
23530,0.000138,172.31.47.0-255,66,13707,92,252980
23531,0.00015,172.31.47.0-255,66,13773,92,252980
23532,0.000186,172.31.47.0-255,66,13839,92,252980
23533,0.000215,172.217.194.0-255,2184,16023,92,252980
23534,0.000217,172.31.47.0-255,66,16089,92,252980
23535,0.00022,172.217.194.0-255,1484,17573,92,252980
23536,0.000223,172.31.47.0-255,66,17639,92,252980
23537,0.000228,172.217.194.0-255,2902,20541,92,252980
23538,0.000235,172.31.47.0-255,66,20607,92,252980
23539,0.000239,172.217.194.0-255,4320,24927,92,252980
23540,0.000242,172.31.47.0-255,66,24993,92,252980
23541,0.000275,172.217.194.0-255,1484,26477,92,252980
23542,0.000277,172.31.47.0-255,66,26543,92,252980
23543,0.000284,172.217.194.0-255,6797,33340,92,252980
23544,0.000287,172.31.47.0-255,66,33406,92,252980
23545,0.000321,172.217.194.0-255,1484,34890,92,252980
23546,0.000324,172.31.47.0-255,66,34956,92,252980
23547,0.000338,172.217.194.0-255,2902,37858,92,252980
23548,0.00034,172.31.47.0-255,66,37924,92,252980
23549,0.000352,172.217.194.0-255,5738,43662,92,252980
23550,0.000354,172.31.47.0-255,66,43728,92,252980
23551,0.000363,172.217.194.0-255,1484,45212,92,252980
23552,0.000394,172.217.194.0-255,5958,51170,92,252980
23553,0.000398,172.31.47.0-255,66,51236,92,252980
23554,0.000408,172.31.47.0-255,66,51302,92,252980
23555,0.000454,172.31.47.0-255,66,51368,92,252980
23556,0.000922,172.217.194.0-255,1484,52852,92,252980
23557,0.000928,172.217.194.0-255,2902,55754,92,252980
23558,0.000931,172.31.47.0-255,66,55820,92,252980
23559,0.000959,172.217.194.0-255,5738,61558,92,252980
23560,0.000962,172.31.47.0-255,66,61624,92,252980
23561,0.000965,172.217.194.0-255,1484,63108,92,252980
23562,0.000997,172.31.47.0-255,66,63174,92,252980
23563,0.001003,172.217.194.0-255,7156,70330,92,252980
23564,0.001005,172.31.47.0-255,66,70396,92,252980
23565,0.001037,172.217.194.0-255,3602,73998,92,252980
23566,0.001044,172.31.47.0-255,66,74064,92,252980
23567,0.001148,172.217.194.0-255,1484,75548,92,252980
23568,0.001153,172.217.194.0-255,2902,78450,92,252980
23569,0.001155,172.31.47.0-255,66,78516,92,252980
23570,0.001207,172.217.194.0-255,5738,84254,92,252980
23571,0.001211,172.31.47.0-255,66,84320,92,252980
23572,0.001223,172.31.47.0-255,66,84386,92,252980
23573,0.001237,172.31.47.0-255,66,84452,92,252980
23574,0.001239,172.217.194.0-255,766,85218,92,252980
23575,0.001412,172.31.47.0-255,66,85284,92,252980
23576,0.003283,172.217.194.0-255,4320,89604,92,252980
23577,0.003288,172.31.47.0-255,66,89670,92,252980
23578,0.003451,172.217.194.0-255,1484,91154,92,252980
23579,0.005357,172.217.194.0-255,4320,95474,92,252980
23580,0.005364,172.31.47.0-255,66,95540,92,252980
23581,0.007391,172.217.194.0-255,5738,101278,92,252980
23582,0.007399,172.31.47.0-255,66,101344,92,252980
23583,0.009422,172.217.194.0-255,5738,107082,92,252980
23584,0.00943,172.31.47.0-255,66,107148,92,252980
23585,0.011499,172.217.194.0-255,5738,112886,92,252980
23586,0.011504,172.31.47.0-255,66,112952,92,252980
23587,0.013575,172.217.194.0-255,5738,118690,92,252980
23588,0.013584,172.31.47.0-255,66,118756,92,252980
23589,0.015629,172.217.194.0-255,5738,124494,92,252980
23590,0.015635,172.31.47.0-255,66,124560,92,252980
23591,0.017648,172.217.194.0-255,5738,130298,92,252980
23592,0.017654,172.31.47.0-255,66,130364,92,252980
23593,0.019724,172.217.194.0-255,2902,133266,92,252980
23594,0.019729,172.31.47.0-255,66,133332,92,252980
23595,0.019756,172.217.194.0-255,2902,136234,92,252980
23596,0.01976,172.31.47.0-255,66,136300,92,252980
23597,0.021753,172.217.194.0-255,2902,139202,92,252980
23598,0.021758,172.31.47.0-255,66,139268,92,252980
23599,0.021829,172.217.194.0-255,2902,142170,92,252980
23600,0.021833,172.31.47.0-255,66,142236,92,252980
23601,0.023833,172.217.194.0-255,2902,145138,92,252980
23602,0.023841,172.31.47.0-255,66,145204,92,252980
23603,0.023887,172.217.194.0-255,2902,148106,92,252980
23604,0.023891,172.31.47.0-255,66,148172,92,252980
23605,0.02586,172.217.194.0-255,2902,151074,92,252980
23606,0.025866,172.31.47.0-255,66,151140,92,252980
23607,0.025944,172.217.194.0-255,2902,154042,92,252980
23608,0.025947,172.31.47.0-255,66,154108,92,252980
23609,0.027936,172.217.194.0-255,2902,157010,92,252980
23610,0.027944,172.31.47.0-255,66,157076,92,252980
23611,0.027991,172.217.194.0-255,2902,159978,92,252980
23612,0.027995,172.31.47.0-255,66,160044,92,252980
23613,0.029962,172.217.194.0-255,2902,162946,92,252980
23614,0.029967,172.31.47.0-255,66,163012,92,252980
23615,0.030019,172.217.194.0-255,2902,165914,92,252980
23616,0.030023,172.31.47.0-255,66,165980,92,252980
23617,0.030292,172.31.47.0-255,172,166152,92,252980
23618,0.030319,172.31.47.0-255,1112,167264,92,252980
23619,0.030352,172.31.47.0-255,1514,168778,92,252980
23620,0.030358,172.31.47.0-255,1514,170292,92,252980
23621,0.030363,172.31.47.0-255,1514,171806,92,252980
23622,0.030364,172.31.47.0-255,1514,173320,92,252980
23623,0.030387,172.31.47.0-255,1494,174814,92,252980
23624,0.031829,104.244.42.0-255,66,174880,92,252980
23625,0.031944,104.244.42.0-255,66,174946,92,252980
23626,0.031949,104.244.42.0-255,66,175012,92,252980
23627,0.032021,172.217.194.0-255,2902,177914,92,252980
23628,0.032026,172.31.47.0-255,66,177980,92,252980
23629,0.032066,172.217.194.0-255,2902,180882,92,252980
23630,0.032069,172.31.47.0-255,66,180948,92,252980
23631,0.032532,104.244.42.0-255,108,181056,92,252980
23632,0.032538,172.31.47.0-255,66,181122,92,252980
23633,0.034087,172.217.194.0-255,2902,184024,92,252980
23634,0.034091,172.31.47.0-255,66,184090,92,252980
23635,0.034125,172.217.194.0-255,1484,185574,92,252980
23636,0.034138,172.217.194.0-255,1484,187058,92,252980
23637,0.034141,172.31.47.0-255,66,187124,92,252980
23638,0.036133,172.217.194.0-255,2902,190026,92,252980
23639,0.036137,172.31.47.0-255,66,190092,92,252980
23640,0.036167,172.217.194.0-255,2902,192994,92,252980
23641,0.036169,172.31.47.0-255,66,193060,92,252980
23642,0.038259,172.217.194.0-255,5738,198798,92,252980
23643,0.038265,172.31.47.0-255,66,198864,92,252980
23644,0.040328,172.217.194.0-255,5738,204602,92,252980
23645,0.040333,172.31.47.0-255,66,204668,92,252980
23646,0.042422,172.217.194.0-255,4320,208988,92,252980
23647,0.042427,172.31.47.0-255,66,209054,92,252980
23648,0.042459,172.217.194.0-255,1484,210538,92,252980
23649,0.044486,172.217.194.0-255,4320,214858,92,252980
23650,0.04449,172.31.47.0-255,66,214924,92,252980
23651,0.046571,172.217.194.0-255,5738,220662,92,252980
23652,0.046577,172.31.47.0-255,66,220728,92,252980
23653,0.048665,172.217.194.0-255,4320,225048,92,252980
23654,0.04867,172.31.47.0-255,66,225114,92,252980
23655,0.048701,172.217.194.0-255,1484,226598,92,252980
23656,0.050745,172.217.194.0-255,2902,229500,92,252980
23657,0.050749,172.31.47.0-255,66,229566,92,252980
23658,0.052757,172.217.194.0-255,1484,231050,92,252980
23659,0.052785,172.217.194.0-255,4320,235370,92,252980
23660,0.052789,172.31.47.0-255,66,235436,92,252980
23661,0.054812,172.217.194.0-255,5738,241174,92,252980
23662,0.054818,172.31.47.0-255,66,241240,92,252980
23663,0.056874,172.217.194.0-255,2902,244142,92,252980
23664,0.056879,172.31.47.0-255,66,244208,92,252980
23665,0.05691,172.217.194.0-255,2902,247110,92,252980
23666,0.056912,172.31.47.0-255,66,247176,92,252980
23667,0.058968,172.217.194.0-255,5738,252914,92,252980
23668,0.058974,172.31.47.0-255,66,252980,92,252980
23669,0.0,104.244.42.0-255,66,66,92,66
23670,0.0,172.217.194.0-255,153,153,92,262265
23671,3.2e-05,172.31.47.0-255,66,219,92,262265
23672,3.9e-05,172.217.194.0-255,1484,1703,92,262265
23673,4.4e-05,172.31.47.0-255,66,1769,92,262265
23674,4.9e-05,172.217.194.0-255,2902,4671,92,262265
23675,5.1e-05,172.31.47.0-255,66,4737,92,262265
23676,5.7e-05,172.217.194.0-255,7156,11893,92,262265
23677,6e-05,172.31.47.0-255,66,11959,92,262265
23678,6.6e-05,172.217.194.0-255,5738,17697,92,262265
23679,6.8e-05,172.31.47.0-255,66,17763,92,262265
23680,9.3e-05,172.217.194.0-255,719,18482,92,262265
23681,9.5e-05,172.31.47.0-255,66,18548,92,262265
23682,0.000125,172.217.194.0-255,4320,22868,92,262265
23683,0.000128,172.31.47.0-255,66,22934,92,262265
23684,0.000156,172.31.47.0-255,66,23000,92,262265
23685,0.00022,172.217.194.0-255,1484,24484,92,262265
23686,0.000225,172.31.47.0-255,66,24550,92,262265
23687,0.00023,172.217.194.0-255,2902,27452,92,262265
23688,0.000232,172.31.47.0-255,66,27518,92,262265
23689,0.000235,172.217.194.0-255,1484,29002,92,262265
23690,0.000237,172.31.47.0-255,66,29068,92,262265
23691,0.000259,172.217.194.0-255,4320,33388,92,262265
23692,0.000262,172.31.47.0-255,66,33454,92,262265
23693,0.000269,172.217.194.0-255,4320,37774,92,262265
23694,0.000271,172.31.47.0-255,66,37840,92,262265
23695,0.00029,172.217.194.0-255,2543,40383,92,262265
23696,0.000292,172.31.47.0-255,66,40449,92,262265
23697,0.000299,172.217.194.0-255,7156,47605,92,262265
23698,0.000302,172.31.47.0-255,66,47671,92,262265
23699,0.000347,172.217.194.0-255,2902,50573,92,262265
23700,0.000352,172.31.47.0-255,66,50639,92,262265
23701,0.000376,172.217.194.0-255,6797,57436,92,262265
23702,0.000379,172.31.47.0-255,66,57502,92,262265
23703,0.000536,172.217.194.0-255,360,57862,92,262265
23704,0.000539,172.31.47.0-255,66,57928,92,262265
23705,0.000642,172.217.194.0-255,384,58312,92,262265
23706,0.000645,172.31.47.0-255,66,58378,92,262265
23707,0.000917,172.217.194.0-255,1484,59862,92,262265
23708,0.000921,172.31.47.0-255,66,59928,92,262265
23709,0.000929,172.217.194.0-255,2902,62830,92,262265
23710,0.000931,172.31.47.0-255,66,62896,92,262265
23711,0.000938,172.217.194.0-255,5738,68634,92,262265
23712,0.00094,172.31.47.0-255,66,68700,92,262265
23713,0.000962,172.217.194.0-255,4320,73020,92,262265
23714,0.000964,172.31.47.0-255,66,73086,92,262265
23715,0.001442,172.217.194.0-255,1484,74570,92,262265
23716,0.00145,172.217.194.0-255,2902,77472,92,262265
23717,0.001453,172.217.194.0-255,1484,78956,92,262265
23718,0.001467,172.217.194.0-255,4320,83276,92,262265
23719,0.001523,172.217.194.0-255,766,84042,92,262265
23720,0.001698,172.217.194.0-255,1484,85526,92,262265
23721,0.001702,172.217.194.0-255,2902,88428,92,262265
23722,0.001716,172.217.194.0-255,2902,91330,92,262265
23723,0.001728,172.217.194.0-255,2902,94232,92,262265
23724,0.001802,172.217.194.0-255,4320,98552,92,262265
23725,0.00182,172.217.194.0-255,6438,104990,92,262265
23726,0.001914,172.217.194.0-255,1484,106474,92,262265
23727,0.001918,172.217.194.0-255,2902,109376,92,262265
23728,0.001949,172.217.194.0-255,5738,115114,92,262265
23729,0.001989,172.217.194.0-255,1484,116598,92,262265
23730,0.002005,172.217.194.0-255,2902,119500,92,262265
23731,0.005439,172.31.47.0-255,66,119566,92,262265
23732,0.00777,172.217.194.0-255,5738,125304,92,262265
23733,0.007777,172.31.47.0-255,66,125370,92,262265
23734,0.010104,172.217.194.0-255,5738,131108,92,262265
23735,0.010114,172.31.47.0-255,66,131174,92,262265
23736,0.012429,172.217.194.0-255,5738,136912,92,262265
23737,0.012437,172.31.47.0-255,66,136978,92,262265
23738,0.014763,172.217.194.0-255,5738,142716,92,262265
23739,0.014774,172.31.47.0-255,66,142782,92,262265
23740,0.017115,172.217.194.0-255,5738,148520,92,262265
23741,0.017133,172.31.47.0-255,66,148586,92,262265
23742,0.019485,172.217.194.0-255,5738,154324,92,262265
23743,0.019869,172.31.47.0-255,66,154390,92,262265
23744,0.022185,172.217.194.0-255,5738,160128,92,262265
23745,0.022196,172.31.47.0-255,66,160194,92,262265
23746,0.024535,172.217.194.0-255,5738,165932,92,262265
23747,0.024555,172.31.47.0-255,66,165998,92,262265
23748,0.026865,172.217.194.0-255,5738,171736,92,262265
23749,0.026874,172.31.47.0-255,66,171802,92,262265
23750,0.029212,172.217.194.0-255,5738,177540,92,262265
23751,0.029222,172.31.47.0-255,66,177606,92,262265
23752,0.031559,172.217.194.0-255,5738,183344,92,262265
23753,0.031573,172.31.47.0-255,66,183410,92,262265
23754,0.033893,172.217.194.0-255,5738,189148,92,262265
23755,0.033913,172.31.47.0-255,66,189214,92,262265
23756,0.036251,172.217.194.0-255,5738,194952,92,262265
23757,0.036259,172.31.47.0-255,66,195018,92,262265
23758,0.038576,172.217.194.0-255,5738,200756,92,262265
23759,0.038583,172.31.47.0-255,66,200822,92,262265
23760,0.040904,172.217.194.0-255,5738,206560,92,262265
23761,0.040918,172.31.47.0-255,66,206626,92,262265
23762,0.043258,172.217.194.0-255,5738,212364,92,262265
23763,0.043267,172.31.47.0-255,66,212430,92,262265
23764,0.045626,172.217.194.0-255,5738,218168,92,262265
23765,0.045646,172.31.47.0-255,66,218234,92,262265
23766,0.047957,172.217.194.0-255,5738,223972,92,262265
23767,0.047966,172.31.47.0-255,66,224038,92,262265
23768,0.050329,172.217.194.0-255,5738,229776,92,262265
23769,0.050348,172.31.47.0-255,66,229842,92,262265
23770,0.052677,172.217.194.0-255,5738,235580,92,262265
23771,0.05269,172.31.47.0-255,66,235646,92,262265
23772,0.054354,172.31.47.0-255,172,235818,92,262265
23773,0.054385,172.31.47.0-255,1103,236921,92,262265
23774,0.054435,172.31.47.0-255,1514,238435,92,262265
23775,0.054437,172.31.47.0-255,1514,239949,92,262265
23776,0.054438,172.31.47.0-255,1514,241463,92,262265
23777,0.054439,172.31.47.0-255,1514,242977,92,262265
23778,0.05444,172.31.47.0-255,1504,244481,92,262265
23779,0.054993,172.217.194.0-255,5738,250219,92,262265
23780,0.055001,172.31.47.0-255,66,250285,92,262265
23781,0.055897,104.244.42.0-255,66,250351,92,262265
23782,0.056043,104.244.42.0-255,66,250417,92,262265
23783,0.05605,104.244.42.0-255,66,250483,92,262265
23784,0.057334,172.217.194.0-255,5738,256221,92,262265
23785,0.05737,172.31.47.0-255,66,256287,92,262265
23786,0.05773,104.244.42.0-255,108,256395,92,262265
23787,0.057737,172.31.47.0-255,66,256461,92,262265
23788,0.059767,172.217.194.0-255,5738,262199,92,262265
23789,0.059786,172.31.47.0-255,66,262265,92,262265
23790,0.0,74.125.68.0-255,153,153,92,400794
23791,2.1e-05,172.31.47.0-255,66,219,92,400794
23792,2.8e-05,74.125.68.0-255,1484,1703,92,400794
23793,3.2e-05,172.31.47.0-255,66,1769,92,400794
23794,3.7e-05,74.125.68.0-255,2902,4671,92,400794
23795,4.5e-05,172.31.47.0-255,66,4737,92,400794
23796,4.8e-05,74.125.68.0-255,1484,6221,92,400794
23797,5e-05,172.31.47.0-255,66,6287,92,400794
23798,5.5e-05,74.125.68.0-255,2902,9189,92,400794
23799,5.7e-05,172.31.47.0-255,66,9255,92,400794
23800,9.9e-05,74.125.68.0-255,2902,12157,92,400794
23801,0.000102,172.31.47.0-255,66,12223,92,400794
23802,0.000125,74.125.68.0-255,1997,14220,92,400794
23803,0.000128,172.31.47.0-255,66,14286,92,400794
23804,0.000857,74.125.68.0-255,1484,15770,92,400794
23805,0.000863,172.31.47.0-255,66,15836,92,400794
23806,0.000872,74.125.68.0-255,2902,18738,92,400794
23807,0.000874,172.31.47.0-255,66,18804,92,400794
23808,0.00092,74.125.68.0-255,1484,20288,92,400794
23809,0.000923,172.31.47.0-255,66,20354,92,400794
23810,0.000949,74.125.68.0-255,4320,24674,92,400794
23811,0.000952,172.31.47.0-255,66,24740,92,400794
23812,0.000959,74.125.68.0-255,6797,31537,92,400794
23813,0.000962,172.31.47.0-255,66,31603,92,400794
23814,0.000986,74.125.68.0-255,1484,33087,92,400794
23815,0.000988,172.31.47.0-255,66,33153,92,400794
23816,0.000993,74.125.68.0-255,2902,36055,92,400794
23817,0.000995,172.31.47.0-255,66,36121,92,400794
23818,0.001023,74.125.68.0-255,1484,37605,92,400794
23819,0.001025,172.31.47.0-255,66,37671,92,400794
23820,0.00103,74.125.68.0-255,2902,40573,92,400794
23821,0.001032,172.31.47.0-255,66,40639,92,400794
23822,0.001057,74.125.68.0-255,5738,46377,92,400794
23823,0.00106,172.31.47.0-255,66,46443,92,400794
23824,0.001063,74.125.68.0-255,1484,47927,92,400794
23825,0.001111,74.125.68.0-255,1125,49052,92,400794
23826,0.001113,172.31.47.0-255,66,49118,92,400794
23827,0.001327,74.125.68.0-255,1484,50602,92,400794
23828,0.001343,74.125.68.0-255,1484,52086,92,400794
23829,0.001346,172.31.47.0-255,66,52152,92,400794
23830,0.001368,74.125.68.0-255,1484,53636,92,400794
23831,0.001371,74.125.68.0-255,1484,55120,92,400794
23832,0.001373,172.31.47.0-255,66,55186,92,400794
23833,0.001395,74.125.68.0-255,4320,59506,92,400794
23834,0.001398,172.31.47.0-255,66,59572,92,400794
23835,0.001419,74.125.68.0-255,1484,61056,92,400794
23836,0.001424,74.125.68.0-255,4320,65376,92,400794
23837,0.001426,172.31.47.0-255,66,65442,92,400794
23838,0.001453,74.125.68.0-255,1125,66567,92,400794
23839,0.002213,74.125.68.0-255,1484,68051,92,400794
23840,0.002216,172.31.47.0-255,66,68117,92,400794
23841,0.002233,74.125.68.0-255,2902,71019,92,400794
23842,0.002235,172.31.47.0-255,66,71085,92,400794
23843,0.002261,74.125.68.0-255,5738,76823,92,400794
23844,0.002264,172.31.47.0-255,66,76889,92,400794
23845,0.002268,74.125.68.0-255,4320,81209,92,400794
23846,0.00227,172.31.47.0-255,66,81275,92,400794
23847,0.002273,74.125.68.0-255,1484,82759,92,400794
23848,0.002298,74.125.68.0-255,4320,87079,92,400794
23849,0.0023,172.31.47.0-255,66,87145,92,400794
23850,0.002347,172.31.47.0-255,66,87211,92,400794
23851,0.002351,74.125.68.0-255,2184,89395,92,400794
23852,0.002352,172.31.47.0-255,66,89461,92,400794
23853,0.002486,74.125.68.0-255,1484,90945,92,400794
23854,0.002503,74.125.68.0-255,2902,93847,92,400794
23855,0.002506,172.31.47.0-255,66,93913,92,400794
23856,0.002532,74.125.68.0-255,5738,99651,92,400794
23857,0.002534,172.31.47.0-255,66,99717,92,400794
23858,0.002537,74.125.68.0-255,1484,101201,92,400794
23859,0.002599,74.125.68.0-255,2902,104103,92,400794
23860,0.002601,172.31.47.0-255,66,104169,92,400794
23861,0.002629,74.125.68.0-255,5738,109907,92,400794
23862,0.002632,172.31.47.0-255,66,109973,92,400794
23863,0.002634,74.125.68.0-255,1484,111457,92,400794
23864,0.002654,74.125.68.0-255,2902,114359,92,400794
23865,0.002657,172.31.47.0-255,66,114425,92,400794
23866,0.002697,172.31.47.0-255,66,114491,92,400794
23867,0.002699,74.125.68.0-255,766,115257,92,400794
23868,0.002735,172.31.47.0-255,66,115323,92,400794
23869,0.002747,172.31.47.0-255,66,115389,92,400794
23870,0.002755,74.125.68.0-255,2902,118291,92,400794
23871,0.002757,172.31.47.0-255,66,118357,92,400794
23872,0.0028,74.125.68.0-255,2902,121259,92,400794
23873,0.002803,172.31.47.0-255,66,121325,92,400794
23874,0.002834,74.125.68.0-255,6438,127763,92,400794
23875,0.002836,172.31.47.0-255,66,127829,92,400794
23876,0.002903,74.125.68.0-255,1484,129313,92,400794
23877,0.00292,74.125.68.0-255,2902,132215,92,400794
23878,0.002924,172.31.47.0-255,66,132281,92,400794
23879,0.002953,74.125.68.0-255,2902,135183,92,400794
23880,0.002956,172.31.47.0-255,66,135249,92,400794
23881,0.002978,74.125.68.0-255,1484,136733,92,400794
23882,0.002984,74.125.68.0-255,5738,142471,92,400794
23883,0.002987,172.31.47.0-255,66,142537,92,400794
23884,0.003011,74.125.68.0-255,1484,144021,92,400794
23885,0.003014,74.125.68.0-255,1484,145505,92,400794
23886,0.003016,172.31.47.0-255,66,145571,92,400794
23887,0.003019,74.125.68.0-255,1484,147055,92,400794
23888,0.003037,74.125.68.0-255,1484,148539,92,400794
23889,0.003039,172.31.47.0-255,66,148605,92,400794
23890,0.003043,74.125.68.0-255,1484,150089,92,400794
23891,0.003062,74.125.68.0-255,1484,151573,92,400794
23892,0.003065,172.31.47.0-255,66,151639,92,400794
23893,0.00307,74.125.68.0-255,4320,155959,92,400794
23894,0.003072,172.31.47.0-255,66,156025,92,400794
23895,0.003102,74.125.68.0-255,2902,158927,92,400794
23896,0.003105,172.31.47.0-255,66,158993,92,400794
23897,0.00313,74.125.68.0-255,3602,162595,92,400794
23898,0.003133,172.31.47.0-255,66,162661,92,400794
23899,0.003374,74.125.68.0-255,647,163308,92,400794
23900,0.003417,74.125.68.0-255,1484,164792,92,400794
23901,0.003421,172.31.47.0-255,66,164858,92,400794
23902,0.00344,74.125.68.0-255,4320,169178,92,400794
23903,0.003442,172.31.47.0-255,66,169244,92,400794
23904,0.003445,74.125.68.0-255,1484,170728,92,400794
23905,0.003465,74.125.68.0-255,1484,172212,92,400794
23906,0.003466,172.31.47.0-255,66,172278,92,400794
23907,0.00349,74.125.68.0-255,1484,173762,92,400794
23908,0.003497,74.125.68.0-255,5738,179500,92,400794
23909,0.003499,172.31.47.0-255,66,179566,92,400794
23910,0.003502,74.125.68.0-255,1484,181050,92,400794
23911,0.003528,74.125.68.0-255,2902,183952,92,400794
23912,0.00353,172.31.47.0-255,66,184018,92,400794
23913,0.003554,74.125.68.0-255,1484,185502,92,400794
23914,0.00357,74.125.68.0-255,2902,188404,92,400794
23915,0.003572,172.31.47.0-255,66,188470,92,400794
23916,0.003577,74.125.68.0-255,4320,192790,92,400794
23917,0.003579,172.31.47.0-255,66,192856,92,400794
23918,0.003607,74.125.68.0-255,1484,194340,92,400794
23919,0.003612,74.125.68.0-255,3602,197942,92,400794
23920,0.003614,172.31.47.0-255,66,198008,92,400794
23921,0.003824,74.125.68.0-255,1484,199492,92,400794
23922,0.003852,74.125.68.0-255,2902,202394,92,400794
23923,0.003855,172.31.47.0-255,66,202460,92,400794
23924,0.003859,74.125.68.0-255,1484,203944,92,400794
23925,0.003881,74.125.68.0-255,1484,205428,92,400794
23926,0.003883,172.31.47.0-255,66,205494,92,400794
23927,0.003886,74.125.68.0-255,1484,206978,92,400794
23928,0.003913,74.125.68.0-255,1484,208462,92,400794
23929,0.003916,172.31.47.0-255,66,208528,92,400794
23930,0.00394,74.125.68.0-255,1484,210012,92,400794
23931,0.003946,74.125.68.0-255,5738,215750,92,400794
23932,0.003948,172.31.47.0-255,66,215816,92,400794
23933,0.003956,74.125.68.0-255,7156,222972,92,400794
23934,0.003957,172.31.47.0-255,66,223038,92,400794
23935,0.003964,74.125.68.0-255,1484,224522,92,400794
23936,0.003982,74.125.68.0-255,4320,228842,92,400794
23937,0.003985,172.31.47.0-255,66,228908,92,400794
23938,0.004011,74.125.68.0-255,3602,232510,92,400794
23939,0.004013,172.31.47.0-255,66,232576,92,400794
23940,0.004064,74.125.68.0-255,1484,234060,92,400794
23941,0.004082,74.125.68.0-255,2902,236962,92,400794
23942,0.004085,172.31.47.0-255,66,237028,92,400794
23943,0.004108,74.125.68.0-255,2902,239930,92,400794
23944,0.004111,172.31.47.0-255,66,239996,92,400794
23945,0.004127,74.125.68.0-255,2902,242898,92,400794
23946,0.004129,172.31.47.0-255,66,242964,92,400794
23947,0.004132,74.125.68.0-255,1484,244448,92,400794
23948,0.004156,74.125.68.0-255,4320,248768,92,400794
23949,0.004158,172.31.47.0-255,66,248834,92,400794
23950,0.004188,74.125.68.0-255,4320,253154,92,400794
23951,0.00419,172.31.47.0-255,66,253220,92,400794
23952,0.004195,74.125.68.0-255,4320,257540,92,400794
23953,0.004197,172.31.47.0-255,66,257606,92,400794
23954,0.004199,74.125.68.0-255,1484,259090,92,400794
23955,0.004227,74.125.68.0-255,7156,266246,92,400794
23956,0.004229,172.31.47.0-255,66,266312,92,400794
23957,0.004232,74.125.68.0-255,766,267078,92,400794
23958,0.004258,74.125.68.0-255,1484,268562,92,400794
23959,0.004261,172.31.47.0-255,66,268628,92,400794
23960,0.004288,74.125.68.0-255,1484,270112,92,400794
23961,0.004292,74.125.68.0-255,2902,273014,92,400794
23962,0.004294,172.31.47.0-255,66,273080,92,400794
23963,0.004297,74.125.68.0-255,1484,274564,92,400794
23964,0.004316,74.125.68.0-255,1484,276048,92,400794
23965,0.004318,172.31.47.0-255,66,276114,92,400794
23966,0.004346,74.125.68.0-255,2902,279016,92,400794
23967,0.004349,172.31.47.0-255,66,279082,92,400794
23968,0.004371,74.125.68.0-255,4320,283402,92,400794
23969,0.004374,172.31.47.0-255,66,283468,92,400794
23970,0.004399,74.125.68.0-255,1484,284952,92,400794
23971,0.004402,74.125.68.0-255,1484,286436,92,400794
23972,0.004404,172.31.47.0-255,66,286502,92,400794
23973,0.004409,74.125.68.0-255,4320,290822,92,400794
23974,0.004411,172.31.47.0-255,66,290888,92,400794
23975,0.004443,74.125.68.0-255,4320,295208,92,400794
23976,0.004445,172.31.47.0-255,66,295274,92,400794
23977,0.004453,74.125.68.0-255,6438,301712,92,400794
23978,0.004455,172.31.47.0-255,66,301778,92,400794
23979,0.004461,74.125.68.0-255,1484,303262,92,400794
23980,0.004464,74.125.68.0-255,1484,304746,92,400794
23981,0.004466,172.31.47.0-255,66,304812,92,400794
23982,0.004492,74.125.68.0-255,1484,306296,92,400794
23983,0.004498,74.125.68.0-255,4320,310616,92,400794
23984,0.0045,172.31.47.0-255,66,310682,92,400794
23985,0.004528,74.125.68.0-255,1484,312166,92,400794
23986,0.004531,74.125.68.0-255,1484,313650,92,400794
23987,0.004533,172.31.47.0-255,66,313716,92,400794
23988,0.004539,74.125.68.0-255,5738,319454,92,400794
23989,0.004541,172.31.47.0-255,66,319520,92,400794
23990,0.00457,74.125.68.0-255,7156,326676,92,400794
23991,0.004573,172.31.47.0-255,66,326742,92,400794
23992,0.004575,74.125.68.0-255,1484,328226,92,400794
23993,0.00458,74.125.68.0-255,4320,332546,92,400794
23994,0.004582,172.31.47.0-255,66,332612,92,400794
23995,0.004588,74.125.68.0-255,1484,334096,92,400794
23996,0.004607,74.125.68.0-255,2184,336280,92,400794
23997,0.004609,172.31.47.0-255,66,336346,92,400794
23998,0.004619,74.125.68.0-255,1484,337830,92,400794
23999,0.004635,74.125.68.0-255,1484,339314,92,400794
24000,0.004637,172.31.47.0-255,66,339380,92,400794
24001,0.004667,74.125.68.0-255,4320,343700,92,400794
24002,0.00467,172.31.47.0-255,66,343766,92,400794
24003,0.004675,74.125.68.0-255,4320,348086,92,400794
24004,0.004677,172.31.47.0-255,66,348152,92,400794
24005,0.004682,74.125.68.0-255,4320,352472,92,400794
24006,0.004689,172.31.47.0-255,66,352538,92,400794
24007,0.004692,74.125.68.0-255,1484,354022,92,400794
24008,0.004749,74.125.68.0-255,1484,355506,92,400794
24009,0.004751,172.31.47.0-255,66,355572,92,400794
24010,0.004758,74.125.68.0-255,5738,361310,92,400794
24011,0.00476,172.31.47.0-255,66,361376,92,400794
24012,0.004769,74.125.68.0-255,4320,365696,92,400794
24013,0.004771,172.31.47.0-255,66,365762,92,400794
24014,0.004773,74.125.68.0-255,1484,367246,92,400794
24015,0.004778,74.125.68.0-255,3602,370848,92,400794
24016,0.00478,172.31.47.0-255,66,370914,92,400794
24017,0.004805,74.125.68.0-255,1484,372398,92,400794
24018,0.004822,74.125.68.0-255,2902,375300,92,400794
24019,0.004825,172.31.47.0-255,66,375366,92,400794
24020,0.004849,74.125.68.0-255,4320,379686,92,400794
24021,0.004852,172.31.47.0-255,66,379752,92,400794
24022,0.004857,74.125.68.0-255,5738,385490,92,400794
24023,0.004859,172.31.47.0-255,66,385556,92,400794
24024,0.004886,74.125.68.0-255,2902,388458,92,400794
24025,0.004889,172.31.47.0-255,66,388524,92,400794
24026,0.004891,74.125.68.0-255,1484,390008,92,400794
24027,0.004893,74.125.68.0-255,892,390900,92,400794
24028,0.004895,172.31.47.0-255,66,390966,92,400794
24029,0.004898,74.125.68.0-255,97,391063,92,400794
24030,0.004951,74.125.68.0-255,105,391168,92,400794
24031,0.014593,74.125.68.0-255,105,391273,92,400794
24032,0.01461,172.31.47.0-255,78,391351,92,400794
24033,0.02565,172.31.47.0-255,105,391456,92,400794
24034,0.027587,74.125.68.0-255,66,391522,92,400794
24035,0.034602,172.31.47.0-255,172,391694,92,400794
24036,0.034646,172.31.47.0-255,1112,392806,92,400794
24037,0.034733,172.31.47.0-255,1514,394320,92,400794
24038,0.034735,172.31.47.0-255,1514,395834,92,400794
24039,0.034741,172.31.47.0-255,1514,397348,92,400794
24040,0.034742,172.31.47.0-255,1514,398862,92,400794
24041,0.034762,172.31.47.0-255,1494,400356,92,400794
24042,0.0362,104.244.42.0-255,66,400422,92,400794
24043,0.036242,104.244.42.0-255,66,400488,92,400794
24044,0.036299,104.244.42.0-255,66,400554,92,400794
24045,0.036339,104.244.42.0-255,66,400620,92,400794
24046,0.038236,104.244.42.0-255,108,400728,92,400794
24047,0.038243,172.31.47.0-255,66,400794,92,400794
24048,0.0,74.125.24.0-255,153,153,92,259253
24049,1.7e-05,172.31.47.0-255,66,219,92,259253
24050,2.3e-05,74.125.24.0-255,1484,1703,92,259253
24051,2.7e-05,172.31.47.0-255,66,1769,92,259253
24052,3.1e-05,74.125.24.0-255,2902,4671,92,259253
24053,3.4e-05,172.31.47.0-255,66,4737,92,259253
24054,6e-05,74.125.24.0-255,5738,10475,92,259253
24055,6.3e-05,172.31.47.0-255,66,10541,92,259253
24056,8.1e-05,74.125.24.0-255,1484,12025,92,259253
24057,8.4e-05,172.31.47.0-255,66,12091,92,259253
24058,8.8e-05,74.125.24.0-255,1949,14040,92,259253
24059,8.9e-05,172.31.47.0-255,66,14106,92,259253
24060,0.000556,74.125.24.0-255,1484,15590,92,259253
24061,0.000562,172.31.47.0-255,66,15656,92,259253
24062,0.00057,74.125.24.0-255,2902,18558,92,259253
24063,0.000571,172.31.47.0-255,66,18624,92,259253
24064,0.000577,74.125.24.0-255,4320,22944,92,259253
24065,0.000578,172.31.47.0-255,66,23010,92,259253
24066,0.000596,74.125.24.0-255,1484,24494,92,259253
24067,0.000599,172.31.47.0-255,66,24560,92,259253
24068,0.000603,74.125.24.0-255,2902,27462,92,259253
24069,0.000605,172.31.47.0-255,66,27528,92,259253
24070,0.000636,172.31.47.0-255,66,27594,92,259253
24071,0.000641,74.125.24.0-255,5738,33332,92,259253
24072,0.000643,172.31.47.0-255,66,33398,92,259253
24073,0.00066,74.125.24.0-255,2902,36300,92,259253
24074,0.000662,172.31.47.0-255,66,36366,92,259253
24075,0.000681,74.125.24.0-255,7156,43522,92,259253
24076,0.000684,172.31.47.0-255,66,43588,92,259253
24077,0.000718,172.31.47.0-255,66,43654,92,259253
24078,0.000827,74.125.24.0-255,397,44051,92,259253
24079,0.000844,74.125.24.0-255,112,44163,92,259253
24080,0.000956,74.125.24.0-255,1484,45647,92,259253
24081,0.000962,74.125.24.0-255,2902,48549,92,259253
24082,0.000992,74.125.24.0-255,5738,54287,92,259253
24083,0.001009,74.125.24.0-255,5738,60025,92,259253
24084,0.001035,74.125.24.0-255,7156,67181,92,259253
24085,0.001079,74.125.24.0-255,2184,69365,92,259253
24086,0.001121,74.125.24.0-255,1484,70849,92,259253
24087,0.001125,74.125.24.0-255,1484,72333,92,259253
24088,0.001136,74.125.24.0-255,1484,73817,92,259253
24089,0.001139,74.125.24.0-255,1484,75301,92,259253
24090,0.001159,74.125.24.0-255,4320,79621,92,259253
24091,0.001174,74.125.24.0-255,5738,85359,92,259253
24092,0.001194,74.125.24.0-255,7156,92515,92,259253
24093,0.001715,74.125.24.0-255,1484,93999,92,259253
24094,0.001722,74.125.24.0-255,2902,96901,92,259253
24095,0.001743,74.125.24.0-255,5738,102639,92,259253
24096,0.001749,74.125.24.0-255,4320,106959,92,259253
24097,0.001752,74.125.24.0-255,1484,108443,92,259253
24098,0.001765,74.125.24.0-255,2902,111345,92,259253
24099,0.001778,74.125.24.0-255,4320,115665,92,259253
24100,0.001793,74.125.24.0-255,7156,122821,92,259253
24101,0.001798,74.125.24.0-255,3602,126423,92,259253
24102,0.00361,172.31.47.0-255,66,126489,92,259253
24103,0.005994,74.125.24.0-255,5738,132227,92,259253
24104,0.006009,172.31.47.0-255,66,132293,92,259253
24105,0.008354,74.125.24.0-255,5738,138031,92,259253
24106,0.008366,172.31.47.0-255,66,138097,92,259253
24107,0.010715,74.125.24.0-255,5738,143835,92,259253
24108,0.015647,172.31.47.0-255,66,143901,92,259253
24109,0.018086,74.125.24.0-255,5738,149639,92,259253
24110,0.018098,172.31.47.0-255,66,149705,92,259253
24111,0.019323,172.31.47.0-255,172,149877,92,259253
24112,0.019366,172.31.47.0-255,1111,150988,92,259253
24113,0.019444,172.31.47.0-255,1514,152502,92,259253
24114,0.019446,172.31.47.0-255,1514,154016,92,259253
24115,0.019447,172.31.47.0-255,1514,155530,92,259253
24116,0.019451,172.31.47.0-255,1514,157044,92,259253
24117,0.019452,172.31.47.0-255,1495,158539,92,259253
24118,0.020437,74.125.24.0-255,5738,164277,92,259253
24119,0.020442,172.31.47.0-255,66,164343,92,259253
24120,0.020873,104.244.42.0-255,66,164409,92,259253
24121,0.020932,104.244.42.0-255,66,164475,92,259253
24122,0.02106,104.244.42.0-255,66,164541,92,259253
24123,0.022764,74.125.24.0-255,5738,170279,92,259253
24124,0.022768,172.31.47.0-255,66,170345,92,259253
24125,0.025128,74.125.24.0-255,5738,176083,92,259253
24126,0.025134,172.31.47.0-255,66,176149,92,259253
24127,0.027451,74.125.24.0-255,2902,179051,92,259253
24128,0.027456,172.31.47.0-255,66,179117,92,259253
24129,0.027494,74.125.24.0-255,2902,182019,92,259253
24130,0.027507,172.31.47.0-255,66,182085,92,259253
24131,0.02978,74.125.24.0-255,2902,184987,92,259253
24132,0.029786,172.31.47.0-255,66,185053,92,259253
24133,0.029835,74.125.24.0-255,2902,187955,92,259253
24134,0.029865,172.31.47.0-255,66,188021,92,259253
24135,0.032129,74.125.24.0-255,2902,190923,92,259253
24136,0.032134,172.31.47.0-255,66,190989,92,259253
24137,0.032221,74.125.24.0-255,2902,193891,92,259253
24138,0.032226,172.31.47.0-255,66,193957,92,259253
24139,0.034515,74.125.24.0-255,2902,196859,92,259253
24140,0.034519,172.31.47.0-255,66,196925,92,259253
24141,0.034564,74.125.24.0-255,2902,199827,92,259253
24142,0.034586,172.31.47.0-255,66,199893,92,259253
24143,0.036831,74.125.24.0-255,2902,202795,92,259253
24144,0.036835,172.31.47.0-255,66,202861,92,259253
24145,0.03691,74.125.24.0-255,2902,205763,92,259253
24146,0.036914,172.31.47.0-255,66,205829,92,259253
24147,0.039172,74.125.24.0-255,2902,208731,92,259253
24148,0.039177,172.31.47.0-255,66,208797,92,259253
24149,0.039289,74.125.24.0-255,2902,211699,92,259253
24150,0.039696,172.31.47.0-255,66,211765,92,259253
24151,0.041542,74.125.24.0-255,2902,214667,92,259253
24152,0.041548,172.31.47.0-255,66,214733,92,259253
24153,0.042005,74.125.24.0-255,2902,217635,92,259253
24154,0.042009,172.31.47.0-255,66,217701,92,259253
24155,0.043873,74.125.24.0-255,2902,220603,92,259253
24156,0.043879,172.31.47.0-255,66,220669,92,259253
24157,0.044361,74.125.24.0-255,2902,223571,92,259253
24158,0.044366,172.31.47.0-255,66,223637,92,259253
24159,0.046214,74.125.24.0-255,2902,226539,92,259253
24160,0.046219,172.31.47.0-255,66,226605,92,259253
24161,0.046736,74.125.24.0-255,2902,229507,92,259253
24162,0.046741,172.31.47.0-255,66,229573,92,259253
24163,0.048558,74.125.24.0-255,2902,232475,92,259253
24164,0.048564,172.31.47.0-255,66,232541,92,259253
24165,0.049052,74.125.24.0-255,2902,235443,92,259253
24166,0.049402,172.31.47.0-255,66,235509,92,259253
24167,0.050892,74.125.24.0-255,2902,238411,92,259253
24168,0.050897,172.31.47.0-255,66,238477,92,259253
24169,0.051721,74.125.24.0-255,2902,241379,92,259253
24170,0.051726,172.31.47.0-255,66,241445,92,259253
24171,0.053254,74.125.24.0-255,2902,244347,92,259253
24172,0.053259,172.31.47.0-255,66,244413,92,259253
24173,0.054038,74.125.24.0-255,2902,247315,92,259253
24174,0.054042,172.31.47.0-255,66,247381,92,259253
24175,0.055593,74.125.24.0-255,2902,250283,92,259253
24176,0.055599,172.31.47.0-255,66,250349,92,259253
24177,0.056367,74.125.24.0-255,2902,253251,92,259253
24178,0.056374,172.31.47.0-255,66,253317,92,259253
24179,0.057913,74.125.24.0-255,2902,256219,92,259253
24180,0.057918,172.31.47.0-255,66,256285,92,259253
24181,0.058705,74.125.24.0-255,2902,259187,92,259253
24182,0.05871,172.31.47.0-255,66,259253,92,259253
24183,0.0,172.31.47.0-255,105,105,92,105
24184,0.0,172.31.47.0-255,66,66,92,66
24185,0.0,172.31.47.0-255,66,66,92,66
24186,0.0,74.125.24.0-255,153,153,92,241327
24187,1.2e-05,172.31.47.0-255,66,219,92,241327
24188,1.8e-05,74.125.24.0-255,1484,1703,92,241327
24189,2.2e-05,172.31.47.0-255,66,1769,92,241327
24190,2.7e-05,74.125.24.0-255,2902,4671,92,241327
24191,3.6e-05,172.31.47.0-255,66,4737,92,241327
24192,4.4e-05,74.125.24.0-255,7156,11893,92,241327
24193,4.6e-05,172.31.47.0-255,66,11959,92,241327
24194,6.9e-05,74.125.24.0-255,5738,17697,92,241327
24195,7.5e-05,172.31.47.0-255,66,17763,92,241327
24196,0.000111,172.31.47.0-255,66,17829,92,241327
24197,0.000115,74.125.24.0-255,2543,20372,92,241327
24198,0.000117,172.31.47.0-255,66,20438,92,241327
24199,0.000157,74.125.24.0-255,1484,21922,92,241327
24200,0.000159,172.31.47.0-255,66,21988,92,241327
24201,0.000164,74.125.24.0-255,2902,24890,92,241327
24202,0.000166,172.31.47.0-255,66,24956,92,241327
24203,0.000195,74.125.24.0-255,5738,30694,92,241327
24204,0.000198,172.31.47.0-255,66,30760,92,241327
24205,0.000231,172.31.47.0-255,66,30826,92,241327
24206,0.000234,74.125.24.0-255,1484,32310,92,241327
24207,0.000235,172.31.47.0-255,66,32376,92,241327
24208,0.000273,172.31.47.0-255,66,32442,92,241327
24209,0.000276,74.125.24.0-255,363,32805,92,241327
24210,0.000277,172.31.47.0-255,66,32871,92,241327
24211,0.000309,74.125.24.0-255,412,33283,92,241327
24212,0.000311,172.31.47.0-255,66,33349,92,241327
24213,0.000603,74.125.24.0-255,1484,34833,92,241327
24214,0.000608,172.31.47.0-255,66,34899,92,241327
24215,0.000613,74.125.24.0-255,2902,37801,92,241327
24216,0.000615,172.31.47.0-255,66,37867,92,241327
24217,0.000625,74.125.24.0-255,5738,43605,92,241327
24218,0.000628,172.31.47.0-255,66,43671,92,241327
24219,0.000634,74.125.24.0-255,7156,50827,92,241327
24220,0.000636,172.31.47.0-255,66,50893,92,241327
24221,0.000678,172.31.47.0-255,66,50959,92,241327
24222,0.000682,74.125.24.0-255,2184,53143,92,241327
24223,0.000683,172.31.47.0-255,66,53209,92,241327
24224,0.001212,74.125.24.0-255,1484,54693,92,241327
24225,0.001218,74.125.24.0-255,2902,57595,92,241327
24226,0.001221,172.31.47.0-255,66,57661,92,241327
24227,0.001252,74.125.24.0-255,5738,63399,92,241327
24228,0.001254,172.31.47.0-255,66,63465,92,241327
24229,0.00126,74.125.24.0-255,2902,66367,92,241327
24230,0.001261,172.31.47.0-255,66,66433,92,241327
24231,0.001275,172.31.47.0-255,66,66499,92,241327
24232,0.001303,74.125.24.0-255,1484,67983,92,241327
24233,0.001314,172.31.47.0-255,66,68049,92,241327
24234,0.001386,74.125.24.0-255,1484,69533,92,241327
24235,0.00139,74.125.24.0-255,1484,71017,92,241327
24236,0.001393,172.31.47.0-255,66,71083,92,241327
24237,0.001419,74.125.24.0-255,1484,72567,92,241327
24238,0.001425,74.125.24.0-255,5738,78305,92,241327
24239,0.001427,172.31.47.0-255,66,78371,92,241327
24240,0.001436,172.31.47.0-255,66,78437,92,241327
24241,0.001462,74.125.24.0-255,4320,82757,92,241327
24242,0.001465,172.31.47.0-255,66,82823,92,241327
24243,0.001476,172.31.47.0-255,66,82889,92,241327
24244,0.001536,74.125.24.0-255,2184,85073,92,241327
24245,0.001539,172.31.47.0-255,66,85139,92,241327
24246,0.001543,74.125.24.0-255,2902,88041,92,241327
24247,0.001545,172.31.47.0-255,66,88107,92,241327
24248,0.001552,74.125.24.0-255,7156,95263,92,241327
24249,0.001554,172.31.47.0-255,66,95329,92,241327
24250,0.001569,172.31.47.0-255,66,95395,92,241327
24251,0.001576,74.125.24.0-255,6438,101833,92,241327
24252,0.001578,172.31.47.0-255,66,101899,92,241327
24253,0.001607,74.125.24.0-255,5738,107637,92,241327
24254,0.001609,172.31.47.0-255,66,107703,92,241327
24255,0.001616,74.125.24.0-255,5738,113441,92,241327
24256,0.001618,172.31.47.0-255,66,113507,92,241327
24257,0.001649,74.125.24.0-255,1484,114991,92,241327
24258,0.001665,172.31.47.0-255,66,115057,92,241327
24259,0.001672,74.125.24.0-255,6438,121495,92,241327
24260,0.001675,172.31.47.0-255,66,121561,92,241327
24261,0.001697,74.125.24.0-255,1484,123045,92,241327
24262,0.001701,74.125.24.0-255,2902,125947,92,241327
24263,0.001703,172.31.47.0-255,66,126013,92,241327
24264,0.001734,74.125.24.0-255,5738,131751,92,241327
24265,0.001737,172.31.47.0-255,66,131817,92,241327
24266,0.001745,74.125.24.0-255,7156,138973,92,241327
24267,0.001747,172.31.47.0-255,66,139039,92,241327
24268,0.001787,74.125.24.0-255,5738,144777,92,241327
24269,0.00179,172.31.47.0-255,66,144843,92,241327
24270,0.001798,74.125.24.0-255,7156,151999,92,241327
24271,0.0018,172.31.47.0-255,66,152065,92,241327
24272,0.001805,74.125.24.0-255,3602,155667,92,241327
24273,0.001807,172.31.47.0-255,66,155733,92,241327
24274,0.001837,74.125.24.0-255,1484,157217,92,241327
24275,0.001849,74.125.24.0-255,2902,160119,92,241327
24276,0.001852,172.31.47.0-255,66,160185,92,241327
24277,0.001857,74.125.24.0-255,4320,164505,92,241327
24278,0.001859,172.31.47.0-255,66,164571,92,241327
24279,0.001893,172.31.47.0-255,66,164637,92,241327
24280,0.001936,172.31.47.0-255,66,164703,92,241327
24281,0.001967,74.125.24.0-255,1484,166187,92,241327
24282,0.001983,74.125.24.0-255,2902,169089,92,241327
24283,0.001986,172.31.47.0-255,66,169155,92,241327
24284,0.001993,74.125.24.0-255,5738,174893,92,241327
24285,0.001995,172.31.47.0-255,66,174959,92,241327
24286,0.002033,74.125.24.0-255,7156,182115,92,241327
24287,0.002036,172.31.47.0-255,66,182181,92,241327
24288,0.002055,172.31.47.0-255,66,182247,92,241327
24289,0.002059,74.125.24.0-255,2184,184431,92,241327
24290,0.00206,172.31.47.0-255,66,184497,92,241327
24291,0.002105,74.125.24.0-255,2902,187399,92,241327
24292,0.002108,172.31.47.0-255,66,187465,92,241327
24293,0.002116,74.125.24.0-255,7156,194621,92,241327
24294,0.002118,172.31.47.0-255,66,194687,92,241327
24295,0.002124,74.125.24.0-255,5738,200425,92,241327
24296,0.002126,172.31.47.0-255,66,200491,92,241327
24297,0.002172,172.31.47.0-255,66,200557,92,241327
24298,0.002204,74.125.24.0-255,5738,206295,92,241327
24299,0.002207,172.31.47.0-255,66,206361,92,241327
24300,0.002212,74.125.24.0-255,3602,209963,92,241327
24301,0.002215,172.31.47.0-255,66,210029,92,241327
24302,0.00222,74.125.24.0-255,4320,214349,92,241327
24303,0.002222,172.31.47.0-255,66,214415,92,241327
24304,0.002227,74.125.24.0-255,2902,217317,92,241327
24305,0.002229,172.31.47.0-255,66,217383,92,241327
24306,0.00224,172.31.47.0-255,66,217449,92,241327
24307,0.002285,172.31.47.0-255,66,217515,92,241327
24308,0.002349,74.125.24.0-255,1484,218999,92,241327
24309,0.002369,74.125.24.0-255,2902,221901,92,241327
24310,0.002373,172.31.47.0-255,66,221967,92,241327
24311,0.002379,74.125.24.0-255,5738,227705,92,241327
24312,0.002381,172.31.47.0-255,66,227771,92,241327
24313,0.002388,74.125.24.0-255,1484,229255,92,241327
24314,0.002419,172.31.47.0-255,66,229321,92,241327
24315,0.002455,74.125.24.0-255,105,229426,92,241327
24316,0.007501,172.31.47.0-255,66,229492,92,241327
24317,0.007541,172.31.47.0-255,105,229597,92,241327
24318,0.009872,74.125.24.0-255,66,229663,92,241327
24319,0.029997,172.31.47.0-255,74,229737,92,241327
24320,0.031539,104.244.42.0-255,74,229811,92,241327
24321,0.031557,172.31.47.0-255,66,229877,92,241327
24322,0.034384,172.31.47.0-255,608,230485,92,241327
24323,0.035929,104.244.42.0-255,66,230551,92,241327
24324,0.03612,104.244.42.0-255,407,230958,92,241327
24325,0.036127,172.31.47.0-255,66,231024,92,241327
24326,0.036385,172.31.47.0-255,117,231141,92,241327
24327,0.038029,104.244.42.0-255,110,231251,92,241327
24328,0.038829,172.31.47.0-255,243,231494,92,241327
24329,0.038853,172.31.47.0-255,835,232329,92,241327
24330,0.03897,172.31.47.0-255,1514,233843,92,241327
24331,0.038972,172.31.47.0-255,1514,235357,92,241327
24332,0.038973,172.31.47.0-255,1514,236871,92,241327
24333,0.038974,172.31.47.0-255,1514,238385,92,241327
24334,0.038975,172.31.47.0-255,1514,239899,92,241327
24335,0.038978,172.31.47.0-255,1022,240921,92,241327
24336,0.039886,172.31.47.0-255,104,241025,92,241327
24337,0.040368,104.244.42.0-255,66,241091,92,241327
24338,0.04043,104.244.42.0-255,104,241195,92,241327
24339,0.040533,104.244.42.0-255,66,241261,92,241327
24340,0.041408,104.244.42.0-255,66,241327,92,241327
24341,0.0,172.217.194.0-255,153,153,92,283426
24342,3.3e-05,172.31.47.0-255,66,219,92,283426
24343,4e-05,172.217.194.0-255,1484,1703,92,283426
24344,4.4e-05,172.31.47.0-255,66,1769,92,283426
24345,4.9e-05,172.217.194.0-255,2902,4671,92,283426
24346,5.1e-05,172.31.47.0-255,66,4737,92,283426
24347,5.9e-05,172.217.194.0-255,7156,11893,92,283426
24348,6.1e-05,172.31.47.0-255,66,11959,92,283426
24349,8.5e-05,172.31.47.0-255,66,12025,92,283426
24350,0.000106,172.217.194.0-255,3546,15571,92,283426
24351,0.000108,172.31.47.0-255,66,15637,92,283426
24352,0.000145,172.217.194.0-255,6797,22434,92,283426
24353,0.000148,172.31.47.0-255,66,22500,92,283426
24354,0.000197,172.217.194.0-255,1484,23984,92,283426
24355,0.0002,172.31.47.0-255,66,24050,92,283426
24356,0.000205,172.217.194.0-255,2902,26952,92,283426
24357,0.000207,172.31.47.0-255,66,27018,92,283426
24358,0.000209,172.217.194.0-255,1484,28502,92,283426
24359,0.000211,172.31.47.0-255,66,28568,92,283426
24360,0.000224,172.217.194.0-255,4320,32888,92,283426
24361,0.000227,172.31.47.0-255,66,32954,92,283426
24362,0.000229,172.217.194.0-255,1484,34438,92,283426
24363,0.000231,172.31.47.0-255,66,34504,92,283426
24364,0.000246,172.217.194.0-255,7156,41660,92,283426
24365,0.000248,172.31.47.0-255,66,41726,92,283426
24366,0.000284,172.217.194.0-255,4320,46046,92,283426
24367,0.000288,172.31.47.0-255,66,46112,92,283426
24368,0.000318,172.31.47.0-255,66,46178,92,283426
24369,0.000393,172.217.194.0-255,367,46545,92,283426
24370,0.000396,172.31.47.0-255,66,46611,92,283426
24371,0.000628,172.217.194.0-255,1484,48095,92,283426
24372,0.000634,172.217.194.0-255,2902,50997,92,283426
24373,0.000637,172.31.47.0-255,66,51063,92,283426
24374,0.000644,172.217.194.0-255,4320,55383,92,283426
24375,0.000646,172.31.47.0-255,66,55449,92,283426
24376,0.000655,172.217.194.0-255,1484,56933,92,283426
24377,0.000669,172.217.194.0-255,5738,62671,92,283426
24378,0.000671,172.31.47.0-255,66,62737,92,283426
24379,0.000695,172.217.194.0-255,7156,69893,92,283426
24380,0.000698,172.31.47.0-255,66,69959,92,283426
24381,0.000708,172.31.47.0-255,66,70025,92,283426
24382,0.001855,172.217.194.0-255,1484,71509,92,283426
24383,0.001865,172.217.194.0-255,2902,74411,92,283426
24384,0.001868,172.31.47.0-255,66,74477,92,283426
24385,0.001891,172.217.194.0-255,5738,80215,92,283426
24386,0.001893,172.31.47.0-255,66,80281,92,283426
24387,0.001921,172.217.194.0-255,7156,87437,92,283426
24388,0.001923,172.31.47.0-255,66,87503,92,283426
24389,0.001925,172.217.194.0-255,1484,88987,92,283426
24390,0.001946,172.217.194.0-255,7156,96143,92,283426
24391,0.001948,172.31.47.0-255,66,96209,92,283426
24392,0.001953,172.217.194.0-255,5738,101947,92,283426
24393,0.001955,172.31.47.0-255,66,102013,92,283426
24394,0.001969,172.217.194.0-255,2184,104197,92,283426
24395,0.001971,172.31.47.0-255,66,104263,92,283426
24396,0.002063,172.217.194.0-255,1484,105747,92,283426
24397,0.002068,172.217.194.0-255,2902,108649,92,283426
24398,0.00207,172.31.47.0-255,66,108715,92,283426
24399,0.00209,172.217.194.0-255,2902,111617,92,283426
24400,0.002092,172.31.47.0-255,66,111683,92,283426
24401,0.002115,172.217.194.0-255,2902,114585,92,283426
24402,0.002117,172.31.47.0-255,66,114651,92,283426
24403,0.002127,172.31.47.0-255,66,114717,92,283426
24404,0.002151,172.217.194.0-255,4320,119037,92,283426
24405,0.002153,172.31.47.0-255,66,119103,92,283426
24406,0.002194,172.31.47.0-255,66,119169,92,283426
24407,0.002197,172.31.47.0-255,66,119235,92,283426
24408,0.002217,172.217.194.0-255,1484,120719,92,283426
24409,0.00224,172.31.47.0-255,66,120785,92,283426
24410,0.002269,172.31.47.0-255,66,120851,92,283426
24411,0.00232,172.31.47.0-255,66,120917,92,283426
24412,0.002344,172.31.47.0-255,66,120983,92,283426
24413,0.002359,172.217.194.0-255,5738,126721,92,283426
24414,0.002362,172.31.47.0-255,66,126787,92,283426
24415,0.00238,172.217.194.0-255,3602,130389,92,283426
24416,0.002383,172.31.47.0-255,66,130455,92,283426
24417,0.002436,172.217.194.0-255,1484,131939,92,283426
24418,0.002452,172.217.194.0-255,2902,134841,92,283426
24419,0.002455,172.31.47.0-255,66,134907,92,283426
24420,0.002458,172.217.194.0-255,1484,136391,92,283426
24421,0.002474,172.217.194.0-255,4320,140711,92,283426
24422,0.002477,172.31.47.0-255,66,140777,92,283426
24423,0.002483,172.217.194.0-255,5738,146515,92,283426
24424,0.002485,172.31.47.0-255,66,146581,92,283426
24425,0.002505,172.217.194.0-255,2902,149483,92,283426
24426,0.002508,172.31.47.0-255,66,149549,92,283426
24427,0.002545,172.31.47.0-255,66,149615,92,283426
24428,0.002551,172.217.194.0-255,5020,154635,92,283426
24429,0.002553,172.31.47.0-255,66,154701,92,283426
24430,0.002559,172.217.194.0-255,5738,160439,92,283426
24431,0.002561,172.31.47.0-255,66,160505,92,283426
24432,0.002574,172.31.47.0-255,66,160571,92,283426
24433,0.002579,172.217.194.0-255,5738,166309,92,283426
24434,0.002582,172.31.47.0-255,66,166375,92,283426
24435,0.002616,172.31.47.0-255,66,166441,92,283426
24436,0.002641,172.217.194.0-255,7156,173597,92,283426
24437,0.002645,172.31.47.0-255,66,173663,92,283426
24438,0.00268,172.31.47.0-255,66,173729,92,283426
24439,0.002701,172.217.194.0-255,5020,178749,92,283426
24440,0.002705,172.31.47.0-255,66,178815,92,283426
24441,0.002708,172.217.194.0-255,1484,180299,92,283426
24442,0.005299,172.217.194.0-255,4320,184619,92,283426
24443,0.005305,172.31.47.0-255,66,184685,92,283426
24444,0.007944,172.217.194.0-255,5738,190423,92,283426
24445,0.00795,172.31.47.0-255,66,190489,92,283426
24446,0.010587,172.217.194.0-255,5738,196227,92,283426
24447,0.010596,172.31.47.0-255,66,196293,92,283426
24448,0.013247,172.217.194.0-255,5738,202031,92,283426
24449,0.013256,172.31.47.0-255,66,202097,92,283426
24450,0.015907,172.217.194.0-255,5738,207835,92,283426
24451,0.015913,172.31.47.0-255,66,207901,92,283426
24452,0.018561,172.217.194.0-255,5738,213639,92,283426
24453,0.018573,172.31.47.0-255,66,213705,92,283426
24454,0.021201,172.217.194.0-255,4320,218025,92,283426
24455,0.02121,172.31.47.0-255,66,218091,92,283426
24456,0.02123,172.217.194.0-255,1484,219575,92,283426
24457,0.023826,172.217.194.0-255,4320,223895,92,283426
24458,0.023833,172.31.47.0-255,66,223961,92,283426
24459,0.026448,172.217.194.0-255,5738,229699,92,283426
24460,0.026456,172.31.47.0-255,66,229765,92,283426
24461,0.027676,172.31.47.0-255,172,229937,92,283426
24462,0.027712,172.31.47.0-255,1111,231048,92,283426
24463,0.027777,172.31.47.0-255,1514,232562,92,283426
24464,0.027779,172.31.47.0-255,1514,234076,92,283426
24465,0.02778,172.31.47.0-255,1514,235590,92,283426
24466,0.027781,172.31.47.0-255,1514,237104,92,283426
24467,0.02781,172.31.47.0-255,1495,238599,92,283426
24468,0.029068,172.217.194.0-255,5738,244337,92,283426
24469,0.029073,172.31.47.0-255,66,244403,92,283426
24470,0.029242,104.244.42.0-255,66,244469,92,283426
24471,0.029277,104.244.42.0-255,66,244535,92,283426
24472,0.029384,104.244.42.0-255,66,244601,92,283426
24473,0.029437,104.244.42.0-255,66,244667,92,283426
24474,0.030602,104.244.42.0-255,108,244775,92,283426
24475,0.030606,172.31.47.0-255,66,244841,92,283426
24476,0.031698,172.217.194.0-255,2902,247743,92,283426
24477,0.031702,172.31.47.0-255,66,247809,92,283426
24478,0.031724,172.217.194.0-255,2902,250711,92,283426
24479,0.031727,172.31.47.0-255,66,250777,92,283426
24480,0.034341,172.217.194.0-255,4320,255097,92,283426
24481,0.034346,172.31.47.0-255,66,255163,92,283426
24482,0.03436,172.217.194.0-255,1484,256647,92,283426
24483,0.037067,172.217.194.0-255,4320,260967,92,283426
24484,0.037072,172.31.47.0-255,66,261033,92,283426
24485,0.039691,172.217.194.0-255,2902,263935,92,283426
24486,0.039696,172.31.47.0-255,66,264001,92,283426
24487,0.039719,172.217.194.0-255,2902,266903,92,283426
24488,0.039722,172.31.47.0-255,66,266969,92,283426
24489,0.042276,172.217.194.0-255,2902,269871,92,283426
24490,0.042281,172.31.47.0-255,66,269937,92,283426
24491,0.042309,172.217.194.0-255,1484,271421,92,283426
24492,0.042321,172.217.194.0-255,1484,272905,92,283426
24493,0.042324,172.31.47.0-255,66,272971,92,283426
24494,0.044909,172.217.194.0-255,2902,275873,92,283426
24495,0.044914,172.31.47.0-255,66,275939,92,283426
24496,0.04495,172.217.194.0-255,2902,278841,92,283426
24497,0.044953,172.31.47.0-255,66,278907,92,283426
24498,0.047518,172.217.194.0-255,2902,281809,92,283426
24499,0.047523,172.31.47.0-255,66,281875,92,283426
24500,0.047556,172.217.194.0-255,1314,283189,92,283426
24501,0.048408,172.31.47.0-255,66,283255,92,283426
24502,0.048439,172.31.47.0-255,105,283360,92,283426
24503,0.051,172.217.194.0-255,66,283426,92,283426
24504,0.0,74.125.200.0-255,153,153,92,284579
24505,1.6e-05,172.31.47.0-255,66,219,92,284579
24506,2.2e-05,74.125.200.0-255,1484,1703,92,284579
24507,2.5e-05,172.31.47.0-255,66,1769,92,284579
24508,3.1e-05,74.125.200.0-255,2902,4671,92,284579
24509,3.4e-05,172.31.47.0-255,66,4737,92,284579
24510,3.7e-05,74.125.200.0-255,1484,6221,92,284579
24511,4e-05,172.31.47.0-255,66,6287,92,284579
24512,4.5e-05,74.125.200.0-255,2902,9189,92,284579
24513,4.8e-05,172.31.47.0-255,66,9255,92,284579
24514,7.2e-05,74.125.200.0-255,4320,13575,92,284579
24515,7.5e-05,172.31.47.0-255,66,13641,92,284579
24516,9.5e-05,74.125.200.0-255,2056,15697,92,284579
24517,9.6e-05,172.31.47.0-255,66,15763,92,284579
24518,0.000101,74.125.200.0-255,2902,18665,92,284579
24519,0.000103,172.31.47.0-255,66,18731,92,284579
24520,0.000105,74.125.200.0-255,1484,20215,92,284579
24521,0.000107,172.31.47.0-255,66,20281,92,284579
24522,0.000144,172.31.47.0-255,66,20347,92,284579
24523,0.000146,74.125.200.0-255,1125,21472,92,284579
24524,0.000148,172.31.47.0-255,66,21538,92,284579
24525,0.000218,74.125.200.0-255,1484,23022,92,284579
24526,0.000221,172.31.47.0-255,66,23088,92,284579
24527,0.000238,74.125.200.0-255,1484,24572,92,284579
24528,0.00024,172.31.47.0-255,66,24638,92,284579
24529,0.000244,74.125.200.0-255,2902,27540,92,284579
24530,0.000246,172.31.47.0-255,66,27606,92,284579
24531,0.000288,74.125.200.0-255,5738,33344,92,284579
24532,0.000291,172.31.47.0-255,66,33410,92,284579
24533,0.000325,74.125.200.0-255,2902,36312,92,284579
24534,0.000327,172.31.47.0-255,66,36378,92,284579
24535,0.000343,74.125.200.0-255,3961,40339,92,284579
24536,0.000346,74.125.200.0-255,1484,41823,92,284579
24537,0.00035,74.125.200.0-255,2902,44725,92,284579
24538,0.000396,74.125.200.0-255,2902,47627,92,284579
24539,0.000409,74.125.200.0-255,2902,50529,92,284579
24540,0.000421,172.31.47.0-255,66,50595,92,284579
24541,0.000448,74.125.200.0-255,5687,56282,92,284579
24542,0.000466,74.125.200.0-255,115,56397,92,284579
24543,0.000469,172.31.47.0-255,66,56463,92,284579
24544,0.000565,74.125.200.0-255,1484,57947,92,284579
24545,0.000584,74.125.200.0-255,2902,60849,92,284579
24546,0.00059,172.31.47.0-255,66,60915,92,284579
24547,0.000607,74.125.200.0-255,4320,65235,92,284579
24548,0.000614,172.31.47.0-255,66,65301,92,284579
24549,0.00064,74.125.200.0-255,2902,68203,92,284579
24550,0.000657,172.31.47.0-255,66,68269,92,284579
24551,0.000688,74.125.200.0-255,5738,74007,92,284579
24552,0.000697,172.31.47.0-255,66,74073,92,284579
24553,0.000715,74.125.200.0-255,7156,81229,92,284579
24554,0.000717,74.125.200.0-255,766,81995,92,284579
24555,0.000719,74.125.200.0-255,330,82325,92,284579
24556,0.000733,172.31.47.0-255,66,82391,92,284579
24557,0.001226,74.125.200.0-255,1484,83875,92,284579
24558,0.00123,172.31.47.0-255,66,83941,92,284579
24559,0.001244,74.125.200.0-255,2902,86843,92,284579
24560,0.001267,74.125.200.0-255,4320,91163,92,284579
24561,0.001285,172.31.47.0-255,66,91229,92,284579
24562,0.001297,74.125.200.0-255,2902,94131,92,284579
24563,0.00131,74.125.200.0-255,2902,97033,92,284579
24564,0.001324,74.125.200.0-255,4320,101353,92,284579
24565,0.001328,172.31.47.0-255,66,101419,92,284579
24566,0.001341,74.125.200.0-255,2902,104321,92,284579
24567,0.001353,74.125.200.0-255,4320,108641,92,284579
24568,0.001367,74.125.200.0-255,1484,110125,92,284579
24569,0.001373,172.31.47.0-255,66,110191,92,284579
24570,0.001383,74.125.200.0-255,4320,114511,92,284579
24571,0.001396,74.125.200.0-255,2184,116695,92,284579
24572,0.001403,172.31.47.0-255,66,116761,92,284579
24573,0.002164,74.125.200.0-255,1484,118245,92,284579
24574,0.002173,74.125.200.0-255,2902,121147,92,284579
24575,0.002177,172.31.47.0-255,66,121213,92,284579
24576,0.002197,74.125.200.0-255,5738,126951,92,284579
24577,0.00221,74.125.200.0-255,5738,132689,92,284579
24578,0.002241,74.125.200.0-255,7156,139845,92,284579
24579,0.002258,74.125.200.0-255,2902,142747,92,284579
24580,0.003762,172.31.47.0-255,66,142813,92,284579
24581,0.006132,74.125.200.0-255,5738,148551,92,284579
24582,0.006137,172.31.47.0-255,66,148617,92,284579
24583,0.008486,74.125.200.0-255,5738,154355,92,284579
24584,0.008492,172.31.47.0-255,66,154421,92,284579
24585,0.010846,74.125.200.0-255,5738,160159,92,284579
24586,0.010854,172.31.47.0-255,66,160225,92,284579
24587,0.013207,74.125.200.0-255,5738,165963,92,284579
24588,0.013214,172.31.47.0-255,66,166029,92,284579
24589,0.01557,74.125.200.0-255,4320,170349,92,284579
24590,0.01558,172.31.47.0-255,66,170415,92,284579
24591,0.0156,74.125.200.0-255,1484,171899,92,284579
24592,0.017935,74.125.200.0-255,4320,176219,92,284579
24593,0.017943,172.31.47.0-255,66,176285,92,284579
24594,0.020299,74.125.200.0-255,5738,182023,92,284579
24595,0.020335,172.31.47.0-255,66,182089,92,284579
24596,0.022693,74.125.200.0-255,5738,187827,92,284579
24597,0.022699,172.31.47.0-255,66,187893,92,284579
24598,0.025045,74.125.200.0-255,2902,190795,92,284579
24599,0.025053,172.31.47.0-255,66,190861,92,284579
24600,0.025074,74.125.200.0-255,2902,193763,92,284579
24601,0.025102,172.31.47.0-255,66,193829,92,284579
24602,0.027406,74.125.200.0-255,2902,196731,92,284579
24603,0.027413,172.31.47.0-255,66,196797,92,284579
24604,0.027434,74.125.200.0-255,1484,198281,92,284579
24605,0.027451,74.125.200.0-255,1484,199765,92,284579
24606,0.027468,172.31.47.0-255,66,199831,92,284579
24607,0.029768,74.125.200.0-255,2902,202733,92,284579
24608,0.029776,172.31.47.0-255,66,202799,92,284579
24609,0.029807,74.125.200.0-255,2902,205701,92,284579
24610,0.029858,172.31.47.0-255,66,205767,92,284579
24611,0.032119,74.125.200.0-255,1484,207251,92,284579
24612,0.032207,74.125.200.0-255,4320,211571,92,284579
24613,0.03223,172.31.47.0-255,66,211637,92,284579
24614,0.032801,172.31.47.0-255,172,211809,92,284579
24615,0.03283,172.31.47.0-255,1112,212921,92,284579
24616,0.03289,172.31.47.0-255,1514,214435,92,284579
24617,0.032892,172.31.47.0-255,1514,215949,92,284579
24618,0.032897,172.31.47.0-255,1514,217463,92,284579
24619,0.032899,172.31.47.0-255,1514,218977,92,284579
24620,0.032916,172.31.47.0-255,1494,220471,92,284579
24621,0.034336,104.244.42.0-255,66,220537,92,284579
24622,0.034353,104.244.42.0-255,66,220603,92,284579
24623,0.034458,104.244.42.0-255,66,220669,92,284579
24624,0.034463,104.244.42.0-255,66,220735,92,284579
24625,0.034589,74.125.200.0-255,5738,226473,92,284579
24626,0.034595,172.31.47.0-255,66,226539,92,284579
24627,0.036959,74.125.200.0-255,5738,232277,92,284579
24628,0.036965,172.31.47.0-255,66,232343,92,284579
24629,0.039316,74.125.200.0-255,5738,238081,92,284579
24630,0.039322,172.31.47.0-255,66,238147,92,284579
24631,0.041684,74.125.200.0-255,5738,243885,92,284579
24632,0.041691,172.31.47.0-255,66,243951,92,284579
24633,0.044043,74.125.200.0-255,5738,249689,92,284579
24634,0.044049,172.31.47.0-255,66,249755,92,284579
24635,0.046415,74.125.200.0-255,5738,255493,92,284579
24636,0.046421,172.31.47.0-255,66,255559,92,284579
24637,0.048777,74.125.200.0-255,5738,261297,92,284579
24638,0.048783,172.31.47.0-255,66,261363,92,284579
24639,0.051139,74.125.200.0-255,5738,267101,92,284579
24640,0.051144,172.31.47.0-255,66,267167,92,284579
24641,0.053508,74.125.200.0-255,5738,272905,92,284579
24642,0.053514,172.31.47.0-255,66,272971,92,284579
24643,0.055874,74.125.200.0-255,5738,278709,92,284579
24644,0.05588,172.31.47.0-255,66,278775,92,284579
24645,0.058236,74.125.200.0-255,5738,284513,92,284579
24646,0.058241,172.31.47.0-255,66,284579,92,284579
24647,0.0,172.217.194.0-255,153,153,92,317664
24648,1.5e-05,172.31.47.0-255,66,219,92,317664
24649,2e-05,172.217.194.0-255,1484,1703,92,317664
24650,2.6e-05,172.31.47.0-255,66,1769,92,317664
24651,3.9e-05,172.217.194.0-255,2902,4671,92,317664
24652,4.2e-05,172.31.47.0-255,66,4737,92,317664
24653,4.9e-05,172.217.194.0-255,7156,11893,92,317664
24654,5.2e-05,172.31.47.0-255,66,11959,92,317664
24655,5.6e-05,172.217.194.0-255,2013,13972,92,317664
24656,5.8e-05,172.31.47.0-255,66,14038,92,317664
24657,0.0001,172.31.47.0-255,66,14104,92,317664
24658,0.000104,172.217.194.0-255,2902,17006,92,317664
24659,0.000106,172.31.47.0-255,66,17072,92,317664
24660,0.000143,172.31.47.0-255,66,17138,92,317664
24661,0.000196,172.217.194.0-255,6438,23576,92,317664
24662,0.0002,172.31.47.0-255,66,23642,92,317664
24663,0.000617,172.217.194.0-255,1484,25126,92,317664
24664,0.000623,172.31.47.0-255,66,25192,92,317664
24665,0.00063,172.217.194.0-255,2902,28094,92,317664
24666,0.000632,172.31.47.0-255,66,28160,92,317664
24667,0.000635,172.217.194.0-255,1484,29644,92,317664
24668,0.000644,172.31.47.0-255,66,29710,92,317664
24669,0.00068,172.217.194.0-255,4320,34030,92,317664
24670,0.000683,172.31.47.0-255,66,34096,92,317664
24671,0.00069,172.217.194.0-255,6797,40893,92,317664
24672,0.000692,172.31.47.0-255,66,40959,92,317664
24673,0.000726,172.217.194.0-255,7156,48115,92,317664
24674,0.000739,172.31.47.0-255,66,48181,92,317664
24675,0.000742,172.31.47.0-255,66,48247,92,317664
24676,0.000771,172.217.194.0-255,1705,49952,92,317664
24677,0.000774,172.31.47.0-255,66,50018,92,317664
24678,0.000811,172.217.194.0-255,2902,52920,92,317664
24679,0.000834,172.217.194.0-255,5738,58658,92,317664
24680,0.000839,172.31.47.0-255,66,58724,92,317664
24681,0.000868,172.217.194.0-255,5738,64462,92,317664
24682,0.000879,172.31.47.0-255,66,64528,92,317664
24683,0.000884,172.217.194.0-255,2543,67071,92,317664
24684,0.000888,172.31.47.0-255,66,67137,92,317664
24685,0.001082,172.217.194.0-255,1484,68621,92,317664
24686,0.001089,172.217.194.0-255,2902,71523,92,317664
24687,0.001092,172.31.47.0-255,66,71589,92,317664
24688,0.001123,172.217.194.0-255,5738,77327,92,317664
24689,0.001126,172.217.194.0-255,1484,78811,92,317664
24690,0.001132,172.31.47.0-255,66,78877,92,317664
24691,0.00116,172.217.194.0-255,4816,83693,92,317664
24692,0.001168,172.31.47.0-255,66,83759,92,317664
24693,0.001191,172.217.194.0-255,1484,85243,92,317664
24694,0.001195,172.217.194.0-255,2902,88145,92,317664
24695,0.001198,172.217.194.0-255,1484,89629,92,317664
24696,0.001204,172.31.47.0-255,66,89695,92,317664
24697,0.001213,172.217.194.0-255,4320,94015,92,317664
24698,0.001237,172.217.194.0-255,5738,99753,92,317664
24699,0.00125,172.31.47.0-255,66,99819,92,317664
24700,0.001262,172.217.194.0-255,1484,101303,92,317664
24701,0.001283,172.217.194.0-255,2184,103487,92,317664
24702,0.0013,172.31.47.0-255,66,103553,92,317664
24703,0.001347,172.217.194.0-255,1484,105037,92,317664
24704,0.001368,172.217.194.0-255,2902,107939,92,317664
24705,0.001372,172.217.194.0-255,1484,109423,92,317664
24706,0.00139,172.217.194.0-255,4320,113743,92,317664
24707,0.001393,172.217.194.0-255,1484,115227,92,317664
24708,0.001411,172.217.194.0-255,5738,120965,92,317664
24709,0.001418,172.217.194.0-255,7156,128121,92,317664
24710,0.001421,172.31.47.0-255,66,128187,92,317664
24711,0.001427,172.31.47.0-255,66,128253,92,317664
24712,0.001456,172.217.194.0-255,7156,135409,92,317664
24713,0.001466,172.217.194.0-255,2184,137593,92,317664
24714,0.00147,172.217.194.0-255,2902,140495,92,317664
24715,0.001482,172.217.194.0-255,4320,144815,92,317664
24716,0.001495,172.217.194.0-255,2902,147717,92,317664
24717,0.001503,172.217.194.0-255,7156,154873,92,317664
24718,0.001508,172.31.47.0-255,66,154939,92,317664
24719,0.001535,172.217.194.0-255,5738,160677,92,317664
24720,0.001541,172.217.194.0-255,4320,164997,92,317664
24721,0.001553,172.31.47.0-255,66,165063,92,317664
24722,0.001571,172.217.194.0-255,6438,171501,92,317664
24723,0.001626,172.217.194.0-255,1484,172985,92,317664
24724,0.001692,172.217.194.0-255,4320,177305,92,317664
24725,0.001718,172.31.47.0-255,66,177371,92,317664
24726,0.002449,172.217.194.0-255,1484,178855,92,317664
24727,0.002454,172.217.194.0-255,2902,181757,92,317664
24728,0.002457,172.31.47.0-255,66,181823,92,317664
24729,0.00246,172.217.194.0-255,1484,183307,92,317664
24730,0.002492,172.217.194.0-255,4320,187627,92,317664
24731,0.002514,172.217.194.0-255,4320,191947,92,317664
24732,0.00252,172.217.194.0-255,5738,197685,92,317664
24733,0.002528,172.31.47.0-255,66,197751,92,317664
24734,0.002537,172.217.194.0-255,5020,202771,92,317664
24735,0.002541,172.31.47.0-255,66,202837,92,317664
24736,0.005193,172.217.194.0-255,1484,204321,92,317664
24737,0.005199,172.31.47.0-255,66,204387,92,317664
24738,0.005215,172.217.194.0-255,4320,208707,92,317664
24739,0.007788,172.217.194.0-255,1484,210191,92,317664
24740,0.008864,172.31.47.0-255,66,210257,92,317664
24741,0.01147,172.217.194.0-255,5738,215995,92,317664
24742,0.011479,172.31.47.0-255,66,216061,92,317664
24743,0.014087,172.217.194.0-255,5738,221799,92,317664
24744,0.014616,172.31.47.0-255,66,221865,92,317664
24745,0.017218,172.217.194.0-255,5738,227603,92,317664
24746,0.017228,172.31.47.0-255,66,227669,92,317664
24747,0.019832,172.217.194.0-255,5738,233407,92,317664
24748,0.019839,172.31.47.0-255,66,233473,92,317664
24749,0.022449,172.217.194.0-255,5738,239211,92,317664
24750,0.022458,172.31.47.0-255,66,239277,92,317664
24751,0.025038,172.217.194.0-255,5738,245015,92,317664
24752,0.025045,172.31.47.0-255,66,245081,92,317664
24753,0.02763,172.217.194.0-255,4320,249401,92,317664
24754,0.027637,172.31.47.0-255,66,249467,92,317664
24755,0.027662,172.217.194.0-255,1484,250951,92,317664
24756,0.030234,172.217.194.0-255,4320,255271,92,317664
24757,0.030241,172.31.47.0-255,66,255337,92,317664
24758,0.032843,172.217.194.0-255,5738,261075,92,317664
24759,0.033005,172.31.47.0-255,66,261141,92,317664
24760,0.033754,172.31.47.0-255,172,261313,92,317664
24761,0.03378,172.31.47.0-255,1113,262426,92,317664
24762,0.033833,172.31.47.0-255,1514,263940,92,317664
24763,0.033834,172.31.47.0-255,1514,265454,92,317664
24764,0.033835,172.31.47.0-255,1514,266968,92,317664
24765,0.033836,172.31.47.0-255,1514,268482,92,317664
24766,0.033867,172.31.47.0-255,1493,269975,92,317664
24767,0.035294,104.244.42.0-255,66,270041,92,317664
24768,0.035369,104.244.42.0-255,66,270107,92,317664
24769,0.0355,104.244.42.0-255,66,270173,92,317664
24770,0.035599,172.217.194.0-255,5738,275911,92,317664
24771,0.035604,172.31.47.0-255,66,275977,92,317664
24772,0.036066,104.244.42.0-255,108,276085,92,317664
24773,0.036071,172.31.47.0-255,66,276151,92,317664
24774,0.038205,172.217.194.0-255,5738,281889,92,317664
24775,0.03821,172.31.47.0-255,66,281955,92,317664
24776,0.040826,172.217.194.0-255,5738,287693,92,317664
24777,0.040834,172.31.47.0-255,66,287759,92,317664
24778,0.043451,172.217.194.0-255,5738,293497,92,317664
24779,0.043457,172.31.47.0-255,66,293563,92,317664
24780,0.046081,172.217.194.0-255,5738,299301,92,317664
24781,0.046087,172.31.47.0-255,66,299367,92,317664
24782,0.048691,172.217.194.0-255,5738,305105,92,317664
24783,0.048697,172.31.47.0-255,66,305171,92,317664
24784,0.051311,172.217.194.0-255,5738,310909,92,317664
24785,0.051318,172.31.47.0-255,66,310975,92,317664
24786,0.053929,172.217.194.0-255,5738,316713,92,317664
24787,0.053935,172.31.47.0-255,66,316779,92,317664
24788,0.056513,172.217.194.0-255,648,317427,92,317664
24789,0.056627,172.31.47.0-255,66,317493,92,317664
24790,0.056658,172.31.47.0-255,105,317598,92,317664
24791,0.05922,172.217.194.0-255,66,317664,92,317664
24792,0.0,74.125.200.0-255,153,153,92,289255
24793,2.5e-05,172.31.47.0-255,66,219,92,289255
24794,3.3e-05,74.125.200.0-255,1484,1703,92,289255
24795,3.8e-05,172.31.47.0-255,66,1769,92,289255
24796,4.4e-05,74.125.200.0-255,2902,4671,92,289255
24797,4.7e-05,172.31.47.0-255,66,4737,92,289255
24798,5.3e-05,74.125.200.0-255,4320,9057,92,289255
24799,5.6e-05,172.31.47.0-255,66,9123,92,289255
24800,6.3e-05,74.125.200.0-255,4898,14021,92,289255
24801,6.6e-05,172.31.47.0-255,66,14087,92,289255
24802,9.2e-05,74.125.200.0-255,5738,19825,92,289255
24803,9.4e-05,172.31.47.0-255,66,19891,92,289255
24804,0.000116,74.125.200.0-255,5738,25629,92,289255
24805,0.000118,172.31.47.0-255,66,25695,92,289255
24806,0.000136,74.125.200.0-255,1484,27179,92,289255
24807,0.000138,172.31.47.0-255,66,27245,92,289255
24808,0.000156,74.125.200.0-255,3961,31206,92,289255
24809,0.000159,172.31.47.0-255,66,31272,92,289255
24810,0.00019,74.125.200.0-255,1484,32756,92,289255
24811,0.000192,172.31.47.0-255,66,32822,92,289255
24812,0.000197,74.125.200.0-255,2902,35724,92,289255
24813,0.000199,172.31.47.0-255,66,35790,92,289255
24814,0.000228,74.125.200.0-255,5738,41528,92,289255
24815,0.000231,172.31.47.0-255,66,41594,92,289255
24816,0.000234,74.125.200.0-255,1484,43078,92,289255
24817,0.000236,172.31.47.0-255,66,43144,92,289255
24818,0.000255,74.125.200.0-255,5738,48882,92,289255
24819,0.000258,172.31.47.0-255,66,48948,92,289255
24820,0.000263,74.125.200.0-255,4320,53268,92,289255
24821,0.000265,172.31.47.0-255,66,53334,92,289255
24822,0.000289,74.125.200.0-255,4320,57654,92,289255
24823,0.000291,172.31.47.0-255,66,57720,92,289255
24824,0.000298,74.125.200.0-255,5738,63458,92,289255
24825,0.0003,172.31.47.0-255,66,63524,92,289255
24826,0.000325,74.125.200.0-255,2184,65708,92,289255
24827,0.000327,172.31.47.0-255,66,65774,92,289255
24828,0.00033,74.125.200.0-255,396,66170,92,289255
24829,0.000332,172.31.47.0-255,66,66236,92,289255
24830,0.000352,74.125.200.0-255,114,66350,92,289255
24831,0.000355,172.31.47.0-255,66,66416,92,289255
24832,0.000569,74.125.200.0-255,1484,67900,92,289255
24833,0.000575,172.31.47.0-255,66,67966,92,289255
24834,0.000581,74.125.200.0-255,2902,70868,92,289255
24835,0.000584,172.31.47.0-255,66,70934,92,289255
24836,0.000607,74.125.200.0-255,2902,73836,92,289255
24837,0.00061,172.31.47.0-255,66,73902,92,289255
24838,0.000613,74.125.200.0-255,1484,75386,92,289255
24839,0.000616,172.31.47.0-255,66,75452,92,289255
24840,0.000632,74.125.200.0-255,2902,78354,92,289255
24841,0.000635,172.31.47.0-255,66,78420,92,289255
24842,0.000671,172.31.47.0-255,66,78486,92,289255
24843,0.000703,74.125.200.0-255,7156,85642,92,289255
24844,0.000705,172.31.47.0-255,66,85708,92,289255
24845,0.000728,74.125.200.0-255,2902,88610,92,289255
24846,0.000731,172.31.47.0-255,66,88676,92,289255
24847,0.000736,74.125.200.0-255,3602,92278,92,289255
24848,0.000739,172.31.47.0-255,66,92344,92,289255
24849,0.000741,74.125.200.0-255,329,92673,92,289255
24850,0.001503,172.31.47.0-255,66,92739,92,289255
24851,0.001996,74.125.200.0-255,1484,94223,92,289255
24852,0.002005,74.125.200.0-255,1484,95707,92,289255
24853,0.00201,172.31.47.0-255,66,95773,92,289255
24854,0.002014,74.125.200.0-255,1484,97257,92,289255
24855,0.002029,74.125.200.0-255,1484,98741,92,289255
24856,0.002031,172.31.47.0-255,66,98807,92,289255
24857,0.002036,74.125.200.0-255,2902,101709,92,289255
24858,0.002038,172.31.47.0-255,66,101775,92,289255
24859,0.002052,74.125.200.0-255,2902,104677,92,289255
24860,0.002054,172.31.47.0-255,66,104743,92,289255
24861,0.00208,172.31.47.0-255,66,104809,92,289255
24862,0.002091,172.31.47.0-255,66,104875,92,289255
24863,0.002103,74.125.200.0-255,1484,106359,92,289255
24864,0.002109,74.125.200.0-255,3602,109961,92,289255
24865,0.002111,172.31.47.0-255,66,110027,92,289255
24866,0.002235,74.125.200.0-255,1484,111511,92,289255
24867,0.002258,74.125.200.0-255,2902,114413,92,289255
24868,0.002262,172.31.47.0-255,66,114479,92,289255
24869,0.002265,74.125.200.0-255,1484,115963,92,289255
24870,0.00227,74.125.200.0-255,2902,118865,92,289255
24871,0.002272,172.31.47.0-255,66,118931,92,289255
24872,0.002295,74.125.200.0-255,5738,124669,92,289255
24873,0.002297,172.31.47.0-255,66,124735,92,289255
24874,0.002313,74.125.200.0-255,5738,130473,92,289255
24875,0.002315,172.31.47.0-255,66,130539,92,289255
24876,0.002338,74.125.200.0-255,4320,134859,92,289255
24877,0.00234,172.31.47.0-255,66,134925,92,289255
24878,0.002348,74.125.200.0-255,7156,142081,92,289255
24879,0.00235,172.31.47.0-255,66,142147,92,289255
24880,0.004653,74.125.200.0-255,5738,147885,92,289255
24881,0.004659,172.31.47.0-255,66,147951,92,289255
24882,0.006967,74.125.200.0-255,5738,153689,92,289255
24883,0.006974,172.31.47.0-255,66,153755,92,289255
24884,0.009316,74.125.200.0-255,5738,159493,92,289255
24885,0.009328,172.31.47.0-255,66,159559,92,289255
24886,0.011631,74.125.200.0-255,5738,165297,92,289255
24887,0.011641,172.31.47.0-255,66,165363,92,289255
24888,0.01396,74.125.200.0-255,5738,171101,92,289255
24889,0.013975,172.31.47.0-255,66,171167,92,289255
24890,0.016298,74.125.200.0-255,5738,176905,92,289255
24891,0.016319,172.31.47.0-255,66,176971,92,289255
24892,0.018637,74.125.200.0-255,5738,182709,92,289255
24893,0.018653,172.31.47.0-255,66,182775,92,289255
24894,0.020967,74.125.200.0-255,5738,188513,92,289255
24895,0.020984,172.31.47.0-255,66,188579,92,289255
24896,0.023304,74.125.200.0-255,5738,194317,92,289255
24897,0.023317,172.31.47.0-255,66,194383,92,289255
24898,0.025635,74.125.200.0-255,5738,200121,92,289255
24899,0.02565,172.31.47.0-255,66,200187,92,289255
24900,0.027966,74.125.200.0-255,5738,205925,92,289255
24901,0.02798,172.31.47.0-255,66,205991,92,289255
24902,0.030303,74.125.200.0-255,5738,211729,92,289255
24903,0.03032,172.31.47.0-255,66,211795,92,289255
24904,0.032651,74.125.200.0-255,5738,217533,92,289255
24905,0.032668,172.31.47.0-255,66,217599,92,289255
24906,0.034963,74.125.200.0-255,2902,220501,92,289255
24907,0.034975,172.31.47.0-255,66,220567,92,289255
24908,0.034993,74.125.200.0-255,2902,223469,92,289255
24909,0.034996,172.31.47.0-255,66,223535,92,289255
24910,0.035428,172.31.47.0-255,172,223707,92,289255
24911,0.03546,172.31.47.0-255,1107,224814,92,289255
24912,0.035539,172.31.47.0-255,1514,226328,92,289255
24913,0.035541,172.31.47.0-255,1514,227842,92,289255
24914,0.035546,172.31.47.0-255,1514,229356,92,289255
24915,0.035547,172.31.47.0-255,1514,230870,92,289255
24916,0.035564,172.31.47.0-255,1499,232369,92,289255
24917,0.036943,104.244.42.0-255,66,232435,92,289255
24918,0.036984,104.244.42.0-255,66,232501,92,289255
24919,0.037095,104.244.42.0-255,66,232567,92,289255
24920,0.03727,74.125.200.0-255,4320,236887,92,289255
24921,0.037278,172.31.47.0-255,66,236953,92,289255
24922,0.037296,74.125.200.0-255,1484,238437,92,289255
24923,0.039577,74.125.200.0-255,4320,242757,92,289255
24924,0.039585,172.31.47.0-255,66,242823,92,289255
24925,0.041891,74.125.200.0-255,5738,248561,92,289255
24926,0.041897,172.31.47.0-255,66,248627,92,289255
24927,0.04423,74.125.200.0-255,5738,254365,92,289255
24928,0.044238,172.31.47.0-255,66,254431,92,289255
24929,0.046553,74.125.200.0-255,5738,260169,92,289255
24930,0.046566,172.31.47.0-255,66,260235,92,289255
24931,0.048918,74.125.200.0-255,5738,265973,92,289255
24932,0.048926,172.31.47.0-255,66,266039,92,289255
24933,0.051264,74.125.200.0-255,5738,271777,92,289255
24934,0.051271,172.31.47.0-255,66,271843,92,289255
24935,0.053577,74.125.200.0-255,5738,277581,92,289255
24936,0.053584,172.31.47.0-255,66,277647,92,289255
24937,0.055882,74.125.200.0-255,5738,283385,92,289255
24938,0.055889,172.31.47.0-255,66,283451,92,289255
24939,0.058195,74.125.200.0-255,5738,289189,92,289255
24940,0.058201,172.31.47.0-255,66,289255,92,289255
24941,0.0,172.217.194.0-255,153,153,92,274110
24942,2.6e-05,172.31.47.0-255,66,219,92,274110
24943,3.2e-05,172.217.194.0-255,1484,1703,92,274110
24944,3.6e-05,172.31.47.0-255,66,1769,92,274110
24945,4e-05,172.217.194.0-255,2902,4671,92,274110
24946,4.2e-05,172.31.47.0-255,66,4737,92,274110
24947,5.6e-05,172.217.194.0-255,2902,7639,92,274110
24948,5.8e-05,172.31.47.0-255,66,7705,92,274110
24949,7e-05,172.217.194.0-255,2902,10607,92,274110
24950,7.2e-05,172.31.47.0-255,66,10673,92,274110
24951,8.3e-05,172.217.194.0-255,1484,12157,92,274110
24952,8.4e-05,172.31.47.0-255,66,12223,92,274110
24953,0.000105,172.217.194.0-255,2902,15125,92,274110
24954,0.000107,172.31.47.0-255,66,15191,92,274110
24955,0.000134,172.31.47.0-255,66,15257,92,274110
24956,0.000151,172.217.194.0-255,3519,18776,92,274110
24957,0.000152,172.31.47.0-255,66,18842,92,274110
24958,0.000174,172.217.194.0-255,2543,21385,92,274110
24959,0.000176,172.31.47.0-255,66,21451,92,274110
24960,0.000179,172.217.194.0-255,1484,22935,92,274110
24961,0.00018,172.31.47.0-255,66,23001,92,274110
24962,0.000196,172.217.194.0-255,1484,24485,92,274110
24963,0.000198,172.31.47.0-255,66,24551,92,274110
24964,0.000226,172.217.194.0-255,5738,30289,92,274110
24965,0.000229,172.31.47.0-255,66,30355,92,274110
24966,0.000234,172.217.194.0-255,7156,37511,92,274110
24967,0.000236,172.31.47.0-255,66,37577,92,274110
24968,0.000268,172.31.47.0-255,66,37643,92,274110
24969,0.000272,172.217.194.0-255,3602,41245,92,274110
24970,0.000273,172.31.47.0-255,66,41311,92,274110
24971,0.000276,172.217.194.0-255,710,42021,92,274110
24972,0.000409,172.217.194.0-255,1484,43505,92,274110
24973,0.000413,172.31.47.0-255,66,43571,92,274110
24974,0.000417,172.217.194.0-255,2902,46473,92,274110
24975,0.000419,172.31.47.0-255,66,46539,92,274110
24976,0.000432,172.217.194.0-255,4320,50859,92,274110
24977,0.000434,172.31.47.0-255,66,50925,92,274110
24978,0.000452,172.217.194.0-255,1484,52409,92,274110
24979,0.000455,172.217.194.0-255,1484,53893,92,274110
24980,0.000457,172.31.47.0-255,66,53959,92,274110
24981,0.000462,172.217.194.0-255,4320,58279,92,274110
24982,0.000463,172.31.47.0-255,66,58345,92,274110
24983,0.000478,172.217.194.0-255,4320,62665,92,274110
24984,0.00048,172.31.47.0-255,66,62731,92,274110
24985,0.000518,172.217.194.0-255,2902,65633,92,274110
24986,0.000521,172.31.47.0-255,66,65699,92,274110
24987,0.000547,172.31.47.0-255,66,65765,92,274110
24988,0.00081,172.217.194.0-255,1484,67249,92,274110
24989,0.000825,172.217.194.0-255,2902,70151,92,274110
24990,0.000828,172.31.47.0-255,66,70217,92,274110
24991,0.000857,172.217.194.0-255,4320,74537,92,274110
24992,0.000859,172.31.47.0-255,66,74603,92,274110
24993,0.000872,172.217.194.0-255,4320,78923,92,274110
24994,0.000875,172.31.47.0-255,66,78989,92,274110
24995,0.000891,172.217.194.0-255,4320,83309,92,274110
24996,0.000894,172.217.194.0-255,2902,86211,92,274110
24997,0.000895,172.31.47.0-255,66,86277,92,274110
24998,0.000898,172.31.47.0-255,66,86343,92,274110
24999,0.000904,172.217.194.0-255,4320,90663,92,274110
25000,0.000906,172.31.47.0-255,66,90729,92,274110
25001,0.000918,172.217.194.0-255,1484,92213,92,274110
25002,0.000945,172.217.194.0-255,2902,95115,92,274110
25003,0.000948,172.31.47.0-255,66,95181,92,274110
25004,0.000969,172.217.194.0-255,5020,100201,92,274110
25005,0.000972,172.31.47.0-255,66,100267,92,274110
25006,0.001023,172.217.194.0-255,1484,101751,92,274110
25007,0.001027,172.217.194.0-255,2902,104653,92,274110
25008,0.001029,172.31.47.0-255,66,104719,92,274110
25009,0.001047,172.217.194.0-255,5738,110457,92,274110
25010,0.00105,172.31.47.0-255,66,110523,92,274110
25011,0.00109,172.31.47.0-255,66,110589,92,274110
25012,0.001093,172.217.194.0-255,1484,112073,92,274110
25013,0.00111,172.217.194.0-255,7156,119229,92,274110
25014,0.001112,172.31.47.0-255,66,119295,92,274110
25015,0.001123,172.217.194.0-255,2184,121479,92,274110
25016,0.001125,172.31.47.0-255,66,121545,92,274110
25017,0.001595,172.217.194.0-255,1484,123029,92,274110
25018,0.001603,172.217.194.0-255,2902,125931,92,274110
25019,0.001606,172.31.47.0-255,66,125997,92,274110
25020,0.001625,172.217.194.0-255,2902,128899,92,274110
25021,0.001628,172.31.47.0-255,66,128965,92,274110
25022,0.001645,172.217.194.0-255,2902,131867,92,274110
25023,0.001647,172.31.47.0-255,66,131933,92,274110
25024,0.001652,172.217.194.0-255,4320,136253,92,274110
25025,0.001653,172.31.47.0-255,66,136319,92,274110
25026,0.001682,172.31.47.0-255,66,136385,92,274110
25027,0.001706,172.31.47.0-255,66,136451,92,274110
25028,0.001725,172.217.194.0-255,766,137217,92,274110
25029,0.001728,172.217.194.0-255,1484,138701,92,274110
25030,0.00173,172.31.47.0-255,66,138767,92,274110
25031,0.001733,172.217.194.0-255,1484,140251,92,274110
25032,0.001751,172.217.194.0-255,2902,143153,92,274110
25033,0.001753,172.31.47.0-255,66,143219,92,274110
25034,0.001758,172.217.194.0-255,4320,147539,92,274110
25035,0.001759,172.31.47.0-255,66,147605,92,274110
25036,0.001774,172.217.194.0-255,5738,153343,92,274110
25037,0.001777,172.31.47.0-255,66,153409,92,274110
25038,0.001779,172.217.194.0-255,1484,154893,92,274110
25039,0.001808,172.31.47.0-255,66,154959,92,274110
25040,0.001827,172.217.194.0-255,1484,156443,92,274110
25041,0.001832,172.217.194.0-255,3602,160045,92,274110
25042,0.001834,172.31.47.0-255,66,160111,92,274110
25043,0.001845,172.217.194.0-255,1484,161595,92,274110
25044,0.001856,172.217.194.0-255,2902,164497,92,274110
25045,0.001859,172.31.47.0-255,66,164563,92,274110
25046,0.001862,172.217.194.0-255,2902,167465,92,274110
25047,0.001864,172.31.47.0-255,66,167531,92,274110
25048,0.001878,172.217.194.0-255,1484,169015,92,274110
25049,0.001897,172.217.194.0-255,7156,176171,92,274110
25050,0.001899,172.31.47.0-255,66,176237,92,274110
25051,0.001917,172.217.194.0-255,2902,179139,92,274110
25052,0.001919,172.31.47.0-255,66,179205,92,274110
25053,0.001929,172.31.47.0-255,66,179271,92,274110
25054,0.001961,172.217.194.0-255,2902,182173,92,274110
25055,0.001963,172.31.47.0-255,66,182239,92,274110
25056,0.001984,172.31.47.0-255,66,182305,92,274110
25057,0.002026,172.217.194.0-255,7156,189461,92,274110
25058,0.002041,172.31.47.0-255,66,189527,92,274110
25059,0.002058,172.217.194.0-255,7156,196683,92,274110
25060,0.002061,172.31.47.0-255,66,196749,92,274110
25061,0.002065,172.217.194.0-255,4320,201069,92,274110
25062,0.002066,172.31.47.0-255,66,201135,92,274110
25063,0.002069,172.217.194.0-255,1484,202619,92,274110
25064,0.002099,172.217.194.0-255,2184,204803,92,274110
25065,0.002102,172.31.47.0-255,66,204869,92,274110
25066,0.002106,172.217.194.0-255,4320,209189,92,274110
25067,0.002108,172.31.47.0-255,66,209255,92,274110
25068,0.002113,172.217.194.0-255,5738,214993,92,274110
25069,0.002116,172.31.47.0-255,66,215059,92,274110
25070,0.002139,172.217.194.0-255,4320,219379,92,274110
25071,0.002142,172.31.47.0-255,66,219445,92,274110
25072,0.002145,172.217.194.0-255,1484,220929,92,274110
25073,0.002168,172.31.47.0-255,66,220995,92,274110
25074,0.002188,172.217.194.0-255,7156,228151,92,274110
25075,0.002191,172.31.47.0-255,66,228217,92,274110
25076,0.002209,172.217.194.0-255,766,228983,92,274110
25077,0.002256,172.217.194.0-255,1484,230467,92,274110
25078,0.002259,172.31.47.0-255,66,230533,92,274110
25079,0.002262,172.217.194.0-255,1484,232017,92,274110
25080,0.002276,172.217.194.0-255,1484,233501,92,274110
25081,0.002278,172.31.47.0-255,66,233567,92,274110
25082,0.002284,172.217.194.0-255,5738,239305,92,274110
25083,0.002286,172.31.47.0-255,66,239371,92,274110
25084,0.002322,172.31.47.0-255,66,239437,92,274110
25085,0.002325,172.217.194.0-255,1484,240921,92,274110
25086,0.002327,172.217.194.0-255,1484,242405,92,274110
25087,0.002329,172.31.47.0-255,66,242471,92,274110
25088,0.002362,172.31.47.0-255,66,242537,92,274110
25089,0.002377,172.217.194.0-255,1484,244021,92,274110
25090,0.002392,172.217.194.0-255,2902,246923,92,274110
25091,0.002395,172.31.47.0-255,66,246989,92,274110
25092,0.002398,172.217.194.0-255,1484,248473,92,274110
25093,0.0024,172.217.194.0-255,1484,249957,92,274110
25094,0.002402,172.31.47.0-255,66,250023,92,274110
25095,0.002415,172.217.194.0-255,1484,251507,92,274110
25096,0.002419,172.217.194.0-255,2902,254409,92,274110
25097,0.002421,172.31.47.0-255,66,254475,92,274110
25098,0.002455,172.217.194.0-255,2902,257377,92,274110
25099,0.002461,172.31.47.0-255,66,257443,92,274110
25100,0.002484,172.31.47.0-255,66,257509,92,274110
25101,0.002487,172.217.194.0-255,1484,258993,92,274110
25102,0.002508,172.31.47.0-255,66,259059,92,274110
25103,0.002526,172.31.47.0-255,66,259125,92,274110
25104,0.002533,172.217.194.0-255,5091,264216,92,274110
25105,0.002538,172.31.47.0-255,66,264282,92,274110
25106,0.002544,172.217.194.0-255,97,264379,92,274110
25107,0.002569,172.217.194.0-255,105,264484,92,274110
25108,0.011921,172.31.47.0-255,66,264550,92,274110
25109,0.011948,172.31.47.0-255,105,264655,92,274110
25110,0.012022,172.217.194.0-255,105,264760,92,274110
25111,0.012033,172.31.47.0-255,78,264838,92,274110
25112,0.014147,172.217.194.0-255,66,264904,92,274110
25113,0.038255,172.31.47.0-255,172,265076,92,274110
25114,0.038285,172.31.47.0-255,1106,266182,92,274110
25115,0.038338,172.31.47.0-255,1514,267696,92,274110
25116,0.03834,172.31.47.0-255,1514,269210,92,274110
25117,0.038341,172.31.47.0-255,1514,270724,92,274110
25118,0.038342,172.31.47.0-255,1514,272238,92,274110
25119,0.038343,172.31.47.0-255,1500,273738,92,274110
25120,0.039798,104.244.42.0-255,66,273804,92,274110
25121,0.039855,104.244.42.0-255,66,273870,92,274110
25122,0.039904,104.244.42.0-255,66,273936,92,274110
25123,0.040493,104.244.42.0-255,108,274044,92,274110
25124,0.040501,172.31.47.0-255,66,274110,92,274110
25125,0.0,74.125.24.0-255,153,153,92,245144
25126,2.6e-05,172.31.47.0-255,66,219,92,245144
25127,3.2e-05,74.125.24.0-255,1484,1703,92,245144
25128,3.6e-05,172.31.47.0-255,66,1769,92,245144
25129,4.8e-05,74.125.24.0-255,2902,4671,92,245144
25130,5.2e-05,172.31.47.0-255,66,4737,92,245144
25131,5.8e-05,74.125.24.0-255,7156,11893,92,245144
25132,6.1e-05,172.31.47.0-255,66,11959,92,245144
25133,8.6e-05,74.125.24.0-255,1484,13443,92,245144
25134,9.5e-05,172.31.47.0-255,66,13509,92,245144
25135,0.000128,172.31.47.0-255,66,13575,92,245144
25136,0.000134,74.125.24.0-255,5379,18954,92,245144
25137,0.000139,172.31.47.0-255,66,19020,92,245144
25138,0.00019,74.125.24.0-255,1484,20504,92,245144
25139,0.000194,172.31.47.0-255,66,20570,92,245144
25140,0.000199,74.125.24.0-255,2902,23472,92,245144
25141,0.000204,172.31.47.0-255,66,23538,92,245144
25142,0.000217,74.125.24.0-255,5738,29276,92,245144
25143,0.00022,172.31.47.0-255,66,29342,92,245144
25144,0.000256,172.31.47.0-255,66,29408,92,245144
25145,0.000262,74.125.24.0-255,4320,33728,92,245144
25146,0.000264,172.31.47.0-255,66,33794,92,245144
25147,0.000293,74.125.24.0-255,5738,39532,92,245144
25148,0.000301,172.31.47.0-255,66,39598,92,245144
25149,0.000306,74.125.24.0-255,4240,43838,92,245144
25150,0.00031,172.31.47.0-255,66,43904,92,245144
25151,0.000427,74.125.24.0-255,130,44034,92,245144
25152,0.000431,172.31.47.0-255,66,44100,92,245144
25153,0.000473,74.125.24.0-255,1484,45584,92,245144
25154,0.000478,172.31.47.0-255,66,45650,92,245144
25155,0.000485,74.125.24.0-255,2902,48552,92,245144
25156,0.000488,172.31.47.0-255,66,48618,92,245144
25157,0.000497,74.125.24.0-255,2902,51520,92,245144
25158,0.000499,172.31.47.0-255,66,51586,92,245144
25159,0.000526,74.125.24.0-255,4320,55906,92,245144
25160,0.000534,172.31.47.0-255,66,55972,92,245144
25161,0.000541,74.125.24.0-255,5379,61351,92,245144
25162,0.000544,172.31.47.0-255,66,61417,92,245144
25163,0.000568,74.125.24.0-255,2902,64319,92,245144
25164,0.000571,172.31.47.0-255,66,64385,92,245144
25165,0.000595,74.125.24.0-255,1484,65869,92,245144
25166,0.000608,74.125.24.0-255,5738,71607,92,245144
25167,0.000612,172.31.47.0-255,66,71673,92,245144
25168,0.000615,74.125.24.0-255,1484,73157,92,245144
25169,0.000643,74.125.24.0-255,5656,78813,92,245144
25170,0.000647,172.31.47.0-255,66,78879,92,245144
25171,0.000755,74.125.24.0-255,1484,80363,92,245144
25172,0.00076,74.125.24.0-255,1484,81847,92,245144
25173,0.000762,172.31.47.0-255,66,81913,92,245144
25174,0.00079,74.125.24.0-255,1484,83397,92,245144
25175,0.000797,74.125.24.0-255,5738,89135,92,245144
25176,0.0008,172.31.47.0-255,66,89201,92,245144
25177,0.000836,172.31.47.0-255,66,89267,92,245144
25178,0.000842,74.125.24.0-255,5738,95005,92,245144
25179,0.000844,172.31.47.0-255,66,95071,92,245144
25180,0.000882,74.125.24.0-255,4320,99391,92,245144
25181,0.000886,172.31.47.0-255,66,99457,92,245144
25182,0.000911,74.125.24.0-255,217,99674,92,245144
25183,0.000944,74.125.24.0-255,1484,101158,92,245144
25184,0.000947,172.31.47.0-255,66,101224,92,245144
25185,0.000952,74.125.24.0-255,2902,104126,92,245144
25186,0.000955,172.31.47.0-255,66,104192,92,245144
25187,0.000987,74.125.24.0-255,5738,109930,92,245144
25188,0.00099,172.31.47.0-255,66,109996,92,245144
25189,0.000995,74.125.24.0-255,2902,112898,92,245144
25190,0.000997,172.31.47.0-255,66,112964,92,245144
25191,0.001015,74.125.24.0-255,5738,118702,92,245144
25192,0.001018,172.31.47.0-255,66,118768,92,245144
25193,0.001043,74.125.24.0-255,4320,123088,92,245144
25194,0.001046,172.31.47.0-255,66,123154,92,245144
25195,0.001063,172.31.47.0-255,66,123220,92,245144
25196,0.001066,74.125.24.0-255,766,123986,92,245144
25197,0.001116,74.125.24.0-255,1484,125470,92,245144
25198,0.001119,172.31.47.0-255,66,125536,92,245144
25199,0.001142,74.125.24.0-255,2902,128438,92,245144
25200,0.001145,172.31.47.0-255,66,128504,92,245144
25201,0.001151,74.125.24.0-255,5738,134242,92,245144
25202,0.001154,172.31.47.0-255,66,134308,92,245144
25203,0.001228,172.31.47.0-255,66,134374,92,245144
25204,0.001231,74.125.24.0-255,1484,135858,92,245144
25205,0.001264,172.31.47.0-255,66,135924,92,245144
25206,0.001291,74.125.24.0-255,1484,137408,92,245144
25207,0.001295,74.125.24.0-255,2902,140310,92,245144
25208,0.001298,172.31.47.0-255,66,140376,92,245144
25209,0.001326,74.125.24.0-255,5738,146114,92,245144
25210,0.001329,172.31.47.0-255,66,146180,92,245144
25211,0.001349,74.125.24.0-255,4320,150500,92,245144
25212,0.001353,172.31.47.0-255,66,150566,92,245144
25213,0.001376,74.125.24.0-255,2902,153468,92,245144
25214,0.001379,172.31.47.0-255,66,153534,92,245144
25215,0.001383,74.125.24.0-255,2902,156436,92,245144
25216,0.001385,172.31.47.0-255,66,156502,92,245144
25217,0.001413,74.125.24.0-255,5738,162240,92,245144
25218,0.001416,172.31.47.0-255,66,162306,92,245144
25219,0.001426,172.31.47.0-255,66,162372,92,245144
25220,0.001455,74.125.24.0-255,1484,163856,92,245144
25221,0.00146,74.125.24.0-255,2902,166758,92,245144
25222,0.001462,172.31.47.0-255,66,166824,92,245144
25223,0.001468,74.125.24.0-255,5738,172562,92,245144
25224,0.001471,172.31.47.0-255,66,172628,92,245144
25225,0.001508,74.125.24.0-255,7156,179784,92,245144
25226,0.001513,172.31.47.0-255,66,179850,92,245144
25227,0.00154,74.125.24.0-255,5738,185588,92,245144
25228,0.001543,172.31.47.0-255,66,185654,92,245144
25229,0.001557,172.31.47.0-255,66,185720,92,245144
25230,0.00156,74.125.24.0-255,1484,187204,92,245144
25231,0.001596,172.31.47.0-255,66,187270,92,245144
25232,0.001613,172.31.47.0-255,66,187336,92,245144
25233,0.001661,172.31.47.0-255,66,187402,92,245144
25234,0.001691,172.31.47.0-255,66,187468,92,245144
25235,0.001698,74.125.24.0-255,7156,194624,92,245144
25236,0.001699,172.31.47.0-255,66,194690,92,245144
25237,0.001743,74.125.24.0-255,4320,199010,92,245144
25238,0.001747,172.31.47.0-255,66,199076,92,245144
25239,0.001785,172.31.47.0-255,66,199142,92,245144
25240,0.001809,74.125.24.0-255,1484,200626,92,245144
25241,0.001814,74.125.24.0-255,2902,203528,92,245144
25242,0.001816,172.31.47.0-255,66,203594,92,245144
25243,0.001821,74.125.24.0-255,5738,209332,92,245144
25244,0.001823,172.31.47.0-255,66,209398,92,245144
25245,0.001865,74.125.24.0-255,5738,215136,92,245144
25246,0.001869,172.31.47.0-255,66,215202,92,245144
25247,0.001896,74.125.24.0-255,7156,222358,92,245144
25248,0.001899,172.31.47.0-255,66,222424,92,245144
25249,0.001943,172.31.47.0-255,66,222490,92,245144
25250,0.00197,74.125.24.0-255,766,223256,92,245144
25251,0.001982,172.31.47.0-255,66,223322,92,245144
25252,0.001992,172.31.47.0-255,66,223388,92,245144
25253,0.002003,74.125.24.0-255,7156,230544,92,245144
25254,0.002006,172.31.47.0-255,66,230610,92,245144
25255,0.002052,172.31.47.0-255,66,230676,92,245144
25256,0.00207,172.31.47.0-255,66,230742,92,245144
25257,0.002076,74.125.24.0-255,4719,235461,92,245144
25258,0.00208,172.31.47.0-255,66,235527,92,245144
25259,0.002101,74.125.24.0-255,105,235632,92,245144
25260,0.008574,172.31.47.0-255,66,235698,92,245144
25261,0.008598,172.31.47.0-255,105,235803,92,245144
25262,0.010849,74.125.24.0-255,66,235869,92,245144
25263,0.039445,172.31.47.0-255,172,236041,92,245144
25264,0.0395,172.31.47.0-255,1111,237152,92,245144
25265,0.039721,172.31.47.0-255,1514,238666,92,245144
25266,0.039723,172.31.47.0-255,1514,240180,92,245144
25267,0.039725,172.31.47.0-255,1514,241694,92,245144
25268,0.039726,172.31.47.0-255,1514,243208,92,245144
25269,0.039753,172.31.47.0-255,1498,244706,92,245144
25270,0.040947,104.244.42.0-255,66,244772,92,245144
25271,0.041022,104.244.42.0-255,66,244838,92,245144
25272,0.041267,104.244.42.0-255,66,244904,92,245144
25273,0.041297,104.244.42.0-255,66,244970,92,245144
25274,0.042216,104.244.42.0-255,108,245078,92,245144
25275,0.04222,172.31.47.0-255,66,245144,92,245144
25276,0.0,172.31.47.0-255,105,105,92,276
25277,0.001768,157.240.13.0-255,105,210,92,276
25278,0.001781,172.31.47.0-255,66,276,92,276
25279,0.0,172.31.47.0-255,105,105,92,105
25280,0.0,74.125.24.0-255,153,153,92,248940
25281,2.9e-05,172.31.47.0-255,66,219,92,248940
25282,3.5e-05,74.125.24.0-255,1484,1703,92,248940
25283,3.9e-05,172.31.47.0-255,66,1769,92,248940
25284,4.4e-05,74.125.24.0-255,2902,4671,92,248940
25285,4.7e-05,172.31.47.0-255,66,4737,92,248940
25286,5.3e-05,74.125.24.0-255,7156,11893,92,248940
25287,5.6e-05,172.31.47.0-255,66,11959,92,248940
25288,7.2e-05,74.125.24.0-255,2254,14213,92,248940
25289,7.5e-05,172.31.47.0-255,66,14279,92,248940
25290,0.000109,74.125.24.0-255,1484,15763,92,248940
25291,0.000112,172.31.47.0-255,66,15829,92,248940
25292,0.000117,74.125.24.0-255,2902,18731,92,248940
25293,0.00012,172.31.47.0-255,66,18797,92,248940
25294,0.000125,74.125.24.0-255,4320,23117,92,248940
25295,0.000126,172.31.47.0-255,66,23183,92,248940
25296,0.00015,74.125.24.0-255,1484,24667,92,248940
25297,0.000152,172.31.47.0-255,66,24733,92,248940
25298,0.000163,74.125.24.0-255,6797,31530,92,248940
25299,0.000165,172.31.47.0-255,66,31596,92,248940
25300,0.000895,74.125.24.0-255,1484,33080,92,248940
25301,0.000901,172.31.47.0-255,66,33146,92,248940
25302,0.00091,74.125.24.0-255,2902,36048,92,248940
25303,0.000913,172.31.47.0-255,66,36114,92,248940
25304,0.000925,74.125.24.0-255,5738,41852,92,248940
25305,0.000927,172.31.47.0-255,66,41918,92,248940
25306,0.000961,74.125.24.0-255,4320,46238,92,248940
25307,0.000964,172.31.47.0-255,66,46304,92,248940
25308,0.000999,74.125.24.0-255,2543,48847,92,248940
25309,0.001002,172.31.47.0-255,66,48913,92,248940
25310,0.001016,172.31.47.0-255,66,48979,92,248940
25311,0.00102,74.125.24.0-255,2818,51797,92,248940
25312,0.001241,74.125.24.0-255,382,52179,92,248940
25313,0.001395,74.125.24.0-255,1484,53663,92,248940
25314,0.001414,74.125.24.0-255,2902,56565,92,248940
25315,0.001419,74.125.24.0-255,5738,62303,92,248940
25316,0.001432,74.125.24.0-255,1484,63787,92,248940
25317,0.001484,74.125.24.0-255,5379,69166,92,248940
25318,0.001493,74.125.24.0-255,1484,70650,92,248940
25319,0.001508,74.125.24.0-255,4320,74970,92,248940
25320,0.001532,74.125.24.0-255,1484,76454,92,248940
25321,0.001821,74.125.24.0-255,1484,77938,92,248940
25322,0.001836,74.125.24.0-255,2902,80840,92,248940
25323,0.001855,74.125.24.0-255,5738,86578,92,248940
25324,0.001881,74.125.24.0-255,4320,90898,92,248940
25325,0.001911,74.125.24.0-255,4320,95218,92,248940
25326,0.001916,74.125.24.0-255,5738,100956,92,248940
25327,0.001929,74.125.24.0-255,766,101722,92,248940
25328,0.003577,172.31.47.0-255,66,101788,92,248940
25329,0.005966,74.125.24.0-255,5738,107526,92,248940
25330,0.005974,172.31.47.0-255,66,107592,92,248940
25331,0.008288,74.125.24.0-255,5738,113330,92,248940
25332,0.008296,172.31.47.0-255,66,113396,92,248940
25333,0.010631,74.125.24.0-255,5738,119134,92,248940
25334,0.010643,172.31.47.0-255,66,119200,92,248940
25335,0.01297,74.125.24.0-255,5738,124938,92,248940
25336,0.012979,172.31.47.0-255,66,125004,92,248940
25337,0.015292,74.125.24.0-255,5738,130742,92,248940
25338,0.015301,172.31.47.0-255,66,130808,92,248940
25339,0.017648,74.125.24.0-255,5738,136546,92,248940
25340,0.017659,172.31.47.0-255,66,136612,92,248940
25341,0.019991,74.125.24.0-255,5738,142350,92,248940
25342,0.019999,172.31.47.0-255,66,142416,92,248940
25343,0.022346,74.125.24.0-255,5738,148154,92,248940
25344,0.022351,172.31.47.0-255,66,148220,92,248940
25345,0.024682,74.125.24.0-255,5738,153958,92,248940
25346,0.024688,172.31.47.0-255,66,154024,92,248940
25347,0.026995,74.125.24.0-255,5738,159762,92,248940
25348,0.027,172.31.47.0-255,66,159828,92,248940
25349,0.029334,74.125.24.0-255,5738,165566,92,248940
25350,0.029341,172.31.47.0-255,66,165632,92,248940
25351,0.031419,172.31.47.0-255,172,165804,92,248940
25352,0.031453,172.31.47.0-255,1107,166911,92,248940
25353,0.031518,172.31.47.0-255,1514,168425,92,248940
25354,0.03152,172.31.47.0-255,1514,169939,92,248940
25355,0.031521,172.31.47.0-255,1514,171453,92,248940
25356,0.031525,172.31.47.0-255,1514,172967,92,248940
25357,0.031526,172.31.47.0-255,1501,174468,92,248940
25358,0.031654,74.125.24.0-255,5738,180206,92,248940
25359,0.03166,172.31.47.0-255,66,180272,92,248940
25360,0.032913,104.244.42.0-255,66,180338,92,248940
25361,0.032937,104.244.42.0-255,66,180404,92,248940
25362,0.033047,104.244.42.0-255,66,180470,92,248940
25363,0.033633,104.244.42.0-255,108,180578,92,248940
25364,0.033637,172.31.47.0-255,66,180644,92,248940
25365,0.033986,74.125.24.0-255,5738,186382,92,248940
25366,0.033989,172.31.47.0-255,66,186448,92,248940
25367,0.036315,74.125.24.0-255,5738,192186,92,248940
25368,0.036324,172.31.47.0-255,66,192252,92,248940
25369,0.038639,74.125.24.0-255,5738,197990,92,248940
25370,0.038643,172.31.47.0-255,66,198056,92,248940
25371,0.040995,74.125.24.0-255,5738,203794,92,248940
25372,0.041,172.31.47.0-255,66,203860,92,248940
25373,0.043327,74.125.24.0-255,4320,208180,92,248940
25374,0.043332,172.31.47.0-255,66,208246,92,248940
25375,0.043356,74.125.24.0-255,1484,209730,92,248940
25376,0.045688,74.125.24.0-255,4320,214050,92,248940
25377,0.045693,172.31.47.0-255,66,214116,92,248940
25378,0.048056,74.125.24.0-255,5738,219854,92,248940
25379,0.048102,172.31.47.0-255,66,219920,92,248940
25380,0.050447,74.125.24.0-255,5738,225658,92,248940
25381,0.050453,172.31.47.0-255,66,225724,92,248940
25382,0.052799,74.125.24.0-255,5738,231462,92,248940
25383,0.052804,172.31.47.0-255,66,231528,92,248940
25384,0.055132,74.125.24.0-255,5738,237266,92,248940
25385,0.055138,172.31.47.0-255,66,237332,92,248940
25386,0.057467,74.125.24.0-255,5738,243070,92,248940
25387,0.057472,172.31.47.0-255,66,243136,92,248940
25388,0.059779,74.125.24.0-255,5738,248874,92,248940
25389,0.059785,172.31.47.0-255,66,248940,92,248940
25390,0.0,74.125.24.0-255,153,153,92,255556
25391,1.5e-05,172.31.47.0-255,66,219,92,255556
25392,3.1e-05,74.125.24.0-255,1484,1703,92,255556
25393,3.6e-05,172.31.47.0-255,66,1769,92,255556
25394,4.1e-05,74.125.24.0-255,2902,4671,92,255556
25395,4.4e-05,172.31.47.0-255,66,4737,92,255556
25396,7.7e-05,74.125.24.0-255,7156,11893,92,255556
25397,8e-05,172.31.47.0-255,66,11959,92,255556
25398,8.3e-05,74.125.24.0-255,2063,14022,92,255556
25399,8.5e-05,172.31.47.0-255,66,14088,92,255556
25400,0.000101,74.125.24.0-255,2902,16990,92,255556
25401,0.000103,172.31.47.0-255,66,17056,92,255556
25402,0.000131,172.31.47.0-255,66,17122,92,255556
25403,0.000136,74.125.24.0-255,5379,22501,92,255556
25404,0.000138,172.31.47.0-255,66,22567,92,255556
25405,0.000189,74.125.24.0-255,1484,24051,92,255556
25406,0.000192,172.31.47.0-255,66,24117,92,255556
25407,0.000196,74.125.24.0-255,2902,27019,92,255556
25408,0.000198,172.31.47.0-255,66,27085,92,255556
25409,0.000209,74.125.24.0-255,1484,28569,92,255556
25410,0.000211,172.31.47.0-255,66,28635,92,255556
25411,0.000234,74.125.24.0-255,4320,32955,92,255556
25412,0.000237,172.31.47.0-255,66,33021,92,255556
25413,0.000277,172.31.47.0-255,66,33087,92,255556
25414,0.000281,74.125.24.0-255,4320,37407,92,255556
25415,0.000283,172.31.47.0-255,66,37473,92,255556
25416,0.000304,172.31.47.0-255,66,37539,92,255556
25417,0.000326,74.125.24.0-255,445,37984,92,255556
25418,0.000328,172.31.47.0-255,66,38050,92,255556
25419,0.000423,74.125.24.0-255,329,38379,92,255556
25420,0.000675,74.125.24.0-255,1484,39863,92,255556
25421,0.000679,172.31.47.0-255,66,39929,92,255556
25422,0.000684,74.125.24.0-255,2902,42831,92,255556
25423,0.000685,172.31.47.0-255,66,42897,92,255556
25424,0.000699,74.125.24.0-255,4320,47217,92,255556
25425,0.000702,172.31.47.0-255,66,47283,92,255556
25426,0.000718,74.125.24.0-255,1484,48767,92,255556
25427,0.000759,172.31.47.0-255,66,48833,92,255556
25428,0.000779,74.125.24.0-255,2902,51735,92,255556
25429,0.000781,172.31.47.0-255,66,51801,92,255556
25430,0.0008,74.125.24.0-255,5738,57539,92,255556
25431,0.000803,172.31.47.0-255,66,57605,92,255556
25432,0.000806,74.125.24.0-255,1125,58730,92,255556
25433,0.001258,74.125.24.0-255,1484,60214,92,255556
25434,0.001264,172.31.47.0-255,66,60280,92,255556
25435,0.001269,74.125.24.0-255,2902,63182,92,255556
25436,0.001271,172.31.47.0-255,66,63248,92,255556
25437,0.001277,74.125.24.0-255,4320,67568,92,255556
25438,0.001279,172.31.47.0-255,66,67634,92,255556
25439,0.001298,74.125.24.0-255,1484,69118,92,255556
25440,0.001309,172.31.47.0-255,66,69184,92,255556
25441,0.001337,74.125.24.0-255,4320,73504,92,255556
25442,0.00134,172.31.47.0-255,66,73570,92,255556
25443,0.001351,172.31.47.0-255,66,73636,92,255556
25444,0.001373,74.125.24.0-255,1484,75120,92,255556
25445,0.001395,74.125.24.0-255,2902,78022,92,255556
25446,0.001399,172.31.47.0-255,66,78088,92,255556
25447,0.001404,74.125.24.0-255,5738,83826,92,255556
25448,0.001407,172.31.47.0-255,66,83892,92,255556
25449,0.00144,172.31.47.0-255,66,83958,92,255556
25450,0.001465,74.125.24.0-255,1484,85442,92,255556
25451,0.001483,172.31.47.0-255,66,85508,92,255556
25452,0.001518,74.125.24.0-255,4320,89828,92,255556
25453,0.001521,172.31.47.0-255,66,89894,92,255556
25454,0.001554,172.31.47.0-255,66,89960,92,255556
25455,0.001565,172.31.47.0-255,66,90026,92,255556
25456,0.001603,74.125.24.0-255,7156,97182,92,255556
25457,0.001606,172.31.47.0-255,66,97248,92,255556
25458,0.001625,74.125.24.0-255,3602,100850,92,255556
25459,0.001627,172.31.47.0-255,66,100916,92,255556
25460,0.001735,74.125.24.0-255,1484,102400,92,255556
25461,0.001739,74.125.24.0-255,1484,103884,92,255556
25462,0.001742,172.31.47.0-255,66,103950,92,255556
25463,0.001762,74.125.24.0-255,1484,105434,92,255556
25464,0.001768,74.125.24.0-255,5738,111172,92,255556
25465,0.001772,172.31.47.0-255,66,111238,92,255556
25466,0.00178,74.125.24.0-255,1484,112722,92,255556
25467,0.001801,172.31.47.0-255,66,112788,92,255556
25468,0.001804,74.125.24.0-255,1484,114272,92,255556
25469,0.001819,74.125.24.0-255,1484,115756,92,255556
25470,0.001821,172.31.47.0-255,66,115822,92,255556
25471,0.001867,74.125.24.0-255,4320,120142,92,255556
25472,0.001872,172.31.47.0-255,66,120208,92,255556
25473,0.001881,74.125.24.0-255,3602,123810,92,255556
25474,0.001884,172.31.47.0-255,66,123876,92,255556
25475,0.002014,74.125.24.0-255,1484,125360,92,255556
25476,0.002019,74.125.24.0-255,2902,128262,92,255556
25477,0.002044,172.31.47.0-255,66,128328,92,255556
25478,0.00205,74.125.24.0-255,5738,134066,92,255556
25479,0.002053,172.31.47.0-255,66,134132,92,255556
25480,0.002058,74.125.24.0-255,4320,138452,92,255556
25481,0.00206,172.31.47.0-255,66,138518,92,255556
25482,0.002084,74.125.24.0-255,2902,141420,92,255556
25483,0.002087,172.31.47.0-255,66,141486,92,255556
25484,0.002101,172.31.47.0-255,66,141552,92,255556
25485,0.002104,74.125.24.0-255,2184,143736,92,255556
25486,0.002106,172.31.47.0-255,66,143802,92,255556
25487,0.00262,74.125.24.0-255,1484,145286,92,255556
25488,0.00264,74.125.24.0-255,2902,148188,92,255556
25489,0.002644,172.31.47.0-255,66,148254,92,255556
25490,0.00265,74.125.24.0-255,5738,153992,92,255556
25491,0.002651,172.31.47.0-255,66,154058,92,255556
25492,0.0027,74.125.24.0-255,4320,158378,92,255556
25493,0.002702,172.31.47.0-255,66,158444,92,255556
25494,0.002707,74.125.24.0-255,5738,164182,92,255556
25495,0.002709,172.31.47.0-255,66,164248,92,255556
25496,0.002718,172.31.47.0-255,66,164314,92,255556
25497,0.002721,74.125.24.0-255,1484,165798,92,255556
25498,0.002743,74.125.24.0-255,3602,169400,92,255556
25499,0.002745,172.31.47.0-255,66,169466,92,255556
25500,0.002748,74.125.24.0-255,1484,170950,92,255556
25501,0.002765,74.125.24.0-255,5738,176688,92,255556
25502,0.002767,172.31.47.0-255,66,176754,92,255556
25503,0.00277,74.125.24.0-255,1484,178238,92,255556
25504,0.002789,74.125.24.0-255,4320,182558,92,255556
25505,0.002792,172.31.47.0-255,66,182624,92,255556
25506,0.002796,74.125.24.0-255,2902,185526,92,255556
25507,0.002797,172.31.47.0-255,66,185592,92,255556
25508,0.002819,74.125.24.0-255,4320,189912,92,255556
25509,0.002821,172.31.47.0-255,66,189978,92,255556
25510,0.002851,172.31.47.0-255,66,190044,92,255556
25511,0.002863,74.125.24.0-255,2184,192228,92,255556
25512,0.002865,172.31.47.0-255,66,192294,92,255556
25513,0.002902,74.125.24.0-255,1484,193778,92,255556
25514,0.002921,74.125.24.0-255,2902,196680,92,255556
25515,0.002923,172.31.47.0-255,66,196746,92,255556
25516,0.002945,74.125.24.0-255,4320,201066,92,255556
25517,0.002947,172.31.47.0-255,66,201132,92,255556
25518,0.002964,74.125.24.0-255,1484,202616,92,255556
25519,0.002975,172.31.47.0-255,66,202682,92,255556
25520,0.002995,74.125.24.0-255,4320,207002,92,255556
25521,0.002997,172.31.47.0-255,66,207068,92,255556
25522,0.003019,74.125.24.0-255,1484,208552,92,255556
25523,0.00304,172.31.47.0-255,66,208618,92,255556
25524,0.003364,74.125.24.0-255,1484,210102,92,255556
25525,0.003369,74.125.24.0-255,2902,213004,92,255556
25526,0.003372,172.31.47.0-255,66,213070,92,255556
25527,0.003387,74.125.24.0-255,5738,218808,92,255556
25528,0.003389,172.31.47.0-255,66,218874,92,255556
25529,0.003391,74.125.24.0-255,1484,220358,92,255556
25530,0.003422,74.125.24.0-255,1484,221842,92,255556
25531,0.003424,172.31.47.0-255,66,221908,92,255556
25532,0.003449,172.31.47.0-255,66,221974,92,255556
25533,0.003454,74.125.24.0-255,5738,227712,92,255556
25534,0.003455,172.31.47.0-255,66,227778,92,255556
25535,0.003472,74.125.24.0-255,6438,234216,92,255556
25536,0.003474,172.31.47.0-255,66,234282,92,255556
25537,0.003477,74.125.24.0-255,1484,235766,92,255556
25538,0.0035,74.125.24.0-255,4320,240086,92,255556
25539,0.003502,172.31.47.0-255,66,240152,92,255556
25540,0.00352,74.125.24.0-255,2902,243054,92,255556
25541,0.003522,172.31.47.0-255,66,243120,92,255556
25542,0.003552,172.31.47.0-255,66,243186,92,255556
25543,0.003555,74.125.24.0-255,1484,244670,92,255556
25544,0.003557,74.125.24.0-255,1154,245824,92,255556
25545,0.003558,172.31.47.0-255,66,245890,92,255556
25546,0.003587,74.125.24.0-255,105,245995,92,255556
25547,0.004567,172.31.47.0-255,105,246100,92,255556
25548,0.004733,172.31.47.0-255,90,246190,92,255556
25549,0.00474,172.31.47.0-255,66,246256,92,255556
25550,0.006531,74.125.24.0-255,66,246322,92,255556
25551,0.00669,74.125.24.0-255,66,246388,92,255556
25552,0.008348,74.125.24.0-255,66,246454,92,255556
25553,0.008356,172.31.47.0-255,66,246520,92,255556
25554,0.031881,172.31.47.0-255,176,246696,92,255556
25555,0.031924,172.31.47.0-255,1107,247803,92,255556
25556,0.032002,172.31.47.0-255,1514,249317,92,255556
25557,0.032005,172.31.47.0-255,1514,250831,92,255556
25558,0.032006,172.31.47.0-255,1514,252345,92,255556
25559,0.032007,172.31.47.0-255,1514,253859,92,255556
25560,0.032008,172.31.47.0-255,1499,255358,92,255556
25561,0.033438,104.244.42.0-255,66,255424,92,255556
25562,0.033479,104.244.42.0-255,66,255490,92,255556
25563,0.033586,104.244.42.0-255,66,255556,92,255556
25564,0.0,74.125.130.0-255,153,153,92,343443
25565,2.2e-05,172.31.47.0-255,66,219,92,343443
25566,2.8e-05,74.125.130.0-255,1484,1703,92,343443
25567,3.2e-05,172.31.47.0-255,66,1769,92,343443
25568,3.6e-05,74.125.130.0-255,2902,4671,92,343443
25569,3.9e-05,172.31.47.0-255,66,4737,92,343443
25570,6.2e-05,74.125.130.0-255,5738,10475,92,343443
25571,6.5e-05,172.31.47.0-255,66,10541,92,343443
25572,0.000101,74.125.130.0-255,6318,16859,92,343443
25573,0.000104,172.31.47.0-255,66,16925,92,343443
25574,0.000107,74.125.130.0-255,4320,21245,92,343443
25575,0.000109,172.31.47.0-255,66,21311,92,343443
25576,0.000142,74.125.130.0-255,5738,27049,92,343443
25577,0.000145,172.31.47.0-255,66,27115,92,343443
25578,0.000156,74.125.130.0-255,3961,31076,92,343443
25579,0.000158,172.31.47.0-255,66,31142,92,343443
25580,0.000301,74.125.130.0-255,1484,32626,92,343443
25581,0.000304,172.31.47.0-255,66,32692,92,343443
25582,0.000308,74.125.130.0-255,1484,34176,92,343443
25583,0.00031,172.31.47.0-255,66,34242,92,343443
25584,0.000328,74.125.130.0-255,1484,35726,92,343443
25585,0.000332,172.31.47.0-255,66,35792,92,343443
25586,0.000334,74.125.130.0-255,5738,41530,92,343443
25587,0.00034,172.31.47.0-255,66,41596,92,343443
25588,0.000369,74.125.130.0-255,6797,48393,92,343443
25589,0.000372,172.31.47.0-255,66,48459,92,343443
25590,0.000374,74.125.130.0-255,1484,49943,92,343443
25591,0.000379,172.31.47.0-255,66,50009,92,343443
25592,0.00039,74.125.130.0-255,5738,55747,92,343443
25593,0.000393,172.31.47.0-255,66,55813,92,343443
25594,0.000415,74.125.130.0-255,7156,62969,92,343443
25595,0.000418,172.31.47.0-255,66,63035,92,343443
25596,0.00044,74.125.130.0-255,1484,64519,92,343443
25597,0.000458,74.125.130.0-255,1415,65934,92,343443
25598,0.000471,172.31.47.0-255,66,66000,92,343443
25599,0.000488,74.125.130.0-255,365,66365,92,343443
25600,0.000581,74.125.130.0-255,1484,67849,92,343443
25601,0.000597,172.31.47.0-255,66,67915,92,343443
25602,0.0006,74.125.130.0-255,2902,70817,92,343443
25603,0.000603,172.31.47.0-255,66,70883,92,343443
25604,0.000616,74.125.130.0-255,2902,73785,92,343443
25605,0.000626,172.31.47.0-255,66,73851,92,343443
25606,0.000635,74.125.130.0-255,1484,75335,92,343443
25607,0.000641,74.125.130.0-255,5738,81073,92,343443
25608,0.000648,172.31.47.0-255,66,81139,92,343443
25609,0.000703,172.31.47.0-255,66,81205,92,343443
25610,0.000715,74.125.130.0-255,1484,82689,92,343443
25611,0.000735,74.125.130.0-255,6438,89127,92,343443
25612,0.000742,172.31.47.0-255,66,89193,92,343443
25613,0.000805,74.125.130.0-255,1484,90677,92,343443
25614,0.00082,74.125.130.0-255,2902,93579,92,343443
25615,0.000823,172.31.47.0-255,66,93645,92,343443
25616,0.000854,74.125.130.0-255,5738,99383,92,343443
25617,0.000863,172.31.47.0-255,66,99449,92,343443
25618,0.000875,74.125.130.0-255,2902,102351,92,343443
25619,0.000878,172.31.47.0-255,66,102417,92,343443
25620,0.000901,74.125.130.0-255,3412,105829,92,343443
25621,0.000904,172.31.47.0-255,66,105895,92,343443
25622,0.00091,74.125.130.0-255,7156,113051,92,343443
25623,0.000921,172.31.47.0-255,66,113117,92,343443
25624,0.000933,74.125.130.0-255,7156,120273,92,343443
25625,0.000944,172.31.47.0-255,66,120339,92,343443
25626,0.00096,74.125.130.0-255,2902,123241,92,343443
25627,0.000964,172.31.47.0-255,66,123307,92,343443
25628,0.000976,74.125.130.0-255,5020,128327,92,343443
25629,0.000977,172.31.47.0-255,66,128393,92,343443
25630,0.000981,172.31.47.0-255,66,128459,92,343443
25631,0.001113,74.125.130.0-255,1484,129943,92,343443
25632,0.001125,74.125.130.0-255,2902,132845,92,343443
25633,0.001128,172.31.47.0-255,66,132911,92,343443
25634,0.001147,74.125.130.0-255,4320,137231,92,343443
25635,0.00115,172.31.47.0-255,66,137297,92,343443
25636,0.001167,74.125.130.0-255,1484,138781,92,343443
25637,0.001172,74.125.130.0-255,4320,143101,92,343443
25638,0.001179,172.31.47.0-255,66,143167,92,343443
25639,0.0012,74.125.130.0-255,5738,148905,92,343443
25640,0.001204,172.31.47.0-255,66,148971,92,343443
25641,0.00121,172.31.47.0-255,66,149037,92,343443
25642,0.001238,74.125.130.0-255,2902,151939,92,343443
25643,0.001242,74.125.130.0-255,2184,154123,92,343443
25644,0.001243,172.31.47.0-255,66,154189,92,343443
25645,0.001246,172.31.47.0-255,66,154255,92,343443
25646,0.001269,74.125.130.0-255,1484,155739,92,343443
25647,0.001278,74.125.130.0-255,2902,158641,92,343443
25648,0.001292,172.31.47.0-255,66,158707,92,343443
25649,0.00132,74.125.130.0-255,5738,164445,92,343443
25650,0.001326,74.125.130.0-255,5738,170183,92,343443
25651,0.00133,172.31.47.0-255,66,170249,92,343443
25652,0.001352,74.125.130.0-255,7156,177405,92,343443
25653,0.001359,172.31.47.0-255,66,177471,92,343443
25654,0.00138,172.31.47.0-255,66,177537,92,343443
25655,0.001405,74.125.130.0-255,2184,179721,92,343443
25656,0.001417,172.31.47.0-255,66,179787,92,343443
25657,0.001421,172.31.47.0-255,66,179853,92,343443
25658,0.001448,74.125.130.0-255,2902,182755,92,343443
25659,0.001458,172.31.47.0-255,66,182821,92,343443
25660,0.001459,74.125.130.0-255,4320,187141,92,343443
25661,0.001462,172.31.47.0-255,66,187207,92,343443
25662,0.001503,74.125.130.0-255,766,187973,92,343443
25663,0.001509,172.31.47.0-255,66,188039,92,343443
25664,0.00163,74.125.130.0-255,1484,189523,92,343443
25665,0.001647,74.125.130.0-255,2902,192425,92,343443
25666,0.001651,172.31.47.0-255,66,192491,92,343443
25667,0.001658,74.125.130.0-255,5738,198229,92,343443
25668,0.001669,172.31.47.0-255,66,198295,92,343443
25669,0.001726,172.31.47.0-255,66,198361,92,343443
25670,0.001741,74.125.130.0-255,2902,201263,92,343443
25671,0.001745,172.31.47.0-255,66,201329,92,343443
25672,0.00176,172.31.47.0-255,66,201395,92,343443
25673,0.001877,74.125.130.0-255,1484,202879,92,343443
25674,0.001883,74.125.130.0-255,2902,205781,92,343443
25675,0.001886,172.31.47.0-255,66,205847,92,343443
25676,0.001911,74.125.130.0-255,1484,207331,92,343443
25677,0.001915,74.125.130.0-255,2902,210233,92,343443
25678,0.00192,74.125.130.0-255,2902,213135,92,343443
25679,0.001925,172.31.47.0-255,66,213201,92,343443
25680,0.001951,74.125.130.0-255,2902,216103,92,343443
25681,0.001959,74.125.130.0-255,7156,223259,92,343443
25682,0.00196,172.31.47.0-255,66,223325,92,343443
25683,0.001964,172.31.47.0-255,66,223391,92,343443
25684,0.001991,74.125.130.0-255,2902,226293,92,343443
25685,0.002001,172.31.47.0-255,66,226359,92,343443
25686,0.002044,172.31.47.0-255,66,226425,92,343443
25687,0.004078,74.125.130.0-255,5738,232163,92,343443
25688,0.004086,172.31.47.0-255,66,232229,92,343443
25689,0.006108,74.125.130.0-255,5738,237967,92,343443
25690,0.006114,172.31.47.0-255,66,238033,92,343443
25691,0.008142,74.125.130.0-255,5738,243771,92,343443
25692,0.008147,172.31.47.0-255,66,243837,92,343443
25693,0.010174,74.125.130.0-255,5738,249575,92,343443
25694,0.010185,172.31.47.0-255,66,249641,92,343443
25695,0.012215,74.125.130.0-255,5738,255379,92,343443
25696,0.012294,172.31.47.0-255,66,255445,92,343443
25697,0.014344,74.125.130.0-255,5738,261183,92,343443
25698,0.014354,172.31.47.0-255,66,261249,92,343443
25699,0.016384,74.125.130.0-255,5738,266987,92,343443
25700,0.016394,172.31.47.0-255,66,267053,92,343443
25701,0.018424,74.125.130.0-255,5738,272791,92,343443
25702,0.018435,172.31.47.0-255,66,272857,92,343443
25703,0.020464,74.125.130.0-255,5738,278595,92,343443
25704,0.020472,172.31.47.0-255,66,278661,92,343443
25705,0.022499,74.125.130.0-255,5738,284399,92,343443
25706,0.022507,172.31.47.0-255,66,284465,92,343443
25707,0.024536,74.125.130.0-255,5738,290203,92,343443
25708,0.024543,172.31.47.0-255,66,290269,92,343443
25709,0.026579,74.125.130.0-255,5738,296007,92,343443
25710,0.026586,172.31.47.0-255,66,296073,92,343443
25711,0.028618,74.125.130.0-255,5738,301811,92,343443
25712,0.028626,172.31.47.0-255,66,301877,92,343443
25713,0.030659,74.125.130.0-255,5738,307615,92,343443
25714,0.030667,172.31.47.0-255,66,307681,92,343443
25715,0.032701,74.125.130.0-255,5738,313419,92,343443
25716,0.032713,172.31.47.0-255,66,313485,92,343443
25717,0.034744,74.125.130.0-255,5738,319223,92,343443
25718,0.034755,172.31.47.0-255,66,319289,92,343443
25719,0.036576,172.31.47.0-255,172,319461,92,343443
25720,0.036619,172.31.47.0-255,1107,320568,92,343443
25721,0.036697,172.31.47.0-255,1514,322082,92,343443
25722,0.036721,172.31.47.0-255,1514,323596,92,343443
25723,0.036725,172.31.47.0-255,1514,325110,92,343443
25724,0.036749,172.31.47.0-255,1514,326624,92,343443
25725,0.036753,172.31.47.0-255,1501,328125,92,343443
25726,0.036781,74.125.130.0-255,5738,333863,92,343443
25727,0.03679,172.31.47.0-255,66,333929,92,343443
25728,0.038055,104.244.42.0-255,66,333995,92,343443
25729,0.03818,104.244.42.0-255,66,334061,92,343443
25730,0.038213,104.244.42.0-255,66,334127,92,343443
25731,0.038346,104.244.42.0-255,66,334193,92,343443
25732,0.038352,104.244.42.0-255,66,334259,92,343443
25733,0.038822,74.125.130.0-255,5738,339997,92,343443
25734,0.038829,172.31.47.0-255,66,340063,92,343443
25735,0.040851,74.125.130.0-255,3143,343206,92,343443
25736,0.040872,172.31.47.0-255,66,343272,92,343443
25737,0.041034,172.31.47.0-255,105,343377,92,343443
25738,0.043034,74.125.130.0-255,66,343443,92,343443
25739,0.0,74.125.24.0-255,298,298,92,244517
25740,1.5e-05,172.31.47.0-255,66,364,92,244517
25741,2.2e-05,74.125.24.0-255,1484,1848,92,244517
25742,2.5e-05,172.31.47.0-255,66,1914,92,244517
25743,3.2e-05,74.125.24.0-255,4320,6234,92,244517
25744,4.2e-05,172.31.47.0-255,66,6300,92,244517
25745,6.2e-05,74.125.24.0-255,1484,7784,92,244517
25746,6.5e-05,172.31.47.0-255,66,7850,92,244517
25747,0.000101,74.125.24.0-255,6120,13970,92,244517
25748,0.000104,172.31.47.0-255,66,14036,92,244517
25749,0.000125,74.125.24.0-255,1484,15520,92,244517
25750,0.000127,172.31.47.0-255,66,15586,92,244517
25751,0.000131,74.125.24.0-255,2902,18488,92,244517
25752,0.000133,172.31.47.0-255,66,18554,92,244517
25753,0.000155,74.125.24.0-255,5738,24292,92,244517
25754,0.00016,172.31.47.0-255,66,24358,92,244517
25755,0.000189,74.125.24.0-255,2902,27260,92,244517
25756,0.000191,172.31.47.0-255,66,27326,92,244517
25757,0.000224,172.31.47.0-255,66,27392,92,244517
25758,0.000234,172.31.47.0-255,66,27458,92,244517
25759,0.000236,74.125.24.0-255,1125,28583,92,244517
25760,0.000242,172.31.47.0-255,66,28649,92,244517
25761,0.000267,74.125.24.0-255,1484,30133,92,244517
25762,0.000269,172.31.47.0-255,66,30199,92,244517
25763,0.000273,74.125.24.0-255,2902,33101,92,244517
25764,0.000275,172.31.47.0-255,66,33167,92,244517
25765,0.000293,74.125.24.0-255,1484,34651,92,244517
25766,0.000295,172.31.47.0-255,66,34717,92,244517
25767,0.00031,172.31.47.0-255,66,34783,92,244517
25768,0.000312,74.125.24.0-255,1125,35908,92,244517
25769,0.000313,172.31.47.0-255,66,35974,92,244517
25770,0.000355,74.125.24.0-255,442,36416,92,244517
25771,0.000358,172.31.47.0-255,66,36482,92,244517
25772,0.000467,74.125.24.0-255,331,36813,92,244517
25773,0.000648,74.125.24.0-255,1484,38297,92,244517
25774,0.000662,172.31.47.0-255,66,38363,92,244517
25775,0.000667,74.125.24.0-255,2902,41265,92,244517
25776,0.000672,172.31.47.0-255,66,41331,92,244517
25777,0.0007,74.125.24.0-255,5738,47069,92,244517
25778,0.000703,74.125.24.0-255,1484,48553,92,244517
25779,0.000711,172.31.47.0-255,66,48619,92,244517
25780,0.000743,74.125.24.0-255,2902,51521,92,244517
25781,0.000757,172.31.47.0-255,66,51587,92,244517
25782,0.000769,172.31.47.0-255,66,51653,92,244517
25783,0.000784,74.125.24.0-255,2184,53837,92,244517
25784,0.000801,172.31.47.0-255,66,53903,92,244517
25785,0.0011,74.125.24.0-255,1484,55387,92,244517
25786,0.001106,74.125.24.0-255,2902,58289,92,244517
25787,0.001109,172.31.47.0-255,66,58355,92,244517
25788,0.001154,74.125.24.0-255,2902,61257,92,244517
25789,0.001158,172.31.47.0-255,66,61323,92,244517
25790,0.00118,74.125.24.0-255,2902,64225,92,244517
25791,0.001186,74.125.24.0-255,5738,69963,92,244517
25792,0.001195,172.31.47.0-255,66,70029,92,244517
25793,0.001206,74.125.24.0-255,5738,75767,92,244517
25794,0.001219,74.125.24.0-255,1484,77251,92,244517
25795,0.001234,172.31.47.0-255,66,77317,92,244517
25796,0.001294,74.125.24.0-255,4320,81637,92,244517
25797,0.001319,74.125.24.0-255,6438,88075,92,244517
25798,0.001327,172.31.47.0-255,66,88141,92,244517
25799,0.003561,74.125.24.0-255,5738,93879,92,244517
25800,0.003567,172.31.47.0-255,66,93945,92,244517
25801,0.005846,74.125.24.0-255,5738,99683,92,244517
25802,0.005852,172.31.47.0-255,66,99749,92,244517
25803,0.008128,74.125.24.0-255,5738,105487,92,244517
25804,0.008134,172.31.47.0-255,66,105553,92,244517
25805,0.010403,74.125.24.0-255,5738,111291,92,244517
25806,0.010409,172.31.47.0-255,66,111357,92,244517
25807,0.012685,74.125.24.0-255,5738,117095,92,244517
25808,0.012691,172.31.47.0-255,66,117161,92,244517
25809,0.014938,74.125.24.0-255,5738,122899,92,244517
25810,0.014945,172.31.47.0-255,66,122965,92,244517
25811,0.017221,74.125.24.0-255,5738,128703,92,244517
25812,0.017229,172.31.47.0-255,66,128769,92,244517
25813,0.0195,74.125.24.0-255,5738,134507,92,244517
25814,0.019509,172.31.47.0-255,66,134573,92,244517
25815,0.021755,74.125.24.0-255,2902,137475,92,244517
25816,0.021762,172.31.47.0-255,66,137541,92,244517
25817,0.021787,74.125.24.0-255,2902,140443,92,244517
25818,0.021809,172.31.47.0-255,66,140509,92,244517
25819,0.024049,74.125.24.0-255,2902,143411,92,244517
25820,0.024065,172.31.47.0-255,66,143477,92,244517
25821,0.0241,74.125.24.0-255,2902,146379,92,244517
25822,0.024157,172.31.47.0-255,66,146445,92,244517
25823,0.026302,74.125.24.0-255,2902,149347,92,244517
25824,0.026314,172.31.47.0-255,66,149413,92,244517
25825,0.026388,74.125.24.0-255,2902,152315,92,244517
25826,0.026429,172.31.47.0-255,66,152381,92,244517
25827,0.028572,74.125.24.0-255,2902,155283,92,244517
25828,0.028585,172.31.47.0-255,66,155349,92,244517
25829,0.028672,74.125.24.0-255,2902,158251,92,244517
25830,0.029061,172.31.47.0-255,66,158317,92,244517
25831,0.029364,172.31.47.0-255,172,158489,92,244517
25832,0.029395,172.31.47.0-255,1107,159596,92,244517
25833,0.029473,172.31.47.0-255,1514,161110,92,244517
25834,0.029474,172.31.47.0-255,1514,162624,92,244517
25835,0.029479,172.31.47.0-255,1514,164138,92,244517
25836,0.02948,172.31.47.0-255,1514,165652,92,244517
25837,0.029498,172.31.47.0-255,1499,167151,92,244517
25838,0.030843,74.125.24.0-255,2902,170053,92,244517
25839,0.030849,172.31.47.0-255,66,170119,92,244517
25840,0.030948,104.244.42.0-255,66,170185,92,244517
25841,0.030954,104.244.42.0-255,66,170251,92,244517
25842,0.031067,104.244.42.0-255,66,170317,92,244517
25843,0.031303,74.125.24.0-255,2902,173219,92,244517
25844,0.031308,172.31.47.0-255,66,173285,92,244517
25845,0.0331,74.125.24.0-255,2902,176187,92,244517
25846,0.033105,172.31.47.0-255,66,176253,92,244517
25847,0.033557,74.125.24.0-255,2902,179155,92,244517
25848,0.033563,172.31.47.0-255,66,179221,92,244517
25849,0.035383,74.125.24.0-255,2902,182123,92,244517
25850,0.03539,172.31.47.0-255,66,182189,92,244517
25851,0.035817,74.125.24.0-255,2902,185091,92,244517
25852,0.035824,172.31.47.0-255,66,185157,92,244517
25853,0.037675,74.125.24.0-255,2902,188059,92,244517
25854,0.037682,172.31.47.0-255,66,188125,92,244517
25855,0.038117,74.125.24.0-255,2902,191027,92,244517
25856,0.038123,172.31.47.0-255,66,191093,92,244517
25857,0.039964,74.125.24.0-255,2902,193995,92,244517
25858,0.03997,172.31.47.0-255,66,194061,92,244517
25859,0.040378,74.125.24.0-255,2902,196963,92,244517
25860,0.040384,172.31.47.0-255,66,197029,92,244517
25861,0.042247,74.125.24.0-255,2902,199931,92,244517
25862,0.042252,172.31.47.0-255,66,199997,92,244517
25863,0.042653,74.125.24.0-255,2902,202899,92,244517
25864,0.042661,172.31.47.0-255,66,202965,92,244517
25865,0.044491,74.125.24.0-255,2902,205867,92,244517
25866,0.044496,172.31.47.0-255,66,205933,92,244517
25867,0.044913,74.125.24.0-255,2902,208835,92,244517
25868,0.044918,172.31.47.0-255,66,208901,92,244517
25869,0.04677,74.125.24.0-255,2902,211803,92,244517
25870,0.046776,172.31.47.0-255,66,211869,92,244517
25871,0.047201,74.125.24.0-255,2902,214771,92,244517
25872,0.047208,172.31.47.0-255,66,214837,92,244517
25873,0.04903,74.125.24.0-255,2902,217739,92,244517
25874,0.049037,172.31.47.0-255,66,217805,92,244517
25875,0.049475,74.125.24.0-255,2902,220707,92,244517
25876,0.049481,172.31.47.0-255,66,220773,92,244517
25877,0.051281,74.125.24.0-255,2902,223675,92,244517
25878,0.051287,172.31.47.0-255,66,223741,92,244517
25879,0.051776,74.125.24.0-255,2902,226643,92,244517
25880,0.051781,172.31.47.0-255,66,226709,92,244517
25881,0.053522,74.125.24.0-255,2902,229611,92,244517
25882,0.053529,172.31.47.0-255,66,229677,92,244517
25883,0.054039,74.125.24.0-255,2902,232579,92,244517
25884,0.054045,172.31.47.0-255,66,232645,92,244517
25885,0.055814,74.125.24.0-255,2902,235547,92,244517
25886,0.055819,172.31.47.0-255,66,235613,92,244517
25887,0.056305,74.125.24.0-255,2902,238515,92,244517
25888,0.056311,172.31.47.0-255,66,238581,92,244517
25889,0.058071,74.125.24.0-255,2902,241483,92,244517
25890,0.058077,172.31.47.0-255,66,241549,92,244517
25891,0.058587,74.125.24.0-255,2902,244451,92,244517
25892,0.058593,172.31.47.0-255,66,244517,92,244517
25893,0.0,172.31.47.0-255,105,105,92,270780
25894,0.001479,157.240.13.0-255,105,210,92,270780
25895,0.001491,172.31.47.0-255,66,276,92,270780
25896,0.029959,172.217.194.0-255,153,429,92,270780
25897,0.029985,172.31.47.0-255,66,495,92,270780
25898,0.029993,172.217.194.0-255,1484,1979,92,270780
25899,0.029997,172.31.47.0-255,66,2045,92,270780
25900,0.030001,172.217.194.0-255,2902,4947,92,270780
25901,0.030004,172.31.47.0-255,66,5013,92,270780
25902,0.030011,172.217.194.0-255,7156,12169,92,270780
25903,0.030013,172.31.47.0-255,66,12235,92,270780
25904,0.030017,172.217.194.0-255,2165,14400,92,270780
25905,0.030019,172.31.47.0-255,66,14466,92,270780
25906,0.03015,172.217.194.0-255,1484,15950,92,270780
25907,0.030155,172.31.47.0-255,66,16016,92,270780
25908,0.03016,172.217.194.0-255,2902,18918,92,270780
25909,0.030163,172.31.47.0-255,66,18984,92,270780
25910,0.030179,172.217.194.0-255,5738,24722,92,270780
25911,0.030182,172.31.47.0-255,66,24788,92,270780
25912,0.030211,172.217.194.0-255,4320,29108,92,270780
25913,0.030213,172.31.47.0-255,66,29174,92,270780
25914,0.030232,172.217.194.0-255,2543,31717,92,270780
25915,0.030234,172.31.47.0-255,66,31783,92,270780
25916,0.030423,172.217.194.0-255,1484,33267,92,270780
25917,0.030427,172.31.47.0-255,66,33333,92,270780
25918,0.030432,172.217.194.0-255,2902,36235,92,270780
25919,0.030437,172.31.47.0-255,66,36301,92,270780
25920,0.030462,172.217.194.0-255,5738,42039,92,270780
25921,0.030465,172.31.47.0-255,66,42105,92,270780
25922,0.030473,172.217.194.0-255,6797,48902,92,270780
25923,0.030475,172.31.47.0-255,66,48968,92,270780
25924,0.0305,172.217.194.0-255,7156,56124,92,270780
25925,0.030503,172.31.47.0-255,66,56190,92,270780
25926,0.030526,172.217.194.0-255,7156,63346,92,270780
25927,0.03053,172.31.47.0-255,66,63412,92,270780
25928,0.030534,172.217.194.0-255,2543,65955,92,270780
25929,0.030537,172.217.194.0-255,394,66349,92,270780
25930,0.03057,172.31.47.0-255,66,66415,92,270780
25931,0.030701,172.217.194.0-255,379,66794,92,270780
25932,0.030797,172.31.47.0-255,66,66860,92,270780
25933,0.031019,172.217.194.0-255,1484,68344,92,270780
25934,0.031028,172.217.194.0-255,2902,71246,92,270780
25935,0.031061,172.217.194.0-255,4320,75566,92,270780
25936,0.031082,172.217.194.0-255,1484,77050,92,270780
25937,0.031089,172.217.194.0-255,7156,84206,92,270780
25938,0.031119,172.217.194.0-255,4320,88526,92,270780
25939,0.031158,172.217.194.0-255,2184,90710,92,270780
25940,0.031252,172.217.194.0-255,1484,92194,92,270780
25941,0.031258,172.217.194.0-255,2902,95096,92,270780
25942,0.031263,172.217.194.0-255,4320,99416,92,270780
25943,0.03128,172.217.194.0-255,1484,100900,92,270780
25944,0.031284,172.217.194.0-255,4320,105220,92,270780
25945,0.031305,172.217.194.0-255,2902,108122,92,270780
25946,0.031442,172.217.194.0-255,1484,109606,92,270780
25947,0.031463,172.217.194.0-255,2902,112508,92,270780
25948,0.03147,172.217.194.0-255,5738,118246,92,270780
25949,0.031477,172.217.194.0-255,5738,123984,92,270780
25950,0.031501,172.217.194.0-255,7156,131140,92,270780
25951,0.031524,172.217.194.0-255,5738,136878,92,270780
25952,0.031527,172.217.194.0-255,1484,138362,92,270780
25953,0.031546,172.217.194.0-255,3602,141964,92,270780
25954,0.031761,172.217.194.0-255,1484,143448,92,270780
25955,0.031779,172.217.194.0-255,2902,146350,92,270780
25956,0.031802,172.217.194.0-255,5738,152088,92,270780
25957,0.031807,172.217.194.0-255,5738,157826,92,270780
25958,0.031811,172.217.194.0-255,2902,160728,92,270780
25959,0.031826,172.217.194.0-255,4320,165048,92,270780
25960,0.031846,172.217.194.0-255,1484,166532,92,270780
25961,0.031858,172.217.194.0-255,1484,168016,92,270780
25962,0.031875,172.217.194.0-255,4320,172336,92,270780
25963,0.031896,172.217.194.0-255,3602,175938,92,270780
25964,0.031927,172.217.194.0-255,1484,177422,92,270780
25965,0.031937,172.217.194.0-255,2902,180324,92,270780
25966,0.031955,172.217.194.0-255,1484,181808,92,270780
25967,0.031971,172.217.194.0-255,4320,186128,92,270780
25968,0.032014,172.217.194.0-255,4320,190448,92,270780
25969,0.032042,172.217.194.0-255,2184,192632,92,270780
25970,0.032248,172.217.194.0-255,1484,194116,92,270780
25971,0.032252,172.217.194.0-255,2902,197018,92,270780
25972,0.032272,172.217.194.0-255,5738,202756,92,270780
25973,0.032305,172.217.194.0-255,2902,205658,92,270780
25974,0.03231,172.31.47.0-255,78,205736,92,270780
25975,0.032329,172.31.47.0-255,78,205814,92,270780
25976,0.032358,172.217.194.0-255,1484,207298,92,270780
25977,0.032506,172.31.47.0-255,66,207364,92,270780
25978,0.03471,172.217.194.0-255,4320,211684,92,270780
25979,0.034716,172.31.47.0-255,66,211750,92,270780
25980,0.034835,172.217.194.0-255,1484,213234,92,270780
25981,0.037044,172.217.194.0-255,4320,217554,92,270780
25982,0.03705,172.31.47.0-255,66,217620,92,270780
25983,0.039391,172.217.194.0-255,5738,223358,92,270780
25984,0.039453,172.31.47.0-255,66,223424,92,270780
25985,0.041799,172.217.194.0-255,2902,226326,92,270780
25986,0.041807,172.31.47.0-255,66,226392,92,270780
25987,0.041831,172.217.194.0-255,2902,229294,92,270780
25988,0.042908,172.31.47.0-255,66,229360,92,270780
25989,0.044144,172.217.194.0-255,2902,232262,92,270780
25990,0.044151,172.31.47.0-255,66,232328,92,270780
25991,0.045239,172.217.194.0-255,2902,235230,92,270780
25992,0.045247,172.31.47.0-255,66,235296,92,270780
25993,0.046505,172.217.194.0-255,2902,238198,92,270780
25994,0.046513,172.31.47.0-255,66,238264,92,270780
25995,0.047588,172.217.194.0-255,2902,241166,92,270780
25996,0.047594,172.31.47.0-255,66,241232,92,270780
25997,0.048872,172.217.194.0-255,2902,244134,92,270780
25998,0.048879,172.31.47.0-255,66,244200,92,270780
25999,0.049927,172.217.194.0-255,2902,247102,92,270780
26000,0.049935,172.31.47.0-255,66,247168,92,270780
26001,0.051235,172.217.194.0-255,2902,250070,92,270780
26002,0.051241,172.31.47.0-255,66,250136,92,270780
26003,0.052252,172.217.194.0-255,2902,253038,92,270780
26004,0.052258,172.31.47.0-255,66,253104,92,270780
26005,0.053561,172.217.194.0-255,2902,256006,92,270780
26006,0.053568,172.31.47.0-255,66,256072,92,270780
26007,0.054608,172.217.194.0-255,2902,258974,92,270780
26008,0.054614,172.31.47.0-255,66,259040,92,270780
26009,0.0559,172.217.194.0-255,2902,261942,92,270780
26010,0.055907,172.31.47.0-255,66,262008,92,270780
26011,0.056935,172.217.194.0-255,2902,264910,92,270780
26012,0.056944,172.31.47.0-255,66,264976,92,270780
26013,0.05827,172.217.194.0-255,2902,267878,92,270780
26014,0.059276,172.217.194.0-255,2902,270780,92,270780
26015,0.0,74.125.24.0-255,153,153,92,259356
26016,3.4e-05,172.31.47.0-255,66,219,92,259356
26017,4.1e-05,74.125.24.0-255,1484,1703,92,259356
26018,4.6e-05,172.31.47.0-255,66,1769,92,259356
26019,5.1e-05,74.125.24.0-255,2902,4671,92,259356
26020,5.3e-05,172.31.47.0-255,66,4737,92,259356
26021,6.1e-05,74.125.24.0-255,7156,11893,92,259356
26022,6.4e-05,172.31.47.0-255,66,11959,92,259356
26023,6.8e-05,74.125.24.0-255,3463,15422,92,259356
26024,7.2e-05,172.31.47.0-255,66,15488,92,259356
26025,7.6e-05,74.125.24.0-255,2902,18390,92,259356
26026,7.9e-05,172.31.47.0-255,66,18456,92,259356
26027,0.00012,172.31.47.0-255,66,18522,92,259356
26028,0.000124,74.125.24.0-255,2543,21065,92,259356
26029,0.000126,172.31.47.0-255,66,21131,92,259356
26030,0.000175,74.125.24.0-255,1484,22615,92,259356
26031,0.000178,172.31.47.0-255,66,22681,92,259356
26032,0.000185,74.125.24.0-255,2902,25583,92,259356
26033,0.000187,172.31.47.0-255,66,25649,92,259356
26034,0.00022,74.125.24.0-255,5738,31387,92,259356
26035,0.000224,172.31.47.0-255,66,31453,92,259356
26036,0.000232,74.125.24.0-255,6797,38250,92,259356
26037,0.000235,172.31.47.0-255,66,38316,92,259356
26038,0.000241,74.125.24.0-255,2902,41218,92,259356
26039,0.000243,172.31.47.0-255,66,41284,92,259356
26040,0.000279,172.31.47.0-255,66,41350,92,259356
26041,0.000284,74.125.24.0-255,2856,44206,92,259356
26042,0.000285,172.31.47.0-255,66,44272,92,259356
26043,0.000309,74.125.24.0-255,110,44382,92,259356
26044,0.000311,172.31.47.0-255,66,44448,92,259356
26045,0.000405,74.125.24.0-255,1484,45932,92,259356
26046,0.000411,74.125.24.0-255,1484,47416,92,259356
26047,0.000414,172.31.47.0-255,66,47482,92,259356
26048,0.000434,74.125.24.0-255,1484,48966,92,259356
26049,0.000442,74.125.24.0-255,5738,54704,92,259356
26050,0.000445,172.31.47.0-255,66,54770,92,259356
26051,0.000477,74.125.24.0-255,6797,61567,92,259356
26052,0.00048,172.31.47.0-255,66,61633,92,259356
26053,0.000487,74.125.24.0-255,5738,67371,92,259356
26054,0.000489,172.31.47.0-255,66,67437,92,259356
26055,0.000503,74.125.24.0-255,1484,68921,92,259356
26056,0.000527,172.31.47.0-255,66,68987,92,259356
26057,0.000543,74.125.24.0-255,1389,70376,92,259356
26058,0.000855,74.125.24.0-255,1484,71860,92,259356
26059,0.000859,172.31.47.0-255,66,71926,92,259356
26060,0.000864,74.125.24.0-255,2902,74828,92,259356
26061,0.000865,172.31.47.0-255,66,74894,92,259356
26062,0.000869,74.125.24.0-255,2902,77796,92,259356
26063,0.000871,172.31.47.0-255,66,77862,92,259356
26064,0.000898,74.125.24.0-255,2902,80764,92,259356
26065,0.000901,172.31.47.0-255,66,80830,92,259356
26066,0.000912,172.31.47.0-255,66,80896,92,259356
26067,0.000943,74.125.24.0-255,4320,85216,92,259356
26068,0.000946,172.31.47.0-255,66,85282,92,259356
26069,0.000968,74.125.24.0-255,5888,91170,92,259356
26070,0.000971,172.31.47.0-255,66,91236,92,259356
26071,0.000986,74.125.24.0-255,1484,92720,92,259356
26072,0.000989,74.125.24.0-255,1484,94204,92,259356
26073,0.000991,172.31.47.0-255,66,94270,92,259356
26074,0.001011,74.125.24.0-255,1484,95754,92,259356
26075,0.001017,74.125.24.0-255,5738,101492,92,259356
26076,0.00102,74.125.24.0-255,2902,104394,92,259356
26077,0.001023,172.31.47.0-255,66,104460,92,259356
26078,0.001026,172.31.47.0-255,66,104526,92,259356
26079,0.001044,74.125.24.0-255,5738,110264,92,259356
26080,0.001046,172.31.47.0-255,66,110330,92,259356
26081,0.001103,172.31.47.0-255,66,110396,92,259356
26082,0.001164,74.125.24.0-255,1484,111880,92,259356
26083,0.001168,74.125.24.0-255,2902,114782,92,259356
26084,0.001172,172.31.47.0-255,66,114848,92,259356
26085,0.001179,74.125.24.0-255,1484,116332,92,259356
26086,0.001197,74.125.24.0-255,4320,120652,92,259356
26087,0.001199,172.31.47.0-255,66,120718,92,259356
26088,0.001228,172.31.47.0-255,66,120784,92,259356
26089,0.001246,74.125.24.0-255,1484,122268,92,259356
26090,0.001258,172.31.47.0-255,66,122334,92,259356
26091,0.00128,74.125.24.0-255,4320,126654,92,259356
26092,0.001283,172.31.47.0-255,66,126720,92,259356
26093,0.001302,74.125.24.0-255,2902,129622,92,259356
26094,0.001305,172.31.47.0-255,66,129688,92,259356
26095,0.001314,172.31.47.0-255,66,129754,92,259356
26096,0.001334,74.125.24.0-255,5738,135492,92,259356
26097,0.001337,172.31.47.0-255,66,135558,92,259356
26098,0.001373,172.31.47.0-255,66,135624,92,259356
26099,0.001375,74.125.24.0-255,766,136390,92,259356
26100,0.001391,74.125.24.0-255,2902,139292,92,259356
26101,0.001394,172.31.47.0-255,66,139358,92,259356
26102,0.001428,172.31.47.0-255,66,139424,92,259356
26103,0.001457,74.125.24.0-255,2902,142326,92,259356
26104,0.001461,172.31.47.0-255,66,142392,92,259356
26105,0.001494,172.31.47.0-255,66,142458,92,259356
26106,0.001519,74.125.24.0-255,1484,143942,92,259356
26107,0.001522,74.125.24.0-255,1484,145426,92,259356
26108,0.001524,172.31.47.0-255,66,145492,92,259356
26109,0.001542,74.125.24.0-255,1484,146976,92,259356
26110,0.001546,74.125.24.0-255,4320,151296,92,259356
26111,0.001549,172.31.47.0-255,66,151362,92,259356
26112,0.001569,74.125.24.0-255,1484,152846,92,259356
26113,0.001581,172.31.47.0-255,66,152912,92,259356
26114,0.001603,74.125.24.0-255,5738,158650,92,259356
26115,0.001605,172.31.47.0-255,66,158716,92,259356
26116,0.001624,74.125.24.0-255,5020,163736,92,259356
26117,0.001626,172.31.47.0-255,66,163802,92,259356
26118,0.002151,74.125.24.0-255,1484,165286,92,259356
26119,0.002163,74.125.24.0-255,2902,168188,92,259356
26120,0.002166,172.31.47.0-255,66,168254,92,259356
26121,0.002182,74.125.24.0-255,5738,173992,92,259356
26122,0.002185,172.31.47.0-255,66,174058,92,259356
26123,0.002225,172.31.47.0-255,66,174124,92,259356
26124,0.002237,172.31.47.0-255,66,174190,92,259356
26125,0.002287,74.125.24.0-255,1484,175674,92,259356
26126,0.002292,74.125.24.0-255,2902,178576,92,259356
26127,0.002295,172.31.47.0-255,66,178642,92,259356
26128,0.002301,74.125.24.0-255,5738,184380,92,259356
26129,0.002303,172.31.47.0-255,66,184446,92,259356
26130,0.002308,74.125.24.0-255,4320,188766,92,259356
26131,0.00231,172.31.47.0-255,66,188832,92,259356
26132,0.002332,172.31.47.0-255,66,188898,92,259356
26133,0.002337,74.125.24.0-255,4320,193218,92,259356
26134,0.002339,172.31.47.0-255,66,193284,92,259356
26135,0.002344,74.125.24.0-255,5738,199022,92,259356
26136,0.002347,172.31.47.0-255,66,199088,92,259356
26137,0.004713,74.125.24.0-255,5738,204826,92,259356
26138,0.004718,172.31.47.0-255,66,204892,92,259356
26139,0.007071,74.125.24.0-255,4320,209212,92,259356
26140,0.007074,172.31.47.0-255,66,209278,92,259356
26141,0.007087,74.125.24.0-255,1484,210762,92,259356
26142,0.009429,74.125.24.0-255,4320,215082,92,259356
26143,0.009435,172.31.47.0-255,66,215148,92,259356
26144,0.011943,74.125.24.0-255,5738,220886,92,259356
26145,0.011992,172.31.47.0-255,66,220952,92,259356
26146,0.014321,74.125.24.0-255,5738,226690,92,259356
26147,0.014328,172.31.47.0-255,66,226756,92,259356
26148,0.016638,74.125.24.0-255,5738,232494,92,259356
26149,0.016651,172.31.47.0-255,66,232560,92,259356
26150,0.018959,74.125.24.0-255,5738,238298,92,259356
26151,0.018967,172.31.47.0-255,66,238364,92,259356
26152,0.021297,74.125.24.0-255,5738,244102,92,259356
26153,0.021304,172.31.47.0-255,66,244168,92,259356
26154,0.023638,74.125.24.0-255,5738,249906,92,259356
26155,0.023645,172.31.47.0-255,66,249972,92,259356
26156,0.025938,74.125.24.0-255,5738,255710,92,259356
26157,0.025945,172.31.47.0-255,66,255776,92,259356
26158,0.028238,74.125.24.0-255,829,256605,92,259356
26159,0.028368,172.31.47.0-255,105,256710,92,259356
26160,0.02857,172.31.47.0-255,90,256800,92,259356
26161,0.028581,172.31.47.0-255,66,256866,92,259356
26162,0.03069,74.125.24.0-255,66,256932,92,259356
26163,0.030869,74.125.24.0-255,66,256998,92,259356
26164,0.030925,74.125.24.0-255,66,257064,92,259356
26165,0.030934,172.31.47.0-255,66,257130,92,259356
26166,0.042797,172.31.47.0-255,172,257302,92,259356
26167,0.042828,172.31.47.0-255,1112,258414,92,259356
26168,0.042859,172.31.47.0-255,570,258984,92,259356
26169,0.044344,104.244.42.0-255,66,259050,92,259356
26170,0.04438,104.244.42.0-255,66,259116,92,259356
26171,0.044384,104.244.42.0-255,66,259182,92,259356
26172,0.045077,104.244.42.0-255,108,259290,92,259356
26173,0.045083,172.31.47.0-255,66,259356,92,259356
26174,0.0,172.217.194.0-255,152,152,92,265196
26175,2.4e-05,172.31.47.0-255,66,218,92,265196
26176,3.1e-05,172.217.194.0-255,1484,1702,92,265196
26177,3.5e-05,172.31.47.0-255,66,1768,92,265196
26178,4e-05,172.217.194.0-255,2902,4670,92,265196
26179,4.2e-05,172.31.47.0-255,66,4736,92,265196
26180,4.9e-05,172.217.194.0-255,7156,11892,92,265196
26181,5.1e-05,172.31.47.0-255,66,11958,92,265196
26182,6.9e-05,172.217.194.0-255,1484,13442,92,265196
26183,7.1e-05,172.31.47.0-255,66,13508,92,265196
26184,0.000103,172.31.47.0-255,66,13574,92,265196
26185,0.000122,172.217.194.0-255,2078,15652,92,265196
26186,0.000125,172.31.47.0-255,66,15718,92,265196
26187,0.000139,172.31.47.0-255,66,15784,92,265196
26188,0.000144,172.217.194.0-255,5020,20804,92,265196
26189,0.000146,172.31.47.0-255,66,20870,92,265196
26190,0.000478,172.217.194.0-255,1484,22354,92,265196
26191,0.000485,172.31.47.0-255,66,22420,92,265196
26192,0.00049,172.217.194.0-255,2902,25322,92,265196
26193,0.000492,172.31.47.0-255,66,25388,92,265196
26194,0.000498,172.217.194.0-255,5738,31126,92,265196
26195,0.0005,172.31.47.0-255,66,31192,92,265196
26196,0.000533,172.217.194.0-255,7108,38300,92,265196
26197,0.000536,172.31.47.0-255,66,38366,92,265196
26198,0.000749,172.217.194.0-255,1484,39850,92,265196
26199,0.000753,172.31.47.0-255,66,39916,92,265196
26200,0.000767,172.217.194.0-255,2902,42818,92,265196
26201,0.00077,172.31.47.0-255,66,42884,92,265196
26202,0.000775,172.217.194.0-255,5738,48622,92,265196
26203,0.000778,172.31.47.0-255,66,48688,92,265196
26204,0.000781,172.217.194.0-255,1484,50172,92,265196
26205,0.000784,172.31.47.0-255,66,50238,92,265196
26206,0.000815,172.217.194.0-255,5738,55976,92,265196
26207,0.000818,172.31.47.0-255,66,56042,92,265196
26208,0.000842,172.217.194.0-255,7156,63198,92,265196
26209,0.000847,172.31.47.0-255,66,63264,92,265196
26210,0.000853,172.31.47.0-255,66,63330,92,265196
26211,0.000902,172.31.47.0-255,66,63396,92,265196
26212,0.000941,172.217.194.0-255,2902,66298,92,265196
26213,0.000945,172.31.47.0-255,66,66364,92,265196
26214,0.000956,172.31.47.0-255,66,66430,92,265196
26215,0.000969,172.31.47.0-255,66,66496,92,265196
26216,0.001005,172.31.47.0-255,66,66562,92,265196
26217,0.001015,172.31.47.0-255,66,66628,92,265196
26218,0.001113,172.217.194.0-255,1484,68112,92,265196
26219,0.001118,172.31.47.0-255,66,68178,92,265196
26220,0.001123,172.217.194.0-255,2902,71080,92,265196
26221,0.001126,172.31.47.0-255,66,71146,92,265196
26222,0.001179,172.217.194.0-255,5738,76884,92,265196
26223,0.00135,172.217.194.0-255,1484,78368,92,265196
26224,0.001355,172.217.194.0-255,1484,79852,92,265196
26225,0.001371,172.217.194.0-255,1484,81336,92,265196
26226,0.001387,172.217.194.0-255,4320,85656,92,265196
26227,0.001402,172.217.194.0-255,1484,87140,92,265196
26228,0.001421,172.217.194.0-255,2902,90042,92,265196
26229,0.001443,172.217.194.0-255,5738,95780,92,265196
26230,0.001455,172.217.194.0-255,1484,97264,92,265196
26231,0.001477,172.217.194.0-255,3602,100866,92,265196
26232,0.001512,172.217.194.0-255,1484,102350,92,265196
26233,0.001524,172.217.194.0-255,2902,105252,92,265196
26234,0.00154,172.217.194.0-255,1484,106736,92,265196
26235,0.001556,172.217.194.0-255,4320,111056,92,265196
26236,0.001558,172.217.194.0-255,1484,112540,92,265196
26237,0.001573,172.217.194.0-255,2902,115442,92,265196
26238,0.001578,172.217.194.0-255,4320,119762,92,265196
26239,0.001604,172.217.194.0-255,7156,126918,92,265196
26240,0.001663,172.217.194.0-255,4320,131238,92,265196
26241,0.00171,172.217.194.0-255,5738,136976,92,265196
26242,0.001727,172.217.194.0-255,3602,140578,92,265196
26243,0.005615,172.31.47.0-255,66,140644,92,265196
26244,0.008174,172.217.194.0-255,5738,146382,92,265196
26245,0.008179,172.31.47.0-255,66,146448,92,265196
26246,0.010897,172.217.194.0-255,5738,152186,92,265196
26247,0.010959,172.31.47.0-255,66,152252,92,265196
26248,0.013506,172.217.194.0-255,5738,157990,92,265196
26249,0.013513,172.31.47.0-255,66,158056,92,265196
26250,0.016034,172.217.194.0-255,5738,163794,92,265196
26251,0.016996,172.31.47.0-255,66,163860,92,265196
26252,0.019525,172.217.194.0-255,5738,169598,92,265196
26253,0.019533,172.31.47.0-255,66,169664,92,265196
26254,0.022035,172.217.194.0-255,5738,175402,92,265196
26255,0.022041,172.31.47.0-255,66,175468,92,265196
26256,0.024551,172.217.194.0-255,5738,181206,92,265196
26257,0.024558,172.31.47.0-255,66,181272,92,265196
26258,0.027094,172.217.194.0-255,5738,187010,92,265196
26259,0.0271,172.31.47.0-255,66,187076,92,265196
26260,0.02967,172.217.194.0-255,5738,192814,92,265196
26261,0.029677,172.31.47.0-255,66,192880,92,265196
26262,0.032201,172.217.194.0-255,5738,198618,92,265196
26263,0.032208,172.31.47.0-255,66,198684,92,265196
26264,0.032228,172.31.47.0-255,172,198856,92,265196
26265,0.032255,172.31.47.0-255,1112,199968,92,265196
26266,0.032298,172.31.47.0-255,1514,201482,92,265196
26267,0.0323,172.31.47.0-255,1514,202996,92,265196
26268,0.032305,172.31.47.0-255,1514,204510,92,265196
26269,0.032306,172.31.47.0-255,1514,206024,92,265196
26270,0.032324,172.31.47.0-255,1494,207518,92,265196
26271,0.033782,104.244.42.0-255,66,207584,92,265196
26272,0.033792,104.244.42.0-255,66,207650,92,265196
26273,0.033894,104.244.42.0-255,66,207716,92,265196
26274,0.034741,172.217.194.0-255,2902,210618,92,265196
26275,0.034745,172.31.47.0-255,66,210684,92,265196
26276,0.034777,172.217.194.0-255,2902,213586,92,265196
26277,0.03478,172.31.47.0-255,66,213652,92,265196
26278,0.037271,172.217.194.0-255,2902,216554,92,265196
26279,0.037276,172.31.47.0-255,66,216620,92,265196
26280,0.037308,172.217.194.0-255,2902,219522,92,265196
26281,0.037311,172.31.47.0-255,66,219588,92,265196
26282,0.039814,172.217.194.0-255,2902,222490,92,265196
26283,0.03982,172.31.47.0-255,66,222556,92,265196
26284,0.03985,172.217.194.0-255,2902,225458,92,265196
26285,0.039852,172.31.47.0-255,66,225524,92,265196
26286,0.042338,172.217.194.0-255,2902,228426,92,265196
26287,0.042343,172.31.47.0-255,66,228492,92,265196
26288,0.042376,172.217.194.0-255,2902,231394,92,265196
26289,0.042379,172.31.47.0-255,66,231460,92,265196
26290,0.044839,172.217.194.0-255,2902,234362,92,265196
26291,0.044844,172.31.47.0-255,66,234428,92,265196
26292,0.044877,172.217.194.0-255,2902,237330,92,265196
26293,0.04488,172.31.47.0-255,66,237396,92,265196
26294,0.04738,172.217.194.0-255,2902,240298,92,265196
26295,0.047385,172.31.47.0-255,66,240364,92,265196
26296,0.047416,172.217.194.0-255,2902,243266,92,265196
26297,0.047419,172.31.47.0-255,66,243332,92,265196
26298,0.049919,172.217.194.0-255,4320,247652,92,265196
26299,0.049924,172.31.47.0-255,66,247718,92,265196
26300,0.04995,172.217.194.0-255,1484,249202,92,265196
26301,0.052444,172.217.194.0-255,4320,253522,92,265196
26302,0.052449,172.31.47.0-255,66,253588,92,265196
26303,0.054964,172.217.194.0-255,5738,259326,92,265196
26304,0.05497,172.31.47.0-255,66,259392,92,265196
26305,0.057499,172.217.194.0-255,5738,265130,92,265196
26306,0.057507,172.31.47.0-255,66,265196,92,265196
26307,0.0,172.31.47.0-255,105,105,92,105
26308,0.0,172.31.47.0-255,105,105,92,210
26309,3.2e-05,172.31.47.0-255,105,210,92,210
26310,0.0,74.125.68.0-255,153,153,92,399477
26311,2.1e-05,172.31.47.0-255,66,219,92,399477
26312,2.8e-05,74.125.68.0-255,1484,1703,92,399477
26313,3.1e-05,172.31.47.0-255,66,1769,92,399477
26314,3.6e-05,74.125.68.0-255,2902,4671,92,399477
26315,3.9e-05,172.31.47.0-255,66,4737,92,399477
26316,7.6e-05,74.125.68.0-255,4320,9057,92,399477
26317,7.9e-05,172.31.47.0-255,66,9123,92,399477
26318,9.9e-05,74.125.68.0-255,2902,12025,92,399477
26319,0.000101,172.31.47.0-255,66,12091,92,399477
26320,0.000107,74.125.68.0-255,4803,16894,92,399477
26321,0.000109,172.31.47.0-255,66,16960,92,399477
26322,0.000147,172.31.47.0-255,66,17026,92,399477
26323,0.000299,74.125.68.0-255,1484,18510,92,399477
26324,0.000301,172.31.47.0-255,66,18576,92,399477
26325,0.000306,74.125.68.0-255,2902,21478,92,399477
26326,0.000308,172.31.47.0-255,66,21544,92,399477
26327,0.000325,74.125.68.0-255,1484,23028,92,399477
26328,0.000327,172.31.47.0-255,66,23094,92,399477
26329,0.000344,74.125.68.0-255,4320,27414,92,399477
26330,0.000346,172.31.47.0-255,66,27480,92,399477
26331,0.000349,74.125.68.0-255,1484,28964,92,399477
26332,0.000351,172.31.47.0-255,66,29030,92,399477
26333,0.000373,74.125.68.0-255,1484,30514,92,399477
26334,0.000375,172.31.47.0-255,66,30580,92,399477
26335,0.000403,172.31.47.0-255,66,30646,92,399477
26336,0.000408,74.125.68.0-255,4320,34966,92,399477
26337,0.00041,172.31.47.0-255,66,35032,92,399477
26338,0.000457,74.125.68.0-255,4320,39352,92,399477
26339,0.000459,172.31.47.0-255,66,39418,92,399477
26340,0.000479,74.125.68.0-255,4270,43688,92,399477
26341,0.00048,172.31.47.0-255,66,43754,92,399477
26342,0.000483,74.125.68.0-255,109,43863,92,399477
26343,0.000511,74.125.68.0-255,1484,45347,92,399477
26344,0.000513,172.31.47.0-255,66,45413,92,399477
26345,0.000527,74.125.68.0-255,2902,48315,92,399477
26346,0.00053,172.31.47.0-255,66,48381,92,399477
26347,0.000534,74.125.68.0-255,2902,51283,92,399477
26348,0.000536,172.31.47.0-255,66,51349,92,399477
26349,0.000574,74.125.68.0-255,4320,55669,92,399477
26350,0.000576,172.31.47.0-255,66,55735,92,399477
26351,0.000581,74.125.68.0-255,4320,60055,92,399477
26352,0.000583,172.31.47.0-255,66,60121,92,399477
26353,0.000598,74.125.68.0-255,4320,64441,92,399477
26354,0.0006,172.31.47.0-255,66,64507,92,399477
26355,0.000606,74.125.68.0-255,5738,70245,92,399477
26356,0.000607,172.31.47.0-255,66,70311,92,399477
26357,0.000644,74.125.68.0-255,4320,74631,92,399477
26358,0.000646,172.31.47.0-255,66,74697,92,399477
26359,0.000658,74.125.68.0-255,3870,78567,92,399477
26360,0.00066,172.31.47.0-255,66,78633,92,399477
26361,0.000729,74.125.68.0-255,1484,80117,92,399477
26362,0.000741,74.125.68.0-255,2902,83019,92,399477
26363,0.000744,172.31.47.0-255,66,83085,92,399477
26364,0.000767,74.125.68.0-255,4320,87405,92,399477
26365,0.00077,172.31.47.0-255,66,87471,92,399477
26366,0.000792,172.31.47.0-255,66,87537,92,399477
26367,0.000797,74.125.68.0-255,4320,91857,92,399477
26368,0.000799,172.31.47.0-255,66,91923,92,399477
26369,0.00081,74.125.68.0-255,1484,93407,92,399477
26370,0.000831,74.125.68.0-255,7156,100563,92,399477
26371,0.000833,172.31.47.0-255,66,100629,92,399477
26372,0.000851,74.125.68.0-255,3602,104231,92,399477
26373,0.000853,172.31.47.0-255,66,104297,92,399477
26374,0.000958,74.125.68.0-255,1484,105781,92,399477
26375,0.000976,74.125.68.0-255,2902,108683,92,399477
26376,0.000979,172.31.47.0-255,66,108749,92,399477
26377,0.001009,74.125.68.0-255,4320,113069,92,399477
26378,0.001011,172.31.47.0-255,66,113135,92,399477
26379,0.001026,74.125.68.0-255,5738,118873,92,399477
26380,0.001029,172.31.47.0-255,66,118939,92,399477
26381,0.001043,74.125.68.0-255,2902,121841,92,399477
26382,0.001045,172.31.47.0-255,66,121907,92,399477
26383,0.00105,74.125.68.0-255,2902,124809,92,399477
26384,0.001052,172.31.47.0-255,66,124875,92,399477
26385,0.001078,74.125.68.0-255,7156,132031,92,399477
26386,0.001081,172.31.47.0-255,66,132097,92,399477
26387,0.001087,74.125.68.0-255,5738,137835,92,399477
26388,0.00109,172.31.47.0-255,66,137901,92,399477
26389,0.001102,74.125.68.0-255,766,138667,92,399477
26390,0.001328,74.125.68.0-255,1484,140151,92,399477
26391,0.001334,172.31.47.0-255,66,140217,92,399477
26392,0.001339,74.125.68.0-255,2902,143119,92,399477
26393,0.001341,172.31.47.0-255,66,143185,92,399477
26394,0.001365,74.125.68.0-255,5738,148923,92,399477
26395,0.001368,172.31.47.0-255,66,148989,92,399477
26396,0.001402,172.31.47.0-255,66,149055,92,399477
26397,0.001449,74.125.68.0-255,2902,151957,92,399477
26398,0.001452,172.31.47.0-255,66,152023,92,399477
26399,0.001478,74.125.68.0-255,7156,159179,92,399477
26400,0.001482,172.31.47.0-255,66,159245,92,399477
26401,0.001487,74.125.68.0-255,5020,164265,92,399477
26402,0.001489,172.31.47.0-255,66,164331,92,399477
26403,0.001566,74.125.68.0-255,1484,165815,92,399477
26404,0.001576,74.125.68.0-255,1484,167299,92,399477
26405,0.00158,172.31.47.0-255,66,167365,92,399477
26406,0.0016,74.125.68.0-255,2902,170267,92,399477
26407,0.001603,172.31.47.0-255,66,170333,92,399477
26408,0.001607,74.125.68.0-255,2902,173235,92,399477
26409,0.001609,172.31.47.0-255,66,173301,92,399477
26410,0.001622,74.125.68.0-255,2902,176203,92,399477
26411,0.001626,172.31.47.0-255,66,176269,92,399477
26412,0.001638,74.125.68.0-255,5738,182007,92,399477
26413,0.00164,172.31.47.0-255,66,182073,92,399477
26414,0.001655,74.125.68.0-255,1484,183557,92,399477
26415,0.001671,74.125.68.0-255,5738,189295,92,399477
26416,0.001674,172.31.47.0-255,66,189361,92,399477
26417,0.001693,74.125.68.0-255,2902,192263,92,399477
26418,0.001695,172.31.47.0-255,66,192329,92,399477
26419,0.001699,74.125.68.0-255,2902,195231,92,399477
26420,0.001701,172.31.47.0-255,66,195297,92,399477
26421,0.001706,74.125.68.0-255,3602,198899,92,399477
26422,0.001709,172.31.47.0-255,66,198965,92,399477
26423,0.001885,74.125.68.0-255,1484,200449,92,399477
26424,0.001906,74.125.68.0-255,2902,203351,92,399477
26425,0.001909,172.31.47.0-255,66,203417,92,399477
26426,0.001947,74.125.68.0-255,5738,209155,92,399477
26427,0.00195,172.31.47.0-255,66,209221,92,399477
26428,0.00199,74.125.68.0-255,7156,216377,92,399477
26429,0.001993,172.31.47.0-255,66,216443,92,399477
26430,0.001998,74.125.68.0-255,4320,220763,92,399477
26431,0.002,172.31.47.0-255,66,220829,92,399477
26432,0.00202,74.125.68.0-255,5738,226567,92,399477
26433,0.002024,172.31.47.0-255,66,226633,92,399477
26434,0.002051,74.125.68.0-255,4320,230953,92,399477
26435,0.002054,172.31.47.0-255,66,231019,92,399477
26436,0.002092,74.125.68.0-255,2184,233203,92,399477
26437,0.002096,172.31.47.0-255,66,233269,92,399477
26438,0.002229,74.125.68.0-255,1484,234753,92,399477
26439,0.002246,74.125.68.0-255,1484,236237,92,399477
26440,0.00225,172.31.47.0-255,66,236303,92,399477
26441,0.002266,74.125.68.0-255,2902,239205,92,399477
26442,0.002269,172.31.47.0-255,66,239271,92,399477
26443,0.002289,74.125.68.0-255,5738,245009,92,399477
26444,0.002291,172.31.47.0-255,66,245075,92,399477
26445,0.002319,74.125.68.0-255,2902,247977,92,399477
26446,0.002322,172.31.47.0-255,66,248043,92,399477
26447,0.002342,74.125.68.0-255,4320,252363,92,399477
26448,0.002345,172.31.47.0-255,66,252429,92,399477
26449,0.002351,74.125.68.0-255,7156,259585,92,399477
26450,0.002353,172.31.47.0-255,66,259651,92,399477
26451,0.002357,74.125.68.0-255,2902,262553,92,399477
26452,0.00236,172.31.47.0-255,66,262619,92,399477
26453,0.002383,74.125.68.0-255,5020,267639,92,399477
26454,0.002385,172.31.47.0-255,66,267705,92,399477
26455,0.002402,74.125.68.0-255,1484,269189,92,399477
26456,0.002415,74.125.68.0-255,2902,272091,92,399477
26457,0.002435,74.125.68.0-255,1484,273575,92,399477
26458,0.002438,172.31.47.0-255,66,273641,92,399477
26459,0.002456,74.125.68.0-255,4320,277961,92,399477
26460,0.002459,74.125.68.0-255,1484,279445,92,399477
26461,0.002465,172.31.47.0-255,66,279511,92,399477
26462,0.002479,74.125.68.0-255,5738,285249,92,399477
26463,0.002488,172.31.47.0-255,66,285315,92,399477
26464,0.002497,74.125.68.0-255,4320,289635,92,399477
26465,0.002501,172.31.47.0-255,66,289701,92,399477
26466,0.002514,74.125.68.0-255,5738,295439,92,399477
26467,0.002531,172.31.47.0-255,66,295505,92,399477
26468,0.002545,74.125.68.0-255,4320,299825,92,399477
26469,0.002558,74.125.68.0-255,4320,304145,92,399477
26470,0.002564,172.31.47.0-255,66,304211,92,399477
26471,0.002582,74.125.68.0-255,2184,306395,92,399477
26472,0.002586,74.125.68.0-255,2902,309297,92,399477
26473,0.002588,74.125.68.0-255,1484,310781,92,399477
26474,0.002604,172.31.47.0-255,66,310847,92,399477
26475,0.005141,74.125.68.0-255,5738,316585,92,399477
26476,0.005147,172.31.47.0-255,66,316651,92,399477
26477,0.007697,74.125.68.0-255,5738,322389,92,399477
26478,0.007702,172.31.47.0-255,66,322455,92,399477
26479,0.010234,74.125.68.0-255,5738,328193,92,399477
26480,0.010243,172.31.47.0-255,66,328259,92,399477
26481,0.012791,74.125.68.0-255,5738,333997,92,399477
26482,0.0128,172.31.47.0-255,66,334063,92,399477
26483,0.015377,74.125.68.0-255,5738,339801,92,399477
26484,0.015387,172.31.47.0-255,66,339867,92,399477
26485,0.017931,74.125.68.0-255,5738,345605,92,399477
26486,0.017938,172.31.47.0-255,66,345671,92,399477
26487,0.020489,74.125.68.0-255,5738,351409,92,399477
26488,0.020497,172.31.47.0-255,66,351475,92,399477
26489,0.023038,74.125.68.0-255,5738,357213,92,399477
26490,0.023045,172.31.47.0-255,66,357279,92,399477
26491,0.025582,74.125.68.0-255,5738,363017,92,399477
26492,0.025589,172.31.47.0-255,66,363083,92,399477
26493,0.028123,74.125.68.0-255,5738,368821,92,399477
26494,0.028131,172.31.47.0-255,66,368887,92,399477
26495,0.030672,74.125.68.0-255,5738,374625,92,399477
26496,0.030682,172.31.47.0-255,66,374691,92,399477
26497,0.033222,74.125.68.0-255,4320,379011,92,399477
26498,0.033228,172.31.47.0-255,66,379077,92,399477
26499,0.033241,74.125.68.0-255,1484,380561,92,399477
26500,0.033566,172.31.47.0-255,172,380733,92,399477
26501,0.033596,172.31.47.0-255,1111,381844,92,399477
26502,0.033629,172.31.47.0-255,1514,383358,92,399477
26503,0.033631,172.31.47.0-255,1514,384872,92,399477
26504,0.033632,172.31.47.0-255,1514,386386,92,399477
26505,0.033633,172.31.47.0-255,1514,387900,92,399477
26506,0.033634,172.31.47.0-255,1495,389395,92,399477
26507,0.035071,104.244.42.0-255,66,389461,92,399477
26508,0.035122,104.244.42.0-255,66,389527,92,399477
26509,0.035171,104.244.42.0-255,66,389593,92,399477
26510,0.035217,104.244.42.0-255,66,389659,92,399477
26511,0.035769,74.125.68.0-255,4320,393979,92,399477
26512,0.035774,172.31.47.0-255,66,394045,92,399477
26513,0.038323,74.125.68.0-255,5195,399240,92,399477
26514,0.038334,172.31.47.0-255,66,399306,92,399477
26515,0.038592,172.31.47.0-255,105,399411,92,399477
26516,0.041095,74.125.68.0-255,66,399477,92,399477
26517,0.0,172.217.26.0-255,297,297,92,281377
26518,2.4e-05,172.31.47.0-255,66,363,92,281377
26519,2.9e-05,172.217.26.0-255,1484,1847,92,281377
26520,3.3e-05,172.31.47.0-255,66,1913,92,281377
26521,3.9e-05,172.217.26.0-255,4320,6233,92,281377
26522,4.1e-05,172.31.47.0-255,66,6299,92,281377
26523,8e-05,172.31.47.0-255,66,6365,92,281377
26524,8.5e-05,172.217.26.0-255,2902,9267,92,281377
26525,8.7e-05,172.31.47.0-255,66,9333,92,281377
26526,0.000112,172.31.47.0-255,66,9399,92,281377
26527,0.000117,172.217.26.0-255,3961,13360,92,281377
26528,0.000119,172.31.47.0-255,66,13426,92,281377
26529,0.000203,172.217.26.0-255,1484,14910,92,281377
26530,0.000206,172.31.47.0-255,66,14976,92,281377
26531,0.000229,172.217.26.0-255,2902,17878,92,281377
26532,0.000231,172.31.47.0-255,66,17944,92,281377
26533,0.000235,172.217.26.0-255,4320,22264,92,281377
26534,0.000238,172.31.47.0-255,66,22330,92,281377
26535,0.000251,172.217.26.0-255,4320,26650,92,281377
26536,0.000254,172.31.47.0-255,66,26716,92,281377
26537,0.000267,172.217.26.0-255,5379,32095,92,281377
26538,0.00027,172.31.47.0-255,66,32161,92,281377
26539,0.000272,172.217.26.0-255,1484,33645,92,281377
26540,0.000274,172.31.47.0-255,66,33711,92,281377
26541,0.000294,172.31.47.0-255,66,33777,92,281377
26542,0.000319,172.217.26.0-255,5379,39156,92,281377
26543,0.000322,172.31.47.0-255,66,39222,92,281377
26544,0.000324,172.217.26.0-255,352,39574,92,281377
26545,0.000326,172.31.47.0-255,66,39640,92,281377
26546,0.001074,172.217.26.0-255,141,39781,92,281377
26547,0.001109,172.31.47.0-255,66,39847,92,281377
26548,0.001167,172.217.26.0-255,1484,41331,92,281377
26549,0.001172,172.217.26.0-255,2902,44233,92,281377
26550,0.001176,172.31.47.0-255,66,44299,92,281377
26551,0.00118,172.217.26.0-255,2902,47201,92,281377
26552,0.001182,172.31.47.0-255,66,47267,92,281377
26553,0.001185,172.217.26.0-255,1484,48751,92,281377
26554,0.001201,172.217.26.0-255,2902,51653,92,281377
26555,0.001203,172.31.47.0-255,66,51719,92,281377
26556,0.001245,172.217.26.0-255,5379,57098,92,281377
26557,0.001248,172.31.47.0-255,66,57164,92,281377
26558,0.001255,172.217.26.0-255,5738,62902,92,281377
26559,0.001257,172.31.47.0-255,66,62968,92,281377
26560,0.001326,172.31.47.0-255,66,63034,92,281377
26561,0.001345,172.217.26.0-255,2543,65577,92,281377
26562,0.001349,172.31.47.0-255,66,65643,92,281377
26563,0.001822,172.217.26.0-255,1484,67127,92,281377
26564,0.00183,172.217.26.0-255,2902,70029,92,281377
26565,0.001833,172.31.47.0-255,66,70095,92,281377
26566,0.001838,172.217.26.0-255,2902,72997,92,281377
26567,0.001839,172.31.47.0-255,66,73063,92,281377
26568,0.001842,172.217.26.0-255,1484,74547,92,281377
26569,0.001855,172.217.26.0-255,2902,77449,92,281377
26570,0.001857,172.31.47.0-255,66,77515,92,281377
26571,0.001861,172.217.26.0-255,2902,80417,92,281377
26572,0.001862,172.31.47.0-255,66,80483,92,281377
26573,0.001886,172.217.26.0-255,5738,86221,92,281377
26574,0.001888,172.31.47.0-255,66,86287,92,281377
26575,0.001893,172.217.26.0-255,4320,90607,92,281377
26576,0.001894,172.31.47.0-255,66,90673,92,281377
26577,0.001921,172.31.47.0-255,66,90739,92,281377
26578,0.00195,172.217.26.0-255,1484,92223,92,281377
26579,0.001952,172.217.26.0-255,1484,93707,92,281377
26580,0.001954,172.31.47.0-255,66,93773,92,281377
26581,0.001974,172.217.26.0-255,1484,95257,92,281377
26582,0.001979,172.217.26.0-255,5738,100995,92,281377
26583,0.001983,172.31.47.0-255,66,101061,92,281377
26584,0.00199,172.217.26.0-255,2902,103963,92,281377
26585,0.001991,172.31.47.0-255,66,104029,92,281377
26586,0.003926,172.217.26.0-255,5738,109767,92,281377
26587,0.003932,172.31.47.0-255,66,109833,92,281377
26588,0.005862,172.217.26.0-255,5738,115571,92,281377
26589,0.005869,172.31.47.0-255,66,115637,92,281377
26590,0.007838,172.217.26.0-255,5738,121375,92,281377
26591,0.007844,172.31.47.0-255,66,121441,92,281377
26592,0.009777,172.217.26.0-255,5738,127179,92,281377
26593,0.009783,172.31.47.0-255,66,127245,92,281377
26594,0.01173,172.217.26.0-255,5738,132983,92,281377
26595,0.011742,172.31.47.0-255,66,133049,92,281377
26596,0.01369,172.217.26.0-255,5738,138787,92,281377
26597,0.0137,172.31.47.0-255,66,138853,92,281377
26598,0.015627,172.217.26.0-255,5738,144591,92,281377
26599,0.015634,172.31.47.0-255,66,144657,92,281377
26600,0.017564,172.217.26.0-255,5738,150395,92,281377
26601,0.01757,172.31.47.0-255,66,150461,92,281377
26602,0.019509,172.217.26.0-255,5738,156199,92,281377
26603,0.019515,172.31.47.0-255,66,156265,92,281377
26604,0.021451,172.217.26.0-255,5738,162003,92,281377
26605,0.021457,172.31.47.0-255,66,162069,92,281377
26606,0.023393,172.217.26.0-255,5738,167807,92,281377
26607,0.023399,172.31.47.0-255,66,167873,92,281377
26608,0.025412,172.217.26.0-255,5738,173611,92,281377
26609,0.025419,172.31.47.0-255,66,173677,92,281377
26610,0.027348,172.31.47.0-255,172,173849,92,281377
26611,0.027357,172.217.26.0-255,5738,179587,92,281377
26612,0.027361,172.31.47.0-255,66,179653,92,281377
26613,0.027401,172.31.47.0-255,1112,180765,92,281377
26614,0.027507,172.31.47.0-255,1514,182279,92,281377
26615,0.027508,172.31.47.0-255,1514,183793,92,281377
26616,0.027513,172.31.47.0-255,1514,185307,92,281377
26617,0.027514,172.31.47.0-255,1514,186821,92,281377
26618,0.027553,172.31.47.0-255,1494,188315,92,281377
26619,0.028899,104.244.42.0-255,66,188381,92,281377
26620,0.028927,104.244.42.0-255,66,188447,92,281377
26621,0.029125,104.244.42.0-255,66,188513,92,281377
26622,0.029295,172.217.26.0-255,5738,194251,92,281377
26623,0.029301,172.31.47.0-255,66,194317,92,281377
26624,0.031253,172.217.26.0-255,5738,200055,92,281377
26625,0.03126,172.31.47.0-255,66,200121,92,281377
26626,0.033223,172.217.26.0-255,5738,205859,92,281377
26627,0.033228,172.31.47.0-255,66,205925,92,281377
26628,0.035182,172.217.26.0-255,5738,211663,92,281377
26629,0.03519,172.31.47.0-255,66,211729,92,281377
26630,0.037143,172.217.26.0-255,5738,217467,92,281377
26631,0.037149,172.31.47.0-255,66,217533,92,281377
26632,0.039097,172.217.26.0-255,5738,223271,92,281377
26633,0.039103,172.31.47.0-255,66,223337,92,281377
26634,0.041048,172.217.26.0-255,5738,229075,92,281377
26635,0.041054,172.31.47.0-255,66,229141,92,281377
26636,0.042995,172.217.26.0-255,5738,234879,92,281377
26637,0.043003,172.31.47.0-255,66,234945,92,281377
26638,0.044945,172.217.26.0-255,5738,240683,92,281377
26639,0.044951,172.31.47.0-255,66,240749,92,281377
26640,0.046896,172.217.26.0-255,5738,246487,92,281377
26641,0.046902,172.31.47.0-255,66,246553,92,281377
26642,0.048848,172.217.26.0-255,5738,252291,92,281377
26643,0.048853,172.31.47.0-255,66,252357,92,281377
26644,0.050817,172.217.26.0-255,5738,258095,92,281377
26645,0.050823,172.31.47.0-255,66,258161,92,281377
26646,0.052769,172.217.26.0-255,5738,263899,92,281377
26647,0.052776,172.31.47.0-255,66,263965,92,281377
26648,0.054713,172.217.26.0-255,5738,269703,92,281377
26649,0.05472,172.31.47.0-255,66,269769,92,281377
26650,0.056669,172.217.26.0-255,5738,275507,92,281377
26651,0.056675,172.31.47.0-255,66,275573,92,281377
26652,0.058622,172.217.26.0-255,5738,281311,92,281377
26653,0.058627,172.31.47.0-255,66,281377,92,281377
26654,0.0,74.125.24.0-255,153,153,92,278243
26655,2.2e-05,172.31.47.0-255,66,219,92,278243
26656,2.8e-05,74.125.24.0-255,1484,1703,92,278243
26657,3.2e-05,172.31.47.0-255,66,1769,92,278243
26658,3.6e-05,74.125.24.0-255,2902,4671,92,278243
26659,3.8e-05,172.31.47.0-255,66,4737,92,278243
26660,5.1e-05,74.125.24.0-255,7156,11893,92,278243
26661,5.3e-05,172.31.47.0-255,66,11959,92,278243
26662,5.8e-05,74.125.24.0-255,2256,14215,92,278243
26663,6.1e-05,172.31.47.0-255,66,14281,92,278243
26664,0.000289,74.125.24.0-255,1484,15765,92,278243
26665,0.000295,172.31.47.0-255,66,15831,92,278243
26666,0.0003,74.125.24.0-255,2902,18733,92,278243
26667,0.000303,172.31.47.0-255,66,18799,92,278243
26668,0.000314,74.125.24.0-255,5738,24537,92,278243
26669,0.000317,172.31.47.0-255,66,24603,92,278243
26670,0.000348,74.125.24.0-255,4320,28923,92,278243
26671,0.000352,172.31.47.0-255,66,28989,92,278243
26672,0.000391,172.31.47.0-255,66,29055,92,278243
26673,0.000408,172.31.47.0-255,66,29121,92,278243
26674,0.000464,74.125.24.0-255,1484,30605,92,278243
26675,0.000468,172.31.47.0-255,66,30671,92,278243
26676,0.000481,74.125.24.0-255,2902,33573,92,278243
26677,0.000489,172.31.47.0-255,66,33639,92,278243
26678,0.000495,74.125.24.0-255,5738,39377,92,278243
26679,0.000497,172.31.47.0-255,66,39443,92,278243
26680,0.000532,74.125.24.0-255,7091,46534,92,278243
26681,0.000536,172.31.47.0-255,66,46600,92,278243
26682,0.000571,74.125.24.0-255,385,46985,92,278243
26683,0.000574,172.31.47.0-255,66,47051,92,278243
26684,0.000803,74.125.24.0-255,1484,48535,92,278243
26685,0.00081,74.125.24.0-255,2902,51437,92,278243
26686,0.000813,172.31.47.0-255,66,51503,92,278243
26687,0.000816,74.125.24.0-255,1484,52987,92,278243
26688,0.000842,74.125.24.0-255,4320,57307,92,278243
26689,0.000845,172.31.47.0-255,66,57373,92,278243
26690,0.000852,74.125.24.0-255,4320,61693,92,278243
26691,0.000853,172.31.47.0-255,66,61759,92,278243
26692,0.000865,74.125.24.0-255,5379,67138,92,278243
26693,0.000867,172.31.47.0-255,66,67204,92,278243
26694,0.000872,74.125.24.0-255,2902,70106,92,278243
26695,0.000874,172.31.47.0-255,66,70172,92,278243
26696,0.000888,74.125.24.0-255,7156,77328,92,278243
26697,0.00089,172.31.47.0-255,66,77394,92,278243
26698,0.000914,74.125.24.0-255,1484,78878,92,278243
26699,0.000924,74.125.24.0-255,2543,81421,92,278243
26700,0.000926,172.31.47.0-255,66,81487,92,278243
26701,0.001235,74.125.24.0-255,1484,82971,92,278243
26702,0.001243,74.125.24.0-255,2902,85873,92,278243
26703,0.001247,172.31.47.0-255,66,85939,92,278243
26704,0.001251,74.125.24.0-255,1484,87423,92,278243
26705,0.001275,74.125.24.0-255,4320,91743,92,278243
26706,0.001278,172.31.47.0-255,66,91809,92,278243
26707,0.001283,74.125.24.0-255,4320,96129,92,278243
26708,0.001285,172.31.47.0-255,66,96195,92,278243
26709,0.001311,74.125.24.0-255,7156,103351,92,278243
26710,0.001319,172.31.47.0-255,66,103417,92,278243
26711,0.001345,74.125.24.0-255,4320,107737,92,278243
26712,0.001348,172.31.47.0-255,66,107803,92,278243
26713,0.001357,172.31.47.0-255,66,107869,92,278243
26714,0.00199,74.125.24.0-255,1484,109353,92,278243
26715,0.001997,74.125.24.0-255,2902,112255,92,278243
26716,0.002001,172.31.47.0-255,66,112321,92,278243
26717,0.002027,74.125.24.0-255,5738,118059,92,278243
26718,0.002029,172.31.47.0-255,66,118125,92,278243
26719,0.002056,74.125.24.0-255,7156,125281,92,278243
26720,0.002058,172.31.47.0-255,66,125347,92,278243
26721,0.002089,172.31.47.0-255,66,125413,92,278243
26722,0.002092,74.125.24.0-255,2184,127597,92,278243
26723,0.002094,172.31.47.0-255,66,127663,92,278243
26724,0.004335,74.125.24.0-255,2902,130565,92,278243
26725,0.004337,172.31.47.0-255,66,130631,92,278243
26726,0.004363,74.125.24.0-255,2902,133533,92,278243
26727,0.004365,172.31.47.0-255,66,133599,92,278243
26728,0.006612,74.125.24.0-255,2902,136501,92,278243
26729,0.006618,172.31.47.0-255,66,136567,92,278243
26730,0.006654,74.125.24.0-255,2902,139469,92,278243
26731,0.006657,172.31.47.0-255,66,139535,92,278243
26732,0.008918,74.125.24.0-255,5738,145273,92,278243
26733,0.008925,172.31.47.0-255,66,145339,92,278243
26734,0.011219,74.125.24.0-255,5738,151077,92,278243
26735,0.011226,172.31.47.0-255,66,151143,92,278243
26736,0.01355,74.125.24.0-255,5738,156881,92,278243
26737,0.013563,172.31.47.0-255,66,156947,92,278243
26738,0.01586,74.125.24.0-255,5738,162685,92,278243
26739,0.015868,172.31.47.0-255,66,162751,92,278243
26740,0.018154,74.125.24.0-255,5738,168489,92,278243
26741,0.018161,172.31.47.0-255,66,168555,92,278243
26742,0.020425,74.125.24.0-255,5738,174293,92,278243
26743,0.020431,172.31.47.0-255,66,174359,92,278243
26744,0.022705,74.125.24.0-255,5738,180097,92,278243
26745,0.022711,172.31.47.0-255,66,180163,92,278243
26746,0.024971,74.125.24.0-255,5738,185901,92,278243
26747,0.024984,172.31.47.0-255,66,185967,92,278243
26748,0.025225,172.31.47.0-255,172,186139,92,278243
26749,0.025257,172.31.47.0-255,1107,187246,92,278243
26750,0.025302,172.31.47.0-255,1514,188760,92,278243
26751,0.025303,172.31.47.0-255,1514,190274,92,278243
26752,0.025309,172.31.47.0-255,1514,191788,92,278243
26753,0.02531,172.31.47.0-255,1514,193302,92,278243
26754,0.025334,172.31.47.0-255,1499,194801,92,278243
26755,0.026785,104.244.42.0-255,66,194867,92,278243
26756,0.026793,104.244.42.0-255,66,194933,92,278243
26757,0.026894,104.244.42.0-255,66,194999,92,278243
26758,0.027273,74.125.24.0-255,1484,196483,92,278243
26759,0.0273,74.125.24.0-255,4320,200803,92,278243
26760,0.027304,172.31.47.0-255,66,200869,92,278243
26761,0.029574,74.125.24.0-255,4320,205189,92,278243
26762,0.029578,172.31.47.0-255,66,205255,92,278243
26763,0.029607,74.125.24.0-255,1484,206739,92,278243
26764,0.030016,104.244.42.0-255,108,206847,92,278243
26765,0.030021,172.31.47.0-255,66,206913,92,278243
26766,0.031873,74.125.24.0-255,4320,211233,92,278243
26767,0.031879,172.31.47.0-255,66,211299,92,278243
26768,0.034177,74.125.24.0-255,5738,217037,92,278243
26769,0.034182,172.31.47.0-255,66,217103,92,278243
26770,0.036447,74.125.24.0-255,5738,222841,92,278243
26771,0.036451,172.31.47.0-255,66,222907,92,278243
26772,0.038705,74.125.24.0-255,5738,228645,92,278243
26773,0.03871,172.31.47.0-255,66,228711,92,278243
26774,0.040986,74.125.24.0-255,4320,233031,92,278243
26775,0.040991,172.31.47.0-255,66,233097,92,278243
26776,0.041021,74.125.24.0-255,1484,234581,92,278243
26777,0.043281,74.125.24.0-255,4320,238901,92,278243
26778,0.043286,172.31.47.0-255,66,238967,92,278243
26779,0.04556,74.125.24.0-255,4320,243287,92,278243
26780,0.045564,172.31.47.0-255,66,243353,92,278243
26781,0.045599,74.125.24.0-255,1484,244837,92,278243
26782,0.047873,74.125.24.0-255,4320,249157,92,278243
26783,0.047877,172.31.47.0-255,66,249223,92,278243
26784,0.050134,74.125.24.0-255,5738,254961,92,278243
26785,0.05014,172.31.47.0-255,66,255027,92,278243
26786,0.052402,74.125.24.0-255,5738,260765,92,278243
26787,0.052406,172.31.47.0-255,66,260831,92,278243
26788,0.054684,74.125.24.0-255,5738,266569,92,278243
26789,0.05469,172.31.47.0-255,66,266635,92,278243
26790,0.056986,74.125.24.0-255,5738,272373,92,278243
26791,0.05699,172.31.47.0-255,66,272439,92,278243
26792,0.05927,74.125.24.0-255,5738,278177,92,278243
26793,0.059275,172.31.47.0-255,66,278243,92,278243
26794,0.0,172.217.194.0-255,153,153,92,132777
26795,6.3e-05,172.31.47.0-255,66,219,92,132777
26796,7e-05,172.217.194.0-255,1484,1703,92,132777
26797,7.4e-05,172.31.47.0-255,66,1769,92,132777
26798,7.9e-05,172.217.194.0-255,2902,4671,92,132777
26799,8.1e-05,172.31.47.0-255,66,4737,92,132777
26800,8.7e-05,172.217.194.0-255,4320,9057,92,132777
26801,9e-05,172.31.47.0-255,66,9123,92,132777
26802,0.000101,172.31.47.0-255,66,9189,92,132777
26803,0.000114,172.31.47.0-255,66,9255,92,132777
26804,0.000171,172.31.47.0-255,66,9321,92,132777
26805,0.000185,172.31.47.0-255,66,9387,92,132777
26806,0.000191,172.217.194.0-255,6438,15825,92,132777
26807,0.000193,172.31.47.0-255,66,15891,92,132777
26808,0.000216,172.217.194.0-255,394,16285,92,132777
26809,0.000219,172.31.47.0-255,66,16351,92,132777
26810,0.000277,172.217.194.0-255,1799,18150,92,132777
26811,0.00028,172.31.47.0-255,66,18216,92,132777
26812,0.000283,172.217.194.0-255,1484,19700,92,132777
26813,0.000287,172.31.47.0-255,66,19766,92,132777
26814,0.000303,172.217.194.0-255,5738,25504,92,132777
26815,0.000306,172.31.47.0-255,66,25570,92,132777
26816,0.000346,172.31.47.0-255,66,25636,92,132777
26817,0.000376,172.31.47.0-255,66,25702,92,132777
26818,0.000391,172.217.194.0-255,5738,31440,92,132777
26819,0.000394,172.31.47.0-255,66,31506,92,132777
26820,0.000407,172.217.194.0-255,2543,34049,92,132777
26821,0.000409,172.31.47.0-255,66,34115,92,132777
26822,0.000742,172.217.194.0-255,1484,35599,92,132777
26823,0.000748,172.217.194.0-255,2902,38501,92,132777
26824,0.000751,172.31.47.0-255,66,38567,92,132777
26825,0.000774,172.217.194.0-255,5738,44305,92,132777
26826,0.000777,172.31.47.0-255,66,44371,92,132777
26827,0.000781,172.217.194.0-255,2902,47273,92,132777
26828,0.000784,172.31.47.0-255,66,47339,92,132777
26829,0.000807,172.31.47.0-255,66,47405,92,132777
26830,0.000818,172.31.47.0-255,66,47471,92,132777
26831,0.000948,172.217.194.0-255,1484,48955,92,132777
26832,0.000961,172.217.194.0-255,2902,51857,92,132777
26833,0.000965,172.31.47.0-255,66,51923,92,132777
26834,0.000971,172.217.194.0-255,5738,57661,92,132777
26835,0.000973,172.31.47.0-255,66,57727,92,132777
26836,0.001001,172.217.194.0-255,2902,60629,92,132777
26837,0.001004,172.31.47.0-255,66,60695,92,132777
26838,0.001009,172.217.194.0-255,4320,65015,92,132777
26839,0.001011,172.31.47.0-255,66,65081,92,132777
26840,0.001023,172.217.194.0-255,2902,67983,92,132777
26841,0.001026,172.31.47.0-255,66,68049,92,132777
26842,0.001048,172.217.194.0-255,5738,73787,92,132777
26843,0.001052,172.31.47.0-255,66,73853,92,132777
26844,0.001064,172.217.194.0-255,4320,78173,92,132777
26845,0.001066,172.31.47.0-255,66,78239,92,132777
26846,0.001091,172.217.194.0-255,3602,81841,92,132777
26847,0.001094,172.31.47.0-255,66,81907,92,132777
26848,0.001231,172.217.194.0-255,1484,83391,92,132777
26849,0.001243,172.217.194.0-255,2902,86293,92,132777
26850,0.001246,172.31.47.0-255,66,86359,92,132777
26851,0.001248,172.217.194.0-255,1484,87843,92,132777
26852,0.001266,172.217.194.0-255,4320,92163,92,132777
26853,0.001269,172.31.47.0-255,66,92229,92,132777
26854,0.001286,172.217.194.0-255,2902,95131,92,132777
26855,0.001288,172.31.47.0-255,66,95197,92,132777
26856,0.001307,172.31.47.0-255,66,95263,92,132777
26857,0.001334,172.217.194.0-255,1484,96747,92,132777
26858,0.001344,172.31.47.0-255,66,96813,92,132777
26859,0.001372,172.217.194.0-255,5738,102551,92,132777
26860,0.001376,172.31.47.0-255,66,102617,92,132777
26861,0.001391,172.217.194.0-255,2902,105519,92,132777
26862,0.001395,172.31.47.0-255,66,105585,92,132777
26863,0.001437,172.31.47.0-255,66,105651,92,132777
26864,0.00146,172.31.47.0-255,66,105717,92,132777
26865,0.001465,172.31.47.0-255,66,105783,92,132777
26866,0.001473,172.31.47.0-255,66,105849,92,132777
26867,0.001486,172.217.194.0-255,1484,107333,92,132777
26868,0.001511,172.31.47.0-255,66,107399,92,132777
26869,0.001521,172.31.47.0-255,66,107465,92,132777
26870,0.00156,172.31.47.0-255,66,107531,92,132777
26871,0.001566,172.217.194.0-255,5738,113269,92,132777
26872,0.001567,172.31.47.0-255,66,113335,92,132777
26873,0.00159,172.31.47.0-255,66,113401,92,132777
26874,0.001618,172.217.194.0-255,4320,117721,92,132777
26875,0.001621,172.31.47.0-255,66,117787,92,132777
26876,0.001656,172.31.47.0-255,66,117853,92,132777
26877,0.001681,172.217.194.0-255,5020,122873,92,132777
26878,0.001684,172.31.47.0-255,66,122939,92,132777
26879,0.001697,172.31.47.0-255,66,123005,92,132777
26880,0.001711,172.31.47.0-255,66,123071,92,132777
26881,0.001753,172.31.47.0-255,66,123137,92,132777
26882,0.001768,172.31.47.0-255,66,123203,92,132777
26883,0.001809,172.31.47.0-255,66,123269,92,132777
26884,0.001868,172.31.47.0-255,66,123335,92,132777
26885,0.001871,172.217.194.0-255,105,123440,92,132777
26886,0.008049,172.31.47.0-255,66,123506,92,132777
26887,0.008073,172.31.47.0-255,105,123611,92,132777
26888,0.010141,172.217.194.0-255,66,123677,92,132777
26889,0.033951,172.31.47.0-255,172,123849,92,132777
26890,0.033978,172.31.47.0-255,1113,124962,92,132777
26891,0.034018,172.31.47.0-255,1514,126476,92,132777
26892,0.03402,172.31.47.0-255,1514,127990,92,132777
26893,0.034025,172.31.47.0-255,1514,129504,92,132777
26894,0.034026,172.31.47.0-255,1514,131018,92,132777
26895,0.034049,172.31.47.0-255,1495,132513,92,132777
26896,0.035467,104.244.42.0-255,66,132579,92,132777
26897,0.035498,104.244.42.0-255,66,132645,92,132777
26898,0.03556,104.244.42.0-255,66,132711,92,132777
26899,0.035582,104.244.42.0-255,66,132777,92,132777
26900,0.0,172.217.194.0-255,297,297,92,327966
26901,3.2e-05,172.31.47.0-255,66,363,92,327966
26902,3.9e-05,172.217.194.0-255,1484,1847,92,327966
26903,4.4e-05,172.31.47.0-255,66,1913,92,327966
26904,5.1e-05,172.217.194.0-255,4320,6233,92,327966
26905,5.3e-05,172.31.47.0-255,66,6299,92,327966
26906,6.2e-05,172.31.47.0-255,66,6365,92,327966
26907,0.000124,172.217.194.0-255,1484,7849,92,327966
26908,0.000127,172.31.47.0-255,66,7915,92,327966
26909,0.00013,172.217.194.0-255,1484,9399,92,327966
26910,0.000132,172.31.47.0-255,66,9465,92,327966
26911,0.000147,172.217.194.0-255,1484,10949,92,327966
26912,0.00015,172.31.47.0-255,66,11015,92,327966
26913,0.000156,172.217.194.0-255,5738,16753,92,327966
26914,0.000158,172.31.47.0-255,66,16819,92,327966
26915,0.000194,172.217.194.0-255,6797,23616,92,327966
26916,0.000198,172.31.47.0-255,66,23682,92,327966
26917,0.000348,172.217.194.0-255,1484,25166,92,327966
26918,0.000352,172.31.47.0-255,66,25232,92,327966
26919,0.000357,172.217.194.0-255,2902,28134,92,327966
26920,0.000359,172.31.47.0-255,66,28200,92,327966
26921,0.00037,172.217.194.0-255,1484,29684,92,327966
26922,0.000375,172.31.47.0-255,66,29750,92,327966
26923,0.000394,172.217.194.0-255,4320,34070,92,327966
26924,0.000397,172.31.47.0-255,66,34136,92,327966
26925,0.000426,172.31.47.0-255,66,34202,92,327966
26926,0.000447,172.217.194.0-255,5379,39581,92,327966
26927,0.000449,172.31.47.0-255,66,39647,92,327966
26928,0.000469,172.217.194.0-255,5738,45385,92,327966
26929,0.000472,172.31.47.0-255,66,45451,92,327966
26930,0.000493,172.217.194.0-255,4543,49994,92,327966
26931,0.000501,172.31.47.0-255,66,50060,92,327966
26932,0.000645,172.217.194.0-255,1484,51544,92,327966
26933,0.000649,172.217.194.0-255,2902,54446,92,327966
26934,0.000654,172.31.47.0-255,66,54512,92,327966
26935,0.00066,172.217.194.0-255,5738,60250,92,327966
26936,0.000677,172.31.47.0-255,66,60316,92,327966
26937,0.0007,172.217.194.0-255,1484,61800,92,327966
26938,0.0007,172.31.47.0-255,66,61866,92,327966
26939,0.000741,172.31.47.0-255,66,61932,92,327966
26940,0.000914,172.217.194.0-255,1484,63416,92,327966
26941,0.000919,172.217.194.0-255,2902,66318,92,327966
26942,0.000921,172.31.47.0-255,66,66384,92,327966
26943,0.000955,172.217.194.0-255,1484,67868,92,327966
26944,0.000974,172.217.194.0-255,4320,72188,92,327966
26945,0.000979,172.31.47.0-255,66,72254,92,327966
26946,0.00099,172.31.47.0-255,66,72320,92,327966
26947,0.00102,172.31.47.0-255,66,72386,92,327966
26948,0.001149,172.217.194.0-255,1484,73870,92,327966
26949,0.001153,172.217.194.0-255,2902,76772,92,327966
26950,0.001156,172.31.47.0-255,66,76838,92,327966
26951,0.001178,172.217.194.0-255,5738,82576,92,327966
26952,0.00119,172.31.47.0-255,66,82642,92,327966
26953,0.001191,172.217.194.0-255,7156,89798,92,327966
26954,0.001194,172.31.47.0-255,66,89864,92,327966
26955,0.001214,172.217.194.0-255,5738,95602,92,327966
26956,0.001227,172.31.47.0-255,66,95668,92,327966
26957,0.001326,172.217.194.0-255,1484,97152,92,327966
26958,0.001331,172.217.194.0-255,2902,100054,92,327966
26959,0.001333,172.31.47.0-255,66,100120,92,327966
26960,0.001356,172.217.194.0-255,5738,105858,92,327966
26961,0.001361,172.31.47.0-255,66,105924,92,327966
26962,0.001376,172.217.194.0-255,7156,113080,92,327966
26963,0.001379,172.31.47.0-255,66,113146,92,327966
26964,0.001413,172.217.194.0-255,2184,115330,92,327966
26965,0.001418,172.31.47.0-255,66,115396,92,327966
26966,0.001501,172.217.194.0-255,1484,116880,92,327966
26967,0.001504,172.217.194.0-255,1484,118364,92,327966
26968,0.001522,172.31.47.0-255,66,118430,92,327966
26969,0.001527,172.217.194.0-255,1484,119914,92,327966
26970,0.001533,172.217.194.0-255,5738,125652,92,327966
26971,0.001539,172.31.47.0-255,66,125718,92,327966
26972,0.001551,172.217.194.0-255,5738,131456,92,327966
26973,0.00156,172.31.47.0-255,66,131522,92,327966
26974,0.001573,172.217.194.0-255,7156,138678,92,327966
26975,0.001575,172.217.194.0-255,1484,140162,92,327966
26976,0.001583,172.31.47.0-255,66,140228,92,327966
26977,0.00162,172.217.194.0-255,5738,145966,92,327966
26978,0.001628,172.31.47.0-255,66,146032,92,327966
26979,0.001633,172.217.194.0-255,3602,149634,92,327966
26980,0.00164,172.31.47.0-255,66,149700,92,327966
26981,0.001867,172.217.194.0-255,1484,151184,92,327966
26982,0.001871,172.217.194.0-255,1484,152668,92,327966
26983,0.001874,172.31.47.0-255,66,152734,92,327966
26984,0.001892,172.217.194.0-255,1484,154218,92,327966
26985,0.001897,172.217.194.0-255,5738,159956,92,327966
26986,0.001903,172.31.47.0-255,66,160022,92,327966
26987,0.001929,172.31.47.0-255,66,160088,92,327966
26988,0.00193,172.217.194.0-255,4320,164408,92,327966
26989,0.001933,172.31.47.0-255,66,164474,92,327966
26990,0.001976,172.217.194.0-255,6438,170912,92,327966
26991,0.001979,172.31.47.0-255,66,170978,92,327966
26992,0.002031,172.217.194.0-255,1484,172462,92,327966
26993,0.002034,172.217.194.0-255,1484,173946,92,327966
26994,0.002043,172.217.194.0-255,1484,175430,92,327966
26995,0.002045,172.31.47.0-255,66,175496,92,327966
26996,0.002047,172.217.194.0-255,2902,178398,92,327966
26997,0.002049,172.31.47.0-255,66,178464,92,327966
26998,0.002059,172.217.194.0-255,2902,181366,92,327966
26999,0.002061,172.31.47.0-255,66,181432,92,327966
27000,0.002074,172.217.194.0-255,1484,182916,92,327966
27001,0.002078,172.31.47.0-255,78,182994,92,327966
27002,0.002089,172.31.47.0-255,66,183060,92,327966
27003,0.004141,172.217.194.0-255,5738,188798,92,327966
27004,0.004152,172.31.47.0-255,66,188864,92,327966
27005,0.006226,172.217.194.0-255,5738,194602,92,327966
27006,0.006242,172.31.47.0-255,66,194668,92,327966
27007,0.008296,172.217.194.0-255,5738,200406,92,327966
27008,0.008314,172.31.47.0-255,66,200472,92,327966
27009,0.010373,172.217.194.0-255,5738,206210,92,327966
27010,0.010387,172.31.47.0-255,66,206276,92,327966
27011,0.012432,172.217.194.0-255,4320,210596,92,327966
27012,0.012438,172.31.47.0-255,66,210662,92,327966
27013,0.012454,172.217.194.0-255,1484,212146,92,327966
27014,0.0145,172.217.194.0-255,4320,216466,92,327966
27015,0.014505,172.31.47.0-255,66,216532,92,327966
27016,0.016569,172.217.194.0-255,5738,222270,92,327966
27017,0.016613,172.31.47.0-255,66,222336,92,327966
27018,0.018665,172.217.194.0-255,5738,228074,92,327966
27019,0.018672,172.31.47.0-255,66,228140,92,327966
27020,0.020723,172.217.194.0-255,5738,233878,92,327966
27021,0.020731,172.31.47.0-255,66,233944,92,327966
27022,0.022781,172.217.194.0-255,5738,239682,92,327966
27023,0.02279,172.31.47.0-255,66,239748,92,327966
27024,0.024828,172.217.194.0-255,5738,245486,92,327966
27025,0.024834,172.31.47.0-255,66,245552,92,327966
27026,0.026878,172.217.194.0-255,5738,251290,92,327966
27027,0.026885,172.31.47.0-255,66,251356,92,327966
27028,0.028926,172.217.194.0-255,4320,255676,92,327966
27029,0.02893,172.31.47.0-255,66,255742,92,327966
27030,0.028946,172.217.194.0-255,1484,257226,92,327966
27031,0.030953,172.217.194.0-255,4320,261546,92,327966
27032,0.030958,172.31.47.0-255,66,261612,92,327966
27033,0.033034,172.217.194.0-255,5738,267350,92,327966
27034,0.033108,172.31.47.0-255,66,267416,92,327966
27035,0.035179,172.217.194.0-255,5738,273154,92,327966
27036,0.035194,172.31.47.0-255,66,273220,92,327966
27037,0.037245,172.217.194.0-255,5738,278958,92,327966
27038,0.037251,172.31.47.0-255,66,279024,92,327966
27039,0.03927,172.217.194.0-255,2902,281926,92,327966
27040,0.039276,172.31.47.0-255,66,281992,92,327966
27041,0.039294,172.217.194.0-255,2902,284894,92,327966
27042,0.039325,172.31.47.0-255,66,284960,92,327966
27043,0.041346,172.217.194.0-255,2902,287862,92,327966
27044,0.041353,172.31.47.0-255,66,287928,92,327966
27045,0.041378,172.217.194.0-255,2902,290830,92,327966
27046,0.041404,172.31.47.0-255,66,290896,92,327966
27047,0.043413,172.217.194.0-255,2902,293798,92,327966
27048,0.043431,172.31.47.0-255,66,293864,92,327966
27049,0.04347,172.217.194.0-255,2902,296766,92,327966
27050,0.043535,172.31.47.0-255,66,296832,92,327966
27051,0.045483,172.217.194.0-255,2902,299734,92,327966
27052,0.045496,172.31.47.0-255,66,299800,92,327966
27053,0.04558,172.217.194.0-255,2902,302702,92,327966
27054,0.045625,172.31.47.0-255,66,302768,92,327966
27055,0.047535,172.217.194.0-255,2902,305670,92,327966
27056,0.04766,172.217.194.0-255,2902,308572,92,327966
27057,0.049561,172.31.47.0-255,66,308638,92,327966
27058,0.049894,172.31.47.0-255,172,308810,92,327966
27059,0.049942,172.31.47.0-255,1103,309913,92,327966
27060,0.050038,172.31.47.0-255,1514,311427,92,327966
27061,0.05004,172.31.47.0-255,1514,312941,92,327966
27062,0.050041,172.31.47.0-255,1514,314455,92,327966
27063,0.050042,172.31.47.0-255,1514,315969,92,327966
27064,0.050043,172.31.47.0-255,1506,317475,92,327966
27065,0.051452,104.244.42.0-255,66,317541,92,327966
27066,0.051476,104.244.42.0-255,66,317607,92,327966
27067,0.0516,104.244.42.0-255,66,317673,92,327966
27068,0.051606,172.217.194.0-255,5738,323411,92,327966
27069,0.051609,172.31.47.0-255,66,323477,92,327966
27070,0.051657,104.244.42.0-255,66,323543,92,327966
27071,0.053663,172.217.194.0-255,3832,327375,92,327966
27072,0.056503,172.31.47.0-255,66,327441,92,327966
27073,0.057727,172.31.47.0-255,105,327546,92,327966
27074,0.057946,172.31.47.0-255,90,327636,92,327966
27075,0.057955,172.31.47.0-255,66,327702,92,327966
27076,0.059729,172.217.194.0-255,66,327768,92,327966
27077,0.059959,172.217.194.0-255,66,327834,92,327966
27078,0.059981,172.217.194.0-255,66,327900,92,327966
27079,0.059985,172.31.47.0-255,66,327966,92,327966
27080,0.0,172.31.47.0-255,105,105,92,105
27081,0.0,74.125.24.0-255,153,153,92,203774
27082,2.1e-05,172.31.47.0-255,66,219,92,203774
27083,2.9e-05,74.125.24.0-255,1484,1703,92,203774
27084,3.3e-05,172.31.47.0-255,66,1769,92,203774
27085,3.9e-05,74.125.24.0-255,2902,4671,92,203774
27086,5.3e-05,172.31.47.0-255,66,4737,92,203774
27087,5.8e-05,74.125.24.0-255,4320,9057,92,203774
27088,6.1e-05,172.31.47.0-255,66,9123,92,203774
27089,9.5e-05,74.125.24.0-255,2902,12025,92,203774
27090,9.8e-05,172.31.47.0-255,66,12091,92,203774
27091,0.000103,74.125.24.0-255,1957,14048,92,203774
27092,0.000105,172.31.47.0-255,66,14114,92,203774
27093,0.000513,74.125.24.0-255,1484,15598,92,203774
27094,0.00052,172.31.47.0-255,66,15664,92,203774
27095,0.000527,74.125.24.0-255,2902,18566,92,203774
27096,0.00053,172.31.47.0-255,66,18632,92,203774
27097,0.000542,74.125.24.0-255,5738,24370,92,203774
27098,0.000545,172.31.47.0-255,66,24436,92,203774
27099,0.000579,74.125.24.0-255,2902,27338,92,203774
27100,0.000582,172.31.47.0-255,66,27404,92,203774
27101,0.000612,74.125.24.0-255,3961,31365,92,203774
27102,0.000616,172.31.47.0-255,66,31431,92,203774
27103,0.000695,74.125.24.0-255,1484,32915,92,203774
27104,0.0007,172.31.47.0-255,66,32981,92,203774
27105,0.000705,74.125.24.0-255,2902,35883,92,203774
27106,0.000709,172.31.47.0-255,66,35949,92,203774
27107,0.00073,74.125.24.0-255,5738,41687,92,203774
27108,0.000738,172.31.47.0-255,66,41753,92,203774
27109,0.000744,74.125.24.0-255,4320,46073,92,203774
27110,0.000746,172.31.47.0-255,66,46139,92,203774
27111,0.000794,172.31.47.0-255,66,46205,92,203774
27112,0.000802,74.125.24.0-255,7108,53313,92,203774
27113,0.000805,172.31.47.0-255,66,53379,92,203774
27114,0.000808,74.125.24.0-255,110,53489,92,203774
27115,0.000832,74.125.24.0-255,331,53820,92,203774
27116,0.000987,172.31.47.0-255,66,53886,92,203774
27117,0.002334,74.125.24.0-255,1484,55370,92,203774
27118,0.003226,74.125.24.0-255,1484,56854,92,203774
27119,0.003231,172.31.47.0-255,66,56920,92,203774
27120,0.003248,74.125.24.0-255,2902,59822,92,203774
27121,0.00325,172.31.47.0-255,66,59888,92,203774
27122,0.005513,74.125.24.0-255,2902,62790,92,203774
27123,0.005515,172.31.47.0-255,66,62856,92,203774
27124,0.005539,74.125.24.0-255,2902,65758,92,203774
27125,0.00554,172.31.47.0-255,66,65824,92,203774
27126,0.007794,74.125.24.0-255,2902,68726,92,203774
27127,0.007802,172.31.47.0-255,66,68792,92,203774
27128,0.007852,74.125.24.0-255,2902,71694,92,203774
27129,0.007856,172.31.47.0-255,66,71760,92,203774
27130,0.010086,74.125.24.0-255,2902,74662,92,203774
27131,0.010094,172.31.47.0-255,66,74728,92,203774
27132,0.010142,74.125.24.0-255,1484,76212,92,203774
27133,0.010157,74.125.24.0-255,1484,77696,92,203774
27134,0.010162,172.31.47.0-255,66,77762,92,203774
27135,0.012412,74.125.24.0-255,2902,80664,92,203774
27136,0.012424,172.31.47.0-255,66,80730,92,203774
27137,0.012479,74.125.24.0-255,2902,83632,92,203774
27138,0.012482,172.31.47.0-255,66,83698,92,203774
27139,0.014757,74.125.24.0-255,2902,86600,92,203774
27140,0.01477,172.31.47.0-255,66,86666,92,203774
27141,0.014808,74.125.24.0-255,2902,89568,92,203774
27142,0.014811,172.31.47.0-255,66,89634,92,203774
27143,0.017083,74.125.24.0-255,5738,95372,92,203774
27144,0.017092,172.31.47.0-255,66,95438,92,203774
27145,0.019422,74.125.24.0-255,5738,101176,92,203774
27146,0.01943,172.31.47.0-255,66,101242,92,203774
27147,0.021728,74.125.24.0-255,5738,106980,92,203774
27148,0.021737,172.31.47.0-255,66,107046,92,203774
27149,0.024068,74.125.24.0-255,5738,112784,92,203774
27150,0.024076,172.31.47.0-255,66,112850,92,203774
27151,0.026445,74.125.24.0-255,5738,118588,92,203774
27152,0.026454,172.31.47.0-255,66,118654,92,203774
27153,0.028763,74.125.24.0-255,5738,124392,92,203774
27154,0.028769,172.31.47.0-255,66,124458,92,203774
27155,0.028816,172.31.47.0-255,172,124630,92,203774
27156,0.028845,172.31.47.0-255,1112,125742,92,203774
27157,0.028888,172.31.47.0-255,1514,127256,92,203774
27158,0.028889,172.31.47.0-255,1514,128770,92,203774
27159,0.028891,172.31.47.0-255,1514,130284,92,203774
27160,0.028891,172.31.47.0-255,1514,131798,92,203774
27161,0.028914,172.31.47.0-255,1494,133292,92,203774
27162,0.030345,104.244.42.0-255,66,133358,92,203774
27163,0.030378,104.244.42.0-255,66,133424,92,203774
27164,0.030474,104.244.42.0-255,66,133490,92,203774
27165,0.031054,74.125.24.0-255,4320,137810,92,203774
27166,0.031064,172.31.47.0-255,66,137876,92,203774
27167,0.0311,74.125.24.0-255,1484,139360,92,203774
27168,0.031144,104.244.42.0-255,108,139468,92,203774
27169,0.031147,172.31.47.0-255,66,139534,92,203774
27170,0.033362,74.125.24.0-255,4320,143854,92,203774
27171,0.033373,172.31.47.0-255,66,143920,92,203774
27172,0.035654,74.125.24.0-255,4320,148240,92,203774
27173,0.03566,172.31.47.0-255,66,148306,92,203774
27174,0.03569,74.125.24.0-255,1484,149790,92,203774
27175,0.037952,74.125.24.0-255,4320,154110,92,203774
27176,0.037957,172.31.47.0-255,66,154176,92,203774
27177,0.04023,74.125.24.0-255,5738,159914,92,203774
27178,0.040236,172.31.47.0-255,66,159980,92,203774
27179,0.042524,74.125.24.0-255,5738,165718,92,203774
27180,0.042529,172.31.47.0-255,66,165784,92,203774
27181,0.044826,74.125.24.0-255,1484,167268,92,203774
27182,0.044856,74.125.24.0-255,4320,171588,92,203774
27183,0.04486,172.31.47.0-255,66,171654,92,203774
27184,0.047128,74.125.24.0-255,4320,175974,92,203774
27185,0.047133,172.31.47.0-255,66,176040,92,203774
27186,0.047164,74.125.24.0-255,1484,177524,92,203774
27187,0.049401,74.125.24.0-255,4320,181844,92,203774
27188,0.049406,172.31.47.0-255,66,181910,92,203774
27189,0.051687,74.125.24.0-255,5738,187648,92,203774
27190,0.051693,172.31.47.0-255,66,187714,92,203774
27191,0.053958,74.125.24.0-255,4320,192034,92,203774
27192,0.053963,172.31.47.0-255,66,192100,92,203774
27193,0.053989,74.125.24.0-255,1484,193584,92,203774
27194,0.056277,74.125.24.0-255,4320,197904,92,203774
27195,0.056285,172.31.47.0-255,66,197970,92,203774
27196,0.058559,74.125.24.0-255,5738,203708,92,203774
27197,0.058564,172.31.47.0-255,66,203774,92,203774
27198,0.0,172.217.194.0-255,153,153,92,335036
27199,1.5e-05,172.31.47.0-255,66,219,92,335036
27200,4.1e-05,172.217.194.0-255,1484,1703,92,335036
27201,4.6e-05,172.31.47.0-255,66,1769,92,335036
27202,5.1e-05,172.217.194.0-255,2902,4671,92,335036
27203,5.3e-05,172.31.47.0-255,66,4737,92,335036
27204,6.1e-05,172.217.194.0-255,7156,11893,92,335036
27205,6.3e-05,172.31.47.0-255,66,11959,92,335036
27206,8.8e-05,172.217.194.0-255,4938,16897,92,335036
27207,9.1e-05,172.31.47.0-255,66,16963,92,335036
27208,0.000131,172.31.47.0-255,66,17029,92,335036
27209,0.00018,172.217.194.0-255,4320,21349,92,335036
27210,0.000183,172.31.47.0-255,66,21415,92,335036
27211,0.000191,172.217.194.0-255,5738,27153,92,335036
27212,0.000193,172.31.47.0-255,66,27219,92,335036
27213,0.000212,172.217.194.0-255,2902,30121,92,335036
27214,0.000214,172.31.47.0-255,66,30187,92,335036
27215,0.00025,172.31.47.0-255,66,30253,92,335036
27216,0.000254,172.217.194.0-255,2902,33155,92,335036
27217,0.000256,172.31.47.0-255,66,33221,92,335036
27218,0.000307,172.31.47.0-255,66,33287,92,335036
27219,0.000324,172.217.194.0-255,120,33407,92,335036
27220,0.000326,172.31.47.0-255,66,33473,92,335036
27221,0.000354,172.217.194.0-255,380,33853,92,335036
27222,0.000358,172.31.47.0-255,66,33919,92,335036
27223,0.000669,172.217.194.0-255,1484,35403,92,335036
27224,0.000673,172.31.47.0-255,66,35469,92,335036
27225,0.000678,172.217.194.0-255,2902,38371,92,335036
27226,0.000679,172.31.47.0-255,66,38437,92,335036
27227,0.000697,172.217.194.0-255,5738,44175,92,335036
27228,0.0007,172.31.47.0-255,66,44241,92,335036
27229,0.000722,172.217.194.0-255,7156,51397,92,335036
27230,0.000725,172.31.47.0-255,66,51463,92,335036
27231,0.00075,172.217.194.0-255,5738,57201,92,335036
27232,0.000753,172.31.47.0-255,66,57267,92,335036
27233,0.000763,172.31.47.0-255,66,57333,92,335036
27234,0.001342,172.217.194.0-255,1484,58817,92,335036
27235,0.001347,172.31.47.0-255,66,58883,92,335036
27236,0.001382,172.217.194.0-255,2902,61785,92,335036
27237,0.001385,172.31.47.0-255,66,61851,92,335036
27238,0.001406,172.217.194.0-255,5738,67589,92,335036
27239,0.001408,172.31.47.0-255,66,67655,92,335036
27240,0.001411,172.217.194.0-255,1484,69139,92,335036
27241,0.001433,172.217.194.0-255,1484,70623,92,335036
27242,0.001435,172.31.47.0-255,66,70689,92,335036
27243,0.001458,172.217.194.0-255,4320,75009,92,335036
27244,0.001477,172.217.194.0-255,6438,81447,92,335036
27245,0.00149,172.217.194.0-255,4320,85767,92,335036
27246,0.001514,172.217.194.0-255,7156,92923,92,335036
27247,0.001543,172.217.194.0-255,5738,98661,92,335036
27248,0.001561,172.217.194.0-255,1484,100145,92,335036
27249,0.001572,172.217.194.0-255,4320,104465,92,335036
27250,0.001583,172.217.194.0-255,2184,106649,92,335036
27251,0.001661,172.217.194.0-255,1484,108133,92,335036
27252,0.001673,172.217.194.0-255,2902,111035,92,335036
27253,0.001695,172.217.194.0-255,5738,116773,92,335036
27254,0.001734,172.217.194.0-255,5738,122511,92,335036
27255,0.001749,172.217.194.0-255,4320,126831,92,335036
27256,0.001751,172.217.194.0-255,766,127597,92,335036
27257,0.001776,172.217.194.0-255,1484,129081,92,335036
27258,0.001795,172.217.194.0-255,4320,133401,92,335036
27259,0.001798,172.217.194.0-255,2902,136303,92,335036
27260,0.00182,172.217.194.0-255,7156,143459,92,335036
27261,0.001825,172.217.194.0-255,5738,149197,92,335036
27262,0.001842,172.217.194.0-255,4320,153517,92,335036
27263,0.001871,172.217.194.0-255,4320,157837,92,335036
27264,0.001884,172.217.194.0-255,3602,161439,92,335036
27265,0.00198,172.217.194.0-255,1484,162923,92,335036
27266,0.001984,172.217.194.0-255,2902,165825,92,335036
27267,0.00203,172.217.194.0-255,5738,171563,92,335036
27268,0.002035,172.217.194.0-255,7156,178719,92,335036
27269,0.002043,172.217.194.0-255,4320,183039,92,335036
27270,0.002056,172.217.194.0-255,4320,187359,92,335036
27271,0.002071,172.217.194.0-255,4320,191679,92,335036
27272,0.002083,172.217.194.0-255,3602,195281,92,335036
27273,0.002087,172.217.194.0-255,4320,199601,92,335036
27274,0.002102,172.217.194.0-255,4320,203921,92,335036
27275,0.002117,172.217.194.0-255,2902,206823,92,335036
27276,0.002153,172.217.194.0-255,4320,211143,92,335036
27277,0.002171,172.217.194.0-255,2184,213327,92,335036
27278,0.002263,172.217.194.0-255,1484,214811,92,335036
27279,0.002267,172.217.194.0-255,2902,217713,92,335036
27280,0.002301,172.217.194.0-255,2902,220615,92,335036
27281,0.002306,172.217.194.0-255,5738,226353,92,335036
27282,0.002317,172.217.194.0-255,1484,227837,92,335036
27283,0.002342,172.217.194.0-255,2902,230739,92,335036
27284,0.005188,172.31.47.0-255,66,230805,92,335036
27285,0.007513,172.217.194.0-255,5738,236543,92,335036
27286,0.007526,172.31.47.0-255,66,236609,92,335036
27287,0.009815,172.217.194.0-255,5738,242347,92,335036
27288,0.009823,172.31.47.0-255,66,242413,92,335036
27289,0.012076,172.217.194.0-255,5738,248151,92,335036
27290,0.012085,172.31.47.0-255,66,248217,92,335036
27291,0.01434,172.217.194.0-255,5738,253955,92,335036
27292,0.014349,172.31.47.0-255,66,254021,92,335036
27293,0.016637,172.217.194.0-255,5738,259759,92,335036
27294,0.016646,172.31.47.0-255,66,259825,92,335036
27295,0.018927,172.217.194.0-255,5738,265563,92,335036
27296,0.018936,172.31.47.0-255,66,265629,92,335036
27297,0.021197,172.217.194.0-255,4320,269949,92,335036
27298,0.021204,172.31.47.0-255,66,270015,92,335036
27299,0.021217,172.217.194.0-255,1484,271499,92,335036
27300,0.02351,172.217.194.0-255,4320,275819,92,335036
27301,0.023517,172.31.47.0-255,66,275885,92,335036
27302,0.025795,172.217.194.0-255,5738,281623,92,335036
27303,0.02581,172.31.47.0-255,66,281689,92,335036
27304,0.028069,172.217.194.0-255,5738,287427,92,335036
27305,0.028076,172.31.47.0-255,66,287493,92,335036
27306,0.030372,172.217.194.0-255,5738,293231,92,335036
27307,0.030379,172.31.47.0-255,66,293297,92,335036
27308,0.032647,172.217.194.0-255,5738,299035,92,335036
27309,0.032654,172.31.47.0-255,66,299101,92,335036
27310,0.034455,172.31.47.0-255,172,299273,92,335036
27311,0.034486,172.31.47.0-255,1107,300380,92,335036
27312,0.034526,172.31.47.0-255,1514,301894,92,335036
27313,0.034528,172.31.47.0-255,1514,303408,92,335036
27314,0.034529,172.31.47.0-255,1514,304922,92,335036
27315,0.03453,172.31.47.0-255,1514,306436,92,335036
27316,0.034531,172.31.47.0-255,1499,307935,92,335036
27317,0.034926,172.217.194.0-255,5738,313673,92,335036
27318,0.034932,172.31.47.0-255,66,313739,92,335036
27319,0.03599,104.244.42.0-255,66,313805,92,335036
27320,0.036033,104.244.42.0-255,66,313871,92,335036
27321,0.036127,104.244.42.0-255,66,313937,92,335036
27322,0.037204,172.217.194.0-255,5738,319675,92,335036
27323,0.037211,172.31.47.0-255,66,319741,92,335036
27324,0.039511,172.217.194.0-255,5738,325479,92,335036
27325,0.039517,172.31.47.0-255,66,325545,92,335036
27326,0.041833,172.217.194.0-255,5738,331283,92,335036
27327,0.041839,172.31.47.0-255,66,331349,92,335036
27328,0.044113,172.217.194.0-255,3450,334799,92,335036
27329,0.04412,172.31.47.0-255,66,334865,92,335036
27330,0.044313,172.31.47.0-255,105,334970,92,335036
27331,0.046597,172.217.194.0-255,66,335036,92,335036
27332,0.0,172.31.47.0-255,105,105,92,105
27333,0.0,172.217.26.0-255,153,153,92,246011
27334,1.5e-05,172.31.47.0-255,66,219,92,246011
27335,2e-05,172.217.26.0-255,1484,1703,92,246011
27336,2.4e-05,172.31.47.0-255,66,1769,92,246011
27337,2.8e-05,172.217.26.0-255,2902,4671,92,246011
27338,3e-05,172.31.47.0-255,66,4737,92,246011
27339,4.3e-05,172.217.26.0-255,7156,11893,92,246011
27340,4.6e-05,172.31.47.0-255,66,11959,92,246011
27341,5e-05,172.217.26.0-255,2216,14175,92,246011
27342,5.1e-05,172.31.47.0-255,66,14241,92,246011
27343,9.2e-05,172.217.26.0-255,1484,15725,92,246011
27344,9.4e-05,172.31.47.0-255,66,15791,92,246011
27345,9.7e-05,172.217.26.0-255,1484,17275,92,246011
27346,9.9e-05,172.31.47.0-255,66,17341,92,246011
27347,0.000119,172.217.26.0-255,1484,18825,92,246011
27348,0.00012,172.31.47.0-255,66,18891,92,246011
27349,0.000131,172.217.26.0-255,5738,24629,92,246011
27350,0.000133,172.31.47.0-255,66,24695,92,246011
27351,0.000163,172.217.26.0-255,6797,31492,92,246011
27352,0.000165,172.31.47.0-255,66,31558,92,246011
27353,0.000287,172.217.26.0-255,1484,33042,92,246011
27354,0.000291,172.31.47.0-255,66,33108,92,246011
27355,0.000303,172.217.26.0-255,2902,36010,92,246011
27356,0.000309,172.31.47.0-255,66,36076,92,246011
27357,0.000314,172.217.26.0-255,4320,40396,92,246011
27358,0.000315,172.31.47.0-255,66,40462,92,246011
27359,0.00033,172.217.26.0-255,1484,41946,92,246011
27360,0.000332,172.31.47.0-255,66,42012,92,246011
27361,0.000359,172.31.47.0-255,66,42078,92,246011
27362,0.000385,172.217.26.0-255,5379,47457,92,246011
27363,0.000388,172.31.47.0-255,66,47523,92,246011
27364,0.000413,172.217.26.0-255,1125,48648,92,246011
27365,0.000415,172.217.26.0-255,394,49042,92,246011
27366,0.000467,172.31.47.0-255,66,49108,92,246011
27367,0.001092,172.217.26.0-255,348,49456,92,246011
27368,0.001117,172.31.47.0-255,66,49522,92,246011
27369,0.001254,172.217.26.0-255,1484,51006,92,246011
27370,0.001261,172.217.26.0-255,1484,52490,92,246011
27371,0.001264,172.217.26.0-255,1484,53974,92,246011
27372,0.001276,172.217.26.0-255,1484,55458,92,246011
27373,0.001285,172.217.26.0-255,5738,61196,92,246011
27374,0.001307,172.217.26.0-255,2902,64098,92,246011
27375,0.001315,172.31.47.0-255,66,64164,92,246011
27376,0.001326,172.217.26.0-255,5738,69902,92,246011
27377,0.001345,172.217.26.0-255,5379,75281,92,246011
27378,0.00137,172.31.47.0-255,66,75347,92,246011
27379,0.003321,172.217.26.0-255,5738,81085,92,246011
27380,0.003325,172.31.47.0-255,66,81151,92,246011
27381,0.0053,172.217.26.0-255,5738,86889,92,246011
27382,0.005306,172.31.47.0-255,66,86955,92,246011
27383,0.007239,172.217.26.0-255,5738,92693,92,246011
27384,0.007244,172.31.47.0-255,66,92759,92,246011
27385,0.009206,172.217.26.0-255,5738,98497,92,246011
27386,0.009211,172.31.47.0-255,66,98563,92,246011
27387,0.011187,172.217.26.0-255,5738,104301,92,246011
27388,0.011196,172.31.47.0-255,66,104367,92,246011
27389,0.013165,172.217.26.0-255,5738,110105,92,246011
27390,0.013173,172.31.47.0-255,66,110171,92,246011
27391,0.015115,172.217.26.0-255,5738,115909,92,246011
27392,0.015121,172.31.47.0-255,66,115975,92,246011
27393,0.017066,172.217.26.0-255,5738,121713,92,246011
27394,0.017072,172.31.47.0-255,66,121779,92,246011
27395,0.01901,172.217.26.0-255,4320,126099,92,246011
27396,0.019015,172.31.47.0-255,66,126165,92,246011
27397,0.019041,172.217.26.0-255,1484,127649,92,246011
27398,0.020959,172.217.26.0-255,4320,131969,92,246011
27399,0.020965,172.31.47.0-255,66,132035,92,246011
27400,0.022927,172.217.26.0-255,5738,137773,92,246011
27401,0.022971,172.31.47.0-255,66,137839,92,246011
27402,0.024073,172.31.47.0-255,172,138011,92,246011
27403,0.024105,172.31.47.0-255,1107,139118,92,246011
27404,0.024149,172.31.47.0-255,1514,140632,92,246011
27405,0.024151,172.31.47.0-255,1514,142146,92,246011
27406,0.024153,172.31.47.0-255,1514,143660,92,246011
27407,0.024154,172.31.47.0-255,1514,145174,92,246011
27408,0.024155,172.31.47.0-255,1499,146673,92,246011
27409,0.024924,172.217.26.0-255,5738,152411,92,246011
27410,0.024931,172.31.47.0-255,66,152477,92,246011
27411,0.025622,104.244.42.0-255,66,152543,92,246011
27412,0.025666,104.244.42.0-255,66,152609,92,246011
27413,0.025759,104.244.42.0-255,66,152675,92,246011
27414,0.02688,172.217.26.0-255,4320,156995,92,246011
27415,0.026884,172.31.47.0-255,66,157061,92,246011
27416,0.026915,104.244.42.0-255,108,157169,92,246011
27417,0.026918,172.31.47.0-255,66,157235,92,246011
27418,0.02692,172.217.26.0-255,1484,158719,92,246011
27419,0.028815,172.217.26.0-255,2902,161621,92,246011
27420,0.02882,172.31.47.0-255,66,161687,92,246011
27421,0.028848,172.217.26.0-255,1484,163171,92,246011
27422,0.030755,172.217.26.0-255,4320,167491,92,246011
27423,0.030799,172.31.47.0-255,66,167557,92,246011
27424,0.032737,172.217.26.0-255,2902,170459,92,246011
27425,0.032742,172.31.47.0-255,66,170525,92,246011
27426,0.032807,172.217.26.0-255,2902,173427,92,246011
27427,0.03282,172.31.47.0-255,66,173493,92,246011
27428,0.034691,172.217.26.0-255,2902,176395,92,246011
27429,0.034696,172.31.47.0-255,66,176461,92,246011
27430,0.034743,172.217.26.0-255,2902,179363,92,246011
27431,0.034759,172.31.47.0-255,66,179429,92,246011
27432,0.036641,172.217.26.0-255,2902,182331,92,246011
27433,0.036645,172.31.47.0-255,66,182397,92,246011
27434,0.036735,172.217.26.0-255,2902,185299,92,246011
27435,0.036739,172.31.47.0-255,66,185365,92,246011
27436,0.038581,172.217.26.0-255,2902,188267,92,246011
27437,0.038586,172.31.47.0-255,66,188333,92,246011
27438,0.038663,172.217.26.0-255,2902,191235,92,246011
27439,0.038675,172.31.47.0-255,66,191301,92,246011
27440,0.040517,172.217.26.0-255,2902,194203,92,246011
27441,0.040521,172.31.47.0-255,66,194269,92,246011
27442,0.0406,172.217.26.0-255,2902,197171,92,246011
27443,0.040604,172.31.47.0-255,66,197237,92,246011
27444,0.042455,172.217.26.0-255,2902,200139,92,246011
27445,0.042459,172.31.47.0-255,66,200205,92,246011
27446,0.042523,172.217.26.0-255,2902,203107,92,246011
27447,0.042529,172.31.47.0-255,66,203173,92,246011
27448,0.044388,172.217.26.0-255,2902,206075,92,246011
27449,0.044393,172.31.47.0-255,66,206141,92,246011
27450,0.044457,172.217.26.0-255,2902,209043,92,246011
27451,0.044475,172.31.47.0-255,66,209109,92,246011
27452,0.046324,172.217.26.0-255,2902,212011,92,246011
27453,0.046329,172.31.47.0-255,66,212077,92,246011
27454,0.046394,172.217.26.0-255,2902,214979,92,246011
27455,0.046405,172.31.47.0-255,66,215045,92,246011
27456,0.048264,172.217.26.0-255,2902,217947,92,246011
27457,0.048269,172.31.47.0-255,66,218013,92,246011
27458,0.048331,172.217.26.0-255,2902,220915,92,246011
27459,0.048344,172.31.47.0-255,66,220981,92,246011
27460,0.050199,172.217.26.0-255,2902,223883,92,246011
27461,0.050204,172.31.47.0-255,66,223949,92,246011
27462,0.050274,172.217.26.0-255,2902,226851,92,246011
27463,0.050281,172.31.47.0-255,66,226917,92,246011
27464,0.052152,172.217.26.0-255,2902,229819,92,246011
27465,0.052161,172.31.47.0-255,66,229885,92,246011
27466,0.052204,172.217.26.0-255,2902,232787,92,246011
27467,0.05411,172.217.26.0-255,2902,235689,92,246011
27468,0.054229,172.31.47.0-255,66,235755,92,246011
27469,0.056162,172.217.26.0-255,4320,240075,92,246011
27470,0.056168,172.31.47.0-255,66,240141,92,246011
27471,0.056199,172.217.26.0-255,1484,241625,92,246011
27472,0.058137,172.217.26.0-255,4320,245945,92,246011
27473,0.058143,172.31.47.0-255,66,246011,92,246011
27474,0.0,172.217.27.0-255,153,153,92,349134
27475,2.3e-05,172.31.47.0-255,66,219,92,349134
27476,2.8e-05,172.217.27.0-255,1484,1703,92,349134
27477,3.2e-05,172.31.47.0-255,66,1769,92,349134
27478,3.4e-05,172.217.27.0-255,1484,3253,92,349134
27479,3.6e-05,172.31.47.0-255,66,3319,92,349134
27480,4e-05,172.217.27.0-255,2902,6221,92,349134
27481,4.3e-05,172.31.47.0-255,66,6287,92,349134
27482,4.8e-05,172.217.27.0-255,4320,10607,92,349134
27483,5e-05,172.31.47.0-255,66,10673,92,349134
27484,6.2e-05,172.217.27.0-255,1484,12157,92,349134
27485,6.5e-05,172.31.47.0-255,66,12223,92,349134
27486,8e-05,172.217.27.0-255,1949,14172,92,349134
27487,8.2e-05,172.31.47.0-255,66,14238,92,349134
27488,0.000107,172.217.27.0-255,2902,17140,92,349134
27489,0.00011,172.31.47.0-255,66,17206,92,349134
27490,0.000129,172.217.27.0-255,7156,24362,92,349134
27491,0.000131,172.31.47.0-255,66,24428,92,349134
27492,0.000133,172.217.27.0-255,1484,25912,92,349134
27493,0.000135,172.31.47.0-255,66,25978,92,349134
27494,0.000154,172.217.27.0-255,5379,31357,92,349134
27495,0.000156,172.31.47.0-255,66,31423,92,349134
27496,0.00019,172.217.27.0-255,1484,32907,92,349134
27497,0.000192,172.31.47.0-255,66,32973,92,349134
27498,0.000195,172.217.27.0-255,1484,34457,92,349134
27499,0.000196,172.31.47.0-255,66,34523,92,349134
27500,0.000209,172.217.27.0-255,1484,36007,92,349134
27501,0.000211,172.31.47.0-255,66,36073,92,349134
27502,0.000223,172.217.27.0-255,2902,38975,92,349134
27503,0.000225,172.31.47.0-255,66,39041,92,349134
27504,0.000236,172.217.27.0-255,1484,40525,92,349134
27505,0.000238,172.31.47.0-255,66,40591,92,349134
27506,0.000244,172.217.27.0-255,4320,44911,92,349134
27507,0.000246,172.31.47.0-255,66,44977,92,349134
27508,0.000292,172.217.27.0-255,2902,47879,92,349134
27509,0.000295,172.31.47.0-255,66,47945,92,349134
27510,0.000312,172.217.27.0-255,1125,49070,92,349134
27511,0.000317,172.217.27.0-255,4320,53390,92,349134
27512,0.000319,172.31.47.0-255,66,53456,92,349134
27513,0.000323,172.217.27.0-255,2902,56358,92,349134
27514,0.000325,172.31.47.0-255,66,56424,92,349134
27515,0.000342,172.217.27.0-255,7156,63580,92,349134
27516,0.000345,172.31.47.0-255,66,63646,92,349134
27517,0.000348,172.217.27.0-255,2543,66189,92,349134
27518,0.00035,172.31.47.0-255,66,66255,92,349134
27519,0.000371,172.217.27.0-255,393,66648,92,349134
27520,0.000665,172.31.47.0-255,66,66714,92,349134
27521,0.00068,172.217.27.0-255,114,66828,92,349134
27522,0.000717,172.31.47.0-255,66,66894,92,349134
27523,0.000824,172.217.27.0-255,1484,68378,92,349134
27524,0.000832,172.217.27.0-255,2902,71280,92,349134
27525,0.000836,172.31.47.0-255,66,71346,92,349134
27526,0.000842,172.217.27.0-255,5738,77084,92,349134
27527,0.000844,172.31.47.0-255,66,77150,92,349134
27528,0.000859,172.217.27.0-255,1484,78634,92,349134
27529,0.000877,172.217.27.0-255,6797,85431,92,349134
27530,0.00088,172.31.47.0-255,66,85497,92,349134
27531,0.000887,172.217.27.0-255,7156,92653,92,349134
27532,0.000889,172.31.47.0-255,66,92719,92,349134
27533,0.000909,172.217.27.0-255,1484,94203,92,349134
27534,0.000917,172.217.27.0-255,6797,101000,92,349134
27535,0.00092,172.31.47.0-255,66,101066,92,349134
27536,0.001154,172.217.27.0-255,1484,102550,92,349134
27537,0.001161,172.217.27.0-255,2902,105452,92,349134
27538,0.001166,172.31.47.0-255,66,105518,92,349134
27539,0.001172,172.217.27.0-255,4320,109838,92,349134
27540,0.001174,172.31.47.0-255,66,109904,92,349134
27541,0.001207,172.31.47.0-255,66,109970,92,349134
27542,0.001257,172.31.47.0-255,66,110036,92,349134
27543,0.001274,172.217.27.0-255,2184,112220,92,349134
27544,0.001276,172.31.47.0-255,66,112286,92,349134
27545,0.001412,172.217.27.0-255,1484,113770,92,349134
27546,0.00142,172.217.27.0-255,2902,116672,92,349134
27547,0.001424,172.31.47.0-255,66,116738,92,349134
27548,0.001427,172.217.27.0-255,1484,118222,92,349134
27549,0.001431,172.217.27.0-255,2902,121124,92,349134
27550,0.001433,172.31.47.0-255,66,121190,92,349134
27551,0.001438,172.217.27.0-255,5738,126928,92,349134
27552,0.00144,172.31.47.0-255,66,126994,92,349134
27553,0.001465,172.217.27.0-255,4320,131314,92,349134
27554,0.001467,172.31.47.0-255,66,131380,92,349134
27555,0.001495,172.31.47.0-255,66,131446,92,349134
27556,0.001502,172.217.27.0-255,6438,137884,92,349134
27557,0.001504,172.31.47.0-255,66,137950,92,349134
27558,0.003156,172.217.27.0-255,4320,142270,92,349134
27559,0.003161,172.31.47.0-255,66,142336,92,349134
27560,0.003177,172.217.27.0-255,1484,143820,92,349134
27561,0.00481,172.217.27.0-255,4320,148140,92,349134
27562,0.004815,172.31.47.0-255,66,148206,92,349134
27563,0.00648,172.217.27.0-255,5738,153944,92,349134
27564,0.006486,172.31.47.0-255,66,154010,92,349134
27565,0.008139,172.217.27.0-255,5738,159748,92,349134
27566,0.008146,172.31.47.0-255,66,159814,92,349134
27567,0.009883,172.217.27.0-255,5738,165552,92,349134
27568,0.009891,172.31.47.0-255,66,165618,92,349134
27569,0.011548,172.217.27.0-255,5738,171356,92,349134
27570,0.011555,172.31.47.0-255,66,171422,92,349134
27571,0.013215,172.217.27.0-255,5738,177160,92,349134
27572,0.013223,172.31.47.0-255,66,177226,92,349134
27573,0.014882,172.217.27.0-255,5738,182964,92,349134
27574,0.01489,172.31.47.0-255,66,183030,92,349134
27575,0.016543,172.217.27.0-255,4320,187350,92,349134
27576,0.016549,172.31.47.0-255,66,187416,92,349134
27577,0.016575,172.217.27.0-255,1484,188900,92,349134
27578,0.018201,172.217.27.0-255,4320,193220,92,349134
27579,0.018209,172.31.47.0-255,66,193286,92,349134
27580,0.019867,172.217.27.0-255,5738,199024,92,349134
27581,0.019874,172.31.47.0-255,66,199090,92,349134
27582,0.021545,172.217.27.0-255,5738,204828,92,349134
27583,0.021554,172.31.47.0-255,66,204894,92,349134
27584,0.023206,172.217.27.0-255,2902,207796,92,349134
27585,0.023212,172.31.47.0-255,66,207862,92,349134
27586,0.023244,172.217.27.0-255,2902,210764,92,349134
27587,0.023247,172.31.47.0-255,66,210830,92,349134
27588,0.024868,172.217.27.0-255,2902,213732,92,349134
27589,0.024875,172.31.47.0-255,66,213798,92,349134
27590,0.024898,172.217.27.0-255,2902,216700,92,349134
27591,0.0249,172.31.47.0-255,66,216766,92,349134
27592,0.026556,172.217.27.0-255,5738,222504,92,349134
27593,0.026575,172.31.47.0-255,66,222570,92,349134
27594,0.028232,172.217.27.0-255,5738,228308,92,349134
27595,0.028238,172.31.47.0-255,66,228374,92,349134
27596,0.029907,172.217.27.0-255,5738,234112,92,349134
27597,0.029915,172.31.47.0-255,66,234178,92,349134
27598,0.031577,172.217.27.0-255,5738,239916,92,349134
27599,0.031585,172.31.47.0-255,66,239982,92,349134
27600,0.033246,172.217.27.0-255,5738,245720,92,349134
27601,0.033252,172.31.47.0-255,66,245786,92,349134
27602,0.033869,172.31.47.0-255,172,245958,92,349134
27603,0.033899,172.31.47.0-255,1111,247069,92,349134
27604,0.033965,172.31.47.0-255,1514,248583,92,349134
27605,0.033967,172.31.47.0-255,1514,250097,92,349134
27606,0.033968,172.31.47.0-255,1514,251611,92,349134
27607,0.033969,172.31.47.0-255,1514,253125,92,349134
27608,0.03397,172.31.47.0-255,1495,254620,92,349134
27609,0.034909,172.217.27.0-255,5738,260358,92,349134
27610,0.034914,172.31.47.0-255,66,260424,92,349134
27611,0.035452,104.244.42.0-255,66,260490,92,349134
27612,0.035458,104.244.42.0-255,66,260556,92,349134
27613,0.035542,104.244.42.0-255,66,260622,92,349134
27614,0.036566,172.217.27.0-255,5738,266360,92,349134
27615,0.036571,172.31.47.0-255,66,266426,92,349134
27616,0.03822,172.217.27.0-255,2902,269328,92,349134
27617,0.038224,172.31.47.0-255,66,269394,92,349134
27618,0.038253,172.217.27.0-255,2902,272296,92,349134
27619,0.038256,172.31.47.0-255,66,272362,92,349134
27620,0.039897,172.217.27.0-255,2902,275264,92,349134
27621,0.039902,172.31.47.0-255,66,275330,92,349134
27622,0.039929,172.217.27.0-255,2902,278232,92,349134
27623,0.039931,172.31.47.0-255,66,278298,92,349134
27624,0.041577,172.217.27.0-255,2902,281200,92,349134
27625,0.041582,172.31.47.0-255,66,281266,92,349134
27626,0.041615,172.217.27.0-255,2902,284168,92,349134
27627,0.041618,172.31.47.0-255,66,284234,92,349134
27628,0.043227,172.217.27.0-255,2902,287136,92,349134
27629,0.043231,172.31.47.0-255,66,287202,92,349134
27630,0.043256,172.217.27.0-255,2902,290104,92,349134
27631,0.043259,172.31.47.0-255,66,290170,92,349134
27632,0.044878,172.217.27.0-255,2902,293072,92,349134
27633,0.044883,172.31.47.0-255,66,293138,92,349134
27634,0.044911,172.217.27.0-255,2902,296040,92,349134
27635,0.044914,172.31.47.0-255,66,296106,92,349134
27636,0.046538,172.217.27.0-255,2902,299008,92,349134
27637,0.046542,172.31.47.0-255,66,299074,92,349134
27638,0.04658,172.217.27.0-255,2902,301976,92,349134
27639,0.046583,172.31.47.0-255,66,302042,92,349134
27640,0.048189,172.217.27.0-255,2902,304944,92,349134
27641,0.048193,172.31.47.0-255,66,305010,92,349134
27642,0.048222,172.217.27.0-255,2902,307912,92,349134
27643,0.048225,172.31.47.0-255,66,307978,92,349134
27644,0.049846,172.217.27.0-255,2902,310880,92,349134
27645,0.049851,172.31.47.0-255,66,310946,92,349134
27646,0.049877,172.217.27.0-255,2902,313848,92,349134
27647,0.049879,172.31.47.0-255,66,313914,92,349134
27648,0.051524,172.217.27.0-255,2902,316816,92,349134
27649,0.051529,172.31.47.0-255,66,316882,92,349134
27650,0.051562,172.217.27.0-255,2902,319784,92,349134
27651,0.051564,172.31.47.0-255,66,319850,92,349134
27652,0.053174,172.217.27.0-255,2902,322752,92,349134
27653,0.053178,172.31.47.0-255,66,322818,92,349134
27654,0.053206,172.217.27.0-255,2902,325720,92,349134
27655,0.053208,172.31.47.0-255,66,325786,92,349134
27656,0.05482,172.217.27.0-255,2902,328688,92,349134
27657,0.054837,172.31.47.0-255,66,328754,92,349134
27658,0.054853,172.217.27.0-255,2902,331656,92,349134
27659,0.054856,172.31.47.0-255,66,331722,92,349134
27660,0.056495,172.217.27.0-255,5738,337460,92,349134
27661,0.0565,172.31.47.0-255,66,337526,92,349134
27662,0.058156,172.217.27.0-255,5738,343264,92,349134
27663,0.05816,172.31.47.0-255,66,343330,92,349134
27664,0.059804,172.217.27.0-255,5738,349068,92,349134
27665,0.059808,172.31.47.0-255,66,349134,92,349134
27666,0.0,74.125.24.0-255,143,143,92,172642
27667,3.3e-05,172.31.47.0-255,66,209,92,172642
27668,4e-05,74.125.24.0-255,1484,1693,92,172642
27669,4.4e-05,172.31.47.0-255,66,1759,92,172642
27670,4.9e-05,74.125.24.0-255,2902,4661,92,172642
27671,5.2e-05,172.31.47.0-255,66,4727,92,172642
27672,5.9e-05,74.125.24.0-255,7156,11883,92,172642
27673,6.2e-05,172.31.47.0-255,66,11949,92,172642
27674,6.6e-05,74.125.24.0-255,4320,16269,92,172642
27675,6.9e-05,172.31.47.0-255,66,16335,92,172642
27676,0.000108,172.31.47.0-255,66,16401,92,172642
27677,0.000112,74.125.24.0-255,2543,18944,92,172642
27678,0.000114,172.31.47.0-255,66,19010,92,172642
27679,0.000153,74.125.24.0-255,1484,20494,92,172642
27680,0.000156,172.31.47.0-255,66,20560,92,172642
27681,0.00016,74.125.24.0-255,2902,23462,92,172642
27682,0.000164,172.31.47.0-255,66,23528,92,172642
27683,0.000184,74.125.24.0-255,5738,29266,92,172642
27684,0.000187,172.31.47.0-255,66,29332,92,172642
27685,0.000203,74.125.24.0-255,2902,32234,92,172642
27686,0.000205,172.31.47.0-255,66,32300,92,172642
27687,0.000232,172.31.47.0-255,66,32366,92,172642
27688,0.000243,172.31.47.0-255,66,32432,92,172642
27689,0.000273,74.125.24.0-255,135,32567,92,172642
27690,0.000276,172.31.47.0-255,66,32633,92,172642
27691,0.00028,74.125.24.0-255,348,32981,92,172642
27692,0.000284,172.31.47.0-255,66,33047,92,172642
27693,0.0005,74.125.24.0-255,1484,34531,92,172642
27694,0.000505,172.31.47.0-255,66,34597,92,172642
27695,0.000511,74.125.24.0-255,2902,37499,92,172642
27696,0.000513,172.31.47.0-255,66,37565,92,172642
27697,0.000539,74.125.24.0-255,5738,43303,92,172642
27698,0.000543,172.31.47.0-255,66,43369,92,172642
27699,0.000548,74.125.24.0-255,4320,47689,92,172642
27700,0.00055,172.31.47.0-255,66,47755,92,172642
27701,0.000572,172.31.47.0-255,66,47821,92,172642
27702,0.000581,172.31.47.0-255,66,47887,92,172642
27703,0.000814,74.125.24.0-255,1484,49371,92,172642
27704,0.00082,74.125.24.0-255,2902,52273,92,172642
27705,0.000824,172.31.47.0-255,66,52339,92,172642
27706,0.000828,74.125.24.0-255,1484,53823,92,172642
27707,0.000847,74.125.24.0-255,4320,58143,92,172642
27708,0.00085,172.31.47.0-255,66,58209,92,172642
27709,0.000863,74.125.24.0-255,2902,61111,92,172642
27710,0.000866,172.31.47.0-255,66,61177,92,172642
27711,0.000902,172.31.47.0-255,66,61243,92,172642
27712,0.00095,172.31.47.0-255,66,61309,92,172642
27713,0.00109,74.125.24.0-255,1484,62793,92,172642
27714,0.001108,74.125.24.0-255,2902,65695,92,172642
27715,0.001111,172.31.47.0-255,66,65761,92,172642
27716,0.001117,74.125.24.0-255,5738,71499,92,172642
27717,0.00112,172.31.47.0-255,66,71565,92,172642
27718,0.001133,74.125.24.0-255,2902,74467,92,172642
27719,0.001137,172.31.47.0-255,66,74533,92,172642
27720,0.001159,172.31.47.0-255,66,74599,92,172642
27721,0.001164,74.125.24.0-255,4320,78919,92,172642
27722,0.001166,172.31.47.0-255,66,78985,92,172642
27723,0.001194,74.125.24.0-255,4320,83305,92,172642
27724,0.001197,172.31.47.0-255,66,83371,92,172642
27725,0.001202,74.125.24.0-255,2184,85555,92,172642
27726,0.001204,172.31.47.0-255,66,85621,92,172642
27727,0.001235,74.125.24.0-255,1484,87105,92,172642
27728,0.001247,74.125.24.0-255,1484,88589,92,172642
27729,0.00125,74.125.24.0-255,1484,90073,92,172642
27730,0.001253,172.31.47.0-255,66,90139,92,172642
27731,0.001275,74.125.24.0-255,5738,95877,92,172642
27732,0.001278,172.31.47.0-255,66,95943,92,172642
27733,0.001286,74.125.24.0-255,7156,103099,92,172642
27734,0.001288,172.31.47.0-255,66,103165,92,172642
27735,0.001307,74.125.24.0-255,4320,107485,92,172642
27736,0.00131,172.31.47.0-255,66,107551,92,172642
27737,0.001315,74.125.24.0-255,4320,111871,92,172642
27738,0.001318,172.31.47.0-255,66,111937,92,172642
27739,0.001342,172.31.47.0-255,66,112003,92,172642
27740,0.001559,74.125.24.0-255,1484,113487,92,172642
27741,0.001573,74.125.24.0-255,2902,116389,92,172642
27742,0.001577,172.31.47.0-255,66,116455,92,172642
27743,0.001583,74.125.24.0-255,5738,122193,92,172642
27744,0.001586,172.31.47.0-255,66,122259,92,172642
27745,0.001618,74.125.24.0-255,4320,126579,92,172642
27746,0.001621,172.31.47.0-255,66,126645,92,172642
27747,0.001641,74.125.24.0-255,1484,128129,92,172642
27748,0.001648,74.125.24.0-255,7156,135285,92,172642
27749,0.00165,172.31.47.0-255,66,135351,92,172642
27750,0.001669,74.125.24.0-255,4320,139671,92,172642
27751,0.001672,172.31.47.0-255,66,139737,92,172642
27752,0.001691,74.125.24.0-255,6438,146175,92,172642
27753,0.001694,172.31.47.0-255,66,146241,92,172642
27754,0.001861,74.125.24.0-255,1484,147725,92,172642
27755,0.001868,74.125.24.0-255,2902,150627,92,172642
27756,0.001872,172.31.47.0-255,66,150693,92,172642
27757,0.00189,74.125.24.0-255,5738,156431,92,172642
27758,0.001893,172.31.47.0-255,66,156497,92,172642
27759,0.001896,74.125.24.0-255,1484,157981,92,172642
27760,0.001934,172.31.47.0-255,66,158047,92,172642
27761,0.001946,172.31.47.0-255,66,158113,92,172642
27762,0.001978,74.125.24.0-255,2902,161015,92,172642
27763,0.001981,172.31.47.0-255,66,161081,92,172642
27764,0.002004,172.31.47.0-255,66,161147,92,172642
27765,0.002023,172.31.47.0-255,66,161213,92,172642
27766,0.002039,74.125.24.0-255,5738,166951,92,172642
27767,0.002041,172.31.47.0-255,66,167017,92,172642
27768,0.002084,172.31.47.0-255,66,167083,92,172642
27769,0.002102,172.31.47.0-255,66,167149,92,172642
27770,0.002105,74.125.24.0-255,766,167915,92,172642
27771,0.002187,172.31.47.0-255,66,167981,92,172642
27772,0.002198,172.31.47.0-255,66,168047,92,172642
27773,0.002209,172.31.47.0-255,66,168113,92,172642
27774,0.002252,172.31.47.0-255,66,168179,92,172642
27775,0.002263,172.31.47.0-255,66,168245,92,172642
27776,0.002289,172.31.47.0-255,66,168311,92,172642
27777,0.002293,74.125.24.0-255,1871,170182,92,172642
27778,0.0023,172.31.47.0-255,66,170248,92,172642
27779,0.00233,74.125.24.0-255,105,170353,92,172642
27780,0.003578,172.31.47.0-255,66,170419,92,172642
27781,0.003606,172.31.47.0-255,105,170524,92,172642
27782,0.0059,74.125.24.0-255,66,170590,92,172642
27783,0.043727,172.31.47.0-255,172,170762,92,172642
27784,0.043755,172.31.47.0-255,1112,171874,92,172642
27785,0.043792,172.31.47.0-255,570,172444,92,172642
27786,0.045259,104.244.42.0-255,66,172510,92,172642
27787,0.045302,104.244.42.0-255,66,172576,92,172642
27788,0.045304,104.244.42.0-255,66,172642,92,172642
27789,0.0,74.125.68.0-255,153,153,92,393957
27790,3.3e-05,172.31.47.0-255,66,219,92,393957
27791,4e-05,74.125.68.0-255,1484,1703,92,393957
27792,4.4e-05,172.31.47.0-255,66,1769,92,393957
27793,8.2e-05,74.125.68.0-255,2902,4671,92,393957
27794,8.5e-05,172.31.47.0-255,66,4737,92,393957
27795,9.9e-05,74.125.68.0-255,1484,6221,92,393957
27796,0.000102,172.31.47.0-255,66,6287,92,393957
27797,0.000114,74.125.68.0-255,2902,9189,92,393957
27798,0.000117,172.31.47.0-255,66,9255,92,393957
27799,0.000131,74.125.68.0-255,1484,10739,92,393957
27800,0.000133,172.31.47.0-255,66,10805,92,393957
27801,0.000157,74.125.68.0-255,3420,14225,92,393957
27802,0.00016,172.31.47.0-255,66,14291,92,393957
27803,0.000166,74.125.68.0-255,5738,20029,92,393957
27804,0.000168,172.31.47.0-255,66,20095,92,393957
27805,0.000206,172.31.47.0-255,66,20161,92,393957
27806,0.000218,74.125.68.0-255,1125,21286,92,393957
27807,0.00022,172.31.47.0-255,66,21352,92,393957
27808,0.00035,74.125.68.0-255,1484,22836,92,393957
27809,0.000355,172.31.47.0-255,66,22902,92,393957
27810,0.000359,74.125.68.0-255,1484,24386,92,393957
27811,0.00036,172.31.47.0-255,66,24452,92,393957
27812,0.000378,74.125.68.0-255,1484,25936,92,393957
27813,0.000381,172.31.47.0-255,66,26002,92,393957
27814,0.000408,74.125.68.0-255,4320,30322,92,393957
27815,0.000412,172.31.47.0-255,66,30388,92,393957
27816,0.000415,74.125.68.0-255,1484,31872,92,393957
27817,0.000417,172.31.47.0-255,66,31938,92,393957
27818,0.000435,74.125.68.0-255,4320,36258,92,393957
27819,0.000438,172.31.47.0-255,66,36324,92,393957
27820,0.000464,74.125.68.0-255,6797,43121,92,393957
27821,0.000466,172.31.47.0-255,66,43187,92,393957
27822,0.000487,74.125.68.0-255,7156,50343,92,393957
27823,0.00049,172.31.47.0-255,66,50409,92,393957
27824,0.000511,74.125.68.0-255,5707,56116,92,393957
27825,0.000513,172.31.47.0-255,66,56182,92,393957
27826,0.000517,74.125.68.0-255,329,56511,92,393957
27827,0.000715,74.125.68.0-255,1484,57995,92,393957
27828,0.000719,172.31.47.0-255,66,58061,92,393957
27829,0.000741,74.125.68.0-255,2902,60963,92,393957
27830,0.000744,172.31.47.0-255,66,61029,92,393957
27831,0.000747,74.125.68.0-255,1484,62513,92,393957
27832,0.000765,74.125.68.0-255,4320,66833,92,393957
27833,0.000768,172.31.47.0-255,66,66899,92,393957
27834,0.000774,74.125.68.0-255,4320,71219,92,393957
27835,0.000776,172.31.47.0-255,66,71285,92,393957
27836,0.000788,74.125.68.0-255,1484,72769,92,393957
27837,0.000815,74.125.68.0-255,7156,79925,92,393957
27838,0.000818,172.31.47.0-255,66,79991,92,393957
27839,0.000821,74.125.68.0-255,1484,81475,92,393957
27840,0.000836,74.125.68.0-255,1484,82959,92,393957
27841,0.000838,172.31.47.0-255,66,83025,92,393957
27842,0.000843,74.125.68.0-255,2902,85927,92,393957
27843,0.000845,172.31.47.0-255,66,85993,92,393957
27844,0.000861,74.125.68.0-255,1484,87477,92,393957
27845,0.000879,74.125.68.0-255,3602,91079,92,393957
27846,0.000884,172.31.47.0-255,66,91145,92,393957
27847,0.001073,74.125.68.0-255,1484,92629,92,393957
27848,0.001091,74.125.68.0-255,2902,95531,92,393957
27849,0.001094,172.31.47.0-255,66,95597,92,393957
27850,0.001112,74.125.68.0-255,1484,97081,92,393957
27851,0.001133,74.125.68.0-255,2902,99983,92,393957
27852,0.001136,172.31.47.0-255,66,100049,92,393957
27853,0.001158,74.125.68.0-255,1484,101533,92,393957
27854,0.001177,74.125.68.0-255,4320,105853,92,393957
27855,0.00118,172.31.47.0-255,66,105919,92,393957
27856,0.001207,74.125.68.0-255,2902,108821,92,393957
27857,0.00121,172.31.47.0-255,66,108887,92,393957
27858,0.001214,74.125.68.0-255,1484,110371,92,393957
27859,0.001231,74.125.68.0-255,2902,113273,92,393957
27860,0.001233,172.31.47.0-255,66,113339,92,393957
27861,0.001282,74.125.68.0-255,7156,120495,92,393957
27862,0.001286,172.31.47.0-255,66,120561,92,393957
27863,0.001306,74.125.68.0-255,1484,122045,92,393957
27864,0.001323,74.125.68.0-255,2902,124947,92,393957
27865,0.001325,172.31.47.0-255,66,125013,92,393957
27866,0.001339,74.125.68.0-255,766,125779,92,393957
27867,0.001416,172.31.47.0-255,66,125845,92,393957
27868,0.001542,74.125.68.0-255,1484,127329,92,393957
27869,0.001568,74.125.68.0-255,1484,128813,92,393957
27870,0.001573,172.31.47.0-255,66,128879,92,393957
27871,0.001577,74.125.68.0-255,1484,130363,92,393957
27872,0.001593,74.125.68.0-255,1484,131847,92,393957
27873,0.001596,172.31.47.0-255,66,131913,92,393957
27874,0.00163,74.125.68.0-255,2902,134815,92,393957
27875,0.001633,172.31.47.0-255,66,134881,92,393957
27876,0.001649,74.125.68.0-255,1484,136365,92,393957
27877,0.001652,74.125.68.0-255,1484,137849,92,393957
27878,0.001654,172.31.47.0-255,66,137915,92,393957
27879,0.001671,74.125.68.0-255,1484,139399,92,393957
27880,0.001674,74.125.68.0-255,1484,140883,92,393957
27881,0.001676,172.31.47.0-255,66,140949,92,393957
27882,0.001697,74.125.68.0-255,2902,143851,92,393957
27883,0.001699,172.31.47.0-255,66,143917,92,393957
27884,0.001703,74.125.68.0-255,1484,145401,92,393957
27885,0.001721,74.125.68.0-255,7156,152557,92,393957
27886,0.001724,172.31.47.0-255,66,152623,92,393957
27887,0.001763,74.125.68.0-255,1484,154107,92,393957
27888,0.00178,74.125.68.0-255,4320,158427,92,393957
27889,0.001783,172.31.47.0-255,66,158493,92,393957
27890,0.001833,74.125.68.0-255,2184,160677,92,393957
27891,0.001837,172.31.47.0-255,66,160743,92,393957
27892,0.002087,74.125.68.0-255,1484,162227,92,393957
27893,0.002094,74.125.68.0-255,1484,163711,92,393957
27894,0.002098,172.31.47.0-255,66,163777,92,393957
27895,0.002111,74.125.68.0-255,1484,165261,92,393957
27896,0.002114,74.125.68.0-255,1484,166745,92,393957
27897,0.002117,172.31.47.0-255,66,166811,92,393957
27898,0.002139,74.125.68.0-255,2902,169713,92,393957
27899,0.002141,172.31.47.0-255,66,169779,92,393957
27900,0.002146,74.125.68.0-255,2902,172681,92,393957
27901,0.002148,172.31.47.0-255,66,172747,92,393957
27902,0.002154,74.125.68.0-255,4320,177067,92,393957
27903,0.002158,172.31.47.0-255,66,177133,92,393957
27904,0.002182,74.125.68.0-255,2902,180035,92,393957
27905,0.002184,172.31.47.0-255,66,180101,92,393957
27906,0.002198,74.125.68.0-255,4320,184421,92,393957
27907,0.0022,172.31.47.0-255,66,184487,92,393957
27908,0.002213,74.125.68.0-255,1484,185971,92,393957
27909,0.002228,74.125.68.0-255,2902,188873,92,393957
27910,0.00223,172.31.47.0-255,66,188939,92,393957
27911,0.002252,74.125.68.0-255,5738,194677,92,393957
27912,0.002254,172.31.47.0-255,66,194743,92,393957
27913,0.002256,74.125.68.0-255,766,195509,92,393957
27914,0.002408,74.125.68.0-255,1484,196993,92,393957
27915,0.002411,172.31.47.0-255,66,197059,92,393957
27916,0.002422,74.125.68.0-255,1484,198543,92,393957
27917,0.002436,74.125.68.0-255,2902,201445,92,393957
27918,0.002438,172.31.47.0-255,66,201511,92,393957
27919,0.002455,74.125.68.0-255,4320,205831,92,393957
27920,0.002458,172.31.47.0-255,66,205897,92,393957
27921,0.00246,74.125.68.0-255,1484,207381,92,393957
27922,0.002481,74.125.68.0-255,4320,211701,92,393957
27923,0.002483,172.31.47.0-255,66,211767,92,393957
27924,0.002486,74.125.68.0-255,1484,213251,92,393957
27925,0.002503,74.125.68.0-255,4320,217571,92,393957
27926,0.002506,172.31.47.0-255,66,217637,92,393957
27927,0.002508,74.125.68.0-255,1484,219121,92,393957
27928,0.002521,74.125.68.0-255,1484,220605,92,393957
27929,0.002523,172.31.47.0-255,66,220671,92,393957
27930,0.002541,74.125.68.0-255,4320,224991,92,393957
27931,0.002543,172.31.47.0-255,66,225057,92,393957
27932,0.002545,74.125.68.0-255,1484,226541,92,393957
27933,0.002574,74.125.68.0-255,2902,229443,92,393957
27934,0.002576,172.31.47.0-255,66,229509,92,393957
27935,0.002586,74.125.68.0-255,766,230275,92,393957
27936,0.002589,74.125.68.0-255,1484,231759,92,393957
27937,0.002591,172.31.47.0-255,66,231825,92,393957
27938,0.002612,74.125.68.0-255,2902,234727,92,393957
27939,0.002614,172.31.47.0-255,66,234793,92,393957
27940,0.002644,172.31.47.0-255,66,234859,92,393957
27941,0.002671,74.125.68.0-255,4320,239179,92,393957
27942,0.002673,172.31.47.0-255,66,239245,92,393957
27943,0.002691,74.125.68.0-255,7156,246401,92,393957
27944,0.002693,172.31.47.0-255,66,246467,92,393957
27945,0.002696,74.125.68.0-255,2902,249369,92,393957
27946,0.002698,172.31.47.0-255,66,249435,92,393957
27947,0.002715,74.125.68.0-255,1484,250919,92,393957
27948,0.002733,74.125.68.0-255,3602,254521,92,393957
27949,0.002735,172.31.47.0-255,66,254587,92,393957
27950,0.002752,74.125.68.0-255,4320,258907,92,393957
27951,0.002754,172.31.47.0-255,66,258973,92,393957
27952,0.002775,74.125.68.0-255,1484,260457,92,393957
27953,0.002789,74.125.68.0-255,5738,266195,92,393957
27954,0.002791,172.31.47.0-255,66,266261,92,393957
27955,0.002803,74.125.68.0-255,2902,269163,92,393957
27956,0.002805,172.31.47.0-255,66,269229,92,393957
27957,0.00284,74.125.68.0-255,5738,274967,92,393957
27958,0.002842,172.31.47.0-255,66,275033,92,393957
27959,0.002854,74.125.68.0-255,1484,276517,92,393957
27960,0.002856,74.125.68.0-255,1484,278001,92,393957
27961,0.002858,172.31.47.0-255,66,278067,92,393957
27962,0.002864,74.125.68.0-255,7156,285223,92,393957
27963,0.002865,172.31.47.0-255,66,285289,92,393957
27964,0.002869,74.125.68.0-255,3602,288891,92,393957
27965,0.002871,172.31.47.0-255,66,288957,92,393957
27966,0.002898,74.125.68.0-255,1484,290441,92,393957
27967,0.002912,74.125.68.0-255,2902,293343,92,393957
27968,0.002913,172.31.47.0-255,66,293409,92,393957
27969,0.002931,74.125.68.0-255,4320,297729,92,393957
27970,0.002932,172.31.47.0-255,66,297795,92,393957
27971,0.002945,74.125.68.0-255,1484,299279,92,393957
27972,0.002948,74.125.68.0-255,1484,300763,92,393957
27973,0.00295,172.31.47.0-255,66,300829,92,393957
27974,0.00296,74.125.68.0-255,5738,306567,92,393957
27975,0.002962,172.31.47.0-255,66,306633,92,393957
27976,0.002984,74.125.68.0-255,2902,309535,92,393957
27977,0.002986,172.31.47.0-255,66,309601,92,393957
27978,0.003003,74.125.68.0-255,5738,315339,92,393957
27979,0.003005,172.31.47.0-255,66,315405,92,393957
27980,0.003027,74.125.68.0-255,7156,322561,92,393957
27981,0.003029,172.31.47.0-255,66,322627,92,393957
27982,0.003042,74.125.68.0-255,2184,324811,92,393957
27983,0.003044,172.31.47.0-255,66,324877,92,393957
27984,0.003047,74.125.68.0-255,2902,327779,92,393957
27985,0.003049,172.31.47.0-255,66,327845,92,393957
27986,0.003077,74.125.68.0-255,1484,329329,92,393957
27987,0.003103,172.31.47.0-255,66,329395,92,393957
27988,0.003121,74.125.68.0-255,2902,332297,92,393957
27989,0.003123,172.31.47.0-255,66,332363,92,393957
27990,0.003127,74.125.68.0-255,4320,336683,92,393957
27991,0.003128,172.31.47.0-255,66,336749,92,393957
27992,0.003158,172.31.47.0-255,66,336815,92,393957
27993,0.003175,74.125.68.0-255,4320,341135,92,393957
27994,0.003177,172.31.47.0-255,66,341201,92,393957
27995,0.003191,74.125.68.0-255,1484,342685,92,393957
27996,0.003208,74.125.68.0-255,4320,347005,92,393957
27997,0.00321,172.31.47.0-255,66,347071,92,393957
27998,0.003212,74.125.68.0-255,1484,348555,92,393957
27999,0.003231,74.125.68.0-255,4320,352875,92,393957
28000,0.003233,172.31.47.0-255,66,352941,92,393957
28001,0.003255,74.125.68.0-255,7156,360097,92,393957
28002,0.003257,172.31.47.0-255,66,360163,92,393957
28003,0.003275,74.125.68.0-255,5738,365901,92,393957
28004,0.003277,172.31.47.0-255,66,365967,92,393957
28005,0.003281,74.125.68.0-255,4320,370287,92,393957
28006,0.003282,172.31.47.0-255,66,370353,92,393957
28007,0.003305,74.125.68.0-255,5020,375373,92,393957
28008,0.003306,172.31.47.0-255,66,375439,92,393957
28009,0.003309,74.125.68.0-255,1484,376923,92,393957
28010,0.003326,74.125.68.0-255,4320,381243,92,393957
28011,0.003328,172.31.47.0-255,66,381309,92,393957
28012,0.00335,74.125.68.0-255,2902,384211,92,393957
28013,0.003352,172.31.47.0-255,66,384277,92,393957
28014,0.003374,172.31.47.0-255,66,384343,92,393957
28015,0.003398,74.125.68.0-255,105,384448,92,393957
28016,0.009067,172.31.47.0-255,66,384514,92,393957
28017,0.00909,172.31.47.0-255,105,384619,92,393957
28018,0.011114,74.125.68.0-255,66,384685,92,393957
28019,0.032244,172.31.47.0-255,172,384857,92,393957
28020,0.032275,172.31.47.0-255,1112,385969,92,393957
28021,0.032322,172.31.47.0-255,1514,387483,92,393957
28022,0.032324,172.31.47.0-255,1514,388997,92,393957
28023,0.032325,172.31.47.0-255,1514,390511,92,393957
28024,0.032326,172.31.47.0-255,1514,392025,92,393957
28025,0.032327,172.31.47.0-255,1494,393519,92,393957
28026,0.033756,104.244.42.0-255,66,393585,92,393957
28027,0.033806,104.244.42.0-255,66,393651,92,393957
28028,0.033901,104.244.42.0-255,66,393717,92,393957
28029,0.033938,104.244.42.0-255,66,393783,92,393957
28030,0.036119,104.244.42.0-255,108,393891,92,393957
28031,0.036125,172.31.47.0-255,66,393957,92,393957
28032,0.0,172.31.47.0-255,66,66,92,66
28033,0.0,74.125.24.0-255,146,146,92,214327
28034,2.9e-05,172.31.47.0-255,66,212,92,214327
28035,3.6e-05,74.125.24.0-255,1484,1696,92,214327
28036,4.2e-05,172.31.47.0-255,66,1762,92,214327
28037,6.4e-05,74.125.24.0-255,2902,4664,92,214327
28038,7.1e-05,172.31.47.0-255,66,4730,92,214327
28039,7.9e-05,74.125.24.0-255,5738,10468,92,214327
28040,8.3e-05,172.31.47.0-255,66,10534,92,214327
28041,8.8e-05,74.125.24.0-255,3590,14124,92,214327
28042,9.2e-05,172.31.47.0-255,66,14190,92,214327
28043,0.000419,74.125.24.0-255,1484,15674,92,214327
28044,0.000426,172.31.47.0-255,66,15740,92,214327
28045,0.000431,74.125.24.0-255,2902,18642,92,214327
28046,0.000434,172.31.47.0-255,66,18708,92,214327
28047,0.00045,74.125.24.0-255,5738,24446,92,214327
28048,0.000454,172.31.47.0-255,66,24512,92,214327
28049,0.000491,74.125.24.0-255,6797,31309,92,214327
28050,0.000495,172.31.47.0-255,66,31375,92,214327
28051,0.000733,74.125.24.0-255,1484,32859,92,214327
28052,0.000739,172.31.47.0-255,66,32925,92,214327
28053,0.000745,74.125.24.0-255,2902,35827,92,214327
28054,0.000747,172.31.47.0-255,66,35893,92,214327
28055,0.000763,74.125.24.0-255,5738,41631,92,214327
28056,0.000768,172.31.47.0-255,66,41697,92,214327
28057,0.000807,74.125.24.0-255,6797,48494,92,214327
28058,0.000815,74.125.24.0-255,7156,55650,92,214327
28059,0.000864,172.31.47.0-255,66,55716,92,214327
28060,0.000868,172.31.47.0-255,66,55782,92,214327
28061,0.000871,172.31.47.0-255,66,55848,92,214327
28062,0.001149,74.125.24.0-255,115,55963,92,214327
28063,0.001154,172.31.47.0-255,66,56029,92,214327
28064,0.001432,74.125.24.0-255,1484,57513,92,214327
28065,0.001437,172.31.47.0-255,66,57579,92,214327
28066,0.001469,74.125.24.0-255,2902,60481,92,214327
28067,0.001474,172.31.47.0-255,66,60547,92,214327
28068,0.001483,74.125.24.0-255,5738,66285,92,214327
28069,0.001487,172.31.47.0-255,66,66351,92,214327
28070,0.00149,74.125.24.0-255,1484,67835,92,214327
28071,0.001493,172.31.47.0-255,66,67901,92,214327
28072,0.00154,74.125.24.0-255,6797,74698,92,214327
28073,0.001545,172.31.47.0-255,66,74764,92,214327
28074,0.001558,172.31.47.0-255,66,74830,92,214327
28075,0.001567,74.125.24.0-255,6797,81627,92,214327
28076,0.00157,172.31.47.0-255,66,81693,92,214327
28077,0.004498,74.125.24.0-255,1484,83177,92,214327
28078,0.004517,172.31.47.0-255,66,83243,92,214327
28079,0.004545,74.125.24.0-255,2902,86145,92,214327
28080,0.004551,172.31.47.0-255,66,86211,92,214327
28081,0.004555,74.125.24.0-255,1484,87695,92,214327
28082,0.004558,172.31.47.0-255,66,87761,92,214327
28083,0.006802,74.125.24.0-255,1484,89245,92,214327
28084,0.006817,172.31.47.0-255,66,89311,92,214327
28085,0.006862,74.125.24.0-255,4320,93631,92,214327
28086,0.006866,172.31.47.0-255,66,93697,92,214327
28087,0.009115,74.125.24.0-255,1484,95181,92,214327
28088,0.009129,172.31.47.0-255,66,95247,92,214327
28089,0.00917,74.125.24.0-255,4320,99567,92,214327
28090,0.009174,172.31.47.0-255,66,99633,92,214327
28091,0.011412,74.125.24.0-255,1484,101117,92,214327
28092,0.01143,172.31.47.0-255,66,101183,92,214327
28093,0.011461,74.125.24.0-255,4320,105503,92,214327
28094,0.011464,172.31.47.0-255,66,105569,92,214327
28095,0.013698,74.125.24.0-255,1484,107053,92,214327
28096,0.013714,172.31.47.0-255,66,107119,92,214327
28097,0.013756,74.125.24.0-255,4320,111439,92,214327
28098,0.013761,172.31.47.0-255,66,111505,92,214327
28099,0.016045,74.125.24.0-255,5738,117243,92,214327
28100,0.016063,172.31.47.0-255,66,117309,92,214327
28101,0.018371,74.125.24.0-255,5738,123047,92,214327
28102,0.018389,172.31.47.0-255,66,123113,92,214327
28103,0.020717,74.125.24.0-255,5738,128851,92,214327
28104,0.020732,172.31.47.0-255,66,128917,92,214327
28105,0.023155,74.125.24.0-255,5738,134655,92,214327
28106,0.030823,172.31.47.0-255,66,134721,92,214327
28107,0.031886,74.125.24.0-255,1484,136205,92,214327
28108,0.031899,172.31.47.0-255,66,136271,92,214327
28109,0.033125,74.125.24.0-255,4320,140591,92,214327
28110,0.033192,172.31.47.0-255,66,140657,92,214327
28111,0.034179,74.125.24.0-255,1484,142141,92,214327
28112,0.034188,172.31.47.0-255,66,142207,92,214327
28113,0.0355,74.125.24.0-255,4320,146527,92,214327
28114,0.03621,172.31.47.0-255,66,146593,92,214327
28115,0.036441,74.125.24.0-255,1484,148077,92,214327
28116,0.036447,172.31.47.0-255,66,148143,92,214327
28117,0.038407,172.31.47.0-255,172,148315,92,214327
28118,0.038437,172.31.47.0-255,1111,149426,92,214327
28119,0.038469,172.31.47.0-255,1514,150940,92,214327
28120,0.038471,172.31.47.0-255,1514,152454,92,214327
28121,0.038472,172.31.47.0-255,1514,153968,92,214327
28122,0.038473,172.31.47.0-255,1514,155482,92,214327
28123,0.038474,172.31.47.0-255,531,156013,92,214327
28124,0.03851,74.125.24.0-255,4320,160333,92,214327
28125,0.038524,172.31.47.0-255,66,160399,92,214327
28126,0.038725,74.125.24.0-255,1484,161883,92,214327
28127,0.039938,104.244.42.0-255,66,161949,92,214327
28128,0.040016,104.244.42.0-255,66,162015,92,214327
28129,0.040019,104.244.42.0-255,66,162081,92,214327
28130,0.040045,104.244.42.0-255,66,162147,92,214327
28131,0.040791,74.125.24.0-255,1484,163631,92,214327
28132,0.040795,172.31.47.0-255,66,163697,92,214327
28133,0.040829,74.125.24.0-255,2902,166599,92,214327
28134,0.040852,172.31.47.0-255,66,166665,92,214327
28135,0.041632,104.244.42.0-255,108,166773,92,214327
28136,0.041638,172.31.47.0-255,66,166839,92,214327
28137,0.043051,74.125.24.0-255,2902,169741,92,214327
28138,0.043055,172.31.47.0-255,66,169807,92,214327
28139,0.043103,74.125.24.0-255,2902,172709,92,214327
28140,0.043109,172.31.47.0-255,66,172775,92,214327
28141,0.045307,74.125.24.0-255,2902,175677,92,214327
28142,0.045313,172.31.47.0-255,66,175743,92,214327
28143,0.04541,74.125.24.0-255,2902,178645,92,214327
28144,0.045415,172.31.47.0-255,66,178711,92,214327
28145,0.047601,74.125.24.0-255,2902,181613,92,214327
28146,0.047606,172.31.47.0-255,66,181679,92,214327
28147,0.047694,74.125.24.0-255,2902,184581,92,214327
28148,0.047699,172.31.47.0-255,66,184647,92,214327
28149,0.049879,74.125.24.0-255,2902,187549,92,214327
28150,0.049883,172.31.47.0-255,66,187615,92,214327
28151,0.049982,74.125.24.0-255,2902,190517,92,214327
28152,0.049986,172.31.47.0-255,66,190583,92,214327
28153,0.052149,74.125.24.0-255,2902,193485,92,214327
28154,0.052153,172.31.47.0-255,66,193551,92,214327
28155,0.052248,74.125.24.0-255,2902,196453,92,214327
28156,0.052252,172.31.47.0-255,66,196519,92,214327
28157,0.054432,74.125.24.0-255,2902,199421,92,214327
28158,0.054437,172.31.47.0-255,66,199487,92,214327
28159,0.054512,74.125.24.0-255,2902,202389,92,214327
28160,0.054516,172.31.47.0-255,66,202455,92,214327
28161,0.056729,74.125.24.0-255,2902,205357,92,214327
28162,0.056733,172.31.47.0-255,66,205423,92,214327
28163,0.056802,74.125.24.0-255,2902,208325,92,214327
28164,0.056819,172.31.47.0-255,66,208391,92,214327
28165,0.058984,74.125.24.0-255,2902,211293,92,214327
28166,0.058988,172.31.47.0-255,66,211359,92,214327
28167,0.059074,74.125.24.0-255,2902,214261,92,214327
28168,0.059078,172.31.47.0-255,66,214327,92,214327
28169,0.0,172.217.26.0-255,226,226,92,210306
28170,2.4e-05,172.31.47.0-255,66,292,92,210306
28171,3.1e-05,172.217.26.0-255,1484,1776,92,210306
28172,3.5e-05,172.31.47.0-255,66,1842,92,210306
28173,7e-05,172.217.26.0-255,4320,6162,92,210306
28174,7.5e-05,172.31.47.0-255,66,6228,92,210306
28175,0.000199,172.217.26.0-255,5738,11966,92,210306
28176,0.000205,172.31.47.0-255,66,12032,92,210306
28177,0.000236,172.217.26.0-255,2126,14158,92,210306
28178,0.000239,172.31.47.0-255,66,14224,92,210306
28179,0.000458,172.217.26.0-255,5738,19962,92,210306
28180,0.000462,172.31.47.0-255,66,20028,92,210306
28181,0.000485,172.217.26.0-255,2902,22930,92,210306
28182,0.000488,172.31.47.0-255,66,22996,92,210306
28183,0.000746,172.31.47.0-255,66,23062,92,210306
28184,0.002644,172.217.26.0-255,5738,28800,92,210306
28185,0.002649,172.31.47.0-255,66,28866,92,210306
28186,0.004558,172.217.26.0-255,4320,33186,92,210306
28187,0.004563,172.31.47.0-255,66,33252,92,210306
28188,0.004596,172.217.26.0-255,1484,34736,92,210306
28189,0.004601,172.31.47.0-255,66,34802,92,210306
28190,0.006476,172.217.26.0-255,2902,37704,92,210306
28191,0.006481,172.31.47.0-255,66,37770,92,210306
28192,0.006513,172.217.26.0-255,2902,40672,92,210306
28193,0.006516,172.31.47.0-255,66,40738,92,210306
28194,0.008392,172.217.26.0-255,2902,43640,92,210306
28195,0.008399,172.31.47.0-255,66,43706,92,210306
28196,0.00843,172.217.26.0-255,2902,46608,92,210306
28197,0.008433,172.31.47.0-255,66,46674,92,210306
28198,0.010304,172.217.26.0-255,2902,49576,92,210306
28199,0.01031,172.31.47.0-255,66,49642,92,210306
28200,0.010351,172.217.26.0-255,2902,52544,92,210306
28201,0.010355,172.31.47.0-255,66,52610,92,210306
28202,0.012221,172.217.26.0-255,2902,55512,92,210306
28203,0.012232,172.31.47.0-255,66,55578,92,210306
28204,0.012269,172.217.26.0-255,2902,58480,92,210306
28205,0.012273,172.31.47.0-255,66,58546,92,210306
28206,0.014163,172.217.26.0-255,2902,61448,92,210306
28207,0.01417,172.31.47.0-255,66,61514,92,210306
28208,0.014202,172.217.26.0-255,2902,64416,92,210306
28209,0.014206,172.31.47.0-255,66,64482,92,210306
28210,0.016093,172.217.26.0-255,2902,67384,92,210306
28211,0.016101,172.31.47.0-255,66,67450,92,210306
28212,0.016137,172.217.26.0-255,2902,70352,92,210306
28213,0.01614,172.31.47.0-255,66,70418,92,210306
28214,0.018006,172.217.26.0-255,2902,73320,92,210306
28215,0.018012,172.31.47.0-255,66,73386,92,210306
28216,0.018045,172.217.26.0-255,2902,76288,92,210306
28217,0.018048,172.31.47.0-255,66,76354,92,210306
28218,0.019936,172.217.26.0-255,2902,79256,92,210306
28219,0.019942,172.31.47.0-255,66,79322,92,210306
28220,0.01997,172.217.26.0-255,2902,82224,92,210306
28221,0.019973,172.31.47.0-255,66,82290,92,210306
28222,0.021852,172.217.26.0-255,2902,85192,92,210306
28223,0.021859,172.31.47.0-255,66,85258,92,210306
28224,0.021891,172.217.26.0-255,2902,88160,92,210306
28225,0.021893,172.31.47.0-255,66,88226,92,210306
28226,0.023778,172.217.26.0-255,2902,91128,92,210306
28227,0.023787,172.31.47.0-255,66,91194,92,210306
28228,0.02382,172.217.26.0-255,2902,94096,92,210306
28229,0.023824,172.31.47.0-255,66,94162,92,210306
28230,0.025692,172.217.26.0-255,2902,97064,92,210306
28231,0.025698,172.31.47.0-255,66,97130,92,210306
28232,0.025726,172.217.26.0-255,2902,100032,92,210306
28233,0.025729,172.31.47.0-255,66,100098,92,210306
28234,0.026508,172.31.47.0-255,172,100270,92,210306
28235,0.026541,172.31.47.0-255,1111,101381,92,210306
28236,0.026607,172.31.47.0-255,1514,102895,92,210306
28237,0.026609,172.31.47.0-255,1514,104409,92,210306
28238,0.02661,172.31.47.0-255,1514,105923,92,210306
28239,0.026611,172.31.47.0-255,1514,107437,92,210306
28240,0.026612,172.31.47.0-255,1495,108932,92,210306
28241,0.027595,172.217.26.0-255,2902,111834,92,210306
28242,0.0276,172.31.47.0-255,66,111900,92,210306
28243,0.027631,172.217.26.0-255,2902,114802,92,210306
28244,0.027634,172.31.47.0-255,66,114868,92,210306
28245,0.028075,104.244.42.0-255,66,114934,92,210306
28246,0.02808,104.244.42.0-255,66,115000,92,210306
28247,0.028168,104.244.42.0-255,66,115066,92,210306
28248,0.029492,172.217.26.0-255,2902,117968,92,210306
28249,0.029495,172.31.47.0-255,66,118034,92,210306
28250,0.029533,172.217.26.0-255,2902,120936,92,210306
28251,0.029536,172.31.47.0-255,66,121002,92,210306
28252,0.031394,172.217.26.0-255,2902,123904,92,210306
28253,0.031398,172.31.47.0-255,66,123970,92,210306
28254,0.031438,172.217.26.0-255,2902,126872,92,210306
28255,0.031442,172.31.47.0-255,66,126938,92,210306
28256,0.033315,172.217.26.0-255,2902,129840,92,210306
28257,0.033319,172.31.47.0-255,66,129906,92,210306
28258,0.033349,172.217.26.0-255,2902,132808,92,210306
28259,0.033352,172.31.47.0-255,66,132874,92,210306
28260,0.035221,172.217.26.0-255,2902,135776,92,210306
28261,0.035225,172.31.47.0-255,66,135842,92,210306
28262,0.035255,172.217.26.0-255,1484,137326,92,210306
28263,0.035258,172.31.47.0-255,66,137392,92,210306
28264,0.035285,172.217.26.0-255,1484,138876,92,210306
28265,0.035288,172.31.47.0-255,66,138942,92,210306
28266,0.037121,172.217.26.0-255,2902,141844,92,210306
28267,0.037126,172.31.47.0-255,66,141910,92,210306
28268,0.037177,172.217.26.0-255,2902,144812,92,210306
28269,0.03718,172.31.47.0-255,66,144878,92,210306
28270,0.039083,172.217.26.0-255,2902,147780,92,210306
28271,0.039088,172.31.47.0-255,66,147846,92,210306
28272,0.039132,172.217.26.0-255,2902,150748,92,210306
28273,0.039135,172.31.47.0-255,66,150814,92,210306
28274,0.04099,172.217.26.0-255,2902,153716,92,210306
28275,0.040995,172.31.47.0-255,66,153782,92,210306
28276,0.04104,172.217.26.0-255,2902,156684,92,210306
28277,0.041043,172.31.47.0-255,66,156750,92,210306
28278,0.042897,172.217.26.0-255,2902,159652,92,210306
28279,0.042902,172.31.47.0-255,66,159718,92,210306
28280,0.042934,172.217.26.0-255,1484,161202,92,210306
28281,0.042937,172.31.47.0-255,66,161268,92,210306
28282,0.04296,172.217.26.0-255,1484,162752,92,210306
28283,0.042963,172.31.47.0-255,66,162818,92,210306
28284,0.044822,172.217.26.0-255,2902,165720,92,210306
28285,0.044827,172.31.47.0-255,66,165786,92,210306
28286,0.044876,172.217.26.0-255,2902,168688,92,210306
28287,0.04488,172.31.47.0-255,66,168754,92,210306
28288,0.046732,172.217.26.0-255,2902,171656,92,210306
28289,0.046738,172.31.47.0-255,66,171722,92,210306
28290,0.046775,172.217.26.0-255,2902,174624,92,210306
28291,0.046779,172.31.47.0-255,66,174690,92,210306
28292,0.048636,172.217.26.0-255,2902,177592,92,210306
28293,0.048642,172.31.47.0-255,66,177658,92,210306
28294,0.048695,172.217.26.0-255,2902,180560,92,210306
28295,0.048699,172.31.47.0-255,66,180626,92,210306
28296,0.050541,172.217.26.0-255,2902,183528,92,210306
28297,0.050547,172.31.47.0-255,66,183594,92,210306
28298,0.050584,172.217.26.0-255,2902,186496,92,210306
28299,0.050588,172.31.47.0-255,66,186562,92,210306
28300,0.052448,172.217.26.0-255,2902,189464,92,210306
28301,0.052452,172.31.47.0-255,66,189530,92,210306
28302,0.052494,172.217.26.0-255,2902,192432,92,210306
28303,0.052498,172.31.47.0-255,66,192498,92,210306
28304,0.054357,172.217.26.0-255,2902,195400,92,210306
28305,0.054362,172.31.47.0-255,66,195466,92,210306
28306,0.054398,172.217.26.0-255,2902,198368,92,210306
28307,0.054401,172.31.47.0-255,66,198434,92,210306
28308,0.056262,172.217.26.0-255,2902,201336,92,210306
28309,0.056271,172.31.47.0-255,66,201402,92,210306
28310,0.056308,172.217.26.0-255,2902,204304,92,210306
28311,0.056311,172.31.47.0-255,66,204370,92,210306
28312,0.058169,172.217.26.0-255,2902,207272,92,210306
28313,0.058173,172.31.47.0-255,66,207338,92,210306
28314,0.058204,172.217.26.0-255,2902,210240,92,210306
28315,0.058206,172.31.47.0-255,66,210306,92,210306
28316,0.0,172.31.47.0-255,105,105,92,459
28317,0.000282,172.31.47.0-255,90,195,92,459
28318,0.00029,172.31.47.0-255,66,261,92,459
28319,0.002815,172.217.194.0-255,66,327,92,459
28320,0.003459,172.217.194.0-255,66,393,92,459
28321,0.003467,172.31.47.0-255,66,459,92,459
28322,0.0,172.217.194.0-255,153,153,92,326089
28323,2.3e-05,172.31.47.0-255,66,219,92,326089
28324,2.8e-05,172.217.194.0-255,1484,1703,92,326089
28325,3.2e-05,172.31.47.0-255,66,1769,92,326089
28326,5.3e-05,172.217.194.0-255,1484,3253,92,326089
28327,5.5e-05,172.31.47.0-255,66,3319,92,326089
28328,5.9e-05,172.217.194.0-255,2902,6221,92,326089
28329,6.1e-05,172.31.47.0-255,66,6287,92,326089
28330,8e-05,172.217.194.0-255,4320,10607,92,326089
28331,8.2e-05,172.31.47.0-255,66,10673,92,326089
28332,0.000104,172.217.194.0-255,1484,12157,92,326089
28333,0.000106,172.31.47.0-255,66,12223,92,326089
28334,0.00011,172.217.194.0-255,2142,14365,92,326089
28335,0.000112,172.31.47.0-255,66,14431,92,326089
28336,0.000115,172.217.194.0-255,1484,15915,92,326089
28337,0.000116,172.31.47.0-255,66,15981,92,326089
28338,0.000139,172.31.47.0-255,66,16047,92,326089
28339,0.00017,172.217.194.0-255,4320,20367,92,326089
28340,0.000173,172.31.47.0-255,66,20433,92,326089
28341,0.000189,172.217.194.0-255,2543,22976,92,326089
28342,0.000191,172.31.47.0-255,66,23042,92,326089
28343,0.000623,172.217.194.0-255,1484,24526,92,326089
28344,0.000629,172.31.47.0-255,66,24592,92,326089
28345,0.000638,172.217.194.0-255,2902,27494,92,326089
28346,0.000641,172.31.47.0-255,66,27560,92,326089
28347,0.000675,172.217.194.0-255,5738,33298,92,326089
28348,0.000678,172.31.47.0-255,66,33364,92,326089
28349,0.000682,172.217.194.0-255,2902,36266,92,326089
28350,0.000684,172.31.47.0-255,66,36332,92,326089
28351,0.000717,172.31.47.0-255,66,36398,92,326089
28352,0.000724,172.217.194.0-255,5738,42136,92,326089
28353,0.000726,172.31.47.0-255,66,42202,92,326089
28354,0.000767,172.217.194.0-255,4236,46438,92,326089
28355,0.000772,172.31.47.0-255,66,46504,92,326089
28356,0.000815,172.217.194.0-255,1484,47988,92,326089
28357,0.000831,172.217.194.0-255,2902,50890,92,326089
28358,0.000834,172.31.47.0-255,66,50956,92,326089
28359,0.000838,172.217.194.0-255,1484,52440,92,326089
28360,0.000859,172.217.194.0-255,4320,56760,92,326089
28361,0.000862,172.31.47.0-255,66,56826,92,326089
28362,0.000866,172.217.194.0-255,2902,59728,92,326089
28363,0.000868,172.31.47.0-255,66,59794,92,326089
28364,0.000907,172.31.47.0-255,66,59860,92,326089
28365,0.000919,172.31.47.0-255,66,59926,92,326089
28366,0.001011,172.217.194.0-255,1484,61410,92,326089
28367,0.001017,172.217.194.0-255,2902,64312,92,326089
28368,0.001021,172.31.47.0-255,66,64378,92,326089
28369,0.001049,172.217.194.0-255,5738,70116,92,326089
28370,0.001053,172.31.47.0-255,66,70182,92,326089
28371,0.001082,172.217.194.0-255,7156,77338,92,326089
28372,0.001086,172.31.47.0-255,66,77404,92,326089
28373,0.001113,172.217.194.0-255,6411,83815,92,326089
28374,0.001117,172.31.47.0-255,66,83881,92,326089
28375,0.00112,172.217.194.0-255,1484,85365,92,326089
28376,0.001146,172.31.47.0-255,66,85431,92,326089
28377,0.001178,172.217.194.0-255,5738,91169,92,326089
28378,0.001181,172.31.47.0-255,66,91235,92,326089
28379,0.001184,172.217.194.0-255,1484,92719,92,326089
28380,0.001203,172.217.194.0-255,5738,98457,92,326089
28381,0.001205,172.31.47.0-255,66,98523,92,326089
28382,0.001222,172.217.194.0-255,1484,100007,92,326089
28383,0.001244,172.217.194.0-255,5738,105745,92,326089
28384,0.001247,172.31.47.0-255,66,105811,92,326089
28385,0.001252,172.217.194.0-255,4320,110131,92,326089
28386,0.001254,172.31.47.0-255,66,110197,92,326089
28387,0.00127,172.217.194.0-255,4320,114517,92,326089
28388,0.001272,172.31.47.0-255,66,114583,92,326089
28389,0.001277,172.217.194.0-255,5020,119603,92,326089
28390,0.001279,172.31.47.0-255,66,119669,92,326089
28391,0.00134,172.217.194.0-255,1484,121153,92,326089
28392,0.001354,172.217.194.0-255,2902,124055,92,326089
28393,0.001357,172.31.47.0-255,66,124121,92,326089
28394,0.001381,172.217.194.0-255,5738,129859,92,326089
28395,0.001383,172.31.47.0-255,66,129925,92,326089
28396,0.001386,172.217.194.0-255,1484,131409,92,326089
28397,0.001401,172.217.194.0-255,4320,135729,92,326089
28398,0.001403,172.31.47.0-255,66,135795,92,326089
28399,0.001418,172.217.194.0-255,4320,140115,92,326089
28400,0.001421,172.31.47.0-255,66,140181,92,326089
28401,0.001436,172.217.194.0-255,1484,141665,92,326089
28402,0.001467,172.31.47.0-255,66,141731,92,326089
28403,0.0015,172.217.194.0-255,1484,143215,92,326089
28404,0.001521,172.217.194.0-255,2902,146117,92,326089
28405,0.001523,172.31.47.0-255,66,146183,92,326089
28406,0.001526,172.217.194.0-255,1484,147667,92,326089
28407,0.001541,172.217.194.0-255,2902,150569,92,326089
28408,0.001544,172.31.47.0-255,66,150635,92,326089
28409,0.001548,172.217.194.0-255,2902,153537,92,326089
28410,0.00155,172.31.47.0-255,66,153603,92,326089
28411,0.001574,172.217.194.0-255,5738,159341,92,326089
28412,0.001577,172.31.47.0-255,66,159407,92,326089
28413,0.00161,172.31.47.0-255,66,159473,92,326089
28414,0.00163,172.217.194.0-255,3602,163075,92,326089
28415,0.001632,172.31.47.0-255,66,163141,92,326089
28416,0.001751,172.217.194.0-255,1484,164625,92,326089
28417,0.001753,172.217.194.0-255,1484,166109,92,326089
28418,0.00176,172.31.47.0-255,66,166175,92,326089
28419,0.001774,172.217.194.0-255,1484,167659,92,326089
28420,0.001779,172.217.194.0-255,2902,170561,92,326089
28421,0.001781,172.31.47.0-255,66,170627,92,326089
28422,0.001801,172.217.194.0-255,2902,173529,92,326089
28423,0.001803,172.31.47.0-255,66,173595,92,326089
28424,0.001807,172.217.194.0-255,2902,176497,92,326089
28425,0.001809,172.31.47.0-255,66,176563,92,326089
28426,0.001818,172.217.194.0-255,4320,180883,92,326089
28427,0.00182,172.31.47.0-255,66,180949,92,326089
28428,0.001843,172.217.194.0-255,5738,186687,92,326089
28429,0.001846,172.31.47.0-255,66,186753,92,326089
28430,0.001863,172.217.194.0-255,7156,193909,92,326089
28431,0.001865,172.31.47.0-255,66,193975,92,326089
28432,0.001887,172.217.194.0-255,3602,197577,92,326089
28433,0.001889,172.31.47.0-255,66,197643,92,326089
28434,0.001961,172.217.194.0-255,1484,199127,92,326089
28435,0.001965,172.217.194.0-255,1484,200611,92,326089
28436,0.001967,172.31.47.0-255,66,200677,92,326089
28437,0.001985,172.217.194.0-255,1484,202161,92,326089
28438,0.001991,172.217.194.0-255,5738,207899,92,326089
28439,0.001994,172.31.47.0-255,66,207965,92,326089
28440,0.001996,172.217.194.0-255,1484,209449,92,326089
28441,0.002019,172.31.47.0-255,66,209515,92,326089
28442,0.00204,172.217.194.0-255,7156,216671,92,326089
28443,0.002044,172.31.47.0-255,66,216737,92,326089
28444,0.002058,172.217.194.0-255,7156,223893,92,326089
28445,0.00206,172.31.47.0-255,66,223959,92,326089
28446,0.002072,172.217.194.0-255,3602,227561,92,326089
28447,0.002074,172.31.47.0-255,66,227627,92,326089
28448,0.002079,172.217.194.0-255,4320,231947,92,326089
28449,0.002081,172.31.47.0-255,66,232013,92,326089
28450,0.002116,172.31.47.0-255,66,232079,92,326089
28451,0.002121,172.217.194.0-255,4320,236399,92,326089
28452,0.002123,172.31.47.0-255,66,236465,92,326089
28453,0.002153,172.31.47.0-255,66,236531,92,326089
28454,0.002179,172.31.47.0-255,66,236597,92,326089
28455,0.002199,172.217.194.0-255,3602,240199,92,326089
28456,0.002202,172.31.47.0-255,66,240265,92,326089
28457,0.004294,172.217.194.0-255,1484,241749,92,326089
28458,0.004318,172.217.194.0-255,4320,246069,92,326089
28459,0.004325,172.31.47.0-255,66,246135,92,326089
28460,0.006418,172.217.194.0-255,5738,251873,92,326089
28461,0.006433,172.31.47.0-255,66,251939,92,326089
28462,0.008564,172.217.194.0-255,5738,257677,92,326089
28463,0.008575,172.31.47.0-255,66,257743,92,326089
28464,0.010676,172.217.194.0-255,5738,263481,92,326089
28465,0.010684,172.31.47.0-255,66,263547,92,326089
28466,0.012768,172.217.194.0-255,5738,269285,92,326089
28467,0.012779,172.31.47.0-255,66,269351,92,326089
28468,0.01484,172.217.194.0-255,5738,275089,92,326089
28469,0.014846,172.31.47.0-255,66,275155,92,326089
28470,0.016911,172.217.194.0-255,5738,280893,92,326089
28471,0.016916,172.31.47.0-255,66,280959,92,326089
28472,0.019,172.217.194.0-255,5738,286697,92,326089
28473,0.019015,172.31.47.0-255,66,286763,92,326089
28474,0.021091,172.217.194.0-255,5738,292501,92,326089
28475,0.021101,172.31.47.0-255,66,292567,92,326089
28476,0.023164,172.217.194.0-255,5738,298305,92,326089
28477,0.02317,172.31.47.0-255,66,298371,92,326089
28478,0.025243,172.217.194.0-255,5738,304109,92,326089
28479,0.025259,172.31.47.0-255,66,304175,92,326089
28480,0.027393,172.217.194.0-255,5738,309913,92,326089
28481,0.02741,172.31.47.0-255,66,309979,92,326089
28482,0.029479,172.217.194.0-255,5738,315717,92,326089
28483,0.029493,172.31.47.0-255,66,315783,92,326089
28484,0.031541,172.217.194.0-255,863,316646,92,326089
28485,0.031666,172.31.47.0-255,66,316712,92,326089
28486,0.031713,172.31.47.0-255,105,316817,92,326089
28487,0.03374,172.217.194.0-255,66,316883,92,326089
28488,0.044848,172.31.47.0-255,172,317055,92,326089
28489,0.044891,172.31.47.0-255,1103,318158,92,326089
28490,0.044969,172.31.47.0-255,1514,319672,92,326089
28491,0.044971,172.31.47.0-255,1514,321186,92,326089
28492,0.044972,172.31.47.0-255,1514,322700,92,326089
28493,0.044973,172.31.47.0-255,1514,324214,92,326089
28494,0.044974,172.31.47.0-255,1503,325717,92,326089
28495,0.046375,104.244.42.0-255,66,325783,92,326089
28496,0.046407,104.244.42.0-255,66,325849,92,326089
28497,0.046532,104.244.42.0-255,66,325915,92,326089
28498,0.047079,104.244.42.0-255,108,326023,92,326089
28499,0.047086,172.31.47.0-255,66,326089,92,326089
28500,0.0,172.31.47.0-255,105,105,92,459
28501,0.000136,172.31.47.0-255,90,195,92,459
28502,0.000147,172.31.47.0-255,66,261,92,459
28503,0.002728,172.217.194.0-255,66,327,92,459
28504,0.002748,172.217.194.0-255,66,393,92,459
28505,0.002763,172.31.47.0-255,66,459,92,459
28506,0.0,74.125.24.0-255,153,153,92,293764
28507,0.0001,172.31.47.0-255,66,219,92,293764
28508,0.000107,74.125.24.0-255,1484,1703,92,293764
28509,0.000111,172.31.47.0-255,66,1769,92,293764
28510,0.000115,74.125.24.0-255,2902,4671,92,293764
28511,0.000124,172.31.47.0-255,66,4737,92,293764
28512,0.000132,74.125.24.0-255,7156,11893,92,293764
28513,0.000134,172.31.47.0-255,66,11959,92,293764
28514,0.000138,74.125.24.0-255,2161,14120,92,293764
28515,0.000141,172.31.47.0-255,66,14186,92,293764
28516,0.000252,74.125.24.0-255,1484,15670,92,293764
28517,0.000256,172.31.47.0-255,66,15736,92,293764
28518,0.000262,74.125.24.0-255,2902,18638,92,293764
28519,0.000265,172.31.47.0-255,66,18704,92,293764
28520,0.000277,74.125.24.0-255,5738,24442,92,293764
28521,0.000279,172.31.47.0-255,66,24508,92,293764
28522,0.000286,74.125.24.0-255,5738,30246,92,293764
28523,0.000288,172.31.47.0-255,66,30312,92,293764
28524,0.000335,74.125.24.0-255,6797,37109,92,293764
28525,0.000339,172.31.47.0-255,66,37175,92,293764
28526,0.000375,172.31.47.0-255,66,37241,92,293764
28527,0.000403,74.125.24.0-255,1125,38366,92,293764
28528,0.000408,172.31.47.0-255,66,38432,92,293764
28529,0.001075,74.125.24.0-255,1484,39916,92,293764
28530,0.001081,172.31.47.0-255,66,39982,92,293764
28531,0.001091,74.125.24.0-255,2902,42884,92,293764
28532,0.001093,172.31.47.0-255,66,42950,92,293764
28533,0.001105,74.125.24.0-255,5738,48688,92,293764
28534,0.001107,172.31.47.0-255,66,48754,92,293764
28535,0.001152,172.31.47.0-255,66,48820,92,293764
28536,0.001174,74.125.24.0-255,2902,51722,92,293764
28537,0.001177,172.31.47.0-255,66,51788,92,293764
28538,0.001197,74.125.24.0-255,5738,57526,92,293764
28539,0.0012,172.31.47.0-255,66,57592,92,293764
28540,0.001211,172.31.47.0-255,66,57658,92,293764
28541,0.00125,74.125.24.0-255,2902,60560,92,293764
28542,0.001253,172.31.47.0-255,66,60626,92,293764
28543,0.001294,172.31.47.0-255,66,60692,92,293764
28544,0.002084,74.125.24.0-255,1484,62176,92,293764
28545,0.002089,74.125.24.0-255,2902,65078,92,293764
28546,0.002092,172.31.47.0-255,66,65144,92,293764
28547,0.002094,74.125.24.0-255,1484,66628,92,293764
28548,0.002115,74.125.24.0-255,4320,70948,92,293764
28549,0.002117,172.31.47.0-255,66,71014,92,293764
28550,0.00215,74.125.24.0-255,1484,72498,92,293764
28551,0.002173,172.31.47.0-255,66,72564,92,293764
28552,0.002189,172.31.47.0-255,66,72630,92,293764
28553,0.002201,74.125.24.0-255,2902,75532,92,293764
28554,0.002208,172.31.47.0-255,66,75598,92,293764
28555,0.002233,172.31.47.0-255,66,75664,92,293764
28556,0.002245,172.31.47.0-255,66,75730,92,293764
28557,0.002265,74.125.24.0-255,1484,77214,92,293764
28558,0.002291,172.31.47.0-255,66,77280,92,293764
28559,0.002313,74.125.24.0-255,1484,78764,92,293764
28560,0.00233,74.125.24.0-255,2902,81666,92,293764
28561,0.002332,172.31.47.0-255,66,81732,92,293764
28562,0.002338,74.125.24.0-255,5738,87470,92,293764
28563,0.002341,172.31.47.0-255,66,87536,92,293764
28564,0.002368,74.125.24.0-255,5738,93274,92,293764
28565,0.00237,172.31.47.0-255,66,93340,92,293764
28566,0.00239,74.125.24.0-255,7156,100496,92,293764
28567,0.002392,172.31.47.0-255,66,100562,92,293764
28568,0.002418,74.125.24.0-255,5738,106300,92,293764
28569,0.00242,172.31.47.0-255,66,106366,92,293764
28570,0.002424,74.125.24.0-255,4320,110686,92,293764
28571,0.002426,172.31.47.0-255,66,110752,92,293764
28572,0.00244,74.125.24.0-255,766,111518,92,293764
28573,0.002442,74.125.24.0-255,1484,113002,92,293764
28574,0.002444,172.31.47.0-255,66,113068,92,293764
28575,0.002464,74.125.24.0-255,4320,117388,92,293764
28576,0.002466,172.31.47.0-255,66,117454,92,293764
28577,0.002472,74.125.24.0-255,7156,124610,92,293764
28578,0.002474,172.31.47.0-255,66,124676,92,293764
28579,0.002477,74.125.24.0-255,1484,126160,92,293764
28580,0.002507,172.31.47.0-255,66,126226,92,293764
28581,0.00251,74.125.24.0-255,2902,129128,92,293764
28582,0.002512,172.31.47.0-255,66,129194,92,293764
28583,0.002544,74.125.24.0-255,3602,132796,92,293764
28584,0.002546,172.31.47.0-255,66,132862,92,293764
28585,0.002548,74.125.24.0-255,1484,134346,92,293764
28586,0.002568,74.125.24.0-255,2902,137248,92,293764
28587,0.00257,172.31.47.0-255,66,137314,92,293764
28588,0.002573,74.125.24.0-255,2902,140216,92,293764
28589,0.002575,172.31.47.0-255,66,140282,92,293764
28590,0.002593,74.125.24.0-255,2902,143184,92,293764
28591,0.002595,172.31.47.0-255,66,143250,92,293764
28592,0.0026,74.125.24.0-255,5738,148988,92,293764
28593,0.002601,172.31.47.0-255,66,149054,92,293764
28594,0.00265,74.125.24.0-255,7156,156210,92,293764
28595,0.002652,172.31.47.0-255,66,156276,92,293764
28596,0.002664,172.31.47.0-255,66,156342,92,293764
28597,0.002676,172.31.47.0-255,66,156408,92,293764
28598,0.002704,74.125.24.0-255,5738,162146,92,293764
28599,0.002708,172.31.47.0-255,66,162212,92,293764
28600,0.005289,74.125.24.0-255,4320,166532,92,293764
28601,0.005294,172.31.47.0-255,66,166598,92,293764
28602,0.005314,74.125.24.0-255,1484,168082,92,293764
28603,0.007837,74.125.24.0-255,4320,172402,92,293764
28604,0.007844,172.31.47.0-255,66,172468,92,293764
28605,0.010407,74.125.24.0-255,5738,178206,92,293764
28606,0.010416,172.31.47.0-255,66,178272,92,293764
28607,0.012955,74.125.24.0-255,5738,184010,92,293764
28608,0.012962,172.31.47.0-255,66,184076,92,293764
28609,0.015511,74.125.24.0-255,5738,189814,92,293764
28610,0.015521,172.31.47.0-255,66,189880,92,293764
28611,0.018068,74.125.24.0-255,5738,195618,92,293764
28612,0.018074,172.31.47.0-255,66,195684,92,293764
28613,0.020625,74.125.24.0-255,5738,201422,92,293764
28614,0.020632,172.31.47.0-255,66,201488,92,293764
28615,0.023171,74.125.24.0-255,5738,207226,92,293764
28616,0.023177,172.31.47.0-255,66,207292,92,293764
28617,0.025732,74.125.24.0-255,5738,213030,92,293764
28618,0.025741,172.31.47.0-255,66,213096,92,293764
28619,0.028318,74.125.24.0-255,5738,218834,92,293764
28620,0.028325,172.31.47.0-255,66,218900,92,293764
28621,0.030244,172.31.47.0-255,172,219072,92,293764
28622,0.030274,172.31.47.0-255,1111,220183,92,293764
28623,0.030318,172.31.47.0-255,1514,221697,92,293764
28624,0.030319,172.31.47.0-255,1514,223211,92,293764
28625,0.030321,172.31.47.0-255,1514,224725,92,293764
28626,0.030322,172.31.47.0-255,1514,226239,92,293764
28627,0.030348,172.31.47.0-255,1495,227734,92,293764
28628,0.030883,74.125.24.0-255,5738,233472,92,293764
28629,0.03089,172.31.47.0-255,66,233538,92,293764
28630,0.031815,104.244.42.0-255,66,233604,92,293764
28631,0.031823,104.244.42.0-255,66,233670,92,293764
28632,0.031865,104.244.42.0-255,66,233736,92,293764
28633,0.031917,104.244.42.0-255,66,233802,92,293764
28634,0.032647,104.244.42.0-255,108,233910,92,293764
28635,0.032652,172.31.47.0-255,66,233976,92,293764
28636,0.033441,74.125.24.0-255,4320,238296,92,293764
28637,0.033446,172.31.47.0-255,66,238362,92,293764
28638,0.033474,74.125.24.0-255,1484,239846,92,293764
28639,0.035983,74.125.24.0-255,4320,244166,92,293764
28640,0.035988,172.31.47.0-255,66,244232,92,293764
28641,0.038542,74.125.24.0-255,5738,249970,92,293764
28642,0.038549,172.31.47.0-255,66,250036,92,293764
28643,0.041076,74.125.24.0-255,5738,255774,92,293764
28644,0.041081,172.31.47.0-255,66,255840,92,293764
28645,0.04364,74.125.24.0-255,5738,261578,92,293764
28646,0.043645,172.31.47.0-255,66,261644,92,293764
28647,0.046178,74.125.24.0-255,5738,267382,92,293764
28648,0.046183,172.31.47.0-255,66,267448,92,293764
28649,0.048713,74.125.24.0-255,4320,271768,92,293764
28650,0.048719,172.31.47.0-255,66,271834,92,293764
28651,0.048746,74.125.24.0-255,1484,273318,92,293764
28652,0.051251,74.125.24.0-255,4320,277638,92,293764
28653,0.051256,172.31.47.0-255,66,277704,92,293764
28654,0.053804,74.125.24.0-255,5738,283442,92,293764
28655,0.05381,172.31.47.0-255,66,283508,92,293764
28656,0.056339,74.125.24.0-255,4320,287828,92,293764
28657,0.056344,172.31.47.0-255,66,287894,92,293764
28658,0.056377,74.125.24.0-255,1484,289378,92,293764
28659,0.058884,74.125.24.0-255,4320,293698,92,293764
28660,0.058889,172.31.47.0-255,66,293764,92,293764
28661,0.0,172.31.47.0-255,105,105,92,105
28662,0.0,74.125.200.0-255,153,153,92,385522
28663,2.1e-05,172.31.47.0-255,66,219,92,385522
28664,2.8e-05,74.125.200.0-255,1484,1703,92,385522
28665,3.2e-05,172.31.47.0-255,66,1769,92,385522
28666,3.5e-05,74.125.200.0-255,1484,3253,92,385522
28667,3.7e-05,172.31.47.0-255,66,3319,92,385522
28668,6e-05,74.125.200.0-255,2902,6221,92,385522
28669,6.2e-05,172.31.47.0-255,66,6287,92,385522
28670,6.8e-05,74.125.200.0-255,5738,12025,92,385522
28671,7e-05,172.31.47.0-255,66,12091,92,385522
28672,0.000103,74.125.200.0-255,6317,18408,92,385522
28673,0.000105,172.31.47.0-255,66,18474,92,385522
28674,0.000111,74.125.200.0-255,5738,24212,92,385522
28675,0.000113,172.31.47.0-255,66,24278,92,385522
28676,0.000123,74.125.200.0-255,1484,25762,92,385522
28677,0.000125,172.31.47.0-255,66,25828,92,385522
28678,0.000156,74.125.200.0-255,5379,31207,92,385522
28679,0.000159,172.31.47.0-255,66,31273,92,385522
28680,0.000259,74.125.200.0-255,1484,32757,92,385522
28681,0.000262,172.31.47.0-255,66,32823,92,385522
28682,0.000267,74.125.200.0-255,2902,35725,92,385522
28683,0.000269,172.31.47.0-255,66,35791,92,385522
28684,0.000272,74.125.200.0-255,1484,37275,92,385522
28685,0.000273,172.31.47.0-255,66,37341,92,385522
28686,0.000301,74.125.200.0-255,4320,41661,92,385522
28687,0.000304,172.31.47.0-255,66,41727,92,385522
28688,0.000309,74.125.200.0-255,4320,46047,92,385522
28689,0.000311,172.31.47.0-255,66,46113,92,385522
28690,0.000317,74.125.200.0-255,5379,51492,92,385522
28691,0.000319,172.31.47.0-255,66,51558,92,385522
28692,0.000344,74.125.200.0-255,1484,53042,92,385522
28693,0.000347,172.31.47.0-255,66,53108,92,385522
28694,0.000365,74.125.200.0-255,5738,58846,92,385522
28695,0.000367,172.31.47.0-255,66,58912,92,385522
28696,0.000422,74.125.200.0-255,4320,63232,92,385522
28697,0.000424,172.31.47.0-255,66,63298,92,385522
28698,0.000439,74.125.200.0-255,2543,65841,92,385522
28699,0.000441,172.31.47.0-255,66,65907,92,385522
28700,0.000444,74.125.200.0-255,677,66584,92,385522
28701,0.000658,74.125.200.0-255,1484,68068,92,385522
28702,0.000663,172.31.47.0-255,66,68134,92,385522
28703,0.000682,74.125.200.0-255,2902,71036,92,385522
28704,0.000684,172.31.47.0-255,66,71102,92,385522
28705,0.000708,74.125.200.0-255,5738,76840,92,385522
28706,0.00071,172.31.47.0-255,66,76906,92,385522
28707,0.000717,74.125.200.0-255,5738,82644,92,385522
28708,0.000719,172.31.47.0-255,66,82710,92,385522
28709,0.000734,74.125.200.0-255,2902,85612,92,385522
28710,0.000736,172.31.47.0-255,66,85678,92,385522
28711,0.000742,74.125.200.0-255,5738,91416,92,385522
28712,0.000743,172.31.47.0-255,66,91482,92,385522
28713,0.000764,74.125.200.0-255,4320,95802,92,385522
28714,0.000767,172.31.47.0-255,66,95868,92,385522
28715,0.000772,74.125.200.0-255,5020,100888,92,385522
28716,0.000774,172.31.47.0-255,66,100954,92,385522
28717,0.001386,74.125.200.0-255,1484,102438,92,385522
28718,0.001395,74.125.200.0-255,2902,105340,92,385522
28719,0.001398,172.31.47.0-255,66,105406,92,385522
28720,0.001403,74.125.200.0-255,1484,106890,92,385522
28721,0.001421,74.125.200.0-255,2902,109792,92,385522
28722,0.001424,172.31.47.0-255,66,109858,92,385522
28723,0.001445,74.125.200.0-255,5738,115596,92,385522
28724,0.001448,172.31.47.0-255,66,115662,92,385522
28725,0.00147,74.125.200.0-255,5738,121400,92,385522
28726,0.001472,172.31.47.0-255,66,121466,92,385522
28727,0.001484,74.125.200.0-255,2902,124368,92,385522
28728,0.001485,172.31.47.0-255,66,124434,92,385522
28729,0.001501,74.125.200.0-255,4320,128754,92,385522
28730,0.001503,172.31.47.0-255,66,128820,92,385522
28731,0.001537,74.125.200.0-255,5738,134558,92,385522
28732,0.00154,172.31.47.0-255,66,134624,92,385522
28733,0.001543,74.125.200.0-255,766,135390,92,385522
28734,0.001588,74.125.200.0-255,1484,136874,92,385522
28735,0.001591,172.31.47.0-255,66,136940,92,385522
28736,0.001605,74.125.200.0-255,2902,139842,92,385522
28737,0.001607,172.31.47.0-255,66,139908,92,385522
28738,0.001626,74.125.200.0-255,4320,144228,92,385522
28739,0.001628,172.31.47.0-255,66,144294,92,385522
28740,0.001645,74.125.200.0-255,2902,147196,92,385522
28741,0.001647,172.31.47.0-255,66,147262,92,385522
28742,0.001676,74.125.200.0-255,5738,153000,92,385522
28743,0.001678,172.31.47.0-255,66,153066,92,385522
28744,0.001687,172.31.47.0-255,66,153132,92,385522
28745,0.001715,74.125.200.0-255,2902,156034,92,385522
28746,0.001717,172.31.47.0-255,66,156100,92,385522
28747,0.001739,74.125.200.0-255,5020,161120,92,385522
28748,0.001741,172.31.47.0-255,66,161186,92,385522
28749,0.001757,74.125.200.0-255,1484,162670,92,385522
28750,0.001776,74.125.200.0-255,2902,165572,92,385522
28751,0.001778,172.31.47.0-255,66,165638,92,385522
28752,0.001802,74.125.200.0-255,5738,171376,92,385522
28753,0.001804,172.31.47.0-255,66,171442,92,385522
28754,0.001808,74.125.200.0-255,2902,174344,92,385522
28755,0.001811,172.31.47.0-255,66,174410,92,385522
28756,0.001827,74.125.200.0-255,5738,180148,92,385522
28757,0.001829,172.31.47.0-255,66,180214,92,385522
28758,0.001846,74.125.200.0-255,2902,183116,92,385522
28759,0.001848,172.31.47.0-255,66,183182,92,385522
28760,0.001871,74.125.200.0-255,7156,190338,92,385522
28761,0.001874,172.31.47.0-255,66,190404,92,385522
28762,0.001877,74.125.200.0-255,1484,191888,92,385522
28763,0.001916,74.125.200.0-255,3602,195490,92,385522
28764,0.001918,172.31.47.0-255,66,195556,92,385522
28765,0.001968,74.125.200.0-255,1484,197040,92,385522
28766,0.001983,74.125.200.0-255,2902,199942,92,385522
28767,0.001986,172.31.47.0-255,66,200008,92,385522
28768,0.001989,74.125.200.0-255,1484,201492,92,385522
28769,0.002009,74.125.200.0-255,4320,205812,92,385522
28770,0.002011,172.31.47.0-255,66,205878,92,385522
28771,0.002017,74.125.200.0-255,5738,211616,92,385522
28772,0.00202,172.31.47.0-255,66,211682,92,385522
28773,0.002022,74.125.200.0-255,1484,213166,92,385522
28774,0.002052,74.125.200.0-255,5738,218904,92,385522
28775,0.002055,172.31.47.0-255,66,218970,92,385522
28776,0.00206,74.125.200.0-255,4320,223290,92,385522
28777,0.002062,172.31.47.0-255,66,223356,92,385522
28778,0.004071,74.125.200.0-255,1484,224840,92,385522
28779,0.00409,74.125.200.0-255,4320,229160,92,385522
28780,0.004094,172.31.47.0-255,66,229226,92,385522
28781,0.006137,74.125.200.0-255,5738,234964,92,385522
28782,0.006144,172.31.47.0-255,66,235030,92,385522
28783,0.008215,74.125.200.0-255,5738,240768,92,385522
28784,0.008222,172.31.47.0-255,66,240834,92,385522
28785,0.010258,74.125.200.0-255,5738,246572,92,385522
28786,0.010267,172.31.47.0-255,66,246638,92,385522
28787,0.0123,74.125.200.0-255,5738,252376,92,385522
28788,0.012308,172.31.47.0-255,66,252442,92,385522
28789,0.014353,74.125.200.0-255,4320,256762,92,385522
28790,0.01436,172.31.47.0-255,66,256828,92,385522
28791,0.01438,74.125.200.0-255,1484,258312,92,385522
28792,0.016385,74.125.200.0-255,4320,262632,92,385522
28793,0.016393,172.31.47.0-255,66,262698,92,385522
28794,0.01844,74.125.200.0-255,5738,268436,92,385522
28795,0.018448,172.31.47.0-255,66,268502,92,385522
28796,0.020475,74.125.200.0-255,5738,274240,92,385522
28797,0.020481,172.31.47.0-255,66,274306,92,385522
28798,0.022509,74.125.200.0-255,5738,280044,92,385522
28799,0.022514,172.31.47.0-255,66,280110,92,385522
28800,0.02454,74.125.200.0-255,5738,285848,92,385522
28801,0.024546,172.31.47.0-255,66,285914,92,385522
28802,0.026575,74.125.200.0-255,5738,291652,92,385522
28803,0.026582,172.31.47.0-255,66,291718,92,385522
28804,0.02861,74.125.200.0-255,5738,297456,92,385522
28805,0.028617,172.31.47.0-255,66,297522,92,385522
28806,0.030656,74.125.200.0-255,5738,303260,92,385522
28807,0.030664,172.31.47.0-255,66,303326,92,385522
28808,0.0327,74.125.200.0-255,5738,309064,92,385522
28809,0.032705,172.31.47.0-255,66,309130,92,385522
28810,0.033332,172.31.47.0-255,172,309302,92,385522
28811,0.03336,172.31.47.0-255,1107,310409,92,385522
28812,0.033406,172.31.47.0-255,575,310984,92,385522
28813,0.034734,74.125.200.0-255,5738,316722,92,385522
28814,0.034742,172.31.47.0-255,66,316788,92,385522
28815,0.034895,104.244.42.0-255,66,316854,92,385522
28816,0.034902,104.244.42.0-255,66,316920,92,385522
28817,0.034942,104.244.42.0-255,66,316986,92,385522
28818,0.035557,104.244.42.0-255,108,317094,92,385522
28819,0.035564,172.31.47.0-255,66,317160,92,385522
28820,0.036767,74.125.200.0-255,1484,318644,92,385522
28821,0.036789,74.125.200.0-255,4320,322964,92,385522
28822,0.036793,172.31.47.0-255,66,323030,92,385522
28823,0.038827,74.125.200.0-255,4320,327350,92,385522
28824,0.038831,172.31.47.0-255,66,327416,92,385522
28825,0.038849,74.125.200.0-255,1484,328900,92,385522
28826,0.040874,74.125.200.0-255,4320,333220,92,385522
28827,0.040881,172.31.47.0-255,66,333286,92,385522
28828,0.042939,74.125.200.0-255,5738,339024,92,385522
28829,0.04295,172.31.47.0-255,66,339090,92,385522
28830,0.044986,74.125.200.0-255,5738,344828,92,385522
28831,0.044993,172.31.47.0-255,66,344894,92,385522
28832,0.04704,74.125.200.0-255,5738,350632,92,385522
28833,0.047046,172.31.47.0-255,66,350698,92,385522
28834,0.049071,74.125.200.0-255,5738,356436,92,385522
28835,0.049076,172.31.47.0-255,66,356502,92,385522
28836,0.051117,74.125.200.0-255,5738,362240,92,385522
28837,0.051123,172.31.47.0-255,66,362306,92,385522
28838,0.053156,74.125.200.0-255,5738,368044,92,385522
28839,0.053162,172.31.47.0-255,66,368110,92,385522
28840,0.055203,74.125.200.0-255,5738,373848,92,385522
28841,0.055209,172.31.47.0-255,66,373914,92,385522
28842,0.057278,74.125.200.0-255,5738,379652,92,385522
28843,0.05729,172.31.47.0-255,66,379718,92,385522
28844,0.059346,74.125.200.0-255,5738,385456,92,385522
28845,0.059353,172.31.47.0-255,66,385522,92,385522
28846,0.0,74.125.24.0-255,153,153,92,228574
28847,3e-05,172.31.47.0-255,66,219,92,228574
28848,3.7e-05,74.125.24.0-255,1484,1703,92,228574
28849,4.1e-05,172.31.47.0-255,66,1769,92,228574
28850,4.6e-05,74.125.24.0-255,2902,4671,92,228574
28851,5.6e-05,172.31.47.0-255,66,4737,92,228574
28852,6.2e-05,74.125.24.0-255,5738,10475,92,228574
28853,6.5e-05,172.31.47.0-255,66,10541,92,228574
28854,9.8e-05,74.125.24.0-255,3668,14209,92,228574
28855,0.000101,172.31.47.0-255,66,14275,92,228574
28856,0.000137,74.125.24.0-255,1484,15759,92,228574
28857,0.000141,172.31.47.0-255,66,15825,92,228574
28858,0.000146,74.125.24.0-255,2902,18727,92,228574
28859,0.000148,172.31.47.0-255,66,18793,92,228574
28860,0.000173,74.125.24.0-255,5738,24531,92,228574
28861,0.000176,172.31.47.0-255,66,24597,92,228574
28862,0.000187,74.125.24.0-255,4320,28917,92,228574
28863,0.000189,172.31.47.0-255,66,28983,92,228574
28864,0.000216,74.125.24.0-255,2543,31526,92,228574
28865,0.000225,172.31.47.0-255,66,31592,92,228574
28866,0.000246,74.125.24.0-255,1484,33076,92,228574
28867,0.00025,74.125.24.0-255,2902,35978,92,228574
28868,0.000251,172.31.47.0-255,66,36044,92,228574
28869,0.000255,172.31.47.0-255,66,36110,92,228574
28870,0.000281,74.125.24.0-255,5738,41848,92,228574
28871,0.000284,172.31.47.0-255,66,41914,92,228574
28872,0.00029,74.125.24.0-255,4320,46234,92,228574
28873,0.000292,172.31.47.0-255,66,46300,92,228574
28874,0.000332,74.125.24.0-255,2543,48843,92,228574
28875,0.000336,172.31.47.0-255,66,48909,92,228574
28876,0.000407,74.125.24.0-255,1484,50393,92,228574
28877,0.000411,172.31.47.0-255,66,50459,92,228574
28878,0.000423,74.125.24.0-255,2902,53361,92,228574
28879,0.000427,172.31.47.0-255,66,53427,92,228574
28880,0.000438,74.125.24.0-255,5738,59165,92,228574
28881,0.000441,172.31.47.0-255,66,59231,92,228574
28882,0.000488,74.125.24.0-255,4320,63551,92,228574
28883,0.000491,172.31.47.0-255,66,63617,92,228574
28884,0.000508,74.125.24.0-255,3153,66770,92,228574
28885,0.000511,172.31.47.0-255,66,66836,92,228574
28886,0.000745,74.125.24.0-255,1484,68320,92,228574
28887,0.000761,74.125.24.0-255,2902,71222,92,228574
28888,0.000764,172.31.47.0-255,66,71288,92,228574
28889,0.00077,74.125.24.0-255,5738,77026,92,228574
28890,0.000772,172.31.47.0-255,66,77092,92,228574
28891,0.000807,172.31.47.0-255,66,77158,92,228574
28892,0.000842,74.125.24.0-255,1484,78642,92,228574
28893,0.00086,172.31.47.0-255,66,78708,92,228574
28894,0.000877,74.125.24.0-255,5020,83728,92,228574
28895,0.000879,172.31.47.0-255,66,83794,92,228574
28896,0.001197,74.125.24.0-255,1484,85278,92,228574
28897,0.001205,74.125.24.0-255,2902,88180,92,228574
28898,0.001208,172.31.47.0-255,66,88246,92,228574
28899,0.001244,74.125.24.0-255,5738,93984,92,228574
28900,0.001247,172.31.47.0-255,66,94050,92,228574
28901,0.001264,172.31.47.0-255,66,94116,92,228574
28902,0.001293,74.125.24.0-255,1484,95600,92,228574
28903,0.00132,172.31.47.0-255,66,95666,92,228574
28904,0.002362,74.125.24.0-255,1484,97150,92,228574
28905,0.002369,74.125.24.0-255,2902,100052,92,228574
28906,0.002372,172.31.47.0-255,66,100118,92,228574
28907,0.002406,74.125.24.0-255,1484,101602,92,228574
28908,0.002418,74.125.24.0-255,4320,105922,92,228574
28909,0.00242,172.31.47.0-255,66,105988,92,228574
28910,0.002434,172.31.47.0-255,66,106054,92,228574
28911,0.002454,74.125.24.0-255,4320,110374,92,228574
28912,0.002456,172.31.47.0-255,66,110440,92,228574
28913,0.002476,74.125.24.0-255,6438,116878,92,228574
28914,0.002478,172.31.47.0-255,66,116944,92,228574
28915,0.002507,74.125.24.0-255,1484,118428,92,228574
28916,0.00252,74.125.24.0-255,1484,119912,92,228574
28917,0.002522,172.31.47.0-255,66,119978,92,228574
28918,0.002549,74.125.24.0-255,1484,121462,92,228574
28919,0.002554,74.125.24.0-255,5738,127200,92,228574
28920,0.002556,172.31.47.0-255,66,127266,92,228574
28921,0.002558,74.125.24.0-255,1484,128750,92,228574
28922,0.002573,74.125.24.0-255,5738,134488,92,228574
28923,0.002575,172.31.47.0-255,66,134554,92,228574
28924,0.002603,74.125.24.0-255,4320,138874,92,228574
28925,0.002605,172.31.47.0-255,66,138940,92,228574
28926,0.002619,172.31.47.0-255,66,139006,92,228574
28927,0.002943,74.125.24.0-255,1484,140490,92,228574
28928,0.00296,74.125.24.0-255,2902,143392,92,228574
28929,0.002962,172.31.47.0-255,66,143458,92,228574
28930,0.002973,74.125.24.0-255,1484,144942,92,228574
28931,0.002996,74.125.24.0-255,4320,149262,92,228574
28932,0.002998,172.31.47.0-255,66,149328,92,228574
28933,0.003009,172.31.47.0-255,66,149394,92,228574
28934,0.003017,74.125.24.0-255,4320,153714,92,228574
28935,0.003019,172.31.47.0-255,66,153780,92,228574
28936,0.003025,74.125.24.0-255,6438,160218,92,228574
28937,0.003027,172.31.47.0-255,66,160284,92,228574
28938,0.003158,74.125.24.0-255,1484,161768,92,228574
28939,0.003171,74.125.24.0-255,2902,164670,92,228574
28940,0.003173,172.31.47.0-255,66,164736,92,228574
28941,0.003202,74.125.24.0-255,5738,170474,92,228574
28942,0.003204,172.31.47.0-255,66,170540,92,228574
28943,0.003208,74.125.24.0-255,2902,173442,92,228574
28944,0.003209,172.31.47.0-255,66,173508,92,228574
28945,0.003262,172.31.47.0-255,66,173574,92,228574
28946,0.00327,172.31.47.0-255,66,173640,92,228574
28947,0.003273,74.125.24.0-255,2184,175824,92,228574
28948,0.003279,172.31.47.0-255,66,175890,92,228574
28949,0.003323,74.125.24.0-255,1484,177374,92,228574
28950,0.003338,74.125.24.0-255,2902,180276,92,228574
28951,0.003342,172.31.47.0-255,66,180342,92,228574
28952,0.003346,74.125.24.0-255,4320,184662,92,228574
28953,0.003348,172.31.47.0-255,66,184728,92,228574
28954,0.003379,74.125.24.0-255,1484,186212,92,228574
28955,0.003392,172.31.47.0-255,66,186278,92,228574
28956,0.003401,172.31.47.0-255,66,186344,92,228574
28957,0.00341,74.125.24.0-255,3602,189946,92,228574
28958,0.003412,172.31.47.0-255,66,190012,92,228574
28959,0.003415,74.125.24.0-255,1484,191496,92,228574
28960,0.003448,74.125.24.0-255,7156,198652,92,228574
28961,0.003451,172.31.47.0-255,66,198718,92,228574
28962,0.003456,74.125.24.0-255,4320,203038,92,228574
28963,0.003457,172.31.47.0-255,66,203104,92,228574
28964,0.003494,172.31.47.0-255,66,203170,92,228574
28965,0.003504,172.31.47.0-255,66,203236,92,228574
28966,0.003551,74.125.24.0-255,5738,208974,92,228574
28967,0.003554,172.31.47.0-255,66,209040,92,228574
28968,0.003579,74.125.24.0-255,4320,213360,92,228574
28969,0.003583,172.31.47.0-255,66,213426,92,228574
28970,0.003602,172.31.47.0-255,66,213492,92,228574
28971,0.003615,172.31.47.0-255,66,213558,92,228574
28972,0.003622,172.31.47.0-255,66,213624,92,228574
28973,0.003705,172.31.47.0-255,66,213690,92,228574
28974,0.003714,74.125.24.0-255,5204,218894,92,228574
28975,0.003724,172.31.47.0-255,66,218960,92,228574
28976,0.003727,74.125.24.0-255,105,219065,92,228574
28977,0.011284,172.31.47.0-255,66,219131,92,228574
28978,0.011313,172.31.47.0-255,105,219236,92,228574
28979,0.013752,74.125.24.0-255,66,219302,92,228574
28980,0.033874,172.31.47.0-255,172,219474,92,228574
28981,0.033904,172.31.47.0-255,1107,220581,92,228574
28982,0.03394,172.31.47.0-255,1514,222095,92,228574
28983,0.033942,172.31.47.0-255,1514,223609,92,228574
28984,0.033943,172.31.47.0-255,1514,225123,92,228574
28985,0.033944,172.31.47.0-255,1514,226637,92,228574
28986,0.033987,172.31.47.0-255,1499,228136,92,228574
28987,0.035421,104.244.42.0-255,66,228202,92,228574
28988,0.035453,104.244.42.0-255,66,228268,92,228574
28989,0.035548,104.244.42.0-255,66,228334,92,228574
28990,0.035586,104.244.42.0-255,66,228400,92,228574
28991,0.03622,104.244.42.0-255,108,228508,92,228574
28992,0.036226,172.31.47.0-255,66,228574,92,228574
28993,0.0,74.125.200.0-255,153,153,92,359527
28994,2.4e-05,172.31.47.0-255,66,219,92,359527
28995,3.1e-05,74.125.200.0-255,1484,1703,92,359527
28996,3.4e-05,172.31.47.0-255,66,1769,92,359527
28997,3.8e-05,74.125.200.0-255,2902,4671,92,359527
28998,4e-05,172.31.47.0-255,66,4737,92,359527
28999,6.3e-05,74.125.200.0-255,4320,9057,92,359527
29000,6.6e-05,172.31.47.0-255,66,9123,92,359527
29001,9.6e-05,74.125.200.0-255,4997,14120,92,359527
29002,9.9e-05,172.31.47.0-255,66,14186,92,359527
29003,0.000123,74.125.200.0-255,5738,19924,92,359527
29004,0.000125,172.31.47.0-255,66,19990,92,359527
29005,0.00015,74.125.200.0-255,5738,25728,92,359527
29006,0.000154,172.31.47.0-255,66,25794,92,359527
29007,0.000182,74.125.200.0-255,5379,31173,92,359527
29008,0.000185,172.31.47.0-255,66,31239,92,359527
29009,0.00023,74.125.200.0-255,1484,32723,92,359527
29010,0.000233,172.31.47.0-255,66,32789,92,359527
29011,0.000236,74.125.200.0-255,1484,34273,92,359527
29012,0.000237,172.31.47.0-255,66,34339,92,359527
29013,0.000258,74.125.200.0-255,2902,37241,92,359527
29014,0.000261,172.31.47.0-255,66,37307,92,359527
29015,0.000289,74.125.200.0-255,5738,43045,92,359527
29016,0.000292,172.31.47.0-255,66,43111,92,359527
29017,0.000317,74.125.200.0-255,6797,49908,92,359527
29018,0.000321,172.31.47.0-255,66,49974,92,359527
29019,0.000339,74.125.200.0-255,1484,51458,92,359527
29020,0.000341,172.31.47.0-255,66,51524,92,359527
29021,0.000371,74.125.200.0-255,5738,57262,92,359527
29022,0.000375,172.31.47.0-255,66,57328,92,359527
29023,0.000381,74.125.200.0-255,7156,64484,92,359527
29024,0.000384,172.31.47.0-255,66,64550,92,359527
29025,0.000391,74.125.200.0-255,1125,65675,92,359527
29026,0.000422,74.125.200.0-255,646,66321,92,359527
29027,0.000425,172.31.47.0-255,66,66387,92,359527
29028,0.000879,74.125.200.0-255,1484,67871,92,359527
29029,0.000894,74.125.200.0-255,2902,70773,92,359527
29030,0.000898,172.31.47.0-255,66,70839,92,359527
29031,0.000903,74.125.200.0-255,2902,73741,92,359527
29032,0.000905,172.31.47.0-255,66,73807,92,359527
29033,0.000907,74.125.200.0-255,1484,75291,92,359527
29034,0.000931,74.125.200.0-255,2902,78193,92,359527
29035,0.000934,172.31.47.0-255,66,78259,92,359527
29036,0.000944,172.31.47.0-255,66,78325,92,359527
29037,0.000973,74.125.200.0-255,7156,85481,92,359527
29038,0.000976,172.31.47.0-255,66,85547,92,359527
29039,0.001012,74.125.200.0-255,6438,91985,92,359527
29040,0.001016,172.31.47.0-255,66,92051,92,359527
29041,0.001423,74.125.200.0-255,1484,93535,92,359527
29042,0.001442,74.125.200.0-255,2902,96437,92,359527
29043,0.001445,172.31.47.0-255,66,96503,92,359527
29044,0.001451,74.125.200.0-255,5738,102241,92,359527
29045,0.001453,172.31.47.0-255,66,102307,92,359527
29046,0.001455,74.125.200.0-255,1484,103791,92,359527
29047,0.001478,74.125.200.0-255,1484,105275,92,359527
29048,0.00148,172.31.47.0-255,66,105341,92,359527
29049,0.001482,74.125.200.0-255,1484,106825,92,359527
29050,0.001512,172.31.47.0-255,66,106891,92,359527
29051,0.001514,74.125.200.0-255,1484,108375,92,359527
29052,0.00154,172.31.47.0-255,66,108441,92,359527
29053,0.001591,74.125.200.0-255,1484,109925,92,359527
29054,0.001602,74.125.200.0-255,2902,112827,92,359527
29055,0.001604,172.31.47.0-255,66,112893,92,359527
29056,0.001606,74.125.200.0-255,1484,114377,92,359527
29057,0.001641,74.125.200.0-255,2902,117279,92,359527
29058,0.001643,172.31.47.0-255,66,117345,92,359527
29059,0.001648,74.125.200.0-255,5738,123083,92,359527
29060,0.00165,172.31.47.0-255,66,123149,92,359527
29061,0.001684,74.125.200.0-255,2902,126051,92,359527
29062,0.001686,172.31.47.0-255,66,126117,92,359527
29063,0.00171,74.125.200.0-255,2902,129019,92,359527
29064,0.001712,172.31.47.0-255,66,129085,92,359527
29065,0.001718,74.125.200.0-255,7156,136241,92,359527
29066,0.001719,172.31.47.0-255,66,136307,92,359527
29067,0.001723,74.125.200.0-255,4320,140627,92,359527
29068,0.001725,172.31.47.0-255,66,140693,92,359527
29069,0.001771,74.125.200.0-255,2184,142877,92,359527
29070,0.001774,172.31.47.0-255,66,142943,92,359527
29071,0.001802,74.125.200.0-255,2902,145845,92,359527
29072,0.001804,172.31.47.0-255,66,145911,92,359527
29073,0.00183,74.125.200.0-255,4320,150231,92,359527
29074,0.001832,172.31.47.0-255,66,150297,92,359527
29075,0.001835,74.125.200.0-255,2902,153199,92,359527
29076,0.001837,172.31.47.0-255,66,153265,92,359527
29077,0.001856,74.125.200.0-255,2902,156167,92,359527
29078,0.001858,172.31.47.0-255,66,156233,92,359527
29079,0.001863,74.125.200.0-255,4320,160553,92,359527
29080,0.001865,172.31.47.0-255,66,160619,92,359527
29081,0.001898,74.125.200.0-255,7156,167775,92,359527
29082,0.001901,172.31.47.0-255,66,167841,92,359527
29083,0.001905,74.125.200.0-255,4320,172161,92,359527
29084,0.001907,172.31.47.0-255,66,172227,92,359527
29085,0.001943,74.125.200.0-255,5020,177247,92,359527
29086,0.001945,172.31.47.0-255,66,177313,92,359527
29087,0.002175,74.125.200.0-255,1484,178797,92,359527
29088,0.002227,74.125.200.0-255,1484,180281,92,359527
29089,0.002229,172.31.47.0-255,66,180347,92,359527
29090,0.00224,74.125.200.0-255,1484,181831,92,359527
29091,0.002255,74.125.200.0-255,1484,183315,92,359527
29092,0.002257,172.31.47.0-255,66,183381,92,359527
29093,0.002261,74.125.200.0-255,2902,186283,92,359527
29094,0.002263,172.31.47.0-255,66,186349,92,359527
29095,0.002293,74.125.200.0-255,2902,189251,92,359527
29096,0.002295,172.31.47.0-255,66,189317,92,359527
29097,0.002301,74.125.200.0-255,4320,193637,92,359527
29098,0.002303,172.31.47.0-255,66,193703,92,359527
29099,0.002312,74.125.200.0-255,5738,199441,92,359527
29100,0.002315,172.31.47.0-255,66,199507,92,359527
29101,0.00232,74.125.200.0-255,5738,205245,92,359527
29102,0.002322,172.31.47.0-255,66,205311,92,359527
29103,0.002348,74.125.200.0-255,5738,211049,92,359527
29104,0.002355,172.31.47.0-255,66,211115,92,359527
29105,0.002357,74.125.200.0-255,766,211881,92,359527
29106,0.004714,74.125.200.0-255,4320,216201,92,359527
29107,0.004719,172.31.47.0-255,66,216267,92,359527
29108,0.00711,74.125.200.0-255,5738,222005,92,359527
29109,0.007116,172.31.47.0-255,66,222071,92,359527
29110,0.009488,74.125.200.0-255,5738,227809,92,359527
29111,0.009494,172.31.47.0-255,66,227875,92,359527
29112,0.011882,74.125.200.0-255,5738,233613,92,359527
29113,0.011893,172.31.47.0-255,66,233679,92,359527
29114,0.014275,74.125.200.0-255,5738,239417,92,359527
29115,0.014291,172.31.47.0-255,66,239483,92,359527
29116,0.016669,74.125.200.0-255,5738,245221,92,359527
29117,0.016677,172.31.47.0-255,66,245287,92,359527
29118,0.01904,74.125.200.0-255,5738,251025,92,359527
29119,0.019046,172.31.47.0-255,66,251091,92,359527
29120,0.021415,74.125.200.0-255,4320,255411,92,359527
29121,0.021422,172.31.47.0-255,66,255477,92,359527
29122,0.02145,74.125.200.0-255,1484,256961,92,359527
29123,0.023786,74.125.200.0-255,4320,261281,92,359527
29124,0.023792,172.31.47.0-255,66,261347,92,359527
29125,0.026168,74.125.200.0-255,5738,267085,92,359527
29126,0.026175,172.31.47.0-255,66,267151,92,359527
29127,0.02855,74.125.200.0-255,5738,272889,92,359527
29128,0.028556,172.31.47.0-255,66,272955,92,359527
29129,0.028713,172.31.47.0-255,172,273127,92,359527
29130,0.028748,172.31.47.0-255,1111,274238,92,359527
29131,0.028801,172.31.47.0-255,1514,275752,92,359527
29132,0.028803,172.31.47.0-255,1514,277266,92,359527
29133,0.028804,172.31.47.0-255,1514,278780,92,359527
29134,0.028853,172.31.47.0-255,1514,280294,92,359527
29135,0.028855,172.31.47.0-255,1495,281789,92,359527
29136,0.030288,104.244.42.0-255,66,281855,92,359527
29137,0.030375,104.244.42.0-255,66,281921,92,359527
29138,0.030423,104.244.42.0-255,66,281987,92,359527
29139,0.030474,104.244.42.0-255,66,282053,92,359527
29140,0.030928,74.125.200.0-255,2902,284955,92,359527
29141,0.030932,172.31.47.0-255,66,285021,92,359527
29142,0.03097,74.125.200.0-255,2902,287923,92,359527
29143,0.030973,172.31.47.0-255,66,287989,92,359527
29144,0.031712,104.244.42.0-255,108,288097,92,359527
29145,0.031717,172.31.47.0-255,66,288163,92,359527
29146,0.033298,74.125.200.0-255,1484,289647,92,359527
29147,0.033326,74.125.200.0-255,1484,291131,92,359527
29148,0.03333,172.31.47.0-255,66,291197,92,359527
29149,0.033358,74.125.200.0-255,2902,294099,92,359527
29150,0.033361,172.31.47.0-255,66,294165,92,359527
29151,0.035697,74.125.200.0-255,2902,297067,92,359527
29152,0.035701,172.31.47.0-255,66,297133,92,359527
29153,0.035729,74.125.200.0-255,2902,300035,92,359527
29154,0.035732,172.31.47.0-255,66,300101,92,359527
29155,0.038058,74.125.200.0-255,2902,303003,92,359527
29156,0.038062,172.31.47.0-255,66,303069,92,359527
29157,0.03809,74.125.200.0-255,2902,305971,92,359527
29158,0.038093,172.31.47.0-255,66,306037,92,359527
29159,0.04043,74.125.200.0-255,2902,308939,92,359527
29160,0.040436,172.31.47.0-255,66,309005,92,359527
29161,0.040473,74.125.200.0-255,2902,311907,92,359527
29162,0.040477,172.31.47.0-255,66,311973,92,359527
29163,0.042814,74.125.200.0-255,2902,314875,92,359527
29164,0.042819,172.31.47.0-255,66,314941,92,359527
29165,0.042857,74.125.200.0-255,2902,317843,92,359527
29166,0.04286,172.31.47.0-255,66,317909,92,359527
29167,0.045184,74.125.200.0-255,2902,320811,92,359527
29168,0.045189,172.31.47.0-255,66,320877,92,359527
29169,0.045212,74.125.200.0-255,1484,322361,92,359527
29170,0.045223,74.125.200.0-255,1484,323845,92,359527
29171,0.045226,172.31.47.0-255,66,323911,92,359527
29172,0.047561,74.125.200.0-255,2902,326813,92,359527
29173,0.047565,172.31.47.0-255,66,326879,92,359527
29174,0.0476,74.125.200.0-255,2902,329781,92,359527
29175,0.047603,172.31.47.0-255,66,329847,92,359527
29176,0.049929,74.125.200.0-255,2902,332749,92,359527
29177,0.049933,172.31.47.0-255,66,332815,92,359527
29178,0.049965,74.125.200.0-255,2902,335717,92,359527
29179,0.049968,172.31.47.0-255,66,335783,92,359527
29180,0.052298,74.125.200.0-255,2902,338685,92,359527
29181,0.052303,172.31.47.0-255,66,338751,92,359527
29182,0.052336,74.125.200.0-255,2902,341653,92,359527
29183,0.05234,172.31.47.0-255,66,341719,92,359527
29184,0.05467,74.125.200.0-255,2902,344621,92,359527
29185,0.054676,172.31.47.0-255,66,344687,92,359527
29186,0.054707,74.125.200.0-255,2902,347589,92,359527
29187,0.054709,172.31.47.0-255,66,347655,92,359527
29188,0.057051,74.125.200.0-255,2902,350557,92,359527
29189,0.057056,172.31.47.0-255,66,350623,92,359527
29190,0.057093,74.125.200.0-255,2902,353525,92,359527
29191,0.057096,172.31.47.0-255,66,353591,92,359527
29192,0.059414,74.125.200.0-255,2902,356493,92,359527
29193,0.059418,172.31.47.0-255,66,356559,92,359527
29194,0.059453,74.125.200.0-255,2902,359461,92,359527
29195,0.059455,172.31.47.0-255,66,359527,92,359527
29196,0.0,172.31.47.0-255,105,105,92,276
29197,0.002187,157.240.7.0-255,105,210,92,276
29198,0.002202,172.31.47.0-255,66,276,92,276
29199,0.0,74.125.24.0-255,153,153,92,290546
29200,1.2e-05,172.31.47.0-255,66,219,92,290546
29201,2.7e-05,74.125.24.0-255,1484,1703,92,290546
29202,3.6e-05,172.31.47.0-255,66,1769,92,290546
29203,4.2e-05,74.125.24.0-255,2902,4671,92,290546
29204,4.5e-05,172.31.47.0-255,66,4737,92,290546
29205,4.8e-05,74.125.24.0-255,1484,6221,92,290546
29206,5e-05,172.31.47.0-255,66,6287,92,290546
29207,8.7e-05,74.125.24.0-255,5738,12025,92,290546
29208,8.9e-05,172.31.47.0-255,66,12091,92,290546
29209,0.000105,74.125.24.0-255,2127,14218,92,290546
29210,0.000118,172.31.47.0-255,66,14284,92,290546
29211,0.000123,74.125.24.0-255,2902,17186,92,290546
29212,0.000125,172.31.47.0-255,66,17252,92,290546
29213,0.000152,74.125.24.0-255,7156,24408,92,290546
29214,0.000155,172.31.47.0-255,66,24474,92,290546
29215,0.000184,74.125.24.0-255,6797,31271,92,290546
29216,0.000187,172.31.47.0-255,66,31337,92,290546
29217,0.000252,74.125.24.0-255,1484,32821,92,290546
29218,0.000255,172.31.47.0-255,66,32887,92,290546
29219,0.00026,74.125.24.0-255,2902,35789,92,290546
29220,0.000262,172.31.47.0-255,66,35855,92,290546
29221,0.00027,74.125.24.0-255,4320,40175,92,290546
29222,0.000272,172.31.47.0-255,66,40241,92,290546
29223,0.000299,74.125.24.0-255,1484,41725,92,290546
29224,0.0003,172.31.47.0-255,66,41791,92,290546
29225,0.000318,172.31.47.0-255,66,41857,92,290546
29226,0.000323,74.125.24.0-255,4320,46177,92,290546
29227,0.000325,172.31.47.0-255,66,46243,92,290546
29228,0.000363,74.125.24.0-255,5709,51952,92,290546
29229,0.000366,172.31.47.0-255,66,52018,92,290546
29230,0.000397,74.125.24.0-255,378,52396,92,290546
29231,0.000598,74.125.24.0-255,1484,53880,92,290546
29232,0.000614,172.31.47.0-255,66,53946,92,290546
29233,0.00062,74.125.24.0-255,2902,56848,92,290546
29234,0.000625,74.125.24.0-255,5738,62586,92,290546
29235,0.000639,172.31.47.0-255,66,62652,92,290546
29236,0.000647,74.125.24.0-255,1484,64136,92,290546
29237,0.000689,172.31.47.0-255,66,64202,92,290546
29238,0.000928,74.125.24.0-255,1484,65686,92,290546
29239,0.000934,74.125.24.0-255,2902,68588,92,290546
29240,0.000937,172.31.47.0-255,66,68654,92,290546
29241,0.000965,74.125.24.0-255,5738,74392,92,290546
29242,0.000969,74.125.24.0-255,2902,77294,92,290546
29243,0.000973,172.31.47.0-255,66,77360,92,290546
29244,0.001003,74.125.24.0-255,7156,84516,92,290546
29245,0.001011,172.31.47.0-255,66,84582,92,290546
29246,0.001073,172.31.47.0-255,66,84648,92,290546
29247,0.001395,74.125.24.0-255,1484,86132,92,290546
29248,0.001409,74.125.24.0-255,2902,89034,92,290546
29249,0.001413,172.31.47.0-255,66,89100,92,290546
29250,0.001437,74.125.24.0-255,4320,93420,92,290546
29251,0.001449,172.31.47.0-255,66,93486,92,290546
29252,0.001484,74.125.24.0-255,4320,97806,92,290546
29253,0.001489,172.31.47.0-255,66,97872,92,290546
29254,0.001532,172.31.47.0-255,66,97938,92,290546
29255,0.001685,74.125.24.0-255,1484,99422,92,290546
29256,0.001706,74.125.24.0-255,2902,102324,92,290546
29257,0.001709,172.31.47.0-255,66,102390,92,290546
29258,0.001715,74.125.24.0-255,5738,108128,92,290546
29259,0.001717,74.125.24.0-255,1484,109612,92,290546
29260,0.001733,172.31.47.0-255,66,109678,92,290546
29261,0.00174,74.125.24.0-255,7156,116834,92,290546
29262,0.001766,172.31.47.0-255,66,116900,92,290546
29263,0.001816,172.31.47.0-255,66,116966,92,290546
29264,0.001998,74.125.24.0-255,1484,118450,92,290546
29265,0.002003,74.125.24.0-255,2902,121352,92,290546
29266,0.002006,172.31.47.0-255,66,121418,92,290546
29267,0.002037,74.125.24.0-255,5738,127156,92,290546
29268,0.002044,74.125.24.0-255,5738,132894,92,290546
29269,0.002048,74.125.24.0-255,2902,135796,92,290546
29270,0.002058,172.31.47.0-255,66,135862,92,290546
29271,0.002098,74.125.24.0-255,5020,140882,92,290546
29272,0.002274,74.125.24.0-255,1484,142366,92,290546
29273,0.00228,74.125.24.0-255,2902,145268,92,290546
29274,0.002302,74.125.24.0-255,5738,151006,92,290546
29275,0.002346,74.125.24.0-255,2902,153908,92,290546
29276,0.007222,172.31.47.0-255,66,153974,92,290546
29277,0.009564,74.125.24.0-255,5738,159712,92,290546
29278,0.009573,172.31.47.0-255,66,159778,92,290546
29279,0.011897,74.125.24.0-255,5738,165516,92,290546
29280,0.011908,172.31.47.0-255,66,165582,92,290546
29281,0.014239,74.125.24.0-255,5738,171320,92,290546
29282,0.014252,172.31.47.0-255,66,171386,92,290546
29283,0.016588,74.125.24.0-255,5738,177124,92,290546
29284,0.016602,172.31.47.0-255,66,177190,92,290546
29285,0.018918,74.125.24.0-255,5738,182928,92,290546
29286,0.018927,172.31.47.0-255,66,182994,92,290546
29287,0.021227,74.125.24.0-255,5738,188732,92,290546
29288,0.021235,172.31.47.0-255,66,188798,92,290546
29289,0.023543,74.125.24.0-255,5738,194536,92,290546
29290,0.02355,172.31.47.0-255,66,194602,92,290546
29291,0.025872,74.125.24.0-255,5738,200340,92,290546
29292,0.02588,172.31.47.0-255,66,200406,92,290546
29293,0.027645,172.31.47.0-255,171,200577,92,290546
29294,0.02767,172.31.47.0-255,1135,201712,92,290546
29295,0.027729,172.31.47.0-255,1514,203226,92,290546
29296,0.02773,172.31.47.0-255,1514,204740,92,290546
29297,0.027736,172.31.47.0-255,1514,206254,92,290546
29298,0.027737,172.31.47.0-255,1514,207768,92,290546
29299,0.027753,172.31.47.0-255,334,208102,92,290546
29300,0.028187,74.125.24.0-255,2902,211004,92,290546
29301,0.028192,172.31.47.0-255,66,211070,92,290546
29302,0.02822,74.125.24.0-255,2902,213972,92,290546
29303,0.028281,172.31.47.0-255,66,214038,92,290546
29304,0.029125,104.244.42.0-255,66,214104,92,290546
29305,0.029157,104.244.42.0-255,66,214170,92,290546
29306,0.02923,104.244.42.0-255,66,214236,92,290546
29307,0.029235,104.244.42.0-255,66,214302,92,290546
29308,0.030535,74.125.24.0-255,2902,217204,92,290546
29309,0.030541,172.31.47.0-255,66,217270,92,290546
29310,0.03057,74.125.24.0-255,2902,220172,92,290546
29311,0.030593,172.31.47.0-255,66,220238,92,290546
29312,0.032874,74.125.24.0-255,2902,223140,92,290546
29313,0.032881,172.31.47.0-255,66,223206,92,290546
29314,0.032917,74.125.24.0-255,2902,226108,92,290546
29315,0.032939,172.31.47.0-255,66,226174,92,290546
29316,0.035207,74.125.24.0-255,2902,229076,92,290546
29317,0.035213,172.31.47.0-255,66,229142,92,290546
29318,0.035252,74.125.24.0-255,2902,232044,92,290546
29319,0.035262,172.31.47.0-255,66,232110,92,290546
29320,0.037535,74.125.24.0-255,2902,235012,92,290546
29321,0.037541,172.31.47.0-255,66,235078,92,290546
29322,0.037566,74.125.24.0-255,2902,237980,92,290546
29323,0.037583,172.31.47.0-255,66,238046,92,290546
29324,0.039867,74.125.24.0-255,2902,240948,92,290546
29325,0.039873,172.31.47.0-255,66,241014,92,290546
29326,0.039897,74.125.24.0-255,2902,243916,92,290546
29327,0.039919,172.31.47.0-255,66,243982,92,290546
29328,0.042192,74.125.24.0-255,2902,246884,92,290546
29329,0.042199,172.31.47.0-255,66,246950,92,290546
29330,0.042219,74.125.24.0-255,2902,249852,92,290546
29331,0.042241,172.31.47.0-255,66,249918,92,290546
29332,0.044609,74.125.24.0-255,5738,255656,92,290546
29333,0.044642,172.31.47.0-255,66,255722,92,290546
29334,0.046964,74.125.24.0-255,5738,261460,92,290546
29335,0.04697,172.31.47.0-255,66,261526,92,290546
29336,0.049277,74.125.24.0-255,5738,267264,92,290546
29337,0.049283,172.31.47.0-255,66,267330,92,290546
29338,0.051609,74.125.24.0-255,5738,273068,92,290546
29339,0.051615,172.31.47.0-255,66,273134,92,290546
29340,0.053937,74.125.24.0-255,5738,278872,92,290546
29341,0.053942,172.31.47.0-255,66,278938,92,290546
29342,0.05625,74.125.24.0-255,5738,284676,92,290546
29343,0.056258,172.31.47.0-255,66,284742,92,290546
29344,0.058586,74.125.24.0-255,5738,290480,92,290546
29345,0.058594,172.31.47.0-255,66,290546,92,290546
29346,0.0,172.31.47.0-255,105,105,92,105
29347,0.0,172.31.47.0-255,105,105,92,276
29348,0.001779,157.240.13.0-255,105,210,92,276
29349,0.040048,172.31.47.0-255,66,276,92,276
29350,0.0,172.31.47.0-255,105,105,92,276
29351,0.001774,157.240.13.0-255,105,210,92,276
29352,0.001784,172.31.47.0-255,66,276,92,276
29353,0.0,172.31.47.0-255,105,105,92,276
29354,0.001784,157.240.13.0-255,105,210,92,276
29355,0.001797,172.31.47.0-255,66,276,92,276
29356,0.0,172.217.194.0-255,152,152,92,264994
29357,2.5e-05,172.31.47.0-255,66,218,92,264994
29358,3.2e-05,172.217.194.0-255,1484,1702,92,264994
29359,3.6e-05,172.31.47.0-255,66,1768,92,264994
29360,4.1e-05,172.217.194.0-255,2902,4670,92,264994
29361,4.4e-05,172.31.47.0-255,66,4736,92,264994
29362,5.8e-05,172.217.194.0-255,7156,11892,92,264994
29363,6.1e-05,172.31.47.0-255,66,11958,92,264994
29364,9.2e-05,172.217.194.0-255,7156,19114,92,264994
29365,9.5e-05,172.31.47.0-255,66,19180,92,264994
29366,0.000122,172.217.194.0-255,3375,22555,92,264994
29367,0.000126,172.31.47.0-255,66,22621,92,264994
29368,0.00013,172.217.194.0-255,2902,25523,92,264994
29369,0.000132,172.31.47.0-255,66,25589,92,264994
29370,0.000162,172.217.194.0-255,5379,30968,92,264994
29371,0.000167,172.31.47.0-255,66,31034,92,264994
29372,0.000239,172.217.194.0-255,1484,32518,92,264994
29373,0.000242,172.31.47.0-255,66,32584,92,264994
29374,0.000246,172.217.194.0-255,2902,35486,92,264994
29375,0.000248,172.31.47.0-255,66,35552,92,264994
29376,0.000279,172.217.194.0-255,5738,41290,92,264994
29377,0.000283,172.31.47.0-255,66,41356,92,264994
29378,0.000293,172.31.47.0-255,66,41422,92,264994
29379,0.000333,172.31.47.0-255,66,41488,92,264994
29380,0.00034,172.217.194.0-255,6797,48285,92,264994
29381,0.000342,172.31.47.0-255,66,48351,92,264994
29382,0.000976,172.217.194.0-255,647,48998,92,264994
29383,0.000981,172.31.47.0-255,66,49064,92,264994
29384,0.001008,172.217.194.0-255,1484,50548,92,264994
29385,0.001011,172.31.47.0-255,66,50614,92,264994
29386,0.001018,172.217.194.0-255,4320,54934,92,264994
29387,0.001021,172.31.47.0-255,66,55000,92,264994
29388,0.001057,172.31.47.0-255,66,55066,92,264994
29389,0.001068,172.31.47.0-255,66,55132,92,264994
29390,0.001097,172.217.194.0-255,2902,58034,92,264994
29391,0.0011,172.31.47.0-255,66,58100,92,264994
29392,0.001123,172.217.194.0-255,6438,64538,92,264994
29393,0.001126,172.31.47.0-255,66,64604,92,264994
29394,0.001625,172.217.194.0-255,1484,66088,92,264994
29395,0.001642,172.217.194.0-255,2902,68990,92,264994
29396,0.001646,172.31.47.0-255,66,69056,92,264994
29397,0.001651,172.217.194.0-255,2902,71958,92,264994
29398,0.001652,172.31.47.0-255,66,72024,92,264994
29399,0.00169,172.217.194.0-255,7156,79180,92,264994
29400,0.001692,172.31.47.0-255,66,79246,92,264994
29401,0.001731,172.217.194.0-255,5738,84984,92,264994
29402,0.001733,172.31.47.0-255,66,85050,92,264994
29403,0.001751,172.31.47.0-255,66,85116,92,264994
29404,0.00176,172.217.194.0-255,3602,88718,92,264994
29405,0.001763,172.31.47.0-255,66,88784,92,264994
29406,0.001781,172.31.47.0-255,66,88850,92,264994
29407,0.001794,172.31.47.0-255,66,88916,92,264994
29408,0.001796,172.217.194.0-255,766,89682,92,264994
29409,0.001913,172.217.194.0-255,1484,91166,92,264994
29410,0.001916,172.31.47.0-255,66,91232,92,264994
29411,0.00192,172.217.194.0-255,1484,92716,92,264994
29412,0.001938,172.217.194.0-255,1484,94200,92,264994
29413,0.00194,172.31.47.0-255,66,94266,92,264994
29414,0.001946,172.217.194.0-255,5738,100004,92,264994
29415,0.001949,172.31.47.0-255,66,100070,92,264994
29416,0.00198,172.31.47.0-255,66,100136,92,264994
29417,0.002006,172.217.194.0-255,4320,104456,92,264994
29418,0.002009,172.31.47.0-255,66,104522,92,264994
29419,0.002018,172.31.47.0-255,66,104588,92,264994
29420,0.002026,172.217.194.0-255,2184,106772,92,264994
29421,0.002028,172.31.47.0-255,66,106838,92,264994
29422,0.004116,172.217.194.0-255,4320,111158,92,264994
29423,0.004123,172.31.47.0-255,66,111224,92,264994
29424,0.004133,172.217.194.0-255,1484,112708,92,264994
29425,0.006217,172.217.194.0-255,4320,117028,92,264994
29426,0.006222,172.31.47.0-255,66,117094,92,264994
29427,0.008317,172.217.194.0-255,4320,121414,92,264994
29428,0.008323,172.31.47.0-255,66,121480,92,264994
29429,0.008352,172.217.194.0-255,1484,122964,92,264994
29430,0.010432,172.217.194.0-255,4320,127284,92,264994
29431,0.010439,172.31.47.0-255,66,127350,92,264994
29432,0.012574,172.217.194.0-255,5738,133088,92,264994
29433,0.012581,172.31.47.0-255,66,133154,92,264994
29434,0.014662,172.217.194.0-255,5738,138892,92,264994
29435,0.014671,172.31.47.0-255,66,138958,92,264994
29436,0.016764,172.217.194.0-255,4320,143278,92,264994
29437,0.01677,172.31.47.0-255,66,143344,92,264994
29438,0.016793,172.217.194.0-255,1484,144828,92,264994
29439,0.018886,172.217.194.0-255,4320,149148,92,264994
29440,0.018893,172.31.47.0-255,66,149214,92,264994
29441,0.020976,172.217.194.0-255,4320,153534,92,264994
29442,0.020982,172.31.47.0-255,66,153600,92,264994
29443,0.021015,172.217.194.0-255,1484,155084,92,264994
29444,0.023121,172.217.194.0-255,4320,159404,92,264994
29445,0.023132,172.31.47.0-255,66,159470,92,264994
29446,0.025229,172.217.194.0-255,5738,165208,92,264994
29447,0.025235,172.31.47.0-255,66,165274,92,264994
29448,0.027329,172.217.194.0-255,5738,171012,92,264994
29449,0.027334,172.31.47.0-255,66,171078,92,264994
29450,0.029431,172.217.194.0-255,5738,176816,92,264994
29451,0.029438,172.31.47.0-255,66,176882,92,264994
29452,0.031543,172.217.194.0-255,5738,182620,92,264994
29453,0.031549,172.31.47.0-255,66,182686,92,264994
29454,0.03333,172.31.47.0-255,172,182858,92,264994
29455,0.033358,172.31.47.0-255,1112,183970,92,264994
29456,0.033393,172.31.47.0-255,1514,185484,92,264994
29457,0.033395,172.31.47.0-255,1514,186998,92,264994
29458,0.033396,172.31.47.0-255,1514,188512,92,264994
29459,0.033397,172.31.47.0-255,1514,190026,92,264994
29460,0.03342,172.31.47.0-255,1494,191520,92,264994
29461,0.033658,172.217.194.0-255,4320,195840,92,264994
29462,0.033663,172.31.47.0-255,66,195906,92,264994
29463,0.033699,172.217.194.0-255,1484,197390,92,264994
29464,0.03488,104.244.42.0-255,66,197456,92,264994
29465,0.034977,104.244.42.0-255,66,197522,92,264994
29466,0.034979,104.244.42.0-255,66,197588,92,264994
29467,0.035774,172.217.194.0-255,4320,201908,92,264994
29468,0.035778,172.31.47.0-255,66,201974,92,264994
29469,0.037889,172.217.194.0-255,5738,207712,92,264994
29470,0.037895,172.31.47.0-255,66,207778,92,264994
29471,0.040023,172.217.194.0-255,4320,212098,92,264994
29472,0.040028,172.31.47.0-255,66,212164,92,264994
29473,0.040065,172.217.194.0-255,1484,213648,92,264994
29474,0.042137,172.217.194.0-255,4320,217968,92,264994
29475,0.042142,172.31.47.0-255,66,218034,92,264994
29476,0.044247,172.217.194.0-255,5738,223772,92,264994
29477,0.044252,172.31.47.0-255,66,223838,92,264994
29478,0.046356,172.217.194.0-255,5738,229576,92,264994
29479,0.046361,172.31.47.0-255,66,229642,92,264994
29480,0.048502,172.217.194.0-255,5738,235380,92,264994
29481,0.048508,172.31.47.0-255,66,235446,92,264994
29482,0.050599,172.217.194.0-255,5738,241184,92,264994
29483,0.050604,172.31.47.0-255,66,241250,92,264994
29484,0.052679,172.217.194.0-255,2902,244152,92,264994
29485,0.052684,172.31.47.0-255,66,244218,92,264994
29486,0.052712,172.217.194.0-255,2902,247120,92,264994
29487,0.052715,172.31.47.0-255,66,247186,92,264994
29488,0.054783,172.217.194.0-255,2902,250088,92,264994
29489,0.054787,172.31.47.0-255,66,250154,92,264994
29490,0.054817,172.217.194.0-255,2902,253056,92,264994
29491,0.05482,172.31.47.0-255,66,253122,92,264994
29492,0.056874,172.217.194.0-255,2902,256024,92,264994
29493,0.056879,172.31.47.0-255,66,256090,92,264994
29494,0.05692,172.217.194.0-255,2902,258992,92,264994
29495,0.056923,172.31.47.0-255,66,259058,92,264994
29496,0.058999,172.217.194.0-255,2902,261960,92,264994
29497,0.059003,172.31.47.0-255,66,262026,92,264994
29498,0.059031,172.217.194.0-255,2902,264928,92,264994
29499,0.059034,172.31.47.0-255,66,264994,92,264994
29500,0.0,172.217.194.0-255,153,153,92,147730
29501,1.3e-05,172.31.47.0-255,66,219,92,147730
29502,1.9e-05,172.217.194.0-255,1484,1703,92,147730
29503,2.4e-05,172.31.47.0-255,66,1769,92,147730
29504,3.6e-05,172.217.194.0-255,2902,4671,92,147730
29505,3.9e-05,172.31.47.0-255,66,4737,92,147730
29506,4.4e-05,172.217.194.0-255,2902,7639,92,147730
29507,4.7e-05,172.31.47.0-255,66,7705,92,147730
29508,7.1e-05,172.217.194.0-255,4320,12025,92,147730
29509,7.3e-05,172.31.47.0-255,66,12091,92,147730
29510,0.0001,172.217.194.0-255,2102,14193,92,147730
29511,0.000102,172.31.47.0-255,66,14259,92,147730
29512,0.000123,172.217.194.0-255,2902,17161,92,147730
29513,0.000125,172.31.47.0-255,66,17227,92,147730
29514,0.000151,172.217.194.0-255,4320,21547,92,147730
29515,0.000153,172.31.47.0-255,66,21613,92,147730
29516,0.000156,172.217.194.0-255,1484,23097,92,147730
29517,0.000158,172.31.47.0-255,66,23163,92,147730
29518,0.00019,172.217.194.0-255,7156,30319,92,147730
29519,0.000193,172.31.47.0-255,66,30385,92,147730
29520,0.000198,172.217.194.0-255,5379,35764,92,147730
29521,0.0002,172.31.47.0-255,66,35830,92,147730
29522,0.000206,172.217.194.0-255,5738,41568,92,147730
29523,0.000208,172.31.47.0-255,66,41634,92,147730
29524,0.00024,172.217.194.0-255,6797,48431,92,147730
29525,0.000242,172.31.47.0-255,66,48497,92,147730
29526,0.000598,172.217.194.0-255,1484,49981,92,147730
29527,0.000603,172.31.47.0-255,66,50047,92,147730
29528,0.000609,172.217.194.0-255,2902,52949,92,147730
29529,0.000611,172.31.47.0-255,66,53015,92,147730
29530,0.000617,172.217.194.0-255,5738,58753,92,147730
29531,0.000637,172.31.47.0-255,66,58819,92,147730
29532,0.000644,172.217.194.0-255,6797,65616,92,147730
29533,0.000646,172.31.47.0-255,66,65682,92,147730
29534,0.001018,172.217.194.0-255,1484,67166,92,147730
29535,0.001027,172.217.194.0-255,2902,70068,92,147730
29536,0.001031,172.31.47.0-255,66,70134,92,147730
29537,0.001067,172.217.194.0-255,5738,75872,92,147730
29538,0.001069,172.31.47.0-255,66,75938,92,147730
29539,0.001074,172.217.194.0-255,2902,78840,92,147730
29540,0.001076,172.31.47.0-255,66,78906,92,147730
29541,0.001116,172.31.47.0-255,66,78972,92,147730
29542,0.001129,172.31.47.0-255,66,79038,92,147730
29543,0.001146,172.31.47.0-255,66,79104,92,147730
29544,0.001154,172.217.194.0-255,7156,86260,92,147730
29545,0.001156,172.31.47.0-255,66,86326,92,147730
29546,0.001185,172.217.194.0-255,4320,90646,92,147730
29547,0.001189,172.31.47.0-255,66,90712,92,147730
29548,0.001202,172.31.47.0-255,66,90778,92,147730
29549,0.001213,172.31.47.0-255,66,90844,92,147730
29550,0.001282,172.31.47.0-255,66,90910,92,147730
29551,0.001309,172.31.47.0-255,66,90976,92,147730
29552,0.001312,172.217.194.0-255,766,91742,92,147730
29553,0.001338,172.217.194.0-255,5738,97480,92,147730
29554,0.00134,172.31.47.0-255,66,97546,92,147730
29555,0.001376,172.31.47.0-255,66,97612,92,147730
29556,0.001391,172.31.47.0-255,66,97678,92,147730
29557,0.001416,172.217.194.0-255,3602,101280,92,147730
29558,0.001419,172.31.47.0-255,66,101346,92,147730
29559,0.001645,172.217.194.0-255,1484,102830,92,147730
29560,0.001652,172.217.194.0-255,2902,105732,92,147730
29561,0.001656,172.31.47.0-255,66,105798,92,147730
29562,0.001686,172.217.194.0-255,5738,111536,92,147730
29563,0.00169,172.31.47.0-255,66,111602,92,147730
29564,0.001693,172.217.194.0-255,1484,113086,92,147730
29565,0.001736,172.31.47.0-255,66,113152,92,147730
29566,0.001753,172.31.47.0-255,66,113218,92,147730
29567,0.001876,172.217.194.0-255,1484,114702,92,147730
29568,0.001883,172.217.194.0-255,2902,117604,92,147730
29569,0.001887,172.31.47.0-255,66,117670,92,147730
29570,0.001919,172.217.194.0-255,5738,123408,92,147730
29571,0.001923,172.31.47.0-255,66,123474,92,147730
29572,0.001931,172.217.194.0-255,7156,130630,92,147730
29573,0.001933,172.31.47.0-255,66,130696,92,147730
29574,0.001981,172.217.194.0-255,1484,132180,92,147730
29575,0.002001,172.31.47.0-255,66,132246,92,147730
29576,0.002015,172.31.47.0-255,66,132312,92,147730
29577,0.002062,172.31.47.0-255,66,132378,92,147730
29578,0.0021,172.31.47.0-255,66,132444,92,147730
29579,0.002218,172.217.194.0-255,5738,138182,92,147730
29580,0.002294,172.217.194.0-255,105,138287,92,147730
29581,0.007503,172.31.47.0-255,66,138353,92,147730
29582,0.010163,172.31.47.0-255,105,138458,92,147730
29583,0.012485,172.217.194.0-255,66,138524,92,147730
29584,0.039103,172.31.47.0-255,172,138696,92,147730
29585,0.039131,172.31.47.0-255,1106,139802,92,147730
29586,0.039188,172.31.47.0-255,1514,141316,92,147730
29587,0.03919,172.31.47.0-255,1514,142830,92,147730
29588,0.039191,172.31.47.0-255,1514,144344,92,147730
29589,0.039192,172.31.47.0-255,1514,145858,92,147730
29590,0.039193,172.31.47.0-255,1500,147358,92,147730
29591,0.040697,104.244.42.0-255,66,147424,92,147730
29592,0.040705,104.244.42.0-255,66,147490,92,147730
29593,0.040823,104.244.42.0-255,66,147556,92,147730
29594,0.043536,104.244.42.0-255,108,147664,92,147730
29595,0.043547,172.31.47.0-255,66,147730,92,147730
29596,0.0,74.125.24.0-255,152,152,92,233712
29597,1.8e-05,172.31.47.0-255,66,218,92,233712
29598,3.6e-05,74.125.24.0-255,1484,1702,92,233712
29599,3.9e-05,172.31.47.0-255,66,1768,92,233712
29600,5.7e-05,74.125.24.0-255,2902,4670,92,233712
29601,6e-05,172.31.47.0-255,66,4736,92,233712
29602,6.2e-05,74.125.24.0-255,1484,6220,92,233712
29603,6.4e-05,172.31.47.0-255,66,6286,92,233712
29604,9.7e-05,74.125.24.0-255,5738,12024,92,233712
29605,9.9e-05,172.31.47.0-255,66,12090,92,233712
29606,0.000102,74.125.24.0-255,2103,14193,92,233712
29607,0.000105,172.31.47.0-255,66,14259,92,233712
29608,0.000124,74.125.24.0-255,2902,17161,92,233712
29609,0.000126,172.31.47.0-255,66,17227,92,233712
29610,0.000154,172.31.47.0-255,66,17293,92,233712
29611,0.000161,74.125.24.0-255,7156,24449,92,233712
29612,0.000163,172.31.47.0-255,66,24515,92,233712
29613,0.000205,74.125.24.0-255,7156,31671,92,233712
29614,0.000208,172.31.47.0-255,66,31737,92,233712
29615,0.000226,172.31.47.0-255,66,31803,92,233712
29616,0.000268,172.31.47.0-255,66,31869,92,233712
29617,0.000338,74.125.24.0-255,2883,34752,92,233712
29618,0.000342,172.31.47.0-255,66,34818,92,233712
29619,0.000416,74.125.24.0-255,1484,36302,92,233712
29620,0.000419,172.31.47.0-255,66,36368,92,233712
29621,0.000448,74.125.24.0-255,2902,39270,92,233712
29622,0.00045,172.31.47.0-255,66,39336,92,233712
29623,0.000456,74.125.24.0-255,5738,45074,92,233712
29624,0.000458,172.31.47.0-255,66,45140,92,233712
29625,0.00046,74.125.24.0-255,1484,46624,92,233712
29626,0.000494,74.125.24.0-255,7156,53780,92,233712
29627,0.000501,172.31.47.0-255,66,53846,92,233712
29628,0.000512,74.125.24.0-255,2543,56389,92,233712
29629,0.000515,74.125.24.0-255,4320,60709,92,233712
29630,0.000516,172.31.47.0-255,66,60775,92,233712
29631,0.000529,172.31.47.0-255,66,60841,92,233712
29632,0.000558,172.31.47.0-255,66,60907,92,233712
29633,0.000581,74.125.24.0-255,5738,66645,92,233712
29634,0.00059,74.125.24.0-255,466,67111,92,233712
29635,0.00059,172.31.47.0-255,66,67177,92,233712
29636,0.000595,172.31.47.0-255,66,67243,92,233712
29637,0.000622,74.125.24.0-255,1484,68727,92,233712
29638,0.000626,74.125.24.0-255,2902,71629,92,233712
29639,0.000635,172.31.47.0-255,66,71695,92,233712
29640,0.000643,74.125.24.0-255,1484,73179,92,233712
29641,0.000649,74.125.24.0-255,5738,78917,92,233712
29642,0.000659,172.31.47.0-255,66,78983,92,233712
29643,0.000668,74.125.24.0-255,4320,83303,92,233712
29644,0.000672,172.31.47.0-255,66,83369,92,233712
29645,0.000698,74.125.24.0-255,2902,86271,92,233712
29646,0.000701,172.31.47.0-255,66,86337,92,233712
29647,0.000717,74.125.24.0-255,3602,89939,92,233712
29648,0.00072,172.31.47.0-255,66,90005,92,233712
29649,0.00075,74.125.24.0-255,1484,91489,92,233712
29650,0.000769,74.125.24.0-255,4320,95809,92,233712
29651,0.000779,172.31.47.0-255,66,95875,92,233712
29652,0.000787,74.125.24.0-255,5738,101613,92,233712
29653,0.00079,172.31.47.0-255,66,101679,92,233712
29654,0.000797,74.125.24.0-255,1484,103163,92,233712
29655,0.000803,74.125.24.0-255,5738,108901,92,233712
29656,0.000815,172.31.47.0-255,66,108967,92,233712
29657,0.000841,74.125.24.0-255,6438,115405,92,233712
29658,0.000842,172.31.47.0-255,66,115471,92,233712
29659,0.000846,172.31.47.0-255,66,115537,92,233712
29660,0.000881,74.125.24.0-255,1484,117021,92,233712
29661,0.000901,74.125.24.0-255,2902,119923,92,233712
29662,0.000904,172.31.47.0-255,66,119989,92,233712
29663,0.000909,74.125.24.0-255,5738,125727,92,233712
29664,0.000915,172.31.47.0-255,66,125793,92,233712
29665,0.000922,74.125.24.0-255,4320,130113,92,233712
29666,0.000929,172.31.47.0-255,66,130179,92,233712
29667,0.000934,74.125.24.0-255,2902,133081,92,233712
29668,0.000938,74.125.24.0-255,2902,135983,92,233712
29669,0.00094,172.31.47.0-255,66,136049,92,233712
29670,0.000968,172.31.47.0-255,66,136115,92,233712
29671,0.001038,172.31.47.0-255,66,136181,92,233712
29672,0.001042,172.31.47.0-255,66,136247,92,233712
29673,0.001043,74.125.24.0-255,4320,140567,92,233712
29674,0.001053,172.31.47.0-255,66,140633,92,233712
29675,0.001081,74.125.24.0-255,4320,144953,92,233712
29676,0.001088,172.31.47.0-255,66,145019,92,233712
29677,0.001117,74.125.24.0-255,3961,148980,92,233712
29678,0.00112,172.31.47.0-255,66,149046,92,233712
29679,0.001121,74.125.24.0-255,4320,153366,92,233712
29680,0.001125,172.31.47.0-255,66,153432,92,233712
29681,0.001141,74.125.24.0-255,1484,154916,92,233712
29682,0.001173,172.31.47.0-255,66,154982,92,233712
29683,0.001175,74.125.24.0-255,4320,159302,92,233712
29684,0.001185,172.31.47.0-255,66,159368,92,233712
29685,0.001194,74.125.24.0-255,4320,163688,92,233712
29686,0.001197,172.31.47.0-255,66,163754,92,233712
29687,0.001205,74.125.24.0-255,2902,166656,92,233712
29688,0.001212,172.31.47.0-255,66,166722,92,233712
29689,0.001232,74.125.24.0-255,7156,173878,92,233712
29690,0.001235,74.125.24.0-255,766,174644,92,233712
29691,0.001246,172.31.47.0-255,66,174710,92,233712
29692,0.001411,74.125.24.0-255,1484,176194,92,233712
29693,0.001416,74.125.24.0-255,2902,179096,92,233712
29694,0.001419,172.31.47.0-255,66,179162,92,233712
29695,0.00144,74.125.24.0-255,5738,184900,92,233712
29696,0.00145,172.31.47.0-255,66,184966,92,233712
29697,0.001458,172.31.47.0-255,66,185032,92,233712
29698,0.001472,74.125.24.0-255,4320,189352,92,233712
29699,0.001476,74.125.24.0-255,4320,193672,92,233712
29700,0.001487,172.31.47.0-255,66,193738,92,233712
29701,0.001491,74.125.24.0-255,6438,200176,92,233712
29702,0.001498,172.31.47.0-255,66,200242,92,233712
29703,0.001545,74.125.24.0-255,1484,201726,92,233712
29704,0.001548,74.125.24.0-255,1484,203210,92,233712
29705,0.001563,172.31.47.0-255,66,203276,92,233712
29706,0.001563,74.125.24.0-255,1484,204760,92,233712
29707,0.001566,74.125.24.0-255,2902,207662,92,233712
29708,0.001575,172.31.47.0-255,66,207728,92,233712
29709,0.001577,74.125.24.0-255,2902,210630,92,233712
29710,0.001579,74.125.24.0-255,1484,212114,92,233712
29711,0.001579,172.31.47.0-255,66,212180,92,233712
29712,0.001602,74.125.24.0-255,7156,219336,92,233712
29713,0.001604,172.31.47.0-255,66,219402,92,233712
29714,0.00162,74.125.24.0-255,1484,220886,92,233712
29715,0.001656,172.31.47.0-255,66,220952,92,233712
29716,0.001666,74.125.24.0-255,1484,222436,92,233712
29717,0.001706,172.31.47.0-255,66,222502,92,233712
29718,0.001717,172.31.47.0-255,66,222568,92,233712
29719,0.001783,172.31.47.0-255,66,222634,92,233712
29720,0.001804,74.125.24.0-255,1638,224272,92,233712
29721,0.001806,172.31.47.0-255,66,224338,92,233712
29722,0.001806,74.125.24.0-255,105,224443,92,233712
29723,0.001818,172.31.47.0-255,66,224509,92,233712
29724,0.003169,172.31.47.0-255,105,224614,92,233712
29725,0.005483,74.125.24.0-255,66,224680,92,233712
29726,0.0313,172.31.47.0-255,172,224852,92,233712
29727,0.031333,172.31.47.0-255,1107,225959,92,233712
29728,0.031363,172.31.47.0-255,1514,227473,92,233712
29729,0.031364,172.31.47.0-255,1514,228987,92,233712
29730,0.031365,172.31.47.0-255,1514,230501,92,233712
29731,0.031366,172.31.47.0-255,1514,232015,92,233712
29732,0.031388,172.31.47.0-255,1499,233514,92,233712
29733,0.032834,104.244.42.0-255,66,233580,92,233712
29734,0.032916,104.244.42.0-255,66,233646,92,233712
29735,0.032954,104.244.42.0-255,66,233712,92,233712
29736,0.0,74.125.24.0-255,153,153,92,308806
29737,2.3e-05,172.31.47.0-255,66,219,92,308806
29738,2.9e-05,74.125.24.0-255,1484,1703,92,308806
29739,3.3e-05,172.31.47.0-255,66,1769,92,308806
29740,6.9e-05,74.125.24.0-255,2902,4671,92,308806
29741,7.3e-05,74.125.24.0-255,2902,7573,92,308806
29742,7.4e-05,172.31.47.0-255,66,7639,92,308806
29743,7.7e-05,172.31.47.0-255,66,7705,92,308806
29744,8.2e-05,74.125.24.0-255,1484,9189,92,308806
29745,8.4e-05,172.31.47.0-255,66,9255,92,308806
29746,0.000102,74.125.24.0-255,6388,15643,92,308806
29747,0.000105,172.31.47.0-255,66,15709,92,308806
29748,0.000113,74.125.24.0-255,4320,20029,92,308806
29749,0.000117,172.31.47.0-255,66,20095,92,308806
29750,0.000157,172.31.47.0-255,66,20161,92,308806
29751,0.000169,74.125.24.0-255,2543,22704,92,308806
29752,0.000171,172.31.47.0-255,66,22770,92,308806
29753,0.000223,74.125.24.0-255,1484,24254,92,308806
29754,0.000225,172.31.47.0-255,66,24320,92,308806
29755,0.000238,74.125.24.0-255,2902,27222,92,308806
29756,0.000246,172.31.47.0-255,66,27288,92,308806
29757,0.000252,74.125.24.0-255,5738,33026,92,308806
29758,0.000254,172.31.47.0-255,66,33092,92,308806
29759,0.000259,74.125.24.0-255,4320,37412,92,308806
29760,0.000261,172.31.47.0-255,66,37478,92,308806
29761,0.000303,74.125.24.0-255,5738,43216,92,308806
29762,0.000307,172.31.47.0-255,66,43282,92,308806
29763,0.000341,74.125.24.0-255,6797,50079,92,308806
29764,0.000345,172.31.47.0-255,66,50145,92,308806
29765,0.000353,74.125.24.0-255,7070,57215,92,308806
29766,0.000355,172.31.47.0-255,66,57281,92,308806
29767,0.000557,74.125.24.0-255,138,57419,92,308806
29768,0.000561,74.125.24.0-255,343,57762,92,308806
29769,0.000801,172.31.47.0-255,66,57828,92,308806
29770,0.001013,74.125.24.0-255,1484,59312,92,308806
29771,0.001021,74.125.24.0-255,1484,60796,92,308806
29772,0.001025,172.31.47.0-255,66,60862,92,308806
29773,0.001054,74.125.24.0-255,1484,62346,92,308806
29774,0.001059,74.125.24.0-255,2902,65248,92,308806
29775,0.001061,172.31.47.0-255,66,65314,92,308806
29776,0.001067,74.125.24.0-255,4320,69634,92,308806
29777,0.001069,172.31.47.0-255,66,69700,92,308806
29778,0.001085,172.31.47.0-255,66,69766,92,308806
29779,0.001141,172.31.47.0-255,66,69832,92,308806
29780,0.00133,74.125.24.0-255,1484,71316,92,308806
29781,0.001335,74.125.24.0-255,1484,72800,92,308806
29782,0.001339,172.31.47.0-255,66,72866,92,308806
29783,0.001366,74.125.24.0-255,1484,74350,92,308806
29784,0.001373,74.125.24.0-255,5738,80088,92,308806
29785,0.001375,172.31.47.0-255,66,80154,92,308806
29786,0.001382,74.125.24.0-255,7156,87310,92,308806
29787,0.001384,172.31.47.0-255,66,87376,92,308806
29788,0.001403,74.125.24.0-255,5738,93114,92,308806
29789,0.001409,172.31.47.0-255,66,93180,92,308806
29790,0.001426,74.125.24.0-255,4320,97500,92,308806
29791,0.001429,172.31.47.0-255,66,97566,92,308806
29792,0.001457,74.125.24.0-255,6438,104004,92,308806
29793,0.001459,172.31.47.0-255,66,104070,92,308806
29794,0.00147,172.31.47.0-255,66,104136,92,308806
29795,0.00148,74.125.24.0-255,7156,111292,92,308806
29796,0.001483,172.31.47.0-255,66,111358,92,308806
29797,0.001561,172.31.47.0-255,66,111424,92,308806
29798,0.001633,74.125.24.0-255,1484,112908,92,308806
29799,0.001642,74.125.24.0-255,2902,115810,92,308806
29800,0.001644,172.31.47.0-255,66,115876,92,308806
29801,0.001663,74.125.24.0-255,5738,121614,92,308806
29802,0.001665,172.31.47.0-255,66,121680,92,308806
29803,0.001701,172.31.47.0-255,66,121746,92,308806
29804,0.001705,74.125.24.0-255,2902,124648,92,308806
29805,0.001706,172.31.47.0-255,66,124714,92,308806
29806,0.001748,74.125.24.0-255,2902,127616,92,308806
29807,0.001768,74.125.24.0-255,5020,132636,92,308806
29808,0.002134,74.125.24.0-255,1484,134120,92,308806
29809,0.002151,74.125.24.0-255,2902,137022,92,308806
29810,0.002154,74.125.24.0-255,1484,138506,92,308806
29811,0.00217,74.125.24.0-255,4320,142826,92,308806
29812,0.002175,74.125.24.0-255,4320,147146,92,308806
29813,0.002214,74.125.24.0-255,5738,152884,92,308806
29814,0.002267,74.125.24.0-255,1484,154368,92,308806
29815,0.002725,172.31.47.0-255,66,154434,92,308806
29816,0.004954,74.125.24.0-255,5738,160172,92,308806
29817,0.00496,172.31.47.0-255,66,160238,92,308806
29818,0.007176,74.125.24.0-255,5738,165976,92,308806
29819,0.007181,172.31.47.0-255,66,166042,92,308806
29820,0.009404,74.125.24.0-255,5738,171780,92,308806
29821,0.009415,172.31.47.0-255,66,171846,92,308806
29822,0.011645,74.125.24.0-255,5738,177584,92,308806
29823,0.011663,172.31.47.0-255,66,177650,92,308806
29824,0.013901,74.125.24.0-255,5738,183388,92,308806
29825,0.01392,172.31.47.0-255,66,183454,92,308806
29826,0.016149,74.125.24.0-255,5738,189192,92,308806
29827,0.016165,172.31.47.0-255,66,189258,92,308806
29828,0.018377,74.125.24.0-255,5738,194996,92,308806
29829,0.018384,172.31.47.0-255,66,195062,92,308806
29830,0.020631,74.125.24.0-255,5738,200800,92,308806
29831,0.020638,172.31.47.0-255,66,200866,92,308806
29832,0.022849,74.125.24.0-255,5738,206604,92,308806
29833,0.022854,172.31.47.0-255,66,206670,92,308806
29834,0.025073,74.125.24.0-255,5738,212408,92,308806
29835,0.025082,172.31.47.0-255,66,212474,92,308806
29836,0.02729,74.125.24.0-255,5738,218212,92,308806
29837,0.027299,172.31.47.0-255,66,218278,92,308806
29838,0.029501,74.125.24.0-255,5738,224016,92,308806
29839,0.029507,172.31.47.0-255,66,224082,92,308806
29840,0.031719,74.125.24.0-255,5738,229820,92,308806
29841,0.031726,172.31.47.0-255,66,229886,92,308806
29842,0.033922,74.125.24.0-255,5738,235624,92,308806
29843,0.033929,172.31.47.0-255,66,235690,92,308806
29844,0.036211,74.125.24.0-255,5738,241428,92,308806
29845,0.03622,172.31.47.0-255,66,241494,92,308806
29846,0.038436,74.125.24.0-255,5738,247232,92,308806
29847,0.038443,172.31.47.0-255,66,247298,92,308806
29848,0.040647,74.125.24.0-255,5738,253036,92,308806
29849,0.040659,172.31.47.0-255,66,253102,92,308806
29850,0.042889,74.125.24.0-255,5738,258840,92,308806
29851,0.042897,172.31.47.0-255,66,258906,92,308806
29852,0.04482,172.31.47.0-255,172,259078,92,308806
29853,0.044879,172.31.47.0-255,1103,260181,92,308806
29854,0.044957,172.31.47.0-255,1514,261695,92,308806
29855,0.044959,172.31.47.0-255,1514,263209,92,308806
29856,0.044964,172.31.47.0-255,1514,264723,92,308806
29857,0.044965,172.31.47.0-255,1514,266237,92,308806
29858,0.044995,172.31.47.0-255,1503,267740,92,308806
29859,0.045104,74.125.24.0-255,5738,273478,92,308806
29860,0.04511,172.31.47.0-255,66,273544,92,308806
29861,0.046361,104.244.42.0-255,66,273610,92,308806
29862,0.046456,104.244.42.0-255,66,273676,92,308806
29863,0.046507,104.244.42.0-255,66,273742,92,308806
29864,0.046559,104.244.42.0-255,66,273808,92,308806
29865,0.047263,104.244.42.0-255,108,273916,92,308806
29866,0.047271,172.31.47.0-255,66,273982,92,308806
29867,0.047314,74.125.24.0-255,5738,279720,92,308806
29868,0.047321,172.31.47.0-255,66,279786,92,308806
29869,0.049561,74.125.24.0-255,5738,285524,92,308806
29870,0.04958,172.31.47.0-255,66,285590,92,308806
29871,0.051821,74.125.24.0-255,5738,291328,92,308806
29872,0.051837,172.31.47.0-255,66,291394,92,308806
29873,0.054101,74.125.24.0-255,5738,297132,92,308806
29874,0.05412,172.31.47.0-255,66,297198,92,308806
29875,0.056318,74.125.24.0-255,5738,302936,92,308806
29876,0.056329,172.31.47.0-255,66,303002,92,308806
29877,0.058534,74.125.24.0-255,5738,308740,92,308806
29878,0.058538,172.31.47.0-255,66,308806,92,308806
29879,0.0,74.125.68.0-255,66,66,92,132
29880,0.033929,172.31.47.0-255,66,132,92,132
29881,0.0,172.217.194.0-255,153,153,92,207329
29882,2.9e-05,172.31.47.0-255,66,219,92,207329
29883,3.6e-05,172.217.194.0-255,1484,1703,92,207329
29884,3.9e-05,172.31.47.0-255,66,1769,92,207329
29885,4.4e-05,172.217.194.0-255,2902,4671,92,207329
29886,4.6e-05,172.31.47.0-255,66,4737,92,207329
29887,5.2e-05,172.217.194.0-255,7156,11893,92,207329
29888,5.5e-05,172.31.47.0-255,66,11959,92,207329
29889,8.4e-05,172.217.194.0-255,4320,16279,92,207329
29890,8.7e-05,172.31.47.0-255,66,16345,92,207329
29891,0.000115,172.31.47.0-255,66,16411,92,207329
29892,0.000149,172.217.194.0-255,6797,23208,92,207329
29893,0.000154,172.31.47.0-255,66,23274,92,207329
29894,0.000159,172.217.194.0-255,7156,30430,92,207329
29895,0.000161,172.31.47.0-255,66,30496,92,207329
29896,0.00018,172.217.194.0-255,2902,33398,92,207329
29897,0.000182,172.31.47.0-255,66,33464,92,207329
29898,0.000198,172.217.194.0-255,2543,36007,92,207329
29899,0.0002,172.31.47.0-255,66,36073,92,207329
29900,0.000205,172.217.194.0-255,4320,40393,92,207329
29901,0.000207,172.31.47.0-255,66,40459,92,207329
29902,0.000216,172.217.194.0-255,1484,41943,92,207329
29903,0.000217,172.31.47.0-255,66,42009,92,207329
29904,0.000234,172.217.194.0-255,5738,47747,92,207329
29905,0.000236,172.31.47.0-255,66,47813,92,207329
29906,0.000258,172.217.194.0-255,5691,53504,92,207329
29907,0.00026,172.31.47.0-255,66,53570,92,207329
29908,0.00029,172.217.194.0-255,98,53668,92,207329
29909,0.000293,172.31.47.0-255,66,53734,92,207329
29910,0.000325,172.217.194.0-255,364,54098,92,207329
29911,0.000328,172.31.47.0-255,66,54164,92,207329
29912,0.000458,172.217.194.0-255,1484,55648,92,207329
29913,0.000462,172.217.194.0-255,1484,57132,92,207329
29914,0.000467,172.31.47.0-255,66,57198,92,207329
29915,0.00048,172.217.194.0-255,1484,58682,92,207329
29916,0.000486,172.217.194.0-255,5738,64420,92,207329
29917,0.000488,172.217.194.0-255,1484,65904,92,207329
29918,0.000489,172.31.47.0-255,66,65970,92,207329
29919,0.000505,172.217.194.0-255,4320,70290,92,207329
29920,0.000508,172.31.47.0-255,66,70356,92,207329
29921,0.000512,172.217.194.0-255,2902,73258,92,207329
29922,0.000514,172.31.47.0-255,66,73324,92,207329
29923,0.000528,172.217.194.0-255,5738,79062,92,207329
29924,0.00053,172.31.47.0-255,66,79128,92,207329
29925,0.000547,172.217.194.0-255,4320,83448,92,207329
29926,0.000549,172.31.47.0-255,66,83514,92,207329
29927,0.000552,172.217.194.0-255,1484,84998,92,207329
29928,0.000571,172.217.194.0-255,3602,88600,92,207329
29929,0.000573,172.31.47.0-255,66,88666,92,207329
29930,0.000599,172.217.194.0-255,1484,90150,92,207329
29931,0.000611,172.217.194.0-255,2902,93052,92,207329
29932,0.000613,172.31.47.0-255,66,93118,92,207329
29933,0.000627,172.217.194.0-255,5738,98856,92,207329
29934,0.00063,172.31.47.0-255,66,98922,92,207329
29935,0.000663,172.31.47.0-255,66,98988,92,207329
29936,0.000677,172.217.194.0-255,1484,100472,92,207329
29937,0.000695,172.217.194.0-255,4320,104792,92,207329
29938,0.000698,172.31.47.0-255,66,104858,92,207329
29939,0.000724,172.31.47.0-255,66,104924,92,207329
29940,0.000764,172.31.47.0-255,66,104990,92,207329
29941,0.000783,172.217.194.0-255,1484,106474,92,207329
29942,0.000795,172.31.47.0-255,66,106540,92,207329
29943,0.000814,172.217.194.0-255,1484,108024,92,207329
29944,0.000818,172.217.194.0-255,2902,110926,92,207329
29945,0.00082,172.31.47.0-255,66,110992,92,207329
29946,0.000837,172.217.194.0-255,3602,114594,92,207329
29947,0.00084,172.31.47.0-255,66,114660,92,207329
29948,0.000844,172.217.194.0-255,2902,117562,92,207329
29949,0.000847,172.31.47.0-255,66,117628,92,207329
29950,0.000867,172.217.194.0-255,4320,121948,92,207329
29951,0.000869,172.31.47.0-255,66,122014,92,207329
29952,0.000909,172.217.194.0-255,4320,126334,92,207329
29953,0.000913,172.31.47.0-255,66,126400,92,207329
29954,0.000943,172.31.47.0-255,66,126466,92,207329
29955,0.000956,172.31.47.0-255,66,126532,92,207329
29956,0.000969,172.217.194.0-255,1125,127657,92,207329
29957,0.00152,172.217.194.0-255,1484,129141,92,207329
29958,0.001525,172.31.47.0-255,66,129207,92,207329
29959,0.001529,172.217.194.0-255,2902,132109,92,207329
29960,0.001531,172.31.47.0-255,66,132175,92,207329
29961,0.001568,172.217.194.0-255,4320,136495,92,207329
29962,0.001571,172.31.47.0-255,66,136561,92,207329
29963,0.001584,172.217.194.0-255,1484,138045,92,207329
29964,0.001595,172.31.47.0-255,66,138111,92,207329
29965,0.001615,172.31.47.0-255,66,138177,92,207329
29966,0.001631,172.217.194.0-255,2184,140361,92,207329
29967,0.001634,172.31.47.0-255,66,140427,92,207329
29968,0.001814,172.217.194.0-255,1484,141911,92,207329
29969,0.00182,172.217.194.0-255,2902,144813,92,207329
29970,0.001822,172.31.47.0-255,66,144879,92,207329
29971,0.001829,172.217.194.0-255,5738,150617,92,207329
29972,0.001831,172.31.47.0-255,66,150683,92,207329
29973,0.001853,172.217.194.0-255,5738,156421,92,207329
29974,0.001856,172.31.47.0-255,66,156487,92,207329
29975,0.001881,172.217.194.0-255,7156,163643,92,207329
29976,0.001884,172.31.47.0-255,66,163709,92,207329
29977,0.001892,172.217.194.0-255,7156,170865,92,207329
29978,0.001894,172.31.47.0-255,66,170931,92,207329
29979,0.001915,172.217.194.0-255,2902,173833,92,207329
29980,0.001918,172.31.47.0-255,66,173899,92,207329
29981,0.001938,172.31.47.0-255,66,173965,92,207329
29982,0.001974,172.31.47.0-255,66,174031,92,207329
29983,0.002025,172.217.194.0-255,5738,179769,92,207329
29984,0.002029,172.31.47.0-255,66,179835,92,207329
29985,0.002049,172.217.194.0-255,3602,183437,92,207329
29986,0.002052,172.31.47.0-255,66,183503,92,207329
29987,0.002056,172.217.194.0-255,2902,186405,92,207329
29988,0.002058,172.31.47.0-255,66,186471,92,207329
29989,0.002088,172.31.47.0-255,66,186537,92,207329
29990,0.002111,172.31.47.0-255,66,186603,92,207329
29991,0.002156,172.217.194.0-255,1484,188087,92,207329
29992,0.002178,172.31.47.0-255,66,188153,92,207329
29993,0.002218,172.31.47.0-255,66,188219,92,207329
29994,0.002297,172.217.194.0-255,5020,193239,92,207329
29995,0.0023,172.31.47.0-255,66,193305,92,207329
29996,0.00233,172.31.47.0-255,66,193371,92,207329
29997,0.002394,172.31.47.0-255,66,193437,92,207329
29998,0.00241,172.31.47.0-255,66,193503,92,207329
29999,0.002484,172.217.194.0-255,4320,197823,92,207329
30000,0.002487,172.31.47.0-255,66,197889,92,207329
30001,0.002512,172.31.47.0-255,66,197955,92,207329
30002,0.002514,172.217.194.0-255,105,198060,92,207329
30003,0.003365,172.31.47.0-255,66,198126,92,207329
30004,0.003388,172.31.47.0-255,105,198231,92,207329
30005,0.005937,172.217.194.0-255,66,198297,92,207329
30006,0.028969,172.31.47.0-255,172,198469,92,207329
30007,0.028993,172.31.47.0-255,1107,199576,92,207329
30008,0.029051,172.31.47.0-255,1514,201090,92,207329
30009,0.029052,172.31.47.0-255,1514,202604,92,207329
30010,0.029053,172.31.47.0-255,1514,204118,92,207329
30011,0.029054,172.31.47.0-255,1514,205632,92,207329
30012,0.029055,172.31.47.0-255,1499,207131,92,207329
30013,0.030482,104.244.42.0-255,66,207197,92,207329
30014,0.030526,104.244.42.0-255,66,207263,92,207329
30015,0.030638,104.244.42.0-255,66,207329,92,207329
30016,0.0,172.253.118.0-255,153,153,92,316467
30017,1.7e-05,172.31.47.0-255,66,219,92,316467
30018,2.4e-05,172.253.118.0-255,1484,1703,92,316467
30019,2.9e-05,172.31.47.0-255,66,1769,92,316467
30020,3.5e-05,172.253.118.0-255,2902,4671,92,316467
30021,4.5e-05,172.31.47.0-255,66,4737,92,316467
30022,5.3e-05,172.253.118.0-255,7156,11893,92,316467
30023,5.7e-05,172.31.47.0-255,66,11959,92,316467
30024,6.1e-05,172.253.118.0-255,2066,14025,92,316467
30025,6.3e-05,172.31.47.0-255,66,14091,92,316467
30026,7.1e-05,172.253.118.0-255,7156,21247,92,316467
30027,7.4e-05,172.31.47.0-255,66,21313,92,316467
30028,9.8e-05,172.253.118.0-255,4320,25633,92,316467
30029,0.000105,172.31.47.0-255,66,25699,92,316467
30030,0.000111,172.253.118.0-255,5379,31078,92,316467
30031,0.000114,172.31.47.0-255,66,31144,92,316467
30032,0.00017,172.253.118.0-255,1484,32628,92,316467
30033,0.000173,172.31.47.0-255,66,32694,92,316467
30034,0.000177,172.253.118.0-255,1484,34178,92,316467
30035,0.000179,172.31.47.0-255,66,34244,92,316467
30036,0.000211,172.253.118.0-255,1484,35728,92,316467
30037,0.000214,172.31.47.0-255,66,35794,92,316467
30038,0.000221,172.253.118.0-255,5738,41532,92,316467
30039,0.000224,172.31.47.0-255,66,41598,92,316467
30040,0.00025,172.253.118.0-255,6797,48395,92,316467
30041,0.000253,172.31.47.0-255,66,48461,92,316467
30042,0.000521,172.253.118.0-255,1484,49945,92,316467
30043,0.000527,172.31.47.0-255,66,50011,92,316467
30044,0.000534,172.253.118.0-255,2902,52913,92,316467
30045,0.000536,172.31.47.0-255,66,52979,92,316467
30046,0.000542,172.253.118.0-255,5738,58717,92,316467
30047,0.000551,172.31.47.0-255,66,58783,92,316467
30048,0.000595,172.31.47.0-255,66,58849,92,316467
30049,0.000618,172.253.118.0-255,7156,66005,92,316467
30050,0.000621,172.31.47.0-255,66,66071,92,316467
30051,0.000646,172.253.118.0-255,3122,69193,92,316467
30052,0.000648,172.31.47.0-255,66,69259,92,316467
30053,0.000743,172.253.118.0-255,1484,70743,92,316467
30054,0.000748,172.253.118.0-255,1484,72227,92,316467
30055,0.000751,172.31.47.0-255,66,72293,92,316467
30056,0.000777,172.253.118.0-255,1484,73777,92,316467
30057,0.000785,172.253.118.0-255,5738,79515,92,316467
30058,0.000788,172.31.47.0-255,66,79581,92,316467
30059,0.000796,172.253.118.0-255,7156,86737,92,316467
30060,0.000798,172.31.47.0-255,66,86803,92,316467
30061,0.000819,172.253.118.0-255,5738,92541,92,316467
30062,0.000822,172.31.47.0-255,66,92607,92,316467
30063,0.000833,172.253.118.0-255,7156,99763,92,316467
30064,0.000835,172.31.47.0-255,66,99829,92,316467
30065,0.000874,172.253.118.0-255,2939,102768,92,316467
30066,0.000879,172.31.47.0-255,66,102834,92,316467
30067,0.000944,172.253.118.0-255,1484,104318,92,316467
30068,0.000959,172.253.118.0-255,2902,107220,92,316467
30069,0.000962,172.31.47.0-255,66,107286,92,316467
30070,0.000967,172.253.118.0-255,2902,110188,92,316467
30071,0.00097,172.31.47.0-255,66,110254,92,316467
30072,0.001001,172.253.118.0-255,2902,113156,92,316467
30073,0.001003,172.31.47.0-255,66,113222,92,316467
30074,0.001022,172.31.47.0-255,66,113288,92,316467
30075,0.001027,172.253.118.0-255,4320,117608,92,316467
30076,0.00103,172.31.47.0-255,66,117674,92,316467
30077,0.001076,172.253.118.0-255,6438,124112,92,316467
30078,0.001079,172.31.47.0-255,66,124178,92,316467
30079,0.001087,172.253.118.0-255,7156,131334,92,316467
30080,0.001089,172.31.47.0-255,66,131400,92,316467
30081,0.00116,172.31.47.0-255,66,131466,92,316467
30082,0.001675,172.253.118.0-255,1484,132950,92,316467
30083,0.0017,172.253.118.0-255,2902,135852,92,316467
30084,0.001704,172.31.47.0-255,66,135918,92,316467
30085,0.001708,172.253.118.0-255,1484,137402,92,316467
30086,0.001732,172.253.118.0-255,4320,141722,92,316467
30087,0.001735,172.31.47.0-255,66,141788,92,316467
30088,0.001743,172.253.118.0-255,7156,148944,92,316467
30089,0.001745,172.31.47.0-255,66,149010,92,316467
30090,0.001782,172.31.47.0-255,66,149076,92,316467
30091,0.001812,172.253.118.0-255,3602,152678,92,316467
30092,0.001815,172.31.47.0-255,66,152744,92,316467
30093,0.00199,172.253.118.0-255,1484,154228,92,316467
30094,0.001997,172.253.118.0-255,2902,157130,92,316467
30095,0.002,172.31.47.0-255,66,157196,92,316467
30096,0.002007,172.253.118.0-255,5738,162934,92,316467
30097,0.002009,172.31.47.0-255,66,163000,92,316467
30098,0.002018,172.253.118.0-255,2902,165902,92,316467
30099,0.002021,172.31.47.0-255,66,165968,92,316467
30100,0.002065,172.31.47.0-255,66,166034,92,316467
30101,0.002069,172.253.118.0-255,1484,167518,92,316467
30102,0.002102,172.31.47.0-255,66,167584,92,316467
30103,0.004438,172.253.118.0-255,5738,173322,92,316467
30104,0.004445,172.31.47.0-255,66,173388,92,316467
30105,0.006781,172.253.118.0-255,5738,179126,92,316467
30106,0.006785,172.31.47.0-255,66,179192,92,316467
30107,0.009112,172.253.118.0-255,5738,184930,92,316467
30108,0.009118,172.31.47.0-255,66,184996,92,316467
30109,0.011432,172.253.118.0-255,5738,190734,92,316467
30110,0.01144,172.31.47.0-255,66,190800,92,316467
30111,0.013769,172.253.118.0-255,5738,196538,92,316467
30112,0.013777,172.31.47.0-255,66,196604,92,316467
30113,0.016101,172.253.118.0-255,5738,202342,92,316467
30114,0.016108,172.31.47.0-255,66,202408,92,316467
30115,0.018413,172.253.118.0-255,5738,208146,92,316467
30116,0.018423,172.31.47.0-255,66,208212,92,316467
30117,0.020755,172.253.118.0-255,5738,213950,92,316467
30118,0.020761,172.31.47.0-255,66,214016,92,316467
30119,0.023073,172.253.118.0-255,2902,216918,92,316467
30120,0.02308,172.31.47.0-255,66,216984,92,316467
30121,0.023107,172.253.118.0-255,2902,219886,92,316467
30122,0.023111,172.31.47.0-255,66,219952,92,316467
30123,0.025395,172.253.118.0-255,2902,222854,92,316467
30124,0.025402,172.31.47.0-255,66,222920,92,316467
30125,0.025436,172.253.118.0-255,2902,225822,92,316467
30126,0.025439,172.31.47.0-255,66,225888,92,316467
30127,0.027719,172.253.118.0-255,2902,228790,92,316467
30128,0.027729,172.31.47.0-255,66,228856,92,316467
30129,0.027761,172.253.118.0-255,2902,231758,92,316467
30130,0.027763,172.31.47.0-255,66,231824,92,316467
30131,0.029404,172.31.47.0-255,172,231996,92,316467
30132,0.029436,172.31.47.0-255,1107,233103,92,316467
30133,0.0295,172.31.47.0-255,1514,234617,92,316467
30134,0.029501,172.31.47.0-255,1514,236131,92,316467
30135,0.029503,172.31.47.0-255,1514,237645,92,316467
30136,0.029504,172.31.47.0-255,1514,239159,92,316467
30137,0.029505,172.31.47.0-255,536,239695,92,316467
30138,0.030058,172.253.118.0-255,2902,242597,92,316467
30139,0.030064,172.31.47.0-255,66,242663,92,316467
30140,0.030093,172.253.118.0-255,2902,245565,92,316467
30141,0.030096,172.31.47.0-255,66,245631,92,316467
30142,0.030939,104.244.42.0-255,66,245697,92,316467
30143,0.031032,104.244.42.0-255,66,245763,92,316467
30144,0.031126,104.244.42.0-255,66,245829,92,316467
30145,0.03113,104.244.42.0-255,66,245895,92,316467
30146,0.032397,172.253.118.0-255,2902,248797,92,316467
30147,0.032406,172.31.47.0-255,66,248863,92,316467
30148,0.032436,172.253.118.0-255,2902,251765,92,316467
30149,0.03244,172.31.47.0-255,66,251831,92,316467
30150,0.034739,172.253.118.0-255,2902,254733,92,316467
30151,0.034746,172.31.47.0-255,66,254799,92,316467
30152,0.034778,172.253.118.0-255,2902,257701,92,316467
30153,0.034782,172.31.47.0-255,66,257767,92,316467
30154,0.037067,172.253.118.0-255,2902,260669,92,316467
30155,0.037073,172.31.47.0-255,66,260735,92,316467
30156,0.037099,172.253.118.0-255,2902,263637,92,316467
30157,0.037102,172.31.47.0-255,66,263703,92,316467
30158,0.039391,172.253.118.0-255,2902,266605,92,316467
30159,0.039399,172.31.47.0-255,66,266671,92,316467
30160,0.039426,172.253.118.0-255,2902,269573,92,316467
30161,0.039429,172.31.47.0-255,66,269639,92,316467
30162,0.041718,172.253.118.0-255,2902,272541,92,316467
30163,0.041725,172.31.47.0-255,66,272607,92,316467
30164,0.041755,172.253.118.0-255,2902,275509,92,316467
30165,0.041758,172.31.47.0-255,66,275575,92,316467
30166,0.04406,172.253.118.0-255,2902,278477,92,316467
30167,0.044067,172.31.47.0-255,66,278543,92,316467
30168,0.044137,172.253.118.0-255,2902,281445,92,316467
30169,0.04414,172.31.47.0-255,66,281511,92,316467
30170,0.046389,172.253.118.0-255,2902,284413,92,316467
30171,0.046396,172.31.47.0-255,66,284479,92,316467
30172,0.046438,172.253.118.0-255,2902,287381,92,316467
30173,0.046441,172.31.47.0-255,66,287447,92,316467
30174,0.048735,172.253.118.0-255,5738,293185,92,316467
30175,0.048744,172.31.47.0-255,66,293251,92,316467
30176,0.051062,172.253.118.0-255,5738,298989,92,316467
30177,0.051069,172.31.47.0-255,66,299055,92,316467
30178,0.053397,172.253.118.0-255,5738,304793,92,316467
30179,0.053403,172.31.47.0-255,66,304859,92,316467
30180,0.055736,172.253.118.0-255,5738,310597,92,316467
30181,0.055741,172.31.47.0-255,66,310663,92,316467
30182,0.058079,172.253.118.0-255,5738,316401,92,316467
30183,0.058085,172.31.47.0-255,66,316467,92,316467
30184,0.0,172.31.47.0-255,105,105,92,276
30185,0.001754,157.240.7.0-255,105,210,92,276
30186,0.001766,172.31.47.0-255,66,276,92,276
30187,0.0,31.13.82.0-255,105,105,92,171
30188,1.5e-05,172.31.47.0-255,66,171,92,171
30189,0.0,74.125.200.0-255,298,298,92,362577
30190,2.4e-05,172.31.47.0-255,66,364,92,362577
30191,3e-05,74.125.200.0-255,1484,1848,92,362577
30192,3.4e-05,172.31.47.0-255,66,1914,92,362577
30193,3.8e-05,74.125.200.0-255,2902,4816,92,362577
30194,4e-05,172.31.47.0-255,66,4882,92,362577
30195,6.6e-05,74.125.200.0-255,5738,10620,92,362577
30196,6.8e-05,172.31.47.0-255,66,10686,92,362577
30197,8.5e-05,74.125.200.0-255,1484,12170,92,362577
30198,8.6e-05,172.31.47.0-255,66,12236,92,362577
30199,0.000112,172.31.47.0-255,66,12302,92,362577
30200,0.000128,74.125.200.0-255,5738,18040,92,362577
30201,0.00013,172.31.47.0-255,66,18106,92,362577
30202,0.000146,74.125.200.0-255,4320,22426,92,362577
30203,0.000148,172.31.47.0-255,66,22492,92,362577
30204,0.000151,74.125.200.0-255,1125,23617,92,362577
30205,0.000152,172.31.47.0-255,66,23683,92,362577
30206,0.000184,74.125.200.0-255,1484,25167,92,362577
30207,0.000187,172.31.47.0-255,66,25233,92,362577
30208,0.000199,74.125.200.0-255,2902,28135,92,362577
30209,0.000201,172.31.47.0-255,66,28201,92,362577
30210,0.000204,74.125.200.0-255,1484,29685,92,362577
30211,0.000205,172.31.47.0-255,66,29751,92,362577
30212,0.000231,74.125.200.0-255,4320,34071,92,362577
30213,0.000233,172.31.47.0-255,66,34137,92,362577
30214,0.000238,74.125.200.0-255,4320,38457,92,362577
30215,0.00024,172.31.47.0-255,66,38523,92,362577
30216,0.000273,74.125.200.0-255,2543,41066,92,362577
30217,0.000276,172.31.47.0-255,66,41132,92,362577
30218,0.000472,74.125.200.0-255,1484,42616,92,362577
30219,0.000477,172.31.47.0-255,66,42682,92,362577
30220,0.00048,74.125.200.0-255,1484,44166,92,362577
30221,0.000482,172.31.47.0-255,66,44232,92,362577
30222,0.000497,74.125.200.0-255,2902,47134,92,362577
30223,0.000499,172.31.47.0-255,66,47200,92,362577
30224,0.000502,74.125.200.0-255,1484,48684,92,362577
30225,0.000504,172.31.47.0-255,66,48750,92,362577
30226,0.000525,74.125.200.0-255,4320,53070,92,362577
30227,0.000528,172.31.47.0-255,66,53136,92,362577
30228,0.000532,74.125.200.0-255,2902,56038,92,362577
30229,0.000534,172.31.47.0-255,66,56104,92,362577
30230,0.000546,74.125.200.0-255,2543,58647,92,362577
30231,0.000548,172.31.47.0-255,66,58713,92,362577
30232,0.000633,74.125.200.0-255,1484,60197,92,362577
30233,0.000636,172.31.47.0-255,66,60263,92,362577
30234,0.00065,74.125.200.0-255,2902,63165,92,362577
30235,0.000652,172.31.47.0-255,66,63231,92,362577
30236,0.000676,74.125.200.0-255,5738,68969,92,362577
30237,0.000679,172.31.47.0-255,66,69035,92,362577
30238,0.000698,74.125.200.0-255,6797,75832,92,362577
30239,0.0007,172.31.47.0-255,66,75898,92,362577
30240,0.000703,74.125.200.0-255,1484,77382,92,362577
30241,0.000705,172.31.47.0-255,66,77448,92,362577
30242,0.000729,74.125.200.0-255,5738,83186,92,362577
30243,0.000732,172.31.47.0-255,66,83252,92,362577
30244,0.000734,74.125.200.0-255,1484,84736,92,362577
30245,0.000736,172.31.47.0-255,66,84802,92,362577
30246,0.000753,74.125.200.0-255,7156,91958,92,362577
30247,0.000755,172.31.47.0-255,66,92024,92,362577
30248,0.000766,74.125.200.0-255,2902,94926,92,362577
30249,0.000769,172.31.47.0-255,66,94992,92,362577
30250,0.000771,74.125.200.0-255,1484,96476,92,362577
30251,0.000792,172.31.47.0-255,66,96542,92,362577
30252,0.000796,74.125.200.0-255,2170,98712,92,362577
30253,0.0008,172.31.47.0-255,66,98778,92,362577
30254,0.000926,74.125.200.0-255,1484,100262,92,362577
30255,0.000939,74.125.200.0-255,2902,103164,92,362577
30256,0.000941,172.31.47.0-255,66,103230,92,362577
30257,0.000945,74.125.200.0-255,1484,104714,92,362577
30258,0.000962,74.125.200.0-255,4320,109034,92,362577
30259,0.000965,172.31.47.0-255,66,109100,92,362577
30260,0.000981,74.125.200.0-255,1484,110584,92,362577
30261,0.000992,74.125.200.0-255,2902,113486,92,362577
30262,0.000995,172.31.47.0-255,66,113552,92,362577
30263,0.001036,74.125.200.0-255,5738,119290,92,362577
30264,0.00104,172.31.47.0-255,66,119356,92,362577
30265,0.001064,74.125.200.0-255,2902,122258,92,362577
30266,0.001066,172.31.47.0-255,66,122324,92,362577
30267,0.001071,74.125.200.0-255,4320,126644,92,362577
30268,0.001074,172.31.47.0-255,66,126710,92,362577
30269,0.00108,74.125.200.0-255,6438,133148,92,362577
30270,0.001083,172.31.47.0-255,66,133214,92,362577
30271,0.001121,74.125.200.0-255,1484,134698,92,362577
30272,0.001126,74.125.200.0-255,2902,137600,92,362577
30273,0.001128,172.31.47.0-255,66,137666,92,362577
30274,0.001146,74.125.200.0-255,1484,139150,92,362577
30275,0.00115,74.125.200.0-255,2902,142052,92,362577
30276,0.001152,172.31.47.0-255,66,142118,92,362577
30277,0.001171,74.125.200.0-255,5738,147856,92,362577
30278,0.001175,172.31.47.0-255,66,147922,92,362577
30279,0.001199,74.125.200.0-255,1484,149406,92,362577
30280,0.001215,74.125.200.0-255,5738,155144,92,362577
30281,0.001219,172.31.47.0-255,66,155210,92,362577
30282,0.001238,74.125.200.0-255,5738,160948,92,362577
30283,0.001241,172.31.47.0-255,66,161014,92,362577
30284,0.001264,74.125.200.0-255,6438,167452,92,362577
30285,0.001266,172.31.47.0-255,66,167518,92,362577
30286,0.001525,74.125.200.0-255,1484,169002,92,362577
30287,0.001544,74.125.200.0-255,2902,171904,92,362577
30288,0.001548,172.31.47.0-255,66,171970,92,362577
30289,0.001552,74.125.200.0-255,1484,173454,92,362577
30290,0.001556,74.125.200.0-255,2902,176356,92,362577
30291,0.001558,172.31.47.0-255,66,176422,92,362577
30292,0.001584,74.125.200.0-255,5738,182160,92,362577
30293,0.001587,172.31.47.0-255,66,182226,92,362577
30294,0.001614,172.31.47.0-255,66,182292,92,362577
30295,0.001629,74.125.200.0-255,4320,186612,92,362577
30296,0.001632,172.31.47.0-255,66,186678,92,362577
30297,0.001668,74.125.200.0-255,6438,193116,92,362577
30298,0.001672,172.31.47.0-255,66,193182,92,362577
30299,0.001737,74.125.200.0-255,1484,194666,92,362577
30300,0.001756,74.125.200.0-255,1484,196150,92,362577
30301,0.00176,172.31.47.0-255,66,196216,92,362577
30302,0.001771,74.125.200.0-255,1484,197700,92,362577
30303,0.001788,74.125.200.0-255,1484,199184,92,362577
30304,0.001791,172.31.47.0-255,66,199250,92,362577
30305,0.001798,74.125.200.0-255,5738,204988,92,362577
30306,0.001801,172.31.47.0-255,66,205054,92,362577
30307,0.001804,74.125.200.0-255,2902,207956,92,362577
30308,0.001806,172.31.47.0-255,66,208022,92,362577
30309,0.00184,172.31.47.0-255,66,208088,92,362577
30310,0.001845,74.125.200.0-255,1484,209572,92,362577
30311,0.001866,74.125.200.0-255,5738,215310,92,362577
30312,0.001869,172.31.47.0-255,66,215376,92,362577
30313,0.001888,74.125.200.0-255,3602,218978,92,362577
30314,0.00189,172.31.47.0-255,66,219044,92,362577
30315,0.004155,74.125.200.0-255,1484,220528,92,362577
30316,0.004183,74.125.200.0-255,4320,224848,92,362577
30317,0.004188,172.31.47.0-255,66,224914,92,362577
30318,0.00649,74.125.200.0-255,5738,230652,92,362577
30319,0.006497,172.31.47.0-255,66,230718,92,362577
30320,0.0088,74.125.200.0-255,5738,236456,92,362577
30321,0.008806,172.31.47.0-255,66,236522,92,362577
30322,0.011151,74.125.200.0-255,5738,242260,92,362577
30323,0.011157,172.31.47.0-255,66,242326,92,362577
30324,0.013465,74.125.200.0-255,5738,248064,92,362577
30325,0.013472,172.31.47.0-255,66,248130,92,362577
30326,0.015787,74.125.200.0-255,5738,253868,92,362577
30327,0.015796,172.31.47.0-255,66,253934,92,362577
30328,0.018106,74.125.200.0-255,5738,259672,92,362577
30329,0.018114,172.31.47.0-255,66,259738,92,362577
30330,0.02041,74.125.200.0-255,5738,265476,92,362577
30331,0.020416,172.31.47.0-255,66,265542,92,362577
30332,0.02272,74.125.200.0-255,5738,271280,92,362577
30333,0.022726,172.31.47.0-255,66,271346,92,362577
30334,0.025024,74.125.200.0-255,5738,277084,92,362577
30335,0.025031,172.31.47.0-255,66,277150,92,362577
30336,0.027337,74.125.200.0-255,5738,282888,92,362577
30337,0.027345,172.31.47.0-255,66,282954,92,362577
30338,0.029683,74.125.200.0-255,5738,288692,92,362577
30339,0.029688,172.31.47.0-255,66,288758,92,362577
30340,0.030219,172.31.47.0-255,172,288930,92,362577
30341,0.030247,172.31.47.0-255,1111,290041,92,362577
30342,0.030271,172.31.47.0-255,570,290611,92,362577
30343,0.031775,104.244.42.0-255,66,290677,92,362577
30344,0.031801,104.244.42.0-255,66,290743,92,362577
30345,0.031803,104.244.42.0-255,66,290809,92,362577
30346,0.031993,74.125.200.0-255,1484,292293,92,362577
30347,0.032021,74.125.200.0-255,4320,296613,92,362577
30348,0.032025,172.31.47.0-255,66,296679,92,362577
30349,0.032583,104.244.42.0-255,108,296787,92,362577
30350,0.032587,172.31.47.0-255,66,296853,92,362577
30351,0.03432,74.125.200.0-255,4320,301173,92,362577
30352,0.034323,172.31.47.0-255,66,301239,92,362577
30353,0.034345,74.125.200.0-255,1484,302723,92,362577
30354,0.036611,74.125.200.0-255,2902,305625,92,362577
30355,0.036616,172.31.47.0-255,66,305691,92,362577
30356,0.036644,74.125.200.0-255,1484,307175,92,362577
30357,0.038908,74.125.200.0-255,4320,311495,92,362577
30358,0.038913,172.31.47.0-255,66,311561,92,362577
30359,0.041215,74.125.200.0-255,5738,317299,92,362577
30360,0.04122,172.31.47.0-255,66,317365,92,362577
30361,0.043523,74.125.200.0-255,4320,321685,92,362577
30362,0.043528,172.31.47.0-255,66,321751,92,362577
30363,0.043556,74.125.200.0-255,1484,323235,92,362577
30364,0.045839,74.125.200.0-255,4320,327555,92,362577
30365,0.045844,172.31.47.0-255,66,327621,92,362577
30366,0.04815,74.125.200.0-255,5738,333359,92,362577
30367,0.048156,172.31.47.0-255,66,333425,92,362577
30368,0.050461,74.125.200.0-255,5738,339163,92,362577
30369,0.050467,172.31.47.0-255,66,339229,92,362577
30370,0.052776,74.125.200.0-255,5738,344967,92,362577
30371,0.052781,172.31.47.0-255,66,345033,92,362577
30372,0.055079,74.125.200.0-255,5738,350771,92,362577
30373,0.055084,172.31.47.0-255,66,350837,92,362577
30374,0.05739,74.125.200.0-255,5738,356575,92,362577
30375,0.057395,172.31.47.0-255,66,356641,92,362577
30376,0.059701,74.125.200.0-255,2902,359543,92,362577
30377,0.059707,172.31.47.0-255,66,359609,92,362577
30378,0.059731,74.125.200.0-255,2902,362511,92,362577
30379,0.059734,172.31.47.0-255,66,362577,92,362577
30380,0.0,74.125.200.0-255,153,153,92,373215
30381,2.5e-05,172.31.47.0-255,66,219,92,373215
30382,3.1e-05,74.125.200.0-255,1484,1703,92,373215
30383,3.5e-05,172.31.47.0-255,66,1769,92,373215
30384,5.7e-05,74.125.200.0-255,1484,3253,92,373215
30385,5.8e-05,172.31.47.0-255,66,3319,92,373215
30386,7.9e-05,74.125.200.0-255,1484,4803,92,373215
30387,8.1e-05,172.31.47.0-255,66,4869,92,373215
30388,8.7e-05,74.125.200.0-255,5738,10607,92,373215
30389,9e-05,172.31.47.0-255,66,10673,92,373215
30390,0.000118,74.125.200.0-255,2902,13575,92,373215
30391,0.000121,172.31.47.0-255,66,13641,92,373215
30392,0.000131,74.125.200.0-255,623,14264,92,373215
30393,0.000137,172.31.47.0-255,66,14330,92,373215
30394,0.00021,74.125.200.0-255,1484,15814,92,373215
30395,0.000212,172.31.47.0-255,66,15880,92,373215
30396,0.000249,74.125.200.0-255,2902,18782,92,373215
30397,0.000253,172.31.47.0-255,66,18848,92,373215
30398,0.000277,74.125.200.0-255,4320,23168,92,373215
30399,0.000281,172.31.47.0-255,66,23234,92,373215
30400,0.000284,74.125.200.0-255,2902,26136,92,373215
30401,0.000286,172.31.47.0-255,66,26202,92,373215
30402,0.000313,74.125.200.0-255,4320,30522,92,373215
30403,0.000317,172.31.47.0-255,66,30588,92,373215
30404,0.000344,74.125.200.0-255,2543,33131,92,373215
30405,0.000347,172.31.47.0-255,66,33197,92,373215
30406,0.00035,74.125.200.0-255,2902,36099,92,373215
30407,0.000352,172.31.47.0-255,66,36165,92,373215
30408,0.000372,74.125.200.0-255,7156,43321,92,373215
30409,0.000375,172.31.47.0-255,66,43387,92,373215
30410,0.000404,172.31.47.0-255,66,43453,92,373215
30411,0.000436,74.125.200.0-255,1484,44937,92,373215
30412,0.00044,172.31.47.0-255,66,45003,92,373215
30413,0.000448,74.125.200.0-255,2184,47187,92,373215
30414,0.000453,172.31.47.0-255,66,47253,92,373215
30415,0.000466,74.125.200.0-255,396,47649,92,373215
30416,0.000515,74.125.200.0-255,347,47996,92,373215
30417,0.000691,172.31.47.0-255,66,48062,92,373215
30418,0.000806,74.125.200.0-255,1484,49546,92,373215
30419,0.000811,172.31.47.0-255,66,49612,92,373215
30420,0.000819,74.125.200.0-255,2902,52514,92,373215
30421,0.000838,74.125.200.0-255,2902,55416,92,373215
30422,0.000851,74.125.200.0-255,2902,58318,92,373215
30423,0.000855,74.125.200.0-255,2902,61220,92,373215
30424,0.000874,74.125.200.0-255,4320,65540,92,373215
30425,0.000899,74.125.200.0-255,5738,71278,92,373215
30426,0.000913,74.125.200.0-255,2902,74180,92,373215
30427,0.000956,74.125.200.0-255,2902,77082,92,373215
30428,0.000979,74.125.200.0-255,5738,82820,92,373215
30429,0.000983,74.125.200.0-255,2902,85722,92,373215
30430,0.000988,74.125.200.0-255,7156,92878,92,373215
30431,0.001012,74.125.200.0-255,5738,98616,92,373215
30432,0.001016,74.125.200.0-255,2902,101518,92,373215
30433,0.00103,74.125.200.0-255,4320,105838,92,373215
30434,0.001049,74.125.200.0-255,1484,107322,92,373215
30435,0.001061,74.125.200.0-255,5738,113060,92,373215
30436,0.001096,74.125.200.0-255,2902,115962,92,373215
30437,0.001109,74.125.200.0-255,4320,120282,92,373215
30438,0.001111,74.125.200.0-255,1484,121766,92,373215
30439,0.001115,74.125.200.0-255,2902,124668,92,373215
30440,0.001133,74.125.200.0-255,5738,130406,92,373215
30441,0.001148,74.125.200.0-255,2184,132590,92,373215
30442,0.001197,74.125.200.0-255,1484,134074,92,373215
30443,0.001211,74.125.200.0-255,2902,136976,92,373215
30444,0.00124,74.125.200.0-255,5738,142714,92,373215
30445,0.001262,74.125.200.0-255,7156,149870,92,373215
30446,0.001273,74.125.200.0-255,2902,152772,92,373215
30447,0.001276,74.125.200.0-255,2902,155674,92,373215
30448,0.001303,74.125.200.0-255,1484,157158,92,373215
30449,0.001313,74.125.200.0-255,766,157924,92,373215
30450,0.00156,74.125.200.0-255,1484,159408,92,373215
30451,0.001572,74.125.200.0-255,2902,162310,92,373215
30452,0.001586,74.125.200.0-255,2902,165212,92,373215
30453,0.0016,74.125.200.0-255,2902,168114,92,373215
30454,0.001625,74.125.200.0-255,2902,171016,92,373215
30455,0.001645,74.125.200.0-255,2902,173918,92,373215
30456,0.00165,74.125.200.0-255,7156,181074,92,373215
30457,0.001716,74.125.200.0-255,1484,182558,92,373215
30458,0.001726,74.125.200.0-255,1484,184042,92,373215
30459,0.001736,74.125.200.0-255,1484,185526,92,373215
30460,0.001761,74.125.200.0-255,1484,187010,92,373215
30461,0.001776,74.125.200.0-255,2902,189912,92,373215
30462,0.001784,74.125.200.0-255,1484,191396,92,373215
30463,0.001797,74.125.200.0-255,4320,195716,92,373215
30464,0.001827,74.125.200.0-255,4320,200036,92,373215
30465,0.001843,74.125.200.0-255,5738,205774,92,373215
30466,0.001866,74.125.200.0-255,2902,208676,92,373215
30467,0.001886,74.125.200.0-255,6438,215114,92,373215
30468,0.001923,74.125.200.0-255,1484,216598,92,373215
30469,0.001965,74.125.200.0-255,2902,219500,92,373215
30470,0.001971,74.125.200.0-255,5738,225238,92,373215
30471,0.001975,74.125.200.0-255,2902,228140,92,373215
30472,0.001977,74.125.200.0-255,1484,229624,92,373215
30473,0.001991,74.125.200.0-255,2902,232526,92,373215
30474,0.002008,74.125.200.0-255,4320,236846,92,373215
30475,0.002019,74.125.200.0-255,4320,241166,92,373215
30476,0.002025,74.125.200.0-255,5738,246904,92,373215
30477,0.002069,74.125.200.0-255,2184,249088,92,373215
30478,0.002158,172.31.47.0-255,66,249154,92,373215
30479,0.002302,74.125.200.0-255,1484,250638,92,373215
30480,0.002321,74.125.200.0-255,2902,253540,92,373215
30481,0.002335,172.31.47.0-255,66,253606,92,373215
30482,0.002346,74.125.200.0-255,4320,257926,92,373215
30483,0.00235,172.31.47.0-255,66,257992,92,373215
30484,0.002374,74.125.200.0-255,4320,262312,92,373215
30485,0.002379,172.31.47.0-255,66,262378,92,373215
30486,0.002406,74.125.200.0-255,4320,266698,92,373215
30487,0.002417,172.31.47.0-255,66,266764,92,373215
30488,0.002422,172.31.47.0-255,66,266830,92,373215
30489,0.002448,74.125.200.0-255,5738,272568,92,373215
30490,0.002451,74.125.200.0-255,766,273334,92,373215
30491,0.002452,172.31.47.0-255,66,273400,92,373215
30492,0.002585,74.125.200.0-255,1484,274884,92,373215
30493,0.002593,172.31.47.0-255,66,274950,92,373215
30494,0.005002,74.125.200.0-255,2902,277852,92,373215
30495,0.005009,172.31.47.0-255,66,277918,92,373215
30496,0.005141,74.125.200.0-255,2902,280820,92,373215
30497,0.005157,172.31.47.0-255,66,280886,92,373215
30498,0.007558,74.125.200.0-255,2902,283788,92,373215
30499,0.007565,172.31.47.0-255,66,283854,92,373215
30500,0.007712,74.125.200.0-255,2902,286756,92,373215
30501,0.007716,172.31.47.0-255,66,286822,92,373215
30502,0.010119,74.125.200.0-255,2902,289724,92,373215
30503,0.010125,172.31.47.0-255,66,289790,92,373215
30504,0.010284,74.125.200.0-255,2902,292692,92,373215
30505,0.010288,172.31.47.0-255,66,292758,92,373215
30506,0.012684,74.125.200.0-255,2902,295660,92,373215
30507,0.012689,172.31.47.0-255,66,295726,92,373215
30508,0.012841,74.125.200.0-255,2902,298628,92,373215
30509,0.012847,172.31.47.0-255,66,298694,92,373215
30510,0.015252,74.125.200.0-255,2902,301596,92,373215
30511,0.015258,172.31.47.0-255,66,301662,92,373215
30512,0.015385,74.125.200.0-255,2902,304564,92,373215
30513,0.01539,172.31.47.0-255,66,304630,92,373215
30514,0.017823,74.125.200.0-255,2902,307532,92,373215
30515,0.017828,172.31.47.0-255,66,307598,92,373215
30516,0.017934,74.125.200.0-255,2902,310500,92,373215
30517,0.017938,172.31.47.0-255,66,310566,92,373215
30518,0.020392,74.125.200.0-255,2902,313468,92,373215
30519,0.020401,172.31.47.0-255,66,313534,92,373215
30520,0.02049,74.125.200.0-255,2902,316436,92,373215
30521,0.020598,172.31.47.0-255,66,316502,92,373215
30522,0.022955,74.125.200.0-255,2902,319404,92,373215
30523,0.022962,172.31.47.0-255,66,319470,92,373215
30524,0.023148,74.125.200.0-255,2902,322372,92,373215
30525,0.023154,172.31.47.0-255,66,322438,92,373215
30526,0.025519,74.125.200.0-255,2902,325340,92,373215
30527,0.025526,172.31.47.0-255,66,325406,92,373215
30528,0.025704,74.125.200.0-255,2902,328308,92,373215
30529,0.02571,172.31.47.0-255,66,328374,92,373215
30530,0.028098,74.125.200.0-255,2902,331276,92,373215
30531,0.028112,172.31.47.0-255,66,331342,92,373215
30532,0.028272,74.125.200.0-255,2902,334244,92,373215
30533,0.028317,172.31.47.0-255,66,334310,92,373215
30534,0.030667,74.125.200.0-255,2902,337212,92,373215
30535,0.030673,172.31.47.0-255,66,337278,92,373215
30536,0.030865,74.125.200.0-255,2902,340180,92,373215
30537,0.030872,172.31.47.0-255,66,340246,92,373215
30538,0.03323,74.125.200.0-255,2902,343148,92,373215
30539,0.033237,172.31.47.0-255,66,343214,92,373215
30540,0.033416,74.125.200.0-255,2902,346116,92,373215
30541,0.03342,172.31.47.0-255,66,346182,92,373215
30542,0.035797,74.125.200.0-255,2902,349084,92,373215
30543,0.035804,172.31.47.0-255,66,349150,92,373215
30544,0.035973,74.125.200.0-255,2902,352052,92,373215
30545,0.035978,172.31.47.0-255,66,352118,92,373215
30546,0.038375,74.125.200.0-255,2902,355020,92,373215
30547,0.03838,172.31.47.0-255,66,355086,92,373215
30548,0.038523,74.125.200.0-255,2902,357988,92,373215
30549,0.038529,172.31.47.0-255,66,358054,92,373215
30550,0.039092,172.31.47.0-255,172,358226,92,373215
30551,0.039119,172.31.47.0-255,1112,359338,92,373215
30552,0.039189,172.31.47.0-255,1514,360852,92,373215
30553,0.039191,172.31.47.0-255,1514,362366,92,373215
30554,0.039192,172.31.47.0-255,1514,363880,92,373215
30555,0.039193,172.31.47.0-255,1514,365394,92,373215
30556,0.039222,172.31.47.0-255,1494,366888,92,373215
30557,0.040622,104.244.42.0-255,66,366954,92,373215
30558,0.040657,104.244.42.0-255,66,367020,92,373215
30559,0.040775,104.244.42.0-255,66,367086,92,373215
30560,0.040922,74.125.200.0-255,2902,369988,92,373215
30561,0.040926,172.31.47.0-255,66,370054,92,373215
30562,0.04108,74.125.200.0-255,2750,372804,92,373215
30563,0.041085,172.31.47.0-255,66,372870,92,373215
30564,0.041416,172.31.47.0-255,105,372975,92,373215
30565,0.042456,104.244.42.0-255,108,373083,92,373215
30566,0.042462,172.31.47.0-255,66,373149,92,373215
30567,0.043922,74.125.200.0-255,66,373215,92,373215
30568,0.0,172.217.194.0-255,153,153,92,255350
30569,3.1e-05,172.31.47.0-255,66,219,92,255350
30570,3.7e-05,172.217.194.0-255,1484,1703,92,255350
30571,4.1e-05,172.31.47.0-255,66,1769,92,255350
30572,4.5e-05,172.217.194.0-255,2902,4671,92,255350
30573,4.8e-05,172.31.47.0-255,66,4737,92,255350
30574,5.6e-05,172.217.194.0-255,7156,11893,92,255350
30575,5.9e-05,172.31.47.0-255,66,11959,92,255350
30576,6.2e-05,172.217.194.0-255,1978,13937,92,255350
30577,6.4e-05,172.31.47.0-255,66,14003,92,255350
30578,9.8e-05,172.217.194.0-255,1484,15487,92,255350
30579,0.0001,172.31.47.0-255,66,15553,92,255350
30580,0.000106,172.217.194.0-255,2902,18455,92,255350
30581,0.000109,172.31.47.0-255,66,18521,92,255350
30582,0.000115,172.217.194.0-255,4320,22841,92,255350
30583,0.000117,172.31.47.0-255,66,22907,92,255350
30584,0.000133,172.217.194.0-255,1484,24391,92,255350
30585,0.000136,172.31.47.0-255,66,24457,92,255350
30586,0.000171,172.31.47.0-255,66,24523,92,255350
30587,0.000227,172.217.194.0-255,5738,30261,92,255350
30588,0.000231,172.31.47.0-255,66,30327,92,255350
30589,0.000249,172.217.194.0-255,3961,34288,92,255350
30590,0.000251,172.31.47.0-255,66,34354,92,255350
30591,0.000389,172.217.194.0-255,1484,35838,92,255350
30592,0.000393,172.31.47.0-255,66,35904,92,255350
30593,0.000408,172.217.194.0-255,2902,38806,92,255350
30594,0.000411,172.31.47.0-255,66,38872,92,255350
30595,0.000436,172.217.194.0-255,4320,43192,92,255350
30596,0.000438,172.31.47.0-255,66,43258,92,255350
30597,0.000456,172.217.194.0-255,1484,44742,92,255350
30598,0.000459,172.31.47.0-255,66,44808,92,255350
30599,0.000471,172.31.47.0-255,66,44874,92,255350
30600,0.000514,172.217.194.0-255,1484,46358,92,255350
30601,0.000517,172.31.47.0-255,66,46424,92,255350
30602,0.000541,172.31.47.0-255,66,46490,92,255350
30603,0.00056,172.217.194.0-255,2765,49255,92,255350
30604,0.000562,172.31.47.0-255,66,49321,92,255350
30605,0.000803,172.217.194.0-255,1484,50805,92,255350
30606,0.000808,172.217.194.0-255,2902,53707,92,255350
30607,0.000811,172.31.47.0-255,66,53773,92,255350
30608,0.000832,172.217.194.0-255,5738,59511,92,255350
30609,0.000835,172.31.47.0-255,66,59577,92,255350
30610,0.000856,172.217.194.0-255,7156,66733,92,255350
30611,0.00086,172.31.47.0-255,66,66799,92,255350
30612,0.000875,172.217.194.0-255,5738,72537,92,255350
30613,0.000878,172.31.47.0-255,66,72603,92,255350
30614,0.000883,172.217.194.0-255,4320,76923,92,255350
30615,0.000885,172.31.47.0-255,66,76989,92,255350
30616,0.000914,172.217.194.0-255,6438,83427,92,255350
30617,0.000918,172.31.47.0-255,66,83493,92,255350
30618,0.000963,172.217.194.0-255,1484,84977,92,255350
30619,0.000966,172.217.194.0-255,1484,86461,92,255350
30620,0.00097,172.31.47.0-255,66,86527,92,255350
30621,0.000983,172.217.194.0-255,1484,88011,92,255350
30622,0.00099,172.217.194.0-255,5738,93749,92,255350
30623,0.000992,172.31.47.0-255,66,93815,92,255350
30624,0.001022,172.31.47.0-255,66,93881,92,255350
30625,0.001042,172.217.194.0-255,1484,95365,92,255350
30626,0.001054,172.31.47.0-255,66,95431,92,255350
30627,0.001208,172.217.194.0-255,1484,96915,92,255350
30628,0.001213,172.217.194.0-255,2902,99817,92,255350
30629,0.001217,172.31.47.0-255,66,99883,92,255350
30630,0.001239,172.217.194.0-255,5738,105621,92,255350
30631,0.001243,172.31.47.0-255,66,105687,92,255350
30632,0.001271,172.31.47.0-255,66,105753,92,255350
30633,0.001277,172.217.194.0-255,4320,110073,92,255350
30634,0.001279,172.31.47.0-255,66,110139,92,255350
30635,0.001309,172.217.194.0-255,6438,116577,92,255350
30636,0.001312,172.31.47.0-255,66,116643,92,255350
30637,0.001319,172.217.194.0-255,5738,122381,92,255350
30638,0.001321,172.31.47.0-255,66,122447,92,255350
30639,0.001352,172.217.194.0-255,5738,128185,92,255350
30640,0.001355,172.31.47.0-255,66,128251,92,255350
30641,0.001366,172.31.47.0-255,66,128317,92,255350
30642,0.00138,172.217.194.0-255,4320,132637,92,255350
30643,0.001382,172.31.47.0-255,66,132703,92,255350
30644,0.001411,172.31.47.0-255,66,132769,92,255350
30645,0.001601,172.217.194.0-255,1484,134253,92,255350
30646,0.001622,172.217.194.0-255,2902,137155,92,255350
30647,0.001626,172.31.47.0-255,66,137221,92,255350
30648,0.001635,172.217.194.0-255,5738,142959,92,255350
30649,0.001637,172.31.47.0-255,66,143025,92,255350
30650,0.001678,172.217.194.0-255,1484,144509,92,255350
30651,0.001712,172.31.47.0-255,66,144575,92,255350
30652,0.001725,172.31.47.0-255,66,144641,92,255350
30653,0.001837,172.217.194.0-255,1484,146125,92,255350
30654,0.001851,172.217.194.0-255,1484,147609,92,255350
30655,0.001856,172.31.47.0-255,66,147675,92,255350
30656,0.001873,172.217.194.0-255,1484,149159,92,255350
30657,0.001886,172.217.194.0-255,1484,150643,92,255350
30658,0.001889,172.31.47.0-255,66,150709,92,255350
30659,0.001907,172.217.194.0-255,4320,155029,92,255350
30660,0.001909,172.31.47.0-255,66,155095,92,255350
30661,0.00192,172.31.47.0-255,66,155161,92,255350
30662,0.001943,172.217.194.0-255,2902,158063,92,255350
30663,0.001945,172.31.47.0-255,66,158129,92,255350
30664,0.001956,172.31.47.0-255,66,158195,92,255350
30665,0.001987,172.217.194.0-255,1484,159679,92,255350
30666,0.002008,172.217.194.0-255,2902,162581,92,255350
30667,0.00201,172.31.47.0-255,66,162647,92,255350
30668,0.002013,172.217.194.0-255,1484,164131,92,255350
30669,0.00203,172.217.194.0-255,4320,168451,92,255350
30670,0.002033,172.31.47.0-255,66,168517,92,255350
30671,0.002068,172.31.47.0-255,66,168583,92,255350
30672,0.002078,172.31.47.0-255,66,168649,92,255350
30673,0.002102,172.217.194.0-255,2184,170833,92,255350
30674,0.002105,172.31.47.0-255,66,170899,92,255350
30675,0.00214,172.217.194.0-255,1484,172383,92,255350
30676,0.002152,172.217.194.0-255,2902,175285,92,255350
30677,0.002155,172.31.47.0-255,66,175351,92,255350
30678,0.002177,172.217.194.0-255,1484,176835,92,255350
30679,0.002199,172.217.194.0-255,4320,181155,92,255350
30680,0.002202,172.31.47.0-255,66,181221,92,255350
30681,0.002214,172.31.47.0-255,66,181287,92,255350
30682,0.002219,172.217.194.0-255,4320,185607,92,255350
30683,0.002221,172.31.47.0-255,66,185673,92,255350
30684,0.002241,172.217.194.0-255,6438,192111,92,255350
30685,0.002243,172.31.47.0-255,66,192177,92,255350
30686,0.002282,172.217.194.0-255,7156,199333,92,255350
30687,0.002284,172.31.47.0-255,66,199399,92,255350
30688,0.002305,172.217.194.0-255,4320,203719,92,255350
30689,0.002307,172.31.47.0-255,66,203785,92,255350
30690,0.00231,172.217.194.0-255,2902,206687,92,255350
30691,0.002311,172.31.47.0-255,66,206753,92,255350
30692,0.00456,172.217.194.0-255,4320,211073,92,255350
30693,0.004563,172.31.47.0-255,66,211139,92,255350
30694,0.004577,172.217.194.0-255,1484,212623,92,255350
30695,0.006832,172.217.194.0-255,4320,216943,92,255350
30696,0.006839,172.31.47.0-255,66,217009,92,255350
30697,0.009072,172.217.194.0-255,5738,222747,92,255350
30698,0.009078,172.31.47.0-255,66,222813,92,255350
30699,0.011393,172.217.194.0-255,5738,228551,92,255350
30700,0.011399,172.31.47.0-255,66,228617,92,255350
30701,0.013658,172.217.194.0-255,5738,234355,92,255350
30702,0.013665,172.31.47.0-255,66,234421,92,255350
30703,0.01592,172.217.194.0-255,5738,240159,92,255350
30704,0.015929,172.31.47.0-255,66,240225,92,255350
30705,0.018196,172.217.194.0-255,5682,245907,92,255350
30706,0.018203,172.31.47.0-255,66,245973,92,255350
30707,0.018543,172.31.47.0-255,105,246078,92,255350
30708,0.020759,172.217.194.0-255,66,246144,92,255350
30709,0.031641,172.31.47.0-255,172,246316,92,255350
30710,0.03167,172.31.47.0-255,1113,247429,92,255350
30711,0.031706,172.31.47.0-255,1514,248943,92,255350
30712,0.031708,172.31.47.0-255,1514,250457,92,255350
30713,0.031712,172.31.47.0-255,1514,251971,92,255350
30714,0.031713,172.31.47.0-255,1514,253485,92,255350
30715,0.031731,172.31.47.0-255,1493,254978,92,255350
30716,0.033199,104.244.42.0-255,66,255044,92,255350
30717,0.033207,104.244.42.0-255,66,255110,92,255350
30718,0.033264,104.244.42.0-255,66,255176,92,255350
30719,0.034977,104.244.42.0-255,108,255284,92,255350
30720,0.034981,172.31.47.0-255,66,255350,92,255350
30721,0.0,172.217.194.0-255,152,152,92,305973
30722,1.6e-05,172.31.47.0-255,66,218,92,305973
30723,2.3e-05,172.217.194.0-255,1484,1702,92,305973
30724,2.8e-05,172.31.47.0-255,66,1768,92,305973
30725,3.3e-05,172.217.194.0-255,2902,4670,92,305973
30726,4.6e-05,172.31.47.0-255,66,4736,92,305973
30727,5.3e-05,172.217.194.0-255,5738,10474,92,305973
30728,5.7e-05,172.31.47.0-255,66,10540,92,305973
30729,8.3e-05,172.217.194.0-255,1484,12024,92,305973
30730,8.5e-05,172.31.47.0-255,66,12090,92,305973
30731,9.9e-05,172.31.47.0-255,66,12156,92,305973
30732,0.000128,172.217.194.0-255,6797,18953,92,305973
30733,0.000131,172.31.47.0-255,66,19019,92,305973
30734,0.000375,172.217.194.0-255,1484,20503,92,305973
30735,0.00038,172.31.47.0-255,66,20569,92,305973
30736,0.000386,172.217.194.0-255,2902,23471,92,305973
30737,0.000388,172.31.47.0-255,66,23537,92,305973
30738,0.000424,172.217.194.0-255,5738,29275,92,305973
30739,0.000426,172.217.194.0-255,1484,30759,92,305973
30740,0.000428,172.31.47.0-255,66,30825,92,305973
30741,0.000431,172.31.47.0-255,66,30891,92,305973
30742,0.000471,172.31.47.0-255,66,30957,92,305973
30743,0.000483,172.31.47.0-255,66,31023,92,305973
30744,0.000486,172.217.194.0-255,676,31699,92,305973
30745,0.000487,172.31.47.0-255,66,31765,92,305973
30746,0.000755,172.217.194.0-255,1484,33249,92,305973
30747,0.000759,172.31.47.0-255,66,33315,92,305973
30748,0.000763,172.217.194.0-255,2902,36217,92,305973
30749,0.000764,172.31.47.0-255,66,36283,92,305973
30750,0.000768,172.217.194.0-255,2902,39185,92,305973
30751,0.000772,172.31.47.0-255,66,39251,92,305973
30752,0.000801,172.217.194.0-255,2902,42153,92,305973
30753,0.000806,172.31.47.0-255,66,42219,92,305973
30754,0.000818,172.31.47.0-255,66,42285,92,305973
30755,0.000831,172.217.194.0-255,2902,45187,92,305973
30756,0.000837,172.217.194.0-255,7156,52343,92,305973
30757,0.00084,172.31.47.0-255,66,52409,92,305973
30758,0.000863,172.217.194.0-255,3602,56011,92,305973
30759,0.00087,172.31.47.0-255,66,56077,92,305973
30760,0.001423,172.217.194.0-255,1484,57561,92,305973
30761,0.001432,172.217.194.0-255,2902,60463,92,305973
30762,0.001436,172.31.47.0-255,66,60529,92,305973
30763,0.001469,172.217.194.0-255,5738,66267,92,305973
30764,0.001472,172.217.194.0-255,1484,67751,92,305973
30765,0.001486,172.217.194.0-255,2902,70653,92,305973
30766,0.00149,172.217.194.0-255,2902,73555,92,305973
30767,0.001561,172.217.194.0-255,1484,75039,92,305973
30768,0.001576,172.217.194.0-255,5738,80777,92,305973
30769,0.00159,172.217.194.0-255,1484,82261,92,305973
30770,0.001595,172.217.194.0-255,4320,86581,92,305973
30771,0.001609,172.217.194.0-255,5738,92319,92,305973
30772,0.001624,172.217.194.0-255,2902,95221,92,305973
30773,0.001695,172.217.194.0-255,1484,96705,92,305973
30774,0.001712,172.217.194.0-255,2184,98889,92,305973
30775,0.001716,172.217.194.0-255,4320,103209,92,305973
30776,0.001734,172.217.194.0-255,7156,110365,92,305973
30777,0.001766,172.217.194.0-255,2902,113267,92,305973
30778,0.001776,172.217.194.0-255,2902,116169,92,305973
30779,0.001789,172.217.194.0-255,6438,122607,92,305973
30780,0.001885,172.217.194.0-255,1484,124091,92,305973
30781,0.0019,172.217.194.0-255,2902,126993,92,305973
30782,0.001914,172.217.194.0-255,1484,128477,92,305973
30783,0.00193,172.217.194.0-255,4320,132797,92,305973
30784,0.001932,172.217.194.0-255,1484,134281,92,305973
30785,0.001953,172.217.194.0-255,5738,140019,92,305973
30786,0.001973,172.217.194.0-255,2902,142921,92,305973
30787,0.002007,172.217.194.0-255,1484,144405,92,305973
30788,0.002009,172.217.194.0-255,766,145171,92,305973
30789,0.002122,172.217.194.0-255,1484,146655,92,305973
30790,0.002134,172.217.194.0-255,2902,149557,92,305973
30791,0.002137,172.31.47.0-255,66,149623,92,305973
30792,0.002143,172.31.47.0-255,66,149689,92,305973
30793,0.002174,172.217.194.0-255,5738,155427,92,305973
30794,0.002179,172.217.194.0-255,1484,156911,92,305973
30795,0.002188,172.31.47.0-255,66,156977,92,305973
30796,0.002226,172.31.47.0-255,66,157043,92,305973
30797,0.00225,172.217.194.0-255,7156,164199,92,305973
30798,0.002254,172.31.47.0-255,66,164265,92,305973
30799,0.002279,172.217.194.0-255,3602,167867,92,305973
30800,0.002292,172.31.47.0-255,66,167933,92,305973
30801,0.004503,172.217.194.0-255,1484,169417,92,305973
30802,0.004551,172.217.194.0-255,4320,173737,92,305973
30803,0.004556,172.31.47.0-255,66,173803,92,305973
30804,0.006837,172.217.194.0-255,5738,179541,92,305973
30805,0.006842,172.31.47.0-255,66,179607,92,305973
30806,0.009153,172.217.194.0-255,5738,185345,92,305973
30807,0.00916,172.31.47.0-255,66,185411,92,305973
30808,0.011437,172.217.194.0-255,5738,191149,92,305973
30809,0.011443,172.31.47.0-255,66,191215,92,305973
30810,0.013733,172.217.194.0-255,5738,196953,92,305973
30811,0.013741,172.31.47.0-255,66,197019,92,305973
30812,0.016003,172.217.194.0-255,5738,202757,92,305973
30813,0.01601,172.31.47.0-255,66,202823,92,305973
30814,0.01831,172.217.194.0-255,5738,208561,92,305973
30815,0.018323,172.31.47.0-255,66,208627,92,305973
30816,0.020639,172.217.194.0-255,4320,212947,92,305973
30817,0.020647,172.31.47.0-255,66,213013,92,305973
30818,0.020683,172.217.194.0-255,1484,214497,92,305973
30819,0.022942,172.217.194.0-255,4320,218817,92,305973
30820,0.026591,172.31.47.0-255,66,218883,92,305973
30821,0.028874,172.217.194.0-255,5738,224621,92,305973
30822,0.028883,172.31.47.0-255,66,224687,92,305973
30823,0.029275,172.31.47.0-255,172,224859,92,305973
30824,0.029305,172.31.47.0-255,1107,225966,92,305973
30825,0.02935,172.31.47.0-255,1514,227480,92,305973
30826,0.029352,172.31.47.0-255,1514,228994,92,305973
30827,0.029353,172.31.47.0-255,1514,230508,92,305973
30828,0.029354,172.31.47.0-255,1514,232022,92,305973
30829,0.029379,172.31.47.0-255,1499,233521,92,305973
30830,0.030854,104.244.42.0-255,66,233587,92,305973
30831,0.030864,104.244.42.0-255,66,233653,92,305973
30832,0.030927,104.244.42.0-255,66,233719,92,305973
30833,0.031187,172.217.194.0-255,5738,239457,92,305973
30834,0.031192,172.31.47.0-255,66,239523,92,305973
30835,0.03347,172.217.194.0-255,4320,243843,92,305973
30836,0.033476,172.31.47.0-255,66,243909,92,305973
30837,0.033503,172.217.194.0-255,1484,245393,92,305973
30838,0.03575,172.217.194.0-255,2902,248295,92,305973
30839,0.035754,172.31.47.0-255,66,248361,92,305973
30840,0.03578,172.217.194.0-255,1484,249845,92,305973
30841,0.038078,172.217.194.0-255,4320,254165,92,305973
30842,0.03814,172.31.47.0-255,66,254231,92,305973
30843,0.040413,172.217.194.0-255,5738,259969,92,305973
30844,0.040459,172.31.47.0-255,66,260035,92,305973
30845,0.042796,172.217.194.0-255,4320,264355,92,305973
30846,0.042801,172.31.47.0-255,66,264421,92,305973
30847,0.042825,172.217.194.0-255,1484,265905,92,305973
30848,0.045159,172.217.194.0-255,4320,270225,92,305973
30849,0.045163,172.31.47.0-255,66,270291,92,305973
30850,0.047446,172.217.194.0-255,2902,273193,92,305973
30851,0.047451,172.31.47.0-255,66,273259,92,305973
30852,0.047481,172.217.194.0-255,2902,276161,92,305973
30853,0.047494,172.31.47.0-255,66,276227,92,305973
30854,0.049742,172.217.194.0-255,2902,279129,92,305973
30855,0.049748,172.31.47.0-255,66,279195,92,305973
30856,0.049774,172.217.194.0-255,2902,282097,92,305973
30857,0.049797,172.31.47.0-255,66,282163,92,305973
30858,0.05207,172.217.194.0-255,2902,285065,92,305973
30859,0.052075,172.31.47.0-255,66,285131,92,305973
30860,0.052113,172.217.194.0-255,2902,288033,92,305973
30861,0.052128,172.31.47.0-255,66,288099,92,305973
30862,0.05436,172.217.194.0-255,2902,291001,92,305973
30863,0.054365,172.31.47.0-255,66,291067,92,305973
30864,0.0544,172.217.194.0-255,2902,293969,92,305973
30865,0.054421,172.31.47.0-255,66,294035,92,305973
30866,0.056678,172.217.194.0-255,2902,296937,92,305973
30867,0.056682,172.31.47.0-255,66,297003,92,305973
30868,0.056712,172.217.194.0-255,2902,299905,92,305973
30869,0.056728,172.31.47.0-255,66,299971,92,305973
30870,0.058942,172.217.194.0-255,2902,302873,92,305973
30871,0.058948,172.31.47.0-255,66,302939,92,305973
30872,0.059002,172.217.194.0-255,1484,304423,92,305973
30873,0.059017,172.217.194.0-255,1484,305907,92,305973
30874,0.05903,172.31.47.0-255,66,305973,92,305973
30875,0.0,74.125.68.0-255,153,153,92,351863
30876,2.6e-05,172.31.47.0-255,66,219,92,351863
30877,3.3e-05,74.125.68.0-255,1484,1703,92,351863
30878,3.7e-05,172.31.47.0-255,66,1769,92,351863
30879,4e-05,74.125.68.0-255,1484,3253,92,351863
30880,4.2e-05,172.31.47.0-255,66,3319,92,351863
30881,6.4e-05,74.125.68.0-255,2902,6221,92,351863
30882,6.7e-05,172.31.47.0-255,66,6287,92,351863
30883,0.000101,74.125.68.0-255,5738,12025,92,351863
30884,0.000104,172.31.47.0-255,66,12091,92,351863
30885,0.000107,74.125.68.0-255,1484,13575,92,351863
30886,0.000109,172.31.47.0-255,66,13641,92,351863
30887,0.000151,74.125.68.0-255,2902,16543,92,351863
30888,0.000156,172.31.47.0-255,66,16609,92,351863
30889,0.000179,74.125.68.0-255,6319,22928,92,351863
30890,0.000182,172.31.47.0-255,66,22994,92,351863
30891,0.000198,74.125.68.0-255,1484,24478,92,351863
30892,0.000201,172.31.47.0-255,66,24544,92,351863
30893,0.000224,74.125.68.0-255,6797,31341,92,351863
30894,0.000227,172.31.47.0-255,66,31407,92,351863
30895,0.000488,74.125.68.0-255,1484,32891,92,351863
30896,0.000493,172.31.47.0-255,66,32957,92,351863
30897,0.000512,74.125.68.0-255,2902,35859,92,351863
30898,0.000515,172.31.47.0-255,66,35925,92,351863
30899,0.000518,74.125.68.0-255,1484,37409,92,351863
30900,0.00052,172.31.47.0-255,66,37475,92,351863
30901,0.00054,74.125.68.0-255,2902,40377,92,351863
30902,0.000542,172.31.47.0-255,66,40443,92,351863
30903,0.000564,74.125.68.0-255,2902,43345,92,351863
30904,0.000567,172.31.47.0-255,66,43411,92,351863
30905,0.000579,74.125.68.0-255,4320,47731,92,351863
30906,0.000582,172.31.47.0-255,66,47797,92,351863
30907,0.000619,74.125.68.0-255,2902,50699,92,351863
30908,0.000622,172.31.47.0-255,66,50765,92,351863
30909,0.000641,74.125.68.0-255,1484,52249,92,351863
30910,0.000648,74.125.68.0-255,5738,57987,92,351863
30911,0.000652,172.31.47.0-255,66,58053,92,351863
30912,0.000659,74.125.68.0-255,1484,59537,92,351863
30913,0.000673,74.125.68.0-255,4320,63857,92,351863
30914,0.000678,172.31.47.0-255,66,63923,92,351863
30915,0.000714,74.125.68.0-255,2184,66107,92,351863
30916,0.000728,172.31.47.0-255,66,66173,92,351863
30917,0.000737,74.125.68.0-255,442,66615,92,351863
30918,0.000802,74.125.68.0-255,1484,68099,92,351863
30919,0.000807,172.31.47.0-255,66,68165,92,351863
30920,0.000849,74.125.68.0-255,2902,71067,92,351863
30921,0.000853,172.31.47.0-255,66,71133,92,351863
30922,0.000859,74.125.68.0-255,5738,76871,92,351863
30923,0.000862,74.125.68.0-255,1484,78355,92,351863
30924,0.000875,74.125.68.0-255,4320,82675,92,351863
30925,0.000876,172.31.47.0-255,66,82741,92,351863
30926,0.000881,172.31.47.0-255,66,82807,92,351863
30927,0.00091,74.125.68.0-255,4320,87127,92,351863
30928,0.000921,172.31.47.0-255,66,87193,92,351863
30929,0.000922,74.125.68.0-255,2184,89377,92,351863
30930,0.000927,172.31.47.0-255,66,89443,92,351863
30931,0.001041,74.125.68.0-255,1484,90927,92,351863
30932,0.001063,74.125.68.0-255,2902,93829,92,351863
30933,0.001065,172.31.47.0-255,66,93895,92,351863
30934,0.001068,74.125.68.0-255,1484,95379,92,351863
30935,0.001085,74.125.68.0-255,2902,98281,92,351863
30936,0.001095,172.31.47.0-255,66,98347,92,351863
30937,0.001107,74.125.68.0-255,5738,104085,92,351863
30938,0.001115,172.31.47.0-255,66,104151,92,351863
30939,0.001131,74.125.68.0-255,4320,108471,92,351863
30940,0.001135,172.31.47.0-255,66,108537,92,351863
30941,0.00115,74.125.68.0-255,5738,114275,92,351863
30942,0.00116,172.31.47.0-255,66,114341,92,351863
30943,0.001169,74.125.68.0-255,1484,115825,92,351863
30944,0.001185,172.31.47.0-255,66,115891,92,351863
30945,0.001424,74.125.68.0-255,1484,117375,92,351863
30946,0.001429,172.31.47.0-255,66,117441,92,351863
30947,0.001436,74.125.68.0-255,2902,120343,92,351863
30948,0.001449,74.125.68.0-255,1484,121827,92,351863
30949,0.001469,74.125.68.0-255,4320,126147,92,351863
30950,0.001483,74.125.68.0-255,1484,127631,92,351863
30951,0.001507,74.125.68.0-255,7156,134787,92,351863
30952,0.00154,74.125.68.0-255,2902,137689,92,351863
30953,0.001565,74.125.68.0-255,7156,144845,92,351863
30954,0.001599,74.125.68.0-255,1484,146329,92,351863
30955,0.001621,74.125.68.0-255,2902,149231,92,351863
30956,0.001667,74.125.68.0-255,766,149997,92,351863
30957,0.001862,74.125.68.0-255,1484,151481,92,351863
30958,0.001866,74.125.68.0-255,1484,152965,92,351863
30959,0.00188,74.125.68.0-255,1484,154449,92,351863
30960,0.001882,74.125.68.0-255,1484,155933,92,351863
30961,0.001886,74.125.68.0-255,2902,158835,92,351863
30962,0.001902,74.125.68.0-255,1484,160319,92,351863
30963,0.001918,74.125.68.0-255,4320,164639,92,351863
30964,0.001934,74.125.68.0-255,4320,168959,92,351863
30965,0.001954,74.125.68.0-255,5738,174697,92,351863
30966,0.001999,74.125.68.0-255,4320,179017,92,351863
30967,0.002022,74.125.68.0-255,5020,184037,92,351863
30968,0.002196,74.125.68.0-255,1484,185521,92,351863
30969,0.0022,74.125.68.0-255,2902,188423,92,351863
30970,0.002216,74.125.68.0-255,2902,191325,92,351863
30971,0.002224,74.125.68.0-255,1484,192809,92,351863
30972,0.002238,74.125.68.0-255,1484,194293,92,351863
30973,0.002241,74.125.68.0-255,4320,198613,92,351863
30974,0.002245,74.125.68.0-255,2902,201515,92,351863
30975,0.002258,74.125.68.0-255,2902,204417,92,351863
30976,0.002279,74.125.68.0-255,2902,207319,92,351863
30977,0.002304,74.125.68.0-255,1484,208803,92,351863
30978,0.002306,74.125.68.0-255,766,209569,92,351863
30979,0.005897,172.31.47.0-255,66,209635,92,351863
30980,0.008202,74.125.68.0-255,5738,215373,92,351863
30981,0.008209,172.31.47.0-255,66,215439,92,351863
30982,0.010502,74.125.68.0-255,5738,221177,92,351863
30983,0.010632,172.31.47.0-255,66,221243,92,351863
30984,0.012966,74.125.68.0-255,5738,226981,92,351863
30985,0.012974,172.31.47.0-255,66,227047,92,351863
30986,0.015291,74.125.68.0-255,5738,232785,92,351863
30987,0.015303,172.31.47.0-255,66,232851,92,351863
30988,0.0176,74.125.68.0-255,5738,238589,92,351863
30989,0.017606,172.31.47.0-255,66,238655,92,351863
30990,0.019909,74.125.68.0-255,5738,244393,92,351863
30991,0.019917,172.31.47.0-255,66,244459,92,351863
30992,0.022221,74.125.68.0-255,4320,248779,92,351863
30993,0.022226,172.31.47.0-255,66,248845,92,351863
30994,0.022246,74.125.68.0-255,1484,250329,92,351863
30995,0.024517,74.125.68.0-255,4320,254649,92,351863
30996,0.024524,172.31.47.0-255,66,254715,92,351863
30997,0.026824,74.125.68.0-255,5738,260453,92,351863
30998,0.026874,172.31.47.0-255,66,260519,92,351863
30999,0.029169,74.125.68.0-255,5738,266257,92,351863
31000,0.029176,172.31.47.0-255,66,266323,92,351863
31001,0.031285,172.31.47.0-255,172,266495,92,351863
31002,0.031314,172.31.47.0-255,1107,267602,92,351863
31003,0.031463,74.125.68.0-255,5738,273340,92,351863
31004,0.031468,172.31.47.0-255,66,273406,92,351863
31005,0.03178,172.31.47.0-255,1514,274920,92,351863
31006,0.031783,172.31.47.0-255,1514,276434,92,351863
31007,0.03179,172.31.47.0-255,1514,277948,92,351863
31008,0.031792,172.31.47.0-255,1514,279462,92,351863
31009,0.031818,172.31.47.0-255,1499,280961,92,351863
31010,0.032844,104.244.42.0-255,66,281027,92,351863
31011,0.032872,104.244.42.0-255,66,281093,92,351863
31012,0.033406,104.244.42.0-255,66,281159,92,351863
31013,0.033745,74.125.68.0-255,1484,282643,92,351863
31014,0.033783,74.125.68.0-255,4320,286963,92,351863
31015,0.033787,172.31.47.0-255,66,287029,92,351863
31016,0.036093,74.125.68.0-255,1484,288513,92,351863
31017,0.036121,74.125.68.0-255,4320,292833,92,351863
31018,0.036125,172.31.47.0-255,66,292899,92,351863
31019,0.038415,74.125.68.0-255,5738,298637,92,351863
31020,0.03842,172.31.47.0-255,66,298703,92,351863
31021,0.040709,74.125.68.0-255,5738,304441,92,351863
31022,0.040715,172.31.47.0-255,66,304507,92,351863
31023,0.043019,74.125.68.0-255,5738,310245,92,351863
31024,0.043025,172.31.47.0-255,66,310311,92,351863
31025,0.045307,74.125.68.0-255,2902,313213,92,351863
31026,0.045312,172.31.47.0-255,66,313279,92,351863
31027,0.045347,74.125.68.0-255,2902,316181,92,351863
31028,0.045363,172.31.47.0-255,66,316247,92,351863
31029,0.047604,74.125.68.0-255,2902,319149,92,351863
31030,0.047609,172.31.47.0-255,66,319215,92,351863
31031,0.047638,74.125.68.0-255,2902,322117,92,351863
31032,0.047657,172.31.47.0-255,66,322183,92,351863
31033,0.049928,74.125.68.0-255,2902,325085,92,351863
31034,0.049934,172.31.47.0-255,66,325151,92,351863
31035,0.049967,74.125.68.0-255,2902,328053,92,351863
31036,0.049984,172.31.47.0-255,66,328119,92,351863
31037,0.052223,74.125.68.0-255,2902,331021,92,351863
31038,0.052229,172.31.47.0-255,66,331087,92,351863
31039,0.052264,74.125.68.0-255,2902,333989,92,351863
31040,0.052277,172.31.47.0-255,66,334055,92,351863
31041,0.054522,74.125.68.0-255,2902,336957,92,351863
31042,0.054527,172.31.47.0-255,66,337023,92,351863
31043,0.054566,74.125.68.0-255,1484,338507,92,351863
31044,0.054583,74.125.68.0-255,1484,339991,92,351863
31045,0.054602,172.31.47.0-255,66,340057,92,351863
31046,0.056811,74.125.68.0-255,2902,342959,92,351863
31047,0.056816,172.31.47.0-255,66,343025,92,351863
31048,0.056895,74.125.68.0-255,2902,345927,92,351863
31049,0.056905,172.31.47.0-255,66,345993,92,351863
31050,0.059103,74.125.68.0-255,1484,347477,92,351863
31051,0.059201,74.125.68.0-255,4320,351797,92,351863
31052,0.059206,172.31.47.0-255,66,351863,92,351863
31053,0.0,172.217.194.0-255,153,153,92,271157
31054,3.1e-05,172.31.47.0-255,66,219,92,271157
31055,3.6e-05,172.217.194.0-255,1484,1703,92,271157
31056,4e-05,172.31.47.0-255,66,1769,92,271157
31057,4.6e-05,172.217.194.0-255,2902,4671,92,271157
31058,4.9e-05,172.31.47.0-255,66,4737,92,271157
31059,5.6e-05,172.217.194.0-255,7156,11893,92,271157
31060,5.9e-05,172.31.47.0-255,66,11959,92,271157
31061,6.5e-05,172.217.194.0-255,6230,18189,92,271157
31062,6.8e-05,172.31.47.0-255,66,18255,92,271157
31063,0.000117,172.217.194.0-255,5738,23993,92,271157
31064,0.00012,172.31.47.0-255,66,24059,92,271157
31065,0.000146,172.217.194.0-255,6797,30856,92,271157
31066,0.000149,172.31.47.0-255,66,30922,92,271157
31067,0.000175,172.217.194.0-255,1484,32406,92,271157
31068,0.000178,172.31.47.0-255,66,32472,92,271157
31069,0.000182,172.217.194.0-255,2902,35374,92,271157
31070,0.000184,172.31.47.0-255,66,35440,92,271157
31071,0.000189,172.217.194.0-255,5738,41178,92,271157
31072,0.000191,172.31.47.0-255,66,41244,92,271157
31073,0.000233,172.31.47.0-255,66,41310,92,271157
31074,0.000242,172.31.47.0-255,66,41376,92,271157
31075,0.000265,172.217.194.0-255,1449,42825,92,271157
31076,0.000268,172.31.47.0-255,66,42891,92,271157
31077,0.000346,172.217.194.0-255,1484,44375,92,271157
31078,0.00035,172.31.47.0-255,66,44441,92,271157
31079,0.000355,172.217.194.0-255,2902,47343,92,271157
31080,0.000358,172.31.47.0-255,66,47409,92,271157
31081,0.000363,172.217.194.0-255,2902,50311,92,271157
31082,0.000365,172.31.47.0-255,66,50377,92,271157
31083,0.000387,172.217.194.0-255,2902,53279,92,271157
31084,0.000391,172.31.47.0-255,66,53345,92,271157
31085,0.000397,172.217.194.0-255,4320,57665,92,271157
31086,0.000399,172.31.47.0-255,66,57731,92,271157
31087,0.00042,172.31.47.0-255,66,57797,92,271157
31088,0.000444,172.217.194.0-255,3961,61758,92,271157
31089,0.000447,172.31.47.0-255,66,61824,92,271157
31090,0.000453,172.217.194.0-255,6513,68337,92,271157
31091,0.000455,172.31.47.0-255,66,68403,92,271157
31092,0.000476,172.217.194.0-255,4320,72723,92,271157
31093,0.000479,172.31.47.0-255,66,72789,92,271157
31094,0.000484,172.217.194.0-255,4320,77109,92,271157
31095,0.00049,172.31.47.0-255,66,77175,92,271157
31096,0.000495,172.217.194.0-255,1484,78659,92,271157
31097,0.000515,172.31.47.0-255,66,78725,92,271157
31098,0.000525,172.217.194.0-255,2902,81627,92,271157
31099,0.00053,172.31.47.0-255,66,81693,92,271157
31100,0.000531,172.217.194.0-255,5738,87431,92,271157
31101,0.000533,172.31.47.0-255,66,87497,92,271157
31102,0.000553,172.217.194.0-255,6438,93935,92,271157
31103,0.000571,172.31.47.0-255,66,94001,92,271157
31104,0.000862,172.217.194.0-255,1484,95485,92,271157
31105,0.000867,172.217.194.0-255,2902,98387,92,271157
31106,0.000871,172.31.47.0-255,66,98453,92,271157
31107,0.000875,172.217.194.0-255,1484,99937,92,271157
31108,0.000894,172.217.194.0-255,2902,102839,92,271157
31109,0.000897,172.217.194.0-255,1484,104323,92,271157
31110,0.000899,172.31.47.0-255,66,104389,92,271157
31111,0.000921,172.217.194.0-255,4320,108709,92,271157
31112,0.000926,172.31.47.0-255,66,108775,92,271157
31113,0.000964,172.31.47.0-255,66,108841,92,271157
31114,0.000969,172.217.194.0-255,2902,111743,92,271157
31115,0.000975,172.217.194.0-255,7156,118899,92,271157
31116,0.000976,172.31.47.0-255,66,118965,92,271157
31117,0.00098,172.31.47.0-255,66,119031,92,271157
31118,0.000993,172.217.194.0-255,7156,126187,92,271157
31119,0.001005,172.31.47.0-255,66,126253,92,271157
31120,0.001011,172.217.194.0-255,2184,128437,92,271157
31121,0.001018,172.31.47.0-255,66,128503,92,271157
31122,0.001022,172.31.47.0-255,66,128569,92,271157
31123,0.00103,172.217.194.0-255,1484,130053,92,271157
31124,0.001044,172.217.194.0-255,4320,134373,92,271157
31125,0.001047,172.31.47.0-255,66,134439,92,271157
31126,0.001084,172.31.47.0-255,66,134505,92,271157
31127,0.001101,172.217.194.0-255,5738,140243,92,271157
31128,0.001108,172.217.194.0-255,7156,147399,92,271157
31129,0.001112,172.31.47.0-255,66,147465,92,271157
31130,0.001166,172.217.194.0-255,6438,153903,92,271157
31131,0.001166,172.31.47.0-255,66,153969,92,271157
31132,0.001171,172.31.47.0-255,66,154035,92,271157
31133,0.001209,172.217.194.0-255,5738,159773,92,271157
31134,0.001214,172.31.47.0-255,66,159839,92,271157
31135,0.001223,172.217.194.0-255,4320,164159,92,271157
31136,0.001228,172.31.47.0-255,66,164225,92,271157
31137,0.001238,172.31.47.0-255,66,164291,92,271157
31138,0.001277,172.31.47.0-255,66,164357,92,271157
31139,0.001298,172.217.194.0-255,1484,165841,92,271157
31140,0.001326,172.31.47.0-255,66,165907,92,271157
31141,0.001328,172.217.194.0-255,7156,173063,92,271157
31142,0.001338,172.31.47.0-255,66,173129,92,271157
31143,0.001351,172.217.194.0-255,7156,180285,92,271157
31144,0.001357,172.217.194.0-255,6438,186723,92,271157
31145,0.001358,172.31.47.0-255,66,186789,92,271157
31146,0.001371,172.31.47.0-255,66,186855,92,271157
31147,0.001425,172.217.194.0-255,1484,188339,92,271157
31148,0.001443,172.217.194.0-255,2902,191241,92,271157
31149,0.001448,172.217.194.0-255,4320,195561,92,271157
31150,0.001448,172.31.47.0-255,66,195627,92,271157
31151,0.001452,172.31.47.0-255,66,195693,92,271157
31152,0.001467,172.217.194.0-255,1484,197177,92,271157
31153,0.001474,172.217.194.0-255,7156,204333,92,271157
31154,0.001482,172.31.47.0-255,66,204399,92,271157
31155,0.001491,172.217.194.0-255,5738,210137,92,271157
31156,0.001495,172.31.47.0-255,66,210203,92,271157
31157,0.001509,172.217.194.0-255,4320,214523,92,271157
31158,0.001517,172.31.47.0-255,66,214589,92,271157
31159,0.001536,172.217.194.0-255,6438,221027,92,271157
31160,0.001549,172.31.47.0-255,66,221093,92,271157
31161,0.001569,172.217.194.0-255,7156,228249,92,271157
31162,0.001572,172.31.47.0-255,66,228315,92,271157
31163,0.001595,172.217.194.0-255,4320,232635,92,271157
31164,0.001604,172.31.47.0-255,66,232701,92,271157
31165,0.001608,172.217.194.0-255,7156,239857,92,271157
31166,0.001608,172.31.47.0-255,66,239923,92,271157
31167,0.00162,172.31.47.0-255,66,239989,92,271157
31168,0.001633,172.217.194.0-255,5020,245009,92,271157
31169,0.001637,172.31.47.0-255,66,245075,92,271157
31170,0.001676,172.217.194.0-255,7156,252231,92,271157
31171,0.001687,172.31.47.0-255,66,252297,92,271157
31172,0.001708,172.217.194.0-255,2902,255199,92,271157
31173,0.001715,172.31.47.0-255,66,255265,92,271157
31174,0.001739,172.31.47.0-255,66,255331,92,271157
31175,0.001743,172.31.47.0-255,66,255397,92,271157
31176,0.001764,172.217.194.0-255,6254,261651,92,271157
31177,0.001774,172.31.47.0-255,66,261717,92,271157
31178,0.001819,172.217.194.0-255,105,261822,92,271157
31179,0.003395,172.31.47.0-255,66,261888,92,271157
31180,0.003418,172.31.47.0-255,105,261993,92,271157
31181,0.005567,172.217.194.0-255,66,262059,92,271157
31182,0.036023,172.31.47.0-255,172,262231,92,271157
31183,0.036055,172.31.47.0-255,1112,263343,92,271157
31184,0.036089,172.31.47.0-255,1514,264857,92,271157
31185,0.03609,172.31.47.0-255,1514,266371,92,271157
31186,0.036092,172.31.47.0-255,1514,267885,92,271157
31187,0.036093,172.31.47.0-255,1514,269399,92,271157
31188,0.036094,172.31.47.0-255,1494,270893,92,271157
31189,0.037548,104.244.42.0-255,66,270959,92,271157
31190,0.037619,104.244.42.0-255,66,271025,92,271157
31191,0.037633,104.244.42.0-255,66,271091,92,271157
31192,0.037676,104.244.42.0-255,66,271157,92,271157
31193,0.0,172.217.194.0-255,153,153,92,280245
31194,2.5e-05,172.31.47.0-255,66,219,92,280245
31195,3.1e-05,172.217.194.0-255,1484,1703,92,280245
31196,3.6e-05,172.31.47.0-255,66,1769,92,280245
31197,4.1e-05,172.217.194.0-255,2902,4671,92,280245
31198,4.4e-05,172.31.47.0-255,66,4737,92,280245
31199,5.9e-05,172.217.194.0-255,7156,11893,92,280245
31200,6.3e-05,172.31.47.0-255,66,11959,92,280245
31201,8.8e-05,172.217.194.0-255,2039,13998,92,280245
31202,9e-05,172.31.47.0-255,66,14064,92,280245
31203,0.00013,172.217.194.0-255,1484,15548,92,280245
31204,0.000134,172.31.47.0-255,66,15614,92,280245
31205,0.000137,172.217.194.0-255,1484,17098,92,280245
31206,0.00014,172.31.47.0-255,66,17164,92,280245
31207,0.000161,172.217.194.0-255,1484,18648,92,280245
31208,0.00017,172.31.47.0-255,66,18714,92,280245
31209,0.000178,172.217.194.0-255,5738,24452,92,280245
31210,0.000182,172.31.47.0-255,66,24518,92,280245
31211,0.000188,172.217.194.0-255,6797,31315,92,280245
31212,0.00019,172.31.47.0-255,66,31381,92,280245
31213,0.000242,172.217.194.0-255,1484,32865,92,280245
31214,0.000245,172.31.47.0-255,66,32931,92,280245
31215,0.000249,172.217.194.0-255,2902,35833,92,280245
31216,0.000252,172.31.47.0-255,66,35899,92,280245
31217,0.000265,172.217.194.0-255,5738,41637,92,280245
31218,0.000267,172.31.47.0-255,66,41703,92,280245
31219,0.000314,172.217.194.0-255,6797,48500,92,280245
31220,0.000318,172.31.47.0-255,66,48566,92,280245
31221,0.000859,172.217.194.0-255,1484,50050,92,280245
31222,0.000863,172.31.47.0-255,66,50116,92,280245
31223,0.000871,172.217.194.0-255,2902,53018,92,280245
31224,0.000874,172.31.47.0-255,66,53084,92,280245
31225,0.000878,172.217.194.0-255,2902,55986,92,280245
31226,0.000886,172.31.47.0-255,66,56052,92,280245
31227,0.00092,172.217.194.0-255,2902,58954,92,280245
31228,0.000924,172.31.47.0-255,66,59020,92,280245
31229,0.000929,172.217.194.0-255,5738,64758,92,280245
31230,0.000931,172.31.47.0-255,66,64824,92,280245
31231,0.000934,172.217.194.0-255,1484,66308,92,280245
31232,0.000941,172.31.47.0-255,66,66374,92,280245
31233,0.000965,172.217.194.0-255,2543,68917,92,280245
31234,0.000967,172.31.47.0-255,66,68983,92,280245
31235,0.000972,172.217.194.0-255,4320,73303,92,280245
31236,0.000974,172.31.47.0-255,66,73369,92,280245
31237,0.000988,172.31.47.0-255,66,73435,92,280245
31238,0.001006,172.217.194.0-255,1125,74560,92,280245
31239,0.001008,172.31.47.0-255,66,74626,92,280245
31240,0.001011,172.217.194.0-255,646,75272,92,280245
31241,0.001013,172.31.47.0-255,66,75338,92,280245
31242,0.001015,172.217.194.0-255,1484,76822,92,280245
31243,0.001017,172.31.47.0-255,66,76888,92,280245
31244,0.001023,172.217.194.0-255,4320,81208,92,280245
31245,0.001032,172.31.47.0-255,66,81274,92,280245
31246,0.001075,172.31.47.0-255,66,81340,92,280245
31247,0.001078,172.217.194.0-255,1125,82465,92,280245
31248,0.00108,172.31.47.0-255,66,82531,92,280245
31249,0.001636,172.217.194.0-255,1484,84015,92,280245
31250,0.001642,172.31.47.0-255,66,84081,92,280245
31251,0.001649,172.217.194.0-255,2902,86983,92,280245
31252,0.001651,172.31.47.0-255,66,87049,92,280245
31253,0.001683,172.217.194.0-255,5738,92787,92,280245
31254,0.001686,172.31.47.0-255,66,92853,92,280245
31255,0.00169,172.217.194.0-255,2902,95755,92,280245
31256,0.001692,172.31.47.0-255,66,95821,92,280245
31257,0.001713,172.217.194.0-255,3398,99219,92,280245
31258,0.00194,172.217.194.0-255,1484,100703,92,280245
31259,0.001953,172.217.194.0-255,2902,103605,92,280245
31260,0.001956,172.217.194.0-255,1484,105089,92,280245
31261,0.001973,172.217.194.0-255,4320,109409,92,280245
31262,0.001991,172.217.194.0-255,4320,113729,92,280245
31263,0.002021,172.217.194.0-255,1484,115213,92,280245
31264,0.002036,172.217.194.0-255,7156,122369,92,280245
31265,0.002047,172.217.194.0-255,2184,124553,92,280245
31266,0.002344,172.31.47.0-255,66,124619,92,280245
31267,0.004482,172.217.194.0-255,4320,128939,92,280245
31268,0.004487,172.31.47.0-255,66,129005,92,280245
31269,0.004509,172.217.194.0-255,1484,130489,92,280245
31270,0.00451,172.31.47.0-255,66,130555,92,280245
31271,0.006562,172.217.194.0-255,5738,136293,92,280245
31272,0.006567,172.31.47.0-255,66,136359,92,280245
31273,0.008634,172.217.194.0-255,2902,139261,92,280245
31274,0.008641,172.31.47.0-255,66,139327,92,280245
31275,0.008671,172.217.194.0-255,2902,142229,92,280245
31276,0.010519,172.31.47.0-255,66,142295,92,280245
31277,0.010684,172.217.194.0-255,2902,145197,92,280245
31278,0.010691,172.31.47.0-255,66,145263,92,280245
31279,0.012591,172.217.194.0-255,2902,148165,92,280245
31280,0.012773,172.217.194.0-255,2902,151067,92,280245
31281,0.014384,172.31.47.0-255,66,151133,92,280245
31282,0.016438,172.217.194.0-255,4320,155453,92,280245
31283,0.016448,172.31.47.0-255,66,155519,92,280245
31284,0.016479,172.217.194.0-255,1484,157003,92,280245
31285,0.018508,172.217.194.0-255,4320,161323,92,280245
31286,0.018514,172.31.47.0-255,66,161389,92,280245
31287,0.020592,172.217.194.0-255,5738,167127,92,280245
31288,0.020639,172.31.47.0-255,66,167193,92,280245
31289,0.0227,172.217.194.0-255,5738,172931,92,280245
31290,0.022712,172.31.47.0-255,66,172997,92,280245
31291,0.024804,172.217.194.0-255,5738,178735,92,280245
31292,0.024813,172.31.47.0-255,66,178801,92,280245
31293,0.025662,172.31.47.0-255,172,178973,92,280245
31294,0.025692,172.31.47.0-255,1112,180085,92,280245
31295,0.02574,172.31.47.0-255,1514,181599,92,280245
31296,0.025742,172.31.47.0-255,1514,183113,92,280245
31297,0.025743,172.31.47.0-255,1514,184627,92,280245
31298,0.025744,172.31.47.0-255,1514,186141,92,280245
31299,0.025746,172.31.47.0-255,1494,187635,92,280245
31300,0.026898,172.217.194.0-255,5738,193373,92,280245
31301,0.026904,172.31.47.0-255,66,193439,92,280245
31302,0.02723,104.244.42.0-255,66,193505,92,280245
31303,0.027237,104.244.42.0-255,66,193571,92,280245
31304,0.027322,104.244.42.0-255,66,193637,92,280245
31305,0.027933,104.244.42.0-255,108,193745,92,280245
31306,0.027938,172.31.47.0-255,66,193811,92,280245
31307,0.028962,172.217.194.0-255,5738,199549,92,280245
31308,0.028966,172.31.47.0-255,66,199615,92,280245
31309,0.031046,172.217.194.0-255,4320,203935,92,280245
31310,0.031052,172.31.47.0-255,66,204001,92,280245
31311,0.031116,172.217.194.0-255,1484,205485,92,280245
31312,0.033161,172.217.194.0-255,4320,209805,92,280245
31313,0.033166,172.31.47.0-255,66,209871,92,280245
31314,0.03523,172.217.194.0-255,5738,215609,92,280245
31315,0.035288,172.31.47.0-255,66,215675,92,280245
31316,0.037341,172.217.194.0-255,5738,221413,92,280245
31317,0.037348,172.31.47.0-255,66,221479,92,280245
31318,0.03944,172.217.194.0-255,5738,227217,92,280245
31319,0.039447,172.31.47.0-255,66,227283,92,280245
31320,0.041512,172.217.194.0-255,5738,233021,92,280245
31321,0.041517,172.31.47.0-255,66,233087,92,280245
31322,0.043577,172.217.194.0-255,5738,238825,92,280245
31323,0.043583,172.31.47.0-255,66,238891,92,280245
31324,0.045644,172.217.194.0-255,5738,244629,92,280245
31325,0.045648,172.31.47.0-255,66,244695,92,280245
31326,0.047729,172.217.194.0-255,5738,250433,92,280245
31327,0.047735,172.31.47.0-255,66,250499,92,280245
31328,0.049787,172.217.194.0-255,2902,253401,92,280245
31329,0.049794,172.31.47.0-255,66,253467,92,280245
31330,0.049832,172.217.194.0-255,2902,256369,92,280245
31331,0.049852,172.31.47.0-255,66,256435,92,280245
31332,0.051869,172.217.194.0-255,2902,259337,92,280245
31333,0.051873,172.31.47.0-255,66,259403,92,280245
31334,0.051919,172.217.194.0-255,2902,262305,92,280245
31335,0.051925,172.31.47.0-255,66,262371,92,280245
31336,0.053935,172.217.194.0-255,2902,265273,92,280245
31337,0.053939,172.31.47.0-255,66,265339,92,280245
31338,0.053978,172.217.194.0-255,2902,268241,92,280245
31339,0.053989,172.31.47.0-255,66,268307,92,280245
31340,0.05601,172.217.194.0-255,2902,271209,92,280245
31341,0.056015,172.31.47.0-255,66,271275,92,280245
31342,0.056048,172.217.194.0-255,2902,274177,92,280245
31343,0.056057,172.31.47.0-255,66,274243,92,280245
31344,0.058052,172.217.194.0-255,2902,277145,92,280245
31345,0.058057,172.31.47.0-255,66,277211,92,280245
31346,0.058104,172.217.194.0-255,1484,278695,92,280245
31347,0.058119,172.217.194.0-255,1484,280179,92,280245
31348,0.058219,172.31.47.0-255,66,280245,92,280245
31349,0.0,74.125.24.0-255,152,152,92,180679
31350,2.4e-05,172.31.47.0-255,66,218,92,180679
31351,2.9e-05,74.125.24.0-255,1484,1702,92,180679
31352,3.3e-05,172.31.47.0-255,66,1768,92,180679
31353,3.6e-05,74.125.24.0-255,2902,4670,92,180679
31354,3.9e-05,172.31.47.0-255,66,4736,92,180679
31355,6.3e-05,74.125.24.0-255,7156,11892,92,180679
31356,6.6e-05,172.31.47.0-255,66,11958,92,180679
31357,7e-05,74.125.24.0-255,2172,14130,92,180679
31358,7.1e-05,172.31.47.0-255,66,14196,92,180679
31359,0.000107,172.31.47.0-255,66,14262,92,180679
31360,0.000111,74.125.24.0-255,4320,18582,92,180679
31361,0.000115,172.31.47.0-255,66,18648,92,180679
31362,0.000125,74.125.24.0-255,1125,19773,92,180679
31363,0.000127,172.31.47.0-255,66,19839,92,180679
31364,0.0002,74.125.24.0-255,1484,21323,92,180679
31365,0.000203,172.31.47.0-255,66,21389,92,180679
31366,0.000208,74.125.24.0-255,2902,24291,92,180679
31367,0.00021,172.31.47.0-255,66,24357,92,180679
31368,0.000233,74.125.24.0-255,5738,30095,92,180679
31369,0.000236,172.31.47.0-255,66,30161,92,180679
31370,0.000251,74.125.24.0-255,4320,34481,92,180679
31371,0.000253,172.31.47.0-255,66,34547,92,180679
31372,0.000274,172.31.47.0-255,66,34613,92,180679
31373,0.000284,172.31.47.0-255,66,34679,92,180679
31374,0.000321,74.125.24.0-255,1437,36116,92,180679
31375,0.000324,172.31.47.0-255,66,36182,92,180679
31376,0.000348,74.125.24.0-255,111,36293,92,180679
31377,0.000351,172.31.47.0-255,66,36359,92,180679
31378,0.00042,74.125.24.0-255,1484,37843,92,180679
31379,0.000425,74.125.24.0-255,2902,40745,92,180679
31380,0.000428,172.31.47.0-255,66,40811,92,180679
31381,0.000434,74.125.24.0-255,7156,47967,92,180679
31382,0.000436,172.31.47.0-255,66,48033,92,180679
31383,0.000446,172.31.47.0-255,66,48099,92,180679
31384,0.000463,74.125.24.0-255,2902,51001,92,180679
31385,0.000464,172.31.47.0-255,66,51067,92,180679
31386,0.000494,172.31.47.0-255,66,51133,92,180679
31387,0.001087,74.125.24.0-255,1484,52617,92,180679
31388,0.001104,74.125.24.0-255,2902,55519,92,180679
31389,0.001108,172.31.47.0-255,66,55585,92,180679
31390,0.001114,74.125.24.0-255,5738,61323,92,180679
31391,0.001116,172.31.47.0-255,66,61389,92,180679
31392,0.001152,172.31.47.0-255,66,61455,92,180679
31393,0.001196,74.125.24.0-255,1484,62939,92,180679
31394,0.001221,172.31.47.0-255,66,63005,92,180679
31395,0.001352,74.125.24.0-255,1484,64489,92,180679
31396,0.001365,74.125.24.0-255,2902,67391,92,180679
31397,0.001367,172.31.47.0-255,66,67457,92,180679
31398,0.001369,74.125.24.0-255,1484,68941,92,180679
31399,0.001391,74.125.24.0-255,4320,73261,92,180679
31400,0.001393,172.31.47.0-255,66,73327,92,180679
31401,0.001401,172.31.47.0-255,66,73393,92,180679
31402,0.001412,74.125.24.0-255,2902,76295,92,180679
31403,0.001414,172.31.47.0-255,66,76361,92,180679
31404,0.001427,74.125.24.0-255,1484,77845,92,180679
31405,0.001443,172.31.47.0-255,66,77911,92,180679
31406,0.001891,74.125.24.0-255,1484,79395,92,180679
31407,0.001909,74.125.24.0-255,2902,82297,92,180679
31408,0.001912,172.31.47.0-255,66,82363,92,180679
31409,0.001918,74.125.24.0-255,5738,88101,92,180679
31410,0.00192,172.31.47.0-255,66,88167,92,180679
31411,0.001927,74.125.24.0-255,7156,95323,92,180679
31412,0.001929,172.31.47.0-255,66,95389,92,180679
31413,0.001954,74.125.24.0-255,5738,101127,92,180679
31414,0.001956,172.31.47.0-255,66,101193,92,180679
31415,0.001965,172.31.47.0-255,66,101259,92,180679
31416,0.001997,74.125.24.0-255,5738,106997,92,180679
31417,0.002,172.31.47.0-255,66,107063,92,180679
31418,0.002029,172.31.47.0-255,66,107129,92,180679
31419,0.002039,172.31.47.0-255,66,107195,92,180679
31420,0.002059,172.31.47.0-255,66,107261,92,180679
31421,0.002071,172.31.47.0-255,66,107327,92,180679
31422,0.002094,74.125.24.0-255,1484,108811,92,180679
31423,0.002113,74.125.24.0-255,2902,111713,92,180679
31424,0.002115,172.31.47.0-255,66,111779,92,180679
31425,0.002144,172.31.47.0-255,66,111845,92,180679
31426,0.002147,74.125.24.0-255,1484,113329,92,180679
31427,0.002151,74.125.24.0-255,2902,116231,92,180679
31428,0.002153,172.31.47.0-255,66,116297,92,180679
31429,0.002171,74.125.24.0-255,5738,122035,92,180679
31430,0.002174,172.31.47.0-255,66,122101,92,180679
31431,0.002222,74.125.24.0-255,1484,123585,92,180679
31432,0.002235,74.125.24.0-255,766,124351,92,180679
31433,0.002266,74.125.24.0-255,1484,125835,92,180679
31434,0.002278,74.125.24.0-255,4320,130155,92,180679
31435,0.002294,74.125.24.0-255,1484,131639,92,180679
31436,0.002328,74.125.24.0-255,5738,137377,92,180679
31437,0.002344,74.125.24.0-255,5738,143115,92,180679
31438,0.002359,74.125.24.0-255,4320,147435,92,180679
31439,0.002519,74.125.24.0-255,2184,149619,92,180679
31440,0.003627,172.31.47.0-255,66,149685,92,180679
31441,0.00618,74.125.24.0-255,4320,154005,92,180679
31442,0.006186,172.31.47.0-255,66,154071,92,180679
31443,0.006203,74.125.24.0-255,1484,155555,92,180679
31444,0.00889,74.125.24.0-255,4320,159875,92,180679
31445,0.008952,172.31.47.0-255,66,159941,92,180679
31446,0.01153,74.125.24.0-255,5738,165679,92,180679
31447,0.011537,172.31.47.0-255,66,165745,92,180679
31448,0.014089,74.125.24.0-255,5738,171483,92,180679
31449,0.014098,172.31.47.0-255,66,171549,92,180679
31450,0.016622,74.125.24.0-255,585,172134,92,180679
31451,0.019334,172.31.47.0-255,66,172200,92,180679
31452,0.019366,172.31.47.0-255,105,172305,92,180679
31453,0.021877,74.125.24.0-255,66,172371,92,180679
31454,0.024015,172.31.47.0-255,172,172543,92,180679
31455,0.024042,172.31.47.0-255,1111,173654,92,180679
31456,0.024094,172.31.47.0-255,1514,175168,92,180679
31457,0.024096,172.31.47.0-255,1514,176682,92,180679
31458,0.024097,172.31.47.0-255,1514,178196,92,180679
31459,0.024098,172.31.47.0-255,1514,179710,92,180679
31460,0.024099,172.31.47.0-255,531,180241,92,180679
31461,0.025542,104.244.42.0-255,66,180307,92,180679
31462,0.025585,104.244.42.0-255,66,180373,92,180679
31463,0.025677,104.244.42.0-255,66,180439,92,180679
31464,0.025678,104.244.42.0-255,66,180505,92,180679
31465,0.026411,104.244.42.0-255,108,180613,92,180679
31466,0.026415,172.31.47.0-255,66,180679,92,180679
31467,0.0,172.217.194.0-255,153,153,92,177406
31468,2.6e-05,172.31.47.0-255,66,219,92,177406
31469,3.2e-05,172.217.194.0-255,1484,1703,92,177406
31470,3.7e-05,172.31.47.0-255,66,1769,92,177406
31471,4.2e-05,172.217.194.0-255,2902,4671,92,177406
31472,5.1e-05,172.31.47.0-255,66,4737,92,177406
31473,6e-05,172.217.194.0-255,7156,11893,92,177406
31474,6.2e-05,172.31.47.0-255,66,11959,92,177406
31475,6.8e-05,172.217.194.0-255,5738,17697,92,177406
31476,7.1e-05,172.31.47.0-255,66,17763,92,177406
31477,9.6e-05,172.217.194.0-255,612,18375,92,177406
31478,9.9e-05,172.31.47.0-255,66,18441,92,177406
31479,0.000135,172.31.47.0-255,66,18507,92,177406
31480,0.000208,172.31.47.0-255,66,18573,92,177406
31481,0.000214,172.217.194.0-255,3961,22534,92,177406
31482,0.000216,172.31.47.0-255,66,22600,92,177406
31483,0.000326,172.217.194.0-255,1484,24084,92,177406
31484,0.00033,172.31.47.0-255,66,24150,92,177406
31485,0.000333,172.217.194.0-255,1484,25634,92,177406
31486,0.000336,172.31.47.0-255,66,25700,92,177406
31487,0.000356,172.217.194.0-255,1484,27184,92,177406
31488,0.000364,172.31.47.0-255,66,27250,92,177406
31489,0.000371,172.217.194.0-255,5738,32988,92,177406
31490,0.000374,172.31.47.0-255,66,33054,92,177406
31491,0.000381,172.217.194.0-255,6797,39851,92,177406
31492,0.000384,172.31.47.0-255,66,39917,92,177406
31493,0.000412,172.217.194.0-255,647,40564,92,177406
31494,0.000415,172.31.47.0-255,66,40630,92,177406
31495,0.000442,172.217.194.0-255,1484,42114,92,177406
31496,0.000445,172.31.47.0-255,66,42180,92,177406
31497,0.000451,172.217.194.0-255,4320,46500,92,177406
31498,0.000453,172.31.47.0-255,66,46566,92,177406
31499,0.000481,172.217.194.0-255,7156,53722,92,177406
31500,0.000485,172.31.47.0-255,66,53788,92,177406
31501,0.000514,172.217.194.0-255,7156,60944,92,177406
31502,0.000518,172.31.47.0-255,66,61010,92,177406
31503,0.000546,172.217.194.0-255,1125,62135,92,177406
31504,0.00056,172.31.47.0-255,66,62201,92,177406
31505,0.00059,172.217.194.0-255,2543,64744,92,177406
31506,0.000593,172.31.47.0-255,66,64810,92,177406
31507,0.001212,172.217.194.0-255,1484,66294,92,177406
31508,0.001221,172.217.194.0-255,2902,69196,92,177406
31509,0.001226,172.31.47.0-255,66,69262,92,177406
31510,0.001231,172.217.194.0-255,2902,72164,92,177406
31511,0.001234,172.31.47.0-255,66,72230,92,177406
31512,0.001252,172.217.194.0-255,2902,75132,92,177406
31513,0.001255,172.31.47.0-255,66,75198,92,177406
31514,0.001271,172.31.47.0-255,66,75264,92,177406
31515,0.001306,172.217.194.0-255,1484,76748,92,177406
31516,0.001324,172.31.47.0-255,66,76814,92,177406
31517,0.001574,172.217.194.0-255,1484,78298,92,177406
31518,0.001581,172.217.194.0-255,2902,81200,92,177406
31519,0.001585,172.31.47.0-255,66,81266,92,177406
31520,0.001615,172.217.194.0-255,5738,87004,92,177406
31521,0.001617,172.31.47.0-255,66,87070,92,177406
31522,0.00163,172.31.47.0-255,66,87136,92,177406
31523,0.001669,172.31.47.0-255,66,87202,92,177406
31524,0.001694,172.217.194.0-255,1484,88686,92,177406
31525,0.001697,172.217.194.0-255,1484,90170,92,177406
31526,0.001699,172.31.47.0-255,66,90236,92,177406
31527,0.001709,172.217.194.0-255,1484,91720,92,177406
31528,0.001719,172.217.194.0-255,5738,97458,92,177406
31529,0.001722,172.31.47.0-255,66,97524,92,177406
31530,0.001725,172.217.194.0-255,1484,99008,92,177406
31531,0.001755,172.31.47.0-255,66,99074,92,177406
31532,0.001766,172.31.47.0-255,66,99140,92,177406
31533,0.001854,172.217.194.0-255,1484,100624,92,177406
31534,0.001857,172.217.194.0-255,1484,102108,92,177406
31535,0.001859,172.31.47.0-255,66,102174,92,177406
31536,0.00188,172.217.194.0-255,1484,103658,92,177406
31537,0.001887,172.217.194.0-255,5738,109396,92,177406
31538,0.001889,172.31.47.0-255,66,109462,92,177406
31539,0.001937,172.217.194.0-255,1484,110946,92,177406
31540,0.001959,172.31.47.0-255,66,111012,92,177406
31541,0.001974,172.31.47.0-255,66,111078,92,177406
31542,0.002071,172.217.194.0-255,1484,112562,92,177406
31543,0.002075,172.217.194.0-255,2902,115464,92,177406
31544,0.002077,172.31.47.0-255,66,115530,92,177406
31545,0.00208,172.217.194.0-255,1484,117014,92,177406
31546,0.002102,172.217.194.0-255,4320,121334,92,177406
31547,0.002104,172.31.47.0-255,66,121400,92,177406
31548,0.00211,172.217.194.0-255,5738,127138,92,177406
31549,0.002113,172.31.47.0-255,66,127204,92,177406
31550,0.002163,172.31.47.0-255,66,127270,92,177406
31551,0.002173,172.31.47.0-255,66,127336,92,177406
31552,0.002189,172.217.194.0-255,3602,130938,92,177406
31553,0.002191,172.31.47.0-255,66,131004,92,177406
31554,0.002221,172.217.194.0-255,4320,135324,92,177406
31555,0.002223,172.31.47.0-255,66,135390,92,177406
31556,0.002264,172.31.47.0-255,66,135456,92,177406
31557,0.002269,172.217.194.0-255,4320,139776,92,177406
31558,0.002271,172.31.47.0-255,66,139842,92,177406
31559,0.002311,172.31.47.0-255,66,139908,92,177406
31560,0.002341,172.217.194.0-255,1484,141392,92,177406
31561,0.002352,172.31.47.0-255,66,141458,92,177406
31562,0.002374,172.31.47.0-255,66,141524,92,177406
31563,0.002401,172.217.194.0-255,2902,144426,92,177406
31564,0.002404,172.31.47.0-255,66,144492,92,177406
31565,0.002427,172.31.47.0-255,66,144558,92,177406
31566,0.002432,172.217.194.0-255,5738,150296,92,177406
31567,0.002435,172.31.47.0-255,66,150362,92,177406
31568,0.00247,172.31.47.0-255,66,150428,92,177406
31569,0.00248,172.31.47.0-255,66,150494,92,177406
31570,0.004862,172.217.194.0-255,4320,154814,92,177406
31571,0.004868,172.31.47.0-255,66,154880,92,177406
31572,0.004893,172.217.194.0-255,1484,156364,92,177406
31573,0.007266,172.217.194.0-255,4320,160684,92,177406
31574,0.00727,172.31.47.0-255,66,160750,92,177406
31575,0.00963,172.217.194.0-255,5738,166488,92,177406
31576,0.009636,172.31.47.0-255,66,166554,92,177406
31577,0.012016,172.217.194.0-255,2481,169035,92,177406
31578,0.012023,172.31.47.0-255,66,169101,92,177406
31579,0.012188,172.31.47.0-255,105,169206,92,177406
31580,0.014537,172.217.194.0-255,66,169272,92,177406
31581,0.025485,172.31.47.0-255,172,169444,92,177406
31582,0.025539,172.31.47.0-255,1107,170551,92,177406
31583,0.025618,172.31.47.0-255,1514,172065,92,177406
31584,0.02562,172.31.47.0-255,1514,173579,92,177406
31585,0.025621,172.31.47.0-255,1514,175093,92,177406
31586,0.025622,172.31.47.0-255,1514,176607,92,177406
31587,0.025623,172.31.47.0-255,535,177142,92,177406
31588,0.027039,104.244.42.0-255,66,177208,92,177406
31589,0.027062,104.244.42.0-255,66,177274,92,177406
31590,0.027223,104.244.42.0-255,66,177340,92,177406
31591,0.027227,104.244.42.0-255,66,177406,92,177406
31592,0.0,172.31.47.0-255,130,130,92,1754
31593,0.001482,172.31.47.0-255,236,366,92,1754
31594,0.001563,172.31.47.0-255,366,732,92,1754
31595,0.002506,74.125.200.0-255,630,1362,92,1754
31596,0.005157,74.125.200.0-255,66,1428,92,1754
31597,0.006229,74.125.200.0-255,97,1525,92,1754
31598,0.006239,172.31.47.0-255,66,1591,92,1754
31599,0.011548,172.31.47.0-255,97,1688,92,1754
31600,0.019428,74.125.200.0-255,66,1754,92,1754
31601,0.0,31.13.82.0-255,105,105,92,171
31602,2.1e-05,172.31.47.0-255,66,171,92,171
31603,0.0,172.253.118.0-255,66,66,92,66
31604,0.0,172.31.47.0-255,66,66,92,66
31605,0.0,74.125.130.0-255,153,153,92,350061
31606,3.2e-05,172.31.47.0-255,66,219,92,350061
31607,3.9e-05,74.125.130.0-255,1484,1703,92,350061
31608,4.3e-05,172.31.47.0-255,66,1769,92,350061
31609,5.4e-05,74.125.130.0-255,1484,3253,92,350061
31610,5.6e-05,172.31.47.0-255,66,3319,92,350061
31611,6.9e-05,74.125.130.0-255,1484,4803,92,350061
31612,7.1e-05,172.31.47.0-255,66,4869,92,350061
31613,8.2e-05,74.125.130.0-255,2902,7771,92,350061
31614,8.4e-05,172.31.47.0-255,66,7837,92,350061
31615,8.9e-05,74.125.130.0-255,4320,12157,92,350061
31616,9.2e-05,172.31.47.0-255,66,12223,92,350061
31617,0.000125,74.125.130.0-255,4320,16543,92,350061
31618,0.000128,172.31.47.0-255,66,16609,92,350061
31619,0.000149,74.125.130.0-255,3385,19994,92,350061
31620,0.000151,172.31.47.0-255,66,20060,92,350061
31621,0.00016,172.31.47.0-255,66,20126,92,350061
31622,0.000184,74.125.130.0-255,2543,22669,92,350061
31623,0.000186,172.31.47.0-255,66,22735,92,350061
31624,0.00039,74.125.130.0-255,1484,24219,92,350061
31625,0.000394,172.31.47.0-255,66,24285,92,350061
31626,0.000416,74.125.130.0-255,1484,25769,92,350061
31627,0.000418,172.31.47.0-255,66,25835,92,350061
31628,0.000435,74.125.130.0-255,1484,27319,92,350061
31629,0.00044,74.125.130.0-255,5738,33057,92,350061
31630,0.00044,172.31.47.0-255,66,33123,92,350061
31631,0.000444,172.31.47.0-255,66,33189,92,350061
31632,0.000445,74.125.130.0-255,6797,39986,92,350061
31633,0.000448,172.31.47.0-255,66,40052,92,350061
31634,0.000471,74.125.130.0-255,1484,41536,92,350061
31635,0.000473,172.31.47.0-255,66,41602,92,350061
31636,0.000495,74.125.130.0-255,7156,48758,92,350061
31637,0.000499,172.31.47.0-255,66,48824,92,350061
31638,0.000541,172.31.47.0-255,66,48890,92,350061
31639,0.000582,74.125.130.0-255,98,48988,92,350061
31640,0.000674,172.31.47.0-255,66,49054,92,350061
31641,0.000777,74.125.130.0-255,1484,50538,92,350061
31642,0.000792,74.125.130.0-255,2902,53440,92,350061
31643,0.000795,172.31.47.0-255,66,53506,92,350061
31644,0.000811,74.125.130.0-255,1484,54990,92,350061
31645,0.000834,74.125.130.0-255,4320,59310,92,350061
31646,0.000837,172.31.47.0-255,66,59376,92,350061
31647,0.00084,74.125.130.0-255,1484,60860,92,350061
31648,0.000878,74.125.130.0-255,2902,63762,92,350061
31649,0.000881,172.31.47.0-255,66,63828,92,350061
31650,0.000903,74.125.130.0-255,6797,70625,92,350061
31651,0.000906,172.31.47.0-255,66,70691,92,350061
31652,0.000918,74.125.130.0-255,1484,72175,92,350061
31653,0.000938,172.31.47.0-255,66,72241,92,350061
31654,0.000941,74.125.130.0-255,1484,73725,92,350061
31655,0.00098,74.125.130.0-255,1400,75125,92,350061
31656,0.000983,172.31.47.0-255,66,75191,92,350061
31657,0.001194,74.125.130.0-255,1484,76675,92,350061
31658,0.001214,74.125.130.0-255,2902,79577,92,350061
31659,0.001218,172.31.47.0-255,66,79643,92,350061
31660,0.001221,74.125.130.0-255,1484,81127,92,350061
31661,0.001239,74.125.130.0-255,4320,85447,92,350061
31662,0.001242,172.31.47.0-255,66,85513,92,350061
31663,0.001245,74.125.130.0-255,2902,88415,92,350061
31664,0.001247,172.31.47.0-255,66,88481,92,350061
31665,0.001256,74.125.130.0-255,1484,89965,92,350061
31666,0.001272,74.125.130.0-255,2902,92867,92,350061
31667,0.001274,172.31.47.0-255,66,92933,92,350061
31668,0.001279,74.125.130.0-255,7156,100089,92,350061
31669,0.001281,172.31.47.0-255,66,100155,92,350061
31670,0.001291,74.125.130.0-255,1484,101639,92,350061
31671,0.001295,74.125.130.0-255,4320,105959,92,350061
31672,0.001297,172.31.47.0-255,66,106025,92,350061
31673,0.001339,74.125.130.0-255,1484,107509,92,350061
31674,0.001349,74.125.130.0-255,2184,109693,92,350061
31675,0.001351,172.31.47.0-255,66,109759,92,350061
31676,0.001447,74.125.130.0-255,1484,111243,92,350061
31677,0.001462,74.125.130.0-255,2902,114145,92,350061
31678,0.001464,172.31.47.0-255,66,114211,92,350061
31679,0.001466,74.125.130.0-255,1484,115695,92,350061
31680,0.001483,74.125.130.0-255,4320,120015,92,350061
31681,0.001485,172.31.47.0-255,66,120081,92,350061
31682,0.001493,74.125.130.0-255,1484,121565,92,350061
31683,0.001504,74.125.130.0-255,4320,125885,92,350061
31684,0.001506,172.31.47.0-255,66,125951,92,350061
31685,0.001526,74.125.130.0-255,7156,133107,92,350061
31686,0.001528,172.31.47.0-255,66,133173,92,350061
31687,0.001551,74.125.130.0-255,7156,140329,92,350061
31688,0.001552,172.31.47.0-255,66,140395,92,350061
31689,0.001569,74.125.130.0-255,2902,143297,92,350061
31690,0.001571,172.31.47.0-255,66,143363,92,350061
31691,0.001586,74.125.130.0-255,766,144129,92,350061
31692,0.001667,74.125.130.0-255,1484,145613,92,350061
31693,0.001669,172.31.47.0-255,66,145679,92,350061
31694,0.00168,74.125.130.0-255,2902,148581,92,350061
31695,0.001682,172.31.47.0-255,66,148647,92,350061
31696,0.001708,74.125.130.0-255,1484,150131,92,350061
31697,0.001712,74.125.130.0-255,2902,153033,92,350061
31698,0.001714,172.31.47.0-255,66,153099,92,350061
31699,0.001719,74.125.130.0-255,5738,158837,92,350061
31700,0.001721,172.31.47.0-255,66,158903,92,350061
31701,0.001743,74.125.130.0-255,2902,161805,92,350061
31702,0.001744,172.31.47.0-255,66,161871,92,350061
31703,0.001766,74.125.130.0-255,7156,169027,92,350061
31704,0.001768,172.31.47.0-255,66,169093,92,350061
31705,0.001813,74.125.130.0-255,4320,173413,92,350061
31706,0.001815,172.31.47.0-255,66,173479,92,350061
31707,0.001835,74.125.130.0-255,5020,178499,92,350061
31708,0.001837,172.31.47.0-255,66,178565,92,350061
31709,0.002019,74.125.130.0-255,1484,180049,92,350061
31710,0.002034,74.125.130.0-255,2902,182951,92,350061
31711,0.002036,172.31.47.0-255,66,183017,92,350061
31712,0.002054,74.125.130.0-255,4320,187337,92,350061
31713,0.002056,172.31.47.0-255,66,187403,92,350061
31714,0.00207,74.125.130.0-255,1484,188887,92,350061
31715,0.002089,74.125.130.0-255,4320,193207,92,350061
31716,0.002091,172.31.47.0-255,66,193273,92,350061
31717,0.002136,74.125.130.0-255,5738,199011,92,350061
31718,0.002138,172.31.47.0-255,66,199077,92,350061
31719,0.002143,74.125.130.0-255,7156,206233,92,350061
31720,0.002145,172.31.47.0-255,66,206299,92,350061
31721,0.002147,74.125.130.0-255,1484,207783,92,350061
31722,0.002169,74.125.130.0-255,2902,210685,92,350061
31723,0.00217,172.31.47.0-255,66,210751,92,350061
31724,0.00221,74.125.130.0-255,2184,212935,92,350061
31725,0.002212,172.31.47.0-255,66,213001,92,350061
31726,0.004693,74.125.130.0-255,2902,215903,92,350061
31727,0.004698,172.31.47.0-255,66,215969,92,350061
31728,0.004733,74.125.130.0-255,2902,218871,92,350061
31729,0.004735,172.31.47.0-255,66,218937,92,350061
31730,0.00725,74.125.130.0-255,2902,221839,92,350061
31731,0.007258,172.31.47.0-255,66,221905,92,350061
31732,0.007278,74.125.130.0-255,2902,224807,92,350061
31733,0.007284,172.31.47.0-255,66,224873,92,350061
31734,0.009793,74.125.130.0-255,2902,227775,92,350061
31735,0.009801,172.31.47.0-255,66,227841,92,350061
31736,0.009821,74.125.130.0-255,2902,230743,92,350061
31737,0.009824,172.31.47.0-255,66,230809,92,350061
31738,0.012335,74.125.130.0-255,2902,233711,92,350061
31739,0.012343,172.31.47.0-255,66,233777,92,350061
31740,0.012367,74.125.130.0-255,2902,236679,92,350061
31741,0.012371,172.31.47.0-255,66,236745,92,350061
31742,0.014896,74.125.130.0-255,5738,242483,92,350061
31743,0.014909,172.31.47.0-255,66,242549,92,350061
31744,0.017452,74.125.130.0-255,5738,248287,92,350061
31745,0.017464,172.31.47.0-255,66,248353,92,350061
31746,0.020001,74.125.130.0-255,5738,254091,92,350061
31747,0.020009,172.31.47.0-255,66,254157,92,350061
31748,0.022548,74.125.130.0-255,5738,259895,92,350061
31749,0.022554,172.31.47.0-255,66,259961,92,350061
31750,0.025102,74.125.130.0-255,5738,265699,92,350061
31751,0.025111,172.31.47.0-255,66,265765,92,350061
31752,0.027653,74.125.130.0-255,5738,271503,92,350061
31753,0.027665,172.31.47.0-255,66,271569,92,350061
31754,0.030224,74.125.130.0-255,5738,277307,92,350061
31755,0.030231,172.31.47.0-255,66,277373,92,350061
31756,0.032774,74.125.130.0-255,5738,283111,92,350061
31757,0.032784,172.31.47.0-255,66,283177,92,350061
31758,0.035261,172.31.47.0-255,172,283349,92,350061
31759,0.035293,172.31.47.0-255,1112,284461,92,350061
31760,0.035315,74.125.130.0-255,2902,287363,92,350061
31761,0.03532,172.31.47.0-255,66,287429,92,350061
31762,0.035337,172.31.47.0-255,1514,288943,92,350061
31763,0.035339,172.31.47.0-255,1514,290457,92,350061
31764,0.035339,74.125.130.0-255,2902,293359,92,350061
31765,0.03534,172.31.47.0-255,1514,294873,92,350061
31766,0.035341,172.31.47.0-255,1514,296387,92,350061
31767,0.035342,172.31.47.0-255,1494,297881,92,350061
31768,0.035343,172.31.47.0-255,66,297947,92,350061
31769,0.036882,104.244.42.0-255,66,298013,92,350061
31770,0.036891,104.244.42.0-255,66,298079,92,350061
31771,0.036909,104.244.42.0-255,66,298145,92,350061
31772,0.037801,104.244.42.0-255,108,298253,92,350061
31773,0.037806,172.31.47.0-255,66,298319,92,350061
31774,0.037854,74.125.130.0-255,1484,299803,92,350061
31775,0.037867,74.125.130.0-255,1484,301287,92,350061
31776,0.03787,172.31.47.0-255,66,301353,92,350061
31777,0.037887,74.125.130.0-255,2902,304255,92,350061
31778,0.03789,172.31.47.0-255,66,304321,92,350061
31779,0.040411,74.125.130.0-255,4320,308641,92,350061
31780,0.040416,172.31.47.0-255,66,308707,92,350061
31781,0.040438,74.125.130.0-255,1484,310191,92,350061
31782,0.042951,74.125.130.0-255,4320,314511,92,350061
31783,0.042957,172.31.47.0-255,66,314577,92,350061
31784,0.045493,74.125.130.0-255,5738,320315,92,350061
31785,0.0455,172.31.47.0-255,66,320381,92,350061
31786,0.048026,74.125.130.0-255,2902,323283,92,350061
31787,0.04803,172.31.47.0-255,66,323349,92,350061
31788,0.048058,74.125.130.0-255,2902,326251,92,350061
31789,0.048061,172.31.47.0-255,66,326317,92,350061
31790,0.050555,74.125.130.0-255,2902,329219,92,350061
31791,0.05056,172.31.47.0-255,66,329285,92,350061
31792,0.050588,74.125.130.0-255,2902,332187,92,350061
31793,0.050591,172.31.47.0-255,66,332253,92,350061
31794,0.053086,74.125.130.0-255,2902,335155,92,350061
31795,0.053091,172.31.47.0-255,66,335221,92,350061
31796,0.053117,74.125.130.0-255,2902,338123,92,350061
31797,0.053119,172.31.47.0-255,66,338189,92,350061
31798,0.055616,74.125.130.0-255,2902,341091,92,350061
31799,0.055622,172.31.47.0-255,66,341157,92,350061
31800,0.055651,74.125.130.0-255,2902,344059,92,350061
31801,0.055653,172.31.47.0-255,66,344125,92,350061
31802,0.05815,74.125.130.0-255,2902,347027,92,350061
31803,0.058155,172.31.47.0-255,66,347093,92,350061
31804,0.058179,74.125.130.0-255,2902,349995,92,350061
31805,0.058182,172.31.47.0-255,66,350061,92,350061
31806,0.0,74.125.24.0-255,297,297,92,258418
31807,4.3e-05,172.31.47.0-255,66,363,92,258418
31808,5e-05,74.125.24.0-255,1484,1847,92,258418
31809,5.5e-05,172.31.47.0-255,66,1913,92,258418
31810,6e-05,74.125.24.0-255,2902,4815,92,258418
31811,6.3e-05,172.31.47.0-255,66,4881,92,258418
31812,8.6e-05,74.125.24.0-255,5738,10619,92,258418
31813,8.9e-05,172.31.47.0-255,66,10685,92,258418
31814,0.000114,74.125.24.0-255,4320,15005,92,258418
31815,0.000119,172.31.47.0-255,66,15071,92,258418
31816,0.000127,74.125.24.0-255,1967,17038,92,258418
31817,0.000129,172.31.47.0-255,66,17104,92,258418
31818,0.000132,74.125.24.0-255,1484,18588,92,258418
31819,0.000134,172.31.47.0-255,66,18654,92,258418
31820,0.000163,74.125.24.0-255,7156,25810,92,258418
31821,0.000165,172.31.47.0-255,66,25876,92,258418
31822,0.000184,74.125.24.0-255,5379,31255,92,258418
31823,0.000187,172.31.47.0-255,66,31321,92,258418
31824,0.00034,74.125.24.0-255,1484,32805,92,258418
31825,0.000347,172.31.47.0-255,66,32871,92,258418
31826,0.000354,74.125.24.0-255,2902,35773,92,258418
31827,0.000356,172.31.47.0-255,66,35839,92,258418
31828,0.000362,74.125.24.0-255,5738,41577,92,258418
31829,0.000365,172.31.47.0-255,66,41643,92,258418
31830,0.000402,172.31.47.0-255,66,41709,92,258418
31831,0.000433,74.125.24.0-255,5379,47088,92,258418
31832,0.000438,74.125.24.0-255,4320,51408,92,258418
31833,0.000438,172.31.47.0-255,66,51474,92,258418
31834,0.000444,172.31.47.0-255,66,51540,92,258418
31835,0.000481,74.125.24.0-255,5652,57192,92,258418
31836,0.000486,172.31.47.0-255,66,57258,92,258418
31837,0.001044,74.125.24.0-255,130,57388,92,258418
31838,0.001081,172.31.47.0-255,66,57454,92,258418
31839,0.001132,74.125.24.0-255,1484,58938,92,258418
31840,0.001138,74.125.24.0-255,2902,61840,92,258418
31841,0.001142,172.31.47.0-255,66,61906,92,258418
31842,0.001149,74.125.24.0-255,5738,67644,92,258418
31843,0.001151,172.31.47.0-255,66,67710,92,258418
31844,0.001154,74.125.24.0-255,1484,69194,92,258418
31845,0.001172,74.125.24.0-255,4320,73514,92,258418
31846,0.001175,172.31.47.0-255,66,73580,92,258418
31847,0.00122,172.31.47.0-255,66,73646,92,258418
31848,0.001225,74.125.24.0-255,3961,77607,92,258418
31849,0.001228,172.31.47.0-255,66,77673,92,258418
31850,0.002103,74.125.24.0-255,1484,79157,92,258418
31851,0.002115,74.125.24.0-255,2902,82059,92,258418
31852,0.002122,172.31.47.0-255,66,82125,92,258418
31853,0.002131,74.125.24.0-255,5738,87863,92,258418
31854,0.002134,172.31.47.0-255,66,87929,92,258418
31855,0.002139,74.125.24.0-255,2902,90831,92,258418
31856,0.00214,172.31.47.0-255,66,90897,92,258418
31857,0.002146,74.125.24.0-255,4320,95217,92,258418
31858,0.002148,172.31.47.0-255,66,95283,92,258418
31859,0.002185,74.125.24.0-255,1484,96767,92,258418
31860,0.002188,172.31.47.0-255,66,96833,92,258418
31861,0.002233,74.125.24.0-255,2902,99735,92,258418
31862,0.002237,172.31.47.0-255,66,99801,92,258418
31863,0.002256,74.125.24.0-255,3602,103403,92,258418
31864,0.002259,172.31.47.0-255,66,103469,92,258418
31865,0.002451,74.125.24.0-255,1484,104953,92,258418
31866,0.002458,74.125.24.0-255,2902,107855,92,258418
31867,0.002462,172.31.47.0-255,66,107921,92,258418
31868,0.002484,74.125.24.0-255,5738,113659,92,258418
31869,0.002487,172.31.47.0-255,66,113725,92,258418
31870,0.002491,74.125.24.0-255,2902,116627,92,258418
31871,0.002493,172.31.47.0-255,66,116693,92,258418
31872,0.002515,74.125.24.0-255,4320,121013,92,258418
31873,0.002519,172.31.47.0-255,66,121079,92,258418
31874,0.002525,74.125.24.0-255,5738,126817,92,258418
31875,0.002527,172.31.47.0-255,66,126883,92,258418
31876,0.002564,172.31.47.0-255,66,126949,92,258418
31877,0.002568,74.125.24.0-255,2184,129133,92,258418
31878,0.00257,172.31.47.0-255,66,129199,92,258418
31879,0.002601,172.31.47.0-255,66,129265,92,258418
31880,0.00264,172.31.47.0-255,66,129331,92,258418
31881,0.002651,172.31.47.0-255,66,129397,92,258418
31882,0.002657,74.125.24.0-255,5020,134417,92,258418
31883,0.002659,172.31.47.0-255,66,134483,92,258418
31884,0.005256,74.125.24.0-255,5738,140221,92,258418
31885,0.005272,172.31.47.0-255,66,140287,92,258418
31886,0.007904,74.125.24.0-255,5738,146025,92,258418
31887,0.00792,172.31.47.0-255,66,146091,92,258418
31888,0.010537,74.125.24.0-255,5738,151829,92,258418
31889,0.010553,172.31.47.0-255,66,151895,92,258418
31890,0.013162,74.125.24.0-255,5738,157633,92,258418
31891,0.013179,172.31.47.0-255,66,157699,92,258418
31892,0.015767,74.125.24.0-255,5738,163437,92,258418
31893,0.015786,172.31.47.0-255,66,163503,92,258418
31894,0.018397,74.125.24.0-255,5738,169241,92,258418
31895,0.018415,172.31.47.0-255,66,169307,92,258418
31896,0.021051,74.125.24.0-255,5738,175045,92,258418
31897,0.021069,172.31.47.0-255,66,175111,92,258418
31898,0.023666,74.125.24.0-255,5738,180849,92,258418
31899,0.023685,172.31.47.0-255,66,180915,92,258418
31900,0.026316,74.125.24.0-255,5738,186653,92,258418
31901,0.026336,172.31.47.0-255,66,186719,92,258418
31902,0.028958,74.125.24.0-255,5738,192457,92,258418
31903,0.028979,172.31.47.0-255,66,192523,92,258418
31904,0.031582,74.125.24.0-255,5738,198261,92,258418
31905,0.031601,172.31.47.0-255,66,198327,92,258418
31906,0.034219,74.125.24.0-255,5738,204065,92,258418
31907,0.034238,172.31.47.0-255,66,204131,92,258418
31908,0.0369,74.125.24.0-255,5738,209869,92,258418
31909,0.036917,172.31.47.0-255,66,209935,92,258418
31910,0.039569,74.125.24.0-255,5738,215673,92,258418
31911,0.039613,172.31.47.0-255,66,215739,92,258418
31912,0.042209,74.125.24.0-255,5738,221477,92,258418
31913,0.042227,172.31.47.0-255,66,221543,92,258418
31914,0.043077,172.31.47.0-255,172,221715,92,258418
31915,0.043104,172.31.47.0-255,1111,222826,92,258418
31916,0.043146,172.31.47.0-255,570,223396,92,258418
31917,0.044672,104.244.42.0-255,66,223462,92,258418
31918,0.044688,104.244.42.0-255,66,223528,92,258418
31919,0.044756,104.244.42.0-255,66,223594,92,258418
31920,0.04478,74.125.24.0-255,5738,229332,92,258418
31921,0.044792,172.31.47.0-255,66,229398,92,258418
31922,0.04737,74.125.24.0-255,5738,235136,92,258418
31923,0.047388,172.31.47.0-255,66,235202,92,258418
31924,0.049972,74.125.24.0-255,5738,240940,92,258418
31925,0.049986,172.31.47.0-255,66,241006,92,258418
31926,0.052552,74.125.24.0-255,5738,246744,92,258418
31927,0.052567,172.31.47.0-255,66,246810,92,258418
31928,0.055141,74.125.24.0-255,5738,252548,92,258418
31929,0.055158,172.31.47.0-255,66,252614,92,258418
31930,0.057733,74.125.24.0-255,5738,258352,92,258418
31931,0.057748,172.31.47.0-255,66,258418,92,258418
31932,0.0,74.125.24.0-255,297,297,92,299971
31933,2.4e-05,172.31.47.0-255,66,363,92,299971
31934,3e-05,74.125.24.0-255,1484,1847,92,299971
31935,3.3e-05,172.31.47.0-255,66,1913,92,299971
31936,3.8e-05,74.125.24.0-255,4320,6233,92,299971
31937,4.6e-05,172.31.47.0-255,66,6299,92,299971
31938,5.7e-05,172.31.47.0-255,66,6365,92,299971
31939,9.5e-05,172.31.47.0-255,66,6431,92,299971
31940,0.000114,74.125.24.0-255,3961,10392,92,299971
31941,0.000117,172.31.47.0-255,66,10458,92,299971
31942,0.000139,74.125.24.0-255,1484,11942,92,299971
31943,0.000141,172.31.47.0-255,66,12008,92,299971
31944,0.000144,74.125.24.0-255,1484,13492,92,299971
31945,0.000146,172.31.47.0-255,66,13558,92,299971
31946,0.000176,74.125.24.0-255,1484,15042,92,299971
31947,0.000178,172.31.47.0-255,66,15108,92,299971
31948,0.000184,74.125.24.0-255,5738,20846,92,299971
31949,0.000186,172.31.47.0-255,66,20912,92,299971
31950,0.000192,74.125.24.0-255,6797,27709,92,299971
31951,0.000194,172.31.47.0-255,66,27775,92,299971
31952,0.000196,74.125.24.0-255,1484,29259,92,299971
31953,0.000198,172.31.47.0-255,66,29325,92,299971
31954,0.000235,172.31.47.0-255,66,29391,92,299971
31955,0.000238,74.125.24.0-255,1484,30875,92,299971
31956,0.000241,172.31.47.0-255,66,30941,92,299971
31957,0.000264,74.125.24.0-255,1395,32336,92,299971
31958,0.000267,172.31.47.0-255,66,32402,92,299971
31959,0.00027,74.125.24.0-255,130,32532,92,299971
31960,0.000272,172.31.47.0-255,66,32598,92,299971
31961,0.000344,74.125.24.0-255,1484,34082,92,299971
31962,0.000366,74.125.24.0-255,2902,36984,92,299971
31963,0.000369,172.31.47.0-255,66,37050,92,299971
31964,0.000375,74.125.24.0-255,5738,42788,92,299971
31965,0.000376,172.31.47.0-255,66,42854,92,299971
31966,0.000379,74.125.24.0-255,1484,44338,92,299971
31967,0.000402,74.125.24.0-255,5379,49717,92,299971
31968,0.000405,172.31.47.0-255,66,49783,92,299971
31969,0.000432,74.125.24.0-255,4320,54103,92,299971
31970,0.000434,172.31.47.0-255,66,54169,92,299971
31971,0.000471,172.31.47.0-255,66,54235,92,299971
31972,0.000475,74.125.24.0-255,2249,56484,92,299971
31973,0.000476,172.31.47.0-255,66,56550,92,299971
31974,0.0005,74.125.24.0-255,5738,62288,92,299971
31975,0.000503,172.31.47.0-255,66,62354,92,299971
31976,0.000524,74.125.24.0-255,2902,65256,92,299971
31977,0.000528,172.31.47.0-255,66,65322,92,299971
31978,0.000535,74.125.24.0-255,5738,71060,92,299971
31979,0.000536,172.31.47.0-255,66,71126,92,299971
31980,0.000566,74.125.24.0-255,3961,75087,92,299971
31981,0.000569,172.31.47.0-255,66,75153,92,299971
31982,0.000575,74.125.24.0-255,7156,82309,92,299971
31983,0.000577,172.31.47.0-255,66,82375,92,299971
31984,0.00061,172.31.47.0-255,66,82441,92,299971
31985,0.000868,74.125.24.0-255,1484,83925,92,299971
31986,0.000873,74.125.24.0-255,2902,86827,92,299971
31987,0.000876,172.31.47.0-255,66,86893,92,299971
31988,0.000881,74.125.24.0-255,5738,92631,92,299971
31989,0.000882,172.31.47.0-255,66,92697,92,299971
31990,0.000948,74.125.24.0-255,6797,99494,92,299971
31991,0.000951,172.31.47.0-255,66,99560,92,299971
31992,0.001083,74.125.24.0-255,1484,101044,92,299971
31993,0.001088,74.125.24.0-255,2902,103946,92,299971
31994,0.001091,172.31.47.0-255,66,104012,92,299971
31995,0.001115,74.125.24.0-255,5738,109750,92,299971
31996,0.001118,172.31.47.0-255,66,109816,92,299971
31997,0.001169,74.125.24.0-255,4320,114136,92,299971
31998,0.001172,172.31.47.0-255,66,114202,92,299971
31999,0.00119,74.125.24.0-255,2543,116745,92,299971
32000,0.001193,172.31.47.0-255,66,116811,92,299971
32001,0.001657,74.125.24.0-255,1484,118295,92,299971
32002,0.001667,74.125.24.0-255,2902,121197,92,299971
32003,0.001671,172.31.47.0-255,66,121263,92,299971
32004,0.001677,74.125.24.0-255,5738,127001,92,299971
32005,0.001679,172.31.47.0-255,66,127067,92,299971
32006,0.001709,74.125.24.0-255,2902,129969,92,299971
32007,0.001711,172.31.47.0-255,66,130035,92,299971
32008,0.001756,74.125.24.0-255,766,130801,92,299971
32009,0.001761,172.31.47.0-255,66,130867,92,299971
32010,0.001763,172.31.47.0-255,66,130933,92,299971
32011,0.001893,74.125.24.0-255,1484,132417,92,299971
32012,0.001898,172.31.47.0-255,66,132483,92,299971
32013,0.001903,74.125.24.0-255,2902,135385,92,299971
32014,0.001905,172.31.47.0-255,66,135451,92,299971
32015,0.001909,74.125.24.0-255,5738,141189,92,299971
32016,0.001911,172.31.47.0-255,66,141255,92,299971
32017,0.001947,172.31.47.0-255,66,141321,92,299971
32018,0.001984,74.125.24.0-255,5738,147059,92,299971
32019,0.001987,172.31.47.0-255,66,147125,92,299971
32020,0.00202,172.31.47.0-255,66,147191,92,299971
32021,0.004295,74.125.24.0-255,5738,152929,92,299971
32022,0.004301,172.31.47.0-255,66,152995,92,299971
32023,0.00654,74.125.24.0-255,4320,157315,92,299971
32024,0.006544,172.31.47.0-255,66,157381,92,299971
32025,0.006566,74.125.24.0-255,1484,158865,92,299971
32026,0.008811,74.125.24.0-255,4320,163185,92,299971
32027,0.008819,172.31.47.0-255,66,163251,92,299971
32028,0.011093,74.125.24.0-255,5738,168989,92,299971
32029,0.0111,172.31.47.0-255,66,169055,92,299971
32030,0.013377,74.125.24.0-255,5738,174793,92,299971
32031,0.013388,172.31.47.0-255,66,174859,92,299971
32032,0.015657,74.125.24.0-255,5738,180597,92,299971
32033,0.015669,172.31.47.0-255,66,180663,92,299971
32034,0.017935,74.125.24.0-255,5738,186401,92,299971
32035,0.017942,172.31.47.0-255,66,186467,92,299971
32036,0.020225,74.125.24.0-255,5738,192205,92,299971
32037,0.02024,172.31.47.0-255,66,192271,92,299971
32038,0.022554,74.125.24.0-255,5738,198009,92,299971
32039,0.02257,172.31.47.0-255,66,198075,92,299971
32040,0.024849,74.125.24.0-255,5738,203813,92,299971
32041,0.024861,172.31.47.0-255,66,203879,92,299971
32042,0.027151,74.125.24.0-255,5738,209617,92,299971
32043,0.027165,172.31.47.0-255,66,209683,92,299971
32044,0.029471,74.125.24.0-255,5738,215421,92,299971
32045,0.029487,172.31.47.0-255,66,215487,92,299971
32046,0.031776,74.125.24.0-255,5738,221225,92,299971
32047,0.031789,172.31.47.0-255,66,221291,92,299971
32048,0.032402,172.31.47.0-255,172,221463,92,299971
32049,0.032434,172.31.47.0-255,1111,222574,92,299971
32050,0.032513,172.31.47.0-255,1514,224088,92,299971
32051,0.032514,172.31.47.0-255,1514,225602,92,299971
32052,0.032516,172.31.47.0-255,1514,227116,92,299971
32053,0.032517,172.31.47.0-255,1514,228630,92,299971
32054,0.032518,172.31.47.0-255,1495,230125,92,299971
32055,0.033957,104.244.42.0-255,66,230191,92,299971
32056,0.034005,104.244.42.0-255,66,230257,92,299971
32057,0.034085,74.125.24.0-255,5738,235995,92,299971
32058,0.034091,172.31.47.0-255,66,236061,92,299971
32059,0.034124,104.244.42.0-255,66,236127,92,299971
32060,0.036373,74.125.24.0-255,5738,241865,92,299971
32061,0.036385,172.31.47.0-255,66,241931,92,299971
32062,0.038722,74.125.24.0-255,5738,247669,92,299971
32063,0.038734,172.31.47.0-255,66,247735,92,299971
32064,0.041017,74.125.24.0-255,5738,253473,92,299971
32065,0.041028,172.31.47.0-255,66,253539,92,299971
32066,0.043312,74.125.24.0-255,5738,259277,92,299971
32067,0.043329,172.31.47.0-255,66,259343,92,299971
32068,0.045617,74.125.24.0-255,5738,265081,92,299971
32069,0.045633,172.31.47.0-255,66,265147,92,299971
32070,0.047923,74.125.24.0-255,5738,270885,92,299971
32071,0.047942,172.31.47.0-255,66,270951,92,299971
32072,0.050243,74.125.24.0-255,5738,276689,92,299971
32073,0.050262,172.31.47.0-255,66,276755,92,299971
32074,0.052552,74.125.24.0-255,5738,282493,92,299971
32075,0.052572,172.31.47.0-255,66,282559,92,299971
32076,0.054864,74.125.24.0-255,5738,288297,92,299971
32077,0.054875,172.31.47.0-255,66,288363,92,299971
32078,0.057143,74.125.24.0-255,5738,294101,92,299971
32079,0.057156,172.31.47.0-255,66,294167,92,299971
32080,0.059461,74.125.24.0-255,5738,299905,92,299971
32081,0.059475,172.31.47.0-255,66,299971,92,299971
32082,0.0,172.31.47.0-255,105,105,92,105
32083,0.0,74.125.68.0-255,153,153,92,357474
32084,2.7e-05,172.31.47.0-255,66,219,92,357474
32085,3.3e-05,74.125.68.0-255,1484,1703,92,357474
32086,3.8e-05,172.31.47.0-255,66,1769,92,357474
32087,5.6e-05,74.125.68.0-255,2902,4671,92,357474
32088,5.9e-05,172.31.47.0-255,66,4737,92,357474
32089,6.2e-05,74.125.68.0-255,1484,6221,92,357474
32090,6.4e-05,172.31.47.0-255,66,6287,92,357474
32091,6.8e-05,74.125.68.0-255,2902,9189,92,357474
32092,7e-05,172.31.47.0-255,66,9255,92,357474
32093,0.000117,74.125.68.0-255,2902,12157,92,357474
32094,0.00012,172.31.47.0-255,66,12223,92,357474
32095,0.000139,74.125.68.0-255,2064,14287,92,357474
32096,0.000142,172.31.47.0-255,66,14353,92,357474
32097,0.00025,74.125.68.0-255,1484,15837,92,357474
32098,0.000254,172.31.47.0-255,66,15903,92,357474
32099,0.000268,74.125.68.0-255,2902,18805,92,357474
32100,0.000271,172.31.47.0-255,66,18871,92,357474
32101,0.000291,74.125.68.0-255,5738,24609,92,357474
32102,0.000294,172.31.47.0-255,66,24675,92,357474
32103,0.000309,74.125.68.0-255,1484,26159,92,357474
32104,0.000311,172.31.47.0-255,66,26225,92,357474
32105,0.00033,74.125.68.0-255,5379,31604,92,357474
32106,0.000333,172.31.47.0-255,66,31670,92,357474
32107,0.000352,74.125.68.0-255,7156,38826,92,357474
32108,0.000355,172.31.47.0-255,66,38892,92,357474
32109,0.00036,74.125.68.0-255,2902,41794,92,357474
32110,0.000362,172.31.47.0-255,66,41860,92,357474
32111,0.000388,74.125.68.0-255,4320,46180,92,357474
32112,0.000391,172.31.47.0-255,66,46246,92,357474
32113,0.000402,172.31.47.0-255,66,46312,92,357474
32114,0.000448,172.31.47.0-255,66,46378,92,357474
32115,0.00045,74.125.68.0-255,412,46790,92,357474
32116,0.000481,74.125.68.0-255,332,47122,92,357474
32117,0.000699,74.125.68.0-255,1484,48606,92,357474
32118,0.000703,172.31.47.0-255,66,48672,92,357474
32119,0.000708,74.125.68.0-255,2902,51574,92,357474
32120,0.00071,172.31.47.0-255,66,51640,92,357474
32121,0.000713,74.125.68.0-255,1484,53124,92,357474
32122,0.000717,74.125.68.0-255,2902,56026,92,357474
32123,0.00072,172.31.47.0-255,66,56092,92,357474
32124,0.000747,74.125.68.0-255,5738,61830,92,357474
32125,0.000749,172.31.47.0-255,66,61896,92,357474
32126,0.000767,74.125.68.0-255,4320,66216,92,357474
32127,0.00077,172.31.47.0-255,66,66282,92,357474
32128,0.000787,74.125.68.0-255,2902,69184,92,357474
32129,0.00079,172.31.47.0-255,66,69250,92,357474
32130,0.000796,74.125.68.0-255,7156,76406,92,357474
32131,0.000798,172.31.47.0-255,66,76472,92,357474
32132,0.000816,74.125.68.0-255,1484,77956,92,357474
32133,0.000821,74.125.68.0-255,3602,81558,92,357474
32134,0.000823,172.31.47.0-255,66,81624,92,357474
32135,0.00087,74.125.68.0-255,1484,83108,92,357474
32136,0.000884,74.125.68.0-255,2902,86010,92,357474
32137,0.000886,172.31.47.0-255,66,86076,92,357474
32138,0.000904,74.125.68.0-255,5738,91814,92,357474
32139,0.000907,172.31.47.0-255,66,91880,92,357474
32140,0.000911,74.125.68.0-255,2902,94782,92,357474
32141,0.000912,172.31.47.0-255,66,94848,92,357474
32142,0.000937,74.125.68.0-255,1484,96332,92,357474
32143,0.000963,172.31.47.0-255,66,96398,92,357474
32144,0.000968,74.125.68.0-255,4320,100718,92,357474
32145,0.000971,172.31.47.0-255,66,100784,92,357474
32146,0.000985,74.125.68.0-255,4320,105104,92,357474
32147,0.000988,172.31.47.0-255,66,105170,92,357474
32148,0.001018,74.125.68.0-255,2184,107354,92,357474
32149,0.001021,172.31.47.0-255,66,107420,92,357474
32150,0.001045,74.125.68.0-255,2902,110322,92,357474
32151,0.001048,172.31.47.0-255,66,110388,92,357474
32152,0.001059,74.125.68.0-255,1484,111872,92,357474
32153,0.001074,74.125.68.0-255,2902,114774,92,357474
32154,0.001076,172.31.47.0-255,66,114840,92,357474
32155,0.001082,74.125.68.0-255,5738,120578,92,357474
32156,0.001084,172.31.47.0-255,66,120644,92,357474
32157,0.001114,74.125.68.0-255,5738,126382,92,357474
32158,0.001117,172.31.47.0-255,66,126448,92,357474
32159,0.001139,74.125.68.0-255,5738,132186,92,357474
32160,0.001142,172.31.47.0-255,66,132252,92,357474
32161,0.001146,74.125.68.0-255,4320,136572,92,357474
32162,0.001148,172.31.47.0-255,66,136638,92,357474
32163,0.001177,74.125.68.0-255,5020,141658,92,357474
32164,0.001181,172.31.47.0-255,66,141724,92,357474
32165,0.001231,74.125.68.0-255,1484,143208,92,357474
32166,0.001258,74.125.68.0-255,2902,146110,92,357474
32167,0.001261,172.31.47.0-255,66,146176,92,357474
32168,0.001275,74.125.68.0-255,4320,150496,92,357474
32169,0.001278,172.31.47.0-255,66,150562,92,357474
32170,0.001281,74.125.68.0-255,1484,152046,92,357474
32171,0.001302,74.125.68.0-255,4320,156366,92,357474
32172,0.001304,172.31.47.0-255,66,156432,92,357474
32173,0.001316,74.125.68.0-255,4320,160752,92,357474
32174,0.001319,172.31.47.0-255,66,160818,92,357474
32175,0.001333,74.125.68.0-255,7156,167974,92,357474
32176,0.001336,172.31.47.0-255,66,168040,92,357474
32177,0.001339,74.125.68.0-255,2902,170942,92,357474
32178,0.001341,172.31.47.0-255,66,171008,92,357474
32179,0.001375,74.125.68.0-255,1484,172492,92,357474
32180,0.001391,74.125.68.0-255,3602,176094,92,357474
32181,0.001393,172.31.47.0-255,66,176160,92,357474
32182,0.001447,74.125.68.0-255,1484,177644,92,357474
32183,0.001458,74.125.68.0-255,2902,180546,92,357474
32184,0.001461,172.31.47.0-255,66,180612,92,357474
32185,0.001482,74.125.68.0-255,4320,184932,92,357474
32186,0.001484,172.31.47.0-255,66,184998,92,357474
32187,0.001504,74.125.68.0-255,1484,186482,92,357474
32188,0.00151,74.125.68.0-255,7156,193638,92,357474
32189,0.001513,172.31.47.0-255,66,193704,92,357474
32190,0.001536,74.125.68.0-255,1484,195188,92,357474
32191,0.001549,74.125.68.0-255,4320,199508,92,357474
32192,0.001551,172.31.47.0-255,66,199574,92,357474
32193,0.001575,74.125.68.0-255,7156,206730,92,357474
32194,0.001578,172.31.47.0-255,66,206796,92,357474
32195,0.001597,74.125.68.0-255,3602,210398,92,357474
32196,0.0016,172.31.47.0-255,66,210464,92,357474
32197,0.001638,74.125.68.0-255,1484,211948,92,357474
32198,0.001641,74.125.68.0-255,1484,213432,92,357474
32199,0.001643,172.31.47.0-255,66,213498,92,357474
32200,0.001658,74.125.68.0-255,1484,214982,92,357474
32201,0.001686,74.125.68.0-255,5738,220720,92,357474
32202,0.001689,172.31.47.0-255,66,220786,92,357474
32203,0.001692,74.125.68.0-255,1484,222270,92,357474
32204,0.001698,74.125.68.0-255,1484,223754,92,357474
32205,0.0017,172.31.47.0-255,66,223820,92,357474
32206,0.001712,74.125.68.0-255,1484,225304,92,357474
32207,0.001734,74.125.68.0-255,5738,231042,92,357474
32208,0.001737,172.31.47.0-255,66,231108,92,357474
32209,0.00174,74.125.68.0-255,1484,232592,92,357474
32210,0.001757,74.125.68.0-255,2902,235494,92,357474
32211,0.001759,172.31.47.0-255,66,235560,92,357474
32212,0.001775,74.125.68.0-255,4320,239880,92,357474
32213,0.001777,172.31.47.0-255,66,239946,92,357474
32214,0.001795,74.125.68.0-255,1484,241430,92,357474
32215,0.001799,74.125.68.0-255,3602,245032,92,357474
32216,0.001801,172.31.47.0-255,66,245098,92,357474
32217,0.001811,74.125.68.0-255,1484,246582,92,357474
32218,0.001827,74.125.68.0-255,2902,249484,92,357474
32219,0.001829,172.31.47.0-255,66,249550,92,357474
32220,0.001832,74.125.68.0-255,1484,251034,92,357474
32221,0.001851,74.125.68.0-255,5738,256772,92,357474
32222,0.001853,172.31.47.0-255,66,256838,92,357474
32223,0.001882,172.31.47.0-255,66,256904,92,357474
32224,0.001913,172.31.47.0-255,66,256970,92,357474
32225,0.001939,74.125.68.0-255,2184,259154,92,357474
32226,0.001943,172.31.47.0-255,66,259220,92,357474
32227,0.001975,74.125.68.0-255,2902,262122,92,357474
32228,0.001978,172.31.47.0-255,66,262188,92,357474
32229,0.00199,74.125.68.0-255,4320,266508,92,357474
32230,0.001992,172.31.47.0-255,66,266574,92,357474
32231,0.002011,74.125.68.0-255,2902,269476,92,357474
32232,0.002014,172.31.47.0-255,66,269542,92,357474
32233,0.002023,172.31.47.0-255,66,269608,92,357474
32234,0.002039,74.125.68.0-255,2902,272510,92,357474
32235,0.002042,172.31.47.0-255,66,272576,92,357474
32236,0.002059,172.31.47.0-255,66,272642,92,357474
32237,0.002095,74.125.68.0-255,2902,275544,92,357474
32238,0.002098,172.31.47.0-255,66,275610,92,357474
32239,0.002129,172.31.47.0-255,66,275676,92,357474
32240,0.002133,74.125.68.0-255,4320,279996,92,357474
32241,0.002139,172.31.47.0-255,66,280062,92,357474
32242,0.00218,172.31.47.0-255,66,280128,92,357474
32243,0.002185,74.125.68.0-255,5738,285866,92,357474
32244,0.002187,172.31.47.0-255,66,285932,92,357474
32245,0.002192,74.125.68.0-255,6438,292370,92,357474
32246,0.002194,172.31.47.0-255,66,292436,92,357474
32247,0.002273,74.125.68.0-255,1484,293920,92,357474
32248,0.002288,74.125.68.0-255,2902,296822,92,357474
32249,0.002292,172.31.47.0-255,66,296888,92,357474
32250,0.002296,74.125.68.0-255,1484,298372,92,357474
32251,0.002316,74.125.68.0-255,2902,301274,92,357474
32252,0.00232,172.31.47.0-255,66,301340,92,357474
32253,0.002353,74.125.68.0-255,5738,307078,92,357474
32254,0.002357,172.31.47.0-255,66,307144,92,357474
32255,0.004658,74.125.68.0-255,4320,311464,92,357474
32256,0.004664,172.31.47.0-255,66,311530,92,357474
32257,0.004682,74.125.68.0-255,1484,313014,92,357474
32258,0.006969,74.125.68.0-255,4320,317334,92,357474
32259,0.006975,172.31.47.0-255,66,317400,92,357474
32260,0.009284,74.125.68.0-255,5738,323138,92,357474
32261,0.009289,172.31.47.0-255,66,323204,92,357474
32262,0.011586,74.125.68.0-255,4320,327524,92,357474
32263,0.011589,172.31.47.0-255,66,327590,92,357474
32264,0.011604,74.125.68.0-255,1484,329074,92,357474
32265,0.013894,74.125.68.0-255,4320,333394,92,357474
32266,0.013897,172.31.47.0-255,66,333460,92,357474
32267,0.016208,74.125.68.0-255,5738,339198,92,357474
32268,0.016215,172.31.47.0-255,66,339264,92,357474
32269,0.018555,74.125.68.0-255,5738,345002,92,357474
32270,0.018563,172.31.47.0-255,66,345068,92,357474
32271,0.020862,74.125.68.0-255,3135,348203,92,357474
32272,0.020868,172.31.47.0-255,66,348269,92,357474
32273,0.02365,172.31.47.0-255,105,348374,92,357474
32274,0.02591,74.125.68.0-255,66,348440,92,357474
32275,0.042769,172.31.47.0-255,172,348612,92,357474
32276,0.042799,172.31.47.0-255,1107,349719,92,357474
32277,0.042848,172.31.47.0-255,1514,351233,92,357474
32278,0.04285,172.31.47.0-255,1514,352747,92,357474
32279,0.042852,172.31.47.0-255,1514,354261,92,357474
32280,0.042853,172.31.47.0-255,1514,355775,92,357474
32281,0.042878,172.31.47.0-255,1501,357276,92,357474
32282,0.044269,104.244.42.0-255,66,357342,92,357474
32283,0.044287,104.244.42.0-255,66,357408,92,357474
32284,0.044393,104.244.42.0-255,66,357474,92,357474
32285,0.0,172.31.47.0-255,105,105,92,105
32286,0.0,172.217.194.0-255,431,431,92,95085
32287,2.8e-05,172.217.194.0-255,1484,1915,92,95085
32288,3.9e-05,172.31.47.0-255,66,1981,92,95085
32289,4.7e-05,172.217.194.0-255,4320,6301,92,95085
32290,5e-05,172.31.47.0-255,66,6367,92,95085
32291,8.1e-05,172.31.47.0-255,66,6433,92,95085
32292,0.000841,172.217.194.0-255,1484,7917,92,95085
32293,0.000851,172.217.194.0-255,2902,10819,92,95085
32294,0.000855,172.31.47.0-255,66,10885,92,95085
32295,0.000958,172.217.194.0-255,5738,16623,92,95085
32296,0.000962,172.31.47.0-255,66,16689,92,95085
32297,0.00117,172.217.194.0-255,2902,19591,92,95085
32298,0.001172,172.31.47.0-255,66,19657,92,95085
32299,0.001208,172.217.194.0-255,2805,22462,92,95085
32300,0.00121,172.31.47.0-255,66,22528,92,95085
32301,0.002094,172.217.194.0-255,4320,26848,92,95085
32302,0.002097,172.31.47.0-255,66,26914,92,95085
32303,0.00234,172.217.194.0-255,4320,31234,92,95085
32304,0.003018,172.217.194.0-255,5738,36972,92,95085
32305,0.003191,172.31.47.0-255,66,37038,92,95085
32306,0.003379,172.217.194.0-255,1484,38522,92,95085
32307,0.003417,172.31.47.0-255,66,38588,92,95085
32308,0.003615,172.31.47.0-255,66,38654,92,95085
32309,0.004137,172.31.47.0-255,66,38720,92,95085
32310,0.00417,172.217.194.0-255,5738,44458,92,95085
32311,0.004318,172.31.47.0-255,66,44524,92,95085
32312,0.005242,172.217.194.0-255,4320,48844,92,95085
32313,0.005248,172.31.47.0-255,66,48910,92,95085
32314,0.006233,172.217.194.0-255,7156,56066,92,95085
32315,0.007982,172.31.47.0-255,66,56132,92,95085
32316,0.010056,172.217.194.0-255,5738,61870,92,95085
32317,0.010064,172.31.47.0-255,66,61936,92,95085
32318,0.010101,172.31.47.0-255,66,62002,92,95085
32319,0.010169,172.217.194.0-255,1484,63486,92,95085
32320,0.010185,172.217.194.0-255,7156,70642,92,95085
32321,0.010188,172.31.47.0-255,66,70708,92,95085
32322,0.010229,172.31.47.0-255,66,70774,92,95085
32323,0.010514,172.217.194.0-255,7156,77930,92,95085
32324,0.010518,172.31.47.0-255,66,77996,92,95085
32325,0.010568,172.31.47.0-255,66,78062,92,95085
32326,0.010898,172.217.194.0-255,7156,85218,92,95085
32327,0.010902,172.31.47.0-255,66,85284,92,95085
32328,0.010935,172.31.47.0-255,66,85350,92,95085
32329,0.012163,172.31.47.0-255,66,85416,92,95085
32330,0.012198,172.31.47.0-255,66,85482,92,95085
32331,0.012233,172.31.47.0-255,66,85548,92,95085
32332,0.012305,172.31.47.0-255,66,85614,92,95085
32333,0.012681,172.31.47.0-255,66,85680,92,95085
32334,0.012731,172.31.47.0-255,66,85746,92,95085
32335,0.013164,172.31.47.0-255,66,85812,92,95085
32336,0.013222,172.31.47.0-255,66,85878,92,95085
32337,0.013636,172.31.47.0-255,105,85983,92,95085
32338,0.019883,172.217.194.0-255,66,86049,92,95085
32339,0.030193,172.31.47.0-255,176,86225,92,95085
32340,0.030222,172.31.47.0-255,1107,87332,92,95085
32341,0.030271,172.31.47.0-255,1514,88846,92,95085
32342,0.030272,172.31.47.0-255,1514,90360,92,95085
32343,0.030273,172.31.47.0-255,1514,91874,92,95085
32344,0.030274,172.31.47.0-255,1514,93388,92,95085
32345,0.030275,172.31.47.0-255,1499,94887,92,95085
32346,0.031752,104.244.42.0-255,66,94953,92,95085
32347,0.03178,104.244.42.0-255,66,95019,92,95085
32348,0.031908,104.244.42.0-255,66,95085,92,95085
32349,0.0,172.31.47.0-255,105,105,92,105
32350,0.0,74.125.24.0-255,153,153,92,261784
32351,1.4e-05,172.31.47.0-255,66,219,92,261784
32352,4.7e-05,74.125.24.0-255,1484,1703,92,261784
32353,5.2e-05,172.31.47.0-255,66,1769,92,261784
32354,5.7e-05,74.125.24.0-255,2902,4671,92,261784
32355,5.9e-05,172.31.47.0-255,66,4737,92,261784
32356,6.2e-05,74.125.24.0-255,2902,7639,92,261784
32357,6.5e-05,172.31.47.0-255,66,7705,92,261784
32358,8e-05,74.125.24.0-255,2902,10607,92,261784
32359,8.2e-05,172.31.47.0-255,66,10673,92,261784
32360,0.000103,74.125.24.0-255,1484,12157,92,261784
32361,0.000105,172.31.47.0-255,66,12223,92,261784
32362,0.000118,74.125.24.0-255,2185,14408,92,261784
32363,0.00012,172.31.47.0-255,66,14474,92,261784
32364,0.000141,74.125.24.0-255,2902,17376,92,261784
32365,0.000143,172.31.47.0-255,66,17442,92,261784
32366,0.00016,74.125.24.0-255,1484,18926,92,261784
32367,0.000161,172.31.47.0-255,66,18992,92,261784
32368,0.000178,74.125.24.0-255,2902,21894,92,261784
32369,0.00018,172.31.47.0-255,66,21960,92,261784
32370,0.000189,172.31.47.0-255,66,22026,92,261784
32371,0.000192,74.125.24.0-255,1125,23151,92,261784
32372,0.000194,172.31.47.0-255,66,23217,92,261784
32373,0.000264,74.125.24.0-255,1484,24701,92,261784
32374,0.000267,172.31.47.0-255,66,24767,92,261784
32375,0.000293,74.125.24.0-255,2902,27669,92,261784
32376,0.000296,172.31.47.0-255,66,27735,92,261784
32377,0.000315,74.125.24.0-255,4320,32055,92,261784
32378,0.000317,172.31.47.0-255,66,32121,92,261784
32379,0.000333,74.125.24.0-255,1484,33605,92,261784
32380,0.000335,172.31.47.0-255,66,33671,92,261784
32381,0.000363,172.31.47.0-255,66,33737,92,261784
32382,0.00037,74.125.24.0-255,7156,40893,92,261784
32383,0.000372,172.31.47.0-255,66,40959,92,261784
32384,0.000386,74.125.24.0-255,4320,45279,92,261784
32385,0.000388,172.31.47.0-255,66,45345,92,261784
32386,0.000409,74.125.24.0-255,4271,49616,92,261784
32387,0.000414,172.31.47.0-255,66,49682,92,261784
32388,0.000428,74.125.24.0-255,108,49790,92,261784
32389,0.00043,172.31.47.0-255,66,49856,92,261784
32390,0.00073,74.125.24.0-255,334,50190,92,261784
32391,0.000735,172.31.47.0-255,66,50256,92,261784
32392,0.000862,74.125.24.0-255,1484,51740,92,261784
32393,0.000866,172.31.47.0-255,66,51806,92,261784
32394,0.00087,74.125.24.0-255,1484,53290,92,261784
32395,0.000872,172.31.47.0-255,66,53356,92,261784
32396,0.000886,74.125.24.0-255,1484,54840,92,261784
32397,0.000889,172.31.47.0-255,66,54906,92,261784
32398,0.000895,74.125.24.0-255,4320,59226,92,261784
32399,0.000897,172.31.47.0-255,66,59292,92,261784
32400,0.000913,74.125.24.0-255,1484,60776,92,261784
32401,0.000915,172.31.47.0-255,66,60842,92,261784
32402,0.000923,74.125.24.0-255,7156,67998,92,261784
32403,0.000933,172.31.47.0-255,66,68064,92,261784
32404,0.00095,74.125.24.0-255,5738,73802,92,261784
32405,0.000957,74.125.24.0-255,7156,80958,92,261784
32406,0.000959,172.31.47.0-255,66,81024,92,261784
32407,0.000964,172.31.47.0-255,66,81090,92,261784
32408,0.000987,74.125.24.0-255,3602,84692,92,261784
32409,0.000998,172.31.47.0-255,66,84758,92,261784
32410,0.00149,74.125.24.0-255,1484,86242,92,261784
32411,0.001496,172.31.47.0-255,66,86308,92,261784
32412,0.001504,74.125.24.0-255,2902,89210,92,261784
32413,0.001507,172.31.47.0-255,66,89276,92,261784
32414,0.00151,74.125.24.0-255,1484,90760,92,261784
32415,0.001536,74.125.24.0-255,4320,95080,92,261784
32416,0.001542,74.125.24.0-255,5738,100818,92,261784
32417,0.001559,74.125.24.0-255,1484,102302,92,261784
32418,0.001586,74.125.24.0-255,5020,107322,92,261784
32419,0.002603,74.125.24.0-255,1484,108806,92,261784
32420,0.002609,74.125.24.0-255,1484,110290,92,261784
32421,0.002623,74.125.24.0-255,1484,111774,92,261784
32422,0.002629,74.125.24.0-255,5738,117512,92,261784
32423,0.002657,74.125.24.0-255,5738,123250,92,261784
32424,0.002674,74.125.24.0-255,7156,130406,92,261784
32425,0.00268,74.125.24.0-255,7156,137562,92,261784
32426,0.004208,172.31.47.0-255,66,137628,92,261784
32427,0.006812,74.125.24.0-255,4320,141948,92,261784
32428,0.006819,172.31.47.0-255,66,142014,92,261784
32429,0.006832,74.125.24.0-255,1484,143498,92,261784
32430,0.009465,74.125.24.0-255,4320,147818,92,261784
32431,0.009471,172.31.47.0-255,66,147884,92,261784
32432,0.012107,74.125.24.0-255,5738,153622,92,261784
32433,0.012434,172.31.47.0-255,66,153688,92,261784
32434,0.015075,74.125.24.0-255,5738,159426,92,261784
32435,0.015083,172.31.47.0-255,66,159492,92,261784
32436,0.017732,74.125.24.0-255,5738,165230,92,261784
32437,0.017738,172.31.47.0-255,66,165296,92,261784
32438,0.020363,74.125.24.0-255,4320,169616,92,261784
32439,0.020368,172.31.47.0-255,66,169682,92,261784
32440,0.020395,74.125.24.0-255,1484,171166,92,261784
32441,0.023001,74.125.24.0-255,4320,175486,92,261784
32442,0.023008,172.31.47.0-255,66,175552,92,261784
32443,0.025656,74.125.24.0-255,5738,181290,92,261784
32444,0.025693,172.31.47.0-255,66,181356,92,261784
32445,0.028291,74.125.24.0-255,5738,187094,92,261784
32446,0.028299,172.31.47.0-255,66,187160,92,261784
32447,0.029517,172.31.47.0-255,172,187332,92,261784
32448,0.029559,172.31.47.0-255,1111,188443,92,261784
32449,0.029578,172.31.47.0-255,1514,189957,92,261784
32450,0.029579,172.31.47.0-255,1514,191471,92,261784
32451,0.029584,172.31.47.0-255,1514,192985,92,261784
32452,0.029585,172.31.47.0-255,1514,194499,92,261784
32453,0.029617,172.31.47.0-255,1495,195994,92,261784
32454,0.030943,74.125.24.0-255,5738,201732,92,261784
32455,0.030948,172.31.47.0-255,66,201798,92,261784
32456,0.031057,104.244.42.0-255,66,201864,92,261784
32457,0.031096,104.244.42.0-255,66,201930,92,261784
32458,0.0312,104.244.42.0-255,66,201996,92,261784
32459,0.033567,74.125.24.0-255,4320,206316,92,261784
32460,0.033572,172.31.47.0-255,66,206382,92,261784
32461,0.033593,74.125.24.0-255,1484,207866,92,261784
32462,0.036159,74.125.24.0-255,4320,212186,92,261784
32463,0.03618,172.31.47.0-255,66,212252,92,261784
32464,0.038828,74.125.24.0-255,5738,217990,92,261784
32465,0.038877,172.31.47.0-255,66,218056,92,261784
32466,0.041471,74.125.24.0-255,5738,223794,92,261784
32467,0.041475,172.31.47.0-255,66,223860,92,261784
32468,0.044098,74.125.24.0-255,4320,228180,92,261784
32469,0.044103,172.31.47.0-255,66,228246,92,261784
32470,0.044131,74.125.24.0-255,1484,229730,92,261784
32471,0.046723,74.125.24.0-255,4320,234050,92,261784
32472,0.046729,172.31.47.0-255,66,234116,92,261784
32473,0.049368,74.125.24.0-255,5738,239854,92,261784
32474,0.049405,172.31.47.0-255,66,239920,92,261784
32475,0.05205,74.125.24.0-255,5738,245658,92,261784
32476,0.052056,172.31.47.0-255,66,245724,92,261784
32477,0.054706,74.125.24.0-255,5738,251462,92,261784
32478,0.054711,172.31.47.0-255,66,251528,92,261784
32479,0.057358,74.125.24.0-255,4320,255848,92,261784
32480,0.057363,172.31.47.0-255,66,255914,92,261784
32481,0.057391,74.125.24.0-255,1484,257398,92,261784
32482,0.059962,74.125.24.0-255,4320,261718,92,261784
32483,0.059967,172.31.47.0-255,66,261784,92,261784
32484,0.0,74.125.200.0-255,226,226,92,189113
32485,3.1e-05,172.31.47.0-255,66,292,92,189113
32486,6.4e-05,74.125.200.0-255,1484,1776,92,189113
32487,6.9e-05,172.31.47.0-255,66,1842,92,189113
32488,8e-05,74.125.200.0-255,1484,3326,92,189113
32489,8.9e-05,172.31.47.0-255,66,3392,92,189113
32490,0.000135,74.125.200.0-255,2902,6294,92,189113
32491,0.00014,172.31.47.0-255,66,6360,92,189113
32492,0.000255,74.125.200.0-255,5738,12098,92,189113
32493,0.000259,172.31.47.0-255,66,12164,92,189113
32494,0.00048,74.125.200.0-255,2092,14256,92,189113
32495,0.000485,172.31.47.0-255,66,14322,92,189113
32496,0.000583,74.125.200.0-255,2902,17224,92,189113
32497,0.000587,172.31.47.0-255,66,17290,92,189113
32498,0.000618,74.125.200.0-255,7156,24446,92,189113
32499,0.000621,172.31.47.0-255,66,24512,92,189113
32500,0.000975,74.125.200.0-255,6797,31309,92,189113
32501,0.000984,172.31.47.0-255,66,31375,92,189113
32502,0.00328,74.125.200.0-255,5738,37113,92,189113
32503,0.003285,172.31.47.0-255,66,37179,92,189113
32504,0.005575,74.125.200.0-255,5738,42917,92,189113
32505,0.005581,172.31.47.0-255,66,42983,92,189113
32506,0.00788,74.125.200.0-255,2902,45885,92,189113
32507,0.007887,172.31.47.0-255,66,45951,92,189113
32508,0.007917,74.125.200.0-255,2902,48853,92,189113
32509,0.00792,172.31.47.0-255,66,48919,92,189113
32510,0.010187,74.125.200.0-255,2902,51821,92,189113
32511,0.010194,172.31.47.0-255,66,51887,92,189113
32512,0.010236,74.125.200.0-255,2902,54789,92,189113
32513,0.010239,172.31.47.0-255,66,54855,92,189113
32514,0.012504,74.125.200.0-255,2902,57757,92,189113
32515,0.012513,172.31.47.0-255,66,57823,92,189113
32516,0.012557,74.125.200.0-255,2902,60725,92,189113
32517,0.012561,172.31.47.0-255,66,60791,92,189113
32518,0.014802,74.125.200.0-255,2902,63693,92,189113
32519,0.014807,172.31.47.0-255,66,63759,92,189113
32520,0.014839,74.125.200.0-255,2902,66661,92,189113
32521,0.014842,172.31.47.0-255,66,66727,92,189113
32522,0.017119,74.125.200.0-255,2902,69629,92,189113
32523,0.017126,172.31.47.0-255,66,69695,92,189113
32524,0.017166,74.125.200.0-255,2902,72597,92,189113
32525,0.01717,172.31.47.0-255,66,72663,92,189113
32526,0.01941,74.125.200.0-255,2902,75565,92,189113
32527,0.019416,172.31.47.0-255,66,75631,92,189113
32528,0.019475,74.125.200.0-255,2902,78533,92,189113
32529,0.019479,172.31.47.0-255,66,78599,92,189113
32530,0.021708,74.125.200.0-255,2902,81501,92,189113
32531,0.021714,172.31.47.0-255,66,81567,92,189113
32532,0.021803,74.125.200.0-255,1484,83051,92,189113
32533,0.021807,172.31.47.0-255,66,83117,92,189113
32534,0.021832,74.125.200.0-255,1484,84601,92,189113
32535,0.021835,172.31.47.0-255,66,84667,92,189113
32536,0.024046,74.125.200.0-255,2902,87569,92,189113
32537,0.024052,172.31.47.0-255,66,87635,92,189113
32538,0.024076,172.31.47.0-255,172,87807,92,189113
32539,0.024096,172.31.47.0-255,1112,88919,92,189113
32540,0.024118,74.125.200.0-255,2902,91821,92,189113
32541,0.02412,172.31.47.0-255,66,91887,92,189113
32542,0.024141,172.31.47.0-255,1514,93401,92,189113
32543,0.024142,172.31.47.0-255,1514,94915,92,189113
32544,0.024143,172.31.47.0-255,1514,96429,92,189113
32545,0.024147,172.31.47.0-255,1514,97943,92,189113
32546,0.024148,172.31.47.0-255,1494,99437,92,189113
32547,0.025634,104.244.42.0-255,66,99503,92,189113
32548,0.025641,104.244.42.0-255,66,99569,92,189113
32549,0.025777,104.244.42.0-255,66,99635,92,189113
32550,0.026337,74.125.200.0-255,2902,102537,92,189113
32551,0.026341,172.31.47.0-255,66,102603,92,189113
32552,0.026408,74.125.200.0-255,2902,105505,92,189113
32553,0.026412,172.31.47.0-255,66,105571,92,189113
32554,0.026684,104.244.42.0-255,108,105679,92,189113
32555,0.0267,172.31.47.0-255,66,105745,92,189113
32556,0.028631,74.125.200.0-255,2902,108647,92,189113
32557,0.028637,172.31.47.0-255,66,108713,92,189113
32558,0.028708,74.125.200.0-255,2902,111615,92,189113
32559,0.028711,172.31.47.0-255,66,111681,92,189113
32560,0.030928,74.125.200.0-255,2902,114583,92,189113
32561,0.030935,172.31.47.0-255,66,114649,92,189113
32562,0.030992,74.125.200.0-255,1484,116133,92,189113
32563,0.031004,74.125.200.0-255,1484,117617,92,189113
32564,0.031006,172.31.47.0-255,66,117683,92,189113
32565,0.033244,74.125.200.0-255,2902,120585,92,189113
32566,0.033249,172.31.47.0-255,66,120651,92,189113
32567,0.033308,74.125.200.0-255,1484,122135,92,189113
32568,0.033328,74.125.200.0-255,1484,123619,92,189113
32569,0.033335,172.31.47.0-255,66,123685,92,189113
32570,0.03554,74.125.200.0-255,2902,126587,92,189113
32571,0.035544,172.31.47.0-255,66,126653,92,189113
32572,0.035616,74.125.200.0-255,2902,129555,92,189113
32573,0.035623,172.31.47.0-255,66,129621,92,189113
32574,0.037831,74.125.200.0-255,2902,132523,92,189113
32575,0.037835,172.31.47.0-255,66,132589,92,189113
32576,0.037913,74.125.200.0-255,1484,134073,92,189113
32577,0.037918,172.31.47.0-255,66,134139,92,189113
32578,0.037941,74.125.200.0-255,1484,135623,92,189113
32579,0.037944,172.31.47.0-255,66,135689,92,189113
32580,0.04012,74.125.200.0-255,2902,138591,92,189113
32581,0.040124,172.31.47.0-255,66,138657,92,189113
32582,0.04022,74.125.200.0-255,2902,141559,92,189113
32583,0.040224,172.31.47.0-255,66,141625,92,189113
32584,0.042401,74.125.200.0-255,2902,144527,92,189113
32585,0.042406,172.31.47.0-255,66,144593,92,189113
32586,0.042503,74.125.200.0-255,2902,147495,92,189113
32587,0.042508,172.31.47.0-255,66,147561,92,189113
32588,0.044697,74.125.200.0-255,2902,150463,92,189113
32589,0.044702,172.31.47.0-255,66,150529,92,189113
32590,0.044782,74.125.200.0-255,2902,153431,92,189113
32591,0.044789,172.31.47.0-255,66,153497,92,189113
32592,0.046987,74.125.200.0-255,2902,156399,92,189113
32593,0.046991,172.31.47.0-255,66,156465,92,189113
32594,0.047067,74.125.200.0-255,2902,159367,92,189113
32595,0.047071,172.31.47.0-255,66,159433,92,189113
32596,0.049273,74.125.200.0-255,2902,162335,92,189113
32597,0.049279,172.31.47.0-255,66,162401,92,189113
32598,0.049346,74.125.200.0-255,2902,165303,92,189113
32599,0.04935,172.31.47.0-255,66,165369,92,189113
32600,0.051567,74.125.200.0-255,2902,168271,92,189113
32601,0.051573,172.31.47.0-255,66,168337,92,189113
32602,0.051647,74.125.200.0-255,2902,171239,92,189113
32603,0.051652,172.31.47.0-255,66,171305,92,189113
32604,0.053859,74.125.200.0-255,2902,174207,92,189113
32605,0.053864,172.31.47.0-255,66,174273,92,189113
32606,0.053927,74.125.200.0-255,2902,177175,92,189113
32607,0.053931,172.31.47.0-255,66,177241,92,189113
32608,0.05615,74.125.200.0-255,2902,180143,92,189113
32609,0.056155,172.31.47.0-255,66,180209,92,189113
32610,0.056208,74.125.200.0-255,2902,183111,92,189113
32611,0.056212,172.31.47.0-255,66,183177,92,189113
32612,0.058441,74.125.200.0-255,2902,186079,92,189113
32613,0.058446,172.31.47.0-255,66,186145,92,189113
32614,0.058492,74.125.200.0-255,2902,189047,92,189113
32615,0.058496,172.31.47.0-255,66,189113,92,189113
32616,0.0,172.217.160.0-255,153,153,92,370834
32617,2.8e-05,172.31.47.0-255,66,219,92,370834
32618,3.4e-05,172.217.160.0-255,1484,1703,92,370834
32619,3.9e-05,172.31.47.0-255,66,1769,92,370834
32620,4.4e-05,172.217.160.0-255,2902,4671,92,370834
32621,4.6e-05,172.31.47.0-255,66,4737,92,370834
32622,5.3e-05,172.217.160.0-255,7156,11893,92,370834
32623,5.6e-05,172.31.47.0-255,66,11959,92,370834
32624,9e-05,172.31.47.0-255,66,12025,92,370834
32625,0.000113,172.217.160.0-255,6477,18502,92,370834
32626,0.000115,172.31.47.0-255,66,18568,92,370834
32627,0.000128,172.217.160.0-255,2543,21111,92,370834
32628,0.000131,172.31.47.0-255,66,21177,92,370834
32629,0.000135,172.217.160.0-255,2902,24079,92,370834
32630,0.000137,172.31.47.0-255,66,24145,92,370834
32631,0.000171,172.217.160.0-255,7156,31301,92,370834
32632,0.000175,172.31.47.0-255,66,31367,92,370834
32633,0.000182,172.217.160.0-255,6797,38164,92,370834
32634,0.000184,172.31.47.0-255,66,38230,92,370834
32635,0.000222,172.217.160.0-255,4320,42550,92,370834
32636,0.000225,172.31.47.0-255,66,42616,92,370834
32637,0.000246,172.217.160.0-255,2902,45518,92,370834
32638,0.000251,172.31.47.0-255,66,45584,92,370834
32639,0.000256,172.31.47.0-255,66,45650,92,370834
32640,0.000269,172.217.160.0-255,1394,47044,92,370834
32641,0.000272,172.31.47.0-255,66,47110,92,370834
32642,0.000843,172.217.160.0-255,125,47235,92,370834
32643,0.000848,172.31.47.0-255,66,47301,92,370834
32644,0.000913,172.217.160.0-255,1484,48785,92,370834
32645,0.000918,172.31.47.0-255,66,48851,92,370834
32646,0.000921,172.217.160.0-255,1484,50335,92,370834
32647,0.000942,172.217.160.0-255,1484,51819,92,370834
32648,0.000946,172.31.47.0-255,66,51885,92,370834
32649,0.000953,172.217.160.0-255,5738,57623,92,370834
32650,0.000955,172.31.47.0-255,66,57689,92,370834
32651,0.001011,172.31.47.0-255,66,57755,92,370834
32652,0.001032,172.217.160.0-255,2543,60298,92,370834
32653,0.001036,172.31.47.0-255,66,60364,92,370834
32654,0.001044,172.217.160.0-255,7156,67520,92,370834
32655,0.001046,172.31.47.0-255,66,67586,92,370834
32656,0.00105,172.217.160.0-255,2543,70129,92,370834
32657,0.001053,172.31.47.0-255,66,70195,92,370834
32658,0.001217,172.217.160.0-255,1484,71679,92,370834
32659,0.001224,172.217.160.0-255,2902,74581,92,370834
32660,0.001228,172.31.47.0-255,66,74647,92,370834
32661,0.001233,172.217.160.0-255,2902,77549,92,370834
32662,0.001234,172.31.47.0-255,66,77615,92,370834
32663,0.001253,172.217.160.0-255,2902,80517,92,370834
32664,0.001255,172.31.47.0-255,66,80583,92,370834
32665,0.00126,172.217.160.0-255,4320,84903,92,370834
32666,0.001262,172.31.47.0-255,66,84969,92,370834
32667,0.001268,172.217.160.0-255,5738,90707,92,370834
32668,0.001269,172.31.47.0-255,66,90773,92,370834
32669,0.001291,172.217.160.0-255,4320,95093,92,370834
32670,0.001294,172.31.47.0-255,66,95159,92,370834
32671,0.00133,172.217.160.0-255,7156,102315,92,370834
32672,0.001333,172.31.47.0-255,66,102381,92,370834
32673,0.001337,172.217.160.0-255,2184,104565,92,370834
32674,0.00134,172.31.47.0-255,66,104631,92,370834
32675,0.001343,172.217.160.0-255,2902,107533,92,370834
32676,0.001345,172.31.47.0-255,66,107599,92,370834
32677,0.00135,172.217.160.0-255,7156,114755,92,370834
32678,0.001352,172.31.47.0-255,66,114821,92,370834
32679,0.001362,172.31.47.0-255,66,114887,92,370834
32680,0.001389,172.217.160.0-255,1484,116371,92,370834
32681,0.001396,172.217.160.0-255,4320,120691,92,370834
32682,0.001399,172.31.47.0-255,66,120757,92,370834
32683,0.00142,172.31.47.0-255,66,120823,92,370834
32684,0.00146,172.217.160.0-255,1484,122307,92,370834
32685,0.001463,172.217.160.0-255,1484,123791,92,370834
32686,0.001471,172.31.47.0-255,66,123857,92,370834
32687,0.001474,172.217.160.0-255,1484,125341,92,370834
32688,0.00148,172.217.160.0-255,5738,131079,92,370834
32689,0.001481,172.31.47.0-255,66,131145,92,370834
32690,0.001507,172.217.160.0-255,5738,136883,92,370834
32691,0.00151,172.31.47.0-255,66,136949,92,370834
32692,0.001515,172.217.160.0-255,5738,142687,92,370834
32693,0.001516,172.31.47.0-255,66,142753,92,370834
32694,0.00153,172.217.160.0-255,1484,144237,92,370834
32695,0.001561,172.217.160.0-255,5738,149975,92,370834
32696,0.001564,172.31.47.0-255,66,150041,92,370834
32697,0.001586,172.217.160.0-255,5020,155061,92,370834
32698,0.001588,172.31.47.0-255,66,155127,92,370834
32699,0.001641,172.217.160.0-255,1484,156611,92,370834
32700,0.001663,172.217.160.0-255,2902,159513,92,370834
32701,0.001666,172.31.47.0-255,66,159579,92,370834
32702,0.001671,172.217.160.0-255,5738,165317,92,370834
32703,0.001673,172.31.47.0-255,66,165383,92,370834
32704,0.001713,172.31.47.0-255,66,165449,92,370834
32705,0.001731,172.217.160.0-255,1484,166933,92,370834
32706,0.001736,172.217.160.0-255,5738,172671,92,370834
32707,0.00174,172.31.47.0-255,66,172737,92,370834
32708,0.001769,172.217.160.0-255,4320,177057,92,370834
32709,0.001771,172.31.47.0-255,66,177123,92,370834
32710,0.001785,172.217.160.0-255,766,177889,92,370834
32711,0.001895,172.217.160.0-255,1484,179373,92,370834
32712,0.001898,172.31.47.0-255,66,179439,92,370834
32713,0.001903,172.217.160.0-255,2902,182341,92,370834
32714,0.001904,172.31.47.0-255,66,182407,92,370834
32715,0.001917,172.217.160.0-255,1484,183891,92,370834
32716,0.001936,172.217.160.0-255,4320,188211,92,370834
32717,0.001938,172.31.47.0-255,66,188277,92,370834
32718,0.001949,172.217.160.0-255,7156,195433,92,370834
32719,0.00195,172.31.47.0-255,66,195499,92,370834
32720,0.001971,172.217.160.0-255,5738,201237,92,370834
32721,0.001974,172.31.47.0-255,66,201303,92,370834
32722,0.001984,172.31.47.0-255,66,201369,92,370834
32723,0.00391,172.217.160.0-255,5738,207107,92,370834
32724,0.003915,172.31.47.0-255,66,207173,92,370834
32725,0.005841,172.217.160.0-255,5738,212911,92,370834
32726,0.005846,172.31.47.0-255,66,212977,92,370834
32727,0.007772,172.217.160.0-255,5738,218715,92,370834
32728,0.007779,172.31.47.0-255,66,218781,92,370834
32729,0.009716,172.217.160.0-255,5738,224519,92,370834
32730,0.009724,172.31.47.0-255,66,224585,92,370834
32731,0.011653,172.217.160.0-255,5738,230323,92,370834
32732,0.011659,172.31.47.0-255,66,230389,92,370834
32733,0.013588,172.217.160.0-255,5738,236127,92,370834
32734,0.013593,172.31.47.0-255,66,236193,92,370834
32735,0.015533,172.217.160.0-255,5738,241931,92,370834
32736,0.01554,172.31.47.0-255,66,241997,92,370834
32737,0.01747,172.217.160.0-255,5738,247735,92,370834
32738,0.017477,172.31.47.0-255,66,247801,92,370834
32739,0.019416,172.217.160.0-255,5738,253539,92,370834
32740,0.019425,172.31.47.0-255,66,253605,92,370834
32741,0.021355,172.217.160.0-255,4320,257925,92,370834
32742,0.02136,172.31.47.0-255,66,257991,92,370834
32743,0.021379,172.217.160.0-255,1484,259475,92,370834
32744,0.023297,172.217.160.0-255,4320,263795,92,370834
32745,0.023301,172.31.47.0-255,66,263861,92,370834
32746,0.025261,172.217.160.0-255,5738,269599,92,370834
32747,0.025267,172.31.47.0-255,66,269665,92,370834
32748,0.027193,172.217.160.0-255,5738,275403,92,370834
32749,0.027199,172.31.47.0-255,66,275469,92,370834
32750,0.029156,172.217.160.0-255,5738,281207,92,370834
32751,0.029163,172.31.47.0-255,66,281273,92,370834
32752,0.031102,172.217.160.0-255,5738,287011,92,370834
32753,0.031108,172.31.47.0-255,66,287077,92,370834
32754,0.033047,172.217.160.0-255,5738,292815,92,370834
32755,0.033053,172.31.47.0-255,66,292881,92,370834
32756,0.03494,172.31.47.0-255,172,293053,92,370834
32757,0.034978,172.31.47.0-255,1111,294164,92,370834
32758,0.035004,172.217.160.0-255,5738,299902,92,370834
32759,0.035009,172.31.47.0-255,66,299968,92,370834
32760,0.03507,172.31.47.0-255,1514,301482,92,370834
32761,0.035071,172.31.47.0-255,1514,302996,92,370834
32762,0.035076,172.31.47.0-255,1514,304510,92,370834
32763,0.035077,172.31.47.0-255,1514,306024,92,370834
32764,0.035102,172.31.47.0-255,1495,307519,92,370834
32765,0.036474,104.244.42.0-255,66,307585,92,370834
32766,0.036502,104.244.42.0-255,66,307651,92,370834
32767,0.036633,104.244.42.0-255,66,307717,92,370834
32768,0.036634,104.244.42.0-255,66,307783,92,370834
32769,0.036928,172.217.160.0-255,4320,312103,92,370834
32770,0.036931,172.31.47.0-255,66,312169,92,370834
32771,0.03696,172.217.160.0-255,1484,313653,92,370834
32772,0.038859,172.217.160.0-255,4320,317973,92,370834
32773,0.038864,172.31.47.0-255,66,318039,92,370834
32774,0.040798,172.217.160.0-255,5738,323777,92,370834
32775,0.040803,172.31.47.0-255,66,323843,92,370834
32776,0.042736,172.217.160.0-255,4320,328163,92,370834
32777,0.042741,172.31.47.0-255,66,328229,92,370834
32778,0.042768,172.217.160.0-255,1484,329713,92,370834
32779,0.044662,172.217.160.0-255,4320,334033,92,370834
32780,0.044667,172.31.47.0-255,66,334099,92,370834
32781,0.046596,172.217.160.0-255,4320,338419,92,370834
32782,0.046601,172.31.47.0-255,66,338485,92,370834
32783,0.046624,172.217.160.0-255,1484,339969,92,370834
32784,0.048539,172.217.160.0-255,4320,344289,92,370834
32785,0.048545,172.31.47.0-255,66,344355,92,370834
32786,0.050477,172.217.160.0-255,5738,350093,92,370834
32787,0.050483,172.31.47.0-255,66,350159,92,370834
32788,0.052413,172.217.160.0-255,5738,355897,92,370834
32789,0.052418,172.31.47.0-255,66,355963,92,370834
32790,0.054342,172.217.160.0-255,4320,360283,92,370834
32791,0.054347,172.31.47.0-255,66,360349,92,370834
32792,0.054373,172.217.160.0-255,1484,361833,92,370834
32793,0.056276,172.217.160.0-255,4320,366153,92,370834
32794,0.056282,172.31.47.0-255,66,366219,92,370834
32795,0.058209,172.217.160.0-255,4444,370663,92,370834
32796,0.058215,172.31.47.0-255,66,370729,92,370834
32797,0.058403,172.31.47.0-255,105,370834,92,370834
32798,0.0,74.125.24.0-255,297,297,92,235237
32799,2.3e-05,172.31.47.0-255,66,363,92,235237
32800,2.8e-05,74.125.24.0-255,1484,1847,92,235237
32801,3.2e-05,172.31.47.0-255,66,1913,92,235237
32802,3.6e-05,74.125.24.0-255,4320,6233,92,235237
32803,3.8e-05,172.31.47.0-255,66,6299,92,235237
32804,5.3e-05,74.125.24.0-255,2902,9201,92,235237
32805,5.5e-05,172.31.47.0-255,66,9267,92,235237
32806,6.8e-05,74.125.24.0-255,2902,12169,92,235237
32807,7e-05,172.31.47.0-255,66,12235,92,235237
32808,0.000106,172.31.47.0-255,66,12301,92,235237
32809,0.000121,74.125.24.0-255,6266,18567,92,235237
32810,0.000123,172.31.47.0-255,66,18633,92,235237
32811,0.000127,74.125.24.0-255,3961,22594,92,235237
32812,0.00013,172.31.47.0-255,66,22660,92,235237
32813,0.000288,74.125.24.0-255,1484,24144,92,235237
32814,0.000293,172.31.47.0-255,66,24210,92,235237
32815,0.000297,74.125.24.0-255,2902,27112,92,235237
32816,0.0003,172.31.47.0-255,66,27178,92,235237
32817,0.000302,74.125.24.0-255,1484,28662,92,235237
32818,0.000304,172.31.47.0-255,66,28728,92,235237
32819,0.000325,74.125.24.0-255,4320,33048,92,235237
32820,0.000329,172.31.47.0-255,66,33114,92,235237
32821,0.000333,74.125.24.0-255,2902,36016,92,235237
32822,0.000335,172.31.47.0-255,66,36082,92,235237
32823,0.000358,172.31.47.0-255,66,36148,92,235237
32824,0.000382,172.31.47.0-255,66,36214,92,235237
32825,0.000401,74.125.24.0-255,2481,38695,92,235237
32826,0.000404,172.31.47.0-255,66,38761,92,235237
32827,0.000445,74.125.24.0-255,130,38891,92,235237
32828,0.000677,172.31.47.0-255,66,38957,92,235237
32829,0.00105,74.125.24.0-255,1484,40441,92,235237
32830,0.001056,172.31.47.0-255,66,40507,92,235237
32831,0.001064,74.125.24.0-255,2902,43409,92,235237
32832,0.001086,74.125.24.0-255,5738,49147,92,235237
32833,0.00109,74.125.24.0-255,2902,52049,92,235237
32834,0.001115,74.125.24.0-255,7156,59205,92,235237
32835,0.001134,74.125.24.0-255,4320,63525,92,235237
32836,0.002411,74.125.24.0-255,1484,65009,92,235237
32837,0.002428,74.125.24.0-255,2902,67911,92,235237
32838,0.002442,74.125.24.0-255,1484,69395,92,235237
32839,0.002454,74.125.24.0-255,4320,73715,92,235237
32840,0.002456,74.125.24.0-255,1484,75199,92,235237
32841,0.002895,74.125.24.0-255,1484,76683,92,235237
32842,0.002906,74.125.24.0-255,2902,79585,92,235237
32843,0.002924,74.125.24.0-255,5738,85323,92,235237
32844,0.00294,74.125.24.0-255,2902,88225,92,235237
32845,0.002953,74.125.24.0-255,4320,92545,92,235237
32846,0.002968,74.125.24.0-255,5738,98283,92,235237
32847,0.002986,74.125.24.0-255,1484,99767,92,235237
32848,0.003158,74.125.24.0-255,1484,101251,92,235237
32849,0.003173,74.125.24.0-255,2902,104153,92,235237
32850,0.003191,74.125.24.0-255,1484,105637,92,235237
32851,0.003203,74.125.24.0-255,4320,109957,92,235237
32852,0.003222,74.125.24.0-255,5738,115695,92,235237
32853,0.00324,74.125.24.0-255,4320,120015,92,235237
32854,0.003251,74.125.24.0-255,2902,122917,92,235237
32855,0.003283,74.125.24.0-255,2902,125819,92,235237
32856,0.003697,74.125.24.0-255,1484,127303,92,235237
32857,0.003715,74.125.24.0-255,2902,130205,92,235237
32858,0.003733,74.125.24.0-255,5738,135943,92,235237
32859,0.003744,74.125.24.0-255,4320,140263,92,235237
32860,0.003991,74.125.24.0-255,1484,141747,92,235237
32861,0.004004,74.125.24.0-255,1484,143231,92,235237
32862,0.004027,74.125.24.0-255,1484,144715,92,235237
32863,0.004033,74.125.24.0-255,5738,150453,92,235237
32864,0.004035,74.125.24.0-255,1484,151937,92,235237
32865,0.004058,74.125.24.0-255,5738,157675,92,235237
32866,0.004084,74.125.24.0-255,7156,164831,92,235237
32867,0.004115,74.125.24.0-255,2902,167733,92,235237
32868,0.004135,74.125.24.0-255,6438,174171,92,235237
32869,0.0046,74.125.24.0-255,1484,175655,92,235237
32870,0.004607,74.125.24.0-255,2902,178557,92,235237
32871,0.004668,74.125.24.0-255,5738,184295,92,235237
32872,0.004693,74.125.24.0-255,4320,188615,92,235237
32873,0.004709,74.125.24.0-255,4320,192935,92,235237
32874,0.00472,74.125.24.0-255,4320,197255,92,235237
32875,0.004776,74.125.24.0-255,1484,198739,92,235237
32876,0.004779,172.31.47.0-255,66,198805,92,235237
32877,0.004815,172.31.47.0-255,66,198871,92,235237
32878,0.004829,74.125.24.0-255,5020,203891,92,235237
32879,0.004831,74.125.24.0-255,1484,205375,92,235237
32880,0.004853,172.31.47.0-255,66,205441,92,235237
32881,0.004887,74.125.24.0-255,5738,211179,92,235237
32882,0.004887,172.31.47.0-255,66,211245,92,235237
32883,0.004892,172.31.47.0-255,66,211311,92,235237
32884,0.004912,74.125.24.0-255,6438,217749,92,235237
32885,0.004924,74.125.24.0-255,1484,219233,92,235237
32886,0.004926,172.31.47.0-255,66,219299,92,235237
32887,0.004962,172.31.47.0-255,66,219365,92,235237
32888,0.00497,74.125.24.0-255,7156,226521,92,235237
32889,0.004977,172.31.47.0-255,66,226587,92,235237
32890,0.004984,74.125.24.0-255,105,226692,92,235237
32891,0.004991,172.31.47.0-255,66,226758,92,235237
32892,0.007388,172.31.47.0-255,105,226863,92,235237
32893,0.009638,74.125.24.0-255,66,226929,92,235237
32894,0.026918,172.31.47.0-255,172,227101,92,235237
32895,0.02695,172.31.47.0-255,1111,228212,92,235237
32896,0.026998,172.31.47.0-255,1514,229726,92,235237
32897,0.027,172.31.47.0-255,1514,231240,92,235237
32898,0.027002,172.31.47.0-255,1514,232754,92,235237
32899,0.027003,172.31.47.0-255,1514,234268,92,235237
32900,0.027004,172.31.47.0-255,531,234799,92,235237
32901,0.028467,104.244.42.0-255,66,234865,92,235237
32902,0.028516,104.244.42.0-255,66,234931,92,235237
32903,0.028572,104.244.42.0-255,66,234997,92,235237
32904,0.028575,104.244.42.0-255,66,235063,92,235237
32905,0.029702,104.244.42.0-255,108,235171,92,235237
32906,0.029707,172.31.47.0-255,66,235237,92,235237
32907,0.0,172.217.194.0-255,153,153,92,214956
32908,2.6e-05,172.31.47.0-255,66,219,92,214956
32909,3.3e-05,172.217.194.0-255,1484,1703,92,214956
32910,3.6e-05,172.31.47.0-255,66,1769,92,214956
32911,4.1e-05,172.217.194.0-255,2902,4671,92,214956
32912,4.4e-05,172.31.47.0-255,66,4737,92,214956
32913,4.8e-05,172.217.194.0-255,2902,7639,92,214956
32914,5.1e-05,172.31.47.0-255,66,7705,92,214956
32915,9.9e-05,172.217.194.0-255,4320,12025,92,214956
32916,0.000103,172.31.47.0-255,66,12091,92,214956
32917,0.000119,172.217.194.0-255,1975,14066,92,214956
32918,0.000122,172.31.47.0-255,66,14132,92,214956
32919,0.000249,172.217.194.0-255,1484,15616,92,214956
32920,0.000252,172.31.47.0-255,66,15682,92,214956
32921,0.000258,172.217.194.0-255,2902,18584,92,214956
32922,0.00026,172.31.47.0-255,66,18650,92,214956
32923,0.000272,172.217.194.0-255,1484,20134,92,214956
32924,0.000274,172.31.47.0-255,66,20200,92,214956
32925,0.000297,172.217.194.0-255,4320,24520,92,214956
32926,0.0003,172.31.47.0-255,66,24586,92,214956
32927,0.000307,172.217.194.0-255,6797,31383,92,214956
32928,0.00031,172.31.47.0-255,66,31449,92,214956
32929,0.000509,172.217.194.0-255,1484,32933,92,214956
32930,0.000513,172.31.47.0-255,66,32999,92,214956
32931,0.000522,172.217.194.0-255,2902,35901,92,214956
32932,0.000524,172.31.47.0-255,66,35967,92,214956
32933,0.000539,172.217.194.0-255,4320,40287,92,214956
32934,0.000542,172.31.47.0-255,66,40353,92,214956
32935,0.000568,172.217.194.0-255,1484,41837,92,214956
32936,0.000571,172.31.47.0-255,66,41903,92,214956
32937,0.000578,172.217.194.0-255,6797,48700,92,214956
32938,0.00058,172.31.47.0-255,66,48766,92,214956
32939,0.000598,172.217.194.0-255,4320,53086,92,214956
32940,0.000601,172.31.47.0-255,66,53152,92,214956
32941,0.000627,172.31.47.0-255,66,53218,92,214956
32942,0.00065,172.217.194.0-255,2543,55761,92,214956
32943,0.000654,172.31.47.0-255,66,55827,92,214956
32944,0.00075,172.217.194.0-255,647,56474,92,214956
32945,0.000839,172.217.194.0-255,1484,57958,92,214956
32946,0.000844,172.31.47.0-255,66,58024,92,214956
32947,0.000849,172.217.194.0-255,2902,60926,92,214956
32948,0.000851,172.31.47.0-255,66,60992,92,214956
32949,0.000853,172.217.194.0-255,1484,62476,92,214956
32950,0.000881,172.217.194.0-255,4320,66796,92,214956
32951,0.000884,172.31.47.0-255,66,66862,92,214956
32952,0.000887,172.217.194.0-255,1484,68346,92,214956
32953,0.000925,172.31.47.0-255,66,68412,92,214956
32954,0.000934,172.31.47.0-255,66,68478,92,214956
32955,0.000983,172.31.47.0-255,66,68544,92,214956
32956,0.000993,172.31.47.0-255,66,68610,92,214956
32957,0.001028,172.31.47.0-255,66,68676,92,214956
32958,0.001047,172.217.194.0-255,7156,75832,92,214956
32959,0.00105,172.31.47.0-255,66,75898,92,214956
32960,0.001064,172.217.194.0-255,2902,78800,92,214956
32961,0.001066,172.31.47.0-255,66,78866,92,214956
32962,0.001069,172.217.194.0-255,766,79632,92,214956
32963,0.001075,172.217.194.0-255,5738,85370,92,214956
32964,0.001077,172.31.47.0-255,66,85436,92,214956
32965,0.001081,172.217.194.0-255,2902,88338,92,214956
32966,0.001083,172.31.47.0-255,66,88404,92,214956
32967,0.001106,172.217.194.0-255,4320,92724,92,214956
32968,0.001109,172.31.47.0-255,66,92790,92,214956
32969,0.001114,172.217.194.0-255,5738,98528,92,214956
32970,0.001117,172.31.47.0-255,66,98594,92,214956
32971,0.001155,172.217.194.0-255,6438,105032,92,214956
32972,0.001188,172.31.47.0-255,66,105098,92,214956
32973,0.00119,172.31.47.0-255,66,105164,92,214956
32974,0.001224,172.31.47.0-255,66,105230,92,214956
32975,0.001237,172.31.47.0-255,66,105296,92,214956
32976,0.001248,172.217.194.0-255,1484,106780,92,214956
32977,0.00125,172.217.194.0-255,766,107546,92,214956
32978,0.001252,172.31.47.0-255,66,107612,92,214956
32979,0.00129,172.217.194.0-255,2902,110514,92,214956
32980,0.001293,172.31.47.0-255,66,110580,92,214956
32981,0.001321,172.31.47.0-255,66,110646,92,214956
32982,0.00135,172.217.194.0-255,2902,113548,92,214956
32983,0.001352,172.31.47.0-255,66,113614,92,214956
32984,0.001364,172.31.47.0-255,66,113680,92,214956
32985,0.001366,172.217.194.0-255,1484,115164,92,214956
32986,0.001369,172.217.194.0-255,2902,118066,92,214956
32987,0.001372,172.31.47.0-255,66,118132,92,214956
32988,0.001377,172.217.194.0-255,5738,123870,92,214956
32989,0.001379,172.31.47.0-255,66,123936,92,214956
32990,0.001389,172.217.194.0-255,7156,131092,92,214956
32991,0.001391,172.31.47.0-255,66,131158,92,214956
32992,0.001393,172.217.194.0-255,1484,132642,92,214956
32993,0.001427,172.31.47.0-255,66,132708,92,214956
32994,0.001442,172.217.194.0-255,1484,134192,92,214956
32995,0.001462,172.217.194.0-255,2184,136376,92,214956
32996,0.001464,172.31.47.0-255,66,136442,92,214956
32997,0.001529,172.217.194.0-255,1484,137926,92,214956
32998,0.001547,172.217.194.0-255,2902,140828,92,214956
32999,0.00155,172.31.47.0-255,66,140894,92,214956
33000,0.001555,172.217.194.0-255,5738,146632,92,214956
33001,0.001557,172.31.47.0-255,66,146698,92,214956
33002,0.001606,172.31.47.0-255,66,146764,92,214956
33003,0.001616,172.31.47.0-255,66,146830,92,214956
33004,0.00165,172.217.194.0-255,1484,148314,92,214956
33005,0.001679,172.217.194.0-255,2902,151216,92,214956
33006,0.001682,172.31.47.0-255,66,151282,92,214956
33007,0.001688,172.217.194.0-255,5738,157020,92,214956
33008,0.001689,172.31.47.0-255,66,157086,92,214956
33009,0.001707,172.217.194.0-255,7156,164242,92,214956
33010,0.001709,172.31.47.0-255,66,164308,92,214956
33011,0.001726,172.217.194.0-255,2902,167210,92,214956
33012,0.001728,172.31.47.0-255,66,167276,92,214956
33013,0.001749,172.217.194.0-255,5738,173014,92,214956
33014,0.001751,172.31.47.0-255,66,173080,92,214956
33015,0.001774,172.31.47.0-255,66,173146,92,214956
33016,0.001784,172.217.194.0-255,2902,176048,92,214956
33017,0.001786,172.31.47.0-255,66,176114,92,214956
33018,0.001803,172.217.194.0-255,2184,178298,92,214956
33019,0.001805,172.31.47.0-255,66,178364,92,214956
33020,0.001808,172.217.194.0-255,2902,181266,92,214956
33021,0.001809,172.31.47.0-255,66,181332,92,214956
33022,0.001869,172.31.47.0-255,66,181398,92,214956
33023,0.00189,172.217.194.0-255,5738,187136,92,214956
33024,0.001908,172.31.47.0-255,66,187202,92,214956
33025,0.001914,172.31.47.0-255,66,187268,92,214956
33026,0.00192,172.217.194.0-255,7156,194424,92,214956
33027,0.001921,172.31.47.0-255,66,194490,92,214956
33028,0.00194,172.217.194.0-255,5020,199510,92,214956
33029,0.001949,172.31.47.0-255,66,199576,92,214956
33030,0.001952,172.31.47.0-255,66,199642,92,214956
33031,0.00196,172.217.194.0-255,5738,205380,92,214956
33032,0.001962,172.31.47.0-255,66,205446,92,214956
33033,0.001989,172.31.47.0-255,66,205512,92,214956
33034,0.001991,172.217.194.0-255,105,205617,92,214956
33035,0.003874,172.31.47.0-255,66,205683,92,214956
33036,0.003913,172.31.47.0-255,105,205788,92,214956
33037,0.005902,172.217.194.0-255,66,205854,92,214956
33038,0.029527,172.31.47.0-255,176,206030,92,214956
33039,0.029566,172.31.47.0-255,1113,207143,92,214956
33040,0.029633,172.31.47.0-255,1514,208657,92,214956
33041,0.029635,172.31.47.0-255,1514,210171,92,214956
33042,0.029636,172.31.47.0-255,1514,211685,92,214956
33043,0.029638,172.31.47.0-255,1514,213199,92,214956
33044,0.029639,172.31.47.0-255,1493,214692,92,214956
33045,0.03107,104.244.42.0-255,66,214758,92,214956
33046,0.031202,104.244.42.0-255,66,214824,92,214956
33047,0.031205,104.244.42.0-255,66,214890,92,214956
33048,0.031288,104.244.42.0-255,66,214956,92,214956
33049,0.0,74.125.24.0-255,153,153,92,233483
33050,2.4e-05,172.31.47.0-255,66,219,92,233483
33051,3e-05,74.125.24.0-255,1484,1703,92,233483
33052,3.3e-05,172.31.47.0-255,66,1769,92,233483
33053,3.8e-05,74.125.24.0-255,2902,4671,92,233483
33054,4.7e-05,172.31.47.0-255,66,4737,92,233483
33055,5.3e-05,74.125.24.0-255,7156,11893,92,233483
33056,5.5e-05,172.31.47.0-255,66,11959,92,233483
33057,8.6e-05,74.125.24.0-255,2173,14132,92,233483
33058,8.8e-05,172.31.47.0-255,66,14198,92,233483
33059,0.000166,74.125.24.0-255,1484,15682,92,233483
33060,0.00017,172.31.47.0-255,66,15748,92,233483
33061,0.000175,74.125.24.0-255,2902,18650,92,233483
33062,0.000178,172.31.47.0-255,66,18716,92,233483
33063,0.000182,74.125.24.0-255,2902,21618,92,233483
33064,0.000189,172.31.47.0-255,66,21684,92,233483
33065,0.000215,74.125.24.0-255,2902,24586,92,233483
33066,0.000218,172.31.47.0-255,66,24652,92,233483
33067,0.000224,74.125.24.0-255,7156,31808,92,233483
33068,0.000226,172.31.47.0-255,66,31874,92,233483
33069,0.000256,74.125.24.0-255,6797,38671,92,233483
33070,0.00026,172.31.47.0-255,66,38737,92,233483
33071,0.000277,172.31.47.0-255,66,38803,92,233483
33072,0.000313,74.125.24.0-255,4320,43123,92,233483
33073,0.000317,172.31.47.0-255,66,43189,92,233483
33074,0.000353,172.31.47.0-255,66,43255,92,233483
33075,0.000355,74.125.24.0-255,362,43617,92,233483
33076,0.000358,172.31.47.0-255,66,43683,92,233483
33077,0.000382,74.125.24.0-255,129,43812,92,233483
33078,0.000386,172.31.47.0-255,66,43878,92,233483
33079,0.000554,74.125.24.0-255,1484,45362,92,233483
33080,0.000557,172.31.47.0-255,66,45428,92,233483
33081,0.000562,74.125.24.0-255,2902,48330,92,233483
33082,0.000568,172.31.47.0-255,66,48396,92,233483
33083,0.000598,74.125.24.0-255,5738,54134,92,233483
33084,0.000604,74.125.24.0-255,7156,61290,92,233483
33085,0.000604,172.31.47.0-255,66,61356,92,233483
33086,0.000609,172.31.47.0-255,66,61422,92,233483
33087,0.000633,74.125.24.0-255,5738,67160,92,233483
33088,0.000642,74.125.24.0-255,5738,72898,92,233483
33089,0.000643,172.31.47.0-255,66,72964,92,233483
33090,0.000648,172.31.47.0-255,66,73030,92,233483
33091,0.000658,74.125.24.0-255,5020,78050,92,233483
33092,0.000668,172.31.47.0-255,66,78116,92,233483
33093,0.00068,74.125.24.0-255,1484,79600,92,233483
33094,0.000687,74.125.24.0-255,2902,82502,92,233483
33095,0.000691,172.31.47.0-255,66,82568,92,233483
33096,0.00072,74.125.24.0-255,5738,88306,92,233483
33097,0.000724,74.125.24.0-255,2902,91208,92,233483
33098,0.000729,172.31.47.0-255,66,91274,92,233483
33099,0.000768,74.125.24.0-255,7156,98430,92,233483
33100,0.000772,172.31.47.0-255,66,98496,92,233483
33101,0.000802,74.125.24.0-255,3602,102098,92,233483
33102,0.000805,172.31.47.0-255,66,102164,92,233483
33103,0.00081,74.125.24.0-255,4320,106484,92,233483
33104,0.000813,172.31.47.0-255,66,106550,92,233483
33105,0.000846,74.125.24.0-255,5738,112288,92,233483
33106,0.00085,172.31.47.0-255,66,112354,92,233483
33107,0.000887,74.125.24.0-255,2902,115256,92,233483
33108,0.000896,172.31.47.0-255,66,115322,92,233483
33109,0.000925,172.31.47.0-255,66,115388,92,233483
33110,0.000936,74.125.24.0-255,4320,119708,92,233483
33111,0.00094,172.31.47.0-255,66,119774,92,233483
33112,0.000969,74.125.24.0-255,5738,125512,92,233483
33113,0.000972,172.31.47.0-255,66,125578,92,233483
33114,0.000988,172.31.47.0-255,66,125644,92,233483
33115,0.001032,172.31.47.0-255,66,125710,92,233483
33116,0.001054,74.125.24.0-255,1484,127194,92,233483
33117,0.001058,74.125.24.0-255,2902,130096,92,233483
33118,0.001061,172.31.47.0-255,66,130162,92,233483
33119,0.001081,74.125.24.0-255,5738,135900,92,233483
33120,0.001087,74.125.24.0-255,5738,141638,92,233483
33121,0.00109,172.31.47.0-255,66,141704,92,233483
33122,0.0011,74.125.24.0-255,1484,143188,92,233483
33123,0.001142,172.31.47.0-255,66,143254,92,233483
33124,0.001143,74.125.24.0-255,2184,145438,92,233483
33125,0.001157,172.31.47.0-255,66,145504,92,233483
33126,0.001185,74.125.24.0-255,2902,148406,92,233483
33127,0.001192,172.31.47.0-255,66,148472,92,233483
33128,0.001233,74.125.24.0-255,4320,152792,92,233483
33129,0.001236,172.31.47.0-255,66,152858,92,233483
33130,0.001255,172.31.47.0-255,66,152924,92,233483
33131,0.001259,172.31.47.0-255,66,152990,92,233483
33132,0.001279,74.125.24.0-255,1484,154474,92,233483
33133,0.001297,172.31.47.0-255,66,154540,92,233483
33134,0.001298,74.125.24.0-255,4320,158860,92,233483
33135,0.00131,172.31.47.0-255,66,158926,92,233483
33136,0.001338,172.31.47.0-255,66,158992,92,233483
33137,0.001345,74.125.24.0-255,1484,160476,92,233483
33138,0.001375,74.125.24.0-255,351,160827,92,233483
33139,0.001381,172.31.47.0-255,66,160893,92,233483
33140,0.001404,74.125.24.0-255,1484,162377,92,233483
33141,0.001407,74.125.24.0-255,1484,163861,92,233483
33142,0.001417,172.31.47.0-255,66,163927,92,233483
33143,0.001423,74.125.24.0-255,2902,166829,92,233483
33144,0.001428,172.31.47.0-255,66,166895,92,233483
33145,0.001457,74.125.24.0-255,5738,172633,92,233483
33146,0.001459,172.31.47.0-255,66,172699,92,233483
33147,0.001463,172.31.47.0-255,66,172765,92,233483
33148,0.001502,74.125.24.0-255,5738,178503,92,233483
33149,0.00152,172.31.47.0-255,66,178569,92,233483
33150,0.001522,74.125.24.0-255,6438,185007,92,233483
33151,0.001533,172.31.47.0-255,66,185073,92,233483
33152,0.001554,74.125.24.0-255,7156,192229,92,233483
33153,0.001556,74.125.24.0-255,1484,193713,92,233483
33154,0.001566,172.31.47.0-255,66,193779,92,233483
33155,0.001584,74.125.24.0-255,7156,200935,92,233483
33156,0.001588,172.31.47.0-255,66,201001,92,233483
33157,0.001591,74.125.24.0-255,7156,208157,92,233483
33158,0.001598,172.31.47.0-255,66,208223,92,233483
33159,0.001625,74.125.24.0-255,766,208989,92,233483
33160,0.001626,172.31.47.0-255,66,209055,92,233483
33161,0.001675,172.31.47.0-255,66,209121,92,233483
33162,0.001697,74.125.24.0-255,5738,214859,92,233483
33163,0.001705,172.31.47.0-255,66,214925,92,233483
33164,0.001722,74.125.24.0-255,7156,222081,92,233483
33165,0.001726,74.125.24.0-255,1484,223565,92,233483
33166,0.001726,172.31.47.0-255,66,223631,92,233483
33167,0.001789,172.31.47.0-255,66,223697,92,233483
33168,0.001793,74.125.24.0-255,236,223933,92,233483
33169,0.001795,74.125.24.0-255,105,224038,92,233483
33170,0.00339,172.31.47.0-255,66,224104,92,233483
33171,0.003416,172.31.47.0-255,105,224209,92,233483
33172,0.005623,74.125.24.0-255,66,224275,92,233483
33173,0.042215,172.31.47.0-255,172,224447,92,233483
33174,0.04227,172.31.47.0-255,1103,225550,92,233483
33175,0.042294,172.31.47.0-255,1514,227064,92,233483
33176,0.042295,172.31.47.0-255,1514,228578,92,233483
33177,0.042296,172.31.47.0-255,1514,230092,92,233483
33178,0.042298,172.31.47.0-255,1514,231606,92,233483
33179,0.042327,172.31.47.0-255,1505,233111,92,233483
33180,0.04376,104.244.42.0-255,66,233177,92,233483
33181,0.043831,104.244.42.0-255,66,233243,92,233483
33182,0.043836,104.244.42.0-255,66,233309,92,233483
33183,0.04459,104.244.42.0-255,108,233417,92,233483
33184,0.044596,172.31.47.0-255,66,233483,92,233483
33185,0.0,216.58.203.0-255,153,153,92,252308
33186,1.9e-05,172.31.47.0-255,66,219,92,252308
33187,2.6e-05,216.58.203.0-255,1484,1703,92,252308
33188,3.1e-05,172.31.47.0-255,66,1769,92,252308
33189,3.7e-05,216.58.203.0-255,2902,4671,92,252308
33190,4e-05,172.31.47.0-255,66,4737,92,252308
33191,5.7e-05,216.58.203.0-255,7156,11893,92,252308
33192,6.1e-05,172.31.47.0-255,66,11959,92,252308
33193,0.000117,216.58.203.0-255,2146,14105,92,252308
33194,0.00012,172.31.47.0-255,66,14171,92,252308
33195,0.000571,216.58.203.0-255,1484,15655,92,252308
33196,0.000578,172.31.47.0-255,66,15721,92,252308
33197,0.000588,216.58.203.0-255,2902,18623,92,252308
33198,0.000591,172.31.47.0-255,66,18689,92,252308
33199,0.000598,216.58.203.0-255,5738,24427,92,252308
33200,0.0006,172.31.47.0-255,66,24493,92,252308
33201,0.000672,216.58.203.0-255,6797,31290,92,252308
33202,0.000677,172.31.47.0-255,66,31356,92,252308
33203,0.000734,216.58.203.0-255,2902,34258,92,252308
33204,0.000737,172.31.47.0-255,66,34324,92,252308
33205,0.000775,216.58.203.0-255,2902,37226,92,252308
33206,0.000778,172.31.47.0-255,66,37292,92,252308
33207,0.000809,172.31.47.0-255,66,37358,92,252308
33208,0.000905,216.58.203.0-255,2902,40260,92,252308
33209,0.000909,172.31.47.0-255,66,40326,92,252308
33210,0.000928,216.58.203.0-255,5738,46064,92,252308
33211,0.000932,172.31.47.0-255,66,46130,92,252308
33212,0.001005,216.58.203.0-255,5738,51868,92,252308
33213,0.001011,172.31.47.0-255,66,51934,92,252308
33214,0.001029,216.58.203.0-255,5312,57246,92,252308
33215,0.001032,172.31.47.0-255,66,57312,92,252308
33216,0.002681,216.58.203.0-255,4320,61632,92,252308
33217,0.002703,216.58.203.0-255,1484,63116,92,252308
33218,0.003264,172.31.47.0-255,66,63182,92,252308
33219,0.004913,216.58.203.0-255,5738,68920,92,252308
33220,0.004919,172.31.47.0-255,66,68986,92,252308
33221,0.006574,216.58.203.0-255,5738,74724,92,252308
33222,0.00728,172.31.47.0-255,66,74790,92,252308
33223,0.008938,216.58.203.0-255,5738,80528,92,252308
33224,0.008946,172.31.47.0-255,66,80594,92,252308
33225,0.010604,216.58.203.0-255,5738,86332,92,252308
33226,0.010612,172.31.47.0-255,66,86398,92,252308
33227,0.012263,216.58.203.0-255,5738,92136,92,252308
33228,0.012271,172.31.47.0-255,66,92202,92,252308
33229,0.013927,216.58.203.0-255,5738,97940,92,252308
33230,0.013936,172.31.47.0-255,66,98006,92,252308
33231,0.015599,216.58.203.0-255,5738,103744,92,252308
33232,0.015606,172.31.47.0-255,66,103810,92,252308
33233,0.017263,216.58.203.0-255,5738,109548,92,252308
33234,0.017271,172.31.47.0-255,66,109614,92,252308
33235,0.018926,216.58.203.0-255,5738,115352,92,252308
33236,0.018934,172.31.47.0-255,66,115418,92,252308
33237,0.020589,216.58.203.0-255,5738,121156,92,252308
33238,0.020599,172.31.47.0-255,66,121222,92,252308
33239,0.022266,216.58.203.0-255,5738,126960,92,252308
33240,0.022278,172.31.47.0-255,66,127026,92,252308
33241,0.023945,216.58.203.0-255,5738,132764,92,252308
33242,0.023958,172.31.47.0-255,66,132830,92,252308
33243,0.025611,216.58.203.0-255,5738,138568,92,252308
33244,0.025619,172.31.47.0-255,66,138634,92,252308
33245,0.026345,172.31.47.0-255,167,138801,92,252308
33246,0.026377,172.31.47.0-255,1103,139904,92,252308
33247,0.026448,172.31.47.0-255,1514,141418,92,252308
33248,0.02645,172.31.47.0-255,1514,142932,92,252308
33249,0.026451,172.31.47.0-255,1514,144446,92,252308
33250,0.026453,172.31.47.0-255,1514,145960,92,252308
33251,0.026454,172.31.47.0-255,1504,147464,92,252308
33252,0.027292,216.58.203.0-255,5738,153202,92,252308
33253,0.0273,172.31.47.0-255,66,153268,92,252308
33254,0.027918,104.244.42.0-255,66,153334,92,252308
33255,0.027975,104.244.42.0-255,66,153400,92,252308
33256,0.028128,104.244.42.0-255,66,153466,92,252308
33257,0.02896,216.58.203.0-255,5738,159204,92,252308
33258,0.028968,172.31.47.0-255,66,159270,92,252308
33259,0.029332,104.244.42.0-255,108,159378,92,252308
33260,0.029338,172.31.47.0-255,66,159444,92,252308
33261,0.03062,216.58.203.0-255,5738,165182,92,252308
33262,0.030627,172.31.47.0-255,66,165248,92,252308
33263,0.032291,216.58.203.0-255,5738,170986,92,252308
33264,0.032298,172.31.47.0-255,66,171052,92,252308
33265,0.033959,216.58.203.0-255,5738,176790,92,252308
33266,0.033966,172.31.47.0-255,66,176856,92,252308
33267,0.035619,216.58.203.0-255,5738,182594,92,252308
33268,0.035626,172.31.47.0-255,66,182660,92,252308
33269,0.037284,216.58.203.0-255,5738,188398,92,252308
33270,0.03729,172.31.47.0-255,66,188464,92,252308
33271,0.038942,216.58.203.0-255,5738,194202,92,252308
33272,0.038949,172.31.47.0-255,66,194268,92,252308
33273,0.040612,216.58.203.0-255,5738,200006,92,252308
33274,0.040619,172.31.47.0-255,66,200072,92,252308
33275,0.042272,216.58.203.0-255,5738,205810,92,252308
33276,0.042278,172.31.47.0-255,66,205876,92,252308
33277,0.043935,216.58.203.0-255,5738,211614,92,252308
33278,0.043943,172.31.47.0-255,66,211680,92,252308
33279,0.045613,216.58.203.0-255,5738,217418,92,252308
33280,0.045619,172.31.47.0-255,66,217484,92,252308
33281,0.047276,216.58.203.0-255,5738,223222,92,252308
33282,0.047286,172.31.47.0-255,66,223288,92,252308
33283,0.048938,216.58.203.0-255,5738,229026,92,252308
33284,0.048945,172.31.47.0-255,66,229092,92,252308
33285,0.050648,216.58.203.0-255,5738,234830,92,252308
33286,0.050654,172.31.47.0-255,66,234896,92,252308
33287,0.052313,216.58.203.0-255,5738,240634,92,252308
33288,0.05232,172.31.47.0-255,66,240700,92,252308
33289,0.053986,216.58.203.0-255,5738,246438,92,252308
33290,0.053993,172.31.47.0-255,66,246504,92,252308
33291,0.055649,216.58.203.0-255,5738,252242,92,252308
33292,0.059369,172.31.47.0-255,66,252308,92,252308
33293,0.0,74.125.200.0-255,153,153,92,363147
33294,8e-05,172.31.47.0-255,66,219,92,363147
33295,8.7e-05,74.125.200.0-255,1484,1703,92,363147
33296,9.2e-05,172.31.47.0-255,66,1769,92,363147
33297,9.6e-05,74.125.200.0-255,2902,4671,92,363147
33298,0.000106,172.31.47.0-255,66,4737,92,363147
33299,0.000113,74.125.200.0-255,7156,11893,92,363147
33300,0.000116,172.31.47.0-255,66,11959,92,363147
33301,0.000119,74.125.200.0-255,2102,14061,92,363147
33302,0.000122,172.31.47.0-255,66,14127,92,363147
33303,0.000126,74.125.200.0-255,2902,17029,92,363147
33304,0.000128,172.31.47.0-255,66,17095,92,363147
33305,0.000134,74.125.200.0-255,7156,24251,92,363147
33306,0.000138,172.31.47.0-255,66,24317,92,363147
33307,0.000145,74.125.200.0-255,6797,31114,92,363147
33308,0.000148,172.31.47.0-255,66,31180,92,363147
33309,0.00025,74.125.200.0-255,1484,32664,92,363147
33310,0.000256,172.31.47.0-255,66,32730,92,363147
33311,0.000262,74.125.200.0-255,2902,35632,92,363147
33312,0.000265,172.31.47.0-255,66,35698,92,363147
33313,0.000269,74.125.200.0-255,2902,38600,92,363147
33314,0.000271,172.31.47.0-255,66,38666,92,363147
33315,0.000299,74.125.200.0-255,1484,40150,92,363147
33316,0.000301,172.31.47.0-255,66,40216,92,363147
33317,0.000308,74.125.200.0-255,5738,45954,92,363147
33318,0.00031,172.31.47.0-255,66,46020,92,363147
33319,0.000348,172.31.47.0-255,66,46086,92,363147
33320,0.000377,74.125.200.0-255,4320,50406,92,363147
33321,0.00038,172.31.47.0-255,66,50472,92,363147
33322,0.000399,74.125.200.0-255,4237,54709,92,363147
33323,0.000403,172.31.47.0-255,66,54775,92,363147
33324,0.000406,74.125.200.0-255,129,54904,92,363147
33325,0.000456,74.125.200.0-255,1484,56388,92,363147
33326,0.00046,172.31.47.0-255,66,56454,92,363147
33327,0.000463,74.125.200.0-255,1484,57938,92,363147
33328,0.000487,74.125.200.0-255,2902,60840,92,363147
33329,0.000491,172.31.47.0-255,66,60906,92,363147
33330,0.00051,74.125.200.0-255,2902,63808,92,363147
33331,0.000513,172.31.47.0-255,66,63874,92,363147
33332,0.000542,74.125.200.0-255,2902,66776,92,363147
33333,0.000545,172.31.47.0-255,66,66842,92,363147
33334,0.000552,74.125.200.0-255,7156,73998,92,363147
33335,0.000555,172.31.47.0-255,66,74064,92,363147
33336,0.000572,74.125.200.0-255,2902,76966,92,363147
33337,0.000573,172.31.47.0-255,66,77032,92,363147
33338,0.000577,172.31.47.0-255,66,77098,92,363147
33339,0.000607,74.125.200.0-255,3303,80401,92,363147
33340,0.00061,172.31.47.0-255,66,80467,92,363147
33341,0.000801,74.125.200.0-255,1484,81951,92,363147
33342,0.000817,74.125.200.0-255,2902,84853,92,363147
33343,0.00082,172.31.47.0-255,66,84919,92,363147
33344,0.000824,74.125.200.0-255,1484,86403,92,363147
33345,0.000851,74.125.200.0-255,4320,90723,92,363147
33346,0.000854,172.31.47.0-255,66,90789,92,363147
33347,0.000859,74.125.200.0-255,4320,95109,92,363147
33348,0.000861,172.31.47.0-255,66,95175,92,363147
33349,0.000873,74.125.200.0-255,5738,100913,92,363147
33350,0.000875,172.31.47.0-255,66,100979,92,363147
33351,0.000914,172.31.47.0-255,66,101045,92,363147
33352,0.000917,74.125.200.0-255,1484,102529,92,363147
33353,0.000973,74.125.200.0-255,766,103295,92,363147
33354,0.000977,172.31.47.0-255,66,103361,92,363147
33355,0.001072,74.125.200.0-255,1484,104845,92,363147
33356,0.001089,74.125.200.0-255,2902,107747,92,363147
33357,0.001092,172.31.47.0-255,66,107813,92,363147
33358,0.001118,74.125.200.0-255,5738,113551,92,363147
33359,0.001121,172.31.47.0-255,66,113617,92,363147
33360,0.001129,74.125.200.0-255,7156,120773,92,363147
33361,0.001131,172.31.47.0-255,66,120839,92,363147
33362,0.001155,74.125.200.0-255,4320,125159,92,363147
33363,0.001159,172.31.47.0-255,66,125225,92,363147
33364,0.001211,74.125.200.0-255,2902,128127,92,363147
33365,0.001215,172.31.47.0-255,66,128193,92,363147
33366,0.001245,74.125.200.0-255,4320,132513,92,363147
33367,0.001249,172.31.47.0-255,66,132579,92,363147
33368,0.001279,74.125.200.0-255,5020,137599,92,363147
33369,0.001283,172.31.47.0-255,66,137665,92,363147
33370,0.001407,74.125.200.0-255,1484,139149,92,363147
33371,0.001463,74.125.200.0-255,2902,142051,92,363147
33372,0.001466,172.31.47.0-255,66,142117,92,363147
33373,0.001472,74.125.200.0-255,4320,146437,92,363147
33374,0.001474,172.31.47.0-255,66,146503,92,363147
33375,0.001497,74.125.200.0-255,2902,149405,92,363147
33376,0.0015,172.31.47.0-255,66,149471,92,363147
33377,0.001531,74.125.200.0-255,5738,155209,92,363147
33378,0.001535,74.125.200.0-255,2902,158111,92,363147
33379,0.001535,172.31.47.0-255,66,158177,92,363147
33380,0.001539,172.31.47.0-255,66,158243,92,363147
33381,0.001577,74.125.200.0-255,4320,162563,92,363147
33382,0.00158,74.125.200.0-255,1484,164047,92,363147
33383,0.001581,172.31.47.0-255,66,164113,92,363147
33384,0.001583,74.125.200.0-255,2902,167015,92,363147
33385,0.001585,172.31.47.0-255,66,167081,92,363147
33386,0.001613,74.125.200.0-255,2902,169983,92,363147
33387,0.001616,172.31.47.0-255,66,170049,92,363147
33388,0.001654,74.125.200.0-255,2184,172233,92,363147
33389,0.001657,172.31.47.0-255,66,172299,92,363147
33390,0.001798,74.125.200.0-255,1484,173783,92,363147
33391,0.001809,74.125.200.0-255,2902,176685,92,363147
33392,0.001813,172.31.47.0-255,66,176751,92,363147
33393,0.001858,74.125.200.0-255,5738,182489,92,363147
33394,0.001862,172.31.47.0-255,66,182555,92,363147
33395,0.001873,172.31.47.0-255,66,182621,92,363147
33396,0.00191,172.31.47.0-255,66,182687,92,363147
33397,0.001927,74.125.200.0-255,2902,185589,92,363147
33398,0.001929,172.31.47.0-255,66,185655,92,363147
33399,0.001933,74.125.200.0-255,2184,187839,92,363147
33400,0.001935,172.31.47.0-255,66,187905,92,363147
33401,0.002138,74.125.200.0-255,1484,189389,92,363147
33402,0.002144,74.125.200.0-255,1484,190873,92,363147
33403,0.002147,172.31.47.0-255,66,190939,92,363147
33404,0.002177,74.125.200.0-255,1484,192423,92,363147
33405,0.002182,74.125.200.0-255,4320,196743,92,363147
33406,0.002185,172.31.47.0-255,66,196809,92,363147
33407,0.002201,74.125.200.0-255,5738,202547,92,363147
33408,0.002204,172.31.47.0-255,66,202613,92,363147
33409,0.002239,172.31.47.0-255,66,202679,92,363147
33410,0.002265,74.125.200.0-255,4320,206999,92,363147
33411,0.00227,172.31.47.0-255,66,207065,92,363147
33412,0.002298,74.125.200.0-255,6438,213503,92,363147
33413,0.002301,172.31.47.0-255,66,213569,92,363147
33414,0.002306,74.125.200.0-255,4320,217889,92,363147
33415,0.002309,172.31.47.0-255,66,217955,92,363147
33416,0.002349,172.31.47.0-255,66,218021,92,363147
33417,0.002356,74.125.200.0-255,5738,223759,92,363147
33418,0.002358,172.31.47.0-255,66,223825,92,363147
33419,0.002391,74.125.200.0-255,5020,228845,92,363147
33420,0.002395,172.31.47.0-255,66,228911,92,363147
33421,0.004767,74.125.200.0-255,1484,230395,92,363147
33422,0.004782,74.125.200.0-255,4320,234715,92,363147
33423,0.004786,172.31.47.0-255,66,234781,92,363147
33424,0.007212,74.125.200.0-255,5738,240519,92,363147
33425,0.007221,172.31.47.0-255,66,240585,92,363147
33426,0.009614,74.125.200.0-255,5738,246323,92,363147
33427,0.009623,172.31.47.0-255,66,246389,92,363147
33428,0.012126,74.125.200.0-255,5738,252127,92,363147
33429,0.012147,172.31.47.0-255,66,252193,92,363147
33430,0.014555,74.125.200.0-255,5738,257931,92,363147
33431,0.014572,172.31.47.0-255,66,257997,92,363147
33432,0.016975,74.125.200.0-255,5738,263735,92,363147
33433,0.016993,172.31.47.0-255,66,263801,92,363147
33434,0.019393,74.125.200.0-255,5738,269539,92,363147
33435,0.019406,172.31.47.0-255,66,269605,92,363147
33436,0.021823,74.125.200.0-255,5738,275343,92,363147
33437,0.021869,172.31.47.0-255,66,275409,92,363147
33438,0.024285,74.125.200.0-255,5738,281147,92,363147
33439,0.024303,172.31.47.0-255,66,281213,92,363147
33440,0.026708,74.125.200.0-255,5738,286951,92,363147
33441,0.026725,172.31.47.0-255,66,287017,92,363147
33442,0.029129,74.125.200.0-255,5738,292755,92,363147
33443,0.029147,172.31.47.0-255,66,292821,92,363147
33444,0.031531,74.125.200.0-255,5738,298559,92,363147
33445,0.031546,172.31.47.0-255,66,298625,92,363147
33446,0.033946,74.125.200.0-255,5738,304363,92,363147
33447,0.033958,172.31.47.0-255,66,304429,92,363147
33448,0.035739,172.31.47.0-255,172,304601,92,363147
33449,0.035766,172.31.47.0-255,1107,305708,92,363147
33450,0.035805,172.31.47.0-255,1514,307222,92,363147
33451,0.035823,172.31.47.0-255,1514,308736,92,363147
33452,0.035824,172.31.47.0-255,1514,310250,92,363147
33453,0.035844,172.31.47.0-255,1514,311764,92,363147
33454,0.035847,172.31.47.0-255,1499,313263,92,363147
33455,0.036338,74.125.200.0-255,4320,317583,92,363147
33456,0.036344,172.31.47.0-255,66,317649,92,363147
33457,0.036379,74.125.200.0-255,1484,319133,92,363147
33458,0.03727,104.244.42.0-255,66,319199,92,363147
33459,0.037297,104.244.42.0-255,66,319265,92,363147
33460,0.037393,104.244.42.0-255,66,319331,92,363147
33461,0.037438,104.244.42.0-255,66,319397,92,363147
33462,0.038737,74.125.200.0-255,4320,323717,92,363147
33463,0.038742,172.31.47.0-255,66,323783,92,363147
33464,0.041129,74.125.200.0-255,5738,329521,92,363147
33465,0.041137,172.31.47.0-255,66,329587,92,363147
33466,0.043518,74.125.200.0-255,5738,335325,92,363147
33467,0.043524,172.31.47.0-255,66,335391,92,363147
33468,0.045906,74.125.200.0-255,2902,338293,92,363147
33469,0.045915,172.31.47.0-255,66,338359,92,363147
33470,0.045943,74.125.200.0-255,2902,341261,92,363147
33471,0.045946,172.31.47.0-255,66,341327,92,363147
33472,0.048299,74.125.200.0-255,2902,344229,92,363147
33473,0.048305,172.31.47.0-255,66,344295,92,363147
33474,0.048346,74.125.200.0-255,2902,347197,92,363147
33475,0.04835,172.31.47.0-255,66,347263,92,363147
33476,0.050691,74.125.200.0-255,2902,350165,92,363147
33477,0.050697,172.31.47.0-255,66,350231,92,363147
33478,0.050736,74.125.200.0-255,2902,353133,92,363147
33479,0.050739,172.31.47.0-255,66,353199,92,363147
33480,0.053119,74.125.200.0-255,2902,356101,92,363147
33481,0.053124,172.31.47.0-255,66,356167,92,363147
33482,0.053155,74.125.200.0-255,2902,359069,92,363147
33483,0.053159,172.31.47.0-255,66,359135,92,363147
33484,0.055505,74.125.200.0-255,2902,362037,92,363147
33485,0.05551,172.31.47.0-255,66,362103,92,363147
33486,0.055541,74.125.200.0-255,807,362910,92,363147
33487,0.055675,172.31.47.0-255,66,362976,92,363147
33488,0.055703,172.31.47.0-255,105,363081,92,363147
33489,0.058052,74.125.200.0-255,66,363147,92,363147
33490,0.0,172.217.194.0-255,153,153,92,239967
33491,1.7e-05,172.31.47.0-255,66,219,92,239967
33492,2.4e-05,172.217.194.0-255,1484,1703,92,239967
33493,2.7e-05,172.31.47.0-255,66,1769,92,239967
33494,3.2e-05,172.217.194.0-255,2902,4671,92,239967
33495,3.4e-05,172.31.47.0-255,66,4737,92,239967
33496,6.4e-05,172.217.194.0-255,4320,9057,92,239967
33497,6.7e-05,172.31.47.0-255,66,9123,92,239967
33498,8.6e-05,172.217.194.0-255,2902,12025,92,239967
33499,8.9e-05,172.31.47.0-255,66,12091,92,239967
33500,9.2e-05,172.217.194.0-255,2141,14232,92,239967
33501,9.4e-05,172.31.47.0-255,66,14298,92,239967
33502,0.000104,172.217.194.0-255,1484,15782,92,239967
33503,0.000106,172.31.47.0-255,66,15848,92,239967
33504,0.000126,172.217.194.0-255,1484,17332,92,239967
33505,0.000128,172.31.47.0-255,66,17398,92,239967
33506,0.000133,172.217.194.0-255,4320,21718,92,239967
33507,0.000134,172.31.47.0-255,66,21784,92,239967
33508,0.000139,172.217.194.0-255,4320,26104,92,239967
33509,0.000141,172.31.47.0-255,66,26170,92,239967
33510,0.000164,172.217.194.0-255,4320,30490,92,239967
33511,0.000166,172.31.47.0-255,66,30556,92,239967
33512,0.000168,172.217.194.0-255,1125,31681,92,239967
33513,0.00017,172.31.47.0-255,66,31747,92,239967
33514,0.00022,172.217.194.0-255,1484,33231,92,239967
33515,0.000222,172.31.47.0-255,66,33297,92,239967
33516,0.000227,172.217.194.0-255,2902,36199,92,239967
33517,0.000229,172.31.47.0-255,66,36265,92,239967
33518,0.000243,172.217.194.0-255,4320,40585,92,239967
33519,0.000245,172.31.47.0-255,66,40651,92,239967
33520,0.000264,172.217.194.0-255,1484,42135,92,239967
33521,0.000266,172.31.47.0-255,66,42201,92,239967
33522,0.000271,172.217.194.0-255,4320,46521,92,239967
33523,0.000273,172.31.47.0-255,66,46587,92,239967
33524,0.000294,172.217.194.0-255,2543,49130,92,239967
33525,0.000296,172.31.47.0-255,66,49196,92,239967
33526,0.000302,172.217.194.0-255,7156,56352,92,239967
33527,0.000304,172.31.47.0-255,66,56418,92,239967
33528,0.000333,172.217.194.0-255,1484,57902,92,239967
33529,0.000335,172.31.47.0-255,66,57968,92,239967
33530,0.000365,172.31.47.0-255,66,58034,92,239967
33531,0.000367,172.217.194.0-255,339,58373,92,239967
33532,0.000369,172.31.47.0-255,66,58439,92,239967
33533,0.000688,172.217.194.0-255,119,58558,92,239967
33534,0.000693,172.31.47.0-255,66,58624,92,239967
33535,0.000788,172.217.194.0-255,381,59005,92,239967
33536,0.000791,172.31.47.0-255,66,59071,92,239967
33537,0.001023,172.217.194.0-255,1484,60555,92,239967
33538,0.001028,172.31.47.0-255,66,60621,92,239967
33539,0.001035,172.217.194.0-255,2902,63523,92,239967
33540,0.001036,172.31.47.0-255,66,63589,92,239967
33541,0.001052,172.217.194.0-255,4320,67909,92,239967
33542,0.001054,172.31.47.0-255,66,67975,92,239967
33543,0.001074,172.217.194.0-255,1484,69459,92,239967
33544,0.001076,172.31.47.0-255,66,69525,92,239967
33545,0.001103,172.31.47.0-255,66,69591,92,239967
33546,0.001117,172.217.194.0-255,1484,71075,92,239967
33547,0.001119,172.31.47.0-255,66,71141,92,239967
33548,0.001136,172.217.194.0-255,5738,76879,92,239967
33549,0.001138,172.31.47.0-255,66,76945,92,239967
33550,0.001165,172.217.194.0-255,4320,81265,92,239967
33551,0.001169,172.217.194.0-255,2184,83449,92,239967
33552,0.001784,172.217.194.0-255,1484,84933,92,239967
33553,0.00179,172.217.194.0-255,2902,87835,92,239967
33554,0.001814,172.217.194.0-255,5738,93573,92,239967
33555,0.001828,172.217.194.0-255,4320,97893,92,239967
33556,0.001847,172.217.194.0-255,1484,99377,92,239967
33557,0.002313,172.217.194.0-255,1484,100861,92,239967
33558,0.002326,172.217.194.0-255,2902,103763,92,239967
33559,0.002836,172.31.47.0-255,66,103829,92,239967
33560,0.005169,172.217.194.0-255,5738,109567,92,239967
33561,0.005175,172.31.47.0-255,66,109633,92,239967
33562,0.007491,172.217.194.0-255,4320,113953,92,239967
33563,0.007497,172.31.47.0-255,66,114019,92,239967
33564,0.007515,172.217.194.0-255,1484,115503,92,239967
33565,0.007517,172.31.47.0-255,66,115569,92,239967
33566,0.009772,172.217.194.0-255,5738,121307,92,239967
33567,0.009778,172.31.47.0-255,66,121373,92,239967
33568,0.012069,172.217.194.0-255,1484,122857,92,239967
33569,0.012076,172.31.47.0-255,66,122923,92,239967
33570,0.012099,172.217.194.0-255,4320,127243,92,239967
33571,0.012122,172.31.47.0-255,66,127309,92,239967
33572,0.014401,172.217.194.0-255,1484,128793,92,239967
33573,0.014413,172.31.47.0-255,66,128859,92,239967
33574,0.014436,172.217.194.0-255,4320,133179,92,239967
33575,0.014606,172.31.47.0-255,66,133245,92,239967
33576,0.01667,172.217.194.0-255,1484,134729,92,239967
33577,0.016676,172.31.47.0-255,66,134795,92,239967
33578,0.016864,172.217.194.0-255,4320,139115,92,239967
33579,0.016922,172.31.47.0-255,66,139181,92,239967
33580,0.018976,172.217.194.0-255,1484,140665,92,239967
33581,0.019241,172.217.194.0-255,4320,144985,92,239967
33582,0.019247,172.31.47.0-255,66,145051,92,239967
33583,0.021569,172.217.194.0-255,5738,150789,92,239967
33584,0.021622,172.31.47.0-255,66,150855,92,239967
33585,0.023905,172.217.194.0-255,5738,156593,92,239967
33586,0.023915,172.31.47.0-255,66,156659,92,239967
33587,0.026229,172.217.194.0-255,5738,162397,92,239967
33588,0.026239,172.31.47.0-255,66,162463,92,239967
33589,0.028209,172.31.47.0-255,172,162635,92,239967
33590,0.028253,172.31.47.0-255,1106,163741,92,239967
33591,0.028309,172.31.47.0-255,576,164317,92,239967
33592,0.02854,172.217.194.0-255,5738,170055,92,239967
33593,0.028546,172.31.47.0-255,66,170121,92,239967
33594,0.029761,104.244.42.0-255,66,170187,92,239967
33595,0.029816,104.244.42.0-255,66,170253,92,239967
33596,0.029869,104.244.42.0-255,66,170319,92,239967
33597,0.030883,172.217.194.0-255,5738,176057,92,239967
33598,0.030891,172.31.47.0-255,66,176123,92,239967
33599,0.033163,172.217.194.0-255,5738,181861,92,239967
33600,0.03317,172.31.47.0-255,66,181927,92,239967
33601,0.035452,172.217.194.0-255,5738,187665,92,239967
33602,0.035459,172.31.47.0-255,66,187731,92,239967
33603,0.037757,172.217.194.0-255,5738,193469,92,239967
33604,0.037768,172.31.47.0-255,66,193535,92,239967
33605,0.040445,172.217.194.0-255,5738,199273,92,239967
33606,0.040457,172.31.47.0-255,66,199339,92,239967
33607,0.042835,172.217.194.0-255,5738,205077,92,239967
33608,0.042843,172.31.47.0-255,66,205143,92,239967
33609,0.045179,172.217.194.0-255,5738,210881,92,239967
33610,0.045187,172.31.47.0-255,66,210947,92,239967
33611,0.047472,172.217.194.0-255,5738,216685,92,239967
33612,0.047479,172.31.47.0-255,66,216751,92,239967
33613,0.049755,172.217.194.0-255,5738,222489,92,239967
33614,0.052379,172.31.47.0-255,66,222555,92,239967
33615,0.054727,172.217.194.0-255,5738,228293,92,239967
33616,0.054735,172.31.47.0-255,66,228359,92,239967
33617,0.05705,172.217.194.0-255,5738,234097,92,239967
33618,0.057058,172.31.47.0-255,66,234163,92,239967
33619,0.059384,172.217.194.0-255,5738,239901,92,239967
33620,0.05939,172.31.47.0-255,66,239967,92,239967
33621,0.0,74.125.24.0-255,153,153,92,254211
33622,2.6e-05,172.31.47.0-255,66,219,92,254211
33623,3.4e-05,74.125.24.0-255,1484,1703,92,254211
33624,3.8e-05,172.31.47.0-255,66,1769,92,254211
33625,4.2e-05,74.125.24.0-255,2902,4671,92,254211
33626,5.3e-05,172.31.47.0-255,66,4737,92,254211
33627,6e-05,74.125.24.0-255,7156,11893,92,254211
33628,6.3e-05,172.31.47.0-255,66,11959,92,254211
33629,6.7e-05,74.125.24.0-255,2174,14133,92,254211
33630,7e-05,172.31.47.0-255,66,14199,92,254211
33631,7.5e-05,74.125.24.0-255,4320,18519,92,254211
33632,7.7e-05,172.31.47.0-255,66,18585,92,254211
33633,0.000118,74.125.24.0-255,7156,25741,92,254211
33634,0.000122,172.31.47.0-255,66,25807,92,254211
33635,0.000128,74.125.24.0-255,5379,31186,92,254211
33636,0.00013,172.31.47.0-255,66,31252,92,254211
33637,0.000206,74.125.24.0-255,1484,32736,92,254211
33638,0.000209,172.31.47.0-255,66,32802,92,254211
33639,0.000214,74.125.24.0-255,2902,35704,92,254211
33640,0.000217,172.31.47.0-255,66,35770,92,254211
33641,0.000243,74.125.24.0-255,5738,41508,92,254211
33642,0.000246,172.31.47.0-255,66,41574,92,254211
33643,0.00025,74.125.24.0-255,2902,44476,92,254211
33644,0.000252,172.31.47.0-255,66,44542,92,254211
33645,0.000287,172.31.47.0-255,66,44608,92,254211
33646,0.000294,74.125.24.0-255,7156,51764,92,254211
33647,0.000297,172.31.47.0-255,66,51830,92,254211
33648,0.000343,74.125.24.0-255,2839,54669,92,254211
33649,0.000347,172.31.47.0-255,66,54735,92,254211
33650,0.00035,74.125.24.0-255,132,54867,92,254211
33651,0.000353,172.31.47.0-255,66,54933,92,254211
33652,0.000463,74.125.24.0-255,346,55279,92,254211
33653,0.000787,172.31.47.0-255,66,55345,92,254211
33654,0.001172,74.125.24.0-255,1484,56829,92,254211
33655,0.001182,74.125.24.0-255,2902,59731,92,254211
33656,0.001185,172.31.47.0-255,66,59797,92,254211
33657,0.001191,74.125.24.0-255,4320,64117,92,254211
33658,0.001193,172.31.47.0-255,66,64183,92,254211
33659,0.001216,74.125.24.0-255,1484,65667,92,254211
33660,0.001231,172.31.47.0-255,66,65733,92,254211
33661,0.001258,74.125.24.0-255,2902,68635,92,254211
33662,0.001261,172.31.47.0-255,66,68701,92,254211
33663,0.001264,74.125.24.0-255,1484,70185,92,254211
33664,0.001268,74.125.24.0-255,2902,73087,92,254211
33665,0.00127,172.31.47.0-255,66,73153,92,254211
33666,0.001324,172.31.47.0-255,66,73219,92,254211
33667,0.001336,172.31.47.0-255,66,73285,92,254211
33668,0.001339,74.125.24.0-255,1484,74769,92,254211
33669,0.001375,74.125.24.0-255,6438,81207,92,254211
33670,0.00139,172.31.47.0-255,66,81273,92,254211
33671,0.002065,74.125.24.0-255,1484,82757,92,254211
33672,0.002072,74.125.24.0-255,2902,85659,92,254211
33673,0.002075,172.31.47.0-255,66,85725,92,254211
33674,0.002104,74.125.24.0-255,5738,91463,92,254211
33675,0.002107,172.31.47.0-255,66,91529,92,254211
33676,0.00211,74.125.24.0-255,2902,94431,92,254211
33677,0.002112,172.31.47.0-255,66,94497,92,254211
33678,0.002145,172.31.47.0-255,66,94563,92,254211
33679,0.00215,74.125.24.0-255,5738,100301,92,254211
33680,0.002152,172.31.47.0-255,66,100367,92,254211
33681,0.002176,74.125.24.0-255,5020,105387,92,254211
33682,0.002178,172.31.47.0-255,66,105453,92,254211
33683,0.004558,74.125.24.0-255,5738,111191,92,254211
33684,0.004562,172.31.47.0-255,66,111257,92,254211
33685,0.006924,74.125.24.0-255,5738,116995,92,254211
33686,0.00693,172.31.47.0-255,66,117061,92,254211
33687,0.009294,74.125.24.0-255,5738,122799,92,254211
33688,0.009302,172.31.47.0-255,66,122865,92,254211
33689,0.011675,74.125.24.0-255,5738,128603,92,254211
33690,0.011686,172.31.47.0-255,66,128669,92,254211
33691,0.01404,74.125.24.0-255,5738,134407,92,254211
33692,0.014048,172.31.47.0-255,66,134473,92,254211
33693,0.016436,74.125.24.0-255,5738,140211,92,254211
33694,0.016444,172.31.47.0-255,66,140277,92,254211
33695,0.018772,74.125.24.0-255,5738,146015,92,254211
33696,0.018779,172.31.47.0-255,66,146081,92,254211
33697,0.021145,74.125.24.0-255,5738,151819,92,254211
33698,0.02115,172.31.47.0-255,66,151885,92,254211
33699,0.023493,74.125.24.0-255,5738,157623,92,254211
33700,0.023499,172.31.47.0-255,66,157689,92,254211
33701,0.025044,172.31.47.0-255,172,157861,92,254211
33702,0.025095,172.31.47.0-255,1103,158964,92,254211
33703,0.025158,172.31.47.0-255,1514,160478,92,254211
33704,0.02516,172.31.47.0-255,1514,161992,92,254211
33705,0.025165,172.31.47.0-255,1514,163506,92,254211
33706,0.025166,172.31.47.0-255,1514,165020,92,254211
33707,0.025187,172.31.47.0-255,1503,166523,92,254211
33708,0.025925,74.125.24.0-255,4320,170843,92,254211
33709,0.025931,172.31.47.0-255,66,170909,92,254211
33710,0.025957,74.125.24.0-255,1484,172393,92,254211
33711,0.026585,104.244.42.0-255,66,172459,92,254211
33712,0.02663,104.244.42.0-255,66,172525,92,254211
33713,0.02675,104.244.42.0-255,66,172591,92,254211
33714,0.026799,104.244.42.0-255,66,172657,92,254211
33715,0.028297,74.125.24.0-255,4320,176977,92,254211
33716,0.028302,172.31.47.0-255,66,177043,92,254211
33717,0.030663,74.125.24.0-255,2902,179945,92,254211
33718,0.030669,172.31.47.0-255,66,180011,92,254211
33719,0.030702,74.125.24.0-255,2902,182913,92,254211
33720,0.030705,172.31.47.0-255,66,182979,92,254211
33721,0.033025,74.125.24.0-255,2902,185881,92,254211
33722,0.033032,172.31.47.0-255,66,185947,92,254211
33723,0.033093,74.125.24.0-255,2902,188849,92,254211
33724,0.033097,172.31.47.0-255,66,188915,92,254211
33725,0.035412,74.125.24.0-255,2902,191817,92,254211
33726,0.035427,172.31.47.0-255,66,191883,92,254211
33727,0.035461,74.125.24.0-255,1484,193367,92,254211
33728,0.035476,74.125.24.0-255,1484,194851,92,254211
33729,0.035479,172.31.47.0-255,66,194917,92,254211
33730,0.037771,74.125.24.0-255,2902,197819,92,254211
33731,0.037789,172.31.47.0-255,66,197885,92,254211
33732,0.037865,74.125.24.0-255,2902,200787,92,254211
33733,0.037868,172.31.47.0-255,66,200853,92,254211
33734,0.04018,74.125.24.0-255,2902,203755,92,254211
33735,0.040192,172.31.47.0-255,66,203821,92,254211
33736,0.040354,74.125.24.0-255,2902,206723,92,254211
33737,0.040358,172.31.47.0-255,66,206789,92,254211
33738,0.042547,74.125.24.0-255,2902,209691,92,254211
33739,0.042556,172.31.47.0-255,66,209757,92,254211
33740,0.042683,74.125.24.0-255,2902,212659,92,254211
33741,0.042687,172.31.47.0-255,66,212725,92,254211
33742,0.04493,74.125.24.0-255,2902,215627,92,254211
33743,0.044944,172.31.47.0-255,66,215693,92,254211
33744,0.045018,74.125.24.0-255,2902,218595,92,254211
33745,0.045021,172.31.47.0-255,66,218661,92,254211
33746,0.04731,74.125.24.0-255,2902,221563,92,254211
33747,0.047325,172.31.47.0-255,66,221629,92,254211
33748,0.04738,74.125.24.0-255,2902,224531,92,254211
33749,0.047383,172.31.47.0-255,66,224597,92,254211
33750,0.049679,74.125.24.0-255,2902,227499,92,254211
33751,0.049696,172.31.47.0-255,66,227565,92,254211
33752,0.049742,74.125.24.0-255,2902,230467,92,254211
33753,0.049745,172.31.47.0-255,66,230533,92,254211
33754,0.052068,74.125.24.0-255,2902,233435,92,254211
33755,0.052083,172.31.47.0-255,66,233501,92,254211
33756,0.052135,74.125.24.0-255,2902,236403,92,254211
33757,0.052138,172.31.47.0-255,66,236469,92,254211
33758,0.054443,74.125.24.0-255,2902,239371,92,254211
33759,0.054463,172.31.47.0-255,66,239437,92,254211
33760,0.05451,74.125.24.0-255,2902,242339,92,254211
33761,0.054513,172.31.47.0-255,66,242405,92,254211
33762,0.056854,74.125.24.0-255,2902,245307,92,254211
33763,0.056872,172.31.47.0-255,66,245373,92,254211
33764,0.056928,74.125.24.0-255,2902,248275,92,254211
33765,0.056931,172.31.47.0-255,66,248341,92,254211
33766,0.059248,74.125.24.0-255,1484,249825,92,254211
33767,0.059324,74.125.24.0-255,4320,254145,92,254211
33768,0.059334,172.31.47.0-255,66,254211,92,254211
33769,0.0,172.31.47.0-255,105,105,92,184793
33770,0.028193,74.125.24.0-255,153,258,92,184793
33771,0.02821,172.31.47.0-255,66,324,92,184793
33772,0.028216,74.125.24.0-255,1484,1808,92,184793
33773,0.028221,172.31.47.0-255,66,1874,92,184793
33774,0.028224,74.125.24.0-255,1484,3358,92,184793
33775,0.028233,172.31.47.0-255,66,3424,92,184793
33776,0.02824,74.125.24.0-255,4320,7744,92,184793
33777,0.028243,172.31.47.0-255,66,7810,92,184793
33778,0.028255,172.31.47.0-255,66,7876,92,184793
33779,0.028257,74.125.24.0-255,1484,9360,92,184793
33780,0.02826,172.31.47.0-255,66,9426,92,184793
33781,0.02829,74.125.24.0-255,2902,12328,92,184793
33782,0.028292,172.31.47.0-255,66,12394,92,184793
33783,0.028326,172.31.47.0-255,66,12460,92,184793
33784,0.028397,74.125.24.0-255,1484,13944,92,184793
33785,0.0284,172.31.47.0-255,66,14010,92,184793
33786,0.028404,74.125.24.0-255,2902,16912,92,184793
33787,0.028406,172.31.47.0-255,66,16978,92,184793
33788,0.028433,74.125.24.0-255,5738,22716,92,184793
33789,0.028436,172.31.47.0-255,66,22782,92,184793
33790,0.028462,74.125.24.0-255,1484,24266,92,184793
33791,0.028464,172.31.47.0-255,66,24332,92,184793
33792,0.02848,74.125.24.0-255,2902,27234,92,184793
33793,0.028482,172.31.47.0-255,66,27300,92,184793
33794,0.028488,74.125.24.0-255,5379,32679,92,184793
33795,0.02849,172.31.47.0-255,66,32745,92,184793
33796,0.028501,172.31.47.0-255,66,32811,92,184793
33797,0.028565,74.125.24.0-255,2876,35687,92,184793
33798,0.028568,172.31.47.0-255,66,35753,92,184793
33799,0.028638,74.125.24.0-255,1484,37237,92,184793
33800,0.028644,74.125.24.0-255,2902,40139,92,184793
33801,0.028647,172.31.47.0-255,66,40205,92,184793
33802,0.02865,74.125.24.0-255,1484,41689,92,184793
33803,0.028674,74.125.24.0-255,4320,46009,92,184793
33804,0.028676,172.31.47.0-255,66,46075,92,184793
33805,0.028696,74.125.24.0-255,6504,52579,92,184793
33806,0.028698,172.31.47.0-255,66,52645,92,184793
33807,0.02878,74.125.24.0-255,1484,54129,92,184793
33808,0.028785,74.125.24.0-255,1484,55613,92,184793
33809,0.028788,172.31.47.0-255,66,55679,92,184793
33810,0.028817,74.125.24.0-255,1484,57163,92,184793
33811,0.028824,74.125.24.0-255,5738,62901,92,184793
33812,0.028826,172.31.47.0-255,66,62967,92,184793
33813,0.028842,172.31.47.0-255,66,63033,92,184793
33814,0.028847,74.125.24.0-255,2902,65935,92,184793
33815,0.028849,172.31.47.0-255,66,66001,92,184793
33816,0.028886,172.31.47.0-255,66,66067,92,184793
33817,0.029749,74.125.24.0-255,1484,67551,92,184793
33818,0.029758,74.125.24.0-255,2902,70453,92,184793
33819,0.029761,172.31.47.0-255,66,70519,92,184793
33820,0.029768,74.125.24.0-255,5738,76257,92,184793
33821,0.02977,172.31.47.0-255,66,76323,92,184793
33822,0.029796,172.31.47.0-255,66,76389,92,184793
33823,0.029808,74.125.24.0-255,1484,77873,92,184793
33824,0.029817,74.125.24.0-255,7156,85029,92,184793
33825,0.029819,172.31.47.0-255,66,85095,92,184793
33826,0.029844,74.125.24.0-255,3602,88697,92,184793
33827,0.029846,172.31.47.0-255,66,88763,92,184793
33828,0.02997,74.125.24.0-255,1484,90247,92,184793
33829,0.029976,74.125.24.0-255,2902,93149,92,184793
33830,0.029979,172.31.47.0-255,66,93215,92,184793
33831,0.029982,74.125.24.0-255,1484,94699,92,184793
33832,0.030007,74.125.24.0-255,4320,99019,92,184793
33833,0.030009,172.31.47.0-255,66,99085,92,184793
33834,0.030014,74.125.24.0-255,4320,103405,92,184793
33835,0.030015,172.31.47.0-255,66,103471,92,184793
33836,0.03002,74.125.24.0-255,5738,109209,92,184793
33837,0.030022,172.31.47.0-255,66,109275,92,184793
33838,0.030061,74.125.24.0-255,5738,115013,92,184793
33839,0.030063,172.31.47.0-255,66,115079,92,184793
33840,0.030072,172.31.47.0-255,66,115145,92,184793
33841,0.032391,74.125.24.0-255,5738,120883,92,184793
33842,0.032402,172.31.47.0-255,66,120949,92,184793
33843,0.034732,74.125.24.0-255,5738,126687,92,184793
33844,0.034737,172.31.47.0-255,66,126753,92,184793
33845,0.03704,74.125.24.0-255,5738,132491,92,184793
33846,0.037047,172.31.47.0-255,66,132557,92,184793
33847,0.039362,74.125.24.0-255,5738,138295,92,184793
33848,0.03937,172.31.47.0-255,66,138361,92,184793
33849,0.041691,74.125.24.0-255,5738,144099,92,184793
33850,0.0417,172.31.47.0-255,66,144165,92,184793
33851,0.044027,74.125.24.0-255,5738,149903,92,184793
33852,0.044036,172.31.47.0-255,66,149969,92,184793
33853,0.046339,74.125.24.0-255,5738,155707,92,184793
33854,0.046347,172.31.47.0-255,66,155773,92,184793
33855,0.048706,74.125.24.0-255,5738,161511,92,184793
33856,0.048715,172.31.47.0-255,66,161577,92,184793
33857,0.051028,74.125.24.0-255,5738,167315,92,184793
33858,0.051035,172.31.47.0-255,66,167381,92,184793
33859,0.053347,74.125.24.0-255,5738,173119,92,184793
33860,0.053356,172.31.47.0-255,66,173185,92,184793
33861,0.055669,74.125.24.0-255,5738,178923,92,184793
33862,0.055684,172.31.47.0-255,66,178989,92,184793
33863,0.05799,74.125.24.0-255,5738,184727,92,184793
33864,0.057998,172.31.47.0-255,66,184793,92,184793
33865,0.0,172.31.47.0-255,105,105,92,105
33866,0.0,172.217.194.0-255,152,152,92,290045
33867,3.8e-05,172.31.47.0-255,66,218,92,290045
33868,4.8e-05,172.217.194.0-255,1484,1702,92,290045
33869,5.4e-05,172.31.47.0-255,66,1768,92,290045
33870,7.4e-05,172.217.194.0-255,2902,4670,92,290045
33871,7.8e-05,172.31.47.0-255,66,4736,92,290045
33872,9e-05,172.217.194.0-255,7156,11892,92,290045
33873,9.3e-05,172.31.47.0-255,66,11958,92,290045
33874,0.000103,172.217.194.0-255,6356,18314,92,290045
33875,0.000108,172.31.47.0-255,66,18380,92,290045
33876,0.000118,172.217.194.0-255,7156,25536,92,290045
33877,0.000121,172.31.47.0-255,66,25602,92,290045
33878,0.00013,172.217.194.0-255,5379,30981,92,290045
33879,0.000134,172.31.47.0-255,66,31047,92,290045
33880,0.000213,172.217.194.0-255,1484,32531,92,290045
33881,0.000218,172.31.47.0-255,66,32597,92,290045
33882,0.000225,172.217.194.0-255,2902,35499,92,290045
33883,0.000229,172.31.47.0-255,66,35565,92,290045
33884,0.00024,172.217.194.0-255,1484,37049,92,290045
33885,0.000244,172.31.47.0-255,66,37115,92,290045
33886,0.000268,172.217.194.0-255,4320,41435,92,290045
33887,0.000273,172.31.47.0-255,66,41501,92,290045
33888,0.000291,172.31.47.0-255,66,41567,92,290045
33889,0.000339,172.31.47.0-255,66,41633,92,290045
33890,0.000343,172.217.194.0-255,1125,42758,92,290045
33891,0.000345,172.31.47.0-255,66,42824,92,290045
33892,0.000405,172.217.194.0-255,645,43469,92,290045
33893,0.000409,172.31.47.0-255,66,43535,92,290045
33894,0.000643,172.217.194.0-255,1484,45019,92,290045
33895,0.000652,172.31.47.0-255,66,45085,92,290045
33896,0.000659,172.217.194.0-255,2902,47987,92,290045
33897,0.000663,172.31.47.0-255,66,48053,92,290045
33898,0.000678,172.217.194.0-255,5738,53791,92,290045
33899,0.000682,172.31.47.0-255,66,53857,92,290045
33900,0.000688,172.217.194.0-255,4320,58177,92,290045
33901,0.000692,172.31.47.0-255,66,58243,92,290045
33902,0.000736,172.31.47.0-255,66,58309,92,290045
33903,0.00075,172.31.47.0-255,66,58375,92,290045
33904,0.000827,172.217.194.0-255,1484,59859,92,290045
33905,0.000836,172.217.194.0-255,2902,62761,92,290045
33906,0.000839,172.31.47.0-255,66,62827,92,290045
33907,0.000888,172.217.194.0-255,5738,68565,92,290045
33908,0.000893,172.31.47.0-255,66,68631,92,290045
33909,0.000907,172.217.194.0-255,6249,74880,92,290045
33910,0.000912,172.31.47.0-255,66,74946,92,290045
33911,0.000951,172.217.194.0-255,1484,76430,92,290045
33912,0.000959,172.217.194.0-255,2902,79332,92,290045
33913,0.000962,172.31.47.0-255,66,79398,92,290045
33914,0.000969,172.217.194.0-255,1484,80882,92,290045
33915,0.001028,172.217.194.0-255,4320,85202,92,290045
33916,0.001034,172.31.47.0-255,66,85268,92,290045
33917,0.001041,172.217.194.0-255,2902,88170,92,290045
33918,0.001047,172.31.47.0-255,66,88236,92,290045
33919,0.001065,172.31.47.0-255,66,88302,92,290045
33920,0.001086,172.31.47.0-255,66,88368,92,290045
33921,0.001304,172.217.194.0-255,1484,89852,92,290045
33922,0.001311,172.217.194.0-255,2902,92754,92,290045
33923,0.001315,172.31.47.0-255,66,92820,92,290045
33924,0.001359,172.217.194.0-255,5738,98558,92,290045
33925,0.001364,172.31.47.0-255,66,98624,92,290045
33926,0.001372,172.217.194.0-255,4320,102944,92,290045
33927,0.001377,172.31.47.0-255,66,103010,92,290045
33928,0.001393,172.31.47.0-255,66,103076,92,290045
33929,0.00143,172.217.194.0-255,1484,104560,92,290045
33930,0.001438,172.217.194.0-255,5738,110298,92,290045
33931,0.001442,172.217.194.0-255,2184,112482,92,290045
33932,0.001461,172.31.47.0-255,66,112548,92,290045
33933,0.001465,172.31.47.0-255,66,112614,92,290045
33934,0.00152,172.217.194.0-255,1484,114098,92,290045
33935,0.001527,172.217.194.0-255,2902,117000,92,290045
33936,0.001531,172.31.47.0-255,66,117066,92,290045
33937,0.001541,172.217.194.0-255,5738,122804,92,290045
33938,0.001544,172.31.47.0-255,66,122870,92,290045
33939,0.001594,172.31.47.0-255,66,122936,92,290045
33940,0.001604,172.217.194.0-255,5738,128674,92,290045
33941,0.001608,172.31.47.0-255,66,128740,92,290045
33942,0.001652,172.217.194.0-255,7156,135896,92,290045
33943,0.001656,172.31.47.0-255,66,135962,92,290045
33944,0.001659,172.217.194.0-255,766,136728,92,290045
33945,0.001755,172.217.194.0-255,1484,138212,92,290045
33946,0.00176,172.31.47.0-255,66,138278,92,290045
33947,0.001766,172.217.194.0-255,2902,141180,92,290045
33948,0.00177,172.31.47.0-255,66,141246,92,290045
33949,0.00178,172.217.194.0-255,1484,142730,92,290045
33950,0.001814,172.217.194.0-255,4320,147050,92,290045
33951,0.001818,172.31.47.0-255,66,147116,92,290045
33952,0.001825,172.217.194.0-255,7156,154272,92,290045
33953,0.001827,172.31.47.0-255,66,154338,92,290045
33954,0.001877,172.31.47.0-255,66,154404,92,290045
33955,0.001882,172.217.194.0-255,2184,156588,92,290045
33956,0.00189,172.31.47.0-255,66,156654,92,290045
33957,0.001986,172.217.194.0-255,1484,158138,92,290045
33958,0.002006,172.217.194.0-255,2902,161040,92,290045
33959,0.002009,172.31.47.0-255,66,161106,92,290045
33960,0.002012,172.217.194.0-255,1484,162590,92,290045
33961,0.002043,172.217.194.0-255,4320,166910,92,290045
33962,0.002049,172.31.47.0-255,66,166976,92,290045
33963,0.00209,172.31.47.0-255,66,167042,92,290045
33964,0.002104,172.217.194.0-255,1484,168526,92,290045
33965,0.011037,172.217.194.0-255,1484,170010,92,290045
33966,0.01469,172.31.47.0-255,66,170076,92,290045
33967,0.017003,172.217.194.0-255,5738,175814,92,290045
33968,0.017021,172.31.47.0-255,66,175880,92,290045
33969,0.019304,172.217.194.0-255,5738,181618,92,290045
33970,0.019326,172.31.47.0-255,66,181684,92,290045
33971,0.021626,172.217.194.0-255,5738,187422,92,290045
33972,0.021643,172.31.47.0-255,66,187488,92,290045
33973,0.0239,172.217.194.0-255,5738,193226,92,290045
33974,0.023912,172.31.47.0-255,66,193292,92,290045
33975,0.026173,172.217.194.0-255,5738,199030,92,290045
33976,0.026181,172.31.47.0-255,66,199096,92,290045
33977,0.028616,172.217.194.0-255,5738,204834,92,290045
33978,0.028676,172.31.47.0-255,66,204900,92,290045
33979,0.030945,172.217.194.0-255,5738,210638,92,290045
33980,0.030955,172.31.47.0-255,66,210704,92,290045
33981,0.033236,172.217.194.0-255,5738,216442,92,290045
33982,0.033247,172.31.47.0-255,66,216508,92,290045
33983,0.035531,172.217.194.0-255,5738,222246,92,290045
33984,0.035548,172.31.47.0-255,66,222312,92,290045
33985,0.037839,172.217.194.0-255,5738,228050,92,290045
33986,0.037854,172.31.47.0-255,66,228116,92,290045
33987,0.040143,172.217.194.0-255,5738,233854,92,290045
33988,0.040159,172.31.47.0-255,66,233920,92,290045
33989,0.042424,172.217.194.0-255,5738,239658,92,290045
33990,0.042437,172.31.47.0-255,66,239724,92,290045
33991,0.044687,172.217.194.0-255,5738,245462,92,290045
33992,0.044699,172.31.47.0-255,66,245528,92,290045
33993,0.046041,172.31.47.0-255,172,245700,92,290045
33994,0.046097,172.31.47.0-255,1107,246807,92,290045
33995,0.046184,172.31.47.0-255,1514,248321,92,290045
33996,0.046186,172.31.47.0-255,1514,249835,92,290045
33997,0.046187,172.31.47.0-255,1514,251349,92,290045
33998,0.046188,172.31.47.0-255,1514,252863,92,290045
33999,0.046189,172.31.47.0-255,1500,254363,92,290045
34000,0.046938,172.217.194.0-255,5738,260101,92,290045
34001,0.046946,172.31.47.0-255,66,260167,92,290045
34002,0.047561,104.244.42.0-255,66,260233,92,290045
34003,0.047647,104.244.42.0-255,66,260299,92,290045
34004,0.047747,104.244.42.0-255,66,260365,92,290045
34005,0.049182,172.217.194.0-255,2902,263267,92,290045
34006,0.049186,172.31.47.0-255,66,263333,92,290045
34007,0.049226,172.217.194.0-255,2902,266235,92,290045
34008,0.04923,172.31.47.0-255,66,266301,92,290045
34009,0.051416,172.217.194.0-255,2902,269203,92,290045
34010,0.051422,172.31.47.0-255,66,269269,92,290045
34011,0.051474,172.217.194.0-255,2902,272171,92,290045
34012,0.051478,172.31.47.0-255,66,272237,92,290045
34013,0.053663,172.217.194.0-255,2902,275139,92,290045
34014,0.053669,172.31.47.0-255,66,275205,92,290045
34015,0.053732,172.217.194.0-255,2902,278107,92,290045
34016,0.053737,172.31.47.0-255,66,278173,92,290045
34017,0.055933,172.217.194.0-255,2902,281075,92,290045
34018,0.055946,172.31.47.0-255,66,281141,92,290045
34019,0.055984,172.217.194.0-255,2902,284043,92,290045
34020,0.055987,172.31.47.0-255,66,284109,92,290045
34021,0.058203,172.217.194.0-255,2902,287011,92,290045
34022,0.058211,172.31.47.0-255,66,287077,92,290045
34023,0.058248,172.217.194.0-255,2902,289979,92,290045
34024,0.058251,172.31.47.0-255,66,290045,92,290045
34025,0.0,172.31.47.0-255,162,162,92,228
34026,0.00789,74.125.24.0-255,66,228,92,228
34027,0.0,74.125.130.0-255,153,153,92,328969
34028,2.1e-05,172.31.47.0-255,66,219,92,328969
34029,2.7e-05,74.125.130.0-255,1484,1703,92,328969
34030,3.2e-05,172.31.47.0-255,66,1769,92,328969
34031,3.7e-05,74.125.130.0-255,2902,4671,92,328969
34032,3.9e-05,172.31.47.0-255,66,4737,92,328969
34033,6.2e-05,74.125.130.0-255,1484,6221,92,328969
34034,6.4e-05,172.31.47.0-255,66,6287,92,328969
34035,9e-05,74.125.130.0-255,4320,10607,92,328969
34036,9.3e-05,172.31.47.0-255,66,10673,92,328969
34037,9.7e-05,74.125.130.0-255,3545,14218,92,328969
34038,9.9e-05,172.31.47.0-255,66,14284,92,328969
34039,0.000104,74.125.130.0-255,4320,18604,92,328969
34040,0.000106,172.31.47.0-255,66,18670,92,328969
34041,0.000135,172.31.47.0-255,66,18736,92,328969
34042,0.000178,74.125.130.0-255,3961,22697,92,328969
34043,0.000181,172.31.47.0-255,66,22763,92,328969
34044,0.000359,74.125.130.0-255,1484,24247,92,328969
34045,0.000364,74.125.130.0-255,2902,27149,92,328969
34046,0.000369,172.31.47.0-255,66,27215,92,328969
34047,0.000373,172.31.47.0-255,66,27281,92,328969
34048,0.000385,74.125.130.0-255,4320,31601,92,328969
34049,0.000388,172.31.47.0-255,66,31667,92,328969
34050,0.000421,74.125.130.0-255,5738,37405,92,328969
34051,0.000424,172.31.47.0-255,66,37471,92,328969
34052,0.000439,74.125.130.0-255,3961,41432,92,328969
34053,0.000441,172.31.47.0-255,66,41498,92,328969
34054,0.000445,74.125.130.0-255,2902,44400,92,328969
34055,0.000447,172.31.47.0-255,66,44466,92,328969
34056,0.000488,74.125.130.0-255,4320,48786,92,328969
34057,0.000491,172.31.47.0-255,66,48852,92,328969
34058,0.000519,74.125.130.0-255,366,49218,92,328969
34059,0.000527,172.31.47.0-255,66,49284,92,328969
34060,0.000645,74.125.130.0-255,1484,50768,92,328969
34061,0.000664,74.125.130.0-255,2902,53670,92,328969
34062,0.000669,74.125.130.0-255,4320,57990,92,328969
34063,0.000683,74.125.130.0-255,1484,59474,92,328969
34064,0.000685,74.125.130.0-255,1484,60958,92,328969
34065,0.000689,74.125.130.0-255,2902,63860,92,328969
34066,0.000694,172.31.47.0-255,66,63926,92,328969
34067,0.000717,74.125.130.0-255,6797,70723,92,328969
34068,0.000732,74.125.130.0-255,4320,75043,92,328969
34069,0.000738,172.31.47.0-255,66,75109,92,328969
34070,0.000752,74.125.130.0-255,5738,80847,92,328969
34071,0.000769,172.31.47.0-255,66,80913,92,328969
34072,0.00078,74.125.130.0-255,2543,83456,92,328969
34073,0.000796,172.31.47.0-255,66,83522,92,328969
34074,0.001003,74.125.130.0-255,1484,85006,92,328969
34075,0.001014,74.125.130.0-255,1484,86490,92,328969
34076,0.001017,172.31.47.0-255,66,86556,92,328969
34077,0.001028,74.125.130.0-255,1484,88040,92,328969
34078,0.00103,74.125.130.0-255,1484,89524,92,328969
34079,0.001041,74.125.130.0-255,1484,91008,92,328969
34080,0.001051,74.125.130.0-255,1484,92492,92,328969
34081,0.001057,172.31.47.0-255,66,92558,92,328969
34082,0.001077,74.125.130.0-255,5738,98296,92,328969
34083,0.00108,172.31.47.0-255,66,98362,92,328969
34084,0.001097,74.125.130.0-255,1484,99846,92,328969
34085,0.001101,74.125.130.0-255,2902,102748,92,328969
34086,0.001115,172.31.47.0-255,66,102814,92,328969
34087,0.001126,74.125.130.0-255,5738,108552,92,328969
34088,0.00113,74.125.130.0-255,2902,111454,92,328969
34089,0.001154,74.125.130.0-255,4320,115774,92,328969
34090,0.001157,172.31.47.0-255,66,115840,92,328969
34091,0.001161,172.31.47.0-255,66,115906,92,328969
34092,0.001178,74.125.130.0-255,2184,118090,92,328969
34093,0.00119,172.31.47.0-255,66,118156,92,328969
34094,0.001249,74.125.130.0-255,1484,119640,92,328969
34095,0.001262,74.125.130.0-255,2902,122542,92,328969
34096,0.001269,172.31.47.0-255,66,122608,92,328969
34097,0.001289,74.125.130.0-255,5738,128346,92,328969
34098,0.001294,74.125.130.0-255,2902,131248,92,328969
34099,0.001297,74.125.130.0-255,2902,134150,92,328969
34100,0.001303,172.31.47.0-255,66,134216,92,328969
34101,0.001316,74.125.130.0-255,1484,135700,92,328969
34102,0.001323,74.125.130.0-255,5738,141438,92,328969
34103,0.001341,74.125.130.0-255,2902,144340,92,328969
34104,0.001345,74.125.130.0-255,4320,148660,92,328969
34105,0.001355,172.31.47.0-255,66,148726,92,328969
34106,0.001388,74.125.130.0-255,3602,152328,92,328969
34107,0.001395,172.31.47.0-255,66,152394,92,328969
34108,0.00148,74.125.130.0-255,1484,153878,92,328969
34109,0.00153,74.125.130.0-255,2902,156780,92,328969
34110,0.001533,172.31.47.0-255,66,156846,92,328969
34111,0.001539,74.125.130.0-255,5738,162584,92,328969
34112,0.001541,74.125.130.0-255,1484,164068,92,328969
34113,0.001546,172.31.47.0-255,66,164134,92,328969
34114,0.001575,74.125.130.0-255,5738,169872,92,328969
34115,0.001595,74.125.130.0-255,6438,176310,92,328969
34116,0.001598,172.31.47.0-255,66,176376,92,328969
34117,0.001603,172.31.47.0-255,66,176442,92,328969
34118,0.001811,74.125.130.0-255,1484,177926,92,328969
34119,0.001823,74.125.130.0-255,2902,180828,92,328969
34120,0.001826,172.31.47.0-255,66,180894,92,328969
34121,0.00185,74.125.130.0-255,4320,185214,92,328969
34122,0.001855,74.125.130.0-255,4320,189534,92,328969
34123,0.001859,172.31.47.0-255,66,189600,92,328969
34124,0.001867,74.125.130.0-255,1484,191084,92,328969
34125,0.001891,74.125.130.0-255,5738,196822,92,328969
34126,0.001906,74.125.130.0-255,5738,202560,92,328969
34127,0.00191,172.31.47.0-255,66,202626,92,328969
34128,0.001914,172.31.47.0-255,66,202692,92,328969
34129,0.001938,74.125.130.0-255,2902,205594,92,328969
34130,0.001946,172.31.47.0-255,66,205660,92,328969
34131,0.001963,74.125.130.0-255,5020,210680,92,328969
34132,0.001969,172.31.47.0-255,66,210746,92,328969
34133,0.002239,74.125.130.0-255,1484,212230,92,328969
34134,0.002256,74.125.130.0-255,2902,215132,92,328969
34135,0.002259,172.31.47.0-255,66,215198,92,328969
34136,0.002263,74.125.130.0-255,1484,216682,92,328969
34137,0.002285,74.125.130.0-255,4320,221002,92,328969
34138,0.002291,172.31.47.0-255,66,221068,92,328969
34139,0.00231,74.125.130.0-255,5738,226806,92,328969
34140,0.012108,74.125.130.0-255,1484,228290,92,328969
34141,0.014562,172.31.47.0-255,66,228356,92,328969
34142,0.016876,74.125.130.0-255,5738,234094,92,328969
34143,0.016893,172.31.47.0-255,66,234160,92,328969
34144,0.019177,74.125.130.0-255,5738,239898,92,328969
34145,0.01919,172.31.47.0-255,66,239964,92,328969
34146,0.021491,74.125.130.0-255,5738,245702,92,328969
34147,0.021499,172.31.47.0-255,66,245768,92,328969
34148,0.023777,74.125.130.0-255,5738,251506,92,328969
34149,0.030498,172.31.47.0-255,66,251572,92,328969
34150,0.032794,74.125.130.0-255,5738,257310,92,328969
34151,0.032805,172.31.47.0-255,66,257376,92,328969
34152,0.035085,74.125.130.0-255,5738,263114,92,328969
34153,0.035093,172.31.47.0-255,66,263180,92,328969
34154,0.037368,74.125.130.0-255,5738,268918,92,328969
34155,0.037375,172.31.47.0-255,66,268984,92,328969
34156,0.039661,74.125.130.0-255,5738,274722,92,328969
34157,0.039667,172.31.47.0-255,66,274788,92,328969
34158,0.041946,74.125.130.0-255,5738,280526,92,328969
34159,0.041953,172.31.47.0-255,66,280592,92,328969
34160,0.044209,172.31.47.0-255,172,280764,92,328969
34161,0.04423,74.125.130.0-255,5738,286502,92,328969
34162,0.044234,172.31.47.0-255,66,286568,92,328969
34163,0.044277,172.31.47.0-255,1103,287671,92,328969
34164,0.044349,172.31.47.0-255,1514,289185,92,328969
34165,0.044351,172.31.47.0-255,1514,290699,92,328969
34166,0.044352,172.31.47.0-255,1514,292213,92,328969
34167,0.044353,172.31.47.0-255,1514,293727,92,328969
34168,0.044353,172.31.47.0-255,1506,295233,92,328969
34169,0.045733,104.244.42.0-255,66,295299,92,328969
34170,0.045833,104.244.42.0-255,66,295365,92,328969
34171,0.045905,104.244.42.0-255,66,295431,92,328969
34172,0.045907,104.244.42.0-255,66,295497,92,328969
34173,0.046501,74.125.130.0-255,5738,301235,92,328969
34174,0.046507,172.31.47.0-255,66,301301,92,328969
34175,0.048793,74.125.130.0-255,5738,307039,92,328969
34176,0.048799,172.31.47.0-255,66,307105,92,328969
34177,0.051071,74.125.130.0-255,5738,312843,92,328969
34178,0.051076,172.31.47.0-255,66,312909,92,328969
34179,0.053345,74.125.130.0-255,4320,317229,92,328969
34180,0.05335,172.31.47.0-255,66,317295,92,328969
34181,0.053374,74.125.130.0-255,1484,318779,92,328969
34182,0.05562,74.125.130.0-255,4320,323099,92,328969
34183,0.055625,172.31.47.0-255,66,323165,92,328969
34184,0.057906,74.125.130.0-255,5738,328903,92,328969
34185,0.057953,172.31.47.0-255,66,328969,92,328969
34186,0.0,172.217.194.0-255,152,152,92,228689
34187,2e-05,172.31.47.0-255,66,218,92,228689
34188,2.7e-05,172.217.194.0-255,1484,1702,92,228689
34189,3.1e-05,172.31.47.0-255,66,1768,92,228689
34190,3.5e-05,172.217.194.0-255,2902,4670,92,228689
34191,3.8e-05,172.31.47.0-255,66,4736,92,228689
34192,4.2e-05,172.217.194.0-255,2902,7638,92,228689
34193,4.3e-05,172.31.47.0-255,66,7704,92,228689
34194,7.2e-05,172.217.194.0-255,4320,12024,92,228689
34195,7.4e-05,172.31.47.0-255,66,12090,92,228689
34196,7.7e-05,172.217.194.0-255,2902,14992,92,228689
34197,7.9e-05,172.31.47.0-255,66,15058,92,228689
34198,0.000105,172.31.47.0-255,66,15124,92,228689
34199,0.000108,172.217.194.0-255,2543,17667,92,228689
34200,0.000109,172.31.47.0-255,66,17733,92,228689
34201,0.000149,172.217.194.0-255,1484,19217,92,228689
34202,0.000151,172.31.47.0-255,66,19283,92,228689
34203,0.00018,172.31.47.0-255,66,19349,92,228689
34204,0.000586,172.217.194.0-255,1484,20833,92,228689
34205,0.00059,172.31.47.0-255,66,20899,92,228689
34206,0.000594,172.217.194.0-255,2902,23801,92,228689
34207,0.000595,172.31.47.0-255,66,23867,92,228689
34208,0.0006,172.217.194.0-255,5738,29605,92,228689
34209,0.000602,172.31.47.0-255,66,29671,92,228689
34210,0.000657,172.217.194.0-255,1484,31155,92,228689
34211,0.000659,172.31.47.0-255,66,31221,92,228689
34212,0.000683,172.217.194.0-255,5379,36600,92,228689
34213,0.000685,172.31.47.0-255,66,36666,92,228689
34214,0.000691,172.217.194.0-255,7156,43822,92,228689
34215,0.000692,172.31.47.0-255,66,43888,92,228689
34216,0.000709,172.217.194.0-255,4320,48208,92,228689
34217,0.000711,172.31.47.0-255,66,48274,92,228689
34218,0.000722,172.217.194.0-255,2902,51176,92,228689
34219,0.000723,172.31.47.0-255,66,51242,92,228689
34220,0.000745,172.217.194.0-255,5379,56621,92,228689
34221,0.000747,172.31.47.0-255,66,56687,92,228689
34222,0.00075,172.217.194.0-255,2902,59589,92,228689
34223,0.000751,172.31.47.0-255,66,59655,92,228689
34224,0.000784,172.31.47.0-255,66,59721,92,228689
34225,0.000787,172.217.194.0-255,1705,61426,92,228689
34226,0.000789,172.31.47.0-255,66,61492,92,228689
34227,0.001114,172.217.194.0-255,1484,62976,92,228689
34228,0.001123,172.217.194.0-255,2902,65878,92,228689
34229,0.001126,172.31.47.0-255,66,65944,92,228689
34230,0.001129,172.217.194.0-255,1484,67428,92,228689
34231,0.001146,172.217.194.0-255,4320,71748,92,228689
34232,0.001148,172.31.47.0-255,66,71814,92,228689
34233,0.001166,172.217.194.0-255,1484,73298,92,228689
34234,0.00118,172.217.194.0-255,5738,79036,92,228689
34235,0.001182,172.31.47.0-255,66,79102,92,228689
34236,0.001197,172.217.194.0-255,5738,84840,92,228689
34237,0.001198,172.31.47.0-255,66,84906,92,228689
34238,0.001208,172.31.47.0-255,66,84972,92,228689
34239,0.00121,172.217.194.0-255,1484,86456,92,228689
34240,0.00124,172.217.194.0-255,4320,90776,92,228689
34241,0.001243,172.31.47.0-255,66,90842,92,228689
34242,0.001248,172.217.194.0-255,7156,97998,92,228689
34243,0.00125,172.31.47.0-255,66,98064,92,228689
34244,0.001282,172.31.47.0-255,66,98130,92,228689
34245,0.001305,172.217.194.0-255,2902,101032,92,228689
34246,0.001307,172.31.47.0-255,66,101098,92,228689
34247,0.001313,172.217.194.0-255,6438,107536,92,228689
34248,0.001315,172.31.47.0-255,66,107602,92,228689
34249,0.001414,172.217.194.0-255,1484,109086,92,228689
34250,0.001428,172.217.194.0-255,2902,111988,92,228689
34251,0.00143,172.31.47.0-255,66,112054,92,228689
34252,0.001433,172.217.194.0-255,1484,113538,92,228689
34253,0.00145,172.217.194.0-255,4320,117858,92,228689
34254,0.001453,172.31.47.0-255,66,117924,92,228689
34255,0.001456,172.217.194.0-255,2902,120826,92,228689
34256,0.001457,172.31.47.0-255,66,120892,92,228689
34257,0.001498,172.31.47.0-255,66,120958,92,228689
34258,0.001506,172.31.47.0-255,66,121024,92,228689
34259,0.00152,172.217.194.0-255,1484,122508,92,228689
34260,0.001541,172.217.194.0-255,3602,126110,92,228689
34261,0.001542,172.31.47.0-255,66,126176,92,228689
34262,0.001562,172.217.194.0-255,5738,131914,92,228689
34263,0.001565,172.31.47.0-255,66,131980,92,228689
34264,0.00157,172.217.194.0-255,5738,137718,92,228689
34265,0.001572,172.31.47.0-255,66,137784,92,228689
34266,0.001601,172.217.194.0-255,7156,144940,92,228689
34267,0.001604,172.31.47.0-255,66,145006,92,228689
34268,0.001613,172.31.47.0-255,66,145072,92,228689
34269,0.00163,172.217.194.0-255,4320,149392,92,228689
34270,0.001631,172.31.47.0-255,66,149458,92,228689
34271,0.001655,172.217.194.0-255,5738,155196,92,228689
34272,0.001657,172.31.47.0-255,66,155262,92,228689
34273,0.001659,172.217.194.0-255,1484,156746,92,228689
34274,0.001689,172.31.47.0-255,66,156812,92,228689
34275,0.001699,172.31.47.0-255,66,156878,92,228689
34276,0.001709,172.217.194.0-255,766,157644,92,228689
34277,0.001801,172.217.194.0-255,1484,159128,92,228689
34278,0.001805,172.31.47.0-255,66,159194,92,228689
34279,0.001809,172.217.194.0-255,2902,162096,92,228689
34280,0.001811,172.31.47.0-255,66,162162,92,228689
34281,0.001813,172.217.194.0-255,1484,163646,92,228689
34282,0.001827,172.217.194.0-255,4320,167966,92,228689
34283,0.001829,172.31.47.0-255,66,168032,92,228689
34284,0.001833,172.217.194.0-255,2902,170934,92,228689
34285,0.001835,172.31.47.0-255,66,171000,92,228689
34286,0.001852,172.217.194.0-255,1484,172484,92,228689
34287,0.001856,172.217.194.0-255,4320,176804,92,228689
34288,0.001858,172.31.47.0-255,66,176870,92,228689
34289,0.001874,172.217.194.0-255,7156,184026,92,228689
34290,0.001876,172.31.47.0-255,66,184092,92,228689
34291,0.0019,172.31.47.0-255,66,184158,92,228689
34292,0.001985,172.217.194.0-255,1484,185642,92,228689
34293,0.001998,172.217.194.0-255,2902,188544,92,228689
34294,0.002,172.31.47.0-255,66,188610,92,228689
34295,0.002021,172.217.194.0-255,5738,194348,92,228689
34296,0.002023,172.31.47.0-255,66,194414,92,228689
34297,0.002049,172.31.47.0-255,66,194480,92,228689
34298,0.002068,172.217.194.0-255,2902,197382,92,228689
34299,0.002069,172.31.47.0-255,66,197448,92,228689
34300,0.002077,172.31.47.0-255,66,197514,92,228689
34301,0.002096,172.217.194.0-255,1484,198998,92,228689
34302,0.002142,172.31.47.0-255,66,199064,92,228689
34303,0.002161,172.31.47.0-255,66,199130,92,228689
34304,0.002171,172.31.47.0-255,66,199196,92,228689
34305,0.002208,172.217.194.0-255,6438,205634,92,228689
34306,0.00221,172.31.47.0-255,66,205700,92,228689
34307,0.002223,172.31.47.0-255,66,205766,92,228689
34308,0.002229,172.217.194.0-255,6438,212204,92,228689
34309,0.00223,172.31.47.0-255,66,212270,92,228689
34310,0.002247,172.217.194.0-255,1484,213754,92,228689
34311,0.002261,172.217.194.0-255,4320,218074,92,228689
34312,0.002263,172.31.47.0-255,66,218140,92,228689
34313,0.00229,172.31.47.0-255,66,218206,92,228689
34314,0.002305,172.217.194.0-255,1109,219315,92,228689
34315,0.002307,172.217.194.0-255,105,219420,92,228689
34316,0.009145,172.31.47.0-255,66,219486,92,228689
34317,0.009171,172.31.47.0-255,105,219591,92,228689
34318,0.011681,172.217.194.0-255,66,219657,92,228689
34319,0.032173,172.31.47.0-255,172,219829,92,228689
34320,0.032199,172.31.47.0-255,1107,220936,92,228689
34321,0.032242,172.31.47.0-255,1514,222450,92,228689
34322,0.032243,172.31.47.0-255,1514,223964,92,228689
34323,0.032244,172.31.47.0-255,1514,225478,92,228689
34324,0.032245,172.31.47.0-255,1514,226992,92,228689
34325,0.032246,172.31.47.0-255,1499,228491,92,228689
34326,0.033725,104.244.42.0-255,66,228557,92,228689
34327,0.033769,104.244.42.0-255,66,228623,92,228689
34328,0.033859,104.244.42.0-255,66,228689,92,228689
34329,0.0,74.125.68.0-255,152,152,92,376666
34330,3.1e-05,172.31.47.0-255,66,218,92,376666
34331,3.7e-05,74.125.68.0-255,1484,1702,92,376666
34332,4e-05,172.31.47.0-255,66,1768,92,376666
34333,4.4e-05,74.125.68.0-255,2902,4670,92,376666
34334,4.6e-05,172.31.47.0-255,66,4736,92,376666
34335,5e-05,74.125.68.0-255,4320,9056,92,376666
34336,5.2e-05,172.31.47.0-255,66,9122,92,376666
34337,7.6e-05,74.125.68.0-255,1484,10606,92,376666
34338,7.8e-05,172.31.47.0-255,66,10672,92,376666
34339,0.000107,172.31.47.0-255,66,10738,92,376666
34340,0.000112,74.125.68.0-255,4320,15058,92,376666
34341,0.000113,172.31.47.0-255,66,15124,92,376666
34342,0.00015,74.125.68.0-255,2902,18026,92,376666
34343,0.000154,172.31.47.0-255,66,18092,92,376666
34344,0.00017,74.125.68.0-255,5379,23471,92,376666
34345,0.000174,172.31.47.0-255,66,23537,92,376666
34346,0.000209,74.125.68.0-255,1484,25021,92,376666
34347,0.000212,172.31.47.0-255,66,25087,92,376666
34348,0.000222,74.125.68.0-255,2902,27989,92,376666
34349,0.000224,172.31.47.0-255,66,28055,92,376666
34350,0.000262,74.125.68.0-255,2902,30957,92,376666
34351,0.000264,172.31.47.0-255,66,31023,92,376666
34352,0.000269,74.125.68.0-255,2902,33925,92,376666
34353,0.000271,172.31.47.0-255,66,33991,92,376666
34354,0.000284,74.125.68.0-255,1484,35475,92,376666
34355,0.000286,172.31.47.0-255,66,35541,92,376666
34356,0.000309,74.125.68.0-255,2902,38443,92,376666
34357,0.000312,172.31.47.0-255,66,38509,92,376666
34358,0.000332,74.125.68.0-255,6797,45306,92,376666
34359,0.000335,172.31.47.0-255,66,45372,92,376666
34360,0.000345,172.31.47.0-255,66,45438,92,376666
34361,0.000364,74.125.68.0-255,1484,46922,92,376666
34362,0.000369,74.125.68.0-255,2813,49735,92,376666
34363,0.000371,172.31.47.0-255,66,49801,92,376666
34364,0.000373,74.125.68.0-255,133,49934,92,376666
34365,0.000401,74.125.68.0-255,350,50284,92,376666
34366,0.000562,74.125.68.0-255,1484,51768,92,376666
34367,0.000566,172.31.47.0-255,66,51834,92,376666
34368,0.000578,74.125.68.0-255,1484,53318,92,376666
34369,0.000595,74.125.68.0-255,1484,54802,92,376666
34370,0.000597,172.31.47.0-255,66,54868,92,376666
34371,0.000603,74.125.68.0-255,5738,60606,92,376666
34372,0.000605,172.31.47.0-255,66,60672,92,376666
34373,0.00061,74.125.68.0-255,4320,64992,92,376666
34374,0.000611,172.31.47.0-255,66,65058,92,376666
34375,0.000615,74.125.68.0-255,2902,67960,92,376666
34376,0.000617,172.31.47.0-255,66,68026,92,376666
34377,0.000636,74.125.68.0-255,2902,70928,92,376666
34378,0.000639,172.31.47.0-255,66,70994,92,376666
34379,0.000664,74.125.68.0-255,4320,75314,92,376666
34380,0.000668,172.31.47.0-255,66,75380,92,376666
34381,0.000683,74.125.68.0-255,4320,79700,92,376666
34382,0.000686,172.31.47.0-255,66,79766,92,376666
34383,0.000704,74.125.68.0-255,1484,81250,92,376666
34384,0.000718,74.125.68.0-255,3602,84852,92,376666
34385,0.000721,172.31.47.0-255,66,84918,92,376666
34386,0.001024,74.125.68.0-255,1484,86402,92,376666
34387,0.00103,74.125.68.0-255,1484,87886,92,376666
34388,0.001033,172.31.47.0-255,66,87952,92,376666
34389,0.00105,74.125.68.0-255,1484,89436,92,376666
34390,0.001054,74.125.68.0-255,2902,92338,92,376666
34391,0.001056,172.31.47.0-255,66,92404,92,376666
34392,0.001076,74.125.68.0-255,2902,95306,92,376666
34393,0.001078,172.31.47.0-255,66,95372,92,376666
34394,0.001108,74.125.68.0-255,4320,99692,92,376666
34395,0.001111,172.31.47.0-255,66,99758,92,376666
34396,0.001134,74.125.68.0-255,5738,105496,92,376666
34397,0.001136,172.31.47.0-255,66,105562,92,376666
34398,0.001139,74.125.68.0-255,1484,107046,92,376666
34399,0.001155,74.125.68.0-255,2902,109948,92,376666
34400,0.001157,172.31.47.0-255,66,110014,92,376666
34401,0.00118,74.125.68.0-255,7156,117170,92,376666
34402,0.001183,172.31.47.0-255,66,117236,92,376666
34403,0.001187,74.125.68.0-255,2184,119420,92,376666
34404,0.001188,172.31.47.0-255,66,119486,92,376666
34405,0.001229,74.125.68.0-255,1484,120970,92,376666
34406,0.001246,74.125.68.0-255,2902,123872,92,376666
34407,0.001248,172.31.47.0-255,66,123938,92,376666
34408,0.001266,74.125.68.0-255,4320,128258,92,376666
34409,0.001268,172.31.47.0-255,66,128324,92,376666
34410,0.001284,74.125.68.0-255,1484,129808,92,376666
34411,0.001289,74.125.68.0-255,4320,134128,92,376666
34412,0.00129,172.31.47.0-255,66,134194,92,376666
34413,0.001303,74.125.68.0-255,2902,137096,92,376666
34414,0.001304,172.31.47.0-255,66,137162,92,376666
34415,0.001322,74.125.68.0-255,7156,144318,92,376666
34416,0.001324,172.31.47.0-255,66,144384,92,376666
34417,0.001347,74.125.68.0-255,4320,148704,92,376666
34418,0.00135,172.31.47.0-255,66,148770,92,376666
34419,0.001378,74.125.68.0-255,5020,153790,92,376666
34420,0.001381,172.31.47.0-255,66,153856,92,376666
34421,0.001698,74.125.68.0-255,1484,155340,92,376666
34422,0.001704,74.125.68.0-255,2902,158242,92,376666
34423,0.001707,172.31.47.0-255,66,158308,92,376666
34424,0.001711,74.125.68.0-255,1484,159792,92,376666
34425,0.001724,74.125.68.0-255,1484,161276,92,376666
34426,0.001725,172.31.47.0-255,66,161342,92,376666
34427,0.001738,74.125.68.0-255,1484,162826,92,376666
34428,0.001743,74.125.68.0-255,4320,167146,92,376666
34429,0.001745,172.31.47.0-255,66,167212,92,376666
34430,0.001763,74.125.68.0-255,1484,168696,92,376666
34431,0.001766,74.125.68.0-255,1484,170180,92,376666
34432,0.001767,172.31.47.0-255,66,170246,92,376666
34433,0.001783,172.31.47.0-255,66,170312,92,376666
34434,0.001795,74.125.68.0-255,1484,171796,92,376666
34435,0.001815,74.125.68.0-255,1484,173280,92,376666
34436,0.001817,172.31.47.0-255,66,173346,92,376666
34437,0.001837,74.125.68.0-255,6438,179784,92,376666
34438,0.001839,172.31.47.0-255,66,179850,92,376666
34439,0.001936,74.125.68.0-255,1484,181334,92,376666
34440,0.00199,74.125.68.0-255,2902,184236,92,376666
34441,0.001993,172.31.47.0-255,66,184302,92,376666
34442,0.001998,74.125.68.0-255,5738,190040,92,376666
34443,0.002,172.31.47.0-255,66,190106,92,376666
34444,0.002005,74.125.68.0-255,7156,197262,92,376666
34445,0.002007,172.31.47.0-255,66,197328,92,376666
34446,0.002041,74.125.68.0-255,4320,201648,92,376666
34447,0.002043,172.31.47.0-255,66,201714,92,376666
34448,0.003983,74.125.68.0-255,1484,203198,92,376666
34449,0.004007,74.125.68.0-255,2902,206100,92,376666
34450,0.004009,172.31.47.0-255,66,206166,92,376666
34451,0.004024,74.125.68.0-255,1484,207650,92,376666
34452,0.005997,74.125.68.0-255,4320,211970,92,376666
34453,0.006005,172.31.47.0-255,66,212036,92,376666
34454,0.007997,74.125.68.0-255,5738,217774,92,376666
34455,0.008002,172.31.47.0-255,66,217840,92,376666
34456,0.009986,74.125.68.0-255,4320,222160,92,376666
34457,0.009993,172.31.47.0-255,66,222226,92,376666
34458,0.010012,74.125.68.0-255,1484,223710,92,376666
34459,0.011984,74.125.68.0-255,4320,228030,92,376666
34460,0.011989,172.31.47.0-255,66,228096,92,376666
34461,0.013984,74.125.68.0-255,5738,233834,92,376666
34462,0.013991,172.31.47.0-255,66,233900,92,376666
34463,0.015982,74.125.68.0-255,5738,239638,92,376666
34464,0.01599,172.31.47.0-255,66,239704,92,376666
34465,0.017976,74.125.68.0-255,5738,245442,92,376666
34466,0.017981,172.31.47.0-255,66,245508,92,376666
34467,0.019973,74.125.68.0-255,5738,251246,92,376666
34468,0.019979,172.31.47.0-255,66,251312,92,376666
34469,0.021967,74.125.68.0-255,5738,257050,92,376666
34470,0.021972,172.31.47.0-255,66,257116,92,376666
34471,0.023961,74.125.68.0-255,5738,262854,92,376666
34472,0.023967,172.31.47.0-255,66,262920,92,376666
34473,0.025961,74.125.68.0-255,5738,268658,92,376666
34474,0.025969,172.31.47.0-255,66,268724,92,376666
34475,0.027962,74.125.68.0-255,5738,274462,92,376666
34476,0.027968,172.31.47.0-255,66,274528,92,376666
34477,0.029853,172.31.47.0-255,172,274700,92,376666
34478,0.029879,172.31.47.0-255,1111,275811,92,376666
34479,0.029916,172.31.47.0-255,1514,277325,92,376666
34480,0.029918,172.31.47.0-255,1514,278839,92,376666
34481,0.029922,172.31.47.0-255,1514,280353,92,376666
34482,0.029923,172.31.47.0-255,1514,281867,92,376666
34483,0.029941,172.31.47.0-255,1497,283364,92,376666
34484,0.029952,74.125.68.0-255,5738,289102,92,376666
34485,0.029956,172.31.47.0-255,66,289168,92,376666
34486,0.031351,104.244.42.0-255,66,289234,92,376666
34487,0.03139,104.244.42.0-255,66,289300,92,376666
34488,0.031453,104.244.42.0-255,66,289366,92,376666
34489,0.031493,104.244.42.0-255,66,289432,92,376666
34490,0.031942,74.125.68.0-255,5738,295170,92,376666
34491,0.031947,172.31.47.0-255,66,295236,92,376666
34492,0.032105,104.244.42.0-255,108,295344,92,376666
34493,0.03211,172.31.47.0-255,66,295410,92,376666
34494,0.033934,74.125.68.0-255,5738,301148,92,376666
34495,0.033938,172.31.47.0-255,66,301214,92,376666
34496,0.035924,74.125.68.0-255,5738,306952,92,376666
34497,0.035931,172.31.47.0-255,66,307018,92,376666
34498,0.037917,74.125.68.0-255,5738,312756,92,376666
34499,0.037922,172.31.47.0-255,66,312822,92,376666
34500,0.0399,74.125.68.0-255,5738,318560,92,376666
34501,0.039904,172.31.47.0-255,66,318626,92,376666
34502,0.041899,74.125.68.0-255,5738,324364,92,376666
34503,0.041904,172.31.47.0-255,66,324430,92,376666
34504,0.043883,74.125.68.0-255,5738,330168,92,376666
34505,0.043888,172.31.47.0-255,66,330234,92,376666
34506,0.045878,74.125.68.0-255,5738,335972,92,376666
34507,0.045883,172.31.47.0-255,66,336038,92,376666
34508,0.047858,74.125.68.0-255,5738,341776,92,376666
34509,0.047877,172.31.47.0-255,66,341842,92,376666
34510,0.04987,74.125.68.0-255,5738,347580,92,376666
34511,0.049875,172.31.47.0-255,66,347646,92,376666
34512,0.051862,74.125.68.0-255,5738,353384,92,376666
34513,0.051869,172.31.47.0-255,66,353450,92,376666
34514,0.053857,74.125.68.0-255,5738,359188,92,376666
34515,0.053864,172.31.47.0-255,66,359254,92,376666
34516,0.055844,74.125.68.0-255,5738,364992,92,376666
34517,0.055848,172.31.47.0-255,66,365058,92,376666
34518,0.057858,74.125.68.0-255,5738,370796,92,376666
34519,0.057862,172.31.47.0-255,66,370862,92,376666
34520,0.05985,74.125.68.0-255,5738,376600,92,376666
34521,0.059855,172.31.47.0-255,66,376666,92,376666
34522,0.0,172.217.194.0-255,226,226,92,202173
34523,2e-05,172.31.47.0-255,66,292,92,202173
34524,3.2e-05,172.217.194.0-255,1484,1776,92,202173
34525,4e-05,172.31.47.0-255,66,1842,92,202173
34526,7e-05,172.217.194.0-255,2902,4744,92,202173
34527,7.3e-05,172.31.47.0-255,66,4810,92,202173
34528,9.4e-05,172.217.194.0-255,1484,6294,92,202173
34529,9.6e-05,172.31.47.0-255,66,6360,92,202173
34530,0.000247,172.217.194.0-255,5738,12098,92,202173
34531,0.000252,172.31.47.0-255,66,12164,92,202173
34532,0.000276,172.217.194.0-255,2205,14369,92,202173
34533,0.000279,172.31.47.0-255,66,14435,92,202173
34534,0.00057,172.217.194.0-255,2902,17337,92,202173
34535,0.000575,172.31.47.0-255,66,17403,92,202173
34536,0.000596,172.217.194.0-255,5738,23141,92,202173
34537,0.000599,172.31.47.0-255,66,23207,92,202173
34538,0.000924,172.217.194.0-255,5738,28945,92,202173
34539,0.000929,172.31.47.0-255,66,29011,92,202173
34540,0.000952,172.217.194.0-255,2579,31590,92,202173
34541,0.000955,172.31.47.0-255,66,31656,92,202173
34542,0.002336,172.217.194.0-255,2902,34558,92,202173
34543,0.002339,172.31.47.0-255,66,34624,92,202173
34544,0.002354,172.217.194.0-255,2648,37272,92,202173
34545,0.002356,172.31.47.0-255,66,37338,92,202173
34546,0.002437,172.217.194.0-255,4320,41658,92,202173
34547,0.00244,172.31.47.0-255,66,41724,92,202173
34548,0.00247,172.217.194.0-255,4408,46132,92,202173
34549,0.002474,172.31.47.0-255,66,46198,92,202173
34550,0.002777,172.217.194.0-255,232,46430,92,202173
34551,0.002784,172.31.47.0-255,66,46496,92,202173
34552,0.002803,172.217.194.0-255,4134,50630,92,202173
34553,0.002807,172.31.47.0-255,66,50696,92,202173
34554,0.00297,172.217.194.0-255,2902,53598,92,202173
34555,0.002974,172.31.47.0-255,66,53664,92,202173
34556,0.003013,172.31.47.0-255,66,53730,92,202173
34557,0.003414,172.217.194.0-255,5738,59468,92,202173
34558,0.00342,172.31.47.0-255,66,59534,92,202173
34559,0.003635,172.217.194.0-255,7156,66690,92,202173
34560,0.003641,172.31.47.0-255,66,66756,92,202173
34561,0.003667,172.217.194.0-255,1484,68240,92,202173
34562,0.003669,172.31.47.0-255,66,68306,92,202173
34563,0.003976,172.217.194.0-255,5738,74044,92,202173
34564,0.003982,172.31.47.0-255,66,74110,92,202173
34565,0.00401,172.217.194.0-255,2902,77012,92,202173
34566,0.004013,172.31.47.0-255,66,77078,92,202173
34567,0.004341,172.217.194.0-255,5738,82816,92,202173
34568,0.004346,172.31.47.0-255,66,82882,92,202173
34569,0.004526,172.217.194.0-255,7156,90038,92,202173
34570,0.004531,172.31.47.0-255,66,90104,92,202173
34571,0.004556,172.217.194.0-255,4320,94424,92,202173
34572,0.004559,172.31.47.0-255,66,94490,92,202173
34573,0.004921,172.217.194.0-255,2902,97392,92,202173
34574,0.004926,172.31.47.0-255,66,97458,92,202173
34575,0.00501,172.217.194.0-255,4320,101778,92,202173
34576,0.005014,172.31.47.0-255,66,101844,92,202173
34577,0.005312,172.217.194.0-255,4320,106164,92,202173
34578,0.00589,172.217.194.0-255,5738,111902,92,202173
34579,0.006134,172.217.194.0-255,2902,114804,92,202173
34580,0.007783,172.31.47.0-255,66,114870,92,202173
34581,0.010134,172.31.47.0-255,66,114936,92,202173
34582,0.010159,172.217.194.0-255,4320,119256,92,202173
34583,0.010162,172.31.47.0-255,66,119322,92,202173
34584,0.010196,172.217.194.0-255,4320,123642,92,202173
34585,0.010199,172.31.47.0-255,66,123708,92,202173
34586,0.010231,172.31.47.0-255,66,123774,92,202173
34587,0.010375,172.217.194.0-255,7156,130930,92,202173
34588,0.010378,172.31.47.0-255,66,130996,92,202173
34589,0.010408,172.217.194.0-255,7156,138152,92,202173
34590,0.010411,172.31.47.0-255,66,138218,92,202173
34591,0.010556,172.217.194.0-255,7156,145374,92,202173
34592,0.01056,172.31.47.0-255,66,145440,92,202173
34593,0.010588,172.217.194.0-255,7156,152596,92,202173
34594,0.010591,172.31.47.0-255,66,152662,92,202173
34595,0.010735,172.217.194.0-255,5738,158400,92,202173
34596,0.01074,172.31.47.0-255,66,158466,92,202173
34597,0.010811,172.31.47.0-255,66,158532,92,202173
34598,0.010993,172.217.194.0-255,4320,162852,92,202173
34599,0.010997,172.31.47.0-255,66,162918,92,202173
34600,0.011034,172.31.47.0-255,66,162984,92,202173
34601,0.011257,172.217.194.0-255,1484,164468,92,202173
34602,0.01126,172.31.47.0-255,66,164534,92,202173
34603,0.011277,172.217.194.0-255,5738,170272,92,202173
34604,0.011284,172.31.47.0-255,66,170338,92,202173
34605,0.01131,172.217.194.0-255,4190,174528,92,202173
34606,0.011313,172.31.47.0-255,66,174594,92,202173
34607,0.012477,172.217.194.0-255,7156,181750,92,202173
34608,0.012483,172.31.47.0-255,66,181816,92,202173
34609,0.012518,172.217.194.0-255,3032,184848,92,202173
34610,0.012522,172.31.47.0-255,66,184914,92,202173
34611,0.012547,172.31.47.0-255,66,184980,92,202173
34612,0.012576,172.217.194.0-255,2902,187882,92,202173
34613,0.012579,172.31.47.0-255,66,187948,92,202173
34614,0.0128,172.31.47.0-255,66,188014,92,202173
34615,0.012838,172.31.47.0-255,66,188080,92,202173
34616,0.013124,172.217.194.0-255,1484,189564,92,202173
34617,0.013127,172.31.47.0-255,66,189630,92,202173
34618,0.013173,172.31.47.0-255,66,189696,92,202173
34619,0.013501,172.31.47.0-255,66,189762,92,202173
34620,0.013548,172.31.47.0-255,66,189828,92,202173
34621,0.013849,172.217.194.0-255,2902,192730,92,202173
34622,0.014065,172.31.47.0-255,66,192796,92,202173
34623,0.014948,172.31.47.0-255,105,192901,92,202173
34624,0.017299,172.217.194.0-255,66,192967,92,202173
34625,0.030258,172.31.47.0-255,172,193139,92,202173
34626,0.030284,172.31.47.0-255,1111,194250,92,202173
34627,0.030329,172.31.47.0-255,1514,195764,92,202173
34628,0.030331,172.31.47.0-255,1514,197278,92,202173
34629,0.030332,172.31.47.0-255,1514,198792,92,202173
34630,0.030333,172.31.47.0-255,1514,200306,92,202173
34631,0.030334,172.31.47.0-255,1495,201801,92,202173
34632,0.031822,104.244.42.0-255,66,201867,92,202173
34633,0.031898,104.244.42.0-255,66,201933,92,202173
34634,0.031957,104.244.42.0-255,66,201999,92,202173
34635,0.033038,104.244.42.0-255,108,202107,92,202173
34636,0.033041,172.31.47.0-255,66,202173,92,202173
34637,0.0,74.125.130.0-255,153,153,92,355554
34638,2.9e-05,172.31.47.0-255,66,219,92,355554
34639,3.6e-05,74.125.130.0-255,1484,1703,92,355554
34640,4e-05,172.31.47.0-255,66,1769,92,355554
34641,4.3e-05,74.125.130.0-255,1484,3253,92,355554
34642,4.4e-05,172.31.47.0-255,66,3319,92,355554
34643,9.1e-05,74.125.130.0-255,2902,6221,92,355554
34644,9.4e-05,172.31.47.0-255,66,6287,92,355554
34645,9.9e-05,74.125.130.0-255,5738,12025,92,355554
34646,0.000101,172.31.47.0-255,66,12091,92,355554
34647,0.000104,74.125.130.0-255,2127,14218,92,355554
34648,0.000106,172.31.47.0-255,66,14284,92,355554
34649,0.000156,74.125.130.0-255,1484,15768,92,355554
34650,0.00016,172.31.47.0-255,66,15834,92,355554
34651,0.000168,74.125.130.0-255,2902,18736,92,355554
34652,0.00017,172.31.47.0-255,66,18802,92,355554
34653,0.000173,74.125.130.0-255,1484,20286,92,355554
34654,0.00018,172.31.47.0-255,66,20352,92,355554
34655,0.000209,74.125.130.0-255,4320,24672,92,355554
34656,0.000212,172.31.47.0-255,66,24738,92,355554
34657,0.000217,74.125.130.0-255,4320,29058,92,355554
34658,0.00022,172.31.47.0-255,66,29124,92,355554
34659,0.000255,74.125.130.0-255,2543,31667,92,355554
34660,0.000258,172.31.47.0-255,66,31733,92,355554
34661,0.000348,74.125.130.0-255,1484,33217,92,355554
34662,0.000353,172.31.47.0-255,66,33283,92,355554
34663,0.000357,74.125.130.0-255,1484,34767,92,355554
34664,0.000361,172.31.47.0-255,66,34833,92,355554
34665,0.000379,74.125.130.0-255,1484,36317,92,355554
34666,0.000383,172.31.47.0-255,66,36383,92,355554
34667,0.000389,74.125.130.0-255,5738,42121,92,355554
34668,0.000392,172.31.47.0-255,66,42187,92,355554
34669,0.000396,74.125.130.0-255,2902,45089,92,355554
34670,0.000398,172.31.47.0-255,66,45155,92,355554
34671,0.000436,74.125.130.0-255,4320,49475,92,355554
34672,0.000446,172.31.47.0-255,66,49541,92,355554
34673,0.000473,74.125.130.0-255,6797,56338,92,355554
34674,0.000477,74.125.130.0-255,4320,60658,92,355554
34675,0.000477,172.31.47.0-255,66,60724,92,355554
34676,0.00048,172.31.47.0-255,66,60790,92,355554
34677,0.000509,74.125.130.0-255,5669,66459,92,355554
34678,0.000512,172.31.47.0-255,66,66525,92,355554
34679,0.000536,74.125.130.0-255,366,66891,92,355554
34680,0.000606,74.125.130.0-255,1484,68375,92,355554
34681,0.000609,74.125.130.0-255,1484,69859,92,355554
34682,0.00061,172.31.47.0-255,66,69925,92,355554
34683,0.000635,74.125.130.0-255,1484,71409,92,355554
34684,0.000639,172.31.47.0-255,66,71475,92,355554
34685,0.000641,74.125.130.0-255,5738,77213,92,355554
34686,0.000643,74.125.130.0-255,1484,78697,92,355554
34687,0.000644,172.31.47.0-255,66,78763,92,355554
34688,0.000671,74.125.130.0-255,2902,81665,92,355554
34689,0.000676,74.125.130.0-255,5738,87403,92,355554
34690,0.000676,172.31.47.0-255,66,87469,92,355554
34691,0.000679,172.31.47.0-255,66,87535,92,355554
34692,0.000723,172.31.47.0-255,66,87601,92,355554
34693,0.000727,74.125.130.0-255,2184,89785,92,355554
34694,0.000729,172.31.47.0-255,66,89851,92,355554
34695,0.000789,74.125.130.0-255,1484,91335,92,355554
34696,0.000807,74.125.130.0-255,2902,94237,92,355554
34697,0.000811,172.31.47.0-255,66,94303,92,355554
34698,0.000815,74.125.130.0-255,1484,95787,92,355554
34699,0.000831,74.125.130.0-255,2902,98689,92,355554
34700,0.000834,172.31.47.0-255,66,98755,92,355554
34701,0.000864,172.31.47.0-255,66,98821,92,355554
34702,0.000867,74.125.130.0-255,2902,101723,92,355554
34703,0.00087,172.31.47.0-255,66,101789,92,355554
34704,0.00091,172.31.47.0-255,66,101855,92,355554
34705,0.000926,74.125.130.0-255,4320,106175,92,355554
34706,0.00093,172.31.47.0-255,66,106241,92,355554
34707,0.000933,74.125.130.0-255,766,107007,92,355554
34708,0.000981,74.125.130.0-255,1484,108491,92,355554
34709,0.000984,172.31.47.0-255,66,108557,92,355554
34710,0.001002,74.125.130.0-255,2902,111459,92,355554
34711,0.001005,172.31.47.0-255,66,111525,92,355554
34712,0.001008,74.125.130.0-255,1484,113009,92,355554
34713,0.001037,74.125.130.0-255,2902,115911,92,355554
34714,0.00104,172.31.47.0-255,66,115977,92,355554
34715,0.001046,74.125.130.0-255,5738,121715,92,355554
34716,0.001049,172.31.47.0-255,66,121781,92,355554
34717,0.001082,172.31.47.0-255,66,121847,92,355554
34718,0.001107,74.125.130.0-255,2902,124749,92,355554
34719,0.001109,172.31.47.0-255,66,124815,92,355554
34720,0.001114,74.125.130.0-255,4320,129135,92,355554
34721,0.001117,172.31.47.0-255,66,129201,92,355554
34722,0.001146,74.125.130.0-255,3602,132803,92,355554
34723,0.00115,172.31.47.0-255,66,132869,92,355554
34724,0.001241,74.125.130.0-255,1484,134353,92,355554
34725,0.001257,74.125.130.0-255,1484,135837,92,355554
34726,0.001261,172.31.47.0-255,66,135903,92,355554
34727,0.001278,74.125.130.0-255,2902,138805,92,355554
34728,0.001281,172.31.47.0-255,66,138871,92,355554
34729,0.001308,74.125.130.0-255,5738,144609,92,355554
34730,0.001312,172.31.47.0-255,66,144675,92,355554
34731,0.001315,74.125.130.0-255,1484,146159,92,355554
34732,0.001344,74.125.130.0-255,2902,149061,92,355554
34733,0.001347,172.31.47.0-255,66,149127,92,355554
34734,0.001353,74.125.130.0-255,5738,154865,92,355554
34735,0.001355,172.31.47.0-255,66,154931,92,355554
34736,0.001406,74.125.130.0-255,1484,156415,92,355554
34737,0.001435,74.125.130.0-255,5738,162153,92,355554
34738,0.00144,172.31.47.0-255,66,162219,92,355554
34739,0.001445,74.125.130.0-255,5020,167239,92,355554
34740,0.001447,172.31.47.0-255,66,167305,92,355554
34741,0.001468,74.125.130.0-255,1484,168789,92,355554
34742,0.00149,74.125.130.0-255,2902,171691,92,355554
34743,0.001493,172.31.47.0-255,66,171757,92,355554
34744,0.001528,74.125.130.0-255,5738,177495,92,355554
34745,0.001532,172.31.47.0-255,66,177561,92,355554
34746,0.001537,74.125.130.0-255,4320,181881,92,355554
34747,0.001539,172.31.47.0-255,66,181947,92,355554
34748,0.001546,74.125.130.0-255,5738,187685,92,355554
34749,0.001548,172.31.47.0-255,66,187751,92,355554
34750,0.001595,172.31.47.0-255,66,187817,92,355554
34751,0.001599,74.125.130.0-255,2184,190001,92,355554
34752,0.001601,172.31.47.0-255,66,190067,92,355554
34753,0.001653,74.125.130.0-255,1484,191551,92,355554
34754,0.001665,74.125.130.0-255,1484,193035,92,355554
34755,0.001668,172.31.47.0-255,66,193101,92,355554
34756,0.001695,74.125.130.0-255,2902,196003,92,355554
34757,0.001698,172.31.47.0-255,66,196069,92,355554
34758,0.001704,74.125.130.0-255,5738,201807,92,355554
34759,0.001706,172.31.47.0-255,66,201873,92,355554
34760,0.001744,74.125.130.0-255,7156,209029,92,355554
34761,0.001749,172.31.47.0-255,66,209095,92,355554
34762,0.001777,74.125.130.0-255,1484,210579,92,355554
34763,0.001788,172.31.47.0-255,66,210645,92,355554
34764,0.001793,74.125.130.0-255,3602,214247,92,355554
34765,0.001795,172.31.47.0-255,66,214313,92,355554
34766,0.00186,74.125.130.0-255,1484,215797,92,355554
34767,0.001872,74.125.130.0-255,1484,217281,92,355554
34768,0.001875,172.31.47.0-255,66,217347,92,355554
34769,0.001897,74.125.130.0-255,1484,218831,92,355554
34770,0.001904,74.125.130.0-255,5738,224569,92,355554
34771,0.001907,172.31.47.0-255,66,224635,92,355554
34772,0.001935,74.125.130.0-255,1484,226119,92,355554
34773,0.001958,172.31.47.0-255,66,226185,92,355554
34774,0.001983,74.125.130.0-255,2902,229087,92,355554
34775,0.001986,172.31.47.0-255,66,229153,92,355554
34776,0.001998,172.31.47.0-255,66,229219,92,355554
34777,0.004026,74.125.130.0-255,5738,234957,92,355554
34778,0.004033,172.31.47.0-255,66,235023,92,355554
34779,0.006077,74.125.130.0-255,5738,240761,92,355554
34780,0.006081,172.31.47.0-255,66,240827,92,355554
34781,0.008111,74.125.130.0-255,2902,243729,92,355554
34782,0.008117,172.31.47.0-255,66,243795,92,355554
34783,0.008142,74.125.130.0-255,2902,246697,92,355554
34784,0.008145,172.31.47.0-255,66,246763,92,355554
34785,0.010155,74.125.130.0-255,2902,249665,92,355554
34786,0.010162,172.31.47.0-255,66,249731,92,355554
34787,0.010192,74.125.130.0-255,2902,252633,92,355554
34788,0.010196,172.31.47.0-255,66,252699,92,355554
34789,0.012197,74.125.130.0-255,2902,255601,92,355554
34790,0.012202,172.31.47.0-255,66,255667,92,355554
34791,0.01223,74.125.130.0-255,2902,258569,92,355554
34792,0.012232,172.31.47.0-255,66,258635,92,355554
34793,0.014258,74.125.130.0-255,4320,262955,92,355554
34794,0.014268,172.31.47.0-255,66,263021,92,355554
34795,0.014298,74.125.130.0-255,1484,264505,92,355554
34796,0.016305,74.125.130.0-255,4320,268825,92,355554
34797,0.016311,172.31.47.0-255,66,268891,92,355554
34798,0.01835,74.125.130.0-255,5738,274629,92,355554
34799,0.018356,172.31.47.0-255,66,274695,92,355554
34800,0.020399,74.125.130.0-255,5738,280433,92,355554
34801,0.020405,172.31.47.0-255,66,280499,92,355554
34802,0.022421,74.125.130.0-255,1484,281983,92,355554
34803,0.022454,74.125.130.0-255,4320,286303,92,355554
34804,0.022459,172.31.47.0-255,66,286369,92,355554
34805,0.024498,74.125.130.0-255,5738,292107,92,355554
34806,0.024503,172.31.47.0-255,66,292173,92,355554
34807,0.026518,74.125.130.0-255,1484,293657,92,355554
34808,0.026549,74.125.130.0-255,4320,297977,92,355554
34809,0.026553,172.31.47.0-255,66,298043,92,355554
34810,0.028618,74.125.130.0-255,5738,303781,92,355554
34811,0.028627,172.31.47.0-255,66,303847,92,355554
34812,0.03066,74.125.130.0-255,5738,309585,92,355554
34813,0.030672,172.31.47.0-255,66,309651,92,355554
34814,0.031867,172.31.47.0-255,172,309823,92,355554
34815,0.031896,172.31.47.0-255,1111,310934,92,355554
34816,0.03192,172.31.47.0-255,570,311504,92,355554
34817,0.032717,74.125.130.0-255,5738,317242,92,355554
34818,0.032722,172.31.47.0-255,66,317308,92,355554
34819,0.033359,104.244.42.0-255,66,317374,92,355554
34820,0.033387,104.244.42.0-255,66,317440,92,355554
34821,0.0334,104.244.42.0-255,66,317506,92,355554
34822,0.034771,74.125.130.0-255,5738,323244,92,355554
34823,0.034777,172.31.47.0-255,66,323310,92,355554
34824,0.036811,74.125.130.0-255,5738,329048,92,355554
34825,0.03682,172.31.47.0-255,66,329114,92,355554
34826,0.03885,74.125.130.0-255,5738,334852,92,355554
34827,0.038855,172.31.47.0-255,66,334918,92,355554
34828,0.040895,74.125.130.0-255,5738,340656,92,355554
34829,0.040901,172.31.47.0-255,66,340722,92,355554
34830,0.04294,74.125.130.0-255,5738,346460,92,355554
34831,0.042945,172.31.47.0-255,66,346526,92,355554
34832,0.044979,74.125.130.0-255,5738,352264,92,355554
34833,0.044985,172.31.47.0-255,66,352330,92,355554
34834,0.04702,74.125.130.0-255,2987,355317,92,355554
34835,0.047025,172.31.47.0-255,66,355383,92,355554
34836,0.047179,172.31.47.0-255,105,355488,92,355554
34837,0.049169,74.125.130.0-255,66,355554,92,355554
34838,0.0,74.125.24.0-255,153,153,92,299466
34839,3.2e-05,172.31.47.0-255,66,219,92,299466
34840,3.8e-05,74.125.24.0-255,1484,1703,92,299466
34841,4.2e-05,172.31.47.0-255,66,1769,92,299466
34842,4.6e-05,74.125.24.0-255,2902,4671,92,299466
34843,4.8e-05,172.31.47.0-255,66,4737,92,299466
34844,6.3e-05,74.125.24.0-255,7156,11893,92,299466
34845,6.5e-05,172.31.47.0-255,66,11959,92,299466
34846,7.2e-05,74.125.24.0-255,6373,18332,92,299466
34847,7.4e-05,172.31.47.0-255,66,18398,92,299466
34848,8e-05,74.125.24.0-255,5738,24136,92,299466
34849,8.3e-05,172.31.47.0-255,66,24202,92,299466
34850,0.000113,74.125.24.0-255,1484,25686,92,299466
34851,0.000115,172.31.47.0-255,66,25752,92,299466
34852,0.000121,74.125.24.0-255,5379,31131,92,299466
34853,0.000123,172.31.47.0-255,66,31197,92,299466
34854,0.000189,74.125.24.0-255,1484,32681,92,299466
34855,0.000194,172.31.47.0-255,66,32747,92,299466
34856,0.000201,74.125.24.0-255,2902,35649,92,299466
34857,0.000202,172.31.47.0-255,66,35715,92,299466
34858,0.000219,74.125.24.0-255,1484,37199,92,299466
34859,0.000221,172.31.47.0-255,66,37265,92,299466
34860,0.000256,74.125.24.0-255,4320,41585,92,299466
34861,0.000258,172.31.47.0-255,66,41651,92,299466
34862,0.000268,172.31.47.0-255,66,41717,92,299466
34863,0.000294,74.125.24.0-255,5379,47096,92,299466
34864,0.000297,172.31.47.0-255,66,47162,92,299466
34865,0.0003,74.125.24.0-255,1484,48646,92,299466
34866,0.000302,172.31.47.0-255,66,48712,92,299466
34867,0.00033,74.125.24.0-255,5738,54450,92,299466
34868,0.000334,172.31.47.0-255,66,54516,92,299466
34869,0.000356,74.125.24.0-255,2856,57372,92,299466
34870,0.00036,172.31.47.0-255,66,57438,92,299466
34871,0.000382,74.125.24.0-255,111,57549,92,299466
34872,0.000409,74.125.24.0-255,1484,59033,92,299466
34873,0.000422,172.31.47.0-255,66,59099,92,299466
34874,0.000438,74.125.24.0-255,2902,62001,92,299466
34875,0.000445,172.31.47.0-255,66,62067,92,299466
34876,0.000456,74.125.24.0-255,2902,64969,92,299466
34877,0.000467,172.31.47.0-255,66,65035,92,299466
34878,0.000478,74.125.24.0-255,4320,69355,92,299466
34879,0.000485,172.31.47.0-255,66,69421,92,299466
34880,0.000508,74.125.24.0-255,2902,72323,92,299466
34881,0.000517,172.31.47.0-255,66,72389,92,299466
34882,0.000523,74.125.24.0-255,2543,74932,92,299466
34883,0.000529,172.31.47.0-255,66,74998,92,299466
34884,0.000538,74.125.24.0-255,1484,76482,92,299466
34885,0.00056,74.125.24.0-255,4585,81067,92,299466
34886,0.000563,172.31.47.0-255,66,81133,92,299466
34887,0.000565,74.125.24.0-255,4320,85453,92,299466
34888,0.000583,74.125.24.0-255,2902,88355,92,299466
34889,0.000586,172.31.47.0-255,66,88421,92,299466
34890,0.00061,74.125.24.0-255,3961,92382,92,299466
34891,0.000619,172.31.47.0-255,66,92448,92,299466
34892,0.001026,74.125.24.0-255,1484,93932,92,299466
34893,0.001039,74.125.24.0-255,2902,96834,92,299466
34894,0.001042,172.31.47.0-255,66,96900,92,299466
34895,0.001048,74.125.24.0-255,4320,101220,92,299466
34896,0.001063,172.31.47.0-255,66,101286,92,299466
34897,0.001068,74.125.24.0-255,1484,102770,92,299466
34898,0.001072,74.125.24.0-255,2902,105672,92,299466
34899,0.001076,74.125.24.0-255,2902,108574,92,299466
34900,0.001084,172.31.47.0-255,66,108640,92,299466
34901,0.001091,74.125.24.0-255,1484,110124,92,299466
34902,0.001122,172.31.47.0-255,66,110190,92,299466
34903,0.001159,74.125.24.0-255,1484,111674,92,299466
34904,0.001162,74.125.24.0-255,1484,113158,92,299466
34905,0.001171,172.31.47.0-255,66,113224,92,299466
34906,0.001176,74.125.24.0-255,1484,114708,92,299466
34907,0.001181,74.125.24.0-255,5738,120446,92,299466
34908,0.001184,172.31.47.0-255,66,120512,92,299466
34909,0.001213,74.125.24.0-255,7156,127668,92,299466
34910,0.001222,172.31.47.0-255,66,127734,92,299466
34911,0.001249,74.125.24.0-255,5738,133472,92,299466
34912,0.001254,172.31.47.0-255,66,133538,92,299466
34913,0.001256,74.125.24.0-255,7156,140694,92,299466
34914,0.001267,172.31.47.0-255,66,140760,92,299466
34915,0.001276,74.125.24.0-255,2902,143662,92,299466
34916,0.00128,172.31.47.0-255,66,143728,92,299466
34917,0.001289,74.125.24.0-255,766,144494,92,299466
34918,0.001329,74.125.24.0-255,1484,145978,92,299466
34919,0.001333,74.125.24.0-255,2902,148880,92,299466
34920,0.001335,172.31.47.0-255,66,148946,92,299466
34921,0.001339,172.31.47.0-255,66,149012,92,299466
34922,0.001367,74.125.24.0-255,5738,154750,92,299466
34923,0.001374,172.31.47.0-255,66,154816,92,299466
34924,0.001413,172.31.47.0-255,66,154882,92,299466
34925,0.001423,74.125.24.0-255,4320,159202,92,299466
34926,0.001425,172.31.47.0-255,66,159268,92,299466
34927,0.001457,172.31.47.0-255,66,159334,92,299466
34928,0.001747,74.125.24.0-255,1484,160818,92,299466
34929,0.001761,74.125.24.0-255,2902,163720,92,299466
34930,0.001764,172.31.47.0-255,66,163786,92,299466
34931,0.00177,74.125.24.0-255,5738,169524,92,299466
34932,0.001777,172.31.47.0-255,66,169590,92,299466
34933,0.001814,172.31.47.0-255,66,169656,92,299466
34934,0.001824,74.125.24.0-255,4320,173976,92,299466
34935,0.001827,172.31.47.0-255,66,174042,92,299466
34936,0.001848,74.125.24.0-255,6438,180480,92,299466
34937,0.001855,172.31.47.0-255,66,180546,92,299466
34938,0.002136,74.125.24.0-255,1484,182030,92,299466
34939,0.002145,74.125.24.0-255,2902,184932,92,299466
34940,0.002148,172.31.47.0-255,66,184998,92,299466
34941,0.002171,74.125.24.0-255,1484,186482,92,299466
34942,0.002182,74.125.24.0-255,1484,187966,92,299466
34943,0.002222,74.125.24.0-255,2902,190868,92,299466
34944,0.002232,74.125.24.0-255,7156,198024,92,299466
34945,0.002237,74.125.24.0-255,4320,202344,92,299466
34946,0.002276,74.125.24.0-255,2902,205246,92,299466
34947,0.002301,74.125.24.0-255,4320,209566,92,299466
34948,0.002305,74.125.24.0-255,2902,212468,92,299466
34949,0.002319,74.125.24.0-255,1484,213952,92,299466
34950,0.002322,74.125.24.0-255,766,214718,92,299466
34951,0.002473,74.125.24.0-255,1484,216202,92,299466
34952,0.002489,74.125.24.0-255,2902,219104,92,299466
34953,0.002491,74.125.24.0-255,1484,220588,92,299466
34954,0.00251,74.125.24.0-255,4320,224908,92,299466
34955,0.002516,74.125.24.0-255,4320,229228,92,299466
34956,0.002518,74.125.24.0-255,1484,230712,92,299466
34957,0.002531,74.125.24.0-255,1484,232196,92,299466
34958,0.002548,74.125.24.0-255,5738,237934,92,299466
34959,0.002564,74.125.24.0-255,4320,242254,92,299466
34960,0.002579,74.125.24.0-255,2902,245156,92,299466
34961,0.0026,74.125.24.0-255,7156,252312,92,299466
34962,0.002624,74.125.24.0-255,6438,258750,92,299466
34963,0.002629,74.125.24.0-255,4320,263070,92,299466
34964,0.002632,74.125.24.0-255,1484,264554,92,299466
34965,0.002636,172.31.47.0-255,78,264632,92,299466
34966,0.002646,172.31.47.0-255,78,264710,92,299466
34967,0.002685,74.125.24.0-255,7156,271866,92,299466
34968,0.00269,74.125.24.0-255,2184,274050,92,299466
34969,0.002705,74.125.24.0-255,4320,278370,92,299466
34970,0.002708,74.125.24.0-255,2902,281272,92,299466
34971,0.002774,74.125.24.0-255,1484,282756,92,299466
34972,0.002777,172.31.47.0-255,78,282834,92,299466
34973,0.002782,74.125.24.0-255,4320,287154,92,299466
34974,0.002784,172.31.47.0-255,78,287232,92,299466
34975,0.002818,172.31.47.0-255,78,287310,92,299466
34976,0.002849,74.125.24.0-255,2902,290212,92,299466
34977,0.0029,74.125.24.0-255,105,290317,92,299466
34978,0.009378,172.31.47.0-255,66,290383,92,299466
34979,0.009392,172.31.47.0-255,78,290461,92,299466
34980,0.010769,172.31.47.0-255,105,290566,92,299466
34981,0.012804,74.125.24.0-255,66,290632,92,299466
34982,0.058766,172.31.47.0-255,172,290804,92,299466
34983,0.058809,172.31.47.0-255,1103,291907,92,299466
34984,0.058846,172.31.47.0-255,1514,293421,92,299466
34985,0.058847,172.31.47.0-255,1514,294935,92,299466
34986,0.058848,172.31.47.0-255,1514,296449,92,299466
34987,0.058849,172.31.47.0-255,1514,297963,92,299466
34988,0.05885,172.31.47.0-255,1503,299466,92,299466
34989,0.0,74.125.24.0-255,153,153,92,251956
34990,2.8e-05,172.31.47.0-255,66,219,92,251956
34991,3.4e-05,74.125.24.0-255,1484,1703,92,251956
34992,3.8e-05,172.31.47.0-255,66,1769,92,251956
34993,4.3e-05,74.125.24.0-255,2902,4671,92,251956
34994,5.2e-05,172.31.47.0-255,66,4737,92,251956
34995,5.7e-05,74.125.24.0-255,5738,10475,92,251956
34996,5.9e-05,172.31.47.0-255,66,10541,92,251956
34997,8.2e-05,74.125.24.0-255,1484,12025,92,251956
34998,8.7e-05,172.31.47.0-255,66,12091,92,251956
34999,9.2e-05,74.125.24.0-255,3481,15572,92,251956
35000,9.4e-05,172.31.47.0-255,66,15638,92,251956
35001,9.7e-05,74.125.24.0-255,2902,18540,92,251956
35002,0.0001,172.31.47.0-255,66,18606,92,251956
35003,0.000129,172.31.47.0-255,66,18672,92,251956
35004,0.000132,74.125.24.0-255,2543,21215,92,251956
35005,0.000134,172.31.47.0-255,66,21281,92,251956
35006,0.000212,74.125.24.0-255,1484,22765,92,251956
35007,0.000216,172.31.47.0-255,66,22831,92,251956
35008,0.000243,74.125.24.0-255,2902,25733,92,251956
35009,0.000245,172.31.47.0-255,66,25799,92,251956
35010,0.000252,74.125.24.0-255,5738,31537,92,251956
35011,0.000254,172.31.47.0-255,66,31603,92,251956
35012,0.000287,172.31.47.0-255,66,31669,92,251956
35013,0.000313,74.125.24.0-255,2902,34571,92,251956
35014,0.000316,172.31.47.0-255,66,34637,92,251956
35015,0.000333,172.31.47.0-255,66,34703,92,251956
35016,0.000579,74.125.24.0-255,645,35348,92,251956
35017,0.000583,172.31.47.0-255,66,35414,92,251956
35018,0.000927,74.125.24.0-255,1484,36898,92,251956
35019,0.000935,74.125.24.0-255,2902,39800,92,251956
35020,0.000938,172.31.47.0-255,66,39866,92,251956
35021,0.000946,74.125.24.0-255,5738,45604,92,251956
35022,0.000947,172.31.47.0-255,66,45670,92,251956
35023,0.000972,172.31.47.0-255,66,45736,92,251956
35024,0.000991,74.125.24.0-255,2902,48638,92,251956
35025,0.000993,172.31.47.0-255,66,48704,92,251956
35026,0.001005,74.125.24.0-255,4320,53024,92,251956
35027,0.001007,172.31.47.0-255,66,53090,92,251956
35028,0.00103,74.125.24.0-255,6438,59528,92,251956
35029,0.001033,172.31.47.0-255,66,59594,92,251956
35030,0.001454,74.125.24.0-255,1484,61078,92,251956
35031,0.00146,74.125.24.0-255,2902,63980,92,251956
35032,0.001463,172.31.47.0-255,66,64046,92,251956
35033,0.001467,74.125.24.0-255,1484,65530,92,251956
35034,0.001488,74.125.24.0-255,4320,69850,92,251956
35035,0.001489,172.31.47.0-255,66,69916,92,251956
35036,0.001502,74.125.24.0-255,2902,72818,92,251956
35037,0.001507,172.31.47.0-255,66,72884,92,251956
35038,0.001538,172.31.47.0-255,66,72950,92,251956
35039,0.001548,172.31.47.0-255,66,73016,92,251956
35040,0.001926,74.125.24.0-255,1484,74500,92,251956
35041,0.001937,74.125.24.0-255,2902,77402,92,251956
35042,0.001939,172.31.47.0-255,66,77468,92,251956
35043,0.001963,74.125.24.0-255,5738,83206,92,251956
35044,0.001965,172.31.47.0-255,66,83272,92,251956
35045,0.001967,74.125.24.0-255,1484,84756,92,251956
35046,0.001997,172.31.47.0-255,66,84822,92,251956
35047,0.002003,74.125.24.0-255,7156,91978,92,251956
35048,0.002004,172.31.47.0-255,66,92044,92,251956
35049,0.002049,74.125.24.0-255,3602,95646,92,251956
35050,0.002051,172.31.47.0-255,66,95712,92,251956
35051,0.004206,74.125.24.0-255,1484,97196,92,251956
35052,0.004246,74.125.24.0-255,1484,98680,92,251956
35053,0.004248,172.31.47.0-255,66,98746,92,251956
35054,0.00427,74.125.24.0-255,2902,101648,92,251956
35055,0.004272,172.31.47.0-255,66,101714,92,251956
35056,0.006491,74.125.24.0-255,5738,107452,92,251956
35057,0.006496,172.31.47.0-255,66,107518,92,251956
35058,0.008737,74.125.24.0-255,5738,113256,92,251956
35059,0.00875,172.31.47.0-255,66,113322,92,251956
35060,0.010971,74.125.24.0-255,5738,119060,92,251956
35061,0.010978,172.31.47.0-255,66,119126,92,251956
35062,0.013206,74.125.24.0-255,5738,124864,92,251956
35063,0.013215,172.31.47.0-255,66,124930,92,251956
35064,0.015426,74.125.24.0-255,5738,130668,92,251956
35065,0.015433,172.31.47.0-255,66,130734,92,251956
35066,0.017702,74.125.24.0-255,5738,136472,92,251956
35067,0.017708,172.31.47.0-255,66,136538,92,251956
35068,0.019947,74.125.24.0-255,5738,142276,92,251956
35069,0.019953,172.31.47.0-255,66,142342,92,251956
35070,0.022172,74.125.24.0-255,5738,148080,92,251956
35071,0.022178,172.31.47.0-255,66,148146,92,251956
35072,0.024415,74.125.24.0-255,5738,153884,92,251956
35073,0.024429,172.31.47.0-255,66,153950,92,251956
35074,0.026665,74.125.24.0-255,5738,159688,92,251956
35075,0.026671,172.31.47.0-255,66,159754,92,251956
35076,0.026985,172.31.47.0-255,172,159926,92,251956
35077,0.027008,172.31.47.0-255,1107,161033,92,251956
35078,0.027049,172.31.47.0-255,1514,162547,92,251956
35079,0.02705,172.31.47.0-255,1514,164061,92,251956
35080,0.027051,172.31.47.0-255,1514,165575,92,251956
35081,0.027052,172.31.47.0-255,1514,167089,92,251956
35082,0.027078,172.31.47.0-255,1499,168588,92,251956
35083,0.02856,104.244.42.0-255,66,168654,92,251956
35084,0.028569,104.244.42.0-255,66,168720,92,251956
35085,0.028693,104.244.42.0-255,66,168786,92,251956
35086,0.028884,74.125.24.0-255,2902,171688,92,251956
35087,0.028889,172.31.47.0-255,66,171754,92,251956
35088,0.028923,74.125.24.0-255,2902,174656,92,251956
35089,0.028926,172.31.47.0-255,66,174722,92,251956
35090,0.031098,74.125.24.0-255,2902,177624,92,251956
35091,0.031103,172.31.47.0-255,66,177690,92,251956
35092,0.031154,74.125.24.0-255,2902,180592,92,251956
35093,0.031158,172.31.47.0-255,66,180658,92,251956
35094,0.033328,74.125.24.0-255,2902,183560,92,251956
35095,0.033333,172.31.47.0-255,66,183626,92,251956
35096,0.033377,74.125.24.0-255,1484,185110,92,251956
35097,0.033388,74.125.24.0-255,1484,186594,92,251956
35098,0.03339,172.31.47.0-255,66,186660,92,251956
35099,0.035549,74.125.24.0-255,2902,189562,92,251956
35100,0.035553,172.31.47.0-255,66,189628,92,251956
35101,0.035585,74.125.24.0-255,2902,192530,92,251956
35102,0.035588,172.31.47.0-255,66,192596,92,251956
35103,0.037752,74.125.24.0-255,2902,195498,92,251956
35104,0.037757,172.31.47.0-255,66,195564,92,251956
35105,0.037859,74.125.24.0-255,2902,198466,92,251956
35106,0.037864,172.31.47.0-255,66,198532,92,251956
35107,0.040001,74.125.24.0-255,2902,201434,92,251956
35108,0.040007,172.31.47.0-255,66,201500,92,251956
35109,0.040095,74.125.24.0-255,2902,204402,92,251956
35110,0.0401,172.31.47.0-255,66,204468,92,251956
35111,0.042218,74.125.24.0-255,2902,207370,92,251956
35112,0.042223,172.31.47.0-255,66,207436,92,251956
35113,0.042303,74.125.24.0-255,2902,210338,92,251956
35114,0.042307,172.31.47.0-255,66,210404,92,251956
35115,0.044429,74.125.24.0-255,2902,213306,92,251956
35116,0.044433,172.31.47.0-255,66,213372,92,251956
35117,0.044516,74.125.24.0-255,2902,216274,92,251956
35118,0.044521,172.31.47.0-255,66,216340,92,251956
35119,0.046647,74.125.24.0-255,2902,219242,92,251956
35120,0.046651,172.31.47.0-255,66,219308,92,251956
35121,0.046718,74.125.24.0-255,2902,222210,92,251956
35122,0.046722,172.31.47.0-255,66,222276,92,251956
35123,0.048849,74.125.24.0-255,2902,225178,92,251956
35124,0.048855,172.31.47.0-255,66,225244,92,251956
35125,0.048936,74.125.24.0-255,2902,228146,92,251956
35126,0.04894,172.31.47.0-255,66,228212,92,251956
35127,0.051095,74.125.24.0-255,2902,231114,92,251956
35128,0.0511,172.31.47.0-255,66,231180,92,251956
35129,0.051152,74.125.24.0-255,2902,234082,92,251956
35130,0.051156,172.31.47.0-255,66,234148,92,251956
35131,0.053296,74.125.24.0-255,2902,237050,92,251956
35132,0.0533,172.31.47.0-255,66,237116,92,251956
35133,0.053388,74.125.24.0-255,2902,240018,92,251956
35134,0.053392,172.31.47.0-255,66,240084,92,251956
35135,0.055526,74.125.24.0-255,2902,242986,92,251956
35136,0.05553,172.31.47.0-255,66,243052,92,251956
35137,0.055589,74.125.24.0-255,2902,245954,92,251956
35138,0.055592,172.31.47.0-255,66,246020,92,251956
35139,0.057758,74.125.24.0-255,2902,248922,92,251956
35140,0.057763,172.31.47.0-255,66,248988,92,251956
35141,0.057808,74.125.24.0-255,2902,251890,92,251956
35142,0.057812,172.31.47.0-255,66,251956,92,251956
35143,0.0,172.31.47.0-255,74,74,92,3023
35144,0.002309,172.217.194.0-255,74,148,92,3023
35145,0.002327,172.31.47.0-255,66,214,92,3023
35146,0.003863,172.31.47.0-255,697,911,92,3023
35147,0.006147,172.217.194.0-255,66,977,92,3023
35148,0.006565,172.217.194.0-255,278,1255,92,3023
35149,0.006573,172.31.47.0-255,66,1321,92,3023
35150,0.007227,172.31.47.0-255,130,1451,92,3023
35151,0.008884,172.31.47.0-255,236,1687,92,3023
35152,0.008909,172.31.47.0-255,380,2067,92,3023
35153,0.010049,172.217.194.0-255,630,2697,92,3023
35154,0.010565,172.31.47.0-255,97,2794,92,3023
35155,0.011208,172.217.194.0-255,97,2891,92,3023
35156,0.01258,172.217.194.0-255,66,2957,92,3023
35157,0.049367,172.31.47.0-255,66,3023,92,3023
35158,0.0,172.217.194.0-255,153,153,92,271444
35159,2.3e-05,172.31.47.0-255,66,219,92,271444
35160,2.9e-05,172.217.194.0-255,1484,1703,92,271444
35161,3.2e-05,172.31.47.0-255,66,1769,92,271444
35162,3.7e-05,172.217.194.0-255,2902,4671,92,271444
35163,3.9e-05,172.31.47.0-255,66,4737,92,271444
35164,5e-05,172.217.194.0-255,2902,7639,92,271444
35165,5.2e-05,172.31.47.0-255,66,7705,92,271444
35166,8e-05,172.217.194.0-255,4320,12025,92,271444
35167,8.3e-05,172.31.47.0-255,66,12091,92,271444
35168,8.8e-05,172.217.194.0-255,3590,15681,92,271444
35169,8.9e-05,172.31.47.0-255,66,15747,92,271444
35170,9.3e-05,172.217.194.0-255,2902,18649,92,271444
35171,9.4e-05,172.31.47.0-255,66,18715,92,271444
35172,0.000133,172.31.47.0-255,66,18781,92,271444
35173,0.000162,172.217.194.0-255,2902,21683,92,271444
35174,0.000165,172.31.47.0-255,66,21749,92,271444
35175,0.000194,172.31.47.0-255,66,21815,92,271444
35176,0.00023,172.31.47.0-255,66,21881,92,271444
35177,0.000236,172.217.194.0-255,7156,29037,92,271444
35178,0.000238,172.31.47.0-255,66,29103,92,271444
35179,0.000251,172.31.47.0-255,66,29169,92,271444
35180,0.000253,172.217.194.0-255,1378,30547,92,271444
35181,0.000255,172.31.47.0-255,66,30613,92,271444
35182,0.000281,172.217.194.0-255,1484,32097,92,271444
35183,0.000284,172.31.47.0-255,66,32163,92,271444
35184,0.000306,172.217.194.0-255,2902,35065,92,271444
35185,0.000311,172.31.47.0-255,66,35131,92,271444
35186,0.000311,172.217.194.0-255,4320,39451,92,271444
35187,0.000314,172.31.47.0-255,66,39517,92,271444
35188,0.000342,172.217.194.0-255,1484,41001,92,271444
35189,0.000354,172.31.47.0-255,66,41067,92,271444
35190,0.000389,172.217.194.0-255,4320,45387,92,271444
35191,0.000393,172.31.47.0-255,66,45453,92,271444
35192,0.000423,172.31.47.0-255,66,45519,92,271444
35193,0.000484,172.217.194.0-255,1484,47003,92,271444
35194,0.000489,172.217.194.0-255,2902,49905,92,271444
35195,0.000491,172.31.47.0-255,66,49971,92,271444
35196,0.000516,172.217.194.0-255,4320,54291,92,271444
35197,0.000519,172.31.47.0-255,66,54357,92,271444
35198,0.00053,172.217.194.0-255,1484,55841,92,271444
35199,0.000539,172.217.194.0-255,4320,60161,92,271444
35200,0.000541,172.31.47.0-255,66,60227,92,271444
35201,0.000568,172.217.194.0-255,2902,63129,92,271444
35202,0.000571,172.31.47.0-255,66,63195,92,271444
35203,0.000604,172.31.47.0-255,66,63261,92,271444
35204,0.000609,172.217.194.0-255,5738,68999,92,271444
35205,0.000611,172.31.47.0-255,66,69065,92,271444
35206,0.000646,172.217.194.0-255,2184,71249,92,271444
35207,0.00065,172.31.47.0-255,66,71315,92,271444
35208,0.0007,172.217.194.0-255,1484,72799,92,271444
35209,0.000711,172.217.194.0-255,2902,75701,92,271444
35210,0.000714,172.31.47.0-255,66,75767,92,271444
35211,0.000739,172.217.194.0-255,5738,81505,92,271444
35212,0.000742,172.31.47.0-255,66,81571,92,271444
35213,0.000745,172.217.194.0-255,1484,83055,92,271444
35214,0.000772,172.217.194.0-255,4320,87375,92,271444
35215,0.000775,172.31.47.0-255,66,87441,92,271444
35216,0.000788,172.217.194.0-255,4320,91761,92,271444
35217,0.000794,172.31.47.0-255,66,91827,92,271444
35218,0.000801,172.217.194.0-255,7156,98983,92,271444
35219,0.000803,172.31.47.0-255,66,99049,92,271444
35220,0.00084,172.217.194.0-255,4320,103369,92,271444
35221,0.000843,172.31.47.0-255,66,103435,92,271444
35222,0.000869,172.217.194.0-255,5020,108455,92,271444
35223,0.000871,172.31.47.0-255,66,108521,92,271444
35224,0.000881,172.31.47.0-255,66,108587,92,271444
35225,0.000905,172.217.194.0-255,1484,110071,92,271444
35226,0.000911,172.217.194.0-255,5738,115809,92,271444
35227,0.000913,172.31.47.0-255,66,115875,92,271444
35228,0.000985,172.31.47.0-255,66,115941,92,271444
35229,0.001204,172.217.194.0-255,1484,117425,92,271444
35230,0.001241,172.217.194.0-255,1484,118909,92,271444
35231,0.001244,172.31.47.0-255,66,118975,92,271444
35232,0.001262,172.217.194.0-255,1484,120459,92,271444
35233,0.001272,172.217.194.0-255,1484,121943,92,271444
35234,0.001274,172.31.47.0-255,66,122009,92,271444
35235,0.001299,172.217.194.0-255,4320,126329,92,271444
35236,0.001301,172.31.47.0-255,66,126395,92,271444
35237,0.001305,172.217.194.0-255,2902,129297,92,271444
35238,0.001307,172.31.47.0-255,66,129363,92,271444
35239,0.00132,172.31.47.0-255,66,129429,92,271444
35240,0.001326,172.217.194.0-255,5738,135167,92,271444
35241,0.001329,172.31.47.0-255,66,135233,92,271444
35242,0.001358,172.217.194.0-255,1484,136717,92,271444
35243,0.001363,172.217.194.0-255,3602,140319,92,271444
35244,0.001366,172.31.47.0-255,66,140385,92,271444
35245,0.001466,172.217.194.0-255,1484,141869,92,271444
35246,0.00148,172.217.194.0-255,2902,144771,92,271444
35247,0.001483,172.31.47.0-255,66,144837,92,271444
35248,0.001512,172.217.194.0-255,5738,150575,92,271444
35249,0.001515,172.31.47.0-255,66,150641,92,271444
35250,0.001519,172.217.194.0-255,2902,153543,92,271444
35251,0.001521,172.31.47.0-255,66,153609,92,271444
35252,0.001562,172.31.47.0-255,66,153675,92,271444
35253,0.001568,172.217.194.0-255,5738,159413,92,271444
35254,0.001571,172.31.47.0-255,66,159479,92,271444
35255,0.0016,172.217.194.0-255,5020,164499,92,271444
35256,0.001604,172.31.47.0-255,66,164565,92,271444
35257,0.001681,172.217.194.0-255,1484,166049,92,271444
35258,0.001686,172.217.194.0-255,2902,168951,92,271444
35259,0.001689,172.31.47.0-255,66,169017,92,271444
35260,0.001692,172.217.194.0-255,1484,170501,92,271444
35261,0.001718,172.217.194.0-255,4320,174821,92,271444
35262,0.001721,172.31.47.0-255,66,174887,92,271444
35263,0.001727,172.217.194.0-255,2902,177789,92,271444
35264,0.001729,172.31.47.0-255,66,177855,92,271444
35265,0.001733,172.217.194.0-255,2902,180757,92,271444
35266,0.001734,172.31.47.0-255,66,180823,92,271444
35267,0.001753,172.217.194.0-255,7156,187979,92,271444
35268,0.001756,172.31.47.0-255,66,188045,92,271444
35269,0.001766,172.217.194.0-255,4320,192365,92,271444
35270,0.001768,172.31.47.0-255,66,192431,92,271444
35271,0.001791,172.217.194.0-255,1484,193915,92,271444
35272,0.001795,172.217.194.0-255,1484,195399,92,271444
35273,0.001802,172.31.47.0-255,66,195465,92,271444
35274,0.001823,172.217.194.0-255,5020,200485,92,271444
35275,0.001826,172.31.47.0-255,66,200551,92,271444
35276,0.001831,172.217.194.0-255,5738,206289,92,271444
35277,0.001833,172.31.47.0-255,66,206355,92,271444
35278,0.001856,172.217.194.0-255,4320,210675,92,271444
35279,0.001863,172.31.47.0-255,66,210741,92,271444
35280,0.001901,172.31.47.0-255,66,210807,92,271444
35281,0.001902,172.217.194.0-255,5738,216545,92,271444
35282,0.001904,172.31.47.0-255,66,216611,92,271444
35283,0.001943,172.31.47.0-255,66,216677,92,271444
35284,0.001949,172.217.194.0-255,4320,220997,92,271444
35285,0.001951,172.31.47.0-255,66,221063,92,271444
35286,0.001973,172.217.194.0-255,5738,226801,92,271444
35287,0.001976,172.31.47.0-255,66,226867,92,271444
35288,0.001988,172.217.194.0-255,4320,231187,92,271444
35289,0.001991,172.31.47.0-255,66,231253,92,271444
35290,0.00203,172.31.47.0-255,66,231319,92,271444
35291,0.002033,172.217.194.0-255,1484,232803,92,271444
35292,0.002058,172.217.194.0-255,6438,239241,92,271444
35293,0.002061,172.31.47.0-255,66,239307,92,271444
35294,0.002111,172.217.194.0-255,5738,245045,92,271444
35295,0.002114,172.31.47.0-255,66,245111,92,271444
35296,0.002145,172.217.194.0-255,2902,248013,92,271444
35297,0.002148,172.31.47.0-255,66,248079,92,271444
35298,0.002154,172.217.194.0-255,5738,253817,92,271444
35299,0.002156,172.31.47.0-255,66,253883,92,271444
35300,0.002178,172.31.47.0-255,66,253949,92,271444
35301,0.002183,172.217.194.0-255,3602,257551,92,271444
35302,0.002185,172.31.47.0-255,66,257617,92,271444
35303,0.002191,172.217.194.0-255,4320,261937,92,271444
35304,0.002194,172.31.47.0-255,66,262003,92,271444
35305,0.002235,172.31.47.0-255,66,262069,92,271444
35306,0.002238,172.217.194.0-255,105,262174,92,271444
35307,0.003353,172.31.47.0-255,66,262240,92,271444
35308,0.003377,172.31.47.0-255,105,262345,92,271444
35309,0.005584,172.217.194.0-255,66,262411,92,271444
35310,0.04562,172.31.47.0-255,172,262583,92,271444
35311,0.045649,172.31.47.0-255,1103,263686,92,271444
35312,0.045687,172.31.47.0-255,1514,265200,92,271444
35313,0.045688,172.31.47.0-255,1514,266714,92,271444
35314,0.045689,172.31.47.0-255,1514,268228,92,271444
35315,0.04569,172.31.47.0-255,1514,269742,92,271444
35316,0.045691,172.31.47.0-255,1504,271246,92,271444
35317,0.047196,104.244.42.0-255,66,271312,92,271444
35318,0.047363,104.244.42.0-255,66,271378,92,271444
35319,0.047416,104.244.42.0-255,66,271444,92,271444
35320,0.0,172.31.47.0-255,105,105,92,105
35321,0.0,74.125.200.0-255,153,153,92,292159
35322,2.3e-05,172.31.47.0-255,66,219,92,292159
35323,3e-05,74.125.200.0-255,1484,1703,92,292159
35324,3.5e-05,172.31.47.0-255,66,1769,92,292159
35325,6.3e-05,74.125.200.0-255,2902,4671,92,292159
35326,6.7e-05,172.31.47.0-255,66,4737,92,292159
35327,7.3e-05,74.125.200.0-255,4320,9057,92,292159
35328,7.6e-05,172.31.47.0-255,66,9123,92,292159
35329,0.000112,74.125.200.0-255,4983,14106,92,292159
35330,0.000115,172.31.47.0-255,66,14172,92,292159
35331,0.000139,74.125.200.0-255,1484,15656,92,292159
35332,0.000142,172.31.47.0-255,66,15722,92,292159
35333,0.000166,74.125.200.0-255,4320,20042,92,292159
35334,0.000169,172.31.47.0-255,66,20108,92,292159
35335,0.000172,74.125.200.0-255,1484,21592,92,292159
35336,0.000175,172.31.47.0-255,66,21658,92,292159
35337,0.000179,74.125.200.0-255,2902,24560,92,292159
35338,0.000182,172.31.47.0-255,66,24626,92,292159
35339,0.00021,74.125.200.0-255,5738,30364,92,292159
35340,0.000214,172.31.47.0-255,66,30430,92,292159
35341,0.000217,74.125.200.0-255,1125,31555,92,292159
35342,0.00022,172.31.47.0-255,66,31621,92,292159
35343,0.000801,74.125.200.0-255,1484,33105,92,292159
35344,0.000807,172.31.47.0-255,66,33171,92,292159
35345,0.000817,74.125.200.0-255,2902,36073,92,292159
35346,0.000819,172.31.47.0-255,66,36139,92,292159
35347,0.000825,74.125.200.0-255,4320,40459,92,292159
35348,0.000827,172.31.47.0-255,66,40525,92,292159
35349,0.000868,74.125.200.0-255,2902,43427,92,292159
35350,0.000872,172.31.47.0-255,66,43493,92,292159
35351,0.000892,74.125.200.0-255,5379,48872,92,292159
35352,0.000895,172.31.47.0-255,66,48938,92,292159
35353,0.000983,74.125.200.0-255,1484,50422,92,292159
35354,0.001021,74.125.200.0-255,1484,51906,92,292159
35355,0.001025,172.31.47.0-255,66,51972,92,292159
35356,0.001029,74.125.200.0-255,1484,53456,92,292159
35357,0.001047,74.125.200.0-255,1484,54940,92,292159
35358,0.00105,172.31.47.0-255,66,55006,92,292159
35359,0.001057,74.125.200.0-255,5738,60744,92,292159
35360,0.001059,172.31.47.0-255,66,60810,92,292159
35361,0.001065,74.125.200.0-255,4320,65130,92,292159
35362,0.001068,172.31.47.0-255,66,65196,92,292159
35363,0.001092,74.125.200.0-255,1125,66321,92,292159
35364,0.001098,74.125.200.0-255,5738,72059,92,292159
35365,0.001117,172.31.47.0-255,66,72125,92,292159
35366,0.001142,172.31.47.0-255,66,72191,92,292159
35367,0.00116,172.31.47.0-255,66,72257,92,292159
35368,0.001169,74.125.200.0-255,6438,78695,92,292159
35369,0.001172,172.31.47.0-255,66,78761,92,292159
35370,0.001244,74.125.200.0-255,646,79407,92,292159
35371,0.001269,74.125.200.0-255,1484,80891,92,292159
35372,0.001272,172.31.47.0-255,66,80957,92,292159
35373,0.001276,74.125.200.0-255,1484,82441,92,292159
35374,0.001293,74.125.200.0-255,1484,83925,92,292159
35375,0.001296,172.31.47.0-255,66,83991,92,292159
35376,0.001303,74.125.200.0-255,5738,89729,92,292159
35377,0.001306,172.31.47.0-255,66,89795,92,292159
35378,0.001334,74.125.200.0-255,7156,96951,92,292159
35379,0.001337,172.31.47.0-255,66,97017,92,292159
35380,0.001341,74.125.200.0-255,2902,99919,92,292159
35381,0.001344,172.31.47.0-255,66,99985,92,292159
35382,0.001372,74.125.200.0-255,5738,105723,92,292159
35383,0.001375,172.31.47.0-255,66,105789,92,292159
35384,0.001388,172.31.47.0-255,66,105855,92,292159
35385,0.002001,74.125.200.0-255,1484,107339,92,292159
35386,0.002023,74.125.200.0-255,2902,110241,92,292159
35387,0.002028,172.31.47.0-255,66,110307,92,292159
35388,0.002032,74.125.200.0-255,1484,111791,92,292159
35389,0.002036,74.125.200.0-255,2902,114693,92,292159
35390,0.002038,172.31.47.0-255,66,114759,92,292159
35391,0.002059,74.125.200.0-255,5738,120497,92,292159
35392,0.002062,172.31.47.0-255,66,120563,92,292159
35393,0.002107,172.31.47.0-255,66,120629,92,292159
35394,0.002143,74.125.200.0-255,6438,127067,92,292159
35395,0.002146,172.31.47.0-255,66,127133,92,292159
35396,0.002184,74.125.200.0-255,1484,128617,92,292159
35397,0.00221,74.125.200.0-255,2902,131519,92,292159
35398,0.002213,172.31.47.0-255,66,131585,92,292159
35399,0.002223,74.125.200.0-255,5738,137323,92,292159
35400,0.002226,172.31.47.0-255,66,137389,92,292159
35401,0.002231,74.125.200.0-255,2902,140291,92,292159
35402,0.002234,172.31.47.0-255,66,140357,92,292159
35403,0.002261,74.125.200.0-255,4320,144677,92,292159
35404,0.002263,172.31.47.0-255,66,144743,92,292159
35405,0.002278,172.31.47.0-255,66,144809,92,292159
35406,0.002282,74.125.200.0-255,2902,147711,92,292159
35407,0.002284,172.31.47.0-255,66,147777,92,292159
35408,0.002315,74.125.200.0-255,5020,152797,92,292159
35409,0.002318,172.31.47.0-255,66,152863,92,292159
35410,0.004657,74.125.200.0-255,5738,158601,92,292159
35411,0.004677,172.31.47.0-255,66,158667,92,292159
35412,0.006999,74.125.200.0-255,5738,164405,92,292159
35413,0.007016,172.31.47.0-255,66,164471,92,292159
35414,0.009332,74.125.200.0-255,5738,170209,92,292159
35415,0.009347,172.31.47.0-255,66,170275,92,292159
35416,0.011675,74.125.200.0-255,5738,176013,92,292159
35417,0.011689,172.31.47.0-255,66,176079,92,292159
35418,0.014027,74.125.200.0-255,5738,181817,92,292159
35419,0.014042,172.31.47.0-255,66,181883,92,292159
35420,0.016388,74.125.200.0-255,5738,187621,92,292159
35421,0.016406,172.31.47.0-255,66,187687,92,292159
35422,0.018738,74.125.200.0-255,5738,193425,92,292159
35423,0.018758,172.31.47.0-255,66,193491,92,292159
35424,0.021112,74.125.200.0-255,5738,199229,92,292159
35425,0.021131,172.31.47.0-255,66,199295,92,292159
35426,0.023485,74.125.200.0-255,5738,205033,92,292159
35427,0.023501,172.31.47.0-255,66,205099,92,292159
35428,0.025813,74.125.200.0-255,5738,210837,92,292159
35429,0.02583,172.31.47.0-255,66,210903,92,292159
35430,0.028174,74.125.200.0-255,5738,216641,92,292159
35431,0.028188,172.31.47.0-255,66,216707,92,292159
35432,0.030506,74.125.200.0-255,5738,222445,92,292159
35433,0.03052,172.31.47.0-255,66,222511,92,292159
35434,0.032864,74.125.200.0-255,5738,228249,92,292159
35435,0.032885,172.31.47.0-255,66,228315,92,292159
35436,0.035224,74.125.200.0-255,5738,234053,92,292159
35437,0.035235,172.31.47.0-255,66,234119,92,292159
35438,0.037536,74.125.200.0-255,5738,239857,92,292159
35439,0.037543,172.31.47.0-255,66,239923,92,292159
35440,0.039852,74.125.200.0-255,5738,245661,92,292159
35441,0.039861,172.31.47.0-255,66,245727,92,292159
35442,0.042163,74.125.200.0-255,5738,251465,92,292159
35443,0.042172,172.31.47.0-255,66,251531,92,292159
35444,0.044478,74.125.200.0-255,5738,257269,92,292159
35445,0.044485,172.31.47.0-255,66,257335,92,292159
35446,0.046786,74.125.200.0-255,5738,263073,92,292159
35447,0.046793,172.31.47.0-255,66,263139,92,292159
35448,0.049096,74.125.200.0-255,5738,268877,92,292159
35449,0.049102,172.31.47.0-255,66,268943,92,292159
35450,0.051421,74.125.200.0-255,5738,274681,92,292159
35451,0.051431,172.31.47.0-255,66,274747,92,292159
35452,0.053773,74.125.200.0-255,5738,280485,92,292159
35453,0.053789,172.31.47.0-255,66,280551,92,292159
35454,0.056096,74.125.200.0-255,5738,286289,92,292159
35455,0.056104,172.31.47.0-255,66,286355,92,292159
35456,0.05841,74.125.200.0-255,5738,292093,92,292159
35457,0.058418,172.31.47.0-255,66,292159,92,292159
35458,0.0,172.31.47.0-255,105,105,92,276
35459,0.001787,157.240.13.0-255,105,210,92,276
35460,0.0018,172.31.47.0-255,66,276,92,276
35461,0.0,74.125.24.0-255,152,152,92,312885
35462,4e-05,172.31.47.0-255,66,218,92,312885
35463,4.8e-05,74.125.24.0-255,1484,1702,92,312885
35464,5.4e-05,172.31.47.0-255,66,1768,92,312885
35465,5.9e-05,74.125.24.0-255,2902,4670,92,312885
35466,6.1e-05,172.31.47.0-255,66,4736,92,312885
35467,7.6e-05,74.125.24.0-255,7156,11892,92,312885
35468,7.9e-05,172.31.47.0-255,66,11958,92,312885
35469,8.6e-05,74.125.24.0-255,6355,18313,92,312885
35470,8.8e-05,172.31.47.0-255,66,18379,92,312885
35471,9.5e-05,74.125.24.0-255,7156,25535,92,312885
35472,9.9e-05,172.31.47.0-255,66,25601,92,312885
35473,0.00014,74.125.24.0-255,5379,30980,92,312885
35474,0.000143,172.31.47.0-255,66,31046,92,312885
35475,0.000171,74.125.24.0-255,1484,32530,92,312885
35476,0.000174,172.31.47.0-255,66,32596,92,312885
35477,0.000178,74.125.24.0-255,1484,34080,92,312885
35478,0.00018,172.31.47.0-255,66,34146,92,312885
35479,0.000211,74.125.24.0-255,1484,35630,92,312885
35480,0.000213,172.31.47.0-255,66,35696,92,312885
35481,0.000219,74.125.24.0-255,5738,41434,92,312885
35482,0.000221,172.31.47.0-255,66,41500,92,312885
35483,0.000256,172.31.47.0-255,66,41566,92,312885
35484,0.000276,172.31.47.0-255,66,41632,92,312885
35485,0.000282,74.125.24.0-255,5020,46652,92,312885
35486,0.000286,172.31.47.0-255,66,46718,92,312885
35487,0.000314,74.125.24.0-255,677,47395,92,312885
35488,0.000317,172.31.47.0-255,66,47461,92,312885
35489,0.000348,74.125.24.0-255,1484,48945,92,312885
35490,0.00035,172.31.47.0-255,66,49011,92,312885
35491,0.000357,74.125.24.0-255,4320,53331,92,312885
35492,0.000359,172.31.47.0-255,66,53397,92,312885
35493,0.000408,172.31.47.0-255,66,53463,92,312885
35494,0.000434,74.125.24.0-255,1994,55457,92,312885
35495,0.000445,172.31.47.0-255,66,55523,92,312885
35496,0.000681,74.125.24.0-255,1484,57007,92,312885
35497,0.0007,74.125.24.0-255,2902,59909,92,312885
35498,0.000704,172.31.47.0-255,66,59975,92,312885
35499,0.000711,74.125.24.0-255,5738,65713,92,312885
35500,0.000723,172.31.47.0-255,66,65779,92,312885
35501,0.000753,172.31.47.0-255,66,65845,92,312885
35502,0.000756,74.125.24.0-255,2902,68747,92,312885
35503,0.00077,172.31.47.0-255,66,68813,92,312885
35504,0.000816,74.125.24.0-255,7156,75969,92,312885
35505,0.000821,172.31.47.0-255,66,76035,92,312885
35506,0.000847,74.125.24.0-255,3602,79637,92,312885
35507,0.000856,172.31.47.0-255,66,79703,92,312885
35508,0.000987,74.125.24.0-255,1484,81187,92,312885
35509,0.001023,74.125.24.0-255,2902,84089,92,312885
35510,0.001027,172.31.47.0-255,66,84155,92,312885
35511,0.001033,74.125.24.0-255,4320,88475,92,312885
35512,0.001043,172.31.47.0-255,66,88541,92,312885
35513,0.001058,74.125.24.0-255,1484,90025,92,312885
35514,0.001069,74.125.24.0-255,5738,95763,92,312885
35515,0.001081,172.31.47.0-255,66,95829,92,312885
35516,0.001085,74.125.24.0-255,5020,100849,92,312885
35517,0.001087,172.31.47.0-255,66,100915,92,312885
35518,0.001104,172.31.47.0-255,66,100981,92,312885
35519,0.001277,74.125.24.0-255,1484,102465,92,312885
35520,0.001281,74.125.24.0-255,1484,103949,92,312885
35521,0.001284,172.31.47.0-255,66,104015,92,312885
35522,0.001305,74.125.24.0-255,1484,105499,92,312885
35523,0.001313,74.125.24.0-255,5738,111237,92,312885
35524,0.001325,172.31.47.0-255,66,111303,92,312885
35525,0.001337,74.125.24.0-255,5738,117041,92,312885
35526,0.001341,172.31.47.0-255,66,117107,92,312885
35527,0.001364,74.125.24.0-255,7156,124263,92,312885
35528,0.001377,172.31.47.0-255,66,124329,92,312885
35529,0.001419,172.31.47.0-255,66,124395,92,312885
35530,0.001478,74.125.24.0-255,1484,125879,92,312885
35531,0.001493,74.125.24.0-255,2902,128781,92,312885
35532,0.001496,172.31.47.0-255,66,128847,92,312885
35533,0.001523,74.125.24.0-255,4320,133167,92,312885
35534,0.001529,172.31.47.0-255,66,133233,92,312885
35535,0.001534,74.125.24.0-255,1484,134717,92,312885
35536,0.001541,74.125.24.0-255,5738,140455,92,312885
35537,0.001555,172.31.47.0-255,66,140521,92,312885
35538,0.001561,74.125.24.0-255,7156,147677,92,312885
35539,0.001581,172.31.47.0-255,66,147743,92,312885
35540,0.001599,74.125.24.0-255,2184,149927,92,312885
35541,0.001606,172.31.47.0-255,66,149993,92,312885
35542,0.001824,74.125.24.0-255,1484,151477,92,312885
35543,0.001845,74.125.24.0-255,2902,154379,92,312885
35544,0.001849,172.31.47.0-255,66,154445,92,312885
35545,0.001857,74.125.24.0-255,4320,158765,92,312885
35546,0.001865,172.31.47.0-255,66,158831,92,312885
35547,0.001895,74.125.24.0-255,7156,165987,92,312885
35548,0.001903,172.31.47.0-255,66,166053,92,312885
35549,0.001931,74.125.24.0-255,1484,167537,92,312885
35550,0.001951,172.31.47.0-255,66,167603,92,312885
35551,0.002177,74.125.24.0-255,1484,169087,92,312885
35552,0.002184,74.125.24.0-255,2902,171989,92,312885
35553,0.002188,172.31.47.0-255,66,172055,92,312885
35554,0.002195,74.125.24.0-255,5738,177793,92,312885
35555,0.002213,74.125.24.0-255,2902,180695,92,312885
35556,0.002259,74.125.24.0-255,1484,182179,92,312885
35557,0.002323,74.125.24.0-255,1484,183663,92,312885
35558,0.002613,172.31.47.0-255,66,183729,92,312885
35559,0.004886,74.125.24.0-255,5738,189467,92,312885
35560,0.004903,172.31.47.0-255,66,189533,92,312885
35561,0.007142,74.125.24.0-255,5738,195271,92,312885
35562,0.00716,172.31.47.0-255,66,195337,92,312885
35563,0.009393,74.125.24.0-255,5738,201075,92,312885
35564,0.009405,172.31.47.0-255,66,201141,92,312885
35565,0.011663,74.125.24.0-255,5738,206879,92,312885
35566,0.011681,172.31.47.0-255,66,206945,92,312885
35567,0.013943,74.125.24.0-255,5738,212683,92,312885
35568,0.013959,172.31.47.0-255,66,212749,92,312885
35569,0.016199,74.125.24.0-255,5738,218487,92,312885
35570,0.016207,172.31.47.0-255,66,218553,92,312885
35571,0.018481,74.125.24.0-255,5738,224291,92,312885
35572,0.018489,172.31.47.0-255,66,224357,92,312885
35573,0.020749,74.125.24.0-255,5738,230095,92,312885
35574,0.020763,172.31.47.0-255,66,230161,92,312885
35575,0.023007,74.125.24.0-255,5738,235899,92,312885
35576,0.023019,172.31.47.0-255,66,235965,92,312885
35577,0.025272,74.125.24.0-255,5738,241703,92,312885
35578,0.02528,172.31.47.0-255,66,241769,92,312885
35579,0.027555,74.125.24.0-255,5738,247507,92,312885
35580,0.027566,172.31.47.0-255,66,247573,92,312885
35581,0.029823,74.125.24.0-255,5738,253311,92,312885
35582,0.029833,172.31.47.0-255,66,253377,92,312885
35583,0.032094,74.125.24.0-255,5738,259115,92,312885
35584,0.032101,172.31.47.0-255,66,259181,92,312885
35585,0.032688,172.31.47.0-255,172,259353,92,312885
35586,0.032717,172.31.47.0-255,1107,260460,92,312885
35587,0.03276,172.31.47.0-255,1514,261974,92,312885
35588,0.032761,172.31.47.0-255,1514,263488,92,312885
35589,0.032765,172.31.47.0-255,1514,265002,92,312885
35590,0.032766,172.31.47.0-255,1514,266516,92,312885
35591,0.032798,172.31.47.0-255,1499,268015,92,312885
35592,0.034185,104.244.42.0-255,66,268081,92,312885
35593,0.034259,104.244.42.0-255,66,268147,92,312885
35594,0.034314,104.244.42.0-255,66,268213,92,312885
35595,0.034319,104.244.42.0-255,66,268279,92,312885
35596,0.034329,74.125.24.0-255,5738,274017,92,312885
35597,0.034333,172.31.47.0-255,66,274083,92,312885
35598,0.034354,104.244.42.0-255,66,274149,92,312885
35599,0.036553,74.125.24.0-255,5738,279887,92,312885
35600,0.036556,172.31.47.0-255,66,279953,92,312885
35601,0.038789,74.125.24.0-255,5738,285691,92,312885
35602,0.038808,172.31.47.0-255,66,285757,92,312885
35603,0.041052,74.125.24.0-255,5738,291495,92,312885
35604,0.041059,172.31.47.0-255,66,291561,92,312885
35605,0.043284,74.125.24.0-255,5738,297299,92,312885
35606,0.04329,172.31.47.0-255,66,297365,92,312885
35607,0.045535,74.125.24.0-255,5738,303103,92,312885
35608,0.045541,172.31.47.0-255,66,303169,92,312885
35609,0.047792,74.125.24.0-255,5738,308907,92,312885
35610,0.047798,172.31.47.0-255,66,308973,92,312885
35611,0.050031,74.125.24.0-255,3675,312648,92,312885
35612,0.050037,172.31.47.0-255,66,312714,92,312885
35613,0.050228,172.31.47.0-255,105,312819,92,312885
35614,0.052428,74.125.24.0-255,66,312885,92,312885
35615,0.0,52.33.61.0-255,97,97,92,260
35616,0.000144,172.31.47.0-255,97,194,92,260
35617,0.000155,172.31.47.0-255,66,260,92,260
35618,0.0,172.217.194.0-255,226,226,92,180056
35619,2.7e-05,172.31.47.0-255,66,292,92,180056
35620,3.3e-05,172.217.194.0-255,1484,1776,92,180056
35621,3.7e-05,172.31.47.0-255,66,1842,92,180056
35622,5.6e-05,172.217.194.0-255,1484,3326,92,180056
35623,5.8e-05,172.31.47.0-255,66,3392,92,180056
35624,7.8e-05,172.217.194.0-255,2902,6294,92,180056
35625,8.3e-05,172.31.47.0-255,66,6360,92,180056
35626,0.000261,172.217.194.0-255,1484,7844,92,180056
35627,0.000266,172.31.47.0-255,66,7910,92,180056
35628,0.000297,172.217.194.0-255,6462,14372,92,180056
35629,0.0003,172.31.47.0-255,66,14438,92,180056
35630,0.000643,172.31.47.0-255,66,14504,92,180056
35631,0.001009,172.217.194.0-255,7156,21660,92,180056
35632,0.001014,172.31.47.0-255,66,21726,92,180056
35633,0.001044,172.217.194.0-255,1158,22884,92,180056
35634,0.001047,172.31.47.0-255,66,22950,92,180056
35635,0.003363,172.217.194.0-255,4320,27270,92,180056
35636,0.003368,172.31.47.0-255,66,27336,92,180056
35637,0.003448,172.217.194.0-255,1484,28820,92,180056
35638,0.003451,172.31.47.0-255,66,28886,92,180056
35639,0.00573,172.217.194.0-255,4320,33206,92,180056
35640,0.005737,172.31.47.0-255,66,33272,92,180056
35641,0.005807,172.217.194.0-255,1484,34756,92,180056
35642,0.005812,172.31.47.0-255,66,34822,92,180056
35643,0.008099,172.217.194.0-255,2902,37724,92,180056
35644,0.008105,172.31.47.0-255,66,37790,92,180056
35645,0.00816,172.217.194.0-255,2902,40692,92,180056
35646,0.008165,172.31.47.0-255,66,40758,92,180056
35647,0.010453,172.217.194.0-255,2902,43660,92,180056
35648,0.01046,172.31.47.0-255,66,43726,92,180056
35649,0.010504,172.217.194.0-255,2902,46628,92,180056
35650,0.010509,172.31.47.0-255,66,46694,92,180056
35651,0.012808,172.217.194.0-255,2902,49596,92,180056
35652,0.012816,172.31.47.0-255,66,49662,92,180056
35653,0.01286,172.217.194.0-255,2902,52564,92,180056
35654,0.012865,172.31.47.0-255,66,52630,92,180056
35655,0.015169,172.217.194.0-255,2902,55532,92,180056
35656,0.015175,172.31.47.0-255,66,55598,92,180056
35657,0.015224,172.217.194.0-255,2902,58500,92,180056
35658,0.015229,172.31.47.0-255,66,58566,92,180056
35659,0.01752,172.217.194.0-255,2902,61468,92,180056
35660,0.017527,172.31.47.0-255,66,61534,92,180056
35661,0.017582,172.217.194.0-255,2902,64436,92,180056
35662,0.017586,172.31.47.0-255,66,64502,92,180056
35663,0.019407,172.31.47.0-255,172,64674,92,180056
35664,0.019437,172.31.47.0-255,1111,65785,92,180056
35665,0.019484,172.31.47.0-255,1514,67299,92,180056
35666,0.019486,172.31.47.0-255,1514,68813,92,180056
35667,0.019487,172.31.47.0-255,1514,70327,92,180056
35668,0.019488,172.31.47.0-255,1514,71841,92,180056
35669,0.019511,172.31.47.0-255,533,72374,92,180056
35670,0.019885,172.217.194.0-255,2902,75276,92,180056
35671,0.019891,172.31.47.0-255,66,75342,92,180056
35672,0.019937,172.217.194.0-255,1484,76826,92,180056
35673,0.019944,172.31.47.0-255,66,76892,92,180056
35674,0.019948,172.217.194.0-255,1484,78376,92,180056
35675,0.01995,172.31.47.0-255,66,78442,92,180056
35676,0.020956,104.244.42.0-255,66,78508,92,180056
35677,0.021085,104.244.42.0-255,66,78574,92,180056
35678,0.021087,104.244.42.0-255,66,78640,92,180056
35679,0.021152,104.244.42.0-255,66,78706,92,180056
35680,0.021648,104.244.42.0-255,108,78814,92,180056
35681,0.021652,172.31.47.0-255,66,78880,92,180056
35682,0.022235,172.217.194.0-255,2902,81782,92,180056
35683,0.022239,172.31.47.0-255,66,81848,92,180056
35684,0.022298,172.217.194.0-255,2902,84750,92,180056
35685,0.022303,172.31.47.0-255,66,84816,92,180056
35686,0.024561,172.217.194.0-255,2902,87718,92,180056
35687,0.024567,172.31.47.0-255,66,87784,92,180056
35688,0.024658,172.217.194.0-255,2902,90686,92,180056
35689,0.024664,172.31.47.0-255,66,90752,92,180056
35690,0.026908,172.217.194.0-255,2902,93654,92,180056
35691,0.026914,172.31.47.0-255,66,93720,92,180056
35692,0.026986,172.217.194.0-255,2902,96622,92,180056
35693,0.02699,172.31.47.0-255,66,96688,92,180056
35694,0.029262,172.217.194.0-255,2902,99590,92,180056
35695,0.029268,172.31.47.0-255,66,99656,92,180056
35696,0.029334,172.217.194.0-255,2902,102558,92,180056
35697,0.029339,172.31.47.0-255,66,102624,92,180056
35698,0.031611,172.217.194.0-255,2902,105526,92,180056
35699,0.031616,172.31.47.0-255,66,105592,92,180056
35700,0.031677,172.217.194.0-255,2902,108494,92,180056
35701,0.031681,172.31.47.0-255,66,108560,92,180056
35702,0.033955,172.217.194.0-255,2902,111462,92,180056
35703,0.03396,172.31.47.0-255,66,111528,92,180056
35704,0.034024,172.217.194.0-255,2902,114430,92,180056
35705,0.034029,172.31.47.0-255,66,114496,92,180056
35706,0.036305,172.217.194.0-255,2902,117398,92,180056
35707,0.03631,172.31.47.0-255,66,117464,92,180056
35708,0.036361,172.217.194.0-255,2902,120366,92,180056
35709,0.036365,172.31.47.0-255,66,120432,92,180056
35710,0.038638,172.217.194.0-255,2902,123334,92,180056
35711,0.038642,172.31.47.0-255,66,123400,92,180056
35712,0.038704,172.217.194.0-255,2902,126302,92,180056
35713,0.038709,172.31.47.0-255,66,126368,92,180056
35714,0.040987,172.217.194.0-255,2902,129270,92,180056
35715,0.040992,172.31.47.0-255,66,129336,92,180056
35716,0.041046,172.217.194.0-255,2902,132238,92,180056
35717,0.041049,172.31.47.0-255,66,132304,92,180056
35718,0.043335,172.217.194.0-255,2902,135206,92,180056
35719,0.043339,172.31.47.0-255,66,135272,92,180056
35720,0.043398,172.217.194.0-255,2902,138174,92,180056
35721,0.043402,172.31.47.0-255,66,138240,92,180056
35722,0.045687,172.217.194.0-255,2902,141142,92,180056
35723,0.045693,172.31.47.0-255,66,141208,92,180056
35724,0.045747,172.217.194.0-255,2902,144110,92,180056
35725,0.045751,172.31.47.0-255,66,144176,92,180056
35726,0.048014,172.217.194.0-255,2902,147078,92,180056
35727,0.048017,172.31.47.0-255,66,147144,92,180056
35728,0.048069,172.217.194.0-255,2902,150046,92,180056
35729,0.048072,172.31.47.0-255,66,150112,92,180056
35730,0.050371,172.217.194.0-255,2902,153014,92,180056
35731,0.050375,172.31.47.0-255,66,153080,92,180056
35732,0.050422,172.217.194.0-255,2902,155982,92,180056
35733,0.050425,172.31.47.0-255,66,156048,92,180056
35734,0.052714,172.217.194.0-255,2902,158950,92,180056
35735,0.052719,172.31.47.0-255,66,159016,92,180056
35736,0.05276,172.217.194.0-255,1484,160500,92,180056
35737,0.052763,172.31.47.0-255,66,160566,92,180056
35738,0.052789,172.217.194.0-255,1484,162050,92,180056
35739,0.052792,172.31.47.0-255,66,162116,92,180056
35740,0.055069,172.217.194.0-255,2902,165018,92,180056
35741,0.055074,172.31.47.0-255,66,165084,92,180056
35742,0.055134,172.217.194.0-255,2902,167986,92,180056
35743,0.055139,172.31.47.0-255,66,168052,92,180056
35744,0.057439,172.217.194.0-255,2902,170954,92,180056
35745,0.057443,172.31.47.0-255,66,171020,92,180056
35746,0.05749,172.217.194.0-255,2902,173922,92,180056
35747,0.057493,172.31.47.0-255,66,173988,92,180056
35748,0.059766,172.217.194.0-255,2902,176890,92,180056
35749,0.059771,172.31.47.0-255,66,176956,92,180056
35750,0.059847,172.217.194.0-255,1484,178440,92,180056
35751,0.059851,172.31.47.0-255,66,178506,92,180056
35752,0.059874,172.217.194.0-255,1484,179990,92,180056
35753,0.059877,172.31.47.0-255,66,180056,92,180056
35754,0.0,74.125.24.0-255,153,153,92,313206
35755,2e-05,172.31.47.0-255,66,219,92,313206
35756,2.8e-05,74.125.24.0-255,1484,1703,92,313206
35757,3.2e-05,172.31.47.0-255,66,1769,92,313206
35758,6.7e-05,74.125.24.0-255,2902,4671,92,313206
35759,7.1e-05,172.31.47.0-255,66,4737,92,313206
35760,9.9e-05,74.125.24.0-255,5738,10475,92,313206
35761,0.000102,172.31.47.0-255,66,10541,92,313206
35762,0.000106,74.125.24.0-255,2902,13443,92,313206
35763,0.000109,172.31.47.0-255,66,13509,92,313206
35764,0.000161,172.31.47.0-255,66,13575,92,313206
35765,0.000165,74.125.24.0-255,1484,15059,92,313206
35766,0.000167,172.31.47.0-255,66,15125,92,313206
35767,0.000214,74.125.24.0-255,2902,18027,92,313206
35768,0.000216,172.31.47.0-255,66,18093,92,313206
35769,0.00024,74.125.24.0-255,2543,20636,92,313206
35770,0.000242,172.31.47.0-255,66,20702,92,313206
35771,0.000936,74.125.24.0-255,1484,22186,92,313206
35772,0.000943,172.31.47.0-255,66,22252,92,313206
35773,0.00095,74.125.24.0-255,2902,25154,92,313206
35774,0.000953,172.31.47.0-255,66,25220,92,313206
35775,0.000964,74.125.24.0-255,5738,30958,92,313206
35776,0.000966,172.31.47.0-255,66,31024,92,313206
35777,0.000972,74.125.24.0-255,6797,37821,92,313206
35778,0.000975,172.31.47.0-255,66,37887,92,313206
35779,0.000983,74.125.24.0-255,7156,45043,92,313206
35780,0.000986,172.31.47.0-255,66,45109,92,313206
35781,0.001021,172.31.47.0-255,66,45175,92,313206
35782,0.001391,74.125.24.0-255,110,45285,92,313206
35783,0.001397,172.31.47.0-255,66,45351,92,313206
35784,0.00159,74.125.24.0-255,1484,46835,92,313206
35785,0.001597,74.125.24.0-255,2902,49737,92,313206
35786,0.001633,74.125.24.0-255,5738,55475,92,313206
35787,0.001653,74.125.24.0-255,5738,61213,92,313206
35788,0.001675,74.125.24.0-255,4320,65533,92,313206
35789,0.001698,74.125.24.0-255,5020,70553,92,313206
35790,0.001747,74.125.24.0-255,4320,74873,92,313206
35791,0.001775,74.125.24.0-255,2229,77102,92,313206
35792,0.002622,74.125.24.0-255,1484,78586,92,313206
35793,0.002635,74.125.24.0-255,2902,81488,92,313206
35794,0.002658,74.125.24.0-255,5738,87226,92,313206
35795,0.002676,74.125.24.0-255,2902,90128,92,313206
35796,0.002697,74.125.24.0-255,4320,94448,92,313206
35797,0.002704,74.125.24.0-255,7156,101604,92,313206
35798,0.002707,74.125.24.0-255,1484,103088,92,313206
35799,0.002709,74.125.24.0-255,1484,104572,92,313206
35800,0.002732,74.125.24.0-255,6438,111010,92,313206
35801,0.002809,74.125.24.0-255,1484,112494,92,313206
35802,0.002833,74.125.24.0-255,2902,115396,92,313206
35803,0.002845,74.125.24.0-255,4320,119716,92,313206
35804,0.002872,74.125.24.0-255,5738,125454,92,313206
35805,0.002885,74.125.24.0-255,2902,128356,92,313206
35806,0.002897,74.125.24.0-255,2902,131258,92,313206
35807,0.002944,74.125.24.0-255,3602,134860,92,313206
35808,0.003988,74.125.24.0-255,1484,136344,92,313206
35809,0.004,74.125.24.0-255,2902,139246,92,313206
35810,0.004003,74.125.24.0-255,1484,140730,92,313206
35811,0.004022,74.125.24.0-255,2902,143632,92,313206
35812,0.004037,74.125.24.0-255,5738,149370,92,313206
35813,0.004052,74.125.24.0-255,2902,152272,92,313206
35814,0.004065,74.125.24.0-255,4320,156592,92,313206
35815,0.004081,74.125.24.0-255,4320,160912,92,313206
35816,0.004101,74.125.24.0-255,4320,165232,92,313206
35817,0.004151,74.125.24.0-255,3602,168834,92,313206
35818,0.004286,74.125.24.0-255,1484,170318,92,313206
35819,0.004304,74.125.24.0-255,2902,173220,92,313206
35820,0.004327,74.125.24.0-255,5738,178958,92,313206
35821,0.00433,74.125.24.0-255,1484,180442,92,313206
35822,0.004367,74.125.24.0-255,2902,183344,92,313206
35823,0.004378,74.125.24.0-255,2902,186246,92,313206
35824,0.004456,74.125.24.0-255,1484,187730,92,313206
35825,0.004459,74.125.24.0-255,1484,189214,92,313206
35826,0.004477,74.125.24.0-255,1484,190698,92,313206
35827,0.004484,74.125.24.0-255,5738,196436,92,313206
35828,0.004519,74.125.24.0-255,5738,202174,92,313206
35829,0.004543,74.125.24.0-255,7156,209330,92,313206
35830,0.00455,74.125.24.0-255,5738,215068,92,313206
35831,0.004584,74.125.24.0-255,5020,220088,92,313206
35832,0.004624,74.125.24.0-255,4320,224408,92,313206
35833,0.004645,74.125.24.0-255,5738,230146,92,313206
35834,0.004649,74.125.24.0-255,1484,231630,92,313206
35835,0.004678,74.125.24.0-255,2902,234532,92,313206
35836,0.004759,74.125.24.0-255,1484,236016,92,313206
35837,0.004771,74.125.24.0-255,2902,238918,92,313206
35838,0.004775,74.125.24.0-255,1484,240402,92,313206
35839,0.004788,74.125.24.0-255,4320,244722,92,313206
35840,0.00484,74.125.24.0-255,4320,249042,92,313206
35841,0.004847,74.125.24.0-255,7156,256198,92,313206
35842,0.004882,74.125.24.0-255,3602,259800,92,313206
35843,0.004929,74.125.24.0-255,2902,262702,92,313206
35844,0.004942,74.125.24.0-255,1484,264186,92,313206
35845,0.004945,74.125.24.0-255,1484,265670,92,313206
35846,0.004965,74.125.24.0-255,4320,269990,92,313206
35847,0.00497,74.125.24.0-255,2902,272892,92,313206
35848,0.004999,74.125.24.0-255,7156,280048,92,313206
35849,0.005009,74.125.24.0-255,1484,281532,92,313206
35850,0.005037,74.125.24.0-255,3602,285134,92,313206
35851,0.005055,74.125.24.0-255,4320,289454,92,313206
35852,0.005072,74.125.24.0-255,2902,292356,92,313206
35853,0.005103,74.125.24.0-255,7156,299512,92,313206
35854,0.005146,74.125.24.0-255,4320,303832,92,313206
35855,0.005175,74.125.24.0-255,105,303937,92,313206
35856,0.005328,172.31.47.0-255,66,304003,92,313206
35857,0.00834,172.31.47.0-255,105,304108,92,313206
35858,0.010906,74.125.24.0-255,66,304174,92,313206
35859,0.041335,172.31.47.0-255,172,304346,92,313206
35860,0.041369,172.31.47.0-255,1107,305453,92,313206
35861,0.041446,172.31.47.0-255,1514,306967,92,313206
35862,0.041448,172.31.47.0-255,1514,308481,92,313206
35863,0.041454,172.31.47.0-255,1514,309995,92,313206
35864,0.041455,172.31.47.0-255,1514,311509,92,313206
35865,0.041472,172.31.47.0-255,1499,313008,92,313206
35866,0.042904,104.244.42.0-255,66,313074,92,313206
35867,0.042914,104.244.42.0-255,66,313140,92,313206
35868,0.043,104.244.42.0-255,66,313206,92,313206
35869,0.0,172.217.160.0-255,153,153,92,283396
35870,3.4e-05,172.31.47.0-255,66,219,92,283396
35871,4e-05,172.217.160.0-255,1484,1703,92,283396
35872,4.5e-05,172.31.47.0-255,66,1769,92,283396
35873,4.7e-05,172.217.160.0-255,1484,3253,92,283396
35874,4.9e-05,172.31.47.0-255,66,3319,92,283396
35875,7.6e-05,172.217.160.0-255,1484,4803,92,283396
35876,7.8e-05,172.31.47.0-255,66,4869,92,283396
35877,8.6e-05,172.217.160.0-255,7156,12025,92,283396
35878,8.8e-05,172.31.47.0-255,66,12091,92,283396
35879,0.000103,172.31.47.0-255,66,12157,92,283396
35880,0.000107,172.217.160.0-255,4320,16477,92,283396
35881,0.00011,172.31.47.0-255,66,16543,92,283396
35882,0.000131,172.217.160.0-255,2543,19086,92,283396
35883,0.000135,172.31.47.0-255,66,19152,92,283396
35884,0.00014,172.217.160.0-255,4320,23472,92,283396
35885,0.000142,172.31.47.0-255,66,23538,92,283396
35886,0.000159,172.217.160.0-255,2902,26440,92,283396
35887,0.000163,172.31.47.0-255,66,26506,92,283396
35888,0.000171,172.217.160.0-255,5738,32244,92,283396
35889,0.000174,172.31.47.0-255,66,32310,92,283396
35890,0.000215,172.217.160.0-255,6797,39107,92,283396
35891,0.000219,172.31.47.0-255,66,39173,92,283396
35892,0.000223,172.217.160.0-255,2902,42075,92,283396
35893,0.000225,172.31.47.0-255,66,42141,92,283396
35894,0.00024,172.217.160.0-255,4320,46461,92,283396
35895,0.000243,172.31.47.0-255,66,46527,92,283396
35896,0.000251,172.217.160.0-255,6797,53324,92,283396
35897,0.000253,172.31.47.0-255,66,53390,92,283396
35898,0.000267,172.217.160.0-255,373,53763,92,283396
35899,0.000269,172.31.47.0-255,66,53829,92,283396
35900,0.000589,172.217.160.0-255,100,53929,92,283396
35901,0.000642,172.217.160.0-255,1484,55413,92,283396
35902,0.000646,172.217.160.0-255,2902,58315,92,283396
35903,0.000647,172.31.47.0-255,66,58381,92,283396
35904,0.00065,172.31.47.0-255,66,58447,92,283396
35905,0.000655,172.217.160.0-255,1484,59931,92,283396
35906,0.000673,172.217.160.0-255,4320,64251,92,283396
35907,0.000676,172.31.47.0-255,66,64317,92,283396
35908,0.00072,172.217.160.0-255,5738,70055,92,283396
35909,0.000722,172.31.47.0-255,66,70121,92,283396
35910,0.000752,172.31.47.0-255,66,70187,92,283396
35911,0.000761,172.31.47.0-255,66,70253,92,283396
35912,0.000913,172.217.160.0-255,367,70620,92,283396
35913,0.000951,172.31.47.0-255,66,70686,92,283396
35914,0.001528,172.217.160.0-255,1484,72170,92,283396
35915,0.001537,172.217.160.0-255,2902,75072,92,283396
35916,0.001541,172.31.47.0-255,66,75138,92,283396
35917,0.001547,172.217.160.0-255,5738,80876,92,283396
35918,0.001549,172.31.47.0-255,66,80942,92,283396
35919,0.001603,172.31.47.0-255,66,81008,92,283396
35920,0.001612,172.31.47.0-255,66,81074,92,283396
35921,0.003266,172.217.160.0-255,4320,85394,92,283396
35922,0.003269,172.31.47.0-255,66,85460,92,283396
35923,0.003279,172.217.160.0-255,1484,86944,92,283396
35924,0.004924,172.217.160.0-255,2902,89846,92,283396
35925,0.004927,172.31.47.0-255,66,89912,92,283396
35926,0.004939,172.217.160.0-255,1484,91396,92,283396
35927,0.006598,172.217.160.0-255,4320,95716,92,283396
35928,0.006604,172.31.47.0-255,66,95782,92,283396
35929,0.008265,172.217.160.0-255,2902,98684,92,283396
35930,0.008271,172.31.47.0-255,66,98750,92,283396
35931,0.00829,172.217.160.0-255,2902,101652,92,283396
35932,0.008293,172.31.47.0-255,66,101718,92,283396
35933,0.009952,172.217.160.0-255,5738,107456,92,283396
35934,0.009959,172.31.47.0-255,66,107522,92,283396
35935,0.011628,172.217.160.0-255,5738,113260,92,283396
35936,0.011633,172.31.47.0-255,66,113326,92,283396
35937,0.013295,172.217.160.0-255,5738,119064,92,283396
35938,0.013301,172.31.47.0-255,66,119130,92,283396
35939,0.014966,172.217.160.0-255,4320,123450,92,283396
35940,0.014971,172.31.47.0-255,66,123516,92,283396
35941,0.014985,172.217.160.0-255,1484,125000,92,283396
35942,0.016646,172.217.160.0-255,4320,129320,92,283396
35943,0.016653,172.31.47.0-255,66,129386,92,283396
35944,0.018315,172.217.160.0-255,5738,135124,92,283396
35945,0.018321,172.31.47.0-255,66,135190,92,283396
35946,0.019984,172.217.160.0-255,5738,140928,92,283396
35947,0.019991,172.31.47.0-255,66,140994,92,283396
35948,0.021654,172.217.160.0-255,5738,146732,92,283396
35949,0.02166,172.31.47.0-255,66,146798,92,283396
35950,0.023319,172.217.160.0-255,5738,152536,92,283396
35951,0.023324,172.31.47.0-255,66,152602,92,283396
35952,0.024991,172.217.160.0-255,5738,158340,92,283396
35953,0.024998,172.31.47.0-255,66,158406,92,283396
35954,0.026661,172.217.160.0-255,5738,164144,92,283396
35955,0.026667,172.31.47.0-255,66,164210,92,283396
35956,0.028339,172.217.160.0-255,5738,169948,92,283396
35957,0.028346,172.31.47.0-255,66,170014,92,283396
35958,0.030012,172.217.160.0-255,5738,175752,92,283396
35959,0.030019,172.31.47.0-255,66,175818,92,283396
35960,0.030945,172.31.47.0-255,172,175990,92,283396
35961,0.030983,172.31.47.0-255,1111,177101,92,283396
35962,0.031046,172.31.47.0-255,1514,178615,92,283396
35963,0.031047,172.31.47.0-255,1514,180129,92,283396
35964,0.031048,172.31.47.0-255,1514,181643,92,283396
35965,0.031049,172.31.47.0-255,1514,183157,92,283396
35966,0.03105,172.31.47.0-255,1495,184652,92,283396
35967,0.03169,172.217.160.0-255,5738,190390,92,283396
35968,0.031697,172.31.47.0-255,66,190456,92,283396
35969,0.032505,104.244.42.0-255,66,190522,92,283396
35970,0.032548,104.244.42.0-255,66,190588,92,283396
35971,0.032691,104.244.42.0-255,66,190654,92,283396
35972,0.033358,172.217.160.0-255,1484,192138,92,283396
35973,0.033384,172.217.160.0-255,4320,196458,92,283396
35974,0.033388,172.31.47.0-255,66,196524,92,283396
35975,0.035059,172.217.160.0-255,5738,202262,92,283396
35976,0.035064,172.31.47.0-255,66,202328,92,283396
35977,0.03552,104.244.42.0-255,108,202436,92,283396
35978,0.035526,172.31.47.0-255,66,202502,92,283396
35979,0.036723,172.217.160.0-255,2902,205404,92,283396
35980,0.036728,172.31.47.0-255,66,205470,92,283396
35981,0.036752,172.217.160.0-255,2902,208372,92,283396
35982,0.036755,172.31.47.0-255,66,208438,92,283396
35983,0.038392,172.217.160.0-255,2902,211340,92,283396
35984,0.038397,172.31.47.0-255,66,211406,92,283396
35985,0.038424,172.217.160.0-255,2902,214308,92,283396
35986,0.038426,172.31.47.0-255,66,214374,92,283396
35987,0.040056,172.217.160.0-255,2902,217276,92,283396
35988,0.040061,172.31.47.0-255,66,217342,92,283396
35989,0.040088,172.217.160.0-255,2902,220244,92,283396
35990,0.040091,172.31.47.0-255,66,220310,92,283396
35991,0.041719,172.217.160.0-255,2902,223212,92,283396
35992,0.041725,172.31.47.0-255,66,223278,92,283396
35993,0.041748,172.217.160.0-255,2902,226180,92,283396
35994,0.041752,172.31.47.0-255,66,226246,92,283396
35995,0.043385,172.217.160.0-255,2902,229148,92,283396
35996,0.04339,172.31.47.0-255,66,229214,92,283396
35997,0.043418,172.217.160.0-255,2902,232116,92,283396
35998,0.04342,172.31.47.0-255,66,232182,92,283396
35999,0.045048,172.217.160.0-255,2902,235084,92,283396
36000,0.045053,172.31.47.0-255,66,235150,92,283396
36001,0.04508,172.217.160.0-255,2902,238052,92,283396
36002,0.045083,172.31.47.0-255,66,238118,92,283396
36003,0.046733,172.217.160.0-255,5738,243856,92,283396
36004,0.046738,172.31.47.0-255,66,243922,92,283396
36005,0.048403,172.217.160.0-255,5738,249660,92,283396
36006,0.048409,172.31.47.0-255,66,249726,92,283396
36007,0.050106,172.217.160.0-255,2902,252628,92,283396
36008,0.050112,172.31.47.0-255,66,252694,92,283396
36009,0.050143,172.217.160.0-255,2902,255596,92,283396
36010,0.050145,172.31.47.0-255,66,255662,92,283396
36011,0.051786,172.217.160.0-255,4320,259982,92,283396
36012,0.05179,172.31.47.0-255,66,260048,92,283396
36013,0.051816,172.217.160.0-255,1484,261532,92,283396
36014,0.053488,172.217.160.0-255,4320,265852,92,283396
36015,0.053493,172.31.47.0-255,66,265918,92,283396
36016,0.055154,172.217.160.0-255,5738,271656,92,283396
36017,0.055159,172.31.47.0-255,66,271722,92,283396
36018,0.05683,172.217.160.0-255,5738,277460,92,283396
36019,0.056835,172.31.47.0-255,66,277526,92,283396
36020,0.058499,172.217.160.0-255,4320,281846,92,283396
36021,0.058505,172.31.47.0-255,66,281912,92,283396
36022,0.058521,172.217.160.0-255,1484,283396,92,283396
36023,0.0,74.125.24.0-255,153,153,92,324583
36024,2.9e-05,172.31.47.0-255,66,219,92,324583
36025,3.5e-05,74.125.24.0-255,1484,1703,92,324583
36026,3.9e-05,172.31.47.0-255,66,1769,92,324583
36027,4.3e-05,74.125.24.0-255,2902,4671,92,324583
36028,4.5e-05,172.31.47.0-255,66,4737,92,324583
36029,5.1e-05,74.125.24.0-255,7156,11893,92,324583
36030,5.4e-05,172.31.47.0-255,66,11959,92,324583
36031,7.7e-05,74.125.24.0-255,2110,14069,92,324583
36032,7.8e-05,172.31.47.0-255,66,14135,92,324583
36033,0.000107,74.125.24.0-255,2902,17037,92,324583
36034,0.000109,172.31.47.0-255,66,17103,92,324583
36035,0.00013,74.125.24.0-255,4320,21423,92,324583
36036,0.000132,172.31.47.0-255,66,21489,92,324583
36037,0.000136,74.125.24.0-255,2902,24391,92,324583
36038,0.000137,172.31.47.0-255,66,24457,92,324583
36039,0.000158,74.125.24.0-255,5738,30195,92,324583
36040,0.00016,172.31.47.0-255,66,30261,92,324583
36041,0.000181,74.125.24.0-255,5738,35999,92,324583
36042,0.000186,172.31.47.0-255,66,36065,92,324583
36043,0.000211,74.125.24.0-255,6797,42862,92,324583
36044,0.000214,172.31.47.0-255,66,42928,92,324583
36045,0.000226,74.125.24.0-255,2902,45830,92,324583
36046,0.000228,172.31.47.0-255,66,45896,92,324583
36047,0.000242,74.125.24.0-255,2543,48439,92,324583
36048,0.000244,172.31.47.0-255,66,48505,92,324583
36049,0.000552,74.125.24.0-255,1484,49989,92,324583
36050,0.000556,172.31.47.0-255,66,50055,92,324583
36051,0.000561,74.125.24.0-255,2902,52957,92,324583
36052,0.000563,172.31.47.0-255,66,53023,92,324583
36053,0.000592,74.125.24.0-255,5738,58761,92,324583
36054,0.000598,172.31.47.0-255,66,58827,92,324583
36055,0.000623,74.125.24.0-255,1484,60311,92,324583
36056,0.000646,74.125.24.0-255,5726,66037,92,324583
36057,0.000649,172.31.47.0-255,66,66103,92,324583
36058,0.000718,74.125.24.0-255,330,66433,92,324583
36059,0.000724,172.31.47.0-255,66,66499,92,324583
36060,0.001033,74.125.24.0-255,1484,67983,92,324583
36061,0.001052,74.125.24.0-255,2902,70885,92,324583
36062,0.001058,172.31.47.0-255,66,70951,92,324583
36063,0.001083,74.125.24.0-255,5738,76689,92,324583
36064,0.001086,172.31.47.0-255,66,76755,92,324583
36065,0.001089,74.125.24.0-255,1484,78239,92,324583
36066,0.001117,172.31.47.0-255,66,78305,92,324583
36067,0.001126,172.31.47.0-255,66,78371,92,324583
36068,0.001144,74.125.24.0-255,2902,81273,92,324583
36069,0.001147,172.31.47.0-255,66,81339,92,324583
36070,0.00115,74.125.24.0-255,2184,83523,92,324583
36071,0.001152,172.31.47.0-255,66,83589,92,324583
36072,0.001227,74.125.24.0-255,1484,85073,92,324583
36073,0.001233,74.125.24.0-255,2902,87975,92,324583
36074,0.001236,172.31.47.0-255,66,88041,92,324583
36075,0.00126,74.125.24.0-255,5738,93779,92,324583
36076,0.001264,172.31.47.0-255,66,93845,92,324583
36077,0.001271,74.125.24.0-255,7156,101001,92,324583
36078,0.001273,172.31.47.0-255,66,101067,92,324583
36079,0.00129,74.125.24.0-255,5738,106805,92,324583
36080,0.001292,172.31.47.0-255,66,106871,92,324583
36081,0.001298,74.125.24.0-255,4320,111191,92,324583
36082,0.0013,172.31.47.0-255,66,111257,92,324583
36083,0.00133,74.125.24.0-255,6438,117695,92,324583
36084,0.001335,172.31.47.0-255,66,117761,92,324583
36085,0.001495,74.125.24.0-255,1484,119245,92,324583
36086,0.0015,74.125.24.0-255,2902,122147,92,324583
36087,0.001503,172.31.47.0-255,66,122213,92,324583
36088,0.001506,74.125.24.0-255,1484,123697,92,324583
36089,0.001521,74.125.24.0-255,4320,128017,92,324583
36090,0.001523,172.31.47.0-255,66,128083,92,324583
36091,0.001542,74.125.24.0-255,2902,130985,92,324583
36092,0.001544,172.31.47.0-255,66,131051,92,324583
36093,0.001566,172.31.47.0-255,66,131117,92,324583
36094,0.00159,74.125.24.0-255,4320,135437,92,324583
36095,0.001593,172.31.47.0-255,66,135503,92,324583
36096,0.001609,74.125.24.0-255,6438,141941,92,324583
36097,0.001611,172.31.47.0-255,66,142007,92,324583
36098,0.001991,74.125.24.0-255,1484,143491,92,324583
36099,0.001998,74.125.24.0-255,2902,146393,92,324583
36100,0.002001,172.31.47.0-255,66,146459,92,324583
36101,0.002019,74.125.24.0-255,4320,150779,92,324583
36102,0.002021,172.31.47.0-255,66,150845,92,324583
36103,0.002052,172.31.47.0-255,66,150911,92,324583
36104,0.002072,74.125.24.0-255,4320,155231,92,324583
36105,0.002074,172.31.47.0-255,66,155297,92,324583
36106,0.002104,172.31.47.0-255,66,155363,92,324583
36107,0.002363,74.125.24.0-255,1484,156847,92,324583
36108,0.00237,74.125.24.0-255,2902,159749,92,324583
36109,0.002373,172.31.47.0-255,66,159815,92,324583
36110,0.002397,74.125.24.0-255,5738,165553,92,324583
36111,0.0024,172.31.47.0-255,66,165619,92,324583
36112,0.002427,172.31.47.0-255,66,165685,92,324583
36113,0.002449,74.125.24.0-255,2902,168587,92,324583
36114,0.002451,172.31.47.0-255,66,168653,92,324583
36115,0.002456,74.125.24.0-255,5738,174391,92,324583
36116,0.002458,172.31.47.0-255,66,174457,92,324583
36117,0.002469,74.125.24.0-255,1484,175941,92,324583
36118,0.002488,74.125.24.0-255,3602,179543,92,324583
36119,0.00249,172.31.47.0-255,66,179609,92,324583
36120,0.002605,74.125.24.0-255,1484,181093,92,324583
36121,0.00261,74.125.24.0-255,2902,183995,92,324583
36122,0.002612,172.31.47.0-255,66,184061,92,324583
36123,0.002652,74.125.24.0-255,5738,189799,92,324583
36124,0.002654,172.31.47.0-255,66,189865,92,324583
36125,0.002659,74.125.24.0-255,4320,194185,92,324583
36126,0.00266,172.31.47.0-255,66,194251,92,324583
36127,0.00269,172.31.47.0-255,66,194317,92,324583
36128,0.0027,172.31.47.0-255,66,194383,92,324583
36129,0.002727,74.125.24.0-255,4320,198703,92,324583
36130,0.00273,172.31.47.0-255,66,198769,92,324583
36131,0.005325,74.125.24.0-255,1484,200253,92,324583
36132,0.005383,74.125.24.0-255,4320,204573,92,324583
36133,0.005387,172.31.47.0-255,66,204639,92,324583
36134,0.008065,74.125.24.0-255,5738,210377,92,324583
36135,0.008082,172.31.47.0-255,66,210443,92,324583
36136,0.010794,74.125.24.0-255,5738,216181,92,324583
36137,0.010813,172.31.47.0-255,66,216247,92,324583
36138,0.013485,74.125.24.0-255,5738,221985,92,324583
36139,0.013502,172.31.47.0-255,66,222051,92,324583
36140,0.016127,74.125.24.0-255,5738,227789,92,324583
36141,0.016143,172.31.47.0-255,66,227855,92,324583
36142,0.018824,74.125.24.0-255,5738,233593,92,324583
36143,0.018844,172.31.47.0-255,66,233659,92,324583
36144,0.021538,74.125.24.0-255,5738,239397,92,324583
36145,0.021546,172.31.47.0-255,66,239463,92,324583
36146,0.024241,74.125.24.0-255,5738,245201,92,324583
36147,0.024252,172.31.47.0-255,66,245267,92,324583
36148,0.026878,74.125.24.0-255,5738,251005,92,324583
36149,0.02689,172.31.47.0-255,66,251071,92,324583
36150,0.029517,74.125.24.0-255,5738,256809,92,324583
36151,0.029524,172.31.47.0-255,66,256875,92,324583
36152,0.032178,74.125.24.0-255,5738,262613,92,324583
36153,0.032185,172.31.47.0-255,66,262679,92,324583
36154,0.032881,172.31.47.0-255,172,262851,92,324583
36155,0.03292,172.31.47.0-255,1106,263957,92,324583
36156,0.03298,172.31.47.0-255,1514,265471,92,324583
36157,0.032982,172.31.47.0-255,1514,266985,92,324583
36158,0.032986,172.31.47.0-255,1514,268499,92,324583
36159,0.032987,172.31.47.0-255,1514,270013,92,324583
36160,0.033013,172.31.47.0-255,1500,271513,92,324583
36161,0.03446,104.244.42.0-255,66,271579,92,324583
36162,0.0345,104.244.42.0-255,66,271645,92,324583
36163,0.034599,104.244.42.0-255,66,271711,92,324583
36164,0.034604,104.244.42.0-255,66,271777,92,324583
36165,0.034867,74.125.24.0-255,5738,277515,92,324583
36166,0.034872,172.31.47.0-255,66,277581,92,324583
36167,0.035195,104.244.42.0-255,108,277689,92,324583
36168,0.0352,172.31.47.0-255,66,277755,92,324583
36169,0.037489,74.125.24.0-255,4320,282075,92,324583
36170,0.037493,172.31.47.0-255,66,282141,92,324583
36171,0.037517,74.125.24.0-255,1484,283625,92,324583
36172,0.040152,74.125.24.0-255,4320,287945,92,324583
36173,0.040157,172.31.47.0-255,66,288011,92,324583
36174,0.042823,74.125.24.0-255,5738,293749,92,324583
36175,0.042828,172.31.47.0-255,66,293815,92,324583
36176,0.045498,74.125.24.0-255,4320,298135,92,324583
36177,0.045503,172.31.47.0-255,66,298201,92,324583
36178,0.045532,74.125.24.0-255,1484,299685,92,324583
36179,0.048208,74.125.24.0-255,4320,304005,92,324583
36180,0.048214,172.31.47.0-255,66,304071,92,324583
36181,0.050866,74.125.24.0-255,4320,308391,92,324583
36182,0.050873,172.31.47.0-255,66,308457,92,324583
36183,0.0509,74.125.24.0-255,1484,309941,92,324583
36184,0.053528,74.125.24.0-255,4320,314261,92,324583
36185,0.053532,172.31.47.0-255,66,314327,92,324583
36186,0.056177,74.125.24.0-255,4320,318647,92,324583
36187,0.056183,172.31.47.0-255,66,318713,92,324583
36188,0.056217,74.125.24.0-255,1484,320197,92,324583
36189,0.058856,74.125.24.0-255,4320,324517,92,324583
36190,0.058861,172.31.47.0-255,66,324583,92,324583
36191,0.0,172.31.47.0-255,105,105,92,105
36192,0.0,172.31.47.0-255,105,105,92,276
36193,0.001783,157.240.13.0-255,105,210,92,276
36194,0.041437,172.31.47.0-255,66,276,92,276
36195,0.0,74.125.68.0-255,152,152,92,231646
36196,2.6e-05,172.31.47.0-255,66,218,92,231646
36197,5.8e-05,74.125.68.0-255,1484,1702,92,231646
36198,6.2e-05,172.31.47.0-255,66,1768,92,231646
36199,6.6e-05,74.125.68.0-255,2902,4670,92,231646
36200,6.8e-05,172.31.47.0-255,66,4736,92,231646
36201,7.1e-05,74.125.68.0-255,1484,6220,92,231646
36202,7.7e-05,172.31.47.0-255,66,6286,92,231646
36203,8.1e-05,74.125.68.0-255,2902,9188,92,231646
36204,8.4e-05,172.31.47.0-255,66,9254,92,231646
36205,0.000121,74.125.68.0-255,4320,13574,92,231646
36206,0.000124,172.31.47.0-255,66,13640,92,231646
36207,0.000148,74.125.68.0-255,550,14190,92,231646
36208,0.00015,172.31.47.0-255,66,14256,92,231646
36209,0.000457,74.125.68.0-255,1484,15740,92,231646
36210,0.000463,172.31.47.0-255,66,15806,92,231646
36211,0.000473,74.125.68.0-255,2902,18708,92,231646
36212,0.000482,172.31.47.0-255,66,18774,92,231646
36213,0.000489,74.125.68.0-255,4320,23094,92,231646
36214,0.000492,172.31.47.0-255,66,23160,92,231646
36215,0.000553,172.31.47.0-255,66,23226,92,231646
36216,0.000592,172.31.47.0-255,66,23292,92,231646
36217,0.000597,74.125.68.0-255,2902,26194,92,231646
36218,0.0006,172.31.47.0-255,66,26260,92,231646
36219,0.000602,74.125.68.0-255,1484,27744,92,231646
36220,0.000612,172.31.47.0-255,66,27810,92,231646
36221,0.00066,172.31.47.0-255,66,27876,92,231646
36222,0.000666,74.125.68.0-255,5738,33614,92,231646
36223,0.000668,172.31.47.0-255,66,33680,92,231646
36224,0.000699,74.125.68.0-255,3933,37613,92,231646
36225,0.000702,172.31.47.0-255,66,37679,92,231646
36226,0.000783,74.125.68.0-255,109,37788,92,231646
36227,0.000972,74.125.68.0-255,1484,39272,92,231646
36228,0.000978,172.31.47.0-255,66,39338,92,231646
36229,0.001003,74.125.68.0-255,1484,40822,92,231646
36230,0.001006,74.125.68.0-255,1484,42306,92,231646
36231,0.00101,172.31.47.0-255,66,42372,92,231646
36232,0.001017,74.125.68.0-255,1484,43856,92,231646
36233,0.001022,74.125.68.0-255,2902,46758,92,231646
36234,0.001023,172.31.47.0-255,66,46824,92,231646
36235,0.001039,74.125.68.0-255,2902,49726,92,231646
36236,0.001041,172.31.47.0-255,66,49792,92,231646
36237,0.001056,172.31.47.0-255,66,49858,92,231646
36238,0.001113,74.125.68.0-255,7156,57014,92,231646
36239,0.001117,172.31.47.0-255,66,57080,92,231646
36240,0.001146,74.125.68.0-255,4320,61400,92,231646
36241,0.001149,172.31.47.0-255,66,61466,92,231646
36242,0.001152,74.125.68.0-255,1034,62500,92,231646
36243,0.001546,172.31.47.0-255,66,62566,92,231646
36244,0.001602,74.125.68.0-255,1484,64050,92,231646
36245,0.001608,74.125.68.0-255,2902,66952,92,231646
36246,0.001611,172.31.47.0-255,66,67018,92,231646
36247,0.001637,74.125.68.0-255,5738,72756,92,231646
36248,0.001639,172.31.47.0-255,66,72822,92,231646
36249,0.001643,74.125.68.0-255,2902,75724,92,231646
36250,0.001644,172.31.47.0-255,66,75790,92,231646
36251,0.001677,172.31.47.0-255,66,75856,92,231646
36252,0.001696,74.125.68.0-255,1484,77340,92,231646
36253,0.001706,172.31.47.0-255,66,77406,92,231646
36254,0.001726,74.125.68.0-255,766,78172,92,231646
36255,0.001916,172.31.47.0-255,66,78238,92,231646
36256,0.004027,74.125.68.0-255,4320,82558,92,231646
36257,0.004033,172.31.47.0-255,66,82624,92,231646
36258,0.004223,74.125.68.0-255,1484,84108,92,231646
36259,0.006346,74.125.68.0-255,4320,88428,92,231646
36260,0.006354,172.31.47.0-255,66,88494,92,231646
36261,0.008679,74.125.68.0-255,5738,94232,92,231646
36262,0.008685,172.31.47.0-255,66,94298,92,231646
36263,0.010998,74.125.68.0-255,5738,100036,92,231646
36264,0.011005,172.31.47.0-255,66,100102,92,231646
36265,0.013332,74.125.68.0-255,5738,105840,92,231646
36266,0.013342,172.31.47.0-255,66,105906,92,231646
36267,0.01565,74.125.68.0-255,5738,111644,92,231646
36268,0.015657,172.31.47.0-255,66,111710,92,231646
36269,0.017975,74.125.68.0-255,5738,117448,92,231646
36270,0.017982,172.31.47.0-255,66,117514,92,231646
36271,0.020308,74.125.68.0-255,5738,123252,92,231646
36272,0.020317,172.31.47.0-255,66,123318,92,231646
36273,0.022635,74.125.68.0-255,5738,129056,92,231646
36274,0.022643,172.31.47.0-255,66,129122,92,231646
36275,0.023412,172.31.47.0-255,172,129294,92,231646
36276,0.023454,172.31.47.0-255,1111,130405,92,231646
36277,0.023529,172.31.47.0-255,1514,131919,92,231646
36278,0.023531,172.31.47.0-255,1514,133433,92,231646
36279,0.023532,172.31.47.0-255,1514,134947,92,231646
36280,0.023533,172.31.47.0-255,1514,136461,92,231646
36281,0.023564,172.31.47.0-255,1495,137956,92,231646
36282,0.024955,74.125.68.0-255,5738,143694,92,231646
36283,0.024961,172.31.47.0-255,66,143760,92,231646
36284,0.024989,104.244.42.0-255,66,143826,92,231646
36285,0.02504,104.244.42.0-255,66,143892,92,231646
36286,0.025106,104.244.42.0-255,66,143958,92,231646
36287,0.025149,104.244.42.0-255,66,144024,92,231646
36288,0.027267,74.125.68.0-255,4320,148344,92,231646
36289,0.027272,172.31.47.0-255,66,148410,92,231646
36290,0.027293,74.125.68.0-255,1484,149894,92,231646
36291,0.029573,74.125.68.0-255,1484,151378,92,231646
36292,0.029578,172.31.47.0-255,66,151444,92,231646
36293,0.029608,74.125.68.0-255,2902,154346,92,231646
36294,0.029611,172.31.47.0-255,66,154412,92,231646
36295,0.03189,74.125.68.0-255,2902,157314,92,231646
36296,0.031897,172.31.47.0-255,66,157380,92,231646
36297,0.031932,74.125.68.0-255,2902,160282,92,231646
36298,0.031936,172.31.47.0-255,66,160348,92,231646
36299,0.034214,74.125.68.0-255,2902,163250,92,231646
36300,0.034222,172.31.47.0-255,66,163316,92,231646
36301,0.034257,74.125.68.0-255,2902,166218,92,231646
36302,0.03426,172.31.47.0-255,66,166284,92,231646
36303,0.036535,74.125.68.0-255,2902,169186,92,231646
36304,0.03654,172.31.47.0-255,66,169252,92,231646
36305,0.03657,74.125.68.0-255,2902,172154,92,231646
36306,0.036573,172.31.47.0-255,66,172220,92,231646
36307,0.038844,74.125.68.0-255,2902,175122,92,231646
36308,0.038849,172.31.47.0-255,66,175188,92,231646
36309,0.038878,74.125.68.0-255,2902,178090,92,231646
36310,0.038881,172.31.47.0-255,66,178156,92,231646
36311,0.041157,74.125.68.0-255,2902,181058,92,231646
36312,0.041161,172.31.47.0-255,66,181124,92,231646
36313,0.041193,74.125.68.0-255,2902,184026,92,231646
36314,0.041196,172.31.47.0-255,66,184092,92,231646
36315,0.043469,74.125.68.0-255,2902,186994,92,231646
36316,0.043474,172.31.47.0-255,66,187060,92,231646
36317,0.0435,74.125.68.0-255,2902,189962,92,231646
36318,0.043503,172.31.47.0-255,66,190028,92,231646
36319,0.045781,74.125.68.0-255,2902,192930,92,231646
36320,0.045786,172.31.47.0-255,66,192996,92,231646
36321,0.045822,74.125.68.0-255,2902,195898,92,231646
36322,0.045825,172.31.47.0-255,66,195964,92,231646
36323,0.048093,74.125.68.0-255,2902,198866,92,231646
36324,0.048098,172.31.47.0-255,66,198932,92,231646
36325,0.048131,74.125.68.0-255,1484,200416,92,231646
36326,0.048143,74.125.68.0-255,1484,201900,92,231646
36327,0.048145,172.31.47.0-255,66,201966,92,231646
36328,0.050411,74.125.68.0-255,2902,204868,92,231646
36329,0.050417,172.31.47.0-255,66,204934,92,231646
36330,0.05045,74.125.68.0-255,2902,207836,92,231646
36331,0.050452,172.31.47.0-255,66,207902,92,231646
36332,0.052743,74.125.68.0-255,2902,210804,92,231646
36333,0.052749,172.31.47.0-255,66,210870,92,231646
36334,0.052781,74.125.68.0-255,2902,213772,92,231646
36335,0.052785,172.31.47.0-255,66,213838,92,231646
36336,0.055069,74.125.68.0-255,2902,216740,92,231646
36337,0.055074,172.31.47.0-255,66,216806,92,231646
36338,0.05513,74.125.68.0-255,2902,219708,92,231646
36339,0.055133,172.31.47.0-255,66,219774,92,231646
36340,0.05738,74.125.68.0-255,2902,222676,92,231646
36341,0.057385,172.31.47.0-255,66,222742,92,231646
36342,0.057434,74.125.68.0-255,2902,225644,92,231646
36343,0.057438,172.31.47.0-255,66,225710,92,231646
36344,0.059689,74.125.68.0-255,2902,228612,92,231646
36345,0.059693,172.31.47.0-255,66,228678,92,231646
36346,0.059755,74.125.68.0-255,2902,231580,92,231646
36347,0.059759,172.31.47.0-255,66,231646,92,231646
36348,0.0,172.217.194.0-255,298,298,92,333008
36349,1.7e-05,172.31.47.0-255,66,364,92,333008
36350,2.3e-05,172.217.194.0-255,1484,1848,92,333008
36351,2.7e-05,172.31.47.0-255,66,1914,92,333008
36352,3.4e-05,172.217.194.0-255,4320,6234,92,333008
36353,3.7e-05,172.31.47.0-255,66,6300,92,333008
36354,6.5e-05,172.217.194.0-255,7156,13456,92,333008
36355,6.7e-05,172.31.47.0-255,66,13522,92,333008
36356,0.000105,172.217.194.0-255,471,13993,92,333008
36357,0.000107,172.31.47.0-255,66,14059,92,333008
36358,0.000159,172.217.194.0-255,1484,15543,92,333008
36359,0.000161,172.31.47.0-255,66,15609,92,333008
36360,0.000177,172.217.194.0-255,2902,18511,92,333008
36361,0.000179,172.31.47.0-255,66,18577,92,333008
36362,0.000182,172.217.194.0-255,1484,20061,92,333008
36363,0.000184,172.31.47.0-255,66,20127,92,333008
36364,0.000205,172.217.194.0-255,4320,24447,92,333008
36365,0.000207,172.31.47.0-255,66,24513,92,333008
36366,0.000211,172.217.194.0-255,2902,27415,92,333008
36367,0.000213,172.31.47.0-255,66,27481,92,333008
36368,0.000232,172.217.194.0-255,3961,31442,92,333008
36369,0.000234,172.31.47.0-255,66,31508,92,333008
36370,0.000263,172.31.47.0-255,66,31574,92,333008
36371,0.000281,172.217.194.0-255,2902,34476,92,333008
36372,0.000283,172.31.47.0-255,66,34542,92,333008
36373,0.000287,172.217.194.0-255,2543,37085,92,333008
36374,0.000289,172.31.47.0-255,66,37151,92,333008
36375,0.000442,172.217.194.0-255,1484,38635,92,333008
36376,0.000446,172.31.47.0-255,66,38701,92,333008
36377,0.000473,172.217.194.0-255,1484,40185,92,333008
36378,0.000476,172.31.47.0-255,66,40251,92,333008
36379,0.00048,172.217.194.0-255,2902,43153,92,333008
36380,0.000482,172.31.47.0-255,66,43219,92,333008
36381,0.000493,172.217.194.0-255,1484,44703,92,333008
36382,0.000514,172.217.194.0-255,4320,49023,92,333008
36383,0.000519,172.217.194.0-255,5379,54402,92,333008
36384,0.000523,172.31.47.0-255,66,54468,92,333008
36385,0.000526,172.31.47.0-255,66,54534,92,333008
36386,0.00054,172.217.194.0-255,346,54880,92,333008
36387,0.000595,172.217.194.0-255,117,54997,92,333008
36388,0.000636,172.217.194.0-255,1484,56481,92,333008
36389,0.00064,172.31.47.0-255,66,56547,92,333008
36390,0.000644,172.217.194.0-255,2902,59449,92,333008
36391,0.000647,172.31.47.0-255,66,59515,92,333008
36392,0.000662,172.217.194.0-255,4320,63835,92,333008
36393,0.000664,172.31.47.0-255,66,63901,92,333008
36394,0.000689,172.217.194.0-255,2902,66803,92,333008
36395,0.000692,172.31.47.0-255,66,66869,92,333008
36396,0.000698,172.217.194.0-255,5379,72248,92,333008
36397,0.0007,172.31.47.0-255,66,72314,92,333008
36398,0.000731,172.217.194.0-255,5738,78052,92,333008
36399,0.000734,172.31.47.0-255,66,78118,92,333008
36400,0.000756,172.217.194.0-255,5738,83856,92,333008
36401,0.000758,172.31.47.0-255,66,83922,92,333008
36402,0.000773,172.217.194.0-255,1484,85406,92,333008
36403,0.000788,172.217.194.0-255,4271,89677,92,333008
36404,0.000793,172.31.47.0-255,66,89743,92,333008
36405,0.001056,172.217.194.0-255,1484,91227,92,333008
36406,0.001077,172.217.194.0-255,1484,92711,92,333008
36407,0.001081,172.31.47.0-255,66,92777,92,333008
36408,0.001086,172.217.194.0-255,2902,95679,92,333008
36409,0.001088,172.31.47.0-255,66,95745,92,333008
36410,0.001095,172.217.194.0-255,5738,101483,92,333008
36411,0.001097,172.31.47.0-255,66,101549,92,333008
36412,0.00113,172.31.47.0-255,66,101615,92,333008
36413,0.001149,172.217.194.0-255,2902,104517,92,333008
36414,0.001152,172.31.47.0-255,66,104583,92,333008
36415,0.00116,172.217.194.0-255,7156,111739,92,333008
36416,0.001162,172.31.47.0-255,66,111805,92,333008
36417,0.001184,172.217.194.0-255,2184,113989,92,333008
36418,0.001186,172.31.47.0-255,66,114055,92,333008
36419,0.001226,172.217.194.0-255,2902,116957,92,333008
36420,0.001229,172.31.47.0-255,66,117023,92,333008
36421,0.001233,172.217.194.0-255,2902,119925,92,333008
36422,0.001235,172.31.47.0-255,66,119991,92,333008
36423,0.001258,172.217.194.0-255,7156,127147,92,333008
36424,0.001261,172.31.47.0-255,66,127213,92,333008
36425,0.00132,172.217.194.0-255,4320,131533,92,333008
36426,0.001323,172.31.47.0-255,66,131599,92,333008
36427,0.001353,172.31.47.0-255,66,131665,92,333008
36428,0.001429,172.31.47.0-255,66,131731,92,333008
36429,0.001481,172.31.47.0-255,66,131797,92,333008
36430,0.001498,172.217.194.0-255,1484,133281,92,333008
36431,0.001505,172.217.194.0-255,5020,138301,92,333008
36432,0.001508,172.31.47.0-255,66,138367,92,333008
36433,0.002232,172.217.194.0-255,1484,139851,92,333008
36434,0.002241,172.217.194.0-255,2902,142753,92,333008
36435,0.002246,172.31.47.0-255,66,142819,92,333008
36436,0.002251,172.217.194.0-255,1484,144303,92,333008
36437,0.002264,172.217.194.0-255,2902,147205,92,333008
36438,0.002267,172.31.47.0-255,66,147271,92,333008
36439,0.00228,172.217.194.0-255,1484,148755,92,333008
36440,0.002287,172.217.194.0-255,7156,155911,92,333008
36441,0.00229,172.31.47.0-255,66,155977,92,333008
36442,0.00232,172.217.194.0-255,2902,158879,92,333008
36443,0.002323,172.31.47.0-255,66,158945,92,333008
36444,0.002328,172.217.194.0-255,4320,163265,92,333008
36445,0.002331,172.31.47.0-255,66,163331,92,333008
36446,0.002361,172.217.194.0-255,5738,169069,92,333008
36447,0.002364,172.31.47.0-255,66,169135,92,333008
36448,0.002382,172.217.194.0-255,2902,172037,92,333008
36449,0.002385,172.31.47.0-255,66,172103,92,333008
36450,0.002388,172.217.194.0-255,766,172869,92,333008
36451,0.002572,172.217.194.0-255,1484,174353,92,333008
36452,0.002578,172.31.47.0-255,66,174419,92,333008
36453,0.002584,172.217.194.0-255,2902,177321,92,333008
36454,0.002587,172.31.47.0-255,66,177387,92,333008
36455,0.00259,172.217.194.0-255,1484,178871,92,333008
36456,0.002608,172.217.194.0-255,4320,183191,92,333008
36457,0.002611,172.31.47.0-255,66,183257,92,333008
36458,0.002623,172.217.194.0-255,5738,188995,92,333008
36459,0.002625,172.31.47.0-255,66,189061,92,333008
36460,0.002652,172.217.194.0-255,5738,194799,92,333008
36461,0.002654,172.31.47.0-255,66,194865,92,333008
36462,0.002661,172.217.194.0-255,7156,202021,92,333008
36463,0.002664,172.31.47.0-255,66,202087,92,333008
36464,0.005277,172.217.194.0-255,5738,207825,92,333008
36465,0.005281,172.31.47.0-255,66,207891,92,333008
36466,0.007926,172.217.194.0-255,5738,213629,92,333008
36467,0.007933,172.31.47.0-255,66,213695,92,333008
36468,0.010559,172.217.194.0-255,5738,219433,92,333008
36469,0.010566,172.31.47.0-255,66,219499,92,333008
36470,0.013192,172.217.194.0-255,5738,225237,92,333008
36471,0.0132,172.31.47.0-255,66,225303,92,333008
36472,0.01583,172.217.194.0-255,5738,231041,92,333008
36473,0.015839,172.31.47.0-255,66,231107,92,333008
36474,0.018487,172.217.194.0-255,5738,236845,92,333008
36475,0.018499,172.31.47.0-255,66,236911,92,333008
36476,0.021113,172.217.194.0-255,5738,242649,92,333008
36477,0.021121,172.31.47.0-255,66,242715,92,333008
36478,0.023769,172.217.194.0-255,5738,248453,92,333008
36479,0.023778,172.31.47.0-255,66,248519,92,333008
36480,0.026412,172.217.194.0-255,5738,254257,92,333008
36481,0.026419,172.31.47.0-255,66,254323,92,333008
36482,0.029076,172.217.194.0-255,5738,260061,92,333008
36483,0.029084,172.31.47.0-255,66,260127,92,333008
36484,0.031713,172.217.194.0-255,5738,265865,92,333008
36485,0.031722,172.31.47.0-255,66,265931,92,333008
36486,0.034397,172.217.194.0-255,5738,271669,92,333008
36487,0.034406,172.31.47.0-255,66,271735,92,333008
36488,0.037031,172.217.194.0-255,5738,277473,92,333008
36489,0.037039,172.31.47.0-255,66,277539,92,333008
36490,0.039711,172.217.194.0-255,5738,283277,92,333008
36491,0.03972,172.31.47.0-255,66,283343,92,333008
36492,0.040666,172.31.47.0-255,176,283519,92,333008
36493,0.0407,172.31.47.0-255,1107,284626,92,333008
36494,0.040763,172.31.47.0-255,1514,286140,92,333008
36495,0.040765,172.31.47.0-255,1514,287654,92,333008
36496,0.040766,172.31.47.0-255,1514,289168,92,333008
36497,0.040767,172.31.47.0-255,1514,290682,92,333008
36498,0.040793,172.31.47.0-255,1500,292182,92,333008
36499,0.042222,104.244.42.0-255,66,292248,92,333008
36500,0.042296,104.244.42.0-255,66,292314,92,333008
36501,0.042338,104.244.42.0-255,66,292380,92,333008
36502,0.042361,172.217.194.0-255,5738,298118,92,333008
36503,0.042368,172.31.47.0-255,66,298184,92,333008
36504,0.045017,172.217.194.0-255,5738,303922,92,333008
36505,0.045024,172.31.47.0-255,66,303988,92,333008
36506,0.047632,172.217.194.0-255,5738,309726,92,333008
36507,0.047639,172.31.47.0-255,66,309792,92,333008
36508,0.050272,172.217.194.0-255,5738,315530,92,333008
36509,0.050279,172.31.47.0-255,66,315596,92,333008
36510,0.052902,172.217.194.0-255,5738,321334,92,333008
36511,0.052909,172.31.47.0-255,66,321400,92,333008
36512,0.055614,172.217.194.0-255,5738,327138,92,333008
36513,0.055624,172.31.47.0-255,66,327204,92,333008
36514,0.058242,172.217.194.0-255,5738,332942,92,333008
36515,0.058249,172.31.47.0-255,66,333008,92,333008
36516,0.0,74.125.24.0-255,153,153,92,304818
36517,2.1e-05,172.31.47.0-255,66,219,92,304818
36518,2.7e-05,74.125.24.0-255,1484,1703,92,304818
36519,3.1e-05,172.31.47.0-255,66,1769,92,304818
36520,3.6e-05,74.125.24.0-255,2902,4671,92,304818
36521,4.6e-05,172.31.47.0-255,66,4737,92,304818
36522,5.3e-05,74.125.24.0-255,7156,11893,92,304818
36523,5.6e-05,172.31.47.0-255,66,11959,92,304818
36524,6.8e-05,172.31.47.0-255,66,12025,92,304818
36525,9.9e-05,74.125.24.0-255,3432,15457,92,304818
36526,0.000101,172.31.47.0-255,66,15523,92,304818
36527,0.000106,74.125.24.0-255,2543,18066,92,304818
36528,0.000108,172.31.47.0-255,66,18132,92,304818
36529,0.000111,74.125.24.0-255,1484,19616,92,304818
36530,0.000112,172.31.47.0-255,66,19682,92,304818
36531,0.000117,74.125.24.0-255,2902,22584,92,304818
36532,0.000119,172.31.47.0-255,66,22650,92,304818
36533,0.00015,74.125.24.0-255,5738,28388,92,304818
36534,0.000153,172.31.47.0-255,66,28454,92,304818
36535,0.000155,74.125.24.0-255,1484,29938,92,304818
36536,0.000157,172.31.47.0-255,66,30004,92,304818
36537,0.000184,74.125.24.0-255,5379,35383,92,304818
36538,0.000187,172.31.47.0-255,66,35449,92,304818
36539,0.000194,74.125.24.0-255,7156,42605,92,304818
36540,0.000199,172.31.47.0-255,66,42671,92,304818
36541,0.000234,172.31.47.0-255,66,42737,92,304818
36542,0.000284,74.125.24.0-255,130,42867,92,304818
36543,0.000286,172.31.47.0-255,66,42933,92,304818
36544,0.000319,74.125.24.0-255,350,43283,92,304818
36545,0.000322,172.31.47.0-255,66,43349,92,304818
36546,0.000428,74.125.24.0-255,1484,44833,92,304818
36547,0.000431,172.31.47.0-255,66,44899,92,304818
36548,0.000436,74.125.24.0-255,2902,47801,92,304818
36549,0.000438,172.31.47.0-255,66,47867,92,304818
36550,0.000464,74.125.24.0-255,5738,53605,92,304818
36551,0.000467,172.31.47.0-255,66,53671,92,304818
36552,0.00047,74.125.24.0-255,1484,55155,92,304818
36553,0.000471,172.31.47.0-255,66,55221,92,304818
36554,0.000502,74.125.24.0-255,5379,60600,92,304818
36555,0.000509,74.125.24.0-255,7156,67756,92,304818
36556,0.000534,172.31.47.0-255,66,67822,92,304818
36557,0.000553,172.31.47.0-255,66,67888,92,304818
36558,0.000913,74.125.24.0-255,1484,69372,92,304818
36559,0.000919,74.125.24.0-255,2902,72274,92,304818
36560,0.000922,172.31.47.0-255,66,72340,92,304818
36561,0.000927,74.125.24.0-255,2902,75242,92,304818
36562,0.000928,172.31.47.0-255,66,75308,92,304818
36563,0.000946,74.125.24.0-255,2902,78210,92,304818
36564,0.000953,74.125.24.0-255,7156,85366,92,304818
36565,0.000967,172.31.47.0-255,66,85432,92,304818
36566,0.000979,74.125.24.0-255,5738,91170,92,304818
36567,0.001009,172.31.47.0-255,66,91236,92,304818
36568,0.001419,74.125.24.0-255,1484,92720,92,304818
36569,0.001439,74.125.24.0-255,2902,95622,92,304818
36570,0.001442,172.31.47.0-255,66,95688,92,304818
36571,0.001449,74.125.24.0-255,5738,101426,92,304818
36572,0.001451,172.31.47.0-255,66,101492,92,304818
36573,0.001482,74.125.24.0-255,2902,104394,92,304818
36574,0.001484,172.31.47.0-255,66,104460,92,304818
36575,0.001513,172.31.47.0-255,66,104526,92,304818
36576,0.001519,74.125.24.0-255,5738,110264,92,304818
36577,0.001521,172.31.47.0-255,66,110330,92,304818
36578,0.001526,74.125.24.0-255,5020,115350,92,304818
36579,0.001528,172.31.47.0-255,66,115416,92,304818
36580,0.00203,74.125.24.0-255,1484,116900,92,304818
36581,0.002039,74.125.24.0-255,2902,119802,92,304818
36582,0.002042,172.31.47.0-255,66,119868,92,304818
36583,0.002049,74.125.24.0-255,4320,124188,92,304818
36584,0.002051,172.31.47.0-255,66,124254,92,304818
36585,0.002077,74.125.24.0-255,1484,125738,92,304818
36586,0.002088,172.31.47.0-255,66,125804,92,304818
36587,0.002094,74.125.24.0-255,5738,131542,92,304818
36588,0.002096,172.31.47.0-255,66,131608,92,304818
36589,0.002116,74.125.24.0-255,4320,135928,92,304818
36590,0.002118,172.31.47.0-255,66,135994,92,304818
36591,0.002128,74.125.24.0-255,5020,141014,92,304818
36592,0.00213,172.31.47.0-255,66,141080,92,304818
36593,0.002304,74.125.24.0-255,1484,142564,92,304818
36594,0.00231,74.125.24.0-255,2902,145466,92,304818
36595,0.002314,172.31.47.0-255,66,145532,92,304818
36596,0.002344,74.125.24.0-255,5738,151270,92,304818
36597,0.002346,172.31.47.0-255,66,151336,92,304818
36598,0.002353,74.125.24.0-255,7156,158492,92,304818
36599,0.002354,172.31.47.0-255,66,158558,92,304818
36600,0.002359,74.125.24.0-255,4320,162878,92,304818
36601,0.002361,172.31.47.0-255,66,162944,92,304818
36602,0.002404,74.125.24.0-255,5020,167964,92,304818
36603,0.007149,172.31.47.0-255,66,168030,92,304818
36604,0.009502,74.125.24.0-255,5738,173768,92,304818
36605,0.009515,172.31.47.0-255,66,173834,92,304818
36606,0.011874,74.125.24.0-255,5738,179572,92,304818
36607,0.011881,172.31.47.0-255,66,179638,92,304818
36608,0.014239,74.125.24.0-255,5738,185376,92,304818
36609,0.014249,172.31.47.0-255,66,185442,92,304818
36610,0.016621,74.125.24.0-255,5738,191180,92,304818
36611,0.016633,172.31.47.0-255,66,191246,92,304818
36612,0.01898,74.125.24.0-255,5738,196984,92,304818
36613,0.018988,172.31.47.0-255,66,197050,92,304818
36614,0.021361,74.125.24.0-255,5738,202788,92,304818
36615,0.021367,172.31.47.0-255,66,202854,92,304818
36616,0.023729,74.125.24.0-255,5738,208592,92,304818
36617,0.023737,172.31.47.0-255,66,208658,92,304818
36618,0.026091,74.125.24.0-255,5738,214396,92,304818
36619,0.026098,172.31.47.0-255,66,214462,92,304818
36620,0.028461,74.125.24.0-255,5738,220200,92,304818
36621,0.028468,172.31.47.0-255,66,220266,92,304818
36622,0.030781,172.31.47.0-255,172,220438,92,304818
36623,0.03081,172.31.47.0-255,1113,221551,92,304818
36624,0.030824,74.125.24.0-255,5738,227289,92,304818
36625,0.030828,172.31.47.0-255,66,227355,92,304818
36626,0.030938,172.31.47.0-255,1514,228869,92,304818
36627,0.030941,172.31.47.0-255,1514,230383,92,304818
36628,0.030941,172.31.47.0-255,1514,231897,92,304818
36629,0.030943,172.31.47.0-255,1514,233411,92,304818
36630,0.030968,172.31.47.0-255,1495,234906,92,304818
36631,0.032328,104.244.42.0-255,66,234972,92,304818
36632,0.032366,104.244.42.0-255,66,235038,92,304818
36633,0.032533,104.244.42.0-255,66,235104,92,304818
36634,0.032548,104.244.42.0-255,66,235170,92,304818
36635,0.033172,74.125.24.0-255,5738,240908,92,304818
36636,0.033176,172.31.47.0-255,66,240974,92,304818
36637,0.035548,74.125.24.0-255,5738,246712,92,304818
36638,0.035553,172.31.47.0-255,66,246778,92,304818
36639,0.037926,74.125.24.0-255,5738,252516,92,304818
36640,0.037935,172.31.47.0-255,66,252582,92,304818
36641,0.040297,74.125.24.0-255,5738,258320,92,304818
36642,0.040305,172.31.47.0-255,66,258386,92,304818
36643,0.042696,74.125.24.0-255,5738,264124,92,304818
36644,0.042707,172.31.47.0-255,66,264190,92,304818
36645,0.045102,74.125.24.0-255,5738,269928,92,304818
36646,0.045108,172.31.47.0-255,66,269994,92,304818
36647,0.047476,74.125.24.0-255,5738,275732,92,304818
36648,0.047481,172.31.47.0-255,66,275798,92,304818
36649,0.049835,74.125.24.0-255,5738,281536,92,304818
36650,0.049842,172.31.47.0-255,66,281602,92,304818
36651,0.052186,74.125.24.0-255,5738,287340,92,304818
36652,0.052192,172.31.47.0-255,66,287406,92,304818
36653,0.054552,74.125.24.0-255,5738,293144,92,304818
36654,0.054559,172.31.47.0-255,66,293210,92,304818
36655,0.056928,74.125.24.0-255,5738,298948,92,304818
36656,0.056936,172.31.47.0-255,66,299014,92,304818
36657,0.059289,74.125.24.0-255,5738,304752,92,304818
36658,0.059296,172.31.47.0-255,66,304818,92,304818
36659,0.0,74.125.24.0-255,153,153,92,293899
36660,3.2e-05,172.31.47.0-255,66,219,92,293899
36661,3.9e-05,74.125.24.0-255,1484,1703,92,293899
36662,4.3e-05,172.31.47.0-255,66,1769,92,293899
36663,4.7e-05,74.125.24.0-255,2902,4671,92,293899
36664,4.9e-05,172.31.47.0-255,66,4737,92,293899
36665,5.7e-05,74.125.24.0-255,7156,11893,92,293899
36666,5.9e-05,172.31.47.0-255,66,11959,92,293899
36667,6.3e-05,74.125.24.0-255,3470,15429,92,293899
36668,6.5e-05,172.31.47.0-255,66,15495,92,293899
36669,9.2e-05,74.125.24.0-255,4320,19815,92,293899
36670,9.7e-05,172.31.47.0-255,66,19881,92,293899
36671,0.000104,74.125.24.0-255,7156,27037,92,293899
36672,0.000106,172.31.47.0-255,66,27103,92,293899
36673,0.000118,74.125.24.0-255,2902,30005,92,293899
36674,0.000121,172.31.47.0-255,66,30071,92,293899
36675,0.000123,74.125.24.0-255,1125,31196,92,293899
36676,0.000126,172.31.47.0-255,66,31262,92,293899
36677,0.000219,74.125.24.0-255,1484,32746,92,293899
36678,0.000223,172.31.47.0-255,66,32812,92,293899
36679,0.000227,74.125.24.0-255,2902,35714,92,293899
36680,0.00023,172.31.47.0-255,66,35780,92,293899
36681,0.000255,74.125.24.0-255,5738,41518,92,293899
36682,0.000258,172.31.47.0-255,66,41584,92,293899
36683,0.000287,172.31.47.0-255,66,41650,92,293899
36684,0.000308,74.125.24.0-255,7156,48806,92,293899
36685,0.000311,172.31.47.0-255,66,48872,92,293899
36686,0.000335,74.125.24.0-255,4320,53192,92,293899
36687,0.000337,172.31.47.0-255,66,53258,92,293899
36688,0.00034,74.125.24.0-255,1401,54659,92,293899
36689,0.000342,172.31.47.0-255,66,54725,92,293899
36690,0.000345,74.125.24.0-255,124,54849,92,293899
36691,0.000347,172.31.47.0-255,66,54915,92,293899
36692,0.000369,74.125.24.0-255,354,55269,92,293899
36693,0.000373,172.31.47.0-255,66,55335,92,293899
36694,0.00061,74.125.24.0-255,1484,56819,92,293899
36695,0.000616,74.125.24.0-255,2902,59721,92,293899
36696,0.00062,172.31.47.0-255,66,59787,92,293899
36697,0.000626,74.125.24.0-255,4320,64107,92,293899
36698,0.000639,74.125.24.0-255,1484,65591,92,293899
36699,0.00064,172.31.47.0-255,66,65657,92,293899
36700,0.000655,74.125.24.0-255,5738,71395,92,293899
36701,0.000666,172.31.47.0-255,66,71461,92,293899
36702,0.000673,74.125.24.0-255,7156,78617,92,293899
36703,0.000685,172.31.47.0-255,66,78683,92,293899
36704,0.000696,74.125.24.0-255,1484,80167,92,293899
36705,0.000708,74.125.24.0-255,766,80933,92,293899
36706,0.000722,172.31.47.0-255,66,80999,92,293899
36707,0.00109,74.125.24.0-255,1484,82483,92,293899
36708,0.001105,74.125.24.0-255,2902,85385,92,293899
36709,0.001109,172.31.47.0-255,66,85451,92,293899
36710,0.001112,74.125.24.0-255,1484,86935,92,293899
36711,0.001129,74.125.24.0-255,4320,91255,92,293899
36712,0.001132,74.125.24.0-255,1484,92739,92,293899
36713,0.001143,74.125.24.0-255,1484,94223,92,293899
36714,0.001143,172.31.47.0-255,66,94289,92,293899
36715,0.001155,74.125.24.0-255,2902,97191,92,293899
36716,0.001159,172.31.47.0-255,66,97257,92,293899
36717,0.001171,74.125.24.0-255,4320,101577,92,293899
36718,0.001186,172.31.47.0-255,66,101643,92,293899
36719,0.00119,74.125.24.0-255,4320,105963,92,293899
36720,0.001202,172.31.47.0-255,66,106029,92,293899
36721,0.001214,172.31.47.0-255,66,106095,92,293899
36722,0.001245,74.125.24.0-255,1484,107579,92,293899
36723,0.00125,74.125.24.0-255,2902,110481,92,293899
36724,0.001253,172.31.47.0-255,66,110547,92,293899
36725,0.00127,74.125.24.0-255,5738,116285,92,293899
36726,0.001273,74.125.24.0-255,1484,117769,92,293899
36727,0.001279,172.31.47.0-255,66,117835,92,293899
36728,0.00131,74.125.24.0-255,2902,120737,92,293899
36729,0.00133,172.31.47.0-255,66,120803,92,293899
36730,0.001345,172.31.47.0-255,66,120869,92,293899
36731,0.00139,74.125.24.0-255,5738,126607,92,293899
36732,0.001403,172.31.47.0-255,66,126673,92,293899
36733,0.001407,74.125.24.0-255,7156,133829,92,293899
36734,0.001417,172.31.47.0-255,66,133895,92,293899
36735,0.001478,74.125.24.0-255,6438,140333,92,293899
36736,0.001481,74.125.24.0-255,1484,141817,92,293899
36737,0.001483,172.31.47.0-255,66,141883,92,293899
36738,0.001492,74.125.24.0-255,1484,143367,92,293899
36739,0.001498,172.31.47.0-255,66,143433,92,293899
36740,0.001506,74.125.24.0-255,1484,144917,92,293899
36741,0.001523,74.125.24.0-255,5738,150655,92,293899
36742,0.001533,172.31.47.0-255,66,150721,92,293899
36743,0.001535,74.125.24.0-255,1484,152205,92,293899
36744,0.001559,172.31.47.0-255,66,152271,92,293899
36745,0.001561,74.125.24.0-255,5738,158009,92,293899
36746,0.001571,172.31.47.0-255,66,158075,92,293899
36747,0.001585,74.125.24.0-255,5738,163813,92,293899
36748,0.001589,74.125.24.0-255,2184,165997,92,293899
36749,0.001595,172.31.47.0-255,66,166063,92,293899
36750,0.00172,74.125.24.0-255,1484,167547,92,293899
36751,0.001733,74.125.24.0-255,2902,170449,92,293899
36752,0.001737,172.31.47.0-255,66,170515,92,293899
36753,0.001741,74.125.24.0-255,2902,173417,92,293899
36754,0.001748,172.31.47.0-255,66,173483,92,293899
36755,0.001758,74.125.24.0-255,2902,176385,92,293899
36756,0.00177,172.31.47.0-255,66,176451,92,293899
36757,0.001796,172.31.47.0-255,66,176517,92,293899
36758,0.001812,172.31.47.0-255,66,176583,92,293899
36759,0.00184,74.125.24.0-255,2902,179485,92,293899
36760,0.001846,74.125.24.0-255,4320,183805,92,293899
36761,0.001849,172.31.47.0-255,66,183871,92,293899
36762,0.00186,74.125.24.0-255,2902,186773,92,293899
36763,0.001861,172.31.47.0-255,66,186839,92,293899
36764,0.001875,74.125.24.0-255,5738,192577,92,293899
36765,0.001875,172.31.47.0-255,66,192643,92,293899
36766,0.00188,172.31.47.0-255,66,192709,92,293899
36767,0.001896,74.125.24.0-255,7156,199865,92,293899
36768,0.001904,172.31.47.0-255,66,199931,92,293899
36769,0.001921,74.125.24.0-255,766,200697,92,293899
36770,0.001923,172.31.47.0-255,66,200763,92,293899
36771,0.001963,74.125.24.0-255,1484,202247,92,293899
36772,0.001967,74.125.24.0-255,1484,203731,92,293899
36773,0.001969,172.31.47.0-255,66,203797,92,293899
36774,0.001985,74.125.24.0-255,2902,206699,92,293899
36775,0.001992,74.125.24.0-255,7156,213855,92,293899
36776,0.001997,172.31.47.0-255,66,213921,92,293899
36777,0.002025,172.31.47.0-255,66,213987,92,293899
36778,0.002035,74.125.24.0-255,2902,216889,92,293899
36779,0.002037,74.125.24.0-255,1484,218373,92,293899
36780,0.00204,172.31.47.0-255,66,218439,92,293899
36781,0.002053,74.125.24.0-255,6438,224877,92,293899
36782,0.002067,172.31.47.0-255,66,224943,92,293899
36783,0.00211,74.125.24.0-255,1484,226427,92,293899
36784,0.002128,74.125.24.0-255,2902,229329,92,293899
36785,0.002134,74.125.24.0-255,5738,235067,92,293899
36786,0.002134,172.31.47.0-255,66,235133,92,293899
36787,0.002138,172.31.47.0-255,66,235199,92,293899
36788,0.002155,74.125.24.0-255,2902,238101,92,293899
36789,0.002164,172.31.47.0-255,66,238167,92,293899
36790,0.002169,172.31.47.0-255,66,238233,92,293899
36791,0.002196,74.125.24.0-255,7156,245389,92,293899
36792,0.002203,172.31.47.0-255,66,245455,92,293899
36793,0.002258,74.125.24.0-255,3602,249057,92,293899
36794,0.002261,74.125.24.0-255,1484,250541,92,293899
36795,0.002263,172.31.47.0-255,66,250607,92,293899
36796,0.002276,74.125.24.0-255,2902,253509,92,293899
36797,0.002278,74.125.24.0-255,1484,254993,92,293899
36798,0.002281,172.31.47.0-255,66,255059,92,293899
36799,0.002298,74.125.24.0-255,2902,257961,92,293899
36800,0.002307,172.31.47.0-255,66,258027,92,293899
36801,0.002318,74.125.24.0-255,7156,265183,92,293899
36802,0.00232,172.31.47.0-255,66,265249,92,293899
36803,0.00234,74.125.24.0-255,7156,272405,92,293899
36804,0.002345,74.125.24.0-255,2902,275307,92,293899
36805,0.00235,172.31.47.0-255,66,275373,92,293899
36806,0.002374,172.31.47.0-255,66,275439,92,293899
36807,0.002399,74.125.24.0-255,4320,279759,92,293899
36808,0.00241,172.31.47.0-255,66,279825,92,293899
36809,0.00242,74.125.24.0-255,4392,284217,92,293899
36810,0.002434,172.31.47.0-255,66,284283,92,293899
36811,0.004761,74.125.24.0-255,105,284388,92,293899
36812,0.009344,172.31.47.0-255,66,284454,92,293899
36813,0.009378,172.31.47.0-255,105,284559,92,293899
36814,0.01173,74.125.24.0-255,66,284625,92,293899
36815,0.033405,172.31.47.0-255,172,284797,92,293899
36816,0.033432,172.31.47.0-255,1112,285909,92,293899
36817,0.033505,172.31.47.0-255,1514,287423,92,293899
36818,0.033507,172.31.47.0-255,1514,288937,92,293899
36819,0.033509,172.31.47.0-255,1514,290451,92,293899
36820,0.03351,172.31.47.0-255,1514,291965,92,293899
36821,0.033536,172.31.47.0-255,1496,293461,92,293899
36822,0.034889,104.244.42.0-255,66,293527,92,293899
36823,0.035,104.244.42.0-255,66,293593,92,293899
36824,0.03502,104.244.42.0-255,66,293659,92,293899
36825,0.035132,104.244.42.0-255,66,293725,92,293899
36826,0.035645,104.244.42.0-255,108,293833,92,293899
36827,0.03565,172.31.47.0-255,66,293899,92,293899
36828,0.0,172.217.194.0-255,153,153,92,294102
36829,2.7e-05,172.31.47.0-255,66,219,92,294102
36830,3.4e-05,172.217.194.0-255,1484,1703,92,294102
36831,3.8e-05,172.31.47.0-255,66,1769,92,294102
36832,4.2e-05,172.217.194.0-255,2902,4671,92,294102
36833,4.5e-05,172.31.47.0-255,66,4737,92,294102
36834,4.7e-05,172.217.194.0-255,1484,6221,92,294102
36835,4.9e-05,172.31.47.0-255,66,6287,92,294102
36836,6.9e-05,172.217.194.0-255,5738,12025,92,294102
36837,7.2e-05,172.31.47.0-255,66,12091,92,294102
36838,7.6e-05,172.217.194.0-255,1974,14065,92,294102
36839,7.7e-05,172.31.47.0-255,66,14131,92,294102
36840,0.000142,172.217.194.0-255,1484,15615,92,294102
36841,0.000147,172.31.47.0-255,66,15681,92,294102
36842,0.000152,172.217.194.0-255,2902,18583,92,294102
36843,0.000154,172.31.47.0-255,66,18649,92,294102
36844,0.000176,172.217.194.0-255,5738,24387,92,294102
36845,0.000179,172.31.47.0-255,66,24453,92,294102
36846,0.000225,172.217.194.0-255,1484,25937,92,294102
36847,0.000228,172.31.47.0-255,66,26003,92,294102
36848,0.000248,172.217.194.0-255,5379,31382,92,294102
36849,0.000251,172.31.47.0-255,66,31448,92,294102
36850,0.000266,172.217.194.0-255,2902,34350,92,294102
36851,0.000268,172.31.47.0-255,66,34416,92,294102
36852,0.00029,172.217.194.0-255,4320,38736,92,294102
36853,0.000294,172.31.47.0-255,66,38802,92,294102
36854,0.000301,172.217.194.0-255,5738,44540,92,294102
36855,0.000303,172.31.47.0-255,66,44606,92,294102
36856,0.000339,172.217.194.0-255,3961,48567,92,294102
36857,0.000343,172.31.47.0-255,66,48633,92,294102
36858,0.000435,172.217.194.0-255,1484,50117,92,294102
36859,0.000439,172.31.47.0-255,66,50183,92,294102
36860,0.000444,172.217.194.0-255,2902,53085,92,294102
36861,0.000446,172.31.47.0-255,66,53151,92,294102
36862,0.00048,172.217.194.0-255,5738,58889,92,294102
36863,0.000483,172.31.47.0-255,66,58955,92,294102
36864,0.000488,172.217.194.0-255,2902,61857,92,294102
36865,0.000492,172.31.47.0-255,66,61923,92,294102
36866,0.000539,172.217.194.0-255,3961,65884,92,294102
36867,0.000542,172.31.47.0-255,66,65950,92,294102
36868,0.001185,172.217.194.0-255,646,66596,92,294102
36869,0.001206,172.217.194.0-255,1484,68080,92,294102
36870,0.00121,172.31.47.0-255,66,68146,92,294102
36871,0.001217,172.217.194.0-255,4320,72466,92,294102
36872,0.001219,172.31.47.0-255,66,72532,92,294102
36873,0.001258,172.31.47.0-255,66,72598,92,294102
36874,0.001261,172.217.194.0-255,1484,74082,92,294102
36875,0.001283,172.31.47.0-255,66,74148,92,294102
36876,0.001307,172.217.194.0-255,4320,78468,92,294102
36877,0.00131,172.31.47.0-255,66,78534,92,294102
36878,0.001315,172.217.194.0-255,5020,83554,92,294102
36879,0.001317,172.31.47.0-255,66,83620,92,294102
36880,0.001573,172.217.194.0-255,1484,85104,92,294102
36881,0.001593,172.217.194.0-255,2902,88006,92,294102
36882,0.001596,172.31.47.0-255,66,88072,92,294102
36883,0.001618,172.217.194.0-255,1484,89556,92,294102
36884,0.00163,172.217.194.0-255,4320,93876,92,294102
36885,0.001632,172.31.47.0-255,66,93942,92,294102
36886,0.001652,172.217.194.0-255,5738,99680,92,294102
36887,0.001654,172.31.47.0-255,66,99746,92,294102
36888,0.00167,172.217.194.0-255,4320,104066,92,294102
36889,0.001672,172.31.47.0-255,66,104132,92,294102
36890,0.001721,172.31.47.0-255,66,104198,92,294102
36891,0.001998,172.217.194.0-255,1484,105682,92,294102
36892,0.002015,172.217.194.0-255,2902,108584,92,294102
36893,0.002018,172.31.47.0-255,66,108650,92,294102
36894,0.002022,172.217.194.0-255,2902,111552,92,294102
36895,0.002024,172.31.47.0-255,66,111618,92,294102
36896,0.002037,172.217.194.0-255,2902,114520,92,294102
36897,0.002039,172.31.47.0-255,66,114586,92,294102
36898,0.002041,172.217.194.0-255,1484,116070,92,294102
36899,0.002068,172.31.47.0-255,66,116136,92,294102
36900,0.002107,172.217.194.0-255,7156,123292,92,294102
36901,0.00211,172.31.47.0-255,66,123358,92,294102
36902,0.002127,172.217.194.0-255,3602,126960,92,294102
36903,0.002129,172.31.47.0-255,66,127026,92,294102
36904,0.002469,172.217.194.0-255,1484,128510,92,294102
36905,0.002472,172.217.194.0-255,1484,129994,92,294102
36906,0.002473,172.31.47.0-255,66,130060,92,294102
36907,0.002489,172.217.194.0-255,1484,131544,92,294102
36908,0.002495,172.217.194.0-255,5738,137282,92,294102
36909,0.002497,172.31.47.0-255,66,137348,92,294102
36910,0.002521,172.217.194.0-255,5738,143086,92,294102
36911,0.002523,172.31.47.0-255,66,143152,92,294102
36912,0.002529,172.217.194.0-255,5738,148890,92,294102
36913,0.002531,172.31.47.0-255,66,148956,92,294102
36914,0.002548,172.217.194.0-255,7156,156112,92,294102
36915,0.002551,172.31.47.0-255,66,156178,92,294102
36916,0.002574,172.217.194.0-255,5020,161198,92,294102
36917,0.002576,172.31.47.0-255,66,161264,92,294102
36918,0.005134,172.217.194.0-255,4320,165584,92,294102
36919,0.005139,172.31.47.0-255,66,165650,92,294102
36920,0.005157,172.217.194.0-255,1484,167134,92,294102
36921,0.007716,172.217.194.0-255,4320,171454,92,294102
36922,0.007721,172.31.47.0-255,66,171520,92,294102
36923,0.010282,172.217.194.0-255,5738,177258,92,294102
36924,0.010289,172.31.47.0-255,66,177324,92,294102
36925,0.012844,172.217.194.0-255,5738,183062,92,294102
36926,0.01285,172.31.47.0-255,66,183128,92,294102
36927,0.015486,172.217.194.0-255,5738,188866,92,294102
36928,0.015494,172.31.47.0-255,66,188932,92,294102
36929,0.018053,172.217.194.0-255,5738,194670,92,294102
36930,0.018062,172.31.47.0-255,66,194736,92,294102
36931,0.02062,172.217.194.0-255,5738,200474,92,294102
36932,0.020626,172.31.47.0-255,66,200540,92,294102
36933,0.023236,172.217.194.0-255,5738,206278,92,294102
36934,0.023247,172.31.47.0-255,66,206344,92,294102
36935,0.025845,172.217.194.0-255,5738,212082,92,294102
36936,0.025854,172.31.47.0-255,66,212148,92,294102
36937,0.028412,172.217.194.0-255,5738,217886,92,294102
36938,0.028419,172.31.47.0-255,66,217952,92,294102
36939,0.030965,172.217.194.0-255,5738,223690,92,294102
36940,0.030973,172.31.47.0-255,66,223756,92,294102
36941,0.032873,172.31.47.0-255,172,223928,92,294102
36942,0.032896,172.31.47.0-255,1113,225041,92,294102
36943,0.032936,172.31.47.0-255,1514,226555,92,294102
36944,0.032938,172.31.47.0-255,1514,228069,92,294102
36945,0.032939,172.31.47.0-255,1514,229583,92,294102
36946,0.03294,172.31.47.0-255,1514,231097,92,294102
36947,0.032962,172.31.47.0-255,1493,232590,92,294102
36948,0.033549,172.217.194.0-255,5738,238328,92,294102
36949,0.033554,172.31.47.0-255,66,238394,92,294102
36950,0.034452,104.244.42.0-255,66,238460,92,294102
36951,0.03446,104.244.42.0-255,66,238526,92,294102
36952,0.034585,104.244.42.0-255,66,238592,92,294102
36953,0.035273,104.244.42.0-255,108,238700,92,294102
36954,0.035277,172.31.47.0-255,66,238766,92,294102
36955,0.036114,172.217.194.0-255,5738,244504,92,294102
36956,0.036117,172.31.47.0-255,66,244570,92,294102
36957,0.038721,172.217.194.0-255,5738,250308,92,294102
36958,0.038725,172.31.47.0-255,66,250374,92,294102
36959,0.041305,172.217.194.0-255,5738,256112,92,294102
36960,0.041312,172.31.47.0-255,66,256178,92,294102
36961,0.043868,172.217.194.0-255,5738,261916,92,294102
36962,0.043885,172.31.47.0-255,66,261982,92,294102
36963,0.04646,172.217.194.0-255,4320,266302,92,294102
36964,0.046464,172.31.47.0-255,66,266368,92,294102
36965,0.046493,172.217.194.0-255,1484,267852,92,294102
36966,0.048996,172.217.194.0-255,4320,272172,92,294102
36967,0.049,172.31.47.0-255,66,272238,92,294102
36968,0.051556,172.217.194.0-255,5738,277976,92,294102
36969,0.051561,172.31.47.0-255,66,278042,92,294102
36970,0.054123,172.217.194.0-255,5738,283780,92,294102
36971,0.054127,172.31.47.0-255,66,283846,92,294102
36972,0.056668,172.217.194.0-255,4320,288166,92,294102
36973,0.056672,172.31.47.0-255,66,288232,92,294102
36974,0.056699,172.217.194.0-255,1484,289716,92,294102
36975,0.059227,172.217.194.0-255,4320,294036,92,294102
36976,0.059232,172.31.47.0-255,66,294102,92,294102
36977,0.0,172.31.47.0-255,105,105,92,105
36978,0.0,74.125.130.0-255,153,153,92,289584
36979,2.9e-05,172.31.47.0-255,66,219,92,289584
36980,3.9e-05,74.125.130.0-255,1484,1703,92,289584
36981,4.7e-05,172.31.47.0-255,66,1769,92,289584
36982,5.3e-05,74.125.130.0-255,2902,4671,92,289584
36983,6.7e-05,172.31.47.0-255,66,4737,92,289584
36984,8.1e-05,74.125.130.0-255,7156,11893,92,289584
36985,8.6e-05,172.31.47.0-255,66,11959,92,289584
36986,9.1e-05,74.125.130.0-255,2175,14134,92,289584
36987,9.4e-05,172.31.47.0-255,66,14200,92,289584
36988,9.9e-05,74.125.130.0-255,2902,17102,92,289584
36989,0.000103,172.31.47.0-255,66,17168,92,289584
36990,0.000114,74.125.130.0-255,7156,24324,92,289584
36991,0.000119,172.31.47.0-255,66,24390,92,289584
36992,0.000177,74.125.130.0-255,6797,31187,92,289584
36993,0.000185,172.31.47.0-255,66,31253,92,289584
36994,0.000447,74.125.130.0-255,1484,32737,92,289584
36995,0.000452,172.31.47.0-255,66,32803,92,289584
36996,0.00048,74.125.130.0-255,2902,35705,92,289584
36997,0.000484,172.31.47.0-255,66,35771,92,289584
36998,0.000489,74.125.130.0-255,4320,40091,92,289584
36999,0.000491,172.31.47.0-255,66,40157,92,289584
37000,0.000529,172.31.47.0-255,66,40223,92,289584
37001,0.000533,74.125.130.0-255,2902,43125,92,289584
37002,0.000535,172.31.47.0-255,66,43191,92,289584
37003,0.000572,172.31.47.0-255,66,43257,92,289584
37004,0.000574,74.125.130.0-255,766,44023,92,289584
37005,0.000575,172.31.47.0-255,66,44089,92,289584
37006,0.000593,74.125.130.0-255,344,44433,92,289584
37007,0.000594,172.31.47.0-255,66,44499,92,289584
37008,0.000643,74.125.130.0-255,114,44613,92,289584
37009,0.000715,74.125.130.0-255,1484,46097,92,289584
37010,0.00072,172.31.47.0-255,66,46163,92,289584
37011,0.000748,74.125.130.0-255,2902,49065,92,289584
37012,0.000752,172.31.47.0-255,66,49131,92,289584
37013,0.000757,74.125.130.0-255,5738,54869,92,289584
37014,0.000759,172.31.47.0-255,66,54935,92,289584
37015,0.000795,172.31.47.0-255,66,55001,92,289584
37016,0.000801,74.125.130.0-255,5738,60739,92,289584
37017,0.000803,172.31.47.0-255,66,60805,92,289584
37018,0.000828,74.125.130.0-255,4320,65125,92,289584
37019,0.00083,172.31.47.0-255,66,65191,92,289584
37020,0.000834,74.125.130.0-255,5020,70211,92,289584
37021,0.000836,172.31.47.0-255,66,70277,92,289584
37022,0.000854,74.125.130.0-255,383,70660,92,289584
37023,0.00121,74.125.130.0-255,1484,72144,92,289584
37024,0.001215,172.31.47.0-255,66,72210,92,289584
37025,0.001219,74.125.130.0-255,1484,73694,92,289584
37026,0.001233,74.125.130.0-255,1484,75178,92,289584
37027,0.001235,172.31.47.0-255,66,75244,92,289584
37028,0.001262,74.125.130.0-255,2902,78146,92,289584
37029,0.001264,172.31.47.0-255,66,78212,92,289584
37030,0.00129,74.125.130.0-255,1484,79696,92,289584
37031,0.0013,172.31.47.0-255,66,79762,92,289584
37032,0.001303,74.125.130.0-255,1484,81246,92,289584
37033,0.001343,74.125.130.0-255,4320,85566,92,289584
37034,0.001346,172.31.47.0-255,66,85632,92,289584
37035,0.001351,74.125.130.0-255,2902,88534,92,289584
37036,0.001353,172.31.47.0-255,66,88600,92,289584
37037,0.001374,74.125.130.0-255,2902,91502,92,289584
37038,0.001376,172.31.47.0-255,66,91568,92,289584
37039,0.001406,74.125.130.0-255,5020,96588,92,289584
37040,0.001409,172.31.47.0-255,66,96654,92,289584
37041,0.001727,74.125.130.0-255,1484,98138,92,289584
37042,0.001731,74.125.130.0-255,1484,99622,92,289584
37043,0.001734,172.31.47.0-255,66,99688,92,289584
37044,0.001745,74.125.130.0-255,1484,101172,92,289584
37045,0.00175,74.125.130.0-255,1484,102656,92,289584
37046,0.001752,172.31.47.0-255,66,102722,92,289584
37047,0.001778,74.125.130.0-255,4320,107042,92,289584
37048,0.001782,172.31.47.0-255,66,107108,92,289584
37049,0.001793,74.125.130.0-255,4320,111428,92,289584
37050,0.001795,172.31.47.0-255,66,111494,92,289584
37051,0.001824,172.31.47.0-255,66,111560,92,289584
37052,0.001854,172.31.47.0-255,66,111626,92,289584
37053,0.001876,74.125.130.0-255,2184,113810,92,289584
37054,0.001878,172.31.47.0-255,66,113876,92,289584
37055,0.001959,74.125.130.0-255,1484,115360,92,289584
37056,0.001994,74.125.130.0-255,2902,118262,92,289584
37057,0.001997,172.31.47.0-255,66,118328,92,289584
37058,0.002001,74.125.130.0-255,4320,122648,92,289584
37059,0.002003,172.31.47.0-255,66,122714,92,289584
37060,0.002008,74.125.130.0-255,5738,128452,92,289584
37061,0.002009,172.31.47.0-255,66,128518,92,289584
37062,0.002042,74.125.130.0-255,7156,135674,92,289584
37063,0.002044,172.31.47.0-255,66,135740,92,289584
37064,0.002071,74.125.130.0-255,4320,140060,92,289584
37065,0.002073,172.31.47.0-255,66,140126,92,289584
37066,0.002078,74.125.130.0-255,4320,144446,92,289584
37067,0.002079,172.31.47.0-255,66,144512,92,289584
37068,0.002096,74.125.130.0-255,3602,148114,92,289584
37069,0.002101,172.31.47.0-255,66,148180,92,289584
37070,0.002577,74.125.130.0-255,1484,149664,92,289584
37071,0.002592,74.125.130.0-255,1484,151148,92,289584
37072,0.002595,172.31.47.0-255,66,151214,92,289584
37073,0.002598,74.125.130.0-255,1484,152698,92,289584
37074,0.004651,74.125.130.0-255,1484,154182,92,289584
37075,0.004657,172.31.47.0-255,66,154248,92,289584
37076,0.005139,74.125.130.0-255,2902,157150,92,289584
37077,0.005143,172.31.47.0-255,66,157216,92,289584
37078,0.007212,74.125.130.0-255,2902,160118,92,289584
37079,0.007217,172.31.47.0-255,66,160184,92,289584
37080,0.00771,74.125.130.0-255,2902,163086,92,289584
37081,0.007716,172.31.47.0-255,66,163152,92,289584
37082,0.009776,74.125.130.0-255,2902,166054,92,289584
37083,0.009781,172.31.47.0-255,66,166120,92,289584
37084,0.010261,74.125.130.0-255,2902,169022,92,289584
37085,0.010267,172.31.47.0-255,66,169088,92,289584
37086,0.012351,74.125.130.0-255,2902,171990,92,289584
37087,0.01236,172.31.47.0-255,66,172056,92,289584
37088,0.012829,74.125.130.0-255,2902,174958,92,289584
37089,0.012835,172.31.47.0-255,66,175024,92,289584
37090,0.014908,74.125.130.0-255,2902,177926,92,289584
37091,0.014915,172.31.47.0-255,66,177992,92,289584
37092,0.015409,74.125.130.0-255,2902,180894,92,289584
37093,0.015415,172.31.47.0-255,66,180960,92,289584
37094,0.017475,74.125.130.0-255,2902,183862,92,289584
37095,0.017481,172.31.47.0-255,66,183928,92,289584
37096,0.017982,74.125.130.0-255,2902,186830,92,289584
37097,0.017987,172.31.47.0-255,66,186896,92,289584
37098,0.020041,74.125.130.0-255,2902,189798,92,289584
37099,0.020048,172.31.47.0-255,66,189864,92,289584
37100,0.020547,74.125.130.0-255,2902,192766,92,289584
37101,0.020553,172.31.47.0-255,66,192832,92,289584
37102,0.022638,74.125.130.0-255,2902,195734,92,289584
37103,0.022646,172.31.47.0-255,66,195800,92,289584
37104,0.023111,74.125.130.0-255,2902,198702,92,289584
37105,0.023117,172.31.47.0-255,66,198768,92,289584
37106,0.025232,74.125.130.0-255,2902,201670,92,289584
37107,0.025251,172.31.47.0-255,66,201736,92,289584
37108,0.025679,74.125.130.0-255,2902,204638,92,289584
37109,0.025686,172.31.47.0-255,66,204704,92,289584
37110,0.027821,74.125.130.0-255,2902,207606,92,289584
37111,0.027831,172.31.47.0-255,66,207672,92,289584
37112,0.028257,74.125.130.0-255,2902,210574,92,289584
37113,0.028262,172.31.47.0-255,66,210640,92,289584
37114,0.030407,74.125.130.0-255,2902,213542,92,289584
37115,0.030419,172.31.47.0-255,66,213608,92,289584
37116,0.030824,74.125.130.0-255,2902,216510,92,289584
37117,0.03083,172.31.47.0-255,66,216576,92,289584
37118,0.033006,74.125.130.0-255,1484,218060,92,289584
37119,0.033383,74.125.130.0-255,4320,222380,92,289584
37120,0.033387,172.31.47.0-255,66,222446,92,289584
37121,0.033855,172.31.47.0-255,172,222618,92,289584
37122,0.033888,172.31.47.0-255,1103,223721,92,289584
37123,0.033953,172.31.47.0-255,1514,225235,92,289584
37124,0.033954,172.31.47.0-255,1514,226749,92,289584
37125,0.033955,172.31.47.0-255,1514,228263,92,289584
37126,0.033956,172.31.47.0-255,1514,229777,92,289584
37127,0.033957,172.31.47.0-255,1503,231280,92,289584
37128,0.035425,104.244.42.0-255,66,231346,92,289584
37129,0.035517,104.244.42.0-255,66,231412,92,289584
37130,0.03557,104.244.42.0-255,66,231478,92,289584
37131,0.035972,74.125.130.0-255,5738,237216,92,289584
37132,0.035981,172.31.47.0-255,66,237282,92,289584
37133,0.038569,74.125.130.0-255,5738,243020,92,289584
37134,0.038586,172.31.47.0-255,66,243086,92,289584
37135,0.041247,74.125.130.0-255,5738,248824,92,289584
37136,0.041266,172.31.47.0-255,66,248890,92,289584
37137,0.043849,74.125.130.0-255,5738,254628,92,289584
37138,0.043869,172.31.47.0-255,66,254694,92,289584
37139,0.046456,74.125.130.0-255,5738,260432,92,289584
37140,0.046466,172.31.47.0-255,66,260498,92,289584
37141,0.049058,74.125.130.0-255,5738,266236,92,289584
37142,0.049077,172.31.47.0-255,66,266302,92,289584
37143,0.051667,74.125.130.0-255,5738,272040,92,289584
37144,0.051686,172.31.47.0-255,66,272106,92,289584
37145,0.05426,74.125.130.0-255,5738,277844,92,289584
37146,0.054272,172.31.47.0-255,66,277910,92,289584
37147,0.056832,74.125.130.0-255,5738,283648,92,289584
37148,0.056837,172.31.47.0-255,66,283714,92,289584
37149,0.059404,74.125.130.0-255,1484,285198,92,289584
37150,0.059429,74.125.130.0-255,4320,289518,92,289584
37151,0.059433,172.31.47.0-255,66,289584,92,289584
37152,0.0,74.125.24.0-255,297,297,92,246215
37153,1.9e-05,172.31.47.0-255,66,363,92,246215
37154,2.5e-05,74.125.24.0-255,1484,1847,92,246215
37155,2.9e-05,172.31.47.0-255,66,1913,92,246215
37156,3.5e-05,74.125.24.0-255,4320,6233,92,246215
37157,3.7e-05,172.31.47.0-255,66,6299,92,246215
37158,4.3e-05,74.125.24.0-255,5738,12037,92,246215
37159,4.6e-05,172.31.47.0-255,66,12103,92,246215
37160,6.3e-05,74.125.24.0-255,3439,15542,92,246215
37161,6.5e-05,172.31.47.0-255,66,15608,92,246215
37162,7e-05,74.125.24.0-255,4320,19928,92,246215
37163,7.3e-05,172.31.47.0-255,66,19994,92,246215
37164,0.000108,74.125.24.0-255,4320,24314,92,246215
37165,0.00011,172.31.47.0-255,66,24380,92,246215
37166,0.000129,74.125.24.0-255,5738,30118,92,246215
37167,0.000131,172.31.47.0-255,66,30184,92,246215
37168,0.00015,74.125.24.0-255,1125,31309,92,246215
37169,0.000152,172.31.47.0-255,66,31375,92,246215
37170,0.000181,74.125.24.0-255,1484,32859,92,246215
37171,0.000183,172.31.47.0-255,66,32925,92,246215
37172,0.000196,74.125.24.0-255,2902,35827,92,246215
37173,0.000198,172.31.47.0-255,66,35893,92,246215
37174,0.000201,74.125.24.0-255,1484,37377,92,246215
37175,0.000203,172.31.47.0-255,66,37443,92,246215
37176,0.000217,74.125.24.0-255,4320,41763,92,246215
37177,0.00022,172.31.47.0-255,66,41829,92,246215
37178,0.000242,74.125.24.0-255,4320,46149,92,246215
37179,0.000244,172.31.47.0-255,66,46215,92,246215
37180,0.000271,172.31.47.0-255,66,46281,92,246215
37181,0.000277,74.125.24.0-255,7156,53437,92,246215
37182,0.000279,172.31.47.0-255,66,53503,92,246215
37183,0.000306,74.125.24.0-255,2813,56316,92,246215
37184,0.000308,172.31.47.0-255,66,56382,92,246215
37185,0.000352,74.125.24.0-255,135,56517,92,246215
37186,0.00062,74.125.24.0-255,1484,58001,92,246215
37187,0.000624,172.31.47.0-255,66,58067,92,246215
37188,0.000629,74.125.24.0-255,2902,60969,92,246215
37189,0.000631,172.31.47.0-255,66,61035,92,246215
37190,0.000657,74.125.24.0-255,2902,63937,92,246215
37191,0.000659,172.31.47.0-255,66,64003,92,246215
37192,0.000665,74.125.24.0-255,5738,69741,92,246215
37193,0.000667,172.31.47.0-255,66,69807,92,246215
37194,0.000678,74.125.24.0-255,1484,71291,92,246215
37195,0.000703,74.125.24.0-255,1484,72775,92,246215
37196,0.000706,172.31.47.0-255,66,72841,92,246215
37197,0.000721,74.125.24.0-255,2543,75384,92,246215
37198,0.000723,172.31.47.0-255,66,75450,92,246215
37199,0.000761,74.125.24.0-255,4320,79770,92,246215
37200,0.000768,172.31.47.0-255,66,79836,92,246215
37201,0.000771,74.125.24.0-255,1484,81320,92,246215
37202,0.000787,74.125.24.0-255,2902,84222,92,246215
37203,0.00079,172.31.47.0-255,66,84288,92,246215
37204,0.00083,74.125.24.0-255,7056,91344,92,246215
37205,0.000833,172.31.47.0-255,66,91410,92,246215
37206,0.001636,74.125.24.0-255,1484,92894,92,246215
37207,0.001647,74.125.24.0-255,2902,95796,92,246215
37208,0.001652,172.31.47.0-255,66,95862,92,246215
37209,0.001659,74.125.24.0-255,4320,100182,92,246215
37210,0.001661,172.31.47.0-255,66,100248,92,246215
37211,0.001679,74.125.24.0-255,7156,107404,92,246215
37212,0.001681,172.31.47.0-255,66,107470,92,246215
37213,0.001692,74.125.24.0-255,1484,108954,92,246215
37214,0.001716,74.125.24.0-255,1484,110438,92,246215
37215,0.001719,172.31.47.0-255,66,110504,92,246215
37216,0.001752,172.31.47.0-255,66,110570,92,246215
37217,0.00429,74.125.24.0-255,5738,116308,92,246215
37218,0.004299,172.31.47.0-255,66,116374,92,246215
37219,0.006851,74.125.24.0-255,5738,122112,92,246215
37220,0.006858,172.31.47.0-255,66,122178,92,246215
37221,0.009391,74.125.24.0-255,5738,127916,92,246215
37222,0.0094,172.31.47.0-255,66,127982,92,246215
37223,0.011984,74.125.24.0-255,5738,133720,92,246215
37224,0.011997,172.31.47.0-255,66,133786,92,246215
37225,0.014652,74.125.24.0-255,5738,139524,92,246215
37226,0.014666,172.31.47.0-255,66,139590,92,246215
37227,0.017211,74.125.24.0-255,5738,145328,92,246215
37228,0.017224,172.31.47.0-255,66,145394,92,246215
37229,0.019756,74.125.24.0-255,5738,151132,92,246215
37230,0.019766,172.31.47.0-255,66,151198,92,246215
37231,0.022309,74.125.24.0-255,5738,156936,92,246215
37232,0.022321,172.31.47.0-255,66,157002,92,246215
37233,0.024895,74.125.24.0-255,5738,162740,92,246215
37234,0.024908,172.31.47.0-255,66,162806,92,246215
37235,0.027418,74.125.24.0-255,5738,168544,92,246215
37236,0.027429,172.31.47.0-255,66,168610,92,246215
37237,0.030002,74.125.24.0-255,5738,174348,92,246215
37238,0.030017,172.31.47.0-255,66,174414,92,246215
37239,0.031353,172.31.47.0-255,171,174585,92,246215
37240,0.031386,172.31.47.0-255,1135,175720,92,246215
37241,0.03145,172.31.47.0-255,1514,177234,92,246215
37242,0.031452,172.31.47.0-255,1514,178748,92,246215
37243,0.031457,172.31.47.0-255,1514,180262,92,246215
37244,0.031458,172.31.47.0-255,1514,181776,92,246215
37245,0.031486,172.31.47.0-255,331,182107,92,246215
37246,0.032559,74.125.24.0-255,5738,187845,92,246215
37247,0.032568,172.31.47.0-255,66,187911,92,246215
37248,0.032931,104.244.42.0-255,66,187977,92,246215
37249,0.032966,104.244.42.0-255,66,188043,92,246215
37250,0.033017,104.244.42.0-255,66,188109,92,246215
37251,0.033021,104.244.42.0-255,66,188175,92,246215
37252,0.035125,74.125.24.0-255,5738,193913,92,246215
37253,0.035132,172.31.47.0-255,66,193979,92,246215
37254,0.037726,74.125.24.0-255,5738,199717,92,246215
37255,0.037734,172.31.47.0-255,66,199783,92,246215
37256,0.040273,74.125.24.0-255,5738,205521,92,246215
37257,0.040282,172.31.47.0-255,66,205587,92,246215
37258,0.042808,74.125.24.0-255,5738,211325,92,246215
37259,0.042816,172.31.47.0-255,66,211391,92,246215
37260,0.045361,74.125.24.0-255,5738,217129,92,246215
37261,0.045368,172.31.47.0-255,66,217195,92,246215
37262,0.047916,74.125.24.0-255,5738,222933,92,246215
37263,0.047923,172.31.47.0-255,66,222999,92,246215
37264,0.050468,74.125.24.0-255,5738,228737,92,246215
37265,0.050474,172.31.47.0-255,66,228803,92,246215
37266,0.053026,74.125.24.0-255,5738,234541,92,246215
37267,0.053033,172.31.47.0-255,66,234607,92,246215
37268,0.055593,74.125.24.0-255,5738,240345,92,246215
37269,0.055602,172.31.47.0-255,66,240411,92,246215
37270,0.0582,74.125.24.0-255,5738,246149,92,246215
37271,0.058209,172.31.47.0-255,66,246215,92,246215
37272,0.0,74.125.200.0-255,153,153,92,353858
37273,2.1e-05,172.31.47.0-255,66,219,92,353858
37274,2.8e-05,74.125.200.0-255,1484,1703,92,353858
37275,3.2e-05,172.31.47.0-255,66,1769,92,353858
37276,5.1e-05,74.125.200.0-255,2902,4671,92,353858
37277,5.4e-05,172.31.47.0-255,66,4737,92,353858
37278,7.4e-05,74.125.200.0-255,5738,10475,92,353858
37279,7.6e-05,172.31.47.0-255,66,10541,92,353858
37280,7.9e-05,74.125.200.0-255,1484,12025,92,353858
37281,8.1e-05,172.31.47.0-255,66,12091,92,353858
37282,0.000133,74.125.200.0-255,2902,14993,92,353858
37283,0.000135,172.31.47.0-255,66,15059,92,353858
37284,0.000154,74.125.200.0-255,6366,21425,92,353858
37285,0.000156,172.31.47.0-255,66,21491,92,353858
37286,0.000161,74.125.200.0-255,4320,25811,92,353858
37287,0.000163,172.31.47.0-255,66,25877,92,353858
37288,0.000183,74.125.200.0-255,5379,31256,92,353858
37289,0.000185,172.31.47.0-255,66,31322,92,353858
37290,0.000278,74.125.200.0-255,1484,32806,92,353858
37291,0.000281,172.31.47.0-255,66,32872,92,353858
37292,0.000286,74.125.200.0-255,2902,35774,92,353858
37293,0.000288,172.31.47.0-255,66,35840,92,353858
37294,0.000298,74.125.200.0-255,1484,37324,92,353858
37295,0.0003,172.31.47.0-255,66,37390,92,353858
37296,0.00032,74.125.200.0-255,4320,41710,92,353858
37297,0.000322,172.31.47.0-255,66,41776,92,353858
37298,0.000334,74.125.200.0-255,2902,44678,92,353858
37299,0.000335,172.31.47.0-255,66,44744,92,353858
37300,0.000359,74.125.200.0-255,3961,48705,92,353858
37301,0.000361,172.31.47.0-255,66,48771,92,353858
37302,0.000369,74.125.200.0-255,7156,55927,92,353858
37303,0.000371,172.31.47.0-255,66,55993,92,353858
37304,0.000373,74.125.200.0-255,1484,57477,92,353858
37305,0.000402,74.125.200.0-255,7156,64633,92,353858
37306,0.000422,172.31.47.0-255,66,64699,92,353858
37307,0.000431,74.125.200.0-255,1713,66412,92,353858
37308,0.000458,172.31.47.0-255,66,66478,92,353858
37309,0.000602,74.125.200.0-255,1484,67962,92,353858
37310,0.00062,74.125.200.0-255,2902,70864,92,353858
37311,0.000623,74.125.200.0-255,2902,73766,92,353858
37312,0.000632,172.31.47.0-255,66,73832,92,353858
37313,0.000641,74.125.200.0-255,4320,78152,92,353858
37314,0.000645,172.31.47.0-255,66,78218,92,353858
37315,0.000653,74.125.200.0-255,2902,81120,92,353858
37316,0.00067,172.31.47.0-255,66,81186,92,353858
37317,0.000676,74.125.200.0-255,5738,86924,92,353858
37318,0.000678,74.125.200.0-255,1484,88408,92,353858
37319,0.000683,172.31.47.0-255,66,88474,92,353858
37320,0.000691,74.125.200.0-255,4320,92794,92,353858
37321,0.000709,172.31.47.0-255,66,92860,92,353858
37322,0.000725,74.125.200.0-255,2902,95762,92,353858
37323,0.000734,172.31.47.0-255,66,95828,92,353858
37324,0.000743,74.125.200.0-255,4320,100148,92,353858
37325,0.000746,74.125.200.0-255,218,100366,92,353858
37326,0.000749,172.31.47.0-255,66,100432,92,353858
37327,0.000811,74.125.200.0-255,1484,101916,92,353858
37328,0.000824,74.125.200.0-255,1484,103400,92,353858
37329,0.000836,74.125.200.0-255,2902,106302,92,353858
37330,0.000881,172.31.47.0-255,66,106368,92,353858
37331,0.000891,74.125.200.0-255,5738,112106,92,353858
37332,0.000906,172.31.47.0-255,66,112172,92,353858
37333,0.000946,74.125.200.0-255,7156,119328,92,353858
37334,0.000951,172.31.47.0-255,66,119394,92,353858
37335,0.000958,74.125.200.0-255,2184,121578,92,353858
37336,0.000978,172.31.47.0-255,66,121644,92,353858
37337,0.001042,74.125.200.0-255,1484,123128,92,353858
37338,0.001057,74.125.200.0-255,2902,126030,92,353858
37339,0.001074,74.125.200.0-255,2902,128932,92,353858
37340,0.001077,172.31.47.0-255,66,128998,92,353858
37341,0.001081,172.31.47.0-255,66,129064,92,353858
37342,0.001088,74.125.200.0-255,2902,131966,92,353858
37343,0.001104,74.125.200.0-255,4320,136286,92,353858
37344,0.00111,172.31.47.0-255,66,136352,92,353858
37345,0.001122,74.125.200.0-255,2902,139254,92,353858
37346,0.001133,74.125.200.0-255,2902,142156,92,353858
37347,0.001141,172.31.47.0-255,66,142222,92,353858
37348,0.001151,74.125.200.0-255,4320,146542,92,353858
37349,0.001154,74.125.200.0-255,1484,148026,92,353858
37350,0.001171,74.125.200.0-255,7156,155182,92,353858
37351,0.001174,74.125.200.0-255,766,155948,92,353858
37352,0.001179,172.31.47.0-255,66,156014,92,353858
37353,0.001822,74.125.200.0-255,1484,157498,92,353858
37354,0.001838,74.125.200.0-255,2902,160400,92,353858
37355,0.001842,172.31.47.0-255,66,160466,92,353858
37356,0.001868,74.125.200.0-255,5738,166204,92,353858
37357,0.001884,74.125.200.0-255,4320,170524,92,353858
37358,0.001886,172.31.47.0-255,66,170590,92,353858
37359,0.001891,172.31.47.0-255,66,170656,92,353858
37360,0.00191,74.125.200.0-255,5738,176394,92,353858
37361,0.001916,74.125.200.0-255,4320,180714,92,353858
37362,0.001923,172.31.47.0-255,66,180780,92,353858
37363,0.001937,74.125.200.0-255,7156,187936,92,353858
37364,0.001941,74.125.200.0-255,1484,189420,92,353858
37365,0.001957,74.125.200.0-255,766,190186,92,353858
37366,0.001967,172.31.47.0-255,66,190252,92,353858
37367,0.001997,74.125.200.0-255,1484,191736,92,353858
37368,0.002015,74.125.200.0-255,2902,194638,92,353858
37369,0.002017,172.31.47.0-255,66,194704,92,353858
37370,0.002023,74.125.200.0-255,4320,199024,92,353858
37371,0.002038,74.125.200.0-255,2902,201926,92,353858
37372,0.002045,172.31.47.0-255,66,201992,92,353858
37373,0.002069,74.125.200.0-255,2902,204894,92,353858
37374,0.002072,74.125.200.0-255,1484,206378,92,353858
37375,0.002087,172.31.47.0-255,66,206444,92,353858
37376,0.004061,74.125.200.0-255,1484,207928,92,353858
37377,0.004067,172.31.47.0-255,66,207994,92,353858
37378,0.004118,74.125.200.0-255,4320,212314,92,353858
37379,0.006096,74.125.200.0-255,1484,213798,92,353858
37380,0.007734,172.31.47.0-255,66,213864,92,353858
37381,0.009766,74.125.200.0-255,5738,219602,92,353858
37382,0.011356,172.31.47.0-255,66,219668,92,353858
37383,0.013398,74.125.200.0-255,5738,225406,92,353858
37384,0.013408,172.31.47.0-255,66,225472,92,353858
37385,0.015474,74.125.200.0-255,5738,231210,92,353858
37386,0.015481,172.31.47.0-255,66,231276,92,353858
37387,0.017509,74.125.200.0-255,4320,235596,92,353858
37388,0.017516,172.31.47.0-255,66,235662,92,353858
37389,0.017534,74.125.200.0-255,1484,237146,92,353858
37390,0.019548,74.125.200.0-255,4320,241466,92,353858
37391,0.019554,172.31.47.0-255,66,241532,92,353858
37392,0.021598,74.125.200.0-255,5738,247270,92,353858
37393,0.024235,172.31.47.0-255,66,247336,92,353858
37394,0.026284,74.125.200.0-255,5738,253074,92,353858
37395,0.026305,172.31.47.0-255,66,253140,92,353858
37396,0.028349,74.125.200.0-255,5738,258878,92,353858
37397,0.028359,172.31.47.0-255,66,258944,92,353858
37398,0.030406,74.125.200.0-255,5738,264682,92,353858
37399,0.03042,172.31.47.0-255,66,264748,92,353858
37400,0.032443,74.125.200.0-255,5738,270486,92,353858
37401,0.032451,172.31.47.0-255,66,270552,92,353858
37402,0.034498,74.125.200.0-255,5738,276290,92,353858
37403,0.034506,172.31.47.0-255,66,276356,92,353858
37404,0.035791,172.31.47.0-255,172,276528,92,353858
37405,0.035825,172.31.47.0-255,1106,277634,92,353858
37406,0.035907,172.31.47.0-255,1514,279148,92,353858
37407,0.035909,172.31.47.0-255,1514,280662,92,353858
37408,0.03591,172.31.47.0-255,1514,282176,92,353858
37409,0.035911,172.31.47.0-255,1514,283690,92,353858
37410,0.035937,172.31.47.0-255,1500,285190,92,353858
37411,0.036573,74.125.200.0-255,5738,290928,92,353858
37412,0.036582,172.31.47.0-255,66,290994,92,353858
37413,0.037325,104.244.42.0-255,66,291060,92,353858
37414,0.037366,104.244.42.0-255,66,291126,92,353858
37415,0.037488,104.244.42.0-255,66,291192,92,353858
37416,0.038609,74.125.200.0-255,5738,296930,92,353858
37417,0.038617,172.31.47.0-255,66,296996,92,353858
37418,0.040352,104.244.42.0-255,108,297104,92,353858
37419,0.040359,172.31.47.0-255,66,297170,92,353858
37420,0.040646,74.125.200.0-255,5738,302908,92,353858
37421,0.040651,172.31.47.0-255,66,302974,92,353858
37422,0.042688,74.125.200.0-255,5738,308712,92,353858
37423,0.0427,172.31.47.0-255,66,308778,92,353858
37424,0.044735,74.125.200.0-255,5738,314516,92,353858
37425,0.044742,172.31.47.0-255,66,314582,92,353858
37426,0.046792,74.125.200.0-255,5738,320320,92,353858
37427,0.0468,172.31.47.0-255,66,320386,92,353858
37428,0.048848,74.125.200.0-255,4320,324706,92,353858
37429,0.048854,172.31.47.0-255,66,324772,92,353858
37430,0.048872,74.125.200.0-255,1484,326256,92,353858
37431,0.050895,74.125.200.0-255,4320,330576,92,353858
37432,0.050902,172.31.47.0-255,66,330642,92,353858
37433,0.052952,74.125.200.0-255,5738,336380,92,353858
37434,0.053006,172.31.47.0-255,66,336446,92,353858
37435,0.055039,74.125.200.0-255,5738,342184,92,353858
37436,0.055044,172.31.47.0-255,66,342250,92,353858
37437,0.057066,74.125.200.0-255,5738,347988,92,353858
37438,0.057072,172.31.47.0-255,66,348054,92,353858
37439,0.059106,74.125.200.0-255,5738,353792,92,353858
37440,0.059116,172.31.47.0-255,66,353858,92,353858
37441,0.0,74.125.24.0-255,153,153,92,256075
37442,2.4e-05,172.31.47.0-255,66,219,92,256075
37443,2.9e-05,74.125.24.0-255,1484,1703,92,256075
37444,3.3e-05,172.31.47.0-255,66,1769,92,256075
37445,3.6e-05,74.125.24.0-255,1484,3253,92,256075
37446,3.7e-05,172.31.47.0-255,66,3319,92,256075
37447,5.4e-05,74.125.24.0-255,1484,4803,92,256075
37448,5.6e-05,172.31.47.0-255,66,4869,92,256075
37449,5.8e-05,74.125.24.0-255,1484,6353,92,256075
37450,6.3e-05,172.31.47.0-255,66,6419,92,256075
37451,8.5e-05,74.125.24.0-255,4320,10739,92,256075
37452,9.1e-05,172.31.47.0-255,66,10805,92,256075
37453,9.5e-05,74.125.24.0-255,2902,13707,92,256075
37454,9.6e-05,172.31.47.0-255,66,13773,92,256075
37455,0.000111,74.125.24.0-255,3463,17236,92,256075
37456,0.000113,172.31.47.0-255,66,17302,92,256075
37457,0.000123,74.125.24.0-255,7156,24458,92,256075
37458,0.000126,172.31.47.0-255,66,24524,92,256075
37459,0.000162,172.31.47.0-255,66,24590,92,256075
37460,0.000209,172.31.47.0-255,66,24656,92,256075
37461,0.000219,74.125.24.0-255,766,25422,92,256075
37462,0.000224,172.31.47.0-255,66,25488,92,256075
37463,0.000267,74.125.24.0-255,1484,26972,92,256075
37464,0.000271,172.31.47.0-255,66,27038,92,256075
37465,0.000296,74.125.24.0-255,2902,29940,92,256075
37466,0.000299,172.31.47.0-255,66,30006,92,256075
37467,0.000304,74.125.24.0-255,4320,34326,92,256075
37468,0.000307,172.31.47.0-255,66,34392,92,256075
37469,0.000325,74.125.24.0-255,1484,35876,92,256075
37470,0.000328,172.31.47.0-255,66,35942,92,256075
37471,0.000353,74.125.24.0-255,7153,43095,92,256075
37472,0.000356,172.31.47.0-255,66,43161,92,256075
37473,0.000441,74.125.24.0-255,1484,44645,92,256075
37474,0.000453,74.125.24.0-255,2902,47547,92,256075
37475,0.000456,172.31.47.0-255,66,47613,92,256075
37476,0.000481,74.125.24.0-255,5738,53351,92,256075
37477,0.000484,172.31.47.0-255,66,53417,92,256075
37478,0.000512,172.31.47.0-255,66,53483,92,256075
37479,0.000529,74.125.24.0-255,2902,56385,92,256075
37480,0.000531,172.31.47.0-255,66,56451,92,256075
37481,0.000538,74.125.24.0-255,5738,62189,92,256075
37482,0.00054,172.31.47.0-255,66,62255,92,256075
37483,0.000568,74.125.24.0-255,6438,68693,92,256075
37484,0.000571,172.31.47.0-255,66,68759,92,256075
37485,0.000574,74.125.24.0-255,329,69088,92,256075
37486,0.00112,74.125.24.0-255,1484,70572,92,256075
37487,0.001125,172.31.47.0-255,66,70638,92,256075
37488,0.00113,74.125.24.0-255,2902,73540,92,256075
37489,0.001132,172.31.47.0-255,66,73606,92,256075
37490,0.001169,74.125.24.0-255,5738,79344,92,256075
37491,0.001172,172.31.47.0-255,66,79410,92,256075
37492,0.001177,74.125.24.0-255,4320,83730,92,256075
37493,0.001178,172.31.47.0-255,66,83796,92,256075
37494,0.001208,172.31.47.0-255,66,83862,92,256075
37495,0.00124,172.31.47.0-255,66,83928,92,256075
37496,0.001344,74.125.24.0-255,1484,85412,92,256075
37497,0.001364,74.125.24.0-255,2902,88314,92,256075
37498,0.001368,172.31.47.0-255,66,88380,92,256075
37499,0.001375,74.125.24.0-255,5738,94118,92,256075
37500,0.001376,172.31.47.0-255,66,94184,92,256075
37501,0.00144,172.31.47.0-255,66,94250,92,256075
37502,0.001447,74.125.24.0-255,7156,101406,92,256075
37503,0.001449,172.31.47.0-255,66,101472,92,256075
37504,0.00147,74.125.24.0-255,3602,105074,92,256075
37505,0.001473,172.31.47.0-255,66,105140,92,256075
37506,0.003755,74.125.24.0-255,1484,106624,92,256075
37507,0.003774,74.125.24.0-255,4320,110944,92,256075
37508,0.003779,172.31.47.0-255,66,111010,92,256075
37509,0.006123,74.125.24.0-255,5738,116748,92,256075
37510,0.006129,172.31.47.0-255,66,116814,92,256075
37511,0.008449,74.125.24.0-255,5738,122552,92,256075
37512,0.008456,172.31.47.0-255,66,122618,92,256075
37513,0.010944,74.125.24.0-255,5738,128356,92,256075
37514,0.010957,172.31.47.0-255,66,128422,92,256075
37515,0.01326,74.125.24.0-255,5738,134160,92,256075
37516,0.013268,172.31.47.0-255,66,134226,92,256075
37517,0.015575,74.125.24.0-255,5738,139964,92,256075
37518,0.015586,172.31.47.0-255,66,140030,92,256075
37519,0.017931,74.125.24.0-255,5738,145768,92,256075
37520,0.017942,172.31.47.0-255,66,145834,92,256075
37521,0.020266,74.125.24.0-255,5738,151572,92,256075
37522,0.020274,172.31.47.0-255,66,151638,92,256075
37523,0.022585,74.125.24.0-255,5738,157376,92,256075
37524,0.022593,172.31.47.0-255,66,157442,92,256075
37525,0.024906,74.125.24.0-255,5738,163180,92,256075
37526,0.024914,172.31.47.0-255,66,163246,92,256075
37527,0.027246,74.125.24.0-255,5738,168984,92,256075
37528,0.027253,172.31.47.0-255,66,169050,92,256075
37529,0.029551,74.125.24.0-255,2902,171952,92,256075
37530,0.029557,172.31.47.0-255,66,172018,92,256075
37531,0.029586,74.125.24.0-255,2902,174920,92,256075
37532,0.029589,172.31.47.0-255,66,174986,92,256075
37533,0.029862,172.31.47.0-255,172,175158,92,256075
37534,0.029909,172.31.47.0-255,1112,176270,92,256075
37535,0.029975,172.31.47.0-255,1514,177784,92,256075
37536,0.029977,172.31.47.0-255,1514,179298,92,256075
37537,0.029978,172.31.47.0-255,1514,180812,92,256075
37538,0.029979,172.31.47.0-255,1514,182326,92,256075
37539,0.02998,172.31.47.0-255,1495,183821,92,256075
37540,0.031428,104.244.42.0-255,66,183887,92,256075
37541,0.031493,104.244.42.0-255,66,183953,92,256075
37542,0.031593,104.244.42.0-255,66,184019,92,256075
37543,0.031827,74.125.24.0-255,2902,186921,92,256075
37544,0.03183,172.31.47.0-255,66,186987,92,256075
37545,0.031873,74.125.24.0-255,2902,189889,92,256075
37546,0.031877,172.31.47.0-255,66,189955,92,256075
37547,0.034122,74.125.24.0-255,2902,192857,92,256075
37548,0.034127,172.31.47.0-255,66,192923,92,256075
37549,0.034168,74.125.24.0-255,2902,195825,92,256075
37550,0.034171,172.31.47.0-255,66,195891,92,256075
37551,0.036441,74.125.24.0-255,2902,198793,92,256075
37552,0.036445,172.31.47.0-255,66,198859,92,256075
37553,0.036472,74.125.24.0-255,2902,201761,92,256075
37554,0.036475,172.31.47.0-255,66,201827,92,256075
37555,0.038779,74.125.24.0-255,4320,206147,92,256075
37556,0.038784,172.31.47.0-255,66,206213,92,256075
37557,0.038821,74.125.24.0-255,1484,207697,92,256075
37558,0.041098,74.125.24.0-255,4320,212017,92,256075
37559,0.041102,172.31.47.0-255,66,212083,92,256075
37560,0.043412,74.125.24.0-255,2902,214985,92,256075
37561,0.043416,172.31.47.0-255,66,215051,92,256075
37562,0.043449,74.125.24.0-255,2902,217953,92,256075
37563,0.043452,172.31.47.0-255,66,218019,92,256075
37564,0.04569,74.125.24.0-255,2902,220921,92,256075
37565,0.045694,172.31.47.0-255,66,220987,92,256075
37566,0.045749,74.125.24.0-255,2902,223889,92,256075
37567,0.045752,172.31.47.0-255,66,223955,92,256075
37568,0.048023,74.125.24.0-255,4320,228275,92,256075
37569,0.048028,172.31.47.0-255,66,228341,92,256075
37570,0.048061,74.125.24.0-255,1484,229825,92,256075
37571,0.05034,74.125.24.0-255,4320,234145,92,256075
37572,0.050344,172.31.47.0-255,66,234211,92,256075
37573,0.052628,74.125.24.0-255,4320,238531,92,256075
37574,0.052632,172.31.47.0-255,66,238597,92,256075
37575,0.05266,74.125.24.0-255,1484,240081,92,256075
37576,0.054933,74.125.24.0-255,4320,244401,92,256075
37577,0.054938,172.31.47.0-255,66,244467,92,256075
37578,0.057236,74.125.24.0-255,5738,250205,92,256075
37579,0.057242,172.31.47.0-255,66,250271,92,256075
37580,0.059522,74.125.24.0-255,5738,256009,92,256075
37581,0.059527,172.31.47.0-255,66,256075,92,256075
37582,0.0,74.125.24.0-255,153,153,92,272721
37583,2.7e-05,172.31.47.0-255,66,219,92,272721
37584,3.3e-05,74.125.24.0-255,1484,1703,92,272721
37585,3.7e-05,172.31.47.0-255,66,1769,92,272721
37586,4.2e-05,74.125.24.0-255,2902,4671,92,272721
37587,4.5e-05,172.31.47.0-255,66,4737,92,272721
37588,4.9e-05,74.125.24.0-255,1484,6221,92,272721
37589,5.1e-05,172.31.47.0-255,66,6287,92,272721
37590,7.5e-05,74.125.24.0-255,4320,10607,92,272721
37591,7.8e-05,172.31.47.0-255,66,10673,92,272721
37592,8.1e-05,74.125.24.0-255,1484,12157,92,272721
37593,8.3e-05,172.31.47.0-255,66,12223,92,272721
37594,0.000108,74.125.24.0-255,4920,17143,92,272721
37595,0.000111,172.31.47.0-255,66,17209,92,272721
37596,0.000118,74.125.24.0-255,7156,24365,92,272721
37597,0.000121,172.31.47.0-255,66,24431,92,272721
37598,0.00015,74.125.24.0-255,6797,31228,92,272721
37599,0.000154,172.31.47.0-255,66,31294,92,272721
37600,0.000318,74.125.24.0-255,1484,32778,92,272721
37601,0.000322,172.31.47.0-255,66,32844,92,272721
37602,0.000328,74.125.24.0-255,2902,35746,92,272721
37603,0.00033,172.31.47.0-255,66,35812,92,272721
37604,0.000335,74.125.24.0-255,2902,38714,92,272721
37605,0.000337,172.31.47.0-255,66,38780,92,272721
37606,0.000354,74.125.24.0-255,2902,41682,92,272721
37607,0.000356,172.31.47.0-255,66,41748,92,272721
37608,0.000372,74.125.24.0-255,1484,43232,92,272721
37609,0.000375,172.31.47.0-255,66,43298,92,272721
37610,0.000409,172.31.47.0-255,66,43364,92,272721
37611,0.000416,74.125.24.0-255,7156,50520,92,272721
37612,0.000419,172.31.47.0-255,66,50586,92,272721
37613,0.000457,74.125.24.0-255,5655,56241,92,272721
37614,0.000462,172.31.47.0-255,66,56307,92,272721
37615,0.000479,74.125.24.0-255,132,56439,92,272721
37616,0.000523,74.125.24.0-255,1484,57923,92,272721
37617,0.000527,172.31.47.0-255,66,57989,92,272721
37618,0.000541,74.125.24.0-255,1484,59473,92,272721
37619,0.000555,74.125.24.0-255,1484,60957,92,272721
37620,0.000558,172.31.47.0-255,66,61023,92,272721
37621,0.000567,74.125.24.0-255,5738,66761,92,272721
37622,0.00057,172.31.47.0-255,66,66827,92,272721
37623,0.000611,74.125.24.0-255,5738,72565,92,272721
37624,0.000615,172.31.47.0-255,66,72631,92,272721
37625,0.00064,172.31.47.0-255,66,72697,92,272721
37626,0.000671,74.125.24.0-255,4320,77017,92,272721
37627,0.000674,172.31.47.0-255,66,77083,92,272721
37628,0.000694,74.125.24.0-255,5636,82719,92,272721
37629,0.000698,172.31.47.0-255,66,82785,92,272721
37630,0.001063,74.125.24.0-255,1484,84269,92,272721
37631,0.00107,74.125.24.0-255,2902,87171,92,272721
37632,0.001075,172.31.47.0-255,66,87237,92,272721
37633,0.001081,74.125.24.0-255,2902,90139,92,272721
37634,0.001084,172.31.47.0-255,66,90205,92,272721
37635,0.001098,74.125.24.0-255,2902,93107,92,272721
37636,0.001102,172.31.47.0-255,66,93173,92,272721
37637,0.001107,74.125.24.0-255,2902,96075,92,272721
37638,0.00111,172.31.47.0-255,66,96141,92,272721
37639,0.001134,74.125.24.0-255,5738,101879,92,272721
37640,0.001137,172.31.47.0-255,66,101945,92,272721
37641,0.001153,74.125.24.0-255,5738,107683,92,272721
37642,0.001157,172.31.47.0-255,66,107749,92,272721
37643,0.001185,172.31.47.0-255,66,107815,92,272721
37644,0.001271,74.125.24.0-255,1484,109299,92,272721
37645,0.001289,74.125.24.0-255,2902,112201,92,272721
37646,0.001293,172.31.47.0-255,66,112267,92,272721
37647,0.001297,74.125.24.0-255,2902,115169,92,272721
37648,0.001301,172.31.47.0-255,66,115235,92,272721
37649,0.001325,74.125.24.0-255,2902,118137,92,272721
37650,0.001328,172.31.47.0-255,66,118203,92,272721
37651,0.001342,172.31.47.0-255,66,118269,92,272721
37652,0.001372,74.125.24.0-255,2902,121171,92,272721
37653,0.001376,172.31.47.0-255,66,121237,92,272721
37654,0.001405,172.31.47.0-255,66,121303,92,272721
37655,0.001744,74.125.24.0-255,1484,122787,92,272721
37656,0.00175,74.125.24.0-255,2902,125689,92,272721
37657,0.001757,172.31.47.0-255,66,125755,92,272721
37658,0.001768,74.125.24.0-255,4320,130075,92,272721
37659,0.001771,172.31.47.0-255,66,130141,92,272721
37660,0.001784,74.125.24.0-255,1484,131625,92,272721
37661,0.001797,172.31.47.0-255,66,131691,92,272721
37662,0.001821,74.125.24.0-255,1484,133175,92,272721
37663,0.001832,172.31.47.0-255,66,133241,92,272721
37664,0.001848,74.125.24.0-255,2184,135425,92,272721
37665,0.001851,172.31.47.0-255,66,135491,92,272721
37666,0.001894,74.125.24.0-255,2902,138393,92,272721
37667,0.001898,172.31.47.0-255,66,138459,92,272721
37668,0.001916,74.125.24.0-255,4320,142779,92,272721
37669,0.001919,172.31.47.0-255,66,142845,92,272721
37670,0.001922,74.125.24.0-255,1484,144329,92,272721
37671,0.001946,74.125.24.0-255,7156,151485,92,272721
37672,0.001949,172.31.47.0-255,66,151551,92,272721
37673,0.001956,74.125.24.0-255,5738,157289,92,272721
37674,0.001958,172.31.47.0-255,66,157355,92,272721
37675,0.001971,74.125.24.0-255,1484,158839,92,272721
37676,0.002007,74.125.24.0-255,7156,165995,92,272721
37677,0.002011,172.31.47.0-255,66,166061,92,272721
37678,0.002031,74.125.24.0-255,3602,169663,92,272721
37679,0.002033,172.31.47.0-255,66,169729,92,272721
37680,0.002141,74.125.24.0-255,1484,171213,92,272721
37681,0.00216,74.125.24.0-255,1484,172697,92,272721
37682,0.002164,172.31.47.0-255,66,172763,92,272721
37683,0.002181,74.125.24.0-255,1484,174247,92,272721
37684,0.002188,74.125.24.0-255,5738,179985,92,272721
37685,0.002192,172.31.47.0-255,66,180051,92,272721
37686,0.002259,172.31.47.0-255,66,180117,92,272721
37687,0.002272,172.31.47.0-255,66,180183,92,272721
37688,0.002276,74.125.24.0-255,2184,182367,92,272721
37689,0.002279,172.31.47.0-255,66,182433,92,272721
37690,0.002451,74.125.24.0-255,1484,183917,92,272721
37691,0.002456,74.125.24.0-255,2902,186819,92,272721
37692,0.002459,172.31.47.0-255,66,186885,92,272721
37693,0.002476,74.125.24.0-255,4320,191205,92,272721
37694,0.002479,172.31.47.0-255,66,191271,92,272721
37695,0.002502,74.125.24.0-255,1484,192755,92,272721
37696,0.002516,172.31.47.0-255,66,192821,92,272721
37697,0.002522,74.125.24.0-255,5738,198559,92,272721
37698,0.002524,172.31.47.0-255,66,198625,92,272721
37699,0.002537,74.125.24.0-255,2902,201527,92,272721
37700,0.00254,172.31.47.0-255,66,201593,92,272721
37701,0.002555,74.125.24.0-255,2184,203777,92,272721
37702,0.002557,172.31.47.0-255,66,203843,92,272721
37703,0.002587,74.125.24.0-255,2902,206745,92,272721
37704,0.00259,172.31.47.0-255,66,206811,92,272721
37705,0.002609,74.125.24.0-255,7156,213967,92,272721
37706,0.002612,172.31.47.0-255,66,214033,92,272721
37707,0.002638,172.31.47.0-255,66,214099,92,272721
37708,0.002641,74.125.24.0-255,1484,215583,92,272721
37709,0.002643,74.125.24.0-255,1484,217067,92,272721
37710,0.002645,172.31.47.0-255,66,217133,92,272721
37711,0.002682,172.31.47.0-255,66,217199,92,272721
37712,0.002687,74.125.24.0-255,3602,220801,92,272721
37713,0.002689,172.31.47.0-255,66,220867,92,272721
37714,0.002715,74.125.24.0-255,4320,225187,92,272721
37715,0.002718,172.31.47.0-255,66,225253,92,272721
37716,0.002741,172.31.47.0-255,66,225319,92,272721
37717,0.002744,74.125.24.0-255,1484,226803,92,272721
37718,0.002747,74.125.24.0-255,1484,228287,92,272721
37719,0.002748,172.31.47.0-255,66,228353,92,272721
37720,0.002784,172.31.47.0-255,66,228419,92,272721
37721,0.002801,74.125.24.0-255,1484,229903,92,272721
37722,0.002806,74.125.24.0-255,3602,233505,92,272721
37723,0.002809,172.31.47.0-255,66,233571,92,272721
37724,0.002825,74.125.24.0-255,1484,235055,92,272721
37725,0.002838,74.125.24.0-255,2902,237957,92,272721
37726,0.002841,172.31.47.0-255,66,238023,92,272721
37727,0.002847,74.125.24.0-255,5738,243761,92,272721
37728,0.00285,172.31.47.0-255,66,243827,92,272721
37729,0.002877,172.31.47.0-255,66,243893,92,272721
37730,0.002901,74.125.24.0-255,1484,245377,92,272721
37731,0.00293,172.31.47.0-255,66,245443,92,272721
37732,0.003,74.125.24.0-255,1484,246927,92,272721
37733,0.003004,74.125.24.0-255,1484,248411,92,272721
37734,0.003007,172.31.47.0-255,66,248477,92,272721
37735,0.003021,74.125.24.0-255,1484,249961,92,272721
37736,0.003026,74.125.24.0-255,2902,252863,92,272721
37737,0.003029,172.31.47.0-255,66,252929,92,272721
37738,0.003047,74.125.24.0-255,2902,255831,92,272721
37739,0.00305,172.31.47.0-255,66,255897,92,272721
37740,0.003055,74.125.24.0-255,4320,260217,92,272721
37741,0.003058,172.31.47.0-255,66,260283,92,272721
37742,0.003086,172.31.47.0-255,66,260349,92,272721
37743,0.003086,74.125.24.0-255,2932,263281,92,272721
37744,0.003089,172.31.47.0-255,66,263347,92,272721
37745,0.003133,74.125.24.0-255,105,263452,92,272721
37746,0.010263,172.31.47.0-255,66,263518,92,272721
37747,0.010296,172.31.47.0-255,105,263623,92,272721
37748,0.012853,74.125.24.0-255,66,263689,92,272721
37749,0.041802,172.31.47.0-255,172,263861,92,272721
37750,0.04183,172.31.47.0-255,1112,264973,92,272721
37751,0.041864,172.31.47.0-255,1514,266487,92,272721
37752,0.041865,172.31.47.0-255,1514,268001,92,272721
37753,0.041869,172.31.47.0-255,1514,269515,92,272721
37754,0.04187,172.31.47.0-255,1514,271029,92,272721
37755,0.041895,172.31.47.0-255,1494,272523,92,272721
37756,0.043347,104.244.42.0-255,66,272589,92,272721
37757,0.043408,104.244.42.0-255,66,272655,92,272721
37758,0.043452,104.244.42.0-255,66,272721,92,272721
37759,0.0,74.125.24.0-255,153,153,92,329243
37760,2.1e-05,172.31.47.0-255,66,219,92,329243
37761,2.8e-05,74.125.24.0-255,1484,1703,92,329243
37762,3.2e-05,172.31.47.0-255,66,1769,92,329243
37763,3.9e-05,74.125.24.0-255,2902,4671,92,329243
37764,4.2e-05,172.31.47.0-255,66,4737,92,329243
37765,5e-05,74.125.24.0-255,5738,10475,92,329243
37766,5.3e-05,172.31.47.0-255,66,10541,92,329243
37767,7.5e-05,74.125.24.0-255,3522,14063,92,329243
37768,7.8e-05,172.31.47.0-255,66,14129,92,329243
37769,0.000477,74.125.24.0-255,1484,15613,92,329243
37770,0.000482,172.31.47.0-255,66,15679,92,329243
37771,0.000488,74.125.24.0-255,2902,18581,92,329243
37772,0.00049,172.31.47.0-255,66,18647,92,329243
37773,0.000515,74.125.24.0-255,5738,24385,92,329243
37774,0.000517,172.31.47.0-255,66,24451,92,329243
37775,0.000553,74.125.24.0-255,2902,27353,92,329243
37776,0.000555,172.31.47.0-255,66,27419,92,329243
37777,0.000574,74.125.24.0-255,2902,30321,92,329243
37778,0.000577,172.31.47.0-255,66,30387,92,329243
37779,0.000615,74.125.24.0-255,1125,31512,92,329243
37780,0.000618,172.31.47.0-255,66,31578,92,329243
37781,0.000722,74.125.24.0-255,1484,33062,92,329243
37782,0.000725,74.125.24.0-255,1484,34546,92,329243
37783,0.00073,172.31.47.0-255,66,34612,92,329243
37784,0.000733,172.31.47.0-255,66,34678,92,329243
37785,0.000744,74.125.24.0-255,1484,36162,92,329243
37786,0.000747,172.31.47.0-255,66,36228,92,329243
37787,0.00075,74.125.24.0-255,1484,37712,92,329243
37788,0.000751,172.31.47.0-255,66,37778,92,329243
37789,0.000783,74.125.24.0-255,4320,42098,92,329243
37790,0.000786,172.31.47.0-255,66,42164,92,329243
37791,0.000793,74.125.24.0-255,6797,48961,92,329243
37792,0.000795,172.31.47.0-255,66,49027,92,329243
37793,0.0008,74.125.24.0-255,4320,53347,92,329243
37794,0.000802,172.31.47.0-255,66,53413,92,329243
37795,0.000818,74.125.24.0-255,7156,60569,92,329243
37796,0.00082,172.31.47.0-255,66,60635,92,329243
37797,0.000849,74.125.24.0-255,2902,63537,92,329243
37798,0.000852,172.31.47.0-255,66,63603,92,329243
37799,0.000885,74.125.24.0-255,2815,66418,92,329243
37800,0.000888,172.31.47.0-255,66,66484,92,329243
37801,0.000891,74.125.24.0-255,132,66616,92,329243
37802,0.000893,172.31.47.0-255,66,66682,92,329243
37803,0.001059,74.125.24.0-255,1484,68166,92,329243
37804,0.001063,172.31.47.0-255,66,68232,92,329243
37805,0.001075,74.125.24.0-255,2902,71134,92,329243
37806,0.001078,172.31.47.0-255,66,71200,92,329243
37807,0.001085,74.125.24.0-255,1484,72684,92,329243
37808,0.001086,172.31.47.0-255,66,72750,92,329243
37809,0.0011,74.125.24.0-255,4320,77070,92,329243
37810,0.001102,172.31.47.0-255,66,77136,92,329243
37811,0.001127,74.125.24.0-255,6797,83933,92,329243
37812,0.00113,172.31.47.0-255,66,83999,92,329243
37813,0.001135,74.125.24.0-255,4320,88319,92,329243
37814,0.001137,172.31.47.0-255,66,88385,92,329243
37815,0.001162,172.31.47.0-255,66,88451,92,329243
37816,0.001166,74.125.24.0-255,2543,90994,92,329243
37817,0.001168,172.31.47.0-255,66,91060,92,329243
37818,0.001508,74.125.24.0-255,1484,92544,92,329243
37819,0.001529,74.125.24.0-255,2902,95446,92,329243
37820,0.001532,172.31.47.0-255,66,95512,92,329243
37821,0.00154,74.125.24.0-255,5738,101250,92,329243
37822,0.001542,172.31.47.0-255,66,101316,92,329243
37823,0.001566,74.125.24.0-255,5738,107054,92,329243
37824,0.001568,172.31.47.0-255,66,107120,92,329243
37825,0.001573,74.125.24.0-255,4320,111440,92,329243
37826,0.001575,172.31.47.0-255,66,111506,92,329243
37827,0.001588,74.125.24.0-255,2902,114408,92,329243
37828,0.00159,172.31.47.0-255,66,114474,92,329243
37829,0.001613,74.125.24.0-255,4320,118794,92,329243
37830,0.001615,172.31.47.0-255,66,118860,92,329243
37831,0.001637,74.125.24.0-255,6438,125298,92,329243
37832,0.001639,172.31.47.0-255,66,125364,92,329243
37833,0.001692,74.125.24.0-255,1484,126848,92,329243
37834,0.001698,74.125.24.0-255,2902,129750,92,329243
37835,0.0017,172.31.47.0-255,66,129816,92,329243
37836,0.001733,74.125.24.0-255,2902,132718,92,329243
37837,0.001736,172.31.47.0-255,66,132784,92,329243
37838,0.00176,74.125.24.0-255,4320,137104,92,329243
37839,0.001762,172.31.47.0-255,66,137170,92,329243
37840,0.001768,74.125.24.0-255,5738,142908,92,329243
37841,0.001771,172.31.47.0-255,66,142974,92,329243
37842,0.001773,74.125.24.0-255,1484,144458,92,329243
37843,0.001798,74.125.24.0-255,5738,150196,92,329243
37844,0.001801,172.31.47.0-255,66,150262,92,329243
37845,0.001832,74.125.24.0-255,766,151028,92,329243
37846,0.001953,74.125.24.0-255,1484,152512,92,329243
37847,0.001958,74.125.24.0-255,2902,155414,92,329243
37848,0.001984,74.125.24.0-255,2902,158316,92,329243
37849,0.001998,74.125.24.0-255,2902,161218,92,329243
37850,0.00204,74.125.24.0-255,2902,164120,92,329243
37851,0.002046,74.125.24.0-255,7156,171276,92,329243
37852,0.002086,74.125.24.0-255,3602,174878,92,329243
37853,0.00699,172.31.47.0-255,66,174944,92,329243
37854,0.009037,74.125.24.0-255,5738,180682,92,329243
37855,0.009044,172.31.47.0-255,66,180748,92,329243
37856,0.011078,74.125.24.0-255,5738,186486,92,329243
37857,0.011086,172.31.47.0-255,66,186552,92,329243
37858,0.013145,74.125.24.0-255,5738,192290,92,329243
37859,0.013153,172.31.47.0-255,66,192356,92,329243
37860,0.015219,74.125.24.0-255,4320,196676,92,329243
37861,0.015226,172.31.47.0-255,66,196742,92,329243
37862,0.015246,74.125.24.0-255,1484,198226,92,329243
37863,0.017274,74.125.24.0-255,4320,202546,92,329243
37864,0.017282,172.31.47.0-255,66,202612,92,329243
37865,0.019353,74.125.24.0-255,5738,208350,92,329243
37866,0.019362,172.31.47.0-255,66,208416,92,329243
37867,0.02138,74.125.24.0-255,5738,214154,92,329243
37868,0.021388,172.31.47.0-255,66,214220,92,329243
37869,0.023444,74.125.24.0-255,5738,219958,92,329243
37870,0.023453,172.31.47.0-255,66,220024,92,329243
37871,0.025507,74.125.24.0-255,2902,222926,92,329243
37872,0.025513,172.31.47.0-255,66,222992,92,329243
37873,0.025536,74.125.24.0-255,2902,225894,92,329243
37874,0.025538,172.31.47.0-255,66,225960,92,329243
37875,0.027555,74.125.24.0-255,2902,228862,92,329243
37876,0.027563,172.31.47.0-255,66,228928,92,329243
37877,0.027585,74.125.24.0-255,2902,231830,92,329243
37878,0.027588,172.31.47.0-255,66,231896,92,329243
37879,0.029596,74.125.24.0-255,2902,234798,92,329243
37880,0.029603,172.31.47.0-255,66,234864,92,329243
37881,0.029639,74.125.24.0-255,2902,237766,92,329243
37882,0.029641,172.31.47.0-255,66,237832,92,329243
37883,0.031639,74.125.24.0-255,2902,240734,92,329243
37884,0.031647,172.31.47.0-255,66,240800,92,329243
37885,0.031697,74.125.24.0-255,2902,243702,92,329243
37886,0.031701,172.31.47.0-255,66,243768,92,329243
37887,0.033693,74.125.24.0-255,2902,246670,92,329243
37888,0.033701,172.31.47.0-255,66,246736,92,329243
37889,0.033725,74.125.24.0-255,2902,249638,92,329243
37890,0.033728,172.31.47.0-255,66,249704,92,329243
37891,0.035734,74.125.24.0-255,2902,252606,92,329243
37892,0.035741,172.31.47.0-255,66,252672,92,329243
37893,0.035762,74.125.24.0-255,2902,255574,92,329243
37894,0.035765,172.31.47.0-255,66,255640,92,329243
37895,0.037772,74.125.24.0-255,2902,258542,92,329243
37896,0.037778,172.31.47.0-255,66,258608,92,329243
37897,0.037806,74.125.24.0-255,2902,261510,92,329243
37898,0.037809,172.31.47.0-255,66,261576,92,329243
37899,0.038371,172.31.47.0-255,172,261748,92,329243
37900,0.038397,172.31.47.0-255,1107,262855,92,329243
37901,0.038452,172.31.47.0-255,1514,264369,92,329243
37902,0.038454,172.31.47.0-255,1514,265883,92,329243
37903,0.038458,172.31.47.0-255,1514,267397,92,329243
37904,0.038459,172.31.47.0-255,1514,268911,92,329243
37905,0.038484,172.31.47.0-255,1500,270411,92,329243
37906,0.039818,74.125.24.0-255,2902,273313,92,329243
37907,0.039826,172.31.47.0-255,66,273379,92,329243
37908,0.039847,74.125.24.0-255,2902,276281,92,329243
37909,0.039851,172.31.47.0-255,66,276347,92,329243
37910,0.039889,104.244.42.0-255,66,276413,92,329243
37911,0.039964,104.244.42.0-255,66,276479,92,329243
37912,0.040085,104.244.42.0-255,66,276545,92,329243
37913,0.040091,104.244.42.0-255,66,276611,92,329243
37914,0.041842,74.125.24.0-255,2902,279513,92,329243
37915,0.041848,172.31.47.0-255,66,279579,92,329243
37916,0.041913,74.125.24.0-255,2902,282481,92,329243
37917,0.041917,172.31.47.0-255,66,282547,92,329243
37918,0.043891,74.125.24.0-255,2902,285449,92,329243
37919,0.043898,172.31.47.0-255,66,285515,92,329243
37920,0.043957,74.125.24.0-255,2902,288417,92,329243
37921,0.04396,172.31.47.0-255,66,288483,92,329243
37922,0.045974,74.125.24.0-255,2902,291385,92,329243
37923,0.045982,172.31.47.0-255,66,291451,92,329243
37924,0.046004,74.125.24.0-255,2902,294353,92,329243
37925,0.046008,172.31.47.0-255,66,294419,92,329243
37926,0.048115,74.125.24.0-255,5738,300157,92,329243
37927,0.048121,172.31.47.0-255,66,300223,92,329243
37928,0.050172,74.125.24.0-255,5738,305961,92,329243
37929,0.050179,172.31.47.0-255,66,306027,92,329243
37930,0.052263,74.125.24.0-255,5738,311765,92,329243
37931,0.05227,172.31.47.0-255,66,311831,92,329243
37932,0.05432,74.125.24.0-255,5738,317569,92,329243
37933,0.054326,172.31.47.0-255,66,317635,92,329243
37934,0.056343,74.125.24.0-255,5738,323373,92,329243
37935,0.056353,172.31.47.0-255,66,323439,92,329243
37936,0.058417,74.125.24.0-255,5738,329177,92,329243
37937,0.058424,172.31.47.0-255,66,329243,92,329243
37938,0.0,172.31.47.0-255,105,105,92,105
37939,0.0,74.125.200.0-255,153,153,92,363037
37940,2.9e-05,172.31.47.0-255,66,219,92,363037
37941,3.6e-05,74.125.200.0-255,1484,1703,92,363037
37942,3.9e-05,172.31.47.0-255,66,1769,92,363037
37943,5.2e-05,74.125.200.0-255,1484,3253,92,363037
37944,5.3e-05,172.31.47.0-255,66,3319,92,363037
37945,7.1e-05,74.125.200.0-255,2902,6221,92,363037
37946,7.3e-05,172.31.47.0-255,66,6287,92,363037
37947,9.2e-05,74.125.200.0-255,5738,12025,92,363037
37948,9.5e-05,172.31.47.0-255,66,12091,92,363037
37949,9.7e-05,74.125.200.0-255,1484,13575,92,363037
37950,9.9e-05,172.31.47.0-255,66,13641,92,363037
37951,0.000122,74.125.200.0-255,2089,15730,92,363037
37952,0.000125,172.31.47.0-255,66,15796,92,363037
37953,0.000159,74.125.200.0-255,5738,21534,92,363037
37954,0.000161,172.31.47.0-255,66,21600,92,363037
37955,0.000179,74.125.200.0-255,7156,28756,92,363037
37956,0.000181,172.31.47.0-255,66,28822,92,363037
37957,0.000203,74.125.200.0-255,2543,31365,92,363037
37958,0.000205,172.31.47.0-255,66,31431,92,363037
37959,0.000297,74.125.200.0-255,1484,32915,92,363037
37960,0.0003,172.31.47.0-255,66,32981,92,363037
37961,0.000317,74.125.200.0-255,2902,35883,92,363037
37962,0.00032,172.31.47.0-255,66,35949,92,363037
37963,0.000345,74.125.200.0-255,5738,41687,92,363037
37964,0.000348,172.31.47.0-255,66,41753,92,363037
37965,0.000351,74.125.200.0-255,1484,43237,92,363037
37966,0.000353,172.31.47.0-255,66,43303,92,363037
37967,0.000375,74.125.200.0-255,5379,48682,92,363037
37968,0.000379,172.31.47.0-255,66,48748,92,363037
37969,0.000385,74.125.200.0-255,7156,55904,92,363037
37970,0.000391,172.31.47.0-255,66,55970,92,363037
37971,0.000407,74.125.200.0-255,5738,61708,92,363037
37972,0.000416,172.31.47.0-255,66,61774,92,363037
37973,0.000419,74.125.200.0-255,2902,64676,92,363037
37974,0.000429,172.31.47.0-255,66,64742,92,363037
37975,0.000445,74.125.200.0-255,1404,66146,92,363037
37976,0.000477,74.125.200.0-255,129,66275,92,363037
37977,0.000538,74.125.200.0-255,1484,67759,92,363037
37978,0.000543,172.31.47.0-255,66,67825,92,363037
37979,0.000553,74.125.200.0-255,2902,70727,92,363037
37980,0.000559,172.31.47.0-255,66,70793,92,363037
37981,0.000564,74.125.200.0-255,2902,73695,92,363037
37982,0.000571,172.31.47.0-255,66,73761,92,363037
37983,0.000576,74.125.200.0-255,1484,75245,92,363037
37984,0.000589,74.125.200.0-255,2902,78147,92,363037
37985,0.000594,172.31.47.0-255,66,78213,92,363037
37986,0.000609,74.125.200.0-255,5738,83951,92,363037
37987,0.000615,74.125.200.0-255,5738,89689,92,363037
37988,0.000617,172.31.47.0-255,66,89755,92,363037
37989,0.000621,172.31.47.0-255,66,89821,92,363037
37990,0.000639,74.125.200.0-255,7156,96977,92,363037
37991,0.000642,172.31.47.0-255,66,97043,92,363037
37992,0.000664,74.125.200.0-255,3602,100645,92,363037
37993,0.000672,172.31.47.0-255,66,100711,92,363037
37994,0.000733,74.125.200.0-255,1484,102195,92,363037
37995,0.000744,74.125.200.0-255,2902,105097,92,363037
37996,0.000753,172.31.47.0-255,66,105163,92,363037
37997,0.000772,74.125.200.0-255,2902,108065,92,363037
37998,0.000775,172.31.47.0-255,66,108131,92,363037
37999,0.000804,74.125.200.0-255,2902,111033,92,363037
38000,0.000812,172.31.47.0-255,66,111099,92,363037
38001,0.00083,74.125.200.0-255,1484,112583,92,363037
38002,0.000843,172.31.47.0-255,66,112649,92,363037
38003,0.000847,172.31.47.0-255,66,112715,92,363037
38004,0.000865,74.125.200.0-255,2902,115617,92,363037
38005,0.000869,172.31.47.0-255,66,115683,92,363037
38006,0.000881,74.125.200.0-255,1882,117565,92,363037
38007,0.00089,172.31.47.0-255,66,117631,92,363037
38008,0.000941,74.125.200.0-255,1484,119115,92,363037
38009,0.000953,74.125.200.0-255,2902,122017,92,363037
38010,0.000956,172.31.47.0-255,66,122083,92,363037
38011,0.000959,74.125.200.0-255,1484,123567,92,363037
38012,0.000976,74.125.200.0-255,2902,126469,92,363037
38013,0.000978,74.125.200.0-255,1484,127953,92,363037
38014,0.000987,172.31.47.0-255,66,128019,92,363037
38015,0.000999,74.125.200.0-255,4320,132339,92,363037
38016,0.00101,172.31.47.0-255,66,132405,92,363037
38017,0.001018,74.125.200.0-255,1484,133889,92,363037
38018,0.001055,172.31.47.0-255,66,133955,92,363037
38019,0.001074,74.125.200.0-255,1484,135439,92,363037
38020,0.001094,74.125.200.0-255,6438,141877,92,363037
38021,0.001097,172.31.47.0-255,66,141943,92,363037
38022,0.0011,74.125.200.0-255,1484,143427,92,363037
38023,0.001119,74.125.200.0-255,7156,150583,92,363037
38024,0.001123,74.125.200.0-255,4320,154903,92,363037
38025,0.001124,172.31.47.0-255,66,154969,92,363037
38026,0.001128,172.31.47.0-255,66,155035,92,363037
38027,0.001147,74.125.200.0-255,5738,160773,92,363037
38028,0.001179,74.125.200.0-255,3602,164375,92,363037
38029,0.001223,74.125.200.0-255,2902,167277,92,363037
38030,0.001276,74.125.200.0-255,4320,171597,92,363037
38031,0.001311,74.125.200.0-255,2184,173781,92,363037
38032,0.001343,74.125.200.0-255,1484,175265,92,363037
38033,0.001364,74.125.200.0-255,2902,178167,92,363037
38034,0.001367,74.125.200.0-255,1484,179651,92,363037
38035,0.001388,74.125.200.0-255,2902,182553,92,363037
38036,0.001399,74.125.200.0-255,2902,185455,92,363037
38037,0.001412,74.125.200.0-255,2902,188357,92,363037
38038,0.00144,74.125.200.0-255,5738,194095,92,363037
38039,0.001458,74.125.200.0-255,7156,201251,92,363037
38040,0.001484,74.125.200.0-255,6438,207689,92,363037
38041,0.001535,74.125.200.0-255,1484,209173,92,363037
38042,0.001539,74.125.200.0-255,2902,212075,92,363037
38043,0.001555,74.125.200.0-255,2902,214977,92,363037
38044,0.001566,74.125.200.0-255,2902,217879,92,363037
38045,0.001569,74.125.200.0-255,2902,220781,92,363037
38046,0.001586,74.125.200.0-255,1484,222265,92,363037
38047,0.001591,74.125.200.0-255,5738,228003,92,363037
38048,0.001628,74.125.200.0-255,2184,230187,92,363037
38049,0.00168,74.125.200.0-255,7156,237343,92,363037
38050,0.001696,74.125.200.0-255,1484,238827,92,363037
38051,0.001702,74.125.200.0-255,5738,244565,92,363037
38052,0.001714,74.125.200.0-255,4320,248885,92,363037
38053,0.001731,74.125.200.0-255,7156,256041,92,363037
38054,0.001744,74.125.200.0-255,4320,260361,92,363037
38055,0.001769,74.125.200.0-255,3602,263963,92,363037
38056,0.001824,74.125.200.0-255,1484,265447,92,363037
38057,0.001838,74.125.200.0-255,1484,266931,92,363037
38058,0.001843,74.125.200.0-255,4320,271251,92,363037
38059,0.001857,74.125.200.0-255,1484,272735,92,363037
38060,0.001877,74.125.200.0-255,7156,279891,92,363037
38061,0.001881,74.125.200.0-255,4320,284211,92,363037
38062,0.001884,74.125.200.0-255,2902,287113,92,363037
38063,0.001898,74.125.200.0-255,2902,290015,92,363037
38064,0.001929,74.125.200.0-255,4320,294335,92,363037
38065,0.001941,74.125.200.0-255,3602,297937,92,363037
38066,0.001986,74.125.200.0-255,1484,299421,92,363037
38067,0.002003,74.125.200.0-255,2902,302323,92,363037
38068,0.002005,74.125.200.0-255,1484,303807,92,363037
38069,0.002015,74.125.200.0-255,2902,306709,92,363037
38070,0.002032,74.125.200.0-255,1484,308193,92,363037
38071,0.002036,74.125.200.0-255,5738,313931,92,363037
38072,0.002053,74.125.200.0-255,4320,318251,92,363037
38073,0.002065,74.125.200.0-255,2902,321153,92,363037
38074,0.002081,74.125.200.0-255,2902,324055,92,363037
38075,0.002094,74.125.200.0-255,4320,328375,92,363037
38076,0.002125,74.125.200.0-255,1484,329859,92,363037
38077,0.00214,74.125.200.0-255,2184,332043,92,363037
38078,0.002158,74.125.200.0-255,1484,333527,92,363037
38079,0.002168,74.125.200.0-255,2902,336429,92,363037
38080,0.002189,74.125.200.0-255,5738,342167,92,363037
38081,0.002214,74.125.200.0-255,7156,349323,92,363037
38082,0.002228,74.125.200.0-255,2902,352225,92,363037
38083,0.002241,74.125.200.0-255,1437,353662,92,363037
38084,0.002257,74.125.200.0-255,105,353767,92,363037
38085,0.004635,172.31.47.0-255,66,353833,92,363037
38086,0.007053,172.31.47.0-255,105,353938,92,363037
38087,0.009653,74.125.200.0-255,66,354004,92,363037
38088,0.030642,172.31.47.0-255,172,354176,92,363037
38089,0.03067,172.31.47.0-255,1107,355283,92,363037
38090,0.030706,172.31.47.0-255,1514,356797,92,363037
38091,0.030707,172.31.47.0-255,1514,358311,92,363037
38092,0.030708,172.31.47.0-255,1514,359825,92,363037
38093,0.030709,172.31.47.0-255,1514,361339,92,363037
38094,0.030711,172.31.47.0-255,1500,362839,92,363037
38095,0.032212,104.244.42.0-255,66,362905,92,363037
38096,0.032254,104.244.42.0-255,66,362971,92,363037
38097,0.032328,104.244.42.0-255,66,363037,92,363037
38098,0.0,74.125.24.0-255,152,152,92,239022
38099,2.7e-05,172.31.47.0-255,66,218,92,239022
38100,3.4e-05,74.125.24.0-255,1484,1702,92,239022
38101,3.9e-05,172.31.47.0-255,66,1768,92,239022
38102,4.4e-05,74.125.24.0-255,2902,4670,92,239022
38103,4.6e-05,172.31.47.0-255,66,4736,92,239022
38104,5.1e-05,74.125.24.0-255,2902,7638,92,239022
38105,5.4e-05,172.31.47.0-255,66,7704,92,239022
38106,7.7e-05,74.125.24.0-255,2902,10606,92,239022
38107,8e-05,172.31.47.0-255,66,10672,92,239022
38108,8.4e-05,74.125.24.0-255,2902,13574,92,239022
38109,8.6e-05,172.31.47.0-255,66,13640,92,239022
38110,0.000101,74.125.24.0-255,3465,17105,92,239022
38111,0.000104,172.31.47.0-255,66,17171,92,239022
38112,0.000109,74.125.24.0-255,4320,21491,92,239022
38113,0.000111,172.31.47.0-255,66,21557,92,239022
38114,0.000134,74.125.24.0-255,4320,25877,92,239022
38115,0.000137,172.31.47.0-255,66,25943,92,239022
38116,0.000162,74.125.24.0-255,5379,31322,92,239022
38117,0.000165,172.31.47.0-255,66,31388,92,239022
38118,0.000283,74.125.24.0-255,1484,32872,92,239022
38119,0.000288,172.31.47.0-255,66,32938,92,239022
38120,0.000294,74.125.24.0-255,2902,35840,92,239022
38121,0.000297,172.31.47.0-255,66,35906,92,239022
38122,0.000319,74.125.24.0-255,2902,38808,92,239022
38123,0.000322,172.31.47.0-255,66,38874,92,239022
38124,0.000328,74.125.24.0-255,4320,43194,92,239022
38125,0.000331,172.31.47.0-255,66,43260,92,239022
38126,0.000344,74.125.24.0-255,2902,46162,92,239022
38127,0.000347,172.31.47.0-255,66,46228,92,239022
38128,0.000366,74.125.24.0-255,5738,51966,92,239022
38129,0.000369,172.31.47.0-255,66,52032,92,239022
38130,0.000387,74.125.24.0-255,5738,57770,92,239022
38131,0.00039,172.31.47.0-255,66,57836,92,239022
38132,0.000432,172.31.47.0-255,66,57902,92,239022
38133,0.00048,74.125.24.0-255,115,58017,92,239022
38134,0.000622,74.125.24.0-255,1484,59501,92,239022
38135,0.000628,172.31.47.0-255,66,59567,92,239022
38136,0.000635,74.125.24.0-255,2902,62469,92,239022
38137,0.000638,172.31.47.0-255,66,62535,92,239022
38138,0.000653,74.125.24.0-255,4320,66855,92,239022
38139,0.000656,172.31.47.0-255,66,66921,92,239022
38140,0.000678,74.125.24.0-255,1484,68405,92,239022
38141,0.000684,74.125.24.0-255,2902,71307,92,239022
38142,0.000686,172.31.47.0-255,66,71373,92,239022
38143,0.000696,172.31.47.0-255,66,71439,92,239022
38144,0.000716,74.125.24.0-255,1484,72923,92,239022
38145,0.000724,74.125.24.0-255,7156,80079,92,239022
38146,0.000726,172.31.47.0-255,66,80145,92,239022
38147,0.000745,74.125.24.0-255,3602,83747,92,239022
38148,0.000748,172.31.47.0-255,66,83813,92,239022
38149,0.000751,74.125.24.0-255,330,84143,92,239022
38150,0.001021,172.31.47.0-255,66,84209,92,239022
38151,0.00105,74.125.24.0-255,1484,85693,92,239022
38152,0.001064,74.125.24.0-255,2902,88595,92,239022
38153,0.001066,172.31.47.0-255,66,88661,92,239022
38154,0.001076,74.125.24.0-255,1484,90145,92,239022
38155,0.001088,74.125.24.0-255,4320,94465,92,239022
38156,0.001091,172.31.47.0-255,66,94531,92,239022
38157,0.001109,74.125.24.0-255,1484,96015,92,239022
38158,0.001134,172.31.47.0-255,66,96081,92,239022
38159,0.00114,74.125.24.0-255,5738,101819,92,239022
38160,0.001143,172.31.47.0-255,66,101885,92,239022
38161,0.001173,74.125.24.0-255,1484,103369,92,239022
38162,0.001185,74.125.24.0-255,3602,106971,92,239022
38163,0.001188,172.31.47.0-255,66,107037,92,239022
38164,0.001398,74.125.24.0-255,1484,108521,92,239022
38165,0.001419,74.125.24.0-255,2902,111423,92,239022
38166,0.001423,172.31.47.0-255,66,111489,92,239022
38167,0.00143,74.125.24.0-255,5738,117227,92,239022
38168,0.001432,172.31.47.0-255,66,117293,92,239022
38169,0.001437,74.125.24.0-255,4320,121613,92,239022
38170,0.001439,172.31.47.0-255,66,121679,92,239022
38171,0.001459,74.125.24.0-255,1484,123163,92,239022
38172,0.001494,172.31.47.0-255,66,123229,92,239022
38173,0.001535,74.125.24.0-255,3602,126831,92,239022
38174,0.00154,172.31.47.0-255,66,126897,92,239022
38175,0.00157,74.125.24.0-255,1484,128381,92,239022
38176,0.001583,74.125.24.0-255,2902,131283,92,239022
38177,0.001585,172.31.47.0-255,66,131349,92,239022
38178,0.00159,74.125.24.0-255,2902,134251,92,239022
38179,0.001592,172.31.47.0-255,66,134317,92,239022
38180,0.001596,74.125.24.0-255,2902,137219,92,239022
38181,0.001597,172.31.47.0-255,66,137285,92,239022
38182,0.001617,74.125.24.0-255,5738,143023,92,239022
38183,0.001619,172.31.47.0-255,66,143089,92,239022
38184,0.001654,74.125.24.0-255,7156,150245,92,239022
38185,0.001657,172.31.47.0-255,66,150311,92,239022
38186,0.001679,172.31.47.0-255,66,150377,92,239022
38187,0.002119,74.125.24.0-255,1484,151861,92,239022
38188,0.002124,74.125.24.0-255,1484,153345,92,239022
38189,0.002128,172.31.47.0-255,66,153411,92,239022
38190,0.002145,74.125.24.0-255,1484,154895,92,239022
38191,0.002152,74.125.24.0-255,5738,160633,92,239022
38192,0.002154,172.31.47.0-255,66,160699,92,239022
38193,0.002165,74.125.24.0-255,4320,165019,92,239022
38194,0.002167,172.31.47.0-255,66,165085,92,239022
38195,0.002187,172.31.47.0-255,66,165151,92,239022
38196,0.00219,74.125.24.0-255,1484,166635,92,239022
38197,0.002218,172.31.47.0-255,66,166701,92,239022
38198,0.002258,74.125.24.0-255,1484,168185,92,239022
38199,0.00227,74.125.24.0-255,2902,171087,92,239022
38200,0.002272,172.31.47.0-255,66,171153,92,239022
38201,0.002287,74.125.24.0-255,4320,175473,92,239022
38202,0.002289,172.31.47.0-255,66,175539,92,239022
38203,0.002302,74.125.24.0-255,1484,177023,92,239022
38204,0.002305,74.125.24.0-255,1484,178507,92,239022
38205,0.002306,172.31.47.0-255,66,178573,92,239022
38206,0.002359,74.125.24.0-255,5738,184311,92,239022
38207,0.002362,172.31.47.0-255,66,184377,92,239022
38208,0.002374,172.31.47.0-255,66,184443,92,239022
38209,0.00238,74.125.24.0-255,6438,190881,92,239022
38210,0.002382,172.31.47.0-255,66,190947,92,239022
38211,0.002385,74.125.24.0-255,2902,193849,92,239022
38212,0.002387,172.31.47.0-255,66,193915,92,239022
38213,0.002425,172.31.47.0-255,66,193981,92,239022
38214,0.002472,74.125.24.0-255,6438,200419,92,239022
38215,0.002475,172.31.47.0-255,66,200485,92,239022
38216,0.002479,74.125.24.0-255,2902,203387,92,239022
38217,0.002481,172.31.47.0-255,66,203453,92,239022
38218,0.002504,172.31.47.0-255,66,203519,92,239022
38219,0.002531,172.31.47.0-255,66,203585,92,239022
38220,0.002602,74.125.24.0-255,5738,209323,92,239022
38221,0.002606,172.31.47.0-255,66,209389,92,239022
38222,0.002641,172.31.47.0-255,66,209455,92,239022
38223,0.002692,74.125.24.0-255,5738,215193,92,239022
38224,0.002696,172.31.47.0-255,66,215259,92,239022
38225,0.002726,172.31.47.0-255,66,215325,92,239022
38226,0.002741,74.125.24.0-255,2184,217509,92,239022
38227,0.002744,172.31.47.0-255,66,217575,92,239022
38228,0.002777,74.125.24.0-255,2902,220477,92,239022
38229,0.00278,172.31.47.0-255,66,220543,92,239022
38230,0.002813,172.31.47.0-255,66,220609,92,239022
38231,0.002841,172.31.47.0-255,66,220675,92,239022
38232,0.005373,74.125.24.0-255,5738,226413,92,239022
38233,0.005378,172.31.47.0-255,66,226479,92,239022
38234,0.007921,74.125.24.0-255,3206,229685,92,239022
38235,0.007924,172.31.47.0-255,66,229751,92,239022
38236,0.008473,172.31.47.0-255,105,229856,92,239022
38237,0.011027,74.125.24.0-255,66,229922,92,239022
38238,0.028279,172.31.47.0-255,172,230094,92,239022
38239,0.028306,172.31.47.0-255,1112,231206,92,239022
38240,0.028359,172.31.47.0-255,1514,232720,92,239022
38241,0.02836,172.31.47.0-255,1514,234234,92,239022
38242,0.028365,172.31.47.0-255,1514,235748,92,239022
38243,0.028366,172.31.47.0-255,1514,237262,92,239022
38244,0.028392,172.31.47.0-255,1496,238758,92,239022
38245,0.029769,104.244.42.0-255,66,238824,92,239022
38246,0.029877,104.244.42.0-255,66,238890,92,239022
38247,0.029882,104.244.42.0-255,66,238956,92,239022
38248,0.029981,104.244.42.0-255,66,239022,92,239022
38249,0.0,172.217.194.0-255,153,153,92,263859
38250,2.7e-05,172.31.47.0-255,66,219,92,263859
38251,3.4e-05,172.217.194.0-255,1484,1703,92,263859
38252,3.8e-05,172.31.47.0-255,66,1769,92,263859
38253,4.3e-05,172.217.194.0-255,2902,4671,92,263859
38254,4.6e-05,172.31.47.0-255,66,4737,92,263859
38255,5.3e-05,172.217.194.0-255,7156,11893,92,263859
38256,5.6e-05,172.31.47.0-255,66,11959,92,263859
38257,6e-05,172.217.194.0-255,2108,14067,92,263859
38258,6.2e-05,172.31.47.0-255,66,14133,92,263859
38259,6.6e-05,172.217.194.0-255,1484,15617,92,263859
38260,6.7e-05,172.31.47.0-255,66,15683,92,263859
38261,0.000107,172.31.47.0-255,66,15749,92,263859
38262,0.000113,172.217.194.0-255,5379,21128,92,263859
38263,0.000116,172.31.47.0-255,66,21194,92,263859
38264,0.000264,172.217.194.0-255,1484,22678,92,263859
38265,0.000269,172.31.47.0-255,66,22744,92,263859
38266,0.000274,172.217.194.0-255,2902,25646,92,263859
38267,0.000277,172.31.47.0-255,66,25712,92,263859
38268,0.000283,172.217.194.0-255,5738,31450,92,263859
38269,0.000285,172.31.47.0-255,66,31516,92,263859
38270,0.000288,172.217.194.0-255,1484,33000,92,263859
38271,0.000291,172.31.47.0-255,66,33066,92,263859
38272,0.00031,172.217.194.0-255,4320,37386,92,263859
38273,0.000313,172.31.47.0-255,66,37452,92,263859
38274,0.000327,172.217.194.0-255,1484,38936,92,263859
38275,0.000329,172.31.47.0-255,66,39002,92,263859
38276,0.000364,172.31.47.0-255,66,39068,92,263859
38277,0.00037,172.217.194.0-255,3961,43029,92,263859
38278,0.000372,172.31.47.0-255,66,43095,92,263859
38279,0.000375,172.217.194.0-255,378,43473,92,263859
38280,0.000778,172.31.47.0-255,66,43539,92,263859
38281,0.000818,172.217.194.0-255,365,43904,92,263859
38282,0.000842,172.31.47.0-255,66,43970,92,263859
38283,0.001053,172.217.194.0-255,1484,45454,92,263859
38284,0.001063,172.217.194.0-255,2902,48356,92,263859
38285,0.001066,172.31.47.0-255,66,48422,92,263859
38286,0.001071,172.217.194.0-255,1484,49906,92,263859
38287,0.001089,172.217.194.0-255,4320,54226,92,263859
38288,0.001091,172.31.47.0-255,66,54292,92,263859
38289,0.001096,172.217.194.0-255,2902,57194,92,263859
38290,0.001098,172.31.47.0-255,66,57260,92,263859
38291,0.00112,172.31.47.0-255,66,57326,92,263859
38292,0.001126,172.217.194.0-255,4320,61646,92,263859
38293,0.001128,172.31.47.0-255,66,61712,92,263859
38294,0.001154,172.217.194.0-255,6438,68150,92,263859
38295,0.001157,172.31.47.0-255,66,68216,92,263859
38296,0.001472,172.217.194.0-255,1484,69700,92,263859
38297,0.00148,172.217.194.0-255,2902,72602,92,263859
38298,0.001484,172.31.47.0-255,66,72668,92,263859
38299,0.001491,172.217.194.0-255,5738,78406,92,263859
38300,0.001493,172.31.47.0-255,66,78472,92,263859
38301,0.001514,172.217.194.0-255,2902,81374,92,263859
38302,0.001516,172.31.47.0-255,66,81440,92,263859
38303,0.001539,172.31.47.0-255,66,81506,92,263859
38304,0.001624,172.217.194.0-255,4320,85826,92,263859
38305,0.001627,172.31.47.0-255,66,85892,92,263859
38306,0.001648,172.217.194.0-255,6438,92330,92,263859
38307,0.00165,172.31.47.0-255,66,92396,92,263859
38308,0.001679,172.217.194.0-255,1484,93880,92,263859
38309,0.001692,172.217.194.0-255,2902,96782,92,263859
38310,0.001695,172.31.47.0-255,66,96848,92,263859
38311,0.001715,172.217.194.0-255,5738,102586,92,263859
38312,0.001717,172.31.47.0-255,66,102652,92,263859
38313,0.001722,172.217.194.0-255,4320,106972,92,263859
38314,0.001724,172.31.47.0-255,66,107038,92,263859
38315,0.00174,172.217.194.0-255,4320,111358,92,263859
38316,0.001742,172.31.47.0-255,66,111424,92,263859
38317,0.001783,172.31.47.0-255,66,111490,92,263859
38318,0.001804,172.217.194.0-255,6438,117928,92,263859
38319,0.001806,172.31.47.0-255,66,117994,92,263859
38320,0.004145,172.217.194.0-255,5738,123732,92,263859
38321,0.004149,172.31.47.0-255,66,123798,92,263859
38322,0.00648,172.217.194.0-255,2902,126700,92,263859
38323,0.006483,172.31.47.0-255,66,126766,92,263859
38324,0.006495,172.217.194.0-255,2902,129668,92,263859
38325,0.006497,172.31.47.0-255,66,129734,92,263859
38326,0.008776,172.217.194.0-255,5738,135472,92,263859
38327,0.008784,172.31.47.0-255,66,135538,92,263859
38328,0.011142,172.217.194.0-255,5738,141276,92,263859
38329,0.011149,172.31.47.0-255,66,141342,92,263859
38330,0.013498,172.217.194.0-255,5738,147080,92,263859
38331,0.013506,172.31.47.0-255,66,147146,92,263859
38332,0.015826,172.217.194.0-255,5738,152884,92,263859
38333,0.015833,172.31.47.0-255,66,152950,92,263859
38334,0.018151,172.217.194.0-255,5738,158688,92,263859
38335,0.01816,172.31.47.0-255,66,158754,92,263859
38336,0.020465,172.217.194.0-255,5738,164492,92,263859
38337,0.020472,172.31.47.0-255,66,164558,92,263859
38338,0.022839,172.217.194.0-255,5738,170296,92,263859
38339,0.022845,172.31.47.0-255,66,170362,92,263859
38340,0.025154,172.217.194.0-255,5738,176100,92,263859
38341,0.025162,172.31.47.0-255,66,176166,92,263859
38342,0.027319,172.31.47.0-255,172,176338,92,263859
38343,0.02735,172.31.47.0-255,1103,177441,92,263859
38344,0.02738,172.31.47.0-255,1514,178955,92,263859
38345,0.027381,172.31.47.0-255,1514,180469,92,263859
38346,0.027383,172.31.47.0-255,1514,181983,92,263859
38347,0.027383,172.31.47.0-255,1514,183497,92,263859
38348,0.027385,172.31.47.0-255,1504,185001,92,263859
38349,0.027473,172.217.194.0-255,4320,189321,92,263859
38350,0.027478,172.31.47.0-255,66,189387,92,263859
38351,0.027509,172.217.194.0-255,1484,190871,92,263859
38352,0.028871,104.244.42.0-255,66,190937,92,263859
38353,0.028918,104.244.42.0-255,66,191003,92,263859
38354,0.029003,104.244.42.0-255,66,191069,92,263859
38355,0.029607,104.244.42.0-255,108,191177,92,263859
38356,0.029611,172.31.47.0-255,66,191243,92,263859
38357,0.029793,172.217.194.0-255,2902,194145,92,263859
38358,0.029797,172.31.47.0-255,66,194211,92,263859
38359,0.03209,172.217.194.0-255,5738,199949,92,263859
38360,0.032096,172.31.47.0-255,66,200015,92,263859
38361,0.034451,172.217.194.0-255,5738,205753,92,263859
38362,0.034458,172.31.47.0-255,66,205819,92,263859
38363,0.036785,172.217.194.0-255,5738,211557,92,263859
38364,0.036805,172.31.47.0-255,66,211623,92,263859
38365,0.039167,172.217.194.0-255,5738,217361,92,263859
38366,0.039181,172.31.47.0-255,66,217427,92,263859
38367,0.04152,172.217.194.0-255,5738,223165,92,263859
38368,0.041539,172.31.47.0-255,66,223231,92,263859
38369,0.043874,172.217.194.0-255,5738,228969,92,263859
38370,0.043889,172.31.47.0-255,66,229035,92,263859
38371,0.046251,172.217.194.0-255,5738,234773,92,263859
38372,0.046267,172.31.47.0-255,66,234839,92,263859
38373,0.048597,172.217.194.0-255,5738,240577,92,263859
38374,0.048616,172.31.47.0-255,66,240643,92,263859
38375,0.050943,172.217.194.0-255,5738,246381,92,263859
38376,0.050957,172.31.47.0-255,66,246447,92,263859
38377,0.053314,172.217.194.0-255,5738,252185,92,263859
38378,0.053331,172.31.47.0-255,66,252251,92,263859
38379,0.055695,172.217.194.0-255,5738,257989,92,263859
38380,0.055714,172.31.47.0-255,66,258055,92,263859
38381,0.058028,172.217.194.0-255,5738,263793,92,263859
38382,0.058035,172.31.47.0-255,66,263859,92,263859
38383,0.0,172.217.194.0-255,153,153,92,219744
38384,3.5e-05,172.31.47.0-255,66,219,92,219744
38385,4.1e-05,172.217.194.0-255,1484,1703,92,219744
38386,4.6e-05,172.31.47.0-255,66,1769,92,219744
38387,5e-05,172.217.194.0-255,2902,4671,92,219744
38388,5.3e-05,172.31.47.0-255,66,4737,92,219744
38389,6.8e-05,172.217.194.0-255,7156,11893,92,219744
38390,7.1e-05,172.31.47.0-255,66,11959,92,219744
38391,8.3e-05,172.31.47.0-255,66,12025,92,219744
38392,0.000127,172.217.194.0-255,7156,19181,92,219744
38393,0.00013,172.31.47.0-255,66,19247,92,219744
38394,0.000159,172.217.194.0-255,1125,20372,92,219744
38395,0.000162,172.31.47.0-255,66,20438,92,219744
38396,0.000174,172.31.47.0-255,66,20504,92,219744
38397,0.000187,172.31.47.0-255,66,20570,92,219744
38398,0.000207,172.217.194.0-255,1484,22054,92,219744
38399,0.00021,172.31.47.0-255,66,22120,92,219744
38400,0.000236,172.217.194.0-255,7156,29276,92,219744
38401,0.000239,172.31.47.0-255,66,29342,92,219744
38402,0.00025,172.31.47.0-255,66,29408,92,219744
38403,0.000252,172.217.194.0-255,361,29769,92,219744
38404,0.000255,172.31.47.0-255,66,29835,92,219744
38405,0.000328,172.217.194.0-255,1484,31319,92,219744
38406,0.000332,172.31.47.0-255,66,31385,92,219744
38407,0.000358,172.217.194.0-255,2902,34287,92,219744
38408,0.000363,172.31.47.0-255,66,34353,92,219744
38409,0.000396,172.217.194.0-255,2902,37255,92,219744
38410,0.000399,172.31.47.0-255,66,37321,92,219744
38411,0.000422,172.217.194.0-255,2902,40223,92,219744
38412,0.000425,172.31.47.0-255,66,40289,92,219744
38413,0.000432,172.217.194.0-255,6533,46822,92,219744
38414,0.000435,172.31.47.0-255,66,46888,92,219744
38415,0.000669,172.217.194.0-255,1484,48372,92,219744
38416,0.000676,172.217.194.0-255,2902,51274,92,219744
38417,0.000679,172.31.47.0-255,66,51340,92,219744
38418,0.000685,172.217.194.0-255,2902,54242,92,219744
38419,0.000687,172.31.47.0-255,66,54308,92,219744
38420,0.00071,172.217.194.0-255,2902,57210,92,219744
38421,0.000713,172.31.47.0-255,66,57276,92,219744
38422,0.000732,172.31.47.0-255,66,57342,92,219744
38423,0.000735,172.217.194.0-255,1484,58826,92,219744
38424,0.000768,172.31.47.0-255,66,58892,92,219744
38425,0.000991,172.217.194.0-255,1484,60376,92,219744
38426,0.000995,172.217.194.0-255,1484,61860,92,219744
38427,0.000999,172.31.47.0-255,66,61926,92,219744
38428,0.001025,172.217.194.0-255,1484,63410,92,219744
38429,0.001032,172.217.194.0-255,5738,69148,92,219744
38430,0.001035,172.31.47.0-255,66,69214,92,219744
38431,0.001039,172.217.194.0-255,1484,70698,92,219744
38432,0.001062,172.217.194.0-255,5738,76436,92,219744
38433,0.001065,172.31.47.0-255,66,76502,92,219744
38434,0.001117,172.31.47.0-255,66,76568,92,219744
38435,0.001122,172.217.194.0-255,2184,78752,92,219744
38436,0.001124,172.31.47.0-255,66,78818,92,219744
38437,0.001177,172.217.194.0-255,1484,80302,92,219744
38438,0.001182,172.217.194.0-255,2902,83204,92,219744
38439,0.001185,172.31.47.0-255,66,83270,92,219744
38440,0.001216,172.217.194.0-255,5738,89008,92,219744
38441,0.001224,172.31.47.0-255,66,89074,92,219744
38442,0.001247,172.31.47.0-255,66,89140,92,219744
38443,0.001278,172.217.194.0-255,2902,92042,92,219744
38444,0.001281,172.31.47.0-255,66,92108,92,219744
38445,0.001288,172.217.194.0-255,7156,99264,92,219744
38446,0.00129,172.31.47.0-255,66,99330,92,219744
38447,0.001301,172.217.194.0-255,3602,102932,92,219744
38448,0.001303,172.31.47.0-255,66,102998,92,219744
38449,0.001333,172.217.194.0-255,4320,107318,92,219744
38450,0.001337,172.31.47.0-255,66,107384,92,219744
38451,0.001348,172.31.47.0-255,66,107450,92,219744
38452,0.001351,172.217.194.0-255,1484,108934,92,219744
38453,0.001389,172.31.47.0-255,66,109000,92,219744
38454,0.001421,172.217.194.0-255,1484,110484,92,219744
38455,0.001434,172.31.47.0-255,66,110550,92,219744
38456,0.001439,172.31.47.0-255,66,110616,92,219744
38457,0.001445,172.217.194.0-255,5738,116354,92,219744
38458,0.001447,172.31.47.0-255,66,116420,92,219744
38459,0.00149,172.31.47.0-255,66,116486,92,219744
38460,0.001495,172.217.194.0-255,4320,120806,92,219744
38461,0.001497,172.31.47.0-255,66,120872,92,219744
38462,0.001535,172.217.194.0-255,5020,125892,92,219744
38463,0.001539,172.31.47.0-255,66,125958,92,219744
38464,0.001555,172.31.47.0-255,66,126024,92,219744
38465,0.001631,172.31.47.0-255,66,126090,92,219744
38466,0.001639,172.217.194.0-255,7156,133246,92,219744
38467,0.001643,172.31.47.0-255,66,133312,92,219744
38468,0.00165,172.217.194.0-255,6438,139750,92,219744
38469,0.001653,172.31.47.0-255,66,139816,92,219744
38470,0.001659,172.217.194.0-255,7156,146972,92,219744
38471,0.001662,172.31.47.0-255,66,147038,92,219744
38472,0.001679,172.31.47.0-255,66,147104,92,219744
38473,0.001694,172.31.47.0-255,66,147170,92,219744
38474,0.001713,172.217.194.0-255,1484,148654,92,219744
38475,0.001719,172.217.194.0-255,2902,151556,92,219744
38476,0.001722,172.31.47.0-255,66,151622,92,219744
38477,0.001728,172.217.194.0-255,5738,157360,92,219744
38478,0.00173,172.31.47.0-255,66,157426,92,219744
38479,0.001761,172.217.194.0-255,7156,164582,92,219744
38480,0.001766,172.31.47.0-255,66,164648,92,219744
38481,0.001803,172.217.194.0-255,5738,170386,92,219744
38482,0.001807,172.31.47.0-255,66,170452,92,219744
38483,0.001814,172.217.194.0-255,7156,177608,92,219744
38484,0.001816,172.31.47.0-255,66,177674,92,219744
38485,0.001821,172.217.194.0-255,3602,181276,92,219744
38486,0.001824,172.31.47.0-255,66,181342,92,219744
38487,0.001917,172.217.194.0-255,1484,182826,92,219744
38488,0.001939,172.217.194.0-255,2902,185728,92,219744
38489,0.001943,172.31.47.0-255,66,185794,92,219744
38490,0.00195,172.217.194.0-255,5738,191532,92,219744
38491,0.001953,172.31.47.0-255,66,191598,92,219744
38492,0.001963,172.217.194.0-255,2902,194500,92,219744
38493,0.001966,172.31.47.0-255,66,194566,92,219744
38494,0.002021,172.31.47.0-255,66,194632,92,219744
38495,0.002033,172.31.47.0-255,66,194698,92,219744
38496,0.002036,172.217.194.0-255,766,195464,92,219744
38497,0.002039,172.217.194.0-255,1484,196948,92,219744
38498,0.002042,172.31.47.0-255,66,197014,92,219744
38499,0.002073,172.217.194.0-255,4320,201334,92,219744
38500,0.002078,172.31.47.0-255,66,201400,92,219744
38501,0.002089,172.31.47.0-255,66,201466,92,219744
38502,0.002123,172.217.194.0-255,1484,202950,92,219744
38503,0.002135,172.31.47.0-255,66,203016,92,219744
38504,0.002139,172.217.194.0-255,1484,204500,92,219744
38505,0.002165,172.217.194.0-255,5738,210238,92,219744
38506,0.002168,172.31.47.0-255,66,210304,92,219744
38507,0.002212,172.31.47.0-255,66,210370,92,219744
38508,0.002215,172.217.194.0-255,105,210475,92,219744
38509,0.003705,172.31.47.0-255,66,210541,92,219744
38510,0.003732,172.31.47.0-255,105,210646,92,219744
38511,0.006303,172.217.194.0-255,66,210712,92,219744
38512,0.036494,172.31.47.0-255,172,210884,92,219744
38513,0.036523,172.31.47.0-255,1112,211996,92,219744
38514,0.036572,172.31.47.0-255,1514,213510,92,219744
38515,0.036573,172.31.47.0-255,1514,215024,92,219744
38516,0.036596,172.31.47.0-255,1514,216538,92,219744
38517,0.036598,172.31.47.0-255,1514,218052,92,219744
38518,0.0366,172.31.47.0-255,1494,219546,92,219744
38519,0.038049,104.244.42.0-255,66,219612,92,219744
38520,0.038093,104.244.42.0-255,66,219678,92,219744
38521,0.038197,104.244.42.0-255,66,219744,92,219744
38522,0.0,74.125.24.0-255,153,153,92,263311
38523,2.4e-05,172.31.47.0-255,66,219,92,263311
38524,3.1e-05,74.125.24.0-255,1484,1703,92,263311
38525,3.5e-05,172.31.47.0-255,66,1769,92,263311
38526,4.1e-05,74.125.24.0-255,2902,4671,92,263311
38527,4.4e-05,172.31.47.0-255,66,4737,92,263311
38528,5.2e-05,74.125.24.0-255,7156,11893,92,263311
38529,5.5e-05,172.31.47.0-255,66,11959,92,263311
38530,5.9e-05,74.125.24.0-255,2166,14125,92,263311
38531,6.2e-05,172.31.47.0-255,66,14191,92,263311
38532,0.00031,74.125.24.0-255,1484,15675,92,263311
38533,0.000315,172.31.47.0-255,66,15741,92,263311
38534,0.000322,74.125.24.0-255,2902,18643,92,263311
38535,0.000324,172.31.47.0-255,66,18709,92,263311
38536,0.000329,74.125.24.0-255,2902,21611,92,263311
38537,0.000332,172.31.47.0-255,66,21677,92,263311
38538,0.000354,74.125.24.0-255,2902,24579,92,263311
38539,0.000357,172.31.47.0-255,66,24645,92,263311
38540,0.000375,74.125.24.0-255,1484,26129,92,263311
38541,0.000378,172.31.47.0-255,66,26195,92,263311
38542,0.000409,172.31.47.0-255,66,26261,92,263311
38543,0.000437,74.125.24.0-255,5738,31999,92,263311
38544,0.000439,172.31.47.0-255,66,32065,92,263311
38545,0.000455,74.125.24.0-255,3961,36026,92,263311
38546,0.000457,172.31.47.0-255,66,36092,92,263311
38547,0.001237,74.125.24.0-255,1484,37576,92,263311
38548,0.001243,172.31.47.0-255,66,37642,92,263311
38549,0.001252,74.125.24.0-255,2902,40544,92,263311
38550,0.001254,172.31.47.0-255,66,40610,92,263311
38551,0.00126,74.125.24.0-255,5738,46348,92,263311
38552,0.001263,172.31.47.0-255,66,46414,92,263311
38553,0.001289,74.125.24.0-255,2902,49316,92,263311
38554,0.001292,172.31.47.0-255,66,49382,92,263311
38555,0.001312,172.31.47.0-255,66,49448,92,263311
38556,0.001324,172.31.47.0-255,66,49514,92,263311
38557,0.00135,74.125.24.0-255,2902,52416,92,263311
38558,0.001353,172.31.47.0-255,66,52482,92,263311
38559,0.001367,172.31.47.0-255,66,52548,92,263311
38560,0.001937,74.125.24.0-255,1484,54032,92,263311
38561,0.001963,74.125.24.0-255,2902,56934,92,263311
38562,0.001968,172.31.47.0-255,66,57000,92,263311
38563,0.001976,74.125.24.0-255,5738,62738,92,263311
38564,0.001978,172.31.47.0-255,66,62804,92,263311
38565,0.001983,74.125.24.0-255,2902,65706,92,263311
38566,0.001985,172.31.47.0-255,66,65772,92,263311
38567,0.002008,74.125.24.0-255,5738,71510,92,263311
38568,0.002011,172.31.47.0-255,66,71576,92,263311
38569,0.002045,74.125.24.0-255,4320,75896,92,263311
38570,0.002048,172.31.47.0-255,66,75962,92,263311
38571,0.002079,172.31.47.0-255,66,76028,92,263311
38572,0.002123,74.125.24.0-255,1484,77512,92,263311
38573,0.002141,74.125.24.0-255,2902,80414,92,263311
38574,0.002144,172.31.47.0-255,66,80480,92,263311
38575,0.002162,74.125.24.0-255,5738,86218,92,263311
38576,0.002165,172.31.47.0-255,66,86284,92,263311
38577,0.002171,74.125.24.0-255,4320,90604,92,263311
38578,0.002173,172.31.47.0-255,66,90670,92,263311
38579,0.002211,172.31.47.0-255,66,90736,92,263311
38580,0.002222,172.31.47.0-255,66,90802,92,263311
38581,0.002242,74.125.24.0-255,2184,92986,92,263311
38582,0.002245,172.31.47.0-255,66,93052,92,263311
38583,0.002285,74.125.24.0-255,1484,94536,92,263311
38584,0.00229,74.125.24.0-255,2902,97438,92,263311
38585,0.002292,172.31.47.0-255,66,97504,92,263311
38586,0.002316,74.125.24.0-255,5738,103242,92,263311
38587,0.002318,172.31.47.0-255,66,103308,92,263311
38588,0.002325,74.125.24.0-255,5738,109046,92,263311
38589,0.002328,172.31.47.0-255,66,109112,92,263311
38590,0.002336,74.125.24.0-255,7156,116268,92,263311
38591,0.002339,172.31.47.0-255,66,116334,92,263311
38592,0.004643,74.125.24.0-255,4320,120654,92,263311
38593,0.004647,172.31.47.0-255,66,120720,92,263311
38594,0.004666,74.125.24.0-255,1484,122204,92,263311
38595,0.007036,74.125.24.0-255,4320,126524,92,263311
38596,0.007044,172.31.47.0-255,66,126590,92,263311
38597,0.009397,74.125.24.0-255,5738,132328,92,263311
38598,0.009408,172.31.47.0-255,66,132394,92,263311
38599,0.011735,74.125.24.0-255,5738,138132,92,263311
38600,0.011745,172.31.47.0-255,66,138198,92,263311
38601,0.014062,74.125.24.0-255,5738,143936,92,263311
38602,0.014073,172.31.47.0-255,66,144002,92,263311
38603,0.016391,74.125.24.0-255,5738,149740,92,263311
38604,0.0164,172.31.47.0-255,66,149806,92,263311
38605,0.018723,74.125.24.0-255,5738,155544,92,263311
38606,0.018733,172.31.47.0-255,66,155610,92,263311
38607,0.021065,74.125.24.0-255,5738,161348,92,263311
38608,0.021075,172.31.47.0-255,66,161414,92,263311
38609,0.023385,74.125.24.0-255,5738,167152,92,263311
38610,0.023393,172.31.47.0-255,66,167218,92,263311
38611,0.025731,74.125.24.0-255,5738,172956,92,263311
38612,0.025744,172.31.47.0-255,66,173022,92,263311
38613,0.028078,74.125.24.0-255,5738,178760,92,263311
38614,0.028088,172.31.47.0-255,66,178826,92,263311
38615,0.030441,74.125.24.0-255,5738,184564,92,263311
38616,0.03046,172.31.47.0-255,66,184630,92,263311
38617,0.032809,74.125.24.0-255,5738,190368,92,263311
38618,0.032824,172.31.47.0-255,66,190434,92,263311
38619,0.035165,74.125.24.0-255,5738,196172,92,263311
38620,0.035183,172.31.47.0-255,66,196238,92,263311
38621,0.037531,74.125.24.0-255,5738,201976,92,263311
38622,0.037547,172.31.47.0-255,66,202042,92,263311
38623,0.039886,74.125.24.0-255,5738,207780,92,263311
38624,0.039899,172.31.47.0-255,66,207846,92,263311
38625,0.042224,74.125.24.0-255,5738,213584,92,263311
38626,0.042235,172.31.47.0-255,66,213650,92,263311
38627,0.044589,74.125.24.0-255,5738,219388,92,263311
38628,0.044616,172.31.47.0-255,66,219454,92,263311
38629,0.046943,74.125.24.0-255,5738,225192,92,263311
38630,0.04695,172.31.47.0-255,66,225258,92,263311
38631,0.047938,172.31.47.0-255,172,225430,92,263311
38632,0.047968,172.31.47.0-255,1103,226533,92,263311
38633,0.048037,172.31.47.0-255,1514,228047,92,263311
38634,0.04804,172.31.47.0-255,1514,229561,92,263311
38635,0.04804,172.31.47.0-255,1514,231075,92,263311
38636,0.048042,172.31.47.0-255,1514,232589,92,263311
38637,0.048043,172.31.47.0-255,1504,234093,92,263311
38638,0.049269,74.125.24.0-255,5738,239831,92,263311
38639,0.049275,172.31.47.0-255,66,239897,92,263311
38640,0.049518,104.244.42.0-255,66,239963,92,263311
38641,0.049525,104.244.42.0-255,66,240029,92,263311
38642,0.049665,104.244.42.0-255,66,240095,92,263311
38643,0.051582,74.125.24.0-255,5738,245833,92,263311
38644,0.0516,172.31.47.0-255,66,245899,92,263311
38645,0.053938,74.125.24.0-255,5738,251637,92,263311
38646,0.053956,172.31.47.0-255,66,251703,92,263311
38647,0.056282,74.125.24.0-255,5738,257441,92,263311
38648,0.056297,172.31.47.0-255,66,257507,92,263311
38649,0.058662,74.125.24.0-255,5738,263245,92,263311
38650,0.058676,172.31.47.0-255,66,263311,92,263311
38651,0.0,74.125.130.0-255,153,153,92,312857
38652,2.2e-05,172.31.47.0-255,66,219,92,312857
38653,2.8e-05,74.125.130.0-255,1484,1703,92,312857
38654,3.1e-05,172.31.47.0-255,66,1769,92,312857
38655,3.6e-05,74.125.130.0-255,2902,4671,92,312857
38656,3.8e-05,172.31.47.0-255,66,4737,92,312857
38657,5.1e-05,74.125.130.0-255,7156,11893,92,312857
38658,5.3e-05,172.31.47.0-255,66,11959,92,312857
38659,5.7e-05,74.125.130.0-255,2218,14177,92,312857
38660,5.8e-05,172.31.47.0-255,66,14243,92,312857
38661,0.000303,74.125.130.0-255,1484,15727,92,312857
38662,0.000308,172.31.47.0-255,66,15793,92,312857
38663,0.000312,74.125.130.0-255,2902,18695,92,312857
38664,0.000314,172.31.47.0-255,66,18761,92,312857
38665,0.000339,74.125.130.0-255,5738,24499,92,312857
38666,0.000341,172.31.47.0-255,66,24565,92,312857
38667,0.000369,74.125.130.0-255,4320,28885,92,312857
38668,0.000372,172.31.47.0-255,66,28951,92,312857
38669,0.000402,74.125.130.0-255,3961,32912,92,312857
38670,0.000404,172.31.47.0-255,66,32978,92,312857
38671,0.000429,74.125.130.0-255,4320,37298,92,312857
38672,0.000431,172.31.47.0-255,66,37364,92,312857
38673,0.000462,172.31.47.0-255,66,37430,92,312857
38674,0.000484,74.125.130.0-255,1484,38914,92,312857
38675,0.000486,172.31.47.0-255,66,38980,92,312857
38676,0.000489,74.125.130.0-255,1125,40105,92,312857
38677,0.00049,172.31.47.0-255,66,40171,92,312857
38678,0.000528,74.125.130.0-255,1484,41655,92,312857
38679,0.000531,172.31.47.0-255,66,41721,92,312857
38680,0.000556,74.125.130.0-255,4320,46041,92,312857
38681,0.000558,172.31.47.0-255,66,46107,92,312857
38682,0.000582,74.125.130.0-255,5738,51845,92,312857
38683,0.000584,172.31.47.0-255,66,51911,92,312857
38684,0.00062,74.125.130.0-255,5379,57290,92,312857
38685,0.000622,172.31.47.0-255,66,57356,92,312857
38686,0.000624,74.125.130.0-255,380,57736,92,312857
38687,0.000886,74.125.130.0-255,98,57834,92,312857
38688,0.000958,172.31.47.0-255,66,57900,92,312857
38689,0.001082,74.125.130.0-255,1484,59384,92,312857
38690,0.001088,74.125.130.0-255,1484,60868,92,312857
38691,0.001091,172.31.47.0-255,66,60934,92,312857
38692,0.001102,74.125.130.0-255,1484,62418,92,312857
38693,0.001109,74.125.130.0-255,2902,65320,92,312857
38694,0.001111,172.31.47.0-255,66,65386,92,312857
38695,0.001133,74.125.130.0-255,2902,68288,92,312857
38696,0.001135,172.31.47.0-255,66,68354,92,312857
38697,0.001151,74.125.130.0-255,1484,69838,92,312857
38698,0.001173,74.125.130.0-255,5379,75217,92,312857
38699,0.001175,172.31.47.0-255,66,75283,92,312857
38700,0.001179,74.125.130.0-255,2902,78185,92,312857
38701,0.001181,172.31.47.0-255,66,78251,92,312857
38702,0.001203,74.125.130.0-255,2902,81153,92,312857
38703,0.001209,172.31.47.0-255,66,81219,92,312857
38704,0.001233,74.125.130.0-255,7156,88375,92,312857
38705,0.001237,172.31.47.0-255,66,88441,92,312857
38706,0.001252,74.125.130.0-255,3677,92118,92,312857
38707,0.001254,172.31.47.0-255,66,92184,92,312857
38708,0.001425,74.125.130.0-255,1484,93668,92,312857
38709,0.001432,74.125.130.0-255,2902,96570,92,312857
38710,0.001435,172.31.47.0-255,66,96636,92,312857
38711,0.001438,74.125.130.0-255,1484,98120,92,312857
38712,0.001469,74.125.130.0-255,4320,102440,92,312857
38713,0.001473,172.31.47.0-255,66,102506,92,312857
38714,0.001479,74.125.130.0-255,7156,109662,92,312857
38715,0.001481,172.31.47.0-255,66,109728,92,312857
38716,0.001483,74.125.130.0-255,1484,111212,92,312857
38717,0.00151,74.125.130.0-255,7156,118368,92,312857
38718,0.001513,172.31.47.0-255,66,118434,92,312857
38719,0.001518,74.125.130.0-255,5738,124172,92,312857
38720,0.001519,172.31.47.0-255,66,124238,92,312857
38721,0.001572,74.125.130.0-255,2184,126422,92,312857
38722,0.001575,172.31.47.0-255,66,126488,92,312857
38723,0.001839,74.125.130.0-255,1484,127972,92,312857
38724,0.001859,74.125.130.0-255,2902,130874,92,312857
38725,0.001864,172.31.47.0-255,66,130940,92,312857
38726,0.001886,74.125.130.0-255,1484,132424,92,312857
38727,0.001889,74.125.130.0-255,1484,133908,92,312857
38728,0.001892,172.31.47.0-255,66,133974,92,312857
38729,0.001915,74.125.130.0-255,1484,135458,92,312857
38730,0.001921,74.125.130.0-255,5738,141196,92,312857
38731,0.001923,172.31.47.0-255,66,141262,92,312857
38732,0.001926,74.125.130.0-255,1484,142746,92,312857
38733,0.00195,74.125.130.0-255,5738,148484,92,312857
38734,0.001953,172.31.47.0-255,66,148550,92,312857
38735,0.001973,74.125.130.0-255,1484,150034,92,312857
38736,0.001975,74.125.130.0-255,1484,151518,92,312857
38737,0.001977,172.31.47.0-255,66,151584,92,312857
38738,0.001999,74.125.130.0-255,1484,153068,92,312857
38739,0.002004,74.125.130.0-255,5738,158806,92,312857
38740,0.002006,172.31.47.0-255,66,158872,92,312857
38741,0.002024,74.125.130.0-255,2184,161056,92,312857
38742,0.002026,172.31.47.0-255,66,161122,92,312857
38743,0.002559,74.125.130.0-255,1484,162606,92,312857
38744,0.002565,74.125.130.0-255,2902,165508,92,312857
38745,0.002568,172.31.47.0-255,66,165574,92,312857
38746,0.002591,74.125.130.0-255,4320,169894,92,312857
38747,0.002594,172.31.47.0-255,66,169960,92,312857
38748,0.00265,74.125.130.0-255,5738,175698,92,312857
38749,0.002654,172.31.47.0-255,66,175764,92,312857
38750,0.002679,74.125.130.0-255,2902,178666,92,312857
38751,0.002681,172.31.47.0-255,66,178732,92,312857
38752,0.002685,74.125.130.0-255,2902,181634,92,312857
38753,0.002687,172.31.47.0-255,66,181700,92,312857
38754,0.005306,74.125.130.0-255,5738,187438,92,312857
38755,0.005323,172.31.47.0-255,66,187504,92,312857
38756,0.007935,74.125.130.0-255,5738,193242,92,312857
38757,0.007947,172.31.47.0-255,66,193308,92,312857
38758,0.010578,74.125.130.0-255,5738,199046,92,312857
38759,0.010593,172.31.47.0-255,66,199112,92,312857
38760,0.013206,74.125.130.0-255,5738,204850,92,312857
38761,0.013212,172.31.47.0-255,66,204916,92,312857
38762,0.01583,74.125.130.0-255,5738,210654,92,312857
38763,0.015842,172.31.47.0-255,66,210720,92,312857
38764,0.018474,74.125.130.0-255,5738,216458,92,312857
38765,0.018493,172.31.47.0-255,66,216524,92,312857
38766,0.021118,74.125.130.0-255,5738,222262,92,312857
38767,0.021133,172.31.47.0-255,66,222328,92,312857
38768,0.023757,74.125.130.0-255,5738,228066,92,312857
38769,0.023772,172.31.47.0-255,66,228132,92,312857
38770,0.026397,74.125.130.0-255,5738,233870,92,312857
38771,0.026412,172.31.47.0-255,66,233936,92,312857
38772,0.029025,74.125.130.0-255,5738,239674,92,312857
38773,0.029042,172.31.47.0-255,66,239740,92,312857
38774,0.031636,172.31.47.0-255,172,239912,92,312857
38775,0.031652,74.125.130.0-255,5738,245650,92,312857
38776,0.031659,172.31.47.0-255,66,245716,92,312857
38777,0.031677,172.31.47.0-255,1107,246823,92,312857
38778,0.031724,172.31.47.0-255,1514,248337,92,312857
38779,0.031726,172.31.47.0-255,1514,249851,92,312857
38780,0.031728,172.31.47.0-255,1514,251365,92,312857
38781,0.031729,172.31.47.0-255,1514,252879,92,312857
38782,0.031757,172.31.47.0-255,1500,254379,92,312857
38783,0.033151,104.244.42.0-255,66,254445,92,312857
38784,0.033196,104.244.42.0-255,66,254511,92,312857
38785,0.033308,104.244.42.0-255,66,254577,92,312857
38786,0.033312,104.244.42.0-255,66,254643,92,312857
38787,0.034204,104.244.42.0-255,108,254751,92,312857
38788,0.034215,172.31.47.0-255,66,254817,92,312857
38789,0.034261,74.125.130.0-255,5738,260555,92,312857
38790,0.034265,172.31.47.0-255,66,260621,92,312857
38791,0.036872,74.125.130.0-255,5738,266359,92,312857
38792,0.036883,172.31.47.0-255,66,266425,92,312857
38793,0.039498,74.125.130.0-255,5738,272163,92,312857
38794,0.039509,172.31.47.0-255,66,272229,92,312857
38795,0.042128,74.125.130.0-255,5738,277967,92,312857
38796,0.042158,172.31.47.0-255,66,278033,92,312857
38797,0.044766,74.125.130.0-255,5738,283771,92,312857
38798,0.044772,172.31.47.0-255,66,283837,92,312857
38799,0.04738,74.125.130.0-255,5738,289575,92,312857
38800,0.047386,172.31.47.0-255,66,289641,92,312857
38801,0.049993,74.125.130.0-255,5738,295379,92,312857
38802,0.049998,172.31.47.0-255,66,295445,92,312857
38803,0.052604,74.125.130.0-255,5738,301183,92,312857
38804,0.052612,172.31.47.0-255,66,301249,92,312857
38805,0.05521,74.125.130.0-255,5738,306987,92,312857
38806,0.055217,172.31.47.0-255,66,307053,92,312857
38807,0.057825,74.125.130.0-255,5738,312791,92,312857
38808,0.057839,172.31.47.0-255,66,312857,92,312857
38809,0.0,172.31.47.0-255,105,105,92,660
38810,0.000306,172.31.47.0-255,90,195,92,660
38811,0.000317,172.31.47.0-255,66,261,92,660
38812,0.001767,157.240.13.0-255,105,366,92,660
38813,0.001801,172.31.47.0-255,54,420,92,660
38814,0.001807,157.240.13.0-255,66,486,92,660
38815,0.001812,172.31.47.0-255,54,540,92,660
38816,0.002043,157.240.13.0-255,60,600,92,660
38817,0.002047,157.240.13.0-255,60,660,92,660
38818,0.0,172.31.47.0-255,105,105,92,105
38819,0.0,172.217.194.0-255,153,153,92,303062
38820,2.2e-05,172.31.47.0-255,66,219,92,303062
38821,3e-05,172.217.194.0-255,1484,1703,92,303062
38822,3.4e-05,172.31.47.0-255,66,1769,92,303062
38823,4.1e-05,172.217.194.0-255,2902,4671,92,303062
38824,5.3e-05,172.31.47.0-255,66,4737,92,303062
38825,6e-05,172.217.194.0-255,5738,10475,92,303062
38826,6.3e-05,172.31.47.0-255,66,10541,92,303062
38827,9e-05,172.217.194.0-255,3627,14168,92,303062
38828,9.3e-05,172.31.47.0-255,66,14234,92,303062
38829,0.000141,172.217.194.0-255,1484,15718,92,303062
38830,0.000144,172.31.47.0-255,66,15784,92,303062
38831,0.000149,172.217.194.0-255,2902,18686,92,303062
38832,0.000151,172.31.47.0-255,66,18752,92,303062
38833,0.000187,172.217.194.0-255,5738,24490,92,303062
38834,0.00019,172.31.47.0-255,66,24556,92,303062
38835,0.000197,172.217.194.0-255,6797,31353,92,303062
38836,0.0002,172.31.47.0-255,66,31419,92,303062
38837,0.000226,172.217.194.0-255,1484,32903,92,303062
38838,0.000228,172.31.47.0-255,66,32969,92,303062
38839,0.000253,172.217.194.0-255,2902,35871,92,303062
38840,0.000255,172.31.47.0-255,66,35937,92,303062
38841,0.000262,172.217.194.0-255,5738,41675,92,303062
38842,0.000264,172.31.47.0-255,66,41741,92,303062
38843,0.000292,172.217.194.0-255,6797,48538,92,303062
38844,0.000294,172.31.47.0-255,66,48604,92,303062
38845,0.000357,172.217.194.0-255,1484,50088,92,303062
38846,0.00036,172.31.47.0-255,66,50154,92,303062
38847,0.000388,172.217.194.0-255,2902,53056,92,303062
38848,0.000391,172.31.47.0-255,66,53122,92,303062
38849,0.000398,172.217.194.0-255,5738,58860,92,303062
38850,0.000401,172.31.47.0-255,66,58926,92,303062
38851,0.000448,172.31.47.0-255,66,58992,92,303062
38852,0.000487,172.217.194.0-255,1484,60476,92,303062
38853,0.0005,172.217.194.0-255,2902,63378,92,303062
38854,0.000503,172.31.47.0-255,66,63444,92,303062
38855,0.000508,172.217.194.0-255,2902,66346,92,303062
38856,0.00051,172.31.47.0-255,66,66412,92,303062
38857,0.000534,172.217.194.0-255,2902,69314,92,303062
38858,0.000536,172.31.47.0-255,66,69380,92,303062
38859,0.000554,172.31.47.0-255,66,69446,92,303062
38860,0.000583,172.217.194.0-255,2543,71989,92,303062
38861,0.000585,172.31.47.0-255,66,72055,92,303062
38862,0.000588,172.217.194.0-255,1484,73539,92,303062
38863,0.000624,172.31.47.0-255,66,73605,92,303062
38864,0.000668,172.31.47.0-255,66,73671,92,303062
38865,0.000686,172.31.47.0-255,66,73737,92,303062
38866,0.000722,172.31.47.0-255,66,73803,92,303062
38867,0.00078,172.217.194.0-255,1484,75287,92,303062
38868,0.000786,172.217.194.0-255,2902,78189,92,303062
38869,0.000789,172.31.47.0-255,66,78255,92,303062
38870,0.00082,172.217.194.0-255,5738,83993,92,303062
38871,0.000824,172.31.47.0-255,66,84059,92,303062
38872,0.000831,172.217.194.0-255,7156,91215,92,303062
38873,0.000834,172.31.47.0-255,66,91281,92,303062
38874,0.00086,172.217.194.0-255,5738,97019,92,303062
38875,0.000863,172.31.47.0-255,66,97085,92,303062
38876,0.000876,172.31.47.0-255,66,97151,92,303062
38877,0.00135,172.217.194.0-255,1484,98635,92,303062
38878,0.001357,172.217.194.0-255,2902,101537,92,303062
38879,0.001361,172.31.47.0-255,66,101603,92,303062
38880,0.001383,172.217.194.0-255,5738,107341,92,303062
38881,0.001386,172.31.47.0-255,66,107407,92,303062
38882,0.001424,172.217.194.0-255,5738,113145,92,303062
38883,0.001427,172.31.47.0-255,66,113211,92,303062
38884,0.00146,172.217.194.0-255,7156,120367,92,303062
38885,0.001463,172.31.47.0-255,66,120433,92,303062
38886,0.001482,172.31.47.0-255,66,120499,92,303062
38887,0.002067,172.217.194.0-255,1484,121983,92,303062
38888,0.002081,172.217.194.0-255,2902,124885,92,303062
38889,0.002084,172.31.47.0-255,66,124951,92,303062
38890,0.002092,172.217.194.0-255,5738,130689,92,303062
38891,0.002094,172.31.47.0-255,66,130755,92,303062
38892,0.002137,172.31.47.0-255,66,130821,92,303062
38893,0.002145,172.217.194.0-255,7156,137977,92,303062
38894,0.002147,172.31.47.0-255,66,138043,92,303062
38895,0.002186,172.217.194.0-255,3602,141645,92,303062
38896,0.002189,172.31.47.0-255,66,141711,92,303062
38897,0.002291,172.217.194.0-255,1484,143195,92,303062
38898,0.002296,172.217.194.0-255,1484,144679,92,303062
38899,0.002299,172.31.47.0-255,66,144745,92,303062
38900,0.002329,172.217.194.0-255,1484,146229,92,303062
38901,0.002337,172.217.194.0-255,5738,151967,92,303062
38902,0.002339,172.31.47.0-255,66,152033,92,303062
38903,0.002345,172.217.194.0-255,4320,156353,92,303062
38904,0.002347,172.31.47.0-255,66,156419,92,303062
38905,0.002371,172.31.47.0-255,66,156485,92,303062
38906,0.002376,172.217.194.0-255,2902,159387,92,303062
38907,0.002378,172.31.47.0-255,66,159453,92,303062
38908,0.004653,172.217.194.0-255,2902,162355,92,303062
38909,0.00466,172.31.47.0-255,66,162421,92,303062
38910,0.004679,172.217.194.0-255,2902,165323,92,303062
38911,0.004681,172.31.47.0-255,66,165389,92,303062
38912,0.006972,172.217.194.0-255,5738,171127,92,303062
38913,0.006976,172.31.47.0-255,66,171193,92,303062
38914,0.009298,172.217.194.0-255,5738,176931,92,303062
38915,0.009302,172.31.47.0-255,66,176997,92,303062
38916,0.011591,172.217.194.0-255,5738,182735,92,303062
38917,0.0116,172.31.47.0-255,66,182801,92,303062
38918,0.013923,172.217.194.0-255,5738,188539,92,303062
38919,0.01393,172.31.47.0-255,66,188605,92,303062
38920,0.016221,172.217.194.0-255,5738,194343,92,303062
38921,0.016228,172.31.47.0-255,66,194409,92,303062
38922,0.018525,172.217.194.0-255,5738,200147,92,303062
38923,0.018534,172.31.47.0-255,66,200213,92,303062
38924,0.020844,172.217.194.0-255,5738,205951,92,303062
38925,0.020851,172.31.47.0-255,66,206017,92,303062
38926,0.023157,172.217.194.0-255,5738,211755,92,303062
38927,0.023163,172.31.47.0-255,66,211821,92,303062
38928,0.025492,172.217.194.0-255,5738,217559,92,303062
38929,0.025498,172.31.47.0-255,66,217625,92,303062
38930,0.026667,172.31.47.0-255,167,217792,92,303062
38931,0.026695,172.31.47.0-255,1111,218903,92,303062
38932,0.026749,172.31.47.0-255,1514,220417,92,303062
38933,0.02675,172.31.47.0-255,1514,221931,92,303062
38934,0.026752,172.31.47.0-255,1514,223445,92,303062
38935,0.026753,172.31.47.0-255,1514,224959,92,303062
38936,0.026753,172.31.47.0-255,531,225490,92,303062
38937,0.027811,172.217.194.0-255,4320,229810,92,303062
38938,0.027816,172.31.47.0-255,66,229876,92,303062
38939,0.027843,172.217.194.0-255,1484,231360,92,303062
38940,0.028217,104.244.42.0-255,66,231426,92,303062
38941,0.028268,104.244.42.0-255,66,231492,92,303062
38942,0.028323,104.244.42.0-255,66,231558,92,303062
38943,0.028326,104.244.42.0-255,66,231624,92,303062
38944,0.029057,104.244.42.0-255,108,231732,92,303062
38945,0.029061,172.31.47.0-255,66,231798,92,303062
38946,0.0301,172.217.194.0-255,2902,234700,92,303062
38947,0.030105,172.31.47.0-255,66,234766,92,303062
38948,0.032419,172.217.194.0-255,5738,240504,92,303062
38949,0.032425,172.31.47.0-255,66,240570,92,303062
38950,0.034712,172.217.194.0-255,5738,246308,92,303062
38951,0.034718,172.31.47.0-255,66,246374,92,303062
38952,0.037017,172.217.194.0-255,5738,252112,92,303062
38953,0.037024,172.31.47.0-255,66,252178,92,303062
38954,0.039344,172.217.194.0-255,5738,257916,92,303062
38955,0.03935,172.31.47.0-255,66,257982,92,303062
38956,0.041672,172.217.194.0-255,5738,263720,92,303062
38957,0.041678,172.31.47.0-255,66,263786,92,303062
38958,0.044033,172.217.194.0-255,5738,269524,92,303062
38959,0.044039,172.31.47.0-255,66,269590,92,303062
38960,0.046367,172.217.194.0-255,5738,275328,92,303062
38961,0.046373,172.31.47.0-255,66,275394,92,303062
38962,0.048687,172.217.194.0-255,4320,279714,92,303062
38963,0.048693,172.31.47.0-255,66,279780,92,303062
38964,0.048719,172.217.194.0-255,1484,281264,92,303062
38965,0.05102,172.217.194.0-255,4320,285584,92,303062
38966,0.051027,172.31.47.0-255,66,285650,92,303062
38967,0.05333,172.217.194.0-255,5738,291388,92,303062
38968,0.053335,172.31.47.0-255,66,291454,92,303062
38969,0.055642,172.217.194.0-255,5738,297192,92,303062
38970,0.055649,172.31.47.0-255,66,297258,92,303062
38971,0.057974,172.217.194.0-255,5738,302996,92,303062
38972,0.057979,172.31.47.0-255,66,303062,92,303062
38973,0.0,172.217.194.0-255,153,153,92,293442
38974,2.2e-05,172.31.47.0-255,66,219,92,293442
38975,2.8e-05,172.217.194.0-255,1484,1703,92,293442
38976,3.2e-05,172.31.47.0-255,66,1769,92,293442
38977,3.6e-05,172.217.194.0-255,2902,4671,92,293442
38978,3.7e-05,172.31.47.0-255,66,4737,92,293442
38979,4.3e-05,172.217.194.0-255,5738,10475,92,293442
38980,5.2e-05,172.31.47.0-255,66,10541,92,293442
38981,7.9e-05,172.217.194.0-255,1484,12025,92,293442
38982,8.1e-05,172.31.47.0-255,66,12091,92,293442
38983,8.7e-05,172.217.194.0-255,5009,17100,92,293442
38984,9.3e-05,172.31.47.0-255,66,17166,92,293442
38985,0.000103,172.31.47.0-255,66,17232,92,293442
38986,0.000131,172.217.194.0-255,5379,22611,92,293442
38987,0.000139,172.31.47.0-255,66,22677,92,293442
38988,0.001086,172.217.194.0-255,1484,24161,92,293442
38989,0.001092,172.31.47.0-255,66,24227,92,293442
38990,0.001101,172.217.194.0-255,2902,27129,92,293442
38991,0.001102,172.31.47.0-255,66,27195,92,293442
38992,0.001111,172.217.194.0-255,4320,31515,92,293442
38993,0.001113,172.31.47.0-255,66,31581,92,293442
38994,0.001136,172.217.194.0-255,1484,33065,92,293442
38995,0.001137,172.31.47.0-255,66,33131,92,293442
38996,0.00114,172.217.194.0-255,1484,34615,92,293442
38997,0.001142,172.31.47.0-255,66,34681,92,293442
38998,0.001173,172.217.194.0-255,6797,41478,92,293442
38999,0.001174,172.31.47.0-255,66,41544,92,293442
39000,0.001187,172.31.47.0-255,66,41610,92,293442
39001,0.001207,172.217.194.0-255,1378,42988,92,293442
39002,0.001209,172.31.47.0-255,66,43054,92,293442
39003,0.001294,172.217.194.0-255,119,43173,92,293442
39004,0.001374,172.217.194.0-255,1484,44657,92,293442
39005,0.001376,172.31.47.0-255,66,44723,92,293442
39006,0.001392,172.217.194.0-255,2902,47625,92,293442
39007,0.001393,172.31.47.0-255,66,47691,92,293442
39008,0.00142,172.217.194.0-255,2902,50593,92,293442
39009,0.001421,172.31.47.0-255,66,50659,92,293442
39010,0.001445,172.217.194.0-255,2902,53561,92,293442
39011,0.001447,172.31.47.0-255,66,53627,92,293442
39012,0.001462,172.31.47.0-255,66,53693,92,293442
39013,0.001471,172.31.47.0-255,66,53759,92,293442
39014,0.001473,172.217.194.0-255,380,54139,92,293442
39015,0.001878,172.217.194.0-255,1484,55623,92,293442
39016,0.00188,172.31.47.0-255,66,55689,92,293442
39017,0.001893,172.217.194.0-255,2902,58591,92,293442
39018,0.001898,172.31.47.0-255,66,58657,92,293442
39019,0.001901,172.217.194.0-255,1484,60141,92,293442
39020,0.001922,172.217.194.0-255,4320,64461,92,293442
39021,0.001924,172.31.47.0-255,66,64527,92,293442
39022,0.001947,172.217.194.0-255,2902,67429,92,293442
39023,0.001949,172.31.47.0-255,66,67495,92,293442
39024,0.00197,172.217.194.0-255,2902,70397,92,293442
39025,0.001972,172.31.47.0-255,66,70463,92,293442
39026,0.001978,172.217.194.0-255,7156,77619,92,293442
39027,0.00198,172.31.47.0-255,66,77685,92,293442
39028,0.002008,172.217.194.0-255,5738,83423,92,293442
39029,0.00201,172.31.47.0-255,66,83489,92,293442
39030,0.002033,172.217.194.0-255,5020,88509,92,293442
39031,0.002035,172.31.47.0-255,66,88575,92,293442
39032,0.002112,172.217.194.0-255,1484,90059,92,293442
39033,0.002115,172.217.194.0-255,1484,91543,92,293442
39034,0.002139,172.217.194.0-255,1484,93027,92,293442
39035,0.002144,172.217.194.0-255,5738,98765,92,293442
39036,0.002162,172.217.194.0-255,2902,101667,92,293442
39037,0.002181,172.217.194.0-255,7156,108823,92,293442
39038,0.002197,172.217.194.0-255,1484,110307,92,293442
39039,0.002232,172.217.194.0-255,2184,112491,92,293442
39040,0.002235,172.217.194.0-255,2902,115393,92,293442
39041,0.002243,172.217.194.0-255,1484,116877,92,293442
39042,0.002259,172.217.194.0-255,7156,124033,92,293442
39043,0.00228,172.217.194.0-255,7156,131189,92,293442
39044,0.002284,172.217.194.0-255,4320,135509,92,293442
39045,0.002297,172.217.194.0-255,5738,141247,92,293442
39046,0.002299,172.217.194.0-255,766,142013,92,293442
39047,0.002372,172.217.194.0-255,1484,143497,92,293442
39048,0.002397,172.217.194.0-255,1484,144981,92,293442
39049,0.003368,172.31.47.0-255,66,145047,92,293442
39050,0.005658,172.217.194.0-255,5738,150785,92,293442
39051,0.005662,172.31.47.0-255,66,150851,92,293442
39052,0.007953,172.217.194.0-255,5738,156589,92,293442
39053,0.007959,172.31.47.0-255,66,156655,92,293442
39054,0.01029,172.217.194.0-255,5738,162393,92,293442
39055,0.010297,172.31.47.0-255,66,162459,92,293442
39056,0.01263,172.217.194.0-255,5738,168197,92,293442
39057,0.012637,172.31.47.0-255,66,168263,92,293442
39058,0.014978,172.217.194.0-255,5738,174001,92,293442
39059,0.014984,172.31.47.0-255,66,174067,92,293442
39060,0.017354,172.217.194.0-255,5738,179805,92,293442
39061,0.017361,172.31.47.0-255,66,179871,92,293442
39062,0.019706,172.217.194.0-255,5738,185609,92,293442
39063,0.019713,172.31.47.0-255,66,185675,92,293442
39064,0.022029,172.217.194.0-255,5738,191413,92,293442
39065,0.022035,172.31.47.0-255,66,191479,92,293442
39066,0.024401,172.217.194.0-255,5738,197217,92,293442
39067,0.02441,172.31.47.0-255,66,197283,92,293442
39068,0.026793,172.217.194.0-255,5738,203021,92,293442
39069,0.026815,172.31.47.0-255,66,203087,92,293442
39070,0.029242,172.217.194.0-255,5738,208825,92,293442
39071,0.029258,172.31.47.0-255,66,208891,92,293442
39072,0.031593,172.217.194.0-255,5738,214629,92,293442
39073,0.03161,172.31.47.0-255,66,214695,92,293442
39074,0.033952,172.217.194.0-255,5738,220433,92,293442
39075,0.033969,172.31.47.0-255,66,220499,92,293442
39076,0.036304,172.217.194.0-255,5738,226237,92,293442
39077,0.036309,172.31.47.0-255,66,226303,92,293442
39078,0.038632,172.217.194.0-255,5738,232041,92,293442
39079,0.03864,172.31.47.0-255,66,232107,92,293442
39080,0.041005,172.217.194.0-255,5738,237845,92,293442
39081,0.041048,172.31.47.0-255,66,237911,92,293442
39082,0.043358,172.217.194.0-255,5738,243649,92,293442
39083,0.043364,172.31.47.0-255,66,243715,92,293442
39084,0.045688,172.217.194.0-255,5738,249453,92,293442
39085,0.045695,172.31.47.0-255,66,249519,92,293442
39086,0.048068,172.217.194.0-255,5738,255257,92,293442
39087,0.048084,172.31.47.0-255,66,255323,92,293442
39088,0.050399,172.217.194.0-255,5738,261061,92,293442
39089,0.050407,172.31.47.0-255,66,261127,92,293442
39090,0.052714,172.217.194.0-255,5738,266865,92,293442
39091,0.052734,172.31.47.0-255,66,266931,92,293442
39092,0.055096,172.217.194.0-255,5738,272669,92,293442
39093,0.055102,172.31.47.0-255,66,272735,92,293442
39094,0.05636,172.31.47.0-255,172,272907,92,293442
39095,0.056393,172.31.47.0-255,1103,274010,92,293442
39096,0.056435,172.31.47.0-255,1514,275524,92,293442
39097,0.056437,172.31.47.0-255,1514,277038,92,293442
39098,0.056438,172.31.47.0-255,1514,278552,92,293442
39099,0.056439,172.31.47.0-255,1514,280066,92,293442
39100,0.056465,172.31.47.0-255,1504,281570,92,293442
39101,0.057426,172.217.194.0-255,5738,287308,92,293442
39102,0.057432,172.31.47.0-255,66,287374,92,293442
39103,0.057902,104.244.42.0-255,66,287440,92,293442
39104,0.05794,104.244.42.0-255,66,287506,92,293442
39105,0.058056,104.244.42.0-255,66,287572,92,293442
39106,0.058062,104.244.42.0-255,66,287638,92,293442
39107,0.059772,172.217.194.0-255,5738,293376,92,293442
39108,0.059782,172.31.47.0-255,66,293442,92,293442
39109,0.0,172.31.47.0-255,105,105,92,105
39110,0.0,74.125.24.0-255,153,153,92,137960
39111,1.7e-05,172.31.47.0-255,66,219,92,137960
39112,2.3e-05,74.125.24.0-255,1484,1703,92,137960
39113,2.7e-05,172.31.47.0-255,66,1769,92,137960
39114,3.8e-05,74.125.24.0-255,2902,4671,92,137960
39115,4e-05,172.31.47.0-255,66,4737,92,137960
39116,7.4e-05,74.125.24.0-255,7156,11893,92,137960
39117,7.7e-05,172.31.47.0-255,66,11959,92,137960
39118,0.000165,74.125.24.0-255,2092,14051,92,137960
39119,0.000168,172.31.47.0-255,66,14117,92,137960
39120,0.000182,74.125.24.0-255,1484,15601,92,137960
39121,0.000187,172.31.47.0-255,66,15667,92,137960
39122,0.000211,74.125.24.0-255,1484,17151,92,137960
39123,0.000214,172.31.47.0-255,66,17217,92,137960
39124,0.000238,74.125.24.0-255,4320,21537,92,137960
39125,0.00024,172.31.47.0-255,66,21603,92,137960
39126,0.000265,74.125.24.0-255,2902,24505,92,137960
39127,0.000267,172.31.47.0-255,66,24571,92,137960
39128,0.000345,74.125.24.0-255,5738,30309,92,137960
39129,0.00036,172.31.47.0-255,66,30375,92,137960
39130,0.000388,172.31.47.0-255,66,30441,92,137960
39131,0.000576,74.125.24.0-255,5738,36179,92,137960
39132,0.000581,172.31.47.0-255,66,36245,92,137960
39133,0.00061,74.125.24.0-255,2543,38788,92,137960
39134,0.000612,172.31.47.0-255,66,38854,92,137960
39135,0.000707,172.31.47.0-255,66,38920,92,137960
39136,0.000735,74.125.24.0-255,7127,46047,92,137960
39137,0.000738,172.31.47.0-255,66,46113,92,137960
39138,0.000935,74.125.24.0-255,347,46460,92,137960
39139,0.000939,172.31.47.0-255,66,46526,92,137960
39140,0.000994,172.31.47.0-255,66,46592,92,137960
39141,0.001228,172.31.47.0-255,66,46658,92,137960
39142,0.001257,74.125.24.0-255,5379,52037,92,137960
39143,0.001494,74.125.24.0-255,5738,57775,92,137960
39144,0.001762,74.125.24.0-255,2184,59959,92,137960
39145,0.001979,74.125.24.0-255,4320,64279,92,137960
39146,0.002481,74.125.24.0-255,2902,67181,92,137960
39147,0.002516,74.125.24.0-255,1484,68665,92,137960
39148,0.002544,74.125.24.0-255,4320,72985,92,137960
39149,0.002554,74.125.24.0-255,1484,74469,92,137960
39150,0.002631,74.125.24.0-255,7156,81625,92,137960
39151,0.00265,74.125.24.0-255,5738,87363,92,137960
39152,0.00285,74.125.24.0-255,4320,91683,92,137960
39153,0.002863,74.125.24.0-255,6438,98121,92,137960
39154,0.002982,74.125.24.0-255,7156,105277,92,137960
39155,0.00349,74.125.24.0-255,4320,109597,92,137960
39156,0.003911,172.31.47.0-255,66,109663,92,137960
39157,0.004202,74.125.24.0-255,7156,116819,92,137960
39158,0.00421,172.31.47.0-255,66,116885,92,137960
39159,0.00424,172.31.47.0-255,66,116951,92,137960
39160,0.00451,74.125.24.0-255,7156,124107,92,137960
39161,0.004536,172.31.47.0-255,66,124173,92,137960
39162,0.004657,172.31.47.0-255,66,124239,92,137960
39163,0.005879,74.125.24.0-255,4320,128559,92,137960
39164,0.005885,172.31.47.0-255,66,128625,92,137960
39165,0.005974,172.31.47.0-255,66,128691,92,137960
39166,0.006497,172.31.47.0-255,105,128796,92,137960
39167,0.008414,74.125.24.0-255,66,128862,92,137960
39168,0.035056,172.31.47.0-255,172,129034,92,137960
39169,0.035085,172.31.47.0-255,1112,130146,92,137960
39170,0.035139,172.31.47.0-255,1514,131660,92,137960
39171,0.035141,172.31.47.0-255,1514,133174,92,137960
39172,0.035146,172.31.47.0-255,1514,134688,92,137960
39173,0.035147,172.31.47.0-255,1514,136202,92,137960
39174,0.035174,172.31.47.0-255,1494,137696,92,137960
39175,0.036615,104.244.42.0-255,66,137762,92,137960
39176,0.036666,104.244.42.0-255,66,137828,92,137960
39177,0.036714,104.244.42.0-255,66,137894,92,137960
39178,0.036812,104.244.42.0-255,66,137960,92,137960
39179,0.0,74.125.200.0-255,153,153,92,181484
39180,2.5e-05,172.31.47.0-255,66,219,92,181484
39181,3.1e-05,74.125.200.0-255,1484,1703,92,181484
39182,3.5e-05,172.31.47.0-255,66,1769,92,181484
39183,3.9e-05,74.125.200.0-255,2902,4671,92,181484
39184,4.3e-05,172.31.47.0-255,66,4737,92,181484
39185,6e-05,74.125.200.0-255,2902,7639,92,181484
39186,6.3e-05,172.31.47.0-255,66,7705,92,181484
39187,0.000106,74.125.200.0-255,2902,10607,92,181484
39188,0.000109,172.31.47.0-255,66,10673,92,181484
39189,0.000122,74.125.200.0-255,1484,12157,92,181484
39190,0.000125,172.31.47.0-255,66,12223,92,181484
39191,0.000208,172.31.47.0-255,66,12289,92,181484
39192,0.000217,74.125.200.0-255,635,12924,92,181484
39193,0.000219,172.31.47.0-255,66,12990,92,181484
39194,0.000326,74.125.200.0-255,4320,17310,92,181484
39195,0.000331,172.31.47.0-255,66,17376,92,181484
39196,0.000354,74.125.200.0-255,7156,24532,92,181484
39197,0.000358,172.31.47.0-255,66,24598,92,181484
39198,0.000373,74.125.200.0-255,4320,28918,92,181484
39199,0.000377,172.31.47.0-255,66,28984,92,181484
39200,0.000577,172.31.47.0-255,66,29050,92,181484
39201,0.000731,74.125.200.0-255,5738,34788,92,181484
39202,0.000737,172.31.47.0-255,66,34854,92,181484
39203,0.000768,172.31.47.0-255,66,34920,92,181484
39204,0.001003,74.125.200.0-255,2902,37822,92,181484
39205,0.001009,172.31.47.0-255,66,37888,92,181484
39206,0.001051,172.31.47.0-255,66,37954,92,181484
39207,0.001472,74.125.200.0-255,5738,43692,92,181484
39208,0.001533,74.125.200.0-255,2884,46576,92,181484
39209,0.002038,74.125.200.0-255,1484,48060,92,181484
39210,0.002294,172.31.47.0-255,66,48126,92,181484
39211,0.003027,74.125.200.0-255,4320,52446,92,181484
39212,0.003033,172.31.47.0-255,66,52512,92,181484
39213,0.00312,172.31.47.0-255,66,52578,92,181484
39214,0.003156,172.31.47.0-255,66,52644,92,181484
39215,0.003998,74.125.200.0-255,1484,54128,92,181484
39216,0.004034,172.31.47.0-255,66,54194,92,181484
39217,0.007385,172.31.47.0-255,66,54260,92,181484
39218,0.009647,74.125.200.0-255,5738,59998,92,181484
39219,0.009658,172.31.47.0-255,66,60064,92,181484
39220,0.011924,74.125.200.0-255,5738,65802,92,181484
39221,0.014847,172.31.47.0-255,66,65868,92,181484
39222,0.017373,74.125.200.0-255,5738,71606,92,181484
39223,0.017384,172.31.47.0-255,66,71672,92,181484
39224,0.01966,74.125.200.0-255,4320,75992,92,181484
39225,0.019667,172.31.47.0-255,66,76058,92,181484
39226,0.019703,74.125.200.0-255,1484,77542,92,181484
39227,0.021919,74.125.200.0-255,4320,81862,92,181484
39228,0.021925,172.31.47.0-255,66,81928,92,181484
39229,0.024186,74.125.200.0-255,5738,87666,92,181484
39230,0.024701,172.31.47.0-255,66,87732,92,181484
39231,0.024953,172.31.47.0-255,172,87904,92,181484
39232,0.024979,172.31.47.0-255,1112,89016,92,181484
39233,0.025022,172.31.47.0-255,1514,90530,92,181484
39234,0.025023,172.31.47.0-255,1514,92044,92,181484
39235,0.025027,172.31.47.0-255,1514,93558,92,181484
39236,0.025028,172.31.47.0-255,1514,95072,92,181484
39237,0.025045,172.31.47.0-255,1494,96566,92,181484
39238,0.026522,104.244.42.0-255,66,96632,92,181484
39239,0.02653,104.244.42.0-255,66,96698,92,181484
39240,0.026675,104.244.42.0-255,66,96764,92,181484
39241,0.026965,74.125.200.0-255,5738,102502,92,181484
39242,0.026972,172.31.47.0-255,66,102568,92,181484
39243,0.029225,74.125.200.0-255,2902,105470,92,181484
39244,0.02923,172.31.47.0-255,66,105536,92,181484
39245,0.029262,74.125.200.0-255,2902,108438,92,181484
39246,0.029278,172.31.47.0-255,66,108504,92,181484
39247,0.031486,74.125.200.0-255,2902,111406,92,181484
39248,0.031491,172.31.47.0-255,66,111472,92,181484
39249,0.031527,74.125.200.0-255,2902,114374,92,181484
39250,0.031542,172.31.47.0-255,66,114440,92,181484
39251,0.033746,74.125.200.0-255,2902,117342,92,181484
39252,0.033751,172.31.47.0-255,66,117408,92,181484
39253,0.033779,74.125.200.0-255,1484,118892,92,181484
39254,0.033795,74.125.200.0-255,1484,120376,92,181484
39255,0.033803,172.31.47.0-255,66,120442,92,181484
39256,0.036038,74.125.200.0-255,2902,123344,92,181484
39257,0.036043,172.31.47.0-255,66,123410,92,181484
39258,0.03607,74.125.200.0-255,2902,126312,92,181484
39259,0.036085,172.31.47.0-255,66,126378,92,181484
39260,0.038295,74.125.200.0-255,1484,127862,92,181484
39261,0.038321,74.125.200.0-255,2902,130764,92,181484
39262,0.038326,172.31.47.0-255,66,130830,92,181484
39263,0.038344,74.125.200.0-255,1484,132314,92,181484
39264,0.040598,74.125.200.0-255,2902,135216,92,181484
39265,0.040604,172.31.47.0-255,66,135282,92,181484
39266,0.040631,74.125.200.0-255,1484,136766,92,181484
39267,0.042867,74.125.200.0-255,4320,141086,92,181484
39268,0.042922,172.31.47.0-255,66,141152,92,181484
39269,0.045186,74.125.200.0-255,5738,146890,92,181484
39270,0.045246,172.31.47.0-255,66,146956,92,181484
39271,0.047503,74.125.200.0-255,4320,151276,92,181484
39272,0.047507,172.31.47.0-255,66,151342,92,181484
39273,0.047534,74.125.200.0-255,1484,152826,92,181484
39274,0.049754,74.125.200.0-255,1484,154310,92,181484
39275,0.049759,172.31.47.0-255,66,154376,92,181484
39276,0.049787,74.125.200.0-255,2902,157278,92,181484
39277,0.049809,172.31.47.0-255,66,157344,92,181484
39278,0.052031,74.125.200.0-255,2902,160246,92,181484
39279,0.052036,172.31.47.0-255,66,160312,92,181484
39280,0.052075,74.125.200.0-255,2902,163214,92,181484
39281,0.052098,172.31.47.0-255,66,163280,92,181484
39282,0.054288,74.125.200.0-255,2902,166182,92,181484
39283,0.054294,172.31.47.0-255,66,166248,92,181484
39284,0.054347,74.125.200.0-255,2902,169150,92,181484
39285,0.05435,172.31.47.0-255,66,169216,92,181484
39286,0.056534,74.125.200.0-255,1484,170700,92,181484
39287,0.056538,172.31.47.0-255,66,170766,92,181484
39288,0.056562,74.125.200.0-255,1484,172250,92,181484
39289,0.056565,172.31.47.0-255,66,172316,92,181484
39290,0.056581,74.125.200.0-255,1484,173800,92,181484
39291,0.056583,172.31.47.0-255,66,173866,92,181484
39292,0.0566,74.125.200.0-255,1484,175350,92,181484
39293,0.056602,172.31.47.0-255,66,175416,92,181484
39294,0.058779,74.125.200.0-255,1484,176900,92,181484
39295,0.058783,172.31.47.0-255,66,176966,92,181484
39296,0.058819,74.125.200.0-255,2902,179868,92,181484
39297,0.058822,172.31.47.0-255,66,179934,92,181484
39298,0.058851,74.125.200.0-255,1484,181418,92,181484
39299,0.058854,172.31.47.0-255,66,181484,92,181484
39300,0.0,172.217.194.0-255,153,153,92,289818
39301,3.1e-05,172.31.47.0-255,66,219,92,289818
39302,3.7e-05,172.217.194.0-255,1484,1703,92,289818
39303,4.1e-05,172.31.47.0-255,66,1769,92,289818
39304,4.6e-05,172.217.194.0-255,2902,4671,92,289818
39305,4.8e-05,172.31.47.0-255,66,4737,92,289818
39306,6.3e-05,172.217.194.0-255,7156,11893,92,289818
39307,6.5e-05,172.31.47.0-255,66,11959,92,289818
39308,7.4e-05,172.31.47.0-255,66,12025,92,289818
39309,0.000107,172.217.194.0-255,5000,17025,92,289818
39310,0.000109,172.31.47.0-255,66,17091,92,289818
39311,0.000115,172.217.194.0-255,5379,22470,92,289818
39312,0.000117,172.31.47.0-255,66,22536,92,289818
39313,0.000138,172.217.194.0-255,1484,24020,92,289818
39314,0.000141,172.31.47.0-255,66,24086,92,289818
39315,0.000167,172.217.194.0-255,4320,28406,92,289818
39316,0.00017,172.31.47.0-255,66,28472,92,289818
39317,0.000175,172.217.194.0-255,5738,34210,92,289818
39318,0.000177,172.31.47.0-255,66,34276,92,289818
39319,0.000211,172.217.194.0-255,2902,37178,92,289818
39320,0.000214,172.31.47.0-255,66,37244,92,289818
39321,0.000236,172.217.194.0-255,2543,39787,92,289818
39322,0.000241,172.31.47.0-255,66,39853,92,289818
39323,0.000251,172.217.194.0-255,1484,41337,92,289818
39324,0.000253,172.31.47.0-255,66,41403,92,289818
39325,0.000276,172.217.194.0-255,4320,45723,92,289818
39326,0.00028,172.31.47.0-255,66,45789,92,289818
39327,0.000286,172.217.194.0-255,5738,51527,92,289818
39328,0.000289,172.31.47.0-255,66,51593,92,289818
39329,0.00032,172.217.194.0-255,2902,54495,92,289818
39330,0.000323,172.31.47.0-255,66,54561,92,289818
39331,0.000348,172.217.194.0-255,2816,57377,92,289818
39332,0.00035,172.31.47.0-255,66,57443,92,289818
39333,0.000415,172.217.194.0-255,119,57562,92,289818
39334,0.000419,172.217.194.0-255,381,57943,92,289818
39335,0.000641,172.217.194.0-255,1484,59427,92,289818
39336,0.000645,172.31.47.0-255,66,59493,92,289818
39337,0.000648,172.217.194.0-255,1484,60977,92,289818
39338,0.000667,172.217.194.0-255,1484,62461,92,289818
39339,0.00067,172.31.47.0-255,66,62527,92,289818
39340,0.000675,172.217.194.0-255,2902,65429,92,289818
39341,0.000676,172.31.47.0-255,66,65495,92,289818
39342,0.000679,172.217.194.0-255,1484,66979,92,289818
39343,0.000707,172.217.194.0-255,2902,69881,92,289818
39344,0.000709,172.31.47.0-255,66,69947,92,289818
39345,0.000712,172.217.194.0-255,1484,71431,92,289818
39346,0.000741,172.217.194.0-255,7156,78587,92,289818
39347,0.000743,172.31.47.0-255,66,78653,92,289818
39348,0.000747,172.217.194.0-255,2902,81555,92,289818
39349,0.000749,172.31.47.0-255,66,81621,92,289818
39350,0.000809,172.31.47.0-255,66,81687,92,289818
39351,0.000812,172.217.194.0-255,1484,83171,92,289818
39352,0.000833,172.217.194.0-255,2902,86073,92,289818
39353,0.000836,172.31.47.0-255,66,86139,92,289818
39354,0.00084,172.217.194.0-255,2902,89041,92,289818
39355,0.000841,172.31.47.0-255,66,89107,92,289818
39356,0.000866,172.217.194.0-255,2902,92009,92,289818
39357,0.000869,172.31.47.0-255,66,92075,92,289818
39358,0.000871,172.217.194.0-255,5738,97813,92,289818
39359,0.000877,172.31.47.0-255,66,97879,92,289818
39360,0.000906,172.217.194.0-255,7156,105035,92,289818
39361,0.000909,172.31.47.0-255,66,105101,92,289818
39362,0.000919,172.31.47.0-255,66,105167,92,289818
39363,0.000944,172.217.194.0-255,766,105933,92,289818
39364,0.00109,172.217.194.0-255,1484,107417,92,289818
39365,0.001093,172.31.47.0-255,66,107483,92,289818
39366,0.001113,172.217.194.0-255,2902,110385,92,289818
39367,0.001115,172.31.47.0-255,66,110451,92,289818
39368,0.001134,172.217.194.0-255,5738,116189,92,289818
39369,0.001137,172.31.47.0-255,66,116255,92,289818
39370,0.001147,172.31.47.0-255,66,116321,92,289818
39371,0.001176,172.217.194.0-255,1484,117805,92,289818
39372,0.001193,172.31.47.0-255,66,117871,92,289818
39373,0.001197,172.217.194.0-255,2184,120055,92,289818
39374,0.001199,172.31.47.0-255,66,120121,92,289818
39375,0.001276,172.217.194.0-255,1484,121605,92,289818
39376,0.001278,172.217.194.0-255,1484,123089,92,289818
39377,0.001281,172.31.47.0-255,66,123155,92,289818
39378,0.001305,172.217.194.0-255,1484,124639,92,289818
39379,0.001311,172.217.194.0-255,5738,130377,92,289818
39380,0.001314,172.31.47.0-255,66,130443,92,289818
39381,0.001316,172.217.194.0-255,1484,131927,92,289818
39382,0.001344,172.31.47.0-255,66,131993,92,289818
39383,0.00137,172.217.194.0-255,1484,133477,92,289818
39384,0.00138,172.217.194.0-255,766,134243,92,289818
39385,0.001382,172.31.47.0-255,66,134309,92,289818
39386,0.001593,172.31.47.0-255,66,134375,92,289818
39387,0.001839,172.217.194.0-255,1484,135859,92,289818
39388,0.001848,172.217.194.0-255,2902,138761,92,289818
39389,0.001851,172.31.47.0-255,66,138827,92,289818
39390,0.001858,172.217.194.0-255,5738,144565,92,289818
39391,0.00186,172.31.47.0-255,66,144631,92,289818
39392,0.001886,172.217.194.0-255,7156,151787,92,289818
39393,0.001888,172.31.47.0-255,66,151853,92,289818
39394,0.001915,172.217.194.0-255,5738,157591,92,289818
39395,0.001917,172.31.47.0-255,66,157657,92,289818
39396,0.001922,172.217.194.0-255,5738,163395,92,289818
39397,0.001924,172.31.47.0-255,66,163461,92,289818
39398,0.001947,172.217.194.0-255,5020,168481,92,289818
39399,0.001949,172.31.47.0-255,66,168547,92,289818
39400,0.002256,172.217.194.0-255,1484,170031,92,289818
39401,0.002268,172.217.194.0-255,2902,172933,92,289818
39402,0.002271,172.31.47.0-255,66,172999,92,289818
39403,0.002295,172.217.194.0-255,4320,177319,92,289818
39404,0.002296,172.31.47.0-255,66,177385,92,289818
39405,0.00232,172.217.194.0-255,1484,178869,92,289818
39406,0.002329,172.217.194.0-255,5738,184607,92,289818
39407,0.002331,172.31.47.0-255,66,184673,92,289818
39408,0.002363,172.31.47.0-255,66,184739,92,289818
39409,0.002368,172.217.194.0-255,5020,189759,92,289818
39410,0.00237,172.31.47.0-255,66,189825,92,289818
39411,0.002405,172.217.194.0-255,1484,191309,92,289818
39412,0.002443,172.217.194.0-255,2902,194211,92,289818
39413,0.002445,172.31.47.0-255,66,194277,92,289818
39414,0.00245,172.217.194.0-255,5738,200015,92,289818
39415,0.002452,172.31.47.0-255,66,200081,92,289818
39416,0.002457,172.217.194.0-255,7156,207237,92,289818
39417,0.002463,172.217.194.0-255,1484,208721,92,289818
39418,0.002476,172.217.194.0-255,7156,215877,92,289818
39419,0.002499,172.217.194.0-255,5738,221615,92,289818
39420,0.002502,172.217.194.0-255,2184,223799,92,289818
39421,0.002577,172.217.194.0-255,1484,225283,92,289818
39422,0.002581,172.217.194.0-255,2902,228185,92,289818
39423,0.002592,172.217.194.0-255,1484,229669,92,289818
39424,0.002606,172.217.194.0-255,4320,233989,92,289818
39425,0.002628,172.217.194.0-255,5738,239727,92,289818
39426,0.002651,172.217.194.0-255,4320,244047,92,289818
39427,0.002665,172.217.194.0-255,2902,246949,92,289818
39428,0.002681,172.217.194.0-255,4320,251269,92,289818
39429,0.00272,172.217.194.0-255,6438,257707,92,289818
39430,0.002753,172.217.194.0-255,7156,264863,92,289818
39431,0.002802,172.217.194.0-255,2184,267047,92,289818
39432,0.002823,172.217.194.0-255,7156,274203,92,289818
39433,0.002841,172.217.194.0-255,2902,277105,92,289818
39434,0.002843,172.217.194.0-255,1484,278589,92,289818
39435,0.002884,172.217.194.0-255,1484,280073,92,289818
39436,0.002887,172.217.194.0-255,1484,281557,92,289818
39437,0.002889,172.217.194.0-255,184,281741,92,289818
39438,0.002935,172.217.194.0-255,105,281846,92,289818
39439,0.005803,172.31.47.0-255,66,281912,92,289818
39440,0.007308,172.31.47.0-255,105,282017,92,289818
39441,0.009357,172.217.194.0-255,66,282083,92,289818
39442,0.031962,172.31.47.0-255,172,282255,92,289818
39443,0.031992,172.31.47.0-255,1111,283366,92,289818
39444,0.032032,172.31.47.0-255,1514,284880,92,289818
39445,0.032034,172.31.47.0-255,1514,286394,92,289818
39446,0.03204,172.31.47.0-255,1514,287908,92,289818
39447,0.032041,172.31.47.0-255,1514,289422,92,289818
39448,0.032061,172.31.47.0-255,132,289554,92,289818
39449,0.033519,104.244.42.0-255,66,289620,92,289818
39450,0.033557,104.244.42.0-255,66,289686,92,289818
39451,0.03361,104.244.42.0-255,66,289752,92,289818
39452,0.033613,104.244.42.0-255,66,289818,92,289818
39453,0.0,172.31.47.0-255,105,105,92,105
39454,0.0,74.125.24.0-255,298,298,92,259574
39455,2.3e-05,172.31.47.0-255,66,364,92,259574
39456,3e-05,74.125.24.0-255,1484,1848,92,259574
39457,3.5e-05,172.31.47.0-255,66,1914,92,259574
39458,5.1e-05,74.125.24.0-255,4320,6234,92,259574
39459,5.4e-05,172.31.47.0-255,66,6300,92,259574
39460,6.2e-05,74.125.24.0-255,7156,13456,92,259574
39461,6.5e-05,172.31.47.0-255,66,13522,92,259574
39462,8.7e-05,74.125.24.0-255,394,13916,92,259574
39463,9.3e-05,172.31.47.0-255,66,13982,92,259574
39464,0.000156,74.125.24.0-255,1484,15466,92,259574
39465,0.000159,172.31.47.0-255,66,15532,92,259574
39466,0.000164,74.125.24.0-255,2902,18434,92,259574
39467,0.000166,172.31.47.0-255,66,18500,92,259574
39468,0.000194,74.125.24.0-255,5738,24238,92,259574
39469,0.000197,172.31.47.0-255,66,24304,92,259574
39470,0.0002,74.125.24.0-255,1484,25788,92,259574
39471,0.000202,172.31.47.0-255,66,25854,92,259574
39472,0.000233,74.125.24.0-255,5379,31233,92,259574
39473,0.000238,172.31.47.0-255,66,31299,92,259574
39474,0.000376,74.125.24.0-255,1484,32783,92,259574
39475,0.00038,172.31.47.0-255,66,32849,92,259574
39476,0.000385,74.125.24.0-255,1484,34333,92,259574
39477,0.000387,172.31.47.0-255,66,34399,92,259574
39478,0.000407,74.125.24.0-255,1484,35883,92,259574
39479,0.000409,172.31.47.0-255,66,35949,92,259574
39480,0.00042,74.125.24.0-255,5738,41687,92,259574
39481,0.000423,172.31.47.0-255,66,41753,92,259574
39482,0.000428,74.125.24.0-255,2902,44655,92,259574
39483,0.000431,172.31.47.0-255,66,44721,92,259574
39484,0.000459,74.125.24.0-255,1484,46205,92,259574
39485,0.000462,172.31.47.0-255,66,46271,92,259574
39486,0.000466,74.125.24.0-255,2902,49173,92,259574
39487,0.000469,172.31.47.0-255,66,49239,92,259574
39488,0.00051,172.31.47.0-255,66,49305,92,259574
39489,0.000513,74.125.24.0-255,1484,50789,92,259574
39490,0.00054,74.125.24.0-255,5379,56168,92,259574
39491,0.000543,172.31.47.0-255,66,56234,92,259574
39492,0.000584,74.125.24.0-255,646,56880,92,259574
39493,0.001156,172.31.47.0-255,66,56946,92,259574
39494,0.001249,74.125.24.0-255,1484,58430,92,259574
39495,0.001257,74.125.24.0-255,2902,61332,92,259574
39496,0.00126,172.31.47.0-255,66,61398,92,259574
39497,0.001292,74.125.24.0-255,5738,67136,92,259574
39498,0.001294,172.31.47.0-255,66,67202,92,259574
39499,0.001298,74.125.24.0-255,1484,68686,92,259574
39500,0.001335,172.31.47.0-255,66,68752,92,259574
39501,0.00134,74.125.24.0-255,4320,73072,92,259574
39502,0.001342,172.31.47.0-255,66,73138,92,259574
39503,0.001379,74.125.24.0-255,6438,79576,92,259574
39504,0.001381,172.31.47.0-255,66,79642,92,259574
39505,0.001741,74.125.24.0-255,1484,81126,92,259574
39506,0.00175,74.125.24.0-255,2902,84028,92,259574
39507,0.001754,172.31.47.0-255,66,84094,92,259574
39508,0.001761,74.125.24.0-255,5738,89832,92,259574
39509,0.001764,172.31.47.0-255,66,89898,92,259574
39510,0.0018,172.31.47.0-255,66,89964,92,259574
39511,0.001831,74.125.24.0-255,1484,91448,92,259574
39512,0.001849,74.125.24.0-255,7156,98604,92,259574
39513,0.001852,172.31.47.0-255,66,98670,92,259574
39514,0.001882,74.125.24.0-255,6438,105108,92,259574
39515,0.001885,172.31.47.0-255,66,105174,92,259574
39516,0.004159,74.125.24.0-255,2902,108076,92,259574
39517,0.004167,172.31.47.0-255,66,108142,92,259574
39518,0.004195,74.125.24.0-255,2902,111044,92,259574
39519,0.004199,172.31.47.0-255,66,111110,92,259574
39520,0.006457,74.125.24.0-255,2902,114012,92,259574
39521,0.006465,172.31.47.0-255,66,114078,92,259574
39522,0.006496,74.125.24.0-255,2902,116980,92,259574
39523,0.006499,172.31.47.0-255,66,117046,92,259574
39524,0.008759,74.125.24.0-255,5738,122784,92,259574
39525,0.008764,172.31.47.0-255,66,122850,92,259574
39526,0.011078,74.125.24.0-255,5738,128588,92,259574
39527,0.011084,172.31.47.0-255,66,128654,92,259574
39528,0.013363,74.125.24.0-255,5738,134392,92,259574
39529,0.01337,172.31.47.0-255,66,134458,92,259574
39530,0.015676,74.125.24.0-255,5738,140196,92,259574
39531,0.015684,172.31.47.0-255,66,140262,92,259574
39532,0.017964,74.125.24.0-255,5738,146000,92,259574
39533,0.017971,172.31.47.0-255,66,146066,92,259574
39534,0.020251,74.125.24.0-255,5738,151804,92,259574
39535,0.020261,172.31.47.0-255,66,151870,92,259574
39536,0.022531,74.125.24.0-255,5738,157608,92,259574
39537,0.022538,172.31.47.0-255,66,157674,92,259574
39538,0.024824,74.125.24.0-255,5738,163412,92,259574
39539,0.024831,172.31.47.0-255,66,163478,92,259574
39540,0.027127,74.125.24.0-255,5738,169216,92,259574
39541,0.027134,172.31.47.0-255,66,169282,92,259574
39542,0.029412,74.125.24.0-255,5738,175020,92,259574
39543,0.02942,172.31.47.0-255,66,175086,92,259574
39544,0.031698,74.125.24.0-255,5738,180824,92,259574
39545,0.031705,172.31.47.0-255,66,180890,92,259574
39546,0.033987,74.125.24.0-255,5738,186628,92,259574
39547,0.033993,172.31.47.0-255,66,186694,92,259574
39548,0.03433,172.31.47.0-255,176,186870,92,259574
39549,0.034358,172.31.47.0-255,1113,187983,92,259574
39550,0.034422,172.31.47.0-255,1514,189497,92,259574
39551,0.034423,172.31.47.0-255,1514,191011,92,259574
39552,0.034424,172.31.47.0-255,1514,192525,92,259574
39553,0.034425,172.31.47.0-255,1514,194039,92,259574
39554,0.034426,172.31.47.0-255,1493,195532,92,259574
39555,0.035878,104.244.42.0-255,66,195598,92,259574
39556,0.035918,104.244.42.0-255,66,195664,92,259574
39557,0.036068,104.244.42.0-255,66,195730,92,259574
39558,0.036266,74.125.24.0-255,5738,201468,92,259574
39559,0.036274,172.31.47.0-255,66,201534,92,259574
39560,0.038551,74.125.24.0-255,5738,207272,92,259574
39561,0.03856,172.31.47.0-255,66,207338,92,259574
39562,0.040871,74.125.24.0-255,5738,213076,92,259574
39563,0.04088,172.31.47.0-255,66,213142,92,259574
39564,0.043154,74.125.24.0-255,5738,218880,92,259574
39565,0.043161,172.31.47.0-255,66,218946,92,259574
39566,0.045451,74.125.24.0-255,5738,224684,92,259574
39567,0.045462,172.31.47.0-255,66,224750,92,259574
39568,0.047763,74.125.24.0-255,5738,230488,92,259574
39569,0.04777,172.31.47.0-255,66,230554,92,259574
39570,0.050051,74.125.24.0-255,5738,236292,92,259574
39571,0.050058,172.31.47.0-255,66,236358,92,259574
39572,0.052343,74.125.24.0-255,5738,242096,92,259574
39573,0.052349,172.31.47.0-255,66,242162,92,259574
39574,0.05464,74.125.24.0-255,5738,247900,92,259574
39575,0.054647,172.31.47.0-255,66,247966,92,259574
39576,0.056946,74.125.24.0-255,5738,253704,92,259574
39577,0.056953,172.31.47.0-255,66,253770,92,259574
39578,0.059224,74.125.24.0-255,5738,259508,92,259574
39579,0.05923,172.31.47.0-255,66,259574,92,259574
39580,0.0,74.125.24.0-255,153,153,92,291594
39581,2.3e-05,172.31.47.0-255,66,219,92,291594
39582,2.9e-05,74.125.24.0-255,1484,1703,92,291594
39583,3.2e-05,172.31.47.0-255,66,1769,92,291594
39584,3.6e-05,74.125.24.0-255,2902,4671,92,291594
39585,3.9e-05,172.31.47.0-255,66,4737,92,291594
39586,5e-05,74.125.24.0-255,7156,11893,92,291594
39587,5.4e-05,172.31.47.0-255,66,11959,92,291594
39588,9.9e-05,172.31.47.0-255,66,12025,92,291594
39589,0.000129,74.125.24.0-255,6346,18371,92,291594
39590,0.000133,172.31.47.0-255,66,18437,92,291594
39591,0.000138,74.125.24.0-255,3961,22398,92,291594
39592,0.00014,172.31.47.0-255,66,22464,92,291594
39593,0.000433,74.125.24.0-255,1484,23948,92,291594
39594,0.000439,172.31.47.0-255,66,24014,92,291594
39595,0.000445,74.125.24.0-255,2902,26916,92,291594
39596,0.000448,172.31.47.0-255,66,26982,92,291594
39597,0.00047,74.125.24.0-255,4320,31302,92,291594
39598,0.000474,172.31.47.0-255,66,31368,92,291594
39599,0.000511,74.125.24.0-255,2902,34270,92,291594
39600,0.000519,172.31.47.0-255,66,34336,92,291594
39601,0.000527,74.125.24.0-255,5379,39715,92,291594
39602,0.000529,172.31.47.0-255,66,39781,92,291594
39603,0.000602,74.125.24.0-255,1484,41265,92,291594
39604,0.000605,172.31.47.0-255,66,41331,92,291594
39605,0.00061,74.125.24.0-255,2902,44233,92,291594
39606,0.000612,172.31.47.0-255,66,44299,92,291594
39607,0.00064,74.125.24.0-255,5738,50037,92,291594
39608,0.000644,172.31.47.0-255,66,50103,92,291594
39609,0.000674,74.125.24.0-255,6797,56900,92,291594
39610,0.000677,172.31.47.0-255,66,56966,92,291594
39611,0.0007,74.125.24.0-255,646,57612,92,291594
39612,0.000859,172.31.47.0-255,66,57678,92,291594
39613,0.000955,74.125.24.0-255,1484,59162,92,291594
39614,0.000964,74.125.24.0-255,2902,62064,92,291594
39615,0.000977,74.125.24.0-255,2902,64966,92,291594
39616,0.000989,74.125.24.0-255,2902,67868,92,291594
39617,0.00101,74.125.24.0-255,5738,73606,92,291594
39618,0.001024,74.125.24.0-255,2543,76149,92,291594
39619,0.001029,74.125.24.0-255,2902,79051,92,291594
39620,0.001048,74.125.24.0-255,5738,84789,92,291594
39621,0.001074,74.125.24.0-255,4320,89109,92,291594
39622,0.001086,74.125.24.0-255,2543,91652,92,291594
39623,0.001453,74.125.24.0-255,1484,93136,92,291594
39624,0.00146,74.125.24.0-255,2902,96038,92,291594
39625,0.001471,74.125.24.0-255,1484,97522,92,291594
39626,0.001486,74.125.24.0-255,4320,101842,92,291594
39627,0.001497,74.125.24.0-255,1484,103326,92,291594
39628,0.00153,74.125.24.0-255,1484,104810,92,291594
39629,0.001563,74.125.24.0-255,5738,110548,92,291594
39630,0.00158,74.125.24.0-255,4471,115019,92,291594
39631,0.00161,74.125.24.0-255,1484,116503,92,291594
39632,0.001629,74.125.24.0-255,1484,117987,92,291594
39633,0.001638,74.125.24.0-255,1484,119471,92,291594
39634,0.001641,74.125.24.0-255,2902,122373,92,291594
39635,0.001651,74.125.24.0-255,2902,125275,92,291594
39636,0.00168,74.125.24.0-255,1484,126759,92,291594
39637,0.001701,74.125.24.0-255,4320,131079,92,291594
39638,0.001713,74.125.24.0-255,2902,133981,92,291594
39639,0.001723,74.125.24.0-255,2184,136165,92,291594
39640,0.004249,172.31.47.0-255,66,136231,92,291594
39641,0.00628,74.125.24.0-255,5738,141969,92,291594
39642,0.006286,172.31.47.0-255,66,142035,92,291594
39643,0.008298,74.125.24.0-255,5738,147773,92,291594
39644,0.008305,172.31.47.0-255,66,147839,92,291594
39645,0.010329,74.125.24.0-255,5738,153577,92,291594
39646,0.010336,172.31.47.0-255,66,153643,92,291594
39647,0.01235,74.125.24.0-255,5738,159381,92,291594
39648,0.012357,172.31.47.0-255,66,159447,92,291594
39649,0.014411,74.125.24.0-255,5738,165185,92,291594
39650,0.014419,172.31.47.0-255,66,165251,92,291594
39651,0.016486,74.125.24.0-255,5738,170989,92,291594
39652,0.016494,172.31.47.0-255,66,171055,92,291594
39653,0.018522,74.125.24.0-255,5738,176793,92,291594
39654,0.018528,172.31.47.0-255,66,176859,92,291594
39655,0.020549,74.125.24.0-255,5738,182597,92,291594
39656,0.020556,172.31.47.0-255,66,182663,92,291594
39657,0.02267,74.125.24.0-255,5738,188401,92,291594
39658,0.022678,172.31.47.0-255,66,188467,92,291594
39659,0.024773,74.125.24.0-255,5738,194205,92,291594
39660,0.024784,172.31.47.0-255,66,194271,92,291594
39661,0.026877,74.125.24.0-255,5738,200009,92,291594
39662,0.026885,172.31.47.0-255,66,200075,92,291594
39663,0.028112,172.31.47.0-255,172,200247,92,291594
39664,0.028141,172.31.47.0-255,1112,201359,92,291594
39665,0.028172,172.31.47.0-255,569,201928,92,291594
39666,0.028951,74.125.24.0-255,4320,206248,92,291594
39667,0.028958,172.31.47.0-255,66,206314,92,291594
39668,0.028992,74.125.24.0-255,1484,207798,92,291594
39669,0.029676,104.244.42.0-255,66,207864,92,291594
39670,0.029685,104.244.42.0-255,66,207930,92,291594
39671,0.02972,104.244.42.0-255,66,207996,92,291594
39672,0.031008,74.125.24.0-255,4320,212316,92,291594
39673,0.031013,172.31.47.0-255,66,212382,92,291594
39674,0.033048,74.125.24.0-255,4320,216702,92,291594
39675,0.033054,172.31.47.0-255,66,216768,92,291594
39676,0.033088,74.125.24.0-255,1484,218252,92,291594
39677,0.035127,74.125.24.0-255,4320,222572,92,291594
39678,0.035134,172.31.47.0-255,66,222638,92,291594
39679,0.037174,74.125.24.0-255,5738,228376,92,291594
39680,0.037224,172.31.47.0-255,66,228442,92,291594
39681,0.039223,74.125.24.0-255,5738,234180,92,291594
39682,0.039228,172.31.47.0-255,66,234246,92,291594
39683,0.041268,74.125.24.0-255,4320,238566,92,291594
39684,0.041273,172.31.47.0-255,66,238632,92,291594
39685,0.041304,74.125.24.0-255,1484,240116,92,291594
39686,0.043299,74.125.24.0-255,4320,244436,92,291594
39687,0.043304,172.31.47.0-255,66,244502,92,291594
39688,0.04534,74.125.24.0-255,2902,247404,92,291594
39689,0.045346,172.31.47.0-255,66,247470,92,291594
39690,0.045381,74.125.24.0-255,2902,250372,92,291594
39691,0.045392,172.31.47.0-255,66,250438,92,291594
39692,0.047403,74.125.24.0-255,5738,256176,92,291594
39693,0.047464,172.31.47.0-255,66,256242,92,291594
39694,0.049537,74.125.24.0-255,5738,261980,92,291594
39695,0.049543,172.31.47.0-255,66,262046,92,291594
39696,0.051556,74.125.24.0-255,5738,267784,92,291594
39697,0.051562,172.31.47.0-255,66,267850,92,291594
39698,0.053564,74.125.24.0-255,2902,270752,92,291594
39699,0.053569,172.31.47.0-255,66,270818,92,291594
39700,0.053608,74.125.24.0-255,2902,273720,92,291594
39701,0.053621,172.31.47.0-255,66,273786,92,291594
39702,0.055694,74.125.24.0-255,2902,276688,92,291594
39703,0.055698,172.31.47.0-255,66,276754,92,291594
39704,0.05573,74.125.24.0-255,2902,279656,92,291594
39705,0.055747,172.31.47.0-255,66,279722,92,291594
39706,0.057733,74.125.24.0-255,2902,282624,92,291594
39707,0.057738,172.31.47.0-255,66,282690,92,291594
39708,0.057879,74.125.24.0-255,2902,285592,92,291594
39709,0.057884,172.31.47.0-255,66,285658,92,291594
39710,0.05976,74.125.24.0-255,2902,288560,92,291594
39711,0.059765,172.31.47.0-255,66,288626,92,291594
39712,0.059954,74.125.24.0-255,2902,291528,92,291594
39713,0.05996,172.31.47.0-255,66,291594,92,291594
39714,0.0,74.125.130.0-255,153,153,92,303457
39715,1.5e-05,172.31.47.0-255,66,219,92,303457
39716,3.6e-05,74.125.130.0-255,1484,1703,92,303457
39717,4e-05,172.31.47.0-255,66,1769,92,303457
39718,4.5e-05,74.125.130.0-255,2902,4671,92,303457
39719,4.7e-05,172.31.47.0-255,66,4737,92,303457
39720,7.6e-05,74.125.130.0-255,5738,10475,92,303457
39721,7.9e-05,172.31.47.0-255,66,10541,92,303457
39722,0.0001,74.125.130.0-255,3393,13934,92,303457
39723,0.000103,172.31.47.0-255,66,14000,92,303457
39724,0.000108,74.125.130.0-255,4320,18320,92,303457
39725,0.00011,172.31.47.0-255,66,18386,92,303457
39726,0.000138,172.31.47.0-255,66,18452,92,303457
39727,0.000157,74.125.130.0-255,1484,19936,92,303457
39728,0.000159,172.31.47.0-255,66,20002,92,303457
39729,0.000177,74.125.130.0-255,2543,22545,92,303457
39730,0.000179,172.31.47.0-255,66,22611,92,303457
39731,0.000343,74.125.130.0-255,1484,24095,92,303457
39732,0.000346,172.31.47.0-255,66,24161,92,303457
39733,0.000357,74.125.130.0-255,2902,27063,92,303457
39734,0.00036,172.31.47.0-255,66,27129,92,303457
39735,0.000383,74.125.130.0-255,4320,31449,92,303457
39736,0.000385,172.31.47.0-255,66,31515,92,303457
39737,0.000406,74.125.130.0-255,1484,32999,92,303457
39738,0.000408,172.31.47.0-255,66,33065,92,303457
39739,0.000416,74.125.130.0-255,6797,39862,92,303457
39740,0.000418,172.31.47.0-255,66,39928,92,303457
39741,0.000463,172.31.47.0-255,66,39994,92,303457
39742,0.000479,74.125.130.0-255,1484,41478,92,303457
39743,0.000481,172.31.47.0-255,66,41544,92,303457
39744,0.000503,74.125.130.0-255,6797,48341,92,303457
39745,0.000506,172.31.47.0-255,66,48407,92,303457
39746,0.000519,74.125.130.0-255,376,48783,92,303457
39747,0.000552,74.125.130.0-255,102,48885,92,303457
39748,0.000693,74.125.130.0-255,362,49247,92,303457
39749,0.000898,74.125.130.0-255,1484,50731,92,303457
39750,0.000901,172.31.47.0-255,66,50797,92,303457
39751,0.000906,74.125.130.0-255,2902,53699,92,303457
39752,0.000909,172.31.47.0-255,66,53765,92,303457
39753,0.000932,74.125.130.0-255,5738,59503,92,303457
39754,0.000934,172.31.47.0-255,66,59569,92,303457
39755,0.000974,172.31.47.0-255,66,59635,92,303457
39756,0.000976,74.125.130.0-255,1484,61119,92,303457
39757,0.001002,172.31.47.0-255,66,61185,92,303457
39758,0.001005,74.125.130.0-255,1484,62669,92,303457
39759,0.001023,74.125.130.0-255,3602,66271,92,303457
39760,0.001025,172.31.47.0-255,66,66337,92,303457
39761,0.001338,74.125.130.0-255,1484,67821,92,303457
39762,0.00135,74.125.130.0-255,1484,69305,92,303457
39763,0.001352,172.31.47.0-255,66,69371,92,303457
39764,0.001372,74.125.130.0-255,2902,72273,92,303457
39765,0.001375,172.31.47.0-255,66,72339,92,303457
39766,0.001397,74.125.130.0-255,1484,73823,92,303457
39767,0.001407,74.125.130.0-255,1484,75307,92,303457
39768,0.001409,172.31.47.0-255,66,75373,92,303457
39769,0.001425,74.125.130.0-255,1484,76857,92,303457
39770,0.001428,74.125.130.0-255,1484,78341,92,303457
39771,0.00143,172.31.47.0-255,66,78407,92,303457
39772,0.001443,74.125.130.0-255,2902,81309,92,303457
39773,0.001446,172.31.47.0-255,66,81375,92,303457
39774,0.001464,74.125.130.0-255,1484,82859,92,303457
39775,0.001471,74.125.130.0-255,7156,90015,92,303457
39776,0.001474,172.31.47.0-255,66,90081,92,303457
39777,0.001491,74.125.130.0-255,5738,95819,92,303457
39778,0.001494,172.31.47.0-255,66,95885,92,303457
39779,0.001504,74.125.130.0-255,2902,98787,92,303457
39780,0.001506,172.31.47.0-255,66,98853,92,303457
39781,0.001518,74.125.130.0-255,2184,101037,92,303457
39782,0.00152,172.31.47.0-255,66,101103,92,303457
39783,0.002108,74.125.130.0-255,1484,102587,92,303457
39784,0.002123,74.125.130.0-255,2902,105489,92,303457
39785,0.002127,172.31.47.0-255,66,105555,92,303457
39786,0.002131,74.125.130.0-255,1484,107039,92,303457
39787,0.002149,74.125.130.0-255,4320,111359,92,303457
39788,0.002152,172.31.47.0-255,66,111425,92,303457
39789,0.002172,74.125.130.0-255,1484,112909,92,303457
39790,0.002176,74.125.130.0-255,2902,115811,92,303457
39791,0.002179,172.31.47.0-255,66,115877,92,303457
39792,0.0022,74.125.130.0-255,1484,117361,92,303457
39793,0.002218,74.125.130.0-255,4320,121681,92,303457
39794,0.002221,172.31.47.0-255,66,121747,92,303457
39795,0.002256,74.125.130.0-255,7156,128903,92,303457
39796,0.002259,172.31.47.0-255,66,128969,92,303457
39797,0.002263,74.125.130.0-255,1484,130453,92,303457
39798,0.002286,74.125.130.0-255,1484,131937,92,303457
39799,0.002288,172.31.47.0-255,66,132003,92,303457
39800,0.002306,74.125.130.0-255,1484,133487,92,303457
39801,0.00231,74.125.130.0-255,2184,135671,92,303457
39802,0.002312,172.31.47.0-255,66,135737,92,303457
39803,0.002362,74.125.130.0-255,2902,138639,92,303457
39804,0.002365,172.31.47.0-255,66,138705,92,303457
39805,0.002368,74.125.130.0-255,1484,140189,92,303457
39806,0.002389,74.125.130.0-255,2902,143091,92,303457
39807,0.002392,172.31.47.0-255,66,143157,92,303457
39808,0.002415,74.125.130.0-255,1484,144641,92,303457
39809,0.002428,74.125.130.0-255,1484,146125,92,303457
39810,0.00243,172.31.47.0-255,66,146191,92,303457
39811,0.002436,74.125.130.0-255,4320,150511,92,303457
39812,0.002438,172.31.47.0-255,66,150577,92,303457
39813,0.002472,74.125.130.0-255,5738,156315,92,303457
39814,0.002478,172.31.47.0-255,66,156381,92,303457
39815,0.002504,74.125.130.0-255,7156,163537,92,303457
39816,0.002507,172.31.47.0-255,66,163603,92,303457
39817,0.002512,74.125.130.0-255,2902,166505,92,303457
39818,0.002513,172.31.47.0-255,66,166571,92,303457
39819,0.005008,74.125.130.0-255,4320,170891,92,303457
39820,0.005014,172.31.47.0-255,66,170957,92,303457
39821,0.00503,74.125.130.0-255,1484,172441,92,303457
39822,0.007511,74.125.130.0-255,4320,176761,92,303457
39823,0.007513,172.31.47.0-255,66,176827,92,303457
39824,0.010031,74.125.130.0-255,5738,182565,92,303457
39825,0.010039,172.31.47.0-255,66,182631,92,303457
39826,0.01257,74.125.130.0-255,5738,188369,92,303457
39827,0.012576,172.31.47.0-255,66,188435,92,303457
39828,0.015084,74.125.130.0-255,5738,194173,92,303457
39829,0.01509,172.31.47.0-255,66,194239,92,303457
39830,0.017597,74.125.130.0-255,5738,199977,92,303457
39831,0.017607,172.31.47.0-255,66,200043,92,303457
39832,0.020104,74.125.130.0-255,5738,205781,92,303457
39833,0.020111,172.31.47.0-255,66,205847,92,303457
39834,0.0226,74.125.130.0-255,5738,211585,92,303457
39835,0.022605,172.31.47.0-255,66,211651,92,303457
39836,0.025137,74.125.130.0-255,5738,217389,92,303457
39837,0.025143,172.31.47.0-255,66,217455,92,303457
39838,0.027646,74.125.130.0-255,5738,223193,92,303457
39839,0.027652,172.31.47.0-255,66,223259,92,303457
39840,0.030162,74.125.130.0-255,5738,228997,92,303457
39841,0.030168,172.31.47.0-255,66,229063,92,303457
39842,0.031084,172.31.47.0-255,172,229235,92,303457
39843,0.031112,172.31.47.0-255,1113,230348,92,303457
39844,0.031148,172.31.47.0-255,1514,231862,92,303457
39845,0.031149,172.31.47.0-255,1514,233376,92,303457
39846,0.03115,172.31.47.0-255,1514,234890,92,303457
39847,0.031151,172.31.47.0-255,1514,236404,92,303457
39848,0.031152,172.31.47.0-255,1493,237897,92,303457
39849,0.032653,104.244.42.0-255,66,237963,92,303457
39850,0.032662,74.125.130.0-255,2902,240865,92,303457
39851,0.032665,172.31.47.0-255,66,240931,92,303457
39852,0.032698,104.244.42.0-255,66,240997,92,303457
39853,0.032702,74.125.130.0-255,2902,243899,92,303457
39854,0.032704,172.31.47.0-255,66,243965,92,303457
39855,0.032739,104.244.42.0-255,66,244031,92,303457
39856,0.035164,74.125.130.0-255,2902,246933,92,303457
39857,0.035168,172.31.47.0-255,66,246999,92,303457
39858,0.035199,74.125.130.0-255,2902,249901,92,303457
39859,0.035202,172.31.47.0-255,66,249967,92,303457
39860,0.037661,74.125.130.0-255,2902,252869,92,303457
39861,0.037666,172.31.47.0-255,66,252935,92,303457
39862,0.037694,74.125.130.0-255,2902,255837,92,303457
39863,0.037697,172.31.47.0-255,66,255903,92,303457
39864,0.040151,74.125.130.0-255,1484,257387,92,303457
39865,0.040175,74.125.130.0-255,1484,258871,92,303457
39866,0.040178,172.31.47.0-255,66,258937,92,303457
39867,0.040198,74.125.130.0-255,2902,261839,92,303457
39868,0.040201,172.31.47.0-255,66,261905,92,303457
39869,0.042674,74.125.130.0-255,2902,264807,92,303457
39870,0.04268,172.31.47.0-255,66,264873,92,303457
39871,0.042696,74.125.130.0-255,2902,267775,92,303457
39872,0.042698,172.31.47.0-255,66,267841,92,303457
39873,0.045175,74.125.130.0-255,2902,270743,92,303457
39874,0.04518,172.31.47.0-255,66,270809,92,303457
39875,0.045205,74.125.130.0-255,2902,273711,92,303457
39876,0.045208,172.31.47.0-255,66,273777,92,303457
39877,0.047678,74.125.130.0-255,2902,276679,92,303457
39878,0.047682,172.31.47.0-255,66,276745,92,303457
39879,0.047708,74.125.130.0-255,2902,279647,92,303457
39880,0.047711,172.31.47.0-255,66,279713,92,303457
39881,0.050177,74.125.130.0-255,2902,282615,92,303457
39882,0.050181,172.31.47.0-255,66,282681,92,303457
39883,0.050206,74.125.130.0-255,2902,285583,92,303457
39884,0.050209,172.31.47.0-255,66,285649,92,303457
39885,0.052677,74.125.130.0-255,2902,288551,92,303457
39886,0.052683,172.31.47.0-255,66,288617,92,303457
39887,0.052712,74.125.130.0-255,2902,291519,92,303457
39888,0.052716,172.31.47.0-255,66,291585,92,303457
39889,0.055194,74.125.130.0-255,2902,294487,92,303457
39890,0.055198,172.31.47.0-255,66,294553,92,303457
39891,0.055233,74.125.130.0-255,2902,297455,92,303457
39892,0.055237,172.31.47.0-255,66,297521,92,303457
39893,0.057697,74.125.130.0-255,2902,300423,92,303457
39894,0.057703,172.31.47.0-255,66,300489,92,303457
39895,0.057736,74.125.130.0-255,2902,303391,92,303457
39896,0.057739,172.31.47.0-255,66,303457,92,303457
39897,0.0,172.31.47.0-255,105,105,92,189612
39898,0.034098,172.217.194.0-255,153,258,92,189612
39899,0.034111,172.31.47.0-255,66,324,92,189612
39900,0.034117,172.217.194.0-255,1484,1808,92,189612
39901,0.03412,172.31.47.0-255,66,1874,92,189612
39902,0.034125,172.217.194.0-255,2902,4776,92,189612
39903,0.034127,172.31.47.0-255,66,4842,92,189612
39904,0.034131,172.217.194.0-255,1484,6326,92,189612
39905,0.034133,172.31.47.0-255,66,6392,92,189612
39906,0.034161,172.217.194.0-255,5738,12130,92,189612
39907,0.034163,172.31.47.0-255,66,12196,92,189612
39908,0.034177,172.217.194.0-255,2155,14351,92,189612
39909,0.034179,172.31.47.0-255,66,14417,92,189612
39910,0.034251,172.217.194.0-255,1484,15901,92,189612
39911,0.034255,172.31.47.0-255,66,15967,92,189612
39912,0.034259,172.217.194.0-255,2902,18869,92,189612
39913,0.034261,172.31.47.0-255,66,18935,92,189612
39914,0.034266,172.217.194.0-255,4320,23255,92,189612
39915,0.034269,172.31.47.0-255,66,23321,92,189612
39916,0.034292,172.217.194.0-255,1484,24805,92,189612
39917,0.034294,172.31.47.0-255,66,24871,92,189612
39918,0.034301,172.217.194.0-255,5738,30609,92,189612
39919,0.034303,172.31.47.0-255,66,30675,92,189612
39920,0.034339,172.31.47.0-255,66,30741,92,189612
39921,0.034343,172.217.194.0-255,2902,33643,92,189612
39922,0.034344,172.31.47.0-255,66,33709,92,189612
39923,0.034376,172.31.47.0-255,66,33775,92,189612
39924,0.03438,172.217.194.0-255,2460,36235,92,189612
39925,0.034381,172.31.47.0-255,66,36301,92,189612
39926,0.034411,172.217.194.0-255,118,36419,92,189612
39927,0.034413,172.31.47.0-255,66,36485,92,189612
39928,0.034467,172.217.194.0-255,1484,37969,92,189612
39929,0.03447,172.31.47.0-255,66,38035,92,189612
39930,0.034475,172.217.194.0-255,2902,40937,92,189612
39931,0.034477,172.31.47.0-255,66,41003,92,189612
39932,0.034481,172.217.194.0-255,2902,43905,92,189612
39933,0.034483,172.31.47.0-255,66,43971,92,189612
39934,0.034509,172.217.194.0-255,2902,46873,92,189612
39935,0.034512,172.31.47.0-255,66,46939,92,189612
39936,0.034516,172.217.194.0-255,2902,49841,92,189612
39937,0.034564,172.31.47.0-255,66,49907,92,189612
39938,0.034633,172.217.194.0-255,1484,51391,92,189612
39939,0.034652,172.217.194.0-255,2902,54293,92,189612
39940,0.034658,172.217.194.0-255,5738,60031,92,189612
39941,0.034699,172.31.47.0-255,66,60097,92,189612
39942,0.034741,172.217.194.0-255,5738,65835,92,189612
39943,0.034747,172.31.47.0-255,66,65901,92,189612
39944,0.034768,172.217.194.0-255,5020,70921,92,189612
39945,0.034771,172.217.194.0-255,1484,72405,92,189612
39946,0.034775,172.217.194.0-255,2902,75307,92,189612
39947,0.03478,172.217.194.0-255,5738,81045,92,189612
39948,0.034791,172.217.194.0-255,1484,82529,92,189612
39949,0.034807,172.217.194.0-255,5379,87908,92,189612
39950,0.034812,172.31.47.0-255,66,87974,92,189612
39951,0.03483,172.217.194.0-255,1484,89458,92,189612
39952,0.034848,172.217.194.0-255,5738,95196,92,189612
39953,0.034856,172.217.194.0-255,7156,102352,92,189612
39954,0.034862,172.31.47.0-255,66,102418,92,189612
39955,0.034871,172.217.194.0-255,2902,105320,92,189612
39956,0.034879,172.31.47.0-255,66,105386,92,189612
39957,0.03493,172.31.47.0-255,66,105452,92,189612
39958,0.034944,172.217.194.0-255,1484,106936,92,189612
39959,0.034987,172.31.47.0-255,66,107002,92,189612
39960,0.035146,172.217.194.0-255,1484,108486,92,189612
39961,0.035151,172.217.194.0-255,2902,111388,92,189612
39962,0.035158,172.31.47.0-255,66,111454,92,189612
39963,0.035172,172.217.194.0-255,5738,117192,92,189612
39964,0.035211,172.31.47.0-255,66,117258,92,189612
39965,0.035227,172.217.194.0-255,2902,120160,92,189612
39966,0.035259,172.31.47.0-255,66,120226,92,189612
39967,0.035529,172.217.194.0-255,1484,121710,92,189612
39968,0.035534,172.217.194.0-255,2902,124612,92,189612
39969,0.035536,172.217.194.0-255,1484,126096,92,189612
39970,0.035559,172.217.194.0-255,4320,130416,92,189612
39971,0.035588,172.217.194.0-255,4320,134736,92,189612
39972,0.035603,172.31.47.0-255,66,134802,92,189612
39973,0.035662,172.217.194.0-255,1484,136286,92,189612
39974,0.035667,172.217.194.0-255,2902,139188,92,189612
39975,0.035677,172.31.47.0-255,66,139254,92,189612
39976,0.03569,172.217.194.0-255,5738,144992,92,189612
39977,0.035745,172.31.47.0-255,66,145058,92,189612
39978,0.035765,172.217.194.0-255,2184,147242,92,189612
39979,0.035804,172.31.47.0-255,66,147308,92,189612
39980,0.035822,172.217.194.0-255,1484,148792,92,189612
39981,0.035827,172.217.194.0-255,2902,151694,92,189612
39982,0.035846,172.217.194.0-255,5738,157432,92,189612
39983,0.035883,172.31.47.0-255,66,157498,92,189612
39984,0.035945,172.217.194.0-255,7156,164654,92,189612
39985,0.03595,172.31.47.0-255,66,164720,92,189612
39986,0.035961,172.217.194.0-255,5020,169740,92,189612
39987,0.035985,172.31.47.0-255,66,169806,92,189612
39988,0.036001,172.217.194.0-255,4320,174126,92,189612
39989,0.03607,172.217.194.0-255,7156,181282,92,189612
39990,0.036078,172.217.194.0-255,3602,184884,92,189612
39991,0.036095,172.31.47.0-255,66,184950,92,189612
39992,0.036103,172.217.194.0-255,4320,189270,92,189612
39993,0.036133,172.217.194.0-255,105,189375,92,189612
39994,0.036147,172.31.47.0-255,66,189441,92,189612
39995,0.055566,172.31.47.0-255,105,189546,92,189612
39996,0.057742,172.217.194.0-255,66,189612,92,189612
39997,0.0,172.31.47.0-255,105,105,92,276
39998,0.001792,157.240.13.0-255,105,210,92,276
39999,0.001804,172.31.47.0-255,66,276,92,276
40000,0.0,172.31.47.0-255,105,105,92,105
40001,0.0,172.217.194.0-255,153,153,92,190176
40002,2.4e-05,172.31.47.0-255,66,219,92,190176
40003,2.9e-05,172.217.194.0-255,1484,1703,92,190176
40004,3.4e-05,172.31.47.0-255,66,1769,92,190176
40005,3.8e-05,172.217.194.0-255,2902,4671,92,190176
40006,4.1e-05,172.31.47.0-255,66,4737,92,190176
40007,4.9e-05,172.217.194.0-255,1484,6221,92,190176
40008,5.2e-05,172.31.47.0-255,66,6287,92,190176
40009,8.8e-05,172.217.194.0-255,5738,12025,92,190176
40010,9.1e-05,172.31.47.0-255,66,12091,92,190176
40011,0.000111,172.217.194.0-255,4880,16971,92,190176
40012,0.000114,172.31.47.0-255,66,17037,92,190176
40013,0.00012,172.217.194.0-255,5738,22775,92,190176
40014,0.000122,172.31.47.0-255,66,22841,92,190176
40015,0.000155,172.217.194.0-255,4320,27161,92,190176
40016,0.000157,172.31.47.0-255,66,27227,92,190176
40017,0.00018,172.217.194.0-255,3961,31188,92,190176
40018,0.000183,172.31.47.0-255,66,31254,92,190176
40019,0.000253,172.217.194.0-255,1484,32738,92,190176
40020,0.000257,172.31.47.0-255,66,32804,92,190176
40021,0.000275,172.217.194.0-255,2902,35706,92,190176
40022,0.000279,172.31.47.0-255,66,35772,92,190176
40023,0.000286,172.217.194.0-255,5738,41510,92,190176
40024,0.000288,172.31.47.0-255,66,41576,92,190176
40025,0.000329,172.31.47.0-255,66,41642,92,190176
40026,0.000387,172.31.47.0-255,66,41708,92,190176
40027,0.000404,172.217.194.0-255,677,42385,92,190176
40028,0.000407,172.31.47.0-255,66,42451,92,190176
40029,0.000516,172.217.194.0-255,1484,43935,92,190176
40030,0.00052,172.31.47.0-255,66,44001,92,190176
40031,0.000524,172.217.194.0-255,1484,45485,92,190176
40032,0.000549,172.217.194.0-255,1484,46969,92,190176
40033,0.000552,172.31.47.0-255,66,47035,92,190176
40034,0.000559,172.217.194.0-255,5738,52773,92,190176
40035,0.000562,172.31.47.0-255,66,52839,92,190176
40036,0.000597,172.217.194.0-255,4320,57159,92,190176
40037,0.0006,172.31.47.0-255,66,57225,92,190176
40038,0.000635,172.217.194.0-255,1484,58709,92,190176
40039,0.000636,172.31.47.0-255,66,58775,92,190176
40040,0.000673,172.31.47.0-255,66,58841,92,190176
40041,0.000696,172.217.194.0-255,1484,60325,92,190176
40042,0.000699,172.217.194.0-255,1484,61809,92,190176
40043,0.000702,172.31.47.0-255,66,61875,92,190176
40044,0.000727,172.217.194.0-255,1484,63359,92,190176
40045,0.000732,172.217.194.0-255,4320,67679,92,190176
40046,0.000735,172.31.47.0-255,66,67745,92,190176
40047,0.000747,172.31.47.0-255,66,67811,92,190176
40048,0.000774,172.217.194.0-255,1484,69295,92,190176
40049,0.000803,172.31.47.0-255,66,69361,92,190176
40050,0.00178,172.217.194.0-255,1484,70845,92,190176
40051,0.001791,172.217.194.0-255,2902,73747,92,190176
40052,0.001796,172.31.47.0-255,66,73813,92,190176
40053,0.001803,172.217.194.0-255,5738,79551,92,190176
40054,0.001805,172.31.47.0-255,66,79617,92,190176
40055,0.001847,172.31.47.0-255,66,79683,92,190176
40056,0.001854,172.217.194.0-255,5738,85421,92,190176
40057,0.001856,172.31.47.0-255,66,85487,92,190176
40058,0.001896,172.217.194.0-255,5020,90507,92,190176
40059,0.001899,172.31.47.0-255,66,90573,92,190176
40060,0.001979,172.217.194.0-255,1484,92057,92,190176
40061,0.002007,172.217.194.0-255,2902,94959,92,190176
40062,0.002012,172.31.47.0-255,66,95025,92,190176
40063,0.002019,172.217.194.0-255,5738,100763,92,190176
40064,0.002021,172.31.47.0-255,66,100829,92,190176
40065,0.002057,172.31.47.0-255,66,100895,92,190176
40066,0.002067,172.31.47.0-255,66,100961,92,190176
40067,0.002094,172.217.194.0-255,7156,108117,92,190176
40068,0.002097,172.31.47.0-255,66,108183,92,190176
40069,0.00214,172.31.47.0-255,66,108249,92,190176
40070,0.00215,172.31.47.0-255,66,108315,92,190176
40071,0.002157,172.217.194.0-255,1484,109799,92,190176
40072,0.002203,172.31.47.0-255,66,109865,92,190176
40073,0.002206,172.217.194.0-255,1484,111349,92,190176
40074,0.002273,172.31.47.0-255,66,111415,92,190176
40075,0.002306,172.217.194.0-255,5020,116435,92,190176
40076,0.002309,172.31.47.0-255,66,116501,92,190176
40077,0.002327,172.31.47.0-255,66,116567,92,190176
40078,0.002338,172.31.47.0-255,66,116633,92,190176
40079,0.002355,172.31.47.0-255,66,116699,92,190176
40080,0.002394,172.31.47.0-255,66,116765,92,190176
40081,0.002408,172.31.47.0-255,66,116831,92,190176
40082,0.002428,172.31.47.0-255,66,116897,92,190176
40083,0.004748,172.217.194.0-255,5738,122635,92,190176
40084,0.004752,172.31.47.0-255,66,122701,92,190176
40085,0.00713,172.217.194.0-255,5738,128439,92,190176
40086,0.007136,172.31.47.0-255,66,128505,92,190176
40087,0.009485,172.217.194.0-255,5738,134243,92,190176
40088,0.009492,172.31.47.0-255,66,134309,92,190176
40089,0.011871,172.217.194.0-255,5738,140047,92,190176
40090,0.011879,172.31.47.0-255,66,140113,92,190176
40091,0.014208,172.217.194.0-255,5738,145851,92,190176
40092,0.014216,172.31.47.0-255,66,145917,92,190176
40093,0.016561,172.217.194.0-255,5738,151655,92,190176
40094,0.016568,172.31.47.0-255,66,151721,92,190176
40095,0.018904,172.217.194.0-255,5738,157459,92,190176
40096,0.018911,172.31.47.0-255,66,157525,92,190176
40097,0.021249,172.217.194.0-255,5738,163263,92,190176
40098,0.021256,172.31.47.0-255,66,163329,92,190176
40099,0.023632,172.217.194.0-255,5738,169067,92,190176
40100,0.023641,172.31.47.0-255,66,169133,92,190176
40101,0.025988,172.217.194.0-255,5738,174871,92,190176
40102,0.025995,172.31.47.0-255,66,174937,92,190176
40103,0.028338,172.217.194.0-255,5738,180675,92,190176
40104,0.028346,172.31.47.0-255,66,180741,92,190176
40105,0.030636,172.217.194.0-255,98,180839,92,190176
40106,0.0307,172.31.47.0-255,66,180905,92,190176
40107,0.03074,172.31.47.0-255,105,181010,92,190176
40108,0.032805,172.31.47.0-255,172,181182,92,190176
40109,0.032835,172.31.47.0-255,1112,182294,92,190176
40110,0.032863,172.31.47.0-255,1514,183808,92,190176
40111,0.032865,172.31.47.0-255,1514,185322,92,190176
40112,0.032866,172.31.47.0-255,1514,186836,92,190176
40113,0.032867,172.31.47.0-255,1514,188350,92,190176
40114,0.032888,172.31.47.0-255,1496,189846,92,190176
40115,0.033048,172.217.194.0-255,66,189912,92,190176
40116,0.034362,104.244.42.0-255,66,189978,92,190176
40117,0.034408,104.244.42.0-255,66,190044,92,190176
40118,0.034413,104.244.42.0-255,66,190110,92,190176
40119,0.034475,104.244.42.0-255,66,190176,92,190176
40120,0.0,74.125.130.0-255,153,153,92,396818
40121,2.3e-05,172.31.47.0-255,66,219,92,396818
40122,2.8e-05,74.125.130.0-255,1484,1703,92,396818
40123,3.2e-05,172.31.47.0-255,66,1769,92,396818
40124,3.5e-05,74.125.130.0-255,1484,3253,92,396818
40125,3.7e-05,172.31.47.0-255,66,3319,92,396818
40126,5.8e-05,74.125.130.0-255,1484,4803,92,396818
40127,6e-05,172.31.47.0-255,66,4869,92,396818
40128,6.2e-05,74.125.130.0-255,1484,6353,92,396818
40129,6.4e-05,172.31.47.0-255,66,6419,92,396818
40130,8.1e-05,74.125.130.0-255,2902,9321,92,396818
40131,8.3e-05,172.31.47.0-255,66,9387,92,396818
40132,0.000123,74.125.130.0-255,1484,10871,92,396818
40133,0.000126,172.31.47.0-255,66,10937,92,396818
40134,0.000147,74.125.130.0-255,3392,14329,92,396818
40135,0.00015,172.31.47.0-255,66,14395,92,396818
40136,0.000155,74.125.130.0-255,5738,20133,92,396818
40137,0.000157,172.31.47.0-255,66,20199,92,396818
40138,0.000159,74.125.130.0-255,1484,21683,92,396818
40139,0.00016,172.31.47.0-255,66,21749,92,396818
40140,0.000175,74.125.130.0-255,1484,23233,92,396818
40141,0.000177,172.31.47.0-255,66,23299,92,396818
40142,0.000182,74.125.130.0-255,4320,27619,92,396818
40143,0.000184,172.31.47.0-255,66,27685,92,396818
40144,0.000213,74.125.130.0-255,1484,29169,92,396818
40145,0.000215,172.31.47.0-255,66,29235,92,396818
40146,0.000234,74.125.130.0-255,2543,31778,92,396818
40147,0.000237,172.31.47.0-255,66,31844,92,396818
40148,0.000378,74.125.130.0-255,1484,33328,92,396818
40149,0.000382,172.31.47.0-255,66,33394,92,396818
40150,0.000386,74.125.130.0-255,2902,36296,92,396818
40151,0.000387,172.31.47.0-255,66,36362,92,396818
40152,0.000418,74.125.130.0-255,5738,42100,92,396818
40153,0.000421,172.31.47.0-255,66,42166,92,396818
40154,0.000426,74.125.130.0-255,4320,46486,92,396818
40155,0.000428,172.31.47.0-255,66,46552,92,396818
40156,0.000433,74.125.130.0-255,5738,52290,92,396818
40157,0.000435,172.31.47.0-255,66,52356,92,396818
40158,0.000461,74.125.130.0-255,4320,56676,92,396818
40159,0.000464,172.31.47.0-255,66,56742,92,396818
40160,0.000487,74.125.130.0-255,7156,63898,92,396818
40161,0.00049,172.31.47.0-255,66,63964,92,396818
40162,0.000494,74.125.130.0-255,2184,66148,92,396818
40163,0.000496,172.31.47.0-255,66,66214,92,396818
40164,0.000507,74.125.130.0-255,380,66594,92,396818
40165,0.000533,74.125.130.0-255,100,66694,92,396818
40166,0.000666,74.125.130.0-255,1484,68178,92,396818
40167,0.00067,172.31.47.0-255,66,68244,92,396818
40168,0.000685,74.125.130.0-255,2902,71146,92,396818
40169,0.000687,172.31.47.0-255,66,71212,92,396818
40170,0.000708,74.125.130.0-255,5738,76950,92,396818
40171,0.000712,172.31.47.0-255,66,77016,92,396818
40172,0.000731,74.125.130.0-255,4320,81336,92,396818
40173,0.000735,172.31.47.0-255,66,81402,92,396818
40174,0.000771,74.125.130.0-255,5738,87140,92,396818
40175,0.000774,172.31.47.0-255,66,87206,92,396818
40176,0.000779,74.125.130.0-255,4320,91526,92,396818
40177,0.000781,172.31.47.0-255,66,91592,92,396818
40178,0.000795,74.125.130.0-255,5738,97330,92,396818
40179,0.000798,172.31.47.0-255,66,97396,92,396818
40180,0.000819,74.125.130.0-255,3602,100998,92,396818
40181,0.000821,172.31.47.0-255,66,101064,92,396818
40182,0.000913,74.125.130.0-255,1484,102548,92,396818
40183,0.000929,74.125.130.0-255,2902,105450,92,396818
40184,0.000932,172.31.47.0-255,66,105516,92,396818
40185,0.000946,74.125.130.0-255,1484,107000,92,396818
40186,0.000961,74.125.130.0-255,4320,111320,92,396818
40187,0.000964,172.31.47.0-255,66,111386,92,396818
40188,0.000967,74.125.130.0-255,1484,112870,92,396818
40189,0.000993,172.31.47.0-255,66,112936,92,396818
40190,0.001033,74.125.130.0-255,5738,118674,92,396818
40191,0.001036,172.31.47.0-255,66,118740,92,396818
40192,0.001051,74.125.130.0-255,5020,123760,92,396818
40193,0.001053,172.31.47.0-255,66,123826,92,396818
40194,0.001166,74.125.130.0-255,1484,125310,92,396818
40195,0.001179,74.125.130.0-255,2902,128212,92,396818
40196,0.001182,172.31.47.0-255,66,128278,92,396818
40197,0.001205,74.125.130.0-255,1484,129762,92,396818
40198,0.001222,74.125.130.0-255,2902,132664,92,396818
40199,0.001226,172.31.47.0-255,66,132730,92,396818
40200,0.001242,74.125.130.0-255,5738,138468,92,396818
40201,0.001244,172.31.47.0-255,66,138534,92,396818
40202,0.001259,74.125.130.0-255,1484,140018,92,396818
40203,0.001278,74.125.130.0-255,5738,145756,92,396818
40204,0.001281,172.31.47.0-255,66,145822,92,396818
40205,0.001286,74.125.130.0-255,4320,150142,92,396818
40206,0.001287,172.31.47.0-255,66,150208,92,396818
40207,0.0013,74.125.130.0-255,1484,151692,92,396818
40208,0.001314,74.125.130.0-255,4320,156012,92,396818
40209,0.001316,172.31.47.0-255,66,156078,92,396818
40210,0.001334,74.125.130.0-255,2184,158262,92,396818
40211,0.001337,172.31.47.0-255,66,158328,92,396818
40212,0.001377,74.125.130.0-255,2902,161230,92,396818
40213,0.00138,172.31.47.0-255,66,161296,92,396818
40214,0.001405,74.125.130.0-255,4320,165616,92,396818
40215,0.001408,172.31.47.0-255,66,165682,92,396818
40216,0.001433,74.125.130.0-255,2902,168584,92,396818
40217,0.001435,172.31.47.0-255,66,168650,92,396818
40218,0.00145,74.125.130.0-255,4320,172970,92,396818
40219,0.001452,172.31.47.0-255,66,173036,92,396818
40220,0.001473,74.125.130.0-255,5738,178774,92,396818
40221,0.001476,172.31.47.0-255,66,178840,92,396818
40222,0.001497,74.125.130.0-255,2902,181742,92,396818
40223,0.001499,172.31.47.0-255,66,181808,92,396818
40224,0.001502,74.125.130.0-255,2902,184710,92,396818
40225,0.001504,172.31.47.0-255,66,184776,92,396818
40226,0.001517,74.125.130.0-255,4320,189096,92,396818
40227,0.001519,172.31.47.0-255,66,189162,92,396818
40228,0.001535,74.125.130.0-255,2902,192064,92,396818
40229,0.001538,172.31.47.0-255,66,192130,92,396818
40230,0.001555,74.125.130.0-255,480,192610,92,396818
40231,0.001739,74.125.130.0-255,1484,194094,92,396818
40232,0.001745,172.31.47.0-255,66,194160,92,396818
40233,0.00175,74.125.130.0-255,2902,197062,92,396818
40234,0.001752,172.31.47.0-255,66,197128,92,396818
40235,0.001763,74.125.130.0-255,1484,198612,92,396818
40236,0.001781,74.125.130.0-255,4320,202932,92,396818
40237,0.001783,172.31.47.0-255,66,202998,92,396818
40238,0.001788,74.125.130.0-255,5738,208736,92,396818
40239,0.00179,172.31.47.0-255,66,208802,92,396818
40240,0.001803,74.125.130.0-255,4320,213122,92,396818
40241,0.001805,172.31.47.0-255,66,213188,92,396818
40242,0.00182,74.125.130.0-255,2902,216090,92,396818
40243,0.001821,172.31.47.0-255,66,216156,92,396818
40244,0.001837,74.125.130.0-255,2902,219058,92,396818
40245,0.001839,172.31.47.0-255,66,219124,92,396818
40246,0.001858,74.125.130.0-255,7156,226280,92,396818
40247,0.00186,172.31.47.0-255,66,226346,92,396818
40248,0.001877,74.125.130.0-255,766,227112,92,396818
40249,0.002126,74.125.130.0-255,1484,228596,92,396818
40250,0.002128,172.31.47.0-255,66,228662,92,396818
40251,0.002132,74.125.130.0-255,2902,231564,92,396818
40252,0.002134,172.31.47.0-255,66,231630,92,396818
40253,0.002136,74.125.130.0-255,1484,233114,92,396818
40254,0.00215,74.125.130.0-255,2902,236016,92,396818
40255,0.002152,172.31.47.0-255,66,236082,92,396818
40256,0.00218,74.125.130.0-255,5738,241820,92,396818
40257,0.002182,172.31.47.0-255,66,241886,92,396818
40258,0.002192,74.125.130.0-255,2902,244788,92,396818
40259,0.002193,172.31.47.0-255,66,244854,92,396818
40260,0.002213,74.125.130.0-255,4320,249174,92,396818
40261,0.002214,172.31.47.0-255,66,249240,92,396818
40262,0.002223,172.31.47.0-255,66,249306,92,396818
40263,0.002268,74.125.130.0-255,3602,252908,92,396818
40264,0.00227,172.31.47.0-255,66,252974,92,396818
40265,0.004514,74.125.130.0-255,1484,254458,92,396818
40266,0.004572,74.125.130.0-255,2902,257360,92,396818
40267,0.004575,172.31.47.0-255,66,257426,92,396818
40268,0.004586,74.125.130.0-255,1484,258910,92,396818
40269,0.006883,74.125.130.0-255,4320,263230,92,396818
40270,0.006889,172.31.47.0-255,66,263296,92,396818
40271,0.009182,74.125.130.0-255,5738,269034,92,396818
40272,0.009187,172.31.47.0-255,66,269100,92,396818
40273,0.011497,74.125.130.0-255,5738,274838,92,396818
40274,0.011504,172.31.47.0-255,66,274904,92,396818
40275,0.01382,74.125.130.0-255,5738,280642,92,396818
40276,0.013832,172.31.47.0-255,66,280708,92,396818
40277,0.016147,74.125.130.0-255,5738,286446,92,396818
40278,0.016155,172.31.47.0-255,66,286512,92,396818
40279,0.018446,74.125.130.0-255,4320,290832,92,396818
40280,0.018451,172.31.47.0-255,66,290898,92,396818
40281,0.018476,74.125.130.0-255,1484,292382,92,396818
40282,0.020762,74.125.130.0-255,4320,296702,92,396818
40283,0.020769,172.31.47.0-255,66,296768,92,396818
40284,0.023073,74.125.130.0-255,5738,302506,92,396818
40285,0.023079,172.31.47.0-255,66,302572,92,396818
40286,0.025374,74.125.130.0-255,5738,308310,92,396818
40287,0.025381,172.31.47.0-255,66,308376,92,396818
40288,0.027697,74.125.130.0-255,5738,314114,92,396818
40289,0.027705,172.31.47.0-255,66,314180,92,396818
40290,0.030019,74.125.130.0-255,5738,319918,92,396818
40291,0.030025,172.31.47.0-255,66,319984,92,396818
40292,0.030459,172.31.47.0-255,172,320156,92,396818
40293,0.030488,172.31.47.0-255,1112,321268,92,396818
40294,0.030567,172.31.47.0-255,1514,322782,92,396818
40295,0.030569,172.31.47.0-255,1514,324296,92,396818
40296,0.03057,172.31.47.0-255,1514,325810,92,396818
40297,0.030575,172.31.47.0-255,1514,327324,92,396818
40298,0.030593,172.31.47.0-255,1494,328818,92,396818
40299,0.032023,104.244.42.0-255,66,328884,92,396818
40300,0.03203,104.244.42.0-255,66,328950,92,396818
40301,0.03217,104.244.42.0-255,66,329016,92,396818
40302,0.032321,74.125.130.0-255,1484,330500,92,396818
40303,0.032346,74.125.130.0-255,4320,334820,92,396818
40304,0.032351,172.31.47.0-255,66,334886,92,396818
40305,0.034703,74.125.130.0-255,4320,339206,92,396818
40306,0.034708,172.31.47.0-255,66,339272,92,396818
40307,0.034729,74.125.130.0-255,1484,340756,92,396818
40308,0.037008,74.125.130.0-255,4320,345076,92,396818
40309,0.037014,172.31.47.0-255,66,345142,92,396818
40310,0.039331,74.125.130.0-255,5738,350880,92,396818
40311,0.039336,172.31.47.0-255,66,350946,92,396818
40312,0.041644,74.125.130.0-255,4320,355266,92,396818
40313,0.041649,172.31.47.0-255,66,355332,92,396818
40314,0.041683,74.125.130.0-255,1484,356816,92,396818
40315,0.043954,74.125.130.0-255,4320,361136,92,396818
40316,0.043958,172.31.47.0-255,66,361202,92,396818
40317,0.04627,74.125.130.0-255,2902,364104,92,396818
40318,0.046276,172.31.47.0-255,66,364170,92,396818
40319,0.046311,74.125.130.0-255,2902,367072,92,396818
40320,0.046314,172.31.47.0-255,66,367138,92,396818
40321,0.048572,74.125.130.0-255,2902,370040,92,396818
40322,0.048577,172.31.47.0-255,66,370106,92,396818
40323,0.048603,74.125.130.0-255,2902,373008,92,396818
40324,0.048605,172.31.47.0-255,66,373074,92,396818
40325,0.050876,74.125.130.0-255,2902,375976,92,396818
40326,0.050882,172.31.47.0-255,66,376042,92,396818
40327,0.050904,74.125.130.0-255,2902,378944,92,396818
40328,0.050906,172.31.47.0-255,66,379010,92,396818
40329,0.053179,74.125.130.0-255,2902,381912,92,396818
40330,0.053184,172.31.47.0-255,66,381978,92,396818
40331,0.053203,74.125.130.0-255,2902,384880,92,396818
40332,0.053205,172.31.47.0-255,66,384946,92,396818
40333,0.055477,74.125.130.0-255,2902,387848,92,396818
40334,0.055482,172.31.47.0-255,66,387914,92,396818
40335,0.055509,74.125.130.0-255,2902,390816,92,396818
40336,0.055511,172.31.47.0-255,66,390882,92,396818
40337,0.05779,74.125.130.0-255,2902,393784,92,396818
40338,0.057794,172.31.47.0-255,66,393850,92,396818
40339,0.057823,74.125.130.0-255,2902,396752,92,396818
40340,0.057826,172.31.47.0-255,66,396818,92,396818
40341,0.0,216.58.221.0-255,153,153,92,381194
40342,1.1e-05,172.31.47.0-255,66,219,92,381194
40343,3.5e-05,216.58.221.0-255,1484,1703,92,381194
40344,3.8e-05,172.31.47.0-255,66,1769,92,381194
40345,4.3e-05,216.58.221.0-255,2902,4671,92,381194
40346,4.6e-05,172.31.47.0-255,66,4737,92,381194
40347,5.2e-05,216.58.221.0-255,5738,10475,92,381194
40348,5.5e-05,172.31.47.0-255,66,10541,92,381194
40349,8.1e-05,216.58.221.0-255,3585,14126,92,381194
40350,8.3e-05,172.31.47.0-255,66,14192,92,381194
40351,9.7e-05,216.58.221.0-255,4320,18512,92,381194
40352,0.0001,172.31.47.0-255,66,18578,92,381194
40353,0.000107,216.58.221.0-255,5738,24316,92,381194
40354,0.00011,172.31.47.0-255,66,24382,92,381194
40355,0.000137,216.58.221.0-255,4320,28702,92,381194
40356,0.00014,172.31.47.0-255,66,28768,92,381194
40357,0.00017,216.58.221.0-255,6797,35565,92,381194
40358,0.000174,172.31.47.0-255,66,35631,92,381194
40359,0.000185,172.31.47.0-255,66,35697,92,381194
40360,0.000187,216.58.221.0-255,1125,36822,92,381194
40361,0.000189,172.31.47.0-255,66,36888,92,381194
40362,0.000192,216.58.221.0-255,1484,38372,92,381194
40363,0.000194,172.31.47.0-255,66,38438,92,381194
40364,0.000215,216.58.221.0-255,4320,42758,92,381194
40365,0.000217,172.31.47.0-255,66,42824,92,381194
40366,0.000221,216.58.221.0-255,1484,44308,92,381194
40367,0.000223,172.31.47.0-255,66,44374,92,381194
40368,0.000246,172.31.47.0-255,66,44440,92,381194
40369,0.000281,216.58.221.0-255,1125,45565,92,381194
40370,0.000284,172.31.47.0-255,66,45631,92,381194
40371,0.000301,216.58.221.0-255,354,45985,92,381194
40372,0.001039,216.58.221.0-255,389,46374,92,381194
40373,0.001072,216.58.221.0-255,1484,47858,92,381194
40374,0.001078,216.58.221.0-255,4320,52178,92,381194
40375,0.001091,216.58.221.0-255,1484,53662,92,381194
40376,0.001108,216.58.221.0-255,4320,57982,92,381194
40377,0.001115,216.58.221.0-255,7156,65138,92,381194
40378,0.0012,216.58.221.0-255,2184,67322,92,381194
40379,0.001226,216.58.221.0-255,2902,70224,92,381194
40380,0.001251,216.58.221.0-255,7156,77380,92,381194
40381,0.001255,216.58.221.0-255,2902,80282,92,381194
40382,0.001278,216.58.221.0-255,4320,84602,92,381194
40383,0.001309,216.58.221.0-255,4320,88922,92,381194
40384,0.001325,216.58.221.0-255,3602,92524,92,381194
40385,0.001362,216.58.221.0-255,1484,94008,92,381194
40386,0.00138,216.58.221.0-255,2902,96910,92,381194
40387,0.001391,216.58.221.0-255,1484,98394,92,381194
40388,0.001405,216.58.221.0-255,4320,102714,92,381194
40389,0.001427,216.58.221.0-255,1484,104198,92,381194
40390,0.001445,216.58.221.0-255,7156,111354,92,381194
40391,0.001448,216.58.221.0-255,1484,112838,92,381194
40392,0.001465,216.58.221.0-255,5738,118576,92,381194
40393,0.001485,216.58.221.0-255,2902,121478,92,381194
40394,0.001491,216.58.221.0-255,5020,126498,92,381194
40395,0.001517,216.58.221.0-255,1484,127982,92,381194
40396,0.001521,216.58.221.0-255,2902,130884,92,381194
40397,0.001526,216.58.221.0-255,2902,133786,92,381194
40398,0.001539,216.58.221.0-255,2902,136688,92,381194
40399,0.001554,216.58.221.0-255,5738,142426,92,381194
40400,0.001568,216.58.221.0-255,7156,149582,92,381194
40401,0.001573,216.58.221.0-255,4320,153902,92,381194
40402,0.001589,216.58.221.0-255,2902,156804,92,381194
40403,0.001612,216.58.221.0-255,3602,160406,92,381194
40404,0.00166,216.58.221.0-255,1484,161890,92,381194
40405,0.001674,216.58.221.0-255,2902,164792,92,381194
40406,0.001693,216.58.221.0-255,5738,170530,92,381194
40407,0.001725,216.58.221.0-255,4320,174850,92,381194
40408,0.001774,216.58.221.0-255,4320,179170,92,381194
40409,0.001785,172.31.47.0-255,66,179236,92,381194
40410,0.001805,216.58.221.0-255,6438,185674,92,381194
40411,0.001835,216.58.221.0-255,1484,187158,92,381194
40412,0.001851,216.58.221.0-255,2902,190060,92,381194
40413,0.00187,216.58.221.0-255,4320,194380,92,381194
40414,0.001882,216.58.221.0-255,1484,195864,92,381194
40415,0.001903,216.58.221.0-255,4320,200184,92,381194
40416,0.001965,216.58.221.0-255,4320,204504,92,381194
40417,0.001981,216.58.221.0-255,6438,210942,92,381194
40418,0.001996,172.31.47.0-255,66,211008,92,381194
40419,0.003891,216.58.221.0-255,5738,216746,92,381194
40420,0.003896,172.31.47.0-255,66,216812,92,381194
40421,0.005797,216.58.221.0-255,5738,222550,92,381194
40422,0.006636,172.31.47.0-255,66,222616,92,381194
40423,0.008525,216.58.221.0-255,4320,226936,92,381194
40424,0.00853,172.31.47.0-255,66,227002,92,381194
40425,0.008553,216.58.221.0-255,1484,228486,92,381194
40426,0.010423,216.58.221.0-255,4320,232806,92,381194
40427,0.010429,172.31.47.0-255,66,232872,92,381194
40428,0.012332,216.58.221.0-255,5738,238610,92,381194
40429,0.012381,172.31.47.0-255,66,238676,92,381194
40430,0.01429,216.58.221.0-255,5738,244414,92,381194
40431,0.014296,172.31.47.0-255,66,244480,92,381194
40432,0.016217,216.58.221.0-255,5738,250218,92,381194
40433,0.016223,172.31.47.0-255,66,250284,92,381194
40434,0.018123,216.58.221.0-255,5738,256022,92,381194
40435,0.018129,172.31.47.0-255,66,256088,92,381194
40436,0.020078,216.58.221.0-255,4320,260408,92,381194
40437,0.020084,172.31.47.0-255,66,260474,92,381194
40438,0.020133,216.58.221.0-255,1484,261958,92,381194
40439,0.021994,216.58.221.0-255,4320,266278,92,381194
40440,0.022006,172.31.47.0-255,66,266344,92,381194
40441,0.023905,216.58.221.0-255,5738,272082,92,381194
40442,0.023959,172.31.47.0-255,66,272148,92,381194
40443,0.025856,216.58.221.0-255,5738,277886,92,381194
40444,0.025862,172.31.47.0-255,66,277952,92,381194
40445,0.027763,216.58.221.0-255,5738,283690,92,381194
40446,0.027769,172.31.47.0-255,66,283756,92,381194
40447,0.029678,216.58.221.0-255,5738,289494,92,381194
40448,0.029683,172.31.47.0-255,66,289560,92,381194
40449,0.03159,216.58.221.0-255,5738,295298,92,381194
40450,0.031597,172.31.47.0-255,66,295364,92,381194
40451,0.032595,172.31.47.0-255,172,295536,92,381194
40452,0.032621,172.31.47.0-255,1111,296647,92,381194
40453,0.032662,172.31.47.0-255,1514,298161,92,381194
40454,0.032663,172.31.47.0-255,1514,299675,92,381194
40455,0.032664,172.31.47.0-255,1514,301189,92,381194
40456,0.032666,172.31.47.0-255,1514,302703,92,381194
40457,0.032689,172.31.47.0-255,1495,304198,92,381194
40458,0.033493,216.58.221.0-255,5738,309936,92,381194
40459,0.033498,172.31.47.0-255,66,310002,92,381194
40460,0.034109,104.244.42.0-255,66,310068,92,381194
40461,0.034137,104.244.42.0-255,66,310134,92,381194
40462,0.034234,104.244.42.0-255,66,310200,92,381194
40463,0.03428,104.244.42.0-255,66,310266,92,381194
40464,0.034878,104.244.42.0-255,108,310374,92,381194
40465,0.034883,172.31.47.0-255,66,310440,92,381194
40466,0.03539,216.58.221.0-255,1484,311924,92,381194
40467,0.035416,216.58.221.0-255,4320,316244,92,381194
40468,0.035419,172.31.47.0-255,66,316310,92,381194
40469,0.037311,216.58.221.0-255,4320,320630,92,381194
40470,0.037315,172.31.47.0-255,66,320696,92,381194
40471,0.037337,216.58.221.0-255,1484,322180,92,381194
40472,0.039213,216.58.221.0-255,4320,326500,92,381194
40473,0.039217,172.31.47.0-255,66,326566,92,381194
40474,0.041119,216.58.221.0-255,5738,332304,92,381194
40475,0.041173,172.31.47.0-255,66,332370,92,381194
40476,0.043072,216.58.221.0-255,5738,338108,92,381194
40477,0.043078,172.31.47.0-255,66,338174,92,381194
40478,0.044979,216.58.221.0-255,5738,343912,92,381194
40479,0.044983,172.31.47.0-255,66,343978,92,381194
40480,0.046873,216.58.221.0-255,2902,346880,92,381194
40481,0.046878,172.31.47.0-255,66,346946,92,381194
40482,0.046906,216.58.221.0-255,2902,349848,92,381194
40483,0.046923,172.31.47.0-255,66,349914,92,381194
40484,0.048772,216.58.221.0-255,2902,352816,92,381194
40485,0.048775,172.31.47.0-255,66,352882,92,381194
40486,0.048807,216.58.221.0-255,2902,355784,92,381194
40487,0.048815,172.31.47.0-255,66,355850,92,381194
40488,0.050672,216.58.221.0-255,2902,358752,92,381194
40489,0.050678,172.31.47.0-255,66,358818,92,381194
40490,0.050711,216.58.221.0-255,2902,361720,92,381194
40491,0.050723,172.31.47.0-255,66,361786,92,381194
40492,0.052567,216.58.221.0-255,2902,364688,92,381194
40493,0.052572,172.31.47.0-255,66,364754,92,381194
40494,0.052597,216.58.221.0-255,1484,366238,92,381194
40495,0.052606,216.58.221.0-255,1484,367722,92,381194
40496,0.052612,172.31.47.0-255,66,367788,92,381194
40497,0.054471,216.58.221.0-255,2902,370690,92,381194
40498,0.054476,172.31.47.0-255,66,370756,92,381194
40499,0.054505,216.58.221.0-255,2902,373658,92,381194
40500,0.054523,172.31.47.0-255,66,373724,92,381194
40501,0.056366,216.58.221.0-255,2902,376626,92,381194
40502,0.05637,172.31.47.0-255,66,376692,92,381194
40503,0.056401,216.58.221.0-255,1484,378176,92,381194
40504,0.056414,216.58.221.0-255,1484,379660,92,381194
40505,0.056439,172.31.47.0-255,66,379726,92,381194
40506,0.058253,216.58.221.0-255,1297,381023,92,381194
40507,0.058374,172.31.47.0-255,66,381089,92,381194
40508,0.058397,172.31.47.0-255,105,381194,92,381194
40509,0.0,172.31.47.0-255,105,105,92,105
40510,0.0,172.31.47.0-255,105,105,92,105
40511,0.0,172.31.47.0-255,105,105,92,276
40512,0.001479,157.240.13.0-255,105,210,92,276
40513,0.039734,172.31.47.0-255,66,276,92,276
40514,0.0,172.217.194.0-255,153,153,92,298469
40515,3.2e-05,172.31.47.0-255,66,219,92,298469
40516,4.1e-05,172.217.194.0-255,1484,1703,92,298469
40517,4.6e-05,172.31.47.0-255,66,1769,92,298469
40518,6.3e-05,172.217.194.0-255,2902,4671,92,298469
40519,6.7e-05,172.31.47.0-255,66,4737,92,298469
40520,7.6e-05,172.217.194.0-255,7156,11893,92,298469
40521,7.9e-05,172.31.47.0-255,66,11959,92,298469
40522,9.6e-05,172.31.47.0-255,66,12025,92,298469
40523,0.0001,172.217.194.0-255,2543,14568,92,298469
40524,0.000104,172.31.47.0-255,66,14634,92,298469
40525,0.000187,172.217.194.0-255,1484,16118,92,298469
40526,0.00019,172.31.47.0-255,66,16184,92,298469
40527,0.000221,172.217.194.0-255,2902,19086,92,298469
40528,0.000224,172.31.47.0-255,66,19152,92,298469
40529,0.000231,172.217.194.0-255,5738,24890,92,298469
40530,0.000233,172.31.47.0-255,66,24956,92,298469
40531,0.000238,172.217.194.0-255,4320,29276,92,298469
40532,0.000241,172.31.47.0-255,66,29342,92,298469
40533,0.000274,172.31.47.0-255,66,29408,92,298469
40534,0.000277,172.217.194.0-255,1484,30892,92,298469
40535,0.000279,172.31.47.0-255,66,30958,92,298469
40536,0.000307,172.31.47.0-255,66,31024,92,298469
40537,0.000422,172.217.194.0-255,1484,32508,92,298469
40538,0.000427,172.31.47.0-255,66,32574,92,298469
40539,0.000433,172.217.194.0-255,2902,35476,92,298469
40540,0.000435,172.31.47.0-255,66,35542,92,298469
40541,0.000467,172.217.194.0-255,5738,41280,92,298469
40542,0.00047,172.31.47.0-255,66,41346,92,298469
40543,0.000486,172.217.194.0-255,1484,42830,92,298469
40544,0.000538,172.217.194.0-255,4320,47150,92,298469
40545,0.000542,172.217.194.0-255,2543,49693,92,298469
40546,0.000723,172.31.47.0-255,66,49759,92,298469
40547,0.000868,172.217.194.0-255,1484,51243,92,298469
40548,0.000875,172.217.194.0-255,2902,54145,92,298469
40549,0.000877,172.217.194.0-255,1484,55629,92,298469
40550,0.000884,172.31.47.0-255,66,55695,92,298469
40551,0.000895,172.217.194.0-255,4320,60015,92,298469
40552,0.000903,172.217.194.0-255,4320,64335,92,298469
40553,0.000918,172.217.194.0-255,4320,68655,92,298469
40554,0.000921,172.31.47.0-255,66,68721,92,298469
40555,0.000939,172.217.194.0-255,7156,75877,92,298469
40556,0.000979,172.31.47.0-255,66,75943,92,298469
40557,0.001425,172.217.194.0-255,1484,77427,92,298469
40558,0.001432,172.217.194.0-255,2902,80329,92,298469
40559,0.001435,172.31.47.0-255,66,80395,92,298469
40560,0.001478,172.217.194.0-255,2902,83297,92,298469
40561,0.001494,172.217.194.0-255,2902,86199,92,298469
40562,0.001501,172.217.194.0-255,7156,93355,92,298469
40563,0.001517,172.217.194.0-255,2184,95539,92,298469
40564,0.001535,172.31.47.0-255,66,95605,92,298469
40565,0.001566,172.217.194.0-255,1484,97089,92,298469
40566,0.001571,172.217.194.0-255,2902,99991,92,298469
40567,0.001582,172.31.47.0-255,66,100057,92,298469
40568,0.001598,172.217.194.0-255,5738,105795,92,298469
40569,0.001637,172.217.194.0-255,4320,110115,92,298469
40570,0.001641,172.31.47.0-255,66,110181,92,298469
40571,0.001648,172.31.47.0-255,66,110247,92,298469
40572,0.00167,172.217.194.0-255,7156,117403,92,298469
40573,0.00169,172.217.194.0-255,3602,121005,92,298469
40574,0.001699,172.31.47.0-255,66,121071,92,298469
40575,0.00204,172.217.194.0-255,1484,122555,92,298469
40576,0.002047,172.217.194.0-255,2902,125457,92,298469
40577,0.00205,172.31.47.0-255,66,125523,92,298469
40578,0.002056,172.217.194.0-255,4320,129843,92,298469
40579,0.002076,172.217.194.0-255,1484,131327,92,298469
40580,0.002083,172.217.194.0-255,5738,137065,92,298469
40581,0.002096,172.217.194.0-255,1484,138549,92,298469
40582,0.002106,172.31.47.0-255,66,138615,92,298469
40583,0.002112,172.217.194.0-255,4320,142935,92,298469
40584,0.002116,172.31.47.0-255,66,143001,92,298469
40585,0.002154,172.217.194.0-255,766,143767,92,298469
40586,0.002164,172.31.47.0-255,66,143833,92,298469
40587,0.002293,172.217.194.0-255,1484,145317,92,298469
40588,0.002304,172.217.194.0-255,2902,148219,92,298469
40589,0.002307,172.31.47.0-255,66,148285,92,298469
40590,0.002312,172.217.194.0-255,2902,151187,92,298469
40591,0.002339,172.217.194.0-255,2902,154089,92,298469
40592,0.002345,172.217.194.0-255,7156,161245,92,298469
40593,0.002349,172.217.194.0-255,2902,164147,92,298469
40594,0.002366,172.217.194.0-255,1484,165631,92,298469
40595,0.008115,172.31.47.0-255,66,165697,92,298469
40596,0.01045,172.217.194.0-255,5738,171435,92,298469
40597,0.010462,172.31.47.0-255,66,171501,92,298469
40598,0.012751,172.217.194.0-255,5738,177239,92,298469
40599,0.012758,172.31.47.0-255,66,177305,92,298469
40600,0.015056,172.217.194.0-255,5738,183043,92,298469
40601,0.015063,172.31.47.0-255,66,183109,92,298469
40602,0.017349,172.217.194.0-255,5738,188847,92,298469
40603,0.017362,172.31.47.0-255,66,188913,92,298469
40604,0.019652,172.217.194.0-255,5738,194651,92,298469
40605,0.01966,172.31.47.0-255,66,194717,92,298469
40606,0.021943,172.217.194.0-255,5738,200455,92,298469
40607,0.021952,172.31.47.0-255,66,200521,92,298469
40608,0.024249,172.217.194.0-255,5738,206259,92,298469
40609,0.024264,172.31.47.0-255,66,206325,92,298469
40610,0.026569,172.217.194.0-255,5738,212063,92,298469
40611,0.026575,172.31.47.0-255,66,212129,92,298469
40612,0.028875,172.217.194.0-255,5738,217867,92,298469
40613,0.028883,172.31.47.0-255,66,217933,92,298469
40614,0.031194,172.217.194.0-255,5738,223671,92,298469
40615,0.031201,172.31.47.0-255,66,223737,92,298469
40616,0.033492,172.217.194.0-255,4320,228057,92,298469
40617,0.033502,172.31.47.0-255,66,228123,92,298469
40618,0.033533,172.217.194.0-255,1484,229607,92,298469
40619,0.035809,172.217.194.0-255,2902,232509,92,298469
40620,0.035824,172.31.47.0-255,66,232575,92,298469
40621,0.038171,172.217.194.0-255,5738,238313,92,298469
40622,0.038179,172.31.47.0-255,66,238379,92,298469
40623,0.040496,172.217.194.0-255,5738,244117,92,298469
40624,0.040509,172.31.47.0-255,66,244183,92,298469
40625,0.042787,172.217.194.0-255,5738,249921,92,298469
40626,0.042794,172.31.47.0-255,66,249987,92,298469
40627,0.043321,172.31.47.0-255,172,250159,92,298469
40628,0.043361,172.31.47.0-255,1106,251265,92,298469
40629,0.043419,172.31.47.0-255,1514,252779,92,298469
40630,0.043421,172.31.47.0-255,1514,254293,92,298469
40631,0.043422,172.31.47.0-255,1514,255807,92,298469
40632,0.043423,172.31.47.0-255,1514,257321,92,298469
40633,0.043445,172.31.47.0-255,1500,258821,92,298469
40634,0.044872,104.244.42.0-255,66,258887,92,298469
40635,0.044881,104.244.42.0-255,66,258953,92,298469
40636,0.045025,104.244.42.0-255,66,259019,92,298469
40637,0.045065,172.217.194.0-255,5738,264757,92,298469
40638,0.04507,172.31.47.0-255,66,264823,92,298469
40639,0.046808,104.244.42.0-255,108,264931,92,298469
40640,0.046814,172.31.47.0-255,66,264997,92,298469
40641,0.047338,172.217.194.0-255,4320,269317,92,298469
40642,0.047342,172.31.47.0-255,66,269383,92,298469
40643,0.047364,172.217.194.0-255,1484,270867,92,298469
40644,0.049641,172.217.194.0-255,4320,275187,92,298469
40645,0.049648,172.31.47.0-255,66,275253,92,298469
40646,0.051944,172.217.194.0-255,5738,280991,92,298469
40647,0.05195,172.31.47.0-255,66,281057,92,298469
40648,0.054243,172.217.194.0-255,5738,286795,92,298469
40649,0.054249,172.31.47.0-255,66,286861,92,298469
40650,0.056518,172.217.194.0-255,5738,292599,92,298469
40651,0.056524,172.31.47.0-255,66,292665,92,298469
40652,0.058808,172.217.194.0-255,5738,298403,92,298469
40653,0.058815,172.31.47.0-255,66,298469,92,298469
40654,0.0,74.125.24.0-255,153,153,92,256888
40655,2.4e-05,172.31.47.0-255,66,219,92,256888
40656,3e-05,74.125.24.0-255,1484,1703,92,256888
40657,3.4e-05,172.31.47.0-255,66,1769,92,256888
40658,6.8e-05,74.125.24.0-255,2902,4671,92,256888
40659,7.1e-05,172.31.47.0-255,66,4737,92,256888
40660,7.6e-05,74.125.24.0-255,5738,10475,92,256888
40661,7.9e-05,172.31.47.0-255,66,10541,92,256888
40662,9.9e-05,74.125.24.0-255,3464,14005,92,256888
40663,0.000101,172.31.47.0-255,66,14071,92,256888
40664,0.000106,74.125.24.0-255,4320,18391,92,256888
40665,0.000108,172.31.47.0-255,66,18457,92,256888
40666,0.000139,172.31.47.0-255,66,18523,92,256888
40667,0.000162,74.125.24.0-255,1484,20007,92,256888
40668,0.000164,172.31.47.0-255,66,20073,92,256888
40669,0.00017,74.125.24.0-255,4320,24393,92,256888
40670,0.000172,172.31.47.0-255,66,24459,92,256888
40671,0.000205,74.125.24.0-255,4320,28779,92,256888
40672,0.000208,172.31.47.0-255,66,28845,92,256888
40673,0.000244,172.31.47.0-255,66,28911,92,256888
40674,0.00052,74.125.24.0-255,1484,30395,92,256888
40675,0.000524,172.31.47.0-255,66,30461,92,256888
40676,0.000529,74.125.24.0-255,2902,33363,92,256888
40677,0.000532,172.31.47.0-255,66,33429,92,256888
40678,0.000558,74.125.24.0-255,5738,39167,92,256888
40679,0.00056,172.31.47.0-255,66,39233,92,256888
40680,0.000597,74.125.24.0-255,4320,43553,92,256888
40681,0.0006,172.31.47.0-255,66,43619,92,256888
40682,0.000626,74.125.24.0-255,2897,46516,92,256888
40683,0.000629,172.31.47.0-255,66,46582,92,256888
40684,0.000814,74.125.24.0-255,1484,48066,92,256888
40685,0.000823,74.125.24.0-255,2902,50968,92,256888
40686,0.000826,172.31.47.0-255,66,51034,92,256888
40687,0.000853,74.125.24.0-255,5738,56772,92,256888
40688,0.000855,74.125.24.0-255,1484,58256,92,256888
40689,0.000872,74.125.24.0-255,1484,59740,92,256888
40690,0.00088,172.31.47.0-255,66,59806,92,256888
40691,0.000936,74.125.24.0-255,3647,63453,92,256888
40692,0.000963,172.31.47.0-255,66,63519,92,256888
40693,0.000989,74.125.24.0-255,4320,67839,92,256888
40694,0.001014,74.125.24.0-255,7156,74995,92,256888
40695,0.001021,172.31.47.0-255,66,75061,92,256888
40696,0.001072,74.125.24.0-255,1484,76545,92,256888
40697,0.001078,74.125.24.0-255,7156,83701,92,256888
40698,0.001093,172.31.47.0-255,66,83767,92,256888
40699,0.00111,74.125.24.0-255,2184,85951,92,256888
40700,0.001139,172.31.47.0-255,66,86017,92,256888
40701,0.001468,74.125.24.0-255,1484,87501,92,256888
40702,0.001474,74.125.24.0-255,2902,90403,92,256888
40703,0.001477,172.31.47.0-255,66,90469,92,256888
40704,0.001502,74.125.24.0-255,5738,96207,92,256888
40705,0.001506,74.125.24.0-255,2902,99109,92,256888
40706,0.00156,74.125.24.0-255,2902,102011,92,256888
40707,0.001637,74.125.24.0-255,7156,109167,92,256888
40708,0.001651,74.125.24.0-255,2902,112069,92,256888
40709,0.001663,74.125.24.0-255,5738,117807,92,256888
40710,0.003896,172.31.47.0-255,66,117873,92,256888
40711,0.006153,74.125.24.0-255,5738,123611,92,256888
40712,0.006158,172.31.47.0-255,66,123677,92,256888
40713,0.008415,74.125.24.0-255,5738,129415,92,256888
40714,0.008421,172.31.47.0-255,66,129481,92,256888
40715,0.010676,74.125.24.0-255,5738,135219,92,256888
40716,0.011284,172.31.47.0-255,66,135285,92,256888
40717,0.013651,74.125.24.0-255,5738,141023,92,256888
40718,0.013663,172.31.47.0-255,66,141089,92,256888
40719,0.015969,74.125.24.0-255,5738,146827,92,256888
40720,0.015976,172.31.47.0-255,66,146893,92,256888
40721,0.018228,74.125.24.0-255,5738,152631,92,256888
40722,0.018235,172.31.47.0-255,66,152697,92,256888
40723,0.020499,74.125.24.0-255,5738,158435,92,256888
40724,0.020506,172.31.47.0-255,66,158501,92,256888
40725,0.022787,74.125.24.0-255,5738,164239,92,256888
40726,0.022793,172.31.47.0-255,66,164305,92,256888
40727,0.025086,74.125.24.0-255,5738,170043,92,256888
40728,0.025093,172.31.47.0-255,66,170109,92,256888
40729,0.027378,74.125.24.0-255,5738,175847,92,256888
40730,0.027384,172.31.47.0-255,66,175913,92,256888
40731,0.028559,172.31.47.0-255,172,176085,92,256888
40732,0.028587,172.31.47.0-255,1112,177197,92,256888
40733,0.02862,172.31.47.0-255,569,177766,92,256888
40734,0.029642,74.125.24.0-255,5738,183504,92,256888
40735,0.029649,172.31.47.0-255,66,183570,92,256888
40736,0.030074,104.244.42.0-255,66,183636,92,256888
40737,0.030127,104.244.42.0-255,66,183702,92,256888
40738,0.030162,104.244.42.0-255,66,183768,92,256888
40739,0.031327,104.244.42.0-255,108,183876,92,256888
40740,0.031332,172.31.47.0-255,66,183942,92,256888
40741,0.031908,74.125.24.0-255,5738,189680,92,256888
40742,0.031913,172.31.47.0-255,66,189746,92,256888
40743,0.034204,74.125.24.0-255,5738,195484,92,256888
40744,0.03421,172.31.47.0-255,66,195550,92,256888
40745,0.036458,74.125.24.0-255,5738,201288,92,256888
40746,0.036463,172.31.47.0-255,66,201354,92,256888
40747,0.038718,74.125.24.0-255,2902,204256,92,256888
40748,0.038722,172.31.47.0-255,66,204322,92,256888
40749,0.038752,74.125.24.0-255,2902,207224,92,256888
40750,0.038766,172.31.47.0-255,66,207290,92,256888
40751,0.041003,74.125.24.0-255,5738,213028,92,256888
40752,0.041045,172.31.47.0-255,66,213094,92,256888
40753,0.043362,74.125.24.0-255,4320,217414,92,256888
40754,0.043367,172.31.47.0-255,66,217480,92,256888
40755,0.043394,74.125.24.0-255,1484,218964,92,256888
40756,0.045655,74.125.24.0-255,4320,223284,92,256888
40757,0.04566,172.31.47.0-255,66,223350,92,256888
40758,0.047991,74.125.24.0-255,5738,229088,92,256888
40759,0.048028,172.31.47.0-255,66,229154,92,256888
40760,0.050297,74.125.24.0-255,5738,234892,92,256888
40761,0.050305,172.31.47.0-255,66,234958,92,256888
40762,0.052572,74.125.24.0-255,5738,240696,92,256888
40763,0.052578,172.31.47.0-255,66,240762,92,256888
40764,0.054839,74.125.24.0-255,4320,245082,92,256888
40765,0.054844,172.31.47.0-255,66,245148,92,256888
40766,0.054877,74.125.24.0-255,1484,246632,92,256888
40767,0.057154,74.125.24.0-255,4320,250952,92,256888
40768,0.05716,172.31.47.0-255,66,251018,92,256888
40769,0.059397,74.125.24.0-255,4320,255338,92,256888
40770,0.059402,172.31.47.0-255,66,255404,92,256888
40771,0.059428,74.125.24.0-255,1484,256888,92,256888
40772,0.0,172.31.47.0-255,66,66,92,66
40773,0.0,74.125.24.0-255,153,153,92,243171
40774,2e-05,172.31.47.0-255,66,219,92,243171
40775,2.7e-05,74.125.24.0-255,1484,1703,92,243171
40776,3.2e-05,172.31.47.0-255,66,1769,92,243171
40777,3.8e-05,74.125.24.0-255,2902,4671,92,243171
40778,4e-05,172.31.47.0-255,66,4737,92,243171
40779,4.8e-05,74.125.24.0-255,7156,11893,92,243171
40780,5e-05,172.31.47.0-255,66,11959,92,243171
40781,7.6e-05,74.125.24.0-255,2065,14024,92,243171
40782,7.8e-05,172.31.47.0-255,66,14090,92,243171
40783,0.00012,74.125.24.0-255,1484,15574,92,243171
40784,0.000122,172.31.47.0-255,66,15640,92,243171
40785,0.000126,74.125.24.0-255,2902,18542,92,243171
40786,0.000129,172.31.47.0-255,66,18608,92,243171
40787,0.000145,74.125.24.0-255,5738,24346,92,243171
40788,0.000147,172.31.47.0-255,66,24412,92,243171
40789,0.000162,74.125.24.0-255,1484,25896,92,243171
40790,0.000164,172.31.47.0-255,66,25962,92,243171
40791,0.000182,74.125.24.0-255,5379,31341,92,243171
40792,0.000184,172.31.47.0-255,66,31407,92,243171
40793,0.000189,74.125.24.0-255,7156,38563,92,243171
40794,0.000191,172.31.47.0-255,66,38629,92,243171
40795,0.000243,172.31.47.0-255,66,38695,92,243171
40796,0.000343,74.125.24.0-255,1484,40179,92,243171
40797,0.000346,172.31.47.0-255,66,40245,92,243171
40798,0.000351,74.125.24.0-255,2902,43147,92,243171
40799,0.000352,172.31.47.0-255,66,43213,92,243171
40800,0.000355,74.125.24.0-255,1484,44697,92,243171
40801,0.000356,172.31.47.0-255,66,44763,92,243171
40802,0.000385,74.125.24.0-255,4320,49083,92,243171
40803,0.000388,172.31.47.0-255,66,49149,92,243171
40804,0.000393,74.125.24.0-255,5738,54887,92,243171
40805,0.000395,172.31.47.0-255,66,54953,92,243171
40806,0.000427,74.125.24.0-255,1708,56661,92,243171
40807,0.000429,172.31.47.0-255,66,56727,92,243171
40808,0.000458,74.125.24.0-255,2902,59629,92,243171
40809,0.000461,172.31.47.0-255,66,59695,92,243171
40810,0.000477,74.125.24.0-255,2902,62597,92,243171
40811,0.000487,74.125.24.0-255,1484,64081,92,243171
40812,0.00049,74.125.24.0-255,1484,65565,92,243171
40813,0.000503,74.125.24.0-255,7156,72721,92,243171
40814,0.000508,172.31.47.0-255,66,72787,92,243171
40815,0.000532,74.125.24.0-255,4320,77107,92,243171
40816,0.000538,172.31.47.0-255,66,77173,92,243171
40817,0.000548,74.125.24.0-255,7156,84329,92,243171
40818,0.000552,172.31.47.0-255,66,84395,92,243171
40819,0.000568,74.125.24.0-255,6438,90833,92,243171
40820,0.000583,172.31.47.0-255,66,90899,92,243171
40821,0.000907,74.125.24.0-255,1484,92383,92,243171
40822,0.000911,74.125.24.0-255,1484,93867,92,243171
40823,0.000914,172.31.47.0-255,66,93933,92,243171
40824,0.000932,74.125.24.0-255,1484,95417,92,243171
40825,0.00095,74.125.24.0-255,5738,101155,92,243171
40826,0.000955,172.31.47.0-255,66,101221,92,243171
40827,0.000987,74.125.24.0-255,5738,106959,92,243171
40828,0.001004,74.125.24.0-255,4320,111279,92,243171
40829,0.001006,74.125.24.0-255,766,112045,92,243171
40830,0.001008,172.31.47.0-255,66,112111,92,243171
40831,0.001012,172.31.47.0-255,66,112177,92,243171
40832,0.001034,74.125.24.0-255,1484,113661,92,243171
40833,0.001054,74.125.24.0-255,4320,117981,92,243171
40834,0.001063,172.31.47.0-255,66,118047,92,243171
40835,0.001073,74.125.24.0-255,5738,123785,92,243171
40836,0.001077,172.31.47.0-255,66,123851,92,243171
40837,0.001085,74.125.24.0-255,4320,128171,92,243171
40838,0.00109,74.125.24.0-255,4320,132491,92,243171
40839,0.001102,172.31.47.0-255,66,132557,92,243171
40840,0.001114,74.125.24.0-255,7156,139713,92,243171
40841,0.001118,172.31.47.0-255,66,139779,92,243171
40842,0.001136,74.125.24.0-255,5738,145517,92,243171
40843,0.001142,172.31.47.0-255,66,145583,92,243171
40844,0.001149,74.125.24.0-255,766,146349,92,243171
40845,0.001393,74.125.24.0-255,1484,147833,92,243171
40846,0.001397,172.31.47.0-255,66,147899,92,243171
40847,0.001402,74.125.24.0-255,2902,150801,92,243171
40848,0.001433,172.31.47.0-255,66,150867,92,243171
40849,0.001449,74.125.24.0-255,5738,156605,92,243171
40850,0.001472,172.31.47.0-255,66,156671,92,243171
40851,0.001513,74.125.24.0-255,2184,158855,92,243171
40852,0.001518,172.31.47.0-255,66,158921,92,243171
40853,0.001547,74.125.24.0-255,1484,160405,92,243171
40854,0.00155,74.125.24.0-255,1484,161889,92,243171
40855,0.001553,172.31.47.0-255,66,161955,92,243171
40856,0.00157,74.125.24.0-255,1484,163439,92,243171
40857,0.001576,74.125.24.0-255,5738,169177,92,243171
40858,0.00158,172.31.47.0-255,66,169243,92,243171
40859,0.001592,74.125.24.0-255,4320,173563,92,243171
40860,0.001596,74.125.24.0-255,2902,176465,92,243171
40861,0.001604,172.31.47.0-255,66,176531,92,243171
40862,0.001616,74.125.24.0-255,2902,179433,92,243171
40863,0.001628,74.125.24.0-255,4320,183753,92,243171
40864,0.001639,172.31.47.0-255,66,183819,92,243171
40865,0.001645,74.125.24.0-255,7156,190975,92,243171
40866,0.001648,74.125.24.0-255,2184,193159,92,243171
40867,0.001652,172.31.47.0-255,66,193225,92,243171
40868,0.001727,74.125.24.0-255,1484,194709,92,243171
40869,0.001742,74.125.24.0-255,2902,197611,92,243171
40870,0.001758,172.31.47.0-255,66,197677,92,243171
40871,0.001773,74.125.24.0-255,5738,203415,92,243171
40872,0.001787,172.31.47.0-255,66,203481,92,243171
40873,0.001828,172.31.47.0-255,66,203547,92,243171
40874,0.001845,74.125.24.0-255,766,204313,92,243171
40875,0.001953,74.125.24.0-255,1484,205797,92,243171
40876,0.001956,172.31.47.0-255,66,205863,92,243171
40877,0.00196,74.125.24.0-255,2902,208765,92,243171
40878,0.001968,172.31.47.0-255,66,208831,92,243171
40879,0.001977,74.125.24.0-255,4320,213151,92,243171
40880,0.001991,74.125.24.0-255,1484,214635,92,243171
40881,0.002003,74.125.24.0-255,5738,220373,92,243171
40882,0.002005,172.31.47.0-255,66,220439,92,243171
40883,0.002009,172.31.47.0-255,66,220505,92,243171
40884,0.002022,74.125.24.0-255,7156,227661,92,243171
40885,0.002038,172.31.47.0-255,66,227727,92,243171
40886,0.002094,172.31.47.0-255,66,227793,92,243171
40887,0.002111,172.31.47.0-255,66,227859,92,243171
40888,0.002118,74.125.24.0-255,1484,229343,92,243171
40889,0.002155,172.31.47.0-255,66,229409,92,243171
40890,0.002224,74.125.24.0-255,1484,230893,92,243171
40891,0.002269,74.125.24.0-255,2902,233795,92,243171
40892,0.002317,74.125.24.0-255,105,233900,92,243171
40893,0.00633,172.31.47.0-255,66,233966,92,243171
40894,0.008387,172.31.47.0-255,105,234071,92,243171
40895,0.010917,74.125.24.0-255,66,234137,92,243171
40896,0.035193,172.31.47.0-255,172,234309,92,243171
40897,0.035221,172.31.47.0-255,1107,235416,92,243171
40898,0.035279,172.31.47.0-255,1514,236930,92,243171
40899,0.03528,172.31.47.0-255,1514,238444,92,243171
40900,0.035281,172.31.47.0-255,1514,239958,92,243171
40901,0.035283,172.31.47.0-255,1514,241472,92,243171
40902,0.035305,172.31.47.0-255,1501,242973,92,243171
40903,0.036683,104.244.42.0-255,66,243039,92,243171
40904,0.036716,104.244.42.0-255,66,243105,92,243171
40905,0.036793,104.244.42.0-255,66,243171,92,243171
40906,0.0,74.125.68.0-255,153,153,92,307430
40907,1.7e-05,172.31.47.0-255,66,219,92,307430
40908,2.4e-05,74.125.68.0-255,1484,1703,92,307430
40909,2.7e-05,172.31.47.0-255,66,1769,92,307430
40910,3.2e-05,74.125.68.0-255,2902,4671,92,307430
40911,3.4e-05,172.31.47.0-255,66,4737,92,307430
40912,4.4e-05,74.125.68.0-255,2902,7639,92,307430
40913,4.7e-05,172.31.47.0-255,66,7705,92,307430
40914,6.8e-05,74.125.68.0-255,4320,12025,92,307430
40915,7.5e-05,172.31.47.0-255,66,12091,92,307430
40916,9.7e-05,74.125.68.0-255,2112,14203,92,307430
40917,0.0001,172.31.47.0-255,66,14269,92,307430
40918,0.000236,74.125.68.0-255,1484,15753,92,307430
40919,0.000241,172.31.47.0-255,66,15819,92,307430
40920,0.000245,74.125.68.0-255,1484,17303,92,307430
40921,0.000246,172.31.47.0-255,66,17369,92,307430
40922,0.000267,74.125.68.0-255,2902,20271,92,307430
40923,0.000269,172.31.47.0-255,66,20337,92,307430
40924,0.000279,74.125.68.0-255,5738,26075,92,307430
40925,0.000281,172.31.47.0-255,66,26141,92,307430
40926,0.000319,74.125.68.0-255,5379,31520,92,307430
40927,0.000321,172.31.47.0-255,66,31586,92,307430
40928,0.000326,74.125.68.0-255,4320,35906,92,307430
40929,0.000328,172.31.47.0-255,66,35972,92,307430
40930,0.00035,74.125.68.0-255,1484,37456,92,307430
40931,0.000353,172.31.47.0-255,66,37522,92,307430
40932,0.000358,74.125.68.0-255,4320,41842,92,307430
40933,0.000359,172.31.47.0-255,66,41908,92,307430
40934,0.000393,74.125.68.0-255,5738,47646,92,307430
40935,0.000395,172.31.47.0-255,66,47712,92,307430
40936,0.000406,74.125.68.0-255,2902,50614,92,307430
40937,0.000412,172.31.47.0-255,66,50680,92,307430
40938,0.000441,172.31.47.0-255,66,50746,92,307430
40939,0.000451,74.125.68.0-255,1484,52230,92,307430
40940,0.000456,172.31.47.0-255,66,52296,92,307430
40941,0.000481,74.125.68.0-255,5020,57316,92,307430
40942,0.000484,172.31.47.0-255,66,57382,92,307430
40943,0.000519,74.125.68.0-255,678,58060,92,307430
40944,0.000704,74.125.68.0-255,1484,59544,92,307430
40945,0.000718,74.125.68.0-255,1484,61028,92,307430
40946,0.000738,74.125.68.0-255,1484,62512,92,307430
40947,0.000745,74.125.68.0-255,5738,68250,92,307430
40948,0.000751,172.31.47.0-255,66,68316,92,307430
40949,0.000762,74.125.68.0-255,5738,74054,92,307430
40950,0.000778,172.31.47.0-255,66,74120,92,307430
40951,0.000784,74.125.68.0-255,7156,81276,92,307430
40952,0.00083,172.31.47.0-255,66,81342,92,307430
40953,0.000839,74.125.68.0-255,2184,83526,92,307430
40954,0.000849,172.31.47.0-255,66,83592,92,307430
40955,0.000986,74.125.68.0-255,1484,85076,92,307430
40956,0.000992,74.125.68.0-255,2902,87978,92,307430
40957,0.000995,172.31.47.0-255,66,88044,92,307430
40958,0.001023,74.125.68.0-255,4320,92364,92,307430
40959,0.001046,172.31.47.0-255,66,92430,92,307430
40960,0.001051,74.125.68.0-255,2902,95332,92,307430
40961,0.001055,172.31.47.0-255,66,95398,92,307430
40962,0.00108,74.125.68.0-255,2902,98300,92,307430
40963,0.001084,74.125.68.0-255,1484,99784,92,307430
40964,0.001103,74.125.68.0-255,5738,105522,92,307430
40965,0.001106,74.125.68.0-255,1484,107006,92,307430
40966,0.001112,172.31.47.0-255,66,107072,92,307430
40967,0.001133,74.125.68.0-255,7156,114228,92,307430
40968,0.001139,74.125.68.0-255,3602,117830,92,307430
40969,0.001158,172.31.47.0-255,66,117896,92,307430
40970,0.001491,74.125.68.0-255,1484,119380,92,307430
40971,0.001508,74.125.68.0-255,2902,122282,92,307430
40972,0.001512,74.125.68.0-255,2902,125184,92,307430
40973,0.001517,172.31.47.0-255,66,125250,92,307430
40974,0.001525,74.125.68.0-255,1484,126734,92,307430
40975,0.001541,172.31.47.0-255,66,126800,92,307430
40976,0.001545,74.125.68.0-255,2902,129702,92,307430
40977,0.001568,74.125.68.0-255,5738,135440,92,307430
40978,0.001571,74.125.68.0-255,1484,136924,92,307430
40979,0.001588,172.31.47.0-255,66,136990,92,307430
40980,0.001597,74.125.68.0-255,2902,139892,92,307430
40981,0.001623,74.125.68.0-255,2902,142794,92,307430
40982,0.001638,74.125.68.0-255,1484,144278,92,307430
40983,0.001642,74.125.68.0-255,2902,147180,92,307430
40984,0.001655,172.31.47.0-255,66,147246,92,307430
40985,0.001659,74.125.68.0-255,2902,150148,92,307430
40986,0.001663,172.31.47.0-255,66,150214,92,307430
40987,0.00168,74.125.68.0-255,2184,152398,92,307430
40988,0.001697,172.31.47.0-255,66,152464,92,307430
40989,0.003974,74.125.68.0-255,2902,155366,92,307430
40990,0.003981,172.31.47.0-255,66,155432,92,307430
40991,0.004012,74.125.68.0-255,2902,158334,92,307430
40992,0.004014,172.31.47.0-255,66,158400,92,307430
40993,0.006283,74.125.68.0-255,2902,161302,92,307430
40994,0.006286,172.31.47.0-255,66,161368,92,307430
40995,0.006312,74.125.68.0-255,2902,164270,92,307430
40996,0.006315,172.31.47.0-255,66,164336,92,307430
40997,0.008593,74.125.68.0-255,2902,167238,92,307430
40998,0.008599,172.31.47.0-255,66,167304,92,307430
40999,0.008627,74.125.68.0-255,2902,170206,92,307430
41000,0.00863,172.31.47.0-255,66,170272,92,307430
41001,0.010905,74.125.68.0-255,2902,173174,92,307430
41002,0.010912,172.31.47.0-255,66,173240,92,307430
41003,0.010936,74.125.68.0-255,2902,176142,92,307430
41004,0.010938,172.31.47.0-255,66,176208,92,307430
41005,0.013228,74.125.68.0-255,2902,179110,92,307430
41006,0.013236,172.31.47.0-255,66,179176,92,307430
41007,0.013266,74.125.68.0-255,2902,182078,92,307430
41008,0.013269,172.31.47.0-255,66,182144,92,307430
41009,0.015603,74.125.68.0-255,5738,187882,92,307430
41010,0.015612,172.31.47.0-255,66,187948,92,307430
41011,0.017975,74.125.68.0-255,5738,193686,92,307430
41012,0.017984,172.31.47.0-255,66,193752,92,307430
41013,0.020299,74.125.68.0-255,5738,199490,92,307430
41014,0.020305,172.31.47.0-255,66,199556,92,307430
41015,0.022622,74.125.68.0-255,5738,205294,92,307430
41016,0.022628,172.31.47.0-255,66,205360,92,307430
41017,0.02494,74.125.68.0-255,5738,211098,92,307430
41018,0.024947,172.31.47.0-255,66,211164,92,307430
41019,0.02728,74.125.68.0-255,5738,216902,92,307430
41020,0.027288,172.31.47.0-255,66,216968,92,307430
41021,0.029595,74.125.68.0-255,5738,222706,92,307430
41022,0.029602,172.31.47.0-255,66,222772,92,307430
41023,0.030026,172.31.47.0-255,172,222944,92,307430
41024,0.030053,172.31.47.0-255,1103,224047,92,307430
41025,0.030115,172.31.47.0-255,1514,225561,92,307430
41026,0.030117,172.31.47.0-255,1514,227075,92,307430
41027,0.030118,172.31.47.0-255,1514,228589,92,307430
41028,0.03012,172.31.47.0-255,1514,230103,92,307430
41029,0.03012,172.31.47.0-255,1503,231606,92,307430
41030,0.031586,104.244.42.0-255,66,231672,92,307430
41031,0.031686,104.244.42.0-255,66,231738,92,307430
41032,0.031692,104.244.42.0-255,66,231804,92,307430
41033,0.031917,74.125.68.0-255,5738,237542,92,307430
41034,0.031925,172.31.47.0-255,66,237608,92,307430
41035,0.03238,104.244.42.0-255,108,237716,92,307430
41036,0.032386,172.31.47.0-255,66,237782,92,307430
41037,0.034255,74.125.68.0-255,5738,243520,92,307430
41038,0.034269,172.31.47.0-255,66,243586,92,307430
41039,0.0366,74.125.68.0-255,5738,249324,92,307430
41040,0.036618,172.31.47.0-255,66,249390,92,307430
41041,0.038937,74.125.68.0-255,5738,255128,92,307430
41042,0.038949,172.31.47.0-255,66,255194,92,307430
41043,0.041282,74.125.68.0-255,5738,260932,92,307430
41044,0.041305,172.31.47.0-255,66,260998,92,307430
41045,0.04363,74.125.68.0-255,5738,266736,92,307430
41046,0.04364,172.31.47.0-255,66,266802,92,307430
41047,0.045965,74.125.68.0-255,5738,272540,92,307430
41048,0.045977,172.31.47.0-255,66,272606,92,307430
41049,0.048332,74.125.68.0-255,5738,278344,92,307430
41050,0.048347,172.31.47.0-255,66,278410,92,307430
41051,0.050673,74.125.68.0-255,5738,284148,92,307430
41052,0.050679,172.31.47.0-255,66,284214,92,307430
41053,0.05299,74.125.68.0-255,5738,289952,92,307430
41054,0.052998,172.31.47.0-255,66,290018,92,307430
41055,0.055313,74.125.68.0-255,5738,295756,92,307430
41056,0.055319,172.31.47.0-255,66,295822,92,307430
41057,0.057652,74.125.68.0-255,5738,301560,92,307430
41058,0.05767,172.31.47.0-255,66,301626,92,307430
41059,0.059991,74.125.68.0-255,5738,307364,92,307430
41060,0.059998,172.31.47.0-255,66,307430,92,307430
41061,0.0,74.125.24.0-255,298,298,92,239809
41062,1e-05,172.31.47.0-255,66,364,92,239809
41063,3e-05,74.125.24.0-255,1484,1848,92,239809
41064,3.4e-05,172.31.47.0-255,66,1914,92,239809
41065,4.1e-05,74.125.24.0-255,4320,6234,92,239809
41066,4.3e-05,172.31.47.0-255,66,6300,92,239809
41067,0.000102,74.125.24.0-255,4320,10620,92,239809
41068,0.000105,172.31.47.0-255,66,10686,92,239809
41069,0.00013,74.125.24.0-255,3264,13950,92,239809
41070,0.000132,172.31.47.0-255,66,14016,92,239809
41071,0.000155,74.125.24.0-255,1484,15500,92,239809
41072,0.000157,172.31.47.0-255,66,15566,92,239809
41073,0.000185,74.125.24.0-255,2902,18468,92,239809
41074,0.000187,172.31.47.0-255,66,18534,92,239809
41075,0.000193,74.125.24.0-255,5738,24272,92,239809
41076,0.000194,172.31.47.0-255,66,24338,92,239809
41077,0.000236,74.125.24.0-255,1484,25822,92,239809
41078,0.000239,172.31.47.0-255,66,25888,92,239809
41079,0.000258,74.125.24.0-255,5379,31267,92,239809
41080,0.000261,172.31.47.0-255,66,31333,92,239809
41081,0.000626,74.125.24.0-255,1484,32817,92,239809
41082,0.00063,172.31.47.0-255,66,32883,92,239809
41083,0.000635,74.125.24.0-255,2902,35785,92,239809
41084,0.000637,172.31.47.0-255,66,35851,92,239809
41085,0.000661,74.125.24.0-255,5738,41589,92,239809
41086,0.000664,172.31.47.0-255,66,41655,92,239809
41087,0.000669,74.125.24.0-255,4320,45975,92,239809
41088,0.000671,172.31.47.0-255,66,46041,92,239809
41089,0.000711,172.31.47.0-255,66,46107,92,239809
41090,0.000715,74.125.24.0-255,2902,49009,92,239809
41091,0.000716,172.31.47.0-255,66,49075,92,239809
41092,0.000741,74.125.24.0-255,3961,53036,92,239809
41093,0.000746,172.31.47.0-255,66,53102,92,239809
41094,0.001536,74.125.24.0-255,645,53747,92,239809
41095,0.001566,74.125.24.0-255,1484,55231,92,239809
41096,0.00157,172.31.47.0-255,66,55297,92,239809
41097,0.001591,74.125.24.0-255,4320,59617,92,239809
41098,0.001594,172.31.47.0-255,66,59683,92,239809
41099,0.001618,74.125.24.0-255,5738,65421,92,239809
41100,0.00162,172.31.47.0-255,66,65487,92,239809
41101,0.001651,172.31.47.0-255,66,65553,92,239809
41102,0.001676,74.125.24.0-255,1484,67037,92,239809
41103,0.001685,172.31.47.0-255,66,67103,92,239809
41104,0.001707,74.125.24.0-255,2184,69287,92,239809
41105,0.001709,172.31.47.0-255,66,69353,92,239809
41106,0.002064,74.125.24.0-255,1484,70837,92,239809
41107,0.002067,74.125.24.0-255,1484,72321,92,239809
41108,0.002069,172.31.47.0-255,66,72387,92,239809
41109,0.002082,74.125.24.0-255,1484,73871,92,239809
41110,0.002091,74.125.24.0-255,5738,79609,92,239809
41111,0.002093,172.31.47.0-255,66,79675,92,239809
41112,0.002115,74.125.24.0-255,4320,83995,92,239809
41113,0.002117,172.31.47.0-255,66,84061,92,239809
41114,0.002141,74.125.24.0-255,4320,88381,92,239809
41115,0.002143,172.31.47.0-255,66,88447,92,239809
41116,0.002177,74.125.24.0-255,2902,91349,92,239809
41117,0.002179,172.31.47.0-255,66,91415,92,239809
41118,0.002213,172.31.47.0-255,66,91481,92,239809
41119,0.004519,74.125.24.0-255,5738,97219,92,239809
41120,0.004527,172.31.47.0-255,66,97285,92,239809
41121,0.006808,74.125.24.0-255,5738,103023,92,239809
41122,0.006813,172.31.47.0-255,66,103089,92,239809
41123,0.00915,74.125.24.0-255,5738,108827,92,239809
41124,0.009157,172.31.47.0-255,66,108893,92,239809
41125,0.01148,74.125.24.0-255,5738,114631,92,239809
41126,0.01149,172.31.47.0-255,66,114697,92,239809
41127,0.013815,74.125.24.0-255,5738,120435,92,239809
41128,0.013825,172.31.47.0-255,66,120501,92,239809
41129,0.016131,74.125.24.0-255,5738,126239,92,239809
41130,0.01614,172.31.47.0-255,66,126305,92,239809
41131,0.018453,74.125.24.0-255,5738,132043,92,239809
41132,0.018462,172.31.47.0-255,66,132109,92,239809
41133,0.020756,74.125.24.0-255,5738,137847,92,239809
41134,0.020764,172.31.47.0-255,66,137913,92,239809
41135,0.023066,74.125.24.0-255,5738,143651,92,239809
41136,0.023075,172.31.47.0-255,66,143717,92,239809
41137,0.023561,172.31.47.0-255,172,143889,92,239809
41138,0.0236,172.31.47.0-255,1112,145001,92,239809
41139,0.023638,172.31.47.0-255,1514,146515,92,239809
41140,0.02364,172.31.47.0-255,1514,148029,92,239809
41141,0.023641,172.31.47.0-255,1514,149543,92,239809
41142,0.023642,172.31.47.0-255,1514,151057,92,239809
41143,0.023669,172.31.47.0-255,1494,152551,92,239809
41144,0.025143,104.244.42.0-255,66,152617,92,239809
41145,0.025171,104.244.42.0-255,66,152683,92,239809
41146,0.025236,104.244.42.0-255,66,152749,92,239809
41147,0.025387,74.125.24.0-255,5738,158487,92,239809
41148,0.025391,172.31.47.0-255,66,158553,92,239809
41149,0.027714,74.125.24.0-255,5738,164291,92,239809
41150,0.027719,172.31.47.0-255,66,164357,92,239809
41151,0.030068,74.125.24.0-255,5738,170095,92,239809
41152,0.030074,172.31.47.0-255,66,170161,92,239809
41153,0.032395,74.125.24.0-255,5738,175899,92,239809
41154,0.0324,172.31.47.0-255,66,175965,92,239809
41155,0.034702,74.125.24.0-255,5738,181703,92,239809
41156,0.034708,172.31.47.0-255,66,181769,92,239809
41157,0.037005,74.125.24.0-255,5738,187507,92,239809
41158,0.037011,172.31.47.0-255,66,187573,92,239809
41159,0.039328,74.125.24.0-255,5738,193311,92,239809
41160,0.039335,172.31.47.0-255,66,193377,92,239809
41161,0.041651,74.125.24.0-255,5738,199115,92,239809
41162,0.041659,172.31.47.0-255,66,199181,92,239809
41163,0.043962,74.125.24.0-255,5738,204919,92,239809
41164,0.043968,172.31.47.0-255,66,204985,92,239809
41165,0.046286,74.125.24.0-255,5738,210723,92,239809
41166,0.046292,172.31.47.0-255,66,210789,92,239809
41167,0.04861,74.125.24.0-255,5738,216527,92,239809
41168,0.048617,172.31.47.0-255,66,216593,92,239809
41169,0.050911,74.125.24.0-255,5738,222331,92,239809
41170,0.050918,172.31.47.0-255,66,222397,92,239809
41171,0.053235,74.125.24.0-255,5738,228135,92,239809
41172,0.053241,172.31.47.0-255,66,228201,92,239809
41173,0.055539,74.125.24.0-255,5738,233939,92,239809
41174,0.055545,172.31.47.0-255,66,234005,92,239809
41175,0.057944,74.125.24.0-255,5738,239743,92,239809
41176,0.057951,172.31.47.0-255,66,239809,92,239809
41177,0.0,172.217.194.0-255,153,153,92,247248
41178,3.2e-05,172.31.47.0-255,66,219,92,247248
41179,3.9e-05,172.217.194.0-255,1484,1703,92,247248
41180,4.3e-05,172.31.47.0-255,66,1769,92,247248
41181,4.9e-05,172.217.194.0-255,2902,4671,92,247248
41182,5.1e-05,172.31.47.0-255,66,4737,92,247248
41183,5.7e-05,172.217.194.0-255,7156,11893,92,247248
41184,6e-05,172.31.47.0-255,66,11959,92,247248
41185,6.3e-05,172.217.194.0-255,2110,14069,92,247248
41186,6.6e-05,172.31.47.0-255,66,14135,92,247248
41187,0.000103,172.31.47.0-255,66,14201,92,247248
41188,0.000125,172.217.194.0-255,5379,19580,92,247248
41189,0.000128,172.31.47.0-255,66,19646,92,247248
41190,0.000198,172.217.194.0-255,1484,21130,92,247248
41191,0.000201,172.31.47.0-255,66,21196,92,247248
41192,0.000205,172.217.194.0-255,2902,24098,92,247248
41193,0.000207,172.31.47.0-255,66,24164,92,247248
41194,0.000236,172.217.194.0-255,5738,29902,92,247248
41195,0.000238,172.31.47.0-255,66,29968,92,247248
41196,0.000241,172.217.194.0-255,1484,31452,92,247248
41197,0.000244,172.31.47.0-255,66,31518,92,247248
41198,0.000261,172.217.194.0-255,7156,38674,92,247248
41199,0.000264,172.31.47.0-255,66,38740,92,247248
41200,0.000288,172.217.194.0-255,5379,44119,92,247248
41201,0.000291,172.31.47.0-255,66,44185,92,247248
41202,0.000303,172.31.47.0-255,66,44251,92,247248
41203,0.000326,172.217.194.0-255,98,44349,92,247248
41204,0.000329,172.31.47.0-255,66,44415,92,247248
41205,0.000332,172.217.194.0-255,365,44780,92,247248
41206,0.000334,172.31.47.0-255,66,44846,92,247248
41207,0.000525,172.217.194.0-255,1484,46330,92,247248
41208,0.000533,172.217.194.0-255,2902,49232,92,247248
41209,0.000536,172.31.47.0-255,66,49298,92,247248
41210,0.00054,172.217.194.0-255,1484,50782,92,247248
41211,0.000557,172.217.194.0-255,4320,55102,92,247248
41212,0.000559,172.31.47.0-255,66,55168,92,247248
41213,0.000564,172.217.194.0-255,2902,58070,92,247248
41214,0.000566,172.31.47.0-255,66,58136,92,247248
41215,0.000589,172.31.47.0-255,66,58202,92,247248
41216,0.000596,172.217.194.0-255,7156,65358,92,247248
41217,0.000598,172.31.47.0-255,66,65424,92,247248
41218,0.000621,172.217.194.0-255,2902,68326,92,247248
41219,0.000624,172.31.47.0-255,66,68392,92,247248
41220,0.00065,172.31.47.0-255,66,68458,92,247248
41221,0.000689,172.217.194.0-255,5738,74196,92,247248
41222,0.00069,172.31.47.0-255,66,74262,92,247248
41223,0.000693,172.31.47.0-255,66,74328,92,247248
41224,0.000714,172.31.47.0-255,66,74394,92,247248
41225,0.000731,172.217.194.0-255,2902,77296,92,247248
41226,0.000734,172.31.47.0-255,66,77362,92,247248
41227,0.00077,172.31.47.0-255,66,77428,92,247248
41228,0.000777,172.217.194.0-255,7156,84584,92,247248
41229,0.000779,172.31.47.0-255,66,84650,92,247248
41230,0.000812,172.31.47.0-255,66,84716,92,247248
41231,0.000815,172.217.194.0-255,766,85482,92,247248
41232,0.001026,172.217.194.0-255,1484,86966,92,247248
41233,0.00103,172.31.47.0-255,66,87032,92,247248
41234,0.001095,172.217.194.0-255,2902,89934,92,247248
41235,0.001098,172.31.47.0-255,66,90000,92,247248
41236,0.001103,172.217.194.0-255,5738,95738,92,247248
41237,0.001105,172.31.47.0-255,66,95804,92,247248
41238,0.001116,172.31.47.0-255,66,95870,92,247248
41239,0.001125,172.31.47.0-255,66,95936,92,247248
41240,0.001154,172.217.194.0-255,6438,102374,92,247248
41241,0.001156,172.31.47.0-255,66,102440,92,247248
41242,0.001162,172.217.194.0-255,7156,109596,92,247248
41243,0.001165,172.31.47.0-255,66,109662,92,247248
41244,0.001195,172.217.194.0-255,1484,111146,92,247248
41245,0.001223,172.31.47.0-255,66,111212,92,247248
41246,0.001227,172.217.194.0-255,5020,116232,92,247248
41247,0.001229,172.31.47.0-255,66,116298,92,247248
41248,0.001442,172.217.194.0-255,1484,117782,92,247248
41249,0.001456,172.217.194.0-255,2902,120684,92,247248
41250,0.00146,172.217.194.0-255,4320,125004,92,247248
41251,0.00146,172.31.47.0-255,66,125070,92,247248
41252,0.001463,172.31.47.0-255,66,125136,92,247248
41253,0.001468,172.217.194.0-255,1484,126620,92,247248
41254,0.001488,172.217.194.0-255,2902,129522,92,247248
41255,0.00149,172.31.47.0-255,66,129588,92,247248
41256,0.001521,172.31.47.0-255,66,129654,92,247248
41257,0.001525,172.217.194.0-255,4320,133974,92,247248
41258,0.001527,172.31.47.0-255,66,134040,92,247248
41259,0.001542,172.217.194.0-255,4320,138360,92,247248
41260,0.001545,172.31.47.0-255,66,138426,92,247248
41261,0.001578,172.217.194.0-255,2184,140610,92,247248
41262,0.001581,172.31.47.0-255,66,140676,92,247248
41263,0.001667,172.217.194.0-255,1484,142160,92,247248
41264,0.001673,172.217.194.0-255,2902,145062,92,247248
41265,0.001676,172.31.47.0-255,66,145128,92,247248
41266,0.001679,172.217.194.0-255,1484,146612,92,247248
41267,0.001693,172.217.194.0-255,4320,150932,92,247248
41268,0.001696,172.31.47.0-255,66,150998,92,247248
41269,0.001701,172.217.194.0-255,4320,155318,92,247248
41270,0.001703,172.31.47.0-255,66,155384,92,247248
41271,0.001727,172.217.194.0-255,4320,159704,92,247248
41272,0.00173,172.31.47.0-255,66,159770,92,247248
41273,0.001757,172.217.194.0-255,2902,162672,92,247248
41274,0.00176,172.31.47.0-255,66,162738,92,247248
41275,0.001779,172.31.47.0-255,66,162804,92,247248
41276,0.001803,172.217.194.0-255,3602,166406,92,247248
41277,0.001806,172.31.47.0-255,66,166472,92,247248
41278,0.00186,172.217.194.0-255,1484,167956,92,247248
41279,0.001864,172.217.194.0-255,1484,169440,92,247248
41280,0.001866,172.31.47.0-255,66,169506,92,247248
41281,0.001888,172.217.194.0-255,1484,170990,92,247248
41282,0.001894,172.217.194.0-255,5738,176728,92,247248
41283,0.001897,172.31.47.0-255,66,176794,92,247248
41284,0.001907,172.31.47.0-255,66,176860,92,247248
41285,0.001927,172.217.194.0-255,2902,179762,92,247248
41286,0.001929,172.31.47.0-255,66,179828,92,247248
41287,0.00194,172.31.47.0-255,66,179894,92,247248
41288,0.002016,172.217.194.0-255,1484,181378,92,247248
41289,0.002021,172.217.194.0-255,2902,184280,92,247248
41290,0.002029,172.31.47.0-255,66,184346,92,247248
41291,0.002047,172.217.194.0-255,5738,190084,92,247248
41292,0.00205,172.31.47.0-255,66,190150,92,247248
41293,0.002054,172.217.194.0-255,2902,193052,92,247248
41294,0.002056,172.31.47.0-255,66,193118,92,247248
41295,0.002098,172.31.47.0-255,66,193184,92,247248
41296,0.002107,172.31.47.0-255,66,193250,92,247248
41297,0.002109,172.217.194.0-255,1484,194734,92,247248
41298,0.002112,172.217.194.0-255,766,195500,92,247248
41299,0.002113,172.31.47.0-255,66,195566,92,247248
41300,0.002161,172.217.194.0-255,1484,197050,92,247248
41301,0.002166,172.217.194.0-255,4320,201370,92,247248
41302,0.002168,172.31.47.0-255,66,201436,92,247248
41303,0.002174,172.217.194.0-255,5738,207174,92,247248
41304,0.002177,172.217.194.0-255,4320,211494,92,247248
41305,0.002178,172.31.47.0-255,66,211560,92,247248
41306,0.00218,172.31.47.0-255,66,211626,92,247248
41307,0.002224,172.31.47.0-255,66,211692,92,247248
41308,0.00223,172.217.194.0-255,6438,218130,92,247248
41309,0.002233,172.31.47.0-255,66,218196,92,247248
41310,0.002312,172.217.194.0-255,1484,219680,92,247248
41311,0.002318,172.217.194.0-255,2902,222582,92,247248
41312,0.002321,172.31.47.0-255,66,222648,92,247248
41313,0.002337,172.217.194.0-255,5738,228386,92,247248
41314,0.00234,172.31.47.0-255,66,228452,92,247248
41315,0.002345,172.217.194.0-255,5738,234190,92,247248
41316,0.002347,172.31.47.0-255,66,234256,92,247248
41317,0.002385,172.217.194.0-255,3551,237807,92,247248
41318,0.002389,172.31.47.0-255,66,237873,92,247248
41319,0.002408,172.217.194.0-255,105,237978,92,247248
41320,0.012791,172.31.47.0-255,66,238044,92,247248
41321,0.012824,172.31.47.0-255,105,238149,92,247248
41322,0.014844,172.217.194.0-255,66,238215,92,247248
41323,0.043639,172.31.47.0-255,172,238387,92,247248
41324,0.043669,172.31.47.0-255,1103,239490,92,247248
41325,0.043706,172.31.47.0-255,1514,241004,92,247248
41326,0.043707,172.31.47.0-255,1514,242518,92,247248
41327,0.043708,172.31.47.0-255,1514,244032,92,247248
41328,0.043709,172.31.47.0-255,1514,245546,92,247248
41329,0.04371,172.31.47.0-255,1504,247050,92,247248
41330,0.045182,104.244.42.0-255,66,247116,92,247248
41331,0.045224,104.244.42.0-255,66,247182,92,247248
41332,0.045288,104.244.42.0-255,66,247248,92,247248
